"Imb.R","Policy","Inducer","Repetition","Iteration","Nu","Nu_majority","Nu_minority","Nl","Nl_majority","Nl_minority","AUC","PRBEP","LIFT","SV_total","SV_minority","SV_majority","SV.diff","SV.R","Data_Efficiency","Imb.R.Empirical","tr.alpha","tr.beta","tr.alpha_minority","tr.beta_minority","tr.alpha_majority","tr.beta_majority","Quantile","Nu_minority.est","Qt_minority.est"
7.5,"random_instances_SVM","SVM",1,0,30040,26573,3467,100,90,10,0.558458064304523,0.16832229580574,1.55436155885987,31,10,21,0,2.1,0.33,9,0,0,0,0,0,0,0.157773724712891,3009.97385058155,18.1507934823021
7.5,"random_instances_SVM","SVM",1,1,29940,26489,3451,200,174,26,0.479590979645299,0.153421633554084,1.46337205385204,88,26,62,57,2.4,0.66,6.7,0,0,0,0,0,0,0.134988946697991,3900.60165590284,13.698570136521
7.5,"random_instances_SVM","SVM",1,2,29840,26399,3441,300,264,36,0.476327504313373,0.147350993377483,1.36155562363995,113,36,77,25,2.1,1,7.3,0,0,0,0,0,0,0.123054395443887,3588.47959184814,12.3448633482799
7.5,"random_instances_SVM","SVM",1,3,29740,26306,3434,400,357,43,0.550934914133056,0.173289183222958,1.59977118998897,134,43,91,21,2.1,1.33,8.3,0,0,0,0,0,0,0.126062331477325,3193.99857921996,13.6585050230247
7.5,"random_instances_SVM","SVM",1,4,29640,26216,3424,500,447,53,0.532158796882018,0.173289183222958,1.57857988422948,172,53,119,38,2.2,1.66,8.4,0,0,0,0,0,0,0.282006308523734,3208.57978934265,45.401718124766
7.5,"random_instances_SVM","SVM",1,5,29540,26124,3416,600,539,61,0.463027071286657,0.114238410596026,1.04808825253386,203,61,142,31,2.3,1.99,8.8,0,0,0,0,0,0,0.106132186134993,2997.94272344819,10.7357974558093
7.5,"random_instances_SVM","SVM",1,6,29440,26035,3405,700,628,72,0.442109628729838,0.107615894039735,0.966608495913132,243,72,171,40,2.4,2.32,8.7,0,0,0,0,0,0,0.115530210762661,3016.05416938176,12.0308193965155
7.5,"random_instances_SVM","SVM",1,7,29340,25942,3398,800,721,79,0.449269661808286,0.115894039735099,1.00588634932779,277,79,198,34,2.5,2.65,9.1,0,0,0,0,0,0,0.100254832217701,2897.27510514799,10.0711574647041
7.5,"random_instances_SVM","SVM",1,8,29240,25855,3385,900,808,92,0.433087684037182,0.107615894039735,0.985144745298572,326,92,234,49,2.5,2.99,8.8,0,0,0,0,0,0,0.126921978119643,2966.72956172749,14.1467111543374
7.5,"random_instances_SVM","SVM",1,9,29140,25762,3378,1000,901,99,0.452187584858433,0.117549668874172,1.01522550088021,343,99,244,17,2.5,3.32,9.1,0,0,0,0,0,0,0.129935356653098,2864.9510051077,15.0819214190891
7.5,"random_instances_SVM","SVM",1,10,29040,25670,3370,1100,993,107,0.4471591789791,0.119205298013245,1.00497932827339,362,107,255,19,2.4,3.65,9.3,0,0,0,0,0,0,0.10873419797297,2811.81136777027,11.4558367268206
7.5,"random_instances_SVM","SVM",1,11,28940,25581,3359,1200,1082,118,0.45614853303858,0.118101545253863,1.04714572712691,393,118,275,31,2.3,3.98,9.2,0,0,0,0,0,0,0.109167241831419,2841.44317573029,11.6824877390793
7.5,"random_instances_SVM","SVM",1,12,28840,25491,3349,1300,1172,128,0.554185319913489,0.201434878587196,1.77962543552285,411,128,283,18,2.2,4.31,9.2,0,0,0,0,0,0,0.159890700558001,2866.54935275,44.4975422992949
7.5,"random_instances_SVM","SVM",1,13,28740,25399,3341,1400,1264,136,0.560104161828022,0.208609271523179,1.82757451568517,440,136,304,29,2.2,4.64,9.3,0,0,0,0,0,0,0.133203885287712,2817.67906411644,32.0537839226086
7.5,"random_instances_SVM","SVM",1,14,28640,25308,3332,1500,1355,145,0.540563683928632,0.19205298013245,1.853277243256,464,145,319,24,2.2,4.98,9.3,0,0,0,0,0,0,0.100959839584918,2771.34044884747,11.1453387897293
7.5,"random_instances_SVM","SVM",1,15,28540,25216,3324,1600,1447,153,0.530054807205812,0.188189845474614,1.758436176309,501,153,348,37,2.3,5.31,9.5,0,0,0,0,0,0,0.0997239802977658,2729.80274209772,10.9613133439386
7.5,"random_instances_SVM","SVM",1,16,28440,25124,3316,1700,1539,161,0.551986305440909,0.211368653421634,1.92222712779004,502,161,341,1,2.1,5.64,9.6,0,0,0,0,0,0,0.101062339333599,2694.60708668238,11.181381982921
7.5,"random_instances_SVM","SVM",1,17,28340,25033,3307,1800,1630,170,0.543511783490969,0.206953642384106,1.90574676814134,536,170,366,34,2.2,5.97,9.6,0,0,0,0,0,0,0.115136896928167,2684.02697823536,17.1230022435921
7.5,"random_instances_SVM","SVM",1,18,28240,24942,3298,1900,1721,179,0.547154192570604,0.199227373068433,1.81037310978648,563,179,384,27,2.1,6.3,9.6,0,0,0,0,0,0,0.114295072734743,2667.85594501618,17.440590231237
7.5,"random_instances_SVM","SVM",1,19,28140,24855,3285,2000,1808,192,0.552555829877395,0.200883002207506,1.86231004326396,616,192,424,53,2.2,6.64,9.4,0,0,0,0,0,0,0.111516717562464,2707.09027664739,15.7487581672142
7.5,"random_instances_SVM","SVM",1,20,28040,24763,3277,2100,1900,200,0.548272097073641,0.205849889624724,1.87213898250493,635,200,435,19,2.2,6.97,9.5,0,0,0,0,0,0,0.187874121540212,2720.63754898629,49.93061249469
7.5,"random_instances_SVM","SVM",1,21,27940,24680,3260,2200,1983,217,0.561731445857022,0.214128035320088,1.97435265731654,698,217,481,63,2.2,7.3,9.1,0,0,0,0,0,0,0.141688882077554,2773.34786117803,29.2876269535794
7.5,"random_instances_SVM","SVM",1,22,27840,24593,3247,2300,2070,230,0.551851739007885,0.204194260485651,1.88456872904002,713,230,483,15,2.1,7.63,9,0,0,0,0,0,0,0.108411201601343,2787.98525129487,12.9518145769252
7.5,"random_instances_SVM","SVM",1,23,27740,24501,3239,2400,2162,238,0.550766133778593,0.19757174392936,1.88793703776038,747,238,509,34,2.1,7.96,9.1,0,0,0,0,0,0,0.129830292004858,2763.26741013291,23.0112749267086
7.5,"random_instances_SVM","SVM",1,24,27640,24410,3230,2500,2253,247,0.557371959601941,0.206953642384106,1.98667036551727,783,247,536,36,2.2,8.29,9.1,0,0,0,0,0,0,0.15368623645371,2750.43310184612,28.0905215414337
7.5,"random_instances_SVM","SVM",1,25,27540,24314,3226,2600,2349,251,0.573039063640723,0.228476821192053,2.11069748947664,794,251,543,11,2.2,8.63,9.4,0,0,0,0,0,0,0.191592042151028,2682.01033213466,42.0292614722216
7.5,"random_instances_SVM","SVM",1,26,27440,24224,3216,2700,2439,261,0.563061959497051,0.215783664459161,2.08117724486858,824,261,563,30,2.2,8.96,9.3,0,0,0,0,0,0,0.184967514245135,2664.96214514832,38.7446433074218
7.5,"random_instances_SVM","SVM",1,27,27340,24133,3207,2800,2530,270,0.568377978754733,0.222958057395143,2.06086569112959,836,270,566,12,2.1,9.29,9.4,0,0,0,0,0,0,0.188575584441819,2656.93551606057,41.887280060748
7.5,"random_instances_SVM","SVM",1,28,27240,24041,3199,2900,2622,278,0.560359059704883,0.214679911699779,2.01654599884723,865,278,587,29,2.1,9.62,9.4,0,0,0,0,0,0,0.171879945233395,2631.08089001454,36.7753172245201
7.5,"random_instances_SVM","SVM",1,29,27140,23953,3187,3000,2710,290,0.541415452405443,0.190397350993377,1.99408331464233,904,290,614,39,2.1,9.95,9.3,0,0,0,0,0,0,0.253631031047648,2657.87165840404,57.352281371404
7.5,"random_instances_SVM","SVM",1,30,27040,23863,3177,3100,2800,300,0.56063372840007,0.202538631346578,2.07933222958057,948,300,648,44,2.2,10.29,9.3,0,0,0,0,0,0,0.139542870854974,2630.3399293357,24.7791856532103
7.5,"random_instances_SVM","SVM",1,31,26940,23774,3166,3200,2889,311,0.540075740132031,0.193156732891832,1.85986782610069,966,311,655,18,2.1,10.62,9.3,0,0,0,0,0,0,0.11595903099344,2623.59581782848,17.1327043094512
7.5,"random_instances_SVM","SVM",1,32,26840,23680,3160,3300,2983,317,0.542344597621806,0.18046357615894,1.7082227105792,963,317,646,-3,2,10.95,9.4,0,0,0,0,0,0,0.12496237373861,2586.39867430609,24.3666506170044
7.5,"random_instances_SVM","SVM",1,33,26740,23593,3147,3400,3070,330,0.484430959220169,0.128587196467991,1.13384214850672,1054,330,724,91,2.2,11.28,9.3,0,0,0,0,0,0,0.104403771625516,2594.60862607205,11.1046902968892
7.5,"random_instances_SVM","SVM",1,34,26640,23505,3135,3500,3158,342,0.542091822506496,0.183774834437086,1.76043912531306,1093,342,751,39,2.2,11.61,9.2,0,0,0,0,0,0,0.14211898058295,2624.18122224621,32.5467032051319
7.5,"random_instances_SVM","SVM",1,35,26540,23415,3125,3600,3248,352,0.544103867471755,0.199779249448124,1.76201941178103,1132,352,780,39,2.2,11.94,9.2,0,0,0,0,0,0,0.121015821413994,2601.34953956468,22.2401973355541
7.5,"random_instances_SVM","SVM",1,36,26440,23327,3113,3700,3336,364,0.526341764276239,0.178256070640177,1.75022928676926,1142,364,778,10,2.1,12.28,9.2,0,0,0,0,0,0,0.109170385206219,2602.58817490442,14.1937008577751
7.5,"random_instances_SVM","SVM",1,37,26340,23239,3101,3800,3424,376,0.473558132948805,0.117549668874172,1.0434194220639,1168,376,792,26,2.1,12.61,9.1,0,0,0,0,0,0,0.103371283515935,2605.748315976,10.6234975958913
7.5,"random_instances_SVM","SVM",1,38,26240,23155,3085,3900,3508,392,0.444938104435542,0.111479028697572,1.00407394149116,1240,392,848,72,2.2,12.94,8.9,0,0,0,0,0,0,0.103786912104572,2637.01586690944,10.5407202919285
7.5,"random_instances_SVM","SVM",1,39,26140,23067,3073,4000,3596,404,0.552908416408235,0.200331125827815,2.04597395851778,1285,404,881,45,2.2,13.27,8.9,0,0,0,0,0,0,0.108415548961512,2641.15915718006,12.5814218570436
7.5,"random_instances_SVM","SVM",1,40,26040,22982,3058,4100,3681,419,0.544242845918977,0.194260485651214,1.90110375275938,1358,419,939,73,2.2,13.6,8.8,0,0,0,0,0,0,0.128474718965577,2665.35661139416,22.4775300765269
7.5,"random_instances_SVM","SVM",1,41,25940,22896,3044,4200,3767,433,0.552191255987225,0.206401766004415,1.98811711834562,1309,433,876,-49,2,13.93,8.7,0,0,0,0,0,0,0.116000385702838,2674.75680661791,15.8889758654519
7.5,"random_instances_SVM","SVM",1,42,25840,22810,3030,4300,3853,447,0.519822222466415,0.160596026490066,1.67981799422774,1420,447,973,111,2.2,14.27,8.6,0,0,0,0,0,0,0.130333817357658,2690.70973214082,23.2559508635743
7.5,"random_instances_SVM","SVM",1,43,25740,22724,3016,4400,3939,461,0.568665342396452,0.201434878587196,2.11092172725964,1401,461,940,-19,2,14.6,8.5,0,0,0,0,0,0,0.129149038335322,2704.76452983688,21.0451527836367
7.5,"random_instances_SVM","SVM",1,44,25640,22640,3000,4500,4023,477,0.539853599379457,0.184878587196468,1.84829531518273,1441,477,964,40,2,14.93,8.4,0,0,0,0,0,0,0.165551122649336,2721.16353791255,36.456797952771
7.5,"random_instances_SVM","SVM",1,45,25540,22550,2990,4600,4113,487,0.548120964775982,0.189293598233996,1.97499297791703,1459,487,972,18,2,15.26,8.4,0,0,0,0,0,0,0.142220043410802,2711.39740710107,26.7967334767605
7.5,"random_instances_SVM","SVM",1,46,25440,22459,2981,4700,4204,496,0.557127425796167,0.199779249448124,1.92393729427384,1460,496,964,1,1.9,15.59,8.5,0,0,0,0,0,0,0.115092394890138,2687.97270574353,14.0480481913298
7.5,"random_instances_SVM","SVM",1,47,25340,22370,2970,4800,4293,507,0.556695423009779,0.210264900662252,2.02554040562175,1487,507,980,27,1.9,15.93,8.5,0,0,0,0,0,0,0.136534610792526,2676.58502893811,20.4450225183878
7.5,"random_instances_SVM","SVM",1,48,25240,22285,2955,4900,4378,522,0.569665953918263,0.22075055187638,2.09966347804758,1524,522,1002,37,1.9,16.26,8.4,0,0,0,0,0,0,0.146091386848205,2691.13035830728,24.401466758114
7.5,"random_instances_SVM","SVM",2,0,30040,26556,3484,100,85,15,0.392620701056113,0.0692737430167598,0.592177763448877,49,15,34,0,2.3,0.33,5.7,0,0,0,0,0,0,0.164657626460328,4581.90324311115,16.6118371305642
7.5,"random_instances_SVM","SVM",2,1,29940,26472,3468,200,169,31,0.585325026427054,0.213966480446927,2.13432726491386,82,31,51,33,1.6,0.66,5.5,0,0,0,0,0,0,0.212473576113878,4591.02958856848,22.319200437786
7.5,"random_instances_SVM","SVM",2,2,29840,26381,3459,300,260,40,0.597481385387362,0.23072625698324,2.36570339387912,117,40,77,35,1.9,1,6.5,0,0,0,0,0,0,0.547292972355844,3920.65624292021,63.7680702150523
7.5,"random_instances_SVM","SVM",2,3,29740,26289,3451,400,352,48,0.60583056653791,0.236871508379888,2.28688297431143,140,48,92,23,1.9,1.33,7.3,0,0,0,0,0,0,0.535291281443721,3510.94563208761,63.2681560635115
7.5,"random_instances_SVM","SVM",2,4,29640,26197,3443,500,444,56,0.600066882626042,0.235195530726257,2.37911666928948,169,56,113,29,2,1.66,7.9,0,0,0,0,0,0,0.220361145752167,3263.92329108726,25.0458215540535
7.5,"random_instances_SVM","SVM",2,5,29540,26103,3437,600,538,62,0.585202155892047,0.218994413407821,2.27875425867198,193,62,131,24,2.1,1.99,8.7,0,0,0,0,0,0,0.396135983747656,3036.88812851078,48.6090205062258
7.5,"random_instances_SVM","SVM",2,6,29440,26009,3431,700,632,68,0.594767212706515,0.229608938547486,2.26936153932931,205,68,137,12,2,2.32,9.3,0,0,0,0,0,0,0.485389532375778,2953.56715648097,59.606582234682
7.5,"random_instances_SVM","SVM",2,7,29340,25917,3423,800,724,76,0.59660513885716,0.225698324022346,2.21179152520815,233,76,157,28,2.1,2.65,9.5,0,0,0,0,0,0,0.866616981817343,2988.98663743318,93.1126139726551
7.5,"random_instances_SVM","SVM",2,8,29240,25825,3415,900,816,84,0.596258842493102,0.23854748603352,2.39509101367886,246,84,162,13,1.9,2.99,9.7,0,0,0,0,0,0,0.802645056739653,2920.48622933406,89.7197204852674
7.5,"random_instances_SVM","SVM",2,9,29140,25734,3406,1000,907,93,0.590482686443732,0.233519553072626,2.37607019227474,281,93,188,35,2,3.32,9.8,0,0,0,0,0,0,0.459168356212615,2815.39905973499,59.0405968038998
7.5,"random_instances_SVM","SVM",2,10,29040,25643,3397,1100,998,102,0.600938733411326,0.23854748603352,2.48759522600305,309,102,207,28,2,3.65,9.8,0,0,0,0,0,0,0.424732734561692,2754.66193937059,55.0861492532755
7.5,"random_instances_SVM","SVM",2,11,28940,25555,3385,1200,1086,114,0.587531858634529,0.23854748603352,2.36338331863177,322,114,208,13,1.8,3.98,9.5,0,0,0,0,0,0,0.667117524774213,2812.21428928588,79.0782109326332
7.5,"random_instances_SVM","SVM",2,12,28840,25463,3377,1300,1178,122,0.591759766020174,0.229608938547486,2.48675669191486,347,122,225,25,1.8,4.31,9.7,0,0,0,0,0,0,0.736029444176224,2821.72667316433,85.4905662425914
7.5,"random_instances_SVM","SVM",2,13,28740,25370,3370,1400,1271,129,0.586852705528418,0.224022346368715,2.45508859298105,379,129,250,32,1.9,4.64,9.9,0,0,0,0,0,0,0.88773443433806,2781.00556247257,94.8323991864898
7.5,"random_instances_SVM","SVM",2,14,28640,25277,3363,1500,1364,136,0.590964493738481,0.231843575418994,2.40769675585612,397,136,261,18,1.9,4.98,10,0,0,0,0,0,0,0.610253868157114,2666.97369845948,74.6230241747748
7.5,"random_instances_SVM","SVM",2,15,28540,25185,3355,1600,1456,144,0.588771500766202,0.23072625698324,2.32568074383717,397,144,253,0,1.8,5.31,10.1,0,0,0,0,0,0,0.672114886229462,2640.99585105818,80.1093538029878
7.5,"random_instances_SVM","SVM",2,16,28440,25094,3346,1700,1547,153,0.587817497925159,0.232960893854749,2.31703739246667,421,153,268,24,1.8,5.64,10.1,0,0,0,0,0,0,0.857159316181908,2670.48183055521,93.1929277924318
7.5,"random_instances_SVM","SVM",2,17,28340,25008,3332,1800,1633,167,0.594180790889157,0.242458100558659,2.41932676164201,464,167,297,43,1.8,5.97,9.8,0,0,0,0,0,0,0.444545233763456,2671.64719221135,63.4802213731801
7.5,"random_instances_SVM","SVM",2,18,28240,24923,3317,1900,1718,182,0.587067970835818,0.237430167597765,2.33917469239469,498,182,316,34,1.7,6.3,9.4,0,0,0,0,0,0,0.456166331861485,2755.93649761287,64.6528719298576
7.5,"random_instances_SVM","SVM",2,19,28140,24833,3307,2000,1808,192,0.58502371809351,0.226815642458101,2.36131199232272,566,192,374,68,1.9,6.64,9.4,0,0,0,0,0,0,0.485171354452296,2782.37344090369,70.6465033213919
7.5,"random_instances_SVM","SVM",2,20,28040,24742,3298,2100,1899,201,0.584922805250834,0.235754189944134,2.30094991703567,596,201,395,30,2,6.97,9.4,0,0,0,0,0,0,0.258876433828436,2697.42666516633,47.1578233393066
7.5,"random_instances_SVM","SVM",2,21,27940,24650,3290,2200,1991,209,0.591977450038891,0.235195530726257,2.46246123139841,605,209,396,9,1.9,7.3,9.5,0,0,0,0,0,0,0.322606165718907,2691.06901719295,52.4108213340683
7.5,"random_instances_SVM","SVM",2,22,27840,24566,3274,2300,2075,225,0.594718796415604,0.236871508379888,2.41610971812881,648,225,423,43,1.9,7.63,9.2,0,0,0,0,0,0,0.477407346647061,2787.86901810099,68.9700321407775
7.5,"random_instances_SVM","SVM",2,23,27740,24476,3264,2400,2165,235,0.587780228738577,0.232960893854749,2.35835648892919,677,235,442,29,1.9,7.96,9.2,0,0,0,0,0,0,0.676868145824925,2801.15665323003,84.9573016977413
7.5,"random_instances_SVM","SVM",2,24,27640,24385,3255,2500,2256,244,0.587787716227542,0.241340782122905,2.27217633138982,723,244,479,46,2,8.29,9.2,0,0,0,0,0,0,0.550436640633954,2789.62921086068,77.0911608692252
7.5,"random_instances_SVM","SVM",2,25,27540,24300,3240,2600,2341,259,0.590301051739821,0.246368715083799,2.38442927826339,746,259,487,23,1.9,8.63,9,0,0,0,0,0,0,0.248731683810506,2775.93933683604,45.1779878744592
7.5,"random_instances_SVM","SVM",2,26,27440,24209,3231,2700,2432,268,0.570269368724759,0.223463687150838,2.14761768578008,800,268,532,54,2,8.96,9.1,0,0,0,0,0,0,0.187832454305412,2739.68338502181,37.2872619581051
7.5,"random_instances_SVM","SVM",2,27,27340,24118,3222,2800,2523,277,0.59067004192573,0.227374301675978,2.22347352270045,845,277,568,45,2.1,9.29,9.1,0,0,0,0,0,0,0.144234249535043,2716.85948050753,23.7171866570466
7.5,"random_instances_SVM","SVM",2,28,27240,24028,3212,2900,2613,287,0.584306433477665,0.226256983240223,2.21997034278226,868,287,581,23,2,9.62,9.1,0,0,0,0,0,0,0.187424506144177,2717.69167516026,32.1347114855202
7.5,"random_instances_SVM","SVM",2,29,27140,23935,3205,3000,2706,294,0.577083824962708,0.222905027932961,2.14572384302366,929,294,635,61,2.2,9.95,9.2,0,0,0,0,0,0,0.287981066925363,2686.08215352401,51.0181033157571
7.5,"random_instances_SVM","SVM",2,30,27040,23849,3191,3100,2792,308,0.571203075422989,0.211731843575419,2.17900405224644,918,308,610,-11,2,10.29,9.1,0,0,0,0,0,0,0.151430971874225,2699.47679652533,24.0847381677498
7.5,"random_instances_SVM","SVM",2,31,26940,23760,3180,3200,2881,319,0.589405329325428,0.229608938547486,2.14935773861043,935,319,616,17,1.9,10.62,9,0,0,0,0,0,0,0.10689111201197,2690.4010484982,15.7817699567922
7.5,"random_instances_SVM","SVM",2,32,26840,23668,3172,3300,2973,327,0.592212001940019,0.224581005586592,2.06601170383691,1005,327,678,70,2.1,10.95,9.1,0,0,0,0,0,0,0.184566310799849,2691.4320192841,38.1540108488654
7.5,"random_instances_SVM","SVM",2,33,26740,23575,3165,3400,3066,334,0.580545442537943,0.224022346368715,2.03178885367904,1024,334,690,19,2.1,11.28,9.2,0,0,0,0,0,0,0.104554297290318,2630.62183371571,14.6678511327998
7.5,"random_instances_SVM","SVM",2,34,26640,23483,3157,3500,3158,342,0.566510817528632,0.196648044692737,1.92103884723011,1061,342,719,37,2.1,11.61,9.2,0,0,0,0,0,0,0.101307348853643,2605.29814064084,12.4009326274632
7.5,"random_instances_SVM","SVM",2,35,26540,23395,3145,3600,3246,354,0.577851082257641,0.218435754189944,2.026095659188,1094,354,740,33,2.1,11.94,9.2,0,0,0,0,0,0,0.0990156751460212,2610.26386956799,10.1961502425488
7.5,"random_instances_SVM","SVM",2,36,26440,23306,3134,3700,3335,365,0.563715165824742,0.207821229050279,1.99861844416624,1135,365,770,41,2.1,12.28,9.1,0,0,0,0,0,0,0.119974031118074,2625.53843860432,24.672983823712
7.5,"random_instances_SVM","SVM",2,37,26340,23220,3120,3800,3421,379,0.557635913698698,0.197206703910615,1.96781704284383,1132,379,753,-3,2,12.61,9,0,0,0,0,0,0,0.103868037033721,2629.61266840734,13.325857249511
7.5,"random_instances_SVM","SVM",2,38,26240,23130,3110,3900,3511,389,0.567740027653234,0.201675977653631,1.98327250155183,1201,389,812,69,2.1,12.94,9,0,0,0,0,0,0,0.12263585802009,2626.86120872682,25.8407418419227
7.5,"random_instances_SVM","SVM",2,39,26140,23041,3099,4000,3600,400,0.555731946212916,0.201117318435754,2.02336090565741,1233,400,833,32,2.1,13.27,9,0,0,0,0,0,0,0.105354203518778,2616.90187922898,13.9717838218111
7.5,"random_instances_SVM","SVM",2,40,26040,22951,3089,4100,3690,410,0.572345380198285,0.210614525139665,2.06783037611142,1233,410,823,0,2,13.6,9,0,0,0,0,0,0,0.112315893527421,2608.05824756038,16.9657362252767
7.5,"random_instances_SVM","SVM",2,41,25940,22868,3072,4200,3773,427,0.563591706386116,0.206703910614525,2.09747668974742,1276,427,849,43,2,13.93,8.8,0,0,0,0,0,0,0.124095550452252,2644.93490733206,21.3400379292016
7.5,"random_instances_SVM","SVM",2,42,25840,22777,3063,4300,3864,436,0.582615396717033,0.226256983240223,2.15848068235883,1256,436,820,-20,1.9,14.27,8.9,0,0,0,0,0,0,0.126426930625005,2627.15254215479,20.8755813089348
7.5,"random_instances_SVM","SVM",2,43,25740,22690,3050,4400,3951,449,0.564928012841465,0.21340782122905,2.07707036152881,1353,449,904,97,2,14.6,8.8,0,0,0,0,0,0,0.132760384105096,2632.94021680523,23.0214022177415
7.5,"random_instances_SVM","SVM",2,44,25640,22602,3038,4500,4039,461,0.576770570298478,0.218435754189944,2.12532407658513,1347,461,886,-6,1.9,14.93,8.8,0,0,0,0,0,0,0.125382752521929,2633.67122724014,21.2109973869364
7.5,"random_instances_SVM","SVM",2,45,25540,22511,3029,4600,4130,470,0.565227344141399,0.198882681564246,1.99469447239668,1420,470,950,73,2,15.26,8.8,0,0,0,0,0,0,0.116940328241969,2615.88438031325,19.9032172387233
7.5,"random_instances_SVM","SVM",2,46,25440,22420,3020,4700,4221,479,0.563160628932248,0.197765363128492,2.08257496496042,1406,479,927,-14,1.9,15.59,8.8,0,0,0,0,0,0,0.175911614551883,2602.59176527006,36.2808380900866
7.5,"random_instances_SVM","SVM",2,47,25340,22330,3010,4800,4311,489,0.549695473728794,0.188826815642458,1.96306955505369,1483,489,994,77,2,15.93,8.8,0,0,0,0,0,0,0.132621959094106,2588.1835088629,24.336121357179
7.5,"random_instances_SVM","SVM",2,48,25240,22239,3001,4900,4402,498,0.563812082535688,0.204469273743017,2.03024684020762,1473,498,975,-10,2,16.26,8.8,0,0,0,0,0,0,0.117230529166047,2568.65851967242,19.6300512602787
7.5,"random_instances_SVM","SVM",3,0,30040,26569,3471,100,84,16,0.47723098300019,0.0965593784683685,0.756192135320811,48,16,32,0,2,0.33,5.2,0,0,0,0,0,0,0.372454327789485,5033.72810755521,41.4308361453978
7.5,"random_instances_SVM","SVM",3,1,29940,26485,3455,200,168,32,0.592849371692334,0.19811320754717,1.94205479479108,90,32,58,42,1.8,0.66,5.2,0,0,0,0,0,0,0.26169638969406,4783.37078173898,28.4204038482046
7.5,"random_instances_SVM","SVM",3,2,29840,26395,3445,300,258,42,0.607901981109912,0.218091009988901,2.04804842348909,112,42,70,22,1.7,1,6.1,0,0,0,0,0,0,0.551945892581977,4219.66476634971,63.8862308825153
7.5,"random_instances_SVM","SVM",3,3,29740,26302,3438,400,351,49,0.602600555449188,0.226970033296337,2.24313718918983,128,49,79,16,1.6,1.33,7.2,0,0,0,0,0,0,0.26646933754892,3578.14978727874,32.1351131328811
7.5,"random_instances_SVM","SVM",3,4,29640,26215,3425,500,438,62,0.612960294241018,0.22142064372919,2.0243771153371,166,62,104,38,1.7,1.66,7.1,0,0,0,0,0,0,0.367802684798117,3762.96030126684,43.9828872449321
7.5,"random_instances_SVM","SVM",3,5,29540,26120,3420,600,533,67,0.60395201938142,0.228079911209767,2.22236094330775,182,67,115,16,1.7,1.99,8,0,0,0,0,0,0,0.872468063622,3455.42239260854,93.3952986493461
7.5,"random_instances_SVM","SVM",3,6,29440,26030,3410,700,623,77,0.600940589955857,0.230854605993341,2.24943820994505,210,77,133,28,1.7,2.32,8.1,0,0,0,0,0,0,0.725762284294902,3372.81864629811,84.1492813280959
7.5,"random_instances_SVM","SVM",3,7,29340,25944,3396,800,709,91,0.610936621864191,0.22142064372919,2.177301288415,240,91,149,30,1.6,2.65,7.8,0,0,0,0,0,0,0.938439705662395,3497.55062770307,96.8996836737775
7.5,"random_instances_SVM","SVM",3,8,29240,25851,3389,900,802,98,0.599196018123738,0.210321864594895,2.13346650557544,267,98,169,27,1.7,2.99,8.2,0,0,0,0,0,0,0.786386950738777,3264.83092098257,87.676018031594
7.5,"random_instances_SVM","SVM",3,9,29140,25757,3383,1000,896,104,0.597889910382525,0.220865704772475,2.2371766829298,275,104,171,8,1.6,3.32,8.6,0,0,0,0,0,0,0.903654071779478,3104.06760710687,95.631988632138
7.5,"random_instances_SVM","SVM",3,10,29040,25669,3371,1100,984,116,0.596873588761666,0.215871254162042,2.12605863576442,305,116,189,30,1.6,3.65,8.5,0,0,0,0,0,0,0.702589449046586,3091.72499826346,81.9363240324922
7.5,"random_instances_SVM","SVM",3,11,28940,25582,3358,1200,1071,129,0.600014290650503,0.215871254162042,2.19078899551138,334,129,205,29,1.6,3.98,8.3,0,0,0,0,0,0,0.361185682634446,3139.41147795885,44.5758642192271
7.5,"random_instances_SVM","SVM",3,12,28840,25494,3346,1300,1159,141,0.597472733798513,0.216426193118757,2.1743576840088,382,141,241,48,1.7,4.31,8.2,0,0,0,0,0,0,0.858255620243407,3211.67480903879,93.0629785026546
7.5,"random_instances_SVM","SVM",3,13,28740,25404,3336,1400,1249,151,0.59573391252081,0.221975582685905,2.11696055679865,406,151,255,24,1.7,4.64,8.3,0,0,0,0,0,0,0.847952178900506,3163.56193921488,92.7230858819408
7.5,"random_instances_SVM","SVM",3,14,28640,25313,3327,1500,1340,160,0.589509031465283,0.207547169811321,2.09459829739584,425,160,265,19,1.7,4.98,8.4,0,0,0,0,0,0,0.576683015769687,3092.88091090578,72.0083686481779
7.5,"random_instances_SVM","SVM",3,15,28540,25222,3318,1600,1431,169,0.588462535117078,0.206992230854606,2.02390384744511,455,169,286,30,1.7,5.31,8.5,0,0,0,0,0,0,0.770846210981467,3088.45361820714,87.6513709394107
7.5,"random_instances_SVM","SVM",3,16,28440,25136,3304,1700,1517,183,0.573097137361465,0.203662597114317,1.99236798618819,511,183,328,56,1.8,5.64,8.3,0,0,0,0,0,0,0.699338179473658,3080.95500142087,84.3730022363825
7.5,"random_instances_SVM","SVM",3,17,28340,25051,3289,1800,1602,198,0.573392339458525,0.199223085460599,1.98317095865458,546,198,348,35,1.8,5.97,8.1,0,0,0,0,0,0,0.315916358981321,3126.08066162467,41.1217972990395
7.5,"random_instances_SVM","SVM",3,18,28240,24962,3278,1900,1691,209,0.581434374798461,0.203107658157603,2.01467061289925,578,209,369,32,1.8,6.3,8.1,0,0,0,0,0,0,0.511775517679632,3101.13423140509,65.6849079403067
7.5,"random_instances_SVM","SVM",3,19,28140,24873,3267,2000,1780,220,0.572766009982627,0.20976692563818,2.06496665455296,598,220,378,20,1.7,6.64,8.1,0,0,0,0,0,0,0.5,3097.69400963282,66.9707698220234
7.5,"random_instances_SVM","SVM",3,20,28040,24785,3255,2100,1868,232,0.576832216554765,0.211986681465039,2.11498955611777,622,232,390,24,1.7,6.97,8.1,0,0,0,0,0,0,0.72957274923897,3115.20911629973,86.0565476428833
7.5,"random_instances_SVM","SVM",3,21,27940,24699,3241,2200,1954,246,0.575588256623447,0.215316315205327,2.10762801399059,675,246,429,53,1.7,7.3,7.9,0,0,0,0,0,0,0.692792467507441,3123.13549111551,83.9436125338154
7.5,"random_instances_SVM","SVM",3,22,27840,24609,3231,2300,2044,256,0.570195909469631,0.210321864594895,2.12252291161596,704,256,448,29,1.8,7.63,8,0,0,0,0,0,0,0.52948253261874,3073.35124853988,70.1366278986101
7.5,"random_instances_SVM","SVM",3,23,27740,24521,3219,2400,2132,268,0.578962221910504,0.214206437291898,2.05732786505784,738,268,470,34,1.8,7.96,8,0,0,0,0,0,0,0.574017555324212,3129.6105235687,75.0250302606462
7.5,"random_instances_SVM","SVM",3,24,27640,24429,3211,2500,2224,276,0.569663429041795,0.20976692563818,2.03496560565504,783,276,507,45,1.8,8.29,8.1,0,0,0,0,0,0,0.590635957436151,3082.75247661197,76.8586240867403
7.5,"random_instances_SVM","SVM",3,25,27540,24340,3200,2600,2313,287,0.560763578271822,0.210876803551609,2.09087125416204,818,287,531,35,1.9,8.63,8.1,0,0,0,0,0,0,0.196824411711982,3026.00409812443,24.6615395043827
7.5,"random_instances_SVM","SVM",3,26,27440,24253,3187,2700,2400,300,0.566967443664849,0.213096559378468,2.10201266404212,844,300,544,26,1.8,8.96,8,0,0,0,0,0,0,0.376712901904071,3053.34727224244,51.9826996337959
7.5,"random_instances_SVM","SVM",3,27,27340,24164,3176,2800,2489,311,0.566269117247661,0.218091009988901,2.16527948384752,885,311,574,41,1.8,9.29,8,0,0,0,0,0,0,0.362679453563855,3045.18025813975,50.2712567430369
7.5,"random_instances_SVM","SVM",3,28,27240,24077,3163,2900,2576,324,0.571494321923483,0.218645948945616,2.14295701494188,900,324,576,15,1.8,9.62,8,0,0,0,0,0,0,0.293484275651714,3021.19585239867,39.6824369024956
7.5,"random_instances_SVM","SVM",3,29,27140,23991,3149,3000,2662,338,0.572248585551813,0.223640399556049,2.14295701494188,938,338,600,38,1.8,9.95,7.9,0,0,0,0,0,0,0.330561632305863,3049.70918380818,44.5811411740033
7.5,"random_instances_SVM","SVM",3,30,27040,23903,3137,3100,2750,350,0.566662873391858,0.218091009988901,2.18016112978462,1010,350,660,72,1.9,10.29,7.9,0,0,0,0,0,0,0.319044644216592,3053.12955306544,44.6065950276312
7.5,"random_instances_SVM","SVM",3,31,26940,23811,3129,3200,2842,358,0.552660900721675,0.206437291897891,2.14848637316562,1036,358,678,26,1.9,10.62,7.9,0,0,0,0,0,0,0.296493132095161,3014.85405421934,41.7153115497968
7.5,"random_instances_SVM","SVM",3,32,26840,23724,3116,3300,2929,371,0.562395564704022,0.212541620421754,2.16168507560425,1111,371,740,75,2,10.95,7.9,0,0,0,0,0,0,0.258699697425825,3000.63184923993,34.1327393252714
7.5,"random_instances_SVM","SVM",3,33,26740,23635,3105,3400,3018,382,0.554387028957448,0.213651498335183,2.15783866087898,1098,382,716,-13,1.9,11.28,7.9,0,0,0,0,0,0,0.151910871224389,2982.79952218956,17.5355905474918
7.5,"random_instances_SVM","SVM",3,34,26640,23544,3096,3500,3109,391,0.553060637442474,0.215871254162042,2.15400591014917,1141,391,750,43,1.9,11.61,8,0,0,0,0,0,0,0.250437311694694,2978.97721558305,35.3212021327255
7.5,"random_instances_SVM","SVM",3,35,26540,23451,3089,3600,3202,398,0.546874337379299,0.20976692563818,2.13741780924134,1211,398,813,70,2,11.94,8,0,0,0,0,0,0,0.16541769263931,2910.38330220999,20.71904300247
7.5,"random_instances_SVM","SVM",3,36,26440,23365,3075,3700,3288,412,0.551611037685246,0.214206437291898,2.13915069697573,1222,412,810,11,2,12.28,8,0,0,0,0,0,0,0.291195852008037,2939.95719057433,43.8573838324657
7.5,"random_instances_SVM","SVM",3,37,26340,23279,3061,3800,3374,426,0.559702255948765,0.214761376248613,2.18919971598155,1285,426,859,63,2,12.61,7.9,0,0,0,0,0,0,0.322382600161634,2950.423929208,48.3899970587805
7.5,"random_instances_SVM","SVM",3,38,26240,23185,3055,3900,3468,432,0.553355149473013,0.208102108768036,2.1985715496695,1287,432,855,2,2,12.94,8,0,0,0,0,0,0,0.216259215745454,2886.51191514105,29.9449963663242
7.5,"random_instances_SVM","SVM",3,39,26140,23097,3043,4000,3556,444,0.552043228444058,0.205327413984462,2.1985715496695,1283,444,839,-4,1.9,13.27,8,0,0,0,0,0,0,0.155200608397667,2896.19066059025,19.2663990020702
7.5,"random_instances_SVM","SVM",3,40,26040,23003,3037,4100,3650,450,0.554564919744434,0.215316315205327,2.19430658122306,1344,450,894,61,2,13.6,8.1,0,0,0,0,0,0,0.298310608535762,2841.87836528836,44.655420280575
7.5,"random_instances_SVM","SVM",3,41,25940,22914,3026,4200,3739,461,0.560075853785868,0.219200887902331,2.22433112144898,1367,461,906,23,2,13.93,8.1,0,0,0,0,0,0,0.242100322478204,2838.0203389042,33.8731569979526
7.5,"random_instances_SVM","SVM",3,42,25840,22826,3014,4300,3827,473,0.574140831621338,0.229189789123196,2.2574008230776,1368,473,895,1,1.9,14.27,8.1,0,0,0,0,0,0,0.280985405786497,2835.3028286201,42.2872644062317
7.5,"random_instances_SVM","SVM",3,43,25740,22740,3000,4400,3913,487,0.566135892585167,0.22031076581576,2.29106105509245,1393,487,906,25,1.9,14.6,8,0,0,0,0,0,0,0.208104753813434,2843.75611521822,26.4888930609541
7.5,"random_instances_SVM","SVM",3,44,25640,22651,2989,4500,4002,498,0.573093226984462,0.224750277469478,2.22630479591344,1463,498,965,70,1.9,14.93,8,0,0,0,0,0,0,0.164076926697198,2828.29818047569,19.2260570144332
7.5,"random_instances_SVM","SVM",3,45,25540,22560,2980,4600,4093,507,0.565322115946396,0.214206437291898,2.29513043529688,1479,507,972,16,1.9,15.26,8.1,0,0,0,0,0,0,0.154339135480924,2802.64384027503,17.6596134682573
7.5,"random_instances_SVM","SVM",3,46,25440,22470,2970,4700,4183,517,0.580849658425427,0.223640399556049,2.3589316713623,1516,517,999,37,1.9,15.59,8.1,0,0,0,0,0,0,0.202430560671673,2789.00573074086,25.3721702211678
7.5,"random_instances_SVM","SVM",3,47,25340,22381,2959,4800,4272,528,0.562222546204977,0.214761376248613,2.31330436630694,1494,528,966,-22,1.8,15.93,8.1,0,0,0,0,0,0,0.169953976582944,2778.60230913115,20.2777142187252
7.5,"random_instances_SVM","SVM",3,48,25240,22292,2948,4900,4361,539,0.568773326862604,0.215871254162042,2.36197889457737,1593,539,1054,99,2,16.26,8.1,0,0,0,0,0,0,0.203354268585467,2779.00071448566,27.2893327128453
7.5,"random_instances_SVM","SVM",4,0,30040,26552,3488,100,91,9,0.521074347553334,0.146205357142857,1.17500066151566,33,9,24,0,2.7,0.33,10.1,0,0,0,0,0,0,0.154085261197261,2557.20554563419,15.9632207811215
7.5,"random_instances_SVM","SVM",4,1,29940,26468,3472,200,175,25,0.509224020640807,0.150669642857143,1.51745189070916,87,25,62,54,2.5,0.66,7,0,0,0,0,0,0,0.157746767652915,3713.55553722838,16.4304003349902
7.5,"random_instances_SVM","SVM",4,2,29840,26375,3465,300,268,32,0.546201251405274,0.166294642857143,1.61733774038462,114,32,82,27,2.6,1,8.4,0,0,0,0,0,0,0.158663817469135,3214.64245305961,17.3675326968715
7.5,"random_instances_SVM","SVM",4,3,29740,26279,3461,400,364,36,0.461652095850858,0.110491071428571,0.874957959641256,148,36,112,34,3.1,1.33,10.1,0,0,0,0,0,0,0.166266461884778,2566.42965827302,17.7396143484255
7.5,"random_instances_SVM","SVM",4,4,29640,26190,3450,500,453,47,0.471210059620181,0.116071428571429,0.947089667792793,184,47,137,36,2.9,1.66,9.6,0,0,0,0,0,0,0.210053561059365,2761.64190263669,23.321590901025
7.5,"random_instances_SVM","SVM",4,5,29540,26100,3440,600,543,57,0.483731508632052,0.116629464285714,0.970402644230769,223,57,166,39,2.9,1.99,9.5,0,0,0,0,0,0,0.104356015839379,2808.79658011948,10.5434418825323
7.5,"random_instances_SVM","SVM",4,6,29440,26009,3431,700,634,66,0.504517130801313,0.122209821428571,0.98632987354521,246,66,180,23,2.7,2.32,9.6,0,0,0,0,0,0,0.114505619812331,2765.458193317,11.6841393403999
7.5,"random_instances_SVM","SVM",4,7,29340,25915,3425,800,728,72,0.495834357316333,0.126116071428571,1.06724056076854,261,72,189,15,2.6,2.65,10.1,0,0,0,0,0,0,0.109208023581829,2632.01497941248,11.1357458148844
7.5,"random_instances_SVM","SVM",4,8,29240,25827,3413,900,816,84,0.512997054795163,0.156808035714286,1.40294310325602,305,84,221,44,2.6,2.99,9.7,0,0,0,0,0,0,0.349573832500772,2708.12562007482,43.9874749044235
7.5,"random_instances_SVM","SVM",4,9,29140,25737,3403,1000,906,94,0.540276045925087,0.177455357142857,1.60694056919643,325,94,231,20,2.5,3.32,9.6,0,0,0,0,0,0,0.183626285885213,2758.52503764216,20.357176443766
7.5,"random_instances_SVM","SVM",4,10,29040,25647,3393,1100,996,104,0.537980152772098,0.185825892857143,1.83575726486247,387,104,283,62,2.7,3.65,9.6,0,0,0,0,0,0,0.249594001932992,2731.71966127877,29.2988092340318
7.5,"random_instances_SVM","SVM",4,11,28940,25558,3382,1200,1085,115,0.529841967345057,0.171316964285714,1.83088357300885,390,115,275,3,2.4,3.98,9.4,0,0,0,0,0,0,0.185176748231439,2788.80448766951,21.2213895474311
7.5,"random_instances_SVM","SVM",4,12,28840,25471,3369,1300,1172,128,0.521552705903791,0.165178571428571,1.70726914165931,429,128,301,39,2.4,4.31,9.2,0,0,0,0,0,0,0.110392855997128,2846.17585463908,11.3268272529977
7.5,"random_instances_SVM","SVM",4,13,28740,25380,3360,1400,1263,137,0.529152144598611,0.1875,1.86563325264085,423,137,286,-6,2.1,4.64,9.2,0,0,0,0,0,0,0.170377291233423,2821.69563158622,26.1578599343616
7.5,"random_instances_SVM","SVM",4,14,28640,25291,3349,1500,1352,148,0.555734883321412,0.193638392857143,1.93056357189974,474,148,326,51,2.2,4.98,9.1,0,0,0,0,0,0,0.231336067065385,2856.56889697534,42.3080444404743
7.5,"random_instances_SVM","SVM",4,15,28540,25205,3335,1600,1438,162,0.555360029900862,0.202566964285714,1.92593321728559,538,162,376,64,2.3,5.31,8.9,0,0,0,0,0,0,0.248493129027051,2888.56190692841,44.4771095456516
7.5,"random_instances_SVM","SVM",4,16,28440,25118,3322,1700,1525,175,0.558053469394471,0.200892857142857,1.97623812941696,523,175,348,-15,2,5.64,8.7,0,0,0,0,0,0,0.286995308671353,2917.00654951035,51.6960725450567
7.5,"random_instances_SVM","SVM",4,17,28340,25033,3307,1800,1610,190,0.557266613402741,0.1953125,1.90194346289753,540,190,350,17,1.8,5.97,8.5,0,0,0,0,0,0,0.333984542072523,2987.34743312349,57.0316062122319
7.5,"random_instances_SVM","SVM",4,18,28240,24943,3297,1900,1700,200,0.568594540890291,0.203683035714286,2.04331261003521,583,200,383,43,1.9,6.3,8.5,0,0,0,0,0,0,0.509670799963735,3051.66966075899,74.6439176322842
7.5,"random_instances_SVM","SVM",4,19,28140,24855,3285,2000,1788,212,0.562181731795904,0.214285714285714,2.16893503289474,612,212,400,29,1.9,6.64,8.4,0,0,0,0,0,0,0.3405454666326,3019.3896734495,54.5042727702393
7.5,"random_instances_SVM","SVM",4,20,28040,24766,3274,2100,1877,223,0.56889492791384,0.218191964285714,2.18914671888694,648,223,425,36,1.9,6.97,8.4,0,0,0,0,0,0,0.465704033723716,3019.97838652638,70.4087328374032
7.5,"random_instances_SVM","SVM",4,21,27940,24674,3266,2200,1969,231,0.570605091585269,0.20703125,2.04352042214912,666,231,435,18,1.9,7.3,8.5,0,0,0,0,0,0,0.547210186853477,2968.29717805123,78.0484787714864
7.5,"random_instances_SVM","SVM",4,22,27840,24585,3255,2300,2058,242,0.565809867453174,0.203683035714286,2.08406332381371,704,242,462,38,1.9,7.63,8.5,0,0,0,0,0,0,0.376126737390698,2930.81426207539,58.9967253506787
7.5,"random_instances_SVM","SVM",4,23,27740,24496,3244,2400,2147,253,0.586897263435552,0.2109375,2.16513654772329,723,253,470,19,1.9,7.96,8.5,0,0,0,0,0,0,0.428021143421907,2940.07470526227,62.7985761708716
7.5,"random_instances_SVM","SVM",4,24,27640,24406,3234,2500,2237,263,0.572669979216647,0.20703125,2.11180134911894,760,263,497,37,1.9,8.29,8.5,0,0,0,0,0,0,0.293596295067014,2905.54322891328,46.1628717747
7.5,"random_instances_SVM","SVM",4,25,27540,24316,3224,2600,2327,273,0.571279407502985,0.213169642857143,2.13579539213532,788,273,515,28,1.9,8.63,8.5,0,0,0,0,0,0,0.263760786853872,2898.54582494997,41.3470466537828
7.5,"random_instances_SVM","SVM",4,26,27440,24229,3211,2700,2414,286,0.57959064745759,0.216517857142857,2.19878204775528,819,286,533,31,1.9,8.96,8.4,0,0,0,0,0,0,0.237117070997588,2898.02231999914,36.8359625961301
7.5,"random_instances_SVM","SVM",4,27,27340,24138,3202,2800,2505,295,0.580208924469898,0.2265625,2.19106702302632,845,295,550,26,1.9,9.29,8.5,0,0,0,0,0,0,0.350499518127321,2895.84205886336,55.3339231853686
7.5,"random_instances_SVM","SVM",4,28,27240,24048,3192,2900,2595,305,0.582185204653159,0.231584821428571,2.17107998348018,873,305,568,28,1.9,9.62,8.5,0,0,0,0,0,0,0.398067401533827,2882.99328645284,60.3810244636624
7.5,"random_instances_SVM","SVM",4,29,27140,23958,3182,3000,2685,315,0.582328296121432,0.229910714285714,2.20969834688049,928,315,613,55,1.9,9.95,8.5,0,0,0,0,0,0,0.402195883062018,2886.37085709446,60.6409065912679
7.5,"random_instances_SVM","SVM",4,30,27040,23870,3170,3100,2773,327,0.56825309649097,0.206473214285714,2.10439151982379,972,327,645,44,2,10.29,8.5,0,0,0,0,0,0,0.527251410723657,2897.95164176427,73.302431601586
7.5,"random_instances_SVM","SVM",4,31,26940,23779,3161,3200,2864,336,0.570946409912797,0.207589285714286,2.1025390625,1001,336,665,29,2,10.62,8.5,0,0,0,0,0,0,0.402191024647089,2878.22826970895,65.4154635213013
7.5,"random_instances_SVM","SVM",4,32,26840,23688,3152,3300,2955,345,0.569050584536003,0.203683035714286,2.03029322687225,1009,345,664,8,1.9,10.95,8.6,0,0,0,0,0,0,0.320493906746764,2822.66018755338,49.3847340099655
7.5,"random_instances_SVM","SVM",4,33,26740,23603,3137,3400,3040,360,0.566921358273808,0.207589285714286,2.07484978599649,1073,360,713,64,2,11.28,8.4,0,0,0,0,0,0,0.583657313856428,2868.67002598057,77.641282966255
7.5,"random_instances_SVM","SVM",4,34,26640,23510,3130,3500,3133,367,0.574853647475069,0.215401785714286,2.10991639254386,1065,367,698,-8,1.9,11.61,8.5,0,0,0,0,0,0,0.579129374646913,2832.17375536845,78.6897053635702
7.5,"random_instances_SVM","SVM",4,35,26540,23418,3122,3600,3225,375,0.570093156117873,0.213169642857143,2.15229239702016,1111,375,736,46,2,11.94,8.6,0,0,0,0,0,0,0.256758564136662,2781.85027242077,39.8213374051519
7.5,"random_instances_SVM","SVM",4,36,26440,23326,3114,3700,3317,383,0.550963675863072,0.200892857142857,2.0711026824978,1158,383,775,47,2,12.28,8.7,0,0,0,0,0,0,0.362998332014596,2769.74951771337,58.879539810687
7.5,"random_instances_SVM","SVM",4,37,26340,23236,3104,3800,3407,393,0.558927651104595,0.200334821428571,2.1099423690581,1183,393,790,25,2,12.61,8.7,0,0,0,0,0,0,0.245771503201233,2721.06687469386,40.8656153755865
7.5,"random_instances_SVM","SVM",4,38,26240,23148,3092,3900,3495,405,0.568944306026968,0.218191964285714,2.13767384014952,1208,405,803,25,2,12.94,8.6,0,0,0,0,0,0,0.392035955305028,2768.15252353599,63.6891975068144
7.5,"random_instances_SVM","SVM",4,39,26140,23063,3077,4000,3580,420,0.566357355162017,0.216517857142857,2.14868785667252,1272,420,852,64,2,13.27,8.5,0,0,0,0,0,0,0.287052339811162,2759.83285438751,47.9185093429028
7.5,"random_instances_SVM","SVM",4,40,26040,22979,3061,4100,3664,436,0.568925143116687,0.213727678571429,2.11180134911894,1298,436,862,26,2,13.6,8.4,0,0,0,0,0,0,0.205778813341304,2786.25326657207,33.7042484249968
7.5,"random_instances_SVM","SVM",4,41,25940,22892,3048,4200,3751,449,0.574901953978087,0.224330357142857,2.17274686950791,1340,449,891,42,2,13.93,8.4,0,0,0,0,0,0,0.200242504572157,2786.22874639566,31.9780709366001
7.5,"random_instances_SVM","SVM",4,42,25840,22803,3037,4300,3840,460,0.575248189104981,0.22265625,2.14304331764448,1359,460,899,19,2,14.27,8.3,0,0,0,0,0,0,0.228029438495282,2769.50419396332,36.9256686736212
7.5,"random_instances_SVM","SVM",4,43,25740,22718,3022,4400,3925,475,0.555333891018844,0.188616071428571,1.9591418013729,1420,475,945,61,2,14.6,8.3,0,0,0,0,0,0,0.191185745195602,2775.6419871766,30.1051912875464
7.5,"random_instances_SVM","SVM",4,44,25640,22633,3007,4500,4010,490,0.562810535801695,0.194196428571429,1.98583425110132,1461,490,971,41,2,14.93,8.2,0,0,0,0,0,0,0.174606099484206,2798.26228061957,25.7656368221456
7.5,"random_instances_SVM","SVM",4,45,25540,22549,2991,4600,4094,506,0.581091237809695,0.22265625,2.07841460723742,1458,506,952,-3,1.9,15.26,8.1,0,0,0,0,0,0,0.235856033692312,2823.66394785927,37.5937475864827
7.5,"random_instances_SVM","SVM",4,46,25440,22463,2977,4700,4180,520,0.554085023983902,0.191964285714286,1.99500179122575,1511,520,991,53,1.9,15.59,8,0,0,0,0,0,0,0.188930875968413,2814.89830954433,28.6859045430618
7.5,"random_instances_SVM","SVM",4,47,25340,22373,2967,4800,4270,530,0.558478121167419,0.199776785714286,2.04872296999117,1533,530,1003,22,1.9,15.93,8.1,0,0,0,0,0,0,0.248707203301124,2806.30234622797,41.5994933553859
7.5,"random_instances_SVM","SVM",4,48,25240,22289,2951,4900,4354,546,0.575710200148204,0.2265625,2.19912212897527,1569,546,1023,36,1.9,16.26,8,0,0,0,0,0,0,0.187409437833216,2807.99550475924,27.9363417921027
7.5,"random_instances_SVM","SVM",5,0,30040,26491,3549,100,87,13,0.45900690420449,0.0903300521134916,0.858743793812909,45,13,32,0,2.5,0.33,6.7,0,0,0,0,0,0,0.140924006608667,3917.23224647033,14.1410588337234
7.5,"random_instances_SVM","SVM",5,1,29940,26407,3533,200,171,29,0.613630136712867,0.249565720903301,2.48013712947011,75,29,46,30,1.6,0.66,5.9,0,0,0,0,0,0,0.378633840154615,4340.48094803345,40.2051554354181
7.5,"random_instances_SVM","SVM",5,2,29840,26311,3529,300,267,33,0.566138237354524,0.191082802547771,1.79780692255983,112,33,79,37,2.4,1,8.1,0,0,0,0,0,0,0.222861483667179,3311.33956847124,24.1322224765559
7.5,"random_instances_SVM","SVM",5,3,29740,26219,3521,400,359,41,0.581401229624287,0.192819918934569,2.02874334195298,132,41,91,20,2.2,1.33,8.8,0,0,0,0,0,0,0.2312564335744,2971.45444354691,25.5296890898254
7.5,"random_instances_SVM","SVM",5,4,29640,26129,3511,500,449,51,0.565653882510672,0.195715112912565,1.84290425719393,164,51,113,32,2.2,1.66,8.8,0,0,0,0,0,0,0.288545295619363,3013.15285562436,31.8387371173497
7.5,"random_instances_SVM","SVM",5,5,29540,26035,3505,600,543,57,0.558021106276529,0.18297625940938,1.79463338871595,191,57,134,27,2.4,1.99,9.5,0,0,0,0,0,0,0.163939715473977,2814.20469712489,17.4956555838928
7.5,"random_instances_SVM","SVM",5,6,29440,25946,3494,700,632,68,0.559478813879982,0.185871453387377,1.85181828933202,244,68,176,53,2.6,2.32,9.3,0,0,0,0,0,0,0.137796462859238,2859.92757927454,14.3219557273038
7.5,"random_instances_SVM","SVM",5,7,29340,25861,3479,800,717,83,0.57226162468983,0.187608569774175,1.97527284195415,273,83,190,29,2.3,2.65,8.6,0,0,0,0,0,0,0.251691007801243,3089.78621543655,30.7488793774264
7.5,"random_instances_SVM","SVM",5,8,29240,25769,3471,900,809,91,0.427708303825965,0.101910828025478,0.967012003317736,307,91,216,34,2.4,2.99,8.9,0,0,0,0,0,0,0.126625682913936,2921.47207168725,13.3344033064833
7.5,"random_instances_SVM","SVM",5,9,29140,25680,3460,1000,898,102,0.578579239966453,0.198031268094962,1.93332180664161,333,102,231,26,2.3,3.32,8.8,0,0,0,0,0,0,0.240257789350884,3030.32467512961,27.3701561608857
7.5,"random_instances_SVM","SVM",5,10,29040,25590,3450,1100,988,112,0.57830785892421,0.210770121598147,2.10115471936971,381,112,269,48,2.4,3.65,8.8,0,0,0,0,0,0,0.115775733299805,2964.07710860372,11.8664806158735
7.5,"random_instances_SVM","SVM",5,11,28940,25497,3443,1200,1081,119,0.588575513358858,0.215402431962942,2.08949003808607,404,119,285,23,2.4,3.98,9.1,0,0,0,0,0,0,0.0993913063421076,2870.32608946152,9.94363956877023
7.5,"random_instances_SVM","SVM",5,12,28840,25405,3435,1300,1173,127,0.58486569892899,0.214823393167342,2.13934818818046,426,127,299,22,2.4,4.31,9.2,0,0,0,0,0,0,0.193864653596693,2855.46989789471,22.5872997056015
7.5,"random_instances_SVM","SVM",5,13,28740,25313,3427,1400,1265,135,0.589236999225166,0.226983207874928,2.27918906149534,469,135,334,43,2.5,4.64,9.4,0,0,0,0,0,0,0.155758750875164,2789.77051397867,19.1320554100848
7.5,"random_instances_SVM","SVM",5,14,28640,25226,3414,1500,1352,148,0.595594666420892,0.217139548349739,2.09164826773859,481,148,333,12,2.2,4.98,9.1,0,0,0,0,0,0,0.156594633239478,2839.79449706507,18.129629181505
7.5,"random_instances_SVM","SVM",5,15,28540,25136,3404,1600,1442,158,0.586819347359407,0.206716850028952,1.96062281106755,515,158,357,34,2.3,5.31,9.1,0,0,0,0,0,0,0.148367982650094,2812.73930687667,17.5048485298956
7.5,"random_instances_SVM","SVM",5,16,28440,25048,3392,1700,1530,170,0.574432976780135,0.191082802547771,1.85018240745098,551,170,381,36,2.2,5.64,9,0,0,0,0,0,0,0.139483824387289,2843.29123527673,15.0585400563141
7.5,"random_instances_SVM","SVM",5,17,28340,24957,3383,1800,1621,179,0.57116208451883,0.203242617255356,1.81003796715986,581,179,402,30,2.2,5.97,9.1,0,0,0,0,0,0,0.116347882757943,2816.37924014972,13.2469883959628
7.5,"random_instances_SVM","SVM",5,18,28240,24870,3370,1900,1708,192,0.580211084461906,0.203821656050955,1.94778576175149,635,192,443,54,2.3,6.3,8.9,0,0,0,0,0,0,0.11302946430831,2855.39663519968,12.1999972502158
7.5,"random_instances_SVM","SVM",5,19,28140,24784,3356,2000,1794,206,0.575977600953406,0.196873190503764,1.93414846921393,658,206,452,23,2.2,6.64,8.7,0,0,0,0,0,0,0.150708799556837,2877.01026923578,19.410236678068
7.5,"random_instances_SVM","SVM",5,20,28040,24693,3347,2100,1885,215,0.567899306785041,0.193977996525767,1.88373564200608,677,215,462,19,2.1,6.97,8.8,0,0,0,0,0,0,0.128091703769239,2871.84448142199,15.2286371429624
7.5,"random_instances_SVM","SVM",5,21,27940,24601,3339,2200,1977,223,0.568007616200032,0.209033005211349,1.94353301336682,714,223,491,37,2.2,7.3,8.9,0,0,0,0,0,0,0.106447990782406,2830.38680948935,11.0040324876366
7.5,"random_instances_SVM","SVM",5,22,27840,24511,3329,2300,2067,233,0.570568292036899,0.203242617255356,2.0510802947389,727,233,494,13,2.1,7.63,8.9,0,0,0,0,0,0,0.162372639567975,2797.89940398224,22.4032862810306
7.5,"random_instances_SVM","SVM",5,23,27740,24424,3316,2400,2154,246,0.560257070834358,0.197452229299363,1.9101677270453,779,246,533,52,2.2,7.96,8.8,0,0,0,0,0,0,0.112762525004111,2842.93254154231,12.0703999705663
7.5,"random_instances_SVM","SVM",5,24,27640,24335,3305,2500,2243,257,0.534361747718211,0.170816444701795,1.9058296561042,806,257,549,27,2.1,8.29,8.7,0,0,0,0,0,0,0.127479158273054,2833.94965073526,16.2950295768981
7.5,"random_instances_SVM","SVM",5,25,27540,24242,3298,2600,2336,264,0.571774492681482,0.199189345686161,2.04747558420333,800,264,536,-6,2,8.63,8.8,0,0,0,0,0,0,0.133256694429179,2792.03369536533,17.9106741316607
7.5,"random_instances_SVM","SVM",5,26,27440,24156,3284,2700,2422,278,0.551510825213597,0.191082802547771,2.08215849409279,889,278,611,89,2.2,8.96,8.7,0,0,0,0,0,0,0.135836609472864,2812.84529829254,18.0234628458901
7.5,"random_instances_SVM","SVM",5,27,27340,24065,3275,2800,2513,287,0.569261028640892,0.215402431962942,2.09133099847205,909,287,622,20,2.2,9.29,8.8,0,0,0,0,0,0,0.148613116316259,2797.24258428672,21.0289782032791
7.5,"random_instances_SVM","SVM",5,28,27240,23976,3264,2900,2602,298,0.569258945767534,0.205558772437753,2.13541886193301,898,298,600,-11,2,9.62,8.7,0,0,0,0,0,0,0.147777382430398,2804.2326823339,29.1493649003642
7.5,"random_instances_SVM","SVM",5,29,27140,23887,3253,3000,2691,309,0.579836297435705,0.206137811233353,1.94269152782353,939,309,630,41,2,9.95,8.7,0,0,0,0,0,0,0.152573507314028,2798.52796214335,30.2032234441621
7.5,"random_instances_SVM","SVM",5,30,27040,23803,3237,3100,2775,325,0.583280111579528,0.214244354371743,2.02100004675469,982,325,657,43,2,10.29,8.5,0,0,0,0,0,0,0.121500938608128,2834.99122461557,19.6851613373945
7.5,"random_instances_SVM","SVM",5,31,26940,23717,3223,3200,2861,339,0.575172396824867,0.192819918934569,1.95984102287638,1042,339,703,60,2.1,10.62,8.4,0,0,0,0,0,0,0.147936070207946,2861.36919725411,29.0088509828631
7.5,"random_instances_SVM","SVM",5,32,26840,23626,3214,3300,2952,348,0.550658105536419,0.190503763752171,1.89374663744632,1052,348,704,10,2,10.95,8.5,0,0,0,0,0,0,0.144321740949344,2830.3690462706,28.5511190462703
7.5,"random_instances_SVM","SVM",5,33,26740,23532,3208,3400,3046,354,0.579950898864005,0.200926462072959,1.97454027556492,1053,354,699,1,2,11.28,8.6,0,0,0,0,0,0,0.136521675005747,2783.16584649855,26.4302749603365
7.5,"random_instances_SVM","SVM",5,34,26640,23442,3198,3500,3136,364,0.543640297663435,0.179502026635785,1.9169353717824,1117,364,753,64,2.1,11.61,8.6,0,0,0,0,0,0,0.124262450509909,2769.84473143874,19.8031729026953
7.5,"random_instances_SVM","SVM",5,35,26540,23350,3190,3600,3228,372,0.539710045802386,0.187608569774175,1.90680179272452,1171,372,799,54,2.1,11.94,8.7,0,0,0,0,0,0,0.131466250106924,2747.68137228929,22.3096627295951
7.5,"random_instances_SVM","SVM",5,36,26440,23262,3178,3700,3316,384,0.572944286435358,0.206716850028952,2.05061883492484,1163,384,779,-8,2,12.28,8.6,0,0,0,0,0,0,0.23525313385155,2750.74708362634,44.2311608851749
7.5,"random_instances_SVM","SVM",5,37,26340,23173,3167,3800,3405,395,0.577990177342778,0.211928199189346,2.07925651213494,1185,395,790,22,2,12.61,8.6,0,0,0,0,0,0,0.20262275104771,2741.37310940399,37.5123033274528
7.5,"random_instances_SVM","SVM",5,38,26240,23090,3150,3900,3488,412,0.569162178942426,0.207295888824551,2.09317520570174,1221,412,809,36,2,12.94,8.5,0,0,0,0,0,0,0.18064837165002,2769.96571347805,30.7683270334188
7.5,"random_instances_SVM","SVM",5,39,26140,23006,3134,4000,3572,428,0.559768333277791,0.185292414591778,2.04110664381857,1275,428,847,54,2,13.27,8.3,0,0,0,0,0,0,0.282711809324367,2810.40981762652,52.9526558992358
7.5,"random_instances_SVM","SVM",5,40,26040,22919,3121,4100,3659,441,0.570733359751112,0.197452229299363,2.11671992268666,1310,441,869,35,2,13.6,8.3,0,0,0,0,0,0,0.273679191729474,2813.80502222874,49.1323371077611
7.5,"random_instances_SVM","SVM",5,41,25940,22830,3110,4200,3748,452,0.565614958814647,0.202084539664157,2.0836422815659,1340,452,888,30,2,13.93,8.3,0,0,0,0,0,0,0.204665989078782,2800.5070455008,36.0526177133888
7.5,"random_instances_SVM","SVM",5,42,25840,22739,3101,4300,3839,461,0.573649816394718,0.207874927620151,2.06684850516564,1371,461,910,31,2,14.27,8.3,0,0,0,0,0,0,0.151395699946322,2774.42222603845,23.4972563518333
7.5,"random_instances_SVM","SVM",5,43,25740,22648,3092,4400,3930,470,0.564285564889144,0.202663578459757,2.1256339808071,1357,470,887,-14,1.9,14.6,8.4,0,0,0,0,0,0,0.230528191992476,2754.88838702376,45.6264367186141
7.5,"random_instances_SVM","SVM",5,44,25640,22558,3082,4500,4020,480,0.546127378641385,0.182397220613781,2.05424824879196,1422,480,942,65,2,14.93,8.4,0,0,0,0,0,0,0.213608472355563,2732.22377862361,41.921058051285
7.5,"random_instances_SVM","SVM",5,45,25540,22471,3069,4600,4107,493,0.562039923648801,0.202663578459757,2.13353411448205,1446,493,953,24,1.9,15.26,8.3,0,0,0,0,0,0,0.353462183356627,2740.67417551612,58.2688075449737
7.5,"random_instances_SVM","SVM",5,46,25440,22387,3053,4700,4191,509,0.564746010082501,0.202084539664157,2.23169415313789,1428,509,919,-18,1.8,15.59,8.2,0,0,0,0,0,0,0.367264648986376,2769.53900081702,60.4251894995818
7.5,"random_instances_SVM","SVM",5,47,25340,22299,3041,4800,4279,521,0.576558722622359,0.214823393167342,2.21630315897832,1514,521,993,86,1.9,15.93,8.2,0,0,0,0,0,0,0.268998225019795,2765.28755534376,45.8292170465988
7.5,"random_instances_SVM","SVM",5,48,25240,22215,3025,4900,4363,537,0.576111468960329,0.218876664736537,2.33379363425293,1550,537,1013,36,1.9,16.26,8.1,0,0,0,0,0,0,0.317206800028605,2768.17658480948,53.1926616103191
7.5,"random_instances_SVM","SVM",6,0,30040,26506,3534,100,91,9,0.576072437885362,0.177548682703322,1.66024364046966,30,9,21,0,2.3,0.33,10.1,0,0,0,0,0,0,0.277591882141658,2827.34368003539,29.2067489085634
7.5,"random_instances_SVM","SVM",6,1,29940,26422,3518,200,175,25,0.598269472544044,0.224513172966781,2.26554584457012,74,25,49,44,2,0.66,7,0,0,0,0,0,0,0.644385454820938,3915.36322970936,74.6553617936249
7.5,"random_instances_SVM","SVM",6,2,29840,26337,3503,300,260,40,0.609369902580864,0.22737686139748,1.96904178098632,109,40,69,35,1.7,1,6.5,0,0,0,0,0,0,0.859962449012055,4190.11721611771,89.8491116291753
7.5,"random_instances_SVM","SVM",6,3,29740,26249,3491,400,348,52,0.606393213971789,0.222794959908362,2.26912718778293,142,52,90,33,1.7,1.33,6.7,0,0,0,0,0,0,0.611804822933339,4133.04320665493,65.5191255365018
7.5,"random_instances_SVM","SVM",6,4,29640,26156,3484,500,441,59,0.590138553090527,0.210194730813288,2.12355827225821,165,59,106,23,1.8,1.66,7.5,0,0,0,0,0,0,0.33375646761725,3623.83786457129,35.528585511594
7.5,"random_instances_SVM","SVM",6,5,29540,26064,3476,600,533,67,0.594730469429989,0.215349369988545,2.20158452389228,202,67,135,37,2,1.99,8,0,0,0,0,0,0,0.195195543490303,3306.69612151469,21.7368933136842
7.5,"random_instances_SVM","SVM",6,6,29440,25970,3470,700,627,73,0.591465026466275,0.222794959908362,2.14073012133516,219,73,146,17,2,2.32,8.6,0,0,0,0,0,0,0.280573862535768,3111.13545571182,32.9074706826109
7.5,"random_instances_SVM","SVM",6,7,29340,25883,3457,800,714,86,0.589665276192805,0.215349369988545,2.06427547414462,255,86,169,36,2,2.65,8.3,0,0,0,0,0,0,0.80881702793909,3385.22025946193,84.5262516526387
7.5,"random_instances_SVM","SVM",6,8,29240,25796,3444,900,801,99,0.589302678435188,0.218785796105384,2.04756197587431,284,99,185,29,1.9,2.99,8.1,0,0,0,0,0,0,0.603128310199059,3306.37842245515,65.7081422451376
7.5,"random_instances_SVM","SVM",6,9,29140,25711,3429,1000,886,114,0.589117640105824,0.221649484536082,2.04355437365164,326,114,212,42,1.9,3.32,7.8,0,0,0,0,0,0,0.82198943993441,3577.30886755752,86.4609938426409
7.5,"random_instances_SVM","SVM",6,10,29040,25622,3418,1100,975,125,0.592316159799187,0.214203894616266,1.98545114028716,368,125,243,42,1.9,3.65,7.8,0,0,0,0,0,0,0.711870935341879,3525.91009810947,80.8482771862988
7.5,"random_instances_SVM","SVM",6,11,28940,25535,3405,1200,1062,138,0.597458935889918,0.222794959908362,2.02604815054935,395,138,257,27,1.9,3.98,7.7,0,0,0,0,0,0,0.321961715807749,3323.68293421474,38.2412089629895
7.5,"random_instances_SVM","SVM",6,12,28840,25443,3397,1300,1154,146,0.599051898845717,0.217067583046964,1.97905618485993,424,146,278,29,1.9,4.31,7.9,0,0,0,0,0,0,0.787692005221983,3425.85393702299,87.8353708990759
7.5,"random_instances_SVM","SVM",6,13,28740,25353,3387,1400,1244,156,0.595161537816807,0.206758304696449,1.89514420262187,463,156,307,39,2,4.64,8,0,0,0,0,0,0,0.252739227979313,3214.87339800526,32.0958482104926
7.5,"random_instances_SVM","SVM",6,14,28640,25257,3383,1500,1340,160,0.602970757066812,0.228522336769759,2.20580137030159,479,160,319,16,2,4.98,8.4,0,0,0,0,0,0,0.31277444068534,3094.65602168215,45.7854671846643
7.5,"random_instances_SVM","SVM",6,15,28540,25166,3374,1600,1431,169,0.597055075229579,0.222794959908362,2.02557922871325,531,169,362,52,2.1,5.31,8.5,0,0,0,0,0,0,0.158533799241325,3024.06353669601,19.189392786327
7.5,"random_instances_SVM","SVM",6,16,28440,25075,3365,1700,1522,178,0.600965895781084,0.223940435280641,2.06610550559333,550,178,372,19,2.1,5.64,8.6,0,0,0,0,0,0,0.184022773285257,2989.16295460542,23.2143612598129
7.5,"random_instances_SVM","SVM",6,17,28340,24985,3355,1800,1612,188,0.584919569576353,0.219358533791523,2.17516524015852,589,188,401,39,2.1,5.97,8.6,0,0,0,0,0,0,0.188904743684558,2972.03915646659,26.5140267940322
7.5,"random_instances_SVM","SVM",6,18,28240,24903,3337,1900,1694,206,0.583710953366467,0.206758304696449,2.06793878465774,630,206,424,41,2.1,6.3,8.2,0,0,0,0,0,0,0.329363862901815,3066.64697056407,48.682534068272
7.5,"random_instances_SVM","SVM",6,19,28140,24815,3325,2000,1782,218,0.590125787379992,0.214776632302405,2.04314877775341,671,218,453,41,2.1,6.64,8.2,0,0,0,0,0,0,0.200686278102496,3086.3539900782,27.5676426358168
7.5,"random_instances_SVM","SVM",6,20,28040,24730,3310,2100,1867,233,0.578033736721189,0.222794959908362,2.15028017433973,720,233,487,49,2.1,6.97,8,0,0,0,0,0,0,0.267686798200887,3107.12192910979,39.4879319266811
7.5,"random_instances_SVM","SVM",6,21,27940,24640,3300,2200,1957,243,0.577824155561141,0.218213058419244,2.10250279773989,774,243,531,54,2.2,7.3,8.1,0,0,0,0,0,0,0.119172072688413,3078.1664818367,12.3875479917649
7.5,"random_instances_SVM","SVM",6,22,27840,24548,3292,2300,2049,251,0.583841275367545,0.217067583046964,2.11980640251924,791,251,540,17,2.2,7.63,8.2,0,0,0,0,0,0,0.226371794995047,3041.93341644322,31.1522186604122
7.5,"random_instances_SVM","SVM",6,23,27740,24462,3278,2400,2135,265,0.569447313505649,0.223940435280641,2.12931262362475,822,265,557,31,2.1,7.96,8.1,0,0,0,0,0,0,0.131866395946871,3055.89073865708,14.303563937819
7.5,"random_instances_SVM","SVM",6,24,27640,24372,3268,2500,2225,275,0.571302295893696,0.218785796105384,2.13701853449798,837,275,562,15,2,8.29,8.1,0,0,0,0,0,0,0.328879172054549,3073.51031122481,48.4493618376064
7.5,"random_instances_SVM","SVM",6,25,27540,24282,3258,2600,2315,285,0.555752542933842,0.194158075601375,2.04794992118566,888,285,603,51,2.1,8.63,8.1,0,0,0,0,0,0,0.311462444350211,3057.17703439535,48.8596032699849
7.5,"random_instances_SVM","SVM",6,26,27440,24196,3244,2700,2401,299,0.580731965210216,0.230813287514318,2.05229936157771,964,299,665,76,2.2,8.96,8,0,0,0,0,0,0,0.64343649910047,3100.65876335848,82.54439209418
7.5,"random_instances_SVM","SVM",6,27,27340,24106,3234,2800,2491,309,0.555371677745328,0.220504009163803,2.13903633624416,959,309,650,-5,2.1,9.29,8.1,0,0,0,0,0,0,0.198392993003543,2974.04904173054,25.3308822541392
7.5,"random_instances_SVM","SVM",6,28,27240,24017,3223,2900,2580,320,0.575162827282523,0.219931271477663,2.13716491337781,1009,320,689,50,2.2,9.62,8.1,0,0,0,0,0,0,0.38575769966646,3026.68571540314,55.0306161228318
7.5,"random_instances_SVM","SVM",6,29,27140,23922,3218,3000,2675,325,0.573317859744817,0.219931271477663,2.04036492147756,1015,325,690,6,2.1,9.95,8.2,0,0,0,0,0,0,0.26311252665854,2940.56301650339,39.0112566163396
7.5,"random_instances_SVM","SVM",6,30,27040,23836,3204,3100,2761,339,0.580772733817743,0.218213058419244,2.00420108381918,1068,339,729,53,2.2,10.29,8.1,0,0,0,0,0,0,0.226807086149258,2943.15841099966,31.2671387093936
7.5,"random_instances_SVM","SVM",6,31,26940,23746,3194,3200,2851,349,0.544072218676195,0.180412371134021,1.92998180952842,1103,349,754,35,2.2,10.62,8.2,0,0,0,0,0,0,0.449882340631945,2962.84874431477,65.6375206041381
7.5,"random_instances_SVM","SVM",6,32,26840,23657,3183,3300,2940,360,0.554789913799214,0.199312714776632,2.00068185452362,1120,360,760,17,2.1,10.95,8.2,0,0,0,0,0,0,0.147013807034131,2907.88414031647,17.7191850851251
7.5,"random_instances_SVM","SVM",6,33,26740,23574,3166,3400,3023,377,0.571652213905159,0.228522336769759,2.12951364061037,1178,377,801,58,2.1,11.28,8,0,0,0,0,0,0,0.406837323711825,2962.94116085114,63.2379448722984
7.5,"random_instances_SVM","SVM",6,34,26640,23483,3157,3500,3114,386,0.567581800480978,0.213631156930126,2.01533776385041,1203,386,817,25,2.1,11.61,8.1,0,0,0,0,0,0,0.372504031046972,2941.2524163641,60.2768440980898
7.5,"random_instances_SVM","SVM",6,35,26540,23394,3146,3600,3203,397,0.561627219761491,0.199885452462772,1.9408176068484,1210,397,813,7,2,11.94,8.1,0,0,0,0,0,0,0.58887963815034,2992.85421710021,76.8049184473189
7.5,"random_instances_SVM","SVM",6,36,26440,23305,3135,3700,3292,408,0.555447261927016,0.211340206185567,1.95007552915546,1251,408,843,41,2.1,12.28,8.1,0,0,0,0,0,0,0.5,2935.69073434139,65.3848796307916
7.5,"random_instances_SVM","SVM",6,37,26340,23220,3120,3800,3377,423,0.574020360663562,0.223367697594502,2.09757067102428,1274,423,851,23,2,12.61,8,0,0,0,0,0,0,0.5,2961.90778107295,67.1614958256196
7.5,"random_instances_SVM","SVM",6,38,26240,23135,3105,3900,3462,438,0.557899417376414,0.209621993127148,2.02658000896459,1292,438,854,18,1.9,12.94,7.9,0,0,0,0,0,0,0.578645121232237,2979.62293291224,73.2573144267558
7.5,"random_instances_SVM","SVM",6,39,26140,23050,3090,4000,3547,453,0.545967991162863,0.210194730813288,2.08978718273347,1360,453,907,68,2,13.27,7.8,0,0,0,0,0,0,0.319671060197026,2950.68897482764,40.7887332687121
7.5,"random_instances_SVM","SVM",6,40,26040,22961,3079,4100,3636,464,0.565769456425734,0.213631156930126,2.10124417482642,1420,464,956,60,2.1,13.6,7.8,0,0,0,0,0,0,0.415830043741131,2974.7036098466,53.4517609385855
7.5,"random_instances_SVM","SVM",6,41,25940,22875,3065,4200,3722,478,0.566793206234996,0.201603665521191,2.02341687559775,1449,478,971,29,2,13.93,7.8,0,0,0,0,0,0,0.625002097137996,3007.73760306954,74.2303632307597
7.5,"random_instances_SVM","SVM",6,42,25840,22787,3053,4300,3810,490,0.576319542497563,0.210194730813288,1.96624272995897,1471,490,981,22,2,14.27,7.8,0,0,0,0,0,0,0.624586196771641,3006.73182640876,75.1593842813288
7.5,"random_instances_SVM","SVM",6,43,25740,22695,3045,4400,3902,498,0.542815978199431,0.186712485681558,1.92828437609875,1479,498,981,8,2,14.6,7.8,0,0,0,0,0,0,0.153401295793932,2891.63098107498,16.634378768967
7.5,"random_instances_SVM","SVM",6,44,25640,22603,3037,4500,3994,506,0.559366700407686,0.201030927835052,2.03500024596097,1503,506,997,24,2,14.93,7.9,0,0,0,0,0,0,0.463998397610172,2889.51597675952,67.6282507297412
7.5,"random_instances_SVM","SVM",6,45,25540,22516,3024,4600,4081,519,0.567070892675619,0.203321878579611,1.9872699235209,1542,519,1023,39,2,15.26,7.9,0,0,0,0,0,0,0.533984023465938,2909.86238277542,71.8111670588533
7.5,"random_instances_SVM","SVM",6,46,25440,22428,3012,4700,4169,531,0.575007876486377,0.207903780068729,2.1332594869439,1609,531,1078,67,2,15.59,7.9,0,0,0,0,0,0,0.166605438902436,2842.12835384846,20.6207054535728
7.5,"random_instances_SVM","SVM",6,47,25340,22341,2999,4800,4256,544,0.557019464484886,0.184994272623139,1.9983669917558,1638,544,1094,29,2,15.93,7.8,0,0,0,0,0,0,0.589318879169275,2895.53387671285,80.7701674024653
7.5,"random_instances_SVM","SVM",6,48,25240,22254,2986,4900,4343,557,0.572709403858518,0.216494845360825,2.14268201117952,1649,557,1092,11,2,16.26,7.8,0,0,0,0,0,0,0.432857291064728,2875.68157509091,62.1847557403625
7.5,"random_instances_SVM","SVM",7,0,30040,26563,3477,100,94,6,0.577387119786251,0.182724252491694,1.68682653744469,29,6,23,0,3.8,0.33,15.7,0,0,0,0,0,0,0.468807193506834,1968.83672971385,57.1773049001874
7.5,"random_instances_SVM","SVM",7,1,29940,26479,3461,200,178,22,0.621278884014807,0.232004429678848,2.12714698282414,70,22,48,41,2.2,0.66,8.1,0,0,0,0,0,0,0.251613856260106,3220.15305295533,31.0412794571406
7.5,"random_instances_SVM","SVM",7,2,29840,26389,3451,300,268,32,0.374590269316291,0.0603543743078627,0.479423266947796,92,32,60,22,1.9,1,8.4,0,0,0,0,0,0,0.11018561680228,3187.62637279047,11.2025079911404
7.5,"random_instances_SVM","SVM",7,3,29740,26296,3444,400,361,39,0.576373202530076,0.21483942414175,2.00279069767442,121,39,82,29,2.1,1.33,9.3,0,0,0,0,0,0,0.143465056886738,2889.8539489435,16.6367026662923
7.5,"random_instances_SVM","SVM",7,4,29640,26207,3433,500,450,50,0.578130881732333,0.22093023255814,2.14542443234922,151,50,101,30,2,1.66,9,0,0,0,0,0,0,0.134230622987692,2952.95654238059,15.2023646215972
7.5,"random_instances_SVM","SVM",7,5,29540,26112,3428,600,545,55,0.569195219353005,0.21483942414175,1.97003063763288,170,55,115,19,2.1,1.99,9.9,0,0,0,0,0,0,0.200166148857159,2706.66606559219,30.3527656336283
7.5,"random_instances_SVM","SVM",7,6,29440,26021,3419,700,636,64,0.437243468289938,0.1140642303433,0.952859088991695,218,64,154,48,2.4,2.32,9.9,0,0,0,0,0,0,0.0953831655983389,2691.12296082304,9.61329388632669
7.5,"random_instances_SVM","SVM",7,7,29340,25932,3408,800,725,75,0.563968932974187,0.207087486157254,1.91269465596488,265,75,190,47,2.5,2.65,9.7,0,0,0,0,0,0,0.180225351072641,2772.50033780742,27.3152150133939
7.5,"random_instances_SVM","SVM",7,8,29240,25844,3396,900,813,87,0.578378579756135,0.219269102990033,1.96524570509939,294,87,207,29,2.4,2.99,9.3,0,0,0,0,0,0,0.446098490953044,2805.12796692441,69.4969471800256
7.5,"random_instances_SVM","SVM",7,9,29140,25753,3387,1000,904,96,0.575116471083743,0.22203765227021,1.94445698803342,310,96,214,16,2.2,3.32,9.4,0,0,0,0,0,0,0.181595996636637,2799.00555386608,31.8018544276955
7.5,"random_instances_SVM","SVM",7,10,29040,25664,3376,1100,993,107,0.563601080120326,0.219269102990033,2.08074538388768,343,107,236,33,2.2,3.65,9.3,0,0,0,0,0,0,0.170697935733874,2823.13407496534,26.2311998977406
7.5,"random_instances_SVM","SVM",7,11,28940,25575,3365,1200,1082,118,0.553698523036874,0.218715393133998,2.10642381351714,366,118,248,23,2.1,3.98,9.2,0,0,0,0,0,0,0.241129318056267,2831.43479008886,43.0004211079031
7.5,"random_instances_SVM","SVM",7,12,28840,25485,3355,1300,1172,128,0.545677264585645,0.217054263565891,2.07337362975105,420,128,292,54,2.3,4.31,9.2,0,0,0,0,0,0,0.251680094699658,2842.20732815256,44.7871260053566
7.5,"random_instances_SVM","SVM",7,13,28740,25396,3344,1400,1261,139,0.55661346209958,0.226467331118494,2.10649507036953,427,139,288,7,2.1,4.64,9.1,0,0,0,0,0,0,0.376158061652112,2858.31303689912,61.2057327869301
7.5,"random_instances_SVM","SVM",7,14,28640,25308,3332,1500,1349,151,0.557153188329386,0.229789590254707,2.20295305469724,487,151,336,60,2.2,4.98,8.9,0,0,0,0,0,0,0.480230909867003,2894.61624484365,70.7249854626679
7.5,"random_instances_SVM","SVM",7,15,28540,25219,3321,1600,1438,162,0.556800174816201,0.225913621262458,2.15212158302734,497,162,335,10,2.1,5.31,8.9,0,0,0,0,0,0,0.575945003725778,2924.60467548576,77.5778680083783
7.5,"random_instances_SVM","SVM",7,16,28440,25124,3316,1700,1533,167,0.563736136904297,0.232004429678848,2.21068271453828,517,167,350,20,2.1,5.64,9.2,0,0,0,0,0,0,0.318160547943851,2795.79126598707,50.6807796234079
7.5,"random_instances_SVM","SVM",7,17,28340,25029,3311,1800,1628,172,0.581709729974093,0.238648947951274,2.17949031517301,544,172,372,27,2.2,5.97,9.5,0,0,0,0,0,0,0.363094705239115,2720.20069872493,60.29748684427
7.5,"random_instances_SVM","SVM",7,18,28240,24934,3306,1900,1723,177,0.571172545842294,0.229235880398671,2.14668449816581,562,177,385,18,2.2,6.3,9.7,0,0,0,0,0,0,0.294895971329945,2642.84816862383,52.3671351482087
7.5,"random_instances_SVM","SVM",7,19,28140,24847,3293,2000,1810,190,0.571014092573276,0.218715393133998,2.15754913750348,621,190,431,59,2.3,6.64,9.5,0,0,0,0,0,0,0.230322584531918,2691.58257303034,44.4899882930883
7.5,"random_instances_SVM","SVM",7,20,28040,24758,3282,2100,1899,201,0.57800106359043,0.222591362126246,2.17217658928317,649,201,448,28,2.2,6.97,9.4,0,0,0,0,0,0,0.196736567943904,2701.21763620325,34.8200284267893
7.5,"random_instances_SVM","SVM",7,21,27940,24667,3273,2200,1990,210,0.427287376876258,0.100221483942414,0.836757631142203,706,210,496,57,2.4,7.3,9.5,0,0,0,0,0,0,0.102448318932803,2661.87408855995,10.6939460847732
7.5,"random_instances_SVM","SVM",7,22,27840,24575,3265,2300,2082,218,0.565340246671168,0.217054263565891,2.23800012229175,718,218,500,12,2.3,7.63,9.6,0,0,0,0,0,0,0.115636284730914,2631.66425442407,13.6898054103943
7.5,"random_instances_SVM","SVM",7,23,27740,24482,3258,2400,2175,225,0.564762075904789,0.214285714285714,2.17027450820674,746,225,521,28,2.3,7.96,9.7,0,0,0,0,0,0,0.167154901346076,2600.04356705606,24.2424473445437
7.5,"random_instances_SVM","SVM",7,24,27640,24395,3245,2500,2262,238,0.558421607582719,0.217607973421927,2.18297761229459,756,238,518,10,2.2,8.29,9.5,0,0,0,0,0,0,0.142421933537586,2630.42971691041,18.4593126235847
7.5,"random_instances_SVM","SVM",7,25,27540,24302,3238,2600,2355,245,0.567316070442407,0.218715393133998,2.25343030008373,802,245,557,46,2.3,8.63,9.6,0,0,0,0,0,0,0.153655848086187,2596.12653789598,20.241711573247
7.5,"random_instances_SVM","SVM",7,26,27440,24209,3231,2700,2448,252,0.566684845380747,0.219269102990033,2.18610385842762,806,252,554,4,2.2,8.96,9.7,0,0,0,0,0,0,0.109485709182333,2560.34925180252,11.8044459914996
7.5,"random_instances_SVM","SVM",7,27,27340,24120,3220,2800,2537,263,0.556043723251098,0.208194905869324,2.19527726008157,849,263,586,43,2.2,9.29,9.6,0,0,0,0,0,0,0.174570429812532,2562.69752836064,23.7974543260616
7.5,"random_instances_SVM","SVM",7,28,27240,24031,3209,2900,2626,274,0.553290743799512,0.194905869324474,2.07894576353879,891,274,617,42,2.3,9.62,9.6,0,0,0,0,0,0,0.122614530266418,2568.0591196095,13.8589935004704
7.5,"random_instances_SVM","SVM",7,29,27140,23947,3193,3000,2710,290,0.564718163144253,0.209302325581395,2.21809792274909,923,290,633,32,2.2,9.95,9.3,0,0,0,0,0,0,0.161802384045914,2614.50137893882,19.4108074592365
7.5,"random_instances_SVM","SVM",7,30,27040,23858,3182,3100,2799,301,0.544679042384584,0.204318936877076,2.1864527267188,961,301,660,38,2.2,10.29,9.3,0,0,0,0,0,0,0.115344225487278,2613.4861359043,12.8154308178383
7.5,"random_instances_SVM","SVM",7,31,26940,23770,3170,3200,2887,313,0.556581320630364,0.225359911406423,2.18264025465826,1008,313,695,47,2.2,10.62,9.2,0,0,0,0,0,0,0.165673335311987,2638.05658907765,23.3230148321414
7.5,"random_instances_SVM","SVM",7,32,26840,23678,3162,3300,2979,321,0.562818769282273,0.219822812846069,2.23213124085217,988,321,667,-20,2.1,10.95,9.3,0,0,0,0,0,0,0.168568219719865,2604.04924341363,22.7164275711713
7.5,"random_instances_SVM","SVM",7,33,26740,23588,3152,3400,3069,331,0.568077865005001,0.225913621262458,2.20831725398599,1046,331,715,58,2.2,11.28,9.3,0,0,0,0,0,0,0.220730095509294,2603.26366322737,34.1774130335222
7.5,"random_instances_SVM","SVM",7,34,26640,23499,3141,3500,3158,342,0.556607576453908,0.214285714285714,2.12829423394411,1096,342,754,50,2.2,11.61,9.2,0,0,0,0,0,0,0.200348715380092,2602.28892669193,30.3784099721404
7.5,"random_instances_SVM","SVM",7,35,26540,23411,3129,3600,3246,354,0.557666575251317,0.212070874861573,2.17408200734394,1139,354,785,43,2.2,11.94,9.2,0,0,0,0,0,0,0.138017174849139,2594.62703094079,17.2716187635713
7.5,"random_instances_SVM","SVM",7,36,26440,23318,3122,3700,3339,361,0.52830421608418,0.191583610188261,2.10266739913325,1172,361,811,33,2.2,12.28,9.2,0,0,0,0,0,0,0.147967398866173,2569.02249296472,19.5754593568165
7.5,"random_instances_SVM","SVM",7,37,26340,23228,3112,3800,3429,371,0.546455797757525,0.196013289036545,2.13766172617098,1216,371,845,44,2.3,12.61,9.2,0,0,0,0,0,0,0.131731379076626,2560.97305035449,16.1388184535466
7.5,"random_instances_SVM","SVM",7,38,26240,23145,3095,3900,3512,388,0.565329393707528,0.216500553709856,2.21456792141796,1282,388,894,66,2.3,12.94,9.1,0,0,0,0,0,0,0.14972879437116,2603.53966858285,19.4967340749899
7.5,"random_instances_SVM","SVM",7,39,26140,23059,3081,4000,3598,402,0.543867574642305,0.213732004429679,2.1374813001496,1285,402,883,3,2.2,13.27,9,0,0,0,0,0,0,0.260689210451832,2623.64625733182,40.7096371719806
7.5,"random_instances_SVM","SVM",7,40,26040,22971,3069,4100,3686,414,0.548500454363502,0.20874861572536,2.13560795983396,1291,414,877,6,2.1,13.6,8.9,0,0,0,0,0,0,0.149100434387148,2625.86901939602,20.0038611558613
7.5,"random_instances_SVM","SVM",7,41,25940,22884,3056,4200,3773,427,0.539746996546669,0.206533776301218,2.0880719521408,1355,427,928,64,2.2,13.93,8.8,0,0,0,0,0,0,0.214150432862092,2644.88162769376,31.7051004089582
7.5,"random_instances_SVM","SVM",7,42,25840,22796,3044,4300,3861,439,0.547935682832992,0.201550387596899,2.12829423394411,1325,439,886,-30,2,14.27,8.8,0,0,0,0,0,0,0.137318470470677,2636.34687648124,16.7724580932582
7.5,"random_instances_SVM","SVM",7,43,25740,22707,3033,4400,3950,450,0.574509790416748,0.226467331118494,2.22532299741602,1379,450,929,54,2.1,14.6,8.8,0,0,0,0,0,0,0.18472983131158,2613.96645914625,26.2561000281244
7.5,"random_instances_SVM","SVM",7,44,25640,22620,3020,4500,4037,463,0.548714424715711,0.196013289036545,2.16458819945161,1404,463,941,25,2,14.93,8.7,0,0,0,0,0,0,0.215609814367405,2621.25491558373,31.1025628606832
7.5,"random_instances_SVM","SVM",7,45,25540,22532,3008,4600,4125,475,0.569666697138451,0.229789590254707,2.26390959021582,1479,475,1004,75,2.1,15.26,8.7,0,0,0,0,0,0,0.210486679124262,2626.6751226659,30.3174158141654
7.5,"random_instances_SVM","SVM",7,46,25440,22440,3000,4700,4217,483,0.577715630646935,0.22203765227021,2.26589896595414,1466,483,983,-13,2,15.59,8.7,0,0,0,0,0,0,0.113088414360297,2608.09340505195,11.8714140899349
7.5,"random_instances_SVM","SVM",7,47,25340,22348,2992,4800,4309,491,0.547179189525717,0.203211517165006,2.10820073439412,1512,491,1021,46,2.1,15.93,8.8,0,0,0,0,0,0,0.168824673452763,2581.38458816578,24.3209484472124
7.5,"random_instances_SVM","SVM",7,48,25240,22259,2981,4900,4398,502,0.555759292119622,0.203765227021041,2.19064390768456,1527,502,1025,15,2,16.26,8.8,0,0,0,0,0,0,0.247234240210748,2580.88772979489,40.2286106969114
7.5,"random_instances_SVM","SVM",8,0,30040,26552,3488,100,86,14,0.399367348613486,0.0861779518746503,0.684625856181052,46,14,32,0,2.3,0.33,6.1,0,0,0,0,0,0,0.208015973736309,4064.62572318119,21.5367078777033
7.5,"random_instances_SVM","SVM",8,1,29940,26468,3472,200,170,30,0.422310829307386,0.0878567431449356,0.798188304420817,88,30,58,42,1.9,0.66,5.7,0,0,0,0,0,0,0.15465336062266,4501.43649880115,15.6423037234504
7.5,"random_instances_SVM","SVM",8,2,29840,26380,3460,300,258,42,0.592904490880382,0.212087297146055,2.03981014056862,124,42,82,36,2,1,6.1,0,0,0,0,0,0,0.203044651975835,4221.28238736834,22.4259339216956
7.5,"random_instances_SVM","SVM",8,3,29740,26292,3448,400,346,54,0.573388942556967,0.176273083379966,1.5883072410676,154,54,100,30,1.9,1.33,6.4,0,0,0,0,0,0,0.155556590387834,4029.06470086473,16.2741810603555
7.5,"random_instances_SVM","SVM",8,4,29640,26204,3436,500,434,66,0.420663632272089,0.0867375489647454,0.638225018527201,192,66,126,38,1.9,1.66,6.6,0,0,0,0,0,0,0.134250625402547,3909.93492183902,13.4599924045766
7.5,"random_instances_SVM","SVM",8,5,29540,26113,3427,600,525,75,0.447312737599178,0.110800223838836,1.02592265947766,234,75,159,42,2.1,1.99,7,0,0,0,0,0,0,0.156562176766973,3653.66036687112,16.4543281320415
7.5,"random_instances_SVM","SVM",8,6,29440,26023,3417,700,615,85,0.443001304041517,0.089535534415221,0.793492126529114,261,85,176,27,2.1,2.32,7.2,0,0,0,0,0,0,0.125690850542469,3570.09751086684,12.6691132773938
7.5,"random_instances_SVM","SVM",8,7,29340,25936,3404,800,702,98,0.556063717231087,0.158365976496922,1.38925563567374,300,98,202,39,2.1,2.65,7.2,0,0,0,0,0,0,0.158464249939068,3605.7623456447,17.2710504798323
7.5,"random_instances_SVM","SVM",8,8,29240,25845,3395,900,793,107,0.544951772032166,0.165640738668159,1.39680593804153,345,107,238,45,2.2,2.99,7.4,0,0,0,0,0,0,0.136137529279132,3481.29149912153,14.2491743264554
7.5,"random_instances_SVM","SVM",8,9,29140,25756,3384,1000,882,118,0.55276060315164,0.168438724118635,1.38418372852264,380,118,262,35,2.2,3.32,7.5,0,0,0,0,0,0,0.173193893685674,3458.92279666306,21.1326000713668
7.5,"random_instances_SVM","SVM",8,10,29040,25668,3372,1100,970,130,0.565297953856245,0.186345831001679,1.5286059037493,406,130,276,26,2.1,3.65,7.5,0,0,0,0,0,0,0.147969891303094,3444.48297003757,16.2025812050853
7.5,"random_instances_SVM","SVM",8,11,28940,25581,3359,1200,1057,143,0.582110425811099,0.202014549524342,1.72845897243737,445,143,302,39,2.1,3.98,7.4,0,0,0,0,0,0,0.307929991621972,3483.04156274381,38.9101967019093
7.5,"random_instances_SVM","SVM",8,12,28840,25489,3351,1300,1149,151,0.589431694696231,0.21152770005596,1.85020991053842,455,151,304,10,2,4.31,7.6,0,0,0,0,0,0,0.280019471276829,3379.85591554889,35.2701507839957
7.5,"random_instances_SVM","SVM",8,13,28740,25395,3345,1400,1243,157,0.57801901450589,0.198097369893677,1.84766303950202,501,157,344,46,2.2,4.64,7.9,0,0,0,0,0,0,0.196761989708333,3249.57106922912,23.3693418053146
7.5,"random_instances_SVM","SVM",8,14,28640,25305,3335,1500,1333,167,0.580908496860881,0.203133743704533,1.9014945843767,527,167,360,26,2.2,4.98,8,0,0,0,0,0,0,0.1670506536452,3204.27115360948,19.057437365897
7.5,"random_instances_SVM","SVM",8,15,28540,25214,3326,1600,1424,176,0.566180781033089,0.194180190263011,1.83438301081047,541,176,365,14,2.1,5.31,8.1,0,0,0,0,0,0,0.121965647509577,3143.43173094162,12.626615990566
7.5,"random_instances_SVM","SVM",8,16,28440,25122,3318,1700,1516,184,0.573210877448566,0.199216564073867,1.86671571776963,565,184,381,24,2.1,5.64,8.2,0,0,0,0,0,0,0.136847761103872,3092.46262100552,14.7551457256095
7.5,"random_instances_SVM","SVM",8,17,28340,25036,3304,1800,1602,198,0.43027607295286,0.0828203693340795,0.688927813984703,602,198,404,37,2,5.97,8.1,0,0,0,0,0,0,0.113209033038557,3115.15331561126,11.423769389075
7.5,"random_instances_SVM","SVM",8,18,28240,24952,3288,1900,1686,214,0.453776244067236,0.0884163402350308,0.67257904058182,681,214,467,79,2.2,6.3,7.9,0,0,0,0,0,0,0.130284212143583,3165.86971639216,14.1405782741593
7.5,"random_instances_SVM","SVM",8,19,28140,24862,3278,2000,1776,224,0.562634854726333,0.200335758254057,1.85915960952559,725,224,501,44,2.2,6.64,7.9,0,0,0,0,0,0,0.112712901481865,3152.0779149564,11.2902256474239
7.5,"random_instances_SVM","SVM",8,20,28040,24775,3265,2100,1863,237,0.434861281088101,0.089535534415221,0.660423792798978,739,237,502,14,2.1,6.97,7.9,0,0,0,0,0,0,0.114290216322858,3163.76608526075,11.5407223210047
7.5,"random_instances_SVM","SVM",8,21,27940,24683,3257,2200,1955,245,0.452382432796539,0.0917739227756016,0.720503899063178,822,245,577,83,2.4,7.3,8,0,0,0,0,0,0,0.122689391598156,3102.72985348428,13.4286817201001
7.5,"random_instances_SVM","SVM",8,22,27840,24599,3241,2300,2039,261,0.443313497208841,0.0828203693340795,0.690166892786834,837,261,576,15,2.2,7.63,7.8,0,0,0,0,0,0,0.123649192198636,3154.99455207783,13.0780979547629
7.5,"random_instances_SVM","SVM",8,23,27740,24508,3232,2400,2130,270,0.568490782992768,0.205372132064913,1.96166833888411,836,270,566,-1,2.1,7.96,7.9,0,0,0,0,0,0,0.11951259409758,3124.41440972488,12.1432435621087
7.5,"random_instances_SVM","SVM",8,24,27640,24415,3225,2500,2223,277,0.576520310375025,0.207610520425294,1.97305271778638,860,277,583,24,2.1,8.29,8,0,0,0,0,0,0,0.203107387956848,3076.33532837636,24.7458059089854
7.5,"random_instances_SVM","SVM",8,25,27540,24325,3215,2600,2313,287,0.573799035727087,0.202014549524342,1.9014945843767,850,287,563,-10,2,8.63,8.1,0,0,0,0,0,0,0.161702485067855,3052.51215340163,19.7414172748862
7.5,"random_instances_SVM","SVM",8,26,27440,24235,3205,2700,2403,297,0.426148307214589,0.0822607722439843,0.642926868439477,959,297,662,109,2.2,8.96,8.1,0,0,0,0,0,0,0.118573390336658,3012.5276346624,12.8231089640494
7.5,"random_instances_SVM","SVM",8,27,27340,24145,3195,2800,2493,307,0.434116162650154,0.0856183547845551,0.665618404972635,989,307,682,30,2.2,9.29,8.1,0,0,0,0,0,0,0.110084964722416,2997.47758761974,11.0784271883868
7.5,"random_instances_SVM","SVM",8,28,27240,24054,3186,2900,2584,316,0.429770523067415,0.0900951315053162,0.669823575401162,1012,316,696,23,2.2,9.62,8.2,0,0,0,0,0,0,0.122248917063929,2959.04747777842,14.9627840117976
7.5,"random_instances_SVM","SVM",8,29,27140,23963,3177,3000,2675,325,0.573617389938746,0.21376608841634,1.89403774286934,1010,325,685,-2,2.1,9.95,8.2,0,0,0,0,0,0,0.125276430872521,2945.6892460915,13.4779303604276
7.5,"random_instances_SVM","SVM",8,30,27040,23874,3166,3100,2764,336,0.430766836736328,0.0844991606043649,0.754914183307006,1068,336,732,58,2.2,10.29,8.2,0,0,0,0,0,0,0.108552384207383,2930.72712996665,10.8839183036295
7.5,"random_instances_SVM","SVM",8,31,26940,23784,3156,3200,2854,346,0.453152531742936,0.093452714045887,0.793041162261906,1099,346,753,31,2.2,10.62,8.2,0,0,0,0,0,0,0.110849238158924,2911.00940852918,11.590923454442
7.5,"random_instances_SVM","SVM",8,32,26840,23694,3146,3300,2944,356,0.556389980364394,0.194739787353106,1.98570954838442,1104,356,748,5,2.1,10.95,8.3,0,0,0,0,0,0,0.128996694365853,2902.70331468755,14.4245065325253
7.5,"random_instances_SVM","SVM",8,33,26740,23602,3138,3400,3036,364,0.549749040672647,0.188584219362059,1.76137195378619,1127,364,763,23,2.1,11.28,8.3,0,0,0,0,0,0,0.12190993162295,2869.24681691457,13.1860527838927
7.5,"random_instances_SVM","SVM",8,34,26640,23513,3127,3500,3125,375,0.56541502102828,0.203133743704533,1.95196659818358,1160,375,785,33,2.1,11.61,8.3,0,0,0,0,0,0,0.119653376829531,2855.70561984901,12.513914583188
7.5,"random_instances_SVM","SVM",8,35,26540,23423,3117,3600,3215,385,0.55242309247068,0.206491326245104,1.91471532722588,1213,385,828,53,2.2,11.94,8.4,0,0,0,0,0,0,0.201339172697399,2851.81579164278,25.9204692478115
7.5,"random_instances_SVM","SVM",8,36,26440,23334,3106,3700,3304,396,0.547921882874866,0.200335758254057,1.90895142588406,1223,396,827,10,2.1,12.28,8.3,0,0,0,0,0,0,0.157305762775123,2832.26302640979,18.6099032901974
7.5,"random_instances_SVM","SVM",8,37,26340,23247,3093,3800,3391,409,0.541197576528401,0.188584219362059,1.90965440565612,1277,409,868,54,2.1,12.61,8.3,0,0,0,0,0,0,0.27656473552228,2855.60824964582,39.5301212081871
7.5,"random_instances_SVM","SVM",8,38,26240,23162,3078,3900,3476,424,0.548322455648852,0.198656966983772,1.92216558141742,1366,424,942,89,2.2,12.94,8.2,0,0,0,0,0,0,0.186609019294326,2862.3985400456,24.1276675061256
7.5,"random_instances_SVM","SVM",8,39,26140,23077,3063,4000,3561,439,0.548747714051783,0.199776161163962,1.92854776926488,1370,439,931,4,2.1,13.27,8.1,0,0,0,0,0,0,0.200420685484793,2879.47134213987,29.0997986432425
7.5,"random_instances_SVM","SVM",8,40,26040,22989,3051,4100,3649,451,0.559375972575869,0.209289311695579,2.01156863171591,1392,451,941,22,2.1,13.6,8.1,0,0,0,0,0,0,0.223429601410737,2869.27204074241,33.9736881267431
7.5,"random_instances_SVM","SVM",8,41,25940,22898,3042,4200,3740,460,0.556249322830229,0.209848908785674,1.98921786914129,1422,460,962,30,2.1,13.93,8.1,0,0,0,0,0,0,0.171512476954984,2854.13440721504,23.3235459695621
7.5,"random_instances_SVM","SVM",8,42,25840,22809,3031,4300,3829,471,0.54164507727276,0.208729714605484,2.02259237066127,1385,471,914,-37,1.9,14.27,8.1,0,0,0,0,0,0,0.241076199764707,2844.63715638982,38.7032714988125
7.5,"random_instances_SVM","SVM",8,43,25740,22724,3016,4400,3914,486,0.534931007458426,0.201454952434247,2.05063141452389,1409,486,923,24,1.9,14.6,8.1,0,0,0,0,0,0,0.317064519631932,2857.55427383089,53.1789336944075
7.5,"random_instances_SVM","SVM",8,44,25640,22632,3008,4500,4006,494,0.544278435696123,0.200895355344152,2.05990957307199,1484,494,990,75,2,14.93,8.1,0,0,0,0,0,0,0.217338271269462,2829.01062979333,33.3256761099572
7.5,"random_instances_SVM","SVM",8,45,25540,22545,2995,4600,4093,507,0.534261546681874,0.196418578623391,2.06173411653795,1536,507,1029,52,2,15.26,8.1,0,0,0,0,0,0,0.230744182245383,2835.5022083376,36.2256885553478
7.5,"random_instances_SVM","SVM",8,46,25440,22462,2978,4700,4176,524,0.544027114088211,0.196978175713486,2.09911733807616,1564,524,1040,28,2,15.59,8,0,0,0,0,0,0,0.185092670063926,2840.30940055142,26.76101471176
7.5,"random_instances_SVM","SVM",8,47,25340,22371,2969,4800,4267,533,0.558361839758424,0.21264689423615,2.20527524069596,1622,533,1089,58,2,15.93,8,0,0,0,0,0,0,0.253950296499463,2828.0334132342,41.3485099055162
7.5,"random_instances_SVM","SVM",8,48,25240,22278,2962,4900,4360,540,0.558417908994115,0.219921656407387,2.21468192768581,1590,540,1050,-32,1.9,16.26,8.1,0,0,0,0,0,0,0.188644326154029,2782.59730885154,27.5926063946714
7.5,"random_instances_SVM","SVM",9,0,30040,26597,3443,100,89,11,0.398841941266614,0,0.631210719964546,40,11,29,0,2.6,0.33,8.1,0,0,0,0,0,0,0.121547544820757,3343.3127429528,12.1960479657434
7.5,"random_instances_SVM","SVM",9,1,29940,26512,3428,200,174,26,0.614181165560361,0.231607629427793,2.12044126752386,73,26,47,33,1.8,0.66,6.7,0,0,0,0,0,0,0.267287542406058,3936.09974760264,27.4399800383915
7.5,"random_instances_SVM","SVM",9,2,29840,26418,3422,300,268,32,0.580467604246692,0.226702997275204,2.19400353409347,98,32,66,25,2.1,1,8.4,0,0,0,0,0,0,0.194163168483575,3185.16946149839,22.4638089375681
7.5,"random_instances_SVM","SVM",9,3,29740,26328,3412,400,358,42,0.577966313489014,0.219618528610354,2.16133658396673,128,42,86,30,2,1.33,8.5,0,0,0,0,0,0,0.579632117134475,3219.40619283965,70.378465733233
7.5,"random_instances_SVM","SVM",9,4,29640,26240,3400,500,446,54,0.566178072682625,0.228337874659401,2.27461259423948,167,54,113,39,2.1,1.66,8.3,0,0,0,0,0,0,0.205735546310204,3151.75936447328,24.8588081646851
7.5,"random_instances_SVM","SVM",9,5,29540,26156,3384,600,530,70,0.437282969492001,0.113351498637602,0.958438305636952,219,70,149,52,2.1,1.99,7.6,0,0,0,0,0,0,0.132412917593698,3437.30249625317,13.6461473727696
7.5,"random_instances_SVM","SVM",9,6,29440,26061,3379,700,625,75,0.564657119588796,0.239782016348774,2.3527801056397,229,75,154,10,2.1,2.32,8.3,0,0,0,0,0,0,0.181948445843547,3148.28847704229,21.6385633274077
7.5,"random_instances_SVM","SVM",9,7,29340,25967,3373,800,719,81,0.562783606430481,0.241961852861035,2.42069697404274,257,81,176,28,2.2,2.65,8.9,0,0,0,0,0,0,0.170449029873449,2980.92091724413,20.4486428162128
7.5,"random_instances_SVM","SVM",9,8,29240,25874,3366,900,812,88,0.5615697177955,0.239237057220708,2.47112816100196,268,88,180,11,2,2.99,9.2,0,0,0,0,0,0,0.172551591824082,2848.93697833574,20.9906396279914
7.5,"random_instances_SVM","SVM",9,9,29140,25783,3357,1000,903,97,0.557159979018495,0.223433242506812,2.12582345635031,302,97,205,34,2.1,3.32,9.3,0,0,0,0,0,0,0.188001853364226,2832.76506508705,22.1431052057102
7.5,"random_instances_SVM","SVM",9,10,29040,25698,3342,1100,988,112,0.563987201942026,0.232152588555858,2.18966942846868,350,112,238,48,2.1,3.65,8.8,0,0,0,0,0,0,0.136492201354167,2948.73545125748,14.3942591309282
7.5,"random_instances_SVM","SVM",9,11,28940,25605,3335,1200,1081,119,0.556945140945803,0.22724795640327,2.08597670661426,372,119,253,22,2.1,3.98,9.1,0,0,0,0,0,0,0.208754343303625,2894.78101505774,22.8445408032049
7.5,"random_instances_SVM","SVM",9,12,28840,25516,3324,1300,1170,130,0.564493006028474,0.223433242506812,2.09680197571755,400,130,270,28,2.1,4.31,9,0,0,0,0,0,0,0.153923816100262,2908.91328766151,16.6286122668111
7.5,"random_instances_SVM","SVM",9,13,28740,25424,3316,1400,1262,138,0.569140886509666,0.233787465940055,2.0587257417164,419,138,281,19,2,4.64,9.1,0,0,0,0,0,0,0.334806578774462,2877.80890087717,37.9674493873449
7.5,"random_instances_SVM","SVM",9,14,28640,25335,3305,1500,1351,149,0.562320210012654,0.227792915531335,2.08586133817741,456,149,307,37,2.1,4.98,9.1,0,0,0,0,0,0,0.419389243408274,2908.6720524495,66.2133507663381
7.5,"random_instances_SVM","SVM",9,15,28540,25245,3295,1600,1441,159,0.576031391556183,0.241961852861035,2.24389161529066,485,159,326,29,2.1,5.31,9.1,0,0,0,0,0,0,0.257900323380635,2898.38642371616,56.3115203015134
7.5,"random_instances_SVM","SVM",9,16,28440,25157,3283,1700,1529,171,0.584340371359422,0.250136239782016,2.44722159984774,539,171,368,54,2.2,5.64,8.9,0,0,0,0,0,0,0.118376766194657,2868.00813023168,15.9204972159754
7.5,"random_instances_SVM","SVM",9,17,28340,25067,3273,1800,1619,181,0.59024866539361,0.255040871934605,2.47764828807584,560,181,379,21,2.1,5.97,8.9,0,0,0,0,0,0,0.367044161008801,2920.4581506894,63.5373573260395
7.5,"random_instances_SVM","SVM",9,18,28240,24980,3260,1900,1706,194,0.580878917459855,0.247956403269755,2.31038113499512,623,194,429,63,2.2,6.3,8.8,0,0,0,0,0,0,0.280306269079825,2943.0414866546,58.8149962266713
7.5,"random_instances_SVM","SVM",9,19,28140,24892,3248,2000,1794,206,0.574636138085953,0.233242506811989,2.13092199703316,666,206,460,43,2.2,6.64,8.7,0,0,0,0,0,0,0.252666149619074,2946.84150384962,56.2121780746823
7.5,"random_instances_SVM","SVM",9,20,28040,24804,3236,2100,1882,218,0.580640816928151,0.238147138964578,2.18966942846868,671,218,453,5,2.1,6.97,8.6,0,0,0,0,0,0,0.191606290082075,2948.50012701213,42.9906096654429
7.5,"random_instances_SVM","SVM",9,21,27940,24720,3220,2200,1966,234,0.584789892646839,0.24141689373297,2.2234702459044,731,234,497,60,2.1,7.3,8.4,0,0,0,0,0,0,0.211881316029678,3018.09032526194,48.7797230628603
7.5,"random_instances_SVM","SVM",9,22,27840,24632,3208,2300,2054,246,0.590850730770593,0.253950953678474,2.43590007652313,761,246,515,30,2.1,7.63,8.3,0,0,0,0,0,0,0.46292921020494,3042.61484493192,73.0286900369847
7.5,"random_instances_SVM","SVM",9,23,27740,24540,3200,2400,2146,254,0.570991096036489,0.229427792915531,2.18432952634935,819,254,565,58,2.2,7.96,8.4,0,0,0,0,0,0,0.171287005563797,2950.6712400711,26.9846778819871
7.5,"random_instances_SVM","SVM",9,24,27640,24451,3189,2500,2235,265,0.572075867730892,0.225613079019074,2.16401197850037,843,265,578,24,2.2,8.29,8.4,0,0,0,0,0,0,0.149825796575162,2942.85814326468,23.1526503805128
7.5,"random_instances_SVM","SVM",9,25,27540,24357,3183,2600,2329,271,0.566793972017529,0.218528610354223,2.00958316424141,863,271,592,20,2.2,8.63,8.6,0,0,0,0,0,0,0.216931552211017,2894.56569616294,33.3274167805096
7.5,"random_instances_SVM","SVM",9,26,27440,24268,3172,2700,2418,282,0.588731335479246,0.231062670299728,2.10051312965687,884,282,602,21,2.1,8.96,8.6,0,0,0,0,0,0,0.200638844384136,2892.11102813651,31.3098671482885
7.5,"random_instances_SVM","SVM",9,27,27340,24185,3155,2800,2501,299,0.582941206502292,0.237602179836512,2.1333618374012,892,299,593,8,2,9.29,8.4,0,0,0,0,0,0,0.144560495010449,2931.16314591233,24.1752985322892
7.5,"random_instances_SVM","SVM",9,28,27240,24098,3142,2900,2588,312,0.582668150523344,0.237057220708447,2.14348371587421,932,312,620,40,2,9.62,8.3,0,0,0,0,0,0,0.134911117455889,2940.17070473389,21.8232862383359
7.5,"random_instances_SVM","SVM",9,29,27140,24009,3131,3000,2677,323,0.567543064369904,0.204359673024523,2.05868735306593,987,323,664,55,2.1,9.95,8.3,0,0,0,0,0,0,0.138152495270546,2932.0094972089,24.6796240154865
7.5,"random_instances_SVM","SVM",9,30,27040,23920,3120,3100,2766,334,0.561760428786824,0.215258855585831,2.13685418726339,1027,334,693,40,2.1,10.29,8.3,0,0,0,0,0,0,0.128282986599906,2918.47301099572,22.099556657791
7.5,"random_instances_SVM","SVM",9,31,26940,23829,3111,3200,2857,343,0.571862676557948,0.210899182561308,2.08064668483197,1057,343,714,30,2.1,10.62,8.3,0,0,0,0,0,0,0.119471969345999,2886.26870867597,14.3348981957913
7.5,"random_instances_SVM","SVM",9,32,26840,23734,3106,3300,2952,348,0.570271689052154,0.216348773841962,2.02594140843163,1085,348,737,28,2.1,10.95,8.5,0,0,0,0,0,0,0.120369076026775,2832.1624579497,14.5280771525459
7.5,"random_instances_SVM","SVM",9,33,26740,23641,3099,3400,3045,355,0.563960398648556,0.206539509536785,1.90816235160455,1084,355,729,-1,2.1,11.28,8.6,0,0,0,0,0,0,0.120018943504855,2792.65159104425,14.6650488385284
7.5,"random_instances_SVM","SVM",9,34,26640,23549,3091,3500,3137,363,0.540204693170222,0.19291553133515,1.90647818359784,1173,363,810,89,2.2,11.61,8.6,0,0,0,0,0,0,0.105436551866231,2763.68576126985,11.1997249097333
7.5,"random_instances_SVM","SVM",9,35,26540,23456,3084,3600,3230,370,0.576917464795464,0.217983651226158,2.02971061371633,1151,370,781,-22,2.1,11.94,8.7,0,0,0,0,0,0,0.110605154371227,2730.1007245414,13.2818267645623
7.5,"random_instances_SVM","SVM",9,36,26440,23366,3074,3700,3320,380,0.551466605401997,0.196185286103542,1.97722272681401,1167,380,787,16,2.1,12.28,8.7,0,0,0,0,0,0,0.124993156250753,2728.57742178464,18.4174819970156
7.5,"random_instances_SVM","SVM",9,37,26340,23276,3064,3800,3410,390,0.438098308386915,0.0942779291553134,0.75001897009623,1254,390,864,87,2.2,12.61,8.7,0,0,0,0,0,0,0.105092449261908,2702.59193027476,10.8666175839309
7.5,"random_instances_SVM","SVM",9,38,26240,23186,3054,3900,3500,400,0.572188350983985,0.212534059945504,1.94997198246319,1229,400,829,-25,2.1,12.94,8.8,0,0,0,0,0,0,0.104449382099279,2692.5900452405,11.4478203904182
7.5,"random_instances_SVM","SVM",9,39,26140,23095,3045,4000,3591,409,0.560731528166519,0.190735694822888,1.87252417776413,1273,409,864,44,2.1,13.27,8.8,0,0,0,0,0,0,0.10624281896766,2674.18357544669,12.2069907841345
7.5,"random_instances_SVM","SVM",9,40,26040,23005,3035,4100,3681,419,0.587700211544269,0.217438692098093,2.00796371428365,1284,419,865,11,2.1,13.6,8.8,0,0,0,0,0,0,0.105348414956079,2662.74861794157,12.0960110690948
7.5,"random_instances_SVM","SVM",9,41,25940,22913,3027,4200,3773,427,0.456789467746705,0.0942779291553134,0.795293624471377,1388,427,961,104,2.3,13.93,8.8,0,0,0,0,0,0,0.102672188371043,2637.14173560943,10.3928997147138
7.5,"random_instances_SVM","SVM",9,42,25840,22825,3015,4300,3861,439,0.566840496935531,0.202724795640327,1.93505670422814,1369,439,930,-19,2.1,14.27,8.8,0,0,0,0,0,0,0.107081944939395,2638.30486446549,12.8131842918791
7.5,"random_instances_SVM","SVM",9,43,25740,22739,3001,4400,3947,453,0.554611319306687,0.195640326975477,1.90151428758604,1378,453,925,9,2,14.6,8.7,0,0,0,0,0,0,0.104891452252753,2650.9022129063,11.7459158705181
7.5,"random_instances_SVM","SVM",9,44,25640,22649,2991,4500,4037,463,0.54021704491837,0.1858310626703,1.80233491408751,1427,463,964,49,2.1,14.93,8.7,0,0,0,0,0,0,0.105172865529946,2638.69299232375,11.8378897136559
7.5,"random_instances_SVM","SVM",9,45,25540,22562,2978,4600,4124,476,0.549536727099657,0.195095367847411,1.91880784162427,1503,476,1027,76,2.2,15.26,8.7,0,0,0,0,0,0,0.109465454228052,2645.62873833841,13.4256524530641
7.5,"random_instances_SVM","SVM",9,46,25440,22473,2967,4700,4213,487,0.539728368589345,0.186376021798365,1.86231021158798,1486,487,999,-17,2.1,15.59,8.7,0,0,0,0,0,0,0.107353199852131,2637.91659601936,12.4638378865798
7.5,"random_instances_SVM","SVM",9,47,25340,22385,2955,4800,4301,499,0.551433502716973,0.210354223433243,2.06604565546473,1535,499,1036,49,2.1,15.93,8.6,0,0,0,0,0,0,0.117965293099455,2638.73131027929,16.8623553303556
7.5,"random_instances_SVM","SVM",9,48,25240,22297,2943,4900,4389,511,0.524086814673547,0.179291553133515,1.87790151948568,1564,511,1053,29,2.1,16.26,8.6,0,0,0,0,0,0,0.116887706708505,2633.63467837831,16.6113227931384
7.5,"random_instances_SVM","SVM",10,0,30040,26493,3547,100,88,12,0.410918533981688,0.0705202312138728,0.609577763328333,48,12,36,0,3,0.33,7.3,0,0,0,0,0,0,0.149391249621253,3561.50447692078,15.193414079784
7.5,"random_instances_SVM","SVM",10,1,29940,26409,3531,200,172,28,0.621081389761585,0.235838150289017,2.32409552942837,80,28,52,32,1.9,0.66,6.1,0,0,0,0,0,0,0.528870571301899,4387.55411481482,61.0615050463409
7.5,"random_instances_SVM","SVM",10,2,29840,26317,3523,300,264,36,0.61732435930265,0.234104046242775,2.25601221812591,104,36,68,24,1.9,1,7.3,0,0,0,0,0,0,0.985134170675347,3902.27537493577,99.3174095910474
7.5,"random_instances_SVM","SVM",10,3,29740,26224,3516,400,357,43,0.614352166579357,0.216763005780347,2.0972275743952,122,43,79,18,1.8,1.33,8.3,0,0,0,0,0,0,0.975153508657001,3301.17100643644,98.9178793506973
7.5,"random_instances_SVM","SVM",10,4,29640,26139,3501,500,442,58,0.611753588507416,0.207514450867052,2.09935587516078,152,58,94,30,1.6,1.66,7.6,0,0,0,0,0,0,0.989785693421638,3595.30281925526,99.6361412170466
7.5,"random_instances_SVM","SVM",10,5,29540,26047,3493,600,534,66,0.602079295734433,0.210982658959538,2.10331799012418,184,66,118,32,1.8,1.99,8.1,0,0,0,0,0,0,0.940256568921864,3427.59377162875,97.5666090559404
7.5,"random_instances_SVM","SVM",10,6,29440,25953,3487,700,628,72,0.60615435142134,0.227745664739884,2.11096641917918,215,72,143,31,2,2.32,8.7,0,0,0,0,0,0,0.872998634886072,3215.39214744716,93.6218503873241
7.5,"random_instances_SVM","SVM",10,7,29340,25863,3477,800,718,82,0.601522838240844,0.223121387283237,2.1165411544411,245,82,163,30,2,2.65,8.8,0,0,0,0,0,0,0.746298097641828,3107.78099212315,85.6939841862383
7.5,"random_instances_SVM","SVM",10,8,29240,25773,3467,900,808,92,0.59284083617238,0.210982658959538,2.02702389141572,286,92,194,41,2.1,2.99,8.8,0,0,0,0,0,0,0.213553815805738,2998.07775759448,26.2635337027534
7.5,"random_instances_SVM","SVM",10,9,29140,25680,3460,1000,901,99,0.595290366998515,0.21849710982659,2.1142317361008,319,99,220,33,2.2,3.32,9.1,0,0,0,0,0,0,0.27027679186039,2905.42364972236,36.5387000785388
7.5,"random_instances_SVM","SVM",10,10,29040,25588,3452,1100,993,107,0.596479582043789,0.213872832369942,2.1142317361008,335,107,228,16,2.1,3.65,9.3,0,0,0,0,0,0,0.16574910158398,2823.68315661146,22.0223349360223
7.5,"random_instances_SVM","SVM",10,11,28940,25498,3442,1200,1083,117,0.584293929834276,0.205780346820809,2.07819801758528,352,117,235,17,2,3.98,9.3,0,0,0,0,0,0,0.12554571748844,2817.22231265913,14.3988140618873
7.5,"random_instances_SVM","SVM",10,12,28840,25409,3431,1300,1172,128,0.584897614507496,0.205780346820809,2.04213055768421,388,128,260,36,2,4.31,9.2,0,0,0,0,0,0,0.4161134047687,2882.66832451326,60.8056378530826
7.5,"random_instances_SVM","SVM",10,13,28740,25315,3425,1400,1266,134,0.588390519381999,0.220809248554913,2.12608133228082,407,134,273,19,2,4.64,9.4,0,0,0,0,0,0,0.283830545092744,2757.07336726146,41.5231138887006
7.5,"random_instances_SVM","SVM",10,14,28640,25224,3416,1500,1357,143,0.581946825661946,0.21849710982659,2.04932749357032,418,143,275,11,1.9,4.98,9.5,0,0,0,0,0,0,0.231135211874294,2715.01936718913,33.2685236427811
7.5,"random_instances_SVM","SVM",10,15,28540,25136,3404,1600,1445,155,0.581480229792721,0.207514450867052,1.99975139933198,469,155,314,51,2,5.31,9.3,0,0,0,0,0,0,0.229479001735004,2775.18393205677,32.4777470857251
7.5,"random_instances_SVM","SVM",10,16,28440,25051,3389,1700,1530,170,0.595550809729494,0.219075144508671,2.12067764696355,486,170,316,17,1.9,5.64,9,0,0,0,0,0,0,0.510822728063173,2894.91423414157,65.372737774537
7.5,"random_instances_SVM","SVM",10,17,28340,24957,3383,1800,1624,176,0.593993309338455,0.211560693641619,2.11840594840977,524,176,348,38,2,5.97,9.2,0,0,0,0,0,0,0.527090382617602,2834.18461682365,68.4235756628757
7.5,"random_instances_SVM","SVM",10,18,28240,24869,3371,1900,1712,188,0.588711057615858,0.21271676300578,2.03346774811794,561,188,373,37,2,6.3,9.1,0,0,0,0,0,0,0.249172828326357,2799.44846233821,34.0933367399153
7.5,"random_instances_SVM","SVM",10,19,28140,24785,3355,2000,1796,204,0.590895899597617,0.212138728323699,2.10887252706993,580,204,376,19,1.8,6.64,8.8,0,0,0,0,0,0,0.476717436035828,2896.04362675818,61.5221852354264
7.5,"random_instances_SVM","SVM",10,20,28040,24690,3350,2100,1891,209,0.581810061815616,0.213872832369942,2.14332048811818,625,209,416,45,2,6.97,9,0,0,0,0,0,0,0.685882223021165,2856.06302094247,81.9590581612087
7.5,"random_instances_SVM","SVM",10,21,27940,24601,3339,2200,1980,220,0.575490436929403,0.219653179190751,2.2144126035029,642,220,422,17,1.9,7.3,9,0,0,0,0,0,0,0.113614243998243,2792.33549947293,12.2033902422189
7.5,"random_instances_SVM","SVM",10,22,27840,24511,3329,2300,2070,230,0.573061443427251,0.211560693641619,2.13578684844114,680,230,450,38,2,7.63,9,0,0,0,0,0,0,0.110224212385689,2781.32500112342,12.292430732336
7.5,"random_instances_SVM","SVM",10,23,27740,24421,3319,2400,2160,240,0.555765680398513,0.209826589595376,2.06909110252137,691,240,451,11,1.9,7.96,9,0,0,0,0,0,0,0.150220006774681,2777.64409285318,23.1040027420836
7.5,"random_instances_SVM","SVM",10,24,27640,24331,3309,2500,2250,250,0.569024126156366,0.212138728323699,2.19129846823351,757,250,507,66,2,8.29,9,0,0,0,0,0,0,0.109578845759721,2761.60947693841,12.2318790940322
7.5,"random_instances_SVM","SVM",10,25,27540,24237,3303,2600,2344,256,0.556231756335479,0.200578034682081,2.14920856445417,761,256,505,4,2,8.63,9.2,0,0,0,0,0,0,0.100862231620913,2710.95520145924,10.466881930929
7.5,"random_instances_SVM","SVM",10,26,27440,24144,3296,2700,2437,263,0.573868724905139,0.190751445086705,1.98305677437192,796,263,533,35,2,8.96,9.3,0,0,0,0,0,0,0.0983790233987533,2672.00353890171,10.0995016312473
7.5,"random_instances_SVM","SVM",10,27,27340,24059,3281,2800,2522,278,0.580841623003194,0.221965317919075,2.13000340618502,887,278,609,91,2.2,9.29,9.1,0,0,0,0,0,0,0.100074070065851,2713.84100938312,10.2374733148066
7.5,"random_instances_SVM","SVM",10,28,27240,23969,3271,2900,2612,288,0.566243831762053,0.190751445086705,2.08738545356046,891,288,603,4,2.1,9.62,9.1,0,0,0,0,0,0,0.100354738154949,2704.61474010059,10.3528766091809
7.5,"random_instances_SVM","SVM",10,29,27140,23879,3261,3000,2702,298,0.567379450457604,0.195375722543353,2.13563833583101,937,298,639,46,2.1,9.95,9.1,0,0,0,0,0,0,0.112826045632895,2692.90333619456,16.0032606676782
7.5,"random_instances_SVM","SVM",10,30,27040,23795,3245,3100,2786,314,0.574114826171482,0.208092485549133,2.18553189331711,971,314,657,34,2.1,10.29,8.9,0,0,0,0,0,0,0.103735118604233,2737.66609164702,10.9564779199462
7.5,"random_instances_SVM","SVM",10,31,26940,23706,3234,3200,2875,325,0.580842012952376,0.213872832369942,2.16255291866808,995,325,670,24,2.1,10.62,8.8,0,0,0,0,0,0,0.105265017479206,2734.7002281436,11.5107951311438
7.5,"random_instances_SVM","SVM",10,32,26840,23612,3228,3300,2969,331,0.567330056893582,0.204046242774566,2.04932749357032,1016,331,685,21,2.1,10.95,9,0,0,0,0,0,0,0.109359210623268,2690.69911199548,15.1339511443911
7.5,"random_instances_SVM","SVM",10,33,26740,23526,3214,3400,3055,345,0.583380148899926,0.208092485549133,2.04345250838507,1060,345,715,44,2.1,11.28,8.9,0,0,0,0,0,0,0.101986430059608,2712.97681277816,10.3699374317479
7.5,"random_instances_SVM","SVM",10,34,26640,23436,3204,3500,3145,355,0.574224358566073,0.220231213872832,2.06467826131242,1071,355,716,11,2,11.61,8.9,0,0,0,0,0,0,0.102857126259849,2701.33877095016,10.7744410604998
7.5,"random_instances_SVM","SVM",10,35,26540,23340,3200,3600,3241,359,0.559859150352716,0.205780346820809,2.06832288313292,1106,359,747,35,2.1,11.94,9,0,0,0,0,0,0,0.100898916236935,2646.20833394481,10.4880022313043
7.5,"random_instances_SVM","SVM",10,36,26440,23248,3192,3700,3333,367,0.547629823833954,0.194797687861272,2.00442989411223,1122,367,755,16,2.1,12.28,9.1,0,0,0,0,0,0,0.0993169251414937,2622.46557088705,9.98707827565689
7.5,"random_instances_SVM","SVM",10,37,26340,23157,3183,3800,3424,376,0.558772058667423,0.194797687861272,1.98657595232111,1108,376,732,-14,1.9,12.61,9.1,0,0,0,0,0,0,0.110769673948607,2611.13959849645,18.5427229211499
7.5,"random_instances_SVM","SVM",10,38,26240,23069,3171,3900,3512,388,0.573954990331422,0.202312138728324,2.0488728068158,1208,388,820,100,2.1,12.94,9.1,0,0,0,0,0,0,0.100525420473457,2610.09520340537,10.5314595034943
7.5,"random_instances_SVM","SVM",10,39,26140,22983,3157,4000,3598,402,0.556241028460655,0.193063583815029,1.98305677437192,1230,402,828,22,2.1,13.27,9,0,0,0,0,0,0,0.109790406717282,2625.25062867884,14.6196136853288
7.5,"random_instances_SVM","SVM",10,40,26040,22897,3143,4100,3684,416,0.56070278376061,0.183236994219653,1.8689695814373,1250,416,834,20,2,13.6,8.9,0,0,0,0,0,0,0.106160856928174,2638.35961095904,13.3067263346801
7.5,"random_instances_SVM","SVM",10,41,25940,22805,3135,4200,3776,424,0.456482060387531,0.11271676300578,0.972272398843931,1291,424,867,41,2,13.93,8.9,0,0,0,0,0,0,0.100982124861391,2618.74496844212,10.1009021391195
7.5,"random_instances_SVM","SVM",10,42,25840,22714,3126,4300,3867,433,0.576931082546611,0.214450867052023,2.13375671615187,1319,433,886,28,2,14.27,8.9,0,0,0,0,0,0,0.106745394427795,2600.8688307069,13.5214588508761
7.5,"random_instances_SVM","SVM",10,43,25740,22627,3113,4400,3954,446,0.578016051175198,0.211560693641619,2.12402009844972,1343,446,897,24,2,14.6,8.9,0,0,0,0,0,0,0.114403428920456,2606.98505167633,16.469640356472
7.5,"random_instances_SVM","SVM",10,44,25640,22540,3100,4500,4041,459,0.582961733419465,0.220231213872832,2.18558589840479,1355,459,896,12,2,14.93,8.8,0,0,0,0,0,0,0.116701643219409,2610.68085927655,15.4050555155876
7.5,"random_instances_SVM","SVM",10,45,25540,22453,3087,4600,4128,472,0.57871250042786,0.217919075144509,2.16249872342164,1376,472,904,21,1.9,15.26,8.7,0,0,0,0,0,0,0.113441820162601,2620.63303473399,13.9758419534566
7.5,"random_instances_SVM","SVM",10,46,25440,22368,3072,4700,4213,487,0.581306225798768,0.21849710982659,2.19910965251361,1447,487,960,71,2,15.59,8.7,0,0,0,0,0,0,0.15896150504732,2635.22745066267,24.8419162554592
7.5,"random_instances_SVM","SVM",10,47,25340,22279,3061,4800,4302,498,0.581514155372231,0.215606936416185,2.1778901734104,1456,498,958,9,1.9,15.93,8.6,0,0,0,0,0,0,0.166424367839088,2631.60081651569,27.1972326701626
7.5,"random_instances_SVM","SVM",10,48,25240,22187,3053,4900,4394,506,0.577081212984607,0.206936416184971,2.1025239651025,1470,506,964,14,1.9,16.26,8.7,0,0,0,0,0,0,0.165546239044007,2596.74636440164,24.8749868906303
7.5,"random_instances_SVM","SVM",11,0,30040,26530,3510,100,92,8,0.556668697435298,0.194805194805195,2.08085619368628,29,8,21,0,2.6,0.33,11.5,0,0,0,0,0,0,0.609083671720449,2377.34085817012,70.7714784826964
7.5,"random_instances_SVM","SVM",11,1,29940,26446,3494,200,176,24,0.582284551016162,0.208921513269339,2.10897061350748,70,24,46,41,1.9,0.66,7.3,0,0,0,0,0,0,0.934711460194622,3539.87223947194,96.6440899195724
7.5,"random_instances_SVM","SVM",11,2,29840,26359,3481,300,263,37,0.576075621011875,0.201581027667984,1.92662525221814,104,37,67,34,1.8,1,7.1,0,0,0,0,0,0,0.792089377926123,3787.63542913879,86.6006452163297
7.5,"random_instances_SVM","SVM",11,3,29740,26265,3475,400,357,43,0.606376415346672,0.208921513269339,1.98094013942541,121,43,78,17,1.8,1.33,8.3,0,0,0,0,0,0,0.825463940141808,3376.88526371103,89.6699608734115
7.5,"random_instances_SVM","SVM",11,4,29640,26173,3467,500,449,51,0.620161308126322,0.226425748164879,2.17763777896681,148,51,97,27,1.9,1.66,8.8,0,0,0,0,0,0,0.977666996495393,3234.19584764518,99.1825312239292
7.5,"random_instances_SVM","SVM",11,5,29540,26082,3458,600,540,60,0.608160654317894,0.23828345567476,2.31546204945726,176,60,116,28,1.9,1.99,9,0,0,0,0,0,0,0.995913841386642,3176.04862562745,99.9154786429748
7.5,"random_instances_SVM","SVM",11,6,29440,25989,3451,700,633,67,0.599695809257761,0.229813664596273,2.32222570651743,200,67,133,24,2,2.32,9.4,0,0,0,0,0,0,0.919422855492046,2990.9405292563,96.2711001280092
7.5,"random_instances_SVM","SVM",11,7,29340,25897,3443,800,725,75,0.60050812378207,0.218520609824958,2.24061394047369,218,75,143,18,1.9,2.65,9.7,0,0,0,0,0,0,0.941813921067989,2885.719710114,97.3795799885161
7.5,"random_instances_SVM","SVM",11,8,29240,25807,3433,900,815,85,0.59237171132235,0.219649915302089,2.14422209081572,245,85,160,27,1.9,2.99,9.6,0,0,0,0,0,0,0.871231514075446,2893.09694490806,93.6353002156404
7.5,"random_instances_SVM","SVM",11,9,29140,25718,3422,1000,904,96,0.583663110345032,0.219649915302089,2.19250220066624,281,96,185,36,1.9,3.32,9.4,0,0,0,0,0,0,0.46715334222688,2863.58869001448,59.9264740806821
7.5,"random_instances_SVM","SVM",11,10,29040,25627,3413,1100,995,105,0.587801420547414,0.232072275550536,2.27029094630778,302,105,197,21,1.9,3.65,9.5,0,0,0,0,0,0,0.916154393873754,2899.32465101689,96.265136251601
7.5,"random_instances_SVM","SVM",11,11,28940,25537,3403,1200,1085,115,0.587016701833637,0.232636928289102,2.26043725296443,345,115,230,43,2,3.98,9.4,0,0,0,0,0,0,0.852428037577681,2883.31692723076,92.858022400262
7.5,"random_instances_SVM","SVM",11,12,28840,25447,3393,1300,1175,125,0.583490700211853,0.226425748164879,2.27129407600454,384,125,259,39,2.1,4.31,9.4,0,0,0,0,0,0,0.194545853217672,2779.77560979182,23.9639171105313
7.5,"random_instances_SVM","SVM",11,13,28740,25356,3384,1400,1266,134,0.585109173271966,0.229249011857708,2.26780481191402,390,134,256,6,1.9,4.64,9.4,0,0,0,0,0,0,0.476637756942285,2785.87960854137,64.5309055399307
7.5,"random_instances_SVM","SVM",11,14,28640,25266,3374,1500,1356,144,0.587141880675702,0.21682665160926,2.25787571904225,440,144,296,50,2.1,4.98,9.4,0,0,0,0,0,0,0.480413762346778,2772.82025880578,65.0735494812763
7.5,"random_instances_SVM","SVM",11,15,28540,25176,3364,1600,1446,154,0.580425697218773,0.228684359119142,2.24648967633157,457,154,303,17,2,5.31,9.4,0,0,0,0,0,0,0.456740169584858,2773.77072832326,61.0551858279702
7.5,"random_instances_SVM","SVM",11,16,28440,25088,3352,1700,1534,166,0.581475908857405,0.229813664596273,2.25833408587286,515,166,349,58,2.1,5.64,9.2,0,0,0,0,0,0,0.455746692596112,2790.44508879216,62.4192526827192
7.5,"random_instances_SVM","SVM",11,17,28340,25001,3339,1800,1621,179,0.57349732320638,0.231507622811971,2.21407534366365,556,179,377,41,2.1,5.97,9.1,0,0,0,0,0,0,0.23351764942415,2827.53981545534,31.8803366561193
7.5,"random_instances_SVM","SVM",11,18,28240,24913,3327,1900,1709,191,0.564176307510733,0.225861095426313,2.16697245782703,632,191,441,76,2.3,6.3,8.9,0,0,0,0,0,0,0.319422064831768,2839.4695855923,48.6177726446668
7.5,"random_instances_SVM","SVM",11,19,28140,24825,3315,2000,1797,203,0.58394004491749,0.239977413890457,2.39714969659856,672,203,469,40,2.3,6.64,8.9,0,0,0,0,0,0,0.192790830840005,2841.74790221416,25.6914323111731
7.5,"random_instances_SVM","SVM",11,20,28040,24735,3305,2100,1887,213,0.576630084528089,0.236024844720497,2.35843139170205,698,213,485,26,2.3,6.97,8.9,0,0,0,0,0,0,0.253275195370598,2845.3053017413,37.1952725548187
7.5,"random_instances_SVM","SVM",11,21,27940,24652,3288,2200,1970,230,0.581606161083123,0.236024844720497,2.35507770590229,751,230,521,53,2.3,7.3,8.6,0,0,0,0,0,0,0.379688200951226,2940.02352105609,56.3063253343996
7.5,"random_instances_SVM","SVM",11,22,27840,24560,3280,2300,2062,238,0.571111941344044,0.231507622811971,2.38186229375046,779,238,541,28,2.3,7.63,8.7,0,0,0,0,0,0,0.180787781737299,2868.48856037019,23.1923250938148
7.5,"random_instances_SVM","SVM",11,23,27740,24472,3268,2400,2150,250,0.555271776278638,0.221908526256352,2.25726297690316,793,250,543,14,2.2,7.96,8.6,0,0,0,0,0,0,0.347120838931877,2900.27821301699,59.6887484720365
7.5,"random_instances_SVM","SVM",11,24,27640,24383,3257,2500,2239,261,0.561702194503768,0.230378317334839,2.25926055475882,826,261,565,33,2.2,8.29,8.6,0,0,0,0,0,0,0.168231665348547,2892.84592718804,23.7243131625465
7.5,"random_instances_SVM","SVM",11,25,27540,24291,3249,2600,2331,269,0.557551911965118,0.221343873517787,2.22127416330315,829,269,560,3,2.1,8.63,8.7,0,0,0,0,0,0,0.172760281288803,2831.43075388165,22.4853178285053
7.5,"random_instances_SVM","SVM",11,26,27440,24203,3237,2700,2419,281,0.567972472117617,0.228119706380576,2.38755688119001,860,281,579,31,2.1,8.96,8.6,0,0,0,0,0,0,0.250860243927574,2851.24388914673,37.2418985287458
7.5,"random_instances_SVM","SVM",11,27,27340,24114,3226,2800,2508,292,0.558221895789729,0.213438735177866,2.27180094374119,917,292,625,57,2.1,9.29,8.6,0,0,0,0,0,0,0.241787459317301,2836.06795245327,40.7399723992465
7.5,"random_instances_SVM","SVM",11,28,27240,24019,3221,2900,2603,297,0.581256373570857,0.233201581027668,2.29227439737238,903,297,606,-14,2,9.62,8.8,0,0,0,0,0,0,0.23684395983322,2782.24753985326,39.3527819338086
7.5,"random_instances_SVM","SVM",11,29,27140,23925,3215,3000,2697,303,0.56343368302178,0.220779220779221,2.1671126604964,934,303,631,31,2.1,9.95,8.9,0,0,0,0,0,0,0.240345000443119,2744.05729938785,40.8431874967089
7.5,"random_instances_SVM","SVM",11,30,27040,23833,3207,3100,2789,311,0.563885150482077,0.214568040654997,2.21016354977025,925,311,614,-9,2,10.29,9,0,0,0,0,0,0,0.143570107273349,2709.67945332529,19.0993241122764
7.5,"random_instances_SVM","SVM",11,31,26940,23739,3201,3200,2883,317,0.571591896171827,0.20609824957651,2.144399828058,982,317,665,57,2.1,10.62,9.1,0,0,0,0,0,0,0.314805959006911,2665.92070666676,55.5385423047733
7.5,"random_instances_SVM","SVM",11,32,26840,23651,3189,3300,2971,329,0.588261294116147,0.237154150197628,2.22289778593553,1015,329,686,33,2.1,10.95,9,0,0,0,0,0,0,0.145939712524092,2668.38774799496,20.1555293241222
7.5,"random_instances_SVM","SVM",11,33,26740,23562,3178,3400,3060,340,0.567545501246056,0.214003387916431,2.10120528961109,1068,340,728,53,2.1,11.28,9,0,0,0,0,0,0,0.351178107838887,2706.52860860874,62.9319974265929
7.5,"random_instances_SVM","SVM",11,34,26640,23477,3163,3500,3145,355,0.573541901054166,0.216261998870695,2.1406610488137,1047,355,692,-21,1.9,11.61,8.9,0,0,0,0,0,0,0.149099272939735,2677.39315612773,20.0254151110888
7.5,"random_instances_SVM","SVM",11,35,26540,23388,3152,3600,3234,366,0.572678322004897,0.214003387916431,2.1444599149163,1094,366,728,47,2,11.94,8.8,0,0,0,0,0,0,0.262151130640744,2686.2863325556,45.7630886484529
7.5,"random_instances_SVM","SVM",11,36,26440,23300,3140,3700,3322,378,0.564739983782162,0.207227555053642,2.09543581538806,1110,378,732,16,1.9,12.28,8.8,0,0,0,0,0,0,0.440586529525831,2699.98820841411,70.0525643595861
7.5,"random_instances_SVM","SVM",11,37,26340,23215,3125,3800,3407,393,0.56151089185414,0.217391304347826,2.14812540772862,1132,393,739,22,1.9,12.61,8.7,0,0,0,0,0,0,0.224344947637607,2707.31075903415,35.2439314708289
7.5,"random_instances_SVM","SVM",11,38,26240,23130,3110,3900,3492,408,0.568459686766324,0.212309429700734,2.26326633588428,1172,408,764,40,1.9,12.94,8.6,0,0,0,0,0,0,0.205939283969914,2719.1864597766,32.7278744284324
7.5,"random_instances_SVM","SVM",11,39,26140,23041,3099,4000,3581,419,0.563962970667781,0.215697346132129,2.18761086048688,1151,419,732,-21,1.7,13.27,8.5,0,0,0,0,0,0,0.180935074998087,2734.61678289472,28.6441193849369
7.5,"random_instances_SVM","SVM",11,40,26040,22951,3089,4100,3671,429,0.560637335858004,0.210050818746471,2.12369154515266,1184,429,755,33,1.8,13.6,8.6,0,0,0,0,0,0,0.238984152689421,2721.9789216004,43.9678773365936
7.5,"random_instances_SVM","SVM",11,41,25940,22867,3073,4200,3755,445,0.560404979133321,0.209486166007905,2.076501678176,1230,445,785,46,1.8,13.93,8.4,0,0,0,0,0,0,0.240281484761544,2748.02179626409,43.42618515299
7.5,"random_instances_SVM","SVM",11,42,25840,22778,3062,4300,3844,456,0.550643322026128,0.200451722190853,2.13504142461283,1282,456,826,52,1.8,14.27,8.4,0,0,0,0,0,0,0.171608618900618,2740.98571202061,27.4167215118905
7.5,"random_instances_SVM","SVM",11,43,25740,22691,3049,4400,3931,469,0.578041164458293,0.228684359119142,2.19536834580775,1289,469,820,7,1.7,14.6,8.4,0,0,0,0,0,0,0.260986196843281,2749.90443579329,47.2578744162733
7.5,"random_instances_SVM","SVM",11,44,25640,22602,3038,4500,4020,480,0.564987412064888,0.207792207792208,2.11804843210088,1309,480,829,20,1.7,14.93,8.4,0,0,0,0,0,0,0.253910640357701,2743.86698843522,45.6632277364726
7.5,"random_instances_SVM","SVM",11,45,25540,22507,3033,4600,4115,485,0.568940066145035,0.217955957086392,2.07503270611813,1358,485,873,49,1.8,15.26,8.5,0,0,0,0,0,0,0.171233932867845,2697.36640679242,27.2704097828462
7.5,"random_instances_SVM","SVM",11,46,25440,22419,3021,4700,4203,497,0.566896872333294,0.216261998870695,2.15956174530304,1379,497,882,21,1.8,15.59,8.5,0,0,0,0,0,0,0.245850268392851,2694.30198065134,43.4536251171885
7.5,"random_instances_SVM","SVM",11,47,25340,22331,3009,4800,4291,509,0.560789877007596,0.201581027667984,2.0971860802048,1420,509,911,41,1.8,15.93,8.4,0,0,0,0,0,0,0.229501700994308,2693.79671477416,39.686405383523
7.5,"random_instances_SVM","SVM",11,48,25240,22245,2995,4900,4377,523,0.576685530879719,0.221908526256352,2.10857630283841,1455,523,932,35,1.8,16.26,8.4,0,0,0,0,0,0,0.220149652220942,2701.10421598326,38.8239845425042
7.5,"random_instances_SVM","SVM",12,0,30040,26538,3502,100,80,20,0.597180222635802,0.204867006225241,1.82873170549582,51,20,31,0,1.6,0.33,4,0,0,0,0,0,0,0.638699131144972,5758.76342620335,66.1205223952922
7.5,"random_instances_SVM","SVM",12,1,29940,26454,3486,200,164,36,0.618145616451261,0.21505376344086,1.98694501289825,89,36,53,38,1.5,0.66,4.6,0,0,0,0,0,0,0.913799567149303,5341.73547735116,93.6049523300328
7.5,"random_instances_SVM","SVM",12,2,29840,26360,3480,300,258,42,0.608700707771025,0.222976796830787,2.15102349956188,115,42,73,26,1.7,1,6.1,0,0,0,0,0,0,0.230645902938292,4159.40302055464,26.6835691606855
7.5,"random_instances_SVM","SVM",12,3,29740,26269,3471,400,349,51,0.592748465129236,0.212224108658744,1.92912105328671,156,51,105,41,2.1,1.33,6.8,0,0,0,0,0,0,0.198243294421985,3769.54821539291,23.595643346221
7.5,"random_instances_SVM","SVM",12,4,29640,26179,3461,500,439,61,0.582025383687913,0.195812110922467,1.7638608752221,185,61,124,29,2,1.66,7.2,0,0,0,0,0,0,0.271421414477372,3599.49355898335,36.974738912729
7.5,"random_instances_SVM","SVM",12,5,29540,26084,3456,600,534,66,0.569700178252939,0.200905489530277,1.88603305705567,196,66,130,11,2,1.99,8.1,0,0,0,0,0,0,0.189414356001658,3246.64502829211,24.2458738435754
7.5,"random_instances_SVM","SVM",12,6,29440,25996,3444,700,622,78,0.576607777347857,0.221279003961517,2.09434532261086,233,78,155,37,2,2.32,8,0,0,0,0,0,0,0.178419742399112,3294.68452856485,21.9989436884107
7.5,"random_instances_SVM","SVM",12,7,29340,25905,3435,800,713,87,0.569961321528757,0.213921901528014,2.03147353578617,260,87,173,27,2,2.65,8.2,0,0,0,0,0,0,0.306511698787057,3219.22113952049,45.0759622595244
7.5,"random_instances_SVM","SVM",12,8,29240,25812,3428,900,806,94,0.558261430665291,0.204301075268817,1.99165428377453,295,94,201,35,2.1,2.99,8.6,0,0,0,0,0,0,0.143164023320188,3036.45503162538,17.2115671196088
7.5,"random_instances_SVM","SVM",12,9,29140,25724,3416,1000,894,106,0.552863689760935,0.202603282399547,1.98811041494219,349,106,243,54,2.3,3.32,8.4,0,0,0,0,0,0,0.118201985347899,3083.46388629685,12.6912078115364
7.5,"random_instances_SVM","SVM",12,10,29040,25633,3407,1100,985,115,0.565497979255549,0.208828522920204,1.99215386486614,372,115,257,23,2.2,3.65,8.6,0,0,0,0,0,0,0.129795882057839,3032.44285181546,14.8867631110404
7.5,"random_instances_SVM","SVM",12,11,28940,25545,3395,1200,1073,127,0.54483188566629,0.207696661007357,1.96593777970435,394,127,267,22,2.1,3.98,8.4,0,0,0,0,0,0,0.125533554950735,3060.45485480814,14.1183812153897
7.5,"random_instances_SVM","SVM",12,12,28840,25452,3388,1300,1166,134,0.546048569161154,0.202603282399547,1.97293399956095,441,134,307,47,2.3,4.31,8.7,0,0,0,0,0,0,0.167583319267231,2972.64026388837,22.7803013245599
7.5,"random_instances_SVM","SVM",12,13,28740,25365,3375,1400,1253,147,0.553986746223695,0.203169213355971,1.94670548772091,457,147,310,16,2.1,4.64,8.5,0,0,0,0,0,0,0.173726737276385,3017.42244253054,24.8179139462489
7.5,"random_instances_SVM","SVM",12,14,28640,25277,3363,1500,1341,159,0.544389231011112,0.198641765704584,1.82279154641264,514,159,355,57,2.2,4.98,8.4,0,0,0,0,0,0,0.114988626183626,3038.8725080974,12.0240090213204
7.5,"random_instances_SVM","SVM",12,15,28540,25184,3356,1600,1434,166,0.539563504055271,0.192416525183928,1.77120400045597,549,166,383,35,2.3,5.31,8.6,0,0,0,0,0,0,0.192587945182891,2976.91904611273,27.2969481084758
7.5,"random_instances_SVM","SVM",12,16,28440,25096,3344,1700,1522,178,0.541571189213886,0.190152801358234,1.62351025882617,540,178,362,-9,2,5.64,8.6,0,0,0,0,0,0,0.153515292723139,2980.56114462815,19.2011992582695
7.5,"random_instances_SVM","SVM",12,17,28340,25004,3336,1800,1614,186,0.542643922742092,0.181663837011885,1.62351025882617,571,186,385,31,2.1,5.97,8.7,0,0,0,0,0,0,0.199738986264177,2927.07892171625,29.7681767024619
7.5,"random_instances_SVM","SVM",12,18,28240,24915,3325,1900,1703,197,0.531973971770155,0.186757215619694,1.66626481025158,596,197,399,25,2,6.3,8.6,0,0,0,0,0,0,0.130214351285285,2930.55625444582,14.9300851551334
7.5,"random_instances_SVM","SVM",12,19,28140,24828,3312,2000,1790,210,0.546393853404483,0.196943972835314,1.8195510281079,644,210,434,48,2.1,6.64,8.5,0,0,0,0,0,0,0.119204057212411,2956.18201297849,12.952771560814
7.5,"random_instances_SVM","SVM",12,20,28040,24738,3302,2100,1880,220,0.539904662073198,0.187889077532541,1.73474144628932,674,220,454,30,2.1,6.97,8.5,0,0,0,0,0,0,0.263044937076574,2957.17176475905,41.8915505371587
7.5,"random_instances_SVM","SVM",12,21,27940,24649,3291,2200,1969,231,0.539532536095539,0.183361629881155,1.70582908885116,719,231,488,45,2.1,7.3,8.5,0,0,0,0,0,0,0.133447536822369,2925.3134624666,15.9559979594954
7.5,"random_instances_SVM","SVM",12,22,27840,24561,3279,2300,2057,243,0.538489749605331,0.191850594227504,1.78800105209644,755,243,512,36,2.1,7.63,8.5,0,0,0,0,0,0,0.141490901167932,2947.49101981908,17.4458652699086
7.5,"random_instances_SVM","SVM",12,23,27740,24474,3266,2400,2144,256,0.540010327474258,0.191850594227504,1.78481672252904,803,256,547,48,2.1,7.96,8.4,0,0,0,0,0,0,0.148449200098152,2948.85623073003,18.5918388867302
7.5,"random_instances_SVM","SVM",12,24,27640,24393,3247,2500,2225,275,0.522526957438794,0.185625353706848,1.73769956115176,853,275,578,50,2.1,8.29,8.1,0,0,0,0,0,0,0.134641733151046,3042.39519543858,15.0946934571818
7.5,"random_instances_SVM","SVM",12,25,27540,24303,3237,2600,2315,285,0.522469828359235,0.179966044142615,1.70127210998513,911,285,626,58,2.2,8.63,8.1,0,0,0,0,0,0,0.126673340822046,3013.17310817308,14.0161796723373
7.5,"random_instances_SVM","SVM",12,26,27440,24212,3228,2700,2406,294,0.529729475304077,0.186191284663271,1.62206069609508,911,294,617,0,2.1,8.96,8.2,0,0,0,0,0,0,0.136162792700318,2992.11848717187,15.8271965809174
7.5,"random_instances_SVM","SVM",12,27,27340,24126,3214,2800,2492,308,0.524635713850602,0.191284663271081,1.83201787171626,944,308,636,33,2.1,9.29,8.1,0,0,0,0,0,0,0.188274679282558,3004.63147363882,26.4036761789623
7.5,"random_instances_SVM","SVM",12,28,27240,24035,3205,2900,2583,317,0.538702314021236,0.190152801358234,1.8195510281079,979,317,662,35,2.1,9.62,8.1,0,0,0,0,0,0,0.126463676293695,2976.07911768144,13.9425918153211
7.5,"random_instances_SVM","SVM",12,29,27140,23948,3192,3000,2670,330,0.541306600327172,0.186191284663271,1.86836133507295,1041,330,711,62,2.2,9.95,8.1,0,0,0,0,0,0,0.135773477190162,2982.49921169819,15.6286557211175
7.5,"random_instances_SVM","SVM",12,30,27040,23861,3179,3100,2757,343,0.548721001993854,0.195812110922467,1.98457913534194,1026,343,683,-15,2,10.29,8,0,0,0,0,0,0,0.131822063685364,2978.29005740576,15.0425532147981
7.5,"random_instances_SVM","SVM",12,31,26940,23774,3166,3200,2844,356,0.534362290587677,0.187889077532541,1.84923949897582,1112,356,756,86,2.1,10.62,8,0,0,0,0,0,0,0.164533084059473,3003.756273305,34.8235676732845
7.5,"random_instances_SVM","SVM",12,32,26840,23683,3157,3300,2935,365,0.527123912845948,0.189020939445388,1.86598664723754,1121,365,756,9,2.1,10.95,8,0,0,0,0,0,0,0.157908390965312,2980.30189348012,30.0477799772235
7.5,"random_instances_SVM","SVM",12,33,26740,23592,3148,3400,3026,374,0.523389125856172,0.173740803621958,1.8396196056238,1153,374,779,32,2.1,11.28,8.1,0,0,0,0,0,0,0.159669372414097,2961.94538676263,33.3570674220443
7.5,"random_instances_SVM","SVM",12,34,26640,23503,3137,3500,3115,385,0.54445193262188,0.196378041878891,1.86836133507295,1161,385,776,8,2,11.61,8.1,0,0,0,0,0,0,0.169849233529468,2941.5641469982,35.0484360256094
7.5,"random_instances_SVM","SVM",12,35,26540,23416,3124,3600,3202,398,0.5502218207731,0.198641765704584,1.93981449484402,1169,398,771,8,1.9,11.94,8,0,0,0,0,0,0,0.276904863766023,2953.33802178568,54.5423336790388
7.5,"random_instances_SVM","SVM",12,36,26440,23327,3113,3700,3291,409,0.544044925151119,0.199207696661007,1.94497815365904,1214,409,805,45,2,12.28,8,0,0,0,0,0,0,0.227239929031012,2926.45464653311,46.6285757744202
7.5,"random_instances_SVM","SVM",12,37,26340,23236,3104,3800,3382,418,0.534328983015605,0.190152801358234,1.90294711689618,1255,418,837,41,2,12.61,8.1,0,0,0,0,0,0,0.231974582827398,2911.77196618696,47.6441014859208
7.5,"random_instances_SVM","SVM",12,38,26240,23148,3092,3900,3470,430,0.544634464922994,0.196943972835314,1.98862167716248,1304,430,874,49,2,12.94,8.1,0,0,0,0,0,0,0.191923216937815,2904.43104160833,38.1710452095467
7.5,"random_instances_SVM","SVM",12,39,26140,23056,3084,4000,3562,438,0.540352166106692,0.199207696661007,1.98510199277812,1316,438,878,12,2,13.27,8.1,0,0,0,0,0,0,0.196047282906711,2879.16201659196,40.3075645902596
7.5,"random_instances_SVM","SVM",12,40,26040,22964,3076,4100,3654,446,0.52856026467056,0.189586870401811,1.92227412851905,1378,446,932,62,2.1,13.6,8.2,0,0,0,0,0,0,0.266640189224161,2854.902543861,55.2256128688766
7.5,"random_instances_SVM","SVM",12,41,25940,22875,3065,4200,3743,457,0.557724936285969,0.200905489530277,1.98106037800977,1367,457,910,-11,2,13.93,8.2,0,0,0,0,0,0,0.278680815045802,2840.6119679223,56.0879612750987
7.5,"random_instances_SVM","SVM",12,42,25840,22789,3051,4300,3829,471,0.538077892756253,0.189020939445388,1.97175107258704,1453,471,982,86,2.1,14.27,8.1,0,0,0,0,0,0,0.145313363064252,2836.21246154704,23.3950279161432
7.5,"random_instances_SVM","SVM",12,43,25740,22701,3039,4400,3917,483,0.54994104602281,0.190718732314658,2.00952408164043,1461,483,978,8,2,14.6,8.1,0,0,0,0,0,0,0.182326461691964,2839.63998990362,35.755053911548
7.5,"random_instances_SVM","SVM",12,44,25640,22608,3032,4500,4010,490,0.54584957449683,0.204301075268817,2.02642817292602,1455,490,965,-6,2,14.93,8.2,0,0,0,0,0,0,0.180200555005612,2798.61866418376,33.1729391563081
7.5,"random_instances_SVM","SVM",12,45,25540,22522,3018,4600,4096,504,0.559706758093609,0.20996038483305,2.09248368232409,1530,504,1026,75,2,15.26,8.1,0,0,0,0,0,0,0.284094952683628,2818.90185931763,53.4879905204696
7.5,"random_instances_SVM","SVM",12,46,25440,22432,3008,4700,4186,514,0.557015438208536,0.204867006225241,2.05064048971422,1501,514,987,-29,1.9,15.59,8.1,0,0,0,0,0,0,0.227116539873236,2799.96654557595,44.6922206294178
7.5,"random_instances_SVM","SVM",12,47,25340,22348,2992,4800,4270,530,0.56221146199057,0.212224108658744,2.09262470155789,1563,530,1033,62,1.9,15.93,8.1,0,0,0,0,0,0,0.184127735379044,2811.86114152012,35.1526156754105
7.5,"random_instances_SVM","SVM",12,48,25240,22261,2979,4900,4357,543,0.543841974415018,0.196943972835314,1.99569862263281,1602,543,1059,39,2,16.26,8,0,0,0,0,0,0,0.222813785513811,2816.16831958378,44.7882859174
7.5,"random_instances_SVM","SVM",13,0,30040,26491,3549,100,89,11,0.542648016209965,0.185078079814922,1.86947114281579,36,11,25,0,2.3,0.33,8.1,0,0,0,0,0,0,0.33528458867764,3335.66840176112,37.6636937793988
7.5,"random_instances_SVM","SVM",13,1,29940,26407,3533,200,173,27,0.45268263598588,0.104684788895315,0.977922347319781,89,27,62,53,2.3,0.66,6.4,0,0,0,0,0,0,0.155270901089269,4059.39092800899,15.7719371276676
7.5,"random_instances_SVM","SVM",13,2,29840,26316,3524,300,264,36,0.594319100334951,0.223828802776171,2.3249313218219,108,36,72,19,2,1,7.3,0,0,0,0,0,0,0.453821252414772,3730.61564104437,50.4073432413673
7.5,"random_instances_SVM","SVM",13,3,29740,26220,3520,400,360,40,0.597810642284382,0.222672064777328,2.29704446375706,135,40,95,27,2.4,1.33,9,0,0,0,0,0,0,0.310132860873077,3024.31230307924,40.8180808972461
7.5,"random_instances_SVM","SVM",13,4,29640,26126,3514,500,454,46,0.588346666627386,0.227299016772701,2.29622716971071,142,46,96,7,2.1,1.66,9.9,0,0,0,0,0,0,0.721008208706584,2858.73438915245,85.1895564191052
7.5,"random_instances_SVM","SVM",13,5,29540,26030,3510,600,550,50,0.580401397275716,0.207634470792366,1.89126561608949,161,50,111,19,2.2,1.99,11,0,0,0,0,0,0,0.5,2547.82948605025,69.1163962850854
7.5,"random_instances_SVM","SVM",13,6,29440,25939,3501,700,641,59,0.570241358732813,0.204164256795836,2.05364902388876,209,59,150,48,2.5,2.32,10.9,0,0,0,0,0,0,0.102953800392211,2492.12823583323,11.3867049468061
7.5,"random_instances_SVM","SVM",13,7,29340,25848,3492,800,732,68,0.422451519872426,0.105841526894158,0.93616904660986,230,68,162,21,2.4,2.65,10.8,0,0,0,0,0,0,0.0912059018403658,2483.02993914651,9.27479169959753
7.5,"random_instances_SVM","SVM",13,8,29240,25757,3483,900,823,77,0.576994170099467,0.203585887796414,2.04961991449846,252,77,175,22,2.3,2.99,10.7,0,0,0,0,0,0,0.246549624260768,2560.45823607111,37.9828906245028
7.5,"random_instances_SVM","SVM",13,9,29140,25667,3473,1000,913,87,0.588677336596483,0.208791208791209,1.96603470723573,278,87,191,26,2.2,3.32,10.5,0,0,0,0,0,0,0.198707984006369,2592.77168081212,27.458573535627
7.5,"random_instances_SVM","SVM",13,10,29040,25579,3461,1100,1001,99,0.594375758128556,0.211683053788317,2.04916542368066,308,99,209,30,2.1,3.65,10.1,0,0,0,0,0,0,0.468274175821232,2703.46983734957,67.8403599975974
7.5,"random_instances_SVM","SVM",13,11,28940,25487,3453,1200,1093,107,0.594818659947406,0.206477732793522,2.07465699995411,323,107,216,15,2,3.98,10.2,0,0,0,0,0,0,0.75903884064037,2700.40778486605,89.5283862667357
7.5,"random_instances_SVM","SVM",13,12,28840,25399,3441,1300,1181,119,0.612756595431048,0.230190861769809,2.45367344713451,349,119,230,26,1.9,4.31,9.9,0,0,0,0,0,0,0.820395692119362,2724.73015519242,93.2342387753086
7.5,"random_instances_SVM","SVM",13,13,28740,25308,3432,1400,1272,128,0.60980531827247,0.204742625795257,2.19816506631056,362,128,234,13,1.8,4.64,9.9,0,0,0,0,0,0,0.513416771163345,2690.61650033086,70.6566153032093
7.5,"random_instances_SVM","SVM",13,14,28640,25220,3420,1500,1360,140,0.615986219714874,0.210526315789474,2.1486721780244,407,140,267,45,1.9,4.98,9.7,0,0,0,0,0,0,0.368837569863504,2674.24005170276,54.7218072137531
7.5,"random_instances_SVM","SVM",13,15,28540,25131,3409,1600,1449,151,0.607556736472974,0.206477732793522,2.12767381810067,445,151,294,38,1.9,5.31,9.6,0,0,0,0,0,0,0.669003135980881,2753.86332328457,84.8004932119919
7.5,"random_instances_SVM","SVM",13,16,28440,25045,3395,1700,1535,165,0.604296225671957,0.200694042799306,2.12210399135172,482,165,317,37,1.9,5.64,9.3,0,0,0,0,0,0,0.53026042532911,2782.1127887696,72.1401094071048
7.5,"random_instances_SVM","SVM",13,17,28340,24957,3383,1800,1623,177,0.609528705127119,0.207634470792366,2.07465699995411,506,177,329,24,1.9,5.97,9.2,0,0,0,0,0,0,0.672281338210376,2863.82400222473,83.6009878854218
7.5,"random_instances_SVM","SVM",13,18,28240,24872,3368,1900,1708,192,0.601525564195905,0.201272411798728,2.1317357462747,551,192,359,45,1.9,6.3,8.9,0,0,0,0,0,0,0.588559334952303,2920.06319700863,75.6548404370337
7.5,"random_instances_SVM","SVM",13,19,28140,24785,3355,2000,1795,205,0.603195776995997,0.209947946790052,2.09350635574492,597,205,392,46,1.9,6.64,8.8,0,0,0,0,0,0,0.5,2934.96907003725,67.6974171774144
7.5,"random_instances_SVM","SVM",13,20,28040,24698,3342,2100,1882,218,0.60474872940457,0.20936957779063,2.18295285131879,626,218,408,29,1.9,6.97,8.6,0,0,0,0,0,0,0.3654425841993,2941.23663272618,51.1757957193678
7.5,"random_instances_SVM","SVM",13,21,27940,24607,3333,2200,1973,227,0.600433286900269,0.210526315789474,2.19816506631056,660,227,433,34,1.9,7.3,8.7,0,0,0,0,0,0,0.34494732825631,2895.86347070761,48.6256623979029
7.5,"random_instances_SVM","SVM",13,22,27840,24517,3323,2300,2063,237,0.612124776500849,0.223828802776171,2.1297100988476,675,237,438,15,1.8,7.63,8.7,0,0,0,0,0,0,0.622556180091707,2911.71585107553,80.239249628241
7.5,"random_instances_SVM","SVM",13,23,27740,24429,3311,2400,2151,249,0.612973212871461,0.225563909774436,2.2000848611283,714,249,465,39,1.9,7.96,8.6,0,0,0,0,0,0,0.561812289847462,2924.25267608088,74.8522216846229
7.5,"random_instances_SVM","SVM",13,24,27640,24339,3301,2500,2241,259,0.611521654938189,0.221515326778485,2.20393452842686,747,259,488,33,1.9,8.29,8.7,0,0,0,0,0,0,0.447157442081334,2903.43982088127,62.9377011071524
7.5,"random_instances_SVM","SVM",13,25,27540,24250,3290,2600,2330,270,0.614586811227438,0.220358588779641,2.20577117380645,768,270,498,21,1.8,8.63,8.6,0,0,0,0,0,0,0.520593192666524,2916.2900719641,70.8305162341583
7.5,"random_instances_SVM","SVM",13,26,27440,24157,3283,2700,2423,277,0.614590842730732,0.226720647773279,2.22876266511625,786,277,509,18,1.8,8.96,8.7,0,0,0,0,0,0,0.695765506821304,2870.91574099284,85.3592405349123
7.5,"random_instances_SVM","SVM",13,27,27340,24073,3267,2800,2507,293,0.609462943938984,0.228455754771544,2.16396408469579,830,293,537,44,1.8,9.29,8.6,0,0,0,0,0,0,0.483150140941629,2904.3213847559,67.1614596324215
7.5,"random_instances_SVM","SVM",13,28,27240,23980,3260,2900,2600,300,0.604683835206385,0.224407171775593,2.17723993797613,867,300,567,37,1.9,9.62,8.7,0,0,0,0,0,0,0.661877118785093,2871.03040309488,83.6436917758665
7.5,"random_instances_SVM","SVM",13,29,27140,23893,3247,3000,2687,313,0.589488557423246,0.213418160786582,2.10295574870474,914,313,601,47,1.9,9.95,8.6,0,0,0,0,0,0,0.6439147950988,2885.64409706775,81.9506044547591
7.5,"random_instances_SVM","SVM",13,30,27040,23803,3237,3100,2777,323,0.606308596058048,0.228455754771544,2.16006792543801,931,323,608,17,1.9,10.29,8.6,0,0,0,0,0,0,0.707309289944095,2865.3375480253,85.9458111911798
7.5,"random_instances_SVM","SVM",13,31,26940,23711,3229,3200,2869,331,0.597179603645174,0.215731636784268,2.15621137864905,966,331,635,35,1.9,10.62,8.7,0,0,0,0,0,0,0.649369618826668,2839.43178297621,81.9315317548817
7.5,"random_instances_SVM","SVM",13,32,26840,23620,3220,3300,2960,340,0.606429389433619,0.224407171775593,2.10848499256636,989,340,649,23,1.9,10.95,8.7,0,0,0,0,0,0,0.464237924624806,2791.85427297514,65.3464422645385
7.5,"random_instances_SVM","SVM",13,33,26740,23528,3212,3400,3052,348,0.601864882389807,0.223828802776171,2.0590391788071,1004,348,656,15,1.9,11.28,8.8,0,0,0,0,0,0,0.529632109227978,2762.67094595108,73.330263757924
7.5,"random_instances_SVM","SVM",13,34,26640,23439,3201,3500,3141,359,0.591241762836837,0.217466743782533,2.04916542368066,1051,359,692,47,1.9,11.61,8.7,0,0,0,0,0,0,0.230776895991872,2750.86837972481,33.4008789499058
7.5,"random_instances_SVM","SVM",13,35,26540,23347,3193,3600,3233,367,0.597906314625997,0.225563909774436,2.13904274608182,1091,367,724,40,2,11.94,8.8,0,0,0,0,0,0,0.327731839660738,2719.4059935245,50.3546698097166
7.5,"random_instances_SVM","SVM",13,36,26440,23254,3186,3700,3326,374,0.596744894881404,0.235974551764025,2.19055895881468,1114,374,740,23,2,12.28,8.9,0,0,0,0,0,0,0.337226190840466,2671.84872163678,52.2385611275487
7.5,"random_instances_SVM","SVM",13,37,26340,23164,3176,3800,3416,384,0.594179991796568,0.235396182764604,2.22681274152472,1110,384,726,-4,1.9,12.61,8.9,0,0,0,0,0,0,0.355152189249877,2676.18101867739,52.7482980949882
7.5,"random_instances_SVM","SVM",13,38,26240,23077,3163,3900,3503,397,0.596207447807886,0.230190861769809,2.14292596016591,1123,397,726,13,1.8,12.94,8.8,0,0,0,0,0,0,0.330654941952553,2681.11235880306,48.9663016704019
7.5,"random_instances_SVM","SVM",13,39,26140,22988,3152,4000,3592,408,0.590391982631795,0.229034123770966,2.24576136343546,1203,408,795,80,1.9,13.27,8.8,0,0,0,0,0,0,0.481098040106771,2680.59434559599,69.4175328505502
7.5,"random_instances_SVM","SVM",13,40,26040,22907,3133,4100,3673,427,0.59497246396554,0.238866396761134,2.37725432462275,1275,427,848,72,2,13.6,8.6,0,0,0,0,0,0,0.161316376621923,2708.46108255438,20.7716836247829
7.5,"random_instances_SVM","SVM",13,41,25940,22817,3123,4200,3763,437,0.582586342012487,0.218623481781377,2.23424599995058,1299,437,862,24,2,13.93,8.6,0,0,0,0,0,0,0.36762556810369,2717.01404976733,57.7603655627283
7.5,"random_instances_SVM","SVM",13,42,25840,22731,3109,4300,3849,451,0.585512996656306,0.223828802776171,2.21904704756997,1367,451,916,68,2,14.27,8.5,0,0,0,0,0,0,0.251479107472071,2713.97855787006,40.9065314234257
7.5,"random_instances_SVM","SVM",13,43,25740,22646,3094,4400,3934,466,0.57572823471571,0.213996529786003,2.15810445273039,1424,466,958,57,2.1,14.6,8.4,0,0,0,0,0,0,0.285985779032573,2735.84085068904,47.602662537871
7.5,"random_instances_SVM","SVM",13,44,25640,22555,3085,4500,4025,475,0.593583849503053,0.222093695777906,2.19438860734407,1431,475,956,7,2,14.93,8.5,0,0,0,0,0,0,0.281616286872312,2708.44093862222,46.6049872505191
7.5,"random_instances_SVM","SVM",13,45,25540,22464,3076,4600,4116,484,0.582832957305368,0.208212839791787,2.16190059072992,1500,484,1016,69,2.1,15.26,8.5,0,0,0,0,0,0,0.362384178240823,2704.06554244623,58.8260863649652
7.5,"random_instances_SVM","SVM",13,46,25440,22378,3062,4700,4202,498,0.570048583516173,0.211104684788895,2.19836628608558,1504,498,1006,4,2,15.59,8.4,0,0,0,0,0,0,0.176760493016973,2687.92388349019,25.1028209723086
7.5,"random_instances_SVM","SVM",13,47,25340,22292,3048,4800,4288,512,0.573532409255006,0.220936957779063,2.1446816988395,1540,512,1028,36,2,15.93,8.4,0,0,0,0,0,0,0.199475230342942,2704.76313078562,30.5480957021746
7.5,"random_instances_SVM","SVM",13,48,25240,22201,3039,4900,4379,521,0.56481012183033,0.203585887796414,2.15045160006114,1551,521,1030,11,2,16.26,8.4,0,0,0,0,0,0,0.277428253590443,2690.28094810979,47.1831147870271
7.5,"random_instances_SVM","SVM",14,0,30040,26568,3472,100,86,14,0.497267078735722,0.11924570160843,1.02548953666024,48,14,34,0,2.4,0.33,6.1,0,0,0,0,0,0,0.146391721299018,4241.74721837936,14.7039246627353
7.5,"random_instances_SVM","SVM",14,1,29940,26484,3456,200,170,30,0.54961856775404,0.178036605657238,1.69835217707433,92,30,62,44,2.1,0.66,5.7,0,0,0,0,0,0,0.383254648741483,4468.74581474891,47.8951238958668
7.5,"random_instances_SVM","SVM",14,2,29840,26391,3449,300,263,37,0.533736502706854,0.19134775374376,1.78538466094804,115,37,78,23,2.1,1,7.1,0,0,0,0,0,0,0.203025879626721,3674.02224275364,23.1925630958874
7.5,"random_instances_SVM","SVM",14,3,29740,26301,3439,400,353,47,0.548964698236003,0.193566278424847,1.85670599727213,144,47,97,29,2.1,1.33,7.5,0,0,0,0,0,0,0.147764335687182,3502.18222570572,15.9352851295185
7.5,"random_instances_SVM","SVM",14,4,29640,26208,3432,500,446,54,0.527976205704129,0.179145867997781,1.73374130298674,167,54,113,23,2.1,1.66,8.3,0,0,0,0,0,0,0.165730133633317,3178.77800549403,19.5592991853858
7.5,"random_instances_SVM","SVM",14,5,29540,26117,3423,600,537,63,0.522184515272925,0.177481974486966,1.66293950614391,192,63,129,25,2,1.99,8.5,0,0,0,0,0,0,0.30053060177336,3078.27928928789,40.497834791753
7.5,"random_instances_SVM","SVM",14,6,29440,26026,3414,700,628,72,0.511403025406857,0.166943982251803,1.62738601838627,232,72,160,40,2.2,2.32,8.7,0,0,0,0,0,0,0.683443157399308,3094.61283941063,84.8536019169227
7.5,"random_instances_SVM","SVM",14,7,29340,25938,3402,800,716,84,0.521627961202911,0.176927343316694,1.58899378332507,275,84,191,43,2.3,2.65,8.5,0,0,0,0,0,0,0.162813241200658,3092.43889977802,20.356797284509
7.5,"random_instances_SVM","SVM",14,8,29240,25845,3395,900,809,91,0.531823635481082,0.180255130338325,1.59779718168834,302,91,211,27,2.3,2.99,8.9,0,0,0,0,0,0,0.10489364335372,2957.10705147395,10.7609026511308
7.5,"random_instances_SVM","SVM",14,9,29140,25756,3384,1000,898,102,0.524900569362257,0.173044925124792,1.55616820665321,342,102,240,40,2.4,3.32,8.8,0,0,0,0,0,0,0.204635103316265,2973.06897991452,28.4544493170398
7.5,"random_instances_SVM","SVM",14,10,29040,25667,3373,1100,987,113,0.526809339975531,0.171935662784248,1.59604970598637,389,113,276,47,2.4,3.65,8.7,0,0,0,0,0,0,0.118526526652208,2985.16343755315,12.6757768079759
7.5,"random_instances_SVM","SVM",14,11,28940,25576,3364,1200,1078,122,0.533427459275907,0.174708818635607,1.56448996176901,408,122,286,19,2.3,3.98,8.8,0,0,0,0,0,0,0.181349017322092,2946.44850434424,25.2721799299683
7.5,"random_instances_SVM","SVM",14,12,28840,25490,3350,1300,1164,136,0.526557523713115,0.171935662784248,1.54214010517231,461,136,325,53,2.4,4.31,8.6,0,0,0,0,0,0,0.209417234699425,3031.09430853222,30.6775893773929
7.5,"random_instances_SVM","SVM",14,13,28740,25400,3340,1400,1254,146,0.464681452428046,0.123682750970605,1.11150877119546,481,146,335,20,2.3,4.64,8.6,0,0,0,0,0,0,0.113055730789461,2992.53237864712,12.5168853885633
7.5,"random_instances_SVM","SVM",14,14,28640,25308,3332,1500,1346,154,0.529876532279388,0.175818080976151,1.54738608568438,510,154,356,29,2.3,4.98,8.7,0,0,0,0,0,0,0.107312847154571,2941.35525468169,11.0215874833526
7.5,"random_instances_SVM","SVM",14,15,28540,25216,3324,1600,1438,162,0.525932288680427,0.175263449805879,1.54683277968905,523,162,361,13,2.2,5.31,8.9,0,0,0,0,0,0,0.13085410352211,2893.27639919249,15.4146293598728
7.5,"random_instances_SVM","SVM",14,16,28440,25121,3319,1700,1533,167,0.52849919263292,0.17249029395452,1.54821019089091,549,167,382,26,2.3,5.64,9.2,0,0,0,0,0,0,0.139344559885604,2807.27757353085,17.56320713985
7.5,"random_instances_SVM","SVM",14,17,28340,25032,3308,1800,1622,178,0.519536849531091,0.17859123682751,1.67325002566827,573,178,395,24,2.2,5.97,9.1,0,0,0,0,0,0,0.123164979093942,2803.41519502458,13.8203221288438
7.5,"random_instances_SVM","SVM",14,18,28240,24951,3289,1900,1703,197,0.537452840883731,0.193011647254576,1.69405953041228,623,197,426,50,2.2,6.3,8.6,0,0,0,0,0,0,0.175294142194106,2935.14504533979,23.6392171558664
7.5,"random_instances_SVM","SVM",14,19,28140,24862,3278,2000,1792,208,0.548482363915966,0.196894065446478,1.83308034367672,643,208,435,20,2.1,6.64,8.6,0,0,0,0,0,0,0.248033428964171,2959.19706917375,61.2466293049794
7.5,"random_instances_SVM","SVM",14,20,28040,24774,3266,2100,1880,220,0.536084426000219,0.195230171935663,1.99264348104216,700,220,480,57,2.2,6.97,8.5,0,0,0,0,0,0,0.16314928006731,2977.56529662052,50.1139105039617
7.5,"random_instances_SVM","SVM",14,21,27940,24683,3257,2200,1971,229,0.454376549083855,0.130892956184138,1.191992351824,742,229,513,42,2.2,7.3,8.6,0,0,0,0,0,0,0.10564924373789,2906.63757062739,10.6951440121886
7.5,"random_instances_SVM","SVM",14,22,27840,24590,3250,2300,2064,236,0.535212370064236,0.202995008319468,1.92840052154791,737,236,501,-5,2.1,7.63,8.7,0,0,0,0,0,0,0.14219333374833,2888.61051060562,44.1010363626306
7.5,"random_instances_SVM","SVM",14,23,27740,24503,3237,2400,2151,249,0.532352997240554,0.196339434276206,1.9306521792929,782,249,533,45,2.1,7.96,8.6,0,0,0,0,0,0,0.24293152127336,2911.68251124234,61.5924066275032
7.5,"random_instances_SVM","SVM",14,24,27640,24416,3224,2500,2238,262,0.541446996271749,0.206322795341098,1.97453063791319,784,262,522,2,2,8.29,8.5,0,0,0,0,0,0,0.192658240045887,2935.16304260848,51.8855000250843
7.5,"random_instances_SVM","SVM",14,25,27540,24325,3215,2600,2329,271,0.535260860579567,0.19744869661675,1.98184371434991,840,271,569,56,2.1,8.63,8.6,0,0,0,0,0,0,0.108441502776788,2870.09720050417,12.0323252021224
7.5,"random_instances_SVM","SVM",14,26,27440,24233,3207,2700,2421,279,0.549689088012122,0.196339434276206,1.96378137359617,861,279,582,21,2.1,8.96,8.7,0,0,0,0,0,0,0.107021478378201,2835.12527689431,11.8956092500156
7.5,"random_instances_SVM","SVM",14,27,27340,24146,3194,2800,2508,292,0.546430734392193,0.205768164170826,1.9435779140438,911,292,619,50,2.1,9.29,8.6,0,0,0,0,0,0,0.108679677705986,2850.88050812874,12.3354832238845
7.5,"random_instances_SVM","SVM",14,28,27240,24056,3184,2900,2598,302,0.546207489911885,0.207432057681642,1.97665564179925,909,302,607,-2,2,9.62,8.6,0,0,0,0,0,0,0.263415806369406,2853.3998934241,50.9066495940177
7.5,"random_instances_SVM","SVM",14,29,27140,23968,3172,3000,2686,314,0.541571399524895,0.204104270660011,2.02241887734735,975,314,661,66,2.1,9.95,8.6,0,0,0,0,0,0,0.211393287096961,2853.11394684435,42.1222840516892
7.5,"random_instances_SVM","SVM",14,30,27040,23880,3160,3100,2774,326,0.537321164053281,0.201885745978924,2.03500709985975,975,326,649,0,2,10.29,8.5,0,0,0,0,0,0,0.12229818473998,2842.32328657831,17.101026228613
7.5,"random_instances_SVM","SVM",14,31,26940,23789,3151,3200,2865,335,0.535022128395862,0.195230171935663,2.07691370802721,1003,335,668,28,2,10.62,8.6,0,0,0,0,0,0,0.224517701711398,2829.15430367495,45.5907364176678
7.5,"random_instances_SVM","SVM",14,32,26840,23697,3143,3300,2957,343,0.547686304322129,0.214642262895175,2.08426490649574,1060,343,717,57,2.1,10.95,8.6,0,0,0,0,0,0,0.111307710398339,2788.82180305696,13.8881018670409
7.5,"random_instances_SVM","SVM",14,33,26740,23608,3132,3400,3046,354,0.531712671625069,0.196894065446478,2.03519737635342,1112,354,758,52,2.1,11.28,8.6,0,0,0,0,0,0,0.32100335291345,2800.03603298029,58.9572726881649
7.5,"random_instances_SVM","SVM",14,34,26640,23523,3117,3500,3131,369,0.546891519694433,0.210759844703272,2.06418282888999,1126,369,757,14,2.1,11.61,8.5,0,0,0,0,0,0,0.114654752303978,2808.78662779888,15.0993291405221
7.5,"random_instances_SVM","SVM",14,35,26540,23436,3104,3600,3218,382,0.535897716615077,0.191902384914032,2.0257221729702,1174,382,792,48,2.1,11.94,8.4,0,0,0,0,0,0,0.11612543787639,2815.96711991507,15.0709982727017
7.5,"random_instances_SVM","SVM",14,36,26440,23341,3099,3700,3313,387,0.52408133046604,0.189129229062673,1.96162068861685,1188,387,801,14,2.1,12.28,8.6,0,0,0,0,0,0,0.14378783386814,2766.91730627629,25.1920235598367
7.5,"random_instances_SVM","SVM",14,37,26340,23255,3085,3800,3399,401,0.530226332824517,0.182473655019412,1.93573284292261,1224,401,823,36,2.1,12.61,8.5,0,0,0,0,0,0,0.13527188603571,2774.86311950375,22.5245491695934
7.5,"random_instances_SVM","SVM",14,38,26240,23161,3079,3900,3493,407,0.530697986690526,0.192457016084304,2.07509822401669,1211,407,804,-13,2,12.94,8.6,0,0,0,0,0,0,0.200312541214882,2740.60235242279,35.0025394250489
7.5,"random_instances_SVM","SVM",14,39,26140,23072,3068,4000,3582,418,0.556807453861695,0.211869107043816,2.09337133188216,1254,418,836,43,2,13.27,8.6,0,0,0,0,0,0,0.169967891058802,2729.14227252786,29.3339805007033
7.5,"random_instances_SVM","SVM",14,40,26040,22983,3057,4100,3671,429,0.570656846668482,0.216860787576262,2.07691370802721,1248,429,819,-6,1.9,13.6,8.6,0,0,0,0,0,0,0.154240578852103,2723.01547539368,25.420885756058
7.5,"random_instances_SVM","SVM",14,41,25940,22902,3038,4200,3752,448,0.549861271143745,0.202995008319468,2.10807461105149,1261,448,813,13,1.8,13.93,8.4,0,0,0,0,0,0,0.185319563493527,2766.79269482037,33.1331422496124
7.5,"random_instances_SVM","SVM",14,42,25840,22812,3028,4300,3842,458,0.559764330243153,0.211869107043816,2.12463201416968,1287,458,829,26,1.8,14.27,8.4,0,0,0,0,0,0,0.237069665348524,2762.79124001986,42.6245776902534
7.5,"random_instances_SVM","SVM",14,43,25740,22722,3018,4400,3932,468,0.546513753498633,0.19134775374376,2.09338419564346,1350,468,882,63,1.9,14.6,8.4,0,0,0,0,0,0,0.117766683455326,2734.93623572978,13.8781192004676
7.5,"random_instances_SVM","SVM",14,44,25640,22640,3000,4500,4014,486,0.542715441269545,0.190793122573489,1.95382524926723,1410,486,924,60,1.9,14.93,8.3,0,0,0,0,0,0,0.120624972843388,2765.86261249095,14.3108282395143
7.5,"random_instances_SVM","SVM",14,45,25540,22550,2990,4600,4104,496,0.562655702626737,0.204658901830283,2.01613019771429,1443,496,947,33,1.9,15.26,8.3,0,0,0,0,0,0,0.116855532207924,2752.1429862658,13.1563342772837
7.5,"random_instances_SVM","SVM",14,46,25440,22463,2977,4700,4191,509,0.574779209306977,0.215196894065446,2.15759511145457,1481,509,972,38,1.9,15.59,8.2,0,0,0,0,0,0,0.270398823888263,2776.76973818686,47.2290910486286
7.5,"random_instances_SVM","SVM",14,47,25340,22376,2964,4800,4278,522,0.551766906594393,0.20077648363838,2.09888504039458,1500,522,978,19,1.9,15.93,8.2,0,0,0,0,0,0,0.228854874222142,2763.87938114106,41.6134135715023
7.5,"random_instances_SVM","SVM",14,48,25240,22288,2952,4900,4366,534,0.551667877257465,0.20687742651137,2.17579085981442,1521,534,987,21,1.8,16.26,8.2,0,0,0,0,0,0,0.39458217857709,2771.89424430025,63.6382783531181
7.5,"random_instances_SVM","SVM",15,0,30040,26510,3530,100,88,12,0.453053736069744,0.135661133371494,1.31010735480565,41,12,29,0,2.4,0.33,7.3,0,0,0,0,0,0,0.23461872313166,2824.06330194181,26.7333184882528
7.5,"random_instances_SVM","SVM",15,1,29940,26426,3514,200,172,28,0.411996260862859,0.0715512306811677,0.597062577550868,83,28,55,42,2,0.66,6.1,0,0,0,0,0,0,0.14071554397016,4198.86855323568,14.0777916362134
7.5,"random_instances_SVM","SVM",15,2,29840,26337,3503,300,261,39,0.39942304919683,0.0829994275901546,0.700926588437321,112,39,73,29,1.9,1,6.7,0,0,0,0,0,0,0.140743119867114,3844.00497470142,14.2644935366081
7.5,"random_instances_SVM","SVM",15,3,29740,26246,3494,400,352,48,0.405570483482681,0.0852890669719519,0.682695515024729,140,48,92,28,1.9,1.33,7.3,0,0,0,0,0,0,0.120168478371674,3571.21382547774,12.0174265132562
7.5,"random_instances_SVM","SVM",15,4,29640,26157,3483,500,441,59,0.420672798090897,0.0933028048082427,0.687978675168697,175,59,116,35,2,1.66,7.5,0,0,0,0,0,0,0.119891597984566,3499.70618440755,12.0584461560448
7.5,"random_instances_SVM","SVM",15,5,29540,26068,3472,600,530,70,0.593837602463677,0.206639954207212,2.0657870892061,213,70,143,38,2,1.99,7.6,0,0,0,0,0,0,0.207725311754874,3461.31344854433,56.0556581950528
7.5,"random_instances_SVM","SVM",15,6,29440,25981,3459,700,617,83,0.590041370401753,0.21751574127075,2.06796010129299,245,83,162,32,2,2.32,7.4,0,0,0,0,0,0,0.21973239849331,3519.85901763099,56.6317129394408
7.5,"random_instances_SVM","SVM",15,7,29340,25891,3449,800,707,93,0.585740219928421,0.220950200343446,2.02528553813706,267,93,174,22,1.9,2.65,7.6,0,0,0,0,0,0,0.227040531573244,3428.24665250013,55.9386375044414
7.5,"random_instances_SVM","SVM",15,8,29240,25800,3440,900,798,102,0.572374467221508,0.215226101888952,2.05215352504781,298,102,196,31,1.9,2.99,7.8,0,0,0,0,0,0,0.189636921245273,3318.77059438224,54.3701761883835
7.5,"random_instances_SVM","SVM",15,9,29140,25711,3429,1000,887,113,0.586876060809833,0.220950200343446,2.03527456489946,324,113,211,26,1.9,3.32,7.8,0,0,0,0,0,0,0.189547264055535,3319.91751541474,55.3090153812991
7.5,"random_instances_SVM","SVM",15,10,29040,25625,3415,1100,973,127,0.574802870022759,0.212936462507155,2.01985581819568,366,127,239,42,1.9,3.65,7.7,0,0,0,0,0,0,0.182030600567675,3381.68924003777,53.3657502351438
7.5,"random_instances_SVM","SVM",15,11,28940,25535,3405,1200,1063,137,0.577723732600225,0.211791642816256,1.92135098963416,405,137,268,39,2,3.98,7.8,0,0,0,0,0,0,0.127222720952855,3314.00556870714,26.9800232584072
7.5,"random_instances_SVM","SVM",15,12,28840,25441,3399,1300,1157,143,0.575848879848406,0.198626216370922,1.96168697431945,435,143,292,30,2,4.31,8.1,0,0,0,0,0,0,0.111047831428288,3173.3664314504,11.7277733575333
7.5,"random_instances_SVM","SVM",15,13,28740,25349,3391,1400,1249,151,0.421257537689089,0.0984544934172868,0.788469942328169,466,151,315,31,2.1,4.64,8.3,0,0,0,0,0,0,0.111049478516131,3099.1013788341,11.3152893762307
7.5,"random_instances_SVM","SVM",15,14,28640,25260,3380,1500,1338,162,0.568285199467899,0.202633085289067,1.94699158031584,490,162,328,24,2,4.98,8.3,0,0,0,0,0,0,0.119964057993282,3107.16215077937,24.3431400815073
7.5,"random_instances_SVM","SVM",15,15,28540,25167,3373,1600,1431,169,0.418872396424489,0.0761305094447624,0.645066188111408,559,169,390,69,2.3,5.31,8.5,0,0,0,0,0,0,0.116390870928755,3000.84734278479,12.6849938103875
7.5,"random_instances_SVM","SVM",15,16,28440,25075,3365,1700,1523,177,0.574019436673785,0.207212364052662,1.9694101513837,569,177,392,10,2.2,5.64,8.6,0,0,0,0,0,0,0.113975103311844,2975.70607228493,22.4689029100615
7.5,"random_instances_SVM","SVM",15,17,28340,24988,3352,1800,1610,190,0.59284653951527,0.213508872352604,1.98901832478811,600,190,410,31,2.2,5.97,8.5,0,0,0,0,0,0,0.106355301204275,2992.40074608124,11.2110676587328
7.5,"random_instances_SVM","SVM",15,18,28240,24899,3341,1900,1699,201,0.425929225157097,0.0927303949627934,0.884401008100217,646,201,445,46,2.2,6.3,8.5,0,0,0,0,0,0,0.142093666348263,2949.74374476559,17.4760642825019
7.5,"random_instances_SVM","SVM",15,19,28140,24812,3328,2000,1786,214,0.571558383656198,0.203205495134516,1.85688727119649,682,214,468,36,2.2,6.64,8.3,0,0,0,0,0,0,0.118966729855857,3030.93974440485,27.9947455779893
7.5,"random_instances_SVM","SVM",15,20,28040,24722,3318,2100,1876,224,0.567916252023235,0.19977103606182,1.87236133178979,714,224,490,32,2.2,6.97,8.4,0,0,0,0,0,0,0.122198728017571,3014.65856352696,33.1624083892675
7.5,"random_instances_SVM","SVM",15,21,27940,24634,3306,2200,1964,236,0.442577699352342,0.0898683457355467,0.729242936503688,722,236,486,8,2.1,7.3,8.3,0,0,0,0,0,0,0.109661363919234,2993.80288451591,11.1338153285892
7.5,"random_instances_SVM","SVM",15,22,27840,24549,3291,2300,2049,251,0.435518121127836,0.088723526044648,0.770805134743624,776,251,525,54,2.1,7.63,8.2,0,0,0,0,0,0,0.111585374920529,3035.8431372363,11.337302604137
7.5,"random_instances_SVM","SVM",15,23,27740,24458,3282,2400,2140,260,0.430554257184376,0.092157985117344,0.760274550822994,780,260,520,4,2,7.96,8.2,0,0,0,0,0,0,0.109168457095099,3004.07810082704,10.9721684322527
7.5,"random_instances_SVM","SVM",15,24,27640,24369,3271,2500,2229,271,0.569843216238772,0.189467658843732,1.79983363051974,842,271,571,62,2.1,8.29,8.2,0,0,0,0,0,0,0.112339071964873,2999.81321091471,14.4272415925377
7.5,"random_instances_SVM","SVM",15,25,27540,24277,3263,2600,2321,279,0.433644299435474,0.0961648540354894,0.846372616654911,852,279,573,10,2.1,8.63,8.3,0,0,0,0,0,0,0.109941140401862,2952.70246176385,11.2039558573896
7.5,"random_instances_SVM","SVM",15,26,27440,24188,3252,2700,2410,290,0.431133583720394,0.100744132799084,0.79273194201643,883,290,593,31,2,8.96,8.3,0,0,0,0,0,0,0.108394238480379,2945.86959353506,10.9173846184026
7.5,"random_instances_SVM","SVM",15,27,27340,24099,3241,2800,2499,301,0.575162924579544,0.202060675443618,1.99494490555238,933,301,632,50,2.1,9.29,8.3,0,0,0,0,0,0,0.162701341117226,2959.77321110781,38.4313134532264
7.5,"random_instances_SVM","SVM",15,28,27240,24008,3232,2900,2590,310,0.541720768647954,0.196336576989124,1.96520569534962,917,310,607,-16,2,9.62,8.4,0,0,0,0,0,0,0.119742821778044,2920.15968603951,22.3128891391527
7.5,"random_instances_SVM","SVM",15,29,27140,23918,3222,3000,2680,320,0.5583864271676,0.204922724670864,1.99257968257645,959,320,639,42,2,9.95,8.4,0,0,0,0,0,0,0.109708629931634,2897.17633364774,13.6686510291252
7.5,"random_instances_SVM","SVM",15,30,27040,23832,3208,3100,2766,334,0.559182533955797,0.195764167143675,1.89387388108237,997,334,663,38,2,10.29,8.3,0,0,0,0,0,0,0.112731382746753,2919.41921837425,17.045695099912
7.5,"random_instances_SVM","SVM",15,31,26940,23737,3203,3200,2861,339,0.45870312567395,0.0978820835718374,0.815313071089593,1048,339,709,51,2.1,10.62,8.4,0,0,0,0,0,0,0.108365873303512,2852.82010545738,11.005203623008
7.5,"random_instances_SVM","SVM",15,32,26840,23649,3191,3300,2949,351,0.441366634090918,0.0950200343445907,0.809734687003403,1075,351,724,27,2.1,10.95,8.4,0,0,0,0,0,0,0.114043608280848,2848.94669113042,11.9711645009622
7.5,"random_instances_SVM","SVM",15,33,26740,23558,3182,3400,3040,360,0.450586453734561,0.0973096737263881,0.771501435678352,1110,360,750,35,2.1,11.28,8.4,0,0,0,0,0,0,0.109632739449862,2828.245584238,11.2239806751549
7.5,"random_instances_SVM","SVM",15,34,26640,23469,3171,3500,3129,371,0.54458677026982,0.19118488838008,1.89820218253013,1143,371,772,33,2.1,11.61,8.4,0,0,0,0,0,0,0.121768425358802,2840.91805101842,26.9680351097624
7.5,"random_instances_SVM","SVM",15,35,26540,23378,3162,3600,3220,380,0.544136583931587,0.191757298225529,1.80847044021432,1142,380,762,-1,2,11.94,8.5,0,0,0,0,0,0,0.125483853499013,2817.91909169107,28.5663005774388
7.5,"random_instances_SVM","SVM",15,36,26440,23287,3153,3700,3311,389,0.439282948836936,0.088723526044648,0.700100081396783,1202,389,813,60,2.1,12.28,8.5,0,0,0,0,0,0,0.125591476064976,2764.81844599711,14.2386948726702
7.5,"random_instances_SVM","SVM",15,37,26340,23195,3145,3800,3403,397,0.443484687993671,0.0829994275901546,0.765090769696985,1187,397,790,-15,2,12.61,8.6,0,0,0,0,0,0,0.106726855505324,2750.4371718034,10.8845786275508
7.5,"random_instances_SVM","SVM",15,38,26240,23105,3135,3900,3493,407,0.554226703683985,0.184315970234688,1.95221606577286,1227,407,820,40,2,12.94,8.6,0,0,0,0,0,0,0.126817040449446,2756.59047794021,33.9740235656806
7.5,"random_instances_SVM","SVM",15,39,26140,23011,3129,4000,3587,413,0.566804641039223,0.20034344590727,1.95323519564537,1209,413,796,-18,1.9,13.27,8.7,0,0,0,0,0,0,0.125967234623973,2719.92665181179,33.7778491861768
7.5,"random_instances_SVM","SVM",15,40,26040,22922,3118,4100,3676,424,0.560351712426518,0.193474527761878,2.01162787712953,1256,424,832,47,2,13.6,8.7,0,0,0,0,0,0,0.115932693499198,2707.66957132137,26.0048528139834
7.5,"random_instances_SVM","SVM",15,41,25940,22834,3106,4200,3764,436,0.44236701953531,0.0927303949627934,0.800503823800904,1314,436,878,58,2,13.93,8.6,0,0,0,0,0,0,0.106843295054352,2691.57145979891,10.9021112848994
7.5,"random_instances_SVM","SVM",15,42,25840,22743,3097,4300,3855,445,0.452281816218114,0.0967372638809388,0.793446758916354,1343,445,898,29,2,14.27,8.7,0,0,0,0,0,0,0.10373049057251,2673.93162169361,10.3893548066787
7.5,"random_instances_SVM","SVM",15,43,25740,22652,3088,4400,3946,454,0.562803743673806,0.204922724670864,2.02937875611961,1380,454,926,37,2,14.6,8.7,0,0,0,0,0,0,0.112615043406866,2668.20553919916,24.111278849103
7.5,"random_instances_SVM","SVM",15,44,25640,22560,3080,4500,4038,462,0.554075696433417,0.194619347452776,1.85962083735676,1387,462,925,7,2,14.93,8.7,0,0,0,0,0,0,0.114232854627657,2646.79260820208,26.6362964373023
7.5,"random_instances_SVM","SVM",15,45,25540,22472,3068,4600,4126,474,0.576617105070286,0.214653692043503,2.0913427347314,1394,474,920,7,1.9,15.26,8.7,0,0,0,0,0,0,0.103279472613617,2631.89068885644,10.4515881876825
7.5,"random_instances_SVM","SVM",15,46,25440,22381,3059,4700,4217,483,0.45751616142748,0.0915855752718947,0.739661492935801,1459,483,976,65,2,15.59,8.7,0,0,0,0,0,0,0.105862707999767,2612.52131170911,10.8081549131011
7.5,"random_instances_SVM","SVM",15,47,25340,22294,3046,4800,4304,496,0.558912310454758,0.187178019461935,2.08153080501081,1494,496,998,35,2,15.93,8.7,0,0,0,0,0,0,0.119945961553612,2626.79471670495,22.708144985756
7.5,"random_instances_SVM","SVM",15,48,25240,22211,3029,4900,4387,513,0.566680699099562,0.192329708070979,2.08365397467724,1530,513,1017,36,2,16.26,8.6,0,0,0,0,0,0,0.131705047836648,2645.83626234997,20.4542610786905
7.5,"random_instances_SVM","SVM",16,0,30040,26566,3474,100,91,9,0.417715292535374,0.0880398671096345,0.706690411341574,31,9,22,0,2.4,0.33,10.1,0,0,0,0,0,0,0.118795583426217,2644.12397670764,12.0736358979685
7.5,"random_instances_SVM","SVM",16,1,29940,26482,3458,200,175,25,0.582789537242151,0.194352159468439,1.87485913328552,70,25,45,39,1.8,0.66,7,0,0,0,0,0,0,0.17496600944089,3719.8237553072,18.5190588972995
7.5,"random_instances_SVM","SVM",16,2,29840,26387,3453,300,270,30,0.57977345690685,0.186046511627907,1.93197606179714,98,30,68,28,2.3,1,9,0,0,0,0,0,0,0.132686033141561,2985.06906290094,13.9680472021636
7.5,"random_instances_SVM","SVM",16,3,29740,26298,3442,400,359,41,0.603224916400873,0.208194905869324,2.0385757687225,128,41,87,30,2.1,1.33,8.8,0,0,0,0,0,0,0.207244536556723,2991.92362871599,23.5128311231885
7.5,"random_instances_SVM","SVM",16,4,29640,26205,3435,500,452,48,0.588044250037255,0.210409745293466,2.01657674963556,156,48,108,28,2.2,1.66,9.4,0,0,0,0,0,0,0.180679761400901,2879.77184384804,21.165186804975
7.5,"random_instances_SVM","SVM",16,5,29540,26115,3425,600,542,58,0.542460174841243,0.197674418604651,1.9099383120428,188,58,130,32,2.2,1.99,9.3,0,0,0,0,0,0,0.358642160381593,2842.61930016193,55.8825715380155
7.5,"random_instances_SVM","SVM",16,6,29440,26024,3416,700,633,67,0.561178322958318,0.209302325581395,2.09903933038474,223,67,156,35,2.3,2.32,9.4,0,0,0,0,0,0,0.300826937892536,2807.60875955186,45.2939794480177
7.5,"random_instances_SVM","SVM",16,7,29340,25931,3409,800,726,74,0.548848646656313,0.208194905869324,2.16323687688179,236,74,162,13,2.2,2.65,9.8,0,0,0,0,0,0,0.271122817280095,2715.11902215766,42.1171161122755
7.5,"random_instances_SVM","SVM",16,8,29240,25838,3402,900,819,81,0.554963749014365,0.198228128460687,2.05324178144712,266,81,185,30,2.3,2.99,10.1,0,0,0,0,0,0,0.148275067064983,2632.94082960884,18.9265858631625
7.5,"random_instances_SVM","SVM",16,9,29140,25747,3393,1000,910,90,0.560755140861038,0.20874861572536,2.22581272518834,296,90,206,30,2.3,3.32,10.1,0,0,0,0,0,0,0.175847567755739,2607.68824649525,23.7326419833137
7.5,"random_instances_SVM","SVM",16,10,29040,25659,3381,1100,998,102,0.567532107031931,0.202104097452935,2.12122580512736,308,102,206,12,2,3.65,9.8,0,0,0,0,0,0,0.11658562719639,2680.84978830255,12.7349203402287
7.5,"random_instances_SVM","SVM",16,11,28940,25566,3374,1200,1091,109,0.565147627437795,0.202104097452935,2.11199636328835,348,109,239,40,2.2,3.98,10,0,0,0,0,0,0,0.208727604470842,2621.87375126223,27.9586303257527
7.5,"random_instances_SVM","SVM",16,12,28840,25476,3364,1300,1181,119,0.569349978440168,0.208194905869324,2.03481889398406,368,119,249,20,2.1,4.31,9.9,0,0,0,0,0,0,0.103789621606334,2637.25608304849,11.30542228148
7.5,"random_instances_SVM","SVM",16,13,28740,25387,3353,1400,1270,130,0.573080183782414,0.207641196013289,2.0364361647441,399,130,269,31,2.1,4.64,9.8,0,0,0,0,0,0,0.123725219287984,2670.14118765366,14.2327637326426
7.5,"random_instances_SVM","SVM",16,14,28640,25295,3345,1500,1362,138,0.575396957580356,0.214285714285714,2.09908435772092,418,138,280,19,2,4.98,9.9,0,0,0,0,0,0,0.164543611847788,2627.09880512529,21.5395237250933
7.5,"random_instances_SVM","SVM",16,15,28540,25211,3329,1600,1446,154,0.572195416793463,0.22203765227021,2.22727674895019,459,154,305,41,2,5.31,9.4,0,0,0,0,0,0,0.18830367329198,2726.74698695226,24.8338119816912
7.5,"random_instances_SVM","SVM",16,16,28440,25118,3322,1700,1539,161,0.589003526795753,0.23421926910299,2.34154943893316,498,161,337,39,2.1,5.64,9.6,0,0,0,0,0,0,0.257926741850217,2692.14635145279,34.7965186458657
7.5,"random_instances_SVM","SVM",16,17,28340,25030,3310,1800,1627,173,0.57972925195113,0.233111849390919,2.36041114282052,530,173,357,32,2.1,5.97,9.4,0,0,0,0,0,0,0.31542593910333,2721.48948915852,41.7148196531423
7.5,"random_instances_SVM","SVM",16,18,28240,24943,3297,1900,1714,186,0.582844302966324,0.223698781838317,2.27722133236012,588,186,402,58,2.2,6.3,9.2,0,0,0,0,0,0,0.34135934852441,2745.50904415209,45.9811612031182
7.5,"random_instances_SVM","SVM",16,19,28140,24856,3284,2000,1801,199,0.595441588306191,0.239202657807309,2.47741036821705,591,199,392,3,2,6.64,9.1,0,0,0,0,0,0,0.243954946045564,2766.27640478573,30.5523403738201
7.5,"random_instances_SVM","SVM",16,20,28040,24766,3274,2100,1891,209,0.59141038019184,0.231450719822813,2.35613853201062,620,209,411,29,2,6.97,9,0,0,0,0,0,0,0.248392201483131,2773.52842333362,31.0120390859965
7.5,"random_instances_SVM","SVM",16,21,27940,24682,3258,2200,1975,225,0.602822647129659,0.239756367663344,2.34884398547189,672,225,447,52,2,7.3,8.8,0,0,0,0,0,0,0.301895330208188,2841.98199779391,39.7904167472263
7.5,"random_instances_SVM","SVM",16,22,27840,24590,3250,2300,2067,233,0.601234816808242,0.235880398671096,2.34679259334484,669,233,436,-3,1.9,7.63,8.9,0,0,0,0,0,0,0.529991812381071,2828.09682264078,67.5214299847776
7.5,"random_instances_SVM","SVM",16,23,27740,24500,3240,2400,2157,243,0.595264267577321,0.24031007751938,2.30306353881047,712,243,469,43,1.9,7.96,8.9,0,0,0,0,0,0,0.482681022878199,2827.34203806749,62.8917370004952
7.5,"random_instances_SVM","SVM",16,24,27640,24408,3232,2500,2249,251,0.582736357720358,0.236434108527132,2.44153887816932,753,251,502,41,2,8.29,9,0,0,0,0,0,0,0.197092683764673,2752.07489751546,24.1707118756542
7.5,"random_instances_SVM","SVM",16,25,27540,24320,3220,2600,2337,263,0.576322798862445,0.229789590254707,2.44581103718624,799,263,536,46,2,8.63,8.9,0,0,0,0,0,0,0.460288739824815,2809.19257337247,60.3801152113477
7.5,"random_instances_SVM","SVM",16,26,27440,24227,3213,2700,2430,270,0.582230860068155,0.230343300110742,2.29377206867162,832,270,562,33,2.1,8.96,9,0,0,0,0,0,0,0.351849382038037,2740.44251276287,46.6485089184347
7.5,"random_instances_SVM","SVM",16,27,27340,24141,3199,2800,2516,284,0.594283702313228,0.236987818383167,2.43303917798423,851,284,567,19,2,9.29,8.9,0,0,0,0,0,0,0.167499013730869,2762.5182228727,19.5001426081529
7.5,"random_instances_SVM","SVM",16,28,27240,24053,3187,2900,2604,296,0.593174070266267,0.24031007751938,2.35725147503092,903,296,607,52,2.1,9.62,8.8,0,0,0,0,0,0,0.395082005974184,2778.27490667897,52.5817566330854
7.5,"random_instances_SVM","SVM",16,29,27140,23964,3176,3000,2693,307,0.585861823406424,0.241417497231451,2.3759959086994,936,307,629,33,2,9.95,8.8,0,0,0,0,0,0,0.339205806935102,2782.40858991517,44.2633099968173
7.5,"random_instances_SVM","SVM",16,30,27040,23877,3163,3100,2780,320,0.589375282542298,0.239202657807309,2.3780601970649,958,320,638,22,2,10.29,8.7,0,0,0,0,0,0,0.428175300004539,2812.63367290106,55.8121680257225
7.5,"random_instances_SVM","SVM",16,31,26940,23789,3151,3200,2868,332,0.597294982299238,0.252491694352159,2.40398796391874,983,332,651,25,2,10.62,8.6,0,0,0,0,0,0,0.252355891279527,2783.86604547061,32.2119109315585
7.5,"random_instances_SVM","SVM",16,32,26840,23704,3136,3300,2953,347,0.590751354846406,0.228682170542636,2.33542507248434,1092,347,745,109,2.1,10.95,8.5,0,0,0,0,0,0,0.259112256510364,2832.01956287093,33.5425415018227
7.5,"random_instances_SVM","SVM",16,33,26740,23616,3124,3400,3041,359,0.596963424260297,0.233111849390919,2.35202659739979,1067,359,708,-25,2,11.28,8.5,0,0,0,0,0,0,0.20009787542706,2805.57297402013,24.6002863395384
7.5,"random_instances_SVM","SVM",16,34,26640,23525,3115,3500,3132,368,0.592350789490494,0.230343300110742,2.41028112612795,1128,368,760,61,2.1,11.61,8.5,0,0,0,0,0,0,0.173210679473911,2792.48755418749,20.1195722455017
7.5,"random_instances_SVM","SVM",16,35,26540,23435,3105,3600,3222,378,0.593622214179898,0.235880398671096,2.39052164787922,1146,378,768,18,2,11.94,8.5,0,0,0,0,0,0,0.240680250399675,2783.89015286686,30.2800705981301
7.5,"random_instances_SVM","SVM",16,36,26440,23341,3099,3700,3316,384,0.609621068774814,0.249169435215947,2.37594529636776,1162,384,778,16,2,12.28,8.6,0,0,0,0,0,0,0.29232970351387,2744.71953572821,38.6523484057063
7.5,"random_instances_SVM","SVM",16,37,26340,23252,3088,3800,3405,395,0.602541263176438,0.251384274640089,2.44581103718624,1154,395,759,-8,1.9,12.61,8.6,0,0,0,0,0,0,0.241043925075,2746.58660824992,30.9980931037972
7.5,"random_instances_SVM","SVM",16,38,26240,23164,3076,3900,3493,407,0.587444749023133,0.232558139534884,2.37280175249412,1231,407,824,77,2,12.94,8.6,0,0,0,0,0,0,0.181910658468941,2737.13885350266,22.8727978926744
7.5,"random_instances_SVM","SVM",16,39,26140,23079,3061,4000,3578,422,0.600381690382479,0.241417497231451,2.40832653338773,1263,422,841,32,2,13.27,8.5,0,0,0,0,0,0,0.177379786180616,2754.1603188231,21.2778050943547
7.5,"random_instances_SVM","SVM",16,40,26040,22991,3049,4100,3666,434,0.594435435093229,0.24031007751938,2.31723001049032,1298,434,864,35,2,13.6,8.4,0,0,0,0,0,0,0.224089566870492,2752.45964828381,26.0037812950277
7.5,"random_instances_SVM","SVM",16,41,25940,22899,3041,4200,3758,442,0.592567222630602,0.239756367663344,2.29394529249052,1303,442,861,5,1.9,13.93,8.5,0,0,0,0,0,0,0.145031012655538,2727.00501827113,15.7723943077429
7.5,"random_instances_SVM","SVM",16,42,25840,22815,3025,4300,3842,458,0.565741535001433,0.215393133997785,2.2772341412818,1375,458,917,72,2,14.27,8.4,0,0,0,0,0,0,0.181687307323932,2744.19131757826,20.9250222432429
7.5,"random_instances_SVM","SVM",16,43,25740,22737,3003,4400,3920,480,0.564116345439812,0.212624584717608,2.27790903114471,1436,480,956,61,2,14.6,8.2,0,0,0,0,0,0,0.260237889055043,2820.82793849898,30.5987339643527
7.5,"random_instances_SVM","SVM",16,44,25640,22647,2993,4500,4010,490,0.573967497043608,0.217054263565891,2.24015848406546,1503,490,1013,67,2.1,14.93,8.2,0,0,0,0,0,0,0.211888298444065,2792.0970537127,25.5945069426622
7.5,"random_instances_SVM","SVM",16,45,25540,22554,2986,4600,4103,497,0.589088388622924,0.235880398671096,2.36094099147563,1493,497,996,-10,2,15.26,8.3,0,0,0,0,0,0,0.245654964342767,2745.88610996979,31.3377733800238
7.5,"random_instances_SVM","SVM",16,46,25440,22462,2978,4700,4195,505,0.576342542907816,0.216500553709856,2.27455580709337,1533,505,1028,40,2,15.59,8.3,0,0,0,0,0,0,0.264130128667116,2730.59455047644,34.9574992113842
7.5,"random_instances_SVM","SVM",16,47,25340,22374,2966,4800,4283,517,0.576842906273393,0.236434108527132,2.41700826003667,1558,517,1041,25,2,15.93,8.3,0,0,0,0,0,0,0.151458442482166,2725.03435380379,16.5767162609338
7.5,"random_instances_SVM","SVM",16,48,25240,22291,2949,4900,4366,534,0.581754456706904,0.241971207087486,2.43057123504177,1564,534,1030,6,1.9,16.26,8.2,0,0,0,0,0,0,0.346528272574525,2770.42422490929,43.7861860923081
7.5,"random_instances_SVM","SVM",17,0,30040,26532,3508,100,91,9,0.591635842373114,0.200338600451467,1.79568364188914,34,9,25,0,2.8,0.33,10.1,0,0,0,0,0,0,0.163433891927637,2769.97440638248,17.7106458292786
7.5,"random_instances_SVM","SVM",17,1,29940,26448,3492,200,175,25,0.638914894057624,0.252257336343115,2.48127085259078,70,25,45,36,1.8,0.66,7,0,0,0,0,0,0,0.805256160076296,3542.34458271848,84.3220689203327
7.5,"random_instances_SVM","SVM",17,2,29840,26358,3482,300,265,35,0.614135709553677,0.22234762979684,1.98820028729735,94,35,59,24,1.7,1,7.6,0,0,0,0,0,0,0.59643037478533,3488.98260937299,69.2644456029664
7.5,"random_instances_SVM","SVM",17,3,29740,26264,3476,400,359,41,0.577194295910158,0.186794582392777,1.58303489853878,119,41,78,25,1.9,1.33,8.8,0,0,0,0,0,0,0.429512923040918,3277.36910265871,49.9244311834428
7.5,"random_instances_SVM","SVM",17,4,29640,26173,3467,500,450,50,0.587514535877967,0.222911963882618,1.95186368130981,145,50,95,26,1.9,1.66,9,0,0,0,0,0,0,0.41532484539557,3089.3431699912,53.0759569739321
7.5,"random_instances_SVM","SVM",17,5,29540,26085,3455,600,538,62,0.580559274216893,0.212189616252822,1.90567158216252,190,62,128,45,2.1,1.99,8.7,0,0,0,0,0,0,0.711559874078337,3220.62554087767,82.8190016129879
7.5,"random_instances_SVM","SVM",17,6,29440,25990,3450,700,633,67,0.579712645785242,0.219525959367946,1.94380527212565,211,67,144,21,2.1,2.32,9.4,0,0,0,0,0,0,0.427142606210216,3009.67373815422,56.1069637857387
7.5,"random_instances_SVM","SVM",17,7,29340,25903,3437,800,720,80,0.577514738714033,0.218961625282167,1.93936527395498,251,80,171,40,2.1,2.65,9,0,0,0,0,0,0,0.72346340173734,3163.86009247499,82.0277286427453
7.5,"random_instances_SVM","SVM",17,8,29240,25810,3430,900,813,87,0.579642459411994,0.231941309255079,2.08363313069131,264,87,177,13,2,2.99,9.3,0,0,0,0,0,0,0.787503408474434,2974.77132722447,89.4729459888914
7.5,"random_instances_SVM","SVM",17,9,29140,25717,3423,1000,906,94,0.563346957297659,0.217832957110609,2.02715603415586,323,94,229,59,2.4,3.32,9.6,0,0,0,0,0,0,0.385418131198585,2817.76603678205,47.2990945247872
7.5,"random_instances_SVM","SVM",17,10,29040,25626,3414,1100,997,103,0.566448948876307,0.224040632054176,2.12813653812996,348,103,245,25,2.4,3.65,9.7,0,0,0,0,0,0,0.199017358881955,2747.9430753067,25.8064071293826
7.5,"random_instances_SVM","SVM",17,11,28940,25539,3401,1200,1084,116,0.572431594595359,0.23589164785553,2.11880915607303,391,116,275,43,2.4,3.98,9.3,0,0,0,0,0,0,0.252783874301423,2868.11389546051,33.8943882054098
7.5,"random_instances_SVM","SVM",17,12,28840,25456,3384,1300,1167,133,0.570584725476234,0.217832957110609,2.05551821879954,439,133,306,48,2.3,4.31,8.8,0,0,0,0,0,0,0.331468111731516,3044.00428267091,45.3916738739787
7.5,"random_instances_SVM","SVM",17,13,28740,25365,3375,1400,1258,142,0.556017403674507,0.217268623024831,1.87833016934011,459,142,317,20,2.2,4.64,8.9,0,0,0,0,0,0,0.181262787725456,2961.00372317896,22.3005194824823
7.5,"random_instances_SVM","SVM",17,14,28640,25275,3365,1500,1348,152,0.555005939108104,0.217268623024831,2.05912439111322,485,152,333,26,2.2,4.98,8.9,0,0,0,0,0,0,0.169988621444267,2930.03201859098,19.8226604219958
7.5,"random_instances_SVM","SVM",17,15,28540,25188,3352,1600,1435,165,0.563829138530582,0.226297968397291,2.08150617797315,523,165,358,38,2.2,5.31,8.7,0,0,0,0,0,0,0.253878975059142,2999.13521512786,36.856916074832
7.5,"random_instances_SVM","SVM",17,16,28440,25106,3334,1700,1517,183,0.566115627254846,0.225733634311512,2.06616318627412,582,183,399,59,2.2,5.64,8.3,0,0,0,0,0,0,0.269606419767618,3124.88459875925,35.243622919424
7.5,"random_instances_SVM","SVM",17,17,28340,25023,3317,1800,1600,200,0.435965946114859,0.0948081264108352,0.768299819943271,644,200,444,62,2.2,5.97,8,0,0,0,0,0,0,0.112081416671858,3148.73425882783,11.2604838736712
7.5,"random_instances_SVM","SVM",17,18,28240,24934,3306,1900,1689,211,0.571038475711532,0.22686230248307,2.22590927144519,668,211,457,24,2.2,6.3,8,0,0,0,0,0,0,0.118370101181004,3132.83028440542,15.8088903007794
7.5,"random_instances_SVM","SVM",17,19,28140,24843,3297,2000,1780,220,0.581305927379263,0.220090293453725,2.29644613463413,674,220,454,6,2.1,6.64,8.1,0,0,0,0,0,0,0.116440157967619,3092.78343158247,15.1847971932504
7.5,"random_instances_SVM","SVM",17,20,28040,24756,3284,2100,1867,233,0.566781591548574,0.224040632054176,2.20334938018055,700,233,467,26,2,6.97,8,0,0,0,0,0,0,0.151076140309054,3107.05076775852,37.5736319824747
7.5,"random_instances_SVM","SVM",17,21,27940,24662,3278,2200,1961,239,0.57714303524578,0.229119638826185,2.1992024872392,717,239,478,17,2,7.3,8.2,0,0,0,0,0,0,0.178814740595271,3038.65784384102,48.3847948052644
7.5,"random_instances_SVM","SVM",17,22,27840,24570,3270,2300,2053,247,0.566001266749468,0.225169300225734,2.06819542367319,738,247,491,21,2,7.63,8.3,0,0,0,0,0,0,0.115008430034529,2987.85292062396,16.1033516077952
7.5,"random_instances_SVM","SVM",17,23,27740,24480,3260,2400,2143,257,0.562162572857611,0.206546275395034,2.05501908981969,807,257,550,69,2.1,7.96,8.3,0,0,0,0,0,0,0.110236382859446,2967.71579371036,12.7026193268778
7.5,"random_instances_SVM","SVM",17,24,27640,24388,3252,2500,2235,265,0.558502782079205,0.198645598194131,2.00824773023339,792,265,527,-15,2,8.29,8.4,0,0,0,0,0,0,0.125175410258908,2925.7705313005,25.550710732239
7.5,"random_instances_SVM","SVM",17,25,27540,24296,3244,2600,2327,273,0.446163466015284,0.101580135440181,0.883544792934762,853,273,580,61,2.1,8.63,8.5,0,0,0,0,0,0,0.106368849022669,2891.88251185412,10.7591183154075
7.5,"random_instances_SVM","SVM",17,26,27440,24203,3237,2700,2420,280,0.554117321912046,0.197516930022573,1.99055040584026,872,280,592,19,2.1,8.96,8.6,0,0,0,0,0,0,0.107702696395586,2843.37343693021,13.3974045895636
7.5,"random_instances_SVM","SVM",17,27,27340,24112,3228,2800,2511,289,0.567659175820181,0.220654627539503,2.13191971560361,880,289,591,8,2,9.29,8.7,0,0,0,0,0,0,0.130248510819607,2827.22609269119,29.1819855997649
7.5,"random_instances_SVM","SVM",17,28,27240,24026,3214,2900,2597,303,0.444884113556291,0.105530474040632,0.838962544559411,990,303,687,110,2.3,9.62,8.6,0,0,0,0,0,0,0.106329632859091,2846.18061276654,10.802822930557
7.5,"random_instances_SVM","SVM",17,29,27140,23941,3199,3000,2682,318,0.437030326284312,0.103273137697517,0.840483782174206,1000,318,682,10,2.1,9.95,8.4,0,0,0,0,0,0,0.10652739120538,2876.91123599074,10.7030902833716
7.5,"random_instances_SVM","SVM",17,30,27040,23849,3191,3100,2774,326,0.550008703280022,0.190180586907449,1.84991108370107,972,326,646,-28,2,10.29,8.5,0,0,0,0,0,0,0.1104268829062,2838.94647900754,13.8003534589976
7.5,"random_instances_SVM","SVM",17,31,26940,23766,3174,3200,2857,343,0.552477277692089,0.195259593679458,1.83221116901206,1032,343,689,60,2,10.62,8.3,0,0,0,0,0,0,0.108422307966316,2885.35928091998,11.3603041857691
7.5,"random_instances_SVM","SVM",17,32,26840,23676,3164,3300,2947,353,0.547829191488628,0.173250564334086,1.69345573112616,1094,353,741,62,2.1,10.95,8.3,0,0,0,0,0,0,0.114469164535164,2864.00143796598,14.2667205131098
7.5,"random_instances_SVM","SVM",17,33,26740,23583,3157,3400,3040,360,0.541925176573465,0.180022573363431,1.69949839207576,1081,360,721,-13,2,11.28,8.4,0,0,0,0,0,0,0.113346558815176,2825.31411988215,13.986586863074
7.5,"random_instances_SVM","SVM",17,34,26640,23491,3149,3500,3132,368,0.44260004358854,0.110045146726862,0.908234681266151,1152,368,784,71,2.1,11.61,8.5,0,0,0,0,0,0,0.110459085422145,2801.55379728502,11.3430926295015
7.5,"random_instances_SVM","SVM",17,35,26540,23399,3141,3600,3224,376,0.56368269767563,0.204853273137698,1.83812159225188,1103,376,727,-49,1.9,11.94,8.6,0,0,0,0,0,0,0.113214958852465,2765.85925213688,14.5619712418655
7.5,"random_instances_SVM","SVM",17,36,26440,23309,3131,3700,3314,386,0.560193110974075,0.191309255079007,1.86072144789432,1168,386,782,65,2,12.28,8.6,0,0,0,0,0,0,0.109003019324807,2753.82118807582,12.3081637149178
7.5,"random_instances_SVM","SVM",17,37,26340,23223,3117,3800,3400,400,0.545818907784611,0.183972911963883,1.79610364118167,1261,400,861,93,2.2,12.61,8.5,0,0,0,0,0,0,0.113523990550913,2768.06463004098,14.1454960940122
7.5,"random_instances_SVM","SVM",17,38,26240,23129,3111,3900,3494,406,0.544825944583828,0.186794582392777,1.85057225280563,1221,406,815,-40,2,12.94,8.6,0,0,0,0,0,0,0.12113079526036,2726.86805823671,18.4557017729129
7.5,"random_instances_SVM","SVM",17,39,26140,23040,3100,4000,3583,417,0.522424355299545,0.169300225733634,1.76306353076324,1315,417,898,94,2.2,13.27,8.6,0,0,0,0,0,0,0.106660745035209,2724.36074189237,11.3801619824437
7.5,"random_instances_SVM","SVM",17,40,26040,22952,3088,4100,3671,429,0.558102329355871,0.184537246049661,1.78975137366201,1332,429,903,17,2.1,13.6,8.6,0,0,0,0,0,0,0.108848904157607,2721.22887159303,12.0775665893634
7.5,"random_instances_SVM","SVM",17,41,25940,22862,3078,4200,3761,439,0.552806780224314,0.18961625282167,1.77157868102224,1318,439,879,-14,2,13.93,8.6,0,0,0,0,0,0,0.108967527562834,2709.86961373585,12.3029360324507
7.5,"random_instances_SVM","SVM",17,42,25840,22770,3070,4300,3853,447,0.525702322023225,0.158577878103837,1.58146042029835,1344,447,897,26,2,14.27,8.6,0,0,0,0,0,0,0.10603488760318,2684.94816455671,11.1445554100082
7.5,"random_instances_SVM","SVM",17,43,25740,22680,3060,4400,3943,457,0.522109280437757,0.158013544018059,1.6648560323265,1406,457,949,62,2.1,14.6,8.6,0,0,0,0,0,0,0.105336657026961,2672.7881336653,10.917562867784
7.5,"random_instances_SVM","SVM",17,44,25640,22591,3049,4500,4032,468,0.516763022288034,0.147855530474041,1.53333129518181,1377,468,909,-29,1.9,14.93,8.6,0,0,0,0,0,0,0.108668781390617,2665.82597932201,12.1491402536052
7.5,"random_instances_SVM","SVM",17,45,25540,22503,3037,4600,4120,480,0.569790821693168,0.187358916478555,1.89584580503376,1432,480,952,55,2,15.26,8.6,0,0,0,0,0,0,0.106538801102648,2663.50060874006,11.2554658765913
7.5,"random_instances_SVM","SVM",17,46,25440,22413,3027,4700,4210,490,0.564729128125683,0.19920993227991,2.00385386696311,1399,490,909,-33,1.9,15.59,8.6,0,0,0,0,0,0,0.105975847467786,2650.97896381217,10.967442189365
7.5,"random_instances_SVM","SVM",17,47,25340,22320,3020,4800,4303,497,0.580129138683354,0.211060948081264,1.93263068500478,1445,497,948,46,1.9,15.93,8.7,0,0,0,0,0,0,0.109832816326976,2619.6913059208,12.7773384237909
7.5,"random_instances_SVM","SVM",17,48,25240,22230,3010,4900,4393,507,0.552850699750505,0.181715575620767,1.92581965175366,1491,507,984,46,1.9,16.26,8.7,0,0,0,0,0,0,0.109210117642441,2612.5387517643,12.4126721490583
7.5,"random_instances_SVM","SVM",18,0,30040,26469,3571,100,86,14,0.638661082351562,0.247065727699531,2.44912348803469,48,14,34,0,2.4,0.33,6.1,0,0,0,0,0,0,0.886561425724987,4539.48837778769,91.530906699751
7.5,"random_instances_SVM","SVM",18,1,29940,26385,3555,200,170,30,0.644112677988074,0.261737089201878,2.49183710961421,84,30,54,36,1.8,0.66,5.7,0,0,0,0,0,0,0.771678292617467,4665.87058873005,84.2133494864589
7.5,"random_instances_SVM","SVM",18,2,29840,26296,3544,300,259,41,0.644840988651539,0.240610328638498,2.50154832967449,109,41,68,25,1.7,1,6.3,0,0,0,0,0,0,0.908265636298012,4396.30140595047,94.8272900785471
7.5,"random_instances_SVM","SVM",18,3,29740,26204,3536,400,351,49,0.63706138040181,0.244718309859155,2.43397707307238,135,49,86,26,1.8,1.33,7.2,0,0,0,0,0,0,0.968694254812716,3701.16282875648,98.6079102595186
7.5,"random_instances_SVM","SVM",18,4,29640,26117,3523,500,438,62,0.625032861566802,0.241784037558685,2.2826969838864,174,62,112,39,1.8,1.66,7.1,0,0,0,0,0,0,0.920883748033766,3907.84919182106,95.8629568411885
7.5,"random_instances_SVM","SVM",18,5,29540,26029,3511,600,526,74,0.621599870538156,0.25,2.53252725635776,204,74,130,30,1.8,1.99,7.1,0,0,0,0,0,0,0.890995946948933,3765.5449137594,94.2186865248037
7.5,"random_instances_SVM","SVM",18,6,29440,25941,3499,700,614,86,0.636733445233888,0.261150234741784,2.60769113074481,229,86,143,25,1.7,2.32,7.1,0,0,0,0,0,0,0.739991614153318,3666.07738726229,82.7164912570956
7.5,"random_instances_SVM","SVM",18,7,29340,25849,3491,800,706,94,0.623035923202371,0.244131455399061,2.44948011175437,256,94,162,27,1.7,2.65,7.5,0,0,0,0,0,0,0.874033549619314,3591.85346379226,92.8165508806981
7.5,"random_instances_SVM","SVM",18,8,29240,25763,3477,900,792,108,0.619155338755554,0.251760563380282,2.5414289338845,293,108,185,37,1.7,2.99,7.3,0,0,0,0,0,0,0.887728075448926,3686.5679720199,94.0238891255214
7.5,"random_instances_SVM","SVM",18,9,29140,25673,3467,1000,882,118,0.621515905612969,0.258215962441315,2.55039340984177,319,118,201,26,1.7,3.32,7.5,0,0,0,0,0,0,0.648364087252879,3589.28056955671,76.6259104756081
7.5,"random_instances_SVM","SVM",18,10,29040,25583,3457,1100,972,128,0.626716023554611,0.267605633802817,2.58843860391942,366,128,238,47,1.9,3.65,7.6,0,0,0,0,0,0,0.774809908607525,3547.83342702597,88.2663759010241
7.5,"random_instances_SVM","SVM",18,11,28940,25493,3447,1200,1062,138,0.629105149462387,0.256455399061033,2.53259591532647,399,138,261,33,1.9,3.98,7.7,0,0,0,0,0,0,0.406762058102967,3404.57228418841,52.8649951286026
7.5,"random_instances_SVM","SVM",18,12,28840,25409,3431,1300,1146,154,0.627672938330709,0.256455399061033,2.52141941084577,446,154,292,47,1.9,4.31,7.4,0,0,0,0,0,0,0.788123678928909,3580.54742872383,88.6290926805575
7.5,"random_instances_SVM","SVM",18,13,28740,25316,3424,1400,1239,161,0.621890509913169,0.247652582159624,2.50123249841841,463,161,302,17,1.9,4.64,7.7,0,0,0,0,0,0,0.44079063701301,3384.06036961087,56.5548286020026
7.5,"random_instances_SVM","SVM",18,14,28640,25224,3416,1500,1331,169,0.612675858773502,0.243544600938967,2.45287010954617,506,169,337,43,2,4.98,7.9,0,0,0,0,0,0,0.866199402343167,3362.49630488277,93.6534203169161
7.5,"random_instances_SVM","SVM",18,15,28540,25134,3406,1600,1421,179,0.613997214252325,0.232394366197183,2.43770218484049,517,179,338,11,1.9,5.31,7.9,0,0,0,0,0,0,0.801455411953582,3308.3370840219,89.9558923195337
7.5,"random_instances_SVM","SVM",18,16,28440,25042,3398,1700,1513,187,0.60675572787866,0.228286384976526,2.3942324173596,568,187,381,51,2,5.64,8.1,0,0,0,0,0,0,0.271921741469358,3152.14117255857,33.9508687360609
7.5,"random_instances_SVM","SVM",18,17,28340,24954,3386,1800,1601,199,0.595784881729967,0.221830985915493,2.3283181124438,624,199,425,56,2.1,5.97,8,0,0,0,0,0,0,0.511043064885326,3213.55882751254,64.4469019781292
7.5,"random_instances_SVM","SVM",18,18,28240,24865,3375,1900,1690,210,0.596126009818174,0.221244131455399,2.31922013562859,661,210,451,37,2.1,6.3,8,0,0,0,0,0,0,0.349011882848535,3158.99192613442,45.04239073112
7.5,"random_instances_SVM","SVM",18,19,28140,24774,3366,2000,1781,219,0.582929489482718,0.219483568075117,2.20719350144681,671,219,452,10,2.1,6.64,8.1,0,0,0,0,0,0,0.118844490681826,3081.33724009544,12.2987431114921
7.5,"random_instances_SVM","SVM",18,20,28040,24684,3356,2100,1871,229,0.580973556734027,0.216549295774648,2.17371101049754,722,229,493,51,2.2,6.97,8.2,0,0,0,0,0,0,0.243748238881732,3065.64376740772,31.5105030250623
7.5,"random_instances_SVM","SVM",18,21,27940,24598,3342,2200,1957,243,0.571530147820418,0.209507042253521,2.16390834628172,755,243,512,33,2.1,7.3,8.1,0,0,0,0,0,0,0.242157425355737,3102.49378572983,32.5004399670981
7.5,"random_instances_SVM","SVM",18,22,27840,24509,3331,2300,2046,254,0.585301712647397,0.215962441314554,2.22685840726446,777,254,523,22,2.1,7.63,8.1,0,0,0,0,0,0,0.201770296548085,3090.44851280536,25.0853688764372
7.5,"random_instances_SVM","SVM",18,23,27740,24422,3318,2400,2133,267,0.579512808503598,0.205985915492958,2.09080120030322,832,267,565,55,2.1,7.96,8,0,0,0,0,0,0,0.219158827487982,3112.57737000269,30.2713522960717
7.5,"random_instances_SVM","SVM",18,24,27640,24340,3300,2500,2215,285,0.579843970558843,0.214788732394366,2.16373973004695,842,285,557,10,2,8.29,7.8,0,0,0,0,0,0,0.1522163845811,3154.78528155139,17.2874926997383
7.5,"random_instances_SVM","SVM",18,25,27540,24249,3291,2600,2306,294,0.586937261583516,0.224765258215962,2.2189617462458,895,294,601,53,2,8.63,7.8,0,0,0,0,0,0,0.459232191780194,3166.24663697046,63.5018356152684
7.5,"random_instances_SVM","SVM",18,26,27440,24160,3280,2700,2395,305,0.596777226411768,0.211854460093897,2.16551032653319,911,305,606,16,2,8.96,7.9,0,0,0,0,0,0,0.159626336015305,3105.53332823343,18.870458375359
7.5,"random_instances_SVM","SVM",18,27,27340,24071,3269,2800,2484,316,0.574979756221176,0.214788732394366,2.13787874966901,940,316,624,29,2,9.29,7.9,0,0,0,0,0,0,0.154474344735181,3090.3160957105,18.0159301345734
7.5,"random_instances_SVM","SVM",18,28,27240,23981,3259,2900,2574,326,0.567874106437582,0.20481220657277,2.13596651465142,976,326,650,36,2,9.62,7.9,0,0,0,0,0,0,0.21368723916098,3075.98296476062,28.8040500558408
7.5,"random_instances_SVM","SVM",18,29,27140,23892,3248,3000,2663,337,0.577544451141156,0.201291079812207,2.07825533169119,1023,337,686,47,2,9.95,7.9,0,0,0,0,0,0,0.234648572242665,3065.27727493525,32.4843724441515
7.5,"random_instances_SVM","SVM",18,30,27040,23803,3237,3100,2752,348,0.592599614670146,0.224765258215962,2.28952943428895,1064,348,716,41,2.1,10.29,7.9,0,0,0,0,0,0,0.194463928927561,3049.23708473621,25.3467372299286
7.5,"random_instances_SVM","SVM",18,31,26940,23720,3220,3200,2835,365,0.576605317172731,0.215962441314554,2.27248593020372,1106,365,741,42,2,10.62,7.8,0,0,0,0,0,0,0.140928642666663,3074.02088536264,18.1701374800804
7.5,"random_instances_SVM","SVM",18,32,26840,23631,3209,3300,2924,376,0.579950874921102,0.219483568075117,2.338647829003,1143,376,767,37,2,10.95,7.8,0,0,0,0,0,0,0.303841698275621,3069.22235252772,47.580990302727
7.5,"random_instances_SVM","SVM",18,33,26740,23544,3196,3400,3011,389,0.602145669332824,0.231220657276995,2.31716043746195,1154,389,765,11,2,11.28,7.7,0,0,0,0,0,0,0.240527731395157,3072.97586245899,36.2985794806433
7.5,"random_instances_SVM","SVM",18,34,26640,23453,3187,3500,3102,398,0.591815942035093,0.222417840375587,2.39358250955005,1219,398,821,65,2.1,11.61,7.8,0,0,0,0,0,0,0.127088405959015,3028.90032068533,14.4203136860442
7.5,"random_instances_SVM","SVM",18,35,26540,23366,3174,3600,3189,411,0.604967593270657,0.216549295774648,2.17564836433933,1228,411,817,9,2,11.94,7.8,0,0,0,0,0,0,0.11707822734679,3029.14303183517,12.1425691875074
7.5,"random_instances_SVM","SVM",18,36,26440,23280,3160,3700,3275,425,0.584466234202295,0.211267605633803,2.27429577464789,1271,425,846,43,2,12.28,7.7,0,0,0,0,0,0,0.129571639888934,3035.16756318062,14.410431062002
7.5,"random_instances_SVM","SVM",18,37,26340,23192,3148,3800,3363,437,0.602035691744538,0.225352112676056,2.28244737240648,1296,437,859,25,2,12.61,7.7,0,0,0,0,0,0,0.126007350294778,3028.11454415082,13.6550014757132
7.5,"random_instances_SVM","SVM",18,38,26240,23103,3137,3900,3452,448,0.591588391599936,0.223591549295775,2.28475858149195,1337,448,889,41,2,12.94,7.7,0,0,0,0,0,0,0.206442779939017,3019.73292178865,31.3160972783057
7.5,"random_instances_SVM","SVM",18,39,26140,23014,3126,4000,3541,459,0.605877180366056,0.221830985915493,2.28065299554138,1347,459,888,10,1.9,13.27,7.7,0,0,0,0,0,0,0.162068121009636,2994.34786936642,21.7337576639024
7.5,"random_instances_SVM","SVM",18,40,26040,22929,3111,4100,3626,474,0.605710831031923,0.22887323943662,2.33374119193395,1412,474,938,65,2,13.6,7.6,0,0,0,0,0,0,0.13830230468687,3008.89890631875,16.2152243817315
7.5,"random_instances_SVM","SVM",18,41,25940,22850,3090,4200,3705,495,0.585705227223797,0.216549295774648,2.2289685046001,1458,495,963,46,1.9,13.93,7.5,0,0,0,0,0,0,0.133586898048503,3057.226411344,14.8988128729464
7.5,"random_instances_SVM","SVM",18,42,25840,22762,3078,4300,3793,507,0.590573700174675,0.21537558685446,2.26052037575468,1464,507,957,6,1.9,14.27,7.5,0,0,0,0,0,0,0.136861017625595,3045.25663221057,15.3192719239792
7.5,"random_instances_SVM","SVM",18,43,25740,22675,3065,4400,3880,520,0.600493415218119,0.230633802816901,2.29418625647745,1495,520,975,31,1.9,14.6,7.5,0,0,0,0,0,0,0.155205195672856,3041.38376706732,19.1075322399852
7.5,"random_instances_SVM","SVM",18,44,25640,22584,3056,4500,3971,529,0.596542475847085,0.222417840375587,2.30588321596244,1530,529,1001,35,1.9,14.93,7.5,0,0,0,0,0,0,0.180152965364247,3016.74428313658,24.8041253970349
7.5,"random_instances_SVM","SVM",18,45,25540,22494,3046,4600,4061,539,0.603338388351102,0.223004694835681,2.26437714900763,1552,539,1013,22,1.9,15.26,7.5,0,0,0,0,0,0,0.190253011323727,2994.29242288439,26.6364660585786
7.5,"random_instances_SVM","SVM",18,46,25440,22399,3041,4700,4156,544,0.60845548528697,0.235915492957746,2.21898964964162,1540,544,996,-12,1.8,15.59,7.6,0,0,0,0,0,0,0.292016879143152,2957.92201381129,45.4365232138295
7.5,"random_instances_SVM","SVM",18,47,25340,22307,3033,4800,4248,552,0.577025602782558,0.196596244131455,2.1774690968851,1581,552,1029,41,1.9,15.93,7.7,0,0,0,0,0,0,0.188033459488505,2908.19852914247,28.2966703036618
7.5,"random_instances_SVM","SVM",18,48,25240,22221,3019,4900,4334,566,0.578149613247677,0.196009389671362,2.17163659037559,1635,566,1069,54,1.9,16.26,7.7,0,0,0,0,0,0,0.145266703637931,2910.88659000177,17.3741087517499
7.5,"random_instances_SVM","SVM",19,0,30040,26508,3532,100,92,8,0.442814170775865,0.109205260148656,0.936956080836618,31,8,23,0,2.9,0.33,11.5,0,0,0,0,0,0,0.0845788278334048,2465.2554105781,8.47795330838661
7.5,"random_instances_SVM","SVM",19,1,29940,26424,3516,200,176,24,0.602226815606302,0.216123499142367,2.02616224355355,69,24,45,38,1.9,0.66,7.3,0,0,0,0,0,0,0.531488811596751,3584.01637285476,60.2659943722246
7.5,"random_instances_SVM","SVM",19,2,29840,26332,3508,300,268,32,0.420947706923097,0.0954831332189823,0.909861535784424,110,32,78,41,2.4,1,8.4,0,0,0,0,0,0,0.114280195741473,3164.31702571528,11.6675770000301
7.5,"random_instances_SVM","SVM",19,3,29740,26240,3500,400,360,40,0.431848653688396,0.0903373356203545,0.903819579442221,128,40,88,18,2.2,1.33,9,0,0,0,0,0,0,0.100949636036937,2973.88456835375,10.14560865018
7.5,"random_instances_SVM","SVM",19,4,29640,26147,3493,500,453,47,0.448581594526874,0.111492281303602,0.86169239565466,158,47,111,30,2.4,1.66,9.6,0,0,0,0,0,0,0.166018200995156,2499.98992833579,23.7604604196154
7.5,"random_instances_SVM","SVM",19,5,29540,26057,3483,600,543,57,0.443379574181786,0.10062893081761,0.901415803964981,185,57,128,27,2.2,1.99,9.5,0,0,0,0,0,0,0.19010707113787,2611.37714094235,30.7513490870454
7.5,"random_instances_SVM","SVM",19,6,29440,25967,3473,700,633,67,0.455557635654112,0.128073184676958,1.22220420079474,233,67,166,48,2.5,2.32,9.4,0,0,0,0,0,0,0.12639848745261,2780.36436520247,15.0330853076919
7.5,"random_instances_SVM","SVM",19,7,29340,25877,3463,800,723,77,0.457698434750154,0.13093196112064,1.06656494208368,254,77,177,21,2.3,2.65,9.4,0,0,0,0,0,0,0.0994525375275105,2821.68096633934,10.1603540793078
7.5,"random_instances_SVM","SVM",19,8,29240,25785,3455,900,815,85,0.444214031326285,0.118925100057176,0.95829468216303,297,85,212,43,2.5,2.99,9.6,0,0,0,0,0,0,0.161491216320016,2706.57540655826,22.0615772794729
7.5,"random_instances_SVM","SVM",19,9,29140,25689,3451,1000,911,89,0.457302557946126,0.114351057747284,1.01330075252029,308,89,219,11,2.5,3.32,10.2,0,0,0,0,0,0,0.120779056195415,2579.80495322839,14.2957377889318
7.5,"random_instances_SVM","SVM",19,10,29040,25598,3442,1100,1002,98,0.467046947023323,0.110348770726129,0.975500825269426,352,98,254,44,2.6,3.65,10.2,0,0,0,0,0,0,0.188547696778192,2543.43438179831,25.0106106594392
7.5,"random_instances_SVM","SVM",19,11,28940,25512,3428,1200,1088,112,0.47326621281605,0.110920526014866,0.941017868900847,383,112,271,31,2.4,3.98,9.7,0,0,0,0,0,0,0.120475905466158,2692.39143341984,13.1778899371089
7.5,"random_instances_SVM","SVM",19,12,28840,25424,3416,1300,1176,124,0.475273450700678,0.109777015437393,0.937632912537894,429,124,305,46,2.5,4.31,9.5,0,0,0,0,0,0,0.0992237601347068,2750.35397719955,10.059980472602
7.5,"random_instances_SVM","SVM",19,13,28740,25332,3408,1400,1268,132,0.471007002607447,0.110348770726129,0.92988388020287,439,132,307,10,2.3,4.64,9.6,0,0,0,0,0,0,0.11642022612793,2706.72758535888,12.7321886804888
7.5,"random_instances_SVM","SVM",19,14,28640,25250,3390,1500,1350,150,0.448171254314022,0.0966266437964551,0.781226106667869,505,150,355,66,2.4,4.98,9,0,0,0,0,0,0,0.101872021572667,2863.97715312042,10.2871551454958
7.5,"random_instances_SVM","SVM",19,15,28540,25160,3380,1600,1440,160,0.542598301180364,0.176672384219554,1.61234587712964,537,160,377,32,2.4,5.31,9,0,0,0,0,0,0,0.141845239137568,2876.54981755088,35.6794308908969
7.5,"random_instances_SVM","SVM",19,16,28440,25072,3368,1700,1528,172,0.552858265717979,0.194396798170383,1.84702887288244,553,172,381,16,2.2,5.64,8.9,0,0,0,0,0,0,0.220118136108749,2918.37783442384,62.1675575515876
7.5,"random_instances_SVM","SVM",19,17,28340,24980,3360,1800,1620,180,0.540718701805628,0.200686106346484,1.89800087148603,565,180,385,12,2.1,5.97,9,0,0,0,0,0,0,0.339959223882385,2883.56810527794,72.0993819984644
7.5,"random_instances_SVM","SVM",19,18,28240,24889,3351,1900,1711,189,0.539678666832507,0.188679245283019,1.86497029094869,626,189,437,61,2.3,6.3,9.1,0,0,0,0,0,0,0.242116896365541,2829.09112004166,60.1225605464651
7.5,"random_instances_SVM","SVM",19,19,28140,24795,3345,2000,1805,195,0.540380464046246,0.192681532304174,1.84485684708443,618,195,423,-8,2.2,6.64,9.3,0,0,0,0,0,0,0.296155455668298,2787.70852822356,68.1169892083857
7.5,"random_instances_SVM","SVM",19,20,28040,24701,3339,2100,1899,201,0.538663867718095,0.189251000571755,1.84811343463444,652,201,451,34,2.2,6.97,9.4,0,0,0,0,0,0,0.123360309245684,2700.42038095545,26.687309780064
7.5,"random_instances_SVM","SVM",19,21,27940,24612,3328,2200,1988,212,0.553285558591007,0.192681532304174,1.86332424479604,659,212,447,7,2.1,7.3,9.4,0,0,0,0,0,0,0.175509765873099,2726.52420187568,55.2326562213932
7.5,"random_instances_SVM","SVM",19,22,27840,24520,3320,2300,2080,220,0.545137251741162,0.192109777015437,1.90471351824637,699,220,479,40,2.2,7.63,9.5,0,0,0,0,0,0,0.1262203358586,2682.86977160545,30.7871459581601
7.5,"random_instances_SVM","SVM",19,23,27740,24435,3305,2400,2165,235,0.52747614202776,0.1789594053745,1.83664453780745,722,235,487,23,2.1,7.96,9.2,0,0,0,0,0,0,0.170198865445601,2750.67196676734,52.2269867824124
7.5,"random_instances_SVM","SVM",19,24,27640,24343,3297,2500,2257,243,0.542596198192128,0.189822755860492,1.87657455053681,768,243,525,46,2.2,8.29,9.3,0,0,0,0,0,0,0.240332146377502,2724.0127826291,66.7590933900271
7.5,"random_instances_SVM","SVM",19,25,27540,24259,3281,2600,2341,259,0.548636366640635,0.19496855345912,1.86457036637651,804,259,545,36,2.1,8.63,9,0,0,0,0,0,0,0.192045489370525,2775.83446639289,54.5672713981573
7.5,"random_instances_SVM","SVM",19,26,27440,24170,3270,2700,2430,270,0.539368840873231,0.198970840480274,1.97790603273045,830,270,560,26,2.1,8.96,9,0,0,0,0,0,0,0.150840986423727,2769.12876181687,48.8749306433958
7.5,"random_instances_SVM","SVM",19,27,27340,24082,3258,2800,2518,282,0.54469090321971,0.193825042881647,1.94303187255462,870,282,588,40,2.1,9.29,8.9,0,0,0,0,0,0,0.254970871920855,2783.92225691119,69.3820635481758
7.5,"random_instances_SVM","SVM",19,28,27240,23993,3247,2900,2607,293,0.55057077246363,0.204688393367639,1.97375174405747,856,293,563,-14,1.9,9.62,8.9,0,0,0,0,0,0,0.157260396224489,2781.33523506804,48.5912571856597
7.5,"random_instances_SVM","SVM",19,29,27140,23903,3237,3000,2697,303,0.542004271383679,0.190966266437965,1.88758975361573,910,303,607,54,2,9.95,8.9,0,0,0,0,0,0,0.311956418701307,2769.56863543466,75.8694332018489
7.5,"random_instances_SVM","SVM",19,30,27040,23814,3226,3100,2786,314,0.535835563144626,0.19496855345912,1.91487199034369,921,314,607,11,1.9,10.29,8.9,0,0,0,0,0,0,0.311379051664655,2759.02760960836,75.178828359376
7.5,"random_instances_SVM","SVM",19,31,26940,23723,3217,3200,2877,323,0.525295171564785,0.182389937106918,1.85359608665269,929,323,606,8,1.9,10.62,8.9,0,0,0,0,0,0,0.255852465422963,2746.24102688007,69.4066961577394
7.5,"random_instances_SVM","SVM",19,32,26840,23634,3206,3300,2966,334,0.547948946999459,0.197255574614065,1.9413016571739,990,334,656,61,2,10.95,8.9,0,0,0,0,0,0,0.220556668774438,2755.94243063149,67.7068935419175
7.5,"random_instances_SVM","SVM",19,33,26740,23542,3198,3400,3058,342,0.542977697423603,0.187535734705546,1.8415509791373,1021,342,679,31,2,11.28,8.9,0,0,0,0,0,0,0.127778486931912,2698.42022819562,28.1515269035198
7.5,"random_instances_SVM","SVM",19,34,26640,23451,3189,3500,3149,351,0.534672353146829,0.189822755860492,1.76796834077227,1031,351,680,10,1.9,11.61,9,0,0,0,0,0,0,0.10971845473562,2673.21281202537,15.0939743326143
7.5,"random_instances_SVM","SVM",19,35,26540,23362,3178,3600,3238,362,0.525141610506154,0.166952544311035,1.78466069500032,1079,362,717,48,2,11.94,8.9,0,0,0,0,0,0,0.109259126569644,2670.11969460287,14.7255770221138
7.5,"random_instances_SVM","SVM",19,36,26440,23273,3167,3700,3327,373,0.528920852020961,0.186392224128073,1.77384770001669,1101,373,728,22,2,12.28,8.9,0,0,0,0,0,0,0.271663804873618,2684.9014020415,65.5193665121013
7.5,"random_instances_SVM","SVM",19,37,26340,23179,3161,3800,3421,379,0.536947872243724,0.189251000571755,1.85689723729677,1148,379,769,47,2,12.61,9,0,0,0,0,0,0,0.118564129410848,2630.34849814697,20.8451670422277
7.5,"random_instances_SVM","SVM",19,38,26240,23093,3147,3900,3507,393,0.523149565638516,0.179531160663236,1.87224349545625,1137,393,744,-11,1.9,12.94,8.9,0,0,0,0,0,0,0.130116948338141,2650.58012616493,24.6056592997981
7.5,"random_instances_SVM","SVM",19,39,26140,23004,3136,4000,3596,404,0.523500464245377,0.174957118353345,1.86457036637651,1176,404,772,39,1.9,13.27,8.9,0,0,0,0,0,0,0.120074903027326,2643.95518343368,19.0727337389652
7.5,"random_instances_SVM","SVM",19,40,26040,22919,3121,4100,3681,419,0.536683797007904,0.188107489994282,1.96607177618175,1216,419,797,40,1.9,13.6,8.8,0,0,0,0,0,0,0.131347996499578,2668.18055958004,25.1470177442308
7.5,"random_instances_SVM","SVM",19,41,25940,22833,3107,4200,3767,433,0.538703824494389,0.190966266437965,1.98496998284734,1264,433,831,48,1.9,13.93,8.7,0,0,0,0,0,0,0.118149820517186,2677.22952527609,18.6121268468505
7.5,"random_instances_SVM","SVM",19,42,25840,22749,3091,4300,3851,449,0.555381379489894,0.209834190966266,1.9808134676498,1298,449,849,34,1.9,14.27,8.6,0,0,0,0,0,0,0.119817119508208,2698.86477294135,18.6139581582298
7.5,"random_instances_SVM","SVM",19,43,25740,22654,3086,4400,3946,454,0.543403702752832,0.198399085191538,1.98852091304921,1317,454,863,19,1.9,14.6,8.7,0,0,0,0,0,0,0.129968583602951,2661.19066304482,25.2800690094869
7.5,"random_instances_SVM","SVM",19,44,25640,22562,3078,4500,4038,462,0.541779637906625,0.191538021726701,1.96364218848917,1370,462,908,53,2,14.93,8.7,0,0,0,0,0,0,0.278472595510925,2663.45283697661,65.9365683038813
7.5,"random_instances_SVM","SVM",19,45,25540,22474,3066,4600,4126,474,0.554685590813944,0.205260148656375,1.94303187255462,1369,474,895,-1,1.9,15.26,8.7,0,0,0,0,0,0,0.117807963527907,2637.41661109556,18.925931323563
7.5,"random_instances_SVM","SVM",19,46,25440,22385,3055,4700,4215,485,0.558425175979343,0.204688393367639,2.01574471126358,1403,485,918,34,1.9,15.59,8.7,0,0,0,0,0,0,0.169356816380101,2642.44708997482,48.5973348650416
7.5,"random_instances_SVM","SVM",19,47,25340,22293,3047,4800,4307,493,0.564938774287469,0.202401372212693,1.98319926921411,1434,493,941,31,1.9,15.93,8.7,0,0,0,0,0,0,0.127507420993244,2612.48665389246,26.4926354815633
7.5,"random_instances_SVM","SVM",19,48,25240,22204,3036,4900,4396,504,0.535789898257427,0.181818181818182,1.78681277734494,1457,504,953,23,1.9,16.26,8.7,0,0,0,0,0,0,0.119548556648261,2601.44198475511,20.4362872260394
7.5,"random_instances_SVM","SVM",20,0,30040,26527,3513,100,86,14,0.423616502500718,0.0828603859250851,0.728274235470233,45,14,31,0,2.2,0.33,6.1,0,0,0,0,0,0,0.147353808001996,4234.76323888358,14.7857990884244
7.5,"random_instances_SVM","SVM",20,1,29940,26443,3497,200,170,30,0.630954116120036,0.215096481271283,2.15895211102832,88,30,58,43,1.9,0.66,5.7,0,0,0,0,0,0,0.224833153561686,4533.99707942641,23.4754474126717
7.5,"random_instances_SVM","SVM",20,2,29840,26355,3485,300,258,42,0.595010937526255,0.185017026106697,1.85876653978975,129,42,87,41,2.1,1,6.1,0,0,0,0,0,0,0.185769430485259,4225.11208087736,20.2308281807461
7.5,"random_instances_SVM","SVM",20,3,29740,26263,3477,400,350,50,0.578958841656741,0.179909194097616,1.60089409822334,154,50,104,25,2.1,1.33,7,0,0,0,0,0,0,0.196161398234167,3757.24410702087,22.6292820011181
7.5,"random_instances_SVM","SVM",20,4,29640,26174,3466,500,439,61,0.428969660208767,0.0947786606129398,0.872946934030569,195,61,134,41,2.2,1.66,7.2,0,0,0,0,0,0,0.135774511848497,3583.87425657591,14.2614063231929
7.5,"random_instances_SVM","SVM",20,5,29540,26084,3456,600,529,71,0.586583213001651,0.191827468785471,1.72748592822966,222,71,151,27,2.1,1.99,7.5,0,0,0,0,0,0,0.18935090146259,3554.61471363953,22.9578816604209
7.5,"random_instances_SVM","SVM",20,6,29440,25993,3447,700,620,80,0.419559481524839,0.0947786606129398,0.912868580852374,257,80,177,35,2.2,2.32,7.8,0,0,0,0,0,0,0.117391911372958,3355.80535661187,11.9999445308134
7.5,"random_instances_SVM","SVM",20,7,29340,25906,3434,800,707,93,0.570481693790369,0.196935300794552,1.93875898600076,290,93,197,33,2.1,2.65,7.6,0,0,0,0,0,0,0.194285345381425,3452.61162402092,24.4630891014705
7.5,"random_instances_SVM","SVM",20,8,29240,25812,3428,900,801,99,0.569142402250739,0.209421112372304,1.97267787455161,326,99,227,36,2.3,2.99,8.1,0,0,0,0,0,0,0.289968099236916,3286.58067147111,41.4331160672546
7.5,"random_instances_SVM","SVM",20,9,29140,25720,3420,1000,893,107,0.571143727768556,0.219636776390465,2.02239172657334,349,107,242,23,2.3,3.32,8.3,0,0,0,0,0,0,0.202275376251445,3150.62154498813,27.7549632283888
7.5,"random_instances_SVM","SVM",20,10,29040,25630,3410,1100,983,117,0.427771815799929,0.107264472190692,0.880604363276451,401,117,284,52,2.4,3.65,8.4,0,0,0,0,0,0,0.120689071991771,3073.18969900603,12.4181474302186
7.5,"random_instances_SVM","SVM",20,11,28940,25541,3399,1200,1072,128,0.563574877727337,0.201475595913734,1.92847379244107,427,128,299,26,2.3,3.98,8.4,0,0,0,0,0,0,0.191921349744348,3123.19789544072,23.8429353669781
7.5,"random_instances_SVM","SVM",20,12,28840,25457,3383,1300,1156,144,0.568294060610666,0.207150964812713,2.07009231530901,477,144,333,50,2.3,4.31,8,0,0,0,0,0,0,0.136299964751083,3206.13151898929,15.0123198842919
7.5,"random_instances_SVM","SVM",20,13,28740,25366,3374,1400,1247,153,0.438286663740212,0.101589103291714,0.973364924186022,513,153,360,36,2.4,4.64,8.2,0,0,0,0,0,0,0.112082482636984,3137.2187347085,11.3385009604697
7.5,"random_instances_SVM","SVM",20,14,28640,25277,3363,1500,1336,164,0.565564604324573,0.204313280363224,1.99879836325164,546,164,382,33,2.3,4.98,8.1,0,0,0,0,0,0,0.1222658285437,3135.58435859362,12.9499474767478
7.5,"random_instances_SVM","SVM",20,15,28540,25184,3356,1600,1429,171,0.574527286418034,0.221906923950057,2.08948231459298,589,171,418,43,2.4,5.31,8.4,0,0,0,0,0,0,0.155093387299926,3048.1368387436,18.8907188909093
7.5,"random_instances_SVM","SVM",20,16,28440,25092,3348,1700,1521,179,0.558296558642905,0.212258796821793,2.02499769375469,630,179,451,41,2.5,5.64,8.5,0,0,0,0,0,0,0.129639888782465,2997.00252129198,14.4414102645618
7.5,"random_instances_SVM","SVM",20,17,28340,25006,3334,1800,1607,193,0.563470061011171,0.21850170261067,2.05703871193714,615,193,422,-15,2.2,5.97,8.3,0,0,0,0,0,0,0.114995561756333,3021.11861726526,11.9759670141899
7.5,"random_instances_SVM","SVM",20,18,28240,24920,3320,1900,1693,207,0.580381116650257,0.221906923950057,2.13453900480441,678,207,471,63,2.3,6.3,8.2,0,0,0,0,0,0,0.239190830849592,3098.71345665418,32.7439018516586
7.5,"random_instances_SVM","SVM",20,19,28140,24830,3310,2000,1783,217,0.557610090173934,0.204880817253121,2.02239172657334,711,217,494,33,2.3,6.64,8.2,0,0,0,0,0,0,0.185422492605984,3054.74179303394,24.6048159750901
7.5,"random_instances_SVM","SVM",20,20,28040,24740,3300,2100,1873,227,0.57144427626957,0.225312145289444,2.09655788372248,711,227,484,0,2.1,6.97,8.3,0,0,0,0,0,0,0.143520691024132,3040.88694821684,16.4408496706342
7.5,"random_instances_SVM","SVM",20,21,27940,24651,3289,2200,1962,238,0.58210069926993,0.240635641316686,2.23818898228385,766,238,528,55,2.2,7.3,8.2,0,0,0,0,0,0,0.184157530214303,3031.24912835001,23.9362042054179
7.5,"random_instances_SVM","SVM",20,22,27840,24560,3280,2300,2053,247,0.582202786828299,0.237230419977299,2.23065299244451,770,247,523,4,2.1,7.63,8.3,0,0,0,0,0,0,0.20193482087779,2989.87328535597,27.3668718047285
7.5,"random_instances_SVM","SVM",20,23,27740,24473,3267,2400,2140,260,0.581602500044988,0.238933030646992,2.18159283695569,803,260,543,33,2.1,7.96,8.2,0,0,0,0,0,0,0.15479825585743,2997.56392756469,18.7044408228628
7.5,"random_instances_SVM","SVM",20,24,27640,24385,3255,2500,2228,272,0.569190844801421,0.224177071509648,2.09300134764943,860,272,588,57,2.2,8.29,8.2,0,0,0,0,0,0,0.135768461287948,2994.97653067451,15.736995595879
7.5,"random_instances_SVM","SVM",20,25,27540,24289,3251,2600,2324,276,0.588940693610336,0.244040862656073,2.22311700260517,877,276,601,17,2.2,8.63,8.4,0,0,0,0,0,0,0.198647357205084,2934.67242009765,27.4527746649623
7.5,"random_instances_SVM","SVM",20,26,27440,24200,3240,2700,2413,287,0.576044186429107,0.241203178206583,2.2964535938674,905,287,618,28,2.2,8.96,8.4,0,0,0,0,0,0,0.146702889878533,2902.17635360413,17.213609989239
7.5,"random_instances_SVM","SVM",20,27,27340,24112,3228,2800,2501,299,0.582069740386311,0.261066969353008,2.38012788631614,947,299,648,42,2.2,9.29,8.4,0,0,0,0,0,0,0.205366230433148,2905.67688156303,28.0784599996088
7.5,"random_instances_SVM","SVM",20,28,27240,24019,3221,2900,2594,306,0.58017553431153,0.238365493757094,2.20853984390973,964,306,658,17,2.2,9.62,8.5,0,0,0,0,0,0,0.153111957471366,2871.29120603554,18.5838868655632
7.5,"random_instances_SVM","SVM",20,29,27140,23926,3214,3000,2687,313,0.590098368228033,0.251418842224745,2.28743564492328,1021,313,708,57,2.3,9.95,8.6,0,0,0,0,0,0,0.219565974854237,2807.61104574443,31.7823929934604
7.5,"random_instances_SVM","SVM",20,30,27040,23833,3207,3100,2780,320,0.58780161138004,0.25255391600454,2.33615685019526,1001,320,681,-20,2.1,10.29,8.7,0,0,0,0,0,0,0.136925537209911,2781.82828418072,15.5719456520334
7.5,"random_instances_SVM","SVM",20,31,26940,23742,3198,3200,2871,329,0.575254393752141,0.237230419977299,2.16282908389045,1071,329,742,70,2.3,10.62,8.7,0,0,0,0,0,0,0.165355339305018,2753.60540872636,20.9737064552916
7.5,"random_instances_SVM","SVM",20,32,26840,23651,3189,3300,2962,338,0.568174915816136,0.207150964812713,2.07216399658374,1094,338,756,23,2.2,10.95,8.8,0,0,0,0,0,0,0.162860195048849,2737.62551742635,20.8445279456528
7.5,"random_instances_SVM","SVM",20,33,26740,23560,3180,3400,3053,347,0.563122818326193,0.203745743473326,2.17419625656074,1081,347,734,-13,2.1,11.28,8.8,0,0,0,0,0,0,0.180619987457853,2711.05582111222,23.7223076121722
7.5,"random_instances_SVM","SVM",20,34,26640,23469,3171,3500,3144,356,0.565039838454331,0.211691259931896,2.17419625656074,1154,356,798,73,2.2,11.61,8.8,0,0,0,0,0,0,0.263907240549337,2716.03223351255,39.6527096458171
7.5,"random_instances_SVM","SVM",20,35,26540,23380,3160,3600,3233,367,0.568154916206757,0.214528944381385,2.13644979377322,1174,367,807,20,2.2,11.94,8.8,0,0,0,0,0,0,0.279511824204662,2702.58882984899,41.8081908536512
7.5,"random_instances_SVM","SVM",20,36,26440,23289,3151,3700,3324,376,0.573094350651911,0.225312145289444,2.12702316391306,1189,376,813,15,2.2,12.28,8.8,0,0,0,0,0,0,0.121938135173227,2685.72451210952,13.3409246401151
7.5,"random_instances_SVM","SVM",20,37,26340,23200,3140,3800,3413,387,0.555825178339801,0.200908059023837,2.17804098910992,1188,387,801,-1,2.1,12.61,8.8,0,0,0,0,0,0,0.299782519160711,2685.2232603917,45.0460807161191
7.5,"random_instances_SVM","SVM",20,38,26240,23108,3132,3900,3505,395,0.573472680149784,0.212258796821793,2.11941377959479,1263,395,868,75,2.2,12.94,8.9,0,0,0,0,0,0,0.262159921541694,2667.72865412935,38.0051046176507
7.5,"random_instances_SVM","SVM",20,39,26140,23024,3116,4000,3589,411,0.560877574331374,0.211691259931896,2.12514913469375,1279,411,868,16,2.1,13.27,8.7,0,0,0,0,0,0,0.150311271501709,2675.68655063397,18.335255357449
7.5,"random_instances_SVM","SVM",20,40,26040,22939,3101,4100,3674,426,0.552725153598284,0.20261066969353,2.16473634057819,1364,426,938,85,2.2,13.6,8.6,0,0,0,0,0,0,0.314414103951797,2691.73299313646,45.1847125161124
7.5,"random_instances_SVM","SVM",20,41,25940,22852,3088,4200,3761,439,0.574194286525232,0.216231555051078,2.11948052858004,1394,439,955,30,2.2,13.93,8.6,0,0,0,0,0,0,0.365220613401866,2728.76740312034,51.9195616646652
7.5,"random_instances_SVM","SVM",20,42,25840,22767,3073,4300,3846,454,0.565964980300174,0.196367763904654,2.18189934338646,1391,454,937,-3,2.1,14.27,8.5,0,0,0,0,0,0,0.132144174913186,2719.44931851985,14.6258580108869
7.5,"random_instances_SVM","SVM",20,43,25740,22683,3057,4400,3930,470,0.580094533761347,0.213393870601589,2.22672924047891,1404,470,934,13,2,14.6,8.4,0,0,0,0,0,0,0.311291758278597,2749.75885302337,43.9428326457366
7.5,"random_instances_SVM","SVM",20,44,25640,22595,3045,4500,4018,482,0.566600532919231,0.200340522133939,2.10625262354321,1468,482,986,64,2,14.93,8.3,0,0,0,0,0,0,0.332692393509921,2729.5625888779,46.9961952256353
7.5,"random_instances_SVM","SVM",20,45,25540,22508,3032,4600,4105,495,0.569946992080068,0.209988649262202,2.21363067736727,1475,495,980,7,2,15.26,8.3,0,0,0,0,0,0,0.276689955482138,2745.44642542166,37.8595358598773
7.5,"random_instances_SVM","SVM",20,46,25440,22417,3023,4700,4196,504,0.555490430080307,0.191259931895573,2.17047834678662,1476,504,972,1,1.9,15.59,8.3,0,0,0,0,0,0,0.359393024573223,2733.52763556601,50.0780519664192
7.5,"random_instances_SVM","SVM",20,47,25340,22325,3015,4800,4288,512,0.55945738884929,0.204313280363224,2.10789815439427,1531,512,1019,55,2,15.93,8.4,0,0,0,0,0,0,0.139153021753928,2691.32898942544,15.3851716367354
7.5,"random_instances_SVM","SVM",20,48,25240,22235,3005,4900,4378,522,0.562929048123497,0.200340522133939,2.01255258062362,1583,522,1061,52,2,16.26,8.4,0,0,0,0,0,0,0.308718223477454,2666.38265144363,43.4040874078454
7.5,"random_policy_SVM","SVM",1,0,30040,26573,3467,100,90,10,0.558458064304523,0.16832229580574,1.55436155885987,31,10,21,0,2.1,0.33,9,0,0,0,0,0,0,0.157773724712891,3009.97385058155,18.1507934823021
7.5,"random_policy_SVM","SVM",1,1,29940,26493,3447,200,170,30,0.528095976958963,0.178256070640177,1.88632941317467,77,30,47,46,1.6,0.66,5.7,0,0,0,0,0,0,0.644894969124441,3790.99636867826,75.1822099143124
7.5,"random_policy_SVM","SVM",1,2,29840,26436,3404,300,227,73,0.489152521998882,0.132450331125828,1.1720897120671,178,73,105,101,1.4,1,3.1,0,0,0,0,0,0,0.270068774307346,6930.74385171675,27.6331702589323
7.5,"random_policy_SVM","SVM",1,3,29740,26348,3392,400,315,85,0.536510666169191,0.151766004415011,1.28418363909465,208,85,123,30,1.4,1.33,3.7,0,0,0,0,0,0,0.23138307193051,5937.75995270516,24.8862414692864
7.5,"random_policy_SVM","SVM",1,4,29640,26262,3378,500,401,99,0.495983651905732,0.152869757174393,1.30395679233219,239,99,140,31,1.4,1.66,4.1,0,0,0,0,0,0,0.222507711903321,5511.16400229191,23.8960039922943
7.5,"random_policy_SVM","SVM",1,5,29540,26181,3359,600,482,118,0.515636594544392,0.175496688741722,1.49304065521547,283,118,165,44,1.4,1.99,4.1,0,0,0,0,0,0,0.223489653031867,5198.71912659171,24.2116988110668
7.5,"random_policy_SVM","SVM",1,6,29440,26101,3339,700,562,138,0.526644694835961,0.179911699779249,1.59530284396766,321,138,183,38,1.3,2.32,4.1,0,0,0,0,0,0,0.21186245159928,5132.06686282075,22.5041940431193
7.5,"random_policy_SVM","SVM",1,7,29340,26033,3307,800,630,170,0.533903790119989,0.174944812362031,1.34436399923149,399,170,229,78,1.3,2.65,3.7,0,0,0,0,0,0,0.235049707822651,5610.87890847661,24.5188568509161
7.5,"random_policy_SVM","SVM",1,8,29240,25945,3295,900,718,182,0.517990695478292,0.171633554083885,1.55858878154201,426,182,244,27,1.3,2.99,3.9,0,0,0,0,0,0,0.205087036760296,5539.48208132584,20.6900716064509
7.5,"random_policy_SVM","SVM",1,9,29140,25865,3275,1000,798,202,0.558008621575217,0.187086092715232,1.64044203579367,475,202,273,49,1.4,3.32,4,0,0,0,0,0,0,0.207468124541078,5506.66467232181,20.9585201155211
7.5,"random_policy_SVM","SVM",1,10,29040,25778,3262,1100,885,215,0.57699014722309,0.194812362030905,1.73914401704202,503,215,288,28,1.3,3.65,4.1,0,0,0,0,0,0,0.253869185143538,4849.53718430643,27.85325887278
7.5,"random_policy_SVM","SVM",1,11,28940,25710,3230,1200,953,247,0.589596229109738,0.199227373068433,1.81783771675388,567,247,320,64,1.3,3.98,3.9,0,0,0,0,0,0,0.231336458283828,4553.08859754952,24.6957838501724
7.5,"random_policy_SVM","SVM",1,12,28840,25625,3215,1300,1038,262,0.599670355943002,0.205849889624724,1.90529120595929,608,262,346,41,1.3,4.31,4,0,0,0,0,0,0,0.210201390520873,4367.87857190609,21.7590793229179
7.5,"random_policy_SVM","SVM",1,13,28740,25546,3194,1400,1117,283,0.58541555429801,0.187086092715232,1.75062784515309,660,283,377,52,1.3,4.64,3.9,0,0,0,0,0,0,0.215395396143871,4716.19566741087,22.9513859290432
7.5,"random_policy_SVM","SVM",1,14,28640,25457,3183,1500,1206,294,0.584729236353604,0.198675496688742,1.92333643124487,689,294,395,29,1.3,4.98,4.1,0,0,0,0,0,0,0.200205780458575,4690.96834315897,20.2871737196502
7.5,"random_policy_SVM","SVM",1,15,28540,25375,3165,1600,1288,312,0.586269820141325,0.194812362030905,1.89591515081408,734,312,422,45,1.4,5.31,4.1,0,0,0,0,0,0,0.194186534746751,4680.50335200435,19.5028853210851
7.5,"random_policy_SVM","SVM",1,16,28440,25302,3138,1700,1361,339,0.583246799583177,0.194812362030905,1.91044323626093,792,339,453,58,1.3,5.64,4,0,0,0,0,0,0,0.198124096838022,4875.99150691379,19.8983160817024
7.5,"random_policy_SVM","SVM",1,17,28340,25214,3126,1800,1449,351,0.584148598636073,0.194260485651214,1.85069569870894,831,351,480,39,1.4,5.97,4.1,0,0,0,0,0,0,0.192732848027138,4105.87986924309,19.4180008838068
7.5,"random_policy_SVM","SVM",1,18,28240,25134,3106,1900,1529,371,0.584747716865903,0.194260485651214,1.82257990210193,868,371,497,37,1.3,6.3,4.1,0,0,0,0,0,0,0.194775373020117,4848.21683530956,19.5261226170606
7.5,"random_policy_SVM","SVM",1,19,28140,25054,3086,2000,1609,391,0.586483802829927,0.192604856512141,1.78331618300834,917,391,526,49,1.3,6.64,4.1,0,0,0,0,0,0,0.194384676184766,4801.91848640611,19.5873368018585
7.5,"random_policy_SVM","SVM",1,20,28040,24975,3065,2100,1688,412,0.587764285893858,0.201986754966887,1.78743290445748,964,412,552,47,1.3,6.97,4.1,0,0,0,0,0,0,0.1962878549849,4746.91351512514,19.6751836772159
7.5,"random_policy_SVM","SVM",1,21,27940,24897,3043,2200,1766,434,0.588402030059306,0.199227373068433,1.77609627943341,1005,434,571,41,1.3,7.3,4.1,0,0,0,0,0,0,0.196092922506838,4361.29617233892,19.6497134598014
7.5,"random_policy_SVM","SVM",1,22,27840,24816,3024,2300,1847,453,0.58863149642036,0.19757174392936,1.77503970817854,1054,453,601,49,1.3,7.63,4.1,0,0,0,0,0,0,0.196328518496922,5210.30657016349,19.8183622390931
7.5,"random_policy_SVM","SVM",1,23,27740,24732,3008,2400,1931,469,0.591237664882388,0.202538631346578,1.80968862452617,1091,469,622,37,1.3,7.96,4.1,0,0,0,0,0,0,0.196781256263886,4910.783708189,19.962265100463
7.5,"random_policy_SVM","SVM",1,24,27640,24654,2986,2500,2009,491,0.59086959467908,0.201434878587196,1.88931492400533,1138,491,647,47,1.3,8.29,4.1,0,0,0,0,0,0,0.195697369341281,5167.44573718429,19.6035168723573
7.5,"random_policy_SVM","SVM",1,25,27540,24581,2959,2600,2082,518,0.593826684760916,0.204746136865342,1.86759866051101,1204,518,686,66,1.3,8.63,4,0,0,0,0,0,0,0.199056406335825,4578.79271214677,20.1194256749429
7.5,"random_policy_SVM","SVM",1,26,27440,24502,2938,2700,2161,539,0.594350881994943,0.204746136865342,1.79834138774536,1258,539,719,54,1.3,8.96,4,0,0,0,0,0,0,0.199209377664494,5287.10678993456,19.9275519398021
7.5,"random_policy_SVM","SVM",1,27,27340,24411,2929,2800,2252,548,0.59435117335437,0.200883002207506,1.84990113213771,1276,548,728,18,1.3,9.29,4.1,0,0,0,0,0,0,0.195346257553516,4285.33161238341,19.5551880758571
7.5,"random_policy_SVM","SVM",1,28,27240,24319,2921,2900,2344,556,0.594757078660563,0.201986754966887,1.79209172175841,1297,556,741,21,1.3,9.62,4.2,0,0,0,0,0,0,0.190520001903445,4326.23779342139,19.0729143887103
7.5,"random_policy_SVM","SVM",1,29,27140,24230,2910,3000,2433,567,0.59615348115413,0.205298013245033,1.75636439636474,1324,567,757,27,1.3,9.95,4.3,0,0,0,0,0,0,0.188592680190695,4409.27382248171,18.8740159637259
7.5,"random_policy_SVM","SVM",1,30,27040,24142,2898,3100,2521,579,0.597847153509965,0.205849889624724,1.90545078877941,1350,579,771,26,1.3,10.29,4.4,0,0,0,0,0,0,0.185825854819634,4842.75777313739,18.5889283817802
7.5,"random_policy_SVM","SVM",1,31,26940,24056,2884,3200,2607,593,0.596888955596332,0.206401766004415,1.81377025065065,1383,593,790,33,1.3,10.62,4.4,0,0,0,0,0,0,0.184585080309421,4570.82174260712,18.5109158181458
7.5,"random_policy_SVM","SVM",1,32,26840,23967,2873,3300,2696,604,0.599285053910653,0.205298013245033,1.70407349242,1397,604,793,14,1.3,10.95,4.5,0,0,0,0,0,0,0.181731291249424,4208.00357953546,18.2093743564133
7.5,"random_policy_SVM","SVM",1,33,26740,23885,2855,3400,2778,622,0.597699184543236,0.202538631346578,1.75789833906899,1442,622,820,45,1.3,11.28,4.5,0,0,0,0,0,0,0.181664083969819,4290.51263916086,18.2046168801523
7.5,"random_policy_SVM","SVM",1,34,26640,23805,2835,3500,2858,642,0.597077257032461,0.202538631346578,1.73156934797825,1489,642,847,47,1.3,11.61,4.5,0,0,0,0,0,0,0.182334681221995,4647.34700384179,18.2513952244418
7.5,"random_policy_SVM","SVM",1,35,26540,23719,2821,3600,2944,656,0.59948704923991,0.201986754966887,1.72308300143565,1531,656,875,42,1.3,11.94,4.5,0,0,0,0,0,0,0.181485306715122,4215.42803793116,18.1887939989911
7.5,"random_policy_SVM","SVM",1,36,26440,23632,2808,3700,3031,669,0.599722634148961,0.205298013245033,1.76208450492791,1569,669,900,38,1.3,12.28,4.5,0,0,0,0,0,0,0.179958939893925,3861.98910127729,18.0340217215431
7.5,"random_policy_SVM","SVM",1,37,26340,23552,2788,3800,3111,689,0.601704127997027,0.20364238410596,1.77813750871637,1610,689,921,41,1.3,12.61,4.5,0,0,0,0,0,0,0.179989680433637,4267.46575257466,18.023034347388
7.5,"random_policy_SVM","SVM",1,38,26240,23466,2774,3900,3197,703,0.600153929348168,0.209713024282561,1.84991378743771,1628,703,925,18,1.3,12.94,4.5,0,0,0,0,0,0,0.178710601394992,4197.71195183002,17.9354348260266
7.5,"random_policy_SVM","SVM",1,39,26140,23383,2757,4000,3280,720,0.59505139330576,0.198123620309051,1.74795003537421,1693,720,973,65,1.4,13.27,4.6,0,0,0,0,0,0,0.179150652407403,4489.37806331903,17.9215620249998
7.5,"random_policy_SVM","SVM",1,40,26040,23303,2737,4100,3360,740,0.596378077650455,0.198675496688742,1.75216457108013,1717,740,977,24,1.3,13.6,4.5,0,0,0,0,0,0,0.179860958325261,4235.92352887784,17.9975849516368
7.5,"random_policy_SVM","SVM",1,41,25940,23215,2725,4200,3448,752,0.593660235281893,0.193156732891832,1.74372071182371,1748,752,996,31,1.3,13.93,4.6,0,0,0,0,0,0,0.178492324717858,4476.47828469974,17.8556679748472
7.5,"random_policy_SVM","SVM",1,42,25840,23119,2721,4300,3544,756,0.592923470533661,0.198123620309051,1.9238852291282,1767,756,1011,19,1.3,14.27,4.7,0,0,0,0,0,0,0.174812684145146,4167.1980758657,17.4941483037213
7.5,"random_policy_SVM","SVM",1,43,25740,23032,2708,4400,3631,769,0.593929534639056,0.19205298013245,1.76054958811178,1820,769,1051,53,1.4,14.6,4.7,0,0,0,0,0,0,0.174478555060137,4108.90382841574,17.4598530050725
7.5,"random_policy_SVM","SVM",1,44,25640,22951,2689,4500,3712,788,0.596820985604012,0.198675496688742,1.81895729430682,1854,788,1066,34,1.4,14.93,4.7,0,0,0,0,0,0,0.174390606091838,4077.3484461321,17.4607983763565
7.5,"random_policy_SVM","SVM",1,45,25540,22870,2670,4600,3793,807,0.593792096234519,0.189293598233996,1.58805146740417,1897,807,1090,43,1.4,15.26,4.7,0,0,0,0,0,0,0.174646628931651,4143.67350272983,17.4864018782265
7.5,"random_policy_SVM","SVM",1,46,25440,22789,2651,4700,3874,826,0.593840503522367,0.192604856512141,1.71281817166148,1963,826,1137,66,1.4,15.59,4.7,0,0,0,0,0,0,0.17495420791814,4122.80951037225,17.5136378330117
7.5,"random_policy_SVM","SVM",1,47,25340,22702,2638,4800,3961,839,0.5942298845867,0.198123620309051,1.75140230086258,1973,839,1134,10,1.4,15.93,4.7,0,0,0,0,0,0,0.174144471440184,4199.84691347576,17.4261114604527
7.5,"random_policy_SVM","SVM",1,48,25240,22616,2624,4900,4047,853,0.596401969123562,0.196467991169978,1.80111171998881,2054,853,1201,81,1.4,16.26,4.7,0,0,0,0,0,0,0.173511687033071,4109.94182932419,17.3676687812834
7.5,"random_policy_SVM","SVM",2,0,30040,26556,3484,100,85,15,0.392620701056113,0.0692737430167598,0.592177763448877,49,15,34,0,2.3,0.33,5.7,0,0,0,0,0,0,0.164657626460328,4581.90324311115,16.6118371305642
7.5,"random_policy_SVM","SVM",2,1,29940,26479,3461,200,162,38,0.578048196714008,0.159217877094972,1.5021504143846,107,38,69,58,1.8,0.66,4.3,0,0,0,0,0,0,0.241241500566192,5735.20042065675,24.270326496023
7.5,"random_policy_SVM","SVM",2,2,29840,26402,3438,300,239,61,0.558209001055403,0.140782122905028,1.1675113594041,174,61,113,67,1.9,1,3.9,0,0,0,0,0,0,0.257623109475521,5927.26078400459,26.9626195602283
7.5,"random_policy_SVM","SVM",2,3,29740,26329,3411,400,312,88,0.549193223065333,0.139664804469274,1.19848606852953,224,88,136,50,1.5,1.33,3.5,0,0,0,0,0,0,0.225812128956973,6469.17697634798,22.9327001560939
7.5,"random_policy_SVM","SVM",2,4,29640,26241,3399,500,400,100,0.557536304856901,0.147486033519553,1.26745960233075,257,100,157,33,1.6,1.66,4,0,0,0,0,0,0,0.225470781876868,5706.00717613543,23.0419165620768
7.5,"random_policy_SVM","SVM",2,5,29540,26161,3379,600,480,120,0.550418689445469,0.124022346368715,0.85107395679971,313,120,193,56,1.6,1.99,4,0,0,0,0,0,0,0.225951112551486,5776.9498611844,22.6148159729118
7.5,"random_policy_SVM","SVM",2,6,29440,26083,3357,700,558,142,0.533991391070286,0.118994413407821,0.83212114823794,360,142,218,47,1.5,2.32,3.9,0,0,0,0,0,0,0.237931105133208,5687.01535084921,23.9108230039645
7.5,"random_policy_SVM","SVM",2,7,29340,25994,3346,800,647,153,0.457417851099081,0.107262569832402,0.879881222004127,403,153,250,43,1.6,2.65,4.2,0,0,0,0,0,0,0.223524200644983,5722.63088774138,23.4351437433592
7.5,"random_policy_SVM","SVM",2,8,29240,25911,3329,900,730,170,0.563821336735513,0.190502793296089,1.65397442582247,415,170,245,12,1.4,2.99,4.3,0,0,0,0,0,0,0.201799357070273,5493.09636030463,28.144094728785
7.5,"random_policy_SVM","SVM",2,9,29140,25836,3304,1000,805,195,0.588820337702573,0.201117318435754,1.76119512640096,458,195,263,43,1.3,3.32,4.1,0,0,0,0,0,0,0.227306784341096,5536.78280579275,23.5462239415351
7.5,"random_policy_SVM","SVM",2,10,29040,25771,3269,1100,870,230,0.520906289028017,0.137988826815642,1.16183796880319,555,230,325,97,1.4,3.65,3.8,0,0,0,0,0,0,0.231088512977392,5837.07473249391,23.7411621215313
7.5,"random_policy_SVM","SVM",2,11,28940,25688,3252,1200,953,247,0.552755122515086,0.167039106145251,1.31719230291744,594,247,347,39,1.4,3.98,3.9,0,0,0,0,0,0,0.208358566398723,5854.86472398355,20.9864347041022
7.5,"random_policy_SVM","SVM",2,12,28840,25599,3241,1300,1042,258,0.565218931232459,0.173184357541899,1.29415829177088,610,258,352,16,1.4,4.31,4,0,0,0,0,0,0,0.211608969808746,5499.41875762721,21.9080105086048
7.5,"random_policy_SVM","SVM",2,13,28740,25518,3222,1400,1123,277,0.568157392065535,0.176536312849162,1.53630485403904,681,277,404,71,1.5,4.64,4.1,0,0,0,0,0,0,0.218291983587639,5562.63881875887,22.5594856239086
7.5,"random_policy_SVM","SVM",2,14,28640,25440,3200,1500,1201,299,0.580562689001264,0.177094972067039,1.48358851100828,716,299,417,35,1.4,4.98,4,0,0,0,0,0,0,0.210722824247898,5568.5989991875,21.7414233575716
7.5,"random_policy_SVM","SVM",2,15,28540,25352,3188,1600,1289,311,0.585892645392942,0.192737430167598,1.75096900182924,761,311,450,45,1.4,5.31,4.1,0,0,0,0,0,0,0.206346143459297,5297.05354737812,21.0971970334053
7.5,"random_policy_SVM","SVM",2,16,28440,25269,3171,1700,1372,328,0.581768511239023,0.162011173184358,1.3572707344711,816,328,488,55,1.5,5.64,4.2,0,0,0,0,0,0,0.193477228293915,5422.02180825338,19.4054838591245
7.5,"random_policy_SVM","SVM",2,17,28340,25196,3144,1800,1445,355,0.585567865043489,0.181564245810056,1.50138883462906,867,355,512,51,1.4,5.97,4.1,0,0,0,0,0,0,0.199348075746795,5490.83170041538,20.0571242207827
7.5,"random_policy_SVM","SVM",2,18,28240,25115,3125,1900,1526,374,0.576552129117971,0.182122905027933,1.50162392865818,931,374,557,64,1.5,6.3,4.1,0,0,0,0,0,0,0.19816977850051,5450.72122216377,19.857957506996
7.5,"random_policy_SVM","SVM",2,19,28140,25034,3106,2000,1607,393,0.582143642848461,0.201117318435754,1.80470973380395,968,393,575,37,1.5,6.64,4.1,0,0,0,0,0,0,0.196695610270961,5526.86012835054,19.6797994138932
7.5,"random_policy_SVM","SVM",2,20,28040,24972,3068,2100,1669,431,0.57701833046664,0.175977653631285,1.61661270986123,1063,431,632,95,1.5,6.97,3.9,0,0,0,0,0,0,0.20623856767879,5663.7411137868,20.6845025263697
7.5,"random_policy_SVM","SVM",2,21,27940,24884,3056,2200,1757,443,0.578787733473997,0.172067039106145,1.52009459505775,1099,443,656,36,1.5,7.3,4,0,0,0,0,0,0,0.202943214411667,5485.27017672544,20.4161946775585
7.5,"random_policy_SVM","SVM",2,22,27840,24797,3043,2300,1844,456,0.573482637228224,0.18268156424581,1.50587601210838,1132,456,676,33,1.5,7.63,4,0,0,0,0,0,0,0.198275712775729,5450.60057825536,19.840140444999
7.5,"random_policy_SVM","SVM",2,23,27740,24710,3030,2400,1931,469,0.565508209106221,0.183240223463687,1.54016214743153,1181,469,712,49,1.5,7.96,4.1,0,0,0,0,0,0,0.195813706752799,5333.73344451458,19.6222437984708
7.5,"random_policy_SVM","SVM",2,24,27640,24625,3015,2500,2016,484,0.556598013123302,0.182122905027933,1.49415316284396,1215,484,731,34,1.5,8.29,4.2,0,0,0,0,0,0,0.194657131951994,5252.1668255936,19.5514666250821
7.5,"random_policy_SVM","SVM",2,25,27540,24543,2997,2600,2098,502,0.564324723141699,0.17877094972067,1.50971296474668,1249,502,747,34,1.5,8.63,4.2,0,0,0,0,0,0,0.193179186610082,5309.36890295868,19.3189956118191
7.5,"random_policy_SVM","SVM",2,26,27440,24455,2985,2700,2186,514,0.567378987666255,0.162011173184358,1.46299792747623,1313,514,799,64,1.6,8.96,4.3,0,0,0,0,0,0,0.19059809528559,5148.87942082988,19.0702953710465
7.5,"random_policy_SVM","SVM",2,27,27340,24376,2964,2800,2265,535,0.544916436678772,0.154189944134078,1.41430812768516,1345,535,810,32,1.5,9.29,4.2,0,0,0,0,0,0,0.190940717634275,5208.64117120498,19.1070399641351
7.5,"random_policy_SVM","SVM",2,28,27240,24294,2946,2900,2347,553,0.552642978438986,0.159217877094972,1.46809992547963,1385,553,832,40,1.5,9.62,4.2,0,0,0,0,0,0,0.190714561462371,5190.07235381547,19.0734077623663
7.5,"random_policy_SVM","SVM",2,29,27140,24212,2928,3000,2429,571,0.548719618356799,0.156424581005587,1.4117487433789,1442,571,871,57,1.5,9.95,4.3,0,0,0,0,0,0,0.190224318307246,5151.0308272582,19.0326008024895
7.5,"random_policy_SVM","SVM",2,30,27040,24121,2919,3100,2520,580,0.548615424479637,0.168156424581006,1.43855330035322,1487,580,907,45,1.6,10.29,4.3,0,0,0,0,0,0,0.187453222187093,5019.21324595357,18.7681658609772
7.5,"random_policy_SVM","SVM",2,31,26940,24027,2913,3200,2614,586,0.549273019506588,0.172625698324022,1.61714763861886,1506,586,920,19,1.6,10.62,4.5,0,0,0,0,0,0,0.182977923359724,4869.40598748248,18.3070217803023
7.5,"random_policy_SVM","SVM",2,32,26840,23935,2905,3300,2706,594,0.528330008131084,0.150837988826816,1.4008141436163,1516,594,922,10,1.6,10.95,4.6,0,0,0,0,0,0,0.180035870064431,4786.41834661531,18.028265034075
7.5,"random_policy_SVM","SVM",2,33,26740,23845,2895,3400,2796,604,0.537715827920684,0.14804469273743,1.28520497899577,1540,604,936,24,1.5,11.28,4.6,0,0,0,0,0,0,0.177708507754814,4703.37551246137,17.7760505062692
7.5,"random_policy_SVM","SVM",2,34,26640,23756,2884,3500,2885,615,0.543834326266916,0.170391061452514,1.61886051176912,1569,615,954,29,1.6,11.61,4.7,0,0,0,0,0,0,0.175901888570035,4664.15757497888,17.6007028570428
7.5,"random_policy_SVM","SVM",2,35,26540,23674,2866,3600,2967,633,0.532085362421805,0.150279329608939,1.44145114061634,1594,633,961,25,1.5,11.94,4.7,0,0,0,0,0,0,0.17579998620977,4632.76344399168,17.5866613264115
7.5,"random_policy_SVM","SVM",2,36,26440,23589,2851,3700,3052,648,0.551959934362491,0.162011173184358,1.38493953936141,1653,648,1005,59,1.6,12.28,4.7,0,0,0,0,0,0,0.175420110237026,4585.61763105002,17.5604755783087
7.5,"random_policy_SVM","SVM",2,37,26340,23501,2839,3800,3140,660,0.522049266836025,0.150837988826816,1.39321763724128,1697,660,1037,44,1.6,12.61,4.8,0,0,0,0,0,0,0.173874144402694,4513.32723624259,17.3921860939181
7.5,"random_policy_SVM","SVM",2,38,26240,23415,2825,3900,3226,674,0.539433028828097,0.158100558659218,1.51253918030355,1735,674,1061,38,1.6,12.94,4.8,0,0,0,0,0,0,0.172671040023995,4488.78260317463,17.2711736480843
7.5,"random_policy_SVM","SVM",2,39,26140,23331,2809,4000,3310,690,0.55567267726946,0.167039106145251,1.47711457414486,1772,690,1082,37,1.6,13.27,4.8,0,0,0,0,0,0,0.172550910203345,4502.25605194161,17.2600118737552
7.5,"random_policy_SVM","SVM",2,40,26040,23249,2791,4100,3392,708,0.567496095358638,0.180446927374302,1.52949086384816,1780,708,1072,8,1.5,13.6,4.8,0,0,0,0,0,0,0.172903154764614,4468.6665689455,17.3044142811549
7.5,"random_policy_SVM","SVM",2,41,25940,23167,2773,4200,3474,726,0.560558558262981,0.167039106145251,1.49664559872418,1819,726,1093,39,1.5,13.93,4.8,0,0,0,0,0,0,0.17326111646565,4420.60316404614,17.4181616705652
7.5,"random_policy_SVM","SVM",2,42,25840,23080,2760,4300,3561,739,0.560068758704731,0.172625698324022,1.56762657733328,1866,739,1127,47,1.5,14.27,4.8,0,0,0,0,0,0,0.171780537523442,4423.36701912756,17.1942257264038
7.5,"random_policy_SVM","SVM",2,43,25740,22990,2750,4400,3651,749,0.567394719805967,0.181564245810056,1.63529377263596,1865,749,1116,-1,1.5,14.6,4.9,0,0,0,0,0,0,0.170093246742206,4353.02077621264,17.0116667796013
7.5,"random_policy_SVM","SVM",2,44,25640,22903,2737,4500,3738,762,0.565442125706533,0.17877094972067,1.50720394509966,1904,762,1142,39,1.5,14.93,4.9,0,0,0,0,0,0,0.169597845452273,4308.60220247375,16.9659250818152
7.5,"random_policy_SVM","SVM",2,45,25540,22819,2721,4600,3822,778,0.570195503384306,0.180446927374302,1.55917649493068,1962,778,1184,58,1.5,15.26,4.9,0,0,0,0,0,0,0.169164069056122,4258.71418335513,16.9250459675412
7.5,"random_policy_SVM","SVM",2,46,25440,22740,2700,4700,3901,799,0.575135226995006,0.168156424581006,1.47686055616134,1969,799,1170,7,1.5,15.59,4.9,0,0,0,0,0,0,0.16998497092987,4255.91574961223,17.0138295903126
7.5,"random_policy_SVM","SVM",2,47,25340,22658,2682,4800,3983,817,0.577638740436098,0.181005586592179,1.62083730753509,2029,817,1212,60,1.5,15.93,4.9,0,0,0,0,0,0,0.170263594051718,4243.31889219215,17.0369701979302
7.5,"random_policy_SVM","SVM",2,48,25240,22576,2664,4900,4065,835,0.579684759889272,0.181564245810056,1.57135756129733,2068,835,1233,39,1.5,16.26,4.9,0,0,0,0,0,0,0.170194733509047,4282.00520532986,17.021087770518
7.5,"random_policy_SVM","SVM",3,0,30040,26569,3471,100,84,16,0.47723098300019,0.0965593784683685,0.756192135320811,48,16,32,0,2,0.33,5.2,0,0,0,0,0,0,0.372454327789485,5033.72810755521,41.4308361453978
7.5,"random_policy_SVM","SVM",3,1,29940,26474,3466,200,179,21,0.479774568229555,0.118201997780244,1.12469247967561,75,21,54,27,2.6,0.66,8.5,0,0,0,0,0,0,0.143672104719664,3209.19053661232,14.9930899350354
7.5,"random_policy_SVM","SVM",3,2,29840,26382,3458,300,271,29,0.530610389357285,0.147058823529412,1.41615748065585,117,29,88,42,3,1,9.3,0,0,0,0,0,0,0.135347296079912,2595.45566290866,14.6173207215103
7.5,"random_policy_SVM","SVM",3,3,29740,26302,3438,400,351,49,0.523415170205118,0.159822419533851,1.54961734794279,137,49,88,20,1.8,1.33,7.2,0,0,0,0,0,0,0.430675240635643,3313.43729280627,55.4130268466578
7.5,"random_policy_SVM","SVM",3,4,29640,26249,3391,500,404,96,0.478386990815594,0.109877913429523,0.910874605773563,230,96,134,93,1.4,1.66,4.2,0,0,0,0,0,0,0.245113460237751,4794.90207919395,27.0902251598164
7.5,"random_policy_SVM","SVM",3,5,29540,26182,3358,600,471,129,0.461007351592408,0.10488346281909,0.910209787717285,323,129,194,93,1.5,1.99,3.7,0,0,0,0,0,0,0.245112352690271,5947.69050002194,25.1344831797254
7.5,"random_policy_SVM","SVM",3,6,29440,26090,3350,700,563,137,0.470918588961994,0.110432852386238,0.957311062242781,338,137,201,15,1.5,2.32,4.1,0,0,0,0,0,0,0.213497955120758,5377.3504011807,22.1867912763724
7.5,"random_policy_SVM","SVM",3,7,29340,26005,3335,800,648,152,0.455091934008892,0.100998890122087,0.810095409684307,386,152,234,48,1.5,2.65,4.3,0,0,0,0,0,0,0.19240047298505,5121.43623915828,19.7133116675785
7.5,"random_policy_SVM","SVM",3,8,29240,25921,3319,900,732,168,0.499354223194617,0.134850166481687,1.22949119522909,434,168,266,48,1.6,2.99,4.4,0,0,0,0,0,0,0.229987202884473,4526.63449728225,25.2866681075506
7.5,"random_policy_SVM","SVM",3,9,29140,25839,3301,1000,814,186,0.501992786671829,0.143729189789123,1.22446763775239,473,186,287,39,1.5,3.32,4.4,0,0,0,0,0,0,0.200675988745526,4634.94627827965,21.0379123673413
7.5,"random_policy_SVM","SVM",3,10,29040,25754,3286,1100,899,201,0.507041898915878,0.134295227524972,1.20641421036606,496,201,295,23,1.5,3.65,4.5,0,0,0,0,0,0,0.233614967920619,4530.94949414817,24.9834634862434
7.5,"random_policy_SVM","SVM",3,11,28940,25659,3281,1200,994,206,0.50460985353108,0.143174250832408,1.26157271768428,522,206,316,26,1.5,3.98,4.8,0,0,0,0,0,0,0.182366241543715,3792.17485119238,18.6145310392553
7.5,"random_policy_SVM","SVM",3,12,28840,25569,3271,1300,1084,216,0.511423361336654,0.147058823529412,1.30725875926295,555,216,339,33,1.6,4.31,5,0,0,0,0,0,0,0.167063490129766,3739.56262854609,19.2651645095996
7.5,"random_policy_SVM","SVM",3,13,28740,25488,3252,1400,1165,235,0.482471766450703,0.133185349611543,1.04450964335464,586,235,351,31,1.5,4.64,5,0,0,0,0,0,0,0.172849828935685,3943.76025136288,22.4089854785305
7.5,"random_policy_SVM","SVM",3,14,28640,25409,3231,1500,1244,256,0.511536406780923,0.16315205327414,1.38769688947061,632,256,376,46,1.5,4.98,4.9,0,0,0,0,0,0,0.180435616173794,4154.26128222732,18.5034874254973
7.5,"random_policy_SVM","SVM",3,15,28540,25322,3218,1600,1331,269,0.507570155300098,0.158712541620422,1.50454227812718,676,269,407,44,1.5,5.31,4.9,0,0,0,0,0,0,0.159700924418251,3142.88231743875,16.5108683914977
7.5,"random_policy_SVM","SVM",3,16,28440,25246,3194,1700,1407,293,0.502186465344567,0.132630410654828,1.26606629815689,712,293,419,36,1.4,5.64,4.8,0,0,0,0,0,0,0.166087824765295,3671.47234257794,17.0463250016969
7.5,"random_policy_SVM","SVM",3,17,28340,25160,3180,1800,1493,307,0.502407077523072,0.149278579356271,1.33341656598465,762,307,455,50,1.5,5.97,4.9,0,0,0,0,0,0,0.161443957026196,3210.36371731436,16.2998834746726
7.5,"random_policy_SVM","SVM",3,18,28240,25073,3167,1900,1580,320,0.499169369009017,0.144839067702553,1.35085415538095,801,320,481,39,1.5,6.3,4.9,0,0,0,0,0,0,0.163669940668295,3929.07812031012,16.4128360043365
7.5,"random_policy_SVM","SVM",3,19,28140,24991,3149,2000,1662,338,0.501935197483242,0.15149833518313,1.44070634120706,845,338,507,44,1.5,6.64,4.9,0,0,0,0,0,0,0.159826473147312,3291.74848724179,16.0457328443388
7.5,"random_policy_SVM","SVM",3,20,28040,24906,3134,2100,1747,353,0.502518282789935,0.153163152053274,1.37664443636864,877,353,524,32,1.5,6.97,4.9,0,0,0,0,0,0,0.160384607890021,3353.35889173775,16.2233505079533
7.5,"random_policy_SVM","SVM",3,21,27940,24831,3109,2200,1822,378,0.507869225951958,0.16204217536071,1.4992539045661,928,378,550,51,1.5,7.3,4.8,0,0,0,0,0,0,0.166775440931232,3598.11203348027,16.8831104980297
7.5,"random_policy_SVM","SVM",3,22,27840,24755,3085,2300,1898,402,0.510909659082877,0.162597114317425,1.52596919602002,976,402,574,48,1.4,7.63,4.7,0,0,0,0,0,0,0.168564912433354,3608.78226823381,16.9652293011799
7.5,"random_policy_SVM","SVM",3,23,27740,24672,3068,2400,1981,419,0.514331657182647,0.157602663706992,1.575941523733,1027,419,608,51,1.5,7.96,4.7,0,0,0,0,0,0,0.168864390345688,3669.99629147112,16.9992361250957
7.5,"random_policy_SVM","SVM",3,24,27640,24594,3046,2500,2059,441,0.508752552932492,0.16315205327414,1.4086645839328,1066,441,625,39,1.4,8.29,4.7,0,0,0,0,0,0,0.170074754460001,3569.01334639904,17.0686769632936
7.5,"random_policy_SVM","SVM",3,25,27540,24506,3034,2600,2147,453,0.509298500113217,0.159267480577137,1.50792825717931,1086,453,633,20,1.4,8.63,4.7,0,0,0,0,0,0,0.168789502386238,3527.87729603589,16.9209224462555
7.5,"random_policy_SVM","SVM",3,26,27440,24422,3018,2700,2231,469,0.510051362697379,0.165926748057714,1.49269548853563,1133,469,664,47,1.4,8.96,4.8,0,0,0,0,0,0,0.165764420529092,3366.01508838848,16.6385680628288
7.5,"random_policy_SVM","SVM",3,27,27340,24347,2993,2800,2306,494,0.511228678930779,0.168146503884573,1.59793140545951,1200,494,706,67,1.4,9.29,4.7,0,0,0,0,0,0,0.171058063384222,3678.9480326286,17.141975369408
7.5,"random_policy_SVM","SVM",3,28,27240,24267,2973,2900,2386,514,0.513374409438973,0.167036625971143,1.47332207567597,1222,514,708,22,1.4,9.62,4.6,0,0,0,0,0,0,0.17348137067268,3576.32005860685,17.7124013574245
7.5,"random_policy_SVM","SVM",3,29,27140,24178,2962,3000,2475,525,0.511267531767522,0.164816870144284,1.54606677244376,1248,525,723,26,1.4,9.95,4.7,0,0,0,0,0,0,0.170994048530324,3845.91781669152,17.1337869323453
7.5,"random_policy_SVM","SVM",3,30,27040,24097,2943,3100,2556,544,0.511535779447708,0.166481687014428,1.57224783602785,1293,544,749,45,1.4,10.29,4.7,0,0,0,0,0,0,0.16956840555173,3530.65920610973,17.0109264709292
7.5,"random_policy_SVM","SVM",3,31,26940,24013,2927,3200,2640,560,0.512725746900828,0.169256381798002,1.58504475861367,1349,560,789,56,1.4,10.62,4.7,0,0,0,0,0,0,0.169689771054289,3330.24649135588,17.025719332605
7.5,"random_policy_SVM","SVM",3,32,26840,23926,2914,3300,2727,573,0.513239030932466,0.175360710321865,1.55531475748194,1360,573,787,11,1.4,10.95,4.8,0,0,0,0,0,0,0.168059648783744,3516.61657451625,16.8545794894359
7.5,"random_policy_SVM","SVM",3,33,26740,23839,2901,3400,2814,586,0.513491971682348,0.167036625971143,1.56633212419805,1400,586,814,40,1.4,11.28,4.8,0,0,0,0,0,0,0.167876270302626,3434.58937614426,16.8580739946091
7.5,"random_policy_SVM","SVM",3,34,26640,23753,2887,3500,2900,600,0.513702839285014,0.168701442841287,1.54933743504193,1424,600,824,24,1.4,11.61,4.8,0,0,0,0,0,0,0.164400239347313,3308.10003626368,16.5405671593005
7.5,"random_policy_SVM","SVM",3,35,26540,23664,2876,3600,2989,611,0.514359740799297,0.171476137624861,1.58050110550832,1449,611,838,25,1.4,11.94,4.9,0,0,0,0,0,0,0.162906484384082,3011.36174324805,16.3643096768764
7.5,"random_policy_SVM","SVM",3,36,26440,23575,2865,3700,3078,622,0.513411380276091,0.169811320754717,1.49739251389771,1535,622,913,86,1.5,12.28,4.9,0,0,0,0,0,0,0.163749760151441,3314.69472560222,16.4122050633207
7.5,"random_policy_SVM","SVM",3,37,26340,23489,2851,3800,3164,636,0.511293796117878,0.165926748057714,1.4243489766344,1540,636,904,5,1.4,12.61,5,0,0,0,0,0,0,0.161967805891206,3405.35965091841,16.2297053464203
7.5,"random_policy_SVM","SVM",3,38,26240,23401,2839,3900,3252,648,0.513621662367762,0.168701442841287,1.57636366805934,1608,648,960,68,1.5,12.94,5,0,0,0,0,0,0,0.162354720067814,3448.62781967824,16.2657849510598
7.5,"random_policy_SVM","SVM",3,39,26140,23316,2824,4000,3337,663,0.515339593449601,0.171476137624861,1.6668738631962,1642,663,979,34,1.5,13.27,5,0,0,0,0,0,0,0.161253472808424,3113.09132800512,16.198710789734
7.5,"random_policy_SVM","SVM",3,40,26040,23237,2803,4100,3416,684,0.517481894536254,0.169811320754717,1.668306722481,1680,684,996,38,1.5,13.6,5,0,0,0,0,0,0,0.162304005075377,3149.05371533884,16.2933445770507
7.5,"random_policy_SVM","SVM",3,41,25940,23150,2790,4200,3503,697,0.513384990459096,0.164816870144284,1.58404842191946,1705,697,1008,25,1.4,13.93,5,0,0,0,0,0,0,0.161600323427325,3017.43731399841,16.2025791561687
7.5,"random_policy_SVM","SVM",3,42,25840,23064,2776,4300,3589,711,0.51488076194051,0.166481687014428,1.60415580092641,1771,711,1060,66,1.5,14.27,5,0,0,0,0,0,0,0.159621019360854,3073.25625126088,16.0056561472011
7.5,"random_policy_SVM","SVM",3,43,25740,22973,2767,4400,3680,720,0.515812351755936,0.166481687014428,1.67562385722872,1797,720,1077,26,1.5,14.6,5.1,0,0,0,0,0,0,0.158374304253449,3144.00260401639,15.8851003241017
7.5,"random_policy_SVM","SVM",3,44,25640,22885,2755,4500,3768,732,0.513294738121429,0.16315205327414,1.61592138702863,1813,732,1081,16,1.5,14.93,5.1,0,0,0,0,0,0,0.158663964393118,3182.25405690925,15.8922835518509
7.5,"random_policy_SVM","SVM",3,45,25540,22801,2739,4600,3852,748,0.514580854844375,0.170366259711432,1.58267337988655,1853,748,1105,40,1.5,15.26,5.1,0,0,0,0,0,0,0.157428036514111,3116.07107469695,15.7723903818727
7.5,"random_policy_SVM","SVM",3,46,25440,22713,2727,4700,3940,760,0.516212172121157,0.170921198668147,1.71802358296531,1877,760,1117,24,1.5,15.59,5.2,0,0,0,0,0,0,0.156520805199081,2979.81676065715,15.7072535865896
7.5,"random_policy_SVM","SVM",3,47,25340,22628,2712,4800,4025,775,0.51574367968065,0.166481687014428,1.63029471915432,1943,775,1168,66,1.5,15.93,5.2,0,0,0,0,0,0,0.157224544327542,3142.84074185247,15.7637150869323
7.5,"random_policy_SVM","SVM",3,48,25240,22536,2704,4900,4117,783,0.5143798572842,0.167036625971143,1.6229839805034,2008,783,1225,65,1.6,16.26,5.3,0,0,0,0,0,0,0.155331258534099,3041.34211982171,15.5642049877091
7.5,"random_policy_SVM","SVM",4,0,30040,26552,3488,100,91,9,0.521074347553334,0.146205357142857,1.17500066151566,33,9,24,0,2.7,0.33,10.1,0,0,0,0,0,0,0.154085261197261,2557.20554563419,15.9632207811215
7.5,"random_policy_SVM","SVM",4,1,29940,26463,3477,200,180,20,0.470576969173936,0.113839285714286,0.990299593585237,69,20,49,36,2.5,0.66,9,0,0,0,0,0,0,0.1636443855704,2845.36233870424,18.1491355984273
7.5,"random_policy_SVM","SVM",4,2,29840,26382,3458,300,261,39,0.508150939688603,0.162946428571429,1.52775768032057,123,39,84,54,2.2,1,6.7,0,0,0,0,0,0,0.153506932584894,3841.34660133606,16.0991480906624
7.5,"random_policy_SVM","SVM",4,3,29740,26304,3436,400,339,61,0.502852268922201,0.120535714285714,1.01918410570018,161,61,100,38,1.6,1.33,5.6,0,0,0,0,0,0,0.272472139101061,4194.0893074575,31.5410468261808
7.5,"random_policy_SVM","SVM",4,4,29640,26227,3413,500,416,84,0.502233592682592,0.110491071428571,1.00679638276328,214,84,130,53,1.5,1.66,5,0,0,0,0,0,0,0.203660523274057,4620.7193550734,21.2645473762783
7.5,"random_policy_SVM","SVM",4,5,29540,26145,3395,600,498,102,0.541078618865182,0.181919642857143,1.30139269342576,263,102,161,49,1.6,1.99,4.9,0,0,0,0,0,0,0.202342544186784,4642.23047535157,20.749885400557
7.5,"random_policy_SVM","SVM",4,6,29440,26056,3384,700,587,113,0.541869004866706,0.173549107142857,1.4226872246696,304,113,191,41,1.7,2.32,5.2,0,0,0,0,0,0,0.184110963787809,4178.92436496765,19.3544307345671
7.5,"random_policy_SVM","SVM",4,7,29340,25983,3357,800,660,140,0.551115487295997,0.170758928571429,1.53383466409692,359,140,219,55,1.6,2.65,4.7,0,0,0,0,0,0,0.199081489742818,4513.66120756989,20.925836720538
7.5,"random_policy_SVM","SVM",4,8,29240,25894,3346,900,749,151,0.532760739130263,0.143415178571429,1.26973939831261,397,151,246,38,1.6,2.99,5,0,0,0,0,0,0,0.179110028771791,4278.83601805037,18.6601265029658
7.5,"random_policy_SVM","SVM",4,9,29140,25810,3330,1000,833,167,0.545744409304968,0.150111607142857,1.3917162477758,448,167,281,51,1.7,3.32,5,0,0,0,0,0,0,0.187121348554724,3998.7154691999,20.0427609268892
7.5,"random_policy_SVM","SVM",4,10,29040,25716,3324,1100,927,173,0.5437830266035,0.153459821428571,1.38177522757549,449,173,276,1,1.6,3.65,5.4,0,0,0,0,0,0,0.173978474966538,3942.84881520829,18.0072120350076
7.5,"random_policy_SVM","SVM",4,11,28940,25631,3309,1200,1012,188,0.534903160905243,0.148995535714286,1.28140734457093,491,188,303,42,1.6,3.98,5.4,0,0,0,0,0,0,0.166163236988205,3894.89602117774,16.7931785463226
7.5,"random_policy_SVM","SVM",4,12,28840,25538,3302,1300,1105,195,0.537372486801124,0.148995535714286,1.41278790127529,529,195,334,38,1.7,4.31,5.7,0,0,0,0,0,0,0.157452583434904,3515.58094539668,16.0379921489599
7.5,"random_policy_SVM","SVM",4,13,28740,25448,3292,1400,1195,205,0.540661069135741,0.1640625,1.41278790127529,551,205,346,22,1.7,4.64,5.8,0,0,0,0,0,0,0.150558451316582,3294.1717033898,15.1624000539892
7.5,"random_policy_SVM","SVM",4,14,28640,25362,3278,1500,1281,219,0.541622366444599,0.161272321428571,1.41396672504378,589,219,370,38,1.7,4.98,5.8,0,0,0,0,0,0,0.149002995696534,3215.80817027498,15.007330704043
7.5,"random_policy_SVM","SVM",4,15,28540,25276,3264,1600,1367,233,0.545341399853959,0.170200892857143,1.57233355978261,645,233,412,56,1.8,5.31,5.9,0,0,0,0,0,0,0.151073978117026,3447.93771457339,15.4251958118879
7.5,"random_policy_SVM","SVM",4,16,28440,25214,3226,1700,1429,271,0.555006608682618,0.184151785714286,1.75789042172593,703,271,432,58,1.6,5.64,5.3,0,0,0,0,0,0,0.199904093551706,3347.6606114525,25.7714501501065
7.5,"random_policy_SVM","SVM",4,17,28340,25150,3190,1800,1493,307,0.559089107028557,0.188616071428571,1.71992796793761,779,307,472,76,1.5,5.97,4.9,0,0,0,0,0,0,0.172176181901071,4097.22264124716,17.3203679326341
7.5,"random_policy_SVM","SVM",4,18,28240,25081,3159,1900,1562,338,0.564396140556243,0.196986607142857,1.91403556034483,864,338,526,85,1.6,6.3,4.6,0,0,0,0,0,0,0.180161726113687,4484.08896612092,18.281174771348
7.5,"random_policy_SVM","SVM",4,19,28140,25006,3134,2000,1637,363,0.562914166803381,0.186383928571429,1.79125405844156,937,363,574,73,1.6,6.64,4.5,0,0,0,0,0,0,0.183184834754554,4394.68074572314,18.3632549984297
7.5,"random_policy_SVM","SVM",4,20,28040,24925,3115,2100,1718,382,0.561652188303494,0.188058035714286,1.79803340517241,973,382,591,36,1.5,6.97,4.5,0,0,0,0,0,0,0.183683437364886,4083.45315592589,18.4162793665586
7.5,"random_policy_SVM","SVM",4,21,27940,24838,3102,2200,1805,395,0.565922197407555,0.195870535714286,1.85357808448574,1005,395,610,32,1.5,7.3,4.6,0,0,0,0,0,0,0.179875995241997,4372.43621947532,18.0043667288985
7.5,"random_policy_SVM","SVM",4,22,27840,24761,3079,2300,1882,418,0.564824868650014,0.202566964285714,1.90117423425367,1062,418,644,57,1.5,7.63,4.5,0,0,0,0,0,0,0.182941105630185,3902.05275194553,18.3575464532195
7.5,"random_policy_SVM","SVM",4,23,27740,24681,3059,2400,1962,438,0.562796962073575,0.196986607142857,1.81524695387293,1094,438,656,32,1.5,7.96,4.5,0,0,0,0,0,0,0.182771740569099,4466.62977071559,18.317335408745
7.5,"random_policy_SVM","SVM",4,24,27640,24594,3046,2500,2049,451,0.563322807460491,0.194754464285714,1.78441576086956,1160,451,709,66,1.6,8.29,4.5,0,0,0,0,0,0,0.181004447718044,3894.2448280968,18.1708694803146
7.5,"random_policy_SVM","SVM",4,25,27540,24510,3030,2600,2133,467,0.562261157016178,0.190848214285714,1.64990912543403,1199,467,732,39,1.6,8.63,4.6,0,0,0,0,0,0,0.180506713558203,3713.01246580798,18.1319979171063
7.5,"random_policy_SVM","SVM",4,26,27440,24427,3013,2700,2216,484,0.562260232489806,0.194196428571429,1.73902448957428,1245,484,761,46,1.6,8.96,4.6,0,0,0,0,0,0,0.17872983487566,3716.88210122715,17.965150903815
7.5,"random_policy_SVM","SVM",4,27,27340,24338,3002,2800,2305,495,0.561738715567269,0.189732142857143,1.72009287967798,1282,495,787,37,1.6,9.29,4.7,0,0,0,0,0,0,0.176439624889674,3885.05096078402,17.6957226525761
7.5,"random_policy_SVM","SVM",4,28,27240,24260,2980,2900,2383,517,0.560653825891855,0.188058035714286,1.74937105635335,1335,517,818,53,1.6,9.62,4.6,0,0,0,0,0,0,0.177833690768288,3940.05112163783,17.857509925459
7.5,"random_policy_SVM","SVM",4,29,27140,24182,2958,3000,2461,539,0.566152068283165,0.181361607142857,1.63204081075175,1375,539,836,40,1.6,9.95,4.6,0,0,0,0,0,0,0.188273966348008,3943.89348982276,20.1373814588529
7.5,"random_policy_SVM","SVM",4,30,27040,24091,2949,3100,2552,548,0.56213617786004,0.189732142857143,1.68934442934783,1425,548,877,50,1.6,10.29,4.7,0,0,0,0,0,0,0.176105861179934,3971.46364478025,17.6532100327983
7.5,"random_policy_SVM","SVM",4,31,26940,24009,2931,3200,2634,566,0.565205731491991,0.188058035714286,1.69524091950262,1474,566,908,49,1.6,10.62,4.7,0,0,0,0,0,0,0.176018687358715,3804.90492760039,17.6662481879224
7.5,"random_policy_SVM","SVM",4,32,26840,23924,2916,3300,2719,581,0.561727789346499,0.192522321428571,1.73877797902249,1500,581,919,26,1.6,10.95,4.7,0,0,0,0,0,0,0.175749442894696,3533.49033026318,17.6562616344687
7.5,"random_policy_SVM","SVM",4,33,26740,23840,2900,3400,2803,597,0.565968045510904,0.193080357142857,1.81723341616249,1509,597,912,9,1.5,11.28,4.7,0,0,0,0,0,0,0.175291456887041,3565.5106009175,17.562898371758
7.5,"random_policy_SVM","SVM",4,34,26640,23749,2891,3500,2894,606,0.560331124163561,0.184709821428571,1.58102154046997,1532,606,926,23,1.5,11.61,4.8,0,0,0,0,0,0,0.172104682674368,3910.92463256222,17.2449499658233
7.5,"random_policy_SVM","SVM",4,35,26540,23667,2873,3600,2976,624,0.565990318191722,0.196986607142857,1.75059627059844,1604,624,980,72,1.6,11.94,4.8,0,0,0,0,0,0,0.170591336842432,3580.04444990553,17.1087193480177
7.5,"random_policy_SVM","SVM",4,36,26440,23579,2861,3700,3064,636,0.566246117829715,0.19921875,1.69806447681976,1610,636,974,6,1.5,12.28,4.8,0,0,0,0,0,0,0.171551683718357,3342.09487735953,17.2300085150725
7.5,"random_policy_SVM","SVM",4,37,26340,23500,2840,3800,3143,657,0.566332981284901,0.198660714285714,1.70397078804348,1683,657,1026,73,1.6,12.61,4.8,0,0,0,0,0,0,0.171758861580839,3683.04759721848,17.2204527243132
7.5,"random_policy_SVM","SVM",4,38,26240,23422,2818,3900,3221,679,0.563132565147171,0.186941964285714,1.60332268197574,1709,679,1030,26,1.5,12.94,4.7,0,0,0,0,0,0,0.173104727048833,3496.98585256131,17.358059614419
7.5,"random_policy_SVM","SVM",4,39,26140,23340,2800,4000,3303,697,0.564017126767029,0.193080357142857,1.78019857905052,1743,697,1046,34,1.5,13.27,4.7,0,0,0,0,0,0,0.173806742111939,3694.13464482402,17.6026206728241
7.5,"random_policy_SVM","SVM",4,40,26040,23261,2779,4100,3382,718,0.568747381909405,0.179129464285714,1.60158627717391,1829,718,1111,86,1.5,13.6,4.7,0,0,0,0,0,0,0.174709341623317,3485.09116242758,18.5490201549318
7.5,"random_policy_SVM","SVM",4,41,25940,23174,2766,4200,3469,731,0.56956180559665,0.191964285714286,1.66602576232699,1812,731,1081,-17,1.5,13.93,4.7,0,0,0,0,0,0,0.173028262012698,3787.47149951298,17.3770843451241
7.5,"random_policy_SVM","SVM",4,42,25840,23096,2744,4300,3547,753,0.571711833702249,0.209263392857143,1.88976066680961,1881,753,1128,69,1.5,14.27,4.7,0,0,0,0,0,0,0.174080863917346,3645.86893065617,17.4382847952158
7.5,"random_policy_SVM","SVM",4,43,25740,23017,2723,4400,3626,774,0.569196407559461,0.191964285714286,1.64386998254799,1890,774,1116,9,1.4,14.6,4.7,0,0,0,0,0,0,0.174560507627111,3351.08827568707,17.5127301013528
7.5,"random_policy_SVM","SVM",4,44,25640,22924,2716,4500,3719,781,0.570434474445425,0.204799107142857,1.87214867342537,1938,781,1157,48,1.5,14.93,4.8,0,0,0,0,0,0,0.172569227038193,3463.79896694731,17.3107729139644
7.5,"random_policy_SVM","SVM",4,45,25540,22846,2694,4600,3797,803,0.567734647315039,0.190290178571429,1.57644602768091,2017,803,1214,79,1.5,15.26,4.7,0,0,0,0,0,0,0.173296862004421,3762.20277690792,17.3614958727123
7.5,"random_policy_SVM","SVM",4,46,25440,22759,2681,4700,3884,816,0.565147948593646,0.1875,1.64689743798956,1969,816,1153,-48,1.4,15.59,4.8,0,0,0,0,0,0,0.1723228512091,3478.95592905087,17.2704962920971
7.5,"random_policy_SVM","SVM",4,47,25340,22677,2663,4800,3966,834,0.568704223337331,0.196428571428571,1.69799530845557,2042,834,1208,73,1.4,15.93,4.8,0,0,0,0,0,0,0.172233729804363,3363.39776975441,17.7217409309927
7.5,"random_policy_SVM","SVM",4,48,25240,22596,2644,4900,4047,853,0.569274656109812,0.213169642857143,1.81566412996546,2110,853,1257,68,1.5,16.26,4.7,0,0,0,0,0,0,0.17307944624241,3765.01774350704,17.3959891376439
7.5,"random_policy_SVM","SVM",5,0,30040,26491,3549,100,87,13,0.45900690420449,0.0903300521134916,0.858743793812909,45,13,32,0,2.5,0.33,6.7,0,0,0,0,0,0,0.140924006608667,3917.23224647033,14.1410588337234
7.5,"random_policy_SVM","SVM",5,1,29940,26402,3538,200,176,24,0.431442505231486,0.0909090909090909,0.804812618647981,78,24,54,33,2.2,0.66,7.3,0,0,0,0,0,0,0.121169457757234,3603.15088734636,12.1267911260542
7.5,"random_policy_SVM","SVM",5,2,29840,26327,3513,300,251,49,0.517712906976099,0.15865662999421,1.34256825976571,136,49,87,58,1.8,1,5.1,0,0,0,0,0,0,0.471730023152417,4548.12780413223,52.5028668455031
7.5,"random_policy_SVM","SVM",5,3,29740,26234,3506,400,344,56,0.531651538930991,0.159814707585408,1.398114657837,154,56,98,18,1.8,1.33,6.1,0,0,0,0,0,0,0.288918480193868,3592.08672684063,33.6424071226643
7.5,"random_policy_SVM","SVM",5,4,29640,26157,3483,500,421,79,0.554188141958932,0.171974522292994,1.55279247125928,204,79,125,50,1.6,1.66,5.3,0,0,0,0,0,0,0.163928427476022,4569.49753034235,16.6958632690278
7.5,"random_policy_SVM","SVM",5,5,29540,26078,3462,600,500,100,0.555281346723427,0.137232194557035,1.15847811410351,248,100,148,44,1.5,1.99,5,0,0,0,0,0,0,0.173564037158358,4768.46369648557,17.636665997844
7.5,"random_policy_SVM","SVM",5,6,29440,25993,3447,700,585,115,0.552700753410011,0.184713375796178,1.79398929484373,286,115,171,38,1.5,2.32,5.1,0,0,0,0,0,0,0.1702143547036,4562.72517423609,17.1155658772509
7.5,"random_policy_SVM","SVM",5,7,29340,25912,3428,800,666,134,0.538915473006655,0.188187608569774,1.69127957325353,332,134,198,46,1.5,2.65,5,0,0,0,0,0,0,0.171434462487152,4584.17726172264,17.3602013592896
7.5,"random_policy_SVM","SVM",5,8,29240,25835,3405,900,743,157,0.559471567216403,0.193398957730168,1.88747227763034,391,157,234,59,1.5,2.99,4.7,0,0,0,0,0,0,0.173911678486852,4663.57596714008,17.6905625906304
7.5,"random_policy_SVM","SVM",5,9,29140,25761,3379,1000,817,183,0.556253658046343,0.19166184134337,1.80604617205005,444,183,261,53,1.4,3.32,4.5,0,0,0,0,0,0,0.190623049923565,4929.1525179348,19.9634080846111
7.5,"random_policy_SVM","SVM",5,10,29040,25698,3342,1100,880,220,0.56410556991581,0.20034742327736,2.0049886027223,515,220,295,71,1.3,3.65,4,0,0,0,0,0,0,0.199210768407686,5632.56334606201,19.9772473623156
7.5,"random_policy_SVM","SVM",5,11,28940,25615,3325,1200,963,237,0.580937096009349,0.22524609148813,2.27685987160093,563,237,326,48,1.4,3.98,4.1,0,0,0,0,0,0,0.203726836399991,5446.65380457582,20.8055530392889
7.5,"random_policy_SVM","SVM",5,12,28840,25552,3288,1300,1026,274,0.578744785005816,0.209033005211349,2.03392596960988,650,274,376,87,1.4,4.31,3.7,0,0,0,0,0,0,0.211294123245839,5742.30785984509,21.2575211403598
7.5,"random_policy_SVM","SVM",5,13,28740,25468,3272,1400,1110,290,0.593883108626012,0.235089751013318,2.26447303125532,689,290,399,39,1.4,4.64,3.8,0,0,0,0,0,0,0.206216134385978,5756.90857728706,20.7993683644348
7.5,"random_policy_SVM","SVM",5,14,28640,25402,3238,1500,1176,324,0.583944244430744,0.227562246670527,2.17974784981379,744,324,420,55,1.3,4.98,3.6,0,0,0,0,0,0,0.219203309110412,5931.24983548109,22.47257035562
7.5,"random_policy_SVM","SVM",5,15,28540,25325,3215,1600,1253,347,0.583705104532475,0.226404169079328,2.08145520838235,810,347,463,66,1.3,5.31,3.6,0,0,0,0,0,0,0.216212281345929,6027.02301616769,21.6456385506493
7.5,"random_policy_SVM","SVM",5,16,28440,25244,3196,1700,1334,366,0.575822340101279,0.217718587145339,2.05919351070206,856,366,490,46,1.3,5.64,3.6,0,0,0,0,0,0,0.212878547026663,5685.61181952397,21.3264546906669
7.5,"random_policy_SVM","SVM",5,17,28340,25159,3181,1800,1419,381,0.572984989252374,0.206716850028952,1.91112289219948,907,381,526,51,1.4,5.97,3.7,0,0,0,0,0,0,0.211099483975727,5942.8295801891,21.1126200343947
7.5,"random_policy_SVM","SVM",5,18,28240,25078,3162,1900,1500,400,0.574560509380566,0.214244354371743,1.95373739294264,970,400,570,63,1.4,6.3,3.8,0,0,0,0,0,0,0.209861392154819,5856.97097368557,20.9907327065753
7.5,"random_policy_SVM","SVM",5,19,28140,24993,3147,2000,1585,415,0.575327136958643,0.219455703532137,2.14137866234399,997,415,582,27,1.4,6.64,3.8,0,0,0,0,0,0,0.205903551584894,5419.46835975084,20.6087975364998
7.5,"random_policy_SVM","SVM",5,20,28040,24913,3127,2100,1665,435,0.572847866755825,0.207874927620151,1.98612800115604,1064,435,629,67,1.4,6.97,3.8,0,0,0,0,0,0,0.205750336997072,5485.88568825631,20.5919858231073
7.5,"random_policy_SVM","SVM",5,21,27940,24838,3102,2200,1740,460,0.572561818813624,0.206137811233353,2.00146489691787,1114,460,654,50,1.4,7.3,3.8,0,0,0,0,0,0,0.206268522051457,5314.26040718462,20.6462441207724
7.5,"random_policy_SVM","SVM",5,22,27840,24767,3073,2300,1811,489,0.573005557626857,0.210770121598147,2.05514403208424,1209,489,720,95,1.5,7.63,3.7,0,0,0,0,0,0,0.211112731701811,5695.83182226453,21.1220335179492
7.5,"random_policy_SVM","SVM",5,23,27740,24695,3045,2400,1883,517,0.571876857228752,0.210191082802548,2.09930998300503,1234,517,717,25,1.4,7.96,3.6,0,0,0,0,0,0,0.214396677194847,5784.68415510549,21.4467032638333
7.5,"random_policy_SVM","SVM",5,24,27640,24611,3029,2500,1967,533,0.566712719864646,0.206137811233353,1.90109075103308,1288,533,755,54,1.4,8.29,3.7,0,0,0,0,0,0,0.209998234554475,5098.01457314461,21.0745958214964
7.5,"random_policy_SVM","SVM",5,25,27540,24524,3016,2600,2054,546,0.570098517306598,0.217718587145339,2.13558173010268,1296,546,750,8,1.4,8.63,3.8,0,0,0,0,0,0,0.207831490021285,5336.7676877326,20.8002113304559
7.5,"random_policy_SVM","SVM",5,26,27440,24450,2990,2700,2128,572,0.568514014787017,0.209033005211349,2.0132635439206,1359,572,787,63,1.4,8.96,3.7,0,0,0,0,0,0,0.21010267335944,5495.96727894336,21.0196356144811
7.5,"random_policy_SVM","SVM",5,27,27340,24360,2980,2800,2218,582,0.566429362300552,0.217139548349739,2.11092678178763,1395,582,813,36,1.4,9.29,3.8,0,0,0,0,0,0,0.207687025924807,5646.971327649,20.7696696274274
7.5,"random_policy_SVM","SVM",5,28,27240,24277,2963,2900,2301,599,0.566104390662349,0.215981470758541,2.05199353339191,1407,599,808,12,1.3,9.62,3.8,0,0,0,0,0,0,0.204476865725296,5075.60462494567,20.4558957687754
7.5,"random_policy_SVM","SVM",5,29,27140,24188,2952,3000,2390,610,0.562147842525054,0.204979733642154,1.7879450887464,1430,610,820,23,1.3,9.95,3.9,0,0,0,0,0,0,0.200904566143517,4833.611458535,20.1226237138659
7.5,"random_policy_SVM","SVM",5,30,27040,24105,2935,3100,2473,627,0.563909909999041,0.213086276780544,2.04887590946854,1475,627,848,45,1.4,10.29,3.9,0,0,0,0,0,0,0.199076742558425,4747.10574799702,19.9371963082606
7.5,"random_policy_SVM","SVM",5,31,26940,24017,2923,3200,2561,639,0.559398145930267,0.202084539664157,1.91207136031488,1483,639,844,8,1.3,10.62,4,0,0,0,0,0,0,0.198643317373132,5213.19660644717,19.8710157948514
7.5,"random_policy_SVM","SVM",5,32,26840,23928,2912,3300,2650,650,0.55909569536033,0.195715112912565,1.81205889795485,1496,650,846,13,1.3,10.95,4.1,0,0,0,0,0,0,0.196294420022368,4885.38470564252,19.8339928680906
7.5,"random_policy_SVM","SVM",5,33,26740,23844,2896,3400,2734,666,0.558473046403645,0.193977996525767,1.86835820819378,1587,666,921,91,1.4,11.28,4.1,0,0,0,0,0,0,0.213604140537778,4717.89160131272,22.2592486251484
7.5,"random_policy_SVM","SVM",5,34,26640,23757,2883,3500,2821,679,0.556628228106579,0.20034742327736,1.91636055626226,1586,679,907,-1,1.3,11.61,4.2,0,0,0,0,0,0,0.19273384479954,4906.92159392425,19.2891866528211
7.5,"random_policy_SVM","SVM",5,35,26540,23672,2868,3600,2906,694,0.555797986104456,0.185871453387377,1.82991462366305,1647,694,953,61,1.4,11.94,4.2,0,0,0,0,0,0,0.190447487990894,4701.17100416653,19.0632095917668
7.5,"random_policy_SVM","SVM",5,36,26440,23586,2854,3700,2992,708,0.55619512062614,0.201505500868558,1.9712774622103,1674,708,966,27,1.4,12.28,4.2,0,0,0,0,0,0,0.190107256972058,4807.47429102662,19.0161500025856
7.5,"random_policy_SVM","SVM",5,37,26340,23498,2842,3800,3080,720,0.55723521211982,0.193398957730168,1.78189033429638,1673,720,953,-1,1.3,12.61,4.3,0,0,0,0,0,0,0.186305886744917,4223.00827989616,18.6587827135877
7.5,"random_policy_SVM","SVM",5,38,26240,23416,2824,3900,3162,738,0.557935665075359,0.207874927620151,1.94515201902743,1730,738,992,57,1.3,12.94,4.3,0,0,0,0,0,0,0.187537431848925,4232.61203841497,18.7707914298223
7.5,"random_policy_SVM","SVM",5,39,26140,23337,2803,4000,3241,759,0.553516936016915,0.189924724956572,1.66113379859608,1777,759,1018,47,1.3,13.27,4.3,0,0,0,0,0,0,0.1882410417153,4602.20935421304,18.8341883048647
7.5,"random_policy_SVM","SVM",5,40,26040,23244,2796,4100,3334,766,0.555581454060847,0.191082802547771,1.83600568510817,1813,766,1047,36,1.4,13.6,4.4,0,0,0,0,0,0,0.185560855622305,4615.9895431212,18.5611470386982
7.5,"random_policy_SVM","SVM",5,41,25940,23156,2784,4200,3422,778,0.555270628604244,0.19976838448176,1.70147840546564,1839,778,1061,26,1.4,13.93,4.4,0,0,0,0,0,0,0.183533065969616,4293.60380791274,18.3635682876423
7.5,"random_policy_SVM","SVM",5,42,25840,23075,2765,4300,3503,797,0.556448623671998,0.199189345686161,1.92399545887685,1877,797,1080,38,1.4,14.27,4.4,0,0,0,0,0,0,0.181765235388109,4050.28006366807,18.2008491216904
7.5,"random_policy_SVM","SVM",5,43,25740,22986,2754,4400,3592,808,0.554934678487666,0.200926462072959,1.7893133887755,1903,808,1095,26,1.4,14.6,4.4,0,0,0,0,0,0,0.180136340234234,3966.52574664254,18.0314121791315
7.5,"random_policy_SVM","SVM",5,44,25640,22904,2736,4500,3674,826,0.554111032251216,0.191082802547771,1.73016187910677,1933,826,1107,30,1.3,14.93,4.4,0,0,0,0,0,0,0.182410251373021,4439.01227469549,18.2504571141832
7.5,"random_policy_SVM","SVM",5,45,25540,22816,2724,4600,3762,838,0.555939230954552,0.206716850028952,2.02840755291576,1967,838,1129,34,1.3,15.26,4.5,0,0,0,0,0,0,0.179239279046441,4057.58985349983,17.9503211438243
7.5,"random_policy_SVM","SVM",5,46,25440,22736,2704,4700,3842,858,0.554001421040356,0.189924724956572,1.77893230919962,2025,858,1167,58,1.4,15.59,4.5,0,0,0,0,0,0,0.180195420839708,4218.32111983298,18.0324606858648
7.5,"random_policy_SVM","SVM",5,47,25340,22644,2696,4800,3934,866,0.553088948933497,0.185292414591778,1.64098139549353,2014,866,1148,-11,1.3,15.93,4.5,0,0,0,0,0,0,0.17831557064647,4069.93036146259,17.8457832160513
7.5,"random_policy_SVM","SVM",5,48,25240,22560,2680,4900,4018,882,0.550619095054016,0.181818181818182,1.62817127230524,2044,882,1162,30,1.3,16.26,4.6,0,0,0,0,0,0,0.176290236867302,3747.07064890762,17.6493941198309
7.5,"random_policy_SVM","SVM",6,0,30040,26506,3534,100,91,9,0.576072437885362,0.177548682703322,1.66024364046966,30,9,21,0,2.3,0.33,10.1,0,0,0,0,0,0,0.277591882141658,2827.34368003539,29.2067489085634
7.5,"random_policy_SVM","SVM",6,1,29940,26438,3502,200,159,41,0.554947959313062,0.134020618556701,1.12687767421704,107,41,66,77,1.6,0.66,3.9,0,0,0,0,0,0,0.261996746888456,5989.36928779878,26.6357737814455
7.5,"random_policy_SVM","SVM",6,2,29840,26352,3488,300,245,55,0.571807121719111,0.15979381443299,1.52233728250581,148,55,93,41,1.7,1,4.5,0,0,0,0,0,0,0.209565690470328,5282.43701589909,21.6735938162713
7.5,"random_policy_SVM","SVM",6,3,29740,26267,3473,400,330,70,0.539228813541106,0.144329896907216,1.24186519199429,196,70,126,48,1.8,1.33,4.7,0,0,0,0,0,0,0.209334591733278,5177.87149054624,21.4703175730024
7.5,"random_policy_SVM","SVM",6,4,29640,26173,3467,500,424,76,0.517379719713137,0.103092783505155,0.708284400154107,228,76,152,32,2,1.66,5.6,0,0,0,0,0,0,0.182744889248434,4340.7423948731,18.7338052655502
7.5,"random_policy_SVM","SVM",6,5,29540,26079,3461,600,518,82,0.497512147841542,0.108820160366552,0.930644708119908,266,82,184,38,2.2,1.99,6.3,0,0,0,0,0,0,0.204320570366778,3136.51211731304,22.7725237225494
7.5,"random_policy_SVM","SVM",6,6,29440,25996,3444,700,601,99,0.542751032109843,0.130011454753723,1.15397455452034,264,99,165,-2,1.7,2.32,6.1,0,0,0,0,0,0,0.337022352027992,3736.09448820056,38.1690363098824
7.5,"random_policy_SVM","SVM",6,7,29340,25924,3416,800,673,127,0.528224878521587,0.126575028636884,1.17183197797272,353,127,226,89,1.8,2.65,5.3,0,0,0,0,0,0,0.190290773031995,4091.28167972324,19.7669449450233
7.5,"random_policy_SVM","SVM",6,8,29240,25845,3395,900,752,148,0.52722347945129,0.151775486827033,1.40036039823548,400,148,252,47,1.7,2.99,5.1,0,0,0,0,0,0,0.40407838623912,3859.8720661452,47.0784175819543
7.5,"random_policy_SVM","SVM",6,9,29140,25757,3383,1000,840,160,0.513244446163729,0.145475372279496,1.21443747775095,449,160,289,49,1.8,3.32,5.2,0,0,0,0,0,0,0.196270771965597,3734.33085322977,20.8631327857382
7.5,"random_policy_SVM","SVM",6,10,29040,25677,3363,1100,920,180,0.512023365118665,0.115120274914089,1.01686743388794,503,180,323,54,1.8,3.65,5.1,0,0,0,0,0,0,0.20047643067417,3719.99470873321,23.7388382091395
7.5,"random_policy_SVM","SVM",6,11,28940,25594,3346,1200,1003,197,0.507268718206613,0.128293241695304,1.1029006851508,529,197,332,26,1.7,3.98,5.1,0,0,0,0,0,0,0.229149119217715,4217.40745381307,29.9414381376674
7.5,"random_policy_SVM","SVM",6,12,28840,25513,3327,1300,1084,216,0.519201218974915,0.153493699885452,1.25847221453791,586,216,370,57,1.7,4.31,5,0,0,0,0,0,0,0.172801352093485,4028.12698690717,18.0960552648719
7.5,"random_policy_SVM","SVM",6,13,28740,25423,3317,1400,1174,226,0.528632156266052,0.172394043528064,1.59540251924688,629,226,403,43,1.8,4.64,5.2,0,0,0,0,0,0,0.163550198631278,4146.00241436099,16.4333159438331
7.5,"random_policy_SVM","SVM",6,14,28640,25337,3303,1500,1260,240,0.532570012615273,0.18213058419244,1.66168315033666,676,240,436,47,1.8,4.98,5.2,0,0,0,0,0,0,0.161963427192066,3794.41756095055,16.6159090474397
7.5,"random_policy_SVM","SVM",6,15,28540,25255,3285,1600,1342,258,0.53260027207727,0.170675830469645,1.63485409868206,715,258,457,39,1.8,5.31,5.2,0,0,0,0,0,0,0.162695438551625,3848.59325740938,16.4361064128615
7.5,"random_policy_SVM","SVM",6,16,28440,25164,3276,1700,1433,267,0.536526523235096,0.18213058419244,1.78639274864286,756,267,489,41,1.8,5.64,5.4,0,0,0,0,0,0,0.158239061747295,3918.62362813388,15.8373278922203
7.5,"random_policy_SVM","SVM",6,17,28340,25076,3264,1800,1521,279,0.531581207326745,0.15922107674685,1.37684031511114,828,279,549,72,2,5.97,5.5,0,0,0,0,0,0,0.156543059593756,3859.89144792175,15.6853905294008
7.5,"random_policy_SVM","SVM",6,18,28240,24991,3249,1900,1606,294,0.53051580777505,0.166093928980527,1.42604624756687,865,294,571,37,1.9,6.3,5.5,0,0,0,0,0,0,0.157659872121218,3668.48683213489,15.7807452290277
7.5,"random_policy_SVM","SVM",6,19,28140,24899,3241,2000,1698,302,0.530361286800813,0.164375715922108,1.54654997578629,896,302,594,31,2,6.64,5.6,0,0,0,0,0,0,0.152589371218071,3390.90711707752,15.3079389078491
7.5,"random_policy_SVM","SVM",6,20,28040,24815,3225,2100,1782,318,0.530808688419951,0.173539518900344,1.63627571094178,942,318,624,46,2,6.97,5.6,0,0,0,0,0,0,0.153106382622532,3500.44694252126,15.3384031047767
7.5,"random_policy_SVM","SVM",6,21,27940,24727,3213,2200,1870,330,0.532887865912755,0.178694158075601,1.74591219087395,1004,330,674,62,2,7.3,5.7,0,0,0,0,0,0,0.15088751002286,3307.97863963625,15.1187155392127
7.5,"random_policy_SVM","SVM",6,22,27840,24654,3186,2300,1943,357,0.53556643004971,0.183276059564719,1.6677493352953,1066,357,709,62,2,7.63,5.4,0,0,0,0,0,0,0.155347580010734,3290.83799813833,15.6043786264482
7.5,"random_policy_SVM","SVM",6,23,27740,24571,3169,2400,2026,374,0.53111755843966,0.168384879725086,1.58338050896643,1086,374,712,20,1.9,7.96,5.4,0,0,0,0,0,0,0.156709107606026,3379.65742277519,15.7092615530708
7.5,"random_policy_SVM","SVM",6,24,27640,24482,3158,2500,2115,385,0.531404636488871,0.176975945017182,1.66285510238062,1110,385,725,24,1.9,8.29,5.5,0,0,0,0,0,0,0.155078826153348,3697.44478191102,15.5303934936937
7.5,"random_policy_SVM","SVM",6,25,27540,24405,3135,2600,2192,408,0.528916397490705,0.166666666666667,1.62704284888848,1151,408,743,41,1.8,8.63,5.4,0,0,0,0,0,0,0.156975634275515,3392.04810227552,15.7396687057781
7.5,"random_policy_SVM","SVM",6,26,27440,24319,3121,2700,2278,422,0.527240263996614,0.160939289805269,1.44116334559761,1166,422,744,15,1.8,8.96,5.4,0,0,0,0,0,0,0.157400569713302,3476.34213567368,15.793865326933
7.5,"random_policy_SVM","SVM",6,27,27340,24248,3092,2800,2349,451,0.528949278866304,0.168384879725086,1.69619141943907,1231,451,780,65,1.7,9.29,5.2,0,0,0,0,0,0,0.16206613763284,3303.81769698132,16.7578051435029
7.5,"random_policy_SVM","SVM",6,28,27240,24166,3074,2900,2431,469,0.531173822126802,0.175257731958763,1.64017980552998,1340,469,871,109,1.9,9.62,5.2,0,0,0,0,0,0,0.162040832699908,3649.31812356728,16.237027122233
7.5,"random_policy_SVM","SVM",6,29,27140,24087,3053,3000,2510,490,0.533551940753349,0.186139747995418,1.70224337253538,1340,490,850,0,1.7,9.95,5.1,0,0,0,0,0,0,0.163965847526606,3526.58195165737,16.4145604665819
7.5,"random_policy_SVM","SVM",6,30,27040,24009,3031,3100,2588,512,0.522515489706842,0.170675830469645,1.4850287600537,1387,512,875,47,1.7,10.29,5.1,0,0,0,0,0,0,0.166789295883903,3179.47545154352,17.523012224258
7.5,"random_policy_SVM","SVM",6,31,26940,23926,3014,3200,2671,529,0.532096048002511,0.175257731958763,1.64342101972319,1408,529,879,21,1.7,10.62,5,0,0,0,0,0,0,0.165582202690439,4170.66987352873,16.5694931823497
7.5,"random_policy_SVM","SVM",6,32,26840,23847,2993,3300,2750,550,0.529596934510187,0.175257731958763,1.63652722978802,1421,550,871,13,1.6,10.95,5,0,0,0,0,0,0,0.166884545152477,4012.65477327303,16.7075593853228
7.5,"random_policy_SVM","SVM",6,33,26740,23767,2973,3400,2830,570,0.527202654580072,0.171821305841924,1.5362197294256,1520,570,950,99,1.7,11.28,5,0,0,0,0,0,0,0.167958387017225,3929.23919609495,16.8125580073544
7.5,"random_policy_SVM","SVM",6,34,26640,23683,2957,3500,2914,586,0.532528061997506,0.180412371134021,1.78561309149283,1570,586,984,50,1.7,11.61,5,0,0,0,0,0,0,0.167609372977998,3651.22788908407,16.7935887654327
7.5,"random_policy_SVM","SVM",6,35,26540,23601,2939,3600,2996,604,0.531870305538899,0.178121420389462,1.68180497976055,1591,604,987,21,1.6,11.94,5,0,0,0,0,0,0,0.166693647680149,3600.14627165407,16.6996024897017
7.5,"random_policy_SVM","SVM",6,36,26440,23515,2925,3700,3082,618,0.535318895615599,0.186712485681558,1.81561360234436,1584,618,966,-7,1.6,12.28,5,0,0,0,0,0,0,0.16692564730569,3572.68712490065,16.7533271363066
7.5,"random_policy_SVM","SVM",6,37,26340,23431,2909,3800,3166,634,0.532408313615252,0.184421534936999,1.79250714135493,1613,634,979,29,1.5,12.61,5,0,0,0,0,0,0,0.166643813174923,4002.50170972477,16.6776885817694
7.5,"random_policy_SVM","SVM",6,38,26240,23348,2892,3900,3249,651,0.531149494207073,0.178121420389462,1.60017804893487,1685,651,1034,72,1.6,12.94,5,0,0,0,0,0,0,0.167394473133994,3629.19874307243,16.7814824493951
7.5,"random_policy_SVM","SVM",6,39,26140,23264,2876,4000,3333,667,0.532858938898669,0.183276059564719,1.75521967716955,1696,667,1029,11,1.5,13.27,5,0,0,0,0,0,0,0.16657648202611,3490.00023025456,16.7149563329333
7.5,"random_policy_SVM","SVM",6,40,26040,23187,2853,4100,3410,690,0.530871614346591,0.183848797250859,1.72329585240772,1792,690,1102,96,1.6,13.6,4.9,0,0,0,0,0,0,0.168193744398079,3471.71671336624,16.869082174966
7.5,"random_policy_SVM","SVM",6,41,25940,23099,2841,4200,3498,702,0.531170469515952,0.186712485681558,1.81839759610378,1859,702,1157,67,1.6,13.93,5,0,0,0,0,0,0,0.16663545446054,3872.40281344226,16.7017515942269
7.5,"random_policy_SVM","SVM",6,42,25840,23011,2829,4300,3586,714,0.532688342585251,0.180412371134021,1.7112025481803,1844,714,1130,-15,1.6,14.27,5,0,0,0,0,0,0,0.165106010138976,3500.41985791408,16.5690181542145
7.5,"random_policy_SVM","SVM",6,43,25740,22930,2810,4400,3667,733,0.530131031207216,0.183848797250859,1.76730493198614,1871,733,1138,27,1.6,14.6,5,0,0,0,0,0,0,0.165901179671461,3319.2749201235,16.6819090636926
7.5,"random_policy_SVM","SVM",6,44,25640,22842,2798,4500,3755,745,0.53003707213916,0.175257731958763,1.73250595473482,1944,745,1199,73,1.6,14.93,5,0,0,0,0,0,0,0.164678262660651,3400.03058242469,16.520673772351
7.5,"random_policy_SVM","SVM",6,45,25540,22756,2784,4600,3841,759,0.530019922245214,0.175830469644903,1.63077493724043,1955,759,1196,11,1.6,15.26,5.1,0,0,0,0,0,0,0.163463557856592,3348.57802576862,16.4368409111268
7.5,"random_policy_SVM","SVM",6,46,25440,22667,2773,4700,3930,770,0.529989619801029,0.1815578465063,1.66818888970128,2002,770,1232,47,1.6,15.59,5.1,0,0,0,0,0,0,0.163251998304325,3344.75001355408,16.3838276257126
7.5,"random_policy_SVM","SVM",6,47,25340,22577,2763,4800,4020,780,0.529293136388934,0.175257731958763,1.70064726379836,2000,780,1220,-2,1.6,15.93,5.2,0,0,0,0,0,0,0.161789812642256,3568.81155609842,16.2227129327523
7.5,"random_policy_SVM","SVM",6,48,25240,22498,2742,4900,4099,801,0.529205151845328,0.180412371134021,1.78903874425867,2110,801,1309,110,1.6,16.26,5.1,0,0,0,0,0,0,0.162271985362523,3501.30723829827,16.2700552746629
7.5,"random_policy_SVM","SVM",7,0,30040,26563,3477,100,94,6,0.577387119786251,0.182724252491694,1.68682653744469,29,6,23,0,3.8,0.33,15.7,0,0,0,0,0,0,0.468807193506834,1968.83672971385,57.1773049001874
7.5,"random_policy_SVM","SVM",7,1,29940,26486,3454,200,171,29,0.512194222967461,0.157253599114064,1.39951178695655,75,29,46,46,1.6,0.66,5.9,0,0,0,0,0,0,0.369374823255904,3100.57011439671,43.5687559292461
7.5,"random_policy_SVM","SVM",7,2,29840,26400,3440,300,257,43,0.634107253995664,0.243632336655592,2.44455708521725,103,43,60,28,1.4,1,6,0,0,0,0,0,0,0.531437441787837,3208.48593810147,67.0775192773811
7.5,"random_policy_SVM","SVM",7,3,29740,26349,3391,400,308,92,0.612420611614591,0.205426356589147,1.97391845754907,206,92,114,103,1.2,1.33,3.3,0,0,0,0,0,0,0.25456560665218,6360.42800655079,26.7886033719674
7.5,"random_policy_SVM","SVM",7,4,29640,26282,3358,500,375,125,0.587066502369497,0.212624584717608,1.98091196847042,278,125,153,72,1.2,1.66,3,0,0,0,0,0,0,0.279915366655776,5554.74538977544,31.5538640372544
7.5,"random_policy_SVM","SVM",7,5,29540,26213,3327,600,444,156,0.591935308823164,0.170542635658915,1.17409071769278,356,156,200,78,1.3,1.99,2.8,0,0,0,0,0,0,0.292286690464052,7361.94496908227,31.5077899997635
7.5,"random_policy_SVM","SVM",7,6,29440,26123,3317,700,534,166,0.624250216746208,0.207641196013289,1.78234650262208,389,166,223,33,1.3,2.32,3.2,0,0,0,0,0,0,0.254263876737237,6486.65000238628,26.1824026823818
7.5,"random_policy_SVM","SVM",7,7,29340,26046,3294,800,611,189,0.617816037257385,0.260243632336656,2.30382365530033,425,189,236,36,1.2,2.65,3.2,0,0,0,0,0,0,0.263343504088665,6057.65694100786,28.4619997023052
7.5,"random_policy_SVM","SVM",7,8,29240,25968,3272,900,689,211,0.585755088683318,0.236987818383167,2.07700098186637,480,211,269,55,1.3,2.99,3.3,0,0,0,0,0,0,0.260060564506228,6401.48196175232,27.9067568183684
7.5,"random_policy_SVM","SVM",7,9,29140,25894,3246,1000,763,237,0.602875471843024,0.217607973421927,2.05471490094746,542,237,305,62,1.3,3.32,3.2,0,0,0,0,0,0,0.244527809076951,6121.78083107806,25.2707133548779
7.5,"random_policy_SVM","SVM",7,10,29040,25809,3231,1100,848,252,0.596865518005692,0.188261351052049,1.6425934251577,588,252,336,46,1.3,3.65,3.4,0,0,0,0,0,0,0.231097901688629,5969.6096555743,23.377428082286
7.5,"random_policy_SVM","SVM",7,11,28940,25720,3220,1200,937,263,0.596891940797916,0.213178294573643,2.03661168596114,625,263,362,37,1.4,3.98,3.6,0,0,0,0,0,0,0.222846178992198,5607.97873916254,22.3807004357351
7.5,"random_policy_SVM","SVM",7,12,28840,25642,3198,1300,1015,285,0.592719769382875,0.20874861572536,1.87156122803788,675,285,390,50,1.4,4.31,3.6,0,0,0,0,0,0,0.220096744801448,5498.87000217664,22.0868370157429
7.5,"random_policy_SVM","SVM",7,13,28740,25554,3186,1400,1103,297,0.593896147156167,0.186600221483942,1.62487791551412,728,297,431,53,1.5,4.64,3.7,0,0,0,0,0,0,0.212735739567685,5077.37015692045,21.3813632053575
7.5,"random_policy_SVM","SVM",7,14,28640,25475,3165,1500,1182,318,0.593099163946116,0.189922480620155,1.71310658060991,764,318,446,36,1.4,4.98,3.7,0,0,0,0,0,0,0.211139491261352,5363.81117942241,21.1413453263397
7.5,"random_policy_SVM","SVM",7,15,28540,25389,3151,1600,1268,332,0.591737200494736,0.188261351052049,1.57976479220594,798,332,466,34,1.4,5.31,3.8,0,0,0,0,0,0,0.207194253013613,5253.31332883323,20.7357013063155
7.5,"random_policy_SVM","SVM",7,16,28440,25318,3122,1700,1339,361,0.593129385275624,0.188261351052049,1.62953271154917,886,361,525,88,1.5,5.64,3.7,0,0,0,0,0,0,0.234208270176978,5480.71504263346,24.3165287102752
7.5,"random_policy_SVM","SVM",7,17,28340,25229,3111,1800,1428,372,0.601600540811525,0.191583610188261,1.76793860627319,907,372,535,21,1.4,5.97,3.8,0,0,0,0,0,0,0.20533934743067,5014.86730857053,20.6064709954149
7.5,"random_policy_SVM","SVM",7,18,28240,25154,3086,1900,1503,397,0.601997007921412,0.18936877076412,1.58568878209044,979,397,582,72,1.5,6.3,3.8,0,0,0,0,0,0,0.213151628594533,5574.46261464179,21.673517646604
7.5,"random_policy_SVM","SVM",7,19,28140,25077,3063,2000,1580,420,0.603369532141258,0.188261351052049,1.68363253093975,1025,420,605,46,1.4,6.64,3.8,0,0,0,0,0,0,0.209495074514732,5794.05763324818,20.9725849255016
7.5,"random_policy_SVM","SVM",7,20,28040,24994,3046,2100,1663,437,0.609509220636162,0.198228128460687,1.72654370489174,1088,437,651,63,1.5,6.97,3.8,0,0,0,0,0,0,0.210598309047827,5031.12274151229,21.7678287476061
7.5,"random_policy_SVM","SVM",7,21,27940,24915,3025,2200,1742,458,0.616114835208181,0.207087486157254,1.8812763497892,1127,458,669,39,1.5,7.3,3.8,0,0,0,0,0,0,0.207080658605126,5180.5507552323,20.7495326861316
7.5,"random_policy_SVM","SVM",7,22,27840,24831,3009,2300,1826,474,0.610298940709009,0.204318936877076,1.83735550115599,1148,474,674,21,1.4,7.63,3.9,0,0,0,0,0,0,0.20529087810272,4900.10807087124,21.4726856572727
7.5,"random_policy_SVM","SVM",7,23,27740,24739,3001,2400,1918,482,0.59650732846369,0.178294573643411,1.51526927784578,1200,482,718,52,1.5,7.96,4,0,0,0,0,0,0,0.205154964667574,5094.46357226796,20.9957466981236
7.5,"random_policy_SVM","SVM",7,24,27640,24644,2996,2500,2013,487,0.603613890791634,0.198228128460687,1.71421843660216,1209,487,722,9,1.5,8.29,4.1,0,0,0,0,0,0,0.194628270421922,4407.52286714152,19.542406538727
7.5,"random_policy_SVM","SVM",7,25,27540,24557,2983,2600,2100,500,0.605450504433226,0.197674418604651,1.87870855148342,1238,500,738,29,1.5,8.63,4.2,0,0,0,0,0,0,0.19117023245821,4839.82385908962,19.1606789094033
7.5,"random_policy_SVM","SVM",7,26,27440,24470,2970,2700,2187,513,0.603921238373244,0.188261351052049,1.58847069223446,1285,513,772,47,1.5,8.96,4.3,0,0,0,0,0,0,0.19000367634291,4296.62843812757,19.0277273520467
7.5,"random_policy_SVM","SVM",7,27,27340,24382,2958,2800,2275,525,0.607502799855898,0.205426356589147,1.92124766692552,1276,525,751,-9,1.4,9.29,4.3,0,0,0,0,0,0,0.186846105226655,4269.97355951366,18.9987090276627
7.5,"random_policy_SVM","SVM",7,28,27240,24292,2948,2900,2365,535,0.605926198177617,0.20874861572536,1.86258361602703,1323,535,788,47,1.5,9.62,4.4,0,0,0,0,0,0,0.182932171716025,4388.72716477314,18.3249991266351
7.5,"random_policy_SVM","SVM",7,29,27140,24208,2932,3000,2449,551,0.602428955873929,0.197120708748616,1.69678440644342,1385,551,834,62,1.5,9.95,4.4,0,0,0,0,0,0,0.182241368455302,4124.49650483397,18.2486086990894
7.5,"random_policy_SVM","SVM",7,30,27040,24125,2915,3100,2532,568,0.601936356551576,0.196013289036545,1.69392446969387,1410,568,842,25,1.5,10.29,4.5,0,0,0,0,0,0,0.182399216917008,4613.49951254905,18.2493043527155
7.5,"random_policy_SVM","SVM",7,31,26940,24038,2902,3200,2619,581,0.603053418704416,0.199335548172757,1.81254588190923,1459,581,878,49,1.5,10.62,4.5,0,0,0,0,0,0,0.180770279751611,4301.30426285514,18.1017645070154
7.5,"random_policy_SVM","SVM",7,32,26840,23952,2888,3300,2705,595,0.604712377679793,0.210963455149502,1.86740391391554,1486,595,891,27,1.5,10.95,4.5,0,0,0,0,0,0,0.178712335515189,3997.15653794315,17.9268571844511
7.5,"random_policy_SVM","SVM",7,33,26740,23871,2869,3400,2786,614,0.607071394551555,0.20874861572536,1.9302768744077,1509,614,895,23,1.5,11.28,4.5,0,0,0,0,0,0,0.179913216878234,4382.03708244732,18.0059975748195
7.5,"random_policy_SVM","SVM",7,34,26640,23791,2849,3500,2866,634,0.609350600398475,0.210409745293466,1.91846573968667,1568,634,934,59,1.5,11.61,4.5,0,0,0,0,0,0,0.180463635318702,4167.39747001988,18.076386077846
7.5,"random_policy_SVM","SVM",7,35,26540,23710,2830,3600,2947,653,0.604307645620676,0.209856035437431,1.89162155403716,1605,653,952,37,1.5,11.94,4.5,0,0,0,0,0,0,0.180639643249698,4337.94937884155,18.082881869669
7.5,"random_policy_SVM","SVM",7,36,26440,23633,2807,3700,3024,676,0.600255149000752,0.202104097452935,1.71850859748096,1702,676,1026,97,1.5,12.28,4.5,0,0,0,0,0,0,0.182659478560972,4469.16980787064,18.2740310062685
7.5,"random_policy_SVM","SVM",7,37,26340,23542,2798,3800,3115,685,0.60201917301252,0.199889258028793,1.71122678138994,1724,685,1039,22,1.5,12.61,4.5,0,0,0,0,0,0,0.179531239297422,4301.27738925263,17.9791683167239
7.5,"random_policy_SVM","SVM",7,38,26240,23450,2790,3900,3207,693,0.603612471557934,0.200442967884828,1.7887274749571,1698,693,1005,-26,1.5,12.94,4.6,0,0,0,0,0,0,0.17538865935324,3649.67098912157,17.6148989780423
7.5,"random_policy_SVM","SVM",7,39,26140,23364,2776,4000,3293,707,0.60090908180171,0.197120708748616,1.5929961036669,1802,707,1095,104,1.5,13.27,4.7,0,0,0,0,0,0,0.176082997558367,4266.39712212391,17.6168030847241
7.5,"random_policy_SVM","SVM",7,40,26040,23275,2765,4100,3382,718,0.601886140723702,0.197674418604651,1.67778412996577,1786,718,1068,-16,1.5,13.6,4.7,0,0,0,0,0,0,0.174664162612712,4406.88163467173,17.4709256469502
7.5,"random_policy_SVM","SVM",7,41,25940,23188,2752,4200,3469,731,0.606328634417501,0.223145071982281,1.99489879037185,1808,731,1077,22,1.5,13.93,4.7,0,0,0,0,0,0,0.173567092688753,4275.84494069782,17.3692917250144
7.5,"random_policy_SVM","SVM",7,42,25840,23107,2733,4300,3550,750,0.603905668544646,0.218715393133998,1.82045402275525,1864,750,1114,56,1.5,14.27,4.7,0,0,0,0,0,0,0.173960246807346,3787.25314832279,17.4016542156387
7.5,"random_policy_SVM","SVM",7,43,25740,23022,2718,4400,3635,765,0.604814103342757,0.218161683277962,1.99347809925454,1904,765,1139,40,1.5,14.6,4.8,0,0,0,0,0,0,0.172336370564876,3841.69972130781,17.2751111546187
7.5,"random_policy_SVM","SVM",7,44,25640,22940,2700,4500,3717,783,0.599381986334448,0.214285714285714,1.87217391304348,1949,783,1166,45,1.5,14.93,4.7,0,0,0,0,0,0,0.173572752749666,3860.37256173532,17.3822051644219
7.5,"random_policy_SVM","SVM",7,45,25540,22857,2683,4600,3800,800,0.602676946092915,0.20874861572536,1.97297682564249,1945,800,1145,-4,1.4,15.26,4.8,0,0,0,0,0,0,0.173073716117458,3768.9357353234,17.3465304345874
7.5,"random_policy_SVM","SVM",7,46,25440,22770,2670,4700,3887,813,0.600350529854209,0.206533776301218,1.76528026237329,2010,813,1197,65,1.5,15.59,4.8,0,0,0,0,0,0,0.172762080713872,3976.40635067296,17.2857582919072
7.5,"random_policy_SVM","SVM",7,47,25340,22682,2658,4800,3975,825,0.59260606371775,0.18936877076412,1.65297225266177,2018,825,1193,8,1.4,15.93,4.8,0,0,0,0,0,0,0.171387953676045,3717.7886654799,17.1800765366462
7.5,"random_policy_SVM","SVM",7,48,25240,22599,2641,4900,4058,842,0.600701080579503,0.215946843853821,1.83516896540152,2104,842,1262,86,1.5,16.26,4.8,0,0,0,0,0,0,0.171510623882428,4079.56791626468,17.1592845244747
7.5,"random_policy_SVM","SVM",8,0,30040,26552,3488,100,86,14,0.399367348613486,0.0861779518746503,0.684625856181052,46,14,32,0,2.3,0.33,6.1,0,0,0,0,0,0,0.208015973736309,4064.62572318119,21.5367078777033
7.5,"random_policy_SVM","SVM",8,1,29940,26457,3483,200,181,19,0.592353992929965,0.19306099608282,1.80826464667662,59,19,40,13,2.1,0.66,9.5,0,0,0,0,0,0,0.517300511036493,3813.41684488066,58.0813155816991
7.5,"random_policy_SVM","SVM",8,2,29840,26404,3436,300,234,66,0.592049593007279,0.158925573587017,1.42165763565071,146,66,80,87,1.2,1,3.5,0,0,0,0,0,0,0.357388408286495,5255.79357801641,39.9822387358615
7.5,"random_policy_SVM","SVM",8,3,29740,26325,3415,400,313,87,0.609618746890074,0.198656966983772,1.81945040180207,194,87,107,48,1.2,1.33,3.6,0,0,0,0,0,0,0.570555251631623,6243.68914710953,65.1548609907829
7.5,"random_policy_SVM","SVM",8,4,29640,26243,3397,500,395,105,0.554596270330048,0.132624510352546,0.948514140437891,260,105,155,66,1.5,1.66,3.8,0,0,0,0,0,0,0.236259708122681,6134.76349297799,24.1538866511453
7.5,"random_policy_SVM","SVM",8,5,29540,26159,3381,600,479,121,0.550384169047187,0.113038612199217,0.748642571551382,301,121,180,41,1.5,1.99,4,0,0,0,0,0,0,0.386706650892346,5403.9114271029,41.1309991962102
7.5,"random_policy_SVM","SVM",8,6,29440,26070,3370,700,568,132,0.556219961254517,0.140458869613878,1.17578090762603,332,132,200,31,1.5,2.32,4.3,0,0,0,0,0,0,0.360360791748305,5120.7603027441,40.3470880449164
7.5,"random_policy_SVM","SVM",8,7,29340,25974,3366,800,664,136,0.568324597316728,0.160044767767208,1.40685523722126,362,136,226,30,1.7,2.65,4.9,0,0,0,0,0,0,0.186415737024459,4538.37611205443,19.4948126177873
7.5,"random_policy_SVM","SVM",8,8,29240,25882,3358,900,756,144,0.561038735037603,0.143816452154449,1.27669360340163,388,144,244,26,1.7,2.99,5.2,0,0,0,0,0,0,0.16395091193964,4609.72166450558,16.4608224435384
7.5,"random_policy_SVM","SVM",8,9,29140,25793,3347,1000,845,155,0.563238515242826,0.181309457190823,1.56367086084285,418,155,263,30,1.7,3.32,5.5,0,0,0,0,0,0,0.16905331321658,4083.29050100918,17.1527277213311
7.5,"random_policy_SVM","SVM",8,10,29040,25703,3337,1100,935,165,0.555969861290358,0.163402350307778,1.45211078218763,450,165,285,32,1.7,3.65,5.7,0,0,0,0,0,0,0.159454177941235,4018.13831984485,15.9947972070497
7.5,"random_policy_SVM","SVM",8,11,28940,25616,3324,1200,1022,178,0.562635655113625,0.158365976496922,1.31078665205629,479,178,301,29,1.7,3.98,5.7,0,0,0,0,0,0,0.152021824206253,3832.15860224574,15.2493427337584
7.5,"random_policy_SVM","SVM",8,12,28840,25538,3302,1300,1100,200,0.577579391257445,0.181309457190823,1.4775411313568,531,200,331,52,1.7,4.31,5.5,0,0,0,0,0,0,0.154968518731189,3992.19642567914,15.7857722499971
7.5,"random_policy_SVM","SVM",8,13,28740,25464,3276,1400,1174,226,0.553608508167405,0.169557918298825,1.40808494860853,592,226,366,61,1.6,4.64,5.2,0,0,0,0,0,0,0.200186978058242,4064.81102091237,22.6158831031758
7.5,"random_policy_SVM","SVM",8,14,28640,25385,3255,1500,1253,247,0.575037782492485,0.173475097929491,1.47608079262966,615,247,368,23,1.5,4.98,5.1,0,0,0,0,0,0,0.418575962037805,4005.36478843398,51.8045681311704
7.5,"random_policy_SVM","SVM",8,15,28540,25300,3240,1600,1338,262,0.580421124191971,0.188584219362059,1.54000155202638,635,262,373,20,1.4,5.31,5.1,0,0,0,0,0,0,0.260366142289932,3606.00613018576,34.2380073082541
7.5,"random_policy_SVM","SVM",8,16,28440,25211,3229,1700,1427,273,0.591208849351441,0.208170117515389,1.98788770062688,656,273,383,21,1.4,5.64,5.2,0,0,0,0,0,0,0.17801045616849,3197.96680726257,19.1413065461227
7.5,"random_policy_SVM","SVM",8,17,28340,25127,3213,1800,1511,289,0.582188611011275,0.192501398992725,1.72356587972817,687,289,398,31,1.4,5.97,5.2,0,0,0,0,0,0,0.309652905886865,2810.43336510238,37.1460321775166
7.5,"random_policy_SVM","SVM",8,18,28240,25032,3208,1900,1606,294,0.600560026771692,0.200895355344152,2.0191283537737,711,294,417,24,1.4,6.3,5.5,0,0,0,0,0,0,0.168092857925003,2596.11758434327,18.0603918765255
7.5,"random_policy_SVM","SVM",8,19,28140,24952,3188,2000,1686,314,0.597035079036978,0.204812534974818,2.01048472093957,773,314,459,62,1.5,6.64,5.4,0,0,0,0,0,0,0.160269111913853,2957.68950946543,16.1624421284717
7.5,"random_policy_SVM","SVM",8,20,28040,24881,3159,2100,1757,343,0.59702631690248,0.203693340794628,1.98570954838442,845,343,502,72,1.5,6.97,5.1,0,0,0,0,0,0,0.231865813763069,3092.2697606974,26.2345189328073
7.5,"random_policy_SVM","SVM",8,21,27940,24803,3137,2200,1835,365,0.600051275337097,0.210408505875769,1.91741507090505,915,365,550,70,1.5,7.3,5,0,0,0,0,0,0,0.175505623514455,3664.53920789207,19.9584149573606
7.5,"random_policy_SVM","SVM",8,22,27840,24747,3093,2300,1891,409,0.598946108997241,0.190263010632345,1.78291118114256,973,409,564,58,1.4,7.63,4.6,0,0,0,0,0,0,0.272961403597145,4256.78740995584,41.5532265900703
7.5,"random_policy_SVM","SVM",8,23,27740,24660,3080,2400,1978,422,0.60965689166311,0.199776161163962,1.77512554279696,1025,422,603,52,1.4,7.96,4.7,0,0,0,0,0,0,0.179090239931028,4542.01276787003,21.5601114885016
7.5,"random_policy_SVM","SVM",8,24,27640,24580,3060,2500,2058,442,0.606378842343426,0.193620593172915,1.77085306977926,1094,442,652,69,1.5,8.29,4.7,0,0,0,0,0,0,0.177059074272504,4762.89087091136,18.1023775695872
7.5,"random_policy_SVM","SVM",8,25,27540,24500,3040,2600,2138,462,0.614270029102085,0.216564073866816,2.00182648270452,1129,462,667,35,1.4,8.63,4.6,0,0,0,0,0,0,0.17773319898978,4783.60478345635,17.7822220498369
7.5,"random_policy_SVM","SVM",8,26,27440,24420,3020,2700,2218,482,0.611219289771717,0.206491326245104,1.9496057384138,1173,482,691,44,1.4,8.96,4.6,0,0,0,0,0,0,0.178310250726455,4777.92465567182,17.8367481890551
7.5,"random_policy_SVM","SVM",8,27,27340,24336,3004,2800,2302,498,0.614231989643165,0.210408505875769,1.98101941920966,1235,498,737,62,1.5,9.29,4.6,0,0,0,0,0,0,0.177784700897534,4812.14204222387,17.7797425446453
7.5,"random_policy_SVM","SVM",8,28,27240,24256,2984,2900,2382,518,0.614420796791435,0.206491326245104,1.95015385298771,1279,518,761,44,1.5,9.62,4.6,0,0,0,0,0,0,0.17846786081733,4776.35273637137,17.8520440746126
7.5,"random_policy_SVM","SVM",8,29,27140,24171,2969,3000,2467,533,0.614692886343151,0.217123670956911,1.95626777586117,1303,533,770,24,1.4,9.95,4.6,0,0,0,0,0,0,0.177562266348128,4751.62296931004,17.7580770572339
7.5,"random_policy_SVM","SVM",8,30,27040,24089,2951,3100,2549,551,0.612282667470075,0.196418578623391,1.83914476450978,1361,551,810,58,1.5,10.29,4.6,0,0,0,0,0,0,0.177725601274012,4582.93906372533,17.7833233593162
7.5,"random_policy_SVM","SVM",8,31,26940,24006,2934,3200,2632,568,0.608956384284979,0.200895355344152,1.76894581941037,1417,568,849,56,1.5,10.62,4.6,0,0,0,0,0,0,0.177488320474979,4653.12142900336,17.7926183417413
7.5,"random_policy_SVM","SVM",8,32,26840,23913,2927,3300,2725,575,0.60928407969027,0.192501398992725,1.72923571483788,1424,575,849,7,1.5,10.95,4.7,0,0,0,0,0,0,0.174213791107395,4494.46423161246,17.4271928219088
7.5,"random_policy_SVM","SVM",8,33,26740,23832,2908,3400,2806,594,0.614856165349561,0.214325685506435,1.94283906163479,1480,594,886,56,1.5,11.28,4.7,0,0,0,0,0,0,0.174519336045548,4590.72712723783,17.4576874310307
7.5,"random_policy_SVM","SVM",8,34,26640,23742,2898,3500,2896,604,0.611569859403128,0.21152770005596,1.94280008949602,1480,604,876,0,1.5,11.61,4.8,0,0,0,0,0,0,0.178530079135291,4447.54191451538,18.4908763446136
7.5,"random_policy_SVM","SVM",8,35,26540,23667,2873,3600,2971,629,0.608656955188587,0.199776161163962,1.76193301661964,1547,629,918,67,1.5,11.94,4.7,0,0,0,0,0,0,0.174556582933243,4567.61660608274,17.4911754646342
7.5,"random_policy_SVM","SVM",8,36,26440,23587,2853,3700,3051,649,0.609219964456057,0.202014549524342,1.87001380207664,1610,649,961,63,1.5,12.28,4.7,0,0,0,0,0,0,0.175547475489331,4587.58278366886,17.6056990560841
7.5,"random_policy_SVM","SVM",8,37,26340,23509,2831,3800,3129,671,0.616316071759862,0.218802462227196,2.0827541908956,1657,671,986,47,1.5,12.61,4.7,0,0,0,0,0,0,0.177277651603695,4190.96745904304,17.7699328321461
7.5,"random_policy_SVM","SVM",8,38,26240,23421,2819,3900,3217,683,0.613894647464782,0.214325685506435,1.99860829369521,1655,683,972,-2,1.4,12.94,4.7,0,0,0,0,0,0,0.174947325490459,4448.12797779556,17.4998342110146
7.5,"random_policy_SVM","SVM",8,39,26140,23338,2802,4000,3300,700,0.611913267674617,0.203133743704533,1.89297620123991,1709,700,1009,54,1.4,13.27,4.7,0,0,0,0,0,0,0.178693056864481,4411.4397665683,18.0317402049721
7.5,"random_policy_SVM","SVM",8,40,26040,23265,2775,4100,3373,727,0.612186789498308,0.208729714605484,1.84234606087968,1807,727,1080,98,1.5,13.6,4.6,0,0,0,0,0,0,0.177243136382616,4516.59838205511,17.7261520751301
7.5,"random_policy_SVM","SVM",8,41,25940,23178,2762,4200,3460,740,0.611051334818519,0.207610520425294,1.92436781731501,1838,740,1098,31,1.5,13.93,4.7,0,0,0,0,0,0,0.176025206025446,4386.63628189474,17.6138843256608
7.5,"random_policy_SVM","SVM",8,42,25840,23089,2751,4300,3549,751,0.610077600496209,0.200895355344152,1.80407581324055,1876,751,1125,38,1.5,14.27,4.7,0,0,0,0,0,0,0.174683822061464,4336.5437572685,17.4763174100393
7.5,"random_policy_SVM","SVM",8,43,25740,23005,2735,4400,3633,767,0.610715045781307,0.203133743704533,1.82828195866808,1901,767,1134,25,1.5,14.6,4.7,0,0,0,0,0,0,0.174269908956342,4436.73823630734,17.4280866204657
7.5,"random_policy_SVM","SVM",8,44,25640,22917,2723,4500,3721,779,0.61118596838522,0.194739787353106,1.75917413082213,1902,779,1123,1,1.4,14.93,4.8,0,0,0,0,0,0,0.173961173219577,3973.0408471827,17.414118824855
7.5,"random_policy_SVM","SVM",8,45,25540,22826,2714,4600,3812,788,0.608573504282584,0.190263010632345,1.68821196989916,1929,788,1141,27,1.4,15.26,4.8,0,0,0,0,0,0,0.171131382032631,4096.20601884202,17.119704051605
7.5,"random_policy_SVM","SVM",8,46,25440,22736,2704,4700,3902,798,0.612031809244287,0.204252937884723,1.84048049821307,1950,798,1152,21,1.4,15.59,4.9,0,0,0,0,0,0,0.169586737648917,4229.02207938645,16.9612453762159
7.5,"random_policy_SVM","SVM",8,47,25340,22648,2692,4800,3990,810,0.610623001243381,0.198097369893677,1.78447651141573,1990,810,1180,40,1.5,15.93,4.9,0,0,0,0,0,0,0.168718519489457,4230.28580467446,16.8740289492412
7.5,"random_policy_SVM","SVM",8,48,25240,22565,2675,4900,4073,827,0.610434825979803,0.19306099608282,1.73656298481601,2024,827,1197,34,1.4,16.26,4.9,0,0,0,0,0,0,0.167026336340546,3050.96484848648,16.7453660295643
7.5,"random_policy_SVM","SVM",9,0,30040,26597,3443,100,89,11,0.398841941266614,0,0.631210719964546,40,11,29,0,2.6,0.33,8.1,0,0,0,0,0,0,0.121547544820757,3343.3127429528,12.1960479657434
7.5,"random_policy_SVM","SVM",9,1,29940,26504,3436,200,182,18,0.429965238063477,0.108991825613079,0.984694198556778,66,18,48,26,2.7,0.66,10.1,0,0,0,0,0,0,0.101162651407624,2703.61815762982,10.3181791791684
7.5,"random_policy_SVM","SVM",9,2,29840,26419,3421,300,267,33,0.409729224977211,0.0861035422343324,0.738091682771369,114,33,81,48,2.5,1,8.1,0,0,0,0,0,0,0.156036904967883,3166.37016672176,15.8765879786326
7.5,"random_policy_SVM","SVM",9,3,29740,26328,3412,400,358,42,0.599334158430116,0.2141689373297,1.810527641538,139,42,97,25,2.3,1.33,8.5,0,0,0,0,0,0,0.107038451400319,3128.33700210983,10.7360278402226
7.5,"random_policy_SVM","SVM",9,4,29640,26241,3399,500,445,55,0.589930154981497,0.202179836512262,2.08054968950845,155,55,100,16,1.8,1.66,8.1,0,0,0,0,0,0,0.219487908803397,3072.83439944442,25.9518350992661
7.5,"random_policy_SVM","SVM",9,5,29540,26178,3362,600,508,92,0.529494986425433,0.145504087193461,1.17018205492995,257,92,165,102,1.8,1.99,5.5,0,0,0,0,0,0,0.183477611599406,4460.30105251166,19.4950544745464
7.5,"random_policy_SVM","SVM",9,6,29440,26094,3346,700,592,108,0.544999806489277,0.148773841961853,1.25467581151782,295,108,187,38,1.7,2.32,5.5,0,0,0,0,0,0,0.186009225901726,4272.24909474996,19.8893413821261
7.5,"random_policy_SVM","SVM",9,7,29340,26013,3327,800,673,127,0.556660309633625,0.155313351498638,1.36152646840257,333,127,206,38,1.6,2.65,5.3,0,0,0,0,0,0,0.184489674364579,3778.10411935012,20.2968027939103
7.5,"random_policy_SVM","SVM",9,8,29240,25937,3303,900,749,151,0.54170151918268,0.141144414168937,1.15797980947774,403,151,252,70,1.7,2.99,5,0,0,0,0,0,0,0.215565701869355,3622.41899707514,22.3227194079844
7.5,"random_policy_SVM","SVM",9,9,29140,25847,3293,1000,839,161,0.530452946838901,0.125885558583106,0.947935046129077,423,161,262,20,1.6,3.32,5.2,0,0,0,0,0,0,0.178658444983095,3695.60148616778,18.0669512855276
7.5,"random_policy_SVM","SVM",9,10,29040,25757,3283,1100,929,171,0.540012870521567,0.153133514986376,1.20345887940153,465,171,294,42,1.7,3.65,5.4,0,0,0,0,0,0,0.169420104164889,3959.77407086538,17.2385074638695
7.5,"random_policy_SVM","SVM",9,11,28940,25679,3261,1200,1007,193,0.52954781073499,0.139509536784741,1.1164763322445,532,193,339,67,1.8,3.98,5.2,0,0,0,0,0,0,0.169551912880667,3721.406090967,17.3396657126683
7.5,"random_policy_SVM","SVM",9,12,28840,25590,3250,1300,1096,204,0.529858292510804,0.13732970027248,1.18948040965893,560,204,356,28,1.7,4.31,5.4,0,0,0,0,0,0,0.172327395115245,3164.02721377845,17.3226858743704
7.5,"random_policy_SVM","SVM",9,13,28740,25506,3234,1400,1180,220,0.540717990650555,0.15858310626703,1.52683671632117,584,220,364,24,1.7,4.64,5.4,0,0,0,0,0,0,0.157504955697341,4173.48000838211,16.0340916817554
7.5,"random_policy_SVM","SVM",9,14,28640,25434,3206,1500,1252,248,0.535458575118805,0.148773841961853,1.33165610738704,667,248,419,83,1.7,4.98,5,0,0,0,0,0,0,0.169938375197172,3613.01220598871,17.0655506878932
7.5,"random_policy_SVM","SVM",9,15,28540,25348,3192,1600,1338,262,0.537625565812997,0.154223433242507,1.37121474972422,724,262,462,57,1.8,5.31,5.1,0,0,0,0,0,0,0.162902577249327,3677.17744681462,16.3223083165905
7.5,"random_policy_SVM","SVM",9,16,28440,25259,3181,1700,1427,273,0.534971957414469,0.143869209809264,1.3904598690186,749,273,476,25,1.7,5.64,5.2,0,0,0,0,0,0,0.160211126724551,3415.98592869407,16.110119286213
7.5,"random_policy_SVM","SVM",9,17,28340,25169,3171,1800,1517,283,0.539209677512323,0.154768392370572,1.48116211369617,809,283,526,60,1.9,5.97,5.4,0,0,0,0,0,0,0.158219310317705,2962.08403453282,15.9444736783158
7.5,"random_policy_SVM","SVM",9,18,28240,25084,3156,1900,1602,298,0.537521728783605,0.15858310626703,1.41207323485826,831,298,533,22,1.8,6.3,5.4,0,0,0,0,0,0,0.155945139885151,3271.83762765775,15.6338410869726
7.5,"random_policy_SVM","SVM",9,19,28140,25001,3139,2000,1685,315,0.53144051027542,0.148773841961853,1.21648584945086,863,315,548,32,1.7,6.64,5.3,0,0,0,0,0,0,0.158021623290271,3058.26146501542,15.8609475243272
7.5,"random_policy_SVM","SVM",9,20,28040,24914,3126,2100,1772,328,0.535021199717062,0.158038147138965,1.53949845450362,911,328,583,48,1.8,6.97,5.4,0,0,0,0,0,0,0.154515844561783,3300.28154340456,15.5052772707717
7.5,"random_policy_SVM","SVM",9,21,27940,24829,3111,2200,1857,343,0.534756995824287,0.162942779291553,1.48603812789945,928,343,585,17,1.7,7.3,5.4,0,0,0,0,0,0,0.154247399709577,3461.3788709084,15.4730586382242
7.5,"random_policy_SVM","SVM",9,22,27840,24738,3102,2300,1948,352,0.531937709310663,0.146594005449591,1.35569601275537,976,352,624,48,1.8,7.63,5.5,0,0,0,0,0,0,0.152327337160125,2930.94745279665,15.2838387436886
7.5,"random_policy_SVM","SVM",9,23,27740,24649,3091,2400,2037,363,0.532432149788825,0.150953678474114,1.28690850827033,1030,363,667,54,1.8,7.96,5.6,0,0,0,0,0,0,0.150858145673929,3138.00609728451,15.136522418091
7.5,"random_policy_SVM","SVM",9,24,27640,24557,3083,2500,2129,371,0.533835349550354,0.152588555858311,1.42302248615435,1095,371,724,65,2,8.29,5.7,0,0,0,0,0,0,0.147495429827124,3119.46807323616,14.7966997059772
7.5,"random_policy_SVM","SVM",9,25,27540,24466,3074,2600,2220,380,0.531235882981182,0.143869209809264,1.28126911953996,1093,380,713,-2,1.9,8.63,5.8,0,0,0,0,0,0,0.145056709086281,2990.88883599578,14.5423422453202
7.5,"random_policy_SVM","SVM",9,26,27440,24375,3065,2700,2311,389,0.52984215289323,0.150408719346049,1.37973918092306,1132,389,743,39,1.9,8.96,5.9,0,0,0,0,0,0,0.141506363098378,2681.19780425518,14.2033508610822
7.5,"random_policy_SVM","SVM",9,27,27340,24287,3053,2800,2399,401,0.528537602426873,0.147683923705722,1.32377183496333,1179,401,778,47,1.9,9.29,6,0,0,0,0,0,0,0.140972047291364,2733.92627986856,14.1471474348208
7.5,"random_policy_SVM","SVM",9,28,27240,24195,3045,2900,2491,409,0.531100837201491,0.152043596730245,1.41954452181518,1202,409,793,23,1.9,9.62,6.1,0,0,0,0,0,0,0.138066063040798,2508.93707868122,13.873796834187
7.5,"random_policy_SVM","SVM",9,29,27140,24112,3028,3000,2574,426,0.529305510608922,0.152588555858311,1.32700403364944,1239,426,813,37,1.9,9.95,6,0,0,0,0,0,0,0.138966331907407,2779.17677765031,13.9594941120664
7.5,"random_policy_SVM","SVM",9,30,27040,24024,3016,3100,2662,438,0.530828604672427,0.155858310626703,1.39721637889248,1233,438,795,-6,1.8,10.29,6.1,0,0,0,0,0,0,0.139297021917076,2820.8918263547,13.9703263226048
7.5,"random_policy_SVM","SVM",9,31,26940,23941,2999,3200,2745,455,0.531637438313316,0.157493188010899,1.42553001476431,1347,455,892,114,2,10.62,6,0,0,0,0,0,0,0.138892989474395,2696.31038188216,14.0271376804229
7.5,"random_policy_SVM","SVM",9,32,26840,23851,2989,3300,2835,465,0.534270419292448,0.160762942779292,1.5036034128183,1312,465,847,-35,1.8,10.95,6.1,0,0,0,0,0,0,0.137142662075764,2730.65150915238,13.7684833470538
7.5,"random_policy_SVM","SVM",9,33,26740,23765,2975,3400,2921,479,0.533669465572799,0.15858310626703,1.53589625203044,1350,479,871,38,1.8,11.28,6.1,0,0,0,0,0,0,0.137509339325768,2581.86698654482,13.8432186623122
7.5,"random_policy_SVM","SVM",9,34,26640,23685,2955,3500,3001,499,0.531754656403189,0.157493188010899,1.28484641525697,1402,499,903,52,1.8,11.61,6,0,0,0,0,0,0,0.140661115545047,3019.58262767222,14.0915174861733
7.5,"random_policy_SVM","SVM",9,35,26540,23603,2937,3600,3083,517,0.531140280450562,0.153678474114441,1.39873398141428,1449,517,932,47,1.8,11.94,6,0,0,0,0,0,0,0.141966955650979,2969.09541214083,14.2235691411232
7.5,"random_policy_SVM","SVM",9,36,26440,23514,2926,3700,3172,528,0.530344827870159,0.159128065395095,1.2881865705826,1450,528,922,1,1.7,12.28,6,0,0,0,0,0,0,0.138681810617712,2535.60198223207,13.9981620851564
7.5,"random_policy_SVM","SVM",9,37,26340,23428,2912,3800,3258,542,0.534914315923131,0.166212534059946,1.51637236306217,1523,542,981,73,1.8,12.61,6,0,0,0,0,0,0,0.140033693491775,2736.44576638235,14.0702642343177
7.5,"random_policy_SVM","SVM",9,38,26240,23338,2902,3900,3348,552,0.528481607835292,0.15149863760218,1.3712395914712,1575,552,1023,52,1.9,12.94,6.1,0,0,0,0,0,0,0.140034808440595,2939.80662751644,14.0456494561399
7.5,"random_policy_SVM","SVM",9,39,26140,23249,2891,4000,3437,563,0.530661567865037,0.154223433242507,1.41901365251009,1536,563,973,-39,1.7,13.27,6.1,0,0,0,0,0,0,0.137960969289777,2593.06680540835,13.8355238473425
7.5,"random_policy_SVM","SVM",9,40,26040,23157,2883,4100,3529,571,0.532350381216119,0.164577656675749,1.51538098524247,1620,571,1049,84,1.8,13.6,6.2,0,0,0,0,0,0,0.135846123617132,2650.32682109187,13.6376131995733
7.5,"random_policy_SVM","SVM",9,41,25940,23076,2864,4200,3610,590,0.530586469236324,0.155858310626703,1.3395663640735,1647,590,1057,27,1.8,13.93,6.1,0,0,0,0,0,0,0.13864571619144,2717.13277205782,13.9038485409356
7.5,"random_policy_SVM","SVM",9,42,25840,22990,2850,4300,3696,604,0.530116979289411,0.155313351498638,1.40012067636228,1630,604,1026,-17,1.7,14.27,6.1,0,0,0,0,0,0,0.137799355493622,2660.58973280251,13.9748023474773
7.5,"random_policy_SVM","SVM",9,43,25740,22903,2837,4400,3783,617,0.530699693594298,0.162397820163488,1.44469287934452,1674,617,1057,44,1.7,14.6,6.1,0,0,0,0,0,0,0.136831333509592,2648.12614447082,13.8078386724142
7.5,"random_policy_SVM","SVM",9,44,25640,22817,2823,4500,3869,631,0.530969291083767,0.168937329700272,1.56128380999188,1719,631,1088,45,1.7,14.93,6.1,0,0,0,0,0,0,0.13741814051289,2641.27327097893,13.851792706248
7.5,"random_policy_SVM","SVM",9,45,25540,22733,2807,4600,3953,647,0.529841947030759,0.156403269754768,1.34852301797889,1734,647,1087,15,1.7,15.26,6.1,0,0,0,0,0,0,0.138745256202704,2714.24252728271,13.899770530396
7.5,"random_policy_SVM","SVM",9,46,25440,22654,2786,4700,4032,668,0.531032490861764,0.164032697547684,1.52309983583529,1767,668,1099,33,1.6,15.59,6,0,0,0,0,0,0,0.13988233050414,2738.09562134128,14.0350248178649
7.5,"random_policy_SVM","SVM",9,47,25340,22568,2772,4800,4118,682,0.542468933294801,0.168392370572207,1.56715995416952,1760,682,1078,-7,1.6,15.93,6,0,0,0,0,0,0,0.141009697825446,3095.44522666054,17.350914129013
7.5,"random_policy_SVM","SVM",9,48,25240,22488,2752,4900,4198,702,0.550808710123409,0.166757493188011,1.38945800942697,1760,702,1058,0,1.5,16.26,6,0,0,0,0,0,0,0.143204478594498,3349.93901360524,14.5160973443416
7.5,"random_policy_SVM","SVM",10,0,30040,26493,3547,100,88,12,0.410918533981688,0.0705202312138728,0.609577763328333,48,12,36,0,3,0.33,7.3,0,0,0,0,0,0,0.149391249621253,3561.50447692078,15.193414079784
7.5,"random_policy_SVM","SVM",10,1,29940,26400,3540,200,181,19,0.431823320088061,0.0878612716763006,0.71733564285504,64,19,45,16,2.4,0.66,9.5,0,0,0,0,0,0,0.136097994912554,2455.82249210238,13.9671846728961
7.5,"random_policy_SVM","SVM",10,2,29840,26304,3536,300,277,23,0.581680360382366,0.184971098265896,1.8400404269655,78,23,55,14,2.4,1,12,0,0,0,0,0,0,0.177576107469308,2467.94108277645,20.8989326128934
7.5,"random_policy_SVM","SVM",10,3,29740,26230,3510,400,351,49,0.513343779638846,0.120809248554913,1.02812112690725,140,49,91,62,1.9,1.33,7.2,0,0,0,0,0,0,0.212597914575962,3781.88705364395,22.415138411766
7.5,"random_policy_SVM","SVM",10,4,29640,26139,3501,500,442,58,0.557536807953916,0.185549132947977,1.7454289761858,169,58,111,29,1.9,1.66,7.6,0,0,0,0,0,0,0.201174984677306,3399.36436962843,24.2652083265133
7.5,"random_policy_SVM","SVM",10,5,29540,26063,3477,600,518,82,0.562280474854129,0.183236994219653,1.78877379576108,223,82,141,54,1.7,1.99,6.3,0,0,0,0,0,0,0.223656786128016,3723.542570428,27.0523678495184
7.5,"random_policy_SVM","SVM",10,6,29440,25997,3443,700,584,116,0.555744753125337,0.18150289017341,1.68158812316943,289,116,173,66,1.5,2.32,5,0,0,0,0,0,0,0.190711475085903,4380.93591970212,20.4048767186408
7.5,"random_policy_SVM","SVM",10,7,29340,25924,3416,800,657,143,0.540381621608038,0.168208092485549,1.57131598718204,339,143,196,50,1.4,2.65,4.6,0,0,0,0,0,0,0.204768910420714,4327.61454017454,23.332049871571
7.5,"random_policy_SVM","SVM",10,8,29240,25842,3398,900,739,161,0.534873242683148,0.150867052023121,1.44287648176077,388,161,227,49,1.4,2.99,4.6,0,0,0,0,0,0,0.184157873925467,4919.45047290742,18.6976681768033
7.5,"random_policy_SVM","SVM",10,9,29140,25758,3382,1000,823,177,0.538666235122892,0.169942196531792,1.45956850218031,428,177,251,40,1.4,3.32,4.6,0,0,0,0,0,0,0.182120531394786,4499.39798615127,18.5566732474269
7.5,"random_policy_SVM","SVM",10,10,29040,25674,3366,1100,907,193,0.532363226404936,0.152023121387283,1.40194651438122,472,193,279,44,1.4,3.65,4.7,0,0,0,0,0,0,0.181044401188504,4466.51282326397,18.238257763086
7.5,"random_policy_SVM","SVM",10,11,28940,25589,3351,1200,992,208,0.539233091261542,0.18728323699422,1.92065905056666,508,208,300,36,1.4,3.98,4.8,0,0,0,0,0,0,0.176851031646261,4651.22506910205,18.1247120400461
7.5,"random_policy_SVM","SVM",10,12,28840,25507,3333,1300,1074,226,0.535892396554061,0.171098265895954,1.57019464842067,570,226,344,62,1.5,4.31,4.8,0,0,0,0,0,0,0.176909569296856,4384.37614332734,18.1580293016871
7.5,"random_policy_SVM","SVM",10,13,28740,25443,3297,1400,1138,262,0.521995950594312,0.159537572254335,1.55994209652579,642,262,380,72,1.5,4.64,4.3,0,0,0,0,0,0,0.187792696516859,4885.83667041171,19.0463083011423
7.5,"random_policy_SVM","SVM",10,14,28640,25364,3276,1500,1217,283,0.524144137352238,0.164161849710983,1.57155648246093,695,283,412,53,1.5,4.98,4.3,0,0,0,0,0,0,0.189151004073258,5198.42153992803,18.995418193486
7.5,"random_policy_SVM","SVM",10,15,28540,25297,3243,1600,1284,316,0.522211029236226,0.158959537572254,1.44067153589939,758,316,442,63,1.4,5.31,4.1,0,0,0,0,0,0,0.196405622061752,4510.02320063107,19.7690993786082
7.5,"random_policy_SVM","SVM",10,16,28440,25224,3216,1700,1357,343,0.524732397368623,0.154335260115607,1.47960649562717,827,343,484,69,1.4,5.64,4,0,0,0,0,0,0,0.200864376447632,4853.36675722526,20.5391398610102
7.5,"random_policy_SVM","SVM",10,17,28340,25136,3204,1800,1445,355,0.523434083205624,0.153179190751445,1.51341719915468,854,355,499,27,1.4,5.97,4.1,0,0,0,0,0,0,0.196755659774318,4627.62898706792,19.7907139591126
7.5,"random_policy_SVM","SVM",10,18,28240,25045,3195,1900,1536,364,0.521798766287413,0.146820809248555,1.39926622540358,886,364,522,32,1.4,6.3,4.2,0,0,0,0,0,0,0.187352389780033,4548.66116010657,19.0628207552641
7.5,"random_policy_SVM","SVM",10,19,28140,24960,3180,2000,1621,379,0.52364036632694,0.148554913294798,1.41553449473174,926,379,547,40,1.4,6.64,4.3,0,0,0,0,0,0,0.186950928827921,4339.00600266138,18.7829561657722
7.5,"random_policy_SVM","SVM",10,20,28040,24886,3154,2100,1695,405,0.522605874454555,0.145664739884393,1.47449559236076,979,405,574,53,1.4,6.97,4.2,0,0,0,0,0,0,0.189969391323801,4959.29778682111,19.0220478452196
7.5,"random_policy_SVM","SVM",10,21,27940,24809,3131,2200,1772,428,0.525302763049979,0.155491329479769,1.4519267822736,1017,428,589,38,1.4,7.3,4.1,0,0,0,0,0,0,0.192606339396793,5216.66486336231,19.2784007094281
7.5,"random_policy_SVM","SVM",10,22,27840,24727,3113,2300,1854,446,0.51831634671336,0.139884393063584,1.41572224514038,1054,446,608,37,1.4,7.63,4.2,0,0,0,0,0,0,0.192495573288375,4791.13806986267,19.2747798699107
7.5,"random_policy_SVM","SVM",10,23,27740,24643,3097,2400,1938,462,0.522119347848976,0.152023121387283,1.51472638358301,1101,462,639,47,1.4,7.96,4.2,0,0,0,0,0,0,0.189352582615174,4326.41404831668,18.9663205257339
7.5,"random_policy_SVM","SVM",10,24,27640,24565,3075,2500,2016,484,0.520908642270577,0.150867052023121,1.47818902381344,1153,484,669,52,1.4,8.29,4.2,0,0,0,0,0,0,0.19262064113955,5074.83523204046,19.2702834069224
7.5,"random_policy_SVM","SVM",10,25,27540,24482,3058,2600,2099,501,0.522948553136866,0.14971098265896,1.43070343291965,1199,501,698,46,1.4,8.63,4.2,0,0,0,0,0,0,0.191256018045593,4875.73483541613,19.148854047407
7.5,"random_policy_SVM","SVM",10,26,27440,24392,3048,2700,2189,511,0.519812408443183,0.145086705202312,1.46570693292504,1215,511,704,16,1.4,8.96,4.3,0,0,0,0,0,0,0.185173432580448,4107.5093102173,18.5542245565089
7.5,"random_policy_SVM","SVM",10,27,27340,24306,3034,2800,2275,525,0.521337976328355,0.150867052023121,1.45693342635041,1237,525,712,22,1.4,9.29,4.3,0,0,0,0,0,0,0.185583320079965,4833.13803149156,18.5667533158796
7.5,"random_policy_SVM","SVM",10,28,27240,24222,3018,2900,2359,541,0.519928093369436,0.146820809248555,1.45941094094512,1298,541,757,61,1.4,9.62,4.4,0,0,0,0,0,0,0.184397253355788,4354.59435997236,18.4629387721548
7.5,"random_policy_SVM","SVM",10,29,27140,24136,3004,3000,2445,555,0.520777142738303,0.148554913294798,1.52452312138728,1338,555,783,40,1.4,9.95,4.4,0,0,0,0,0,0,0.182736505930348,4280.67884904927,18.2987528994506
7.5,"random_policy_SVM","SVM",10,30,27040,24051,2989,3100,2530,570,0.516904470680807,0.142196531791908,1.41187362965916,1390,570,820,52,1.4,10.29,4.4,0,0,0,0,0,0,0.180713701247719,4042.88797355797,18.0987602242168
7.5,"random_policy_SVM","SVM",10,31,26940,23962,2978,3200,2619,581,0.51928714688476,0.145664739884393,1.44440384557788,1411,581,830,21,1.4,10.62,4.5,0,0,0,0,0,0,0.176778986149868,3708.7243870217,17.7184560858745
7.5,"random_policy_SVM","SVM",10,32,26840,23872,2968,3300,2709,591,0.516759019633076,0.142196531791908,1.35696427327808,1434,591,843,23,1.4,10.95,4.6,0,0,0,0,0,0,0.176419733367086,4270.66377028101,17.6603272322782
7.5,"random_policy_SVM","SVM",10,33,26740,23780,2960,3400,2801,599,0.516986360010618,0.144508670520231,1.38422035201214,1466,599,867,32,1.4,11.28,4.7,0,0,0,0,0,0,0.173488397555123,3948.57561223313,17.3743035517239
7.5,"random_policy_SVM","SVM",10,34,26640,23689,2951,3500,2892,608,0.518201398357792,0.146242774566474,1.43183090985459,1481,608,873,15,1.4,11.61,4.8,0,0,0,0,0,0,0.171258029696601,3912.33348921611,17.1436776442579
7.5,"random_policy_SVM","SVM",10,35,26540,23600,2940,3600,2981,619,0.514412782014503,0.147398843930636,1.53600551555997,1523,619,904,42,1.5,11.94,4.8,0,0,0,0,0,0,0.169094155525999,3810.76166183804,16.937414538023
7.5,"random_policy_SVM","SVM",10,36,26440,23516,2924,3700,3065,635,0.513570838386425,0.144508670520231,1.47832545104221,1588,635,953,65,1.5,12.28,4.8,0,0,0,0,0,0,0.169405099532003,3911.74204109839,16.9726342865169
7.5,"random_policy_SVM","SVM",10,37,26340,23426,2914,3800,3155,645,0.511767540022865,0.144508670520231,1.44186143196321,1571,645,926,-17,1.4,12.61,4.9,0,0,0,0,0,0,0.167497119182188,4038.0482504311,16.8012057770354
7.5,"random_policy_SVM","SVM",10,38,26240,23337,2903,3900,3244,656,0.51368383699604,0.14971098265896,1.46941987603594,1625,656,969,54,1.5,12.94,4.9,0,0,0,0,0,0,0.165164577789819,3704.49109998514,16.5438102990822
7.5,"random_policy_SVM","SVM",10,39,26140,23249,2891,4000,3332,668,0.511139461861452,0.141618497109827,1.39325046347149,1634,668,966,9,1.4,13.27,5,0,0,0,0,0,0,0.163509699468784,3441.08322807737,16.397438887178
7.5,"random_policy_SVM","SVM",10,40,26040,23156,2884,4100,3425,675,0.510102933587759,0.140462427745665,1.46329957691282,1687,675,1012,53,1.5,13.6,5.1,0,0,0,0,0,0,0.161740003242311,3475.00362080706,16.1939567344305
7.5,"random_policy_SVM","SVM",10,41,25940,23064,2876,4200,3517,683,0.510681488202083,0.143352601156069,1.50719043142589,1686,683,1003,-1,1.5,13.93,5.1,0,0,0,0,0,0,0.159584278733548,3370.0717461259,15.9880344767061
7.5,"random_policy_SVM","SVM",10,42,25840,22974,2866,4300,3607,693,0.510468185995365,0.147976878612717,1.50747876350842,1730,693,1037,44,1.5,14.27,5.2,0,0,0,0,0,0,0.158896763032699,3488.56112655809,15.9145605493367
7.5,"random_policy_SVM","SVM",10,43,25740,22880,2860,4400,3701,699,0.507019302051608,0.142196531791908,1.34714856087242,1734,699,1035,4,1.5,14.6,5.3,0,0,0,0,0,0,0.156384130958417,3505.0241774812,15.6576220471759
7.5,"random_policy_SVM","SVM",10,44,25640,22785,2855,4500,3796,704,0.507267353063897,0.142196531791908,1.39325046347149,1772,704,1068,38,1.5,14.93,5.4,0,0,0,0,0,0,0.153362649527126,3228.57241967966,15.361760634766
7.5,"random_policy_SVM","SVM",10,45,25540,22695,2845,4600,3886,714,0.508898597179457,0.13757225433526,1.41431209879501,1740,714,1026,-32,1.4,15.26,5.4,0,0,0,0,0,0,0.153110744238025,3605.83250132836,15.3227951254687
7.5,"random_policy_SVM","SVM",10,46,25440,22609,2831,4700,3972,728,0.504053001893854,0.134104046242775,1.32977856208233,1809,728,1081,69,1.5,15.59,5.5,0,0,0,0,0,0,0.151736447513138,3264.65838367206,15.1884246371129
7.5,"random_policy_SVM","SVM",10,47,25340,22518,2822,4800,4063,737,0.508038975854782,0.146820809248555,1.4206082580658,1849,737,1112,40,1.5,15.93,5.5,0,0,0,0,0,0,0.148295261761707,2983.25258655964,14.8561593279142
7.5,"random_policy_SVM","SVM",10,48,25240,22426,2814,4900,4155,745,0.506351665711296,0.142774566473988,1.26209889907882,1861,745,1116,12,1.5,16.26,5.6,0,0,0,0,0,0,0.149106713072983,3181.24978958413,16.3369159465395
7.5,"random_policy_SVM","SVM",11,0,30040,26530,3510,100,92,8,0.556668697435298,0.194805194805195,2.08085619368628,29,8,21,0,2.6,0.33,11.5,0,0,0,0,0,0,0.609083671720449,2377.34085817012,70.7714784826964
7.5,"random_policy_SVM","SVM",11,1,29940,26478,3462,200,144,56,0.529937633468199,0.189723320158103,1.70648682244165,120,56,64,91,1.1,0.66,2.6,0,0,0,0,0,0,0.454890414576127,5706.87677180461,53.3709622751118
7.5,"random_policy_SVM","SVM",11,2,29840,26411,3429,300,211,89,0.525024390451005,0.161490683229814,1.52123544020427,197,89,108,77,1.2,1,2.4,0,0,0,0,0,0,0.327723637496147,7406.91460971946,35.5487190898433
7.5,"random_policy_SVM","SVM",11,3,29740,26350,3390,400,272,128,0.525615407802399,0.153020892151327,1.35005248955493,275,128,147,78,1.1,1.33,2.1,0,0,0,0,0,0,0.390561617125238,8049.17227879002,40.7699933808912
7.5,"random_policy_SVM","SVM",11,4,29640,26265,3375,500,357,143,0.528072835957767,0.135516657255788,1.26775218343306,309,143,166,34,1.2,1.66,2.5,0,0,0,0,0,0,0.30857998427009,7764.85291052901,32.333818235054
7.5,"random_policy_SVM","SVM",11,5,29540,26183,3357,600,439,161,0.565440153177975,0.185206098249577,1.78995723334249,355,161,194,46,1.2,1.99,2.7,0,0,0,0,0,0,0.311727256090603,6197.94086641423,33.9418037812068
7.5,"random_policy_SVM","SVM",11,6,29440,26104,3336,700,518,182,0.546041189931353,0.138339920948617,1.22428126384533,402,182,220,47,1.2,2.32,2.8,0,0,0,0,0,0,0.286919643455198,5949.39802182037,30.3906507163465
7.5,"random_policy_SVM","SVM",11,7,29340,26030,3310,800,592,208,0.568765363436827,0.189723320158103,1.77873497218118,461,208,253,59,1.2,2.65,2.8,0,0,0,0,0,0,0.262840989411559,5369.14882534941,27.8326871703145
7.5,"random_policy_SVM","SVM",11,8,29240,25955,3285,900,667,233,0.563869696828186,0.185206098249577,1.89191564147627,521,233,288,60,1.2,2.99,2.9,0,0,0,0,0,0,0.246296705904375,5596.64597222076,25.124289557987
7.5,"random_policy_SVM","SVM",11,9,29140,25880,3260,1000,742,258,0.526045392985578,0.166572557876906,1.36308720137116,578,258,320,57,1.2,3.32,2.9,0,0,0,0,0,0,0.350421004952443,5439.06269262515,51.1282216147956
7.5,"random_policy_SVM","SVM",11,10,29040,25794,3246,1100,828,272,0.567062234921011,0.1699604743083,1.51236619452512,600,272,328,22,1.2,3.65,3,0,0,0,0,0,0,0.281767502633843,5224.7888103256,30.550818088778
7.5,"random_policy_SVM","SVM",11,11,28940,25708,3232,1200,914,286,0.56213714693283,0.18068887634105,1.75004622377891,628,286,342,28,1.2,3.98,3.2,0,0,0,0,0,0,0.230844318158509,5409.12998105307,23.4255553660724
7.5,"random_policy_SVM","SVM",11,12,28840,25632,3208,1300,990,310,0.56792241756282,0.188029361942405,1.91359767446724,684,310,374,56,1.2,4.31,3.2,0,0,0,0,0,0,0.222812507484333,4738.20497637352,22.8818111750236
7.5,"random_policy_SVM","SVM",11,13,28740,25564,3176,1400,1058,342,0.568435232632679,0.188029361942405,1.9806184196719,756,342,414,72,1.2,4.64,3.1,0,0,0,0,0,0,0.227995054021476,4982.68770143764,22.9898444795458
7.5,"random_policy_SVM","SVM",11,14,28640,25486,3154,1500,1136,364,0.570226880017665,0.186900056465274,1.96729765401541,809,364,445,53,1.2,4.98,3.1,0,0,0,0,0,0,0.228055584480192,5000.29755693733,23.0697051022245
7.5,"random_policy_SVM","SVM",11,15,28540,25417,3123,1600,1205,395,0.571195068416389,0.193111236589497,1.91114932044467,872,395,477,63,1.2,5.31,3.1,0,0,0,0,0,0,0.236671174170775,5522.95079307917,23.7282730431371
7.5,"random_policy_SVM","SVM",11,16,28440,25345,3095,1700,1277,423,0.5727172533253,0.198757763975155,1.93440476397764,938,423,515,66,1.2,5.64,3,0,0,0,0,0,0,0.232867363692789,4611.39827343047,23.3360076978318
7.5,"random_policy_SVM","SVM",11,17,28340,25271,3069,1800,1351,449,0.572780384048773,0.199322416713721,1.95862350210176,997,449,548,59,1.2,5.97,3,0,0,0,0,0,0,0.243606528619112,5921.67138439789,24.3780682883669
7.5,"random_policy_SVM","SVM",11,18,28240,25194,3046,1900,1428,472,0.573411224277518,0.197063805759458,1.94426113353293,1033,472,561,36,1.2,6.3,3,0,0,0,0,0,0,0.237185444715492,5127.57488357034,23.7711472428154
7.5,"random_policy_SVM","SVM",11,19,28140,25109,3031,2000,1513,487,0.574262406439589,0.199322416713721,1.9517390609696,1070,487,583,37,1.2,6.64,3.1,0,0,0,0,0,0,0.236542499981337,5638.1469955478,23.6866165916755
7.5,"random_policy_SVM","SVM",11,20,28040,25033,3007,2100,1589,511,0.573197675159097,0.200451722190853,1.96842463872405,1127,511,616,57,1.2,6.97,3.1,0,0,0,0,0,0,0.236527094100885,5637.34641406789,23.7136108945247
7.5,"random_policy_SVM","SVM",11,21,27940,24953,2987,2200,1669,531,0.575732074398301,0.207792207792208,1.99836265604305,1171,531,640,44,1.2,7.3,3.1,0,0,0,0,0,0,0.232463431586571,5432.03207470455,23.3020577102708
7.5,"random_policy_SVM","SVM",11,22,27840,24873,2967,2300,1749,551,0.576225445035519,0.207227555053642,1.99660662558959,1229,551,678,58,1.2,7.63,3.2,0,0,0,0,0,0,0.231135516595666,5420.18707428062,23.200249632312
7.5,"random_policy_SVM","SVM",11,23,27740,24785,2955,2400,1837,563,0.575084634228148,0.202710333145116,1.96496823022761,1279,563,716,50,1.3,7.96,3.3,0,0,0,0,0,0,0.225555211814002,5015.71023569448,22.6130345851824
7.5,"random_policy_SVM","SVM",11,24,27640,24696,2944,2500,1926,574,0.575611395796089,0.201016374929418,1.94320126980175,1319,574,745,40,1.3,8.29,3.4,0,0,0,0,0,0,0.215692045659983,4202.85919644281,21.6543161599416
7.5,"random_policy_SVM","SVM",11,25,27540,24606,2934,2600,2016,584,0.576000645317413,0.201016374929418,1.96381878990575,1341,584,757,22,1.3,8.63,3.5,0,0,0,0,0,0,0.212468137458495,4152.50511896017,21.3171833025499
7.5,"random_policy_SVM","SVM",11,26,27440,24519,2921,2700,2103,597,0.576929265569345,0.199887069452287,1.97577246949648,1371,597,774,30,1.3,8.96,3.5,0,0,0,0,0,0,0.214960893051738,4919.13999691926,21.5350638409153
7.5,"random_policy_SVM","SVM",11,27,27340,24437,2903,2800,2185,615,0.577026784918249,0.204968944099379,2.01142651814589,1411,615,796,40,1.3,9.29,3.6,0,0,0,0,0,0,0.210532947265966,4573.03432685568,21.0916766117605
7.5,"random_policy_SVM","SVM",11,28,27240,24360,2880,2900,2262,638,0.578607557855685,0.211180124223602,2.03705747851455,1469,638,831,58,1.3,9.62,3.5,0,0,0,0,0,0,0.211994436976392,4504.22307896785,21.2447330139315
7.5,"random_policy_SVM","SVM",11,29,27140,24283,2857,3000,2339,661,0.577915964388665,0.206662902315076,2.03001492889133,1517,661,856,48,1.3,9.95,3.5,0,0,0,0,0,0,0.213147923369732,4671.52562125762,21.3763943130254
7.5,"random_policy_SVM","SVM",11,30,27040,24204,2836,3100,2418,682,0.578643602229743,0.207792207792208,2.07414568821506,1555,682,873,38,1.3,10.29,3.5,0,0,0,0,0,0,0.210174634393993,4265.6614977145,21.1139507016215
7.5,"random_policy_SVM","SVM",11,31,26940,24120,2820,3200,2502,698,0.577611773646425,0.20609824957651,2.08345372768161,1559,698,861,4,1.2,10.62,3.6,0,0,0,0,0,0,0.209743977595022,4560.65748115765,21.041282267509
7.5,"random_policy_SVM","SVM",11,32,26840,24036,2804,3300,2586,714,0.578781369006937,0.204968944099379,2.04677320430694,1633,714,919,74,1.3,10.95,3.6,0,0,0,0,0,0,0.208250360172531,4320.91119261749,20.8934513431965
7.5,"random_policy_SVM","SVM",11,33,26740,23953,2787,3400,2669,731,0.577398649078937,0.204968944099379,2.01182701456551,1646,731,915,13,1.3,11.28,3.7,0,0,0,0,0,0,0.207896666264196,4533.74860474962,20.8306619942354
7.5,"random_policy_SVM","SVM",11,34,26640,23867,2773,3500,2755,745,0.58013063432155,0.205533596837945,2.07432940799978,1697,745,952,51,1.3,11.61,3.7,0,0,0,0,0,0,0.203048619658015,4087.66792968635,20.3605630054049
7.5,"random_policy_SVM","SVM",11,35,26540,23780,2760,3600,2842,758,0.578962652254582,0.206662902315076,2.03101532677164,1737,758,979,40,1.3,11.94,3.7,0,0,0,0,0,0,0.202421004692812,3988.90869427391,20.2993413482438
7.5,"random_policy_SVM","SVM",11,36,26440,23698,2742,3700,2924,776,0.582199513464637,0.208921513269339,2.07076220351483,1751,776,975,14,1.3,12.28,3.8,0,0,0,0,0,0,0.201151224362282,4060.51867658674,20.1909003213024
7.5,"random_policy_SVM","SVM",11,37,26340,23615,2725,3800,3007,793,0.582625125773214,0.217391304347826,2.04501026442381,1810,793,1017,59,1.3,12.61,3.8,0,0,0,0,0,0,0.202644377119294,4298.51550535598,20.3126515625927
7.5,"random_policy_SVM","SVM",11,38,26240,23534,2706,3900,3088,812,0.583272502260733,0.218520609824958,2.04501026442381,1845,812,1033,35,1.3,12.94,3.8,0,0,0,0,0,0,0.20088886964728,3782.02266534984,20.1729007746739
7.5,"random_policy_SVM","SVM",11,39,26140,23450,2690,4000,3172,828,0.584615229491,0.22360248447205,2.01049604063947,1873,828,1045,28,1.3,13.27,3.8,0,0,0,0,0,0,0.201000150926697,4146.27648175105,20.1547270103646
7.5,"random_policy_SVM","SVM",11,40,26040,23367,2673,4100,3255,845,0.5835972200405,0.226425748164879,2.04382622208709,1907,845,1062,34,1.3,13.6,3.9,0,0,0,0,0,0,0.198283369276063,3909.47894860735,19.8846715089178
7.5,"random_policy_SVM","SVM",11,41,25940,23285,2655,4200,3337,863,0.585431322518611,0.225861095426313,2.10381157504303,1952,863,1089,45,1.3,13.93,3.9,0,0,0,0,0,0,0.195990749284788,3448.71431423281,19.6890419964269
7.5,"random_policy_SVM","SVM",11,42,25840,23200,2640,4300,3422,878,0.585162411958756,0.228684359119142,2.0621214369545,2018,878,1140,66,1.3,14.27,3.9,0,0,0,0,0,0,0.199089521010264,4256.61873125717,19.9584994414065
7.5,"random_policy_SVM","SVM",11,43,25740,23124,2616,4400,3498,902,0.585838212131119,0.22755505364201,2.22756519710438,2052,902,1150,34,1.3,14.6,3.9,0,0,0,0,0,0,0.197042613032082,3865.10075684312,19.8022497185039
7.5,"random_policy_SVM","SVM",11,44,25640,23037,2603,4500,3585,915,0.585324484276757,0.22755505364201,2.16389964264443,2078,915,1163,26,1.3,14.93,3.9,0,0,0,0,0,0,0.196623123907648,4013.40723592715,19.7061847434146
7.5,"random_policy_SVM","SVM",11,45,25540,22951,2589,4600,3671,929,0.583394560653469,0.226990400903444,2.11294837378084,2130,929,1201,52,1.3,15.26,4,0,0,0,0,0,0,0.193786380113405,3607.6268533717,19.4276635186735
7.5,"random_policy_SVM","SVM",11,46,25440,22859,2581,4700,3763,937,0.581605524256715,0.216261998870695,2.05057383684937,2144,937,1207,14,1.3,15.59,4,0,0,0,0,0,0,0.192374116921686,3720.45966946061,19.2789661321799
7.5,"random_policy_SVM","SVM",11,47,25340,22759,2581,4800,3863,937,0.582988329094896,0.221908526256352,2.23017582118032,2117,937,1180,-27,1.3,15.93,4.1,0,0,0,0,0,0,0.188955721379572,3784.50390951392,18.9290326188985
7.5,"random_policy_SVM","SVM",11,48,25240,22665,2575,4900,3957,943,0.580399035420276,0.217955957086392,2.07664341890488,2149,943,1206,32,1.3,16.26,4.2,0,0,0,0,0,0,0.184866001684264,3347.27750300121,18.5642028621682
7.5,"random_policy_SVM","SVM",12,0,30040,26538,3502,100,80,20,0.597180222635802,0.204867006225241,1.82873170549582,51,20,31,0,1.6,0.33,4,0,0,0,0,0,0,0.638699131144972,5758.76342620335,66.1205223952922
7.5,"random_policy_SVM","SVM",12,1,29940,26476,3464,200,142,58,0.567525104465816,0.165251839275608,1.61055671952703,130,58,72,79,1.2,0.66,2.4,0,0,0,0,0,0,0.519328994301528,7757.98635120767,57.3888044265231
7.5,"random_policy_SVM","SVM",12,2,29840,26411,3429,300,207,93,0.537235292005742,0.160158460667799,1.59873667968562,207,93,114,77,1.2,1,2.2,0,0,0,0,0,0,0.355713150469899,8684.16118030996,38.436111005261
7.5,"random_policy_SVM","SVM",12,3,29740,26334,3406,400,284,116,0.518877757722331,0.139219015280136,1.31509996600379,259,116,143,52,1.2,1.33,2.4,0,0,0,0,0,0,0.444064586866065,8307.2019298081,45.8938570287895
7.5,"random_policy_SVM","SVM",12,4,29640,26262,3378,500,356,144,0.509276626745221,0.135257498585173,1.30157515756148,324,144,180,65,1.2,1.66,2.5,0,0,0,0,0,0,0.385280662894306,8176.64477202761,40.3252910417394
7.5,"random_policy_SVM","SVM",12,5,29540,26171,3369,600,447,153,0.530489423931295,0.132427843803056,1.13313601952411,349,153,196,25,1.3,1.99,2.9,0,0,0,0,0,0,0.359419581734847,6607.22923337582,38.2311088537306
7.5,"random_policy_SVM","SVM",12,6,29440,26096,3344,700,522,178,0.545633989854085,0.130730050933786,1.15466770454727,409,178,231,60,1.3,2.32,2.9,0,0,0,0,0,0,0.413338827688764,7122.22305904805,42.2672883811619
7.5,"random_policy_SVM","SVM",12,7,29340,26024,3316,800,594,206,0.554965257182101,0.133559705715903,1.18779653536357,469,206,263,60,1.3,2.65,2.9,0,0,0,0,0,0,0.291162182058083,6904.76873915952,29.4599003955748
7.5,"random_policy_SVM","SVM",12,8,29240,25941,3299,900,677,223,0.55055832083555,0.150537634408602,1.45095273534145,513,223,290,44,1.3,2.99,3,0,0,0,0,0,0,0.27124478964564,6483.15456084659,27.8730410345411
7.5,"random_policy_SVM","SVM",12,9,29140,25851,3289,1000,767,233,0.543274682229596,0.147707979626486,1.44820163932851,549,233,316,36,1.4,3.32,3.3,0,0,0,0,0,0,0.241557241848768,6306.30770572001,24.3922550946175
7.5,"random_policy_SVM","SVM",12,10,29040,25769,3271,1100,849,251,0.546231016385458,0.144878324844369,1.31980515371758,592,251,341,43,1.4,3.65,3.4,0,0,0,0,0,0,0.23235257068723,6104.01848770324,23.401543417868
7.5,"random_policy_SVM","SVM",12,11,28940,25687,3253,1200,931,269,0.538700655023397,0.118845500848896,1.25384444471014,639,269,370,47,1.4,3.98,3.5,0,0,0,0,0,0,0.223080818520254,6128.14660963375,22.4173664288092
7.5,"random_policy_SVM","SVM",12,12,28840,25602,3238,1300,1016,284,0.542111426972955,0.140350877192982,1.5276081392697,666,284,382,27,1.3,4.31,3.6,0,0,0,0,0,0,0.236863925217238,5131.82048436248,25.3993826118677
7.5,"random_policy_SVM","SVM",12,13,28740,25523,3217,1400,1095,305,0.539455966964329,0.127334465195246,1.26024312632803,733,305,428,67,1.4,4.64,3.6,0,0,0,0,0,0,0.217503019559524,5788.0658251749,21.8817299471581
7.5,"random_policy_SVM","SVM",12,14,28640,25436,3204,1500,1182,318,0.545265692332983,0.143180531975099,1.38570825202071,768,318,450,35,1.4,4.98,3.7,0,0,0,0,0,0,0.210718559151482,5467.70434107734,21.1261009280237
7.5,"random_policy_SVM","SVM",12,15,28540,25355,3185,1600,1263,337,0.542386054923552,0.138653084323713,1.33732245641641,826,337,489,58,1.5,5.31,3.7,0,0,0,0,0,0,0.208434901699465,5536.1998272672,20.878398353441
7.5,"random_policy_SVM","SVM",12,16,28440,25270,3170,1700,1348,352,0.542561270618794,0.136955291454443,1.28937559278932,872,352,520,46,1.5,5.64,3.8,0,0,0,0,0,0,0.205286409617444,5502.93816171211,20.5563529315145
7.5,"random_policy_SVM","SVM",12,17,28340,25181,3159,1800,1437,363,0.548704241861809,0.142614601018676,1.45240009302705,899,363,536,27,1.5,5.97,4,0,0,0,0,0,0,0.199794900403389,5306.53255700467,19.9939695109668
7.5,"random_policy_SVM","SVM",12,18,28240,25102,3138,1900,1516,384,0.543126776191157,0.136389360498019,1.24925582792936,937,384,553,38,1.4,6.3,3.9,0,0,0,0,0,0,0.200227249428506,5167.12047574099,20.0441990946461
7.5,"random_policy_SVM","SVM",12,19,28140,25013,3127,2000,1605,395,0.550031482674451,0.142048670062252,1.3980992965866,954,395,559,17,1.4,6.64,4.1,0,0,0,0,0,0,0.195518992977531,5048.55833851942,19.5661900196346
7.5,"random_policy_SVM","SVM",12,20,28040,24921,3119,2100,1697,403,0.547300729686809,0.138653084323713,1.3982205646321,958,403,555,4,1.4,6.97,4.2,0,0,0,0,0,0,0.189387437538044,4789.00713294589,18.959565246548
7.5,"random_policy_SVM","SVM",12,21,27940,24840,3100,2200,1778,422,0.550521184806913,0.139784946236559,1.36229406401308,998,422,576,40,1.4,7.3,4.2,0,0,0,0,0,0,0.189621252137542,4824.94932432346,18.9754440092531
7.5,"random_policy_SVM","SVM",12,22,27840,24754,3086,2300,1864,436,0.549205812209617,0.140350877192982,1.37088784290819,1023,436,587,25,1.3,7.63,4.3,0,0,0,0,0,0,0.187836194669696,4825.81132531898,18.7963746917485
7.5,"random_policy_SVM","SVM",12,23,27740,24661,3079,2400,1957,443,0.557074991977266,0.157894736842105,1.51431302926735,1066,443,623,43,1.4,7.96,4.4,0,0,0,0,0,0,0.181972323287138,4627.6487384834,18.2280869905564
7.5,"random_policy_SVM","SVM",12,24,27640,24575,3065,2500,2043,457,0.550542283856404,0.144312393887946,1.42772094620498,1097,457,640,31,1.4,8.29,4.5,0,0,0,0,0,0,0.180432542098259,4455.45611281414,18.0603238902298
7.5,"random_policy_SVM","SVM",12,25,27540,24486,3054,2600,2132,468,0.555308584658746,0.153367289190719,1.36466327108093,1102,468,634,5,1.4,8.63,4.6,0,0,0,0,0,0,0.179049278391097,4590.17145317809,17.9128923343331
7.5,"random_policy_SVM","SVM",12,26,27440,24394,3046,2700,2224,476,0.552196219628858,0.153933220147142,1.37447030242798,1128,476,652,26,1.4,8.96,4.7,0,0,0,0,0,0,0.174766152331711,4451.56389450093,17.4843627320062
7.5,"random_policy_SVM","SVM",12,27,27340,24314,3026,2800,2304,496,0.552737138002414,0.145444255800792,1.39190915236119,1177,496,681,49,1.4,9.29,4.6,0,0,0,0,0,0,0.175501246087705,4444.37668572644,17.5658670369247
7.5,"random_policy_SVM","SVM",12,28,27240,24227,3013,2900,2391,509,0.555258219185781,0.149971703452179,1.38169168755457,1190,509,681,13,1.3,9.62,4.7,0,0,0,0,0,0,0.17415503971341,4493.60284742207,17.4246609318195
7.5,"random_policy_SVM","SVM",12,29,27140,24149,2991,3000,2469,531,0.556538837905194,0.147707979626486,1.41038958608233,1234,531,703,44,1.3,9.95,4.6,0,0,0,0,0,0,0.174572779891991,4172.38316571072,17.4782979543983
7.5,"random_policy_SVM","SVM",12,30,27040,24067,2973,3100,2551,549,0.559319616058554,0.151103565365025,1.4413364252488,1281,549,732,47,1.3,10.29,4.6,0,0,0,0,0,0,0.175898716397388,4311.6774000148,17.6079851792563
7.5,"random_policy_SVM","SVM",12,31,26940,23974,2966,3200,2644,556,0.554618186325697,0.148273910582909,1.47463070669583,1296,556,740,15,1.3,10.62,4.8,0,0,0,0,0,0,0.172501713555744,4298.08776139652,17.2665698358098
7.5,"random_policy_SVM","SVM",12,32,26840,23886,2954,3300,2732,568,0.558264280738504,0.160158460667799,1.5736978539445,1341,568,773,45,1.4,10.95,4.8,0,0,0,0,0,0,0.1702299755744,4200.79396259841,17.0492678920971
7.5,"random_policy_SVM","SVM",12,33,26740,23797,2943,3400,2821,579,0.563441587621795,0.176004527447651,1.66404149962296,1341,579,762,0,1.3,11.28,4.9,0,0,0,0,0,0,0.169081421333863,3954.0526049169,17.0666199139038
7.5,"random_policy_SVM","SVM",12,34,26640,23726,2914,3500,2892,608,0.560274433124689,0.166383701188455,1.56823836442518,1425,608,817,84,1.3,11.61,4.8,0,0,0,0,0,0,0.172657428543999,4342.43604405767,17.274417980156
7.5,"random_policy_SVM","SVM",12,35,26540,23642,2898,3600,2976,624,0.565882696601452,0.178834182229768,1.6924675032988,1449,624,825,24,1.3,11.94,4.8,0,0,0,0,0,0,0.172155076162083,4163.83456931237,17.2244493553106
7.5,"random_policy_SVM","SVM",12,36,26440,23566,2874,3700,3052,648,0.562171475888718,0.162988115449915,1.58716271745282,1474,648,826,25,1.3,12.28,4.7,0,0,0,0,0,0,0.174938557243591,4599.64868859738,17.4943778499125
7.5,"random_policy_SVM","SVM",12,37,26340,23483,2857,3800,3135,665,0.560187271930336,0.164685908319185,1.42892801279633,1546,665,881,72,1.3,12.61,4.7,0,0,0,0,0,0,0.173540794792337,4171.2952480725,17.3709793623019
7.5,"random_policy_SVM","SVM",12,38,26240,23396,2844,3900,3222,678,0.567915989880618,0.183927560837578,1.79289130013336,1556,678,878,10,1.3,12.94,4.8,0,0,0,0,0,0,0.173220779888009,4282.43150100292,17.3308556660104
7.5,"random_policy_SVM","SVM",12,39,26140,23312,2828,4000,3306,694,0.561243330403288,0.166949632144878,1.50951745874798,1614,694,920,58,1.3,13.27,4.8,0,0,0,0,0,0,0.172483665885256,4120.68501729728,17.2637936383622
7.5,"random_policy_SVM","SVM",12,40,26040,23221,2819,4100,3397,703,0.563184570571383,0.167515563101302,1.58578377503974,1634,703,931,20,1.3,13.6,4.8,0,0,0,0,0,0,0.169887126047745,4114.61799859849,16.9998513257026
7.5,"random_policy_SVM","SVM",12,41,25940,23131,2809,4200,3487,713,0.565744446781222,0.182229767968308,1.82190186922949,1694,713,981,60,1.4,13.93,4.9,0,0,0,0,0,0,0.168335993894031,4054.61671150865,16.8573382238765
7.5,"random_policy_SVM","SVM",12,42,25840,23046,2794,4300,3572,728,0.567136303432914,0.182795698924731,1.73248266836446,1718,728,990,24,1.4,14.27,4.9,0,0,0,0,0,0,0.167155760715664,3797.79462158206,16.740790421807
7.5,"random_policy_SVM","SVM",12,43,25740,22959,2781,4400,3659,741,0.564388620159591,0.170345217883418,1.63512114734438,1725,741,984,7,1.3,14.6,4.9,0,0,0,0,0,0,0.167015639338283,3999.73785390617,16.7121364905115
7.5,"random_policy_SVM","SVM",12,44,25640,22870,2770,4500,3748,752,0.56521654515996,0.175438596491228,1.64792888479094,1759,752,1007,34,1.3,14.93,5,0,0,0,0,0,0,0.165814185773235,3815.28704254067,16.6014473500321
7.5,"random_policy_SVM","SVM",12,45,25540,22782,2758,4600,3836,764,0.563449329611741,0.173174872665535,1.62001981985431,1805,764,1041,46,1.4,15.26,5,0,0,0,0,0,0,0.164814975262482,3885.04109689226,16.4985414938892
7.5,"random_policy_SVM","SVM",12,46,25440,22690,2750,4700,3928,772,0.56716854754483,0.183927560837578,1.74426197993446,1858,772,1086,53,1.4,15.59,5.1,0,0,0,0,0,0,0.163000043611176,3896.72882193968,16.305347397337
7.5,"random_policy_SVM","SVM",12,47,25340,22597,2743,4800,4021,779,0.566350108609059,0.179966044142615,1.75448281394372,1857,779,1078,-1,1.4,15.93,5.2,0,0,0,0,0,0,0.161064717356036,3849.50496355131,16.1169728542606
7.5,"random_policy_SVM","SVM",12,48,25240,22513,2727,4900,4105,795,0.568416284076236,0.181097906055461,1.76594641356838,1921,795,1126,64,1.4,16.26,5.2,0,0,0,0,0,0,0.160318971490776,3596.02261918023,16.0481063407907
7.5,"random_policy_SVM","SVM",13,0,30040,26491,3549,100,89,11,0.542648016209965,0.185078079814922,1.86947114281579,36,11,25,0,2.3,0.33,8.1,0,0,0,0,0,0,0.33528458867764,3335.66840176112,37.6636937793988
7.5,"random_policy_SVM","SVM",13,1,29940,26433,3507,200,147,53,0.487724332567314,0.122614227877386,1.17853931106553,123,53,70,87,1.3,0.66,2.8,0,0,0,0,0,0,0.40637762117671,7022.61063237912,49.714527658159
7.5,"random_policy_SVM","SVM",13,2,29840,26357,3483,300,223,77,0.471572092945851,0.115095430884905,0.992133241170468,189,77,112,66,1.5,1,2.9,0,0,0,0,0,0,0.257694228229666,7657.73866855419,25.7792569315017
7.5,"random_policy_SVM","SVM",13,3,29740,26269,3471,400,311,89,0.445307585928047,0.112781954887218,0.944036013388094,229,89,140,40,1.6,1.33,3.5,0,0,0,0,0,0,0.236941842035596,6536.30228265867,24.2264497744221
7.5,"random_policy_SVM","SVM",13,4,29640,26185,3455,500,395,105,0.505904678442551,0.119722382880278,0.941486861236731,260,105,155,31,1.5,1.66,3.8,0,0,0,0,0,0,0.237191450459501,6352.28112996287,24.0535836690119
7.5,"random_policy_SVM","SVM",13,5,29540,26090,3450,600,490,110,0.512045351551009,0.148640832851359,1.23414004564119,295,110,185,35,1.7,1.99,4.5,0,0,0,0,0,0,0.187321282068378,5438.21653674393,18.7769061917985
7.5,"random_policy_SVM","SVM",13,6,29440,26005,3435,700,575,125,0.478158615639012,0.0913823019086177,0.715893976819305,330,125,205,35,1.6,2.32,4.6,0,0,0,0,0,0,0.179285672088126,5258.42081793527,17.9391698506004
7.5,"random_policy_SVM","SVM",13,7,29340,25915,3425,800,665,135,0.505048872657314,0.105263157894737,0.875568707902907,360,135,225,30,1.7,2.65,4.9,0,0,0,0,0,0,0.177200429708852,4953.51527275934,17.7772829108985
7.5,"random_policy_SVM","SVM",13,8,29240,25824,3416,900,756,144,0.518752169100518,0.139386928860613,1.36975130133025,394,144,250,34,1.7,2.99,5.2,0,0,0,0,0,0,0.164083525216951,4678.82062880943,16.4881514980886
7.5,"random_policy_SVM","SVM",13,9,29140,25731,3409,1000,849,151,0.504624004229546,0.122614227877386,1.12978423348408,416,151,265,22,1.8,3.32,5.6,0,0,0,0,0,0,0.152307555436164,4400.27881531001,15.2415668281608
7.5,"random_policy_SVM","SVM",13,10,29040,25640,3400,1100,940,160,0.487088352085337,0.122035858877964,1.11591198228337,441,160,281,25,1.8,3.65,5.9,0,0,0,0,0,0,0.147077235970775,4208.94286878661,14.7684835781264
7.5,"random_policy_SVM","SVM",13,11,28940,25554,3386,1200,1026,174,0.532812708754949,0.151532677848467,1.33800580030383,480,174,306,39,1.8,3.98,5.9,0,0,0,0,0,0,0.149612956701946,4188.45575044222,15.0380922389234
7.5,"random_policy_SVM","SVM",13,12,28840,25480,3360,1300,1100,200,0.485442935197986,0.105263157894737,0.861478805868081,539,200,339,59,1.7,4.31,5.5,0,0,0,0,0,0,0.15546120503415,4435.71158051723,15.5966264817356
7.5,"random_policy_SVM","SVM",13,13,28740,25394,3346,1400,1186,214,0.503778255527791,0.123770965876229,1.1715859126725,576,214,362,37,1.7,4.64,5.5,0,0,0,0,0,0,0.152992926204314,4393.19400456599,15.3027412330365
7.5,"random_policy_SVM","SVM",13,14,28640,25303,3337,1500,1277,223,0.499967054381705,0.0965876229034124,0.791712482109445,605,223,382,29,1.7,4.98,5.7,0,0,0,0,0,0,0.148885467946051,4258.68567048873,14.8908187585126
7.5,"random_policy_SVM","SVM",13,15,28540,25217,3323,1600,1363,237,0.517210140765386,0.142278773857721,1.3754917161972,641,237,404,36,1.7,5.31,5.8,0,0,0,0,0,0,0.14962125619713,4217.6209176131,14.9832221830559
7.5,"random_policy_SVM","SVM",13,16,28440,25136,3304,1700,1444,256,0.512536067865916,0.128397917871602,0.996406928142207,696,256,440,55,1.7,5.64,5.6,0,0,0,0,0,0,0.150601101000739,4282.85043388915,15.0606228668755
7.5,"random_policy_SVM","SVM",13,17,28340,25049,3291,1800,1531,269,0.52112802502551,0.137651821862348,1.26304925655269,737,269,468,41,1.7,5.97,5.7,0,0,0,0,0,0,0.150577586570928,4233.38381859441,15.0947041554472
7.5,"random_policy_SVM","SVM",13,18,28240,24975,3265,1900,1605,295,0.528712539856629,0.13128976286871,1.2217335792311,813,295,518,76,1.8,6.3,5.4,0,0,0,0,0,0,0.157208806779616,4365.82925668377,15.79715072282
7.5,"random_policy_SVM","SVM",13,19,28140,24893,3247,2000,1687,313,0.544462279391179,0.146327356853673,1.31644795635201,860,313,547,47,1.7,6.64,5.4,0,0,0,0,0,0,0.1573606194911,4397.92649535648,15.7719699728873
7.5,"random_policy_SVM","SVM",13,20,28040,24802,3238,2100,1778,322,0.539618666605881,0.137073452862927,1.26304925655269,910,322,588,50,1.8,6.97,5.5,0,0,0,0,0,0,0.153966443430809,4283.11769740824,15.4176260614612
7.5,"random_policy_SVM","SVM",13,21,27940,24713,3227,2200,1867,333,0.520315785485551,0.148062463851938,1.46420563826283,934,333,601,24,1.8,7.3,5.6,0,0,0,0,0,0,0.15159556195458,4226.9622044004,15.1811983459477
7.5,"random_policy_SVM","SVM",13,22,27840,24623,3217,2300,1957,343,0.52782916379081,0.165991902834008,1.58622277478473,954,343,611,20,1.8,7.63,5.7,0,0,0,0,0,0,0.14969628841768,4140.23468607462,15.1138818094926
7.5,"random_policy_SVM","SVM",13,23,27740,24551,3189,2400,2029,371,0.546151826067267,0.170618854829381,1.50996206445854,1023,371,652,69,1.8,7.96,5.5,0,0,0,0,0,0,0.154954302397284,4285.005306747,15.5140584407659
7.5,"random_policy_SVM","SVM",13,24,27640,24491,3149,2500,2089,411,0.523398671719395,0.126662810873337,1.28071136811822,1135,411,724,112,1.8,8.29,5.1,0,0,0,0,0,0,0.164613147054755,4541.12801090691,16.4712553571419
7.5,"random_policy_SVM","SVM",13,25,27540,24417,3123,2600,2163,437,0.564339671405634,0.168305378831695,1.51026388785033,1156,437,719,21,1.6,8.63,4.9,0,0,0,0,0,0,0.174529305136211,4596.81078284475,17.5371597558048
7.5,"random_policy_SVM","SVM",13,26,27440,24344,3096,2700,2236,464,0.5385233548454,0.145748987854251,1.2419019327207,1252,464,788,96,1.7,8.96,4.8,0,0,0,0,0,0,0.172233476164724,4704.60409924045,17.2309170446125
7.5,"random_policy_SVM","SVM",13,27,27340,24264,3076,2800,2316,484,0.46343556560996,0.108155002891845,0.757965146981165,1288,484,804,36,1.7,9.29,4.8,0,0,0,0,0,0,0.173233629105723,4727.98506007915,17.3296915772574
7.5,"random_policy_SVM","SVM",13,28,27240,24175,3065,2900,2405,495,0.534111329660037,0.158473105841527,1.41392250680176,1312,495,817,24,1.7,9.62,4.9,0,0,0,0,0,0,0.170927069342045,4643.30148257577,17.1153093853268
7.5,"random_policy_SVM","SVM",13,29,27140,24090,3050,3000,2490,510,0.534178738129086,0.161943319838057,1.66864967016789,1352,510,842,40,1.7,9.95,4.9,0,0,0,0,0,0,0.170782261154724,4599.45421671558,17.0875963453358
7.5,"random_policy_SVM","SVM",13,30,27040,24016,3024,3100,2564,536,0.529072210639741,0.142857142857143,1.26304925655269,1414,536,878,62,1.6,10.29,4.8,0,0,0,0,0,0,0.173217870344327,4661.10693204784,17.3300850014773
7.5,"random_policy_SVM","SVM",13,31,26940,23925,3015,3200,2655,545,0.532690940015673,0.178137651821862,1.66216260298153,1470,545,925,56,1.7,10.62,4.9,0,0,0,0,0,0,0.171028699045537,4569.419130164,17.1151090705601
7.5,"random_policy_SVM","SVM",13,32,26840,23841,2999,3300,2739,561,0.515052072717245,0.157316367842684,1.4215242407093,1514,561,953,44,1.7,10.95,4.9,0,0,0,0,0,0,0.170333023379949,4546.19012573353,17.0387466208387
7.5,"random_policy_SVM","SVM",13,33,26740,23749,2991,3400,2831,569,0.541821818131715,0.152111046847889,1.49828741677208,1556,569,987,42,1.7,11.28,5,0,0,0,0,0,0,0.167760840658791,4453.08360779171,16.784293986872
7.5,"random_policy_SVM","SVM",13,34,26640,23664,2976,3500,2916,584,0.535870712377059,0.183342972816657,1.74019840593841,1580,584,996,24,1.7,11.61,5,0,0,0,0,0,0,0.166932079214558,4441.15671231867,16.6944688936085
7.5,"random_policy_SVM","SVM",13,35,26540,23587,2953,3600,2993,607,0.522032989141236,0.150954308849046,1.60037382638002,1626,607,1019,46,1.7,11.94,4.9,0,0,0,0,0,0,0.168734737054772,4467.63937595837,16.8744587488143
7.5,"random_policy_SVM","SVM",13,36,26440,23501,2939,3700,3079,621,0.538021367661073,0.1631000578369,1.52991614950969,1622,621,1001,-4,1.6,12.28,5,0,0,0,0,0,0,0.167940975723555,4420.52821360262,16.8081318764215
7.5,"random_policy_SVM","SVM",13,37,26340,23418,2922,3800,3162,638,0.516442767955627,0.169462116830538,1.56711667016723,1726,638,1088,104,1.7,12.61,5,0,0,0,0,0,0,0.16808568456703,4404.05389941274,16.8159118103774
7.5,"random_policy_SVM","SVM",13,38,26240,23331,2909,3900,3249,651,0.54946823604567,0.188548293811452,1.81213509482208,1756,651,1105,30,1.7,12.94,5,0,0,0,0,0,0,0.167240490587382,4366.36290503264,16.7381793986422
7.5,"random_policy_SVM","SVM",13,39,26140,23243,2897,4000,3337,663,0.5515521764526,0.185078079814922,1.76666787160208,1792,663,1129,36,1.7,13.27,5,0,0,0,0,0,0,0.165857748994177,4324.91642576417,16.5882130828454
7.5,"random_policy_SVM","SVM",13,40,26040,23153,2887,4100,3427,673,0.509114795452381,0.137073452862927,1.52991614950969,1845,673,1172,53,1.7,13.6,5.1,0,0,0,0,0,0,0.164338540245624,4258.38021942473,16.4386205198204
7.5,"random_policy_SVM","SVM",13,41,25940,23065,2875,4200,3515,685,0.523753444009249,0.122614227877386,1.19458255923424,1863,685,1178,18,1.7,13.93,5.1,0,0,0,0,0,0,0.16317669656198,4226.59966740819,16.3390845087343
7.5,"random_policy_SVM","SVM",13,42,25840,22971,2869,4300,3609,691,0.535154318576694,0.175824175824176,1.56152980146788,1831,691,1140,-32,1.6,14.27,5.2,0,0,0,0,0,0,0.160986153310022,4136.89601500212,16.1103005964757
7.5,"random_policy_SVM","SVM",13,43,25740,22884,2856,4400,3696,704,0.464950153713001,0.11336032388664,1.1069926147518,1897,704,1193,66,1.7,14.6,5.2,0,0,0,0,0,0,0.160010386991012,4118.46626734389,16.0010982131739
7.5,"random_policy_SVM","SVM",13,44,25640,22804,2836,4500,3776,724,0.516509092687231,0.141122035858878,1.30670741901017,1985,724,1261,88,1.7,14.93,5.2,0,0,0,0,0,0,0.161091118931595,4117.39196448639,16.116414248689
7.5,"random_policy_SVM","SVM",13,45,25540,22711,2829,4600,3869,731,0.533950719770749,0.138808559861191,1.38583690830161,1975,731,1244,-10,1.7,15.26,5.3,0,0,0,0,0,0,0.158930786903939,4058.38561922521,15.8933591017503
7.5,"random_policy_SVM","SVM",13,46,25440,22625,2815,4700,3955,745,0.543558182265419,0.196067090803933,1.96085183893897,2014,745,1269,39,1.7,15.59,5.3,0,0,0,0,0,0,0.158664701282578,4023.44373625674,15.8687152096866
7.5,"random_policy_SVM","SVM",13,47,25340,22542,2798,4800,4038,762,0.457301524974663,0.10294968189705,1.02321949894765,2072,762,1310,58,1.7,15.93,5.3,0,0,0,0,0,0,0.159253444126231,4024.21848934869,15.932192745694
7.5,"random_policy_SVM","SVM",13,48,25240,22449,2791,4900,4131,769,0.491711749421894,0.0919606709080393,0.889138714266049,2094,769,1325,22,1.7,16.26,5.4,0,0,0,0,0,0,0.157557390691101,3963.00480833617,15.7627098269296
7.5,"random_policy_SVM","SVM",14,0,30040,26568,3472,100,86,14,0.497267078735722,0.11924570160843,1.02548953666024,48,14,34,0,2.4,0.33,6.1,0,0,0,0,0,0,0.146391721299018,4241.74721837936,14.7039246627353
7.5,"random_policy_SVM","SVM",14,1,29940,26482,3458,200,172,28,0.470324452546262,0.0837493067110372,0.699049429282552,92,28,64,44,2.3,0.66,6.1,0,0,0,0,0,0,0.19457789012415,4126.46061515686,19.8889090586623
7.5,"random_policy_SVM","SVM",14,2,29840,26390,3450,300,264,36,0.453329195754705,0.0998336106489185,0.821817490483089,115,36,79,23,2.2,1,7.3,0,0,0,0,0,0,0.191409974906358,3222.13722444136,20.5516546422784
7.5,"random_policy_SVM","SVM",14,3,29740,26295,3445,400,359,41,0.485518997329846,0.134220743205768,1.06662362497689,139,41,98,24,2.4,1.33,8.8,0,0,0,0,0,0,0.128475933876372,2377.70162829373,13.4207100512717
7.5,"random_policy_SVM","SVM",14,4,29640,26216,3424,500,438,62,0.467505857737859,0.127010537992235,0.934529407509224,188,62,126,49,2,1.66,7.1,0,0,0,0,0,0,0.133226695622409,3482.2475947152,13.5393188622124
7.5,"random_policy_SVM","SVM",14,5,29540,26122,3418,600,532,68,0.480047009882536,0.129229062673322,0.916442926196785,208,68,140,20,2.1,1.99,7.8,0,0,0,0,0,0,0.117777866935887,3111.32962904364,11.9616237751038
7.5,"random_policy_SVM","SVM",14,6,29440,26032,3408,700,622,78,0.457676245048325,0.0992789794786467,0.826293727380912,236,78,158,28,2,2.32,8,0,0,0,0,0,0,0.126164827885269,2911.81382988543,13.0864241433033
7.5,"random_policy_SVM","SVM",14,7,29340,25945,3395,800,709,91,0.461952648677357,0.104825291181364,0.831430544513831,277,91,186,41,2,2.65,7.8,0,0,0,0,0,0,0.118785448105505,3256.30545490414,12.9791949659536
7.5,"random_policy_SVM","SVM",14,8,29240,25857,3383,900,797,103,0.54749777654267,0.17249029395452,1.5812027319772,306,103,203,29,2,2.99,7.7,0,0,0,0,0,0,0.127510799688796,3357.04650617925,13.6982552978638
7.5,"random_policy_SVM","SVM",14,9,29140,25778,3362,1000,876,124,0.550742544457866,0.155851358846367,1.21459771219648,355,124,231,49,1.9,3.32,7.1,0,0,0,0,0,0,0.130556728832741,3615.56100958096,13.2018755023767
7.5,"random_policy_SVM","SVM",14,10,29040,25690,3350,1100,964,136,0.52561271110304,0.145867997781475,0.945570856014235,381,136,245,26,1.8,3.65,7.1,0,0,0,0,0,0,0.1304907832989,3587.12868953457,13.1932120144181
7.5,"random_policy_SVM","SVM",14,11,28940,25600,3340,1200,1054,146,0.546138495432948,0.166389351081531,1.43528233884609,425,146,279,44,1.9,3.98,7.2,0,0,0,0,0,0,0.126818438706781,3501.07053372212,12.7635993110578
7.5,"random_policy_SVM","SVM",14,12,28840,25512,3328,1300,1142,158,0.546596187374708,0.168607875762618,1.64375902987476,450,158,292,25,1.8,4.31,7.2,0,0,0,0,0,0,0.12600494280079,3479.73198586352,12.7843135509695
7.5,"random_policy_SVM","SVM",14,13,28740,25450,3290,1400,1204,196,0.545247900235279,0.168053244592346,1.31395719981204,536,196,340,86,1.7,4.64,6.1,0,0,0,0,0,0,0.142646830377811,4006.53453268676,14.3173520222705
7.5,"random_policy_SVM","SVM",14,14,28640,25367,3273,1500,1287,213,0.495660203382597,0.132002218524681,1.25986222321001,601,213,388,65,1.8,4.98,6,0,0,0,0,0,0,0.145558650406681,4039.33025554746,14.58364417998
7.5,"random_policy_SVM","SVM",14,15,28540,25281,3259,1600,1373,227,0.505903991956601,0.127010537992235,1.00336332746666,626,227,399,25,1.8,5.31,6,0,0,0,0,0,0,0.143050150731301,4049.36588438776,14.3278562722463
7.5,"random_policy_SVM","SVM",14,16,28440,25194,3246,1700,1460,240,0.479114570714305,0.10981697171381,1.0131934990504,681,240,441,55,1.8,5.64,6.1,0,0,0,0,0,0,0.142531461700322,3986.78524046442,14.341268965528
7.5,"random_policy_SVM","SVM",14,17,28340,25105,3235,1800,1549,251,0.499677684380584,0.132002218524681,1.16258602641919,700,251,449,19,1.8,5.97,6.2,0,0,0,0,0,0,0.140201736808753,3938.38123365715,14.0941684146021
7.5,"random_policy_SVM","SVM",14,18,28240,25017,3223,1900,1637,263,0.472523037593023,0.113699389905713,1.0104916497196,754,263,491,54,1.9,6.3,6.2,0,0,0,0,0,0,0.138908822519672,3892.54005987529,13.9180847713781
7.5,"random_policy_SVM","SVM",14,19,28140,24933,3207,2000,1721,279,0.509918128781107,0.118691070438159,1.01186034970955,753,279,474,-1,1.7,6.64,6.2,0,0,0,0,0,0,0.141113683161717,3897.3066231248,14.2566664262809
7.5,"random_policy_SVM","SVM",14,20,28040,24851,3189,2100,1803,297,0.513817978477237,0.126455906821963,1.09347507349228,781,297,484,28,1.6,6.97,6.1,0,0,0,0,0,0,0.143672361491557,3923.2849349351,14.4513913832857
7.5,"random_policy_SVM","SVM",14,21,27940,24763,3177,2200,1891,309,0.524050522267928,0.133111480865225,1.1317730036959,826,309,517,45,1.7,7.3,6.1,0,0,0,0,0,0,0.140776409812976,3890.94325540869,14.098280456802
7.5,"random_policy_SVM","SVM",14,22,27840,24676,3164,2300,1978,322,0.509096548963471,0.129229062673322,1.13154688813162,859,322,537,33,1.7,7.63,6.1,0,0,0,0,0,0,0.140138169989029,3897.06165081406,14.0156781140861
7.5,"random_policy_SVM","SVM",14,23,27740,24592,3148,2400,2062,338,0.532927170924551,0.160843039378813,1.5774189793417,914,338,576,55,1.7,7.96,6.1,0,0,0,0,0,0,0.142094826234403,3873.95847000168,14.3063191635661
7.5,"random_policy_SVM","SVM",14,24,27640,24523,3117,2500,2131,369,0.543572176710804,0.151968940654465,1.16566436541236,998,369,629,84,1.7,8.29,5.8,0,0,0,0,0,0,0.147834020941047,4059.04937514056,14.7904789197041
7.5,"random_policy_SVM","SVM",14,25,27540,24430,3110,2600,2224,376,0.479972142198939,0.115363283416528,0.918720051165974,1036,376,660,38,1.8,8.63,5.9,0,0,0,0,0,0,0.145465914273928,3984.49884996311,14.5596048794072
7.5,"random_policy_SVM","SVM",14,26,27440,24340,3100,2700,2314,386,0.513038702454005,0.127565169162507,1.16844089003393,1078,386,692,42,1.8,8.96,6,0,0,0,0,0,0,0.143782242382102,3899.40224898811,14.4543226985429
7.5,"random_policy_SVM","SVM",14,27,27340,24243,3097,2800,2411,389,0.51762883135685,0.158069883527454,1.37947063151265,1129,389,740,51,1.9,9.29,6.2,0,0,0,0,0,0,0.138973447007495,3789.48321634862,13.918466633874
7.5,"random_policy_SVM","SVM",14,28,27240,24154,3086,2900,2500,400,0.550540639984518,0.176372712146423,1.74762357320638,1145,400,745,16,1.9,9.62,6.2,0,0,0,0,0,0,0.138275359852124,3729.21489404622,13.9049693572828
7.5,"random_policy_SVM","SVM",14,29,27140,24065,3075,3000,2589,411,0.537963914194533,0.160288408208541,1.47853499664404,1195,411,784,50,1.9,9.95,6.3,0,0,0,0,0,0,0.137057903941245,3698.87814266852,13.7103152134902
7.5,"random_policy_SVM","SVM",14,30,27040,23982,3058,3100,2672,428,0.539934761027876,0.173044925124792,1.56728369384359,1221,428,793,26,1.9,10.29,6.2,0,0,0,0,0,0,0.13808484627548,3721.73617394101,13.8110297908367
7.5,"random_policy_SVM","SVM",14,31,26940,23894,3046,3200,2760,440,0.527446070604531,0.149750415973378,1.41513802531843,1284,440,844,63,1.9,10.62,6.3,0,0,0,0,0,0,0.137507950951304,3687.45734679088,13.7526817009234
7.5,"random_policy_SVM","SVM",14,32,26840,23812,3028,3300,2842,458,0.515469874765723,0.120909595119246,1.03385731383367,1316,458,858,32,1.9,10.95,6.2,0,0,0,0,0,0,0.138924764142692,3695.87826834479,13.898947578981
7.5,"random_policy_SVM","SVM",14,33,26740,23723,3017,3400,2931,469,0.522068054431777,0.112590127565169,1.01542323826486,1363,469,894,47,1.9,11.28,6.2,0,0,0,0,0,0,0.13794868425641,3674.27456519472,13.796952575612
7.5,"random_policy_SVM","SVM",14,34,26640,23634,3006,3500,3020,480,0.515301537433595,0.117027176927343,0.92632939671035,1362,480,882,-1,1.8,11.61,6.3,0,0,0,0,0,0,0.137185441997037,3643.81123098803,13.721437678913
7.5,"random_policy_SVM","SVM",14,35,26540,23546,2994,3600,3108,492,0.445058553133315,0.10038824181919,0.859250212675298,1400,492,908,38,1.8,11.94,6.3,0,0,0,0,0,0,0.13706733455524,3628.59435758048,13.7123962755046
7.5,"random_policy_SVM","SVM",14,36,26440,23473,2967,3700,3181,519,0.496226998983873,0.117027176927343,1.06975527205565,1467,519,948,67,1.8,12.28,6.1,0,0,0,0,0,0,0.140399058897441,3696.99317952118,14.0713250086617
7.5,"random_policy_SVM","SVM",14,37,26340,23378,2962,3800,3276,524,0.535177925077468,0.171381031613977,1.61902282834676,1486,524,962,19,1.8,12.61,6.3,0,0,0,0,0,0,0.137907802583122,3619.97316773553,13.8013990499298
7.5,"random_policy_SVM","SVM",14,38,26240,23299,2941,3900,3355,545,0.508619000991714,0.111480865224626,0.996858886543629,1567,545,1022,81,1.9,12.94,6.2,0,0,0,0,0,0,0.139742933357902,3653.71810265393,13.976176731083
7.5,"random_policy_SVM","SVM",14,39,26140,23205,2935,4000,3449,551,0.525234526885572,0.155851358846367,1.49107716391447,1559,551,1008,-8,1.8,13.27,6.3,0,0,0,0,0,0,0.137749895571412,3592.85117195259,13.776852760992
7.5,"random_policy_SVM","SVM",14,40,26040,23124,2916,4100,3530,570,0.484588940885216,0.113699389905713,1.1105641763285,1607,570,1037,48,1.8,13.6,6.2,0,0,0,0,0,0,0.139123534236711,3602.56838140167,13.9178354200128
7.5,"random_policy_SVM","SVM",14,41,25940,23030,2910,4200,3624,576,0.507814769073952,0.13477537437604,1.29275655590614,1625,576,1049,18,1.8,13.93,6.3,0,0,0,0,0,0,0.137122888042876,3545.55671456094,13.7350807490087
7.5,"random_policy_SVM","SVM",14,42,25840,22946,2894,4300,3708,592,0.518735543765122,0.145867997781475,1.21730772337367,1675,592,1083,50,1.8,14.27,6.3,0,0,0,0,0,0,0.13772701347221,3537.91615746036,13.7790870407571
7.5,"random_policy_SVM","SVM",14,43,25740,22853,2887,4400,3801,599,0.503933939364447,0.107598447032723,1.0705189207072,1673,599,1074,-2,1.8,14.6,6.3,0,0,0,0,0,0,0.136383304750737,3497.45088063355,13.6406129623255
7.5,"random_policy_SVM","SVM",14,44,25640,22767,2873,4500,3887,613,0.518783365445765,0.151414309484193,1.36245513473628,1741,613,1128,68,1.8,14.93,6.3,0,0,0,0,0,0,0.136167418987303,3479.43662390772,13.6201218158395
7.5,"random_policy_SVM","SVM",14,45,25540,22676,2864,4600,3978,622,0.518122682174274,0.150859678313921,1.48503690955805,1745,622,1123,4,1.8,15.26,6.4,0,0,0,0,0,0,0.135159217420046,3445.91467592693,13.5173785986024
7.5,"random_policy_SVM","SVM",14,46,25440,22585,2855,4700,4069,631,0.52338900295308,0.135330005546312,1.12877625258285,1770,631,1139,25,1.8,15.59,6.4,0,0,0,0,0,0,0.134252306839386,3404.90883166078,13.4270495047232
7.5,"random_policy_SVM","SVM",14,47,25340,22499,2841,4800,4155,645,0.517629374785044,0.13477537437604,1.00568509038264,1793,645,1148,23,1.8,15.93,6.4,0,0,0,0,0,0,0.134444390865032,3388.03870275498,13.4486836368935
7.5,"random_policy_SVM","SVM",14,48,25240,22415,2825,4900,4239,661,0.53677322122995,0.183028286189684,1.7164844136199,1826,661,1165,33,1.8,16.26,6.4,0,0,0,0,0,0,0.134873913395288,3394.72489991434,13.4905036563252
7.5,"random_policy_SVM","SVM",15,0,30040,26510,3530,100,88,12,0.453053736069744,0.135661133371494,1.31010735480565,41,12,29,0,2.4,0.33,7.3,0,0,0,0,0,0,0.23461872313166,2824.06330194181,26.7333184882528
7.5,"random_policy_SVM","SVM",15,1,29940,26433,3507,200,165,35,0.443444004105679,0.107613050944476,1.02377249056223,97,35,62,56,1.8,0.66,4.7,0,0,0,0,0,0,0.244149536636774,4991.1470530736,25.4970066146204
7.5,"random_policy_SVM","SVM",15,2,29840,26338,3502,300,260,40,0.570228810997691,0.191757298225529,1.78697767601603,109,40,69,12,1.7,1,6.5,0,0,0,0,0,0,0.538527102750285,4584.16707773183,69.4889564485336
7.5,"random_policy_SVM","SVM",15,3,29740,26259,3481,400,339,61,0.542097191273732,0.151688609044076,1.41052282684628,156,61,95,47,1.6,1.33,5.6,0,0,0,0,0,0,0.252250548996115,3873.34117590199,31.0709119442251
7.5,"random_policy_SVM","SVM",15,4,29640,26189,3451,500,409,91,0.54105210510552,0.157412707498569,1.57807111843299,207,91,116,51,1.3,1.66,4.5,0,0,0,0,0,0,0.236512677049037,3738.82358340533,27.5061706765
7.5,"random_policy_SVM","SVM",15,5,29540,26109,3431,600,489,111,0.51505153492963,0.153978248425873,1.31176573589481,264,111,153,57,1.4,1.99,4.4,0,0,0,0,0,0,0.240823783682229,3752.93348868666,29.0145001765679
7.5,"random_policy_SVM","SVM",15,6,29440,26032,3408,700,566,134,0.533554369569863,0.162564396107613,1.41892938826264,311,134,177,47,1.3,2.32,4.2,0,0,0,0,0,0,0.209113827120009,4088.33292867004,22.5384770856137
7.5,"random_policy_SVM","SVM",15,7,29340,25948,3392,800,650,150,0.553253684276189,0.175729822552948,1.71788867495794,353,150,203,42,1.4,2.65,4.3,0,0,0,0,0,0,0.200857980251319,3883.27611752584,26.0833261323446
7.5,"random_policy_SVM","SVM",15,8,29240,25874,3366,900,724,176,0.543356501525878,0.167143674871208,1.57395798780285,413,176,237,60,1.3,2.99,4.1,0,0,0,0,0,0,0.234589412503408,3977.1380274342,24.6759071659149
7.5,"random_policy_SVM","SVM",15,9,29140,25792,3348,1000,806,194,0.543580327351065,0.172867773325701,1.56646294976569,452,194,258,39,1.3,3.32,4.2,0,0,0,0,0,0,0.209356529396714,3536.73742021134,21.4567621124126
7.5,"random_policy_SVM","SVM",15,10,29040,25713,3327,1100,885,215,0.556053053680226,0.179736691471093,1.72687255664169,497,215,282,45,1.3,3.65,4.1,0,0,0,0,0,0,0.253940108857005,3467.68697047591,26.3879764830783
7.5,"random_policy_SVM","SVM",15,11,28940,25649,3291,1200,949,251,0.53866513800645,0.169433314253005,1.72228225213174,572,251,321,75,1.3,3.98,3.8,0,0,0,0,0,0,0.205095263439081,3715.93671959449,21.0891242202941
7.5,"random_policy_SVM","SVM",15,12,28840,25566,3274,1300,1032,268,0.563145969494044,0.176302232398397,1.81177725712067,617,268,349,45,1.3,4.31,3.9,0,0,0,0,0,0,0.239136889712055,3558.12582179846,27.0458593363038
7.5,"random_policy_SVM","SVM",15,13,28740,25488,3252,1400,1110,290,0.538660025669944,0.167716084716657,1.65987639382808,668,290,378,51,1.3,4.64,3.8,0,0,0,0,0,0,0.203717440650877,3924.77235826732,21.9187651533943
7.5,"random_policy_SVM","SVM",15,14,28640,25395,3245,1500,1203,297,0.532870089772627,0.166571265025758,1.66016409752898,694,297,397,26,1.3,4.98,4.1,0,0,0,0,0,0,0.194010304027215,4240.21208430133,27.333046749887
7.5,"random_policy_SVM","SVM",15,15,28540,25310,3230,1600,1288,312,0.550637843456649,0.170005724098454,1.69211969079844,719,312,407,25,1.3,5.31,4.1,0,0,0,0,0,0,0.19382091885318,4661.99835810849,20.4862047178796
7.5,"random_policy_SVM","SVM",15,16,28440,25232,3208,1700,1366,334,0.558170291327572,0.180881511161992,1.82809359452331,784,334,450,65,1.3,5.64,4.1,0,0,0,0,0,0,0.194891941862776,4021.59859704253,19.9534664283603
7.5,"random_policy_SVM","SVM",15,17,28340,25155,3185,1800,1443,357,0.558010348228305,0.180309101316543,1.79756104498982,838,357,481,54,1.3,5.97,4,0,0,0,0,0,0,0.196964148958555,4345.58127403109,20.9584895659467
7.5,"random_policy_SVM","SVM",15,18,28240,25085,3155,1900,1513,387,0.575057584671041,0.199198626216371,2.03646320521591,903,387,516,65,1.3,6.3,3.9,0,0,0,0,0,0,0.335884292868253,4024.5026700753,34.2088601936522
7.5,"random_policy_SVM","SVM",15,19,28140,25019,3121,2000,1579,421,0.581703278442589,0.19977103606182,1.99833831023012,974,421,553,71,1.3,6.64,3.8,0,0,0,0,0,0,0.277573032929377,4522.88804434304,28.3925582983371
7.5,"random_policy_SVM","SVM",15,20,28040,24960,3080,2100,1638,462,0.570091787491084,0.191757298225529,1.94798456339901,1058,462,596,84,1.3,6.97,3.5,0,0,0,0,0,0,0.217371811788895,5067.20892512655,21.8867282165145
7.5,"random_policy_SVM","SVM",15,21,27940,24887,3053,2200,1711,489,0.567112670053921,0.194046937607327,1.96473985321134,1137,489,648,79,1.3,7.3,3.5,0,0,0,0,0,0,0.217563613296325,3761.09030805968,21.8204855761758
7.5,"random_policy_SVM","SVM",15,22,27840,24809,3031,2300,1789,511,0.566127922344736,0.192902117916428,1.95620492769782,1180,511,669,43,1.3,7.63,3.5,0,0,0,0,0,0,0.21884051842269,4213.13951182426,21.9346216439957
7.5,"random_policy_SVM","SVM",15,23,27740,24732,3008,2400,1866,534,0.564820023415358,0.192902117916428,1.9370857314516,1217,534,683,37,1.3,7.96,3.5,0,0,0,0,0,0,0.217270461169488,4007.85445546366,21.7809528051373
7.5,"random_policy_SVM","SVM",15,24,27640,24653,2987,2500,1945,555,0.564933998446884,0.194619347452776,1.93616836587406,1252,555,697,35,1.3,8.29,3.5,0,0,0,0,0,0,0.220307930759548,5478.21227125331,22.0528592748354
7.5,"random_policy_SVM","SVM",15,25,27540,24568,2972,2600,2030,570,0.561949296104302,0.190612478534631,1.93294221155809,1293,570,723,41,1.3,8.63,3.6,0,0,0,0,0,0,0.216215861288184,5164.02915820694,21.6469297624448
7.5,"random_policy_SVM","SVM",15,26,27440,24481,2959,2700,2117,583,0.562937394756756,0.194619347452776,1.93449202962655,1336,583,753,43,1.3,8.96,3.6,0,0,0,0,0,0,0.210795906286144,4322.6288482899,21.1147353941385
7.5,"random_policy_SVM","SVM",15,27,27340,24393,2947,2800,2205,595,0.564365884682526,0.193474527761878,1.9262247755492,1349,595,754,13,1.3,9.29,3.7,0,0,0,0,0,0,0.207715375658402,4518.16707032973,20.8319713935404
7.5,"random_policy_SVM","SVM",15,28,27240,24312,2928,2900,2286,614,0.563234984294385,0.197481396680023,1.94028121366732,1397,614,783,48,1.3,9.62,3.7,0,0,0,0,0,0,0.207109259143485,4259.89468877732,20.7670256066119
7.5,"random_policy_SVM","SVM",15,29,27140,24232,2908,3000,2366,634,0.560613257843748,0.192902117916428,1.94364391941025,1429,634,795,32,1.3,9.95,3.7,0,0,0,0,0,0,0.208534502247306,4979.43686612942,20.8737584790881
7.5,"random_policy_SVM","SVM",15,30,27040,24141,2899,3100,2457,643,0.562696986058529,0.195764167143675,1.92702294843108,1462,643,819,33,1.3,10.29,3.8,0,0,0,0,0,0,0.203112974969354,4199.73802230097,20.3713144424359
7.5,"random_policy_SVM","SVM",15,31,26940,24053,2887,3200,2545,655,0.562037967218154,0.198626216370922,2.00117515592076,1492,655,837,30,1.3,10.62,3.9,0,0,0,0,0,0,0.204840181658214,4528.47887895622,20.7251253670392
7.5,"random_policy_SVM","SVM",15,32,26840,23984,2856,3300,2614,686,0.562677095203042,0.19977103606182,2.01441508856452,1574,686,888,82,1.3,10.95,3.8,0,0,0,0,0,0,0.203370739951481,4287.49473153984,20.3888909177965
7.5,"random_policy_SVM","SVM",15,33,26740,23902,2838,3400,2696,704,0.5598937072207,0.199198626216371,1.90296811340449,1600,704,896,26,1.3,11.28,3.8,0,0,0,0,0,0,0.20313322736151,4456.69709568789,20.3545463524756
7.5,"random_policy_SVM","SVM",15,34,26640,23815,2825,3500,2783,717,0.561327223561354,0.200915855752719,1.96842890071089,1643,717,926,43,1.3,11.61,3.9,0,0,0,0,0,0,0.200281255300261,4155.35690065876,20.0656559998151
7.5,"random_policy_SVM","SVM",15,35,26540,23729,2811,3600,2869,731,0.559431405933777,0.205495134516314,1.88571802953083,1669,731,938,26,1.3,11.94,3.9,0,0,0,0,0,0,0.19935941804941,4161.15788702956,19.9840656485831
7.5,"random_policy_SVM","SVM",15,36,26440,23642,2798,3700,2956,744,0.558243410627846,0.203205495134516,1.87667890071716,1707,744,963,38,1.3,12.28,4,0,0,0,0,0,0,0.197172189806478,4094.89113820499,19.7781183056228
7.5,"random_policy_SVM","SVM",15,37,26340,23553,2787,3800,3045,755,0.558610811483324,0.205495134516314,1.88988929475566,1749,755,994,42,1.3,12.61,4,0,0,0,0,0,0,0.195163721720955,4404.5553670198,19.5520767300934
7.5,"random_policy_SVM","SVM",15,38,26240,23470,2770,3900,3128,772,0.558442877673206,0.204350314825415,1.873457134364,1791,772,1019,42,1.3,12.94,4.1,0,0,0,0,0,0,0.194176489468643,4181.73044392189,19.4580241833648
7.5,"random_policy_SVM","SVM",15,39,26140,23383,2757,4000,3215,785,0.556932676284955,0.202633085289067,1.77393864860482,1840,785,1055,49,1.3,13.27,4.1,0,0,0,0,0,0,0.192726128751204,4022.80633337546,19.3236144490787
7.5,"random_policy_SVM","SVM",15,40,26040,23303,2737,4100,3295,805,0.558520336015401,0.206067544361763,1.9351187162337,1889,805,1084,49,1.3,13.6,4.1,0,0,0,0,0,0,0.191819365177563,3859.78712954381,19.231514545761
7.5,"random_policy_SVM","SVM",15,41,25940,23220,2720,4200,3378,822,0.556475616216991,0.203205495134516,1.7401044036419,1907,822,1085,18,1.3,13.93,4.1,0,0,0,0,0,0,0.191297082376848,3970.01931361121,19.1682402672698
7.5,"random_policy_SVM","SVM",15,42,25840,23130,2710,4300,3468,832,0.557367697456908,0.20835718374356,1.84648732465048,1930,832,1098,23,1.3,14.27,4.2,0,0,0,0,0,0,0.189127896359664,3983.34024142927,18.9554782485264
7.5,"random_policy_SVM","SVM",15,43,25740,23042,2698,4400,3556,844,0.554526054614876,0.203777904979966,1.8185004627838,1972,844,1128,42,1.3,14.6,4.2,0,0,0,0,0,0,0.187849185939662,3904.76866404151,18.8403212662562
7.5,"random_policy_SVM","SVM",15,44,25640,22947,2693,4500,3651,849,0.555772004054814,0.209502003434459,1.8744263048031,1995,849,1146,23,1.3,14.93,4.3,0,0,0,0,0,0,0.18374286309329,3799.96901839002,18.4124949549381
7.5,"random_policy_SVM","SVM",15,45,25540,22852,2688,4600,3746,854,0.551249390600895,0.202633085289067,1.89745226380042,2020,854,1166,25,1.4,15.26,4.4,0,0,0,0,0,0,0.181610606682537,3730.15153651009,18.2890851471144
7.5,"random_policy_SVM","SVM",15,46,25440,22758,2682,4700,3840,860,0.554000557975011,0.204350314825415,1.90728323384305,2021,860,1161,1,1.4,15.59,4.5,0,0,0,0,0,0,0.178962320852182,3793.29903864773,17.9238684879634
7.5,"random_policy_SVM","SVM",15,47,25340,22672,2668,4800,3926,874,0.551655413225432,0.198626216370922,1.88153238063281,2100,874,1226,79,1.4,15.93,4.5,0,0,0,0,0,0,0.177743279411833,3685.16589458283,17.8178682677176
7.5,"random_policy_SVM","SVM",15,48,25240,22579,2661,4900,4019,881,0.550913007450951,0.201488265598168,1.8064643173401,2125,881,1244,25,1.4,16.26,4.6,0,0,0,0,0,0,0.17466303416363,3384.29105163959,17.5092405735134
7.5,"random_policy_SVM","SVM",16,0,30040,26566,3474,100,91,9,0.417715292535374,0.0880398671096345,0.706690411341574,31,9,22,0,2.4,0.33,10.1,0,0,0,0,0,0,0.118795583426217,2644.12397670764,12.0736358979685
7.5,"random_policy_SVM","SVM",16,1,29940,26475,3465,200,182,18,0.58447529468927,0.188815060908084,1.62304308315089,61,18,43,30,2.4,0.66,10.1,0,0,0,0,0,0,0.993246870804084,3656.03827907207,99.7129295320331
7.5,"random_policy_SVM","SVM",16,2,29840,26390,3450,300,267,33,0.420890327045712,0.0819490586932447,0.780250160492038,108,33,75,47,2.3,1,8.1,0,0,0,0,0,0,0.151786762531572,3242.62200233244,16.9955040360281
7.5,"random_policy_SVM","SVM",16,3,29740,26316,3424,400,341,59,0.53515070383556,0.167220376522702,1.54426329002179,163,59,104,55,1.8,1.33,5.8,0,0,0,0,0,0,0.1826329688234,4091.9621550104,20.140136011422
7.5,"random_policy_SVM","SVM",16,4,29640,26247,3393,500,410,90,0.558938772170832,0.162236987818383,1.33489549777972,235,90,145,72,1.6,1.66,4.6,0,0,0,0,0,0,0.185013304918336,5273.09619085086,18.7002487155252
7.5,"random_policy_SVM","SVM",16,5,29540,26154,3386,600,503,97,0.525800833925031,0.173311184939092,1.40076135105205,254,97,157,19,1.6,1.99,5.2,0,0,0,0,0,0,0.165054044373882,4657.47116007971,16.6965373163489
7.5,"random_policy_SVM","SVM",16,6,29440,26073,3367,700,584,116,0.517829373880006,0.142857142857143,1.22067252185387,300,116,184,46,1.6,2.32,5,0,0,0,0,0,0,0.171590454664055,4680.9558791722,17.6413902352644
7.5,"random_policy_SVM","SVM",16,7,29340,25983,3357,800,674,126,0.535254725317745,0.151162790697674,1.33608950090832,321,126,195,21,1.5,2.65,5.3,0,0,0,0,0,0,0.17800337827836,4441.58476088474,18.9397541494946
7.5,"random_policy_SVM","SVM",16,8,29240,25895,3345,900,762,138,0.542361913778215,0.18936877076412,1.76113607653917,360,138,222,39,1.6,2.99,5.5,0,0,0,0,0,0,0.159999657412539,4295.27393934754,16.1566045254998
7.5,"random_policy_SVM","SVM",16,9,29140,25810,3330,1000,847,153,0.545968395335065,0.172757475083056,1.46913079923243,393,153,240,33,1.6,3.32,5.5,0,0,0,0,0,0,0.153604595930082,4330.60913802286,15.4526343732721
7.5,"random_policy_SVM","SVM",16,10,29040,25731,3309,1100,926,174,0.518682959469605,0.121816168327796,1.19748322730907,447,174,273,54,1.6,3.65,5.3,0,0,0,0,0,0,0.158172242153702,4433.43734509172,15.8710912441657
7.5,"random_policy_SVM","SVM",16,11,28940,25639,3301,1200,1018,182,0.532851920911946,0.168327796234773,1.68209951702585,473,182,291,26,1.6,3.98,5.6,0,0,0,0,0,0,0.151168871657919,4277.61008258947,15.1569849890447
7.5,"random_policy_SVM","SVM",16,12,28840,25558,3282,1300,1099,201,0.534291399568969,0.167774086378738,1.68369702557798,517,201,316,44,1.6,4.31,5.5,0,0,0,0,0,0,0.155669048303244,4413.55781946832,15.6330887244345
7.5,"random_policy_SVM","SVM",16,13,28740,25475,3265,1400,1182,218,0.539500446432487,0.156699889258029,1.53971434547061,579,218,361,62,1.7,4.64,5.4,0,0,0,0,0,0,0.155614858646174,4425.79857259495,15.5712371294566
7.5,"random_policy_SVM","SVM",16,14,28640,25409,3231,1500,1248,252,0.544966291112379,0.167220376522702,1.37595171965897,611,252,359,32,1.4,4.98,5,0,0,0,0,0,0,0.170848765725311,4702.1404554439,17.3857338440136
7.5,"random_policy_SVM","SVM",16,15,28540,25324,3216,1600,1333,267,0.531610133161693,0.160575858250277,1.39822488866898,667,267,400,56,1.5,5.31,5,0,0,0,0,0,0,0.166807042722472,4686.62371136528,16.7122767967904
7.5,"random_policy_SVM","SVM",16,16,28440,25232,3208,1700,1425,275,0.537390797271233,0.176079734219269,1.62935918676239,687,275,412,20,1.5,5.64,5.2,0,0,0,0,0,0,0.162800529632893,4369.37804470613,16.3644298069098
7.5,"random_policy_SVM","SVM",16,17,28340,25152,3188,1800,1505,295,0.5289820462762,0.159468438538206,1.44938800489596,737,295,442,50,1.5,5.97,5.1,0,0,0,0,0,0,0.163822973793433,4625.44350199815,16.3873749499667
7.5,"random_policy_SVM","SVM",16,18,28240,25067,3173,1900,1590,310,0.533070107223104,0.165559246954596,1.47563339005483,771,310,461,34,1.5,6.3,5.1,0,0,0,0,0,0,0.162572962100342,4546.99346330169,16.2700484694545
7.5,"random_policy_SVM","SVM",16,19,28140,24982,3158,2000,1675,325,0.528800426104054,0.169435215946844,1.58951642672573,830,325,505,59,1.6,6.64,5.2,0,0,0,0,0,0,0.162478593893587,4559.33167050645,16.2493078770761
7.5,"random_policy_SVM","SVM",16,20,28040,24895,3145,2100,1762,338,0.536558041023369,0.17109634551495,1.51526927784578,869,338,531,39,1.6,6.97,5.2,0,0,0,0,0,0,0.160231144863495,4429.30233426169,16.0310277976041
7.5,"random_policy_SVM","SVM",16,21,27940,24803,3137,2200,1854,346,0.530333657669977,0.155592469545958,1.37472647324788,876,346,530,7,1.5,7.3,5.4,0,0,0,0,0,0,0.156690861688272,4314.67929414245,15.671926975437
7.5,"random_policy_SVM","SVM",16,22,27840,24714,3126,2300,1943,357,0.538841504571395,0.168327796234773,1.47737262974815,931,357,574,55,1.6,7.63,5.4,0,0,0,0,0,0,0.154857532401173,4283.73091714233,15.5340570977183
7.5,"random_policy_SVM","SVM",16,23,27740,24631,3109,2400,2026,374,0.53173757200002,0.181616832779623,1.79289123590941,951,374,577,20,1.5,7.96,5.4,0,0,0,0,0,0,0.156399486697068,4238.99975281973,15.8712278866983
7.5,"random_policy_SVM","SVM",16,24,27640,24551,3089,2500,2106,394,0.531476432998188,0.16500553709856,1.46877163686719,1022,394,628,71,1.6,8.29,5.3,0,0,0,0,0,0,0.156956854505146,4245.57789388529,15.7021892936336
7.5,"random_policy_SVM","SVM",16,25,27540,24459,3081,2600,2198,402,0.537952939045165,0.174418604651163,1.46018569384253,1054,402,652,32,1.6,8.63,5.5,0,0,0,0,0,0,0.154284451614826,4093.2435126479,15.4336880779756
7.5,"random_policy_SVM","SVM",16,26,27440,24369,3071,2700,2288,412,0.545671358068908,0.179955703211517,1.70543312684066,1032,412,620,-22,1.5,8.96,5.6,0,0,0,0,0,0,0.151783141418865,4082.48687866181,15.184843866841
7.5,"random_policy_SVM","SVM",16,27,27340,24284,3056,2800,2373,427,0.539727315114545,0.179955703211517,1.69529860573725,1100,427,673,68,1.6,9.29,5.6,0,0,0,0,0,0,0.152406190338535,4137.99374671347,15.2417376708502
7.5,"random_policy_SVM","SVM",16,28,27240,24194,3046,2900,2463,437,0.539536177728132,0.173864894795127,1.53529656621902,1135,437,698,35,1.6,9.62,5.6,0,0,0,0,0,0,0.150672276705891,4095.83747381326,15.0676130257595
7.5,"random_policy_SVM","SVM",16,29,27140,24103,3037,3000,2554,446,0.537117469556396,0.171650055370986,1.56330408459635,1154,446,708,19,1.6,9.95,5.7,0,0,0,0,0,0,0.148061276224338,3884.25131245333,14.8134349665043
7.5,"random_policy_SVM","SVM",16,30,27040,24010,3030,3100,2647,453,0.53700777113938,0.168327796234773,1.49988730662842,1155,453,702,1,1.5,10.29,5.8,0,0,0,0,0,0,0.145473447854858,3868.44892630402,14.5508635977327
7.5,"random_policy_SVM","SVM",16,31,26940,23933,3007,3200,2724,476,0.533839498860233,0.168881506090808,1.58743590784258,1188,476,712,33,1.5,10.62,5.7,0,0,0,0,0,0,0.148040130408653,3923.93708709357,14.8102898512335
7.5,"random_policy_SVM","SVM",16,32,26840,23846,2994,3300,2811,489,0.536556621789663,0.167220376522702,1.60706850740954,1274,489,785,86,1.6,10.95,5.7,0,0,0,0,0,0,0.147499281341042,3862.5508058451,14.7540293328697
7.5,"random_policy_SVM","SVM",16,33,26740,23770,2970,3400,2887,513,0.539484500924377,0.173864894795127,1.51793231699841,1309,513,796,35,1.6,11.28,5.6,0,0,0,0,0,0,0.150488680233835,3931.2471804105,15.0542303770744
7.5,"random_policy_SVM","SVM",16,34,26640,23686,2954,3500,2971,529,0.533497004373328,0.166666666666667,1.47913334153644,1393,529,864,84,1.6,11.61,5.6,0,0,0,0,0,0,0.150308848482121,3890.51794200062,15.0372014775311
7.5,"random_policy_SVM","SVM",16,35,26540,23596,2944,3600,3061,539,0.537439092959388,0.167774086378738,1.57020913797354,1368,539,829,-25,1.5,11.94,5.7,0,0,0,0,0,0,0.14900247347192,3867.99887122422,14.9055329961267
7.5,"random_policy_SVM","SVM",16,36,26440,23514,2926,3700,3143,557,0.539294949740345,0.170542635658915,1.58115055079559,1430,557,873,62,1.6,12.28,5.6,0,0,0,0,0,0,0.149992785920873,3859.7221302541,15.0057260694609
7.5,"random_policy_SVM","SVM",16,37,26340,23435,2905,3800,3222,578,0.536714615894831,0.171650055370986,1.55596462880012,1486,578,908,56,1.6,12.61,5.6,0,0,0,0,0,0,0.151881408470421,3879.24537604746,15.2133011530097
7.5,"random_policy_SVM","SVM",16,38,26240,23345,2895,3900,3312,588,0.539444511927621,0.165559246954596,1.57383040935673,1481,588,893,-5,1.5,12.94,5.6,0,0,0,0,0,0,0.150281725308179,3877.09576876958,15.0306181350877
7.5,"random_policy_SVM","SVM",16,39,26140,23257,2883,4000,3400,600,0.543929749601256,0.171650055370986,1.6322303042721,1539,600,939,58,1.6,13.27,5.7,0,0,0,0,0,0,0.149588856772921,3870.67266635158,14.9602183386009
7.5,"random_policy_SVM","SVM",16,40,26040,23179,2861,4100,3478,622,0.541992328624399,0.174418604651163,1.67486898132984,1548,622,926,9,1.5,13.6,5.6,0,0,0,0,0,0,0.150928072714867,3800.67755469675,15.1013723333053
7.5,"random_policy_SVM","SVM",16,41,25940,23105,2835,4200,3552,648,0.535949774154,0.169435215946844,1.63413079118344,1606,648,958,58,1.5,13.93,5.5,0,0,0,0,0,0,0.153646827715508,3849.76195028287,15.3717931158307
7.5,"random_policy_SVM","SVM",16,42,25840,23027,2813,4300,3630,670,0.545705962326025,0.172757475083056,1.67774570390849,1692,670,1022,86,1.5,14.27,5.4,0,0,0,0,0,0,0.1556021656705,3962.88005475248,15.5636676123746
7.5,"random_policy_SVM","SVM",16,43,25740,22940,2800,4400,3717,683,0.5331560960888,0.171650055370986,1.57064354039257,1724,683,1041,32,1.5,14.6,5.4,0,0,0,0,0,0,0.154886733092043,3957.90633193127,15.4900012481926
7.5,"random_policy_SVM","SVM",16,44,25640,22851,2789,4500,3806,694,0.53863663401177,0.174972314507198,1.62935918676239,1785,694,1091,61,1.6,14.93,5.5,0,0,0,0,0,0,0.153731100693914,3811.75466598839,15.3814153138853
7.5,"random_policy_SVM","SVM",16,45,25540,22768,2772,4600,3889,711,0.533211821882829,0.169988925802879,1.42617654851925,1824,711,1113,39,1.6,15.26,5.5,0,0,0,0,0,0,0.153907997009288,3828.54663822548,15.3990794226505
7.5,"random_policy_SVM","SVM",16,46,25440,22684,2756,4700,3973,727,0.533529897201566,0.166666666666667,1.50856883092025,1860,727,1133,36,1.6,15.59,5.5,0,0,0,0,0,0,0.153907401086032,3807.31508569025,15.4011682756103
7.5,"random_policy_SVM","SVM",16,47,25340,22601,2739,4800,4056,744,0.532871122309145,0.17718715393134,1.71310658060991,1953,744,1209,93,1.6,15.93,5.5,0,0,0,0,0,0,0.154663849883789,3886.01717166027,15.4683912790826
7.5,"random_policy_SVM","SVM",16,48,25240,22518,2722,4900,4139,761,0.530410421516584,0.165559246954596,1.51123414687594,1922,761,1161,-31,1.5,16.26,5.4,0,0,0,0,0,0,0.154754697236601,3829.64488114863,15.4926091895352
7.5,"random_policy_SVM","SVM",17,0,30040,26532,3508,100,91,9,0.591635842373114,0.200338600451467,1.79568364188914,34,9,25,0,2.8,0.33,10.1,0,0,0,0,0,0,0.163433891927637,2769.97440638248,17.7106458292786
7.5,"random_policy_SVM","SVM",17,1,29940,26455,3485,200,168,32,0.410297762505947,0.0784424379232506,0.651877110528062,93,32,61,59,1.9,0.66,5.2,0,0,0,0,0,0,0.1787988625266,4870.91672611397,17.9239375647471
7.5,"random_policy_SVM","SVM",17,2,29840,26375,3465,300,248,52,0.547006644536318,0.165914221218962,1.48501379483321,148,52,96,55,1.8,1,4.8,0,0,0,0,0,0,0.204181490378906,5071.3639791107,21.31111772303
7.5,"random_policy_SVM","SVM",17,3,29740,26293,3447,400,330,70,0.565998890427286,0.16196388261851,1.3922905135641,193,70,123,45,1.8,1.33,4.7,0,0,0,0,0,0,0.272839512394928,5161.94747968547,29.7960218879265
7.5,"random_policy_SVM","SVM",17,4,29640,26208,3432,500,415,85,0.567789237025754,0.182279909706546,1.75454427062779,221,85,136,28,1.6,1.66,4.9,0,0,0,0,0,0,0.586213348400128,4658.62794196622,72.1300658356369
7.5,"random_policy_SVM","SVM",17,5,29540,26154,3386,600,469,131,0.520973695471255,0.158577878103837,1.40611225759859,294,131,163,73,1.2,1.99,3.6,0,0,0,0,0,0,0.252736341466196,5798.90093879845,27.9863548096915
7.5,"random_policy_SVM","SVM",17,6,29440,26074,3366,700,549,151,0.528698397527135,0.13431151241535,1.15463805504536,360,151,209,66,1.4,2.32,3.6,0,0,0,0,0,0,0.270004142251889,5669.21026996325,28.7963460524957
7.5,"random_policy_SVM","SVM",17,7,29340,25986,3354,800,637,163,0.550955667672704,0.126410835214447,1.0094602186957,393,163,230,33,1.4,2.65,3.9,0,0,0,0,0,0,0.244729206768551,5401.69860216018,25.7990513186973
7.5,"random_policy_SVM","SVM",17,8,29240,25897,3343,900,726,174,0.550443103463209,0.163092550790068,1.55114656775489,407,174,233,14,1.3,2.99,4.2,0,0,0,0,0,0,0.21693404125954,4418.07189069111,22.8004517661641
7.5,"random_policy_SVM","SVM",17,9,29140,25808,3332,1000,815,185,0.573584323029091,0.173814898419865,1.37440894462171,438,185,253,31,1.4,3.32,4.4,0,0,0,0,0,0,0.188974087605031,5009.77313372158,19.0059787976201
7.5,"random_policy_SVM","SVM",17,10,29040,25726,3314,1100,897,203,0.560374135803758,0.167042889390519,1.38590481242426,489,203,286,51,1.4,3.65,4.4,0,0,0,0,0,0,0.188844955853823,4994.0545579762,18.9512167191581
7.5,"random_policy_SVM","SVM",17,11,28940,25638,3302,1200,985,215,0.566418947808666,0.174943566591422,1.63361982645147,506,215,291,17,1.4,3.98,4.6,0,0,0,0,0,0,0.18090621738239,4833.7223361861,18.1238824433735
7.5,"random_policy_SVM","SVM",17,12,28840,25549,3291,1300,1074,226,0.568749059018843,0.189051918735892,1.54968505427069,537,226,311,31,1.4,4.31,4.8,0,0,0,0,0,0,0.175756647916944,4349.46435537238,17.617436442042
7.5,"random_policy_SVM","SVM",17,13,28740,25470,3270,1400,1153,247,0.570622407156665,0.18510158013544,1.61861365180782,599,247,352,62,1.4,4.64,4.7,0,0,0,0,0,0,0.180404035984276,4522.72879977739,18.3282302758884
7.5,"random_policy_SVM","SVM",17,14,28640,25383,3257,1500,1240,260,0.565885718082982,0.162528216704289,1.54305388686921,647,260,387,48,1.5,4.98,4.8,0,0,0,0,0,0,0.173143809700519,4662.93567294107,17.5436192234009
7.5,"random_policy_SVM","SVM",17,15,28540,25301,3239,1600,1322,278,0.571394796737036,0.171557562076749,1.53625772635411,699,278,421,52,1.5,5.31,4.8,0,0,0,0,0,0,0.174773921125246,4235.71345606083,19.0019777051986
7.5,"random_policy_SVM","SVM",17,16,28440,25216,3224,1700,1407,293,0.569365544889823,0.173814898419865,1.60570026076127,727,293,434,28,1.5,5.64,4.8,0,0,0,0,0,0,0.17317337566188,3928.29534532651,17.4014408475807
7.5,"random_policy_SVM","SVM",17,17,28340,25131,3209,1800,1492,308,0.568579830931461,0.173250564334086,1.50003961934506,776,308,468,49,1.5,5.97,4.8,0,0,0,0,0,0,0.172335249109994,4247.22510053892,17.2503685581791
7.5,"random_policy_SVM","SVM",17,18,28240,25045,3195,1900,1578,322,0.566299070841046,0.172121896162528,1.48138724468039,803,322,481,27,1.5,6.3,4.9,0,0,0,0,0,0,0.170163431373625,4063.99571724697,17.0389886691271
7.5,"random_policy_SVM","SVM",17,19,28140,24963,3177,2000,1660,340,0.565305386256742,0.165349887133183,1.47657621645347,850,340,510,47,1.5,6.64,4.9,0,0,0,0,0,0,0.171788817086301,4372.6042111701,17.4539776960449
7.5,"random_policy_SVM","SVM",17,20,28040,24876,3164,2100,1747,353,0.558018479130033,0.168735891647856,1.60305154054342,915,353,562,65,1.6,6.97,4.9,0,0,0,0,0,0,0.168139271912537,4072.50664181079,16.8321348994216
7.5,"random_policy_SVM","SVM",17,21,27940,24789,3151,2200,1834,366,0.559530498992014,0.16647855530474,1.55914132965152,938,366,572,23,1.6,7.3,5,0,0,0,0,0,0,0.165393923667189,4256.93046149468,16.559153057873
7.5,"random_policy_SVM","SVM",17,22,27840,24707,3133,2300,1916,384,0.558309918072897,0.174943566591422,1.54434329333492,996,384,612,58,1.6,7.63,5,0,0,0,0,0,0,0.166948234023274,3777.1560615068,16.7393138158307
7.5,"random_policy_SVM","SVM",17,23,27740,24619,3121,2400,2004,396,0.557718341150582,0.163656884875847,1.52351850034351,1041,396,645,45,1.6,7.96,5.1,0,0,0,0,0,0,0.165075464779486,3536.97351697217,16.5396426958108
7.5,"random_policy_SVM","SVM",17,24,27640,24545,3095,2500,2078,422,0.556034122798485,0.163656884875847,1.51823767365254,1134,422,712,93,1.7,8.29,4.9,0,0,0,0,0,0,0.168862403356893,3949.23865087605,16.8973723860921
7.5,"random_policy_SVM","SVM",17,25,27540,24460,3080,2600,2163,437,0.55385299850275,0.159142212189616,1.4592769872971,1151,437,714,17,1.6,8.63,4.9,0,0,0,0,0,0,0.167549790934765,4150.65522299631,16.7608561914077
7.5,"random_policy_SVM","SVM",17,26,27440,24376,3064,2700,2247,453,0.556770358334108,0.164785553047404,1.44719930743503,1200,453,747,49,1.6,8.96,5,0,0,0,0,0,0,0.168019368246178,4171.70220645279,16.8144802090387
7.5,"random_policy_SVM","SVM",17,27,27340,24299,3041,2800,2324,476,0.558437602956285,0.176636568848758,1.6802897602587,1234,476,758,34,1.6,9.29,4.9,0,0,0,0,0,0,0.169377949338026,4174.32038880104,16.9595839486051
7.5,"random_policy_SVM","SVM",17,28,27240,24220,3020,2900,2403,497,0.558283948266103,0.172121896162528,1.59146386984855,1278,497,781,44,1.6,9.62,4.8,0,0,0,0,0,0,0.171090657828035,3784.38436275076,17.1245829464142
7.5,"random_policy_SVM","SVM",17,29,27140,24129,3011,3000,2494,506,0.558458395775441,0.174379232505643,1.63303428366344,1339,506,833,61,1.6,9.95,4.9,0,0,0,0,0,0,0.168792827854922,4213.93046969643,16.889670537629
7.5,"random_policy_SVM","SVM",17,30,27040,24051,2989,3100,2572,528,0.558229420158715,0.177200902934537,1.59377137254747,1357,528,829,18,1.6,10.29,4.9,0,0,0,0,0,0,0.169927818125484,4215.9598819696,17.0094859373915
7.5,"random_policy_SVM","SVM",17,31,26940,23969,2971,3200,2654,546,0.557568972327215,0.170428893905192,1.54367926126403,1390,546,844,33,1.5,10.62,4.9,0,0,0,0,0,0,0.169193280756362,3965.78664436654,16.9322417935352
7.5,"random_policy_SVM","SVM",17,32,26840,23887,2953,3300,2736,564,0.558365846513018,0.169864559819413,1.59981801089762,1463,564,899,73,1.6,10.95,4.9,0,0,0,0,0,0,0.170644740518711,3915.67784125489,17.0795173847661
7.5,"random_policy_SVM","SVM",17,33,26740,23799,2941,3400,2824,576,0.559550061215757,0.173814898419865,1.62248458404449,1476,576,900,13,1.6,11.28,4.9,0,0,0,0,0,0,0.168930836426444,4117.29492937333,16.9023137453811
7.5,"random_policy_SVM","SVM",17,34,26640,23719,2921,3500,2904,596,0.559217333674847,0.172686230248307,1.56575784653625,1535,596,939,59,1.6,11.61,4.9,0,0,0,0,0,0,0.169064274695672,3757.88824393783,16.9329299593082
7.5,"random_policy_SVM","SVM",17,35,26540,23635,2905,3600,2988,612,0.555920186636343,0.168735891647856,1.54168387893786,1548,612,936,13,1.5,11.94,4.9,0,0,0,0,0,0,0.168535953752686,3812.23526606417,16.8769937247944
7.5,"random_policy_SVM","SVM",17,36,26440,23548,2892,3700,3075,625,0.558284627215301,0.174379232505643,1.55643683471717,1605,625,980,57,1.6,12.28,4.9,0,0,0,0,0,0,0.168135195672738,3914.56269026154,16.8346032484832
7.5,"random_policy_SVM","SVM",17,37,26340,23459,2881,3800,3164,636,0.55718303214298,0.177765237020316,1.57909497966838,1613,636,977,8,1.5,12.61,5,0,0,0,0,0,0,0.166975686690628,4107.61768401801,16.7062992882775
7.5,"random_policy_SVM","SVM",17,38,26240,23380,2860,3900,3243,657,0.557632369208502,0.186794582392777,1.59193853159684,1696,657,1039,83,1.6,12.94,4.9,0,0,0,0,0,0,0.16785756350854,4044.83939534912,16.8014816026989
7.5,"random_policy_SVM","SVM",17,39,26140,23298,2842,4000,3325,675,0.555756559879839,0.171557562076749,1.49872485970028,1702,675,1027,6,1.5,13.27,4.9,0,0,0,0,0,0,0.165317565323012,2841.39668986344,16.5824302758153
7.5,"random_policy_SVM","SVM",17,40,26040,23214,2826,4100,3409,691,0.556010571748215,0.180022573363431,1.74084878195854,1744,691,1053,42,1.5,13.6,4.9,0,0,0,0,0,0,0.167723190855143,3923.07778246385,16.7879703885058
7.5,"random_policy_SVM","SVM",17,41,25940,23138,2802,4200,3485,715,0.556851662500468,0.176636568848758,1.60946807593429,1790,715,1075,46,1.5,13.93,4.9,0,0,0,0,0,0,0.168577814198383,3357.86447247815,16.8833043884219
7.5,"random_policy_SVM","SVM",17,42,25840,23050,2790,4300,3573,727,0.559122323221578,0.18510158013544,1.75104567786483,1814,727,1087,24,1.5,14.27,4.9,0,0,0,0,0,0,0.16743295997037,3786.31942059108,16.7543051147467
7.5,"random_policy_SVM","SVM",17,43,25740,22970,2770,4400,3653,747,0.557015883337519,0.174379232505643,1.55175203425032,1887,747,1140,73,1.5,14.6,4.9,0,0,0,0,0,0,0.168331033532613,3799.26995251909,16.8474301174986
7.5,"random_policy_SVM","SVM",17,44,25640,22882,2758,4500,3741,759,0.557950584210327,0.182844243792325,1.68482966483632,1908,759,1149,21,1.5,14.93,4.9,0,0,0,0,0,0,0.166882707601521,3467.61376774316,16.7150072857402
7.5,"random_policy_SVM","SVM",17,45,25540,22801,2739,4600,3822,778,0.558336651697539,0.187358916478555,1.64924575522622,1958,778,1180,50,1.5,15.26,4.9,0,0,0,0,0,0,0.165613074421918,3263.9938313515,16.6101096992937
7.5,"random_policy_SVM","SVM",17,46,25440,22712,2728,4700,3911,789,0.55698325134173,0.18058690744921,1.50394689753895,1997,789,1208,39,1.5,15.59,5,0,0,0,0,0,0,0.166862585482788,3716.77662129708,16.6974120961279
7.5,"random_policy_SVM","SVM",17,47,25340,22629,2711,4800,3994,806,0.558637935403763,0.184537246049661,1.53224660957511,2000,806,1194,3,1.5,15.93,5,0,0,0,0,0,0,0.166486258837193,3406.83349883954,16.6684807209981
7.5,"random_policy_SVM","SVM",17,48,25240,22548,2692,4900,4075,825,0.556471408515754,0.173250564334086,1.53901429646351,2059,825,1234,59,1.5,16.26,4.9,0,0,0,0,0,0,0.16767703992882,3722.02220722024,16.7868445545983
7.5,"random_policy_SVM","SVM",18,0,30040,26469,3571,100,86,14,0.638661082351562,0.247065727699531,2.44912348803469,48,14,34,0,2.4,0.33,6.1,0,0,0,0,0,0,0.886561425724987,4539.48837778769,91.530906699751
7.5,"random_policy_SVM","SVM",18,1,29940,26410,3530,200,145,55,0.579343605459595,0.19424882629108,2.06552469631956,118,55,63,70,1.1,0.66,2.6,0,0,0,0,0,0,0.423069863936524,6895.72317571413,44.6902886994432
7.5,"random_policy_SVM","SVM",18,2,29840,26353,3487,300,202,98,0.572119351103257,0.151995305164319,1.48851949631896,210,98,112,92,1.1,1,2.1,0,0,0,0,0,0,0.354213364144074,8609.62948154476,37.3812246886078
7.5,"random_policy_SVM","SVM",18,3,29740,26273,3467,400,282,118,0.574500859800826,0.142605633802817,1.36368689375608,261,118,143,51,1.2,1.33,2.4,0,0,0,0,0,0,0.345263317347336,8131.50297391127,34.9418812763076
7.5,"random_policy_SVM","SVM",18,4,29640,26182,3458,500,373,127,0.601152907570351,0.188967136150235,1.70448750823473,281,127,154,20,1.2,1.66,2.9,0,0,0,0,0,0,0.349120424140617,6242.08339229968,39.4665581018521
7.5,"random_policy_SVM","SVM",18,5,29540,26106,3434,600,449,151,0.597750121963174,0.161384976525822,1.57825590172365,351,151,200,70,1.3,1.99,3,0,0,0,0,0,0,0.270467516734654,6882.33542080008,27.4999090010308
7.5,"random_policy_SVM","SVM",18,6,29440,26027,3413,700,528,172,0.593958814732246,0.153169014084507,1.51080146358579,393,172,221,42,1.3,2.32,3.1,0,0,0,0,0,0,0.250247061449349,6552.38648642837,25.5039207995018
7.5,"random_policy_SVM","SVM",18,7,29340,25957,3383,800,598,202,0.611624200829522,0.18368544600939,1.67455555555556,474,202,272,81,1.3,2.65,3,0,0,0,0,0,0,0.306453090697072,5904.14883300081,33.4444700539046
7.5,"random_policy_SVM","SVM",18,8,29240,25863,3377,900,692,208,0.592364820202224,0.174295774647887,1.67201367806367,504,208,296,30,1.4,2.99,3.3,0,0,0,0,0,0,0.246171007604287,5645.70342244586,25.1850761702385
7.5,"random_policy_SVM","SVM",18,9,29140,25782,3358,1000,773,227,0.579956933566692,0.169600938967136,1.68651400199675,528,227,301,24,1.3,3.32,3.4,0,0,0,0,0,0,0.236979541373938,5628.19058540477,25.4974775140599
7.5,"random_policy_SVM","SVM",18,10,29040,25714,3326,1100,841,259,0.579466797919761,0.155516431924883,1.25788210745957,605,259,346,77,1.3,3.65,3.2,0,0,0,0,0,0,0.291647672535096,5426.16764775131,34.6473205979452
7.5,"random_policy_SVM","SVM",18,11,28940,25628,3312,1200,927,273,0.577254602024251,0.164319248826291,1.49867017439728,634,273,361,29,1.3,3.98,3.4,0,0,0,0,0,0,0.237611604659473,5700.41461948102,25.353977170586
7.5,"random_policy_SVM","SVM",18,12,28840,25545,3295,1300,1010,290,0.585914206593144,0.171948356807512,1.5782828436134,667,290,377,33,1.3,4.31,3.5,0,0,0,0,0,0,0.227269702775888,5102.76272803235,24.4067448462192
7.5,"random_policy_SVM","SVM",18,13,28740,25463,3277,1400,1092,308,0.591601386955686,0.190727699530516,1.80807159824364,711,308,403,44,1.3,4.64,3.5,0,0,0,0,0,0,0.21842745978783,4860.81549247433,21.9616595524615
7.5,"random_policy_SVM","SVM",18,14,28640,25370,3270,1500,1185,315,0.589700157630157,0.196009389671362,1.93259923724006,729,315,414,18,1.3,4.98,3.8,0,0,0,0,0,0,0.203402137328617,4992.2684315339,20.4169911520548
7.5,"random_policy_SVM","SVM",18,15,28540,25287,3253,1600,1268,332,0.594767292691584,0.193075117370892,1.76127215881496,781,332,449,52,1.4,5.31,3.8,0,0,0,0,0,0,0.20346386787728,4998.82418789517,20.5132849622795
7.5,"random_policy_SVM","SVM",18,16,28440,25204,3236,1700,1351,349,0.592882351463963,0.2018779342723,1.93830787428048,828,349,479,47,1.4,5.64,3.9,0,0,0,0,0,0,0.199242987037763,4803.4725043089,20.0073896289104
7.5,"random_policy_SVM","SVM",18,17,28340,25129,3211,1800,1426,374,0.590331837286909,0.194835680751174,1.91335917328471,903,374,529,75,1.4,5.97,3.8,0,0,0,0,0,0,0.203061335671351,4610.54379163799,20.4375073196762
7.5,"random_policy_SVM","SVM",18,18,28240,25038,3202,1900,1517,383,0.59424286862293,0.198943661971831,1.96973214834861,923,383,540,20,1.4,6.3,4,0,0,0,0,0,0,0.195523307270139,4258.63781898421,19.6015281447441
7.5,"random_policy_SVM","SVM",18,19,28140,24960,3180,2000,1595,405,0.598958075401864,0.205399061032864,2.03026403805418,969,405,564,46,1.4,6.64,3.9,0,0,0,0,0,0,0.195395986693997,4122.61769847861,19.7174427063541
7.5,"random_policy_SVM","SVM",18,20,28040,24876,3164,2100,1679,421,0.594471648348479,0.203638497652582,1.93473078051643,1046,421,625,77,1.5,6.97,4,0,0,0,0,0,0,0.195382958037604,4171.29559403287,25.0073441441833
7.5,"random_policy_SVM","SVM",18,21,27940,24791,3149,2200,1764,436,0.579139806671247,0.184272300469484,1.69461233719025,1059,436,623,13,1.4,7.3,4,0,0,0,0,0,0,0.204233897373782,4706.13249761344,20.9026820976805
7.5,"random_policy_SVM","SVM",18,22,27840,24701,3139,2300,1854,446,0.579793657458574,0.193661971830986,1.81620974046754,1093,446,647,34,1.5,7.63,4.2,0,0,0,0,0,0,0.186910757819065,3889.72791391706,19.8753174529648
7.5,"random_policy_SVM","SVM",18,23,27740,24617,3123,2400,1938,462,0.58443576536147,0.197769953051643,1.8782019065364,1138,462,676,45,1.5,7.96,4.2,0,0,0,0,0,0,0.188249763769142,4465.17359907873,18.9177936134778
7.5,"random_policy_SVM","SVM",18,24,27640,24530,3110,2500,2025,475,0.587910925441427,0.203638497652582,1.94578638497653,1185,475,710,47,1.5,8.29,4.3,0,0,0,0,0,0,0.184564885996256,4097.9141823347,18.5016000267413
7.5,"random_policy_SVM","SVM",18,25,27540,24449,3091,2600,2106,494,0.581379090858964,0.188967136150235,1.81662151615816,1214,494,720,29,1.5,8.63,4.3,0,0,0,0,0,0,0.185281574921799,4297.518286337,18.5806936872557
7.5,"random_policy_SVM","SVM",18,26,27440,24364,3076,2700,2191,509,0.587640042519397,0.192488262910798,1.75963547427672,1272,509,763,58,1.5,8.96,4.3,0,0,0,0,0,0,0.188405653645997,3893.06628253086,23.7486770691897
7.5,"random_policy_SVM","SVM",18,27,27340,24282,3058,2800,2273,527,0.582094011037629,0.197769953051643,1.88196979600898,1297,527,770,25,1.5,9.29,4.3,0,0,0,0,0,0,0.183298937591871,3960.94573505022,18.4600070837855
7.5,"random_policy_SVM","SVM",18,28,27240,24196,3044,2900,2359,541,0.583521129394764,0.194835680751174,1.87867963902295,1313,541,772,16,1.4,9.62,4.4,0,0,0,0,0,0,0.181582811596851,3890.34615504186,18.1822630896124
7.5,"random_policy_SVM","SVM",18,29,27140,24122,3018,3000,2433,567,0.584592719404631,0.198356807511737,2.04576750357216,1413,567,846,100,1.5,9.95,4.3,0,0,0,0,0,0,0.185869244508517,4250.10105262651,18.6074853163507
7.5,"random_policy_SVM","SVM",18,30,27040,24042,2998,3100,2513,587,0.580326686560099,0.193661971830986,1.89030665312466,1417,587,830,4,1.4,10.29,4.3,0,0,0,0,0,0,0.18365225748586,3780.0320038172,18.4120580698889
7.5,"random_policy_SVM","SVM",18,31,26940,23954,2986,3200,2601,599,0.580469723279707,0.193075117370892,1.92204794423104,1494,599,895,77,1.5,10.62,4.3,0,0,0,0,0,0,0.182949601354033,4022.50848850876,18.3169346072885
7.5,"random_policy_SVM","SVM",18,32,26840,23862,2978,3300,2693,607,0.582113635780918,0.201291079812207,1.89030665312466,1484,607,877,-10,1.4,10.95,4.4,0,0,0,0,0,0,0.179506573982,4086.30945225659,20.4170956723289
7.5,"random_policy_SVM","SVM",18,33,26740,23770,2970,3400,2785,615,0.582779384343266,0.193661971830986,1.83902918243676,1491,615,876,7,1.4,11.28,4.5,0,0,0,0,0,0,0.176586235940767,3948.59417071574,18.496837167257
7.5,"random_policy_SVM","SVM",18,34,26640,23686,2954,3500,2869,631,0.584184024247221,0.197183098591549,1.94747984571193,1503,631,872,12,1.4,11.61,4.5,0,0,0,0,0,0,0.176558407054342,3842.81027223117,17.6949259840229
7.5,"random_policy_SVM","SVM",18,35,26540,23596,2944,3600,2959,641,0.584381720486753,0.205399061032864,1.96373616082154,1568,641,927,65,1.4,11.94,4.6,0,0,0,0,0,0,0.175070652652227,4200.73287582507,17.5267986934584
7.5,"random_policy_SVM","SVM",18,36,26440,23515,2925,3700,3040,660,0.581623017198468,0.193075117370892,1.95087562573932,1646,660,986,78,1.5,12.28,4.6,0,0,0,0,0,0,0.175719376360026,4315.89274687323,17.5829070469106
7.5,"random_policy_SVM","SVM",18,37,26340,23428,2912,3800,3127,673,0.582006907031576,0.195422535211268,1.85710941061945,1631,673,958,-15,1.4,12.61,4.6,0,0,0,0,0,0,0.17395209875359,3888.16868652349,17.4252757047825
7.5,"random_policy_SVM","SVM",18,38,26240,23341,2899,3900,3214,686,0.583596203916095,0.199530516431925,1.82001194264243,1660,686,974,29,1.4,12.94,4.7,0,0,0,0,0,0,0.173426766993864,4006.76178345911,17.3637715722545
7.5,"random_policy_SVM","SVM",18,39,26140,23259,2881,4000,3296,704,0.582361030475517,0.197769953051643,1.9535701410071,1689,704,985,29,1.4,13.27,4.7,0,0,0,0,0,0,0.173554703684673,4003.21304488846,17.4481519335746
7.5,"random_policy_SVM","SVM",18,40,26040,23174,2866,4100,3381,719,0.583747999329857,0.198943661971831,1.94839447206512,1767,719,1048,78,1.5,13.6,4.7,0,0,0,0,0,0,0.170439806739339,3560.82435564182,17.0729912774324
7.5,"random_policy_SVM","SVM",18,41,25940,23087,2853,4200,3468,732,0.582514955195876,0.206572769953052,1.88262247973797,1798,732,1066,31,1.5,13.93,4.7,0,0,0,0,0,0,0.170383795373172,3762.2211341991,17.0777106642401
7.5,"random_policy_SVM","SVM",18,42,25840,23001,2839,4300,3554,746,0.582755061954475,0.197769953051643,1.99714145085567,1825,746,1079,27,1.4,14.27,4.8,0,0,0,0,0,0,0.16961295516507,3694.7940436598,16.9904080473592
7.5,"random_policy_SVM","SVM",18,43,25740,22920,2820,4400,3635,765,0.582975543969782,0.2018779342723,1.94917625672736,1868,765,1103,43,1.4,14.6,4.8,0,0,0,0,0,0,0.17243904810585,4216.13699504435,17.2510669948565
7.5,"random_policy_SVM","SVM",18,44,25640,22829,2811,4500,3726,774,0.581773824789589,0.202464788732394,2.05111824682474,1842,774,1068,-26,1.4,14.93,4.8,0,0,0,0,0,0,0.169637450645775,3823.94455703211,16.9799252173397
7.5,"random_policy_SVM","SVM",18,45,25540,22739,2801,4600,3816,784,0.580916043504232,0.196009389671362,1.95946421360483,1943,784,1159,101,1.5,15.26,4.9,0,0,0,0,0,0,0.166675572345214,3685.20844981707,16.6968982589992
7.5,"random_policy_SVM","SVM",18,46,25440,22659,2781,4700,3896,804,0.580615481999502,0.200117370892019,2.01851454253979,1948,804,1144,5,1.4,15.59,4.8,0,0,0,0,0,0,0.167846208100411,3708.21751963897,16.8003994949879
7.5,"random_policy_SVM","SVM",18,47,25340,22574,2766,4800,3981,819,0.580083177301264,0.204225352112676,2.01150581148931,1989,819,1170,41,1.4,15.93,4.9,0,0,0,0,0,0,0.166966474457182,3529.2304300647,16.7228092298909
7.5,"random_policy_SVM","SVM",18,48,25240,22491,2749,4900,4064,836,0.58027992962137,0.199530516431925,1.92843818603389,2037,836,1201,48,1.4,16.26,4.9,0,0,0,0,0,0,0.168311477574885,3841.42682773273,16.845250512005
7.5,"random_policy_SVM","SVM",19,0,30040,26508,3532,100,92,8,0.442814170775865,0.109205260148656,0.936956080836618,31,8,23,0,2.9,0.33,11.5,0,0,0,0,0,0,0.0845788278334048,2465.2554105781,8.47795330838661
7.5,"random_policy_SVM","SVM",19,1,29940,26419,3521,200,181,19,0.465728587996195,0.121783876500858,1.09163187589674,65,19,46,34,2.4,0.66,9.5,0,0,0,0,0,0,0.11539456447872,2784.47727333484,11.8121502418175
7.5,"random_policy_SVM","SVM",19,2,29840,26324,3516,300,276,24,0.586665518177583,0.190394511149228,1.84043326685848,75,24,51,10,2.1,1,11.5,0,0,0,0,0,0,0.0855456708362797,2407.25082159437,8.6879131491816
7.5,"random_policy_SVM","SVM",19,3,29740,26263,3477,400,337,63,0.511345020626018,0.106918238993711,0.828697940611783,156,63,93,81,1.5,1.33,5.3,0,0,0,0,0,0,0.413326791545993,4442.05277466357,47.3149109133081
7.5,"random_policy_SVM","SVM",19,4,29640,26176,3464,500,424,76,0.598586156723788,0.198970840480274,1.94673063116377,194,76,118,38,1.6,1.66,5.6,0,0,0,0,0,0,0.283459299948232,3975.75227915631,32.8472125770161
7.5,"random_policy_SVM","SVM",19,5,29540,26103,3437,600,497,103,0.543976101813473,0.154373927958834,1.37993444143985,257,103,154,63,1.5,1.99,4.8,0,0,0,0,0,0,0.180342373092549,4937.53450680701,18.7807572954443
7.5,"random_policy_SVM","SVM",19,6,29440,26027,3413,700,573,127,0.590616174691878,0.17724413950829,1.57431885172564,302,127,175,45,1.4,2.32,4.5,0,0,0,0,0,0,0.233226289775123,4473.94307526981,24.2483261667831
7.5,"random_policy_SVM","SVM",19,7,29340,25938,3402,800,662,138,0.585079006692567,0.1789594053745,1.51148107234351,332,138,194,30,1.4,2.65,4.8,0,0,0,0,0,0,0.190055943237992,4529.49225339252,19.4972058931889
7.5,"random_policy_SVM","SVM",19,8,29240,25851,3389,900,749,151,0.568453811812079,0.168667810177244,1.59544792907238,378,151,227,46,1.5,2.99,5,0,0,0,0,0,0,0.189626752098505,4172.14693600515,19.7668813145015
7.5,"random_policy_SVM","SVM",19,9,29140,25762,3378,1000,838,162,0.571894343468107,0.178387650085763,1.63917052576541,409,162,247,31,1.5,3.32,5.2,0,0,0,0,0,0,0.173219184062987,3976.24855751414,17.6322268415656
7.5,"random_policy_SVM","SVM",19,10,29040,25684,3356,1100,916,184,0.579801064180714,0.182389937106918,1.73412717202095,454,184,270,45,1.5,3.65,5,0,0,0,0,0,0,0.182827152552494,4207.53102054956,19.5863409858084
7.5,"random_policy_SVM","SVM",19,11,28940,25600,3340,1200,1000,200,0.562971579015405,0.162378502001144,1.47434957767154,503,200,303,49,1.5,3.98,5,0,0,0,0,0,0,0.169984589234738,4302.32347076157,17.147633802169
7.5,"random_policy_SVM","SVM",19,12,28840,25511,3329,1300,1089,211,0.568788487366926,0.163522012578616,1.44507420389291,527,211,316,24,1.5,4.31,5.2,0,0,0,0,0,0,0.163222610851675,4368.71569692097,16.4784414255123
7.5,"random_policy_SVM","SVM",19,13,28740,25428,3312,1400,1172,228,0.559694393750991,0.161234991423671,1.45014663573415,566,228,338,39,1.5,4.64,5.1,0,0,0,0,0,0,0.162977331351438,4294.86366755971,16.3562998909627
7.5,"random_policy_SVM","SVM",19,14,28640,25346,3294,1500,1254,246,0.557928913676104,0.158376214979989,1.48198869465429,618,246,372,52,1.5,4.98,5.1,0,0,0,0,0,0,0.164495024712761,4033.52709346589,16.4909659602705
7.5,"random_policy_SVM","SVM",19,15,28540,25258,3282,1600,1342,258,0.561442105721249,0.158947970268725,1.4969435797528,654,258,396,36,1.5,5.31,5.2,0,0,0,0,0,0,0.161222150088232,4568.79178503918,16.1241995733271
7.5,"random_policy_SVM","SVM",19,16,28440,25181,3259,1700,1419,281,0.569517838018237,0.172098341909663,1.61328389958415,710,281,429,56,1.5,5.64,5,0,0,0,0,0,0,0.165292645212162,4193.83994649401,17.0745778940048
7.5,"random_policy_SVM","SVM",19,17,28340,25098,3242,1800,1502,298,0.559172251817137,0.157232704402516,1.49461689865764,748,298,450,38,1.5,5.97,5,0,0,0,0,0,0,0.165743262903182,4238.32706521506,16.6224210177879
7.5,"random_policy_SVM","SVM",19,18,28240,25010,3230,1900,1590,310,0.555646270170122,0.158947970268725,1.45263237043283,792,310,482,44,1.6,6.3,5.1,0,0,0,0,0,0,0.163838535564265,3567.75330993538,16.4346796955113
7.5,"random_policy_SVM","SVM",19,19,28140,24921,3219,2000,1679,321,0.559096329650364,0.155517438536306,1.50986809150109,790,321,469,-2,1.5,6.64,5.2,0,0,0,0,0,0,0.160134128204161,3742.16692049748,16.0482384710042
7.5,"random_policy_SVM","SVM",19,20,28040,24841,3199,2100,1759,341,0.560102073039949,0.160663236134934,1.58952966188724,849,341,508,59,1.5,6.97,5.2,0,0,0,0,0,0,0.162058638878963,4223.8421384127,16.2277762357858
7.5,"random_policy_SVM","SVM",19,21,27940,24763,3177,2200,1837,363,0.55581523883637,0.160091480846198,1.53410249359244,897,363,534,48,1.5,7.3,5.1,0,0,0,0,0,0,0.164695031273622,4512.79444127949,16.4729516542909
7.5,"random_policy_SVM","SVM",19,22,27840,24670,3170,2300,1930,370,0.555782878568562,0.161806746712407,1.53003685094158,933,370,563,36,1.5,7.63,5.2,0,0,0,0,0,0,0.160783491113691,3785.09399115402,16.1144450793276
7.5,"random_policy_SVM","SVM",19,23,27740,24590,3150,2400,2010,390,0.554950395657929,0.160663236134934,1.5237708145971,963,390,573,30,1.5,7.96,5.2,0,0,0,0,0,0,0.161941467801486,4304.97425806032,16.2032261960217
7.5,"random_policy_SVM","SVM",19,24,27640,24503,3137,2500,2097,403,0.552539298197638,0.158947970268725,1.56048534548768,995,403,592,32,1.5,8.29,5.2,0,0,0,0,0,0,0.160839686414316,4217.02745992203,16.0904516766981
7.5,"random_policy_SVM","SVM",19,25,27540,24413,3127,2600,2187,413,0.55712909146016,0.160091480846198,1.57431885172564,1024,413,611,29,1.5,8.63,5.3,0,0,0,0,0,0,0.158017478919882,4168.85159141439,15.8069757500278
7.5,"random_policy_SVM","SVM",19,26,27440,24330,3110,2700,2270,430,0.55205865809266,0.166380789022298,1.57505442329068,1089,430,659,65,1.5,8.96,5.3,0,0,0,0,0,0,0.159130913998717,4117.73665334159,15.9228141845733
7.5,"random_policy_SVM","SVM",19,27,27340,24247,3093,2800,2353,447,0.553442081000406,0.161234991423671,1.51214097650156,1120,447,673,31,1.5,9.29,5.3,0,0,0,0,0,0,0.159142031769264,3942.37467563513,15.9331112933098
7.5,"random_policy_SVM","SVM",19,28,27240,24154,3086,2900,2446,454,0.554478940032133,0.165237278444826,1.54389723140244,1135,454,681,15,1.5,9.62,5.4,0,0,0,0,0,0,0.156063234687551,3821.14024886673,15.6275541661068
7.5,"random_policy_SVM","SVM",19,29,27140,24072,3068,3000,2528,472,0.554777221015226,0.168096054888508,1.65183082912598,1176,472,704,41,1.5,9.95,5.4,0,0,0,0,0,0,0.157155768616417,4090.79883904519,15.7238570846514
7.5,"random_policy_SVM","SVM",19,30,27040,23991,3049,3100,2609,491,0.552898394166771,0.166380789022298,1.46011090747453,1241,491,750,65,1.5,10.29,5.3,0,0,0,0,0,0,0.158239197002108,3735.16865323127,15.8473070349037
7.5,"random_policy_SVM","SVM",19,31,26940,23898,3042,3200,2702,498,0.556320127683141,0.169239565465981,1.65329133383785,1251,498,753,10,1.5,10.62,5.4,0,0,0,0,0,0,0.155675254233786,3831.2374086544,15.5827326268495
7.5,"random_policy_SVM","SVM",19,32,26840,23813,3027,3300,2787,513,0.552977964374351,0.173813607775872,1.63554971407211,1301,513,788,50,1.5,10.95,5.4,0,0,0,0,0,0,0.154971020225862,3752.96126119385,15.5136357832014
7.5,"random_policy_SVM","SVM",19,33,26740,23732,3008,3400,2868,532,0.556042876582314,0.172670097198399,1.6900387355408,1359,532,827,58,1.6,11.28,5.4,0,0,0,0,0,0,0.15629053732196,4015.37123568379,15.6354470521351
7.5,"random_policy_SVM","SVM",19,34,26640,23654,2986,3500,2946,554,0.555792063047757,0.169239565465981,1.65826568232311,1402,554,848,43,1.5,11.61,5.3,0,0,0,0,0,0,0.157584899475871,3733.96008559722,15.7706209999173
7.5,"random_policy_SVM","SVM",19,35,26540,23574,2966,3600,3026,574,0.553093457054278,0.17095483133219,1.63165139491327,1466,574,892,64,1.6,11.94,5.3,0,0,0,0,0,0,0.159156321980512,4019.97274912082,15.923886822363
7.5,"random_policy_SVM","SVM",19,36,26440,23488,2952,3700,3112,588,0.556071202546175,0.171526586620926,1.73091048908796,1496,588,908,30,1.5,12.28,5.3,0,0,0,0,0,0,0.15865746628945,3714.29061315488,15.8892140743027
7.5,"random_policy_SVM","SVM",19,37,26340,23398,2942,3800,3202,598,0.554977648668609,0.172098341909663,1.70988569372726,1527,598,929,31,1.6,12.61,5.4,0,0,0,0,0,0,0.156991540868147,3833.2340902555,15.7124960722061
7.5,"random_policy_SVM","SVM",19,38,26240,23322,2918,3900,3278,622,0.551474928646469,0.172670097198399,1.66948222615977,1592,622,970,65,1.6,12.94,5.3,0,0,0,0,0,0,0.159053639905969,3991.57245802821,15.9136293243799
7.5,"random_policy_SVM","SVM",19,39,26140,23237,2903,4000,3363,637,0.552377196431717,0.169811320754717,1.6062907027012,1600,637,963,8,1.5,13.27,5.3,0,0,0,0,0,0,0.158730807995492,3824.04308938561,15.8929605262523
7.5,"random_policy_SVM","SVM",19,40,26040,23153,2887,4100,3447,653,0.553304828830064,0.170383076043453,1.5803965335151,1681,653,1028,81,1.6,13.6,5.3,0,0,0,0,0,0,0.158693735004043,3697.14153471811,15.9363268701562
7.5,"random_policy_SVM","SVM",19,41,25940,23065,2875,4200,3535,665,0.551109480794524,0.169239565465981,1.59739321387678,1669,665,1004,-12,1.5,13.93,5.3,0,0,0,0,0,0,0.157891511238663,3954.88946668845,15.7935339043189
7.5,"random_policy_SVM","SVM",19,42,25840,22977,2863,4300,3623,677,0.55056652356905,0.168667810177244,1.64845501777413,1714,677,1037,45,1.5,14.27,5.4,0,0,0,0,0,0,0.15703112446004,3881.91043358118,15.7090230569249
7.5,"random_policy_SVM","SVM",19,43,25740,22888,2852,4400,3712,688,0.549749104921001,0.170383076043453,1.64525400739643,1757,688,1069,43,1.6,14.6,5.4,0,0,0,0,0,0,0.155254223033147,3440.10161073722,15.5490961123634
7.5,"random_policy_SVM","SVM",19,44,25640,22799,2841,4500,3801,699,0.550743689597565,0.171526586620926,1.63917052576541,1745,699,1046,-12,1.5,14.93,5.4,0,0,0,0,0,0,0.154685392495901,3635.04528018365,15.4902919806111
7.5,"random_policy_SVM","SVM",19,45,25540,22716,2824,4600,3884,716,0.548900270203945,0.169239565465981,1.65020814072513,1828,716,1112,83,1.6,15.26,5.4,0,0,0,0,0,0,0.155130161875506,3576.59912288577,15.5313341301065
7.5,"random_policy_SVM","SVM",19,46,25440,22633,2807,4700,3967,733,0.549783611095162,0.169239565465981,1.616613133209,1870,733,1137,42,1.6,15.59,5.4,0,0,0,0,0,0,0.155270809070267,3585.16765849967,15.5442514065654
7.5,"random_policy_SVM","SVM",19,47,25340,22546,2794,4800,4054,746,0.547670408354818,0.166380789022298,1.5606040787853,1880,746,1134,10,1.5,15.93,5.4,0,0,0,0,0,0,0.154777143749509,3539.08766073488,15.4968182537181
7.5,"random_policy_SVM","SVM",19,48,25240,22455,2785,4900,4145,755,0.548983488452326,0.168667810177244,1.61707695448659,1884,755,1129,4,1.5,16.26,5.5,0,0,0,0,0,0,0.153441136445988,3598.28336201497,15.3601932759786
7.5,"random_policy_SVM","SVM",20,0,30040,26527,3513,100,86,14,0.423616502500718,0.0828603859250851,0.728274235470233,45,14,31,0,2.2,0.33,6.1,0,0,0,0,0,0,0.147353808001996,4234.76323888358,14.7857990884244
7.5,"random_policy_SVM","SVM",20,1,29940,26440,3500,200,173,27,0.45834870261383,0.125425652667423,1.14711874138606,88,27,61,43,2.3,0.66,6.4,0,0,0,0,0,0,0.258150467026354,3579.01455628556,29.1261141919007
7.5,"random_policy_SVM","SVM",20,2,29840,26367,3473,300,246,54,0.455685257831639,0.104426787741203,0.971623663140966,148,54,94,60,1.7,1,4.6,0,0,0,0,0,0,0.181931591532195,5384.60469775185,18.2184427232547
7.5,"random_policy_SVM","SVM",20,3,29740,26277,3463,400,336,64,0.44349803317274,0.0839954597048808,0.781799271703792,187,64,123,39,1.9,1.33,5.2,0,0,0,0,0,0,0.163750906064673,4776.2171945547,16.4612048827556
7.5,"random_policy_SVM","SVM",20,4,29640,26191,3449,500,422,78,0.560474085410185,0.168558456299659,1.48168241171897,228,78,150,41,1.9,1.66,5.4,0,0,0,0,0,0,0.157120124456425,4597.8622899249,15.9183258156627
7.5,"random_policy_SVM","SVM",20,5,29540,26121,3419,600,492,108,0.576089771892731,0.158910329171396,1.42306147885602,262,108,154,34,1.4,1.99,4.6,0,0,0,0,0,0,0.296234496275796,4650.21049195313,31.3963165393172
7.5,"random_policy_SVM","SVM",20,6,29440,26042,3398,700,571,129,0.530896198274676,0.132803632236095,1.1465614567896,334,129,205,72,1.6,2.32,4.4,0,0,0,0,0,0,0.186973826552193,5362.81213342306,18.8032427692507
7.5,"random_policy_SVM","SVM",20,7,29340,25953,3387,800,660,140,0.53378364721064,0.130533484676504,1.19792659181188,386,140,246,52,1.8,2.65,4.7,0,0,0,0,0,0,0.1761544005603,5091.79697972076,17.6349430477845
7.5,"random_policy_SVM","SVM",20,8,29240,25867,3373,900,746,154,0.496622112881552,0.135641316685585,1.27422764861518,420,154,266,34,1.7,2.99,4.8,0,0,0,0,0,0,0.172766454946474,4927.37702262238,17.3427431659443
7.5,"random_policy_SVM","SVM",20,9,29140,25777,3363,1000,836,164,0.488990748069825,0.12883087400681,1.06147669832352,446,164,282,26,1.7,3.32,5.1,0,0,0,0,0,0,0.164144074114963,4754.01043549599,16.4220377078667
7.5,"random_policy_SVM","SVM",20,10,29040,25680,3360,1100,933,167,0.490486625037347,0.114074914869467,1.01970524436402,468,167,301,22,1.8,3.65,5.6,0,0,0,0,0,0,0.151835500710635,4371.27832368224,15.1998111261683
7.5,"random_policy_SVM","SVM",20,11,28940,25592,3348,1200,1021,179,0.507497891938827,0.136208853575482,1.16844849602724,500,179,321,32,1.8,3.98,5.7,0,0,0,0,0,0,0.149670919953836,4255.06110963701,15.0930084906784
7.5,"random_policy_SVM","SVM",20,12,28840,25516,3324,1300,1097,203,0.549809901367384,0.14472190692395,1.23928515575735,520,203,317,20,1.6,4.31,5.4,0,0,0,0,0,0,0.158017010067478,4433.2225547841,15.9073440796664
7.5,"random_policy_SVM","SVM",20,13,28740,25433,3307,1400,1180,220,0.566984107517216,0.164585698070375,1.49416782500845,560,220,340,40,1.5,4.64,5.4,0,0,0,0,0,0,0.16189624127672,4408.80660470583,16.6857388496206
7.5,"random_policy_SVM","SVM",20,14,28640,25355,3285,1500,1258,242,0.571491268955174,0.16572077185017,1.42680966536749,622,242,380,62,1.6,4.98,5.2,0,0,0,0,0,0,0.161522913571976,4570.10454042596,16.1745553782329
7.5,"random_policy_SVM","SVM",20,15,28540,25277,3263,1600,1336,264,0.579180116652731,0.177639046538025,1.55857670141165,667,264,403,45,1.5,5.31,5.1,0,0,0,0,0,0,0.168972948953289,4608.69944689141,17.1074810677414
7.5,"random_policy_SVM","SVM",20,16,28440,25193,3247,1700,1420,280,0.567134168552275,0.166855845629966,1.37451189349142,707,280,427,40,1.5,5.64,5.1,0,0,0,0,0,0,0.165127481708841,4639.85981934208,16.5254516639669
7.5,"random_policy_SVM","SVM",20,17,28340,25107,3233,1800,1506,294,0.56762699474782,0.171396140749149,1.55928299498759,762,294,468,55,1.6,5.97,5.1,0,0,0,0,0,0,0.163581594237263,4555.57727765902,16.3738450069978
7.5,"random_policy_SVM","SVM",20,18,28240,25020,3220,1900,1593,307,0.564588546628815,0.174233825198638,1.56546696092275,803,307,496,41,1.6,6.3,5.2,0,0,0,0,0,0,0.168684346360025,4207.06499619511,16.9813731921218
7.5,"random_policy_SVM","SVM",20,19,28140,24947,3193,2000,1666,334,0.560685765710851,0.170261066969353,1.61030641028444,859,334,525,56,1.6,6.64,5,0,0,0,0,0,0,0.166975141383658,4646.18286433554,16.716091155799
7.5,"random_policy_SVM","SVM",20,20,28040,24875,3165,2100,1738,362,0.567311862309893,0.178774120317821,1.57581619244578,900,362,538,41,1.5,6.97,4.8,0,0,0,0,0,0,0.172537305824971,4805.94569127304,17.2571166632714
7.5,"random_policy_SVM","SVM",20,21,27940,24786,3154,2200,1827,373,0.563992055080546,0.178774120317821,1.54903161225165,948,373,575,48,1.5,7.3,4.9,0,0,0,0,0,0,0.169366240845705,4697.1656640472,16.9394039015892
7.5,"random_policy_SVM","SVM",20,22,27840,24698,3142,2300,1915,385,0.566771233210029,0.185017026106697,1.73317850528705,1002,385,617,54,1.6,7.63,5,0,0,0,0,0,0,0.167139420781659,4612.10070209664,16.7606195525563
7.5,"random_policy_SVM","SVM",20,23,27740,24602,3138,2400,2011,389,0.566765988109914,0.178774120317821,1.59009385610065,1013,389,624,11,1.6,7.96,5.2,0,0,0,0,0,0,0.161591045371373,4413.72100781587,16.1658277948597
7.5,"random_policy_SVM","SVM",20,24,27640,24518,3122,2500,2095,405,0.557768594540883,0.175936435868331,1.5530880742855,1054,405,649,41,1.6,8.29,5.2,0,0,0,0,0,0,0.161528233323988,4403.73268906499,16.1581359728379
7.5,"random_policy_SVM","SVM",20,25,27540,24433,3107,2600,2180,420,0.557232997325685,0.158342792281498,1.49380287954533,1092,420,672,38,1.6,8.63,5.2,0,0,0,0,0,0,0.161643056514968,4300.56435942477,16.1762203172848
7.5,"random_policy_SVM","SVM",20,26,27440,24345,3095,2700,2268,432,0.558448069543034,0.162315550510783,1.52009110698296,1128,432,696,36,1.6,8.96,5.2,0,0,0,0,0,0,0.159998471472274,4280.91042865226,16.0053563569363
7.5,"random_policy_SVM","SVM",20,27,27340,24258,3082,2800,2355,445,0.562925124959183,0.179341657207718,1.71516357188436,1150,445,705,22,1.6,9.29,5.3,0,0,0,0,0,0,0.158632839472208,4268.59274906842,15.8671026496451
7.5,"random_policy_SVM","SVM",20,28,27240,24180,3060,2900,2433,467,0.56943808943945,0.190692395005675,1.62244459569942,1210,467,743,60,1.6,9.62,5.2,0,0,0,0,0,0,0.160896106101013,4341.49232510893,16.0945189954675
7.5,"random_policy_SVM","SVM",20,29,27140,24095,3045,3000,2518,482,0.56254056957011,0.185584562996595,1.62565820919598,1240,482,758,30,1.6,9.95,5.2,0,0,0,0,0,0,0.160523961397987,4319.92406112842,16.0536937612797
7.5,"random_policy_SVM","SVM",20,30,27040,24011,3029,3100,2602,498,0.564105912131861,0.175936435868331,1.61454777923164,1281,498,783,41,1.6,10.29,5.2,0,0,0,0,0,0,0.160766677334354,4312.91712370153,16.0833287872433
7.5,"random_policy_SVM","SVM",20,31,26940,23931,3009,3200,2682,518,0.553872721803557,0.176503972758229,1.63345196430824,1318,518,800,37,1.5,10.62,5.2,0,0,0,0,0,0,0.161702909605261,4304.78350515147,16.2205204360335
7.5,"random_policy_SVM","SVM",20,32,26840,23841,2999,3300,2772,528,0.550333984948183,0.162315550510783,1.51541437927707,1360,528,832,42,1.6,10.95,5.2,0,0,0,0,0,0,0.159738727747021,4243.62538011911,15.977941284865
7.5,"random_policy_SVM","SVM",20,33,26740,23754,2986,3400,2859,541,0.554995087942422,0.183881952326901,1.61921408327124,1406,541,865,46,1.6,11.28,5.3,0,0,0,0,0,0,0.158978811633911,4217.07822517226,15.900874725156
7.5,"random_policy_SVM","SVM",20,34,26640,23665,2975,3500,2948,552,0.44396633959132,0.120885357548241,1.03349747039238,1409,552,857,3,1.6,11.61,5.3,0,0,0,0,0,0,0.158775218880897,4206.96157880454,15.8959809456621
7.5,"random_policy_SVM","SVM",20,35,26540,23575,2965,3600,3038,562,0.56017758800276,0.17366628830874,1.55515426684553,1417,562,855,8,1.5,11.94,5.4,0,0,0,0,0,0,0.156167919189859,4101.84612831228,15.6702864137425
7.5,"random_policy_SVM","SVM",20,36,26440,23502,2938,3700,3111,589,0.556944090388344,0.154937570942111,1.3697533133248,1502,589,913,85,1.6,12.28,5.3,0,0,0,0,0,0,0.158987004330966,4160.56174636327,15.9116987811207
7.5,"random_policy_SVM","SVM",20,37,26340,23419,2921,3800,3194,606,0.565445416886949,0.171963677639047,1.60699274240704,1555,606,949,53,1.6,12.61,5.3,0,0,0,0,0,0,0.160585452846678,4074.59022143393,16.0617508786779
7.5,"random_policy_SVM","SVM",20,38,26240,23334,2906,3900,3279,621,0.556262867019487,0.162315550510783,1.40194377673782,1559,621,938,4,1.5,12.94,5.3,0,0,0,0,0,0,0.158999698101922,4080.09211493833,15.9070006498056
7.5,"random_policy_SVM","SVM",20,39,26140,23252,2888,4000,3361,639,0.558283211355615,0.175368898978434,1.59028372899842,1611,639,972,52,1.5,13.27,5.3,0,0,0,0,0,0,0.159401763514025,4117.27254815016,15.9428023218686
7.5,"random_policy_SVM","SVM",20,40,26040,23171,2869,4100,3442,658,0.558233105724418,0.18161180476731,1.6423023556479,1648,658,990,37,1.5,13.6,5.2,0,0,0,0,0,0,0.160372290923156,4143.54146527026,16.0385704808511
7.5,"random_policy_SVM","SVM",20,41,25940,23089,2851,4200,3524,676,0.553777926213635,0.179341657207718,1.56399810125891,1715,676,1039,67,1.5,13.93,5.2,0,0,0,0,0,0,0.160827825324535,4152.22042952781,16.0835353528138
7.5,"random_policy_SVM","SVM",20,42,25840,23006,2834,4300,3607,693,0.55640759766824,0.177639046538025,1.80305777802386,1740,693,1047,25,1.5,14.27,5.2,0,0,0,0,0,0,0.161897706947081,4014.95620023213,16.1969074224243
7.5,"random_policy_SVM","SVM",20,43,25740,22934,2806,4400,3679,721,0.562971222139884,0.201475595913734,1.91393226769627,1842,721,1121,102,1.6,14.6,5.1,0,0,0,0,0,0,0.163854194120202,4194.93693840418,16.3861868819035
7.5,"random_policy_SVM","SVM",20,44,25640,22852,2788,4500,3761,739,0.552833552334028,0.174233825198638,1.55043350367644,1862,739,1123,20,1.5,14.93,5.1,0,0,0,0,0,0,0.164070624081052,4166.90360834098,16.4100559023837
7.5,"random_policy_SVM","SVM",20,45,25540,22766,2774,4600,3847,753,0.550350317251803,0.162315550510783,1.45331230600785,1859,753,1106,-3,1.5,15.26,5.1,0,0,0,0,0,0,0.163550254887838,4138.59663563456,16.3604754996374
7.5,"random_policy_SVM","SVM",20,46,25440,22681,2759,4700,3932,768,0.556874710080284,0.185017026106697,1.73298277648917,1903,768,1135,44,1.5,15.59,5.1,0,0,0,0,0,0,0.163337950153964,4120.93744561356,16.3350834971695
7.5,"random_policy_SVM","SVM",20,47,25340,22599,2741,4800,4014,786,0.553287573317329,0.168558456299659,1.56335367422784,1988,786,1202,85,1.5,15.93,5.1,0,0,0,0,0,0,0.163711009734658,4126.24737724512,16.3736793360122
7.5,"random_policy_SVM","SVM",20,48,25240,22527,2713,4900,4086,814,0.55209825752657,0.184449489216799,1.72254934417959,2013,814,1199,25,1.5,16.26,5,0,0,0,0,0,0,0.165984420986481,4147.63879376512,16.6011242486603
7.5,"max_tuv_SVM","SVM",1,0,30040,26573,3467,100,90,10,0.558458064304523,0.16832229580574,1.55436155885987,31,10,21,0,2.1,0.33,9,0,0,0,0,0,0,0.157773724712891,3009.97385058155,18.1507934823021
7.5,"max_tuv_SVM","SVM",1,1,29940,26493,3447,200,170,30,0.529345659169076,0.178256070640177,1.90545078877941,79,30,49,48,1.6,0.66,5.7,0,0,0,0,0,0,0.538030144592128,3779.6798223891,65.1893163178494
7.5,"max_tuv_SVM","SVM",1,2,29840,26434,3406,300,229,71,0.524597561871016,0.13355408388521,1.31560966804562,168,71,97,89,1.4,1,3.2,0,0,0,0,0,0,0.288338285859599,6405.10008907398,31.2146887330852
7.5,"max_tuv_SVM","SVM",1,3,29740,26357,3383,400,306,94,0.509570574495862,0.110927152317881,0.865002207505519,228,94,134,60,1.4,1.33,3.3,0,0,0,0,0,0,0.238700665602424,6943.1131115139,24.1264584323774
7.5,"max_tuv_SVM","SVM",1,4,29640,26269,3371,500,394,106,0.52824342564099,0.146247240618102,1.21680815575812,255,106,149,27,1.4,1.66,3.7,0,0,0,0,0,0,0.230324219114284,5830.65681985881,24.1233390992013
7.5,"max_tuv_SVM","SVM",1,5,29540,26186,3354,600,477,123,0.529361122030156,0.135761589403974,1.08455037877683,283,123,160,28,1.3,1.99,3.9,0,0,0,0,0,0,0.253221533459406,5110.48115104591,26.7654156167637
7.5,"max_tuv_SVM","SVM",1,6,29440,26104,3336,700,559,141,0.562598198532975,0.182671081677704,1.57374746995665,320,141,179,37,1.3,2.32,4,0,0,0,0,0,0,0.272328606155346,4479.87746567954,29.7043077388603
7.5,"max_tuv_SVM","SVM",1,7,29340,26026,3314,800,637,163,0.557663277407308,0.173841059602649,1.62361345344357,368,163,205,48,1.3,2.65,3.9,0,0,0,0,0,0,0.229223928951945,4790.8550044877,24.0934509020383
7.5,"max_tuv_SVM","SVM",1,8,29240,25954,3286,900,709,191,0.571147350119302,0.213576158940397,1.98732637871418,428,191,237,60,1.2,2.99,3.7,0,0,0,0,0,0,0.24626950430271,4954.81020965106,26.2002849405029
7.5,"max_tuv_SVM","SVM",1,9,29140,25888,3252,1000,775,225,0.577567579986901,0.190949227373068,1.52842975662301,499,225,274,71,1.2,3.32,3.4,0,0,0,0,0,0,0.37327255874516,4857.03234138748,40.1372214637666
7.5,"max_tuv_SVM","SVM",1,10,29040,25805,3235,1100,858,242,0.570196477814149,0.209713024282561,1.95615339723584,540,242,298,41,1.2,3.65,3.5,0,0,0,0,0,0,0.237369111666066,4587.68906493847,24.9499105318828
7.5,"max_tuv_SVM","SVM",1,11,28940,25727,3213,1200,936,264,0.563459332134269,0.212472406181015,2.00737663334842,600,264,336,60,1.3,3.98,3.5,0,0,0,0,0,0,0.222393843463,5416.69400511888,22.5620679451751
7.5,"max_tuv_SVM","SVM",1,12,28840,25651,3189,1300,1012,288,0.563484264176758,0.222958057395143,2.11420187862032,647,288,359,47,1.2,4.31,3.5,0,0,0,0,0,0,0.220203743402552,4977.71401773252,22.3015997724991
7.5,"max_tuv_SVM","SVM",1,13,28740,25579,3161,1400,1084,316,0.561687908433897,0.220198675496689,2.09037293168454,713,316,397,66,1.3,4.64,3.4,0,0,0,0,0,0,0.223642883010909,5754.49064314526,22.5443966793963
7.5,"max_tuv_SVM","SVM",1,14,28640,25493,3147,1500,1170,330,0.552497016895687,0.217439293598234,2.00355212165808,747,330,417,34,1.3,4.98,3.5,0,0,0,0,0,0,0.217379316846017,5409.62458870716,21.9175236352928
7.5,"max_tuv_SVM","SVM",1,15,28540,25404,3136,1600,1259,341,0.551231268294255,0.219094922737307,2.06463730216304,778,341,437,31,1.3,5.31,3.7,0,0,0,0,0,0,0.210905048237485,5059.30390108331,21.1984857657815
7.5,"max_tuv_SVM","SVM",1,16,28440,25311,3129,1700,1352,348,0.555303765512601,0.223509933774834,2.08117071961557,803,348,455,25,1.3,5.64,3.9,0,0,0,0,0,0,0.202715271821432,4770.79079691413,20.3392115833955
7.5,"max_tuv_SVM","SVM",1,17,28340,25231,3109,1800,1432,368,0.557330045467052,0.223509933774834,2.15090677234637,833,368,465,30,1.3,5.97,3.9,0,0,0,0,0,0,0.202775306041463,4935.08613617381,20.3264712726831
7.5,"max_tuv_SVM","SVM",1,18,28240,25155,3085,1900,1508,392,0.559223299031168,0.227373068432671,2.09923880445036,888,392,496,55,1.3,6.3,3.8,0,0,0,0,0,0,0.202802697895256,4058.03754795104,20.3720501272977
7.5,"max_tuv_SVM","SVM",1,19,28140,25090,3050,2000,1573,427,0.556516819680308,0.222958057395143,2.07203632702064,965,427,538,77,1.3,6.64,3.7,0,0,0,0,0,0,0.213344036092342,5087.85864368521,21.3753660880098
7.5,"max_tuv_SVM","SVM",1,20,28040,25011,3029,2100,1652,448,0.558704138152983,0.222406181015453,2.01366910654119,1005,448,557,40,1.2,6.97,3.7,0,0,0,0,0,0,0.212432926755155,5163.40132054924,21.2700856599364
7.5,"max_tuv_SVM","SVM",1,21,27940,24924,3016,2200,1739,461,0.558043334969942,0.228476821192053,2.05744452190078,1044,461,583,39,1.3,7.3,3.8,0,0,0,0,0,0,0.208598963697384,5020.62028919889,20.9115466964971
7.5,"max_tuv_SVM","SVM",1,22,27840,24840,3000,2300,1823,477,0.558300896704425,0.226269315673289,2.02273934185713,1076,477,599,32,1.3,7.63,3.8,0,0,0,0,0,0,0.206310120340841,4874.76400242672,20.6455520063615
7.5,"max_tuv_SVM","SVM",1,23,27740,24761,2979,2400,1902,498,0.560305158210663,0.229580573951435,2.06474042446071,1130,498,632,54,1.3,7.96,3.8,0,0,0,0,0,0,0.207369154030134,4697.27556049798,20.7627941942529
7.5,"max_tuv_SVM","SVM",1,24,27640,24677,2963,2500,1986,514,0.562936341960733,0.229028697571744,2.08662813214051,1164,514,650,34,1.3,8.29,3.9,0,0,0,0,0,0,0.205437434729179,5044.32449939918,20.5548985632952
7.5,"max_tuv_SVM","SVM",1,25,27540,24595,2945,2600,2068,532,0.562585253849816,0.225165562913907,2.0957624227906,1207,532,675,43,1.3,8.63,3.9,0,0,0,0,0,0,0.20271382368916,4667.30137839589,20.3504010406472
7.5,"max_tuv_SVM","SVM",1,26,27440,24515,2925,2700,2148,552,0.562444693737121,0.227924944812362,2.11766934707065,1252,552,700,45,1.3,8.96,3.9,0,0,0,0,0,0,0.202332253471022,4841.29562983891,20.3077448803528
7.5,"max_tuv_SVM","SVM",1,27,27340,24427,2913,2800,2236,564,0.562794533164776,0.225717439293598,2.0884281710923,1279,564,715,27,1.3,9.29,4,0,0,0,0,0,0,0.197079968703773,4186.1547434231,19.7966715360924
7.5,"max_tuv_SVM","SVM",1,28,27240,24340,2900,2900,2323,577,0.562870536352751,0.227373068432671,2.07569066700688,1318,577,741,39,1.3,9.62,4,0,0,0,0,0,0,0.196586760201018,4312.06673977151,19.8867239317757
7.5,"max_tuv_SVM","SVM",1,29,27140,24260,2880,3000,2403,597,0.562572725394406,0.223509933774834,2.10666788553474,1342,597,745,24,1.2,9.95,4,0,0,0,0,0,0,0.196345046182604,4576.23122588553,19.7727577433607
7.5,"max_tuv_SVM","SVM",1,30,27040,24182,2858,3100,2481,619,0.56247104095398,0.227924944812362,2.16688306029976,1393,619,774,51,1.3,10.29,4,0,0,0,0,0,0,0.19709138773046,4791.88189400765,19.7742091913826
7.5,"max_tuv_SVM","SVM",1,31,26940,24095,2845,3200,2568,632,0.56056621625829,0.224061810154525,2.12853641029808,1430,632,798,37,1.3,10.62,4.1,0,0,0,0,0,0,0.195241739686326,4697.84551393272,19.7215431452695
7.5,"max_tuv_SVM","SVM",1,32,26840,24017,2823,3300,2646,654,0.563844259561625,0.227373068432671,2.12853641029808,1476,654,822,46,1.3,10.95,4,0,0,0,0,0,0,0.196243965953801,4160.7495795453,19.9461530696225
7.5,"max_tuv_SVM","SVM",1,33,26740,23939,2801,3400,2724,676,0.564502190773166,0.228476821192053,2.03734395804383,1521,676,845,45,1.2,11.28,4,0,0,0,0,0,0,0.204669407412707,4621.45957157979,20.9760674561685
7.5,"max_tuv_SVM","SVM",1,34,26640,23865,2775,3500,2798,702,0.564237761280731,0.228476821192053,2.1485219184808,1592,702,890,71,1.3,11.61,4,0,0,0,0,0,0,0.199044130098956,4859.62883816882,19.9820333921934
7.5,"max_tuv_SVM","SVM",1,35,26540,23791,2749,3600,2872,728,0.565908166505091,0.224061810154525,2.13562856068712,1660,728,932,68,1.3,11.94,3.9,0,0,0,0,0,0,0.201044035131377,4746.68026551153,20.1320593441871
7.5,"max_tuv_SVM","SVM",1,36,26440,23702,2738,3700,2961,739,0.565572395575533,0.222958057395143,2.01260604354893,1678,739,939,18,1.3,12.28,4,0,0,0,0,0,0,0.199306292062271,4747.41630874589,19.9429569413598
7.5,"max_tuv_SVM","SVM",1,37,26340,23611,2729,3800,3052,748,0.566056676567896,0.221854304635762,2.21213297565177,1713,748,965,35,1.3,12.61,4.1,0,0,0,0,0,0,0.195291403647034,4723.93176817808,19.5454222010514
7.5,"max_tuv_SVM","SVM",1,38,26240,23520,2720,3900,3143,757,0.566024918390232,0.225165562913907,1.91384904175928,1739,757,982,26,1.3,12.94,4.2,0,0,0,0,0,0,0.193232792928563,4341.82744886806,19.3415520250585
7.5,"max_tuv_SVM","SVM",1,39,26140,23432,2708,4000,3231,769,0.563576000773852,0.222958057395143,2.03778171587045,1752,769,983,13,1.3,13.27,4.2,0,0,0,0,0,0,0.190913499387479,4507.60475538862,19.1166310362629
7.5,"max_tuv_SVM","SVM",1,40,26040,23343,2697,4100,3320,780,0.566019715543295,0.224613686534216,1.74685473392594,1798,780,1018,46,1.3,13.6,4.3,0,0,0,0,0,0,0.188917914309526,4412.15986792595,18.9419658896775
7.5,"max_tuv_SVM","SVM",1,41,25940,23256,2684,4200,3407,793,0.566004606475808,0.227924944812362,1.94046962621743,1820,793,1027,22,1.3,13.93,4.3,0,0,0,0,0,0,0.185972755793772,3880.54060768968,18.6567421242073
7.5,"max_tuv_SVM","SVM",1,42,25840,23166,2674,4300,3497,803,0.562346047759309,0.221302428256071,2.02137174931352,1868,803,1065,48,1.3,14.27,4.4,0,0,0,0,0,0,0.185468428106877,4149.51425283829,18.5758038083113
7.5,"max_tuv_SVM","SVM",1,43,25740,23084,2656,4400,3579,821,0.563497791578785,0.226269315673289,1.800882522315,1908,821,1087,40,1.3,14.6,4.4,0,0,0,0,0,0,0.185461183033576,4406.8254006944,18.5617150244035
7.5,"max_tuv_SVM","SVM",1,44,25640,22996,2644,4500,3667,833,0.56230479958884,0.218543046357616,1.73848765768922,1937,833,1104,29,1.3,14.93,4.4,0,0,0,0,0,0,0.184300963018288,4513.08835717516,18.4443947659879
7.5,"max_tuv_SVM","SVM",1,45,25540,22915,2625,4600,3748,852,0.564906223054456,0.224061810154525,1.97409551988103,1993,852,1141,56,1.3,15.26,4.4,0,0,0,0,0,0,0.183498166139435,4111.76846180555,18.3897794691741
7.5,"max_tuv_SVM","SVM",1,46,25440,22838,2602,4700,3825,875,0.56732737827961,0.221302428256071,1.87176316287989,2068,875,1193,75,1.4,15.59,4.4,0,0,0,0,0,0,0.184500153903161,4275.99110288821,18.4760256610088
7.5,"max_tuv_SVM","SVM",1,47,25340,22751,2589,4800,3912,888,0.565573685881581,0.218543046357616,1.78124614072462,2050,888,1162,-18,1.3,15.93,4.4,0,0,0,0,0,0,0.184511213049196,4494.93926314423,18.4669061131653
7.5,"max_tuv_SVM","SVM",1,48,25240,22662,2578,4900,4001,899,0.562699425122881,0.202538631346578,1.605098563185,2113,899,1214,63,1.4,16.26,4.5,0,0,0,0,0,0,0.180845223768697,3923.73925255897,18.1165649695799
7.5,"max_tuv_SVM","SVM",2,0,30040,26556,3484,100,85,15,0.392620701056113,0.0692737430167598,0.592177763448877,49,15,34,0,2.3,0.33,5.7,0,0,0,0,0,0,0.164657626460328,4581.90324311115,16.6118371305642
7.5,"max_tuv_SVM","SVM",2,1,29940,26493,3447,200,148,52,0.586397419929087,0.153072625698324,1.46590432960894,124,52,72,75,1.4,0.66,2.8,0,0,0,0,0,0,0.260769945695009,7785.91143211046,26.079111257971
7.5,"max_tuv_SVM","SVM",2,2,29840,26433,3407,300,208,92,0.574441119943262,0.140223463687151,1.13311275754588,212,92,120,88,1.3,1,2.3,0,0,0,0,0,0,0.460189141477238,8497.48800731926,46.8449590532187
7.5,"max_tuv_SVM","SVM",2,3,29740,26360,3380,400,281,119,0.561081841198768,0.126815642458101,1.08251396648045,278,119,159,66,1.3,1.33,2.4,0,0,0,0,0,0,0.341255026301806,8469.28983157517,35.4859143745835
7.5,"max_tuv_SVM","SVM",2,4,29640,26281,3359,500,360,140,0.436851948366611,0.0893854748603352,0.75040579969926,338,140,198,60,1.4,1.66,2.6,0,0,0,0,0,0,0.30170121809293,8413.12422936352,30.5951993976658
7.5,"max_tuv_SVM","SVM",2,5,29540,26201,3339,600,440,160,0.548975518014343,0.118435754189944,0.898589072325074,386,160,226,48,1.4,1.99,2.8,0,0,0,0,0,0,0.479589587945553,7391.10866555163,53.7862442641545
7.5,"max_tuv_SVM","SVM",2,6,29440,26114,3326,700,527,173,0.546699973373151,0.121787709497207,0.91615640448535,420,173,247,34,1.4,2.32,3,0,0,0,0,0,0,0.282203851269551,7135.92010870308,31.0666068787789
7.5,"max_tuv_SVM","SVM",2,7,29340,26026,3314,800,615,185,0.573581068262767,0.130167597765363,1.0048652853405,477,185,292,57,1.6,2.65,3.3,0,0,0,0,0,0,0.235933436886104,6722.25010193241,23.8232251142472
7.5,"max_tuv_SVM","SVM",2,8,29240,25933,3307,900,708,192,0.533673719628877,0.128491620111732,1.06471478317509,481,192,289,4,1.5,2.99,3.7,0,0,0,0,0,0,0.216035271036018,6201.58443384101,21.6706648080892
7.5,"max_tuv_SVM","SVM",2,9,29140,25851,3289,1000,790,210,0.519793219111267,0.122905027932961,1.06266203829256,508,210,298,27,1.4,3.32,3.8,0,0,0,0,0,0,0.214722996738145,6019.26890427972,22.2773248410505
7.5,"max_tuv_SVM","SVM",2,10,29040,25784,3256,1100,857,243,0.576486087782817,0.158659217877095,1.23882410848325,569,243,326,61,1.3,3.65,3.5,0,0,0,0,0,0,0.352187908235791,5779.12271840305,41.945521263809
7.5,"max_tuv_SVM","SVM",2,11,28940,25700,3240,1200,941,259,0.579765313492329,0.183798882681564,1.52474238506031,601,259,342,32,1.3,3.98,3.6,0,0,0,0,0,0,0.217500076308656,6197.57697815221,21.8199232107015
7.5,"max_tuv_SVM","SVM",2,12,28840,25631,3209,1300,1010,290,0.573782347109055,0.155307262569832,1.25094783196485,667,290,377,66,1.3,4.31,3.5,0,0,0,0,0,0,0.238455629028814,5929.21632614621,24.5747195871901
7.5,"max_tuv_SVM","SVM",2,13,28740,25550,3190,1400,1091,309,0.585090011815942,0.178212290502793,1.40700086902545,717,309,408,50,1.3,4.64,3.5,0,0,0,0,0,0,0.229260101172508,5948.17098948534,23.1826800990572
7.5,"max_tuv_SVM","SVM",2,14,28640,25463,3177,1500,1178,322,0.598186303027087,0.188268156424581,1.55334000537747,743,322,421,26,1.3,4.98,3.7,0,0,0,0,0,0,0.225717842232083,5543.75072129181,22.809226124544
7.5,"max_tuv_SVM","SVM",2,15,28540,25389,3151,1600,1252,348,0.608050985593314,0.208938547486034,1.95907895650793,802,348,454,59,1.3,5.31,3.6,0,0,0,0,0,0,0.227743010303197,5617.70479671901,24.5542702685499
7.5,"max_tuv_SVM","SVM",2,16,28440,25320,3120,1700,1321,379,0.608250077083271,0.220111731843575,1.94641572360966,861,379,482,59,1.3,5.64,3.5,0,0,0,0,0,0,0.244577380149787,5176.69804453555,26.8844451507758
7.5,"max_tuv_SVM","SVM",2,17,28340,25232,3108,1800,1409,391,0.61144773964065,0.205586592178771,1.93954399996055,894,391,503,33,1.3,5.97,3.6,0,0,0,0,0,0,0.229154901223574,5197.55893755498,23.1014436394723
7.5,"max_tuv_SVM","SVM",2,18,28240,25150,3090,1900,1491,409,0.611184878300971,0.205027932960894,1.90504528262605,953,409,544,59,1.3,6.3,3.6,0,0,0,0,0,0,0.22396191718591,5157.26424757294,23.2939142738137
7.5,"max_tuv_SVM","SVM",2,19,28140,25068,3072,2000,1573,427,0.612154255733072,0.208379888268156,1.95613291351639,993,427,566,40,1.3,6.64,3.7,0,0,0,0,0,0,0.217928223184435,4990.41311267323,21.9687707881673
7.5,"max_tuv_SVM","SVM",2,20,28040,24988,3052,2100,1653,447,0.610773444989463,0.206145251396648,2.01741722606681,1040,447,593,47,1.3,6.97,3.7,0,0,0,0,0,0,0.214417570410062,5370.86540427995,21.4752657185315
7.5,"max_tuv_SVM","SVM",2,21,27940,24905,3035,2200,1736,464,0.612385947245177,0.211731843575419,2.06769942949642,1075,464,611,35,1.3,7.3,3.7,0,0,0,0,0,0,0.212550243130415,5204.14843646501,21.2879147124213
7.5,"max_tuv_SVM","SVM",2,22,27840,24840,3000,2300,1801,499,0.61239768325313,0.212849162011173,2.0955992643252,1144,499,645,69,1.3,7.63,3.6,0,0,0,0,0,0,0.217455295628849,5682.30267616173,21.7613237968383
7.5,"max_tuv_SVM","SVM",2,23,27740,24770,2970,2400,1871,529,0.614844998462547,0.217877094972067,2.14383333743509,1216,529,687,72,1.3,7.96,3.5,0,0,0,0,0,0,0.221609128779488,5200.31971536065,22.2179416243642
7.5,"max_tuv_SVM","SVM",2,24,27640,24700,2940,2500,1941,559,0.615474788825468,0.217877094972067,2.12720157135243,1278,559,719,62,1.3,8.29,3.5,0,0,0,0,0,0,0.223581711417822,5797.17649502338,22.402278275383
7.5,"max_tuv_SVM","SVM",2,25,27540,24622,2918,2600,2019,581,0.617012458256199,0.216759776536313,2.10673628243927,1331,581,750,53,1.3,8.63,3.5,0,0,0,0,0,0,0.224220786752799,5277.48017776898,22.4799468462205
7.5,"max_tuv_SVM","SVM",2,26,27440,24546,2894,2700,2095,605,0.617804912213405,0.21731843575419,2.13463933908443,1387,605,782,56,1.3,8.96,3.5,0,0,0,0,0,0,0.224281050848623,5574.77893669339,22.9456196002418
7.5,"max_tuv_SVM","SVM",2,27,27340,24456,2884,2800,2185,615,0.617313976912458,0.220670391061453,2.03794835856841,1422,615,807,35,1.3,9.29,3.6,0,0,0,0,0,0,0.219590878222207,5139.25684025486,22.0004101170695
7.5,"max_tuv_SVM","SVM",2,28,27240,24363,2877,2900,2278,622,0.62007160226795,0.228491620111732,2.09936362703265,1428,622,806,6,1.3,9.62,3.7,0,0,0,0,0,0,0.214629244801464,5504.3468610409,21.4719451302211
7.5,"max_tuv_SVM","SVM",2,29,27140,24283,2857,3000,2358,642,0.622487074617032,0.229050279329609,2.17658315239931,1467,642,825,39,1.3,9.95,3.7,0,0,0,0,0,0,0.214770710819915,5225.85821676041,21.5164311291339
7.5,"max_tuv_SVM","SVM",2,30,27040,24199,2841,3100,2442,658,0.619195608125021,0.225139664804469,2.04358084287032,1499,658,841,32,1.3,10.29,3.7,0,0,0,0,0,0,0.212438107347628,5473.72402631479,21.254325194645
7.5,"max_tuv_SVM","SVM",2,31,26940,24124,2816,3200,2517,683,0.619497547426727,0.226815642458101,2.07002089492628,1550,683,867,51,1.3,10.62,3.7,0,0,0,0,0,0,0.213279226958266,5677.85703870887,21.3630146924143
7.5,"max_tuv_SVM","SVM",2,32,26840,24039,2801,3300,2602,698,0.620714642962461,0.226256983240223,2.05713338598185,1610,698,912,60,1.3,10.95,3.7,0,0,0,0,0,0,0.211673550268662,5206.42844078547,21.1855655019264
7.5,"max_tuv_SVM","SVM",2,33,26740,23958,2782,3400,2683,717,0.623582393295926,0.232960893854749,2.06118816570335,1628,717,911,18,1.3,11.28,3.7,0,0,0,0,0,0,0.212091077031386,5084.69016305601,21.7622430492089
7.5,"max_tuv_SVM","SVM",2,34,26640,23873,2767,3500,2768,732,0.620480932352217,0.229608938547486,2.06462084041778,1692,732,960,64,1.3,11.61,3.8,0,0,0,0,0,0,0.210436482948239,4938.36927435589,21.0668781516251
7.5,"max_tuv_SVM","SVM",2,35,26540,23790,2750,3600,2851,749,0.621620250544854,0.227374301675978,2.07182719588172,1734,749,985,42,1.3,11.94,3.8,0,0,0,0,0,0,0.208747243240661,4679.37963485508,20.9068632682235
7.5,"max_tuv_SVM","SVM",2,36,26440,23726,2714,3700,2915,785,0.621344896035375,0.23072625698324,2.08470189418108,1802,785,1017,68,1.3,12.28,3.7,0,0,0,0,0,0,0.211935653131249,5037.40883583171,21.2146773053604
7.5,"max_tuv_SVM","SVM",2,37,26340,23642,2698,3800,2999,801,0.620243393868425,0.22122905027933,1.9937145920214,1870,801,1069,68,1.3,12.61,3.7,0,0,0,0,0,0,0.210721955810377,4968.05148585749,21.106237746864
7.5,"max_tuv_SVM","SVM",2,38,26240,23562,2678,3900,3079,821,0.622006234806818,0.226256983240223,1.99623699272228,1885,821,1064,15,1.3,12.94,3.8,0,0,0,0,0,0,0.20974973043568,4877.89847911156,21.175168616175
7.5,"max_tuv_SVM","SVM",2,39,26140,23480,2660,4000,3161,839,0.623028024661597,0.227374301675978,2.09022005722851,1931,839,1092,46,1.3,13.27,3.8,0,0,0,0,0,0,0.209839764280102,5203.27993315601,20.9947053377823
7.5,"max_tuv_SVM","SVM",2,40,26040,23407,2633,4100,3234,866,0.620116905782574,0.223463687150838,1.88739543484429,1996,866,1130,65,1.3,13.6,3.7,0,0,0,0,0,0,0.211632816531337,5008.54779350295,21.1837265105608
7.5,"max_tuv_SVM","SVM",2,41,25940,23328,2612,4200,3313,887,0.619829184296971,0.223463687150838,1.86279839710419,2048,887,1161,52,1.3,13.93,3.7,0,0,0,0,0,0,0.211272337180974,5202.27264693079,21.1474749069775
7.5,"max_tuv_SVM","SVM",2,42,25840,23242,2598,4300,3399,901,0.621763564448571,0.226815642458101,2.0993442253079,2066,901,1165,18,1.3,14.27,3.8,0,0,0,0,0,0,0.208279194770163,4842.07175075221,20.8584385502952
7.5,"max_tuv_SVM","SVM",2,43,25740,23149,2591,4400,3492,908,0.620500997140034,0.225139664804469,1.88002279642693,2082,908,1174,16,1.3,14.6,3.8,0,0,0,0,0,0,0.20613907695156,5066.60588950017,20.6241276176415
7.5,"max_tuv_SVM","SVM",2,44,25640,23062,2578,4500,3579,921,0.62060573785629,0.229608938547486,1.89642869383418,2133,921,1212,51,1.3,14.93,3.9,0,0,0,0,0,0,0.204496307207456,4525.83567425817,20.5631306171999
7.5,"max_tuv_SVM","SVM",2,45,25540,22981,2559,4600,3660,940,0.619199225675865,0.220111731843575,1.73736809435133,2158,940,1218,25,1.3,15.26,3.9,0,0,0,0,0,0,0.204013050036581,4780.92918678945,20.4767853616204
7.5,"max_tuv_SVM","SVM",2,46,25440,22893,2547,4700,3748,952,0.619615580539094,0.219553072625698,1.97676463444256,2186,952,1234,28,1.3,15.59,3.9,0,0,0,0,0,0,0.202158041095696,5045.09723913802,20.2201244340538
7.5,"max_tuv_SVM","SVM",2,47,25340,22812,2528,4800,3829,971,0.619646960689424,0.222905027932961,1.91253555435623,2233,971,1262,47,1.3,15.93,3.9,0,0,0,0,0,0,0.201471392276177,4852.41586688221,20.1621984908973
7.5,"max_tuv_SVM","SVM",2,48,25240,22749,2491,4900,3892,1008,0.618998914314098,0.226815642458101,1.8808076671834,2332,1008,1324,99,1.3,16.26,3.9,0,0,0,0,0,0,0.205687986480688,4400.78578134311,20.6024741110279
7.5,"max_tuv_SVM","SVM",3,0,30040,26569,3471,100,84,16,0.47723098300019,0.0965593784683685,0.756192135320811,48,16,32,0,2,0.33,5.2,0,0,0,0,0,0,0.372454327789485,5033.72810755521,41.4308361453978
7.5,"max_tuv_SVM","SVM",3,1,29940,26474,3466,200,179,21,0.519443774591983,0.143729189789123,1.28269761336891,75,21,54,27,2.6,0.66,8.5,0,0,0,0,0,0,0.118657339452101,3130.60536822925,12.0045120455353
7.5,"max_tuv_SVM","SVM",3,2,29840,26390,3450,300,263,37,0.501498949969673,0.129855715871254,1.05838792688556,132,37,95,57,2.6,1,7.1,0,0,0,0,0,0,0.161082973737911,3459.76768769529,17.1041513548672
7.5,"max_tuv_SVM","SVM",3,3,29740,26307,3433,400,346,54,0.505215481011087,0.153163152053274,1.62789261931188,148,54,94,16,1.7,1.33,6.4,0,0,0,0,0,0,0.307851942183667,3858.50650973687,42.9648589681272
7.5,"max_tuv_SVM","SVM",3,4,29640,26235,3405,500,418,82,0.473418302688944,0.111542730299667,0.997617495259378,230,82,148,82,1.8,1.66,5.1,0,0,0,0,0,0,0.191951381617843,4734.81988160442,20.3111798431748
7.5,"max_tuv_SVM","SVM",3,5,29540,26164,3376,600,489,111,0.485388322183946,0.139289678135405,1.26786873922592,273,111,162,43,1.5,1.99,4.4,0,0,0,0,0,0,0.298273484484204,4976.62624897339,31.2187187719313
7.5,"max_tuv_SVM","SVM",3,6,29440,26093,3347,700,560,140,0.433574195827837,0.105438401775805,0.874021857595664,344,140,204,71,1.5,2.32,4,0,0,0,0,0,0,0.233719404378895,5540.15077286342,23.7659669599907
7.5,"max_tuv_SVM","SVM",3,7,29340,26007,3333,800,646,154,0.466065497434668,0.135960044395117,1.22574758063476,368,154,214,24,1.4,2.65,4.2,0,0,0,0,0,0,0.229655919724267,4922.47890559657,25.0436886447842
7.5,"max_tuv_SVM","SVM",3,8,29240,25924,3316,900,729,171,0.468658056476549,0.131520532741398,1.19585129818026,405,171,234,37,1.4,2.99,4.3,0,0,0,0,0,0,0.235510840978433,4868.96845550028,26.4507391408307
7.5,"max_tuv_SVM","SVM",3,9,29140,25837,3303,1000,816,184,0.473440133884614,0.143174250832408,1.32836186156169,447,184,263,42,1.4,3.32,4.4,0,0,0,0,0,0,0.213249611004691,4250.87739440661,23.5868532260658
7.5,"max_tuv_SVM","SVM",3,10,29040,25749,3291,1100,904,196,0.44824183176613,0.115982241953385,1.11363652143036,469,196,273,22,1.4,3.65,4.6,0,0,0,0,0,0,0.203002963809476,3900.87121516669,21.3204337467067
7.5,"max_tuv_SVM","SVM",3,11,28940,25661,3279,1200,992,208,0.455550305473635,0.135405105438402,1.19686871093394,499,208,291,30,1.4,3.98,4.8,0,0,0,0,0,0,0.177995349592489,4410.76846552527,18.3681351929125
7.5,"max_tuv_SVM","SVM",3,12,28840,25584,3256,1300,1069,231,0.46703322164293,0.148723640399556,1.40488987156295,551,231,320,52,1.4,4.31,4.6,0,0,0,0,0,0,0.194789211454667,3638.86304633757,24.0528376615622
7.5,"max_tuv_SVM","SVM",3,13,28740,25516,3224,1400,1137,263,0.47429577455953,0.131520532741398,1.09120147856697,627,263,364,76,1.4,4.64,4.3,0,0,0,0,0,0,0.207639425919957,4067.47391939762,20.8883995558692
7.5,"max_tuv_SVM","SVM",3,14,28640,25431,3209,1500,1222,278,0.475056604275451,0.140954495005549,1.09151792352107,663,278,385,36,1.4,4.98,4.4,0,0,0,0,0,0,0.188447446257786,4128.65071287992,19.1699448898139
7.5,"max_tuv_SVM","SVM",3,15,28540,25338,3202,1600,1315,285,0.478904958935184,0.149833518312986,1.30519949257195,678,285,393,15,1.4,5.31,4.6,0,0,0,0,0,0,0.186176369832778,3913.54800014152,21.4812456072814
7.5,"max_tuv_SVM","SVM",3,16,28440,25259,3181,1700,1394,306,0.493649045880558,0.157602663706992,1.4450000290544,726,306,420,48,1.4,5.64,4.6,0,0,0,0,0,0,0.182989183167402,3817.49901960389,18.7666821959285
7.5,"max_tuv_SVM","SVM",3,17,28340,25170,3170,1800,1483,317,0.483593563695105,0.152053274139845,1.50020918409547,770,317,453,44,1.4,5.97,4.7,0,0,0,0,0,0,0.172026757234089,4498.24412953609,17.2496507223371
7.5,"max_tuv_SVM","SVM",3,18,28240,25086,3154,1900,1567,333,0.480858976414693,0.149278579356271,1.31519616682304,815,333,482,45,1.4,6.3,4.7,0,0,0,0,0,0,0.173406364014163,3818.04130026499,17.3612360791165
7.5,"max_tuv_SVM","SVM",3,19,28140,24997,3143,2000,1656,344,0.481482796557768,0.153163152053274,1.42387793060734,848,344,504,33,1.5,6.64,4.8,0,0,0,0,0,0,0.169334906726127,3740.89239214611,16.9644844580924
7.5,"max_tuv_SVM","SVM",3,20,28040,24910,3130,2100,1743,357,0.481735820952076,0.152053274139845,1.47590912058497,870,357,513,22,1.4,6.97,4.9,0,0,0,0,0,0,0.164533802917782,3716.15925124326,16.4658370417043
7.5,"max_tuv_SVM","SVM",3,21,27940,24829,3111,2200,1824,376,0.481424370924894,0.152608213096559,1.46087074526606,933,376,557,63,1.5,7.3,4.9,0,0,0,0,0,0,0.165389620662641,3508.50196172611,16.554708714644
7.5,"max_tuv_SVM","SVM",3,22,27840,24752,3088,2300,1901,399,0.484771235417329,0.155382907880133,1.52391652721309,979,399,580,46,1.5,7.63,4.8,0,0,0,0,0,0,0.171048057858287,3656.94433238282,17.1457323239009
7.5,"max_tuv_SVM","SVM",3,23,27740,24663,3077,2400,1990,410,0.486081107157796,0.149278579356271,1.35546136476712,1023,410,613,44,1.5,7.96,4.9,0,0,0,0,0,0,0.165888970379091,3697.21068301824,16.6330699009621
7.5,"max_tuv_SVM","SVM",3,24,27640,24592,3048,2500,2061,439,0.484426536730066,0.153163152053274,1.43895768408706,1069,439,630,46,1.4,8.29,4.7,0,0,0,0,0,0,0.170600986771839,3528.22867595991,17.0869308143689
7.5,"max_tuv_SVM","SVM",3,25,27540,24511,3029,2600,2142,458,0.488551796268271,0.158157602663707,1.57678214475469,1131,458,673,62,1.5,8.63,4.7,0,0,0,0,0,0,0.170649256171444,4097.45940056178,17.0755373598777
7.5,"max_tuv_SVM","SVM",3,26,27440,24428,3012,2700,2225,475,0.482129702562925,0.148168701442841,1.30633841010473,1176,475,701,45,1.5,8.96,4.7,0,0,0,0,0,0,0.172894781753979,4247.31501180684,17.308047376412
7.5,"max_tuv_SVM","SVM",3,27,27340,24341,2999,2800,2312,488,0.484430426195964,0.155937846836848,1.42983979236511,1196,488,708,20,1.5,9.29,4.7,0,0,0,0,0,0,0.169634556257538,3862.85907411404,16.9751708297414
7.5,"max_tuv_SVM","SVM",3,28,27240,24248,2992,2900,2405,495,0.486415141180503,0.153718091009989,1.46778798728317,1234,495,739,38,1.5,9.62,4.9,0,0,0,0,0,0,0.165875776488837,3945.36589884011,16.60219459426
7.5,"max_tuv_SVM","SVM",3,29,27140,24163,2977,3000,2490,510,0.48375052246401,0.153718091009989,1.46270473884236,1233,510,723,-1,1.4,9.95,4.9,0,0,0,0,0,0,0.165629329213309,3735.16077854983,16.5760912551542
7.5,"max_tuv_SVM","SVM",3,30,27040,24080,2960,3100,2573,527,0.484169371936576,0.152608213096559,1.38904034367408,1295,527,768,62,1.5,10.29,4.9,0,0,0,0,0,0,0.163631274145028,3370.0103834972,16.4056063076742
7.5,"max_tuv_SVM","SVM",3,31,26940,23985,2955,3200,2668,532,0.485189248445615,0.149833518312986,1.40243591545541,1283,532,751,-12,1.4,10.62,5,0,0,0,0,0,0,0.163253634477213,3355.95696789013,16.3567696198317
7.5,"max_tuv_SVM","SVM",3,32,26840,23904,2936,3300,2749,551,0.482925830227405,0.150943396226415,1.31321387542107,1355,551,804,72,1.5,10.95,5,0,0,0,0,0,0,0.161622801879123,3234.66680998413,16.1909659124337
7.5,"max_tuv_SVM","SVM",3,33,26740,23813,2927,3400,2840,560,0.4860463110758,0.155937846836848,1.48537835378791,1381,560,821,26,1.5,11.28,5.1,0,0,0,0,0,0,0.16210853237323,3551.45795097343,16.2316311811541
7.5,"max_tuv_SVM","SVM",3,34,26640,23724,2916,3500,2929,571,0.484355188033093,0.158157602663707,1.40483255719155,1442,571,871,61,1.5,11.61,5.1,0,0,0,0,0,0,0.16067532988781,3653.84812310142,16.2419576969282
7.5,"max_tuv_SVM","SVM",3,35,26540,23638,2902,3600,3015,585,0.486533790801439,0.154827968923418,1.5146468927788,1453,585,868,11,1.5,11.94,5.2,0,0,0,0,0,0,0.158729392439735,3432.50354484494,15.8947077935343
7.5,"max_tuv_SVM","SVM",3,36,26440,23546,2894,3700,3107,593,0.488165359011504,0.15149833518313,1.4085101293308,1467,593,874,14,1.5,12.28,5.2,0,0,0,0,0,0,0.155969182791038,3091.28333590721,15.6150387986184
7.5,"max_tuv_SVM","SVM",3,37,26340,23463,2877,3800,3190,610,0.488552360868154,0.155382907880133,1.43724828869861,1505,610,895,38,1.5,12.61,5.2,0,0,0,0,0,0,0.157144374747091,3248.19202270761,15.7292783005985
7.5,"max_tuv_SVM","SVM",3,38,26240,23375,2865,3900,3278,622,0.484353933366673,0.152608213096559,1.38185608839083,1567,622,945,62,1.5,12.94,5.3,0,0,0,0,0,0,0.154864227691372,3174.57168669863,15.5177710167775
7.5,"max_tuv_SVM","SVM",3,39,26140,23281,2859,4000,3372,628,0.488045663835218,0.149833518312986,1.37462123976051,1561,628,933,-6,1.5,13.27,5.4,0,0,0,0,0,0,0.152888767542001,2998.30357873163,15.3297107977869
7.5,"max_tuv_SVM","SVM",3,40,26040,23201,2839,4100,3452,648,0.487901920885923,0.150943396226415,1.43040406916496,1637,648,989,76,1.5,13.6,5.3,0,0,0,0,0,0,0.154627102592485,3356.59508102793,15.5004104420871
7.5,"max_tuv_SVM","SVM",3,41,25940,23115,2825,4200,3538,662,0.487851106895992,0.154273029966704,1.47208882087681,1657,662,995,20,1.5,13.93,5.3,0,0,0,0,0,0,0.154931923581617,3494.76973664682,15.504388487411
7.5,"max_tuv_SVM","SVM",3,42,25840,23026,2814,4300,3627,673,0.488928447126978,0.161487236403996,1.47759683827575,1663,673,990,6,1.5,14.27,5.4,0,0,0,0,0,0,0.153331071994844,3132.99293524356,15.3688882389057
7.5,"max_tuv_SVM","SVM",3,43,25740,22942,2798,4400,3711,689,0.488584041195212,0.154827968923418,1.46199738080225,1755,689,1066,92,1.5,14.6,5.4,0,0,0,0,0,0,0.152893209580617,3225.30880615562,15.3224746094605
7.5,"max_tuv_SVM","SVM",3,44,25640,22855,2785,4500,3798,702,0.491353591846479,0.158157602663707,1.49911523883316,1763,702,1061,8,1.5,14.93,5.4,0,0,0,0,0,0,0.151962955095308,3243.54540286337,15.2315283199532
7.5,"max_tuv_SVM","SVM",3,45,25540,22773,2767,4600,3880,720,0.490784600625877,0.157602663706992,1.51262327781345,1801,720,1081,38,1.5,15.26,5.4,0,0,0,0,0,0,0.151528651113112,2982.64234194204,15.183340920656
7.5,"max_tuv_SVM","SVM",3,46,25440,22685,2755,4700,3968,732,0.489654397116473,0.154827968923418,1.49088211166337,1861,732,1129,60,1.5,15.59,5.4,0,0,0,0,0,0,0.152230848268048,3156.85644273657,15.2473213857656
7.5,"max_tuv_SVM","SVM",3,47,25340,22597,2743,4800,4056,744,0.491245941467803,0.158157602663707,1.55498331326039,1871,744,1127,10,1.5,15.93,5.5,0,0,0,0,0,0,0.151783782347239,3180.17690587436,15.1899383931401
7.5,"max_tuv_SVM","SVM",3,48,25240,22516,2724,4900,4137,763,0.490755074142836,0.161487236403996,1.48476963846155,1953,763,1190,82,1.6,16.26,5.4,0,0,0,0,0,0,0.151598487225921,3152.77228867438,15.1914586705953
7.5,"max_tuv_SVM","SVM",4,0,30040,26552,3488,100,91,9,0.521074347553334,0.146205357142857,1.17500066151566,33,9,24,0,2.7,0.33,10.1,0,0,0,0,0,0,0.154085261197261,2557.20554563419,15.9632207811215
7.5,"max_tuv_SVM","SVM",4,1,29940,26459,3481,200,184,16,0.46776279494072,0.117745535714286,1.00834193092963,63,16,47,30,2.9,0.66,11.5,0,0,0,0,0,0,0.104019412601189,2245.03945600425,11.4526472428264
7.5,"max_tuv_SVM","SVM",4,2,29840,26372,3468,300,271,29,0.487317284171838,0.11328125,0.910222635286225,102,29,73,39,2.5,1,9.3,0,0,0,0,0,0,0.118507955921869,2734.69430546698,12.395105211356
7.5,"max_tuv_SVM","SVM",4,3,29740,26292,3448,400,351,49,0.479437587914053,0.11328125,0.739188621076233,162,49,113,60,2.3,1.33,7.2,0,0,0,0,0,0,0.137103248225714,3568.80790672265,14.0469440258845
7.5,"max_tuv_SVM","SVM",4,4,29640,26207,3433,500,436,64,0.468793725895072,0.122767857142857,1.21438130605381,196,64,132,34,2.1,1.66,6.8,0,0,0,0,0,0,0.130015917725411,3788.8223433807,13.0255373285507
7.5,"max_tuv_SVM","SVM",4,5,29540,26123,3417,600,520,80,0.472434804921569,0.118303571428571,0.998327900179856,237,80,157,41,2,1.99,6.5,0,0,0,0,0,0,0.13555934495493,3938.65496831388,13.5757642589408
7.5,"max_tuv_SVM","SVM",4,6,29440,26045,3395,700,598,102,0.501205099115948,0.136160714285714,1.37810354849424,276,102,174,39,1.7,2.32,5.9,0,0,0,0,0,0,0.158391831137093,4286.39897601612,16.4043379424782
7.5,"max_tuv_SVM","SVM",4,7,29340,25978,3362,800,665,135,0.531059148339743,0.12890625,1.1735101744186,345,135,210,69,1.6,2.65,4.9,0,0,0,0,0,0,0.237918202909823,4857.66644892784,24.9622214703333
7.5,"max_tuv_SVM","SVM",4,8,29240,25886,3354,900,757,143,0.508057562524878,0.127790178571429,1.07203068895871,371,143,228,26,1.6,2.99,5.3,0,0,0,0,0,0,0.214015515508439,4610.5286154448,23.1846902286963
7.5,"max_tuv_SVM","SVM",4,9,29140,25803,3337,1000,840,160,0.50436861824659,0.130580357142857,1.05409299462847,392,160,232,21,1.4,3.32,5.2,0,0,0,0,0,0,0.222783099662409,4369.11879173028,26.0203101938317
7.5,"max_tuv_SVM","SVM",4,10,29040,25718,3322,1100,925,175,0.530690346364558,0.125,1.08494008563167,442,175,267,50,1.5,3.65,5.3,0,0,0,0,0,0,0.196332265791726,4475.68552684083,20.0148127918789
7.5,"max_tuv_SVM","SVM",4,11,28940,25638,3302,1200,1005,195,0.522036947603894,0.138392857142857,1.07958020085278,506,195,311,64,1.6,3.98,5.2,0,0,0,0,0,0,0.189208827636094,4424.51162154834,19.8809378841572
7.5,"max_tuv_SVM","SVM",4,12,28840,25552,3288,1300,1091,209,0.530308685067992,0.1328125,1.04370644109712,533,209,324,27,1.6,4.31,5.2,0,0,0,0,0,0,0.17420925302697,4371.45460317065,17.8971533924866
7.5,"max_tuv_SVM","SVM",4,13,28740,25479,3261,1400,1164,236,0.550011224590649,0.165736607142857,1.28696341192171,582,236,346,49,1.5,4.64,4.9,0,0,0,0,0,0,0.186999965079378,4596.32954389015,19.0134422020028
7.5,"max_tuv_SVM","SVM",4,14,28640,25390,3250,1500,1253,247,0.55633767451696,0.200334821428571,1.67458863384956,607,247,360,25,1.5,4.98,5.1,0,0,0,0,0,0,0.185361753343388,4233.06233514708,19.2435015333981
7.5,"max_tuv_SVM","SVM",4,15,28540,25319,3221,1600,1324,276,0.533391140045236,0.163504464285714,1.49381105683837,676,276,400,69,1.4,5.31,4.8,0,0,0,0,0,0,0.185719666464917,4498.58439539506,19.1414540734272
7.5,"max_tuv_SVM","SVM",4,16,28440,25241,3199,1700,1402,298,0.519168772625679,0.167410714285714,1.5202686720837,732,298,434,56,1.5,5.64,4.7,0,0,0,0,0,0,0.180453574145521,4546.47895935932,18.3333590608012
7.5,"max_tuv_SVM","SVM",4,17,28340,25157,3183,1800,1486,314,0.516977056785416,0.150669642857143,1.32319791666667,789,314,475,57,1.5,5.97,4.7,0,0,0,0,0,0,0.180276090176458,4450.58124973494,18.2883378953906
7.5,"max_tuv_SVM","SVM",4,18,28240,25063,3177,1900,1580,320,0.528872727514172,0.1640625,1.62301260964912,816,320,496,27,1.6,6.3,4.9,0,0,0,0,0,0,0.171048393274931,4137.31272447448,17.1683811362452
7.5,"max_tuv_SVM","SVM",4,19,28140,24996,3144,2000,1647,353,0.533028305467543,0.176897321428571,1.74689485648554,891,353,538,75,1.5,6.64,4.7,0,0,0,0,0,0,0.181791034923446,4317.38642734624,18.6298834987126
7.5,"max_tuv_SVM","SVM",4,20,28040,24922,3118,2100,1721,379,0.532164923906434,0.173549107142857,1.70435909845133,961,379,582,70,1.5,6.97,4.5,0,0,0,0,0,0,0.180946143429925,4672.94154455234,18.5343562273942
7.5,"max_tuv_SVM","SVM",4,21,27940,24837,3103,2200,1806,394,0.522180333239648,0.143973214285714,1.29158622021183,1007,394,613,46,1.6,7.3,4.6,0,0,0,0,0,0,0.181496616457499,4623.30961279547,18.2419321805223
7.5,"max_tuv_SVM","SVM",4,22,27840,24758,3082,2300,1885,415,0.536517552049152,0.17578125,1.69685090859031,1042,415,627,35,1.5,7.63,4.5,0,0,0,0,0,0,0.188017520256674,4828.25348652728,20.354167301025
7.5,"max_tuv_SVM","SVM",4,23,27740,24684,3056,2400,1959,441,0.534481618902833,0.183035714285714,1.49942768093557,1097,441,656,55,1.5,7.96,4.4,0,0,0,0,0,0,0.183367934934417,4911.70706525353,18.3616802372052
7.5,"max_tuv_SVM","SVM",4,24,27640,24597,3043,2500,2046,454,0.530825873526134,0.148995535714286,1.20780217511013,1133,454,679,36,1.5,8.29,4.5,0,0,0,0,0,0,0.181951396195282,4794.18675596431,18.2056165307151
7.5,"max_tuv_SVM","SVM",4,25,27540,24508,3032,2600,2135,465,0.538281338250241,0.175223214285714,1.69233240376203,1163,465,698,30,1.5,8.63,4.6,0,0,0,0,0,0,0.1788749216422,4653.97812186603,17.9060562472826
7.5,"max_tuv_SVM","SVM",4,26,27440,24420,3020,2700,2223,477,0.53713618626483,0.173549107142857,1.65397278314311,1192,477,715,29,1.5,8.96,4.7,0,0,0,0,0,0,0.176147515822311,4506.16473567798,17.6415297336039
7.5,"max_tuv_SVM","SVM",4,27,27340,24336,3004,2800,2307,493,0.528558346523239,0.154575892857143,1.35839240401589,1227,493,734,35,1.5,9.29,4.7,0,0,0,0,0,0,0.175663524570864,4475.75196697477,17.5821221984925
7.5,"max_tuv_SVM","SVM",4,28,27240,24249,2991,2900,2394,506,0.531957787974833,0.1640625,1.61791126440603,1277,506,771,50,1.5,9.62,4.7,0,0,0,0,0,0,0.174431057091906,4575.78092717452,17.4526578951531
7.5,"max_tuv_SVM","SVM",4,29,27140,24165,2975,3000,2478,522,0.529292966774875,0.154575892857143,1.38808404126214,1308,522,786,31,1.5,9.95,4.7,0,0,0,0,0,0,0.173727372931136,4465.26053099495,17.3836569706908
7.5,"max_tuv_SVM","SVM",4,30,27040,24084,2956,3100,2559,541,0.529105203873188,0.150111607142857,1.41534959034544,1352,541,811,44,1.5,10.29,4.7,0,0,0,0,0,0,0.173818520886422,4462.8284115406,17.3943728096039
7.5,"max_tuv_SVM","SVM",4,31,26940,23998,2942,3200,2645,555,0.537729059813833,0.161830357142857,1.47103439708481,1385,555,830,33,1.5,10.62,4.8,0,0,0,0,0,0,0.173342968952544,4504.63191676388,17.3737536545586
7.5,"max_tuv_SVM","SVM",4,32,26840,23916,2924,3300,2727,573,0.535301001413349,0.143415178571429,1.18221057606762,1426,573,853,41,1.5,10.95,4.8,0,0,0,0,0,0,0.17399618743282,4318.09523272392,17.7596819721669
7.5,"max_tuv_SVM","SVM",4,33,26740,23831,2909,3400,2812,588,0.542016971110408,0.166852678571429,1.46199379938543,1460,588,872,34,1.5,11.28,4.8,0,0,0,0,0,0,0.172261940890623,4161.39953345619,17.4227138183843
7.5,"max_tuv_SVM","SVM",4,34,26640,23751,2889,3500,2892,608,0.546886913783038,0.162946428571429,1.5899058635159,1488,608,880,28,1.4,11.61,4.8,0,0,0,0,0,0,0.173540132957749,4437.58640944573,17.4104547247332
7.5,"max_tuv_SVM","SVM",4,35,26540,23663,2877,3600,2980,620,0.543484152441286,0.1484375,1.13810550307557,1526,620,906,38,1.5,11.94,4.8,0,0,0,0,0,0,0.172659862673298,4170.01453560298,17.27092533591
7.5,"max_tuv_SVM","SVM",4,36,26440,23577,2863,3700,3066,634,0.539546930807773,0.147321428571429,1.26374052614235,1573,634,939,47,1.5,12.28,4.8,0,0,0,0,0,0,0.171432166685534,4354.82511105256,17.1455967642456
7.5,"max_tuv_SVM","SVM",4,37,26340,23486,2854,3800,3157,643,0.541634175167829,0.138950892857143,1.16436907517637,1586,643,943,13,1.5,12.61,4.9,0,0,0,0,0,0,0.168884211167261,4313.0331519854,16.8914696290048
7.5,"max_tuv_SVM","SVM",4,38,26240,23394,2846,3900,3249,651,0.538455863615212,0.138950892857143,1.19611111111111,1618,651,967,32,1.5,12.94,5,0,0,0,0,0,0,0.166740171781632,4094.48404538622,16.690507747576
7.5,"max_tuv_SVM","SVM",4,39,26140,23308,2832,4000,3335,665,0.545516597601743,0.154575892857143,1.31734305862832,1628,665,963,10,1.4,13.27,5,0,0,0,0,0,0,0.165722046069105,4126.45677163603,16.5750307894243
7.5,"max_tuv_SVM","SVM",4,40,26040,23218,2822,4100,3425,675,0.54830736450814,0.162388392857143,1.48458186231244,1690,675,1015,62,1.5,13.6,5.1,0,0,0,0,0,0,0.164581778086429,4119.88974906022,16.4651111175204
7.5,"max_tuv_SVM","SVM",4,41,25940,23124,2816,4200,3519,681,0.537162157051146,0.121651785714286,1.02436148499559,1657,681,976,-33,1.4,13.93,5.2,0,0,0,0,0,0,0.161442355208361,3972.00126071922,16.1488406457413
7.5,"max_tuv_SVM","SVM",4,42,25840,23029,2811,4300,3614,686,0.543825512792757,0.160714285714286,1.48806461817782,1720,686,1034,63,1.5,14.27,5.3,0,0,0,0,0,0,0.160474616694538,3731.84925926797,16.0773396593407
7.5,"max_tuv_SVM","SVM",4,43,25740,22967,2773,4400,3676,724,0.548409566696336,0.169642857142857,1.6776547593235,1817,724,1093,97,1.5,14.6,5.1,0,0,0,0,0,0,0.164443152038893,3711.02844687204,16.4589683834886
7.5,"max_tuv_SVM","SVM",4,44,25640,22878,2762,4500,3765,735,0.545995292143606,0.151227678571429,1.42519858781995,1834,735,1099,17,1.5,14.93,5.1,0,0,0,0,0,0,0.162187460986484,3676.72876257191,16.2342645283378
7.5,"max_tuv_SVM","SVM",4,45,25540,22787,2753,4600,3856,744,0.545351737739771,0.15625,1.41396672504378,1886,744,1142,52,1.5,15.26,5.2,0,0,0,0,0,0,0.161643017638725,3949.23660604406,16.1794048049757
7.5,"max_tuv_SVM","SVM",4,46,25440,22693,2747,4700,3950,750,0.545091315469913,0.150669642857143,1.35884620633188,1840,750,1090,-46,1.5,15.59,5.3,0,0,0,0,0,0,0.159562706900422,3787.32411095302,15.9681499866569
7.5,"max_tuv_SVM","SVM",4,47,25340,22607,2733,4800,4036,764,0.556010560276432,0.170200892857143,1.44468941717791,1843,764,1079,3,1.4,15.93,5.3,0,0,0,0,0,0,0.158363094493206,3733.1064015964,15.8490676236786
7.5,"max_tuv_SVM","SVM",4,48,25240,22514,2726,4900,4129,771,0.544990920310531,0.137834821428571,1.11891644021739,1871,771,1100,28,1.4,16.26,5.4,0,0,0,0,0,0,0.157266988859068,3918.76024679349,15.7374078939843
7.5,"max_tuv_SVM","SVM",5,0,30040,26491,3549,100,87,13,0.45900690420449,0.0903300521134916,0.858743793812909,45,13,32,0,2.5,0.33,6.7,0,0,0,0,0,0,0.140924006608667,3917.23224647033,14.1410588337234
7.5,"max_tuv_SVM","SVM",5,1,29940,26402,3538,200,176,24,0.563799213958309,0.190503763752171,1.93498243445915,66,24,42,21,1.8,0.66,7.3,0,0,0,0,0,0,0.509547312186719,2931.22609309829,63.4350771658441
7.5,"max_tuv_SVM","SVM",5,2,29840,26341,3499,300,237,63,0.484601946410452,0.137232194557035,1.2365441417788,153,63,90,87,1.4,1,3.8,0,0,0,0,0,0,0.267623137531172,5991.22460888263,31.9178914596172
7.5,"max_tuv_SVM","SVM",5,3,29740,26253,3487,400,325,75,0.508827499378612,0.167342211928199,1.55279247125928,178,75,103,25,1.4,1.33,4.3,0,0,0,0,0,0,0.227602552757393,4841.89984533869,24.4186301803436
7.5,"max_tuv_SVM","SVM",5,4,29640,26170,3470,500,408,92,0.518543279157795,0.177185871453387,1.63769670100936,223,92,131,45,1.4,1.66,4.4,0,0,0,0,0,0,0.218053658538982,4375.29130015748,23.4588890909918
7.5,"max_tuv_SVM","SVM",5,5,29540,26088,3452,600,490,110,0.509142230222771,0.139548349739433,1.26540916437688,260,110,150,37,1.4,1.99,4.5,0,0,0,0,0,0,0.195017914311133,4694.99163834351,19.8069148811111
7.5,"max_tuv_SVM","SVM",5,6,29440,26006,3434,700,572,128,0.518575173156206,0.149392009264621,1.44796166463581,295,128,167,35,1.3,2.32,4.5,0,0,0,0,0,0,0.178449663509197,4049.69650356073,18.2929704772613
7.5,"max_tuv_SVM","SVM",5,7,29340,25923,3417,800,655,145,0.522134456592221,0.148812970469021,1.44025290688265,344,145,199,49,1.4,2.65,4.5,0,0,0,0,0,0,0.176158084255466,4382.6029475387,17.8489117894901
7.5,"max_tuv_SVM","SVM",5,8,29240,25845,3395,900,733,167,0.519553993458388,0.145338737695426,1.47896938287412,397,167,230,53,1.4,2.99,4.4,0,0,0,0,0,0,0.180993826042267,4652.35572984046,18.203544608316
7.5,"max_tuv_SVM","SVM",5,9,29140,25766,3374,1000,812,188,0.529114382205874,0.155182397220614,1.49711278388985,442,188,254,45,1.4,3.32,4.3,0,0,0,0,0,0,0.183453160016859,4241.33985055104,18.5247411107485
7.5,"max_tuv_SVM","SVM",5,10,29040,25689,3351,1100,889,211,0.536154494181145,0.165026056745802,1.6260919916417,497,211,286,55,1.4,3.65,4.2,0,0,0,0,0,0,0.18843254425538,4935.36505085133,18.903810304905
7.5,"max_tuv_SVM","SVM",5,11,28940,25615,3325,1200,963,237,0.539981166485457,0.179502026635785,1.7499847148144,549,237,312,52,1.3,3.98,4.1,0,0,0,0,0,0,0.195604529532004,4563.24636824935,20.1563777576827
7.5,"max_tuv_SVM","SVM",5,12,28840,25539,3301,1300,1039,261,0.541496196499664,0.186450492182976,1.7298932621406,604,261,343,55,1.3,4.31,4,0,0,0,0,0,0,0.197045901952617,4992.63089075567,19.7541941192809
7.5,"max_tuv_SVM","SVM",5,13,28740,25461,3279,1400,1117,283,0.548123812762182,0.185871453387377,1.89272289776748,650,283,367,46,1.3,4.64,3.9,0,0,0,0,0,0,0.219501222589734,5499.2835118565,22.5170917066233
7.5,"max_tuv_SVM","SVM",5,14,28640,25391,3249,1500,1187,313,0.539349318171408,0.187029530978576,1.81967437159905,716,313,403,66,1.3,4.98,3.8,0,0,0,0,0,0,0.205634602354476,5214.87013456847,20.6644981856234
7.5,"max_tuv_SVM","SVM",5,15,28540,25308,3232,1600,1270,330,0.53994419548322,0.19166184134337,2.00132175255742,765,330,435,49,1.3,5.31,3.8,0,0,0,0,0,0,0.21172242996887,4744.47493345247,21.4443596244535
7.5,"max_tuv_SVM","SVM",5,16,28440,25239,3201,1700,1339,361,0.538100418622831,0.185292414591778,1.95131038997004,827,361,466,62,1.3,5.64,3.7,0,0,0,0,0,0,0.211153957635477,5737.31604708676,21.1323034438836
7.5,"max_tuv_SVM","SVM",5,17,28340,25156,3184,1800,1422,378,0.543780110538091,0.184713375796178,1.9762938637315,857,378,479,30,1.3,5.97,3.8,0,0,0,0,0,0,0.208203862699923,5581.04756950888,20.8610132819292
7.5,"max_tuv_SVM","SVM",5,18,28240,25066,3174,1900,1512,388,0.545658384988593,0.188187608569774,1.93754300365833,884,388,496,27,1.3,6.3,3.9,0,0,0,0,0,0,0.199221661981197,4491.95822864547,20.0198949898635
7.5,"max_tuv_SVM","SVM",5,19,28140,25006,3134,2000,1572,428,0.54956442344677,0.195715112912565,2.04010705783954,958,428,530,74,1.2,6.64,3.7,0,0,0,0,0,0,0.213363426724332,4865.94470663018,23.5037926014484
7.5,"max_tuv_SVM","SVM",5,20,28040,24922,3118,2100,1656,444,0.545475092132431,0.189924724956572,1.90485061878028,996,444,552,38,1.2,6.97,3.7,0,0,0,0,0,0,0.213645791832837,5611.52341536325,21.5284218156469
7.5,"max_tuv_SVM","SVM",5,21,27940,24829,3111,2200,1749,451,0.550224998055985,0.197452229299363,2.03880277323713,1005,451,554,9,1.2,7.3,3.9,0,0,0,0,0,0,0.203579125406049,5115.93458939866,20.4064782745121
7.5,"max_tuv_SVM","SVM",5,22,27840,24754,3086,2300,1824,476,0.550295251638876,0.196294151708164,2.0227948958193,1072,476,596,67,1.3,7.63,3.8,0,0,0,0,0,0,0.202180281669298,4498.71718539381,20.2716030077798
7.5,"max_tuv_SVM","SVM",5,23,27740,24677,3063,2400,1901,499,0.548580526140759,0.196873190503764,2.0460454118632,1140,499,641,68,1.3,7.96,3.8,0,0,0,0,0,0,0.206722863530335,5360.96678085836,20.6833862376717
7.5,"max_tuv_SVM","SVM",5,24,27640,24598,3042,2500,1980,520,0.549663099572453,0.199189345686161,2.01863021263706,1187,520,667,47,1.3,8.29,3.8,0,0,0,0,0,0,0.204378653238159,4673.50318655183,20.4754341381366
7.5,"max_tuv_SVM","SVM",5,25,27540,24527,3013,2600,2051,549,0.5521510918075,0.202084539664157,2.0836422815659,1233,549,684,46,1.2,8.63,3.7,0,0,0,0,0,0,0.206512743247776,4651.62990571639,20.672262398305
7.5,"max_tuv_SVM","SVM",5,26,27440,24445,2995,2700,2133,567,0.55089138735335,0.199189345686161,2.02269283034062,1304,567,737,71,1.3,8.96,3.8,0,0,0,0,0,0,0.210065285222009,5105.59319788043,21.0316495532684
7.5,"max_tuv_SVM","SVM",5,27,27340,24362,2978,2800,2216,584,0.553546443389586,0.202663578459757,2.10907833451811,1325,584,741,21,1.3,9.29,3.8,0,0,0,0,0,0,0.206875667807648,5067.52937037747,20.6936860128127
7.5,"max_tuv_SVM","SVM",5,28,27240,24278,2962,2900,2300,600,0.55259995101777,0.202663578459757,2.08798192546385,1350,600,750,25,1.2,9.62,3.8,0,0,0,0,0,0,0.203960427973693,4731.16043008467,20.423910297598
7.5,"max_tuv_SVM","SVM",5,29,27140,24198,2942,3000,2380,620,0.55085472010348,0.200926462072959,2.05876224340834,1414,620,794,64,1.3,9.95,3.8,0,0,0,0,0,0,0.204334185273028,4958.81459086619,20.4606019050558
7.5,"max_tuv_SVM","SVM",5,30,27040,24114,2926,3100,2464,636,0.552053326938918,0.202084539664157,2.04974049825756,1465,636,829,51,1.3,10.29,3.9,0,0,0,0,0,0,0.204607763917197,5405.52724519492,20.4649579143613
7.5,"max_tuv_SVM","SVM",5,31,26940,24031,2909,3200,2547,653,0.552767709110073,0.200926462072959,2.03318256092792,1481,653,828,16,1.3,10.62,3.9,0,0,0,0,0,0,0.200292403476137,4414.72365765602,20.0555968080482
7.5,"max_tuv_SVM","SVM",5,32,26840,23949,2891,3300,2629,671,0.553630626188108,0.203242617255356,2.15878873587328,1523,671,852,42,1.3,10.95,3.9,0,0,0,0,0,0,0.198642999243593,4268.78360888134,19.9211025629896
7.5,"max_tuv_SVM","SVM",5,33,26740,23860,2880,3400,2718,682,0.552340329531394,0.20034742327736,2.14166019778347,1563,682,881,40,1.3,11.28,4,0,0,0,0,0,0,0.199529198606144,5006.48542644837,19.9644491737449
7.5,"max_tuv_SVM","SVM",5,34,26640,23766,2874,3500,2812,688,0.551751266907724,0.19976838448176,2.09013467713526,1551,688,863,-12,1.3,11.61,4.1,0,0,0,0,0,0,0.194484819955303,4775.11550265124,19.4615191688895
7.5,"max_tuv_SVM","SVM",5,35,26540,23675,2865,3600,2903,697,0.551618613910263,0.203242617255356,2.07125714072057,1586,697,889,35,1.3,11.94,4.2,0,0,0,0,0,0,0.187325753833,3977.32634391989,18.7713816393214
7.5,"max_tuv_SVM","SVM",5,36,26440,23588,2852,3700,2990,710,0.548387903747651,0.198031268094962,1.91207136031488,1636,710,926,50,1.3,12.28,4.2,0,0,0,0,0,0,0.185811931145932,3850.523443775,18.6556535070828
7.5,"max_tuv_SVM","SVM",5,37,26340,23493,2847,3800,3085,715,0.546427616158383,0.195715112912565,1.94436859374841,1636,715,921,0,1.3,12.61,4.3,0,0,0,0,0,0,0.183159681100927,3940.13545298231,18.3660609360729
7.5,"max_tuv_SVM","SVM",5,38,26240,23407,2833,3900,3171,729,0.545816206039221,0.198610306890562,1.93250235124079,1687,729,958,51,1.3,12.94,4.3,0,0,0,0,0,0,0.183219323708264,4086.66909321525,18.4779786457187
7.5,"max_tuv_SVM","SVM",5,39,26140,23319,2821,4000,3259,741,0.545481123786554,0.198031268094962,2.03140995189485,1712,741,971,25,1.3,13.27,4.4,0,0,0,0,0,0,0.18046031164371,3871.86123513025,18.0722103318287
7.5,"max_tuv_SVM","SVM",5,40,26040,23227,2813,4100,3351,749,0.543818817268131,0.194557035321367,1.91728579729402,1725,749,976,13,1.3,13.6,4.5,0,0,0,0,0,0,0.179341898489378,4003.47315516263,17.9534853154653
7.5,"max_tuv_SVM","SVM",5,41,25940,23134,2806,4200,3444,756,0.543255052877209,0.194557035321367,1.8110563959449,1778,756,1022,53,1.4,13.93,4.6,0,0,0,0,0,0,0.177675505467261,3999.84120688563,17.7888156468285
7.5,"max_tuv_SVM","SVM",5,42,25840,23042,2798,4300,3536,764,0.541734164781668,0.191082802547771,1.68142921111896,1773,764,1009,-5,1.3,14.27,4.6,0,0,0,0,0,0,0.174806659547719,3917.0458148435,17.4980686930465
7.5,"max_tuv_SVM","SVM",5,43,25740,22949,2791,4400,3629,771,0.541315919470563,0.189924724956572,1.79845774275572,1785,771,1014,12,1.3,14.6,4.7,0,0,0,0,0,0,0.169744844688827,3366.34950123213,17.0042827724369
7.5,"max_tuv_SVM","SVM",5,44,25640,22855,2785,4500,3723,777,0.539367196167787,0.175448755066589,1.62765827989985,1833,777,1056,48,1.4,14.93,4.8,0,0,0,0,0,0,0.167360634776582,3325.72002299828,16.7707528725576
7.5,"max_tuv_SVM","SVM",5,45,25540,22766,2774,4600,3812,788,0.542545096811952,0.189924724956572,1.7179727992995,1855,788,1067,22,1.4,15.26,4.8,0,0,0,0,0,0,0.165644770867855,3285.13166401356,16.6013362727469
7.5,"max_tuv_SVM","SVM",5,46,25440,22671,2769,4700,3907,793,0.541828458194649,0.19166184134337,1.79734707869599,1842,793,1049,-13,1.3,15.59,4.9,0,0,0,0,0,0,0.163518066161648,3363.60308714192,16.3865024464437
7.5,"max_tuv_SVM","SVM",5,47,25340,22577,2763,4800,4001,799,0.541143843755335,0.18355529820498,1.6996093384545,1894,799,1095,52,1.4,15.93,5,0,0,0,0,0,0,0.161578110247484,3269.18246762533,16.1851596568672
7.5,"max_tuv_SVM","SVM",5,48,25240,22480,2760,4900,4098,802,0.543754204800606,0.190503763752171,1.77129740658503,1892,802,1090,-2,1.4,16.26,5.1,0,0,0,0,0,0,0.16008195859159,3568.20487274637,16.0429087350365
7.5,"max_tuv_SVM","SVM",6,0,30040,26506,3534,100,91,9,0.576072437885362,0.177548682703322,1.66024364046966,30,9,21,0,2.3,0.33,10.1,0,0,0,0,0,0,0.277591882141658,2827.34368003539,29.2067489085634
7.5,"max_tuv_SVM","SVM",6,1,29940,26438,3502,200,159,41,0.551991472333436,0.127720504009164,1.10388017066159,104,41,63,74,1.5,0.66,3.9,0,0,0,0,0,0,0.252551670979997,6000.99700817523,25.6234072156187
7.5,"max_tuv_SVM","SVM",6,2,29840,26346,3494,300,251,49,0.56093623806976,0.180412371134021,1.58780239155426,146,49,97,42,2,1,5.1,0,0,0,0,0,0,0.212253371384615,4710.08295565951,21.9218126699259
7.5,"max_tuv_SVM","SVM",6,3,29740,26262,3478,400,335,65,0.545840484495251,0.148911798396334,1.54598143304098,172,65,107,26,1.6,1.33,5.2,0,0,0,0,0,0,0.628558799762377,4558.08887857319,69.2222369270109
7.5,"max_tuv_SVM","SVM",6,4,29640,26175,3465,500,422,78,0.548570047001027,0.139747995418099,1.46519245900417,191,78,113,19,1.4,1.66,5.4,0,0,0,0,0,0,0.416362166448649,3780.79653735659,62.1383432779014
7.5,"max_tuv_SVM","SVM",6,5,29540,26111,3429,600,486,114,0.541782342486392,0.166093928980527,1.77981682530994,265,114,151,74,1.3,1.99,4.3,0,0,0,0,0,0,0.253674461180993,4534.19460211461,28.9454164426059
7.5,"max_tuv_SVM","SVM",6,6,29440,26041,3399,700,556,144,0.538445334175782,0.135166093928981,1.22762377497773,346,144,202,81,1.4,2.32,3.9,0,0,0,0,0,0,0.232833656232732,4570.33400635768,24.9358870186584
7.5,"max_tuv_SVM","SVM",6,7,29340,25956,3384,800,641,159,0.527005194397698,0.118556701030928,1.11921183969855,386,159,227,40,1.4,2.65,4,0,0,0,0,0,0,0.209784939557777,4854.03009797307,22.68127142052
7.5,"max_tuv_SVM","SVM",6,8,29240,25873,3367,900,724,176,0.525915810783801,0.126575028636884,0.920925950092073,432,176,256,46,1.5,2.99,4.1,0,0,0,0,0,0,0.234018736854224,4310.41837767941,27.6277425664963
7.5,"max_tuv_SVM","SVM",6,9,29140,25787,3353,1000,810,190,0.524407264849808,0.115120274914089,0.813133954214187,470,190,280,38,1.5,3.32,4.3,0,0,0,0,0,0,0.212074345369005,4054.61519929694,21.5706231515286
7.5,"max_tuv_SVM","SVM",6,10,29040,25688,3352,1100,909,191,0.526183933687075,0.132875143184422,1.04557644959351,487,191,296,17,1.5,3.65,4.8,0,0,0,0,0,0,0.181124859401236,3748.70927821562,18.9510045800295
7.5,"max_tuv_SVM","SVM",6,11,28940,25607,3333,1200,990,210,0.533976604793801,0.152920962199313,1.34728055661618,533,210,323,46,1.5,3.98,4.7,0,0,0,0,0,0,0.205863871741418,3523.43699627794,21.047660118252
7.5,"max_tuv_SVM","SVM",6,12,28840,25542,3298,1300,1055,245,0.526320831963276,0.13631156930126,1.19084495417092,613,245,368,80,1.5,4.31,4.3,0,0,0,0,0,0,0.188817941608357,4462.99238755932,19.0535552994445
7.5,"max_tuv_SVM","SVM",6,13,28740,25449,3291,1400,1148,252,0.527306327623151,0.134593356242841,1.13215468354226,661,252,409,48,1.6,4.64,4.6,0,0,0,0,0,0,0.179249009394452,4036.90356858581,17.9827906291268
7.5,"max_tuv_SVM","SVM",6,14,28640,25361,3279,1500,1236,264,0.529496442149196,0.139175257731959,1.32507905568322,691,264,427,30,1.6,4.98,4.7,0,0,0,0,0,0,0.175144657248758,3564.73275985687,17.5254620973011
7.5,"max_tuv_SVM","SVM",6,15,28540,25267,3273,1600,1330,270,0.528607140631281,0.13573883161512,1.43366938544556,698,270,428,7,1.6,5.31,4.9,0,0,0,0,0,0,0.168800872371206,4051.10733622787,16.9027876069002
7.5,"max_tuv_SVM","SVM",6,16,28440,25197,3243,1700,1400,300,0.528011708348642,0.134593356242841,1.21266010167343,773,300,473,75,1.6,5.64,4.7,0,0,0,0,0,0,0.175354623199805,3721.30198201816,17.5748732954463
7.5,"max_tuv_SVM","SVM",6,17,28340,25112,3228,1800,1485,315,0.52790403796187,0.150057273768614,1.34422386777827,809,315,494,36,1.6,5.97,4.7,0,0,0,0,0,0,0.174315134726764,4093.16633623025,17.4446881744371
7.5,"max_tuv_SVM","SVM",6,18,28240,25018,3222,1900,1579,321,0.525817553496707,0.139175257731959,1.27514188274498,831,321,510,22,1.6,6.3,4.9,0,0,0,0,0,0,0.169234506218395,3931.92070502174,16.9408607932303
7.5,"max_tuv_SVM","SVM",6,19,28140,24931,3209,2000,1666,334,0.526395148170355,0.13631156930126,1.33144997505253,862,334,528,31,1.6,6.64,5,0,0,0,0,0,0,0.165470060738176,3663.39549778583,16.5790889740481
7.5,"max_tuv_SVM","SVM",6,20,28040,24849,3191,2100,1748,352,0.528220601793644,0.13631156930126,1.16888005918289,896,352,544,34,1.5,6.97,5,0,0,0,0,0,0,0.168170492477982,3541.7473496897,16.8626651240386
7.5,"max_tuv_SVM","SVM",6,21,27940,24757,3183,2200,1840,360,0.527485821249965,0.141466208476518,1.34471680638675,914,360,554,18,1.5,7.3,5.1,0,0,0,0,0,0,0.162126858844824,2882.35155045571,16.2665720537584
7.5,"max_tuv_SVM","SVM",6,22,27840,24666,3174,2300,1931,369,0.527678940231116,0.138602520045819,1.37132510168242,959,369,590,45,1.6,7.63,5.2,0,0,0,0,0,0,0.15836729710882,2883.28135416157,17.3257050760218
7.5,"max_tuv_SVM","SVM",6,23,27740,24583,3157,2400,2014,386,0.523770698611036,0.117983963344788,0.889790635360371,966,386,580,7,1.5,7.96,5.2,0,0,0,0,0,0,0.160399148868123,3505.97391761725,16.0526686585373
7.5,"max_tuv_SVM","SVM",6,24,27640,24504,3136,2500,2093,407,0.527256941086462,0.134020618556701,1.18743371091596,1024,407,617,58,1.5,8.29,5.1,0,0,0,0,0,0,0.161611085051332,3186.91825298848,16.1817058283011
7.5,"max_tuv_SVM","SVM",6,25,27540,24415,3125,2600,2182,418,0.532101506740679,0.156930126002291,1.52456524002916,1063,418,645,39,1.5,8.63,5.2,0,0,0,0,0,0,0.160290979623157,3704.42961293987,16.0321346800342
7.5,"max_tuv_SVM","SVM",6,26,27440,24325,3115,2700,2272,428,0.53073132047736,0.15807560137457,1.58496415452068,1110,428,682,47,1.6,8.96,5.3,0,0,0,0,0,0,0.157985415543106,3457.60421691055,15.8027919961362
7.5,"max_tuv_SVM","SVM",6,27,27340,24240,3100,2800,2357,443,0.523679920225052,0.138602520045819,1.22549248370172,1103,443,660,-7,1.5,9.29,5.3,0,0,0,0,0,0,0.157542079950303,3409.39127821736,15.7709108609487
7.5,"max_tuv_SVM","SVM",6,28,27240,24149,3091,2900,2448,452,0.521631947802431,0.119129438717068,0.943857565087042,1139,452,687,36,1.5,9.62,5.4,0,0,0,0,0,0,0.155640218944815,2993.17369040563,15.6150787473992
7.5,"max_tuv_SVM","SVM",6,29,27140,24069,3071,3000,2528,472,0.524855612077136,0.13573883161512,1.2298101040516,1147,472,675,8,1.4,9.95,5.4,0,0,0,0,0,0,0.157009295239353,3321.56692794575,15.7159154023131
7.5,"max_tuv_SVM","SVM",6,30,27040,23973,3067,3100,2624,476,0.524272257789979,0.132875143184422,1.13178273616418,1212,476,736,65,1.5,10.29,5.5,0,0,0,0,0,0,0.153731535976693,3572.17632565942,15.3762918780617
7.5,"max_tuv_SVM","SVM",6,31,26940,23880,3060,3200,2717,483,0.530643636809088,0.160366552119129,1.50676684552159,1227,483,744,15,1.5,10.62,5.6,0,0,0,0,0,0,0.149093103084534,2906.65506593969,14.9263498988915
7.5,"max_tuv_SVM","SVM",6,32,26840,23793,3047,3300,2804,496,0.524663868526075,0.130011454753723,1.1971568532213,1256,496,760,29,1.5,10.95,5.7,0,0,0,0,0,0,0.148908011426133,2931.96299921862,14.9084920373813
7.5,"max_tuv_SVM","SVM",6,33,26740,23719,3021,3400,2878,522,0.525257710467666,0.131156930126002,1.24393995212758,1338,522,816,82,1.6,11.28,5.5,0,0,0,0,0,0,0.152824684765703,3256.19852521651,15.2960015632782
7.5,"max_tuv_SVM","SVM",6,34,26640,23622,3018,3500,2975,525,0.52539413593977,0.139175257731959,1.21573657293129,1314,525,789,-24,1.5,11.61,5.7,0,0,0,0,0,0,0.14845822265992,3148.2748327986,14.8581471075206
7.5,"max_tuv_SVM","SVM",6,35,26540,23539,3001,3600,3058,542,0.527836126101149,0.149484536082474,1.31695962673681,1373,542,831,59,1.5,11.94,5.6,0,0,0,0,0,0,0.148562767745974,2969.84094014639,14.8752762375253
7.5,"max_tuv_SVM","SVM",6,36,26440,23442,2998,3700,3155,545,0.521186437399661,0.123138602520046,1.03702759259934,1392,545,847,19,1.6,12.28,5.8,0,0,0,0,0,0,0.146855012191693,3455.68791673872,14.6901370740968
7.5,"max_tuv_SVM","SVM",6,37,26340,23361,2979,3800,3236,564,0.524374770313913,0.134593356242841,1.17287268132794,1397,564,833,5,1.5,12.61,5.7,0,0,0,0,0,0,0.146988546375791,2818.60049907179,14.7142015681503
7.5,"max_tuv_SVM","SVM",6,38,26240,23284,2956,3900,3313,587,0.523883526860645,0.132875143184422,1.15981897345279,1486,587,899,89,1.5,12.94,5.6,0,0,0,0,0,0,0.149160570475906,2741.14905662849,14.9284012720187
7.5,"max_tuv_SVM","SVM",6,39,26140,23188,2952,4000,3409,591,0.522326883855676,0.119129438717068,1.00155587819609,1513,591,922,27,1.6,13.27,5.8,0,0,0,0,0,0,0.146247749613163,2892.99036913122,14.6467110265811
7.5,"max_tuv_SVM","SVM",6,40,26040,23095,2945,4100,3502,598,0.524675430735271,0.128865979381443,1.04422143065787,1543,598,945,30,1.6,13.6,5.9,0,0,0,0,0,0,0.145062588183648,2877.18817941224,14.51578836896
7.5,"max_tuv_SVM","SVM",6,41,25940,23003,2937,4200,3594,606,0.522937102011783,0.126575028636884,1.03246722499776,1587,606,981,44,1.6,13.93,5.9,0,0,0,0,0,0,0.142628352320592,2873.85807328222,14.2759499153818
7.5,"max_tuv_SVM","SVM",6,42,25840,22911,2929,4300,3686,614,0.525546035000399,0.132875143184422,1.1725837848474,1576,614,962,-11,1.6,14.27,6,0,0,0,0,0,0,0.140018047619783,2579.59238369637,14.0504170467953
7.5,"max_tuv_SVM","SVM",6,43,25740,22824,2916,4400,3773,627,0.524258976293173,0.126575028636884,1.02487555422572,1651,627,1024,75,1.6,14.6,6,0,0,0,0,0,0,0.14066047660843,2798.69626604407,14.0964468742856
7.5,"max_tuv_SVM","SVM",6,44,25640,22744,2896,4500,3853,647,0.525589876834533,0.134020618556701,1.15240369910581,1720,647,1073,69,1.7,14.93,6,0,0,0,0,0,0,0.142041293472122,2789.49627668643,14.2100647040003
7.5,"max_tuv_SVM","SVM",6,45,25540,22659,2881,4600,3938,662,0.529542905896938,0.156930126002291,1.46477836787115,1687,662,1025,-33,1.5,15.26,5.9,0,0,0,0,0,0,0.142940042844015,2614.01029497618,14.3002549421289
7.5,"max_tuv_SVM","SVM",6,46,25440,22562,2878,4700,4035,665,0.523592279538972,0.124856815578465,0.988194550001043,1729,665,1064,42,1.6,15.59,6.1,0,0,0,0,0,0,0.139986834275475,2916.07556341248,14.0059848667906
7.5,"max_tuv_SVM","SVM",6,47,25340,22480,2860,4800,4117,683,0.525194999451978,0.126575028636884,1.05803388344435,1765,683,1082,36,1.6,15.93,6,0,0,0,0,0,0,0.140284428468707,2703.99707651402,14.0559942701815
7.5,"max_tuv_SVM","SVM",6,48,25240,22397,2843,4900,4200,700,0.526340818681781,0.13631156930126,1.22446602993482,1790,700,1090,25,1.6,16.26,6,0,0,0,0,0,0,0.141003032292792,2909.02371281287,14.1026446070336
7.5,"max_tuv_SVM","SVM",7,0,30040,26563,3477,100,94,6,0.577387119786251,0.182724252491694,1.68682653744469,29,6,23,0,3.8,0.33,15.7,0,0,0,0,0,0,0.468807193506834,1968.83672971385,57.1773049001874
7.5,"max_tuv_SVM","SVM",7,1,29940,26483,3457,200,174,26,0.592945928448078,0.205980066445183,1.71236211830735,71,26,45,42,1.7,0.66,6.7,0,0,0,0,0,0,0.33451539346288,3013.72436500241,39.8065615532379
7.5,"max_tuv_SVM","SVM",7,2,29840,26408,3432,300,249,51,0.548069090801319,0.17109634551495,1.29015039729548,133,51,82,62,1.6,1,4.9,0,0,0,0,0,0,0.21057251848093,4710.34271150241,21.7686790043541
7.5,"max_tuv_SVM","SVM",7,3,29740,26330,3410,400,327,73,0.57234316319643,0.20265780730897,1.79714964045513,184,73,111,51,1.5,1.33,4.5,0,0,0,0,0,0,0.182847239960036,5421.3287347276,18.2946706735956
7.5,"max_tuv_SVM","SVM",7,4,29640,26255,3385,500,402,98,0.5499298314159,0.187153931339978,1.73267163285941,234,98,136,50,1.4,1.66,4.1,0,0,0,0,0,0,0.237179790626925,4715.23383470154,25.2621922845368
7.5,"max_tuv_SVM","SVM",7,5,29540,26173,3367,600,484,116,0.525696499376582,0.191029900332226,1.81125257149085,284,116,168,50,1.4,1.99,4.2,0,0,0,0,0,0,0.244487545340594,4888.99354985502,44.307655402816
7.5,"max_tuv_SVM","SVM",7,6,29440,26099,3341,700,558,142,0.542695204117113,0.20265780730897,1.95354658010792,339,142,197,55,1.4,2.32,3.9,0,0,0,0,0,0,0.212072209987904,5107.17621874974,21.9576796058235
7.5,"max_tuv_SVM","SVM",7,7,29340,26015,3325,800,642,158,0.551630657785603,0.207087486157254,1.88055464570368,383,158,225,44,1.4,2.65,4.1,0,0,0,0,0,0,0.198543160866563,5464.87589447182,19.8987003421568
7.5,"max_tuv_SVM","SVM",7,8,29240,25931,3309,900,726,174,0.550824700009472,0.209302325581395,1.96829032788232,429,174,255,46,1.5,2.99,4.2,0,0,0,0,0,0,0.193069767881134,4676.97470101868,19.551774422918
7.5,"max_tuv_SVM","SVM",7,9,29140,25844,3296,1000,813,187,0.552419960436767,0.179955703211517,1.72197612895287,466,187,279,37,1.5,3.32,4.3,0,0,0,0,0,0,0.186732765838727,4661.98786879909,18.7651058492818
7.5,"max_tuv_SVM","SVM",7,10,29040,25769,3271,1100,888,212,0.565246452020089,0.200442967884828,1.90763015113884,521,212,309,55,1.5,3.65,4.2,0,0,0,0,0,0,0.190472805602238,4859.11803831539,19.5373527790647
7.5,"max_tuv_SVM","SVM",7,11,28940,25710,3230,1200,947,253,0.569649123685796,0.187707641196013,1.92066568229359,611,253,358,90,1.4,3.98,3.7,0,0,0,0,0,0,0.207573581539321,4971.23610185898,20.8018344152766
7.5,"max_tuv_SVM","SVM",7,12,28840,25640,3200,1300,1017,283,0.5630236398419,0.189922480620155,1.80966235852203,686,283,403,75,1.4,4.31,3.6,0,0,0,0,0,0,0.215808241520684,5114.47809549237,21.6277443395141
7.5,"max_tuv_SVM","SVM",7,13,28740,25567,3173,1400,1090,310,0.562547403449328,0.19656699889258,1.85768637601995,734,310,424,48,1.4,4.64,3.5,0,0,0,0,0,0,0.218903121961249,5476.95176270113,21.9130961491982
7.5,"max_tuv_SVM","SVM",7,14,28640,25490,3150,1500,1167,333,0.563262572010458,0.186600221483942,1.8503726501301,798,333,465,64,1.4,4.98,3.5,0,0,0,0,0,0,0.220933723354976,5651.33359579958,22.1615517172546
7.5,"max_tuv_SVM","SVM",7,15,28540,25402,3138,1600,1255,345,0.56343997622366,0.203765227021041,1.85199578403373,824,345,479,26,1.4,5.31,3.6,0,0,0,0,0,0,0.213067464506375,5231.70249226967,21.3299579840554
7.5,"max_tuv_SVM","SVM",7,16,28440,25324,3116,1700,1333,367,0.563965802311601,0.20265780730897,1.90221387224535,888,367,521,64,1.4,5.64,3.6,0,0,0,0,0,0,0.214975850673421,5445.34729284621,21.6387659809397
7.5,"max_tuv_SVM","SVM",7,17,28340,25247,3093,1800,1410,390,0.562387447462261,0.198781838316722,1.91846573968667,945,390,555,57,1.4,5.97,3.6,0,0,0,0,0,0,0.215158482573625,5385.73198686202,21.5232914072898
7.5,"max_tuv_SVM","SVM",7,18,28240,25163,3077,1900,1494,406,0.562599831612096,0.196013289036545,1.90888245724884,997,406,591,52,1.5,6.3,3.7,0,0,0,0,0,0,0.21302205943213,5478.49885557884,21.3106712076752
7.5,"max_tuv_SVM","SVM",7,19,28140,25080,3060,2000,1577,423,0.561576605852501,0.196013289036545,1.84390846619952,1034,423,611,37,1.4,6.64,3.7,0,0,0,0,0,0,0.210272664418385,5336.0707118554,21.0377232699487
7.5,"max_tuv_SVM","SVM",7,20,28040,24988,3052,2100,1669,431,0.563403159631657,0.210963455149502,1.93136657526827,1039,431,608,5,1.4,6.97,3.9,0,0,0,0,0,0,0.203990291357631,5309.34821226726,20.4070245551809
7.5,"max_tuv_SVM","SVM",7,21,27940,24916,3024,2200,1741,459,0.561564792819009,0.205980066445183,1.96266510007293,1117,459,658,78,1.4,7.3,3.8,0,0,0,0,0,0,0.2077739616695,5294.46412315224,20.7921329945616
7.5,"max_tuv_SVM","SVM",7,22,27840,24824,3016,2300,1833,467,0.562979685339183,0.211517165005537,1.99315347209506,1149,467,682,32,1.5,7.63,3.9,0,0,0,0,0,0,0.201354354924401,4939.16572042,20.1525756185972
7.5,"max_tuv_SVM","SVM",7,23,27740,24733,3007,2400,1924,476,0.561053618231973,0.212624584717608,1.94643134238738,1165,476,689,16,1.4,7.96,4,0,0,0,0,0,0,0.19660555742872,4331.67524288927,19.6994071986096
7.5,"max_tuv_SVM","SVM",7,24,27640,24649,2991,2500,2008,492,0.561123536363059,0.206533776301218,1.86251968397505,1222,492,730,57,1.5,8.29,4.1,0,0,0,0,0,0,0.195665725819647,4676.51955653159,19.5808165508242
7.5,"max_tuv_SVM","SVM",7,25,27540,24554,2986,2600,2103,497,0.561361466719593,0.210409745293466,1.98028414721894,1197,497,700,-25,1.4,8.63,4.2,0,0,0,0,0,0,0.188064518642217,4029.98565885921,18.8349595568277
7.5,"max_tuv_SVM","SVM",7,26,27440,24476,2964,2700,2181,519,0.560875504401919,0.212624584717608,1.96051927829119,1253,519,734,56,1.4,8.96,4.2,0,0,0,0,0,0,0.188787319723569,3838.38440920987,18.9115679350907
7.5,"max_tuv_SVM","SVM",7,27,27340,24392,2948,2800,2265,535,0.558850508356991,0.209302325581395,1.81570087909271,1301,535,766,48,1.4,9.29,4.2,0,0,0,0,0,0,0.189225069673848,4329.34104250697,18.9364980514905
7.5,"max_tuv_SVM","SVM",7,28,27240,24299,2941,2900,2358,542,0.559214667028989,0.207087486157254,1.85848481771098,1335,542,793,34,1.5,9.62,4.4,0,0,0,0,0,0,0.185478141306685,4652.40091856113,18.556461972858
7.5,"max_tuv_SVM","SVM",7,29,27140,24209,2931,3000,2448,552,0.557607760536865,0.20874861572536,1.81035892075871,1343,552,791,8,1.4,9.95,4.4,0,0,0,0,0,0,0.18279678729247,4061.02407657113,18.2905689932366
7.5,"max_tuv_SVM","SVM",7,30,27040,24133,2907,3100,2524,576,0.558538986558605,0.209856035437431,1.95029936893433,1400,576,824,57,1.4,10.29,4.4,0,0,0,0,0,0,0.183679238746496,4187.6334196251,18.3771113826526
7.5,"max_tuv_SVM","SVM",7,31,26940,24056,2884,3200,2601,599,0.556584367808606,0.200442967884828,1.80626866673378,1419,599,820,19,1.4,10.62,4.3,0,0,0,0,0,0,0.184277490071462,3802.6974450179,18.4425674669602
7.5,"max_tuv_SVM","SVM",7,32,26840,23966,2874,3300,2691,609,0.559038264627813,0.213732004429679,1.94691636916167,1465,609,856,46,1.4,10.95,4.4,0,0,0,0,0,0,0.183233102010701,4159.8795693842,18.3298489718018
7.5,"max_tuv_SVM","SVM",7,33,26740,23882,2858,3400,2775,625,0.556277521133016,0.207087486157254,1.8552379228025,1495,625,870,30,1.4,11.28,4.4,0,0,0,0,0,0,0.181763744904015,3840.36120113302,18.2180816577933
7.5,"max_tuv_SVM","SVM",7,34,26640,23797,2843,3500,2860,640,0.555469351021989,0.203765227021041,1.77583085217671,1558,640,918,63,1.4,11.61,4.5,0,0,0,0,0,0,0.181315223819001,4037.58401799929,18.1697214413545
7.5,"max_tuv_SVM","SVM",7,35,26540,23709,2831,3600,2948,652,0.552242848418742,0.207641196013289,1.84558986667742,1567,652,915,9,1.4,11.94,4.5,0,0,0,0,0,0,0.183931613031374,4008.27604594337,18.734767439371
7.5,"max_tuv_SVM","SVM",7,36,26440,23620,2820,3700,3037,663,0.550878672632459,0.20874861572536,1.78613988419115,1593,663,930,26,1.4,12.28,4.6,0,0,0,0,0,0,0.177557692124157,3958.28262547075,17.8394879442257
7.5,"max_tuv_SVM","SVM",7,37,26340,23528,2812,3800,3129,671,0.554737986499748,0.207087486157254,1.77736836806604,1652,671,981,59,1.5,12.61,4.7,0,0,0,0,0,0,0.174756142812441,3706.43798954598,17.5112316581164
7.5,"max_tuv_SVM","SVM",7,38,26240,23447,2793,3900,3210,690,0.551410342623882,0.199889258028793,1.64436302217916,1652,690,962,0,1.4,12.94,4.7,0,0,0,0,0,0,0.174214239324927,3412.37886795907,17.4469719596061
7.5,"max_tuv_SVM","SVM",7,39,26140,23357,2783,4000,3300,700,0.551801299767615,0.200442967884828,1.69936385742883,1683,700,983,31,1.4,13.27,4.7,0,0,0,0,0,0,0.173500533427487,3864.96843952332,17.3679449105488
7.5,"max_tuv_SVM","SVM",7,40,26040,23263,2777,4100,3394,706,0.5509700462378,0.197674418604651,1.63555425006077,1731,706,1025,48,1.5,13.6,4.8,0,0,0,0,0,0,0.170316979412576,3801.60021710955,17.0504669305136
7.5,"max_tuv_SVM","SVM",7,41,25940,23170,2770,4200,3487,713,0.552437408662915,0.212624584717608,1.91796593988046,1719,713,1006,-12,1.4,13.93,4.9,0,0,0,0,0,0,0.167100920257412,3409.72761292889,16.7353907616878
7.5,"max_tuv_SVM","SVM",7,42,25840,23088,2752,4300,3569,731,0.550302380263631,0.188261351052049,1.57424596323753,1773,731,1042,54,1.4,14.27,4.9,0,0,0,0,0,0,0.167025385946028,3406.39029220441,16.716860500029
7.5,"max_tuv_SVM","SVM",7,43,25740,22999,2741,4400,3658,742,0.551505556508666,0.204872646733112,1.76861202757437,1827,742,1085,54,1.5,14.6,4.9,0,0,0,0,0,0,0.166968802456342,3615.86332430271,16.7099362248837
7.5,"max_tuv_SVM","SVM",7,44,25640,22907,2733,4500,3750,750,0.550191137386417,0.192691029900332,1.54832469005753,1793,750,1043,-34,1.4,14.93,5,0,0,0,0,0,0,0.164919642877927,3573.00776436227,16.5024215896217
7.5,"max_tuv_SVM","SVM",7,45,25540,22824,2716,4600,3833,767,0.550849244404148,0.205980066445183,1.73430064037749,1844,767,1077,51,1.4,15.26,5,0,0,0,0,0,0,0.164599731732186,3341.73444352422,16.4830977891909
7.5,"max_tuv_SVM","SVM",7,46,25440,22736,2704,4700,3921,779,0.550591570002238,0.197674418604651,1.5669577874818,1870,779,1091,26,1.4,15.59,5,0,0,0,0,0,0,0.163672312125208,3506.96995180733,16.5989533983687
7.5,"max_tuv_SVM","SVM",7,47,25340,22657,2683,4800,4000,800,0.548895293528836,0.188815060908084,1.47134842921257,1911,800,1111,41,1.4,15.93,5,0,0,0,0,0,0,0.165052162573082,3634.898244135,16.5186769184215
7.5,"max_tuv_SVM","SVM",7,48,25240,22576,2664,4900,4081,819,0.548950685385527,0.187153931339978,1.59579083367333,1977,819,1158,66,1.4,16.26,5,0,0,0,0,0,0,0.165500790764557,3534.83245951032,16.5721790522253
7.5,"max_tuv_SVM","SVM",8,0,30040,26552,3488,100,86,14,0.399367348613486,0.0861779518746503,0.684625856181052,46,14,32,0,2.3,0.33,6.1,0,0,0,0,0,0,0.208015973736309,4064.62572318119,21.5367078777033
7.5,"max_tuv_SVM","SVM",8,1,29940,26457,3483,200,181,19,0.58958018760068,0.187465025181869,1.71171536981178,59,19,40,13,2.1,0.66,9.5,0,0,0,0,0,0,0.304825881027286,3369.27117260328,34.2666049021731
7.5,"max_tuv_SVM","SVM",8,2,29840,26404,3436,300,234,66,0.591558744972503,0.158365976496922,1.41549592202226,148,66,82,89,1.2,1,3.5,0,0,0,0,0,0,0.41078671009589,5113.06292921117,46.9446775850947
7.5,"max_tuv_SVM","SVM",8,3,29740,26324,3416,400,314,86,0.607258510096766,0.198656966983772,1.82330372433312,194,86,108,46,1.3,1.33,3.7,0,0,0,0,0,0,0.38503630041477,6039.58555492176,44.3706434692953
7.5,"max_tuv_SVM","SVM",8,4,29640,26243,3397,500,395,105,0.558187776586464,0.160044767767208,1.27073241273017,255,105,150,61,1.4,1.66,3.8,0,0,0,0,0,0,0.318664452139836,5998.42944554367,34.2120672190009
7.5,"max_tuv_SVM","SVM",8,5,29540,26169,3371,600,469,131,0.56563411651651,0.162283156127588,1.51299634220443,320,131,189,65,1.4,1.99,3.6,0,0,0,0,0,0,0.248770913312994,6274.52816206906,25.5938154108026
7.5,"max_tuv_SVM","SVM",8,6,29440,26099,3341,700,539,161,0.554640797138556,0.153329602686066,1.32393537017614,386,161,225,66,1.4,2.32,3.3,0,0,0,0,0,0,0.367048033395408,6346.84932875033,37.4416249705707
7.5,"max_tuv_SVM","SVM",8,7,29340,26008,3332,800,630,170,0.564692692565177,0.175153889199776,1.54056318193467,412,170,242,26,1.4,2.65,3.7,0,0,0,0,0,0,0.401762313439045,5736.1475377315,43.4441268693991
7.5,"max_tuv_SVM","SVM",8,8,29240,25920,3320,900,718,182,0.570289337476483,0.143256855064354,1.21306467562533,443,182,261,31,1.4,2.99,3.9,0,0,0,0,0,0,0.297653826714596,5113.73872129495,35.3775605198347
7.5,"max_tuv_SVM","SVM",8,9,29140,25832,3308,1000,806,194,0.549981321488277,0.153329602686066,1.30136187707851,475,194,281,32,1.4,3.32,4.2,0,0,0,0,0,0,0.265439093158996,4825.75475068427,28.9070656892661
7.5,"max_tuv_SVM","SVM",8,10,29040,25738,3302,1100,900,200,0.57260759606291,0.19082260772244,1.77512554279696,505,200,305,30,1.5,3.65,4.5,0,0,0,0,0,0,0.195701820934655,5002.80403514928,20.0292924250939
7.5,"max_tuv_SVM","SVM",8,11,28940,25661,3279,1200,977,223,0.594698790673793,0.174594292109681,1.40444425392568,573,223,350,68,1.6,3.98,4.4,0,0,0,0,0,0,0.517200116146888,4676.38045874182,61.2966750342345
7.5,"max_tuv_SVM","SVM",8,12,28840,25578,3262,1300,1060,240,0.576782163394605,0.19082260772244,1.55025570683215,609,240,369,36,1.5,4.31,4.4,0,0,0,0,0,0,0.207711818029011,4557.91575063231,21.6757823569397
7.5,"max_tuv_SVM","SVM",8,13,28740,25491,3249,1400,1147,253,0.565714239496441,0.175153889199776,1.53272463843592,656,253,403,47,1.6,4.64,4.5,0,0,0,0,0,0,0.20143251764926,4818.75768327146,21.0259959060307
7.5,"max_tuv_SVM","SVM",8,14,28640,25418,3222,1500,1220,280,0.569905109453385,0.170677112479015,1.4731332305369,717,280,437,61,1.6,4.98,4.4,0,0,0,0,0,0,0.197710991584066,5072.07584608038,20.1659935020154
7.5,"max_tuv_SVM","SVM",8,15,28540,25339,3201,1600,1299,301,0.575086058483537,0.158925573587017,1.25435425776031,776,301,475,59,1.6,5.31,4.3,0,0,0,0,0,0,0.568442956277245,4613.53969349918,63.8989873348729
7.5,"max_tuv_SVM","SVM",8,16,28440,25256,3184,1700,1382,318,0.565242685007838,0.17011751538892,1.38626020590476,823,318,505,47,1.6,5.64,4.3,0,0,0,0,0,0,0.224832611892256,4850.48024159674,26.3229033768977
7.5,"max_tuv_SVM","SVM",8,17,28340,25183,3157,1800,1455,345,0.562423931613568,0.167319529938444,1.39708097073836,889,345,544,66,1.6,5.97,4.2,0,0,0,0,0,0,0.205874696101383,4798.41162015995,21.0926001311787
7.5,"max_tuv_SVM","SVM",8,18,28240,25091,3149,1900,1547,353,0.569101309989659,0.176832680470062,1.5623176794686,901,353,548,12,1.6,6.3,4.4,0,0,0,0,0,0,0.193141387046676,4645.44809014693,20.1795967314102
7.5,"max_tuv_SVM","SVM",8,19,28140,25019,3121,2000,1619,381,0.576344098795094,0.204252937884723,1.79110090901775,970,381,589,69,1.5,6.64,4.2,0,0,0,0,0,0,0.212238280526394,4129.54880078418,21.8781400200573
7.5,"max_tuv_SVM","SVM",8,20,28040,24936,3104,2100,1702,398,0.575519152256751,0.185226636821489,1.72459450143528,1032,398,634,62,1.6,6.97,4.3,0,0,0,0,0,0,0.209211241962642,4247.71360409887,21.4162828696964
7.5,"max_tuv_SVM","SVM",8,21,27940,24859,3081,2200,1779,421,0.595515480585383,0.212087297146055,1.81409437882512,1053,421,632,21,1.5,7.3,4.2,0,0,0,0,0,0,0.348533140728491,4173.40821545645,54.6501029231365
7.5,"max_tuv_SVM","SVM",8,22,27840,24785,3055,2300,1853,447,0.596872895297379,0.192501398992725,1.6823104162903,1124,447,677,71,1.5,7.63,4.1,0,0,0,0,0,0,0.194297416649739,5397.44384535837,19.6521700219267
7.5,"max_tuv_SVM","SVM",8,23,27740,24701,3039,2400,1937,463,0.59443487349753,0.207610520425294,1.82645006380566,1159,463,696,35,1.5,7.96,4.2,0,0,0,0,0,0,0.194898320341869,5327.81703212916,19.6869562094344
7.5,"max_tuv_SVM","SVM",8,24,27640,24611,3029,2500,2027,473,0.587157583787495,0.195299384443201,1.61199939518785,1169,473,696,10,1.5,8.29,4.3,0,0,0,0,0,0,0.189453242003969,5198.4269448652,18.9808434271489
7.5,"max_tuv_SVM","SVM",8,25,27540,24533,3007,2600,2105,495,0.60402511396252,0.191382204812535,1.60886551926515,1217,495,722,48,1.5,8.63,4.3,0,0,0,0,0,0,0.190701049584201,5234.5538739721,19.0799989886667
7.5,"max_tuv_SVM","SVM",8,26,27440,24451,2989,2700,2187,513,0.610606530115544,0.209848908785674,1.96165572332912,1279,513,766,62,1.5,8.96,4.3,0,0,0,0,0,0,0.1899034525485,5115.85821377231,19.0070144071856
7.5,"max_tuv_SVM","SVM",8,27,27340,24374,2966,2800,2264,536,0.611229484178202,0.200335758254057,1.92096697998102,1338,536,802,59,1.5,9.29,4.2,0,0,0,0,0,0,0.192070189829045,5157.72992282363,19.2564831200486
7.5,"max_tuv_SVM","SVM",8,28,27240,24288,2952,2900,2350,550,0.606504840152544,0.205372132064913,1.90736566718376,1367,550,817,29,1.5,9.62,4.3,0,0,0,0,0,0,0.19016024891494,5143.84909530305,19.1020895554035
7.5,"max_tuv_SVM","SVM",8,29,27140,24196,2944,3000,2442,558,0.604748411315495,0.188024622271964,1.48531442241311,1388,558,830,21,1.5,9.95,4.4,0,0,0,0,0,0,0.185798330820514,5008.72710627339,18.5818326872648
7.5,"max_tuv_SVM","SVM",8,30,27040,24107,2933,3100,2531,569,0.604435670514766,0.188584219362059,1.64453272677322,1445,569,876,57,1.5,10.29,4.4,0,0,0,0,0,0,0.183426446478679,4918.12755862579,18.3450521702118
7.5,"max_tuv_SVM","SVM",8,31,26940,24020,2920,3200,2618,582,0.602614957940912,0.19194180190263,1.59399596551651,1466,582,884,21,1.5,10.62,4.5,0,0,0,0,0,0,0.181858660439838,4894.37599791077,18.1859677860199
7.5,"max_tuv_SVM","SVM",8,32,26840,23938,2902,3300,2700,600,0.605439819553947,0.208170117515389,1.95123880985639,1512,600,912,46,1.5,10.95,4.5,0,0,0,0,0,0,0.181681943446322,4842.67591261811,18.1928706359888
7.5,"max_tuv_SVM","SVM",8,33,26740,23863,2877,3400,2775,625,0.608728821541784,0.216004476776721,1.92500194003298,1588,625,963,76,1.5,11.28,4.4,0,0,0,0,0,0,0.183621467228182,4852.27683586577,18.3651973974122
7.5,"max_tuv_SVM","SVM",8,34,26640,23790,2850,3500,2848,652,0.604431710703976,0.204812534974818,1.70552725602262,1622,652,970,34,1.5,11.61,4.4,0,0,0,0,0,0,0.186282639483335,4938.07648904862,18.6290115905985
7.5,"max_tuv_SVM","SVM",8,35,26540,23726,2814,3600,2912,688,0.605128890156035,0.205372132064913,1.79938177383056,1702,688,1014,80,1.5,11.94,4.2,0,0,0,0,0,0,0.190928051036733,5032.50031130012,19.0939736696633
7.5,"max_tuv_SVM","SVM",8,36,26440,23649,2791,3700,2989,711,0.607470444225056,0.202014549524342,1.76823651595528,1786,711,1075,84,1.5,12.28,4.2,0,0,0,0,0,0,0.192069241819465,5019.57660546295,19.2323171837159
7.5,"max_tuv_SVM","SVM",8,37,26340,23572,2768,3800,3066,734,0.604938987740942,0.209848908785674,1.74142699167862,1788,734,1054,2,1.4,12.61,4.2,0,0,0,0,0,0,0.19307591448987,5068.86943018125,19.3088337977579
7.5,"max_tuv_SVM","SVM",8,38,26240,23479,2761,3900,3159,741,0.603459703533179,0.19194180190263,1.61821839183307,1860,741,1119,72,1.5,12.94,4.3,0,0,0,0,0,0,0.190030593514454,4957.37694920704,19.0050142933714
7.5,"max_tuv_SVM","SVM",8,39,26140,23403,2737,4000,3235,765,0.606409383437237,0.21152770005596,1.82409883797851,1849,765,1084,-11,1.4,13.27,4.2,0,0,0,0,0,0,0.191109935210084,4968.96705305306,19.1131569309989
7.5,"max_tuv_SVM","SVM",8,40,26040,23320,2720,4100,3318,782,0.606462756631536,0.197537772803581,1.80465100081053,1952,782,1170,103,1.5,13.6,4.2,0,0,0,0,0,0,0.190539087134947,4916.24066055018,19.055360653435
7.5,"max_tuv_SVM","SVM",8,41,25940,23240,2700,4200,3398,802,0.603426634900558,0.205372132064913,1.61961823473258,1985,802,1183,33,1.5,13.93,4.2,0,0,0,0,0,0,0.190758766179424,4900.30278190454,19.078978796263
7.5,"max_tuv_SVM","SVM",8,42,25840,23157,2683,4300,3481,819,0.608379010171999,0.216564073866816,1.98136419507212,2020,819,1201,35,1.5,14.27,4.3,0,0,0,0,0,0,0.190305662884069,4872.65178194221,19.0322106834307
7.5,"max_tuv_SVM","SVM",8,43,25740,23065,2675,4400,3573,827,0.613171350111807,0.208170117515389,1.91674721473267,2054,827,1227,34,1.5,14.6,4.3,0,0,0,0,0,0,0.187859852006109,4818.96316455189,18.7997781315986
7.5,"max_tuv_SVM","SVM",8,44,25640,22979,2661,4500,3659,841,0.605702262332578,0.21376608841634,1.79362282767518,2032,841,1191,-22,1.4,14.93,4.4,0,0,0,0,0,0,0.186848285015784,4775.18829590292,18.6869699794578
7.5,"max_tuv_SVM","SVM",8,45,25540,22893,2647,4600,3745,855,0.605766503943717,0.216004476776721,1.88310838437854,2075,855,1220,43,1.4,15.26,4.4,0,0,0,0,0,0,0.185839587738228,4733.42613423971,18.5849431641488
7.5,"max_tuv_SVM","SVM",8,46,25440,22814,2626,4700,3824,876,0.602010918293606,0.208170117515389,1.77357656762872,2147,876,1271,72,1.5,15.59,4.4,0,0,0,0,0,0,0.186405875584108,4723.69880249905,18.6488513235706
7.5,"max_tuv_SVM","SVM",8,47,25340,22724,2616,4800,3914,886,0.597679095922966,0.190263010632345,1.60537897640486,2183,886,1297,36,1.5,15.93,4.4,0,0,0,0,0,0,0.1843862635967,4622.23307422001,18.4551767542143
7.5,"max_tuv_SVM","SVM",8,48,25240,22636,2604,4900,4002,898,0.596317763525825,0.194739787353106,1.69998417893044,2164,898,1266,-19,1.4,16.26,4.5,0,0,0,0,0,0,0.18307938970603,4591.29899543762,18.3097956798824
7.5,"max_tuv_SVM","SVM",9,0,30040,26597,3443,100,89,11,0.398841941266614,0,0.631210719964546,40,11,29,0,2.6,0.33,8.1,0,0,0,0,0,0,0.121547544820757,3343.3127429528,12.1960479657434
7.5,"max_tuv_SVM","SVM",9,1,29940,26504,3436,200,182,18,0.429638204945145,0.108446866485014,0.981759668649294,68,18,50,28,2.8,0.66,10.1,0,0,0,0,0,0,0.095306462749618,2705.47451207124,9.62481751359382
7.5,"max_tuv_SVM","SVM",9,2,29840,26421,3419,300,265,35,0.406685177819885,0.0779291553133515,0.642888331308309,119,35,84,51,2.4,1,7.6,0,0,0,0,0,0,0.123692234520589,3476.61047073239,12.4072088472834
7.5,"max_tuv_SVM","SVM",9,3,29740,26326,3414,400,360,40,0.419150232665761,0.0762942779291553,0.640169135233369,142,40,102,23,2.5,1.33,9,0,0,0,0,0,0,0.114346386672894,2866.50709064616,11.6010672860489
7.5,"max_tuv_SVM","SVM",9,4,29640,26230,3410,500,456,44,0.569421024157547,0.190735694822888,1.68492118419715,159,44,115,17,2.6,1.66,10.4,0,0,0,0,0,0,0.114368106562037,2665.34243849133,11.9695529886567
7.5,"max_tuv_SVM","SVM",9,5,29540,26140,3400,600,546,54,0.576780483908555,0.184741144414169,1.681933735289,194,54,140,35,2.6,1.99,10.1,0,0,0,0,0,0,0.092618135572635,2665.67877662647,9.30366693441248
7.5,"max_tuv_SVM","SVM",9,6,29440,26056,3384,700,630,70,0.479554521851476,0.13841961852861,1.31497418999478,249,70,179,55,2.6,2.32,9,0,0,0,0,0,0,0.10597564092417,2943.39301716745,10.6447816954008
7.5,"max_tuv_SVM","SVM",9,7,29340,25990,3350,800,696,104,0.505989033294551,0.129155313351499,1.08143745091004,268,104,164,19,1.6,2.65,6.7,0,0,0,0,0,0,0.131422693176244,3814.42573921212,13.1826144555398
7.5,"max_tuv_SVM","SVM",9,8,29240,25901,3339,900,785,115,0.514119612682115,0.138964577656676,0.992869996972449,323,115,208,55,1.8,2.99,6.8,0,0,0,0,0,0,0.171945968591218,3605.72180779856,18.5197597502541
7.5,"max_tuv_SVM","SVM",9,9,29140,25812,3328,1000,874,126,0.504789555032391,0.13133514986376,1.18053957681569,368,126,242,45,1.9,3.32,6.9,0,0,0,0,0,0,0.167794671421841,3344.97880477295,17.9019390342123
7.5,"max_tuv_SVM","SVM",9,10,29040,25727,3313,1100,959,141,0.519013581158802,0.145504087193461,1.15769464896516,403,141,262,35,1.9,3.65,6.8,0,0,0,0,0,0,0.156478860962629,3235.65461657225,17.2629313528419
7.5,"max_tuv_SVM","SVM",9,11,28940,25642,3298,1200,1044,156,0.532923914054895,0.137874659400545,1.24792366720906,456,156,300,53,1.9,3.98,6.7,0,0,0,0,0,0,0.156514558723767,3306.09483837103,16.8281093734337
7.5,"max_tuv_SVM","SVM",9,12,28840,25570,3270,1300,1116,184,0.529415029442456,0.168392370572207,1.50053606085457,529,184,345,73,1.9,4.31,6.1,0,0,0,0,0,0,0.184126977165385,3642.59626167254,21.0027517551674
7.5,"max_tuv_SVM","SVM",9,13,28740,25490,3250,1400,1196,204,0.517379403707008,0.152043596730245,1.31176062416437,554,204,350,25,1.7,4.64,5.9,0,0,0,0,0,0,0.151582831060145,3890.80564663184,15.4630331038056
7.5,"max_tuv_SVM","SVM",9,14,28640,25404,3236,1500,1282,218,0.518765763918567,0.147683923705722,1.40670042075123,620,218,402,66,1.8,4.98,5.9,0,0,0,0,0,0,0.157127531866096,3631.39436576706,16.2798374449049
7.5,"max_tuv_SVM","SVM",9,15,28540,25329,3211,1600,1357,243,0.521627005203382,0.167847411444142,1.54718213915646,647,243,404,27,1.7,5.31,5.6,0,0,0,0,0,0,0.235532727393572,3535.77773914818,30.6446233130227
7.5,"max_tuv_SVM","SVM",9,16,28440,25265,3175,1700,1421,279,0.48340587926743,0.148773841961853,1.28306706652782,745,279,466,98,1.7,5.64,5.1,0,0,0,0,0,0,0.169921985801062,4165.68399434512,17.201729749561
7.5,"max_tuv_SVM","SVM",9,17,28340,25176,3164,1800,1510,290,0.475879835606462,0.143324250681199,1.26968977768363,795,290,505,50,1.7,5.97,5.2,0,0,0,0,0,0,0.167085307863793,3712.52133087343,17.6160404676555
7.5,"max_tuv_SVM","SVM",9,18,28240,25088,3152,1900,1598,302,0.494090141411046,0.147683923705722,1.37979727520436,814,302,512,19,1.7,6.3,5.3,0,0,0,0,0,0,0.165727313216662,3738.78507719208,17.4258574013828
7.5,"max_tuv_SVM","SVM",9,19,28140,25005,3135,2000,1681,319,0.487222981168527,0.150408719346049,1.41378645048826,874,319,555,60,1.7,6.64,5.3,0,0,0,0,0,0,0.163894620889228,3786.49237303464,16.517666759136
7.5,"max_tuv_SVM","SVM",9,20,28040,24911,3129,2100,1775,325,0.482119074145899,0.146049046321526,1.31554628535603,895,325,570,21,1.8,6.97,5.5,0,0,0,0,0,0,0.153245475220438,3506.86137572362,15.5130856066913
7.5,"max_tuv_SVM","SVM",9,21,27940,24825,3115,2200,1861,339,0.492547819792938,0.148228882833787,1.43402966999697,928,339,589,33,1.7,7.3,5.5,0,0,0,0,0,0,0.155442084327196,3817.3378188147,15.7995304401962
7.5,"max_tuv_SVM","SVM",9,22,27840,24737,3103,2300,1949,351,0.490993393461643,0.147683923705722,1.3943983045716,967,351,616,39,1.8,7.63,5.6,0,0,0,0,0,0,0.152059696229378,3335.6213940172,15.4054575846863
7.5,"max_tuv_SVM","SVM",9,23,27740,24650,3090,2400,2036,364,0.49074742898363,0.15149863760218,1.34568703429166,1016,364,652,49,1.8,7.96,5.6,0,0,0,0,0,0,0.148573763023571,3215.69908640548,14.9453787713766
7.5,"max_tuv_SVM","SVM",9,24,27640,24558,3082,2500,2128,372,0.497454140017769,0.161307901907357,1.36274103260275,1020,372,648,4,1.7,8.29,5.7,0,0,0,0,0,0,0.160397266870981,3371.92202422687,18.2718166376698
7.5,"max_tuv_SVM","SVM",9,25,27540,24476,3064,2600,2210,390,0.509442458557824,0.170027247956403,1.63096604634085,1087,390,697,67,1.8,8.63,5.7,0,0,0,0,0,0,0.14847751431494,3154.06573616736,16.6201967174905
7.5,"max_tuv_SVM","SVM",9,26,27440,24395,3045,2700,2291,409,0.502391916027876,0.157493188010899,1.42233606458201,1126,409,717,39,1.8,8.96,5.6,0,0,0,0,0,0,0.149300366871649,3101.69682167961,15.0206289099532
7.5,"max_tuv_SVM","SVM",9,27,27340,24312,3028,2800,2374,426,0.496044723209677,0.162942779291553,1.47488390835476,1181,426,755,55,1.8,9.29,5.6,0,0,0,0,0,0,0.151106372992513,3247.85200627686,15.1721925814493
7.5,"max_tuv_SVM","SVM",9,28,27240,24223,3017,2900,2463,437,0.50402761686195,0.166757493188011,1.59314818881941,1163,437,726,-18,1.7,9.62,5.6,0,0,0,0,0,0,0.14822362695416,3260.02228991087,14.9137948592574
7.5,"max_tuv_SVM","SVM",9,29,27140,24143,2997,3000,2543,457,0.498576172819073,0.156403269754768,1.47001681463383,1271,457,814,108,1.8,9.95,5.6,0,0,0,0,0,0,0.151343020479645,3237.96298413521,15.2803868482283
7.5,"max_tuv_SVM","SVM",9,30,27040,24057,2983,3100,2629,471,0.494925613655435,0.158038147138965,1.61917079680219,1289,471,818,18,1.7,10.29,5.6,0,0,0,0,0,0,0.148239289822456,3129.55213539317,14.8967338615667
7.5,"max_tuv_SVM","SVM",9,31,26940,23966,2974,3200,2720,480,0.502785607413684,0.160762942779292,1.50852471778902,1310,480,830,21,1.7,10.62,5.7,0,0,0,0,0,0,0.146879164230201,3164.51111241324,14.7857992040202
7.5,"max_tuv_SVM","SVM",9,32,26840,23879,2961,3300,2807,493,0.497373318412421,0.155858310626703,1.51389791357812,1362,493,869,52,1.8,10.95,5.7,0,0,0,0,0,0,0.147136690881525,3035.31908436855,14.7963272774541
7.5,"max_tuv_SVM","SVM",9,33,26740,23790,2950,3400,2896,504,0.502072664510875,0.174386920980926,1.62520291543505,1370,504,866,8,1.7,11.28,5.7,0,0,0,0,0,0,0.144731195448791,3177.6054458994,14.5501324449675
7.5,"max_tuv_SVM","SVM",9,34,26640,23703,2937,3500,2983,517,0.496168281863599,0.153133514986376,1.37366638523238,1335,517,818,-35,1.6,11.61,5.8,0,0,0,0,0,0,0.14782761714685,3338.46586770783,29.9879010817764
7.5,"max_tuv_SVM","SVM",9,35,26540,23618,2922,3600,3068,532,0.507998992097352,0.156403269754768,1.33008270839864,1408,532,876,73,1.6,11.94,5.8,0,0,0,0,0,0,0.147433704684126,3885.14408477808,15.0371022321176
7.5,"max_tuv_SVM","SVM",9,36,26440,23528,2912,3700,3158,542,0.520100782030348,0.162397820163488,1.51045131385261,1393,542,851,-15,1.6,12.28,5.8,0,0,0,0,0,0,0.146409156934697,3814.94446728875,14.6799256653076
7.5,"max_tuv_SVM","SVM",9,37,26340,23444,2896,3800,3242,558,0.515125415533395,0.166757493188011,1.4706811046265,1434,558,876,41,1.6,12.61,5.8,0,0,0,0,0,0,0.146610449351065,3834.74865353305,14.6648830457081
7.5,"max_tuv_SVM","SVM",9,38,26240,23362,2878,3900,3324,576,0.512509438794203,0.167302452316076,1.41253309370592,1512,576,936,78,1.6,12.94,5.8,0,0,0,0,0,0,0.1474064369039,3821.22415367338,14.7436594577299
7.5,"max_tuv_SVM","SVM",9,39,26140,23268,2872,4000,3418,582,0.503626349737279,0.141144414168937,1.24572274363373,1508,582,926,-4,1.6,13.27,5.9,0,0,0,0,0,0,0.145506429110134,3793.37124719031,14.551504760133
7.5,"max_tuv_SVM","SVM",9,40,26040,23175,2865,4100,3511,589,0.515818183914235,0.161307901907357,1.34841595835536,1514,589,925,6,1.6,13.6,6,0,0,0,0,0,0,0.143383346518726,3690.76349904296,14.344712304487
7.5,"max_tuv_SVM","SVM",9,41,25940,23082,2858,4200,3604,596,0.505419905912615,0.156403269754768,1.41730124665429,1524,596,928,10,1.6,13.93,6,0,0,0,0,0,0,0.141607027477733,3648.77039919991,14.1624628748038
7.5,"max_tuv_SVM","SVM",9,42,25840,22995,2845,4300,3691,609,0.517166336051534,0.168392370572207,1.44678794108235,1598,609,989,74,1.6,14.27,6.1,0,0,0,0,0,0,0.141299678371006,3622.05443134206,14.1362659017494
7.5,"max_tuv_SVM","SVM",9,43,25740,22902,2838,4400,3784,616,0.517035284003742,0.161307901907357,1.39315994018033,1582,616,966,-16,1.6,14.6,6.1,0,0,0,0,0,0,0.139706321436276,3569.13052177488,13.9731414912239
7.5,"max_tuv_SVM","SVM",9,44,25640,22808,2832,4500,3878,622,0.50530680507212,0.15149863760218,1.29145588815821,1596,622,974,14,1.6,14.93,6.2,0,0,0,0,0,0,0.137826192824829,3479.06743645331,13.787926509617
7.5,"max_tuv_SVM","SVM",9,45,25540,22721,2819,4600,3965,635,0.51044080918772,0.150953678474114,1.16181455874795,1654,635,1019,58,1.6,15.26,6.2,0,0,0,0,0,0,0.137722162991934,3491.11526102755,13.7750372950976
7.5,"max_tuv_SVM","SVM",9,46,25440,22632,2808,4700,4054,646,0.521607489441312,0.175476839237057,1.48998336186733,1669,646,1023,15,1.6,15.59,6.3,0,0,0,0,0,0,0.137024632112295,3433.00173794204,13.7106751481891
7.5,"max_tuv_SVM","SVM",9,47,25340,22539,2801,4800,4147,653,0.519451285940495,0.156948228882834,1.33972210949427,1668,653,1015,-1,1.6,15.93,6.4,0,0,0,0,0,0,0.135749694124372,3100.32918276191,13.605719367788
7.5,"max_tuv_SVM","SVM",9,48,25240,22451,2789,4900,4235,665,0.515378544025335,0.163487738419619,1.35541446791134,1698,665,1033,30,1.6,16.26,6.4,0,0,0,0,0,0,0.135436234088777,3390.89358035033,13.5457066059725
7.5,"max_tuv_SVM","SVM",10,0,30040,26493,3547,100,88,12,0.410918533981688,0.0705202312138728,0.609577763328333,48,12,36,0,3,0.33,7.3,0,0,0,0,0,0,0.149391249621253,3561.50447692078,15.193414079784
7.5,"max_tuv_SVM","SVM",10,1,29940,26400,3540,200,181,19,0.433222241141981,0.0878612716763006,0.720393339542402,63,19,44,15,2.3,0.66,9.5,0,0,0,0,0,0,0.13982864871712,2436.19455212131,14.3698883977669
7.5,"max_tuv_SVM","SVM",10,2,29840,26302,3538,300,279,21,0.566984215290071,0.175722543352601,1.8050292569793,74,21,53,11,2.5,1,13.3,0,0,0,0,0,0,0.183518609397064,2321.77073626088,22.2856512038184
7.5,"max_tuv_SVM","SVM",10,3,29740,26245,3495,400,336,64,0.548456429460574,0.154335260115607,1.46470782789221,160,64,96,86,1.5,1.33,5.2,0,0,0,0,0,0,0.479839617140467,5052.32754586757,55.7392396577318
7.5,"max_tuv_SVM","SVM",10,4,29640,26162,3478,500,419,81,0.494054618016605,0.121387283236994,1.16728645984946,207,81,126,47,1.6,1.66,5.2,0,0,0,0,0,0,0.30265819135954,4521.84866437995,31.8918621674233
7.5,"max_tuv_SVM","SVM",10,5,29540,26078,3462,600,503,97,0.496072605072898,0.116763005780347,1.02303784116839,237,97,140,30,1.4,1.99,5.2,0,0,0,0,0,0,0.279109216832539,4130.79148235157,32.1457606763822
7.5,"max_tuv_SVM","SVM",10,6,29440,25990,3450,700,591,109,0.521049110634216,0.131791907514451,1.31758480241911,275,109,166,38,1.5,2.32,5.4,0,0,0,0,0,0,0.179608785748208,3941.70461602828,18.9684963610342
7.5,"max_tuv_SVM","SVM",10,7,29340,25901,3439,800,680,120,0.510207569953639,0.123121387283237,1.17660614019668,314,120,194,39,1.6,2.65,5.7,0,0,0,0,0,0,0.159066001050286,4224.22414720529,15.9238410790237
7.5,"max_tuv_SVM","SVM",10,8,29240,25808,3432,900,773,127,0.505585588864437,0.139306358381503,1.23446330905415,324,127,197,10,1.6,2.99,6.1,0,0,0,0,0,0,0.148562934254564,3688.63343158965,15.1609006321924
7.5,"max_tuv_SVM","SVM",10,9,29140,25715,3425,1000,866,134,0.501610490153132,0.132369942196532,1.25894097446025,351,134,217,27,1.6,3.32,6.5,0,0,0,0,0,0,0.136885605014531,3324.73492437555,13.8802019377601
7.5,"max_tuv_SVM","SVM",10,10,29040,25630,3410,1100,951,149,0.512867326720659,0.139884393063584,1.30478083931673,407,149,258,56,1.7,3.65,6.4,0,0,0,0,0,0,0.138479040018989,3504.90779073729,13.9746561571842
7.5,"max_tuv_SVM","SVM",10,11,28940,25547,3393,1200,1034,166,0.511930278818004,0.138728323699422,1.32159224167454,462,166,296,55,1.8,3.98,6.2,0,0,0,0,0,0,0.139358868718909,3494.18720486791,14.0950546664058
7.5,"max_tuv_SVM","SVM",10,12,28840,25460,3380,1300,1121,179,0.513889816823532,0.145086705202312,1.44306585160585,500,179,321,38,1.8,4.31,6.3,0,0,0,0,0,0,0.136523769409338,3205.94950387045,13.7200939340822
7.5,"max_tuv_SVM","SVM",10,13,28740,25378,3362,1400,1203,197,0.517700530287571,0.157225433526012,1.49275424891047,543,197,346,43,1.8,4.64,6.1,0,0,0,0,0,0,0.141697358766982,3449.06745005162,14.2256889645485
7.5,"max_tuv_SVM","SVM",10,14,28640,25311,3329,1500,1270,230,0.516410621695989,0.155491329479769,1.44551933839773,627,230,397,84,1.7,4.98,5.5,0,0,0,0,0,0,0.151644816762659,3393.13471461489,15.244735848572
7.5,"max_tuv_SVM","SVM",10,15,28540,25234,3306,1600,1347,253,0.514147486582495,0.152601156069364,1.39815171626347,665,253,412,38,1.6,5.31,5.3,0,0,0,0,0,0,0.155236813366258,3630.85852855698,16.0043235296077
7.5,"max_tuv_SVM","SVM",10,16,28440,25161,3279,1700,1420,280,0.517988616083328,0.15028901734104,1.53237655121225,706,280,426,41,1.5,5.64,5.1,0,0,0,0,0,0,0.162421438755598,4263.3941381428,16.4236064144951
7.5,"max_tuv_SVM","SVM",10,17,28340,25083,3257,1800,1498,302,0.519355777942133,0.150867052023121,1.46592432355757,756,302,454,50,1.5,5.97,5,0,0,0,0,0,0,0.166528975265788,3985.94563345079,18.2520262928016
7.5,"max_tuv_SVM","SVM",10,18,28240,25008,3232,1900,1573,327,0.521597465850198,0.165895953757225,1.6033547288911,816,327,489,60,1.5,6.3,4.8,0,0,0,0,0,0,0.183849407479684,3710.77852050922,18.9762197196528
7.5,"max_tuv_SVM","SVM",10,19,28140,24946,3194,2000,1635,365,0.51502643205591,0.157225433526012,1.50305096474803,884,365,519,68,1.4,6.64,4.5,0,0,0,0,0,0,0.179319975318043,4232.41326609273,18.0221060811159
7.5,"max_tuv_SVM","SVM",10,20,28040,24866,3174,2100,1715,385,0.512468755321184,0.149132947976879,1.4519267822736,944,385,559,60,1.5,6.97,4.5,0,0,0,0,0,0,0.181278129513795,4664.82518579414,18.151817293465
7.5,"max_tuv_SVM","SVM",10,21,27940,24789,3151,2200,1792,408,0.514665859038569,0.153179190751445,1.45832293549948,990,408,582,46,1.4,7.3,4.4,0,0,0,0,0,0,0.181281620198572,4804.66873722468,18.1347853118086
7.5,"max_tuv_SVM","SVM",10,22,27840,24713,3127,2300,1868,432,0.514498007576278,0.154913294797688,1.48509909891606,1035,432,603,45,1.4,7.63,4.3,0,0,0,0,0,0,0.182584768562864,4236.51963273488,18.2751018136503
7.5,"max_tuv_SVM","SVM",10,23,27740,24627,3113,2400,1954,446,0.517103084801385,0.160693641618497,1.53868514887695,1083,446,637,48,1.4,7.96,4.4,0,0,0,0,0,0,0.181982127003919,4202.2349529277,18.2106133934668
7.5,"max_tuv_SVM","SVM",10,24,27640,24534,3106,2500,2047,453,0.515203079038803,0.158381502890173,1.52070226143393,1103,453,650,20,1.4,8.29,4.5,0,0,0,0,0,0,0.178728765393234,4190.48058087491,17.885476699621
7.5,"max_tuv_SVM","SVM",10,25,27540,24451,3089,2600,2130,470,0.512350384078285,0.147398843930636,1.53463952622433,1144,470,674,41,1.4,8.63,4.5,0,0,0,0,0,0,0.177405135594348,4154.5911718173,17.7532523827941
7.5,"max_tuv_SVM","SVM",10,26,27440,24372,3068,2700,2209,491,0.514695451849291,0.155491329479769,1.54362742115404,1188,491,697,44,1.4,8.96,4.5,0,0,0,0,0,0,0.178503755461253,4090.61944332472,17.8674668962962
7.5,"max_tuv_SVM","SVM",10,27,27340,24284,3056,2800,2297,503,0.513499347701656,0.150867052023121,1.51803903505664,1232,503,729,44,1.4,9.29,4.6,0,0,0,0,0,0,0.176326567745195,4166.23173039494,17.6471821037525
7.5,"max_tuv_SVM","SVM",10,28,27240,24194,3046,2900,2387,513,0.514594671647617,0.158381502890173,1.50278236133748,1280,513,767,48,1.5,9.62,4.7,0,0,0,0,0,0,0.17347568031945,3811.01237421744,17.3670198666287
7.5,"max_tuv_SVM","SVM",10,29,27140,24101,3039,3000,2480,520,0.51532621632735,0.159537572254335,1.58044966133551,1260,520,740,-20,1.4,9.95,4.8,0,0,0,0,0,0,0.169483884452611,4254.05964104622,16.9636947043745
7.5,"max_tuv_SVM","SVM",10,30,27040,24011,3029,3100,2570,530,0.514501517118984,0.156647398843931,1.60536183961431,1301,530,771,41,1.5,10.29,4.8,0,0,0,0,0,0,0.16775407921047,4259.19625489618,16.7853914713571
7.5,"max_tuv_SVM","SVM",10,31,26940,23920,3020,3200,2661,539,0.511731404731297,0.152023121387283,1.49646441363169,1319,539,780,18,1.4,10.62,4.9,0,0,0,0,0,0,0.164954035730914,3695.13916029488,16.5090273110291
7.5,"max_tuv_SVM","SVM",10,32,26840,23840,3000,3300,2741,559,0.513038601070279,0.150867052023121,1.5051387585873,1358,559,799,39,1.4,10.95,4.9,0,0,0,0,0,0,0.166651229429628,3904.3305711808,16.8414943991458
7.5,"max_tuv_SVM","SVM",10,33,26740,23749,2991,3400,2832,568,0.513607623593314,0.15606936416185,1.55074902399903,1417,568,849,59,1.5,11.28,5,0,0,0,0,0,0,0.163266020513408,3559.35207082381,16.3810742682703
7.5,"max_tuv_SVM","SVM",10,34,26640,23658,2982,3500,2923,577,0.512537646344678,0.14971098265896,1.48088976231896,1434,577,857,17,1.5,11.61,5.1,0,0,0,0,0,0,0.161510449832716,3592.86896242192,16.2058360023272
7.5,"max_tuv_SVM","SVM",10,35,26540,23573,2967,3600,3008,592,0.511423344871497,0.149132947976879,1.53823012247868,1470,592,878,36,1.5,11.94,5.1,0,0,0,0,0,0,0.161148614747034,3620.11466322743,16.1270891202177
7.5,"max_tuv_SVM","SVM",10,36,26440,23477,2963,3700,3104,596,0.512154889551228,0.154335260115607,1.51866756237811,1490,596,894,20,1.5,12.28,5.2,0,0,0,0,0,0,0.157844081158901,3416.15045582342,15.7985584958823
7.5,"max_tuv_SVM","SVM",10,37,26340,23387,2953,3800,3194,606,0.51063417436708,0.150867052023121,1.43287262502592,1500,606,894,10,1.5,12.61,5.3,0,0,0,0,0,0,0.156570967596651,3581.82472504793,15.6645350941279
7.5,"max_tuv_SVM","SVM",10,38,26240,23298,2942,3900,3283,617,0.510096131140779,0.152023121387283,1.54584512308501,1527,617,910,27,1.5,12.94,5.3,0,0,0,0,0,0,0.15587404513902,3599.22924743929,15.5975797006925
7.5,"max_tuv_SVM","SVM",10,39,26140,23204,2936,4000,3377,623,0.511273604382684,0.149132947976879,1.54362742115404,1536,623,913,9,1.5,13.27,5.4,0,0,0,0,0,0,0.152393148907923,3439.64326537227,15.2476713475383
7.5,"max_tuv_SVM","SVM",10,40,26040,23114,2926,4100,3467,633,0.510395048858469,0.149132947976879,1.50120889237688,1566,633,933,30,1.5,13.6,5.5,0,0,0,0,0,0,0.152608826822775,3652.57830220535,15.2678222121774
7.5,"max_tuv_SVM","SVM",10,41,25940,23026,2914,4200,3555,645,0.510036078965577,0.146242774566474,1.48233362588143,1603,645,958,37,1.5,13.93,5.5,0,0,0,0,0,0,0.151316168835646,3473.7211687384,15.1407753867602
7.5,"max_tuv_SVM","SVM",10,42,25840,22943,2897,4300,3638,662,0.50934261932337,0.14971098265896,1.46208011641538,1639,662,977,36,1.5,14.27,5.5,0,0,0,0,0,0,0.149504742999966,3071.7354612472,14.9702877280036
7.5,"max_tuv_SVM","SVM",10,43,25740,22856,2884,4400,3725,675,0.509221301797708,0.14971098265896,1.49623143561238,1708,675,1033,69,1.5,14.6,5.5,0,0,0,0,0,0,0.149159723137981,3062.58797972979,14.9426589862792
7.5,"max_tuv_SVM","SVM",10,44,25640,22766,2874,4500,3815,685,0.509680098683139,0.146820809248555,1.53557174737449,1761,685,1076,53,1.6,14.93,5.6,0,0,0,0,0,0,0.149854533670181,3443.80289220703,15.0044948470782
7.5,"max_tuv_SVM","SVM",10,45,25540,22677,2863,4600,3904,696,0.51057815166684,0.153757225433526,1.51637261856251,1748,696,1052,-13,1.5,15.26,5.6,0,0,0,0,0,0,0.148338299532151,3199.52183815483,14.8472724742035
7.5,"max_tuv_SVM","SVM",10,46,25440,22598,2842,4700,3983,717,0.506710029016557,0.147398843930636,1.50588776035292,1771,717,1054,23,1.5,15.59,5.6,0,0,0,0,0,0,0.149752882657694,3251.48439335092,14.9894042664752
7.5,"max_tuv_SVM","SVM",10,47,25340,22506,2834,4800,4075,725,0.508277104826578,0.154913294797688,1.47717768283488,1854,725,1129,83,1.6,15.93,5.6,0,0,0,0,0,0,0.148058444452272,3141.7421942191,14.8155297420059
7.5,"max_tuv_SVM","SVM",10,48,25240,22425,2815,4900,4156,744,0.508329877950241,0.151445086705202,1.44939729310588,1877,744,1133,23,1.5,16.26,5.6,0,0,0,0,0,0,0.148392956262195,3045.01919036442,14.8501227091072
7.5,"max_tuv_SVM","SVM",11,0,30040,26530,3510,100,92,8,0.556668697435298,0.194805194805195,2.08085619368628,29,8,21,0,2.6,0.33,11.5,0,0,0,0,0,0,0.609083671720449,2377.34085817012,70.7714784826964
7.5,"max_tuv_SVM","SVM",11,1,29940,26479,3461,200,143,57,0.526977282279671,0.18746470920384,1.72892050017208,120,57,63,91,1.1,0.66,2.5,0,0,0,0,0,0,0.35964914561485,6760.309455092,39.3716166344194
7.5,"max_tuv_SVM","SVM",11,2,29840,26406,3434,300,216,84,0.468391928437695,0.125352907961604,1.20624075484847,180,84,96,60,1.1,1,2.6,0,0,0,0,0,0,0.29040777189221,7510.94312516914,29.9301689661955
7.5,"max_tuv_SVM","SVM",11,3,29740,26341,3399,400,281,119,0.551530251376606,0.167701863354037,1.62955176183668,257,119,138,77,1.2,1.33,2.4,0,0,0,0,0,0,0.331635461562879,7817.91806697355,34.8730496485452
7.5,"max_tuv_SVM","SVM",11,4,29640,26272,3368,500,350,150,0.507033896146352,0.102766798418972,0.898558908010704,320,150,170,63,1.1,1.66,2.3,0,0,0,0,0,0,0.439082263321718,7337.03367297068,49.0253289138684
7.5,"max_tuv_SVM","SVM",11,5,29540,26187,3353,600,435,165,0.53369333837134,0.12987012987013,1.21677033584628,356,165,191,36,1.2,1.99,2.6,0,0,0,0,0,0,0.281204955313797,5768.73774753739,29.6906848562183
7.5,"max_tuv_SVM","SVM",11,6,29440,26107,3333,700,515,185,0.55785499887494,0.160361377752682,1.54656532952093,402,185,217,46,1.2,2.32,2.8,0,0,0,0,0,0,0.277243660222663,6514.6602924155,28.5245042531553
7.5,"max_tuv_SVM","SVM",11,7,29340,26019,3321,800,603,197,0.559754949202478,0.178994918125353,1.70197628458498,432,197,235,30,1.2,2.65,3.1,0,0,0,0,0,0,0.245755651112846,4941.6880193986,25.4463011135498
7.5,"max_tuv_SVM","SVM",11,8,29240,25933,3307,900,689,211,0.576155606407325,0.190287972896669,1.75314091206145,466,211,255,34,1.2,2.99,3.3,0,0,0,0,0,0,0.221604640110175,4480.57278175858,22.8949512649991
7.5,"max_tuv_SVM","SVM",11,9,29140,25846,3294,1000,776,224,0.580183788098138,0.203274985883682,1.80740844380706,498,224,274,32,1.2,3.32,3.5,0,0,0,0,0,0,0.204317909442608,3500.12958705641,20.7421825892221
7.5,"max_tuv_SVM","SVM",11,10,29040,25773,3267,1100,849,251,0.578891370153216,0.197063805759458,1.82515550376942,553,251,302,55,1.2,3.65,3.4,0,0,0,0,0,0,0.213733541930661,3754.53981903028,21.7757462865106
7.5,"max_tuv_SVM","SVM",11,11,28940,25699,3241,1200,923,277,0.582442229232032,0.202710333145116,1.85683808433079,605,277,328,52,1.2,3.98,3.3,0,0,0,0,0,0,0.220991208803674,4701.51456284095,22.2055646032458
7.5,"max_tuv_SVM","SVM",11,12,28840,25619,3221,1300,1003,297,0.582889578548294,0.204404291360813,1.87773199976278,661,297,364,56,1.2,4.31,3.4,0,0,0,0,0,0,0.21304325661709,4176.96560075455,21.4652946951786
7.5,"max_tuv_SVM","SVM",11,13,28740,25532,3208,1400,1090,310,0.584321376563939,0.203274985883682,1.87773199976278,696,310,386,35,1.2,4.64,3.5,0,0,0,0,0,0,0.204749236503308,3468.43451207807,20.6356374048421
7.5,"max_tuv_SVM","SVM",11,14,28640,25443,3197,1500,1179,321,0.597259481283677,0.214003387916431,1.94640904886048,738,321,417,42,1.3,4.98,3.7,0,0,0,0,0,0,0.200603060361862,3437.02256729899,25.5129894928167
7.5,"max_tuv_SVM","SVM",11,15,28540,25368,3172,1600,1254,346,0.611800308223982,0.237718802936194,2.19876124948589,802,346,456,64,1.3,5.31,3.6,0,0,0,0,0,0,0.221817114511155,3207.06988941171,24.3641518468999
7.5,"max_tuv_SVM","SVM",11,16,28440,25297,3143,1700,1325,375,0.610495535846965,0.223037831733484,2.11621389882259,879,375,504,77,1.3,5.64,3.5,0,0,0,0,0,0,0.215288217013301,4205.78101503673,21.797541278657
7.5,"max_tuv_SVM","SVM",11,17,28340,25224,3116,1800,1398,402,0.61051464063887,0.229813664596273,2.10305983973431,972,402,570,93,1.4,5.97,3.5,0,0,0,0,0,0,0.214758785580905,4573.72868067849,21.7488377165467
7.5,"max_tuv_SVM","SVM",11,18,28240,25149,3091,1900,1473,427,0.611334363576931,0.235460191981931,2.13684247183577,1002,427,575,30,1.3,6.3,3.4,0,0,0,0,0,0,0.21280623626701,3610.13694088911,21.3498416985462
7.5,"max_tuv_SVM","SVM",11,19,28140,25059,3081,2000,1563,437,0.611497773230375,0.232636928289102,2.14812540772862,1047,437,610,45,1.4,6.64,3.6,0,0,0,0,0,0,0.213166680562351,4985.52409785633,21.3507632578317
7.5,"max_tuv_SVM","SVM",11,20,28040,24977,3063,2100,1645,455,0.610849356593061,0.228684359119142,2.15364310175955,1077,455,622,30,1.4,6.97,3.6,0,0,0,0,0,0,0.209084565498622,4751.24211992511,20.9503974043098
7.5,"max_tuv_SVM","SVM",11,21,27940,24904,3036,2200,1718,482,0.61138560687433,0.223037831733484,2.11821243425285,1136,482,654,59,1.4,7.3,3.6,0,0,0,0,0,0,0.208122897689636,3398.49852898352,20.8779903497149
7.5,"max_tuv_SVM","SVM",11,22,27840,24834,3006,2300,1788,512,0.610493922553428,0.214568040654997,2.12377040728648,1165,512,653,29,1.3,7.63,3.5,0,0,0,0,0,0,0.214350018984708,3731.6856736798,21.4690104239079
7.5,"max_tuv_SVM","SVM",11,23,27740,24765,2975,2400,1857,543,0.61154162934157,0.225296442687747,2.0681680461638,1252,543,709,87,1.3,7.96,3.4,0,0,0,0,0,0,0.218631219843742,3970.19100099857,21.8983415816043
7.5,"max_tuv_SVM","SVM",11,24,27640,24683,2957,2500,1939,561,0.611639106235381,0.230942970073405,2.07177741448172,1281,561,720,29,1.3,8.29,3.5,0,0,0,0,0,0,0.216796762495906,3853.66105306209,22.2378944979698
7.5,"max_tuv_SVM","SVM",11,25,27540,24599,2941,2600,2023,577,0.61024844720497,0.220214568040655,2.05692596348185,1326,577,749,45,1.3,8.63,3.5,0,0,0,0,0,0,0.215648598299334,4629.42763325644,21.6237791585224
7.5,"max_tuv_SVM","SVM",11,26,27440,24513,2927,2700,2109,591,0.610492394170066,0.226425748164879,2.04029415109359,1345,591,754,19,1.3,8.96,3.6,0,0,0,0,0,0,0.211148281843442,3726.16924344347,21.1835390722194
7.5,"max_tuv_SVM","SVM",11,27,27340,24438,2902,2800,2184,616,0.610740416824113,0.229249011857708,2.0681680461638,1409,616,793,64,1.3,9.29,3.5,0,0,0,0,0,0,0.211667309967592,3872.03973898545,21.2715141484248
7.5,"max_tuv_SVM","SVM",11,28,27240,24355,2885,2900,2267,633,0.610192151751496,0.232072275550536,2.06075525746788,1468,633,835,59,1.3,9.62,3.6,0,0,0,0,0,0,0.208360308832209,3427.66444449515,20.9859210521739
7.5,"max_tuv_SVM","SVM",11,29,27140,24274,2866,3000,2348,652,0.609335195696755,0.226425748164879,2.05513265401063,1497,652,845,29,1.3,9.95,3.6,0,0,0,0,0,0,0.209478972907383,3839.37902520253,21.0063365321616
7.5,"max_tuv_SVM","SVM",11,30,27040,24191,2849,3100,2431,669,0.610612542083609,0.230378317334839,2.02722306148211,1513,669,844,16,1.3,10.29,3.6,0,0,0,0,0,0,0.207945115930933,3717.79565375979,20.8415621567546
7.5,"max_tuv_SVM","SVM",11,31,26940,24104,2836,3200,2518,682,0.609779318425942,0.231507622811971,1.98317236638598,1594,682,912,81,1.3,10.62,3.7,0,0,0,0,0,0,0.206322196777491,4036.77182067296,20.6703701673693
7.5,"max_tuv_SVM","SVM",11,32,26840,24027,2813,3300,2595,705,0.610105755636975,0.228684359119142,1.99797216016498,1623,705,918,29,1.3,10.95,3.7,0,0,0,0,0,0,0.206853721309731,3796.60543812217,20.7093413960645
7.5,"max_tuv_SVM","SVM",11,33,26740,23947,2793,3400,2675,725,0.61070708957601,0.228119706380576,2.07432940799978,1682,725,957,59,1.3,11.28,3.7,0,0,0,0,0,0,0.20563352600144,3587.36074490137,20.6071272441709
7.5,"max_tuv_SVM","SVM",11,34,26640,23871,2769,3500,2751,749,0.60998306041784,0.226425748164879,1.98416924368715,1747,749,998,65,1.3,11.61,3.7,0,0,0,0,0,0,0.207240564798934,3710.48462448888,20.7492393339975
7.5,"max_tuv_SVM","SVM",11,35,26540,23812,2728,3600,2810,790,0.609992188262864,0.229249011857708,2.03385431764469,1863,790,1073,116,1.4,11.94,3.6,0,0,0,0,0,0,0.211675528922898,3514.05070723383,21.2024750549466
7.5,"max_tuv_SVM","SVM",11,36,26440,23733,2707,3700,2889,811,0.610171773306791,0.229813664596273,2.00275657625733,1895,811,1084,32,1.3,12.28,3.6,0,0,0,0,0,0,0.213239731558896,4188.38548598012,21.3480642385995
7.5,"max_tuv_SVM","SVM",11,37,26340,23664,2676,3800,2958,842,0.610333102660664,0.232636928289102,2.07216350072955,1983,842,1141,88,1.4,12.61,3.5,0,0,0,0,0,0,0.213400427772184,3504.57490837387,21.3963100683886
7.5,"max_tuv_SVM","SVM",11,38,26240,23583,2657,3900,3039,861,0.60996179041619,0.226990400903444,1.96154979072619,2011,861,1150,28,1.3,12.94,3.5,0,0,0,0,0,0,0.211390551164218,3091.67769312801,21.202952424006
7.5,"max_tuv_SVM","SVM",11,39,26140,23498,2642,4000,3124,876,0.609643080032094,0.226990400903444,1.9773390569619,2049,876,1173,38,1.3,13.27,3.6,0,0,0,0,0,0,0.21371629845837,4337.67393276193,21.390451263544
7.5,"max_tuv_SVM","SVM",11,40,26040,23414,2626,4100,3208,892,0.610805542936963,0.230378317334839,1.9902732132722,2108,892,1216,59,1.4,13.6,3.6,0,0,0,0,0,0,0.213255535020745,4308.03915112042,21.3473045539303
7.5,"max_tuv_SVM","SVM",11,41,25940,23324,2616,4200,3298,902,0.610200005943715,0.226425748164879,1.94972304780192,2139,902,1237,31,1.4,13.93,3.7,0,0,0,0,0,0,0.209353302990706,4024.31850551476,20.9599083312858
7.5,"max_tuv_SVM","SVM",11,42,25840,23237,2603,4300,3385,915,0.609337106175939,0.225861095426313,1.85537328877504,2178,915,1263,39,1.4,14.27,3.7,0,0,0,0,0,0,0.205447219354123,3506.9000276445,20.5765492603321
7.5,"max_tuv_SVM","SVM",11,43,25740,23159,2581,4400,3463,937,0.609833172711566,0.225296442687747,1.88945732109692,2192,937,1255,14,1.3,14.6,3.7,0,0,0,0,0,0,0.205613170793974,3401.73413290106,20.6070635659179
7.5,"max_tuv_SVM","SVM",11,44,25640,23074,2566,4500,3548,952,0.610137469591543,0.225296442687747,1.89354071488459,2253,952,1301,61,1.4,14.93,3.7,0,0,0,0,0,0,0.205528226583654,3705.73274764464,20.5900459998767
7.5,"max_tuv_SVM","SVM",11,45,25540,22990,2550,4600,3632,968,0.610864597971498,0.219649915302089,2.01356434359363,2278,968,1310,25,1.4,15.26,3.8,0,0,0,0,0,0,0.204958108669737,3889.78718106413,20.5236299343287
7.5,"max_tuv_SVM","SVM",11,46,25440,22907,2533,4700,3715,985,0.612379692879864,0.236589497459063,2.14616517432289,2318,985,1333,40,1.4,15.59,3.8,0,0,0,0,0,0,0.203012929056755,3775.59918787874,20.3296634307916
7.5,"max_tuv_SVM","SVM",11,47,25340,22820,2520,4800,3802,998,0.612762425544377,0.230378317334839,2.09428624273022,2356,998,1358,38,1.4,15.93,3.8,0,0,0,0,0,0,0.200208594830434,3234.30072516436,20.0604281242233
7.5,"max_tuv_SVM","SVM",11,48,25240,22733,2507,4900,3889,1011,0.612125577919949,0.225296442687747,1.93038002840374,2401,1011,1390,45,1.4,16.26,3.8,0,0,0,0,0,0,0.200389660242896,3612.37564246012,20.0698915199965
7.5,"max_tuv_SVM","SVM",12,0,30040,26538,3502,100,80,20,0.597180222635802,0.204867006225241,1.82873170549582,51,20,31,0,1.6,0.33,4,0,0,0,0,0,0,0.638699131144972,5758.76342620335,66.1205223952922
7.5,"max_tuv_SVM","SVM",12,1,29940,26474,3466,200,144,56,0.413502128281542,0.0888511601584607,0.733033091001394,130,56,74,79,1.3,0.66,2.6,0,0,0,0,0,0,0.28400364059979,8405.16520677308,28.4289579869568
7.5,"max_tuv_SVM","SVM",12,2,29840,26399,3441,300,219,81,0.56014783882777,0.195812110922467,1.7043073858281,186,81,105,56,1.3,1,2.7,0,0,0,0,0,0,0.32882282587264,7726.37162885593,35.0811240137146
7.5,"max_tuv_SVM","SVM",12,3,29740,26308,3432,400,310,90,0.560574541580612,0.164685908319185,1.44704532223011,221,90,131,35,1.5,1.33,3.4,0,0,0,0,0,0,0.395162501796131,6346.2498169045,42.499561596739
7.5,"max_tuv_SVM","SVM",12,4,29640,26227,3413,500,391,109,0.500460286824553,0.132427843803056,1.16480692500169,270,109,161,49,1.5,1.66,3.6,0,0,0,0,0,0,0.247064858068516,6327.67170087745,25.4678050169414
7.5,"max_tuv_SVM","SVM",12,5,29540,26145,3395,600,473,127,0.540210555752369,0.161290322580645,1.37198050041648,322,127,195,52,1.5,1.99,3.7,0,0,0,0,0,0,0.241948453586336,5816.78449189003,27.7196040235046
7.5,"max_tuv_SVM","SVM",12,6,29440,26077,3363,700,541,159,0.515367148133362,0.130730050933786,1.23148089302089,379,159,220,57,1.4,2.32,3.4,0,0,0,0,0,0,0.231243859179256,6399.37072435314,23.5924160080752
7.5,"max_tuv_SVM","SVM",12,7,29340,26005,3335,800,613,187,0.521715792570479,0.122241086587436,1.14026008613045,441,187,254,62,1.4,2.65,3.3,0,0,0,0,0,0,0.234794889576805,6796.1232929216,23.5229709864494
7.5,"max_tuv_SVM","SVM",12,8,29240,25920,3320,900,698,202,0.520857580224885,0.134691567628749,1.26723068433338,481,202,279,40,1.4,2.99,3.5,0,0,0,0,0,0,0.228987457172761,6169.60106108615,23.2513382852757
7.5,"max_tuv_SVM","SVM",12,9,29140,25840,3300,1000,778,222,0.536527750694995,0.149405772495756,1.40381842276452,522,222,300,41,1.4,3.32,3.5,0,0,0,0,0,0,0.277340139676824,6278.58922561574,28.7002938550624
7.5,"max_tuv_SVM","SVM",12,10,29040,25749,3291,1100,869,231,0.539853275678481,0.154499151103565,1.39235826610063,552,231,321,30,1.4,3.65,3.8,0,0,0,0,0,0,0.211629813809018,5887.72648676814,21.4106787869113
7.5,"max_tuv_SVM","SVM",12,11,28940,25667,3273,1200,951,249,0.551516115590126,0.162988115449915,1.58201891304745,598,249,349,46,1.4,3.98,3.8,0,0,0,0,0,0,0.208111610169618,5733.41206575127,20.8605176914846
7.5,"max_tuv_SVM","SVM",12,12,28840,25588,3252,1300,1030,270,0.534947746672567,0.149405772495756,1.39220131915207,644,270,374,46,1.4,4.31,3.8,0,0,0,0,0,0,0.21456596734645,5655.57601468976,22.8665233866979
7.5,"max_tuv_SVM","SVM",12,13,28740,25493,3247,1400,1125,275,0.533471578899726,0.148839841539332,1.41388163726463,675,275,400,31,1.5,4.64,4.1,0,0,0,0,0,0,0.196726757915614,5430.93889075323,19.7151621053576
7.5,"max_tuv_SVM","SVM",12,14,28640,25413,3227,1500,1205,295,0.539861060206819,0.169779286926995,1.5624186787265,705,295,410,30,1.4,4.98,4.1,0,0,0,0,0,0,0.197324800952447,5156.5371247268,19.778719313882
7.5,"max_tuv_SVM","SVM",12,15,28540,25326,3214,1600,1292,308,0.540627985132651,0.169779286926995,1.571950086287,750,308,442,45,1.4,5.31,4.2,0,0,0,0,0,0,0.190961984659441,5091.47108366616,19.4161620590634
7.5,"max_tuv_SVM","SVM",12,16,28440,25245,3195,1700,1373,327,0.539879181567867,0.169779286926995,1.63531548535423,803,327,476,53,1.5,5.64,4.2,0,0,0,0,0,0,0.193027965601906,4977.86255736544,19.4921397743244
7.5,"max_tuv_SVM","SVM",12,17,28340,25176,3164,1800,1442,358,0.540318603304178,0.176570458404075,1.65948316268605,865,358,507,62,1.4,5.97,4,0,0,0,0,0,0,0.199167340406161,5115.25070750701,20.004649260389
7.5,"max_tuv_SVM","SVM",12,18,28240,25097,3143,1900,1521,379,0.535237475757362,0.162422184493492,1.59592130113171,918,379,539,53,1.4,6.3,4,0,0,0,0,0,0,0.19825170669779,5231.87017140929,19.8754810726487
7.5,"max_tuv_SVM","SVM",12,19,28140,25009,3131,2000,1609,391,0.534886448829186,0.164119977362762,1.5473228460818,944,391,553,26,1.4,6.64,4.1,0,0,0,0,0,0,0.194767200956576,5160.63994947298,19.482729235143
7.5,"max_tuv_SVM","SVM",12,20,28040,24924,3116,2100,1694,406,0.537716358841747,0.174872665534805,1.68201297591781,996,406,590,52,1.5,6.97,4.2,0,0,0,0,0,0,0.192089219253773,5032.3701594264,19.2216075145774
7.5,"max_tuv_SVM","SVM",12,21,27940,24839,3101,2200,1779,421,0.532871829910352,0.154499151103565,1.58060260247176,1033,421,612,37,1.5,7.3,4.2,0,0,0,0,0,0,0.18992761551831,4932.98089069594,19.0495197333419
7.5,"max_tuv_SVM","SVM",12,22,27840,24753,3087,2300,1865,435,0.533069590960901,0.162422184493492,1.54661837389172,1060,435,625,27,1.4,7.63,4.3,0,0,0,0,0,0,0.187972012688685,4691.73940360109,18.9502644443068
7.5,"max_tuv_SVM","SVM",12,23,27740,24658,3082,2400,1960,440,0.530180850332534,0.149405772495756,1.36255545049453,1065,440,625,5,1.4,7.96,4.5,0,0,0,0,0,0,0.18216255072829,4640.86371657545,18.2210693764619
7.5,"max_tuv_SVM","SVM",12,24,27640,24565,3075,2500,2053,447,0.535436725652121,0.162422184493492,1.63356095446029,1087,447,640,22,1.4,8.29,4.6,0,0,0,0,0,0,0.178377125370042,4818.6519435771,17.8504886202024
7.5,"max_tuv_SVM","SVM",12,25,27540,24475,3065,2600,2143,457,0.533246125346732,0.158460667798529,1.53853236560131,1101,457,644,14,1.4,8.63,4.7,0,0,0,0,0,0,0.175627225871266,4752.35847221544,17.5642582615342
7.5,"max_tuv_SVM","SVM",12,26,27440,24395,3045,2700,2223,477,0.53194445011623,0.155065082059989,1.4976550384997,1155,477,678,54,1.4,8.96,4.7,0,0,0,0,0,0,0.176313955983366,4532.49334248273,17.647296637394
7.5,"max_tuv_SVM","SVM",12,27,27340,24313,3027,2800,2305,495,0.527049683327087,0.144312393887946,1.15218280562754,1184,495,689,29,1.4,9.29,4.7,0,0,0,0,0,0,0.176560760134847,4452.23994368921,17.6816843974627
7.5,"max_tuv_SVM","SVM",12,28,27240,24215,3025,2900,2403,497,0.531496308006645,0.151669496321449,1.44777930584113,1188,497,691,4,1.4,9.62,4.8,0,0,0,0,0,0,0.170824506150454,4431.11254523139,17.0996571737291
7.5,"max_tuv_SVM","SVM",12,29,27140,24141,2999,3000,2477,523,0.530790340616931,0.153933220147142,1.51092036213566,1244,523,721,56,1.4,9.95,4.7,0,0,0,0,0,0,0.173350557012884,4348.20357026626,17.4039196757196
7.5,"max_tuv_SVM","SVM",12,30,27040,24055,2985,3100,2563,537,0.533107875526498,0.151103565365025,1.38654824884651,1268,537,731,24,1.4,10.29,4.8,0,0,0,0,0,0,0.172593132594755,4545.12405914733,17.2618292446849
7.5,"max_tuv_SVM","SVM",12,31,26940,23959,2981,3200,2659,541,0.534385899403133,0.156762874929259,1.57391963382576,1292,541,751,24,1.4,10.62,4.9,0,0,0,0,0,0,0.167761954705617,4215.40328147114,16.783101199371
7.5,"max_tuv_SVM","SVM",12,32,26840,23864,2976,3300,2754,546,0.531374563088029,0.146576117713639,1.39175409954261,1306,546,760,14,1.4,10.95,5,0,0,0,0,0,0,0.164835212893406,4322.70176955249,16.4844871768889
7.5,"max_tuv_SVM","SVM",12,33,26740,23778,2962,3400,2840,560,0.531198539163065,0.156762874929259,1.44396936029945,1346,560,786,40,1.4,11.28,5.1,0,0,0,0,0,0,0.163489253590919,4014.80662163493,16.3581132249456
7.5,"max_tuv_SVM","SVM",12,34,26640,23690,2950,3500,2928,572,0.532634337988393,0.149971703452179,1.46128715653334,1361,572,789,15,1.4,11.61,5.1,0,0,0,0,0,0,0.161695392315024,3794.2667392063,16.19200082128
7.5,"max_tuv_SVM","SVM",12,35,26540,23611,2929,3600,3007,593,0.529778819855293,0.152235427277872,1.41777351711904,1393,593,800,32,1.3,11.94,5.1,0,0,0,0,0,0,0.163958477816494,4124.77767943285,16.4018833111474
7.5,"max_tuv_SVM","SVM",12,36,26440,23520,2920,3700,3098,602,0.531684668069416,0.151669496321449,1.42525527546182,1449,602,847,56,1.4,12.28,5.1,0,0,0,0,0,0,0.161907882350692,4007.56376888715,16.1958522104103
7.5,"max_tuv_SVM","SVM",12,37,26340,23431,2909,3800,3187,613,0.527823371859513,0.149405772495756,1.35181727268853,1442,613,829,-7,1.4,12.61,5.2,0,0,0,0,0,0,0.160411699745371,3679.74045253802,16.0620371074023
7.5,"max_tuv_SVM","SVM",12,38,26240,23337,2903,3900,3281,619,0.527907895672682,0.147707979626486,1.23448157745808,1474,619,855,32,1.4,12.94,5.3,0,0,0,0,0,0,0.157411579250921,3720.72889747917,15.7508560811622
7.5,"max_tuv_SVM","SVM",12,39,26140,23253,2887,4000,3365,635,0.532550707481764,0.154499151103565,1.50293311793054,1508,635,873,34,1.4,13.27,5.3,0,0,0,0,0,0,0.157685497987415,3886.89665039695,15.7756544473765
7.5,"max_tuv_SVM","SVM",12,40,26040,23170,2870,4100,3448,652,0.530580243428582,0.154499151103565,1.39418723608028,1554,652,902,46,1.4,13.6,5.3,0,0,0,0,0,0,0.15794297937898,3763.73628864644,15.8033947043405
7.5,"max_tuv_SVM","SVM",12,41,25940,23081,2859,4200,3537,663,0.531049229357221,0.149405772495756,1.28274746786961,1587,663,924,33,1.4,13.93,5.3,0,0,0,0,0,0,0.157349056241422,3770.87819617171,15.7398883466253
7.5,"max_tuv_SVM","SVM",12,42,25840,22984,2856,4300,3634,666,0.53257308268343,0.152801358234295,1.45913070210373,1625,666,959,38,1.4,14.27,5.5,0,0,0,0,0,0,0.154025141281811,3781.27393246311,15.4075096811629
7.5,"max_tuv_SVM","SVM",12,43,25740,22894,2846,4400,3724,676,0.529853985219096,0.146010186757216,1.25559719519097,1623,676,947,-2,1.4,14.6,5.5,0,0,0,0,0,0,0.15216645332216,3339.52900071022,15.2417131511264
7.5,"max_tuv_SVM","SVM",12,44,25640,22808,2832,4500,3810,690,0.528237653397741,0.149405772495756,1.36347763835193,1644,690,954,21,1.4,14.93,5.5,0,0,0,0,0,0,0.152033073873782,3526.680051874,15.2114890040787
7.5,"max_tuv_SVM","SVM",12,45,25540,22716,2824,4600,3902,698,0.535432046427439,0.155065082059989,1.45383160981633,1644,698,946,0,1.4,15.26,5.6,0,0,0,0,0,0,0.15002886615777,3385.69781885047,15.018825875989
7.5,"max_tuv_SVM","SVM",12,46,25440,22628,2812,4700,3990,710,0.534188861505504,0.147142048670062,1.34827539337144,1708,710,998,64,1.4,15.59,5.6,0,0,0,0,0,0,0.14984302199129,3496.70664044951,15.0018703937294
7.5,"max_tuv_SVM","SVM",12,47,25340,22540,2800,4800,4078,722,0.532117496352758,0.152235427277872,1.50382301253984,1746,722,1024,38,1.4,15.93,5.6,0,0,0,0,0,0,0.149653800448067,3566.36188797699,14.9774250967725
7.5,"max_tuv_SVM","SVM",12,48,25240,22451,2789,4900,4167,733,0.533960983263349,0.153367289190719,1.47778509456323,1762,733,1029,16,1.4,16.26,5.7,0,0,0,0,0,0,0.148679475199878,3528.10174811722,14.8785673605724
7.5,"max_tuv_SVM","SVM",13,0,30040,26491,3549,100,89,11,0.542648016209965,0.185078079814922,1.86947114281579,36,11,25,0,2.3,0.33,8.1,0,0,0,0,0,0,0.33528458867764,3335.66840176112,37.6636937793988
7.5,"max_tuv_SVM","SVM",13,1,29940,26433,3507,200,147,53,0.484658222589115,0.112203585887796,1.07537539967006,121,53,68,85,1.3,0.66,2.8,0,0,0,0,0,0,0.553621918414738,7065.47787353255,62.9038205785661
7.5,"max_tuv_SVM","SVM",13,2,29840,26352,3488,300,228,72,0.433963325804703,0.10294968189705,0.907653057516045,176,72,104,55,1.4,1,3.2,0,0,0,0,0,0,0.280869629132758,6771.02170808428,28.7049286247719
7.5,"max_tuv_SVM","SVM",13,3,29740,26263,3477,400,317,83,0.521501654346904,0.120300751879699,1.0254822576804,208,83,125,32,1.5,1.33,3.8,0,0,0,0,0,0,0.208634292207874,6179.13272024605,20.8702794990811
7.5,"max_tuv_SVM","SVM",13,4,29640,26181,3459,500,399,101,0.491508353578293,0.13128976286871,1.10810840198768,246,101,145,38,1.4,1.66,4,0,0,0,0,0,0,0.202431650938989,5981.43535515049,20.4972903338451
7.5,"max_tuv_SVM","SVM",13,5,29540,26094,3446,600,486,114,0.499956650502239,0.135916714864083,1.24185993874191,284,114,170,38,1.5,1.99,4.3,0,0,0,0,0,0,0.216219844912805,5425.33187074928,23.3625158830423
7.5,"max_tuv_SVM","SVM",13,6,29440,26012,3428,700,568,132,0.49930493415257,0.15962984384037,1.5225500769054,329,132,197,45,1.5,2.32,4.3,0,0,0,0,0,0,0.20017211568106,5444.80873896111,20.4372508962792
7.5,"max_tuv_SVM","SVM",13,7,29340,25943,3397,800,637,163,0.524352664117106,0.147484094852516,1.34808563927054,407,163,244,78,1.5,2.65,3.9,0,0,0,0,0,0,0.222262170436093,5830.10744110955,22.6926452133398
7.5,"max_tuv_SVM","SVM",13,8,29240,25859,3381,900,721,179,0.513834818819495,0.148640832851359,1.20540697532009,446,179,267,39,1.5,2.99,4,0,0,0,0,0,0,0.204869337834421,5723.5865262182,20.6934700489355
7.5,"max_tuv_SVM","SVM",13,9,29140,25781,3359,1000,799,201,0.509732352397802,0.112203585887796,1.09250124139631,487,201,286,41,1.4,3.32,4,0,0,0,0,0,0,0.207952804254602,5820.16172990534,21.1493436341657
7.5,"max_tuv_SVM","SVM",13,10,29040,25697,3343,1100,883,217,0.552126687346722,0.175824175824176,1.47290887530785,522,217,305,35,1.4,3.65,4.1,0,0,0,0,0,0,0.214152482750174,5477.68486899517,22.066816031523
7.5,"max_tuv_SVM","SVM",13,11,28940,25599,3341,1200,981,219,0.539321809245071,0.164835164835165,1.52016291720578,543,219,324,21,1.5,3.98,4.5,0,0,0,0,0,0,0.18424862427545,5208.68757792384,18.4748769123756
7.5,"max_tuv_SVM","SVM",13,12,28840,25515,3325,1300,1065,235,0.535078760402067,0.155581260844419,1.41390910075348,600,235,365,57,1.6,4.31,4.5,0,0,0,0,0,0,0.182803643897199,5110.69527030517,18.3093116487217
7.5,"max_tuv_SVM","SVM",13,13,28740,25426,3314,1400,1154,246,0.536409069790027,0.165413533834586,1.27914944180785,629,246,383,29,1.6,4.64,4.7,0,0,0,0,0,0,0.178127460739589,4851.84142138368,18.0666094284763
7.5,"max_tuv_SVM","SVM",13,14,28640,25337,3303,1500,1243,257,0.532472501896347,0.153846153846154,1.29903462359603,661,257,404,32,1.6,4.98,4.8,0,0,0,0,0,0,0.173208427488018,4742.54498357463,17.3515013184325
7.5,"max_tuv_SVM","SVM",13,15,28540,25255,3285,1600,1325,275,0.54472558424071,0.164256795835743,1.56005163614108,699,275,424,38,1.5,5.31,4.8,0,0,0,0,0,0,0.175451469374276,4659.58761771993,17.8652516887055
7.5,"max_tuv_SVM","SVM",13,16,28440,25164,3276,1700,1416,284,0.54821664934567,0.164256795835743,1.31885935574723,730,284,446,31,1.6,5.64,5,0,0,0,0,0,0,0.167819108123484,4617.74443540263,16.7959230488695
7.5,"max_tuv_SVM","SVM",13,17,28340,25081,3259,1800,1499,301,0.535278341489862,0.160786581839213,1.52936009993736,769,301,468,39,1.6,5.97,5,0,0,0,0,0,0,0.170746492419261,4450.68787533084,17.2234886162675
7.5,"max_tuv_SVM","SVM",13,18,28240,24990,3250,1900,1590,310,0.54647499657325,0.168883747831116,1.71770493983113,805,310,495,36,1.6,6.3,5.1,0,0,0,0,0,0,0.16242548546418,4330.37827259681,16.2805458590816
7.5,"max_tuv_SVM","SVM",13,19,28140,24906,3234,2000,1674,326,0.544216270991256,0.162521688837478,1.68094975659043,858,326,532,53,1.6,6.64,5.1,0,0,0,0,0,0,0.163544267907675,4382.51517445861,16.3657392525088
7.5,"max_tuv_SVM","SVM",13,20,28040,24815,3225,2100,1765,335,0.544424521978609,0.162521688837478,1.65994367188875,851,335,516,-7,1.5,6.97,5.3,0,0,0,0,0,0,0.159525546073293,4360.26187692287,15.9793383906154
7.5,"max_tuv_SVM","SVM",13,21,27940,24733,3207,2200,1847,353,0.539833289969407,0.157316367842684,1.63011725116988,916,353,563,65,1.6,7.3,5.2,0,0,0,0,0,0,0.161189566009274,4301.59394395234,16.1224328487229
7.5,"max_tuv_SVM","SVM",13,22,27840,24664,3176,2300,1916,384,0.539814129491389,0.159051474840949,1.59449985188111,974,384,590,58,1.5,7.63,5,0,0,0,0,0,0,0.1671903272032,4587.48562630237,16.7209619210086
7.5,"max_tuv_SVM","SVM",13,23,27740,24573,3167,2400,2007,393,0.536947990746471,0.153267784846732,1.45403532344465,1021,393,628,47,1.6,7.96,5.1,0,0,0,0,0,0,0.163536657221297,4382.6388914427,16.3577451531869
7.5,"max_tuv_SVM","SVM",13,24,27640,24481,3159,2500,2099,401,0.538404057027506,0.15962984384037,1.61279589148961,1025,401,624,4,1.6,8.29,5.2,0,0,0,0,0,0,0.160375779318602,4204.13141562946,16.049790883364
7.5,"max_tuv_SVM","SVM",13,25,27540,24400,3140,2600,2180,420,0.537146271349331,0.156737998843262,1.57728937728938,1068,420,648,43,1.5,8.63,5.2,0,0,0,0,0,0,0.161760807483445,4319.08165636838,16.2130316373589
7.5,"max_tuv_SVM","SVM",13,26,27440,24314,3126,2700,2266,434,0.539926231292656,0.157894736842105,1.60287725915894,1088,434,654,20,1.5,8.96,5.2,0,0,0,0,0,0,0.160511538147879,4284.71114806885,16.0998175096443
7.5,"max_tuv_SVM","SVM",13,27,27340,24242,3098,2800,2338,462,0.548394729082571,0.165991902834008,1.72331705085921,1144,462,682,56,1.5,9.29,5.1,0,0,0,0,0,0,0.164849595317524,4395.49863265373,16.495577754806
7.5,"max_tuv_SVM","SVM",13,28,27240,24163,3077,2900,2417,483,0.552148708891592,0.1631000578369,1.62240476588242,1188,483,705,44,1.5,9.62,5,0,0,0,0,0,0,0.166037280070534,4238.94666526925,16.6295909113524
7.5,"max_tuv_SVM","SVM",13,29,27140,24072,3068,3000,2508,492,0.547896730052043,0.160208212839792,1.58343865361409,1243,492,751,55,1.5,9.95,5.1,0,0,0,0,0,0,0.163914387495031,4185.47778558765,16.4112764098968
7.5,"max_tuv_SVM","SVM",13,30,27040,23997,3043,3100,2583,517,0.545786606548455,0.158473105841527,1.5621956990378,1329,517,812,86,1.6,10.29,5,0,0,0,0,0,0,0.166697156861902,4248.49207582403,16.6867268120669
7.5,"max_tuv_SVM","SVM",13,31,26940,23913,3027,3200,2667,533,0.550350485024555,0.167148640832851,1.71151296003827,1366,533,833,37,1.6,10.62,5,0,0,0,0,0,0,0.17286448381904,3990.93536657856,17.6079549893729
7.5,"max_tuv_SVM","SVM",13,32,26840,23818,3022,3300,2762,538,0.54202928882811,0.16657027183343,1.5972825741357,1344,538,806,-22,1.5,10.95,5.1,0,0,0,0,0,0,0.163060230524497,4181.8697572116,16.3116394163618
7.5,"max_tuv_SVM","SVM",13,33,26740,23727,3013,3400,2853,547,0.548965598618878,0.164835164835165,1.65156616236949,1372,547,825,28,1.5,11.28,5.2,0,0,0,0,0,0,0.160740223238845,4147.64078999035,16.0946823361154
7.5,"max_tuv_SVM","SVM",13,34,26640,23637,3003,3500,2943,557,0.550936266788095,0.157894736842105,1.57793962713572,1386,557,829,14,1.5,11.61,5.3,0,0,0,0,0,0,0.159291177667794,3985.17734335905,16.2948164920639
7.5,"max_tuv_SVM","SVM",13,35,26540,23548,2992,3600,3032,568,0.551200828773068,0.175824175824176,1.58483621641516,1414,568,846,28,1.5,11.94,5.3,0,0,0,0,0,0,0.158217760586278,4105.51826894916,15.87474010772
7.5,"max_tuv_SVM","SVM",13,36,26440,23483,2957,3700,3097,603,0.562639547452086,0.182186234817814,1.92009003142606,1498,603,895,84,1.5,12.28,5.1,0,0,0,0,0,0,0.163557591334021,4079.78869146137,16.4646535025776
7.5,"max_tuv_SVM","SVM",13,37,26340,23401,2939,3800,3179,621,0.561983322754639,0.186813186813187,1.8863146589793,1536,621,915,38,1.5,12.61,5.1,0,0,0,0,0,0,0.163343186667123,4047.68632519862,16.345260462315
7.5,"max_tuv_SVM","SVM",13,38,26240,23322,2918,3900,3258,642,0.559291492340302,0.186813186813187,1.78587690472241,1605,642,963,69,1.5,12.94,5.1,0,0,0,0,0,0,0.164059930436308,4085.27211541632,16.4183959255171
7.5,"max_tuv_SVM","SVM",13,39,26140,23235,2905,4000,3345,655,0.555414573355575,0.172932330827068,1.64621586100217,1612,655,957,7,1.5,13.27,5.1,0,0,0,0,0,0,0.163741301025729,4037.20868152923,16.3813749627141
7.5,"max_tuv_SVM","SVM",13,40,26040,23152,2888,4100,3428,672,0.557005933419191,0.182764603817235,1.67773562717616,1671,672,999,59,1.5,13.6,5.1,0,0,0,0,0,0,0.163757523954049,4090.46366587777,16.3822623188671
7.5,"max_tuv_SVM","SVM",13,41,25940,23076,2864,4200,3504,696,0.556142411423347,0.176402544823597,1.52559651615338,1712,696,1016,41,1.5,13.93,5,0,0,0,0,0,0,0.165081567926398,3861.5703707165,16.5205686608354
7.5,"max_tuv_SVM","SVM",13,42,25840,22985,2855,4300,3595,705,0.561308501122647,0.186234817813765,1.85701461010385,1737,705,1032,25,1.5,14.27,5.1,0,0,0,0,0,0,0.163702890646646,3800.14591333619,16.3912446412579
7.5,"max_tuv_SVM","SVM",13,43,25740,22902,2838,4400,3678,722,0.554808200580578,0.187391555812608,1.6961619715822,1776,722,1054,39,1.5,14.6,5.1,0,0,0,0,0,0,0.163820055871524,3951.98740329452,16.3936218203408
7.5,"max_tuv_SVM","SVM",13,44,25640,22825,2815,4500,3755,745,0.554665190587396,0.179294389820706,1.69595532010773,1819,745,1074,43,1.4,14.93,5,0,0,0,0,0,0,0.165076805578316,3829.94030930431,16.5207619447156
7.5,"max_tuv_SVM","SVM",13,45,25540,22751,2789,4600,3829,771,0.559586832468694,0.18796992481203,1.79975276369806,1883,771,1112,64,1.4,15.26,5,0,0,0,0,0,0,0.16691819735962,4056.84840083733,16.6981600646886
7.5,"max_tuv_SVM","SVM",13,46,25440,22660,2780,4700,3920,780,0.5552516659429,0.1844997108155,1.6753982859246,1917,780,1137,34,1.5,15.59,5,0,0,0,0,0,0,0.165373015198066,3937.20685163263,16.5513453319685
7.5,"max_tuv_SVM","SVM",13,47,25340,22588,2752,4800,3992,808,0.557570907423792,0.18796992481203,1.74634381002209,1958,808,1150,41,1.4,15.93,4.9,0,0,0,0,0,0,0.167668058344901,3774.98401570488,16.7916568063675
7.5,"max_tuv_SVM","SVM",13,48,25240,22504,2736,4900,4076,824,0.555309277425461,0.176402544823597,1.5422855961681,1983,824,1159,25,1.4,16.26,4.9,0,0,0,0,0,0,0.167058236664595,3810.58882579961,16.7298741281352
7.5,"max_tuv_SVM","SVM",14,0,30040,26568,3472,100,86,14,0.497267078735722,0.11924570160843,1.02548953666024,48,14,34,0,2.4,0.33,6.1,0,0,0,0,0,0,0.146391721299018,4241.74721837936,14.7039246627353
7.5,"max_tuv_SVM","SVM",14,1,29940,26481,3459,200,173,27,0.469589904843213,0.0859678313921242,0.727501726449602,90,27,63,42,2.3,0.66,6.4,0,0,0,0,0,0,0.136051280297368,4050.3854953511,13.6093289807633
7.5,"max_tuv_SVM","SVM",14,2,29840,26390,3450,300,264,36,0.465090152228447,0.124237382140876,1.123941052041,111,36,75,21,2.1,1,7.3,0,0,0,0,0,0,0.144904158909814,3453.46201860005,14.879838034973
7.5,"max_tuv_SVM","SVM",14,3,29740,26296,3444,400,358,42,0.463783959872594,0.0931780366056572,0.774795028685603,130,42,88,19,2.1,1.33,8.5,0,0,0,0,0,0,0.117549115380984,2789.07417369877,12.0765469763169
7.5,"max_tuv_SVM","SVM",14,4,29640,26226,3414,500,428,72,0.559402783288704,0.166389351081531,1.71919535211212,167,72,95,37,1.3,1.66,5.9,0,0,0,0,0,0,0.19347620198471,4034.8063389508,21.8589316218381
7.5,"max_tuv_SVM","SVM",14,5,29540,26155,3385,600,499,101,0.506808549078506,0.136439267886855,1.16617568578821,255,101,154,88,1.5,1.99,4.9,0,0,0,0,0,0,0.265443554348494,4667.33472926672,32.2762258574313
7.5,"max_tuv_SVM","SVM",14,6,29440,26070,3370,700,584,116,0.478543260478841,0.127565169162507,1.04578953655337,305,116,189,50,1.6,2.32,5,0,0,0,0,0,0,0.25802019701843,4617.16933641387,26.0806685623116
7.5,"max_tuv_SVM","SVM",14,7,29340,25981,3359,800,673,127,0.478710051130742,0.126455906821963,1.07808442544718,344,127,217,39,1.7,2.65,5.3,0,0,0,0,0,0,0.193827049182904,4351.30844971393,19.902047168892
7.5,"max_tuv_SVM","SVM",14,8,29240,25901,3339,900,753,147,0.463201195842993,0.123128119800333,1.1708313173867,370,147,223,26,1.5,2.99,5.1,0,0,0,0,0,0,0.178912824400988,4485.67955971342,18.3512622541523
7.5,"max_tuv_SVM","SVM",14,9,29140,25818,3322,1000,836,164,0.468901172316734,0.125901275651692,1.15647786866217,409,164,245,39,1.5,3.32,5.1,0,0,0,0,0,0,0.195341667026745,4142.79424618196,20.658491871018
7.5,"max_tuv_SVM","SVM",14,10,29040,25736,3304,1100,918,182,0.464850040573185,0.10648918469218,0.927112507449627,462,182,280,53,1.5,3.65,5,0,0,0,0,0,0,0.228910821451929,4091.27344835905,25.9039072570024
7.5,"max_tuv_SVM","SVM",14,11,28940,25654,3286,1200,1000,200,0.444936532603769,0.102052135330006,0.856026435191682,537,200,337,75,1.7,3.98,5,0,0,0,0,0,0,0.184866564538991,4324.07085570124,18.8037812412527
7.5,"max_tuv_SVM","SVM",14,12,28840,25557,3283,1300,1097,203,0.463564080466834,0.120909595119246,1.14315233418557,541,203,338,4,1.7,4.31,5.4,0,0,0,0,0,0,0.237873362213749,3901.48569190762,26.6262418139762
7.5,"max_tuv_SVM","SVM",14,13,28740,25467,3273,1400,1187,213,0.450329054128958,0.114254021075984,1.01407148301839,561,213,348,20,1.6,4.64,5.6,0,0,0,0,0,0,0.168884742597403,3589.64095120213,17.2869177602931
7.5,"max_tuv_SVM","SVM",14,14,28640,25377,3263,1500,1277,223,0.449291022683364,0.123128119800333,1.1754627703827,585,223,362,24,1.6,4.98,5.7,0,0,0,0,0,0,0.172135977112309,3485.99373942092,24.2078432464411
7.5,"max_tuv_SVM","SVM",14,15,28540,25282,3258,1600,1372,228,0.451031581371012,0.113144758735441,0.864708244879224,603,228,375,18,1.6,5.31,6,0,0,0,0,0,0,0.160206808324006,3185.49183737693,16.3070651321056
7.5,"max_tuv_SVM","SVM",14,16,28440,25185,3255,1700,1469,231,0.453544560526278,0.113699389905713,1.0131934990504,642,231,411,39,1.8,5.64,6.4,0,0,0,0,0,0,0.142221240471757,3088.51836955845,14.3241923147014
7.5,"max_tuv_SVM","SVM",14,17,28340,25095,3245,1800,1559,241,0.452634527320307,0.121464226289517,1.02043059547219,642,241,401,0,1.7,5.97,6.5,0,0,0,0,0,0,0.137026580372814,3200.80082763014,13.8469500319033
7.5,"max_tuv_SVM","SVM",14,18,28240,25021,3219,1900,1633,267,0.456777958251674,0.093732667775929,0.84609614187717,715,267,448,73,1.7,6.3,6.1,0,0,0,0,0,0,0.204489634532517,3139.52406153225,21.5977331289397
7.5,"max_tuv_SVM","SVM",14,19,28140,24928,3212,2000,1726,274,0.458895029070062,0.111480865224626,1.21059154283091,723,274,449,8,1.6,6.64,6.3,0,0,0,0,0,0,0.141968709015548,3049.03246949371,14.2702348502077
7.5,"max_tuv_SVM","SVM",14,20,28040,24839,3201,2100,1815,285,0.45417564786255,0.116472545757072,1.11403369467816,736,285,451,13,1.6,6.97,6.4,0,0,0,0,0,0,0.137944092325437,3194.33450898227,13.9101272522734
7.5,"max_tuv_SVM","SVM",14,21,27940,24744,3196,2200,1910,290,0.45794210683932,0.120354963948974,1.19619223814602,789,290,499,53,1.7,7.3,6.6,0,0,0,0,0,0,0.134896516606771,2994.36967316229,13.5744596292432
7.5,"max_tuv_SVM","SVM",14,22,27840,24654,3186,2300,2000,300,0.452905321767174,0.114808652246256,1.14445210226361,803,300,503,14,1.7,7.63,6.7,0,0,0,0,0,0,0.133648565213155,2872.4627308571,13.4259658595544
7.5,"max_tuv_SVM","SVM",14,23,27740,24568,3172,2400,2086,314,0.456735069226895,0.112590127565169,1.0367561385632,838,314,524,35,1.7,7.96,6.6,0,0,0,0,0,0,0.132641249253006,2797.31915950631,13.3286587427019
7.5,"max_tuv_SVM","SVM",14,24,27640,24479,3161,2500,2175,325,0.456615807640464,0.105379922351636,0.999268719285968,876,325,551,38,1.7,8.29,6.7,0,0,0,0,0,0,0.129914009458201,2856.06436482299,13.0448461837161
7.5,"max_tuv_SVM","SVM",14,25,27540,24387,3153,2600,2267,333,0.4556704516022,0.10648918469218,1.05854386309087,906,333,573,30,1.7,8.63,6.8,0,0,0,0,0,0,0.128249321676364,2889.99609629092,12.8729492738531
7.5,"max_tuv_SVM","SVM",14,26,27440,24301,3139,2700,2353,347,0.457917150944789,0.120354963948974,1.08869589922003,972,347,625,66,1.8,8.96,6.8,0,0,0,0,0,0,0.127637837575853,2900.64059206975,12.8005633863123
7.5,"max_tuv_SVM","SVM",14,27,27340,24216,3124,2800,2438,362,0.46069824920814,0.122573488630061,1.18787441835051,1012,362,650,40,1.8,9.29,6.7,0,0,0,0,0,0,0.128227939381713,2686.28468941851,12.8587572512611
7.5,"max_tuv_SVM","SVM",14,28,27240,24127,3113,2900,2527,373,0.455485560611389,0.119800332778702,1.07523486308917,997,373,624,-15,1.7,9.62,6.8,0,0,0,0,0,0,0.129595441324032,2668.02020058168,13.0228452901661
7.5,"max_tuv_SVM","SVM",14,29,27140,24039,3101,3000,2615,385,0.457729542813027,0.1159179145868,1.06398567533236,1038,385,653,41,1.7,9.95,6.8,0,0,0,0,0,0,0.128098753655735,2613.5932256847,12.8784543252193
7.5,"max_tuv_SVM","SVM",14,30,27040,23954,3086,3100,2700,400,0.463977378505759,0.123128119800333,1.19516199146922,1101,400,701,63,1.8,10.29,6.8,0,0,0,0,0,0,0.127966151495168,2762.45957785935,12.9360066328945
7.5,"max_tuv_SVM","SVM",14,31,26940,23866,3074,3200,2788,412,0.465990236518339,0.119800332778702,1.1398426864317,1051,412,639,-50,1.6,10.62,6.8,0,0,0,0,0,0,0.128332534686286,3413.36729034507,19.6319462267312
7.5,"max_tuv_SVM","SVM",14,32,26840,23779,3061,3300,2875,425,0.466894166607727,0.133666112035496,1.16719363843339,1128,425,703,77,1.7,10.95,6.8,0,0,0,0,0,0,0.128651084672529,3416.88812008914,13.2877463089572
7.5,"max_tuv_SVM","SVM",14,33,26740,23697,3043,3400,2957,443,0.471389237379634,0.12534664448142,1.14315233418557,1154,443,711,26,1.6,11.28,6.7,0,0,0,0,0,0,0.130080375909253,3415.77694583485,13.0162002620693
7.5,"max_tuv_SVM","SVM",14,34,26640,23611,3029,3500,3043,457,0.469039662900625,0.12867443150305,1.23969013771497,1196,457,739,42,1.6,11.61,6.7,0,0,0,0,0,0,0.130688394395597,3444.50408939217,13.0709693269629
7.5,"max_tuv_SVM","SVM",14,35,26540,23519,3021,3600,3135,465,0.468804651109908,0.117581808097615,1.15952390343477,1196,465,731,0,1.6,11.94,6.7,0,0,0,0,0,0,0.128983888557174,3345.67528251628,12.9060278872702
7.5,"max_tuv_SVM","SVM",14,36,26440,23428,3012,3700,3226,474,0.468715696095563,0.118136439267887,1.21397068849478,1229,474,755,33,1.6,12.28,6.8,0,0,0,0,0,0,0.127794351145775,3330.22544914756,12.783267537426
7.5,"max_tuv_SVM","SVM",14,37,26340,23337,3003,3800,3317,483,0.458006147761306,0.10648918469218,0.995979046396635,1261,483,778,32,1.6,12.61,6.9,0,0,0,0,0,0,0.126904147137822,3218.15198401438,12.6956313154197
7.5,"max_tuv_SVM","SVM",14,38,26240,23243,2997,3900,3411,489,0.465947723713085,0.114254021075984,1.17432309346745,1282,489,793,21,1.6,12.94,7,0,0,0,0,0,0,0.125236100590204,3182.67103061826,12.5292721208295
7.5,"max_tuv_SVM","SVM",14,39,26140,23156,2984,4000,3498,502,0.466855750414969,0.1159179145868,1.18477561552003,1292,502,790,10,1.6,13.27,7,0,0,0,0,0,0,0.125457238113002,3250.08168715257,12.5470006381545
7.5,"max_tuv_SVM","SVM",14,40,26040,23066,2974,4100,3588,512,0.471490356824981,0.13477537437604,1.15994398850523,1309,512,797,17,1.6,13.6,7,0,0,0,0,0,0,0.124504863377468,3160.04981232185,12.454747914776
7.5,"max_tuv_SVM","SVM",14,41,25940,22977,2963,4200,3677,523,0.472139795313177,0.129783693843594,1.28990044201251,1339,523,816,30,1.6,13.93,7,0,0,0,0,0,0,0.124249020336694,3053.23328522864,12.4367307929675
7.5,"max_tuv_SVM","SVM",14,42,25840,22884,2956,4300,3770,530,0.462028937634676,0.1159179145868,1.04485579589573,1387,530,857,48,1.6,14.27,7.1,0,0,0,0,0,0,0.122680260694146,3090.38470172903,12.2695646843676
7.5,"max_tuv_SVM","SVM",14,43,25740,22800,2940,4400,3854,546,0.476162543384382,0.133666112035496,1.31866112716025,1403,546,857,16,1.6,14.6,7.1,0,0,0,0,0,0,0.123960821795664,3121.72741117309,12.4124977434907
7.5,"max_tuv_SVM","SVM",14,44,25640,22710,2930,4500,3944,556,0.469745116294471,0.11924570160843,1.2275228930803,1423,556,867,20,1.6,14.93,7.1,0,0,0,0,0,0,0.12334901310743,3053.23133055082,12.3455255543194
7.5,"max_tuv_SVM","SVM",14,45,25540,22618,2922,4600,4036,564,0.466887729073791,0.121464226289517,1.1451473644372,1422,564,858,-1,1.5,15.26,7.2,0,0,0,0,0,0,0.122342285434591,3006.05926452394,12.2376277315861
7.5,"max_tuv_SVM","SVM",14,46,25440,22529,2911,4700,4125,575,0.470422771246325,0.131447587354409,1.25965193512168,1442,575,867,20,1.5,15.59,7.2,0,0,0,0,0,0,0.121945891416192,2995.37593803901,12.220864730556
7.5,"max_tuv_SVM","SVM",14,47,25340,22445,2895,4800,4209,591,0.465630696067969,0.117581808097615,1.10964598061939,1522,591,931,80,1.6,15.93,7.1,0,0,0,0,0,0,0.122914821481377,3038.2849084296,12.2933505000997
7.5,"max_tuv_SVM","SVM",14,48,25240,22363,2877,4900,4291,609,0.46585968834644,0.114254021075984,1.14183890829936,1534,609,925,12,1.5,16.26,7,0,0,0,0,0,0,0.124036871594575,3073.97599284852,12.4070724426295
7.5,"max_tuv_SVM","SVM",15,0,30040,26510,3530,100,88,12,0.453053736069744,0.135661133371494,1.31010735480565,41,12,29,0,2.4,0.33,7.3,0,0,0,0,0,0,0.23461872313166,2824.06330194181,26.7333184882528
7.5,"max_tuv_SVM","SVM",15,1,29940,26435,3505,200,163,37,0.446168213570906,0.115054378935318,1.1507399158303,103,37,66,62,1.8,0.66,4.4,0,0,0,0,0,0,0.199730912066256,5505.91222170226,20.1413420521158
7.5,"max_tuv_SVM","SVM",15,2,29840,26361,3479,300,237,63,0.546952042159335,0.179164281625644,1.63504119491072,153,63,90,50,1.4,1,3.8,0,0,0,0,0,0,0.311710518022719,6048.69569082748,35.6566654048324
7.5,"max_tuv_SVM","SVM",15,3,29740,26287,3453,400,311,89,0.538780552225137,0.172295363480252,1.63105056697298,213,89,124,60,1.4,1.33,3.5,0,0,0,0,0,0,0.256464299955489,5889.14836396277,27.6063781750044
7.5,"max_tuv_SVM","SVM",15,4,29640,26217,3423,500,381,119,0.509558093069272,0.132226674298798,1.17116120981132,266,119,147,53,1.2,1.66,3.2,0,0,0,0,0,0,0.329426738644398,5593.74581715803,35.2377408924962
7.5,"max_tuv_SVM","SVM",15,5,29540,26133,3407,600,465,135,0.568803242407067,0.187178019461935,1.79131409088038,301,135,166,35,1.2,1.99,3.4,0,0,0,0,0,0,0.249795766513869,5211.94419156822,25.5143042532826
7.5,"max_tuv_SVM","SVM",15,6,29440,26063,3377,700,535,165,0.55484871178571,0.168860904407556,1.45676644319021,364,165,199,63,1.2,2.32,3.2,0,0,0,0,0,0,0.33908152074782,5072.45691423129,41.4397265106762
7.5,"max_tuv_SVM","SVM",15,7,29340,25983,3357,800,615,185,0.545671616668593,0.162564396107613,1.35367164379057,415,185,230,51,1.2,2.65,3.3,0,0,0,0,0,0,0.248898585707595,6053.14877678847,28.1233338141132
7.5,"max_tuv_SVM","SVM",15,8,29240,25899,3341,900,699,201,0.582237968696004,0.200915855752719,1.74209403068399,459,201,258,44,1.3,2.99,3.5,0,0,0,0,0,0,0.268823872210383,5218.58991245243,31.6671231567886
7.5,"max_tuv_SVM","SVM",15,9,29140,25809,3331,1000,789,211,0.561915142259567,0.200915855752719,1.90363465214824,475,211,264,16,1.3,3.32,3.7,0,0,0,0,0,0,0.221521504110287,4739.26299038103,23.5317423955003
7.5,"max_tuv_SVM","SVM",15,10,29040,25735,3305,1100,863,237,0.535863405757809,0.190612478534631,1.79693040799737,532,237,295,57,1.2,3.65,3.6,0,0,0,0,0,0,0.230957457725376,4972.26446709031,24.4658895551648
7.5,"max_tuv_SVM","SVM",15,11,28940,25653,3287,1200,945,255,0.544042199029875,0.196908986834574,1.79880912891754,586,255,331,54,1.3,3.98,3.7,0,0,0,0,0,0,0.225771741895343,4435.99625945603,24.6605636805488
7.5,"max_tuv_SVM","SVM",15,12,28840,25578,3262,1300,1020,280,0.539073351632347,0.189467658843732,1.7853701998457,645,280,365,59,1.3,4.31,3.6,0,0,0,0,0,0,0.214266348581301,5172.11434068615,21.6060931661888
7.5,"max_tuv_SVM","SVM",15,13,28740,25490,3250,1400,1108,292,0.540748049965825,0.192329708070979,1.77741596431321,678,292,386,33,1.3,4.64,3.8,0,0,0,0,0,0,0.201483385252185,4017.17901653687,20.2780470663422
7.5,"max_tuv_SVM","SVM",15,14,28640,25417,3223,1500,1181,319,0.541333133250515,0.195191757298226,1.8122247265153,740,319,421,62,1.3,4.98,3.7,0,0,0,0,0,0,0.211261761435958,4432.50905001744,21.6248059743607
7.5,"max_tuv_SVM","SVM",15,15,28540,25347,3193,1600,1251,349,0.5361091415966,0.189467658843732,1.78072483072208,793,349,444,53,1.3,5.31,3.6,0,0,0,0,0,0,0.212620895617165,4734.30318151799,21.2997470616524
7.5,"max_tuv_SVM","SVM",15,16,28440,25277,3163,1700,1321,379,0.53686220165221,0.188322839152833,1.78072483072208,864,379,485,71,1.3,5.64,3.5,0,0,0,0,0,0,0.216219270307951,3959.05840166381,21.6617424674273
7.5,"max_tuv_SVM","SVM",15,17,28340,25200,3140,1800,1398,402,0.534824656309221,0.187178019461935,1.77303603611619,911,402,509,47,1.3,5.97,3.5,0,0,0,0,0,0,0.219675752463097,4938.58269680834,22.0180285531946
7.5,"max_tuv_SVM","SVM",15,18,28240,25123,3117,1900,1475,425,0.535024939609986,0.185460789925587,1.7863928450251,966,425,541,55,1.3,6.3,3.5,0,0,0,0,0,0,0.218346845557929,4403.82347887567,21.8726101329803
7.5,"max_tuv_SVM","SVM",15,19,28140,25043,3097,2000,1555,445,0.532652342902199,0.183171150543789,1.77764132452169,1001,445,556,35,1.2,6.64,3.5,0,0,0,0,0,0,0.21710493069582,4300.20296024223,21.8032468372785
7.5,"max_tuv_SVM","SVM",15,20,28040,24950,3090,2100,1648,452,0.531248770246788,0.186605609616485,1.75371571235316,1009,452,557,8,1.2,6.97,3.6,0,0,0,0,0,0,0.211257751983827,4529.07760351025,21.1767156345108
7.5,"max_tuv_SVM","SVM",15,21,27940,24865,3075,2200,1733,467,0.533272310365393,0.183171150543789,1.8031709420337,1055,467,588,46,1.3,7.3,3.7,0,0,0,0,0,0,0.207178828221688,4276.22575969317,20.756010041194
7.5,"max_tuv_SVM","SVM",15,22,27840,24784,3056,2300,1814,486,0.531561868637183,0.184315970234688,1.7822705988043,1092,486,606,37,1.2,7.63,3.7,0,0,0,0,0,0,0.205523133876583,4045.59227342828,20.6073365784492
7.5,"max_tuv_SVM","SVM",15,23,27740,24701,3039,2400,1897,503,0.531226344703457,0.181453921007441,1.8000485681081,1129,503,626,37,1.2,7.96,3.8,0,0,0,0,0,0,0.205585398299327,4742.43449140295,20.5836448946947
7.5,"max_tuv_SVM","SVM",15,24,27640,24613,3027,2500,1985,515,0.531309559794314,0.184315970234688,1.8031709420337,1157,515,642,28,1.2,8.29,3.9,0,0,0,0,0,0,0.202098727893844,4722.81928704864,20.2466297101166
7.5,"max_tuv_SVM","SVM",15,25,27540,24536,3004,2600,2062,538,0.532389508660638,0.186033199771036,1.81184932906343,1196,538,658,39,1.2,8.63,3.8,0,0,0,0,0,0,0.201649653966331,4269.38391725567,20.2333733221608
7.5,"max_tuv_SVM","SVM",15,26,27440,24448,2992,2700,2150,550,0.533787195684943,0.184315970234688,1.83898616990354,1232,550,682,36,1.2,8.96,3.9,0,0,0,0,0,0,0.1960632346368,3646.23848566689,19.6845734391042
7.5,"max_tuv_SVM","SVM",15,27,27340,24360,2980,2800,2238,562,0.533336236052132,0.188322839152833,1.82676166922033,1279,562,717,47,1.3,9.29,4,0,0,0,0,0,0,0.195019482308864,4375.3138603397,19.5819444735557
7.5,"max_tuv_SVM","SVM",15,28,27240,24275,2965,2900,2323,577,0.533548204693488,0.184888380080137,1.81733727539804,1303,577,726,24,1.3,9.62,4,0,0,0,0,0,0,0.191989280652627,3585.18213847673,19.3836209126256
7.5,"max_tuv_SVM","SVM",15,29,27140,24184,2956,3000,2414,586,0.533249798900435,0.186033199771036,1.84117350914821,1325,586,739,22,1.3,9.95,4.1,0,0,0,0,0,0,0.189667594560077,3760.93326922514,19.1161743638961
7.5,"max_tuv_SVM","SVM",15,30,27040,24105,2935,3100,2493,607,0.535252159339237,0.186605609616485,1.91053243867072,1384,607,777,59,1.3,10.29,4.1,0,0,0,0,0,0,0.190448846460944,3853.73547636813,19.1073936046441
7.5,"max_tuv_SVM","SVM",15,31,26940,24027,2913,3200,2571,629,0.535142867036118,0.188322839152833,1.91216119607794,1423,629,794,39,1.3,10.62,4.1,0,0,0,0,0,0,0.191415642611779,4091.03621176472,19.1807117835096
7.5,"max_tuv_SVM","SVM",15,32,26840,23942,2898,3300,2656,644,0.535638162225859,0.187178019461935,1.92687012835547,1470,644,826,47,1.3,10.95,4.1,0,0,0,0,0,0,0.186507061699654,3472.50552051527,18.7136388783262
7.5,"max_tuv_SVM","SVM",15,33,26740,23854,2886,3400,2744,656,0.536031554371973,0.188895248998283,1.87219671412391,1496,656,840,26,1.3,11.28,4.2,0,0,0,0,0,0,0.185773924049932,3663.59243056608,18.63132231268
7.5,"max_tuv_SVM","SVM",15,34,26640,23766,2874,3500,2832,668,0.53587693841327,0.188322839152833,1.9472734471067,1543,668,875,47,1.3,11.61,4.2,0,0,0,0,0,0,0.18524771474636,3821.27007967712,18.5997849800602
7.5,"max_tuv_SVM","SVM",15,35,26540,23684,2856,3600,2914,686,0.535513704756472,0.188322839152833,1.88848783360914,1600,686,914,57,1.3,11.94,4.2,0,0,0,0,0,0,0.18460442380069,3602.09845207498,18.5062503748246
7.5,"max_tuv_SVM","SVM",15,36,26440,23595,2845,3700,3003,697,0.534004104819567,0.190612478534631,1.89009779766166,1626,697,929,26,1.3,12.28,4.3,0,0,0,0,0,0,0.18329829463479,3934.43480010448,18.3785167341922
7.5,"max_tuv_SVM","SVM",15,37,26340,23504,2836,3800,3094,706,0.532840124606975,0.188895248998283,1.90651301590194,1664,706,958,38,1.4,12.61,4.4,0,0,0,0,0,0,0.180598266678913,3459.57033644827,18.1101557823441
7.5,"max_tuv_SVM","SVM",15,38,26240,23409,2831,3900,3189,711,0.532017382115964,0.188322839152833,1.85228741143929,1674,711,963,10,1.4,12.94,4.5,0,0,0,0,0,0,0.176717479837227,3412.7647524828,17.7101752957047
7.5,"max_tuv_SVM","SVM",15,39,26140,23313,2827,4000,3285,715,0.530614754598398,0.187750429307384,1.73708491167526,1684,715,969,10,1.4,13.27,4.6,0,0,0,0,0,0,0.175111377410315,3750.78485229335,17.5279421097825
7.5,"max_tuv_SVM","SVM",15,40,26040,23221,2819,4100,3377,723,0.530086508466637,0.188322839152833,1.78106174488223,1717,723,994,33,1.4,13.6,4.7,0,0,0,0,0,0,0.17199938642236,3448.35204674143,17.227911493517
7.5,"max_tuv_SVM","SVM",15,41,25940,23131,2809,4200,3467,733,0.529243058864733,0.186033199771036,1.76373183798402,1763,733,1030,46,1.4,13.93,4.7,0,0,0,0,0,0,0.169656108791461,3371.95300158039,16.9882451817252
7.5,"max_tuv_SVM","SVM",15,42,25840,23038,2802,4300,3560,740,0.529127666126447,0.183171150543789,1.78129938988534,1774,740,1034,11,1.4,14.27,4.8,0,0,0,0,0,0,0.167828227012119,3367.3324496308,17.0886707390082
7.5,"max_tuv_SVM","SVM",15,43,25740,22942,2798,4400,3656,744,0.527552636874433,0.183743560389239,1.65587034009581,1821,744,1077,47,1.4,14.6,4.9,0,0,0,0,0,0,0.164120179044314,3147.05169217412,16.443940687646
7.5,"max_tuv_SVM","SVM",15,44,25640,22852,2788,4500,3746,754,0.528837680652359,0.180309101316543,1.85338257671354,1857,754,1103,36,1.5,14.93,5,0,0,0,0,0,0,0.161244461946876,2973.6671472854,16.1754211872168
7.5,"max_tuv_SVM","SVM",15,45,25540,22758,2782,4600,3840,760,0.527807480405137,0.180309101316543,1.69888167805387,1825,760,1065,-32,1.4,15.26,5.1,0,0,0,0,0,0,0.159218181283843,2860.68894968738,15.9821428348962
7.5,"max_tuv_SVM","SVM",15,46,25440,22666,2774,4700,3932,768,0.525125436975882,0.176874642243847,1.51451369300901,1915,768,1147,90,1.5,15.59,5.1,0,0,0,0,0,0,0.15944660516025,3374.69027715165,15.9639771656694
7.5,"max_tuv_SVM","SVM",15,47,25340,22572,2768,4800,4026,774,0.525390161493127,0.170578133943904,1.51890469131454,1875,774,1101,-40,1.4,15.93,5.2,0,0,0,0,0,0,0.156169798751715,2937.05705974574,15.6521419016374
7.5,"max_tuv_SVM","SVM",15,48,25240,22476,2764,4900,4122,778,0.525387755687708,0.175729822552948,1.45627882588784,1901,778,1123,26,1.4,16.26,5.3,0,0,0,0,0,0,0.152720879216663,2864.33476381564,15.3047612145916
7.5,"max_tuv_SVM","SVM",16,0,30040,26566,3474,100,91,9,0.417715292535374,0.0880398671096345,0.706690411341574,31,9,22,0,2.4,0.33,10.1,0,0,0,0,0,0,0.118795583426217,2644.12397670764,12.0736358979685
7.5,"max_tuv_SVM","SVM",16,1,29940,26474,3466,200,183,17,0.581270331044605,0.187707641196013,1.62900751807295,63,17,46,32,2.7,0.66,10.8,0,0,0,0,0,0,0.927347292286836,3208.61495532818,95.6779538336107
7.5,"max_tuv_SVM","SVM",16,2,29840,26381,3459,300,276,24,0.421167432426733,0.0736434108527132,0.60988130276776,87,24,63,24,2.6,1,11.5,0,0,0,0,0,0,0.125503469056944,2069.85046835099,13.282222706347
7.5,"max_tuv_SVM","SVM",16,3,29740,26285,3455,400,372,28,0.436906880319777,0.106312292358804,0.8720860395279,99,28,71,12,2.5,1.33,13.3,0,0,0,0,0,0,0.164554117125135,1430.22785324003,21.6899968889867
7.5,"max_tuv_SVM","SVM",16,4,29640,26193,3447,500,464,36,0.441016062803596,0.109080841638981,0.855508616362724,123,36,87,24,2.4,1.66,12.9,0,0,0,0,0,0,0.152910403727489,1696.36821423661,16.7523518541537
7.5,"max_tuv_SVM","SVM",16,5,29540,26099,3441,600,558,42,0.448992156229247,0.128460686600221,1.09466697312244,144,42,102,21,2.4,1.99,13.3,0,0,0,0,0,0,0.0850840581534088,1830.94778768756,8.65534447489662
7.5,"max_tuv_SVM","SVM",16,6,29440,26016,3424,700,641,59,0.451710614908048,0.115725359911406,1.09861527600115,192,59,133,48,2.3,2.32,10.9,0,0,0,0,0,0,0.128553313002554,1981.65926933139,13.6215496686653
7.5,"max_tuv_SVM","SVM",16,7,29340,25926,3414,800,731,69,0.457111300063994,0.123477297895903,1.15716795865633,215,69,146,23,2.1,2.65,10.6,0,0,0,0,0,0,0.0993018004008248,2250.1098250214,10.1029738087537
7.5,"max_tuv_SVM","SVM",16,8,29240,25845,3395,900,812,88,0.436304248643069,0.10077519379845,0.917431974528373,268,88,180,53,2,2.99,9.2,0,0,0,0,0,0,0.13479033817521,2215.9915896253,14.017103183914
7.5,"max_tuv_SVM","SVM",16,9,29140,25751,3389,1000,906,94,0.445567587039725,0.107419712070875,1.02442624545025,289,94,195,21,2.1,3.32,9.6,0,0,0,0,0,0,0.12250918824535,2232.18768108254,12.6340991988177
7.5,"max_tuv_SVM","SVM",16,10,29040,25660,3380,1100,997,103,0.441961689873226,0.0985603543743079,0.896749831329946,307,103,204,18,2,3.65,9.7,0,0,0,0,0,0,0.120661868360122,2113.11017239616,12.5453489409
7.5,"max_tuv_SVM","SVM",16,11,28940,25564,3376,1200,1093,107,0.450391437178665,0.109080841638981,0.931259841987524,320,107,213,13,2,3.98,10.2,0,0,0,0,0,0,0.106046353612773,2195.04937753747,10.8293102600671
7.5,"max_tuv_SVM","SVM",16,12,28840,25468,3372,1300,1189,111,0.449860935967935,0.102990033222591,0.927217915590009,345,111,234,25,2.1,4.31,10.7,0,0,0,0,0,0,0.096247947028793,2125.25100626839,9.82667382707671
7.5,"max_tuv_SVM","SVM",16,13,28740,25382,3358,1400,1275,125,0.484741442751247,0.125138427464009,1.08911310720096,391,125,266,46,2.1,4.64,10.2,0,0,0,0,0,0,0.102784960112717,2350.37817030935,12.6945333959464
7.5,"max_tuv_SVM","SVM",16,14,28640,25294,3346,1500,1363,137,0.479169197285592,0.111849390919158,0.882640131186643,437,137,300,46,2.2,4.98,9.9,0,0,0,0,0,0,0.106980716561788,2233.63573274874,11.3153590032239
7.5,"max_tuv_SVM","SVM",16,15,28540,25209,3331,1600,1448,152,0.468463792217507,0.116832779623477,0.89062815031112,473,152,321,36,2.1,5.31,9.5,0,0,0,0,0,0,0.104029660821127,2474.70934182123,10.5915493921085
7.5,"max_tuv_SVM","SVM",16,16,28440,25116,3324,1700,1541,159,0.461761628011333,0.110188261351052,0.868175339799075,495,159,336,22,2.1,5.64,9.7,0,0,0,0,0,0,0.101294509082921,2242.04491649807,10.4383094459502
7.5,"max_tuv_SVM","SVM",16,17,28340,25024,3316,1800,1633,167,0.459197865806444,0.0957918050941307,0.876825637568812,525,167,358,30,2.1,5.97,9.8,0,0,0,0,0,0,0.100525030338799,2264.25235378698,10.4733641321267
7.5,"max_tuv_SVM","SVM",16,18,28240,24934,3306,1900,1723,177,0.456459871793106,0.0952380952380952,0.79762478942549,552,177,375,27,2.1,6.3,9.7,0,0,0,0,0,0,0.0980717685879325,2245.29417745136,10.1994643982981
7.5,"max_tuv_SVM","SVM",16,19,28140,24840,3300,2000,1817,183,0.440326774386506,0.105758582502769,0.948975736713962,567,183,384,15,2.1,6.64,9.9,0,0,0,0,0,0,0.0992703644665295,2321.95143580996,10.9321188967376
7.5,"max_tuv_SVM","SVM",16,20,28040,24751,3289,2100,1906,194,0.446976760882916,0.105758582502769,0.941329557993796,590,194,396,23,2,6.97,9.8,0,0,0,0,0,0,0.0977279490983494,2198.44106159604,10.0328140931135
7.5,"max_tuv_SVM","SVM",16,21,27940,24658,3282,2200,1999,201,0.445140815116009,0.108527131782946,0.969140002199131,625,201,424,35,2.1,7.3,9.9,0,0,0,0,0,0,0.0952100094822424,2171.30300033044,9.64262417167254
7.5,"max_tuv_SVM","SVM",16,22,27840,24569,3271,2300,2088,212,0.434615360533366,0.106312292358804,0.962880143112701,640,212,428,15,2,7.63,9.8,0,0,0,0,0,0,0.0948101285257878,2250.29304917327,9.60261021991005
7.5,"max_tuv_SVM","SVM",16,23,27740,24483,3257,2400,2174,226,0.434060314927961,0.10077519379845,0.809753651350843,689,226,463,49,2,7.96,9.6,0,0,0,0,0,0,0.0966030047462413,2354.21122668407,9.78530188557197
7.5,"max_tuv_SVM","SVM",16,24,27640,24391,3249,2500,2266,234,0.437292619692536,0.0880398671096345,0.768811277058979,695,234,461,6,2,8.29,9.7,0,0,0,0,0,0,0.097443060544855,2157.40784064194,10.2084783249286
7.5,"max_tuv_SVM","SVM",16,25,27540,24300,3240,2600,2357,243,0.44331543011756,0.0913621262458472,0.796866325334649,729,243,486,34,2,8.63,9.7,0,0,0,0,0,0,0.0945135515343177,2257.32971953575,9.6358219184976
7.5,"max_tuv_SVM","SVM",16,26,27440,24209,3231,2700,2448,252,0.429157864287033,0.0863787375415282,0.77866715798668,721,252,469,-8,1.9,8.96,9.7,0,0,0,0,0,0,0.0948685761667292,2376.28073292645,9.59756368033153
7.5,"max_tuv_SVM","SVM",16,27,27340,24116,3224,2800,2541,259,0.446095124556544,0.0952380952380952,0.756648621614863,759,259,500,38,1.9,9.29,9.8,0,0,0,0,0,0,0.0933203073743411,2334.28190155606,9.4035146464526
7.5,"max_tuv_SVM","SVM",16,28,27240,24021,3219,2900,2636,264,0.43219155981715,0.0902547065337763,0.718392315470172,790,264,526,31,2,9.62,10,0,0,0,0,0,0,0.0914952779816304,2147.81332139918,9.29126470558528
7.5,"max_tuv_SVM","SVM",16,29,27140,23932,3208,3000,2725,275,0.560740948523977,0.185492801771872,1.54893152684263,806,275,531,16,1.9,9.95,9.9,0,0,0,0,0,0,0.0961341763676367,2499.64033429872,9.67352162716866
7.5,"max_tuv_SVM","SVM",16,30,27040,23837,3203,3100,2820,280,0.44348970366818,0.104097452934662,0.858716328158557,833,280,553,27,2,10.29,10.1,0,0,0,0,0,0,0.0904215576065627,2298.79835053003,9.08720571327913
7.5,"max_tuv_SVM","SVM",16,31,26940,23746,3194,3200,2911,289,0.44382092776977,0.117940199335548,0.972369396697,851,289,562,18,1.9,10.62,10.1,0,0,0,0,0,0,0.0906044109821225,2161.98204352636,9.11007030604629
7.5,"max_tuv_SVM","SVM",16,32,26840,23659,3181,3300,2998,302,0.550971903764271,0.19047619047619,1.55911197550277,870,302,568,19,1.9,10.95,9.9,0,0,0,0,0,0,0.106574356942146,2488.89833159513,12.6791918075939
7.5,"max_tuv_SVM","SVM",16,33,26740,23572,3168,3400,3085,315,0.455427128819254,0.110741971207087,0.96981981981982,918,315,603,48,1.9,11.28,9.8,0,0,0,0,0,0,0.0932815290008133,2471.31013117437,9.40275714312546
7.5,"max_tuv_SVM","SVM",16,34,26640,23500,3140,3500,3157,343,0.499390230412588,0.13233665559247,1.12264052560225,1082,343,739,164,2.2,11.61,9.2,0,0,0,0,0,0,0.116656195075831,2631.30661429155,12.5421434314904
7.5,"max_tuv_SVM","SVM",16,35,26540,23422,3118,3600,3235,365,0.502750391437179,0.131229235880399,1.20596228450511,1113,365,748,31,2,11.94,8.9,0,0,0,0,0,0,0.109771262342209,2703.59470717975,11.145816150856
7.5,"max_tuv_SVM","SVM",16,36,26440,23332,3108,3700,3325,375,0.507097671246202,0.122369878183832,0.968408919999719,1149,375,774,36,2.1,12.28,8.9,0,0,0,0,0,0,0.11747826143993,2632.12037950817,14.2249405652525
7.5,"max_tuv_SVM","SVM",16,37,26340,23239,3101,3800,3418,382,0.523185102721218,0.16500553709856,1.59022413662187,1209,382,827,60,2.2,12.61,8.9,0,0,0,0,0,0,0.101985769005919,2648.48116851496,10.2208848531263
7.5,"max_tuv_SVM","SVM",16,38,26240,23159,3081,3900,3498,402,0.502005502452561,0.171650055370986,1.51117496144777,1231,402,829,22,2.1,12.94,8.7,0,0,0,0,0,0,0.10755000015961,2695.25083416934,10.9442310471071
7.5,"max_tuv_SVM","SVM",16,39,26140,23088,3052,4000,3569,431,0.493897545518787,0.153931339977852,1.37964059826395,1280,431,849,49,2,13.27,8.3,0,0,0,0,0,0,0.108870012467375,2805.32450743335,10.9362002969543
7.5,"max_tuv_SVM","SVM",16,40,26040,23011,3029,4100,3646,454,0.537024551490846,0.17109634551495,1.55168763276228,1323,454,869,43,1.9,13.6,8,0,0,0,0,0,0,0.111265202349939,2876.31712160108,11.1692520787514
7.5,"max_tuv_SVM","SVM",16,41,25940,22929,3011,4200,3728,472,0.523739271741093,0.165559246954596,1.43223502898492,1389,472,917,66,1.9,13.93,7.9,0,0,0,0,0,0,0.112819658622847,2904.18428672063,11.3724490969011
7.5,"max_tuv_SVM","SVM",16,42,25840,22846,2994,4300,3811,489,0.519885718292967,0.151162790697674,1.26032033030599,1440,489,951,51,1.9,14.27,7.8,0,0,0,0,0,0,0.113954473361163,2925.9373576249,11.4035901891528
7.5,"max_tuv_SVM","SVM",16,43,25740,22754,2986,4400,3903,497,0.512877041348537,0.156699889258029,1.45482952596556,1460,497,963,20,1.9,14.6,7.9,0,0,0,0,0,0,0.113039315867706,2900.67653127635,11.312173180919
7.5,"max_tuv_SVM","SVM",16,44,25640,22666,2974,4500,3991,509,0.520487181188978,0.16500553709856,1.55070584845866,1461,509,952,1,1.9,14.93,7.8,0,0,0,0,0,0,0.113241207159847,2887.41864859748,11.3351152397278
7.5,"max_tuv_SVM","SVM",16,45,25540,22573,2967,4600,4084,516,0.544587021775636,0.172203765227021,1.56008093734192,1526,516,1010,65,2,15.26,7.9,0,0,0,0,0,0,0.112255085838566,2859.04217110717,11.2303070798941
7.5,"max_tuv_SVM","SVM",16,46,25440,22499,2941,4700,4158,542,0.534977390354805,0.179401993355482,1.64527655004337,1608,542,1066,82,2,15.59,7.7,0,0,0,0,0,0,0.115289753599238,2926.65507384936,11.533461036638
7.5,"max_tuv_SVM","SVM",16,47,25340,22411,2929,4800,4246,554,0.521209404176472,0.13953488372093,1.17942118863049,1632,554,1078,24,1.9,15.93,7.7,0,0,0,0,0,0,0.11548290911467,2923.58032106387,11.5517986881941
7.5,"max_tuv_SVM","SVM",16,48,25240,22330,2910,4900,4327,573,0.475669033030158,0.12624584717608,1.06194903870372,1632,573,1059,0,1.8,16.26,7.6,0,0,0,0,0,0,0.119219882522683,2951.57357600741,11.9766616083459
7.5,"max_tuv_SVM","SVM",17,0,30040,26532,3508,100,91,9,0.591635842373114,0.200338600451467,1.79568364188914,34,9,25,0,2.8,0.33,10.1,0,0,0,0,0,0,0.163433891927637,2769.97440638248,17.7106458292786
7.5,"max_tuv_SVM","SVM",17,1,29940,26455,3485,200,168,32,0.619723419011627,0.216704288939052,1.86916564226499,86,32,54,52,1.7,0.66,5.2,0,0,0,0,0,0,0.210170054450774,4444.1874245326,22.6592273859535
7.5,"max_tuv_SVM","SVM",17,2,29840,26376,3464,300,247,53,0.586370421612176,0.18058690744921,1.66957096699838,140,53,87,54,1.6,1,4.7,0,0,0,0,0,0,0.292983488481313,4879.17109200657,31.0544910871812
7.5,"max_tuv_SVM","SVM",17,3,29740,26309,3431,400,314,86,0.509122934275854,0.107787810383747,0.973103634108149,215,86,129,75,1.5,1.33,3.7,0,0,0,0,0,0,0.374451434340104,5804.48806620019,44.9788732300234
7.5,"max_tuv_SVM","SVM",17,4,29640,26227,3413,500,396,104,0.56483313465583,0.179458239277652,1.4489575592726,252,104,148,37,1.4,1.66,3.8,0,0,0,0,0,0,0.340977258630476,4968.88337232667,38.7298443064872
7.5,"max_tuv_SVM","SVM",17,5,29540,26150,3390,600,473,127,0.556235600972738,0.178329571106095,1.60927224354484,304,127,177,52,1.4,1.99,3.7,0,0,0,0,0,0,0.220186717457635,5864.97750202133,22.555601565274
7.5,"max_tuv_SVM","SVM",17,6,29440,26074,3366,700,549,151,0.561134092126961,0.195823927765237,1.87920319603853,352,151,201,48,1.3,2.32,3.6,0,0,0,0,0,0,0.283721081069151,3540.64310229896,34.8596354298978
7.5,"max_tuv_SVM","SVM",17,7,29340,25982,3358,800,641,159,0.569890372619198,0.223476297968397,2.09826795513866,367,159,208,15,1.3,2.65,4,0,0,0,0,0,0,0.210837954785107,4741.13267031532,21.4962588474972
7.5,"max_tuv_SVM","SVM",17,8,29240,25903,3337,900,720,180,0.562086360810233,0.191873589164786,1.84729109632903,418,180,238,51,1.3,2.99,4,0,0,0,0,0,0,0.23388496720297,4170.19394332832,25.4923285369156
7.5,"max_tuv_SVM","SVM",17,9,29140,25830,3310,1000,793,207,0.559703418865664,0.196388261851016,2.03546819646056,476,207,269,58,1.3,3.32,3.8,0,0,0,0,0,0,0.206641103226946,4904.31494776584,20.962644376308
7.5,"max_tuv_SVM","SVM",17,10,29040,25748,3292,1100,875,225,0.556814659769218,0.196952595936795,1.98401931055861,513,225,288,37,1.3,3.65,3.9,0,0,0,0,0,0,0.201059918276756,4039.73703462109,20.5874386350765
7.5,"max_tuv_SVM","SVM",17,11,28940,25666,3274,1200,957,243,0.558167126569878,0.196952595936795,1.97600333814579,570,243,327,57,1.3,3.98,3.9,0,0,0,0,0,0,0.194202641849629,4043.01116731302,19.6566798542256
7.5,"max_tuv_SVM","SVM",17,12,28840,25599,3241,1300,1024,276,0.560625516743992,0.195823927765237,1.95811133547827,639,276,363,69,1.3,4.31,3.7,0,0,0,0,0,0,0.207376069225988,4841.56609151018,21.0001002967694
7.5,"max_tuv_SVM","SVM",17,13,28740,25513,3227,1400,1110,290,0.558583874073936,0.190180586907449,1.85579020730803,675,290,385,36,1.3,4.64,3.8,0,0,0,0,0,0,0.197473296763396,3450.57488353396,19.9170926006011
7.5,"max_tuv_SVM","SVM",17,14,28640,25438,3202,1500,1185,315,0.559193315847004,0.192437923250564,1.98351665882315,731,315,416,56,1.3,4.98,3.8,0,0,0,0,0,0,0.201270015297249,3594.89293641607,20.2529365206453
7.5,"max_tuv_SVM","SVM",17,15,28540,25369,3171,1600,1254,346,0.559493835735372,0.195823927765237,1.90579538376701,809,346,463,78,1.3,5.31,3.6,0,0,0,0,0,0,0.209896738383218,3620.99911704904,21.0994169700481
7.5,"max_tuv_SVM","SVM",17,16,28440,25292,3148,1700,1331,369,0.559386689065196,0.195823927765237,1.90245188309374,857,369,488,48,1.3,5.64,3.6,0,0,0,0,0,0,0.209130605404581,3524.99981197733,21.0221579808959
7.5,"max_tuv_SVM","SVM",17,17,28340,25220,3120,1800,1403,397,0.558935527323713,0.200902934537246,1.91158931144305,910,397,513,53,1.3,5.97,3.5,0,0,0,0,0,0,0.217324965852379,4836.4320495649,21.7730832423994
7.5,"max_tuv_SVM","SVM",17,18,28240,25145,3095,1900,1478,422,0.558431110504581,0.204288939051919,1.89499128747376,975,422,553,65,1.3,6.3,3.5,0,0,0,0,0,0,0.219187986734239,4917.78508170808,21.9576471426607
7.5,"max_tuv_SVM","SVM",17,19,28140,25078,3062,2000,1545,455,0.556294414946929,0.201467268623025,1.89745857106462,1046,455,591,71,1.3,6.64,3.4,0,0,0,0,0,0,0.22286641512234,4471.99051914175,22.3532201599995
7.5,"max_tuv_SVM","SVM",17,20,28040,24993,3047,2100,1630,470,0.557840254965789,0.20823927765237,1.90412216569523,1071,470,601,25,1.3,6.97,3.5,0,0,0,0,0,0,0.220172626422846,4509.18534381932,22.0641010671222
7.5,"max_tuv_SVM","SVM",17,21,27940,24915,3025,2200,1708,492,0.558355365234772,0.206546275395034,1.9048995850688,1122,492,630,51,1.3,7.3,3.5,0,0,0,0,0,0,0.218505241067569,4189.73015434013,21.9488985632745
7.5,"max_tuv_SVM","SVM",17,22,27840,24830,3010,2300,1793,507,0.556898849469665,0.20372460496614,1.90656762323436,1162,507,655,40,1.3,7.63,3.5,0,0,0,0,0,0,0.215246601309782,4146.06252300081,21.5813812297744
7.5,"max_tuv_SVM","SVM",17,23,27740,24739,3001,2400,1884,516,0.556798407422824,0.206546275395034,1.92146268279087,1188,516,672,26,1.3,7.96,3.7,0,0,0,0,0,0,0.212494967499927,4805.62706433067,21.2839324840753
7.5,"max_tuv_SVM","SVM",17,24,27640,24655,2985,2500,1968,532,0.555979340085149,0.203160270880361,1.9346636410855,1243,532,711,55,1.3,8.29,3.7,0,0,0,0,0,0,0.208534597677149,4230.77940092399,20.935848507548
7.5,"max_tuv_SVM","SVM",17,25,27540,24564,2976,2600,2059,541,0.555080750822765,0.200338600451467,1.94614034914783,1264,541,723,21,1.3,8.63,3.8,0,0,0,0,0,0,0.201695501181058,3799.82095238242,20.2468744661344
7.5,"max_tuv_SVM","SVM",17,26,27440,24486,2954,2700,2137,563,0.55441041579358,0.200902934537246,1.95356836574763,1343,563,780,79,1.4,8.96,3.8,0,0,0,0,0,0,0.202967860800759,4174.64888768496,20.3611949939954
7.5,"max_tuv_SVM","SVM",17,27,27340,24405,2935,2800,2218,582,0.55407543923345,0.197516930022573,1.94210465508967,1376,582,794,33,1.4,9.29,3.8,0,0,0,0,0,0,0.201377761743409,3733.7195822248,20.2010297092024
7.5,"max_tuv_SVM","SVM",17,28,27240,24320,2920,2900,2303,597,0.554202614904937,0.198081264108352,1.9478415207817,1437,597,840,61,1.4,9.62,3.9,0,0,0,0,0,0,0.200410636576244,3993.73128691971,20.0888225730443
7.5,"max_tuv_SVM","SVM",17,29,27140,24230,2910,3000,2393,607,0.554566574108916,0.199774266365688,1.95870033168217,1473,607,866,36,1.4,9.95,3.9,0,0,0,0,0,0,0.195630621993809,3879.53840760902,19.6393384141585
7.5,"max_tuv_SVM","SVM",17,30,27040,24145,2895,3100,2478,622,0.553428740123205,0.202595936794582,1.96670675112965,1516,622,894,43,1.4,10.29,4,0,0,0,0,0,0,0.195055615905861,3818.07657102081,19.5779978618233
7.5,"max_tuv_SVM","SVM",17,31,26940,24060,2880,3200,2563,637,0.555966609787695,0.217268623024831,1.99118037669423,1532,637,895,16,1.4,10.62,4,0,0,0,0,0,0,0.197165687356741,4151.38398823598,19.7685339087078
7.5,"max_tuv_SVM","SVM",17,32,26840,23983,2857,3300,2640,660,0.556050672185165,0.221218961625282,2.03270654432774,1620,660,960,88,1.5,10.95,4,0,0,0,0,0,0,0.196795830531395,3789.2881893005,19.7026401014783
7.5,"max_tuv_SVM","SVM",17,33,26740,23896,2844,3400,2727,673,0.553860933721489,0.217268623024831,1.94233638216939,1637,673,964,17,1.4,11.28,4.1,0,0,0,0,0,0,0.194726962383105,4175.72814682827,19.5049423101857
7.5,"max_tuv_SVM","SVM",17,34,26640,23826,2814,3500,2797,703,0.555512520077804,0.218397291196388,2.131782983547,1694,703,991,57,1.4,11.61,4,0,0,0,0,0,0,0.197974184029272,3945.9852866811,19.8259020763937
7.5,"max_tuv_SVM","SVM",17,35,26540,23749,2791,3600,2874,726,0.554007035101843,0.218961625282167,1.88758822858093,1763,726,1037,69,1.4,11.94,4,0,0,0,0,0,0,0.197790550221648,3810.76942543184,19.785731942499
7.5,"max_tuv_SVM","SVM",17,36,26440,23677,2763,3700,2946,754,0.552883459049258,0.216704288939052,1.9110897939745,1824,754,1070,61,1.4,12.28,3.9,0,0,0,0,0,0,0.197810267572619,3256.66102574102,19.8800612210304
7.5,"max_tuv_SVM","SVM",17,37,26340,23603,2737,3800,3020,780,0.552422197938469,0.216139954853273,1.85819083654,1877,780,1097,53,1.4,12.61,3.9,0,0,0,0,0,0,0.202078861458889,4356.71106092703,20.2331028424105
7.5,"max_tuv_SVM","SVM",17,38,26240,23522,2718,3900,3101,799,0.55467130202257,0.22234762979684,1.94756097324882,1928,799,1129,51,1.4,12.94,3.9,0,0,0,0,0,0,0.201474323453343,3957.38008175309,20.2007244018517
7.5,"max_tuv_SVM","SVM",17,39,26140,23441,2699,4000,3182,818,0.554235671243972,0.218961625282167,2.00632632980263,2009,818,1191,81,1.5,13.27,3.9,0,0,0,0,0,0,0.20130120365591,4276.36896584015,20.1578998113762
7.5,"max_tuv_SVM","SVM",17,40,26040,23361,2679,4100,3262,838,0.555044193651926,0.219525959367946,2.0717500144701,1978,838,1140,-31,1.4,13.6,3.9,0,0,0,0,0,0,0.19769360113089,3146.98281711031,19.8982544449843
7.5,"max_tuv_SVM","SVM",17,41,25940,23280,2660,4200,3343,857,0.554072596133689,0.221218961625282,2.03334793735166,2067,857,1210,89,1.4,13.93,3.9,0,0,0,0,0,0,0.199172006729996,3768.09164921593,19.9714951284566
7.5,"max_tuv_SVM","SVM",17,42,25840,23205,2635,4300,3418,882,0.555029235552432,0.221218961625282,2.06073404016822,2159,882,1277,92,1.4,14.27,3.9,0,0,0,0,0,0,0.199610272597243,3919.55211269063,20.026058137449
7.5,"max_tuv_SVM","SVM",17,43,25740,23121,2619,4400,3502,898,0.553542633851016,0.220654627539503,1.88518375256669,2180,898,1282,21,1.4,14.6,3.9,0,0,0,0,0,0,0.198226547108764,3765.52034305314,19.8930900983644
7.5,"max_tuv_SVM","SVM",17,44,25640,23034,2606,4500,3589,911,0.553592154708077,0.223476297968397,1.92830670584572,2216,911,1305,36,1.4,14.93,3.9,0,0,0,0,0,0,0.19810935256508,3981.50133420457,19.8430039119098
7.5,"max_tuv_SVM","SVM",17,45,25540,22954,2586,4600,3669,931,0.552737315234584,0.213318284424379,1.85432623838634,2263,931,1332,47,1.4,15.26,3.9,0,0,0,0,0,0,0.199385519832148,3986.83571011457,19.9600016383335
7.5,"max_tuv_SVM","SVM",17,46,25440,22869,2571,4700,3754,946,0.552900899556766,0.220090293453725,1.89734320650642,2293,946,1347,30,1.4,15.59,4,0,0,0,0,0,0,0.197981251000855,3899.84358922399,19.8180344104307
7.5,"max_tuv_SVM","SVM",17,47,25340,22778,2562,4800,3845,955,0.553687037858379,0.217268623024831,1.96836025372616,2344,955,1389,51,1.5,15.93,4,0,0,0,0,0,0,0.194517419628638,3676.79887420327,19.4733911797222
7.5,"max_tuv_SVM","SVM",17,48,25240,22689,2551,4900,3934,966,0.551503982800853,0.211060948081264,1.76882059066316,2374,966,1408,30,1.5,16.26,4.1,0,0,0,0,0,0,0.193354374415921,3729.77186373984,19.3693072725019
7.5,"max_tuv_SVM","SVM",18,0,30040,26469,3571,100,86,14,0.638661082351562,0.247065727699531,2.44912348803469,48,14,34,0,2.4,0.33,6.1,0,0,0,0,0,0,0.886561425724987,4539.48837778769,91.530906699751
7.5,"max_tuv_SVM","SVM",18,1,29940,26396,3544,200,159,41,0.575780638921935,0.166666666666667,1.60949482253685,99,41,58,51,1.4,0.66,3.9,0,0,0,0,0,0,0.335787427286233,5641.2124260327,36.2091987927321
7.5,"max_tuv_SVM","SVM",18,2,29840,26334,3506,300,221,79,0.578776287936348,0.1731220657277,1.55662910798122,177,79,98,78,1.2,1,2.8,0,0,0,0,0,0,0.353221025160477,6464.06576000961,41.9481672083062
7.5,"max_tuv_SVM","SVM",18,3,29740,26264,3476,400,291,109,0.588292707919543,0.169014084507042,1.48323637477036,246,109,137,69,1.3,1.33,2.7,0,0,0,0,0,0,0.298712620287866,7270.80788345918,31.3403035006622
7.5,"max_tuv_SVM","SVM",18,4,29640,26192,3448,500,363,137,0.620425239650163,0.201291079812207,1.81544662713121,309,137,172,63,1.3,1.66,2.6,0,0,0,0,0,0,0.287564452657959,7491.55876026027,29.3430995283492
7.5,"max_tuv_SVM","SVM",18,5,29540,26124,3416,600,431,169,0.632414113869515,0.210680751173709,1.86943791225744,376,169,207,67,1.2,1.99,2.6,0,0,0,0,0,0,0.372624315596446,7697.04961550826,44.8744965554283
7.5,"max_tuv_SVM","SVM",18,6,29440,26049,3391,700,506,194,0.619377730561317,0.180164319248826,1.64804041641151,445,194,251,69,1.3,2.32,2.6,0,0,0,0,0,0,0.285202358138458,8046.77124515496,28.8613340705142
7.5,"max_tuv_SVM","SVM",18,7,29340,25974,3366,800,581,219,0.596637877563372,0.161971830985915,1.48323637477036,501,219,282,56,1.3,2.65,2.7,0,0,0,0,0,0,0.283804538043803,7618.22723836775,28.5519919791686
7.5,"max_tuv_SVM","SVM",18,8,29240,25891,3349,900,664,236,0.621151464910261,0.192488262910798,1.71997985534378,544,236,308,43,1.3,2.99,2.8,0,0,0,0,0,0,0.423983469537277,6485.73001011399,47.6121581894367
7.5,"max_tuv_SVM","SVM",18,9,29140,25801,3339,1000,754,246,0.630597156791764,0.222417840375587,1.94984205645395,561,246,315,17,1.3,3.32,3.1,0,0,0,0,0,0,0.25786234810417,5952.8301387374,27.2519247158119
7.5,"max_tuv_SVM","SVM",18,10,29040,25721,3319,1100,834,266,0.623697808280562,0.194835680751174,1.78620798038528,630,266,364,69,1.4,3.65,3.1,0,0,0,0,0,0,0.243304139466143,6707.91881664457,24.4288595488187
7.5,"max_tuv_SVM","SVM",18,11,28940,25643,3297,1200,912,288,0.629659252113765,0.220657276995305,2.07969062920647,681,288,393,51,1.4,3.98,3.2,0,0,0,0,0,0,0.239969061933725,6680.76175135632,24.0429995046666
7.5,"max_tuv_SVM","SVM",18,12,28840,25579,3261,1300,976,324,0.629218990534815,0.19424882629108,1.80768830821184,741,324,417,60,1.3,4.31,3,0,0,0,0,0,0,0.262355523066452,6101.85709415585,27.1889417169863
7.5,"max_tuv_SVM","SVM",18,13,28740,25485,3255,1400,1070,330,0.628876764865893,0.20481220657277,1.96973214834861,769,330,439,28,1.3,4.64,3.2,0,0,0,0,0,0,0.233957339680494,5498.16872296626,23.5699060686077
7.5,"max_tuv_SVM","SVM",18,14,28640,25408,3232,1500,1147,353,0.619025099827164,0.193075117370892,1.67036808900984,836,353,483,67,1.4,4.98,3.2,0,0,0,0,0,0,0.240223887657899,6293.34952441039,25.1115599898453
7.5,"max_tuv_SVM","SVM",18,15,28540,25318,3222,1600,1237,363,0.625363716299445,0.204225352112676,1.93736306729264,860,363,497,24,1.4,5.31,3.4,0,0,0,0,0,0,0.236844050791559,4819.49612181349,24.9909304259976
7.5,"max_tuv_SVM","SVM",18,16,28440,25245,3195,1700,1310,390,0.617755462351933,0.207159624413146,1.79207003300736,917,390,527,57,1.4,5.64,3.4,0,0,0,0,0,0,0.228299078254332,5658.19817028876,23.1183154053747
7.5,"max_tuv_SVM","SVM",18,17,28340,25160,3180,1800,1395,405,0.616834372610571,0.191901408450704,1.81049968510248,955,405,550,38,1.4,5.97,3.4,0,0,0,0,0,0,0.221427468543747,5546.24976136411,22.192240253994
7.5,"max_tuv_SVM","SVM",18,18,28240,25071,3169,1900,1484,416,0.619284304490322,0.203638497652582,1.89634326502999,1003,416,587,48,1.4,6.3,3.6,0,0,0,0,0,0,0.217915573868433,5497.66111707206,21.8068169095162
7.5,"max_tuv_SVM","SVM",18,19,28140,24986,3154,2000,1569,431,0.62068376381328,0.205985915492958,1.81641473625113,1047,431,616,44,1.4,6.64,3.6,0,0,0,0,0,0,0.211219285921363,5188.36024946177,21.1367538816022
7.5,"max_tuv_SVM","SVM",18,20,28040,24892,3148,2100,1663,437,0.62037090940446,0.212441314553991,1.90838510264359,1050,437,613,3,1.4,6.97,3.8,0,0,0,0,0,0,0.204239864077476,4502.7895320137,20.4481885480647
7.5,"max_tuv_SVM","SVM",18,21,27940,24814,3126,2200,1741,459,0.619302656039976,0.203638497652582,1.85996556710829,1127,459,668,77,1.5,7.3,3.8,0,0,0,0,0,0,0.205545574124442,5030.14002163887,20.5755868711958
7.5,"max_tuv_SVM","SVM",18,22,27840,24730,3110,2300,1825,475,0.624355785971399,0.216549295774648,1.95694709889994,1160,475,685,33,1.4,7.63,3.8,0,0,0,0,0,0,0.201433463191864,4256.80130357069,20.1765148257825
7.5,"max_tuv_SVM","SVM",18,23,27740,24641,3099,2400,1914,486,0.617679246346631,0.201291079812207,1.88213058628588,1172,486,686,12,1.4,7.96,3.9,0,0,0,0,0,0,0.201019929693621,5064.60120920707,20.1111496678073
7.5,"max_tuv_SVM","SVM",18,24,27640,24555,3085,2500,2000,500,0.618497163500181,0.213028169014085,1.93568714768426,1232,500,732,60,1.5,8.29,4,0,0,0,0,0,0,0.19759125157076,4651.13217046579,19.7764292058043
7.5,"max_tuv_SVM","SVM",18,25,27540,24473,3067,2600,2082,518,0.614645489329575,0.190727699530516,1.79809657248443,1234,518,716,2,1.4,8.63,4,0,0,0,0,0,0,0.196898041222484,4949.68574062637,19.6986608244394
7.5,"max_tuv_SVM","SVM",18,26,27440,24396,3044,2700,2159,541,0.618635414767844,0.204225352112676,1.94502062882345,1325,541,784,91,1.4,8.96,4,0,0,0,0,0,0,0.19582013611552,4715.67672066602,19.6303380179853
7.5,"max_tuv_SVM","SVM",18,27,27340,24311,3029,2800,2244,556,0.619181044096044,0.203638497652582,1.97654980608287,1338,556,782,13,1.4,9.29,4,0,0,0,0,0,0,0.192346531517709,4156.37745947617,19.4589786141582
7.5,"max_tuv_SVM","SVM",18,28,27240,24232,3008,2900,2323,577,0.621313862953788,0.20481220657277,1.95428326875372,1407,577,830,69,1.4,9.62,4,0,0,0,0,0,0,0.197040904983206,4962.40450946347,20.0948221891232
7.5,"max_tuv_SVM","SVM",18,29,27140,24147,2993,3000,2408,592,0.621402723088984,0.204225352112676,1.91439038270024,1408,592,816,1,1.4,9.95,4.1,0,0,0,0,0,0,0.192673638281455,4289.19298216986,19.3102289526292
7.5,"max_tuv_SVM","SVM",18,30,27040,24064,2976,3100,2491,609,0.620496779961579,0.2018779342723,1.96373616082154,1471,609,862,63,1.4,10.29,4.1,0,0,0,0,0,0,0.195370321171781,5036.83580945688,19.5440072387286
7.5,"max_tuv_SVM","SVM",18,31,26940,23984,2956,3200,2571,629,0.618117488377051,0.202464788732394,1.81031927325735,1504,629,875,33,1.4,10.62,4.1,0,0,0,0,0,0,0.191502961440984,4047.75981139924,19.1767993790962
7.5,"max_tuv_SVM","SVM",18,32,26840,23898,2942,3300,2657,643,0.619936443051719,0.207746478873239,1.91872547587455,1538,643,895,34,1.4,10.95,4.1,0,0,0,0,0,0,0.19098758304434,3941.86175956592,19.1433793276353
7.5,"max_tuv_SVM","SVM",18,33,26740,23816,2924,3400,2739,661,0.621677337785481,0.211267605633803,1.95533569885465,1551,661,890,13,1.3,11.28,4.1,0,0,0,0,0,0,0.190663158756827,4284.82768399317,19.0738764386139
7.5,"max_tuv_SVM","SVM",18,34,26640,23739,2901,3500,2816,684,0.617701768703034,0.197769953051643,1.74868963340677,1619,684,935,68,1.4,11.61,4.1,0,0,0,0,0,0,0.193789632958798,4865.23797921891,19.3882965910459
7.5,"max_tuv_SVM","SVM",18,35,26540,23660,2880,3600,2895,705,0.616079720009795,0.199530516431925,1.74734357698264,1667,705,962,48,1.4,11.94,4.1,0,0,0,0,0,0,0.191749345114446,4132.72426583926,19.2237834059156
7.5,"max_tuv_SVM","SVM",18,36,26440,23576,2864,3700,2979,721,0.617352957549791,0.2018779342723,1.87840708625499,1712,721,991,45,1.4,12.28,4.1,0,0,0,0,0,0,0.192891947160063,4576.88067214324,19.2977531652636
7.5,"max_tuv_SVM","SVM",18,37,26340,23494,2846,3800,3061,739,0.618498787919663,0.206572769953052,1.86319731227722,1752,739,1013,40,1.4,12.61,4.1,0,0,0,0,0,0,0.191111416641742,3844.67341504017,19.1410849316108
7.5,"max_tuv_SVM","SVM",18,38,26240,23409,2831,3900,3146,754,0.622329915379151,0.20481220657277,1.97637860553733,1772,754,1018,20,1.4,12.94,4.2,0,0,0,0,0,0,0.189756990243231,3915.2618530431,19.0008074536037
7.5,"max_tuv_SVM","SVM",18,39,26140,23347,2793,4000,3208,792,0.618108663828067,0.20481220657277,1.83229248744214,1853,792,1061,81,1.3,13.27,4.1,0,0,0,0,0,0,0.19311454083359,3960.17027741147,19.5288860608502
7.5,"max_tuv_SVM","SVM",18,40,26040,23263,2777,4100,3292,808,0.616657793824121,0.203051643192488,1.73703836800103,1871,808,1063,18,1.3,13.6,4.1,0,0,0,0,0,0,0.193776849619688,4250.57091089069,19.4236130758903
7.5,"max_tuv_SVM","SVM",18,41,25940,23182,2758,4200,3373,827,0.61741859287694,0.193075117370892,1.71976069379238,1944,827,1117,73,1.4,13.93,4.1,0,0,0,0,0,0,0.193586564986398,3948.72046656126,19.4079703463666
7.5,"max_tuv_SVM","SVM",18,42,25840,23094,2746,4300,3461,839,0.616199927050398,0.196596244131455,1.75662336260989,1989,839,1150,45,1.4,14.27,4.1,0,0,0,0,0,0,0.190824570090278,4122.34436863861,19.112910175302
7.5,"max_tuv_SVM","SVM",18,43,25740,23015,2725,4400,3540,860,0.616546235719596,0.203051643192488,1.76279180692438,2089,860,1229,100,1.4,14.6,4.1,0,0,0,0,0,0,0.189900650248102,3782.92522223669,19.0181609811163
7.5,"max_tuv_SVM","SVM",18,44,25640,22933,2707,4500,3622,878,0.617757042868161,0.20481220657277,1.93401412508471,2092,878,1214,3,1.4,14.93,4.1,0,0,0,0,0,0,0.191942722373628,4260.28049147244,19.2421957628844
7.5,"max_tuv_SVM","SVM",18,45,25540,22850,2690,4600,3705,895,0.613604060837927,0.190140845070423,1.79196927944478,2141,895,1246,49,1.4,15.26,4.1,0,0,0,0,0,0,0.191463259950177,4435.84592059402,19.1598572288889
7.5,"max_tuv_SVM","SVM",18,46,25440,22765,2675,4700,3790,910,0.615945244419816,0.20481220657277,1.97557193101334,2170,910,1260,29,1.4,15.59,4.2,0,0,0,0,0,0,0.190649809756363,4348.08084670753,19.0808432821559
7.5,"max_tuv_SVM","SVM",18,47,25340,22686,2654,4800,3869,931,0.61596100567896,0.200117370892019,1.98317028459416,2258,931,1327,88,1.4,15.93,4.2,0,0,0,0,0,0,0.190076425873298,4036.9499935698,19.0469910323639
7.5,"max_tuv_SVM","SVM",18,48,25240,22602,2638,4900,3953,947,0.613664998519587,0.197183098591549,1.8134649192578,2319,947,1372,61,1.4,16.26,4.2,0,0,0,0,0,0,0.189103627964938,3931.23289439398,18.9355023804542
7.5,"max_tuv_SVM","SVM",19,0,30040,26508,3532,100,92,8,0.442814170775865,0.109205260148656,0.936956080836618,31,8,23,0,2.9,0.33,11.5,0,0,0,0,0,0,0.0845788278334048,2465.2554105781,8.47795330838661
7.5,"max_tuv_SVM","SVM",19,1,29940,26420,3520,200,180,20,0.415039340042809,0,0.685962640547985,71,20,51,40,2.5,0.66,9,0,0,0,0,0,0,0.140237727049384,2962.09892606507,14.3026628462688
7.5,"max_tuv_SVM","SVM",19,2,29840,26327,3513,300,273,27,0.431497154227748,0.093767867352773,0.892467124070898,93,27,66,22,2.4,1,10.1,0,0,0,0,0,0,0.133804168860705,2303.21689734114,13.6152294851364
7.5,"max_tuv_SVM","SVM",19,3,29740,26233,3507,400,367,33,0.434860325959741,0.0909090909090909,0.705299825624811,109,33,76,16,2.3,1.33,11.1,0,0,0,0,0,0,0.112385401088046,2125.08249970571,11.7707336173638
7.5,"max_tuv_SVM","SVM",19,4,29640,26139,3501,500,461,39,0.42581408605548,0.0680388793596341,0.579032909546898,138,39,99,29,2.5,1.66,11.8,0,0,0,0,0,0,0.0821111237047896,2263.85721630066,8.23462525061631
7.5,"max_tuv_SVM","SVM",19,5,29540,26058,3482,600,542,58,0.581753796043959,0.205831903945111,1.90463203317608,161,58,103,23,1.8,1.99,9.3,0,0,0,0,0,0,0.147020894695523,2877.0890895349,17.6299267303034
7.5,"max_tuv_SVM","SVM",19,6,29440,25980,3460,700,620,80,0.563936850611179,0.157232704402516,1.40920204115105,225,80,145,64,1.8,2.32,7.8,0,0,0,0,0,0,0.119241501702883,3369.96693441264,12.1305694381819
7.5,"max_tuv_SVM","SVM",19,7,29340,25892,3448,800,708,92,0.429566460822747,0.0777587192681532,0.727754583931159,259,92,167,34,1.8,2.65,7.7,0,0,0,0,0,0,0.122968420303923,3328.93311946873,12.3950273049403
7.5,"max_tuv_SVM","SVM",19,8,29240,25797,3443,900,803,97,0.425621254910588,0.0954831332189823,0.812187626065882,282,97,185,23,1.9,2.99,8.3,0,0,0,0,0,0,0.111323964531121,3089.46360087996,11.1693394292674
7.5,"max_tuv_SVM","SVM",19,9,29140,25736,3404,1000,864,136,0.54576093796365,0.153802172670097,1.35167434612496,343,136,207,61,1.5,3.32,6.4,0,0,0,0,0,0,0.298323934289665,3961.09777581483,35.6749377604205
7.5,"max_tuv_SVM","SVM",19,10,29040,25653,3387,1100,947,153,0.569294663757508,0.163522012578616,1.52967695571166,379,153,226,36,1.5,3.65,6.2,0,0,0,0,0,0,0.212008170113655,3727.27037237493,23.8418263017072
7.5,"max_tuv_SVM","SVM",19,11,28940,25585,3355,1200,1015,185,0.54865383431835,0.150371640937679,1.38513608892978,440,185,255,61,1.4,3.98,5.5,0,0,0,0,0,0,0.176037242041666,4312.61100536962,18.1628028273181
7.5,"max_tuv_SVM","SVM",19,12,28840,25504,3336,1300,1096,204,0.549310267071779,0.125786163522013,1.09359700978674,500,204,296,60,1.5,4.31,5.4,0,0,0,0,0,0,0.227874594755186,4327.29536090484,24.9884095328327
7.5,"max_tuv_SVM","SVM",19,13,28740,25417,3323,1400,1183,217,0.527090222229195,0.126357918810749,1.08097612358111,532,217,315,32,1.5,4.64,5.5,0,0,0,0,0,0,0.159466521278939,4367.52536936809,16.0390019644034
7.5,"max_tuv_SVM","SVM",19,14,28640,25329,3311,1500,1271,229,0.52849527587301,0.13093196112064,1.228821902254,568,229,339,36,1.5,4.98,5.6,0,0,0,0,0,0,0.158143009604348,4228.98744586912,15.9933312667707
7.5,"max_tuv_SVM","SVM",19,15,28540,25238,3302,1600,1362,238,0.526193104619203,0.137793024585477,1.18463840733609,599,238,361,31,1.5,5.31,5.7,0,0,0,0,0,0,0.163537799826416,3938.70069557074,16.8714084326271
7.5,"max_tuv_SVM","SVM",19,16,28440,25148,3292,1700,1452,248,0.527134728326967,0.141795311606632,1.23098913664951,625,248,377,26,1.5,5.64,5.9,0,0,0,0,0,0,0.156924863057676,3745.14117593894,16.4450314033793
7.5,"max_tuv_SVM","SVM",19,17,28340,25055,3285,1800,1545,255,0.530799850541921,0.152086906803888,1.50777322074306,656,255,401,31,1.6,5.97,6.1,0,0,0,0,0,0,0.151860444416154,3641.02190572566,15.4064435987931
7.5,"max_tuv_SVM","SVM",19,18,28240,24964,3276,1900,1636,264,0.534807502328956,0.141223556317896,1.32277341438215,690,264,426,34,1.6,6.3,6.2,0,0,0,0,0,0,0.145549991118387,3469.96582035938,14.6220087519863
7.5,"max_tuv_SVM","SVM",19,19,28140,24874,3266,2000,1726,274,0.528201758802012,0.13893653516295,1.24174013347615,734,274,460,44,1.7,6.64,6.3,0,0,0,0,0,0,0.142560439063756,3528.3867235182,14.4801463855173
7.5,"max_tuv_SVM","SVM",19,20,28040,24794,3246,2100,1806,294,0.523274843651409,0.129788450543168,1.12921870670663,784,294,490,50,1.7,6.97,6.1,0,0,0,0,0,0,0.143030919223736,3691.84936604421,14.3995257857222
7.5,"max_tuv_SVM","SVM",19,21,27940,24705,3235,2200,1895,305,0.520993573525493,0.130360205831904,1.2288612384012,808,305,503,24,1.6,7.3,6.2,0,0,0,0,0,0,0.140181416222944,3502.32922059881,14.0556378778623
7.5,"max_tuv_SVM","SVM",19,22,27840,24619,3221,2300,1981,319,0.523583510821246,0.141795311606632,1.25241627566865,854,319,535,46,1.7,7.63,6.2,0,0,0,0,0,0,0.141366219276516,3492.07151204403,14.1568106009339
7.5,"max_tuv_SVM","SVM",19,23,27740,24537,3203,2400,2063,337,0.523285358592544,0.146369353916524,1.31355548118088,900,337,563,46,1.7,7.96,6.1,0,0,0,0,0,0,0.141261471626486,3480.16779303469,14.2674091391825
7.5,"max_tuv_SVM","SVM",19,24,27640,24468,3172,2500,2132,368,0.5318775676306,0.148656375071469,1.45263237043283,967,368,599,67,1.6,8.29,5.8,0,0,0,0,0,0,0.150507676471981,3710.81340617943,15.7373855267632
7.5,"max_tuv_SVM","SVM",19,25,27540,24380,3160,2600,2220,380,0.52770120468608,0.139508290451687,1.15538340247813,1033,380,653,66,1.7,8.63,5.8,0,0,0,0,0,0,0.147117506962631,3704.18528634301,15.0116613002006
7.5,"max_tuv_SVM","SVM",19,26,27440,24292,3148,2700,2308,392,0.528686905310343,0.152658662092624,1.35124000346875,1066,392,674,33,1.7,8.96,5.9,0,0,0,0,0,0,0.148306362987619,3504.08327444948,14.8589055050767
7.5,"max_tuv_SVM","SVM",19,27,27340,24198,3142,2800,2402,398,0.522394936210361,0.145797598627787,1.2363412633306,1091,398,693,25,1.7,9.29,6,0,0,0,0,0,0,0.144765601857797,3302.55367859079,14.490141523306
7.5,"max_tuv_SVM","SVM",19,28,27240,24111,3129,2900,2489,411,0.521195889576466,0.134934248141795,1.23524125801963,1115,411,704,24,1.7,9.62,6.1,0,0,0,0,0,0,0.142746222958049,3364.11204144551,14.2872254665501
7.5,"max_tuv_SVM","SVM",19,29,27140,24027,3113,3000,2573,427,0.520801429070628,0.133790737564322,1.25569485230653,1190,427,763,75,1.8,9.95,6,0,0,0,0,0,0,0.145011466343016,3408.52776533733,14.5318759705052
7.5,"max_tuv_SVM","SVM",19,30,27040,23939,3101,3100,2661,439,0.526525720103946,0.142938822184105,1.25756489521276,1201,439,762,11,1.7,10.29,6.1,0,0,0,0,0,0,0.142620259546737,3473.5416219094,14.2849901762653
7.5,"max_tuv_SVM","SVM",19,31,26940,23849,3091,3200,2751,449,0.516258416566602,0.133790737564322,1.13204186810292,1261,449,812,60,1.8,10.62,6.1,0,0,0,0,0,0,0.142947103445806,3368.29559472271,14.3292616372339
7.5,"max_tuv_SVM","SVM",19,32,26840,23757,3083,3300,2843,457,0.519761909115038,0.134934248141795,1.20651830679391,1260,457,803,-1,1.8,10.95,6.2,0,0,0,0,0,0,0.139411704124013,3315.65287267194,13.9722335607888
7.5,"max_tuv_SVM","SVM",19,33,26740,23669,3071,3400,2931,469,0.520347226531922,0.146369353916524,1.35430065638297,1286,469,817,26,1.7,11.28,6.2,0,0,0,0,0,0,0.140211095867091,3261.83960933122,14.0504436962459
7.5,"max_tuv_SVM","SVM",19,34,26640,23582,3058,3500,3018,482,0.514586540926859,0.141795311606632,1.32797615953705,1333,482,851,47,1.8,11.61,6.3,0,0,0,0,0,0,0.138708700681689,3299.09812541039,13.9068904637749
7.5,"max_tuv_SVM","SVM",19,35,26540,23496,3044,3600,3104,496,0.525543281257337,0.147512864493997,1.32912691877409,1369,496,873,36,1.8,11.94,6.3,0,0,0,0,0,0,0.138789794503209,3268.20044030328,13.8988073854366
7.5,"max_tuv_SVM","SVM",19,36,26440,23408,3032,3700,3192,508,0.525984608357934,0.14694110920526,1.38861579439122,1403,508,895,34,1.8,12.28,6.3,0,0,0,0,0,0,0.138020260978614,3324.57641322676,13.8135039382474
7.5,"max_tuv_SVM","SVM",19,37,26340,23323,3017,3800,3277,523,0.521868759972568,0.148656375071469,1.33143443078585,1457,523,934,54,1.8,12.61,6.3,0,0,0,0,0,0,0.137978848899578,3424.6561935175,13.8078564269835
7.5,"max_tuv_SVM","SVM",19,38,26240,23231,3009,3900,3369,531,0.527334812635341,0.163522012578616,1.41637906686781,1441,531,910,-16,1.7,12.94,6.3,0,0,0,0,0,0,0.136698255877496,3132.54647028726,13.6880888952908
7.5,"max_tuv_SVM","SVM",19,39,26140,23140,3000,4000,3460,540,0.520689799022138,0.141223556317896,1.33082777240884,1458,540,918,17,1.7,13.27,6.4,0,0,0,0,0,0,0.135773771117767,3176.81412772928,13.5888627000925
7.5,"max_tuv_SVM","SVM",19,40,26040,23048,2992,4100,3552,548,0.524938650683274,0.14694110920526,1.39150671837151,1496,548,948,38,1.7,13.6,6.5,0,0,0,0,0,0,0.134626069562437,3034.41160921568,13.4914522637199
7.5,"max_tuv_SVM","SVM",19,41,25940,22953,2987,4200,3647,553,0.522402446882592,0.145225843339051,1.33374996892634,1521,553,968,25,1.8,13.93,6.6,0,0,0,0,0,0,0.131656630740383,3010.76774164066,13.2151496652406
7.5,"max_tuv_SVM","SVM",19,42,25840,22873,2967,4300,3727,573,0.524653931828331,0.151515151515152,1.46845503411737,1581,573,1008,60,1.8,14.27,6.5,0,0,0,0,0,0,0.134228788137446,3042.56271915728,13.4986856262714
7.5,"max_tuv_SVM","SVM",19,43,25740,22784,2956,4400,3816,584,0.522481201645761,0.14065180102916,1.27491477163875,1602,584,1018,21,1.7,14.6,6.5,0,0,0,0,0,0,0.1334469561812,2924.47764982613,13.3693452845127
7.5,"max_tuv_SVM","SVM",19,44,25640,22715,2925,4500,3885,615,0.527247817591782,0.156089193825043,1.34873592363338,1612,615,997,10,1.6,14.93,6.3,0,0,0,0,0,0,0.136579474612253,3392.19367978996,16.4343471055508
7.5,"max_tuv_SVM","SVM",19,45,25540,22628,2912,4600,3972,628,0.52132198303378,0.144082332761578,1.31176270204646,1668,628,1040,56,1.7,15.26,6.3,0,0,0,0,0,0,0.13661240659138,3337.6076168712,16.0754254056208
7.5,"max_tuv_SVM","SVM",19,46,25440,22546,2894,4700,4054,646,0.516240176362607,0.148084619782733,1.34357960646502,1684,646,1038,16,1.6,15.59,6.3,0,0,0,0,0,0,0.13738921612474,3328.19874305621,16.2060715550746
7.5,"max_tuv_SVM","SVM",19,47,25340,22465,2875,4800,4135,665,0.518006600636272,0.146369353916524,1.38499646564824,1752,665,1087,68,1.6,15.93,6.2,0,0,0,0,0,0,0.138845777287891,3281.5313936548,14.776819385266
7.5,"max_tuv_SVM","SVM",19,48,25240,22372,2868,4900,4228,672,0.522010690218762,0.143510577472842,1.27518401808789,1796,672,1124,44,1.7,16.26,6.3,0,0,0,0,0,0,0.137144323126146,3296.4534442315,13.7214981081621
7.5,"max_tuv_SVM","SVM",20,0,30040,26527,3513,100,86,14,0.423616502500718,0.0828603859250851,0.728274235470233,45,14,31,0,2.2,0.33,6.1,0,0,0,0,0,0,0.147353808001996,4234.76323888358,14.7857990884244
7.5,"max_tuv_SVM","SVM",20,1,29940,26453,3487,200,160,40,0.588569250971556,0.194097616345062,2.00328424637075,112,40,72,67,1.8,0.66,4,0,0,0,0,0,0,0.520640465522624,5935.47685081583,57.7995642991132
7.5,"max_tuv_SVM","SVM",20,2,29840,26393,3447,300,220,80,0.528690782926288,0.122020431328036,1.06533641308549,191,80,111,79,1.4,1,2.8,0,0,0,0,0,0,0.335591465793522,7407.81718180502,35.111081201753
7.5,"max_tuv_SVM","SVM",20,3,29740,26303,3437,400,310,90,0.575886023206884,0.184449489216799,1.49888669746969,225,90,135,34,1.5,1.33,3.4,0,0,0,0,0,0,0.273109205183563,5716.68859211599,28.1867104115768
7.5,"max_tuv_SVM","SVM",20,4,29640,26217,3423,500,396,104,0.553943125545781,0.163450624290579,1.56517459072984,261,104,157,36,1.5,1.66,3.8,0,0,0,0,0,0,0.244153207810284,4886.28333510606,25.5090019673225
7.5,"max_tuv_SVM","SVM",20,5,29540,26149,3391,600,464,136,0.53937509450775,0.171963677639047,1.59779774288585,315,136,179,54,1.3,1.99,3.4,0,0,0,0,0,0,0.246515704812059,5632.67399937346,26.8038682327818
7.5,"max_tuv_SVM","SVM",20,6,29440,26071,3369,700,542,158,0.537948491240553,0.17366628830874,1.69171086487203,380,158,222,65,1.4,2.32,3.4,0,0,0,0,0,0,0.258908134332794,4776.06350983757,26.500747873395
7.5,"max_tuv_SVM","SVM",20,7,29340,26001,3339,800,612,188,0.528593108927765,0.162883087400681,1.47241898361802,441,188,253,61,1.3,2.65,3.3,0,0,0,0,0,0,0.261052612764103,5900.76685037468,28.5926546580718
7.5,"max_tuv_SVM","SVM",20,8,29240,25924,3316,900,689,211,0.518564882613377,0.158342792281498,1.46086224895822,496,211,285,55,1.4,2.99,3.3,0,0,0,0,0,0,0.261275650898004,4618.09146664373,26.5904904737088
7.5,"max_tuv_SVM","SVM",20,9,29140,25855,3285,1000,758,242,0.515645174179539,0.147559591373439,1.44378772088216,568,242,326,72,1.3,3.32,3.1,0,0,0,0,0,0,0.244680407510498,4886.32724658577,24.9156869176431
7.5,"max_tuv_SVM","SVM",20,10,29040,25762,3278,1100,851,249,0.517383199935799,0.162883087400681,1.57658619472626,590,249,341,22,1.4,3.65,3.4,0,0,0,0,0,0,0.222024401907779,5061.725053185,22.3272751862059
7.5,"max_tuv_SVM","SVM",20,11,28940,25674,3266,1200,939,261,0.519747631368226,0.161748013620885,1.57328430363518,628,261,367,38,1.4,3.98,3.6,0,0,0,0,0,0,0.211230359006614,4598.81670801051,21.3382824696721
7.5,"max_tuv_SVM","SVM",20,12,28840,25586,3254,1300,1027,273,0.515947748227351,0.15266742338252,1.58340533916712,667,273,394,39,1.4,4.31,3.8,0,0,0,0,0,0,0.205267357458917,4172.12125779679,20.5455883008444
7.5,"max_tuv_SVM","SVM",20,13,28740,25520,3220,1400,1093,307,0.516387782277004,0.153234960272418,1.59080442953705,736,307,429,69,1.4,4.64,3.6,0,0,0,0,0,0,0.212755836209588,4476.83727310757,21.2897101663956
7.5,"max_tuv_SVM","SVM",20,14,28640,25432,3208,1500,1181,319,0.517416632118656,0.158910329171396,1.65168108340835,773,319,454,37,1.4,4.98,3.7,0,0,0,0,0,0,0.205695411457309,3919.9752470338,20.5977182992534
7.5,"max_tuv_SVM","SVM",20,15,28540,25343,3197,1600,1270,330,0.512634508033917,0.148127128263337,1.57658619472626,807,330,477,34,1.4,5.31,3.8,0,0,0,0,0,0,0.201515856587872,4528.22930484873,20.1595736735223
7.5,"max_tuv_SVM","SVM",20,16,28440,25266,3174,1700,1347,353,0.51423831466319,0.154370034052213,1.60054074330282,859,353,506,52,1.4,5.64,3.8,0,0,0,0,0,0,0.201819189500636,3926.64815697343,20.1985914631313
7.5,"max_tuv_SVM","SVM",20,17,28340,25183,3157,1800,1430,370,0.512111192028744,0.154370034052213,1.60467294831995,868,370,498,9,1.3,5.97,3.9,0,0,0,0,0,0,0.200895937096766,4087.9225319042,20.1221460384277
7.5,"max_tuv_SVM","SVM",20,18,28240,25093,3147,1900,1520,380,0.510395148785578,0.149262202043133,1.55848008863091,922,380,542,54,1.4,6.3,4,0,0,0,0,0,0,0.192223063885754,3635.75037318574,19.301194182736
7.5,"max_tuv_SVM","SVM",20,19,28140,25009,3131,2000,1604,396,0.51117040016873,0.151532349602724,1.57057174449098,964,396,568,42,1.4,6.64,4.1,0,0,0,0,0,0,0.190792260087931,3947.26516338087,19.1436253181845
7.5,"max_tuv_SVM","SVM",20,20,28040,24927,3113,2100,1686,414,0.50853710405144,0.150397275822929,1.51977951313616,1008,414,594,44,1.4,6.97,4.1,0,0,0,0,0,0,0.189619589670301,3854.07994395688,19.0271712115191
7.5,"max_tuv_SVM","SVM",20,21,27940,24839,3101,2200,1774,426,0.510353827630998,0.154370034052213,1.5531467527317,1051,426,625,43,1.5,7.3,4.2,0,0,0,0,0,0,0.188982397395154,4436.04613848396,18.9323543238565
7.5,"max_tuv_SVM","SVM",20,22,27840,24751,3089,2300,1862,438,0.543114509746461,0.175368898978434,1.76764332123945,1002,438,564,-49,1.3,7.63,4.3,0,0,0,0,0,0,0.189756674873653,5133.52855442851,19.0261247041298
7.5,"max_tuv_SVM","SVM",20,23,27740,24671,3069,2400,1942,458,0.55878153850982,0.183881952326901,1.80070494055798,1072,458,614,70,1.3,7.96,4.2,0,0,0,0,0,0,0.190866119406697,5048.92035184653,19.3091989163286
7.5,"max_tuv_SVM","SVM",20,24,27640,24588,3052,2500,2025,475,0.559605530945274,0.188989784335982,1.74855505301201,1150,475,675,78,1.4,8.29,4.3,0,0,0,0,0,0,0.188816630305349,4830.64052258001,18.9221780162722
7.5,"max_tuv_SVM","SVM",20,25,27540,24496,3044,2600,2117,483,0.555534693608117,0.186152099886493,1.76788763353666,1126,483,643,-24,1.3,8.63,4.4,0,0,0,0,0,0,0.185662893017215,5056.25466537188,18.5687361329215
7.5,"max_tuv_SVM","SVM",20,26,27440,24416,3024,2700,2197,503,0.556173444458953,0.185584562996595,1.80031819121508,1181,503,678,55,1.3,8.96,4.4,0,0,0,0,0,0,0.185232136066953,4882.92708672749,18.5299429827528
7.5,"max_tuv_SVM","SVM",20,27,27340,24333,3007,2800,2280,520,0.553162927564145,0.186152099886493,1.74888052860893,1228,520,708,47,1.4,9.29,4.4,0,0,0,0,0,0,0.184947764696048,4825.55134296463,18.5012281622056
7.5,"max_tuv_SVM","SVM",20,28,27240,24255,2985,2900,2358,542,0.555179348735956,0.180476730987514,1.75021428404833,1261,542,719,33,1.3,9.62,4.4,0,0,0,0,0,0,0.186648981446081,5004.58231158941,18.6669815814908
7.5,"max_tuv_SVM","SVM",20,29,27140,24181,2959,3000,2432,568,0.556189265045482,0.185017026106697,1.8030194713299,1344,568,776,83,1.4,9.95,4.3,0,0,0,0,0,0,0.188589765163392,5001.52473973622,18.8624883607993
7.5,"max_tuv_SVM","SVM",20,30,27040,24113,2927,3100,2500,600,0.557703052110964,0.188989784335982,1.78802932984159,1378,600,778,34,1.3,10.29,4.2,0,0,0,0,0,0,0.192537100629818,4957.02241251014,19.2733352164972
7.5,"max_tuv_SVM","SVM",20,31,26940,24038,2902,3200,2575,625,0.558293360411132,0.183314415437003,1.76012783092806,1435,625,810,57,1.3,10.62,4.1,0,0,0,0,0,0,0.19496342646706,5166.03025808082,19.5269727579489
7.5,"max_tuv_SVM","SVM",20,32,26840,23952,2888,3300,2661,639,0.552354798358306,0.184449489216799,1.71066969353008,1493,639,854,58,1.3,10.95,4.2,0,0,0,0,0,0,0.193379455725947,5103.88367689723,19.3408283026853
7.5,"max_tuv_SVM","SVM",20,33,26740,23869,2871,3400,2744,656,0.553671744918586,0.182179341657208,1.75153893535503,1526,656,870,33,1.3,11.28,4.2,0,0,0,0,0,0,0.19261608916958,5102.6178329714,19.263742961194
7.5,"max_tuv_SVM","SVM",20,34,26640,23783,2857,3500,2830,670,0.550945572150445,0.185584562996595,1.66233741623,1574,670,904,48,1.3,11.61,4.2,0,0,0,0,0,0,0.190042158112973,4634.22108883661,19.0226002894627
7.5,"max_tuv_SVM","SVM",20,35,26540,23709,2831,3600,2904,696,0.551477629989144,0.183881952326901,1.68142747654666,1629,696,933,55,1.3,11.94,4.2,0,0,0,0,0,0,0.192557930797996,4915.91994052481,19.261300999081
7.5,"max_tuv_SVM","SVM",20,36,26440,23632,2808,3700,2981,719,0.553638014234093,0.182179341657208,1.63616571883321,1690,719,971,61,1.4,12.28,4.1,0,0,0,0,0,0,0.192744987547759,4483.01534547888,19.2886764846029
7.5,"max_tuv_SVM","SVM",20,37,26340,23549,2791,3800,3064,736,0.555231586521674,0.185017026106697,1.78377523598863,1732,736,996,42,1.4,12.61,4.2,0,0,0,0,0,0,0.192943226318076,4935.62002375543,19.2988004192226
7.5,"max_tuv_SVM","SVM",20,38,26240,23465,2775,3900,3148,752,0.553762830559638,0.185017026106697,1.74302973932343,1727,752,975,-5,1.3,12.94,4.2,0,0,0,0,0,0,0.192448506697741,4994.94415574242,19.2465163759992
7.5,"max_tuv_SVM","SVM",20,39,26140,23374,2766,4000,3239,761,0.553096319056965,0.18161180476731,1.71944986304349,1804,761,1043,77,1.4,13.27,4.3,0,0,0,0,0,0,0.189419045452482,4761.5819360777,18.9472480905097
7.5,"max_tuv_SVM","SVM",20,40,26040,23290,2750,4100,3323,777,0.556032764903781,0.183881952326901,1.83705937879089,1839,777,1062,35,1.4,13.6,4.3,0,0,0,0,0,0,0.187870012258584,4450.08815175534,18.8004402132727
7.5,"max_tuv_SVM","SVM",20,41,25940,23198,2742,4200,3415,785,0.555353161972359,0.179909194097616,1.60978024065927,1861,785,1076,22,1.4,13.93,4.4,0,0,0,0,0,0,0.186108436078107,4562.94674807536,18.707429597664
7.5,"max_tuv_SVM","SVM",20,42,25840,23105,2735,4300,3508,792,0.555323823526175,0.18671963677639,1.73556813941194,1863,792,1071,2,1.4,14.27,4.4,0,0,0,0,0,0,0.183191135206195,4497.69050703539,18.3279928338237
7.5,"max_tuv_SVM","SVM",20,43,25740,23017,2723,4400,3596,804,0.553257509938615,0.182179341657208,1.69738580462432,1923,804,1119,60,1.4,14.6,4.5,0,0,0,0,0,0,0.182121305932226,4436.53667943602,18.2193988722984
7.5,"max_tuv_SVM","SVM",20,44,25640,22926,2714,4500,3687,813,0.552413688466127,0.167423382519864,1.52076013518502,1910,813,1097,-13,1.3,14.93,4.5,0,0,0,0,0,0,0.180342754961577,4497.67057118803,18.037557785831
7.5,"max_tuv_SVM","SVM",20,45,25540,22844,2696,4600,3769,831,0.55410508400305,0.178206583427923,1.67814183418897,1997,831,1166,87,1.4,15.26,4.5,0,0,0,0,0,0,0.180441983894402,4538.35105799742,18.0460829408363
7.5,"max_tuv_SVM","SVM",20,46,25440,22756,2684,4700,3857,843,0.554220305633268,0.170828603859251,1.55043350367644,2021,843,1178,24,1.4,15.59,4.6,0,0,0,0,0,0,0.178686527018375,4354.62780198446,17.9374075977109
7.5,"max_tuv_SVM","SVM",20,47,25340,22672,2668,4800,3941,859,0.553445480681013,0.152099886492622,1.39223334365219,2051,859,1192,30,1.4,15.93,4.6,0,0,0,0,0,0,0.178470043000026,4414.24434390381,17.8492054031303
7.5,"max_tuv_SVM","SVM",20,48,25240,22585,2655,4900,4028,872,0.55448878653031,0.185584562996595,1.4929748400112,2075,872,1203,24,1.4,16.26,4.6,0,0,0,0,0,0,0.177132445314962,4145.77420491423,17.946478368146
7.5,"greedy_SVM","SVM",1,0,30040,26573,3467,100,90,10,0.558458064304523,0.16832229580574,1.55436155885987,31,10,21,0,2.1,0.33,9,0,0,0,0,0,0,0.157773724712891,3009.97385058155,18.1507934823021
7.5,"greedy_SVM","SVM",1,1,29940,26494,3446,200,169,31,0.534873392674092,0.179359823399558,1.90026846991546,82,31,51,51,1.6,0.66,5.5,0,0,0,0,0,0,0.365600626603955,4062.47516775259,43.1159374478706
7.5,"greedy_SVM","SVM",1,2,29840,26433,3407,300,230,70,0.488548908509309,0.110927152317881,0.939174448771714,169,70,99,87,1.4,1,3.3,0,0,0,0,0,0,0.244975369761081,6903.07075213829,24.7004565878246
7.5,"greedy_SVM","SVM",1,3,29740,26344,3396,400,319,81,0.480554546896968,0.139072847682119,1.11446223815649,206,81,125,37,1.5,1.33,3.9,0,0,0,0,0,0,0.225113980014097,5581.02566098876,25.8780728322179
7.5,"greedy_SVM","SVM",1,4,29640,26264,3376,500,399,101,0.5061511802471,0.146247240618102,1.34317112966695,238,101,137,32,1.4,1.66,4,0,0,0,0,0,0,0.22270446609327,5510.76792139059,23.5157278668006
7.5,"greedy_SVM","SVM",1,5,29540,26190,3350,600,473,127,0.561652695565861,0.177152317880795,1.49360484096633,296,127,169,58,1.3,1.99,3.7,0,0,0,0,0,0,0.265641172615715,5224.22646479648,28.7851821374445
7.5,"greedy_SVM","SVM",1,6,29440,26123,3317,700,540,160,0.546059263839623,0.206401766004415,1.86035990601291,363,160,203,67,1.3,2.32,3.4,0,0,0,0,0,0,0.265494743886938,5203.12318440069,27.3343726785459
7.5,"greedy_SVM","SVM",1,7,29340,26047,3293,800,616,184,0.55782377482945,0.177704194260486,1.5870521610933,411,184,227,48,1.2,2.65,3.3,0,0,0,0,0,0,0.269695247133983,5155.67395218615,28.5688116659747
7.5,"greedy_SVM","SVM",1,8,29240,25959,3281,900,704,196,0.541955632785233,0.186534216335541,1.63415361126509,440,196,244,29,1.2,2.99,3.6,0,0,0,0,0,0,0.234196602117067,5046.9374530316,24.183155835334
7.5,"greedy_SVM","SVM",1,9,29140,25868,3272,1000,795,205,0.559479653705164,0.199779249448124,1.98240645282792,471,205,266,31,1.3,3.32,3.9,0,0,0,0,0,0,0.210301781140435,4008.93290670525,22.0006428181977
7.5,"greedy_SVM","SVM",1,10,29040,25795,3245,1100,868,232,0.548233887365788,0.188189845474614,1.78859374084276,524,232,292,53,1.3,3.65,3.7,0,0,0,0,0,0,0.23010361419837,3909.76650270705,26.4583098544357
7.5,"greedy_SVM","SVM",1,11,28940,25702,3238,1200,961,239,0.544808499437348,0.191501103752759,1.84011701732794,550,239,311,26,1.3,3.98,4,0,0,0,0,0,0,0.1954598215934,3505.31518760538,20.0492580644362
7.5,"greedy_SVM","SVM",1,12,28840,25630,3210,1300,1033,267,0.538587392927491,0.194812362030905,1.89900076188244,615,267,348,65,1.3,4.31,3.9,0,0,0,0,0,0,0.201811151670042,4320.79088585807,20.3964898085723
7.5,"greedy_SVM","SVM",1,13,28740,25550,3190,1400,1113,287,0.54000040290846,0.195916114790287,1.89230234649661,656,287,369,41,1.3,4.64,3.9,0,0,0,0,0,0,0.197353675617332,3725.75811050303,19.9525420553834
7.5,"greedy_SVM","SVM",1,14,28640,25476,3164,1500,1187,313,0.538301860687905,0.198123620309051,1.90757719479975,706,313,393,50,1.3,4.98,3.8,0,0,0,0,0,0,0.204160190575381,4154.23871191295,20.6008266458935
7.5,"greedy_SVM","SVM",1,15,28540,25414,3126,1600,1249,351,0.541455035664895,0.201434878587196,2.01366910654119,802,351,451,96,1.3,5.31,3.6,0,0,0,0,0,0,0.217977664479339,4513.03838396652,21.989041966578
7.5,"greedy_SVM","SVM",1,16,28440,25339,3101,1700,1324,376,0.540786990118914,0.199779249448124,1.97545673695473,853,376,477,51,1.3,5.64,3.5,0,0,0,0,0,0,0.221347538466983,3632.71228234477,22.2426907104049
7.5,"greedy_SVM","SVM",1,17,28340,25254,3086,1800,1409,391,0.540175260188132,0.199227373068433,1.97372691494338,889,391,498,36,1.3,5.97,3.6,0,0,0,0,0,0,0.217011142589645,4141.58569173351,21.8009969496589
7.5,"greedy_SVM","SVM",1,18,28240,25166,3074,1900,1497,403,0.542561868509658,0.199227373068433,1.96259778862166,922,403,519,33,1.3,6.3,3.7,0,0,0,0,0,0,0.205852443889082,3802.35599970863,20.9525857741853
7.5,"greedy_SVM","SVM",1,19,28140,25086,3054,2000,1577,423,0.543997271543826,0.201986754966887,2.02293739220787,960,423,537,38,1.3,6.64,3.7,0,0,0,0,0,0,0.203883130609772,4118.00517778058,20.5480165645571
7.5,"greedy_SVM","SVM",1,20,28040,25012,3028,2100,1651,449,0.548629761583087,0.204746136865342,2.05925088232387,1018,449,569,58,1.3,6.97,3.7,0,0,0,0,0,0,0.209254999874451,4910.01181153134,21.1102410478806
7.5,"greedy_SVM","SVM",1,21,27940,24935,3005,2200,1728,472,0.550677477266899,0.208057395143488,1.99761174894204,1070,472,598,52,1.3,7.3,3.7,0,0,0,0,0,0,0.210955454715622,4784.40466558744,21.2077015272055
7.5,"greedy_SVM","SVM",1,22,27840,24851,2989,2300,1812,488,0.554370374773139,0.205849889624724,2.07569066700688,1112,488,624,42,1.3,7.63,3.7,0,0,0,0,0,0,0.210019763765203,4340.32058512794,21.1152311537604
7.5,"greedy_SVM","SVM",1,23,27740,24771,2969,2400,1892,508,0.553452217969493,0.204746136865342,2.08115141788292,1157,508,649,45,1.3,7.96,3.7,0,0,0,0,0,0,0.210480563027512,4408.56798151158,21.089343822098
7.5,"greedy_SVM","SVM",1,24,27640,24691,2949,2500,1972,528,0.554174248255215,0.206953642384106,2.07569066700688,1196,528,668,39,1.3,8.29,3.7,0,0,0,0,0,0,0.210548107666799,4477.17638896851,21.1181553129164
7.5,"greedy_SVM","SVM",1,25,27540,24605,2935,2600,2058,542,0.557959798059622,0.208057395143488,2.11210629274384,1221,542,679,25,1.3,8.63,3.8,0,0,0,0,0,0,0.204890466298434,4311.21827745607,20.7245644656069
7.5,"greedy_SVM","SVM",1,26,27440,24524,2916,2700,2139,561,0.559718318699601,0.206401766004415,2.11938941789123,1260,561,699,39,1.2,8.96,3.8,0,0,0,0,0,0,0.203882259340726,4581.38147486715,20.4904636094824
7.5,"greedy_SVM","SVM",1,27,27340,24442,2898,2800,2221,579,0.562610477251745,0.206953642384106,2.13022497645842,1309,579,730,49,1.3,9.29,3.8,0,0,0,0,0,0,0.202472610467226,4477.45089497357,20.4131313282401
7.5,"greedy_SVM","SVM",1,28,27240,24359,2881,2900,2304,596,0.564905557090051,0.208609271523179,2.14664219676735,1366,596,770,57,1.3,9.62,3.9,0,0,0,0,0,0,0.202810603233986,4727.79938754253,20.4576428889966
7.5,"greedy_SVM","SVM",1,29,27140,24278,2862,3000,2385,615,0.567428230264522,0.20916114790287,2.11395739378919,1412,615,797,46,1.3,9.95,3.9,0,0,0,0,0,0,0.201338908424814,4748.40668972648,20.3414953321327
7.5,"greedy_SVM","SVM",1,30,27040,24189,2851,3100,2474,626,0.565217644660375,0.208057395143488,2.11025843072044,1436,626,810,24,1.3,10.29,4,0,0,0,0,0,0,0.196656122444622,4245.81304288307,19.7276153563641
7.5,"greedy_SVM","SVM",1,31,26940,24098,2842,3200,2565,635,0.564027399773611,0.211920529801325,1.91219489392717,1467,635,832,31,1.3,10.62,4,0,0,0,0,0,0,0.200094714450433,3910.14232210544,20.0998830609834
7.5,"greedy_SVM","SVM",1,32,26840,24019,2821,3300,2644,656,0.561962160901336,0.210264900662252,1.93710950565255,1497,656,841,30,1.3,10.95,4,0,0,0,0,0,0,0.199041396019067,4394.77013583813,19.9340810662589
7.5,"greedy_SVM","SVM",1,33,26740,23928,2812,3400,2735,665,0.563456918013294,0.210816777041943,1.95701856901701,1527,665,862,30,1.3,11.28,4.1,0,0,0,0,0,0,0.195745320008544,4935.85807180227,19.5764652212222
7.5,"greedy_SVM","SVM",1,34,26640,23830,2810,3500,2833,667,0.564575779840169,0.20916114790287,2.08655213315551,1526,667,859,-1,1.3,11.61,4.2,0,0,0,0,0,0,0.187608611260116,3686.04900909605,18.808112455044
7.5,"greedy_SVM","SVM",1,35,26540,23743,2797,3600,2920,680,0.564493491613099,0.210264900662252,1.90665412054966,1572,680,892,46,1.3,11.94,4.3,0,0,0,0,0,0,0.187477410679001,4454.18807758029,18.789863438899
7.5,"greedy_SVM","SVM",1,36,26440,23656,2784,3700,3007,693,0.560785984512667,0.210264900662252,1.71558481605081,1604,693,911,32,1.3,12.28,4.3,0,0,0,0,0,0,0.185401682619584,4202.75460996424,18.6021462718947
7.5,"greedy_SVM","SVM",1,37,26340,23560,2780,3800,3103,697,0.563830107817969,0.209713024282561,1.79365006238603,1597,697,900,-7,1.3,12.61,4.5,0,0,0,0,0,0,0.179987858749661,4066.99377108856,18.1629234867818
7.5,"greedy_SVM","SVM",1,38,26240,23475,2765,3900,3188,712,0.564909011780418,0.211368653421634,2.01237375047311,1656,712,944,59,1.3,12.94,4.5,0,0,0,0,0,0,0.179757413532397,4064.95514640939,18.1491200734142
7.5,"greedy_SVM","SVM",1,39,26140,23390,2750,4000,3273,727,0.565588004116329,0.20916114790287,2.00662830546937,1685,727,958,29,1.3,13.27,4.5,0,0,0,0,0,0,0.179691115556377,4127.49261990759,18.088430543135
7.5,"greedy_SVM","SVM",1,40,26040,23307,2733,4100,3356,744,0.563954892898775,0.210816777041943,1.75216457108013,1726,744,982,41,1.3,13.6,4.5,0,0,0,0,0,0,0.177840272322194,3824.09429444431,17.9563670113815
7.5,"greedy_SVM","SVM",1,41,25940,23223,2717,4200,3440,760,0.566535088748918,0.209713024282561,1.68809898777796,1767,760,1007,41,1.3,13.93,4.5,0,0,0,0,0,0,0.176804286881825,3657.65572079629,17.7725848392725
7.5,"greedy_SVM","SVM",1,42,25840,23145,2695,4300,3518,782,0.565976386234056,0.213024282560706,1.71558481605081,1808,782,1026,41,1.3,14.27,4.5,0,0,0,0,0,0,0.181128125625093,4269.8340427325,18.1447782607519
7.5,"greedy_SVM","SVM",1,43,25740,23063,2677,4400,3600,800,0.569823412877789,0.210264900662252,1.74033037523745,1841,800,1041,33,1.3,14.6,4.5,0,0,0,0,0,0,0.180647683134015,4306.65307365495,18.1366250915791
7.5,"greedy_SVM","SVM",1,44,25640,22984,2656,4500,3679,821,0.56890009484998,0.210264900662252,1.68945743653422,1899,821,1078,58,1.3,14.93,4.5,0,0,0,0,0,0,0.179349343482191,3967.62975897813,17.9997990597151
7.5,"greedy_SVM","SVM",1,45,25540,22897,2643,4600,3766,834,0.576361268708819,0.207505518763797,1.87717492948246,1936,834,1102,37,1.3,15.26,4.5,0,0,0,0,0,0,0.179453462806157,4008.77901737905,17.9957565787289
7.5,"greedy_SVM","SVM",1,46,25440,22814,2626,4700,3849,851,0.575408689869872,0.209713024282561,1.92106284727654,1974,851,1123,38,1.3,15.59,4.5,0,0,0,0,0,0,0.180576343880653,4381.43825334074,18.0645027741596
7.5,"greedy_SVM","SVM",1,47,25340,22742,2598,4800,3921,879,0.573880301555346,0.206953642384106,1.76761575777396,2047,879,1168,73,1.3,15.93,4.5,0,0,0,0,0,0,0.182732733205247,4446.41576618583,18.2793283572624
7.5,"greedy_SVM","SVM",1,48,25240,22664,2576,4900,3999,901,0.573806712488351,0.210816777041943,1.94583068801559,2100,901,1199,53,1.3,16.26,4.4,0,0,0,0,0,0,0.182421363355524,3953.64762280608,18.2620125728588
7.5,"greedy_SVM","SVM",2,0,30040,26556,3484,100,85,15,0.392620701056113,0.0692737430167598,0.592177763448877,49,15,34,0,2.3,0.33,5.7,0,0,0,0,0,0,0.164657626460328,4581.90324311115,16.6118371305642
7.5,"greedy_SVM","SVM",2,1,29940,26467,3473,200,174,26,0.605148447881392,0.21731843575419,2.07534597667353,76,26,50,27,1.9,0.66,6.7,0,0,0,0,0,0,0.197985107506031,3964.71355969718,20.4780218045655
7.5,"greedy_SVM","SVM",2,2,29840,26407,3433,300,234,66,0.422793935470463,0.0949720670391061,0.823121178599695,164,66,98,88,1.5,1,3.5,0,0,0,0,0,0,0.224102318674775,6577.04751915945,22.4806470108126
7.5,"greedy_SVM","SVM",2,3,29740,26314,3426,400,327,73,0.586441040861921,0.160335195530726,1.51717191852845,189,73,116,25,1.6,1.33,4.5,0,0,0,0,0,0,0.235766603915493,5479.05160478439,23.7531762433988
7.5,"greedy_SVM","SVM",2,4,29640,26260,3380,500,381,119,0.568564366535289,0.147486033519553,1.24148905896626,288,119,169,99,1.4,1.66,3.2,0,0,0,0,0,0,0.2447162621029,6939.96099939812,24.5728298528918
7.5,"greedy_SVM","SVM",2,5,29540,26184,3356,600,457,143,0.415501626004975,0.076536312849162,0.652271698413567,348,143,205,60,1.4,1.99,3.2,0,0,0,0,0,0,0.239956427656877,7073.69356118062,24.0007980203942
7.5,"greedy_SVM","SVM",2,6,29440,26095,3345,700,546,154,0.559885651741742,0.154189944134078,1.35165919282511,378,154,224,30,1.5,2.32,3.5,0,0,0,0,0,0,0.288844255199772,6540.8908442654,31.7511639164085
7.5,"greedy_SVM","SVM",2,7,29340,26023,3317,800,618,182,0.553856877069309,0.141340782122905,1.30222420856611,428,182,246,50,1.4,2.65,3.4,0,0,0,0,0,0,0.249140827139952,6572.49007361675,25.5244836239154
7.5,"greedy_SVM","SVM",2,8,29240,25940,3300,900,701,199,0.589376304789596,0.178212290502793,1.61082680574593,463,199,264,35,1.3,2.99,3.5,0,0,0,0,0,0,0.290500721639043,6253.4433434791,30.4271681918309
7.5,"greedy_SVM","SVM",2,9,29140,25866,3274,1000,775,225,0.538078676683082,0.140223463687151,1.2825484071204,538,225,313,75,1.4,3.32,3.4,0,0,0,0,0,0,0.235763741207937,6482.95963220149,23.8599232196266
7.5,"greedy_SVM","SVM",2,10,29040,25792,3248,1100,849,251,0.557577149529784,0.163128491620112,1.57633158680037,575,251,324,37,1.3,3.65,3.4,0,0,0,0,0,0,0.238499085415657,6470.6135376193,24.3200064932115
7.5,"greedy_SVM","SVM",2,11,28940,25719,3221,1200,922,278,0.559287998690952,0.156424581005587,1.42438851804385,642,278,364,67,1.3,3.98,3.3,0,0,0,0,0,0,0.266941545330094,6453.89201057716,27.8317417402492
7.5,"greedy_SVM","SVM",2,12,28840,25639,3201,1300,1002,298,0.596406299754467,0.160893854748603,1.46234342840341,685,298,387,43,1.3,4.31,3.4,0,0,0,0,0,0,0.258251390318016,6319.91738262581,27.5471756868086
7.5,"greedy_SVM","SVM",2,13,28740,25551,3189,1400,1090,310,0.573974329690965,0.137988826815642,1.07752444442253,719,310,409,34,1.3,4.64,3.5,0,0,0,0,0,0,0.226339644630798,6222.70553992797,22.7534408558506
7.5,"greedy_SVM","SVM",2,14,28640,25469,3171,1500,1172,328,0.58131585467373,0.167039106145251,1.36452240357781,758,328,430,39,1.3,4.98,3.6,0,0,0,0,0,0,0.225050949480885,6045.11632788628,23.1080742187686
7.5,"greedy_SVM","SVM",2,15,28540,25376,3164,1600,1265,335,0.564517084304502,0.150279329608939,1.21035803380064,784,335,449,26,1.3,5.31,3.8,0,0,0,0,0,0,0.215211792624048,5765.19972428803,21.6406483694351
7.5,"greedy_SVM","SVM",2,16,28440,25286,3154,1700,1355,345,0.587609888364904,0.22122905027933,1.64065693177826,801,345,456,17,1.3,5.64,3.9,0,0,0,0,0,0,0.209665506188916,5500.8340356009,21.2284827321193
7.5,"greedy_SVM","SVM",2,17,28340,25202,3138,1800,1439,361,0.596649895532703,0.202793296089385,1.65089275933837,843,361,482,42,1.3,5.97,4,0,0,0,0,0,0,0.205043780172501,5524.17488719891,20.6280284517561
7.5,"greedy_SVM","SVM",2,18,28240,25123,3117,1900,1518,382,0.612832714774202,0.212290502793296,1.74942084179225,882,382,500,39,1.3,6.3,4,0,0,0,0,0,0,0.206911270628479,5458.17534907984,21.0427832587122
7.5,"greedy_SVM","SVM",2,19,28140,25040,3100,2000,1601,399,0.609240907433193,0.216201117318436,1.80632255636119,930,399,531,48,1.3,6.64,4,0,0,0,0,0,0,0.203259279833339,5416.51221556572,20.606002162893
7.5,"greedy_SVM","SVM",2,20,28040,24980,3060,2100,1661,439,0.611523287562903,0.223463687150838,2.16991129497503,1005,439,566,75,1.3,6.97,3.8,0,0,0,0,0,0,0.218062009662723,5269.11856634338,23.8597608758414
7.5,"greedy_SVM","SVM",2,21,27940,24915,3025,2200,1726,474,0.606351367665578,0.225698324022346,2.02039886123217,1084,474,610,79,1.3,7.3,3.6,0,0,0,0,0,0,0.221652032964596,5519.76711915958,22.2700303450596
7.5,"greedy_SVM","SVM",2,22,27840,24829,3011,2300,1812,488,0.606913560305206,0.21340782122905,2.0734167637073,1128,488,640,44,1.3,7.63,3.7,0,0,0,0,0,0,0.213975653024149,5736.55375175181,21.5137857883035
7.5,"greedy_SVM","SVM",2,23,27740,24752,2988,2400,1889,511,0.607832249960987,0.221787709497207,2.10116280219509,1169,511,658,41,1.3,7.96,3.7,0,0,0,0,0,0,0.213897768758175,5629.84985816088,21.4642754904569
7.5,"greedy_SVM","SVM",2,24,27640,24679,2961,2500,1962,538,0.603762421134237,0.21731843575419,1.9635706812484,1239,538,701,70,1.3,8.29,3.6,0,0,0,0,0,0,0.244237260135475,5342.94894101985,25.2854828616219
7.5,"greedy_SVM","SVM",2,25,27540,24592,2948,2600,2049,551,0.601737896663396,0.212849162011173,2.10860059314435,1279,551,728,40,1.3,8.63,3.7,0,0,0,0,0,0,0.212487548303693,5571.41914063926,21.3684047487134
7.5,"greedy_SVM","SVM",2,26,27440,24513,2927,2700,2128,572,0.60587612243979,0.225698324022346,2.17759920036023,1334,572,762,55,1.3,8.96,3.7,0,0,0,0,0,0,0.214303543637868,5644.38073071944,21.7267004218199
7.5,"greedy_SVM","SVM",2,27,27340,24422,2918,2800,2219,581,0.605817021754513,0.224022346368715,2.18505673186832,1350,581,769,16,1.3,9.29,3.8,0,0,0,0,0,0,0.207380357639308,5614.98293756855,20.7447895142729
7.5,"greedy_SVM","SVM",2,28,27240,24346,2894,2900,2295,605,0.604692846797981,0.231284916201117,2.19382720906444,1411,605,806,61,1.3,9.62,3.8,0,0,0,0,0,0,0.210835794547708,4876.6977364181,21.1786162292898
7.5,"greedy_SVM","SVM",2,29,27140,24267,2873,3000,2374,626,0.602785682406791,0.221787709497207,2.10303046739018,1462,626,836,51,1.3,9.95,3.8,0,0,0,0,0,0,0.208351257989445,5333.39826062227,20.8511377798023
7.5,"greedy_SVM","SVM",2,30,27040,24193,2847,3100,2448,652,0.605078031833608,0.222346368715084,2.24373314072611,1523,652,871,61,1.3,10.29,3.8,0,0,0,0,0,0,0.210563414377239,5231.6775659016,21.0709426185559
7.5,"greedy_SVM","SVM",2,31,26940,24112,2828,3200,2529,671,0.599745846021056,0.224022346368715,2.14006230254074,1567,671,896,44,1.3,10.62,3.8,0,0,0,0,0,0,0.20955514409563,5606.67634799107,20.9677485030293
7.5,"greedy_SVM","SVM",2,32,26840,24026,2814,3300,2615,685,0.602813066425384,0.227932960893855,2.1178471229296,1585,685,900,18,1.3,10.95,3.8,0,0,0,0,0,0,0.207647935654917,4987.06772939408,20.813061620104
7.5,"greedy_SVM","SVM",2,33,26740,23953,2787,3400,2688,712,0.604124849251184,0.223463687150838,2.08639188618668,1654,712,942,69,1.3,11.28,3.8,0,0,0,0,0,0,0.209388641787017,5176.38643489991,20.9615534993669
7.5,"greedy_SVM","SVM",2,34,26640,23876,2764,3500,2765,735,0.60128629171173,0.222905027932961,2.12712300338343,1699,735,964,45,1.3,11.61,3.8,0,0,0,0,0,0,0.209814199684037,5486.65538019292,20.9884025631959
7.5,"greedy_SVM","SVM",2,35,26540,23792,2748,3600,2849,751,0.601592942242426,0.218994413407821,2.0679604038028,1745,751,994,46,1.3,11.94,3.8,0,0,0,0,0,0,0.208401349501098,5041.86981194405,20.8825223819883
7.5,"greedy_SVM","SVM",2,36,26440,23709,2731,3700,2932,768,0.605319103739155,0.227374301675978,2.18967360995607,1782,768,1014,37,1.3,12.28,3.8,0,0,0,0,0,0,0.207574656395963,5235.64618815983,20.7701315538979
7.5,"greedy_SVM","SVM",2,37,26340,23630,2710,3800,3011,789,0.602448282693943,0.220111731843575,2.00954489712495,1834,789,1045,52,1.3,12.61,3.8,0,0,0,0,0,0,0.207171838831583,4953.22476574198,20.7447946313273
7.5,"greedy_SVM","SVM",2,38,26240,23545,2695,3900,3096,804,0.603688850245599,0.224581005586592,2.16900583942316,1887,804,1083,53,1.3,12.94,3.9,0,0,0,0,0,0,0.206034532810021,5372.34915083851,20.6050756342399
7.5,"greedy_SVM","SVM",2,39,26140,23467,2673,4000,3174,826,0.604701049384204,0.224022346368715,2.15640651248193,1915,826,1089,28,1.3,13.27,3.8,0,0,0,0,0,0,0.206387691043378,5368.93418479298,20.6400789611527
7.5,"greedy_SVM","SVM",2,40,26040,23386,2654,4100,3255,845,0.602927986761446,0.222346368715084,2.20056500761808,1955,845,1110,40,1.3,13.6,3.9,0,0,0,0,0,0,0.205611086132568,5278.88761424829,20.5637739792097
7.5,"greedy_SVM","SVM",2,41,25940,23298,2642,4200,3343,857,0.598582130392512,0.222346368715084,2.05499188251971,1991,857,1134,36,1.3,13.93,3.9,0,0,0,0,0,0,0.202970402774971,4758.47094956777,20.3184302181077
7.5,"greedy_SVM","SVM",2,42,25840,23223,2617,4300,3418,882,0.600929037533773,0.219553072625698,2.14746736241113,2032,882,1150,41,1.3,14.27,3.9,0,0,0,0,0,0,0.204265967458168,4996.47014958048,20.4431024707877
7.5,"greedy_SVM","SVM",2,43,25740,23132,2608,4400,3509,891,0.601880705792577,0.226815642458101,2.16482037587788,2060,891,1169,28,1.3,14.6,3.9,0,0,0,0,0,0,0.202220143393628,5084.56085415848,20.2281833826253
7.5,"greedy_SVM","SVM",2,44,25640,23056,2584,4500,3585,915,0.602920457207946,0.227374301675978,1.96991276395922,2114,915,1199,54,1.3,14.93,3.9,0,0,0,0,0,0,0.202837715536725,4753.0606523832,20.3014751670511
7.5,"greedy_SVM","SVM",2,45,25540,22974,2566,4600,3667,933,0.602963489237157,0.228491620111732,2.04505940265327,2154,933,1221,40,1.3,15.26,3.9,0,0,0,0,0,0,0.202404625000447,4928.67891015948,20.2475236440004
7.5,"greedy_SVM","SVM",2,46,25440,22891,2549,4700,3750,950,0.603054601040936,0.225139664804469,1.96041722281815,2178,950,1228,24,1.3,15.59,3.9,0,0,0,0,0,0,0.202182581396517,4962.72286238048,20.2345663594725
7.5,"greedy_SVM","SVM",2,47,25340,22804,2536,4800,3837,963,0.603687630373793,0.221787709497207,2.09763003274899,2227,963,1264,49,1.3,15.93,4,0,0,0,0,0,0,0.199926653095628,4705.04960236031,20.0050384005742
7.5,"greedy_SVM","SVM",2,48,25240,22716,2524,4900,3925,975,0.60319589584651,0.222905027932961,2.10125288254648,2241,975,1266,14,1.3,16.26,4,0,0,0,0,0,0,0.19787951600046,4487.35891453611,19.8588816629313
7.5,"greedy_SVM","SVM",3,0,30040,26569,3471,100,84,16,0.47723098300019,0.0965593784683685,0.756192135320811,48,16,32,0,2,0.33,5.2,0,0,0,0,0,0,0.372454327789485,5033.72810755521,41.4308361453978
7.5,"greedy_SVM","SVM",3,1,29940,26474,3466,200,179,21,0.479252877932918,0.120421753607103,1.10304319099425,74,21,53,26,2.5,0.66,8.5,0,0,0,0,0,0,0.130256381387914,3187.28621964243,13.3999615218503
7.5,"greedy_SVM","SVM",3,2,29840,26389,3451,300,264,36,0.538565685425518,0.140954495005549,1.22121683871411,120,36,84,46,2.3,1,7.3,0,0,0,0,0,0,0.12418578910468,3583.46574267426,12.4585743529976
7.5,"greedy_SVM","SVM",3,3,29740,26324,3416,400,329,71,0.521966866936516,0.130410654827969,1.27641474965704,192,71,121,72,1.7,1.33,4.6,0,0,0,0,0,0,0.200799039617112,5056.79786893634,21.4267847095695
7.5,"greedy_SVM","SVM",3,4,29640,26253,3387,500,400,100,0.477205011405334,0.123196448390677,1.15825242137034,240,100,140,48,1.4,1.66,4,0,0,0,0,0,0,0.276557977340317,5293.91548080228,30.3473723206829
7.5,"greedy_SVM","SVM",3,5,29540,26192,3348,600,461,139,0.470552895523339,0.107658157602664,0.953273448024012,328,139,189,88,1.4,1.99,3.3,0,0,0,0,0,0,0.281131595668961,6533.98673011448,29.1870614798614
7.5,"greedy_SVM","SVM",3,6,29440,26100,3340,700,553,147,0.486134095902852,0.124306326304107,1.01171189717518,346,147,199,18,1.4,2.32,3.8,0,0,0,0,0,0,0.244808049736991,5406.3775756244,26.5399335719974
7.5,"greedy_SVM","SVM",3,7,29340,26015,3325,800,638,162,0.479612799906053,0.124306326304107,0.987407041613088,395,162,233,49,1.4,2.65,3.9,0,0,0,0,0,0,0.207054431634858,5302.72605804327,22.4331912746774
7.5,"greedy_SVM","SVM",3,8,29240,25930,3310,900,723,177,0.477174564833589,0.117092119866815,1.09477497546508,442,177,265,47,1.5,2.99,4.1,0,0,0,0,0,0,0.199491993826284,4920.64697648073,21.2121309256799
7.5,"greedy_SVM","SVM",3,9,29140,25847,3293,1000,806,194,0.492011329805046,0.134295227524972,1.19373735351458,456,194,262,14,1.4,3.32,4.2,0,0,0,0,0,0,0.210654218683324,4336.07999790737,22.9184647119855
7.5,"greedy_SVM","SVM",3,10,29040,25777,3263,1100,876,224,0.481902231541327,0.130410654827969,1.18203921568627,531,224,307,75,1.4,3.65,3.9,0,0,0,0,0,0,0.225160212182429,5451.10230646413,24.7718920753302
7.5,"greedy_SVM","SVM",3,11,28940,25697,3243,1200,956,244,0.523062065252852,0.147613762486127,1.28324658596207,566,244,322,35,1.3,3.98,3.9,0,0,0,0,0,0,0.223115642883153,4833.47602198261,23.5759104510375
7.5,"greedy_SVM","SVM",3,12,28840,25609,3231,1300,1044,256,0.531124468010985,0.164261931187569,1.45451913333012,600,256,344,34,1.3,4.31,4.1,0,0,0,0,0,0,0.214739778498221,4366.55222497882,22.5588301246707
7.5,"greedy_SVM","SVM",3,13,28740,25529,3211,1400,1124,276,0.553396929864734,0.173140954495006,1.63262351700319,637,276,361,37,1.3,4.64,4.1,0,0,0,0,0,0,0.216059477389832,4101.47567312783,22.6624840236318
7.5,"greedy_SVM","SVM",3,14,28640,25448,3192,1500,1205,295,0.53714954343944,0.155382907880133,1.46675822258312,681,295,386,44,1.3,4.98,4.1,0,0,0,0,0,0,0.191773957092832,4214.63412361945,19.6848543312204
7.5,"greedy_SVM","SVM",3,15,28540,25357,3183,1600,1296,304,0.517458139518738,0.152608213096559,1.36409782357096,709,304,405,28,1.3,5.31,4.3,0,0,0,0,0,0,0.18034870472873,3953.62821406033,18.3449568062063
7.5,"greedy_SVM","SVM",3,16,28440,25268,3172,1700,1385,315,0.518965412108984,0.149278579356271,1.35703813321275,738,315,423,29,1.3,5.64,4.4,0,0,0,0,0,0,0.176238078514697,3421.25520948232,17.7783062593916
7.5,"greedy_SVM","SVM",3,17,28340,25174,3166,1800,1479,321,0.510352629015467,0.140954495005549,1.29637721692952,762,321,441,24,1.4,5.97,4.6,0,0,0,0,0,0,0.172368803916942,3520.41917709966,17.2909927541288
7.5,"greedy_SVM","SVM",3,18,28240,25085,3155,1900,1568,332,0.513823580016648,0.148168701442841,1.41841178226107,799,332,467,37,1.4,6.3,4.7,0,0,0,0,0,0,0.165340322720808,3596.52443459296,16.5774604684557
7.5,"greedy_SVM","SVM",3,19,28140,24996,3144,2000,1657,343,0.517368472692059,0.146503884572697,1.3963900383036,818,343,475,19,1.4,6.64,4.8,0,0,0,0,0,0,0.161573846705102,3357.76888903524,16.2151403596255
7.5,"greedy_SVM","SVM",3,20,28040,24908,3132,2100,1745,355,0.523072646272985,0.152608213096559,1.39515100543909,847,355,492,29,1.4,6.97,4.9,0,0,0,0,0,0,0.168117132695221,3189.71357432274,17.220132146645
7.5,"greedy_SVM","SVM",3,21,27940,24829,3111,2200,1824,376,0.5193712130508,0.145948945615982,1.4111533906182,921,376,545,74,1.4,7.3,4.9,0,0,0,0,0,0,0.163102213241821,3528.94746584863,16.3374612241103
7.5,"greedy_SVM","SVM",3,22,27840,24742,3098,2300,1911,389,0.518525358773957,0.146503884572697,1.40742346976194,934,389,545,13,1.4,7.63,4.9,0,0,0,0,0,0,0.1629548786234,3835.60356602196,16.316738219609
7.5,"greedy_SVM","SVM",3,23,27740,24654,3086,2400,1999,401,0.517638225971948,0.145948945615982,1.38901464687742,973,401,572,39,1.4,7.96,5,0,0,0,0,0,0,0.161284742592158,3772.2425581481,16.1632980185219
7.5,"greedy_SVM","SVM",3,24,27640,24566,3074,2500,2087,413,0.516764183522902,0.143729189789123,1.35464898156977,1028,413,615,55,1.5,8.29,5.1,0,0,0,0,0,0,0.155956795905932,3219.5369482384,15.6344766666043
7.5,"greedy_SVM","SVM",3,25,27540,24475,3065,2600,2178,422,0.514773655250624,0.143174250832408,1.33373637710425,1008,422,586,-20,1.4,8.63,5.2,0,0,0,0,0,0,0.153585130275069,3242.48131383882,15.416156299691
7.5,"greedy_SVM","SVM",3,26,27440,24385,3055,2700,2268,432,0.517079732127046,0.141509433962264,1.38288054804737,1058,432,626,50,1.4,8.96,5.2,0,0,0,0,0,0,0.151459618873677,3150.34970571987,15.2032600667539
7.5,"greedy_SVM","SVM",3,27,27340,24303,3037,2800,2350,450,0.508283851380914,0.140399556048835,1.3093230720874,1118,450,668,60,1.5,9.29,5.2,0,0,0,0,0,0,0.152465480784485,2953.97570232714,15.4824604786754
7.5,"greedy_SVM","SVM",3,28,27240,24217,3023,2900,2436,464,0.514515026679644,0.141509433962264,1.37794863269886,1168,464,704,50,1.5,9.62,5.2,0,0,0,0,0,0,0.148716445990067,2916.16921531635,14.9533557986099
7.5,"greedy_SVM","SVM",3,29,27140,24122,3018,3000,2531,469,0.514565338803013,0.140399556048835,1.37794863269886,1188,469,719,20,1.5,9.95,5.4,0,0,0,0,0,0,0.148796961893212,3167.83319134461,14.9433775421276
7.5,"greedy_SVM","SVM",3,30,27040,24034,3006,3100,2619,481,0.512358338751406,0.142619311875694,1.35823587207702,1205,481,724,17,1.5,10.29,5.4,0,0,0,0,0,0,0.146575963000038,3077.80906225485,14.7572931700334
7.5,"greedy_SVM","SVM",3,31,26940,23948,2992,3200,2705,495,0.508556532215775,0.137069922308546,1.29066126800126,1258,495,763,53,1.5,10.62,5.5,0,0,0,0,0,0,0.146809383363926,2940.84326084315,14.716928888919
7.5,"greedy_SVM","SVM",3,32,26840,23855,2985,3300,2798,502,0.507582283742143,0.136514983351831,1.29461157689541,1277,502,775,19,1.5,10.95,5.6,0,0,0,0,0,0,0.14766756673119,3374.75547605685,14.7886175111467
7.5,"greedy_SVM","SVM",3,33,26740,23766,2974,3400,2887,513,0.508898261525851,0.142619311875694,1.24531186591501,1306,513,793,29,1.5,11.28,5.6,0,0,0,0,0,0,0.14411965238452,2964.32326199496,14.4500989950766
7.5,"greedy_SVM","SVM",3,34,26640,23680,2960,3500,2973,527,0.508549882483762,0.140399556048835,1.27366453158462,1328,527,801,22,1.5,11.61,5.6,0,0,0,0,0,0,0.143701934910317,3012.17449603036,14.4037509694255
7.5,"greedy_SVM","SVM",3,35,26540,23590,2950,3600,3063,537,0.507633955087461,0.138179800221976,1.25600040002667,1365,537,828,37,1.5,11.94,5.7,0,0,0,0,0,0,0.14212232613538,2925.83483593743,14.2488658368296
7.5,"greedy_SVM","SVM",3,36,26440,23499,2941,3700,3154,546,0.507432309282972,0.137069922308546,1.25378523177265,1375,546,829,10,1.5,12.28,5.8,0,0,0,0,0,0,0.141798444370018,3019.52685402576,14.2181049443388
7.5,"greedy_SVM","SVM",3,37,26340,23406,2934,3800,3247,553,0.507880601594147,0.142619311875694,1.24751012163596,1399,553,846,24,1.5,12.61,5.9,0,0,0,0,0,0,0.138530620660012,2815.08931451442,13.8858710933174
7.5,"greedy_SVM","SVM",3,38,26240,23313,2927,3900,3340,560,0.50675470577278,0.140399556048835,1.19478357380688,1381,560,821,-18,1.5,12.94,6,0,0,0,0,0,0,0.136846287592961,2684.45623749643,13.731211284459
7.5,"greedy_SVM","SVM",3,39,26140,23224,2916,4000,3429,571,0.504695338136369,0.139289678135405,1.18203921568627,1447,571,876,66,1.5,13.27,6,0,0,0,0,0,0,0.136768656149418,2778.18872684656,15.1146290259819
7.5,"greedy_SVM","SVM",3,40,26040,23141,2899,4100,3512,588,0.50382819635262,0.137069922308546,1.25933786787439,1497,588,909,50,1.5,13.6,6,0,0,0,0,0,0,0.137777539662935,2856.72914703335,13.8255934589733
7.5,"greedy_SVM","SVM",3,41,25940,23049,2891,4200,3604,596,0.514066316146332,0.159822419533851,1.43331810355985,1502,596,906,5,1.5,13.93,6,0,0,0,0,0,0,0.142566320348826,2946.69647905073,14.6069040744735
7.5,"greedy_SVM","SVM",3,42,25840,22977,2863,4300,3676,624,0.515001669961,0.148168701442841,1.33609072198881,1573,624,949,71,1.5,14.27,5.9,0,0,0,0,0,0,0.138794291785685,2831.53181074873,13.9158833134944
7.5,"greedy_SVM","SVM",3,43,25740,22893,2847,4400,3760,640,0.514734300547315,0.152053274139845,1.47374185315386,1626,640,986,53,1.5,14.6,5.9,0,0,0,0,0,0,0.141507242262158,2853.61558564345,14.4104152841364
7.5,"greedy_SVM","SVM",3,44,25640,22826,2814,4500,3827,673,0.515303542701191,0.158712541620422,1.37299930546916,1705,673,1032,79,1.5,14.93,5.7,0,0,0,0,0,0,0.145880195731996,3167.36988496593,14.6193005609357
7.5,"greedy_SVM","SVM",3,45,25540,22736,2804,4600,3917,683,0.518997196991579,0.16204217536071,1.53207203402316,1704,683,1021,-1,1.5,15.26,5.7,0,0,0,0,0,0,0.143117935959437,2901.48981512688,14.5029984086027
7.5,"greedy_SVM","SVM",3,46,25440,22664,2776,4700,3989,711,0.518408507508218,0.158157602663707,1.46714741609946,1777,711,1066,73,1.5,15.59,5.6,0,0,0,0,0,0,0.14653559323311,2913.4481516424,15.1626838398082
7.5,"greedy_SVM","SVM",3,47,25340,22583,2757,4800,4070,730,0.520283062781254,0.155937846836848,1.50513072551381,1830,730,1100,53,1.5,15.93,5.6,0,0,0,0,0,0,0.146697788789509,2984.28078261829,14.7187195063915
7.5,"greedy_SVM","SVM",3,48,25240,22499,2741,4900,4154,746,0.520323212106628,0.158712541620422,1.50853310645113,1894,746,1148,64,1.5,16.26,5.6,0,0,0,0,0,0,0.147847046243823,3062.04997140715,14.8080369481181
7.5,"greedy_SVM","SVM",4,0,30040,26552,3488,100,91,9,0.521074347553334,0.146205357142857,1.17500066151566,33,9,24,0,2.7,0.33,10.1,0,0,0,0,0,0,0.154085261197261,2557.20554563419,15.9632207811215
7.5,"greedy_SVM","SVM",4,1,29940,26463,3477,200,180,20,0.488289633773251,0.126674107142857,1.12039656276687,73,20,53,40,2.6,0.66,9,0,0,0,0,0,0,0.110167132930258,2982.69748809659,11.7397980759322
7.5,"greedy_SVM","SVM",4,2,29840,26381,3459,300,262,38,0.529361423750448,0.116071428571429,0.98193446412656,112,38,74,39,1.9,1,6.9,0,0,0,0,0,0,0.137424114817733,3796.27568346489,13.8746127900152
7.5,"greedy_SVM","SVM",4,3,29740,26300,3440,400,343,57,0.564582264524808,0.192522321428571,1.68352771908363,142,57,85,30,1.5,1.33,6,0,0,0,0,0,0,0.1459075445356,4228.06594951021,14.7456937124798
7.5,"greedy_SVM","SVM",4,4,29640,26249,3391,500,394,106,0.597217373128089,0.212053571428571,2.01608295056868,246,106,140,104,1.3,1.66,3.7,0,0,0,0,0,0,0.261646096891444,5346.94241217801,28.4029605186391
7.5,"greedy_SVM","SVM",4,5,29540,26191,3349,600,452,148,0.568175352227733,0.14453125,0.994341578294224,342,148,194,96,1.3,1.99,3.1,0,0,0,0,0,0,0.304138119258396,6714.3123664406,31.4977329155998
7.5,"greedy_SVM","SVM",4,6,29440,26117,3323,700,526,174,0.522733704298137,0.114955357142857,0.927702588155515,411,174,237,69,1.4,2.32,3,0,0,0,0,0,0,0.328284987282037,7015.95594114282,34.6623551058734
7.5,"greedy_SVM","SVM",4,7,29340,26026,3314,800,617,183,0.509831980779264,0.09375,0.715434106334842,442,183,259,31,1.4,2.65,3.4,0,0,0,0,0,0,0.259237943582039,6359.30152723208,26.9181547973258
7.5,"greedy_SVM","SVM",4,8,29240,25937,3303,900,706,194,0.529143277550208,0.121651785714286,1.01827003923767,450,194,256,8,1.3,2.99,3.6,0,0,0,0,0,0,0.312024666771621,5832.23499461799,36.3363373649141
7.5,"greedy_SVM","SVM",4,9,29140,25852,3288,1000,791,209,0.533608529814798,0.142857142857143,1.24761924709562,483,209,274,33,1.3,3.32,3.8,0,0,0,0,0,0,0.218761335453462,5769.61160337191,22.0523351570345
7.5,"greedy_SVM","SVM",4,10,29040,25760,3280,1100,883,217,0.555876966215452,0.192522321428571,1.85669243564572,507,217,290,24,1.3,3.65,4.1,0,0,0,0,0,0,0.212010588294103,5358.1215393364,21.6429066691001
7.5,"greedy_SVM","SVM",4,11,28940,25700,3240,1200,943,257,0.541628712057439,0.162946428571429,1.492485581189,596,257,339,89,1.3,3.98,3.7,0,0,0,0,0,0,0.234342232335523,5385.89153646942,24.3360839914793
7.5,"greedy_SVM","SVM",4,12,28840,25616,3224,1300,1027,273,0.522089267391853,0.157366071428571,1.21529740137411,646,273,373,50,1.4,4.31,3.8,0,0,0,0,0,0,0.247208504172334,5608.72279167647,27.2352318708852
7.5,"greedy_SVM","SVM",4,13,28740,25525,3215,1400,1118,282,0.535131560943428,0.151227678571429,1.31894961453744,664,282,382,18,1.4,4.64,4,0,0,0,0,0,0,0.212314114638336,5434.44387929101,21.6051772876989
7.5,"greedy_SVM","SVM",4,14,28640,25438,3202,1500,1205,295,0.530847347752361,0.171316964285714,1.57275090539947,694,295,399,30,1.4,4.98,4.1,0,0,0,0,0,0,0.197978733810791,5260.34235773415,19.9376092174625
7.5,"greedy_SVM","SVM",4,15,28540,25353,3187,1600,1290,310,0.549856912734126,0.1796875,1.69089181848112,752,310,442,58,1.4,5.31,4.2,0,0,0,0,0,0,0.194783814794754,4989.15930066816,19.6164596643371
7.5,"greedy_SVM","SVM",4,16,28440,25278,3162,1700,1365,335,0.548896834119127,0.185267857142857,1.65093736245599,804,335,469,52,1.4,5.64,4.1,0,0,0,0,0,0,0.196151593518507,5293.63929181108,19.7215085075922
7.5,"greedy_SVM","SVM",4,17,28340,25188,3152,1800,1455,345,0.542976503414359,0.185267857142857,1.62872744278169,817,345,472,13,1.4,5.97,4.2,0,0,0,0,0,0,0.192279171005506,5044.3027435136,19.4459303857879
7.5,"greedy_SVM","SVM",4,18,28240,25111,3129,1900,1532,368,0.55281779249325,0.192522321428571,1.76198696082746,882,368,514,65,1.4,6.3,4.2,0,0,0,0,0,0,0.193226651452611,5084.60178774496,19.5546187761963
7.5,"greedy_SVM","SVM",4,19,28140,25042,3098,2000,1601,399,0.555873352157809,0.191964285714286,1.78845150483304,943,399,544,61,1.4,6.64,4,0,0,0,0,0,0,0.198779531333457,4817.24158138168,20.2126508677066
7.5,"greedy_SVM","SVM",4,20,28040,24962,3078,2100,1681,419,0.563199467237477,0.195870535714286,1.86974475505272,993,419,574,50,1.4,6.97,4,0,0,0,0,0,0,0.230232229292062,5245.94794003537,23.7182594114828
7.5,"greedy_SVM","SVM",4,21,27940,24875,3065,2200,1768,432,0.561859744474357,0.201450892857143,1.91139914772727,1025,432,593,32,1.4,7.3,4.1,0,0,0,0,0,0,0.195555877255687,5038.44172868668,19.6584725439214
7.5,"greedy_SVM","SVM",4,22,27840,24789,3051,2300,1854,446,0.546967053410062,0.185267857142857,1.6051045789358,1057,446,611,32,1.4,7.63,4.2,0,0,0,0,0,0,0.198297919585185,4875.64656455391,20.4054419410901
7.5,"greedy_SVM","SVM",4,23,27740,24694,3046,2400,1949,451,0.546219069549932,0.179129464285714,1.68795389524648,1099,451,648,42,1.4,7.96,4.3,0,0,0,0,0,0,0.187526337530539,4976.7083822739,18.7699947811868
7.5,"greedy_SVM","SVM",4,24,27640,24607,3033,2500,2036,464,0.544997602114779,0.182477678571429,1.68795389524648,1115,464,651,16,1.4,8.29,4.4,0,0,0,0,0,0,0.18433865362248,4795.44806683972,18.4530455306143
7.5,"greedy_SVM","SVM",4,25,27540,24514,3026,2600,2129,471,0.552424028305966,0.194754464285714,1.8721995508326,1131,471,660,16,1.4,8.63,4.5,0,0,0,0,0,0,0.18046220047641,4509.10314388073,18.0676625036383
7.5,"greedy_SVM","SVM",4,26,27440,24434,3006,2700,2209,491,0.559084694516312,0.196428571428571,1.81005987532808,1214,491,723,83,1.5,8.96,4.5,0,0,0,0,0,0,0.181551220213662,4425.64706528168,18.1808739586485
7.5,"greedy_SVM","SVM",4,27,27340,24350,2990,2800,2293,507,0.556225554682202,0.188058035714286,1.76436844405594,1242,507,735,28,1.4,9.29,4.5,0,0,0,0,0,0,0.179287890743186,4633.28475995148,17.9319324558472
7.5,"greedy_SVM","SVM",4,28,27240,24263,2977,2900,2380,520,0.552883770057183,0.197544642857143,1.86403114092496,1268,520,748,26,1.4,9.62,4.6,0,0,0,0,0,0,0.180544368589021,4348.53006295467,18.0765794298749
7.5,"greedy_SVM","SVM",4,29,27140,24196,2944,3000,2447,553,0.553152681160103,0.189732142857143,1.66734102074236,1354,553,801,86,1.4,9.95,4.4,0,0,0,0,0,0,0.183467249813424,4711.50559017832,18.3607313756191
7.5,"greedy_SVM","SVM",4,30,27040,24107,2933,3100,2536,564,0.558554646736798,0.199776785714286,1.89977465247611,1360,564,796,6,1.4,10.29,4.5,0,0,0,0,0,0,0.181309517320864,4219.30619210802,18.1716429156295
7.5,"greedy_SVM","SVM",4,31,26940,24038,2902,3200,2605,595,0.562147860511491,0.193638392857143,1.8445251305483,1445,595,850,85,1.4,10.62,4.4,0,0,0,0,0,0,0.184643533258624,4334.23936726473,18.8415301990308
7.5,"greedy_SVM","SVM",4,32,26840,23957,2883,3300,2686,614,0.56197774765876,0.206473214285714,1.89906754032258,1561,614,947,116,1.5,10.95,4.4,0,0,0,0,0,0,0.189848232958455,4599.41458242861,19.8010955600185
7.5,"greedy_SVM","SVM",4,33,26740,23864,2876,3400,2779,621,0.557525564835189,0.190848214285714,1.74330211947095,1529,621,908,-32,1.5,11.28,4.5,0,0,0,0,0,0,0.182871179696448,4473.72683736682,18.3077418988306
7.5,"greedy_SVM","SVM",4,34,26640,23777,2863,3500,2866,634,0.556919747916955,0.195870535714286,1.81424331331878,1557,634,923,28,1.5,11.61,4.5,0,0,0,0,0,0,0.180652408273619,4150.51537511634,18.0882143902293
7.5,"greedy_SVM","SVM",4,35,26540,23702,2838,3600,2941,659,0.561091757225427,0.203683035714286,1.96261208945549,1692,659,1033,135,1.6,11.94,4.5,0,0,0,0,0,0,0.183198521063059,4328.51474287255,18.3750076707432
7.5,"greedy_SVM","SVM",4,36,26440,23622,2818,3700,3021,679,0.561144623324416,0.194754464285714,1.70842755557977,1698,679,1019,6,1.5,12.28,4.4,0,0,0,0,0,0,0.18347231645981,4723.72986977759,18.3870578849095
7.5,"greedy_SVM","SVM",4,37,26340,23532,2808,3800,3111,689,0.565140174167325,0.205915178571429,1.91238695090439,1700,689,1011,2,1.5,12.61,4.5,0,0,0,0,0,0,0.181323239090844,4746.19185249236,18.1340472352322
7.5,"greedy_SVM","SVM",4,38,26240,23453,2787,3900,3190,710,0.562426226997774,0.19921875,1.82797436459246,1755,710,1045,55,1.5,12.94,4.5,0,0,0,0,0,0,0.181745377293753,4379.51638089632,18.2022466918178
7.5,"greedy_SVM","SVM",4,39,26140,23368,2772,4000,3275,725,0.564564110188755,0.200334821428571,1.87136984620419,1819,725,1094,64,1.5,13.27,4.5,0,0,0,0,0,0,0.181085671737474,4514.01244880389,18.1182604136033
7.5,"greedy_SVM","SVM",4,40,26040,23287,2753,4100,3356,744,0.567686950158956,0.211495535714286,2.00449319948187,1888,744,1144,69,1.5,13.6,4.5,0,0,0,0,0,0,0.182011035657971,4184.96657968392,18.230587102362
7.5,"greedy_SVM","SVM",4,41,25940,23198,2742,4200,3445,755,0.565965818242821,0.212053571428571,1.80166157883462,1895,755,1140,7,1.5,13.93,4.6,0,0,0,0,0,0,0.178848356453655,4275.15032998046,17.8983715158789
7.5,"greedy_SVM","SVM",4,42,25840,23113,2727,4300,3530,770,0.566137654076518,0.201450892857143,1.79280627166378,1894,770,1124,-1,1.5,14.27,4.6,0,0,0,0,0,0,0.17809389054328,4167.65532191572,17.8500425225321
7.5,"greedy_SVM","SVM",4,43,25740,23034,2706,4400,3609,791,0.569550122945192,0.209263392857143,2.01727647756687,1967,791,1176,73,1.5,14.6,4.6,0,0,0,0,0,0,0.178502985789475,4174.0034682515,17.8775141513135
7.5,"greedy_SVM","SVM",4,44,25640,22953,2687,4500,3690,810,0.569696408231846,0.212611607142857,1.9674144440874,2022,810,1212,55,1.5,14.93,4.6,0,0,0,0,0,0,0.180005962035346,4462.07440511905,18.0073711137514
7.5,"greedy_SVM","SVM",4,45,25540,22865,2675,4600,3778,822,0.56673590668806,0.204241071428571,1.82955247742906,2020,822,1198,-2,1.5,15.26,4.6,0,0,0,0,0,0,0.178565788812217,4366.64141949292,17.9068337735726
7.5,"greedy_SVM","SVM",4,46,25440,22781,2659,4700,3862,838,0.568626605145877,0.212053571428571,2.04123003323328,2084,838,1246,64,1.5,15.59,4.6,0,0,0,0,0,0,0.178482849901619,4180.12628366079,17.8638366741577
7.5,"greedy_SVM","SVM",4,47,25340,22696,2644,4800,3947,853,0.562432110347436,0.200334821428571,1.78706702623591,2130,853,1277,46,1.5,15.93,4.6,0,0,0,0,0,0,0.176529551394609,4014.70861065458,17.7669058156649
7.5,"greedy_SVM","SVM",4,48,25240,22613,2627,4900,4030,870,0.563392777297396,0.196986607142857,1.80630503651203,2188,870,1318,58,1.5,16.26,4.6,0,0,0,0,0,0,0.177063915270912,4136.67301570843,17.7201475601713
7.5,"greedy_SVM","SVM",5,0,30040,26491,3549,100,87,13,0.45900690420449,0.0903300521134916,0.858743793812909,45,13,32,0,2.5,0.33,6.7,0,0,0,0,0,0,0.140924006608667,3917.23224647033,14.1410588337234
7.5,"greedy_SVM","SVM",5,1,29940,26401,3539,200,177,23,0.427488907831466,0.094962362478286,0.764268079955995,82,23,59,37,2.6,0.66,7.7,0,0,0,0,0,0,0.16520291178053,3325.64597002615,17.162471158578
7.5,"greedy_SVM","SVM",5,2,29840,26310,3530,300,268,32,0.419915406701852,0.0839606253618992,0.753104348560749,116,32,84,34,2.6,1,8.4,0,0,0,0,0,0,0.147933139599084,2955.95115238493,15.6079883459328
7.5,"greedy_SVM","SVM",5,3,29740,26225,3515,400,353,47,0.591614165239898,0.177764910248987,1.56532622214836,147,47,100,31,2.1,1.33,7.5,0,0,0,0,0,0,0.139856896349842,3511.96407946236,14.5915914678193
7.5,"greedy_SVM","SVM",5,4,29640,26147,3493,500,431,69,0.409251485609428,0.0723798494499131,0.619463615863505,205,69,136,58,2,1.66,6.2,0,0,0,0,0,0,0.220441940860087,3975.66573114412,23.904049633869
7.5,"greedy_SVM","SVM",5,5,29540,26057,3483,600,521,79,0.414346844759284,0.0938042848870874,0.905453012400131,234,79,155,29,2,1.99,6.6,0,0,0,0,0,0,0.178046857053117,3737.99782491983,19.6116023040552
7.5,"greedy_SVM","SVM",5,6,29440,25975,3465,700,603,97,0.377684020993976,0.0648523451071222,0.577559963063309,276,97,179,42,1.8,2.32,6.2,0,0,0,0,0,0,0.153165376865224,4021.55106544874,15.6542757605489
7.5,"greedy_SVM","SVM",5,7,29340,25884,3456,800,694,106,0.603568686741402,0.178343949044586,1.68628008049825,291,106,185,15,1.7,2.65,6.5,0,0,0,0,0,0,0.532639218020595,4165.05959478499,79.7416002039099
7.5,"greedy_SVM","SVM",5,8,29240,25802,3438,900,776,124,0.577552817329237,0.192240880138969,1.86890254213404,333,124,209,42,1.7,2.99,6.3,0,0,0,0,0,0,0.159193277505444,3964.32347436035,16.8854196192414
7.5,"greedy_SVM","SVM",5,9,29140,25745,3395,1000,833,167,0.551531436981275,0.166184134337001,1.50136665608209,402,167,235,69,1.4,3.32,5,0,0,0,0,0,0,0.500022206458352,4582.76289778632,62.9483376594543
7.5,"greedy_SVM","SVM",5,10,29040,25658,3382,1100,920,180,0.543570000687352,0.163288940359004,1.50353337083887,446,180,266,44,1.5,3.65,5.1,0,0,0,0,0,0,0.235902082038038,4527.87153205576,26.4648179464981
7.5,"greedy_SVM","SVM",5,11,28940,25570,3370,1200,1008,192,0.550167979397607,0.176606832657788,1.56378689347711,488,192,296,42,1.5,3.98,5.2,0,0,0,0,0,0,0.166579031127921,4521.97118637179,16.8548934767593
7.5,"greedy_SVM","SVM",5,12,28840,25504,3336,1300,1074,226,0.553328392584138,0.163288940359004,1.5140471177044,553,226,327,65,1.4,4.31,4.8,0,0,0,0,0,0,0.189608198428936,4806.48295616032,19.3367265321373
7.5,"greedy_SVM","SVM",5,13,28740,25423,3317,1400,1155,245,0.550644914005096,0.165026056745802,1.54707306353381,597,245,352,44,1.4,4.64,4.7,0,0,0,0,0,0,0.203104242369041,4642.47667584394,20.5642920539935
7.5,"greedy_SVM","SVM",5,14,28640,25341,3299,1500,1237,263,0.524994719048155,0.170237405906196,1.58598172251454,630,263,367,33,1.4,4.98,4.7,0,0,0,0,0,0,0.188215150181445,4824.3057145015,18.904003843158
7.5,"greedy_SVM","SVM",5,15,28540,25255,3285,1600,1323,277,0.512844233877515,0.148812970469021,1.43652440118418,676,277,399,46,1.4,5.31,4.8,0,0,0,0,0,0,0.178648633671068,4704.06594453407,18.0491990540148
7.5,"greedy_SVM","SVM",5,16,28440,25172,3268,1700,1406,294,0.512187955194618,0.142443543717429,1.39718717847009,710,294,416,34,1.4,5.64,4.8,0,0,0,0,0,0,0.183285787387891,4600.00729774323,18.4827245759853
7.5,"greedy_SVM","SVM",5,17,28340,25081,3259,1800,1497,303,0.521131249314386,0.162709901563405,1.70591318845122,736,303,433,26,1.4,5.97,4.9,0,0,0,0,0,0,0.170239591358287,4623.36951840737,17.0947832230401
7.5,"greedy_SVM","SVM",5,18,28240,24991,3249,1900,1587,313,0.509626324707459,0.135495078170237,1.35479459691015,775,313,462,39,1.5,6.3,5.1,0,0,0,0,0,0,0.165496660876927,4528.39766031636,16.6303011315957
7.5,"greedy_SVM","SVM",5,19,28140,24909,3231,2000,1669,331,0.505394316567591,0.138390272148234,1.39009279993441,818,331,487,43,1.5,6.64,5,0,0,0,0,0,0,0.167025787879028,4380.37254005726,16.9141007884688
7.5,"greedy_SVM","SVM",5,20,28040,24829,3211,2100,1749,351,0.51897452073084,0.135495078170237,1.27726366869034,853,351,502,35,1.4,6.97,5,0,0,0,0,0,0,0.169050520474869,4273.87462573176,17.2312209850263
7.5,"greedy_SVM","SVM",5,21,27940,24755,3185,2200,1823,377,0.531434963494171,0.140127388535032,1.37628032620036,901,377,524,48,1.4,7.3,4.8,0,0,0,0,0,0,0.172768661287137,4265.06107115608,18.6231687600469
7.5,"greedy_SVM","SVM",5,22,27840,24678,3162,2300,1900,400,0.527196576554622,0.144759698899826,1.40975560902528,982,400,582,81,1.5,7.63,4.8,0,0,0,0,0,0,0.1739817767559,4785.22937660714,17.4063351448755
7.5,"greedy_SVM","SVM",5,23,27740,24593,3147,2400,1985,415,0.520479917455731,0.12507237984945,1.2292193209491,1019,415,604,37,1.5,7.96,4.8,0,0,0,0,0,0,0.173432398376032,4447.67138418901,17.3576575612049
7.5,"greedy_SVM","SVM",5,24,27640,24498,3142,2500,2080,420,0.52561294189894,0.138390272148234,1.35083385151449,1022,420,602,3,1.4,8.29,5,0,0,0,0,0,0,0.167145354452279,4305.34527855299,16.7448277129071
7.5,"greedy_SVM","SVM",5,25,27540,24409,3131,2600,2169,431,0.533836125945798,0.175448755066589,1.67350780891111,1060,431,629,38,1.5,8.63,5,0,0,0,0,0,0,0.165629495957927,4383.13703235433,16.615390440433
7.5,"greedy_SVM","SVM",5,26,27440,24329,3111,2700,2249,451,0.519875363461406,0.130283729009844,1.19867971049073,1146,451,695,86,1.5,8.96,5,0,0,0,0,0,0,0.165450740956059,4158.44739908966,16.5606964296505
7.5,"greedy_SVM","SVM",5,27,27340,24244,3096,2800,2334,466,0.527329533304448,0.145338737695426,1.35256110583227,1162,466,696,16,1.5,9.29,5,0,0,0,0,0,0,0.164961127701756,4214.68757950028,16.5178480410653
7.5,"greedy_SVM","SVM",5,28,27240,24161,3079,2900,2417,483,0.530324791990379,0.154603358425014,1.62481272346646,1215,483,732,53,1.5,9.62,5,0,0,0,0,0,0,0.16471999325435,3990.05476220864,16.6276196674496
7.5,"greedy_SVM","SVM",5,29,27140,24083,3057,3000,2495,505,0.528381601319989,0.145338737695426,1.46725219586191,1262,505,757,47,1.5,9.95,4.9,0,0,0,0,0,0,0.166628742559206,4263.96916333829,16.6745143685241
7.5,"greedy_SVM","SVM",5,30,27040,24001,3039,3100,2577,523,0.524193116554818,0.148233931673422,1.38920981320524,1296,523,773,34,1.5,10.29,4.9,0,0,0,0,0,0,0.168092513221838,4463.88973609759,16.8125911889605
7.5,"greedy_SVM","SVM",5,31,26940,23904,3036,3200,2674,526,0.528858796286656,0.159235668789809,1.6400691809638,1296,526,770,0,1.5,10.62,5.1,0,0,0,0,0,0,0.163840960999702,4302.45467795691,16.3891111218545
7.5,"greedy_SVM","SVM",5,32,26840,23829,3011,3300,2749,551,0.531382240762113,0.1667631731326,1.68557735861718,1359,551,808,63,1.5,10.95,5,0,0,0,0,0,0,0.166479935495989,4372.20363736397,16.6512268599526
7.5,"greedy_SVM","SVM",5,33,26740,23750,2990,3400,2828,572,0.533646758042318,0.163288940359004,1.7178530882829,1410,572,838,51,1.5,11.28,4.9,0,0,0,0,0,0,0.167110441931954,4181.81799444726,16.7270859647867
7.5,"greedy_SVM","SVM",5,34,26640,23666,2974,3500,2912,588,0.525243665808524,0.140706427330631,1.20737093062994,1452,588,864,42,1.5,11.61,5,0,0,0,0,0,0,0.167639318721608,4347.96631208299,16.7655980753694
7.5,"greedy_SVM","SVM",5,35,26540,23573,2967,3600,3005,595,0.534494617681653,0.1667631731326,1.65677386736617,1474,595,879,22,1.5,11.94,5.1,0,0,0,0,0,0,0.164353921139925,4240.28761148737,16.4400697291146
7.5,"greedy_SVM","SVM",5,36,26440,23489,2951,3700,3089,611,0.535242889938198,0.171395483497394,1.73312289351208,1494,611,883,20,1.4,12.28,5.1,0,0,0,0,0,0,0.164923583120881,4278.0877669185,16.4955580479212
7.5,"greedy_SVM","SVM",5,37,26340,23406,2934,3800,3172,628,0.534294097727026,0.169658367110596,1.67382093414557,1571,628,943,77,1.5,12.61,5.1,0,0,0,0,0,0,0.16458061159545,4096.44915119153,16.4677275860216
7.5,"greedy_SVM","SVM",5,38,26240,23324,2916,3900,3254,646,0.530686691237626,0.156919513607412,1.53234305328835,1587,646,941,16,1.5,12.94,5,0,0,0,0,0,0,0.16351621493666,3882.86227148865,16.3627990977237
7.5,"greedy_SVM","SVM",5,39,26140,23229,2911,4000,3349,651,0.530958896750573,0.156340474811812,1.63151229828051,1574,651,923,-13,1.4,13.27,5.1,0,0,0,0,0,0,0.161110866914333,3823.81716367882,16.1224457205061
7.5,"greedy_SVM","SVM",5,40,26040,23142,2898,4100,3436,664,0.532794559083481,0.165605095541401,1.65493049755141,1686,664,1022,112,1.5,13.6,5.2,0,0,0,0,0,0,0.159914477335375,3839.72879959024,15.9995120105855
7.5,"greedy_SVM","SVM",5,41,25940,23053,2887,4200,3525,675,0.528532132313836,0.156919513607412,1.4582865442486,1675,675,1000,-11,1.5,13.93,5.2,0,0,0,0,0,0,0.159437637595123,3980.40045475443,15.952320534239
7.5,"greedy_SVM","SVM",5,42,25840,22966,2874,4300,3612,688,0.532632745858901,0.160972785176607,1.64150406213699,1680,688,992,5,1.4,14.27,5.2,0,0,0,0,0,0,0.15872340348188,3751.73705170692,15.8910647111145
7.5,"greedy_SVM","SVM",5,43,25740,22884,2856,4400,3694,706,0.536327806602429,0.185871453387377,1.7834465703962,1741,706,1035,61,1.5,14.6,5.2,0,0,0,0,0,0,0.158763955029152,3728.18506336142,15.890685102248
7.5,"greedy_SVM","SVM",5,44,25640,22801,2839,4500,3777,723,0.529186762055329,0.152287203242617,1.42414792832786,1757,723,1034,16,1.4,14.93,5.2,0,0,0,0,0,0,0.158567823237819,3736.66148331782,15.8680751761302
7.5,"greedy_SVM","SVM",5,45,25540,22709,2831,4600,3869,731,0.531213050694362,0.164447017950203,1.62726725327197,1796,731,1065,39,1.5,15.26,5.3,0,0,0,0,0,0,0.158118854479083,3890.95425193303,15.8197123762175
7.5,"greedy_SVM","SVM",5,46,25440,22621,2819,4700,3957,743,0.530522404600934,0.154603358425014,1.46839745586407,1835,743,1092,39,1.5,15.59,5.3,0,0,0,0,0,0,0.157726039003221,3958.93792403701,15.7736419038828
7.5,"greedy_SVM","SVM",5,47,25340,22536,2804,4800,4042,758,0.527548625546582,0.146496815286624,1.2292193209491,1874,758,1116,39,1.5,15.93,5.3,0,0,0,0,0,0,0.157107395322497,3818.61699952077,15.7233290221998
7.5,"greedy_SVM","SVM",5,48,25240,22443,2797,4900,4135,765,0.532786010624039,0.162709901563405,1.61320922058116,1865,765,1100,-9,1.4,16.26,5.4,0,0,0,0,0,0,0.154398279678066,3652.73438810728,15.4658470409363
7.5,"greedy_SVM","SVM",6,0,30040,26506,3534,100,91,9,0.576072437885362,0.177548682703322,1.66024364046966,30,9,21,0,2.3,0.33,10.1,0,0,0,0,0,0,0.277591882141658,2827.34368003539,29.2067489085634
7.5,"greedy_SVM","SVM",6,1,29940,26438,3502,200,159,41,0.541051602268603,0.115120274914089,1.05208804669952,103,41,62,73,1.5,0.66,3.9,0,0,0,0,0,0,0.285445360416043,5927.48104199733,29.2902407288738
7.5,"greedy_SVM","SVM",6,2,29840,26360,3480,300,237,63,0.564692516155938,0.149484536082474,1.29322900164916,148,63,85,45,1.3,1,3.8,0,0,0,0,0,0,0.431322082419139,5597.28631938002,44.8779726627386
7.5,"greedy_SVM","SVM",6,3,29740,26275,3465,400,322,78,0.565228525560433,0.170103092783505,1.56032156951546,184,78,106,36,1.4,1.33,4.1,0,0,0,0,0,0,0.444952122240923,4986.85884682927,48.8957510329133
7.5,"greedy_SVM","SVM",6,4,29640,26194,3446,500,403,97,0.558696608060446,0.150057273768614,1.42570759324725,256,97,159,72,1.6,1.66,4.2,0,0,0,0,0,0,0.248297931592287,5169.82039149971,25.5374648620996
7.5,"greedy_SVM","SVM",6,5,29540,26103,3437,600,494,106,0.568717411440573,0.184994272623139,1.64010563714896,275,106,169,19,1.6,1.99,4.7,0,0,0,0,0,0,0.335791353154766,3986.13098104864,40.1930064581487
7.5,"greedy_SVM","SVM",6,6,29440,26041,3399,700,556,144,0.565116041168339,0.15979381443299,1.55263525636514,343,144,199,68,1.4,2.32,3.9,0,0,0,0,0,0,0.573571622053492,5110.06736707965,61.7481845862671
7.5,"greedy_SVM","SVM",6,7,29340,25976,3364,800,621,179,0.535751339432509,0.13631156930126,1.15192121901408,409,179,230,66,1.3,2.65,3.5,0,0,0,0,0,0,0.241552851047945,4747.08309523583,27.0248102279936
7.5,"greedy_SVM","SVM",6,8,29240,25902,3338,900,695,205,0.531877483564685,0.123711340206186,0.977903361116987,482,205,277,73,1.4,2.99,3.4,0,0,0,0,0,0,0.23693935253129,5496.5538255473,23.9550227619217
7.5,"greedy_SVM","SVM",6,9,29140,25806,3334,1000,791,209,0.540778622377807,0.1815578465063,1.49086562021556,485,209,276,3,1.3,3.32,3.8,0,0,0,0,0,0,0.216842958146634,4020.4985411653,21.9641650013618
7.5,"greedy_SVM","SVM",6,10,29040,25732,3308,1100,865,235,0.54265767479245,0.176975945017182,1.58945506658391,549,235,314,64,1.3,3.65,3.7,0,0,0,0,0,0,0.219163622691739,3554.03180907768,22.5710081285046
7.5,"greedy_SVM","SVM",6,11,28940,25665,3275,1200,932,268,0.546952627178925,0.186139747995418,1.80140445241297,606,268,338,57,1.3,3.98,3.5,0,0,0,0,0,0,0.222960471363235,4789.1481800311,22.5719378522305
7.5,"greedy_SVM","SVM",6,12,28840,25577,3263,1300,1020,280,0.545127689341923,0.190721649484536,1.83302179194618,654,280,374,48,1.3,4.31,3.6,0,0,0,0,0,0,0.21155888618355,3999.18076353924,21.2111487924813
7.5,"greedy_SVM","SVM",6,13,28740,25496,3244,1400,1101,299,0.548515502601489,0.195876288659794,1.84535232863349,709,299,410,55,1.4,4.64,3.7,0,0,0,0,0,0,0.208732805859658,3994.16458348466,20.9872807847134
7.5,"greedy_SVM","SVM",6,14,28640,25422,3218,1500,1175,325,0.551006148602328,0.193585337915235,1.88465713271007,791,325,466,82,1.4,4.98,3.6,0,0,0,0,0,0,0.212517641294423,3946.03508055692,21.2983122011868
7.5,"greedy_SVM","SVM",6,15,28540,25355,3185,1600,1242,358,0.561232664745359,0.190721649484536,1.81522412734967,879,358,521,88,1.5,5.31,3.5,0,0,0,0,0,0,0.221318726626134,5271.29788009752,24.4131614001534
7.5,"greedy_SVM","SVM",6,16,28440,25281,3159,1700,1316,384,0.564006369960602,0.200458190148912,1.97318445186526,904,384,520,25,1.4,5.64,3.4,0,0,0,0,0,0,0.222615753080146,4249.15117961789,24.3156234029572
7.5,"greedy_SVM","SVM",6,17,28340,25218,3122,1800,1379,421,0.563979849949171,0.202749140893471,1.87121412379144,972,421,551,68,1.3,5.97,3.3,0,0,0,0,0,0,0.229835563599539,4444.1126380734,24.4818216363615
7.5,"greedy_SVM","SVM",6,18,28240,25137,3103,1900,1460,440,0.56254931669063,0.197594501718213,1.8804030509932,1027,440,587,55,1.3,6.3,3.3,0,0,0,0,0,0,0.228650099755392,4817.55409306642,23.0877044044622
7.5,"greedy_SVM","SVM",6,19,28140,25060,3080,2000,1537,463,0.56205957761401,0.192439862542955,1.90806655814795,1096,463,633,69,1.4,6.64,3.3,0,0,0,0,0,0,0.228093074738032,4435.60955667487,23.1145639243344
7.5,"greedy_SVM","SVM",6,20,28040,24982,3058,2100,1615,485,0.562447062059837,0.198739977090493,1.92998180952842,1127,485,642,31,1.3,6.97,3.3,0,0,0,0,0,0,0.227189213308825,4537.36748251366,22.7621574111888
7.5,"greedy_SVM","SVM",6,21,27940,24907,3033,2200,1690,510,0.561912320629952,0.195303550973654,1.895506689957,1197,510,687,70,1.3,7.3,3.3,0,0,0,0,0,0,0.227096583338216,4558.41586638455,22.7389102926411
7.5,"greedy_SVM","SVM",6,22,27840,24832,3008,2300,1765,535,0.56205050837186,0.196449026345934,1.91649852121414,1244,535,709,47,1.3,7.63,3.3,0,0,0,0,0,0,0.229306285783805,4385.25667341388,22.9608474744542
7.5,"greedy_SVM","SVM",6,23,27740,24753,2987,2400,1844,556,0.56234816003989,0.195303550973654,1.84535232863349,1310,556,754,66,1.4,7.96,3.3,0,0,0,0,0,0,0.227749627891491,4572.01895228197,22.8012912224969
7.5,"greedy_SVM","SVM",6,24,27640,24663,2977,2500,1934,566,0.561174832208275,0.194730813287514,1.82594281434488,1325,566,759,15,1.3,8.29,3.4,0,0,0,0,0,0,0.221513838175824,4093.55188746043,22.2175734028432
7.5,"greedy_SVM","SVM",6,25,27540,24577,2963,2600,2020,580,0.559976875581601,0.189576174112257,1.82983669760744,1363,580,783,38,1.4,8.63,3.5,0,0,0,0,0,0,0.21930089200566,4017.0540989224,21.9750240776697
7.5,"greedy_SVM","SVM",6,26,27440,24490,2950,2700,2107,593,0.560510327545783,0.194158075601375,1.9256549692949,1407,593,814,44,1.4,8.96,3.6,0,0,0,0,0,0,0.217266745222994,4911.41307047509,21.7654025674783
7.5,"greedy_SVM","SVM",6,27,27340,24404,2936,2800,2193,607,0.560824742268039,0.196449026345934,1.83733602833534,1455,607,848,48,1.4,9.29,3.6,0,0,0,0,0,0,0.214142604456973,4545.35537792119,21.4481001654785
7.5,"greedy_SVM","SVM",6,28,27240,24326,2914,2900,2271,629,0.560747417307637,0.201030927835052,1.83685596737179,1497,629,868,42,1.4,9.62,3.6,0,0,0,0,0,0,0.213436953951648,4321.13862035508,21.3810467806834
7.5,"greedy_SVM","SVM",6,29,27140,24252,2888,3000,2345,655,0.56109445551236,0.20446735395189,1.88069804394171,1567,655,912,70,1.4,9.95,3.6,0,0,0,0,0,0,0.213471931093521,4144.56535976942,21.3876516613975
7.5,"greedy_SVM","SVM",6,30,27040,24167,2873,3100,2430,670,0.560517892411277,0.20561282932417,1.92231761232905,1595,670,925,28,1.4,10.29,3.6,0,0,0,0,0,0,0.211317406736769,4050.17109521046,21.1657430072448
7.5,"greedy_SVM","SVM",6,31,26940,24088,2852,3200,2509,691,0.559870451678343,0.199885452462772,1.86672354407702,1649,691,958,54,1.4,10.62,3.6,0,0,0,0,0,0,0.211526932766998,4135.38866571453,21.1993659663048
7.5,"greedy_SVM","SVM",6,32,26840,23997,2843,3300,2600,700,0.559253614264931,0.200458190148912,1.88261000513489,1656,700,956,7,1.4,10.95,3.7,0,0,0,0,0,0,0.207926013624237,4027.326633736,20.8190128786737
7.5,"greedy_SVM","SVM",6,33,26740,23913,2827,3400,2684,716,0.558007775478232,0.202176403207331,1.83893371183824,1669,716,953,13,1.3,11.28,3.7,0,0,0,0,0,0,0.207821958413142,4273.55612829175,20.807097320225
7.5,"greedy_SVM","SVM",6,34,26640,23835,2805,3500,2762,738,0.544468342542267,0.178121420389462,1.56940539414766,1737,738,999,68,1.4,11.61,3.7,0,0,0,0,0,0,0.256330470452064,4286.38823912059,26.0997233909722
7.5,"greedy_SVM","SVM",6,35,26540,23750,2790,3600,2847,753,0.554359919967161,0.198739977090493,1.95740843276899,1735,753,982,-2,1.3,11.94,3.8,0,0,0,0,0,0,0.208275900563975,4160.47116107626,20.9605112790233
7.5,"greedy_SVM","SVM",6,36,26440,23668,2772,3700,2929,771,0.553550780234211,0.203321878579611,1.7547201314324,1837,771,1066,102,1.4,12.28,3.8,0,0,0,0,0,0,0.204342456545917,3951.40541131012,20.4585558929003
7.5,"greedy_SVM","SVM",6,37,26340,23591,2749,3800,3006,794,0.553100842665836,0.194158075601375,1.88261000513489,1858,794,1064,21,1.3,12.61,3.8,0,0,0,0,0,0,0.205809760037741,4062.28093166939,20.611600034373
7.5,"greedy_SVM","SVM",6,38,26240,23504,2736,3900,3093,807,0.554307438712768,0.198739977090493,1.92474246452072,1909,807,1102,51,1.4,12.94,3.8,0,0,0,0,0,0,0.204091513699094,4035.57226411315,20.4224186291027
7.5,"greedy_SVM","SVM",6,39,26140,23408,2732,4000,3189,811,0.552555570599321,0.197021764032073,1.75158056887675,1880,811,1069,-29,1.3,13.27,3.9,0,0,0,0,0,0,0.198852318399734,3667.94823086721,19.9167318095375
7.5,"greedy_SVM","SVM",6,40,26040,23324,2716,4100,3273,827,0.552242144467444,0.199312714776632,1.84965635738832,1914,827,1087,34,1.3,13.6,4,0,0,0,0,0,0,0.198404755596473,3851.01740893717,19.865728976122
7.5,"greedy_SVM","SVM",6,41,25940,23237,2703,4200,3360,840,0.553521939184498,0.193585337915235,1.89675776391408,1929,840,1089,15,1.3,13.93,4,0,0,0,0,0,0,0.197964734326788,4327.34973782004,19.8113694795618
7.5,"greedy_SVM","SVM",6,42,25840,23153,2687,4300,3444,856,0.552841101289676,0.197594501718213,1.83638004130026,1983,856,1127,54,1.3,14.27,4,0,0,0,0,0,0,0.195449849467297,3582.62684797086,19.7588916326347
7.5,"greedy_SVM","SVM",6,43,25740,23066,2674,4400,3531,869,0.552740522964309,0.198739977090493,1.70567113196288,2023,869,1154,40,1.3,14.6,4.1,0,0,0,0,0,0,0.193794410580062,3694.86558090467,19.4164680600675
7.5,"greedy_SVM","SVM",6,44,25640,22974,2666,4500,3623,877,0.552933470016699,0.198167239404353,1.76323366718556,2049,877,1172,26,1.3,14.93,4.1,0,0,0,0,0,0,0.191694034118345,3483.99759942818,19.1829340462804
7.5,"greedy_SVM","SVM",6,45,25540,22888,2652,4600,3709,891,0.554081180462866,0.201030927835052,1.85755412151038,2064,891,1173,15,1.3,15.26,4.2,0,0,0,0,0,0,0.190304873728439,3509.45583634862,19.043977439789
7.5,"greedy_SVM","SVM",6,46,25440,22807,2633,4700,3790,910,0.555750264877743,0.20504009163803,2.02399178417664,2107,910,1197,43,1.3,15.59,4.2,0,0,0,0,0,0,0.189665515930075,3438.31007338633,18.9893788923362
7.5,"greedy_SVM","SVM",6,47,25340,22725,2615,4800,3872,928,0.553002413449985,0.194730813287514,1.80375399995736,2135,928,1207,28,1.3,15.93,4.2,0,0,0,0,0,0,0.190849001069421,3954.10615877243,19.112749487876
7.5,"greedy_SVM","SVM",6,48,25240,22633,2607,4900,3964,936,0.555081676907177,0.199885452462772,1.8991294782503,2152,936,1216,17,1.3,16.26,4.2,0,0,0,0,0,0,0.185129162116705,3234.97910364037,18.5910933588188
7.5,"greedy_SVM","SVM",7,0,30040,26563,3477,100,94,6,0.577387119786251,0.182724252491694,1.68682653744469,29,6,23,0,3.8,0.33,15.7,0,0,0,0,0,0,0.468807193506834,1968.83672971385,57.1773049001874
7.5,"greedy_SVM","SVM",7,1,29940,26488,3452,200,169,31,0.539086197159109,0.169988925802879,1.55722937430786,82,31,51,53,1.6,0.66,5.5,0,0,0,0,0,0,0.218916349865577,4287.13723720683,23.7663344135217
7.5,"greedy_SVM","SVM",7,2,29840,26404,3436,300,253,47,0.620637745188274,0.233665559246955,2.19871587462083,110,47,63,28,1.3,1,5.4,0,0,0,0,0,0,0.251436396844468,3961.98779137455,29.4239113054132
7.5,"greedy_SVM","SVM",7,3,29740,26344,3396,400,313,87,0.592937746983182,0.18327796234773,1.49385108622835,199,87,112,89,1.3,1.33,3.6,0,0,0,0,0,0,0.284872234244608,5879.11887091661,29.5824712286915
7.5,"greedy_SVM","SVM",7,4,29640,26284,3356,500,373,127,0.578552268916406,0.166666666666667,1.36621046854634,285,127,158,86,1.2,1.66,2.9,0,0,0,0,0,0,0.283445151259743,6999.90561548047,29.4306642213502
7.5,"greedy_SVM","SVM",7,5,29540,26200,3340,600,457,143,0.565914493673772,0.198781838316722,1.7004287458851,328,143,185,43,1.3,1.99,3.2,0,0,0,0,0,0,0.264316275781543,6356.05957515711,28.6674139594493
7.5,"greedy_SVM","SVM",7,6,29440,26116,3324,700,541,159,0.589798193315492,0.199335548172757,1.88221152204351,361,159,202,33,1.3,2.32,3.4,0,0,0,0,0,0,0.284609348997545,4806.59902251134,31.0873582282068
7.5,"greedy_SVM","SVM",7,7,29340,26032,3308,800,625,175,0.5734588895999,0.180509413067553,1.54454984360125,405,175,230,44,1.3,2.65,3.6,0,0,0,0,0,0,0.226845017748786,5595.20984138274,23.0289980895962
7.5,"greedy_SVM","SVM",7,8,29240,25946,3294,900,711,189,0.573764901432136,0.181063122923588,1.5937326506693,439,189,250,34,1.3,2.99,3.8,0,0,0,0,0,0,0.217807559938132,4494.65960305467,22.4017208238809
7.5,"greedy_SVM","SVM",7,9,29140,25860,3280,1000,797,203,0.569368866771106,0.17718715393134,1.5513540279343,487,203,284,48,1.4,3.32,3.9,0,0,0,0,0,0,0.205780890855806,3882.49942145388,20.66769790259
7.5,"greedy_SVM","SVM",7,10,29040,25795,3245,1100,862,238,0.56547094139859,0.175526024363234,1.66017714816028,566,238,328,79,1.4,3.65,3.6,0,0,0,0,0,0,0.217746054970404,4768.34208777759,21.8262809945157
7.5,"greedy_SVM","SVM",7,11,28940,25714,3226,1200,943,257,0.564241801525177,0.172203765227021,1.55459734880996,612,257,355,46,1.4,3.98,3.7,0,0,0,0,0,0,0.216252405193089,4631.32634260244,21.6609605331558
7.5,"greedy_SVM","SVM",7,12,28840,25639,3201,1300,1018,282,0.561479680538842,0.170542635658915,1.66604349850714,675,282,393,63,1.4,4.31,3.6,0,0,0,0,0,0,0.217587557992768,4440.21013282838,21.8039018402308
7.5,"greedy_SVM","SVM",7,13,28740,25564,3176,1400,1093,307,0.563799960678881,0.178848283499446,1.6127673319039,731,307,424,56,1.4,4.64,3.6,0,0,0,0,0,0,0.221414699585178,4057.73507004471,22.217752944461
7.5,"greedy_SVM","SVM",7,14,28640,25474,3166,1500,1183,317,0.56371580846857,0.171650055370986,1.66163985930403,789,317,472,58,1.5,4.98,3.7,0,0,0,0,0,0,0.210844697415416,4845.30950260301,21.1073891598042
7.5,"greedy_SVM","SVM",7,15,28540,25387,3153,1600,1270,330,0.561429214257956,0.174418604651163,1.63711913221361,809,330,479,20,1.5,5.31,3.8,0,0,0,0,0,0,0.206063203669987,3952.63974813866,20.6583923257906
7.5,"greedy_SVM","SVM",7,16,28440,25307,3133,1700,1350,350,0.564222767096647,0.179955703211517,1.66318200524892,854,350,504,45,1.4,5.64,3.9,0,0,0,0,0,0,0.204788144357333,4324.5600624383,20.5292546512509
7.5,"greedy_SVM","SVM",7,17,28340,25219,3121,1800,1438,362,0.564719707604464,0.173864894795127,1.71639047885896,869,362,507,15,1.4,5.97,4,0,0,0,0,0,0,0.200428278187898,4178.66439731068,20.0743610755843
7.5,"greedy_SVM","SVM",7,18,28240,25134,3106,1900,1523,377,0.563606068309391,0.178848283499446,1.67474243668583,893,377,516,24,1.4,6.3,4,0,0,0,0,0,0,0.199206244689457,3974.41282083533,19.9491197364984
7.5,"greedy_SVM","SVM",7,19,28140,25056,3084,2000,1601,399,0.561284201966974,0.174418604651163,1.64304936337711,964,399,565,71,1.4,6.64,4,0,0,0,0,0,0,0.197050464397803,3742.40401351287,19.73119983611
7.5,"greedy_SVM","SVM",7,20,28040,24973,3067,2100,1684,416,0.561293844407742,0.175526024363234,1.58814141251576,995,416,579,31,1.4,6.97,4,0,0,0,0,0,0,0.198258019355492,3808.3340116436,19.8564470055517
7.5,"greedy_SVM","SVM",7,21,27940,24878,3062,2200,1779,421,0.562339777906624,0.175526024363234,1.58229135205879,990,421,569,-5,1.4,7.3,4.2,0,0,0,0,0,0,0.188528978288924,3589.71838742311,18.8792003092234
7.5,"greedy_SVM","SVM",7,22,27840,24790,3050,2300,1867,433,0.56486956198691,0.178848283499446,1.66755470090606,1021,433,588,31,1.4,7.63,4.3,0,0,0,0,0,0,0.185388334512292,3350.94776355093,18.5918839480721
7.5,"greedy_SVM","SVM",7,23,27740,24703,3037,2400,1954,446,0.564568517472646,0.179955703211517,1.60701757909253,1047,446,601,26,1.3,7.96,4.4,0,0,0,0,0,0,0.185404684987991,4167.22960683463,18.5686678659879
7.5,"greedy_SVM","SVM",7,24,27640,24620,3020,2500,2037,463,0.566010333691061,0.179955703211517,1.56692639998932,1091,463,628,44,1.4,8.29,4.4,0,0,0,0,0,0,0.182609075602828,3764.49075021043,18.3024986352511
7.5,"greedy_SVM","SVM",7,25,27540,24533,3007,2600,2124,476,0.566842672517247,0.184385382059801,1.58266506281743,1148,476,672,57,1.4,8.63,4.5,0,0,0,0,0,0,0.181124337933694,3443.09014414994,18.1649324276941
7.5,"greedy_SVM","SVM",7,26,27440,24443,2997,2700,2214,486,0.565339662280816,0.185492801771872,1.55523004996288,1156,486,670,8,1.4,8.96,4.6,0,0,0,0,0,0,0.175556975995165,3173.86407371512,17.6191732941573
7.5,"greedy_SVM","SVM",7,27,27340,24355,2985,2800,2302,498,0.567241811125872,0.182170542635659,1.59843088468407,1160,498,662,4,1.3,9.29,4.6,0,0,0,0,0,0,0.175547294027594,3797.80019648636,17.5954131964525
7.5,"greedy_SVM","SVM",7,28,27240,24266,2974,2900,2391,509,0.569750223216243,0.181063122923588,1.54936672423719,1227,509,718,67,1.4,9.62,4.7,0,0,0,0,0,0,0.171747412697119,3104.5138622316,17.3084024311554
7.5,"greedy_SVM","SVM",7,29,27140,24182,2958,3000,2475,525,0.567728733513407,0.181063122923588,1.63177629741912,1259,525,734,32,1.4,9.95,4.7,0,0,0,0,0,0,0.173157134198061,3933.95265825689,17.3546619584109
7.5,"greedy_SVM","SVM",7,30,27040,24103,2937,3100,2554,546,0.568727832300007,0.183831672203765,1.58439556194891,1335,546,789,76,1.4,10.29,4.7,0,0,0,0,0,0,0.173249769862999,3926.27398909036,17.3487382195094
7.5,"greedy_SVM","SVM",7,31,26940,24013,2927,3200,2644,556,0.570939081897716,0.182724252491694,1.68621314829997,1343,556,787,8,1.4,10.62,4.8,0,0,0,0,0,0,0.168416078582529,2949.46215787167,16.913596357908
7.5,"greedy_SVM","SVM",7,32,26840,23930,2910,3300,2727,573,0.57197149093423,0.183831672203765,1.62024161538666,1364,573,791,21,1.4,10.95,4.8,0,0,0,0,0,0,0.169913783881919,3342.83513367867,17.0684462201971
7.5,"greedy_SVM","SVM",7,33,26740,23854,2886,3400,2803,597,0.570258976757549,0.182724252491694,1.61258783066651,1458,597,861,94,1.4,11.28,4.7,0,0,0,0,0,0,0.172718858424719,3609.30675433439,17.4100438667754
7.5,"greedy_SVM","SVM",7,34,26640,23767,2873,3500,2890,610,0.570097726763279,0.181063122923588,1.5133349399526,1495,610,885,37,1.5,11.61,4.7,0,0,0,0,0,0,0.171061468167331,3161.61005978042,17.2727019121134
7.5,"greedy_SVM","SVM",7,35,26540,23684,2856,3600,2973,627,0.569983019286135,0.184385382059801,1.65317922934653,1555,627,928,60,1.5,11.94,4.7,0,0,0,0,0,0,0.169769556267111,3215.17005662236,17.1077235564767
7.5,"greedy_SVM","SVM",7,36,26440,23602,2838,3700,3055,645,0.572091583151027,0.186046511627907,1.66899224806202,1571,645,926,16,1.4,12.28,4.7,0,0,0,0,0,0,0.169422263530133,3324.7915051611,17.0313400314539
7.5,"greedy_SVM","SVM",7,37,26340,23524,2816,3800,3133,667,0.570849544947758,0.181063122923588,1.63112680438871,1645,667,978,74,1.5,12.61,4.7,0,0,0,0,0,0,0.174437016612103,3530.50612969088,17.4744464585379
7.5,"greedy_SVM","SVM",7,38,26240,23430,2810,3900,3227,673,0.57082854863734,0.183831672203765,1.6398395450391,1682,673,1009,37,1.5,12.94,4.8,0,0,0,0,0,0,0.170329727004561,3452.74930618167,17.0576383192862
7.5,"greedy_SVM","SVM",7,39,26140,23339,2801,4000,3318,682,0.571337594373825,0.183831672203765,1.63555425006077,1684,682,1002,2,1.5,13.27,4.9,0,0,0,0,0,0,0.167949978837465,2866.20427946969,16.8853039989084
7.5,"greedy_SVM","SVM",7,40,26040,23252,2788,4100,3405,695,0.568538656795478,0.180509413067553,1.54726434244765,1751,695,1056,67,1.5,13.6,4.9,0,0,0,0,0,0,0.166980913486916,3180.34332785868,16.7596705700542
7.5,"greedy_SVM","SVM",7,41,25940,23165,2775,4200,3492,708,0.566293136877994,0.18327796234773,1.60928135611564,1774,708,1066,23,1.5,13.93,4.9,0,0,0,0,0,0,0.166214757642422,3323.27326489776,16.7063325375295
7.5,"greedy_SVM","SVM",7,42,25840,23080,2760,4300,3577,723,0.569009758901407,0.182170542635659,1.62686798766706,1788,723,1065,14,1.5,14.27,4.9,0,0,0,0,0,0,0.166165321673167,3343.07577031146,16.673523431225
7.5,"greedy_SVM","SVM",7,43,25740,22989,2751,4400,3668,732,0.571041141498014,0.178848283499446,1.49407602992451,1833,732,1101,45,1.5,14.6,5,0,0,0,0,0,0,0.164204674624528,3626.14459034459,16.4575773048304
7.5,"greedy_SVM","SVM",7,44,25640,22905,2735,4500,3752,748,0.57536901119901,0.186046511627907,1.66754221135649,1850,748,1102,17,1.5,14.93,5,0,0,0,0,0,0,0.163341301139227,3083.8679087422,16.428121752668
7.5,"greedy_SVM","SVM",7,45,25540,22834,2706,4600,3823,777,0.574979598515471,0.179401993355482,1.69827281381749,1916,777,1139,66,1.5,15.26,4.9,0,0,0,0,0,0,0.165784418474127,3180.91466523933,16.6255357565695
7.5,"greedy_SVM","SVM",7,46,25440,22752,2688,4700,3905,795,0.57728785691119,0.183831672203765,1.69541428892843,1957,795,1162,41,1.5,15.59,4.9,0,0,0,0,0,0,0.16817289273286,3661.73277927592,16.8333316620049
7.5,"greedy_SVM","SVM",7,47,25340,22676,2664,4800,3981,819,0.5776647052022,0.194905869324474,1.73732207006455,2013,819,1194,56,1.5,15.93,4.9,0,0,0,0,0,0,0.168589261309652,3181.70448835514,16.8929602791373
7.5,"greedy_SVM","SVM",7,48,25240,22605,2635,4900,4052,848,0.575873381812687,0.17718715393134,1.48174665132714,2074,848,1226,61,1.4,16.26,4.8,0,0,0,0,0,0,0.168958766590559,2924.17289264672,16.9361515837511
7.5,"greedy_SVM","SVM",8,0,30040,26552,3488,100,86,14,0.399367348613486,0.0861779518746503,0.684625856181052,46,14,32,0,2.3,0.33,6.1,0,0,0,0,0,0,0.208015973736309,4064.62572318119,21.5367078777033
7.5,"greedy_SVM","SVM",8,1,29940,26457,3483,200,181,19,0.592380532087359,0.192501398992725,1.80407581324055,60,19,41,14,2.2,0.66,9.5,0,0,0,0,0,0,0.472991746564046,3742.30095418291,53.1528010305172
7.5,"greedy_SVM","SVM",8,2,29840,26404,3436,300,234,66,0.592556217096708,0.159485170677112,1.42780853925524,146,66,80,86,1.2,1,3.5,0,0,0,0,0,0,0.387983461419487,5197.87524567631,43.9087123883061
7.5,"greedy_SVM","SVM",8,3,29740,26324,3416,400,314,86,0.609604360981747,0.202014549524342,1.90485016305501,194,86,108,48,1.3,1.33,3.7,0,0,0,0,0,0,0.352991678910659,6102.0768574079,39.0767116633383
7.5,"greedy_SVM","SVM",8,4,29640,26244,3396,500,394,106,0.550825013939372,0.137660884163402,1.01408529111635,258,106,152,64,1.4,1.66,3.7,0,0,0,0,0,0,0.327435582241426,6174.24624392141,34.8169918484389
7.5,"greedy_SVM","SVM",8,5,29540,26161,3379,600,477,123,0.552975486075202,0.146054840514829,1.03844879883494,302,123,179,44,1.5,1.99,3.9,0,0,0,0,0,0,0.29309771229474,5878.0696787387,30.5285698808271
7.5,"greedy_SVM","SVM",8,6,29440,26069,3371,700,569,131,0.568358887593103,0.16899832120873,1.39606885419408,325,131,194,23,1.5,2.32,4.3,0,0,0,0,0,0,0.315476556342459,5194.06667569898,33.4449808005221
7.5,"greedy_SVM","SVM",8,7,29340,25978,3362,800,660,140,0.574162706434627,0.166200335758254,1.37633098613443,369,140,229,44,1.6,2.65,4.7,0,0,0,0,0,0,0.207783118734283,4770.4096279256,21.8137546684658
7.5,"greedy_SVM","SVM",8,8,29240,25886,3354,900,752,148,0.54414944696609,0.144376049244544,1.19742104703019,402,148,254,33,1.7,2.99,5.1,0,0,0,0,0,0,0.197061224826218,4453.77829419693,20.4827266689489
7.5,"greedy_SVM","SVM",8,9,29140,25793,3347,1000,845,155,0.563317416579005,0.140458869613878,1.09366359789272,421,155,266,19,1.7,3.32,5.5,0,0,0,0,0,0,0.195028133166172,4061.79206123703,21.0404430961626
7.5,"greedy_SVM","SVM",8,10,29040,25722,3318,1100,916,184,0.544061277987645,0.139899272523783,1.19344637898449,485,184,301,64,1.6,3.65,5,0,0,0,0,0,0,0.1829659467487,4463.90351877481,18.5627477763145
7.5,"greedy_SVM","SVM",8,11,28940,25632,3308,1200,1006,194,0.574010337970688,0.178511471740347,1.57371611862699,512,194,318,27,1.6,3.98,5.2,0,0,0,0,0,0,0.194966907719168,3654.21745430185,19.9199366550256
7.5,"greedy_SVM","SVM",8,12,28840,25543,3297,1300,1095,205,0.572551316198977,0.188024622271964,1.66946719863405,534,205,329,22,1.6,4.31,5.3,0,0,0,0,0,0,0.171747289098721,3692.03883052709,17.4432340381014
7.5,"greedy_SVM","SVM",8,13,28740,25462,3278,1400,1176,224,0.564956778244017,0.157806379406827,1.504736131192,585,224,361,51,1.6,4.64,5.2,0,0,0,0,0,0,0.201011686579314,3517.48167773868,25.038216384246
7.5,"greedy_SVM","SVM",8,14,28640,25384,3256,1500,1254,246,0.597550149318564,0.178511471740347,1.37692861139979,593,246,347,8,1.4,4.98,5.1,0,0,0,0,0,0,0.471395383835578,3705.56072661765,59.3585006802827
7.5,"greedy_SVM","SVM",8,15,28540,25301,3239,1600,1337,263,0.58055847486287,0.181869054280918,1.49799071844116,628,263,365,35,1.4,5.31,5.1,0,0,0,0,0,0,0.189607962642172,3769.86747323769,20.732558357971
7.5,"greedy_SVM","SVM",8,16,28440,25214,3226,1700,1424,276,0.592798924009883,0.177392277560157,1.4628343345004,669,276,393,41,1.4,5.64,5.2,0,0,0,0,0,0,0.217112595612341,2678.98892798813,22.7161163215186
7.5,"greedy_SVM","SVM",8,17,28340,25126,3214,1800,1512,288,0.600377454219114,0.182428651371013,1.41429891572507,702,288,414,33,1.4,5.97,5.2,0,0,0,0,0,0,0.170079506187673,3161.35815374503,17.4513252623066
7.5,"greedy_SVM","SVM",8,18,28240,25038,3202,1900,1600,300,0.602616348087254,0.198656966983772,1.89577767255439,747,300,447,45,1.5,6.3,5.3,0,0,0,0,0,0,0.173191987280573,2650.53924386247,19.3679190051916
7.5,"greedy_SVM","SVM",8,19,28140,24955,3185,2000,1683,317,0.603440578489605,0.194739787353106,1.77240372920989,817,317,500,70,1.6,6.64,5.3,0,0,0,0,0,0,0.168218390874913,2625.34719617853,17.194677094833
7.5,"greedy_SVM","SVM",8,20,28040,24879,3161,2100,1759,341,0.603779184437364,0.201454952434247,1.87092986944499,845,341,504,28,1.5,6.97,5.2,0,0,0,0,0,0,0.171450587925674,2457.04874084518,18.5850975895617
7.5,"greedy_SVM","SVM",8,21,27940,24813,3127,2200,1825,375,0.603168615314826,0.200895355344152,1.87897070578763,923,375,548,78,1.5,7.3,4.9,0,0,0,0,0,0,0.17173432251368,3421.22689383477,17.3250096835243
7.5,"greedy_SVM","SVM",8,22,27840,24738,3102,2300,1900,400,0.604210045551308,0.196418578623391,1.86771797267341,996,400,596,73,1.5,7.63,4.8,0,0,0,0,0,0,0.177292864407618,2908.12596221769,17.9265174885633
7.5,"greedy_SVM","SVM",8,23,27740,24658,3082,2400,1980,420,0.602775330277711,0.203133743704533,1.95237693920618,1041,420,621,45,1.5,7.96,4.7,0,0,0,0,0,0,0.179294827237524,2665.00563973429,17.9595821315499
7.5,"greedy_SVM","SVM",8,24,27640,24572,3068,2500,2066,434,0.603115916130879,0.201454952434247,1.89268486792691,1072,434,638,31,1.5,8.29,4.8,0,0,0,0,0,0,0.175948493133132,3280.10788965523,17.6321936284765
7.5,"greedy_SVM","SVM",8,25,27540,24486,3054,2600,2152,448,0.600813749541461,0.195299384443201,1.80411361551642,1102,448,654,30,1.5,8.63,4.8,0,0,0,0,0,0,0.176843674520639,2626.52052670768,17.7741451463402
7.5,"greedy_SVM","SVM",8,26,27440,24405,3035,2700,2233,467,0.601142835093091,0.19194180190263,1.85165013951533,1143,467,676,41,1.4,8.96,4.8,0,0,0,0,0,0,0.173751067758707,3029.37729210016,17.4277417274044
7.5,"greedy_SVM","SVM",8,27,27340,24323,3017,2800,2315,485,0.595911166784366,0.181309457190823,1.71422298072318,1188,485,703,45,1.4,9.29,4.8,0,0,0,0,0,0,0.174804228451323,2657.72982248194,17.566897950592
7.5,"greedy_SVM","SVM",8,28,27240,24242,2998,2900,2396,504,0.60229678293177,0.195299384443201,1.84758623275778,1224,504,720,36,1.4,9.62,4.8,0,0,0,0,0,0,0.177012819423978,3079.12100541016,17.7818792333466
7.5,"greedy_SVM","SVM",8,29,27140,24171,2969,3000,2467,533,0.601632040227631,0.202014549524342,1.95123880985639,1286,533,753,62,1.4,9.95,4.6,0,0,0,0,0,0,0.17942383940782,2686.16236829379,18.0043494101115
7.5,"greedy_SVM","SVM",8,30,27040,24098,2942,3100,2540,560,0.602394556557635,0.199776161163962,1.94847268587307,1361,560,801,75,1.4,10.29,4.5,0,0,0,0,0,0,0.18165447733833,2775.3033125462,18.2650489469624
7.5,"greedy_SVM","SVM",8,31,26940,24012,2928,3200,2626,574,0.601259775888192,0.199776161163962,1.98227703403976,1375,574,801,14,1.4,10.62,4.6,0,0,0,0,0,0,0.181004621641486,2587.00482644836,18.2045528011762
7.5,"greedy_SVM","SVM",8,32,26840,23941,2899,3300,2697,603,0.602286251520105,0.202014549524342,1.97800408448185,1453,603,850,78,1.4,10.95,4.5,0,0,0,0,0,0,0.184111362988913,2722.65522254924,18.5929741810778
7.5,"greedy_SVM","SVM",8,33,26740,23860,2880,3400,2778,622,0.60146058884577,0.199776161163962,1.90693451568113,1488,622,866,35,1.4,11.28,4.5,0,0,0,0,0,0,0.182718973835711,2415.60254104342,18.4192399802678
7.5,"greedy_SVM","SVM",8,34,26640,23773,2867,3500,2865,635,0.599890144738663,0.192501398992725,1.83184870096256,1522,635,887,34,1.4,11.61,4.5,0,0,0,0,0,0,0.183711873067195,2517.41921163335,18.4940674591899
7.5,"greedy_SVM","SVM",8,35,26540,23683,2857,3600,2955,645,0.599786473522257,0.198656966983772,1.91740251292574,1554,645,909,32,1.4,11.94,4.6,0,0,0,0,0,0,0.180314683112607,2470.84053401936,18.1361353193818
7.5,"greedy_SVM","SVM",8,36,26440,23598,2842,3700,3040,660,0.599944655325431,0.196418578623391,1.8486758183216,1591,660,931,37,1.4,12.28,4.6,0,0,0,0,0,0,0.178923102251989,2437.70899815696,17.9495401317604
7.5,"greedy_SVM","SVM",8,37,26340,23509,2831,3800,3129,671,0.603366732231027,0.207050923335199,2.03073372433202,1613,671,942,22,1.4,12.61,4.7,0,0,0,0,0,0,0.176468938313886,2639.01020455598,17.7633412135786
7.5,"greedy_SVM","SVM",8,38,26240,23432,2808,3900,3206,694,0.600166573231985,0.199776161163962,1.77100301500109,1666,694,972,53,1.4,12.94,4.6,0,0,0,0,0,0,0.178098247668061,2435.77867550637,17.9172607610483
7.5,"greedy_SVM","SVM",8,39,26140,23340,2800,4000,3298,702,0.602892481701039,0.204252937884723,1.93795377966162,1708,702,1006,42,1.4,13.27,4.7,0,0,0,0,0,0,0.174049542207979,2458.17540083445,17.4687693913748
7.5,"greedy_SVM","SVM",8,40,26040,23254,2786,4100,3384,716,0.602992445860549,0.204812534974818,2.05085410177028,1732,716,1016,24,1.4,13.6,4.7,0,0,0,0,0,0,0.173251963934182,1991.00609370151,17.4113807680981
7.5,"greedy_SVM","SVM",8,41,25940,23168,2772,4200,3470,730,0.602226854358331,0.206491326245104,1.988197025801,1752,730,1022,20,1.4,13.93,4.8,0,0,0,0,0,0,0.172988469937389,2475.99185191822,17.3585028316139
7.5,"greedy_SVM","SVM",8,42,25840,23079,2761,4300,3559,741,0.603372503444623,0.208170117515389,2.11021633785377,1798,741,1057,46,1.4,14.27,4.8,0,0,0,0,0,0,0.169147896366845,2472.52158787557,17.0042542982923
7.5,"greedy_SVM","SVM",8,43,25740,23008,2732,4400,3630,770,0.600423455425257,0.205372132064913,1.93795377966162,1878,770,1108,80,1.4,14.6,4.7,0,0,0,0,0,0,0.17342673518606,2764.56823353916,17.3999300787905
7.5,"greedy_SVM","SVM",8,44,25640,22926,2714,4500,3712,788,0.602945770644037,0.205372132064913,1.98227703403976,1890,788,1102,12,1.4,14.93,4.7,0,0,0,0,0,0,0.176582853584114,2353.00672211481,19.2732504396617
7.5,"greedy_SVM","SVM",8,45,25540,22849,2691,4600,3789,811,0.599030023285385,0.202014549524342,1.93630585978096,1956,811,1145,66,1.4,15.26,4.7,0,0,0,0,0,0,0.174537038281162,2353.67887979074,17.5774050630864
7.5,"greedy_SVM","SVM",8,46,25440,22761,2679,4700,3877,823,0.598518491558104,0.195858981533296,1.75066214169037,1977,823,1154,21,1.4,15.59,4.7,0,0,0,0,0,0,0.172833776217248,2222.09942880691,17.4735189345252
7.5,"greedy_SVM","SVM",8,47,25340,22669,2671,4800,3969,831,0.596692344775841,0.19194180190263,1.61621193716134,1999,831,1168,22,1.4,15.93,4.8,0,0,0,0,0,0,0.171674336625491,2108.44511382624,17.2875268798419
7.5,"greedy_SVM","SVM",8,48,25240,22585,2655,4900,4053,847,0.598658559333218,0.205372132064913,1.83811143156415,2044,847,1197,45,1.4,16.26,4.8,0,0,0,0,0,0,0.170082031598297,2149.16361751541,17.1451238252549
7.5,"greedy_SVM","SVM",9,0,30040,26597,3443,100,89,11,0.398841941266614,0,0.631210719964546,40,11,29,0,2.6,0.33,8.1,0,0,0,0,0,0,0.121547544820757,3343.3127429528,12.1960479657434
7.5,"greedy_SVM","SVM",9,1,29940,26504,3436,200,182,18,0.430151584770459,0.105722070844687,0.949911274448011,68,18,50,28,2.8,0.66,10.1,0,0,0,0,0,0,0.147473818373584,2587.21553706071,16.2974560264
7.5,"greedy_SVM","SVM",9,2,29840,26422,3418,300,264,36,0.40499646740003,0.0741144414168937,0.621217938118142,113,36,77,45,2.1,1,7.3,0,0,0,0,0,0,0.134372999837079,3561.54108949121,13.5291359853456
7.5,"greedy_SVM","SVM",9,3,29740,26328,3412,400,358,42,0.415030224727706,0.085558583106267,0.749288874193603,138,42,96,25,2.3,1.33,8.5,0,0,0,0,0,0,0.132547209955198,3029.18698776498,13.5759923609943
7.5,"greedy_SVM","SVM",9,4,29640,26236,3404,500,450,50,0.421344397205868,0.0953678474114441,0.805346087559334,171,50,121,33,2.4,1.66,9,0,0,0,0,0,0,0.106681767407926,2898.48495609017,10.7196336276507
7.5,"greedy_SVM","SVM",9,5,29540,26149,3391,600,537,63,0.416765439479315,0.0752043596730245,0.57765569295558,207,63,144,36,2.3,1.99,8.5,0,0,0,0,0,0,0.12156758119018,2950.24279574784,12.4884230696814
7.5,"greedy_SVM","SVM",9,6,29440,26056,3384,700,630,70,0.415806696788462,0.100272479564033,0.752681096087605,219,70,149,12,2.1,2.32,9,0,0,0,0,0,0,0.130770684986473,2842.19849403455,15.8404908526957
7.5,"greedy_SVM","SVM",9,7,29340,25967,3373,800,719,81,0.434114293195915,0.116621253405995,0.986756557847141,265,81,184,46,2.3,2.65,8.9,0,0,0,0,0,0,0.112798460964319,2897.67137349621,11.7195355884739
7.5,"greedy_SVM","SVM",9,8,29240,25884,3356,900,802,98,0.434795821485953,0.116621253405995,1.03681791043309,313,98,215,48,2.2,2.99,8.2,0,0,0,0,0,0,0.138579561535464,2891.71635031714,14.2269698871171
7.5,"greedy_SVM","SVM",9,9,29140,25798,3342,1000,888,112,0.419847694710897,0.10299727520436,0.829381527395276,336,112,224,23,2,3.32,7.9,0,0,0,0,0,0,0.123121453157033,3100.31446232289,12.8002775082376
7.5,"greedy_SVM","SVM",9,10,29040,25708,3332,1100,978,122,0.431439398618087,0.105177111716621,0.897041754992816,377,122,255,41,2.1,3.65,8,0,0,0,0,0,0,0.111873163006229,3208.06425259161,11.2016412461778
7.5,"greedy_SVM","SVM",9,11,28940,25623,3317,1200,1063,137,0.413053574472394,0.0920980926430518,0.80520382539937,415,137,278,38,2,3.98,7.8,0,0,0,0,0,0,0.117373181760303,3221.81736472095,11.7789272602895
7.5,"greedy_SVM","SVM",9,12,28840,25533,3307,1300,1153,147,0.417135086128738,0.085558583106267,0.653560664647764,452,147,305,37,2.1,4.31,7.8,0,0,0,0,0,0,0.114809639303891,3230.30625040371,11.4984133475046
7.5,"greedy_SVM","SVM",9,13,28740,25441,3299,1400,1245,155,0.418403034248103,0.0920980926430518,0.719930003460832,458,155,303,6,2,4.64,8,0,0,0,0,0,0,0.112042736015689,3138.42507286515,11.219541965703
7.5,"greedy_SVM","SVM",9,14,28640,25347,3293,1500,1339,161,0.420396771088345,0.0888283378746594,0.822041867860804,485,161,324,27,2,4.98,8.3,0,0,0,0,0,0,0.108747674655297,3001.07969397488,10.8979468024683
7.5,"greedy_SVM","SVM",9,15,28540,25254,3286,1600,1432,168,0.591733921935313,0.188555858310627,1.78862609748713,507,168,339,22,2,5.31,8.5,0,0,0,0,0,0,0.141105351022149,3065.51830844151,15.3687885240646
7.5,"greedy_SVM","SVM",9,16,28440,25179,3261,1700,1507,193,0.534519101155047,0.139509536784741,1.32256877442377,583,193,390,76,2,5.64,7.8,0,0,0,0,0,0,0.114655745929433,3225.91097824492,11.5238361527255
7.5,"greedy_SVM","SVM",9,17,28340,25108,3232,1800,1578,222,0.533343997009228,0.147683923705722,1.30795475481688,606,222,384,23,1.7,5.97,7.1,0,0,0,0,0,0,0.126956633275577,3478.43641512132,13.0009853443894
7.5,"greedy_SVM","SVM",9,18,28240,25028,3212,1900,1658,242,0.528333716237526,0.150408719346049,1.17536996562714,679,242,437,73,1.8,6.3,6.9,0,0,0,0,0,0,0.128465831571386,3582.42407284802,12.8726075141883
7.5,"greedy_SVM","SVM",9,19,28140,24943,3197,2000,1743,257,0.53759814493212,0.159128065395095,1.39277738610164,716,257,459,37,1.8,6.64,6.8,0,0,0,0,0,0,0.129643640033176,3596.41613627961,12.9934671627757
7.5,"greedy_SVM","SVM",9,20,28040,24858,3182,2100,1828,272,0.530087293921375,0.152588555858311,1.34238374125456,746,272,474,30,1.7,6.97,6.7,0,0,0,0,0,0,0.130101717993054,3614.70517446269,13.0418729972767
7.5,"greedy_SVM","SVM",9,21,27940,24791,3149,2200,1895,305,0.524355876920594,0.156403269754768,1.33301282508524,837,305,532,91,1.7,7.3,6.2,0,0,0,0,0,0,0.139192355990767,3860.94987899623,13.9426215435534
7.5,"greedy_SVM","SVM",9,22,27840,24698,3142,2300,1988,312,0.518187619760488,0.155858310626703,1.34581011384288,860,312,548,23,1.8,7.63,6.4,0,0,0,0,0,0,0.13573922156059,3758.29167020098,13.5850752085974
7.5,"greedy_SVM","SVM",9,23,27740,24613,3127,2400,2073,327,0.509031721759579,0.128065395095368,1.18912385078313,908,327,581,48,1.8,7.96,6.3,0,0,0,0,0,0,0.136311006571211,3750.36613150336,13.641690932336
7.5,"greedy_SVM","SVM",9,24,27640,24520,3120,2500,2166,334,0.520110334048912,0.154768392370572,1.40345552549121,942,334,608,34,1.8,8.29,6.5,0,0,0,0,0,0,0.133430747155884,3671.72685040679,13.3473845174609
7.5,"greedy_SVM","SVM",9,25,27540,24430,3110,2600,2256,344,0.522205519913898,0.154768392370572,1.14853083907889,963,344,619,21,1.8,8.63,6.6,0,0,0,0,0,0,0.132378243887193,3641.12962283364,13.2388015712867
7.5,"greedy_SVM","SVM",9,26,27440,24340,3100,2700,2346,354,0.539392812764793,0.1858310626703,1.73957576445655,1021,354,667,58,1.9,8.96,6.6,0,0,0,0,0,0,0.131001556335254,3582.42437539658,13.1026436918391
7.5,"greedy_SVM","SVM",9,27,27340,24257,3083,2800,2429,371,0.535335757569769,0.153133514986376,1.34700320791543,1035,371,664,14,1.8,9.29,6.5,0,0,0,0,0,0,0.13230472806542,3604.88990038634,13.2342729562015
7.5,"greedy_SVM","SVM",9,28,27240,24167,3073,2900,2519,381,0.529247992635066,0.156403269754768,1.40276482361168,1081,381,700,46,1.8,9.62,6.6,0,0,0,0,0,0,0.13118135928903,3560.86170553141,13.1239534498522
7.5,"greedy_SVM","SVM",9,29,27140,24080,3060,3000,2606,394,0.530820493691137,0.174386920980926,1.404007307955,1152,394,758,71,1.9,9.95,6.6,0,0,0,0,0,0,0.131063616272843,3541.78477150026,13.1098535107378
7.5,"greedy_SVM","SVM",9,30,27040,23995,3045,3100,2691,409,0.534715864502968,0.171662125340599,1.59456055423503,1167,409,758,15,1.9,10.29,6.6,0,0,0,0,0,0,0.131594007992531,3535.85819435206,13.1622326798043
7.5,"greedy_SVM","SVM",9,31,26940,23907,3033,3200,2779,421,0.52543179652883,0.144959128065395,1.23232430118491,1229,421,808,62,1.9,10.62,6.6,0,0,0,0,0,0,0.131334060107809,3527.28540778731,13.135132626963
7.5,"greedy_SVM","SVM",9,32,26840,23827,3013,3300,2859,441,0.523240267028325,0.162397820163488,1.42135355013405,1278,441,837,49,1.9,10.95,6.5,0,0,0,0,0,0,0.133341120373602,3554.80518077023,13.3379449995819
7.5,"greedy_SVM","SVM",9,33,26740,23738,3002,3400,2948,452,0.527819471789844,0.159673024523161,1.58562112734783,1293,452,841,15,1.9,11.28,6.5,0,0,0,0,0,0,0.132595428126586,3533.73410463272,13.2614962478556
7.5,"greedy_SVM","SVM",9,34,26640,23646,2994,3500,3040,460,0.523084593829227,0.156403269754768,1.41402698544264,1330,460,870,37,1.9,11.61,6.6,0,0,0,0,0,0,0.131102496365154,3472.51678578212,13.1127925457624
7.5,"greedy_SVM","SVM",9,35,26540,23557,2983,3600,3129,471,0.528681335602764,0.173297002724796,1.53542570726949,1351,471,880,21,1.9,11.94,6.6,0,0,0,0,0,0,0.130532005071575,3451.90379814961,13.0545153544548
7.5,"greedy_SVM","SVM",9,36,26440,23480,2960,3700,3206,494,0.517090043420513,0.148773841961853,1.31265804409647,1419,494,925,68,1.9,12.28,6.5,0,0,0,0,0,0,0.133253967588206,3499.12870554702,13.3268057399188
7.5,"greedy_SVM","SVM",9,37,26340,23406,2934,3800,3280,520,0.524866086463882,0.159128065395095,1.55815506212921,1483,520,963,64,1.9,12.61,6.3,0,0,0,0,0,0,0.136543662106047,3576.5066853754,13.6566092787094
7.5,"greedy_SVM","SVM",9,38,26240,23331,2909,3900,3355,545,0.533784748555464,0.17983651226158,1.46585137348295,1518,545,973,35,1.8,12.94,6.2,0,0,0,0,0,0,0.139538431211118,3648.52166425466,13.9546445400665
7.5,"greedy_SVM","SVM",9,39,26140,23252,2888,4000,3434,566,0.521486071757071,0.146049046321526,1.30447306514123,1598,566,1032,80,1.8,13.27,6.1,0,0,0,0,0,0,0.141331848131858,3683.08881454132,14.1578359052195
7.5,"greedy_SVM","SVM",9,40,26040,23163,2877,4100,3523,577,0.523249077942002,0.161307901907357,1.41331298308904,1617,577,1040,19,1.8,13.6,6.1,0,0,0,0,0,0,0.140410349358215,3635.95158610457,14.0435900786739
7.5,"greedy_SVM","SVM",9,41,25940,23073,2867,4200,3613,587,0.529251451124545,0.172207084468665,1.61968224983475,1622,587,1035,5,1.8,13.93,6.2,0,0,0,0,0,0,0.139487110142733,3594.03505197662,13.950358435909
7.5,"greedy_SVM","SVM",9,42,25840,23010,2830,4300,3676,624,0.513374390544157,0.150408719346049,1.33534326708714,1714,624,1090,92,1.7,14.27,5.9,0,0,0,0,0,0,0.144811346468091,3712.71341739721,14.4841639665235
7.5,"greedy_SVM","SVM",9,43,25740,22920,2820,4400,3766,634,0.536434116187129,0.173297002724796,1.55072121339151,1734,634,1100,20,1.7,14.6,5.9,0,0,0,0,0,0,0.143904417960336,3691.07206332175,14.3923109445173
7.5,"greedy_SVM","SVM",9,44,25640,22841,2799,4500,3845,655,0.525015542616421,0.164577656675749,1.3943983045716,1768,655,1113,34,1.7,14.93,5.9,0,0,0,0,0,0,0.145307360168399,3712.11634085976,14.5328613428462
7.5,"greedy_SVM","SVM",9,45,25540,22753,2787,4600,3933,667,0.527763559543247,0.177656675749319,1.70473759762653,1823,667,1156,55,1.7,15.26,5.9,0,0,0,0,0,0,0.145638664544673,3627.02322249382,14.5693728895787
7.5,"greedy_SVM","SVM",9,46,25440,22694,2746,4700,3992,708,0.527461682818639,0.17983651226158,1.60237674650342,1910,708,1202,87,1.7,15.59,5.6,0,0,0,0,0,0,0.150653061892245,3827.74219183507,15.0654667802211
7.5,"greedy_SVM","SVM",9,47,25340,22606,2734,4800,4080,720,0.524725935294956,0.154223433242507,1.28306706652782,1937,720,1217,27,1.7,15.93,5.7,0,0,0,0,0,0,0.149685997441784,3771.89486020843,14.9726260266165
7.5,"greedy_SVM","SVM",9,48,25240,22521,2719,4900,4165,735,0.520645576468433,0.14441416893733,1.18584563376998,1992,735,1257,55,1.7,16.26,5.7,0,0,0,0,0,0,0.149996700337611,3778.69981768338,15.0000941334645
7.5,"greedy_SVM","SVM",10,0,30040,26493,3547,100,88,12,0.410918533981688,0.0705202312138728,0.609577763328333,48,12,36,0,3,0.33,7.3,0,0,0,0,0,0,0.149391249621253,3561.50447692078,15.193414079784
7.5,"greedy_SVM","SVM",10,1,29940,26400,3540,200,181,19,0.431736231435716,0.084971098265896,0.700760597710376,62,19,43,14,2.3,0.66,9.5,0,0,0,0,0,0,0.133093335253486,2545.44092484923,13.599496425221
7.5,"greedy_SVM","SVM",10,2,29840,26302,3538,300,279,21,0.56773673057067,0.176300578034682,1.78052073826184,69,21,48,7,2.3,1,13.3,0,0,0,0,0,0,0.143179708078392,2270.75535682588,16.47157708084
7.5,"greedy_SVM","SVM",10,3,29740,26243,3497,400,338,62,0.517875617473706,0.133526011560694,1.16414577879157,155,62,93,86,1.5,1.33,5.5,0,0,0,0,0,0,0.332972494931617,4705.90164919056,35.6064729644251
7.5,"greedy_SVM","SVM",10,4,29640,26160,3480,500,421,79,0.52047675187923,0.144508670520231,1.34803220035778,190,79,111,35,1.4,1.66,5.3,0,0,0,0,0,0,0.323480989943975,3821.96911446928,39.8441479305609
7.5,"greedy_SVM","SVM",10,5,29540,26077,3463,600,504,96,0.535073503255865,0.145086705202312,1.37428363883651,232,96,136,42,1.4,1.99,5.2,0,0,0,0,0,0,0.18317926875023,4293.96027485127,18.6121707222727
7.5,"greedy_SVM","SVM",10,6,29440,25982,3458,700,599,101,0.524788420068862,0.129479768786127,1.08111094939078,246,101,145,14,1.4,2.32,5.9,0,0,0,0,0,0,0.151384348383572,3844.46248655258,15.3427335729579
7.5,"greedy_SVM","SVM",10,7,29340,25901,3439,800,680,120,0.51284574953217,0.131791907514451,1.1792942423707,309,120,189,63,1.6,2.65,5.7,0,0,0,0,0,0,0.156286410475784,3670.17157863283,16.0248360680927
7.5,"greedy_SVM","SVM",10,8,29240,25816,3424,900,765,135,0.514187174744471,0.148554913294798,1.31216912408684,338,135,203,29,1.5,2.99,5.7,0,0,0,0,0,0,0.175185962193033,3679.56471750473,18.8476869272679
7.5,"greedy_SVM","SVM",10,9,29140,25725,3415,1000,856,144,0.522053749729745,0.158959537572254,1.55399544886577,380,144,236,42,1.6,3.32,5.9,0,0,0,0,0,0,0.149471315086757,3662.65147839245,14.9890926267793
7.5,"greedy_SVM","SVM",10,10,29040,25636,3404,1100,945,155,0.525261601746623,0.16242774566474,1.63579523941742,391,155,236,11,1.5,3.65,6.1,0,0,0,0,0,0,0.14235234207536,3329.47444746708,14.4061642101666
7.5,"greedy_SVM","SVM",10,11,28940,25551,3389,1200,1030,170,0.523791190007943,0.155491329479769,1.46592432355757,453,170,283,62,1.7,3.98,6.1,0,0,0,0,0,0,0.143474946417805,3660.99016366119,14.4544885430315
7.5,"greedy_SVM","SVM",10,12,28840,25471,3369,1300,1110,190,0.519171635269255,0.154335260115607,1.40484414340934,503,190,313,50,1.6,4.31,5.8,0,0,0,0,0,0,0.146398562267265,3231.44443617986,15.4704870339191
7.5,"greedy_SVM","SVM",10,13,28740,25387,3353,1400,1194,206,0.528733059415693,0.163005780346821,1.57143739307371,546,206,340,43,1.7,4.64,5.8,0,0,0,0,0,0,0.147572325670028,3714.82671655007,14.8500750229222
7.5,"greedy_SVM","SVM",10,14,28640,25314,3326,1500,1267,233,0.52791390615136,0.155491329479769,1.40484414340934,607,233,374,61,1.6,4.98,5.4,0,0,0,0,0,0,0.154471867743247,3769.85251677161,15.8168834065468
7.5,"greedy_SVM","SVM",10,15,28540,25240,3300,1600,1341,259,0.522340665677933,0.145086705202312,1.25551228387585,660,259,401,53,1.5,5.31,5.2,0,0,0,0,0,0,0.161539314749155,4101.56295717133,16.1910988248336
7.5,"greedy_SVM","SVM",10,16,28440,25158,3282,1700,1423,277,0.528187217205597,0.161271676300578,1.53911820784095,708,277,431,48,1.6,5.64,5.1,0,0,0,0,0,0,0.162169165938537,3871.91117583468,16.7019837440814
7.5,"greedy_SVM","SVM",10,17,28340,25087,3253,1800,1494,306,0.533815960447017,0.153757225433526,1.37792699899428,777,306,471,69,1.5,5.97,4.9,0,0,0,0,0,0,0.255286779620663,4086.87829038293,28.6131243955096
7.5,"greedy_SVM","SVM",10,18,28240,25016,3224,1900,1565,335,0.53686375998541,0.152601156069364,1.43797814069718,851,335,516,74,1.5,6.3,4.7,0,0,0,0,0,0,0.174102040664383,4058.79644444997,17.4590824854858
7.5,"greedy_SVM","SVM",10,19,28140,24925,3215,2000,1656,344,0.536551150718394,0.14971098265896,1.38802155418057,860,344,516,9,1.5,6.64,4.8,0,0,0,0,0,0,0.168750472067567,4166.90320162244,16.8899116725753
7.5,"greedy_SVM","SVM",10,20,28040,24833,3207,2100,1748,352,0.537605919948629,0.153179190751445,1.43916819894958,883,352,531,23,1.5,6.97,5,0,0,0,0,0,0,0.165297334621628,4269.45921252655,16.5420126573239
7.5,"greedy_SVM","SVM",10,21,27940,24744,3196,2200,1837,363,0.535149543347832,0.145086705202312,1.41268551788783,921,363,558,38,1.5,7.3,5.1,0,0,0,0,0,0,0.161716166601056,4067.86280293217,16.1772097993735
7.5,"greedy_SVM","SVM",10,22,27840,24656,3184,2300,1925,375,0.537673034536937,0.147398843930636,1.45825601846486,978,375,603,57,1.6,7.63,5.1,0,0,0,0,0,0,0.160592242754102,3824.71679761033,16.0830918954902
7.5,"greedy_SVM","SVM",10,23,27740,24560,3180,2400,2021,379,0.532994164193739,0.145664739884393,1.34794263606303,972,379,593,-6,1.6,7.96,5.3,0,0,0,0,0,0,0.154156696278952,3676.18480173573,15.5400335222939
7.5,"greedy_SVM","SVM",10,24,27640,24469,3171,2500,2112,388,0.534453657355112,0.145086705202312,1.42385789896076,971,388,583,-1,1.5,8.29,5.4,0,0,0,0,0,0,0.153891451783754,3774.96544826358,15.4480255365569
7.5,"greedy_SVM","SVM",10,25,27540,24377,3163,2600,2204,396,0.536507173115341,0.152601156069364,1.41762929922777,981,396,585,10,1.5,8.63,5.6,0,0,0,0,0,0,0.150556006342272,3468.69937048522,15.562874918484
7.5,"greedy_SVM","SVM",10,26,27440,24288,3152,2700,2293,407,0.539669617715479,0.155491329479769,1.5087907554697,980,407,573,-1,1.4,8.96,5.6,0,0,0,0,0,0,0.149687388782341,3682.92168762487,15.3939766503151
7.5,"greedy_SVM","SVM",10,27,27340,24213,3127,2800,2368,432,0.531190735847116,0.158959537572254,1.5853058830074,1034,432,602,54,1.4,9.29,5.5,0,0,0,0,0,0,0.178929818648184,3365.65876294146,19.4994102251945
7.5,"greedy_SVM","SVM",10,28,27240,24145,3095,2900,2436,464,0.5338061250619,0.145664739884393,1.3319960990278,1131,464,667,97,1.4,9.62,5.2,0,0,0,0,0,0,0.158366869722677,4112.38591088531,15.8806968655641
7.5,"greedy_SVM","SVM",10,29,27140,24053,3087,3000,2528,472,0.535183512255022,0.148554913294798,1.43297212454157,1142,472,670,11,1.4,9.95,5.4,0,0,0,0,0,0,0.154450000365884,3341.25067438291,15.4650919734334
7.5,"greedy_SVM","SVM",10,30,27040,23972,3068,3100,2609,491,0.536589019117475,0.155491329479769,1.54353495436174,1204,491,713,62,1.5,10.29,5.3,0,0,0,0,0,0,0.155668128561364,3433.55276600139,15.5781364601794
7.5,"greedy_SVM","SVM",10,31,26940,23896,3044,3200,2685,515,0.536882737512633,0.152601156069364,1.46208011641538,1238,515,723,34,1.4,10.62,5.2,0,0,0,0,0,0,0.158099181639858,3502.01850646699,15.825391797615
7.5,"greedy_SVM","SVM",10,32,26840,23815,3025,3300,2766,534,0.535577967524166,0.14393063583815,1.40020740949062,1318,534,784,80,1.5,10.95,5.2,0,0,0,0,0,0,0.159767856375013,3634.98964862194,15.9936577727556
7.5,"greedy_SVM","SVM",10,33,26740,23725,3015,3400,2856,544,0.53582567191495,0.141040462427746,1.31352821550576,1312,544,768,-6,1.4,11.28,5.2,0,0,0,0,0,0,0.158615861532138,3932.63677245577,15.8683267925561
7.5,"greedy_SVM","SVM",10,34,26640,23641,2999,3500,2940,560,0.535160028648262,0.150867052023121,1.50747876350842,1359,560,799,47,1.4,11.61,5.2,0,0,0,0,0,0,0.155405525898244,3037.25588049617,15.5682146703725
7.5,"greedy_SVM","SVM",10,35,26540,23558,2982,3600,3023,577,0.536929358104636,0.14393063583815,1.40900025131943,1411,577,834,52,1.4,11.94,5.2,0,0,0,0,0,0,0.157847347984356,3490.78801519472,15.804080613066
7.5,"greedy_SVM","SVM",10,36,26440,23469,2971,3700,3112,588,0.53676440959743,0.14971098265896,1.42291347559046,1416,588,828,5,1.4,12.28,5.3,0,0,0,0,0,0,0.154925917680101,3229.41356158917,15.521908159103
7.5,"greedy_SVM","SVM",10,37,26340,23379,2961,3800,3202,598,0.537576153827156,0.154335260115607,1.48492511823437,1495,598,897,79,1.5,12.61,5.4,0,0,0,0,0,0,0.154901337988759,3405.62258060368,15.507758373002
7.5,"greedy_SVM","SVM",10,38,26240,23288,2952,3900,3293,607,0.537003535106043,0.152601156069364,1.5342068527599,1483,607,876,-12,1.4,12.94,5.4,0,0,0,0,0,0,0.154459832269382,3503.00639785941,15.4753317197737
7.5,"greedy_SVM","SVM",10,39,26140,23205,2935,4000,3376,624,0.536135464882257,0.153179190751445,1.44687660216135,1512,624,888,29,1.4,13.27,5.4,0,0,0,0,0,0,0.154415402344164,3557.93950565131,15.4501724382159
7.5,"greedy_SVM","SVM",10,40,26040,23117,2923,4100,3464,636,0.537610166062025,0.154913294797688,1.6174313895794,1595,636,959,83,1.5,13.6,5.4,0,0,0,0,0,0,0.151932126273714,3074.32431820444,15.2065031247323
7.5,"greedy_SVM","SVM",10,41,25940,23036,2904,4200,3545,655,0.539992062367608,0.161849710982659,1.61916442211664,1600,655,945,5,1.4,13.93,5.4,0,0,0,0,0,0,0.152547127272453,3243.94589371369,15.2832027162168
7.5,"greedy_SVM","SVM",10,42,25840,22943,2897,4300,3638,662,0.537161681166281,0.158381502890173,1.5426722061657,1668,662,1006,68,1.5,14.27,5.5,0,0,0,0,0,0,0.151927937915972,3335.86952797977,15.209135588496
7.5,"greedy_SVM","SVM",10,43,25740,22866,2874,4400,3715,685,0.539347563012539,0.156647398843931,1.5510643931635,1715,685,1030,47,1.5,14.6,5.4,0,0,0,0,0,0,0.153991691262439,3485.00638676584,15.4230749808961
7.5,"greedy_SVM","SVM",10,44,25640,22789,2851,4500,3792,708,0.538173296019533,0.160693641618497,1.56747804868292,1725,708,1017,10,1.4,14.93,5.4,0,0,0,0,0,0,0.154252731943566,3267.54880416566,15.4408317322538
7.5,"greedy_SVM","SVM",10,45,25540,22707,2833,4600,3874,726,0.537531612964162,0.157803468208092,1.56322430565346,1760,726,1034,35,1.4,15.26,5.3,0,0,0,0,0,0,0.15495131124032,3137.62954042342,15.5287929956611
7.5,"greedy_SVM","SVM",10,46,25440,22618,2822,4700,3963,737,0.538193270083578,0.161271676300578,1.62110781603418,1826,737,1089,66,1.5,15.59,5.4,0,0,0,0,0,0,0.154478297625364,3527.54827547002,15.4599953499024
7.5,"greedy_SVM","SVM",10,47,25340,22532,2808,4800,4049,751,0.540081187421274,0.161849710982659,1.61523664882107,1903,751,1152,77,1.5,15.93,5.4,0,0,0,0,0,0,0.153583678274004,3333.5863544696,15.3858049778775
7.5,"greedy_SVM","SVM",10,48,25240,22442,2798,4900,4139,761,0.536408342659623,0.157225433526012,1.5087907554697,1868,761,1107,-35,1.5,16.26,5.4,0,0,0,0,0,0,0.152560193819766,3271.65806436876,15.2684192814423
7.5,"greedy_SVM","SVM",11,0,30040,26530,3510,100,92,8,0.556668697435298,0.194805194805195,2.08085619368628,29,8,21,0,2.6,0.33,11.5,0,0,0,0,0,0,0.609083671720449,2377.34085817012,70.7714784826964
7.5,"greedy_SVM","SVM",11,1,29940,26479,3461,200,143,57,0.516326360791868,0.180124223602484,1.70346402609248,119,57,62,90,1.1,0.66,2.5,0,0,0,0,0,0,0.374589681952198,6451.30110154367,41.2818482470875
7.5,"greedy_SVM","SVM",11,2,29840,26417,3423,300,205,95,0.525720653978254,0.134387351778656,1.37449982382635,201,95,106,82,1.1,1,2.2,0,0,0,0,0,0,0.330202909387526,8998.19075972556,33.7296537350578
7.5,"greedy_SVM","SVM",11,3,29740,26350,3390,400,272,128,0.542406312223247,0.166572557876906,1.41703696061306,277,128,149,76,1.2,1.33,2.1,0,0,0,0,0,0,0.372179789132843,8232.98150781497,39.9792073000345
7.5,"greedy_SVM","SVM",11,4,29640,26269,3371,500,353,147,0.509765817706319,0.107848673066064,0.866049879324216,317,147,170,40,1.2,1.66,2.4,0,0,0,0,0,0,0.371002566702108,7446.34902564053,40.2386364871619
7.5,"greedy_SVM","SVM",11,5,29540,26182,3358,600,440,160,0.5666634117762,0.182382834556748,1.79817494414848,348,160,188,31,1.2,1.99,2.8,0,0,0,0,0,0,0.276204413882075,6110.10245561044,29.672064525868
7.5,"greedy_SVM","SVM",11,6,29440,26115,3325,700,507,193,0.557748479046287,0.163749294184077,1.60977330646803,419,193,226,71,1.2,2.32,2.6,0,0,0,0,0,0,0.304812114806324,4257.22542752944,34.8681779013072
7.5,"greedy_SVM","SVM",11,7,29340,26028,3312,800,594,206,0.5658025073978,0.171089779785432,1.66101963602545,451,206,245,32,1.2,2.65,2.9,0,0,0,0,0,0,0.297401079829952,4881.35561068549,31.9645925164417
7.5,"greedy_SVM","SVM",11,8,29240,25956,3284,900,666,234,0.572393872880966,0.181818181818182,1.75469236419602,513,234,279,62,1.2,2.99,2.8,0,0,0,0,0,0,0.275129137577549,3888.59658024245,29.4789467747854
7.5,"greedy_SVM","SVM",11,9,29140,25876,3264,1000,746,254,0.556074899275295,0.171089779785432,1.76691415524794,555,254,301,42,1.2,3.32,2.9,0,0,0,0,0,0,0.244619971197519,4141.16580991792,26.2255319919626
7.5,"greedy_SVM","SVM",11,10,29040,25794,3246,1100,828,272,0.565134094411637,0.192546583850932,1.89527971353518,596,272,324,41,1.2,3.65,3,0,0,0,0,0,0,0.279231676094009,3949.58202050877,32.3116308887791
7.5,"greedy_SVM","SVM",11,11,28940,25722,3218,1200,900,300,0.579238992455732,0.20214568040655,1.89527971353518,658,300,358,62,1.2,3.98,3,0,0,0,0,0,0,0.260969330413791,4391.87571564244,27.1729786920962
7.5,"greedy_SVM","SVM",11,12,28840,25636,3204,1300,986,314,0.571814148584338,0.197063805759458,1.89359950102318,690,314,376,32,1.2,4.31,3.1,0,0,0,0,0,0,0.229606138921513,4018.02387763508,23.4782070189232
7.5,"greedy_SVM","SVM",11,13,28740,25555,3185,1400,1067,333,0.574969835656329,0.195369847543761,1.91038154392192,736,333,403,46,1.2,4.64,3.2,0,0,0,0,0,0,0.223577986544788,3473.44973087649,23.401676589681
7.5,"greedy_SVM","SVM",11,14,28640,25468,3172,1500,1154,346,0.574749196537362,0.200451722190853,1.87262696795508,763,346,417,27,1.2,4.98,3.3,0,0,0,0,0,0,0.218062209860851,3950.7322762628,22.1138347221546
7.5,"greedy_SVM","SVM",11,15,28540,25387,3153,1600,1235,365,0.575428308206997,0.204968944099379,1.98237273182396,822,365,457,59,1.3,5.31,3.4,0,0,0,0,0,0,0.217955854769528,4041.83695703506,22.538602847779
7.5,"greedy_SVM","SVM",11,16,28440,25312,3128,1700,1310,390,0.572486509894164,0.199322416713721,1.89359950102318,867,390,477,45,1.2,5.64,3.4,0,0,0,0,0,0,0.212934079764451,3140.03344551421,21.4988285583751
7.5,"greedy_SVM","SVM",11,17,28340,25224,3116,1800,1398,402,0.574306220095698,0.200451722190853,1.87851105878395,900,402,498,33,1.2,5.97,3.5,0,0,0,0,0,0,0.213245938678124,4081.87662797431,21.4471865764778
7.5,"greedy_SVM","SVM",11,18,28240,25136,3104,1900,1486,414,0.576225614855883,0.20214568040655,1.87684718716413,924,414,510,24,1.2,6.3,3.6,0,0,0,0,0,0,0.204316711543831,3450.41733284489,20.4976861936714
7.5,"greedy_SVM","SVM",11,19,28140,25056,3084,2000,1566,434,0.57713846304072,0.205533596837945,1.89024799748155,976,434,542,52,1.2,6.64,3.6,0,0,0,0,0,0,0.206358184412062,3508.1582309444,20.709013127935
7.5,"greedy_SVM","SVM",11,20,28040,24970,3070,2100,1652,448,0.578551517132757,0.202710333145116,1.91284060302914,1016,448,568,40,1.3,6.97,3.7,0,0,0,0,0,0,0.197342281345086,2835.10953592689,19.867176208463
7.5,"greedy_SVM","SVM",11,21,27940,24891,3049,2200,1731,469,0.580034558445801,0.20214568040655,1.90530973451327,1078,469,609,62,1.3,7.3,3.7,0,0,0,0,0,0,0.197929316820871,3062.14314741622,19.9153734423907
7.5,"greedy_SVM","SVM",11,22,27840,24814,3026,2300,1808,492,0.581039215769523,0.199322416713721,1.90362511052166,1138,492,646,60,1.3,7.63,3.7,0,0,0,0,0,0,0.203337903578056,3588.02996299638,20.4937075657655
7.5,"greedy_SVM","SVM",11,23,27740,24735,3005,2400,1887,513,0.582118381781677,0.200451722190853,1.9145348816855,1209,513,696,71,1.4,7.96,3.7,0,0,0,0,0,0,0.201633482922883,3189.06303243036,20.2778782714215
7.5,"greedy_SVM","SVM",11,24,27640,24651,2989,2500,1971,529,0.581795977804482,0.201581027667984,1.91867353036768,1261,529,732,52,1.4,8.29,3.7,0,0,0,0,0,0,0.200477380712326,3443.350749399,20.1410630303428
7.5,"greedy_SVM","SVM",11,25,27540,24570,2970,2600,2052,548,0.582657264278714,0.203839638622247,1.91867353036768,1307,548,759,46,1.4,8.63,3.7,0,0,0,0,0,0,0.199319660004137,3263.15590989023,20.0367532980887
7.5,"greedy_SVM","SVM",11,26,27440,24482,2958,2700,2140,560,0.582347129823425,0.200451722190853,1.87352827082962,1331,560,771,24,1.4,8.96,3.8,0,0,0,0,0,0,0.198120291047469,4152.79265721088,19.8614895488398
7.5,"greedy_SVM","SVM",11,27,27340,24398,2942,2800,2224,576,0.584272638117027,0.204968944099379,1.87939077361416,1392,576,816,61,1.4,9.29,3.9,0,0,0,0,0,0,0.194159272692216,3373.35003493151,19.5100901672387
7.5,"greedy_SVM","SVM",11,28,27240,24313,2927,2900,2309,591,0.585095078181054,0.203839638622247,1.8718732105197,1429,591,838,37,1.4,9.62,3.9,0,0,0,0,0,0,0.192952159771385,3120.30505019837,19.4212684637186
7.5,"greedy_SVM","SVM",11,29,27140,24222,2918,3000,2400,600,0.5872642787092,0.202710333145116,1.91114932044467,1473,600,873,44,1.5,9.95,4,0,0,0,0,0,0,0.190034017036725,3083.72213529052,19.190248329385
7.5,"greedy_SVM","SVM",11,30,27040,24128,2912,3100,2494,606,0.587209469183966,0.199887069452287,1.90946102599198,1479,606,873,6,1.4,10.29,4.1,0,0,0,0,0,0,0.184342737999721,3144.67360570206,18.5239235053347
7.5,"greedy_SVM","SVM",11,31,26940,24040,2900,3200,2582,618,0.58861273737704,0.199887069452287,1.97711909384209,1484,618,866,5,1.4,10.62,4.2,0,0,0,0,0,0,0.185136295273832,3733.66375016886,18.5929379604922
7.5,"greedy_SVM","SVM",11,32,26840,23960,2880,3300,2662,638,0.589565047570937,0.199322416713721,1.93953127836981,1521,638,883,37,1.4,10.95,4.2,0,0,0,0,0,0,0.184642000193578,3473.46960668834,18.5247273702215
7.5,"greedy_SVM","SVM",11,33,26740,23872,2868,3400,2750,650,0.589428894087282,0.197628458498024,1.96323795027549,1591,650,941,70,1.4,11.28,4.2,0,0,0,0,0,0,0.185429200518352,3571.50732402848,18.5962391503148
7.5,"greedy_SVM","SVM",11,34,26640,23788,2852,3500,2834,666,0.590279694153506,0.201581027667984,1.94190245686128,1651,666,985,60,1.5,11.61,4.3,0,0,0,0,0,0,0.181155895573413,3111.11326038957,18.1836258581918
7.5,"greedy_SVM","SVM",11,35,26540,23703,2837,3600,2919,681,0.589059025315965,0.206662902315076,1.9438438821328,1678,681,997,27,1.5,11.94,4.3,0,0,0,0,0,0,0.183566546476321,2940.61509815155,18.4008561980625
7.5,"greedy_SVM","SVM",11,36,26440,23622,2818,3700,3000,700,0.588549075964894,0.204968944099379,1.85615707377781,1722,700,1022,44,1.5,12.28,4.3,0,0,0,0,0,0,0.180391680881924,3060.30487739842,18.102210395787
7.5,"greedy_SVM","SVM",11,37,26340,23546,2794,3800,3076,724,0.587640091193533,0.204968944099379,1.93305400468529,1774,724,1050,52,1.5,12.61,4.2,0,0,0,0,0,0,0.17969202238151,2418.34596697046,18.1215958586348
7.5,"greedy_SVM","SVM",11,38,26240,23456,2784,3900,3166,734,0.587724661739045,0.205533596837945,1.93575605420864,1804,734,1070,30,1.5,12.94,4.3,0,0,0,0,0,0,0.179172713856637,3049.90253764433,17.9756348244899
7.5,"greedy_SVM","SVM",11,39,26140,23372,2768,4000,3250,750,0.587559086875864,0.205533596837945,1.89026111746154,1823,750,1073,19,1.4,13.27,4.3,0,0,0,0,0,0,0.18197714557117,3344.81640646162,18.2573888096296
7.5,"greedy_SVM","SVM",11,40,26040,23292,2748,4100,3330,770,0.588350874362643,0.207792207792208,1.88120964440638,1873,770,1103,50,1.4,13.6,4.3,0,0,0,0,0,0,0.18277648025539,3457.92001315455,18.3366977131009
7.5,"greedy_SVM","SVM",11,41,25940,23213,2727,4200,3409,791,0.588218881478121,0.204968944099379,1.87957380993298,1906,791,1115,33,1.4,13.93,4.3,0,0,0,0,0,0,0.182169158960723,3315.16670036573,18.2628319067185
7.5,"greedy_SVM","SVM",11,42,25840,23129,2711,4300,3493,807,0.589025273516948,0.214003387916431,2.0632240550836,1996,807,1189,90,1.5,14.27,4.3,0,0,0,0,0,0,0.183362000716108,3622.71786542064,18.3905837221688
7.5,"greedy_SVM","SVM",11,43,25740,23050,2690,4400,3572,828,0.588527614915322,0.210615471485037,2.03399626277291,2008,828,1180,12,1.4,14.6,4.3,0,0,0,0,0,0,0.182796492368667,3596.2015278557,18.3108544485717
7.5,"greedy_SVM","SVM",11,44,25640,22975,2665,4500,3647,853,0.589061211753274,0.210050818746471,2.01879438084972,2100,853,1247,92,1.5,14.93,4.3,0,0,0,0,0,0,0.18165547016679,3057.45243514387,18.2973985499381
7.5,"greedy_SVM","SVM",11,45,25540,22889,2651,4600,3733,867,0.589757496508073,0.209486166007905,1.91545440962743,2124,867,1257,24,1.4,15.26,4.3,0,0,0,0,0,0,0.180613918497931,3109.41682304931,18.1234028952837
7.5,"greedy_SVM","SVM",11,46,25440,22803,2637,4700,3819,881,0.591843824694435,0.214003387916431,2.05282227307399,2161,881,1280,37,1.5,15.59,4.3,0,0,0,0,0,0,0.180568860674453,2885.31148086936,18.1145451496538
7.5,"greedy_SVM","SVM",11,47,25340,22714,2626,4800,3908,892,0.591794746606778,0.216261998870695,1.97886720975177,2176,892,1284,15,1.4,15.93,4.4,0,0,0,0,0,0,0.181181990680236,3013.05580809255,18.1574179638948
7.5,"greedy_SVM","SVM",11,48,25240,22633,2607,4900,3989,911,0.589307217790379,0.2343308865048,2.21359533998563,2230,911,1319,54,1.4,16.26,4.4,0,0,0,0,0,0,0.188186840769375,3531.03065997733,21.4793509760752
7.5,"greedy_SVM","SVM",12,0,30040,26538,3502,100,80,20,0.597180222635802,0.204867006225241,1.82873170549582,51,20,31,0,1.6,0.33,4,0,0,0,0,0,0,0.638699131144972,5758.76342620335,66.1205223952922
7.5,"greedy_SVM","SVM",12,1,29940,26476,3464,200,142,58,0.572297466991047,0.165251839275608,1.61485153744576,130,58,72,79,1.2,0.66,2.4,0,0,0,0,0,0,0.507604100779675,7901.32748086495,56.1531073427961
7.5,"greedy_SVM","SVM",12,2,29840,26414,3426,300,204,96,0.544767525057675,0.162988115449915,1.41644736842105,210,96,114,80,1.2,1,2.1,0,0,0,0,0,0,0.430275223522413,8769.83290675117,47.2634951500216
7.5,"greedy_SVM","SVM",12,3,29740,26335,3405,400,283,117,0.558837102916742,0.156762874929259,1.53204489213174,259,117,142,49,1.2,1.33,2.4,0,0,0,0,0,0,0.401246309671869,8083.0333351085,41.2292353714825
7.5,"greedy_SVM","SVM",12,4,29640,26266,3374,500,352,148,0.572366825862395,0.159026598754952,1.44197782690656,334,148,186,75,1.3,1.66,2.4,0,0,0,0,0,0,0.386842000319606,7858.89238964509,40.7256939216206
7.5,"greedy_SVM","SVM",12,5,29540,26197,3343,600,421,179,0.528879728101318,0.129598189020939,1.25789555113125,406,179,227,72,1.3,1.99,2.4,0,0,0,0,0,0,0.347468046122,8167.9740893324,35.5641966791835
7.5,"greedy_SVM","SVM",12,6,29440,26105,3335,700,513,187,0.517521973639121,0.117147707979626,1.06710280535694,444,187,257,38,1.4,2.32,2.7,0,0,0,0,0,0,0.296757893265646,7159.5083931103,30.0412864305367
7.5,"greedy_SVM","SVM",12,7,29340,26020,3320,800,598,202,0.537554032283584,0.132993774759479,1.21296577875105,472,202,270,28,1.3,2.65,3,0,0,0,0,0,0,0.268684387035079,6861.42904085533,27.5528556562729
7.5,"greedy_SVM","SVM",12,8,29240,25950,3290,900,668,232,0.544640462838275,0.137521222410866,1.09289229258833,536,232,304,64,1.3,2.99,2.9,0,0,0,0,0,0,0.277562993534841,6777.51010488162,28.2487375349129
7.5,"greedy_SVM","SVM",12,9,29140,25866,3274,1000,752,248,0.581264839523006,0.135823429541596,1.10029011513976,556,248,308,20,1.2,3.32,3,0,0,0,0,0,0,0.5,6163.34141370136,51.9640290413182
7.5,"greedy_SVM","SVM",12,10,29040,25784,3256,1100,834,266,0.54161887476727,0.132993774759479,1.04916036880669,611,266,345,55,1.3,3.65,3.1,0,0,0,0,0,0,0.260367129744319,5936.95595475617,27.6025748930271
7.5,"greedy_SVM","SVM",12,11,28940,25693,3247,1200,925,275,0.545711750060658,0.136389360498019,1.21416657466559,641,275,366,30,1.3,3.98,3.4,0,0,0,0,0,0,0.232088004047561,5293.05582125046,23.5152370799057
7.5,"greedy_SVM","SVM",12,12,28840,25606,3234,1300,1012,288,0.553083017783428,0.191284663271081,2.10968261872052,673,288,385,32,1.3,4.31,3.5,0,0,0,0,0,0,0.251750674332214,5014.09715847608,26.2921167648892
7.5,"greedy_SVM","SVM",12,13,28740,25526,3214,1400,1092,308,0.550058558370003,0.188455008488964,1.87611061450503,720,308,412,47,1.3,4.64,3.5,0,0,0,0,0,0,0.24071064065524,5212.76999613078,24.5130850626487
7.5,"greedy_SVM","SVM",12,14,28640,25459,3181,1500,1159,341,0.530505928832904,0.12790039615167,1.21521452789839,797,341,456,77,1.3,4.98,3.4,0,0,0,0,0,0,0.225784618084132,5874.44815557929,22.7155635679534
7.5,"greedy_SVM","SVM",12,15,28540,25383,3157,1600,1235,365,0.544079381260171,0.153933220147142,1.63593025085987,843,365,478,46,1.3,5.31,3.4,0,0,0,0,0,0,0.226915306664015,5286.7424462519,23.2862459249198
7.5,"greedy_SVM","SVM",12,16,28440,25307,3133,1700,1311,389,0.572321054537299,0.182229767968308,1.48596667295479,896,389,507,53,1.3,5.64,3.4,0,0,0,0,0,0,0.234325626799946,6462.91983580563,23.534895151041
7.5,"greedy_SVM","SVM",12,17,28340,25215,3125,1800,1403,397,0.567589550151247,0.179966044142615,1.67089225087825,910,397,513,14,1.3,5.97,3.5,0,0,0,0,0,0,0.230065048604617,6073.41135927604,23.2416532457944
7.5,"greedy_SVM","SVM",12,18,28240,25150,3090,1900,1468,432,0.566369591199112,0.192416525183928,1.91717074587697,984,432,552,74,1.3,6.3,3.4,0,0,0,0,0,0,0.226720165313272,6213.35043865339,22.8845929607895
7.5,"greedy_SVM","SVM",12,19,28140,25084,3056,2000,1534,466,0.580745445582989,0.20656479909451,1.90713811175906,1080,466,614,96,1.3,6.64,3.3,0,0,0,0,0,0,0.237006399917499,6360.98664887067,24.0517078496881
7.5,"greedy_SVM","SVM",12,20,28040,24996,3044,2100,1622,478,0.568096693030267,0.197509903791737,1.91378351841075,1105,478,627,25,1.3,6.97,3.4,0,0,0,0,0,0,0.227045353157145,6219.42127684872,22.7225935893263
7.5,"greedy_SVM","SVM",12,21,27940,24916,3024,2200,1702,498,0.566016947811492,0.184493491794001,1.75071932803145,1159,498,661,54,1.3,7.3,3.4,0,0,0,0,0,0,0.226356909000175,6322.7053304723,22.6359664675058
7.5,"greedy_SVM","SVM",12,22,27840,24825,3015,2300,1793,507,0.554816670529155,0.171477079796265,1.57174645304627,1178,507,671,19,1.3,7.63,3.5,0,0,0,0,0,0,0.219032986860463,5900.71970799145,21.9198368292323
7.5,"greedy_SVM","SVM",12,23,27740,24736,3004,2400,1882,518,0.561589167645906,0.182229767968308,1.72085842003047,1194,518,676,16,1.3,7.96,3.6,0,0,0,0,0,0,0.215413136277052,5877.30803371921,21.5817380186663
7.5,"greedy_SVM","SVM",12,24,27640,24654,2986,2500,1964,536,0.557826603076855,0.182795698924731,1.71772676340287,1255,536,719,61,1.3,8.29,3.7,0,0,0,0,0,0,0.212653844313186,5712.65704795774,21.2853752925772
7.5,"greedy_SVM","SVM",12,25,27540,24569,2971,2600,2049,551,0.555839634122061,0.179400113186191,1.53718631803735,1296,551,745,41,1.4,8.63,3.7,0,0,0,0,0,0,0.2104938476038,5623.34043333807,21.0600021532994
7.5,"greedy_SVM","SVM",12,26,27440,24473,2967,2700,2145,555,0.562600263023477,0.182229767968308,1.81965087177714,1310,555,755,14,1.4,8.96,3.9,0,0,0,0,0,0,0.203664236143318,5334.30189095254,20.3803458188289
7.5,"greedy_SVM","SVM",12,27,27340,24385,2955,2800,2233,567,0.564266747625754,0.192982456140351,1.84474511797827,1337,567,770,27,1.4,9.29,3.9,0,0,0,0,0,0,0.201187284279609,5363.26394837937,20.1260152992541
7.5,"greedy_SVM","SVM",12,28,27240,24302,2938,2900,2316,584,0.560582453724162,0.185059422750424,1.79678675879864,1382,584,798,45,1.4,9.62,4,0,0,0,0,0,0,0.199874798104658,5317.25138118105,20.0195704693987
7.5,"greedy_SVM","SVM",12,29,27140,24213,2927,3000,2405,595,0.565523757529723,0.185059422750424,1.84773514823566,1397,595,802,15,1.3,9.95,4,0,0,0,0,0,0,0.197151065954476,5214.68026818745,19.7651125830849
7.5,"greedy_SVM","SVM",12,30,27040,24126,2914,3100,2492,608,0.568806829183794,0.181663837011885,1.76696457193062,1445,608,837,48,1.4,10.29,4.1,0,0,0,0,0,0,0.19529448216878,5198.15103875396,19.5372841063036
7.5,"greedy_SVM","SVM",12,31,26940,24043,2897,3200,2575,625,0.570787885300129,0.190152801358234,1.93297211567349,1484,625,859,39,1.4,10.62,4.1,0,0,0,0,0,0,0.194152303804653,5027.71316735768,19.427565879128
7.5,"greedy_SVM","SVM",12,32,26840,23959,2881,3300,2659,641,0.568024845662156,0.187323146576118,1.85416205309909,1530,641,889,46,1.4,10.95,4.1,0,0,0,0,0,0,0.193107751568604,4925.33462798288,19.3180127305252
7.5,"greedy_SVM","SVM",12,33,26740,23873,2867,3400,2745,655,0.5702370129395,0.176570458404075,1.73755841645601,1539,655,884,9,1.3,11.28,4.2,0,0,0,0,0,0,0.190867491026992,4875.02675031119,19.0946082760302
7.5,"greedy_SVM","SVM",12,34,26640,23779,2861,3500,2839,661,0.566436929496166,0.178268251273345,1.72694456828875,1560,661,899,21,1.4,11.61,4.3,0,0,0,0,0,0,0.187524563340119,4852.23735556877,18.7572723454546
7.5,"greedy_SVM","SVM",12,35,26540,23683,2857,3600,2935,665,0.569595618850438,0.191850594227504,1.76823747015059,1574,665,909,14,1.4,11.94,4.4,0,0,0,0,0,0,0.18462623405151,4871.00151920219,18.4635449881826
7.5,"greedy_SVM","SVM",12,36,26440,23596,2844,3700,3022,678,0.570741093053278,0.192416525183928,1.85577577116097,1575,678,897,1,1.3,12.28,4.5,0,0,0,0,0,0,0.182560349382412,4697.47839135875,18.2593531598406
7.5,"greedy_SVM","SVM",12,37,26340,23514,2826,3800,3104,696,0.568712861844447,0.176570458404075,1.72541899888214,1633,696,937,58,1.3,12.61,4.5,0,0,0,0,0,0,0.182534623474125,4733.74883903294,18.2559030667211
7.5,"greedy_SVM","SVM",12,38,26240,23418,2822,3900,3200,700,0.566732613957841,0.177136389360498,1.69986465147755,1652,700,952,19,1.4,12.94,4.6,0,0,0,0,0,0,0.177262300191338,4311.82015183777,17.735097041723
7.5,"greedy_SVM","SVM",12,39,26140,23327,2813,4000,3291,709,0.566827942526185,0.176004527447651,1.69541862361842,1663,709,954,11,1.3,13.27,4.6,0,0,0,0,0,0,0.176019791467834,4437.95024963058,17.6044745639991
7.5,"greedy_SVM","SVM",12,40,26040,23244,2796,4100,3374,726,0.5660518293046,0.182229767968308,1.80921266999365,1716,726,990,53,1.4,13.6,4.6,0,0,0,0,0,0,0.176078855235597,4443.18646560464,17.6106313257695
7.5,"greedy_SVM","SVM",12,41,25940,23169,2771,4200,3449,751,0.567546713976184,0.188455008488964,1.8244954602495,1758,751,1007,42,1.3,13.93,4.6,0,0,0,0,0,0,0.177690012612014,4474.9699997937,17.7737696474818
7.5,"greedy_SVM","SVM",12,42,25840,23079,2761,4300,3539,761,0.568776967222618,0.190152801358234,1.85351991905472,1764,761,1003,6,1.3,14.27,4.7,0,0,0,0,0,0,0.175745061558831,4367.15147089702,17.5793868452871
7.5,"greedy_SVM","SVM",12,43,25740,22995,2745,4400,3623,777,0.565994615148233,0.181097906055461,1.77999557097512,1823,777,1046,59,1.3,14.6,4.7,0,0,0,0,0,0,0.175694107696641,4368.12607432864,17.5738274949054
7.5,"greedy_SVM","SVM",12,44,25640,22911,2729,4500,3707,793,0.567927900634368,0.186191284663271,1.88067289726915,1855,793,1062,32,1.3,14.93,4.7,0,0,0,0,0,0,0.175303993613212,4371.05613406714,17.5389147886893
7.5,"greedy_SVM","SVM",12,45,25540,22822,2718,4600,3796,804,0.56689396213265,0.181663837011885,1.79406162792967,1892,804,1088,37,1.4,15.26,4.7,0,0,0,0,0,0,0.173474824558207,4256.12117455039,17.3539316791621
7.5,"greedy_SVM","SVM",12,46,25440,22738,2702,4700,3880,820,0.566231001071623,0.189586870401811,1.78309660855522,1919,820,1099,27,1.3,15.59,4.7,0,0,0,0,0,0,0.173124897700017,4180.49356268957,17.3234060600497
7.5,"greedy_SVM","SVM",12,47,25340,22646,2694,4800,3972,828,0.563712216962205,0.185625353706848,1.79208722935104,1959,828,1131,40,1.4,15.93,4.8,0,0,0,0,0,0,0.171392253124619,4171.91835162172,17.1429984716985
7.5,"greedy_SVM","SVM",12,48,25240,22553,2687,4900,4065,835,0.562254000396792,0.174306734578381,1.63276473102449,1955,835,1120,-4,1.3,16.26,4.9,0,0,0,0,0,0,0.16934659303571,4099.2875854267,16.9420667305625
7.5,"greedy_SVM","SVM",13,0,30040,26491,3549,100,89,11,0.542648016209965,0.185078079814922,1.86947114281579,36,11,25,0,2.3,0.33,8.1,0,0,0,0,0,0,0.33528458867764,3335.66840176112,37.6636937793988
7.5,"greedy_SVM","SVM",13,1,29940,26430,3510,200,150,50,0.458322709093938,0.116830537883169,1.04136362007811,117,50,67,81,1.3,0.66,3,0,0,0,0,0,0,0.407806665806102,6632.84341003344,48.6008198366624
7.5,"greedy_SVM","SVM",13,2,29840,26350,3490,300,230,70,0.458857425149091,0.10641989589358,0.91877667140825,179,70,109,62,1.6,1,3.3,0,0,0,0,0,0,0.337244985456489,6763.90744582136,34.4011249617447
7.5,"greedy_SVM","SVM",13,3,29740,26257,3483,400,323,77,0.451444964474677,0.103528050896472,0.886566794331255,198,77,121,19,1.6,1.33,4.2,0,0,0,0,0,0,0.211472397379757,5568.85447808647,21.7669176529296
7.5,"greedy_SVM","SVM",13,4,29640,26171,3469,500,409,91,0.484078032910786,0.131868131868132,1.20228954348737,232,91,141,34,1.5,1.66,4.5,0,0,0,0,0,0,0.186181806114636,5363.26164838648,18.6459130759715
7.5,"greedy_SVM","SVM",13,5,29540,26082,3458,600,498,102,0.48178102972226,0.134181607865818,1.28827870487335,250,102,148,18,1.5,1.99,4.9,0,0,0,0,0,0,0.173296934942042,4763.12905109975,17.5141909032392
7.5,"greedy_SVM","SVM",13,6,29440,25992,3448,700,588,112,0.49808572952742,0.12781954887218,1.1666155481945,300,112,188,50,1.7,2.32,5.2,0,0,0,0,0,0,0.160182370486156,4665.91124945142,16.0332042501702
7.5,"greedy_SVM","SVM",13,7,29340,25906,3434,800,674,126,0.498583815256946,0.145170618854829,1.29520773621632,310,126,184,10,1.5,2.65,5.3,0,0,0,0,0,0,0.190881901875205,4325.81821893872,20.556863724253
7.5,"greedy_SVM","SVM",13,8,29240,25820,3420,900,760,140,0.509333927163676,0.126084441873916,1.19654445878782,345,140,205,35,1.5,2.99,5.4,0,0,0,0,0,0,0.156779185590998,4315.65815021445,15.8773988154322
7.5,"greedy_SVM","SVM",13,9,29140,25733,3407,1000,847,153,0.496814158708949,0.114517061885483,1.16828222393703,379,153,226,34,1.5,3.32,5.5,0,0,0,0,0,0,0.154277290617896,4098.71207898531,15.442825091268
7.5,"greedy_SVM","SVM",13,10,29040,25645,3395,1100,935,165,0.481470820716123,0.100636205899364,0.914328586393364,431,165,266,52,1.6,3.65,5.7,0,0,0,0,0,0,0.149594096211322,4188.12367816004,14.975431916709
7.5,"greedy_SVM","SVM",13,11,28940,25557,3383,1200,1023,177,0.481640794096932,0.10989010989011,1.03660945231669,457,177,280,26,1.6,3.98,5.8,0,0,0,0,0,0,0.14689671456552,4106.27915144098,14.706084703516
7.5,"greedy_SVM","SVM",13,12,28840,25470,3370,1300,1110,190,0.479358399689157,0.111046847888953,0.998142040146089,515,190,325,58,1.7,4.31,5.8,0,0,0,0,0,0,0.145286431477849,3995.11263486021,14.5583511093521
7.5,"greedy_SVM","SVM",13,13,28740,25384,3356,1400,1196,204,0.482461313390971,0.112781954887218,1.10175415388793,541,204,337,26,1.7,4.64,5.9,0,0,0,0,0,0,0.145684663375516,3869.31438339578,14.5721050109027
7.5,"greedy_SVM","SVM",13,14,28640,25294,3346,1500,1286,214,0.478279604087324,0.109311740890688,0.917936033093378,575,214,361,34,1.7,4.98,6,0,0,0,0,0,0,0.141971661866276,3920.97546629872,14.2026036784679
7.5,"greedy_SVM","SVM",13,15,28540,25204,3336,1600,1376,224,0.482997980173527,0.120300751879699,1.1056676644495,570,224,346,-5,1.5,5.31,6.1,0,0,0,0,0,0,0.139964686575526,3873.17172636208,14.0011042206344
7.5,"greedy_SVM","SVM",13,16,28440,25121,3319,1700,1459,241,0.483601101736181,0.121457489878543,1.15267042014984,638,241,397,68,1.6,5.64,6.1,0,0,0,0,0,0,0.141235308787213,3863.08749579434,14.1267962248385
7.5,"greedy_SVM","SVM",13,17,28340,25039,3301,1800,1541,259,0.479068391548992,0.117987275882013,1.06671668412559,678,259,419,40,1.6,5.97,5.9,0,0,0,0,0,0,0.143836408606377,4032.77133522657,14.3840938971058
7.5,"greedy_SVM","SVM",13,18,28240,24950,3290,1900,1630,270,0.483635998081897,0.111046847888953,0.969359104348504,685,270,415,7,1.5,6.3,6,0,0,0,0,0,0,0.142155986872319,3832.00454883463,14.2232791968642
7.5,"greedy_SVM","SVM",13,19,28140,24859,3281,2000,1721,279,0.483228859598715,0.117408906882591,1.13133560919184,707,279,428,22,1.5,6.64,6.2,0,0,0,0,0,0,0.138501489519235,3687.87074492086,13.8586557438475
7.5,"greedy_SVM","SVM",13,20,28040,24774,3266,2100,1806,294,0.479741349152568,0.115673799884326,1.08863641911378,751,294,457,44,1.6,6.97,6.1,0,0,0,0,0,0,0.139443820088147,3730.33111016588,13.9520059518277
7.5,"greedy_SVM","SVM",13,21,27940,24688,3252,2200,1892,308,0.480630360653109,0.119722382880278,1.06115120577363,784,308,476,33,1.5,7.3,6.1,0,0,0,0,0,0,0.138407651185058,3631.99575574283,13.8452629897333
7.5,"greedy_SVM","SVM",13,22,27840,24599,3241,2300,1981,319,0.478830576204148,0.116830537883169,1.12201408141126,825,319,506,41,1.6,7.63,6.2,0,0,0,0,0,0,0.137716699682478,3663.49201865866,13.7761555977552
7.5,"greedy_SVM","SVM",13,23,27740,24507,3233,2400,2073,327,0.48668359782454,0.120879120879121,1.21804006152432,826,327,499,1,1.5,7.96,6.3,0,0,0,0,0,0,0.135486300758056,3612.32553781092,13.5554455936794
7.5,"greedy_SVM","SVM",13,24,27640,24432,3208,2500,2148,352,0.486036216424647,0.116830537883169,1.10578029972974,878,352,526,52,1.5,8.29,6.1,0,0,0,0,0,0,0.140325416636828,3753.2643134542,14.0532205948241
7.5,"greedy_SVM","SVM",13,25,27540,24341,3199,2600,2239,361,0.491582741316501,0.127241179872759,1.24740162932502,908,361,547,30,1.5,8.63,6.2,0,0,0,0,0,0,0.137557065097794,3476.04321424249,13.7680945761459
7.5,"greedy_SVM","SVM",13,26,27440,24258,3182,2700,2322,378,0.488459886845696,0.120879120879121,1.16017782567695,944,378,566,36,1.5,8.96,6.1,0,0,0,0,0,0,0.139207460593311,3633.4559314605,13.9276772761317
7.5,"greedy_SVM","SVM",13,27,27340,24174,3166,2800,2406,394,0.482743345223547,0.124349334875651,1.21609399448495,985,394,591,41,1.5,9.29,6.1,0,0,0,0,0,0,0.138704082422283,3397.87059456342,13.8783704210052
7.5,"greedy_SVM","SVM",13,28,27240,24082,3158,2900,2498,402,0.486064653695192,0.115095430884905,1.08672509521406,989,402,587,4,1.5,9.62,6.2,0,0,0,0,0,0,0.138315187952209,3696.28134223276,13.8352491576182
7.5,"greedy_SVM","SVM",13,29,27140,23990,3150,3000,2590,410,0.491800485843855,0.126662810873337,1.29416756536959,1029,410,619,40,1.5,9.95,6.3,0,0,0,0,0,0,0.136458929274226,3565.70535259788,13.6498126682704
7.5,"greedy_SVM","SVM",13,30,27040,23902,3138,3100,2678,422,0.490595889999466,0.122614227877386,1.2528213121923,1065,422,643,36,1.5,10.29,6.3,0,0,0,0,0,0,0.135332729179251,3468.1777613886,13.5404268572052
7.5,"greedy_SVM","SVM",13,31,26940,23810,3130,3200,2770,430,0.489533957352266,0.122035858877964,1.21910478185782,1064,430,634,-1,1.5,10.62,6.4,0,0,0,0,0,0,0.13381944717743,3498.87123262932,13.3848972055178
7.5,"greedy_SVM","SVM",13,32,26840,23715,3125,3300,2865,435,0.485795583362452,0.116252168883748,1.06095209058616,1104,435,669,40,1.5,10.95,6.6,0,0,0,0,0,0,0.131249954188845,3276.37586478046,13.1272956016798
7.5,"greedy_SVM","SVM",13,33,26740,23620,3120,3400,2960,440,0.490012058963315,0.126662810873337,1.25500773682091,1168,440,728,64,1.7,11.28,6.7,0,0,0,0,0,0,0.128751064567442,3321.39515499477,12.8781446751399
7.5,"greedy_SVM","SVM",13,34,26640,23537,3103,3500,3043,457,0.490802797152378,0.126084441873916,1.27006822547061,1139,457,682,-29,1.5,11.61,6.7,0,0,0,0,0,0,0.130542199813487,3458.90348872447,13.1005558785904
7.5,"greedy_SVM","SVM",13,35,26540,23448,3092,3600,3132,468,0.485906428028283,0.127241179872759,1.16576894765154,1203,468,735,64,1.6,11.94,6.7,0,0,0,0,0,0,0.131475925677808,3205.68291986538,13.2887415005236
7.5,"greedy_SVM","SVM",13,36,26440,23356,3084,3700,3224,476,0.483300646367047,0.135916714864083,1.31841387925635,1230,476,754,27,1.6,12.28,6.8,0,0,0,0,0,0,0.128059365208238,3232.12751835194,12.8278673172917
7.5,"greedy_SVM","SVM",13,37,26340,23268,3072,3800,3312,488,0.483561566994198,0.122035858877964,1.20809006321472,1270,488,782,40,1.6,12.61,6.8,0,0,0,0,0,0,0.127737443716276,3174.82037528669,12.781315600296
7.5,"greedy_SVM","SVM",13,38,26240,23175,3065,3900,3405,495,0.480934544079051,0.120879120879121,1.21467070223932,1269,495,774,-1,1.6,12.94,6.9,0,0,0,0,0,0,0.126157478931,3158.22848111195,12.6206324128795
7.5,"greedy_SVM","SVM",13,39,26140,23080,3060,4000,3500,500,0.481816142815461,0.128397917871602,1.22790353810949,1246,500,746,-23,1.5,13.27,7,0,0,0,0,0,0,0.123544975669062,2955.13300700696,12.3741618309059
7.5,"greedy_SVM","SVM",13,40,26040,22995,3045,4100,3585,515,0.48500527866837,0.123770965876229,1.1996713171296,1295,515,780,49,1.5,13.6,7,0,0,0,0,0,0,0.125283655087042,3189.82381560673,12.5308295304175
7.5,"greedy_SVM","SVM",13,41,25940,22911,3029,4200,3669,531,0.483625117357952,0.126084441873916,1.24849106306243,1345,531,814,50,1.5,13.93,6.9,0,0,0,0,0,0,0.125821592210665,3149.87986947761,12.5864063901735
7.5,"greedy_SVM","SVM",13,42,25840,22819,3021,4300,3761,539,0.474644271853745,0.120300751879699,1.09628292366801,1394,539,855,49,1.6,14.27,7,0,0,0,0,0,0,0.124091763629238,2891.72926144395,12.4185797114986
7.5,"greedy_SVM","SVM",13,43,25740,22734,3006,4400,3846,554,0.485603675135767,0.130711393869289,1.28230180732716,1435,554,881,41,1.6,14.6,6.9,0,0,0,0,0,0,0.125200564963892,3073.16469500005,12.5229074816661
7.5,"greedy_SVM","SVM",13,44,25640,22649,2991,4500,3931,569,0.484851778096725,0.128976286871024,1.26032213400634,1425,569,856,-10,1.5,14.93,6.9,0,0,0,0,0,0,0.125391691033442,2977.04755827212,12.5586776138394
7.5,"greedy_SVM","SVM",13,45,25540,22560,2980,4600,4020,580,0.478709587755833,0.111625216888375,1.06262428291441,1474,580,894,49,1.5,15.26,6.9,0,0,0,0,0,0,0.125231587668595,2971.38207886803,12.5294929550155
7.5,"greedy_SVM","SVM",13,46,25440,22467,2973,4700,4113,587,0.486344301305388,0.126662810873337,1.14491232797067,1509,587,922,35,1.6,15.59,7,0,0,0,0,0,0,0.123889742369304,2921.65759718337,12.3971395421677
7.5,"greedy_SVM","SVM",13,47,25340,22378,2962,4800,4202,598,0.48072217488941,0.118565644881434,1.08280735283024,1512,598,914,3,1.5,15.93,7,0,0,0,0,0,0,0.123862699351951,2968.33474658585,12.3948948337032
7.5,"greedy_SVM","SVM",13,48,25240,22282,2958,4900,4298,602,0.488629903575999,0.130711393869289,1.23867462177711,1547,602,945,35,1.6,16.26,7.1,0,0,0,0,0,0,0.122052537188596,2897.41739876522,12.2105982971245
7.5,"greedy_SVM","SVM",14,0,30040,26568,3472,100,86,14,0.497267078735722,0.11924570160843,1.02548953666024,48,14,34,0,2.4,0.33,6.1,0,0,0,0,0,0,0.146391721299018,4241.74721837936,14.7039246627353
7.5,"greedy_SVM","SVM",14,1,29940,26481,3459,200,173,27,0.474680531108253,0.0820854132002218,0.705858137671782,89,27,62,41,2.3,0.66,6.4,0,0,0,0,0,0,0.152512367141102,4015.56489644914,15.3635390996464
7.5,"greedy_SVM","SVM",14,2,29840,26390,3450,300,264,36,0.467058741744699,0.129229062673322,1.12139863001695,114,36,78,25,2.2,1,7.3,0,0,0,0,0,0,0.168897283134433,3307.11540640187,17.9328250327961
7.5,"greedy_SVM","SVM",14,3,29740,26298,3442,400,356,44,0.48143007642607,0.153078202995008,1.46062886346669,138,44,94,24,2.1,1.33,8.1,0,0,0,0,0,0,0.121482463006989,3094.05577529194,12.4523923320039
7.5,"greedy_SVM","SVM",14,4,29640,26220,3420,500,434,66,0.547746081422922,0.174154187465336,1.53939608363285,197,66,131,59,2,1.66,6.6,0,0,0,0,0,0,0.132517752823915,3915.26187418898,13.2603713515442
7.5,"greedy_SVM","SVM",14,5,29540,26149,3391,600,505,95,0.558504203876866,0.173044925124792,1.7515884960374,233,95,138,36,1.5,1.99,5.3,0,0,0,0,0,0,0.269826255551096,4454.11106849441,30.6502237854525
7.5,"greedy_SVM","SVM",14,6,29440,26088,3352,700,566,134,0.524554447407943,0.125901275651692,1.07880417915588,338,134,204,105,1.5,2.32,4.2,0,0,0,0,0,0,0.197041887788648,5605.29183700172,19.8424002629531
7.5,"greedy_SVM","SVM",14,7,29340,26007,3333,800,647,153,0.492328779572317,0.141985579589573,1.22946260467731,387,153,234,49,1.5,2.65,4.2,0,0,0,0,0,0,0.194672255126942,5551.11455545845,19.564960478489
7.5,"greedy_SVM","SVM",14,8,29240,25918,3322,900,736,164,0.47508496708748,0.116472545757072,1.13263500910106,405,164,241,18,1.5,2.99,4.5,0,0,0,0,0,0,0.182304835734704,5326.62052750893,18.2476570072145
7.5,"greedy_SVM","SVM",14,9,29140,25828,3312,1000,826,174,0.485486517045002,0.108153078202995,0.972829031093607,444,174,270,39,1.6,3.32,4.7,0,0,0,0,0,0,0.174189068133855,5030.75028135422,17.4364335740925
7.5,"greedy_SVM","SVM",14,10,29040,25747,3293,1100,907,193,0.49569469017153,0.132002218524681,1.23449154532876,485,193,292,41,1.5,3.65,4.7,0,0,0,0,0,0,0.175751721478954,5013.79193152552,17.6226566800982
7.5,"greedy_SVM","SVM",14,11,28940,25652,3288,1200,1002,198,0.491286442503375,0.12867443150305,1.21759781755856,524,198,326,39,1.6,3.98,5.1,0,0,0,0,0,0,0.165582042941523,4659.2517197311,16.6062549377187
7.5,"greedy_SVM","SVM",14,12,28840,25564,3276,1300,1090,210,0.506821047926855,0.125901275651692,1.20344188807418,543,210,333,19,1.6,4.31,5.2,0,0,0,0,0,0,0.161526866891702,4510.37190754576,16.4011916282441
7.5,"greedy_SVM","SVM",14,13,28740,25478,3262,1400,1176,224,0.506160155644523,0.128119800332779,1.18169293828971,596,224,372,53,1.7,4.64,5.2,0,0,0,0,0,0,0.159897221698439,4465.23429585451,16.0021356696458
7.5,"greedy_SVM","SVM",14,14,28640,25388,3252,1500,1266,234,0.513322580979581,0.162506932889628,1.51979024857561,635,234,401,39,1.7,4.98,5.4,0,0,0,0,0,0,0.155519128165549,4342.5117022009,15.6201632069062
7.5,"greedy_SVM","SVM",14,15,28540,25327,3213,1600,1327,273,0.513888080713634,0.168607875762618,1.59284454378611,722,273,449,87,1.6,5.31,4.9,0,0,0,0,0,0,0.169944795818059,4783.46101458194,16.9988257175437
7.5,"greedy_SVM","SVM",14,16,28440,25240,3200,1700,1414,286,0.499634168323287,0.146422628951747,1.2632108067824,755,286,469,33,1.6,5.64,4.9,0,0,0,0,0,0,0.167436679796881,4697.63342507559,16.7480359187719
7.5,"greedy_SVM","SVM",14,17,28340,25152,3188,1800,1502,298,0.506679087762982,0.148086522462562,1.37982694158254,807,298,509,52,1.7,5.97,5,0,0,0,0,0,0,0.165422199057976,4670.68384782779,16.5455100146923
7.5,"greedy_SVM","SVM",14,18,28240,25066,3174,1900,1588,312,0.497028680969362,0.139212423738214,1.38832050388914,839,312,527,32,1.7,6.3,5.1,0,0,0,0,0,0,0.163499621245248,4555.64858217799,16.3515174879845
7.5,"greedy_SVM","SVM",14,19,28140,24986,3154,2000,1668,332,0.504310200682179,0.151414309484193,1.42587805741036,908,332,576,69,1.7,6.64,5,0,0,0,0,0,0,0.165577495328756,4636.5129202736,16.5590308367391
7.5,"greedy_SVM","SVM",14,20,28040,24902,3138,2100,1752,348,0.500580360404917,0.13477537437604,1.23565554992886,945,348,597,37,1.7,6.97,5,0,0,0,0,0,0,0.165069103643638,4572.30688098802,16.5131811253567
7.5,"greedy_SVM","SVM",14,21,27940,24823,3117,2200,1831,369,0.502008656894657,0.141985579589573,1.43294509151414,997,369,628,52,1.7,7.3,5,0,0,0,0,0,0,0.167372522409096,4633.97628457878,16.7394635982257
7.5,"greedy_SVM","SVM",14,22,27840,24750,3090,2300,1904,396,0.508716441846246,0.155296727676095,1.41956270201006,1023,396,627,26,1.6,7.63,4.8,0,0,0,0,0,0,0.170667742850963,4718.73112745489,17.067713766072
7.5,"greedy_SVM","SVM",14,23,27740,24659,3081,2400,1995,405,0.506963467914586,0.155851358846367,1.62853386118921,1044,405,639,21,1.6,7.96,4.9,0,0,0,0,0,0,0.168402564445484,4604.64891829822,16.8438946426562
7.5,"greedy_SVM","SVM",14,24,27640,24580,3060,2500,2074,426,0.497707088360251,0.140876317249029,1.38102679109696,1097,426,671,53,1.6,8.29,4.9,0,0,0,0,0,0,0.170479731427408,4672.8402320735,17.0487103562878
7.5,"greedy_SVM","SVM",14,25,27540,24490,3050,2600,2164,436,0.503531760702318,0.155296727676095,1.42463816344739,1119,436,683,22,1.6,8.63,5,0,0,0,0,0,0,0.167273690695201,4557.68269299723,16.7302719361736
7.5,"greedy_SVM","SVM",14,26,27440,24397,3043,2700,2257,443,0.513360746359324,0.170271769273433,1.56638140041018,1131,443,688,12,1.6,8.96,5.1,0,0,0,0,0,0,0.164223770626973,4414.08317167937,16.60133781997
7.5,"greedy_SVM","SVM",14,27,27340,24323,3017,2800,2331,469,0.504557836727751,0.153078202995008,1.37615153605779,1216,469,747,85,1.6,9.29,5,0,0,0,0,0,0,0.166773697789693,4502.00398000801,16.7047406195869
7.5,"greedy_SVM","SVM",14,28,27240,24237,3003,2900,2417,483,0.510363071061514,0.162506932889628,1.45684811576143,1254,483,771,38,1.6,9.62,5,0,0,0,0,0,0,0.166273674451971,4491.31043774011,16.6298658705645
7.5,"greedy_SVM","SVM",14,29,27140,24169,2971,3000,2485,515,0.501513886429525,0.145313366611204,1.43869989107846,1305,515,790,51,1.5,9.95,4.8,0,0,0,0,0,0,0.171474294216594,4560.93963372821,17.151026650924
7.5,"greedy_SVM","SVM",14,30,27040,24088,2952,3100,2566,534,0.502618174312031,0.153078202995008,1.36441650323154,1347,534,813,42,1.5,10.29,4.8,0,0,0,0,0,0,0.171879908132253,4605.18608338266,17.1897589411705
7.5,"greedy_SVM","SVM",14,31,26940,23997,2943,3200,2657,543,0.500129691227446,0.146977260122019,1.28375725052245,1345,543,802,-2,1.5,10.62,4.9,0,0,0,0,0,0,0.169374404814071,4505.41733757428,16.9385751176404
7.5,"greedy_SVM","SVM",14,32,26840,23903,2937,3300,2751,549,0.506496370484931,0.170271769273433,1.64720567996008,1380,549,831,35,1.5,10.95,5,0,0,0,0,0,0,0.166472250984376,4266.73305986365,16.6610908094329
7.5,"greedy_SVM","SVM",14,33,26740,23822,2918,3400,2832,568,0.498982179902822,0.139212423738214,1.15517104301605,1401,568,833,21,1.5,11.28,5,0,0,0,0,0,0,0.16666387364356,4403.09084051558,16.6686543796154
7.5,"greedy_SVM","SVM",14,34,26640,23733,2907,3500,2921,579,0.504363331238206,0.153078202995008,1.51003132146575,1435,579,856,34,1.5,11.61,5,0,0,0,0,0,0,0.16493501318985,4326.45456938822,16.4964816905225
7.5,"greedy_SVM","SVM",14,35,26540,23649,2891,3600,3005,595,0.502779656088542,0.149750415973378,1.24985343260129,1478,595,883,43,1.5,11.94,5.1,0,0,0,0,0,0,0.164205995929705,4267.29139645959,16.4256030081659
7.5,"greedy_SVM","SVM",14,36,26440,23557,2883,3700,3097,603,0.498580502866709,0.161397670549085,1.53019086618776,1484,603,881,6,1.5,12.28,5.1,0,0,0,0,0,0,0.162482045557083,4131.4622886581,16.3191365691659
7.5,"greedy_SVM","SVM",14,37,26340,23477,2863,3800,3177,623,0.510412564828889,0.167498613422074,1.64436321977033,1546,623,923,62,1.5,12.61,5.1,0,0,0,0,0,0,0.16344964273677,4237.4180963235,16.3504023073614
7.5,"greedy_SVM","SVM",14,38,26240,23404,2836,3900,3250,650,0.508609261086477,0.15363283416528,1.40399670582699,1574,650,924,28,1.4,12.94,5,0,0,0,0,0,0,0.166360050490786,4305.27338547306,16.6388310439194
7.5,"greedy_SVM","SVM",14,39,26140,23312,2828,4000,3342,658,0.508248299362385,0.151414309484193,1.52110722452758,1573,658,915,-1,1.4,13.27,5.1,0,0,0,0,0,0,0.163511352298093,4186.4120794219,16.3583369446106
7.5,"greedy_SVM","SVM",14,40,26040,23224,2816,4100,3430,670,0.509887822209026,0.154187465335552,1.47634914505403,1601,670,931,28,1.4,13.6,5.1,0,0,0,0,0,0,0.162951903839539,4155.48103583238,16.2997885223927
7.5,"greedy_SVM","SVM",14,41,25940,23136,2804,4200,3518,682,0.501228586630226,0.140876317249029,1.16906942198124,1657,682,975,56,1.4,13.93,5.2,0,0,0,0,0,0,0.161752990631997,4100.17607470488,16.1803428357472
7.5,"greedy_SVM","SVM",14,42,25840,23046,2794,4300,3608,692,0.50640156316701,0.164170826400444,1.56107487332469,1709,692,1017,52,1.5,14.27,5.2,0,0,0,0,0,0,0.16050581462512,4083.3094718121,16.053448769066
7.5,"greedy_SVM","SVM",14,43,25740,22958,2782,4400,3696,704,0.50551949561169,0.147531891292291,1.47132754932256,1712,704,1008,3,1.4,14.6,5.2,0,0,0,0,0,0,0.159676629900438,4072.60926589171,15.9690743689906
7.5,"greedy_SVM","SVM",14,44,25640,22863,2777,4500,3791,709,0.512010160100632,0.174708818635607,1.62335346824004,1720,709,1011,8,1.4,14.93,5.3,0,0,0,0,0,0,0.157093392630647,3960.82548272222,15.7162539235943
7.5,"greedy_SVM","SVM",14,45,25540,22773,2767,4600,3881,719,0.507733547460763,0.154187465335552,1.35010492955988,1728,719,1009,8,1.4,15.26,5.4,0,0,0,0,0,0,0.156258776789526,3940.74690978666,15.6312038742413
7.5,"greedy_SVM","SVM",14,46,25440,22680,2760,4700,3974,726,0.513617746090619,0.180809761508597,1.71945154311622,1755,726,1029,27,1.4,15.59,5.5,0,0,0,0,0,0,0.153956691744214,3870.74895612374,15.3980216241022
7.5,"greedy_SVM","SVM",14,47,25340,22594,2746,4800,4060,740,0.510268639963105,0.157515252357182,1.55893227096343,1816,740,1076,61,1.5,15.93,5.5,0,0,0,0,0,0,0.153786123044523,3826.60178219309,15.38513340454
7.5,"greedy_SVM","SVM",14,48,25240,22502,2738,4900,4152,748,0.501204801196413,0.145313366611204,1.17760756944514,1858,748,1110,42,1.5,16.26,5.6,0,0,0,0,0,0,0.152287674555677,3788.79946856156,15.2296763902112
7.5,"greedy_SVM","SVM",15,0,30040,26510,3530,100,88,12,0.453053736069744,0.135661133371494,1.31010735480565,41,12,29,0,2.4,0.33,7.3,0,0,0,0,0,0,0.23461872313166,2824.06330194181,26.7333184882528
7.5,"greedy_SVM","SVM",15,1,29940,26436,3504,200,162,38,0.443549344014194,0.107040641099027,1.01713230166249,106,38,68,65,1.8,0.66,4.3,0,0,0,0,0,0,0.196574536669889,5682.66855061912,19.7286855876847
7.5,"greedy_SVM","SVM",15,2,29840,26341,3499,300,257,43,0.562480119884719,0.192902117916428,1.83367618030653,113,43,70,7,1.6,1,6,0,0,0,0,0,0,0.637351093595619,5011.37113287504,77.3811420826606
7.5,"greedy_SVM","SVM",15,3,29740,26263,3477,400,335,65,0.524579190264315,0.13050944476245,1.14556273782543,165,65,100,52,1.5,1.33,5.2,0,0,0,0,0,0,0.2142019764662,4525.7692164361,23.8211640191637
7.5,"greedy_SVM","SVM",15,4,29640,26192,3448,500,406,94,0.53139082016828,0.161419576416714,1.54566471535367,218,94,124,53,1.3,1.66,4.3,0,0,0,0,0,0,0.231768648644459,4682.07067593874,26.4382848189544
7.5,"greedy_SVM","SVM",15,5,29540,26124,3416,600,474,126,0.536659534026427,0.162564396107613,1.46165678905572,289,126,163,71,1.3,1.99,3.8,0,0,0,0,0,0,0.280810987451426,4437.02727699927,29.5909907682
7.5,"greedy_SVM","SVM",15,6,29440,26052,3388,700,546,154,0.539227645384972,0.133943903835146,1.13062043266785,354,154,200,65,1.3,2.32,3.5,0,0,0,0,0,0,0.23490093390656,6131.11405665939,26.4836980548919
7.5,"greedy_SVM","SVM",15,7,29340,25973,3367,800,625,175,0.550306873368889,0.150543789353177,1.38699254249081,409,175,234,55,1.3,2.65,3.6,0,0,0,0,0,0,0.228648251405184,5615.91209200368,24.1811095828506
7.5,"greedy_SVM","SVM",15,8,29240,25894,3346,900,704,196,0.551781331362408,0.176302232398397,1.64639060496504,455,196,259,46,1.3,2.99,3.6,0,0,0,0,0,0,0.228964976140406,5258.68110537633,23.227237539231
7.5,"greedy_SVM","SVM",15,9,29140,25810,3330,1000,788,212,0.543632395853981,0.18259874069834,1.70022400991981,504,212,292,49,1.4,3.32,3.7,0,0,0,0,0,0,0.210054123189488,5247.85922508456,21.2019160482627
7.5,"greedy_SVM","SVM",15,10,29040,25733,3307,1100,865,235,0.543111710824943,0.183743560389239,1.74634386265744,552,235,317,48,1.3,3.65,3.7,0,0,0,0,0,0,0.207184531715947,4515.42879331314,20.8041979309554
7.5,"greedy_SVM","SVM",15,11,28940,25645,3295,1200,953,247,0.547619373916631,0.185460789925587,1.74482793916555,572,247,325,20,1.3,3.98,3.9,0,0,0,0,0,0,0.202332122381055,5009.68984476097,20.2755399175212
7.5,"greedy_SVM","SVM",15,12,28840,25555,3285,1300,1043,257,0.545398085185095,0.184315970234688,1.72535775615341,612,257,355,40,1.4,4.31,4.1,0,0,0,0,0,0,0.195134206418457,4023.26864277297,21.1325471683795
7.5,"greedy_SVM","SVM",15,13,28740,25473,3267,1400,1125,275,0.541117298136171,0.183743560389239,1.69226458210338,646,275,371,34,1.3,4.64,4.1,0,0,0,0,0,0,0.192769958786754,4560.83511461481,20.3990378825595
7.5,"greedy_SVM","SVM",15,14,28640,25383,3257,1500,1215,285,0.539421377162063,0.184315970234688,1.75842210339676,684,285,399,38,1.4,4.98,4.3,0,0,0,0,0,0,0.186276150812776,4451.34873372817,18.6474432197228
7.5,"greedy_SVM","SVM",15,15,28540,25305,3235,1600,1293,307,0.537614960982131,0.183171150543789,1.71636371050882,746,307,439,62,1.4,5.31,4.2,0,0,0,0,0,0,0.187418890817293,4375.26233718541,18.7564504889799
7.5,"greedy_SVM","SVM",15,16,28440,25227,3213,1700,1371,329,0.538508674732879,0.182026330852891,1.69842242257946,793,329,464,47,1.4,5.64,4.2,0,0,0,0,0,0,0.187897860445009,4260.8340532158,18.8147337438536
7.5,"greedy_SVM","SVM",15,17,28340,25140,3200,1800,1458,342,0.539624839562853,0.180881511161992,1.71190175978826,840,342,498,47,1.5,5.97,4.3,0,0,0,0,0,0,0.184784028875225,4114.05343657176,18.4984950848905
7.5,"greedy_SVM","SVM",15,18,28240,25059,3181,1900,1539,361,0.548874173283636,0.186033199771036,1.77764132452169,863,361,502,23,1.4,6.3,4.3,0,0,0,0,0,0,0.190491892390992,3893.48157143706,19.53309764918
7.5,"greedy_SVM","SVM",15,19,28140,24981,3159,2000,1617,383,0.539721716191606,0.185460789925587,1.71184320453863,913,383,530,50,1.4,6.64,4.2,0,0,0,0,0,0,0.183313842771856,3743.60048459676,18.3911263122233
7.5,"greedy_SVM","SVM",15,20,28040,24907,3133,2100,1691,409,0.539775331283707,0.187178019461935,1.75980500302105,973,409,564,60,1.4,6.97,4.1,0,0,0,0,0,0,0.190647422745987,4434.08956745342,19.0863642356238
7.5,"greedy_SVM","SVM",15,21,27940,24835,3105,2200,1763,437,0.539816702544668,0.186033199771036,1.73135378658313,1041,437,604,68,1.4,7.3,4,0,0,0,0,0,0,0.193049500061547,4175.9338781866,19.5380990932553
7.5,"greedy_SVM","SVM",15,22,27840,24759,3081,2300,1839,461,0.54024515071254,0.185460789925587,1.83469032229854,1095,461,634,54,1.4,7.63,4,0,0,0,0,0,0,0.196021822359561,4369.96402915015,19.6170909090424
7.5,"greedy_SVM","SVM",15,23,27740,24677,3063,2400,1921,479,0.539227237257272,0.186033199771036,1.75536397799955,1129,479,650,34,1.4,7.96,4,0,0,0,0,0,0,0.196231180343525,4556.65067103258,19.6435448533782
7.5,"greedy_SVM","SVM",15,24,27640,24592,3048,2500,2006,494,0.538096508712369,0.183743560389239,1.74036086707648,1179,494,685,50,1.4,8.29,4.1,0,0,0,0,0,0,0.193295309225093,4242.64872380077,19.3680471438823
7.5,"greedy_SVM","SVM",15,25,27540,24512,3028,2600,2086,514,0.5392226834113,0.184888380080137,1.72987046170568,1241,514,727,62,1.4,8.63,4.1,0,0,0,0,0,0,0.194372602972801,4455.91007393541,19.464641214056
7.5,"greedy_SVM","SVM",15,26,27440,24433,3007,2700,2165,535,0.536920843159187,0.184888380080137,1.74339285464978,1247,535,712,6,1.3,8.96,4,0,0,0,0,0,0,0.192600302341267,4200.5442815309,19.2857030334836
7.5,"greedy_SVM","SVM",15,27,27340,24347,2993,2800,2251,549,0.537558080868397,0.183743560389239,1.71190175978826,1278,549,729,31,1.3,9.29,4.1,0,0,0,0,0,0,0.190802628295633,4162.0612973848,19.1387091148229
7.5,"greedy_SVM","SVM",15,28,27240,24268,2972,2900,2330,570,0.53923488428162,0.183743560389239,1.74927952746922,1316,570,746,38,1.3,9.62,4.1,0,0,0,0,0,0,0.192511194305211,4362.42865675776,19.2933474527726
7.5,"greedy_SVM","SVM",15,29,27140,24189,2951,3000,2409,591,0.539203694732848,0.184315970234688,1.78975913073205,1365,591,774,49,1.3,9.95,4.1,0,0,0,0,0,0,0.190926643939664,3909.46734621011,19.1201001101463
7.5,"greedy_SVM","SVM",15,30,27040,24102,2938,3100,2496,604,0.539350362941523,0.183743560389239,1.80473619458755,1404,604,800,39,1.3,10.29,4.1,0,0,0,0,0,0,0.189836025493749,4237.72201423467,19.0096818628423
7.5,"greedy_SVM","SVM",15,31,26940,24023,2917,3200,2575,625,0.537937811476617,0.183171150543789,1.74786242253802,1459,625,834,55,1.3,10.62,4.1,0,0,0,0,0,0,0.190540360775105,4221.66662177313,19.0857268516942
7.5,"greedy_SVM","SVM",15,32,26840,23932,2908,3300,2666,634,0.535499613610466,0.183171150543789,1.7538389006946,1505,634,871,46,1.4,10.95,4.2,0,0,0,0,0,0,0.189194300011617,4476.53731865099,18.9516813801792
7.5,"greedy_SVM","SVM",15,33,26740,23848,2892,3400,2750,650,0.53591066264989,0.185460789925587,1.80473619458755,1518,650,868,13,1.3,11.28,4.2,0,0,0,0,0,0,0.18731653528094,4427.85516625596,18.7495806305986
7.5,"greedy_SVM","SVM",15,34,26640,23767,2873,3500,2831,669,0.536701012689422,0.185460789925587,1.80160840222258,1577,669,908,59,1.4,11.61,4.2,0,0,0,0,0,0,0.18660025619857,4089.27203292963,18.6946325045344
7.5,"greedy_SVM","SVM",15,35,26540,23688,2852,3600,2910,690,0.535626433924465,0.186033199771036,1.82561705334532,1629,690,939,52,1.4,11.94,4.2,0,0,0,0,0,0,0.186098662748468,3852.66059518848,18.6600821306152
7.5,"greedy_SVM","SVM",15,36,26440,23609,2831,3700,2989,711,0.533367941130622,0.186605609616485,1.70590445968333,1654,711,943,25,1.3,12.28,4.2,0,0,0,0,0,0,0.184596268037092,3585.01082732055,18.5114838995245
7.5,"greedy_SVM","SVM",15,37,26340,23522,2818,3800,3076,724,0.534943399990755,0.186605609616485,1.79257948691263,1708,724,984,54,1.4,12.61,4.2,0,0,0,0,0,0,0.185832959189009,3945.29759827735,18.6136587086651
7.5,"greedy_SVM","SVM",15,38,26240,23432,2808,3900,3166,734,0.53361891818835,0.189467658843732,1.77150623798322,1742,734,1008,34,1.4,12.94,4.3,0,0,0,0,0,0,0.183383260619244,3975.7527188741,18.3582482126134
7.5,"greedy_SVM","SVM",15,39,26140,23342,2798,4000,3256,744,0.533828137337807,0.191757298225529,1.73873262248018,1775,744,1031,33,1.4,13.27,4.4,0,0,0,0,0,0,0.183445834432089,4273.33358448978,18.3645070512573
7.5,"greedy_SVM","SVM",15,40,26040,23262,2778,4100,3336,764,0.534424691159025,0.190612478534631,1.72090713425447,1836,764,1072,61,1.4,13.6,4.4,0,0,0,0,0,0,0.179170254647509,3394.59712451239,17.9667889136386
7.5,"greedy_SVM","SVM",15,41,25940,23179,2761,4200,3419,781,0.534042468823764,0.190040068689181,1.71054781833235,1886,781,1105,50,1.4,13.93,4.4,0,0,0,0,0,0,0.179680342991471,3539.64616570469,17.9999059614954
7.5,"greedy_SVM","SVM",15,42,25840,23100,2740,4300,3498,802,0.5311176968125,0.184888380080137,1.71500856652781,1930,802,1128,44,1.4,14.27,4.4,0,0,0,0,0,0,0.18244337574835,3918.67479887748,18.2686385576209
7.5,"greedy_SVM","SVM",15,43,25740,23010,2730,4400,3588,812,0.530132218769513,0.184315970234688,1.71178413744241,1993,812,1181,63,1.5,14.6,4.4,0,0,0,0,0,0,0.180990317476411,3941.24053280619,18.1232807620899
7.5,"greedy_SVM","SVM",15,44,25640,22915,2725,4500,3683,817,0.530969610897061,0.190040068689181,1.77786864438416,1983,817,1166,-10,1.4,14.93,4.5,0,0,0,0,0,0,0.176325241929532,3629.4701759754,17.6546286734882
7.5,"greedy_SVM","SVM",15,45,25540,22823,2717,4600,3775,825,0.531150991441004,0.191757298225529,1.77111146910529,2007,825,1182,24,1.4,15.26,4.6,0,0,0,0,0,0,0.172970391222263,3367.49801377196,17.3452554020048
7.5,"greedy_SVM","SVM",15,46,25440,22738,2702,4700,3860,840,0.527711935561532,0.175157412707499,1.61471956381775,2043,840,1203,36,1.4,15.59,4.6,0,0,0,0,0,0,0.174509310018707,3470.51525682992,17.4868683831937
7.5,"greedy_SVM","SVM",15,47,25340,22649,2691,4800,3949,851,0.528798328549503,0.186605609616485,1.84538264353799,2086,851,1235,43,1.5,15.93,4.6,0,0,0,0,0,0,0.172358099999423,3597.52127452921,17.2616500130025
7.5,"greedy_SVM","SVM",15,48,25240,22555,2685,4900,4043,857,0.527470925411958,0.181453921007441,1.63856612574846,2101,857,1244,15,1.5,16.26,4.7,0,0,0,0,0,0,0.169365206799472,3354.8957649702,16.9607312875296
7.5,"greedy_SVM","SVM",16,0,30040,26566,3474,100,91,9,0.417715292535374,0.0880398671096345,0.706690411341574,31,9,22,0,2.4,0.33,10.1,0,0,0,0,0,0,0.118795583426217,2644.12397670764,12.0736358979685
7.5,"greedy_SVM","SVM",16,1,29940,26474,3466,200,183,17,0.418014291683412,0.0725359911406423,0.626816093163562,63,17,46,32,2.7,0.66,10.8,0,0,0,0,0,0,0.101361474675659,2392.28151635414,10.1992713862738
7.5,"greedy_SVM","SVM",16,2,29840,26386,3454,300,271,29,0.426175428138976,0.0941306755260244,0.736976951642014,97,29,68,34,2.3,1,9.3,0,0,0,0,0,0,0.156574456115569,2459.47758756365,16.3038251139014
7.5,"greedy_SVM","SVM",16,3,29740,26293,3447,400,364,36,0.564847000345201,0.174972314507198,1.5327479829141,117,36,81,20,2.2,1.33,10.1,0,0,0,0,0,0,0.775601514171725,3150.79775961582,84.2278819794424
7.5,"greedy_SVM","SVM",16,4,29640,26211,3429,500,446,54,0.459074768153567,0.124031007751938,1.06609636990745,169,54,115,52,2.1,1.66,8.3,0,0,0,0,0,0,0.18184169220661,3114.95481685634,23.8010486308257
7.5,"greedy_SVM","SVM",16,5,29540,26123,3417,600,534,66,0.437904476388334,0.104651162790698,0.933858688485908,196,66,130,27,2,1.99,8.1,0,0,0,0,0,0,0.132041888422848,3128.01658928278,14.3869175893087
7.5,"greedy_SVM","SVM",16,6,29440,26037,3403,700,620,80,0.580564971892905,0.193798449612403,1.5759369248787,230,80,150,34,1.9,2.32,7.8,0,0,0,0,0,0,0.131940263157067,3359.95139735955,13.6150048729918
7.5,"greedy_SVM","SVM",16,7,29340,25962,3378,800,695,105,0.585955555444245,0.227574750830565,2.27455580709337,262,105,157,32,1.5,2.65,6.6,0,0,0,0,0,0,0.221396956377226,3637.08849955049,25.899464748469
7.5,"greedy_SVM","SVM",16,8,29240,25895,3345,900,762,138,0.52114967113433,0.161129568106312,1.43440694551436,353,138,215,91,1.6,2.99,5.5,0,0,0,0,0,0,0.179185510676481,4401.51243296899,18.7063046176287
7.5,"greedy_SVM","SVM",16,9,29140,25818,3322,1000,839,161,0.489629993250291,0.13344407530454,1.13557216519886,417,161,256,64,1.6,3.32,5.2,0,0,0,0,0,0,0.180597165228328,4605.89830391647,18.3800791860934
7.5,"greedy_SVM","SVM",16,10,29040,25731,3309,1100,926,174,0.490431568098798,0.13233665559247,1.20388777749993,444,174,270,27,1.6,3.65,5.3,0,0,0,0,0,0,0.162326294824809,4552.1594749248,16.3778233444961
7.5,"greedy_SVM","SVM",16,11,28940,25656,3284,1200,1001,199,0.513764354609733,0.135658914728682,1.21993603782111,500,199,301,56,1.5,3.98,5,0,0,0,0,0,0,0.197476334055434,4628.7806807025,20.6033925051851
7.5,"greedy_SVM","SVM",16,12,28840,25563,3277,1300,1094,206,0.507159491396731,0.143964562569214,1.31018124736358,521,206,315,21,1.5,4.31,5.3,0,0,0,0,0,0,0.162629184039581,4461.83725739261,16.473929902153
7.5,"greedy_SVM","SVM",16,13,28740,25478,3262,1400,1179,221,0.504558996084167,0.153377630121816,1.47563339005483,571,221,350,50,1.6,4.64,5.3,0,0,0,0,0,0,0.163058654582176,4366.85795938262,16.5154220755713
7.5,"greedy_SVM","SVM",16,14,28640,25393,3247,1500,1264,236,0.517270654963836,0.150055370985604,1.48965512608655,599,236,363,28,1.5,4.98,5.4,0,0,0,0,0,0,0.159906437008544,4400.28320752015,16.4459034975869
7.5,"greedy_SVM","SVM",16,15,28540,25303,3237,1600,1354,246,0.511014923242416,0.142857142857143,1.3822941931802,622,246,376,23,1.5,5.31,5.5,0,0,0,0,0,0,0.154281718772602,4291.39221307938,15.4533890909744
7.5,"greedy_SVM","SVM",16,16,28440,25217,3223,1700,1440,260,0.512416082589385,0.143410852713178,1.34596149037259,656,260,396,34,1.5,5.64,5.5,0,0,0,0,0,0,0.156596264969493,4126.94860377787,15.8157831537107
7.5,"greedy_SVM","SVM",16,17,28340,25132,3208,1800,1525,275,0.513213608447615,0.137873754152824,1.19423062525948,690,275,415,34,1.5,5.97,5.5,0,0,0,0,0,0,0.154309878335668,4239.01429955858,15.5471772005324
7.5,"greedy_SVM","SVM",16,18,28240,25050,3190,1900,1607,293,0.516018682124626,0.13344407530454,1.24317059573112,735,293,442,45,1.5,6.3,5.5,0,0,0,0,0,0,0.155548845233758,4153.40100514955,15.5894681731877
7.5,"greedy_SVM","SVM",16,19,28140,24963,3177,2000,1694,306,0.51147976402318,0.127353266888151,1.03946008431933,782,306,476,47,1.6,6.64,5.5,0,0,0,0,0,0,0.153081152433181,4297.63704913426,15.3103469454887
7.5,"greedy_SVM","SVM",16,20,28040,24874,3166,2100,1783,317,0.505129653260335,0.140088593576966,1.2015571935126,823,317,506,41,1.6,6.97,5.6,0,0,0,0,0,0,0.151296722301941,4080.18083342962,15.1351856718985
7.5,"greedy_SVM","SVM",16,21,27940,24775,3165,2200,1882,318,0.511474087088356,0.144518272425249,1.2916548702393,838,318,520,15,1.6,7.3,5.9,0,0,0,0,0,0,0.14448765414688,3907.43946933004,14.4527847727872
7.5,"greedy_SVM","SVM",16,22,27840,24693,3147,2300,1964,336,0.508730541366696,0.130121816168328,1.16888641486613,874,336,538,36,1.6,7.63,5.8,0,0,0,0,0,0,0.146071810982017,4005.08535059205,14.6120523017277
7.5,"greedy_SVM","SVM",16,23,27740,24606,3134,2400,2051,349,0.510505543568593,0.137873754152824,1.15759778399385,894,349,545,20,1.6,7.96,5.9,0,0,0,0,0,0,0.145243101804478,3849.52831153489,14.5353004775748
7.5,"greedy_SVM","SVM",16,24,27640,24513,3127,2500,2144,356,0.506331702466831,0.136212624584718,1.15963401580386,924,356,568,30,1.6,8.29,6,0,0,0,0,0,0,0.141891785940305,3832.22295368995,14.1939222430508
7.5,"greedy_SVM","SVM",16,25,27540,24417,3123,2600,2240,360,0.514106431674955,0.152823920265781,1.54216036738027,933,360,573,9,1.6,8.63,6.2,0,0,0,0,0,0,0.138217152899967,3785.72564475932,13.8227283809701
7.5,"greedy_SVM","SVM",16,26,27440,24347,3093,2700,2310,390,0.508025724863178,0.132890365448505,1.10970229259443,998,390,608,65,1.6,8.96,5.9,0,0,0,0,0,0,0.144312886538759,3877.58522464969,14.4342592829517
7.5,"greedy_SVM","SVM",16,27,27340,24248,3092,2800,2409,391,0.508777710016333,0.148947951273533,1.1942052078501,990,391,599,-8,1.5,9.29,6.2,0,0,0,0,0,0,0.139326813619861,3695.89424834073,13.9363478306674
7.5,"greedy_SVM","SVM",16,28,27240,24158,3082,2900,2499,401,0.512805077851227,0.143964562569214,1.25432662321195,1014,401,613,24,1.5,9.62,6.2,0,0,0,0,0,0,0.13788641881659,3648.66889779302,13.7933084405614
7.5,"greedy_SVM","SVM",16,29,27140,24065,3075,3000,2592,408,0.510113375901994,0.138427464008859,1.29288131892128,1053,408,645,39,1.6,9.95,6.4,0,0,0,0,0,0,0.135983523919293,3668.69664870438,13.5990516146599
7.5,"greedy_SVM","SVM",16,30,27040,23976,3064,3100,2681,419,0.515778748144037,0.141196013289037,1.36274169508136,1044,419,625,-9,1.5,10.29,6.4,0,0,0,0,0,0,0.135118690033652,3622.79730514371,13.5134867210935
7.5,"greedy_SVM","SVM",16,31,26940,23882,3058,3200,2775,425,0.509892267639088,0.143964562569214,1.31335375842192,1111,425,686,67,1.6,10.62,6.5,0,0,0,0,0,0,0.133033423244072,3529.66832860482,13.3228453589673
7.5,"greedy_SVM","SVM",16,32,26840,23798,3042,3300,2859,441,0.505048798681282,0.128460686600221,1.16562181025683,1139,441,698,28,1.6,10.95,6.5,0,0,0,0,0,0,0.133234345814433,3504.41876911618,13.3263475223333
7.5,"greedy_SVM","SVM",16,33,26740,23711,3029,3400,2946,454,0.505993799618392,0.149501661129568,1.2765456442782,1141,454,687,2,1.5,11.28,6.5,0,0,0,0,0,0,0.133087450859835,3505.15451254211,13.3120681176279
7.5,"greedy_SVM","SVM",16,34,26640,23622,3018,3500,3035,465,0.50068753524604,0.136766334440753,1.09007437207934,1198,465,733,57,1.6,11.61,6.5,0,0,0,0,0,0,0.13241207951735,3426.12501500961,13.2466245604685
7.5,"greedy_SVM","SVM",16,35,26540,23528,3012,3600,3129,471,0.506094899148836,0.141749723145072,1.29644933554817,1221,471,750,23,1.6,11.94,6.6,0,0,0,0,0,0,0.13090545076394,3357.12201611431,13.094909855269
7.5,"greedy_SVM","SVM",16,36,26440,23444,2996,3700,3213,487,0.50909570185072,0.148394241417497,1.2621382658832,1228,487,741,7,1.5,12.28,6.6,0,0,0,0,0,0,0.131206818426982,3430.77278229571,13.1229416723231
7.5,"greedy_SVM","SVM",16,37,26340,23362,2978,3800,3295,505,0.50646536088817,0.148394241417497,1.44872666350822,1261,505,756,33,1.5,12.61,6.5,0,0,0,0,0,0,0.132421639918456,3418.42291361735,13.2466971157279
7.5,"greedy_SVM","SVM",16,38,26240,23282,2958,3900,3375,525,0.503303266449859,0.148947951273533,1.35243361151953,1339,525,814,78,1.6,12.94,6.4,0,0,0,0,0,0,0.134189028918367,3423.9268685772,13.4348806405901
7.5,"greedy_SVM","SVM",16,39,26140,23190,2950,4000,3467,533,0.509635678533547,0.150609080841639,1.43673284512029,1362,533,829,23,1.6,13.27,6.5,0,0,0,0,0,0,0.133292572353379,3445.65177151182,13.3308580446768
7.5,"greedy_SVM","SVM",16,40,26040,23110,2930,4100,3547,553,0.506919098252299,0.153377630121816,1.4440411189754,1409,553,856,47,1.5,13.6,6.4,0,0,0,0,0,0,0.134929554749271,3473.10848215288,13.4933261715328
7.5,"greedy_SVM","SVM",16,41,25940,23036,2904,4200,3621,579,0.502992496010488,0.146179401993355,1.34572556373099,1429,579,850,20,1.5,13.93,6.3,0,0,0,0,0,0,0.137757508648982,3441.00096670406,13.7832046502646
7.5,"greedy_SVM","SVM",16,42,25840,22954,2886,4300,3703,597,0.505268696421319,0.138427464008859,1.22392764857881,1487,597,890,58,1.5,14.27,6.2,0,0,0,0,0,0,0.138581786230468,3521.76210389508,13.860170354725
7.5,"greedy_SVM","SVM",16,43,25740,22860,2880,4400,3797,603,0.510486634366574,0.157253599114064,1.48043884316181,1506,603,903,19,1.5,14.6,6.3,0,0,0,0,0,0,0.136576204429324,3442.31098404304,13.6627575045737
7.5,"greedy_SVM","SVM",16,44,25640,22777,2863,4500,3880,620,0.504023569297634,0.152270210409745,1.21528561752089,1567,620,947,61,1.5,14.93,6.3,0,0,0,0,0,0,0.13747379862874,3456.76385266293,13.7495279999953
7.5,"greedy_SVM","SVM",16,45,25540,22685,2855,4600,3972,628,0.50677512951551,0.158914728682171,1.36851414279595,1577,628,949,10,1.5,15.26,6.3,0,0,0,0,0,0,0.136119234816043,3387.84448967704,13.6164719147605
7.5,"greedy_SVM","SVM",16,46,25440,22602,2838,4700,4055,645,0.51015165346988,0.155592469545958,1.47790905687066,1642,645,997,65,1.5,15.59,6.3,0,0,0,0,0,0,0.136880380447324,3425.51442948623,13.6934041751394
7.5,"greedy_SVM","SVM",16,47,25340,22513,2827,4800,4144,656,0.505122724060479,0.152270210409745,1.42311392580288,1645,656,989,3,1.5,15.93,6.3,0,0,0,0,0,0,0.136570118379426,3409.29736356255,13.6586481773829
7.5,"greedy_SVM","SVM",16,48,25240,22431,2809,4900,4226,674,0.507185329798609,0.1578073089701,1.50982810319336,1690,674,1016,45,1.5,16.26,6.3,0,0,0,0,0,0,0.137530812850479,3454.47170502302,13.7542023858581
7.5,"greedy_SVM","SVM",17,0,30040,26532,3508,100,91,9,0.591635842373114,0.200338600451467,1.79568364188914,34,9,25,0,2.8,0.33,10.1,0,0,0,0,0,0,0.163433891927637,2769.97440638248,17.7106458292786
7.5,"greedy_SVM","SVM",17,1,29940,26461,3479,200,162,38,0.61323949661349,0.208803611738149,1.93092341408163,101,38,63,67,1.7,0.66,4.3,0,0,0,0,0,0,0.254904507267034,5546.22483725285,25.6944814867018
7.5,"greedy_SVM","SVM",17,2,29840,26397,3443,300,226,74,0.61462117944678,0.193002257336343,1.82518845879716,182,74,108,81,1.5,1,3.1,0,0,0,0,0,0,0.541771343742205,6091.88635819161,60.3616185960632
7.5,"greedy_SVM","SVM",17,3,29740,26316,3424,400,307,93,0.54496054626216,0.126410835214447,1.12245949690791,228,93,135,46,1.5,1.33,3.3,0,0,0,0,0,0,0.318481657759074,6220.35876421251,32.6092830850802
7.5,"greedy_SVM","SVM",17,4,29640,26227,3413,500,396,104,0.548576672120326,0.145598194130926,1.20857698154483,263,104,159,35,1.5,1.66,3.8,0,0,0,0,0,0,0.280298503538373,5058.89835797926,28.8845842362904
7.5,"greedy_SVM","SVM",17,5,29540,26134,3406,600,489,111,0.527655871034962,0.144469525959368,1.47001365549146,285,111,174,22,1.6,1.99,4.4,0,0,0,0,0,0,0.187289927521005,5347.19411319281,18.8032047783202
7.5,"greedy_SVM","SVM",17,6,29440,26048,3392,700,575,125,0.514396587295809,0.150677200902935,1.42631759740897,358,125,233,73,1.9,2.32,4.6,0,0,0,0,0,0,0.2010071948445,4720.57138944931,23.9079417757229
7.5,"greedy_SVM","SVM",17,7,29340,25967,3373,800,656,144,0.509066751229791,0.169300225733634,1.67833559066968,384,144,240,26,1.7,2.65,4.6,0,0,0,0,0,0,0.186992330669109,5232.19366163218,19.1989420917458
7.5,"greedy_SVM","SVM",17,8,29240,25913,3327,900,710,190,0.490424588518599,0.111738148984199,0.930483327142326,476,190,286,92,1.5,2.99,3.7,0,0,0,0,0,0,0.219538532308451,6080.93038756518,22.2172521794663
7.5,"greedy_SVM","SVM",17,9,29140,25821,3319,1000,802,198,0.508004535210903,0.15293453724605,1.39985730983347,507,198,309,31,1.6,3.32,4.1,0,0,0,0,0,0,0.203702652734765,5000.20246825176,21.1433598309271
7.5,"greedy_SVM","SVM",17,10,29040,25741,3299,1100,882,218,0.503028219504954,0.112302483069977,0.950075849728777,536,218,318,29,1.5,3.65,4,0,0,0,0,0,0,0.213112147840724,5404.97202518067,22.3534647014432
7.5,"greedy_SVM","SVM",17,11,28940,25654,3286,1200,969,231,0.535538683385112,0.165349887133183,1.47521724365249,574,231,343,38,1.5,3.98,4.2,0,0,0,0,0,0,0.20013454610508,4594.09878975808,21.1580096713833
7.5,"greedy_SVM","SVM",17,12,28840,25564,3276,1300,1059,241,0.547894667651821,0.171557562076749,1.69806264892149,605,241,364,31,1.5,4.31,4.4,0,0,0,0,0,0,0.189098942218888,5111.04422775244,22.5240368503541
7.5,"greedy_SVM","SVM",17,13,28740,25478,3262,1400,1145,255,0.546824898323114,0.177200902934537,1.63472289146991,640,255,385,35,1.5,4.64,4.5,0,0,0,0,0,0,0.24166938654333,4831.70220535289,25.2873948299984
7.5,"greedy_SVM","SVM",17,14,28640,25391,3249,1500,1232,268,0.54603608665904,0.175507900677201,1.59282398360041,672,268,404,32,1.5,4.98,4.6,0,0,0,0,0,0,0.178216275987313,4584.19224783039,18.0164661060361
7.5,"greedy_SVM","SVM",17,15,28540,25314,3226,1600,1309,291,0.547733289914531,0.17607223476298,1.65500228491288,707,291,416,35,1.4,5.31,4.5,0,0,0,0,0,0,0.185227105258105,4495.99652137867,19.1824856626332
7.5,"greedy_SVM","SVM",17,16,28440,25242,3198,1700,1381,319,0.547121514253606,0.187923250564334,1.83001699969345,782,319,463,75,1.5,5.64,4.3,0,0,0,0,0,0,0.188263082903415,4861.43251166735,19.1187756119734
7.5,"greedy_SVM","SVM",17,17,28340,25161,3179,1800,1462,338,0.547586382282007,0.173250564334086,1.46899061675867,811,338,473,29,1.4,5.97,4.3,0,0,0,0,0,0,0.188139496547987,4573.45645930393,19.3463922138429
7.5,"greedy_SVM","SVM",17,18,28240,25081,3159,1900,1542,358,0.547541104857424,0.176636568848758,1.6490196851558,879,358,521,68,1.5,6.3,4.3,0,0,0,0,0,0,0.185720665843518,4462.15278102464,19.0494673518216
7.5,"greedy_SVM","SVM",17,19,28140,25000,3140,2000,1623,377,0.552593717479396,0.189051918735892,1.81341772655403,931,377,554,52,1.5,6.64,4.3,0,0,0,0,0,0,0.185938900713956,4378.92745708522,18.7004205867582
7.5,"greedy_SVM","SVM",17,20,28040,24918,3122,2100,1705,395,0.553024892653892,0.183972911963883,1.74406070383196,965,395,570,34,1.4,6.97,4.3,0,0,0,0,0,0,0.186565610622009,4237.98363191316,18.7133106213852
7.5,"greedy_SVM","SVM",17,21,27940,24832,3108,2200,1791,409,0.555279598068862,0.195259593679458,1.78030677538411,1006,409,597,41,1.5,7.3,4.4,0,0,0,0,0,0,0.184466658350692,4678.82693532109,18.4612650499452
7.5,"greedy_SVM","SVM",17,22,27840,24744,3096,2300,1879,421,0.551795952172781,0.183972911963883,1.6678105239544,1032,421,611,26,1.5,7.63,4.5,0,0,0,0,0,0,0.182354322101039,4771.92780598162,18.2449497302144
7.5,"greedy_SVM","SVM",17,23,27740,24649,3091,2400,1974,426,0.55126034612491,0.18510158013544,1.71600272471435,1046,426,620,14,1.5,7.96,4.6,0,0,0,0,0,0,0.175605187686579,4395.09213894508,17.5737895127749
7.5,"greedy_SVM","SVM",17,24,27640,24554,3086,2500,2069,431,0.549959012685651,0.187358916478555,1.73695275490414,1053,431,622,7,1.4,8.29,4.8,0,0,0,0,0,0,0.169525815439632,4021.16729920294,16.9712705452467
7.5,"greedy_SVM","SVM",17,25,27540,24468,3072,2600,2155,445,0.548568270124012,0.179458239277652,1.66648503045312,1082,445,637,29,1.4,8.63,4.8,0,0,0,0,0,0,0.169381208757973,4066.07728661338,16.9551425744426
7.5,"greedy_SVM","SVM",17,26,27440,24371,3069,2700,2252,448,0.550131762821996,0.186230248306998,1.7040317868178,1101,448,653,19,1.5,8.96,5,0,0,0,0,0,0,0.163055504184819,3964.72749788618,16.3238627466589
7.5,"greedy_SVM","SVM",17,27,27340,24293,3047,2800,2330,470,0.54931413825137,0.177200902934537,1.75656530236951,1192,470,722,91,1.5,9.29,5,0,0,0,0,0,0,0.164365982347379,3648.55050282013,16.4519546504292
7.5,"greedy_SVM","SVM",17,28,27240,24212,3028,2900,2411,489,0.552066980205409,0.187358916478555,1.74001616364295,1188,489,699,-4,1.4,9.62,4.9,0,0,0,0,0,0,0.16503632490088,3750.74733639868,16.5426557604756
7.5,"greedy_SVM","SVM",17,29,27140,24131,3009,3000,2492,508,0.550248754255523,0.18058690744921,1.73711162737784,1272,508,764,84,1.5,9.95,4.9,0,0,0,0,0,0,0.167941174602349,4106.24503522021,16.8033726464291
7.5,"greedy_SVM","SVM",17,30,27040,24043,2997,3100,2580,520,0.549687517875461,0.180022573363431,1.80638846161529,1287,520,767,15,1.5,10.29,5,0,0,0,0,0,0,0.164236997656025,3820.32244565849,16.4501481180468
7.5,"greedy_SVM","SVM",17,31,26940,23968,2972,3200,2655,545,0.547629750161973,0.182844243792325,1.71303711443818,1332,545,787,45,1.4,10.62,4.9,0,0,0,0,0,0,0.167923890916353,3695.56134530071,16.830905384388
7.5,"greedy_SVM","SVM",17,32,26840,23880,2960,3300,2743,557,0.546081194346319,0.178329571106095,1.54159256975089,1375,557,818,43,1.5,10.95,4.9,0,0,0,0,0,0,0.166348535212713,3794.88064777625,16.6610670039256
7.5,"greedy_SVM","SVM",17,33,26740,23786,2954,3400,2837,563,0.545037946470623,0.182844243792325,1.66795719037402,1419,563,856,44,1.5,11.28,5,0,0,0,0,0,0,0.16193262685508,3557.28188973615,16.2093783181782
7.5,"greedy_SVM","SVM",17,34,26640,23692,2948,3500,2931,569,0.546885579407604,0.178893905191874,1.65480064811866,1409,569,840,-10,1.5,11.61,5.2,0,0,0,0,0,0,0.161508549049326,4067.39796002822,16.1612117337227
7.5,"greedy_SVM","SVM",17,35,26540,23606,2934,3600,3017,583,0.546284539630859,0.17607223476298,1.74884752863326,1454,583,871,45,1.5,11.94,5.2,0,0,0,0,0,0,0.160300173406405,3781.36913006242,16.0401076483173
7.5,"greedy_SVM","SVM",17,36,26440,23525,2915,3700,3098,602,0.546982669142796,0.18058690744921,1.77251208722569,1480,602,878,26,1.5,12.28,5.1,0,0,0,0,0,0,0.16229998881652,4053.35257139245,16.23715736774
7.5,"greedy_SVM","SVM",17,37,26340,23448,2892,3800,3175,625,0.542611042565529,0.174943566591422,1.63100902143877,1549,625,924,69,1.5,12.61,5.1,0,0,0,0,0,0,0.162867847327924,3894.53226883218,16.2974558037177
7.5,"greedy_SVM","SVM",17,38,26240,23361,2879,3900,3262,638,0.545619890801206,0.178893905191874,1.74731210499091,1596,638,958,47,1.5,12.94,5.1,0,0,0,0,0,0,0.161260302232196,3726.95411628992,16.1514556874447
7.5,"greedy_SVM","SVM",17,39,26140,23283,2857,4000,3340,660,0.548882666036601,0.189051918735892,1.86751734804782,1655,660,995,59,1.5,13.27,5.1,0,0,0,0,0,0,0.16145211124885,3560.83753879496,16.1953344543274
7.5,"greedy_SVM","SVM",17,40,26040,23202,2838,4100,3421,679,0.548057573024803,0.183408577878104,1.87437716786874,1680,679,1001,25,1.5,13.6,5,0,0,0,0,0,0,0.163900873890282,3851.79886675037,16.4088962098179
7.5,"greedy_SVM","SVM",17,41,25940,23117,2823,4200,3506,694,0.544375419357217,0.181715575620767,1.74406070383196,1767,694,1073,87,1.5,13.93,5.1,0,0,0,0,0,0,0.16389408585884,4027.25083993962,16.4016246770525
7.5,"greedy_SVM","SVM",17,42,25840,23032,2808,4300,3591,709,0.545683372551136,0.180022573363431,1.71593699259435,1779,709,1070,12,1.5,14.27,5.1,0,0,0,0,0,0,0.16241547036759,3635.8865391624,16.2604762376124
7.5,"greedy_SVM","SVM",17,43,25740,22944,2796,4400,3679,721,0.54627838665376,0.191309255079007,1.87274585614736,1816,721,1095,37,1.5,14.6,5.1,0,0,0,0,0,0,0.161768672166688,3771.52980819073,16.2002590919012
7.5,"greedy_SVM","SVM",17,44,25640,22859,2781,4500,3764,736,0.542279588054362,0.18058690744921,1.58216753575759,1852,736,1116,36,1.5,14.93,5.1,0,0,0,0,0,0,0.162940294089601,3918.68078634089,16.3014261323065
7.5,"greedy_SVM","SVM",17,45,25540,22772,2768,4600,3851,749,0.541588332903045,0.171557562076749,1.53759943615878,1885,749,1136,33,1.5,15.26,5.1,0,0,0,0,0,0,0.160717826558144,3480.07683082321,16.0887846977162
7.5,"greedy_SVM","SVM",17,46,25440,22680,2760,4700,3943,757,0.543828568213262,0.178893905191874,1.53887131190491,1938,757,1181,53,1.6,15.59,5.2,0,0,0,0,0,0,0.160444987946686,3712.12569310682,16.0586249596213
7.5,"greedy_SVM","SVM",17,47,25340,22596,2744,4800,4027,773,0.541363133941226,0.165349887133183,1.38888910909534,1974,773,1201,36,1.6,15.93,5.2,0,0,0,0,0,0,0.160033611999037,3617.04070012932,16.0124671470364
7.5,"greedy_SVM","SVM",17,48,25240,22505,2735,4900,4118,782,0.546498451062268,0.190744920993228,1.80880586515551,1968,782,1186,-6,1.5,16.26,5.3,0,0,0,0,0,0,0.157970042152019,3473.92789829206,15.8106064017869
7.5,"greedy_SVM","SVM",18,0,30040,26469,3571,100,86,14,0.638661082351562,0.247065727699531,2.44912348803469,48,14,34,0,2.4,0.33,6.1,0,0,0,0,0,0,0.886561425724987,4539.48837778769,91.530906699751
7.5,"greedy_SVM","SVM",18,1,29940,26422,3518,200,133,67,0.601251470319137,0.197183098591549,1.92543624579334,135,66,69,87,1,0.66,2,0,0,0,0,0,0,0.542172009431653,6620.12322825293,62.2781306542474
7.5,"greedy_SVM","SVM",18,2,29840,26348,3492,300,207,93,0.584357705420571,0.19131455399061,1.84325999227326,205,93,112,70,1.2,1,2.2,0,0,0,0,0,0,0.32782848327378,8821.59950097715,33.200251319424
7.5,"greedy_SVM","SVM",18,3,29740,26278,3462,400,277,123,0.552218610157238,0.143779342723005,1.26349765258216,272,123,149,67,1.2,1.33,2.3,0,0,0,0,0,0,0.313080958431966,8944.51966055987,31.6531454613995
7.5,"greedy_SVM","SVM",18,4,29640,26190,3450,500,365,135,0.547239237650281,0.169014084507042,1.63439174688568,318,135,183,46,1.4,1.66,2.7,0,0,0,0,0,0,0.284287260730672,7577.27908336836,29.3038315015695
7.5,"greedy_SVM","SVM",18,5,29540,26112,3428,600,443,157,0.538225553540683,0.13849765258216,1.24559157424619,358,157,201,40,1.3,1.99,2.8,0,0,0,0,0,0,0.292273440803709,7150.48049255267,30.8346924948041
7.5,"greedy_SVM","SVM",18,6,29440,26025,3415,700,530,170,0.430574616874085,0.0980046948356808,0.784591284264728,400,170,230,42,1.4,2.32,3.1,0,0,0,0,0,0,0.248215996308398,7209.458091808,24.8799517012472
7.5,"greedy_SVM","SVM",18,7,29340,25938,3402,800,617,183,0.558166312279807,0.152582159624413,1.39029626247717,447,183,264,47,1.4,2.65,3.4,0,0,0,0,0,0,0.233780686704125,6647.18858826621,23.5488427889604
7.5,"greedy_SVM","SVM",18,8,29240,25846,3394,900,709,191,0.560971070055156,0.15669014084507,1.49240841734838,464,191,273,17,1.4,2.99,3.7,0,0,0,0,0,0,0.220370695537662,6031.76561336073,22.1140694824894
7.5,"greedy_SVM","SVM",18,9,29140,25756,3384,1000,799,201,0.546700281612869,0.147300469483568,1.32510436436586,495,201,294,31,1.5,3.32,4,0,0,0,0,0,0,0.201231702804955,5782.24316107946,20.1343476346222
7.5,"greedy_SVM","SVM",18,10,29040,25674,3366,1100,881,219,0.551086433691551,0.159037558685446,1.41135376086305,532,219,313,37,1.4,3.65,4,0,0,0,0,0,0,0.200533505263747,5562.37469679119,20.1899591095645
7.5,"greedy_SVM","SVM",18,11,28940,25597,3343,1200,958,242,0.536533918229703,0.154342723004695,1.48844276167783,584,242,342,52,1.4,3.98,4,0,0,0,0,0,0,0.20458736031555,5598.16210185383,20.7119137113991
7.5,"greedy_SVM","SVM",18,12,28840,25515,3325,1300,1040,260,0.53120037837559,0.129694835680751,1.21286773774138,621,260,361,37,1.4,4.31,4,0,0,0,0,0,0,0.20095243509615,5640.55555910505,20.2283290079853
7.5,"greedy_SVM","SVM",18,13,28740,25420,3320,1400,1135,265,0.520762254005823,0.147300469483568,1.39855349707195,670,265,405,49,1.5,4.64,4.3,0,0,0,0,0,0,0.190435344607488,5026.37461179916,19.1488054272881
7.5,"greedy_SVM","SVM",18,14,28640,25332,3308,1500,1223,277,0.516909350544807,0.13849765258216,1.35770581088872,662,277,385,-8,1.4,4.98,4.4,0,0,0,0,0,0,0.18679089694324,4553.65529562505,18.7474965455863
7.5,"greedy_SVM","SVM",18,15,28540,25245,3295,1600,1310,290,0.51873480289733,0.129107981220657,1.18589528810696,736,290,446,74,1.5,5.31,4.5,0,0,0,0,0,0,0.182273378572081,4606.78026235561,18.2802655355707
7.5,"greedy_SVM","SVM",18,16,28440,25156,3284,1700,1399,301,0.520254600970579,0.126173708920188,1.16354770929965,762,301,461,26,1.5,5.64,4.6,0,0,0,0,0,0,0.177518350100209,4330.64257050007,17.8057386389381
7.5,"greedy_SVM","SVM",18,17,28340,25068,3272,1800,1487,313,0.523655959722831,0.144953051643192,1.39240330579195,807,313,494,45,1.6,5.97,4.8,0,0,0,0,0,0,0.174628800402464,4492.98880328273,17.5150433700063
7.5,"greedy_SVM","SVM",18,18,28240,24990,3250,1900,1565,335,0.522932610124227,0.141431924882629,1.32976501198332,846,335,511,39,1.5,6.3,4.7,0,0,0,0,0,0,0.174832209897077,4443.35205270384,17.5016093952317
7.5,"greedy_SVM","SVM",18,19,28140,24904,3236,2000,1651,349,0.519114697536606,0.143192488262911,1.32744430515613,880,349,531,34,1.5,6.64,4.7,0,0,0,0,0,0,0.173100761597796,4652.20789573578,17.3236260317191
7.5,"greedy_SVM","SVM",18,20,28040,24817,3223,2100,1738,362,0.526207966609662,0.147300469483568,1.40512536827319,917,362,555,37,1.5,6.97,4.8,0,0,0,0,0,0,0.171620242416918,4545.52075173744,17.1758516568119
7.5,"greedy_SVM","SVM",18,21,27940,24734,3206,2200,1821,379,0.521740505751151,0.132042253521127,1.24581089629055,936,379,557,19,1.5,7.3,4.8,0,0,0,0,0,0,0.169406655583672,4159.16751992752,16.9524558601651
7.5,"greedy_SVM","SVM",18,22,27840,24643,3197,2300,1912,388,0.51940608326651,0.141431924882629,1.28675221060514,976,388,588,40,1.5,7.63,4.9,0,0,0,0,0,0,0.1673453487448,4338.22517980977,16.7429553949547
7.5,"greedy_SVM","SVM",18,23,27740,24556,3184,2400,1999,401,0.521017946410664,0.145539906103286,1.41293162031915,1006,401,605,30,1.5,7.96,5,0,0,0,0,0,0,0.164945122616531,4236.28891047877,17.8450148459176
7.5,"greedy_SVM","SVM",18,24,27640,24473,3167,2500,2082,418,0.508741418235854,0.142018779342723,1.21939651287598,1070,418,652,64,1.6,8.29,5,0,0,0,0,0,0,0.165648617206732,4403.41377604755,16.5720358367244
7.5,"greedy_SVM","SVM",18,25,27540,24387,3153,2600,2168,432,0.513019041532806,0.137323943661972,1.32976501198332,1103,432,671,33,1.6,8.63,5,0,0,0,0,0,0,0.164839214016356,4236.36402335668,16.492807560969
7.5,"greedy_SVM","SVM",18,26,27440,24301,3139,2700,2254,446,0.508904387021361,0.139084507042254,1.31857601581591,1127,446,681,24,1.5,8.96,5.1,0,0,0,0,0,0,0.164575812455465,4303.07047650045,16.4746618123057
7.5,"greedy_SVM","SVM",18,27,27340,24217,3123,2800,2338,462,0.509925312705141,0.143779342723005,1.43674580232487,1141,462,679,14,1.5,9.29,5.1,0,0,0,0,0,0,0.160753816307908,3732.90483283418,16.0921865768084
7.5,"greedy_SVM","SVM",18,28,27240,24134,3106,2900,2421,479,0.510460888193931,0.132629107981221,1.23160780756486,1195,479,716,54,1.5,9.62,5.1,0,0,0,0,0,0,0.163646281255574,4104.33480309275,16.3734462533916
7.5,"greedy_SVM","SVM",18,29,27140,24045,3095,3000,2510,490,0.516378033669209,0.144953051643192,1.37546703621672,1199,490,709,4,1.4,9.95,5.1,0,0,0,0,0,0,0.161070156561579,3844.05066349854,16.1295134797691
7.5,"greedy_SVM","SVM",18,30,27040,23956,3084,3100,2599,501,0.516487396612291,0.146713615023474,1.3464043226991,1261,501,760,62,1.5,10.29,5.2,0,0,0,0,0,0,0.15958130986738,3993.50215828145,15.9724839550162
7.5,"greedy_SVM","SVM",18,31,26940,23868,3072,3200,2687,513,0.511320864640729,0.134976525821596,1.24038489064468,1266,513,753,5,1.5,10.62,5.2,0,0,0,0,0,0,0.159107982885515,3882.55700211755,15.9433559797826
7.5,"greedy_SVM","SVM",18,32,26840,23776,3064,3300,2779,521,0.518916737877707,0.146713615023474,1.35006861056481,1280,521,759,14,1.5,10.95,5.3,0,0,0,0,0,0,0.156091223606269,3885.62994914497,15.6158754806647
7.5,"greedy_SVM","SVM",18,33,26740,23694,3046,3400,2861,539,0.513486830436246,0.137910798122066,1.2899814461734,1338,539,799,58,1.5,11.28,5.3,0,0,0,0,0,0,0.155208019885701,3553.79377179376,15.5404020127647
7.5,"greedy_SVM","SVM",18,34,26640,23606,3034,3500,2949,551,0.518485169138066,0.142605633802817,1.27120190656132,1379,551,828,41,1.5,11.61,5.4,0,0,0,0,0,0,0.156125865004742,3962.36852658077,15.6161504219971
7.5,"greedy_SVM","SVM",18,35,26540,23513,3027,3600,3042,558,0.51723168805105,0.148474178403756,1.38267472374275,1368,558,810,-11,1.5,11.94,5.5,0,0,0,0,0,0,0.152722149469983,3728.66755081907,15.2819694678426
7.5,"greedy_SVM","SVM",18,36,26440,23421,3019,3700,3134,566,0.519627838475453,0.140845070422535,1.35476858832134,1387,566,821,19,1.5,12.28,5.5,0,0,0,0,0,0,0.150323172102549,3519.34021331436,15.0435181866076
7.5,"greedy_SVM","SVM",18,37,26340,23337,3003,3800,3218,582,0.530474701905854,0.155516431924883,1.41420005193941,1480,582,898,93,1.5,12.61,5.5,0,0,0,0,0,0,0.151463917720458,3621.28675447175,15.4595717984976
7.5,"greedy_SVM","SVM",18,38,26240,23270,2970,3900,3285,615,0.528494973607132,0.15669014084507,1.45357164727495,1513,615,898,33,1.5,12.94,5.3,0,0,0,0,0,0,0.156516880589216,3820.26836648593,15.6689059795962
7.5,"greedy_SVM","SVM",18,39,26140,23198,2942,4000,3357,643,0.530550786201462,0.150821596244131,1.32781720521576,1648,643,1005,135,1.6,13.27,5.2,0,0,0,0,0,0,0.158287078262271,3739.26014738593,15.8492340930135
7.5,"greedy_SVM","SVM",18,40,26040,23110,2930,4100,3445,655,0.536046241163599,0.167253521126761,1.59628416729508,1678,655,1023,30,1.6,13.6,5.3,0,0,0,0,0,0,0.158230204108852,3835.74695936665,15.8265674918894
7.5,"greedy_SVM","SVM",18,41,25940,23028,2912,4200,3527,673,0.532329525518486,0.159037558685446,1.48556693697539,1696,673,1023,18,1.5,13.93,5.2,0,0,0,0,0,0,0.158590423970867,3839.86690758241,15.8678802098433
7.5,"greedy_SVM","SVM",18,42,25840,22936,2904,4300,3619,681,0.534247394167751,0.160798122065728,1.5212205964105,1716,681,1035,20,1.5,14.27,5.3,0,0,0,0,0,0,0.157017263578326,3631.85767811477,15.7125363463757
7.5,"greedy_SVM","SVM",18,43,25740,22843,2897,4400,3712,688,0.534434202406529,0.171948356807512,1.65834066901408,1725,688,1037,9,1.5,14.6,5.4,0,0,0,0,0,0,0.154322678594849,3685.58847548847,15.4475386483167
7.5,"greedy_SVM","SVM",18,44,25640,22768,2872,4500,3787,713,0.532235133576452,0.157276995305164,1.44727912932138,1734,713,1021,9,1.4,14.93,5.3,0,0,0,0,0,0,0.156772579993232,3841.08954797636,15.6821847385493
7.5,"greedy_SVM","SVM",18,45,25540,22686,2854,4600,3869,731,0.532988600790044,0.15962441314554,1.40291808321192,1768,731,1037,34,1.4,15.26,5.3,0,0,0,0,0,0,0.15583829131336,3415.11415334945,15.5976545450215
7.5,"greedy_SVM","SVM",18,46,25440,22603,2837,4700,3952,748,0.537168012564054,0.161971830985915,1.48299897338511,1862,748,1114,94,1.5,15.59,5.3,0,0,0,0,0,0,0.157395271587144,3602.44966190596,15.7456673928094
7.5,"greedy_SVM","SVM",18,47,25340,22515,2825,4800,4040,760,0.53279582171215,0.160211267605634,1.35836778349277,1861,760,1101,-1,1.4,15.93,5.3,0,0,0,0,0,0,0.157048945246705,3638.7041310714,15.7100297984388
7.5,"greedy_SVM","SVM",18,48,25240,22427,2813,4900,4128,772,0.534357722981867,0.154342723004695,1.43751229934497,1927,772,1155,66,1.5,16.26,5.3,0,0,0,0,0,0,0.156565722392923,3781.04227471457,15.6587512636128
7.5,"greedy_SVM","SVM",19,0,30040,26508,3532,100,92,8,0.442814170775865,0.109205260148656,0.936956080836618,31,8,23,0,2.9,0.33,11.5,0,0,0,0,0,0,0.0845788278334048,2465.2554105781,8.47795330838661
7.5,"greedy_SVM","SVM",19,1,29940,26417,3523,200,183,17,0.470010057433895,0.124070897655803,1.147889059918,61,17,44,30,2.6,0.66,10.8,0,0,0,0,0,0,0.11615503232267,2457.22239688822,12.0954023519839
7.5,"greedy_SVM","SVM",19,2,29840,26324,3516,300,276,24,0.404589784678895,0.0903373356203545,0.833402583197497,90,24,66,29,2.8,1,11.5,0,0,0,0,0,0,0.143563935991871,1738.06094861973,15.1031192693983
7.5,"greedy_SVM","SVM",19,3,29740,26238,3502,400,362,38,0.400728676836718,0.0726129216695254,0.556176347327941,136,38,98,46,2.6,1.33,9.5,0,0,0,0,0,0,0.143062646591025,2327.965185827,15.7525616333008
7.5,"greedy_SVM","SVM",19,4,29640,26145,3495,500,455,45,0.42501293337759,0.0931961120640366,0.843885634558472,155,45,110,19,2.4,1.66,10.1,0,0,0,0,0,0,0.122641591614707,2517.22194879335,13.1703592388361
7.5,"greedy_SVM","SVM",19,5,29540,26066,3474,600,534,66,0.572387215239309,0.161806746712407,1.51472385245124,187,66,121,32,1.8,1.99,8.1,0,0,0,0,0,0,0.323245635349601,3474.45096077205,43.3955967944034
7.5,"greedy_SVM","SVM",19,6,29440,26004,3436,700,596,104,0.573741453820652,0.141795311606632,0.971028697853965,255,104,151,68,1.5,2.32,5.7,0,0,0,0,0,0,0.456412628493348,4430.33711903163,53.74411730543
7.5,"greedy_SVM","SVM",19,7,29340,25918,3422,800,682,118,0.584872270074503,0.192109777015437,1.79964075552655,302,118,184,47,1.6,2.65,5.8,0,0,0,0,0,0,0.29319351407191,3815.04980200608,36.3588906602267
7.5,"greedy_SVM","SVM",19,8,29240,25841,3399,900,759,141,0.617093268557864,0.221841052029731,2.05456905725488,343,141,202,41,1.4,2.99,5.4,0,0,0,0,0,0,0.33792379832406,4557.78154869602,34.825274776071
7.5,"greedy_SVM","SVM",19,9,29140,25778,3362,1000,822,178,0.581136075441138,0.137793024585477,1.25822340958424,435,178,257,92,1.4,3.32,4.6,0,0,0,0,0,0,0.231516777045783,4882.07652894949,25.3279860620476
7.5,"greedy_SVM","SVM",19,10,29040,25690,3350,1100,910,190,0.602434195996273,0.173241852487136,1.41979115147306,462,190,272,27,1.4,3.65,4.8,0,0,0,0,0,0,0.201111353260336,4697.2283520684,20.8809299327519
7.5,"greedy_SVM","SVM",19,11,28940,25609,3331,1200,991,209,0.576277915130082,0.143510577472842,1.25695024322209,519,209,310,57,1.5,3.98,4.7,0,0,0,0,0,0,0.181468684034178,4939.1756984763,18.3099054953525
7.5,"greedy_SVM","SVM",19,12,28840,25527,3313,1300,1073,227,0.572314211505168,0.155517438536306,1.25489183833203,560,227,333,41,1.5,4.31,4.7,0,0,0,0,0,0,0.196261406602329,4618.2930875826,19.9193803877361
7.5,"greedy_SVM","SVM",19,13,28740,25429,3311,1400,1171,229,0.574574880930085,0.161806746712407,1.49992637254275,570,229,341,10,1.5,4.64,5.1,0,0,0,0,0,0,0.166106966596565,4590.39706292177,16.6605848081144
7.5,"greedy_SVM","SVM",19,14,28640,25343,3297,1500,1257,243,0.577535201662403,0.16295025728988,1.43615399275777,609,243,366,39,1.5,4.98,5.2,0,0,0,0,0,0,0.164406888531999,4493.88838343877,16.4965483987832
7.5,"greedy_SVM","SVM",19,15,28540,25263,3277,1600,1337,263,0.589706868333794,0.193825042881647,1.66437512769118,665,263,402,56,1.5,5.31,5.1,0,0,0,0,0,0,0.170832788079531,4240.77437562465,17.6687745039191
7.5,"greedy_SVM","SVM",19,16,28440,25177,3263,1700,1423,277,0.587482335971864,0.185820468839337,1.57774663993107,722,277,445,57,1.6,5.64,5.1,0,0,0,0,0,0,0.164196079175189,4507.94111792415,16.4350483229409
7.5,"greedy_SVM","SVM",19,17,28340,25095,3245,1800,1505,295,0.588581683796576,0.185820468839337,1.62281591754591,762,295,467,40,1.6,5.97,5.1,0,0,0,0,0,0,0.165029647261795,4485.07471019389,16.5143995107157
7.5,"greedy_SVM","SVM",19,18,28240,25029,3211,1900,1571,329,0.577747217210098,0.190966266437965,1.72338479130932,811,329,482,49,1.5,6.3,4.8,0,0,0,0,0,0,0.219108640442477,4011.13401675403,22.7715198835665
7.5,"greedy_SVM","SVM",19,19,28140,24961,3179,2000,1639,361,0.585356343629638,0.181246426529445,1.66264876342177,880,361,519,69,1.4,6.64,4.5,0,0,0,0,0,0,0.18658511842979,4197.94389925293,18.8660892937199
7.5,"greedy_SVM","SVM",19,20,28040,24878,3162,2100,1722,378,0.586001231406904,0.186392224128073,1.66705507639903,930,378,552,50,1.5,6.97,4.6,0,0,0,0,0,0,0.192882244390319,4299.73020753434,19.9060444154671
7.5,"greedy_SVM","SVM",19,21,27940,24791,3149,2200,1809,391,0.58678221256507,0.189822755860492,1.72489785960722,1003,391,612,73,1.6,7.3,4.6,0,0,0,0,0,0,0.180719922279679,4488.22712934235,18.1713799240264
7.5,"greedy_SVM","SVM",19,22,27840,24709,3131,2300,1891,409,0.582867993540647,0.18696397941681,1.56465198158346,1015,409,606,12,1.5,7.63,4.6,0,0,0,0,0,0,0.17936700659805,4659.9345404457,17.9427990909429
7.5,"greedy_SVM","SVM",19,23,27740,24620,3120,2400,1980,420,0.583909230221329,0.198970840480274,1.74163776350324,1057,420,637,42,1.5,7.96,4.7,0,0,0,0,0,0,0.17495647730314,4819.94173043679,17.4968926748514
7.5,"greedy_SVM","SVM",19,24,27640,24531,3109,2500,2069,431,0.584363261087532,0.196683819325329,1.79360241788171,1092,431,661,35,1.5,8.29,4.8,0,0,0,0,0,0,0.1743508161735,4414.25850345234,17.4441450751773
7.5,"greedy_SVM","SVM",19,25,27540,24452,3088,2600,2148,452,0.585185143220791,0.196112064036592,1.76289802285609,1130,452,678,38,1.5,8.63,4.8,0,0,0,0,0,0,0.175764499680931,4390.16661857131,17.6039820224431
7.5,"greedy_SVM","SVM",19,26,27440,24367,3073,2700,2233,467,0.586970580224757,0.205260148656375,1.83224628613402,1175,467,708,45,1.5,8.96,4.8,0,0,0,0,0,0,0.175590657416656,3992.92854217444,17.6363225968815
7.5,"greedy_SVM","SVM",19,27,27340,24289,3051,2800,2311,489,0.587263281851327,0.200114351057747,1.88780666185827,1230,489,741,55,1.5,9.29,4.7,0,0,0,0,0,0,0.17600963410555,4325.33219294731,17.6153047113384
7.5,"greedy_SVM","SVM",19,28,27240,24203,3037,2900,2397,503,0.586996030674095,0.199542595769011,1.81047072491272,1251,503,748,21,1.5,9.62,4.8,0,0,0,0,0,0,0.177125506768035,3863.1939750528,17.7562480391045
7.5,"greedy_SVM","SVM",19,29,27140,24115,3025,3000,2485,515,0.585736383644795,0.204688393367639,1.82368760985113,1289,515,774,38,1.5,9.95,4.8,0,0,0,0,0,0,0.171814591414519,4526.08308679299,17.1870852393879
7.5,"greedy_SVM","SVM",19,30,27040,24041,2999,3100,2559,541,0.582913486755329,0.202401372212693,1.79171282268282,1367,541,826,78,1.5,10.29,4.7,0,0,0,0,0,0,0.175539169241291,4296.08732415205,17.593912369858
7.5,"greedy_SVM","SVM",19,31,26940,23957,2983,3200,2643,557,0.584238283501525,0.208118925100057,1.78569411797923,1374,557,817,7,1.5,10.62,4.7,0,0,0,0,0,0,0.17731312013681,2739.9953659957,17.8410948483331
7.5,"greedy_SVM","SVM",19,32,26840,23871,2969,3300,2729,571,0.582522845962804,0.203544882790166,1.86004085405631,1416,571,845,42,1.5,10.95,4.8,0,0,0,0,0,0,0.173496839296069,4197.84262536827,17.3667502237764
7.5,"greedy_SVM","SVM",19,33,26740,23780,2960,3400,2820,580,0.586261572765663,0.214408233276158,1.96871724842014,1451,580,871,35,1.5,11.28,4.9,0,0,0,0,0,0,0.172239496228303,3601.90143690377,17.279464095298
7.5,"greedy_SVM","SVM",19,34,26640,23709,2931,3500,2891,609,0.583405800590877,0.214408233276158,1.90303090913132,1539,609,930,88,1.5,11.61,4.7,0,0,0,0,0,0,0.17482588756161,4194.84225736415,17.4983604271495
7.5,"greedy_SVM","SVM",19,35,26540,23629,2911,3600,2971,629,0.58755851564739,0.220125786163522,1.96459797952955,1571,629,942,32,1.5,11.94,4.7,0,0,0,0,0,0,0.17521285929161,4302.90189877342,17.5641969519418
7.5,"greedy_SVM","SVM",19,36,26440,23560,2880,3700,3040,660,0.578063137543416,0.220697541452258,2.09909180230085,1642,660,982,71,1.5,12.28,4.6,0,0,0,0,0,0,0.179275956558519,4158.13582798621,18.3571533630724
7.5,"greedy_SVM","SVM",19,37,26340,23492,2848,3800,3108,692,0.581964738638473,0.213264722698685,2.01592064418768,1714,692,1022,72,1.5,12.61,4.5,0,0,0,0,0,0,0.182666329844979,4175.1147539521,18.3287961843306
7.5,"greedy_SVM","SVM",19,38,26240,23403,2837,3900,3197,703,0.583067219486476,0.220125786163522,2.11229020881717,1754,703,1051,40,1.5,12.94,4.5,0,0,0,0,0,0,0.1805494542409,4201.93425744812,18.1151665445791
7.5,"greedy_SVM","SVM",19,39,26140,23324,2816,4000,3276,724,0.580564363070531,0.213264722698685,1.89557222882839,1831,724,1107,77,1.5,13.27,4.5,0,0,0,0,0,0,0.183867603555563,3067.30509156583,18.4596425776283
7.5,"greedy_SVM","SVM",19,40,26040,23240,2800,4100,3360,740,0.582763230392483,0.21726700971984,1.96382235751452,1884,740,1144,53,1.5,13.6,4.5,0,0,0,0,0,0,0.180919502045624,4417.74780793765,18.1548298317619
7.5,"greedy_SVM","SVM",19,41,25940,23156,2784,4200,3444,756,0.579243772300797,0.217838765008576,1.97044874995789,1879,756,1123,-5,1.5,13.93,4.6,0,0,0,0,0,0,0.180403236945649,4207.4457437514,18.0635890022009
7.5,"greedy_SVM","SVM",19,42,25840,23065,2775,4300,3535,765,0.582056755102894,0.212692967409949,1.83403306726849,1921,765,1156,42,1.5,14.27,4.6,0,0,0,0,0,0,0.178338808266487,3724.6282405498,17.8642781080409
7.5,"greedy_SVM","SVM",19,43,25740,22981,2759,4400,3619,781,0.578548069461106,0.218982275586049,1.9418420183767,1932,781,1151,11,1.5,14.6,4.6,0,0,0,0,0,0,0.176903801434138,3430.39700181006,17.7428347656676
7.5,"greedy_SVM","SVM",19,44,25640,22895,2745,4500,3705,795,0.581080453548457,0.213264722698685,1.93177289052324,2001,795,1206,69,1.5,14.93,4.7,0,0,0,0,0,0,0.17678522342539,4149.95716422199,17.6973637932886
7.5,"greedy_SVM","SVM",19,45,25540,22812,2728,4600,3788,812,0.580544663650213,0.215551743853631,2.01061558986087,2053,812,1241,52,1.5,15.26,4.7,0,0,0,0,0,0,0.176878238550746,4057.15708226122,17.7082278958539
7.5,"greedy_SVM","SVM",19,46,25440,22743,2697,4700,3857,843,0.582019502168605,0.21726700971984,1.88708361053659,2084,843,1241,31,1.5,15.59,4.6,0,0,0,0,0,0,0.179351212137369,4140.14150619771,17.9507541170379
7.5,"greedy_SVM","SVM",19,47,25340,22672,2668,4800,3928,872,0.583652021885844,0.217838765008576,1.98151290983142,2127,872,1255,43,1.4,15.93,4.5,0,0,0,0,0,0,0.181627930389921,3399.15378924513,18.2274560586273
7.5,"greedy_SVM","SVM",19,48,25240,22588,2652,4900,4012,888,0.581907142511962,0.213836477987421,1.93596088891576,2216,888,1328,89,1.5,16.26,4.5,0,0,0,0,0,0,0.181121739081881,4484.72997177761,18.1183102166302
7.5,"greedy_SVM","SVM",20,0,30040,26527,3513,100,86,14,0.423616502500718,0.0828603859250851,0.728274235470233,45,14,31,0,2.2,0.33,6.1,0,0,0,0,0,0,0.147353808001996,4234.76323888358,14.7857990884244
7.5,"greedy_SVM","SVM",20,1,29940,26435,3505,200,178,22,0.566315549146205,0.188422247446084,1.5634337039361,73,22,51,28,2.3,0.66,8.1,0,0,0,0,0,0,0.139054241721366,3403.93803274573,14.4806058383326
7.5,"greedy_SVM","SVM",20,2,29840,26358,3482,300,255,45,0.551262836742894,0.170828603859251,1.72886830729104,135,45,90,62,2,1,5.7,0,0,0,0,0,0,0.151010887155989,4480.93492481199,15.1087691473317
7.5,"greedy_SVM","SVM",20,3,29740,26290,3450,400,323,77,0.511380332102683,0.129398410896708,1.1701403464129,201,77,124,66,1.6,1.33,4.2,0,0,0,0,0,0,0.219761819801596,5643.51748933515,22.3137174559715
7.5,"greedy_SVM","SVM",20,4,29640,26203,3437,500,410,90,0.500915717722865,0.106696935300795,0.85533484676504,247,90,157,46,1.7,1.66,4.6,0,0,0,0,0,0,0.248211185357569,4810.37176191014,26.3309744364509
7.5,"greedy_SVM","SVM",20,5,29540,26113,3427,600,500,100,0.510933368550841,0.126560726447219,0.992128293259976,282,100,182,35,1.8,1.99,5,0,0,0,0,0,0,0.19448271910043,4753.13555581603,19.6274978197365
7.5,"greedy_SVM","SVM",20,6,29440,26022,3418,700,591,109,0.494252585599823,0.12883087400681,1.17324691370426,306,109,197,24,1.8,2.32,5.4,0,0,0,0,0,0,0.210480146680983,4374.76733122182,26.6673150576506
7.5,"greedy_SVM","SVM",20,7,29340,25956,3384,800,657,143,0.530611640932555,0.129398410896708,1.06355121051345,375,143,232,69,1.6,2.65,4.6,0,0,0,0,0,0,0.187479801125336,5051.26737178209,19.1492583935434
7.5,"greedy_SVM","SVM",20,8,29240,25882,3358,900,731,169,0.502561570439265,0.106129398410897,0.927111197542526,426,169,257,51,1.5,2.99,4.3,0,0,0,0,0,0,0.271676258475879,4960.60626967424,28.1073106401976
7.5,"greedy_SVM","SVM",20,9,29140,25797,3343,1000,816,184,0.494381090552691,0.114074914869467,0.9042534775159,465,184,281,39,1.5,3.32,4.4,0,0,0,0,0,0,0.215622447409451,4997.78141651301,23.1365420881334
7.5,"greedy_SVM","SVM",20,10,29040,25703,3337,1100,910,190,0.494770464610969,0.117480136208854,0.94381776194763,482,190,292,17,1.5,3.65,4.8,0,0,0,0,0,0,0.186654963856621,4644.44295011037,19.1902379824652
7.5,"greedy_SVM","SVM",20,11,28940,25618,3322,1200,995,205,0.539738328351627,0.171963677639047,1.45712921084334,517,205,312,35,1.5,3.98,4.9,0,0,0,0,0,0,0.200729640172372,4228.20273691513,20.9390711739132
7.5,"greedy_SVM","SVM",20,12,28840,25551,3289,1300,1062,238,0.545604951510969,0.180476730987514,1.59334179753013,588,238,350,71,1.5,4.31,4.5,0,0,0,0,0,0,0.217287741750149,4137.03844343656,26.1960768571166
7.5,"greedy_SVM","SVM",20,13,28740,25495,3245,1400,1118,282,0.541075573022927,0.170261066969353,1.57102318793579,688,282,406,100,1.4,4.64,4,0,0,0,0,0,0,0.21843269483145,4800.30681368437,30.0843602237643
7.5,"greedy_SVM","SVM",20,14,28640,25433,3207,1500,1180,320,0.526191300826618,0.158342792281498,1.43778413349869,755,320,435,67,1.4,4.98,3.7,0,0,0,0,0,0,0.218655322010177,5379.3471501205,22.2616725424565
7.5,"greedy_SVM","SVM",20,15,28540,25346,3194,1600,1267,333,0.523170976021019,0.137911464245176,1.23778959627176,784,333,451,29,1.4,5.31,3.8,0,0,0,0,0,0,0.212625634707037,4811.75473285887,21.5828160131226
7.5,"greedy_SVM","SVM",20,16,28440,25255,3185,1700,1358,342,0.522710729146529,0.149262202043133,1.43894931522385,834,342,492,50,1.4,5.64,4,0,0,0,0,0,0,0.196994263925117,4651.55314829497,19.9235907896752
7.5,"greedy_SVM","SVM",20,17,28340,25173,3167,1800,1440,360,0.524378415125195,0.161748013620885,1.49101737743906,884,360,524,50,1.5,5.97,4,0,0,0,0,0,0,0.199277075643145,4506.46016907176,19.9926258954277
7.5,"greedy_SVM","SVM",20,18,28240,25082,3158,1900,1531,369,0.516960606910107,0.13677639046538,1.28263580277534,925,369,556,41,1.5,6.3,4.1,0,0,0,0,0,0,0.192810300943784,4339.56477652095,19.3015807889862
7.5,"greedy_SVM","SVM",20,19,28140,25011,3129,2000,1602,398,0.520256768545842,0.152099886492622,1.36293666366522,987,398,589,62,1.5,6.64,4,0,0,0,0,0,0,0.196819173832902,4618.66366234232,19.796937967535
7.5,"greedy_SVM","SVM",20,20,28040,24918,3122,2100,1695,405,0.52317583733333,0.153234960272418,1.42072567767752,1037,405,632,50,1.6,6.97,4.2,0,0,0,0,0,0,0.190437544757875,4449.3234581391,19.0718598701332
7.5,"greedy_SVM","SVM",20,21,27940,24835,3105,2200,1778,422,0.51736584419801,0.146424517593644,1.3539768638153,1071,422,649,34,1.5,7.3,4.2,0,0,0,0,0,0,0.187015184327421,4239.62402033155,18.7873726326266
7.5,"greedy_SVM","SVM",20,22,27840,24748,3092,2300,1865,435,0.526782419345499,0.158910329171396,1.51243758312101,1073,435,638,2,1.5,7.63,4.3,0,0,0,0,0,0,0.193378302281738,4308.70282244283,21.4360858501234
7.5,"greedy_SVM","SVM",20,23,27740,24661,3079,2400,1952,448,0.512777149171245,0.136208853575482,1.36883171843886,1127,448,679,54,1.5,7.96,4.4,0,0,0,0,0,0,0.183592977242762,4351.63614382635,18.399459863442
7.5,"greedy_SVM","SVM",20,24,27640,24570,3070,2500,2043,457,0.514913695928667,0.146424517593644,1.37530194621722,1148,457,691,21,1.5,8.29,4.5,0,0,0,0,0,0,0.180946972875896,4484.4613968055,18.1130719663809
7.5,"greedy_SVM","SVM",20,25,27540,24485,3055,2600,2128,472,0.515083159569849,0.140181611804767,1.38384639579886,1218,472,746,70,1.6,8.63,4.5,0,0,0,0,0,0,0.178782245360761,4161.12562531313,17.9561391483832
7.5,"greedy_SVM","SVM",20,26,27440,24406,3034,2700,2207,493,0.517606436513947,0.150964812712826,1.4450196216679,1253,493,760,35,1.5,8.96,4.5,0,0,0,0,0,0,0.179706453215736,4295.92363773946,17.9979978738063
7.5,"greedy_SVM","SVM",20,27,27340,24325,3015,2800,2288,512,0.51333573101216,0.146424517593644,1.43532217436599,1288,512,776,35,1.5,9.29,4.5,0,0,0,0,0,0,0.178312518845481,3731.69479200726,17.8951636782482
7.5,"greedy_SVM","SVM",20,28,27240,24235,3005,2900,2378,522,0.511225367112233,0.13677639046538,1.40714001491923,1299,522,777,11,1.5,9.62,4.6,0,0,0,0,0,0,0.175537583212949,3865.7702835672,17.6165764255971
7.5,"greedy_SVM","SVM",20,29,27140,24138,3002,3000,2475,525,0.513021152934414,0.140181611804767,1.44378772088216,1342,525,817,43,1.6,9.95,4.7,0,0,0,0,0,0,0.170066616110373,3646.55789008679,17.0575482715415
7.5,"greedy_SVM","SVM",20,30,27040,24056,2984,3100,2557,543,0.512315495074766,0.132803632236095,1.25871134937024,1386,543,843,44,1.6,10.29,4.7,0,0,0,0,0,0,0.170008517022604,3686.07289906338,17.0441063130921
7.5,"greedy_SVM","SVM",20,31,26940,23973,2967,3200,2640,560,0.513656961412008,0.139614074914869,1.25741533028707,1437,560,877,51,1.6,10.62,4.7,0,0,0,0,0,0,0.170170390051388,3694.10961528305,17.0501228183025
7.5,"greedy_SVM","SVM",20,32,26840,23875,2965,3300,2738,562,0.513777214926889,0.139614074914869,1.33201752164634,1422,562,860,-15,1.5,10.95,4.9,0,0,0,0,0,0,0.168530878138799,4133.88031476616,16.873066674274
7.5,"greedy_SVM","SVM",20,33,26740,23784,2956,3400,2829,571,0.508259582819233,0.135073779795687,1.34704197037868,1433,571,862,11,1.5,11.28,5,0,0,0,0,0,0,0.163477141586415,3504.75149590904,16.374880151875
7.5,"greedy_SVM","SVM",20,34,26640,23693,2947,3500,2920,580,0.509054194165417,0.136208853575482,1.29905804372165,1466,580,886,33,1.5,11.61,5,0,0,0,0,0,0,0.161857668462488,3634.31379965548,16.207373307954
7.5,"greedy_SVM","SVM",20,35,26540,23595,2945,3600,3018,582,0.508799486986568,0.133938706015891,1.2796927200096,1542,582,960,76,1.6,11.94,5.2,0,0,0,0,0,0,0.159480545346387,3782.90622424762,15.9603761930495
7.5,"greedy_SVM","SVM",20,36,26440,23498,2942,3700,3115,585,0.513440249226689,0.139046538024972,1.34859992977521,1504,585,919,-38,1.6,12.28,5.3,0,0,0,0,0,0,0.154855889768967,3457.37713239156,15.5108111046645
7.5,"greedy_SVM","SVM",20,37,26340,23413,2927,3800,3200,600,0.510769683048412,0.139046538024972,1.31307836681769,1581,600,981,77,1.6,12.61,5.3,0,0,0,0,0,0,0.15407079320174,3351.69546480756,15.443537873883
7.5,"greedy_SVM","SVM",20,38,26240,23323,2917,3900,3290,610,0.517528101156913,0.148127128263337,1.4279991020478,1618,610,1008,37,1.7,12.94,5.4,0,0,0,0,0,0,0.152277282756618,3340.96515044046,15.2560825702055
7.5,"greedy_SVM","SVM",20,39,26140,23237,2903,4000,3376,624,0.509315169878558,0.126560726447219,1.23244969292288,1600,624,976,-18,1.6,13.27,5.4,0,0,0,0,0,0,0.153920463204014,3400.53635825428,15.4045257751926
7.5,"greedy_SVM","SVM",20,40,26040,23143,2897,4100,3470,630,0.515148829929036,0.146992054483541,1.42193070369761,1616,630,986,16,1.6,13.6,5.5,0,0,0,0,0,0,0.149919479705096,3150.12426975037,15.0324965762125
7.5,"greedy_SVM","SVM",20,41,25940,23057,2883,4200,3556,644,0.515534024964463,0.149262202043133,1.52370321239555,1648,644,1004,32,1.6,13.93,5.5,0,0,0,0,0,0,0.149530291816645,3250.59026247749,14.9661098812437
7.5,"greedy_SVM","SVM",20,42,25840,22974,2866,4300,3639,661,0.513372531999159,0.14472190692395,1.41820984042657,1731,661,1070,83,1.6,14.27,5.5,0,0,0,0,0,0,0.149567882819685,3118.68330623316,14.990969007674
7.5,"greedy_SVM","SVM",20,43,25740,22885,2855,4400,3728,672,0.510164236451163,0.133371169125993,1.3015965059468,1739,672,1067,8,1.6,14.6,5.5,0,0,0,0,0,0,0.149437660425572,3021.53684587834,14.9692554829006
7.5,"greedy_SVM","SVM",20,44,25640,22798,2842,4500,3815,685,0.512280826242289,0.144154370034052,1.23556538483686,1798,685,1113,59,1.6,14.93,5.6,0,0,0,0,0,0,0.149296339238592,3129.85527399907,14.9625208752548
7.5,"greedy_SVM","SVM",20,45,25540,22709,2831,4600,3904,696,0.509854647614986,0.124858115777526,1.18079012495605,1827,696,1131,29,1.6,15.26,5.6,0,0,0,0,0,0,0.149076627227709,3262.14238836485,14.9181667191105
7.5,"greedy_SVM","SVM",20,46,25440,22612,2828,4700,4001,699,0.513055096834359,0.141316685584563,1.35013826635939,1841,699,1142,14,1.6,15.59,5.7,0,0,0,0,0,0,0.145657576641259,3130.36452064209,14.5857523969421
7.5,"greedy_SVM","SVM",20,47,25340,22521,2819,4800,4092,708,0.511971962338646,0.143586833144154,1.39464831909651,1803,708,1095,-38,1.5,15.93,5.8,0,0,0,0,0,0,0.144313706909646,3114.27264777675,14.4529557457509
7.5,"greedy_SVM","SVM",20,48,25240,22434,2806,4900,4179,721,0.50473035537302,0.125993189557321,1.30562821362226,1918,721,1197,115,1.7,16.26,5.8,0,0,0,0,0,0,0.142971094877238,2974.43829846415,14.3368333928373
7.5,"eps_greedy_SVM","SVM",1,0,30040,26573,3467,100,90,10,0.558458064304523,0.16832229580574,1.55436155885987,31,10,21,0,2.1,0.33,9,0,0,0,0,0,0,0.157773724712891,3009.97385058155,18.1507934823021
7.5,"eps_greedy_SVM","SVM",1,1,29940,26493,3447,200,170,30,0.529345659169076,0.178256070640177,1.90545078877941,79,30,49,48,1.6,0.66,5.7,0,0,0,0,0,0,0.538030144592128,3779.6798223891,65.1893163178494
7.5,"eps_greedy_SVM","SVM",1,2,29840,26429,3411,300,234,66,0.496124336886749,0.107615894039735,0.864525228069342,170,66,104,91,1.6,1,3.5,0,0,0,0,0,0,0.22116255585527,6575.79198428065,22.139897648326
7.5,"eps_greedy_SVM","SVM",1,3,29740,26342,3398,400,321,79,0.483346519428596,0.13355408388521,1.11747701427414,202,79,123,32,1.6,1.33,4.1,0,0,0,0,0,0,0.227488315539406,5645.29412452227,23.5679024422264
7.5,"eps_greedy_SVM","SVM",1,4,29640,26248,3392,500,415,85,0.475454716334961,0.150110375275938,1.48391238507088,231,85,146,29,1.7,1.66,4.9,0,0,0,0,0,0,0.190552510381164,4404.37720322894,21.5713204315667
7.5,"eps_greedy_SVM","SVM",1,5,29540,26174,3366,600,489,111,0.488166936299012,0.153421633554084,1.45590586990381,271,111,160,40,1.4,1.99,4.4,0,0,0,0,0,0,0.197912566275573,5075.64199480324,20.6185877849392
7.5,"eps_greedy_SVM","SVM",1,6,29440,26092,3348,700,571,129,0.482839554023616,0.120860927152318,1.11241511662238,305,129,176,34,1.4,2.32,4.4,0,0,0,0,0,0,0.221892059354627,4479.17755844475,25.0813867613428
7.5,"eps_greedy_SVM","SVM",1,7,29340,26002,3338,800,661,139,0.477493607990375,0.124724061810155,1.17135101684078,345,139,206,40,1.5,2.65,4.8,0,0,0,0,0,0,0.182877973369726,4379.85849030702,18.5347801876139
7.5,"eps_greedy_SVM","SVM",1,8,29240,25911,3329,900,752,148,0.481823791811537,0.127483443708609,1.07817226718993,359,148,211,14,1.4,2.99,5.1,0,0,0,0,0,0,0.16935056204701,4288.58432707593,17.1550229757568
7.5,"eps_greedy_SVM","SVM",1,9,29140,25822,3318,1000,841,159,0.479919050361396,0.119205298013245,1.21431539176913,393,159,234,34,1.5,3.32,5.3,0,0,0,0,0,0,0.164199919371031,4080.23668789237,17.2596028143242
7.5,"eps_greedy_SVM","SVM",1,10,29040,25735,3305,1100,928,172,0.487976428855769,0.129690949227373,1.1672156204883,425,172,253,32,1.5,3.65,5.4,0,0,0,0,0,0,0.155549894424107,4075.56507586212,15.5827789765816
7.5,"eps_greedy_SVM","SVM",1,11,28940,25660,3280,1200,1003,197,0.482735788444418,0.127483443708609,1.16487122228064,465,197,268,40,1.4,3.98,5.1,0,0,0,0,0,0,0.180248026052929,4365.17211115449,19.4052995127598
7.5,"eps_greedy_SVM","SVM",1,12,28840,25575,3265,1300,1088,212,0.510663630201958,0.165011037527594,1.3567274122086,508,212,296,43,1.4,4.31,5.1,0,0,0,0,0,0,0.168429221174767,3877.84776387836,17.0738534014106
7.5,"eps_greedy_SVM","SVM",1,13,28740,25497,3243,1400,1166,234,0.513467465224588,0.155629139072848,1.48391238507088,562,234,328,54,1.4,4.64,5,0,0,0,0,0,0,0.169509685070835,4416.57937053678,17.3513493100707
7.5,"eps_greedy_SVM","SVM",1,14,28640,25404,3236,1500,1259,241,0.510049069922437,0.157284768211921,1.45879852755915,576,241,335,14,1.4,4.98,5.2,0,0,0,0,0,0,0.162441265534818,3509.3867295211,16.4514924060779
7.5,"eps_greedy_SVM","SVM",1,15,28540,25320,3220,1600,1343,257,0.510155166377057,0.159492273730684,1.45699687917794,627,257,370,51,1.4,5.31,5.2,0,0,0,0,0,0,0.16073968482112,3558.0389705879,16.1326328733482
7.5,"eps_greedy_SVM","SVM",1,16,28440,25231,3209,1700,1432,268,0.509806700500993,0.162251655629139,1.43352038224802,645,268,377,18,1.4,5.64,5.3,0,0,0,0,0,0,0.157511987898729,3838.74445923263,15.7863703030886
7.5,"eps_greedy_SVM","SVM",1,17,28340,25143,3197,1800,1520,280,0.509139862015506,0.153973509933775,1.35175061461188,680,280,400,35,1.4,5.97,5.4,0,0,0,0,0,0,0.155053415689433,3713.34628113396,15.552235594588
7.5,"eps_greedy_SVM","SVM",1,18,28240,25059,3181,1900,1604,296,0.50840426270498,0.157284768211921,1.39347919050426,717,296,421,37,1.4,6.3,5.4,0,0,0,0,0,0,0.15501009107702,3415.91910835821,15.547777411172
7.5,"eps_greedy_SVM","SVM",1,19,28140,24971,3169,2000,1692,308,0.506746302690483,0.149558498896247,1.37276302535417,751,308,443,34,1.4,6.64,5.5,0,0,0,0,0,0,0.152904687451946,3622.26106104327,15.3300784371896
7.5,"eps_greedy_SVM","SVM",1,20,28040,24889,3151,2100,1774,326,0.509473968034045,0.149558498896247,1.3923606426598,783,326,457,32,1.4,6.97,5.4,0,0,0,0,0,0,0.154417066063269,3677.1379619802,15.5265808134987
7.5,"eps_greedy_SVM","SVM",1,21,27940,24809,3131,2200,1854,346,0.508488632070817,0.150110375275938,1.38743853773594,825,346,479,42,1.4,7.3,5.4,0,0,0,0,0,0,0.156164362001072,3515.1016317563,15.6864528972218
7.5,"eps_greedy_SVM","SVM",1,22,27840,24722,3118,2300,1941,359,0.50894789777513,0.152869757174393,1.38010400409937,878,359,519,53,1.4,7.63,5.4,0,0,0,0,0,0,0.154407235937537,3881.6239389426,15.4576975842416
7.5,"eps_greedy_SVM","SVM",1,23,27740,24636,3104,2400,2027,373,0.508368716854745,0.150110375275938,1.35193332241281,910,373,537,32,1.4,7.96,5.4,0,0,0,0,0,0,0.155557672059364,3696.72765887603,15.5704028898884
7.5,"eps_greedy_SVM","SVM",1,24,27640,24543,3097,2500,2120,380,0.51047308113595,0.152869757174393,1.38622148638705,924,380,544,14,1.4,8.29,5.6,0,0,0,0,0,0,0.151089091142486,3768.71311303173,15.1209513791179
7.5,"eps_greedy_SVM","SVM",1,25,27540,24454,3086,2600,2209,391,0.513240204870632,0.160596026490066,1.4180604957917,953,391,562,29,1.4,8.63,5.6,0,0,0,0,0,0,0.149681707836538,3765.09725704799,14.9837353224583
7.5,"eps_greedy_SVM","SVM",1,26,27440,24371,3069,2700,2292,408,0.512856026653231,0.163907284768212,1.41071303208293,994,408,586,41,1.4,8.96,5.6,0,0,0,0,0,0,0.15039795378703,3238.3158103051,15.0726686765487
7.5,"eps_greedy_SVM","SVM",1,27,27340,24282,3058,2800,2381,419,0.51402329576795,0.16832229580574,1.44243581758652,1050,419,631,56,1.5,9.29,5.7,0,0,0,0,0,0,0.149001382615123,3624.64368259751,14.9044186579773
7.5,"eps_greedy_SVM","SVM",1,28,27240,24195,3045,2900,2468,432,0.516050949273985,0.167770419426049,1.50092643332401,1059,432,627,9,1.5,9.62,5.7,0,0,0,0,0,0,0.148198629518264,3645.34849400021,14.823227041895
7.5,"eps_greedy_SVM","SVM",1,29,27140,24108,3032,3000,2555,445,0.517387581462018,0.165562913907285,1.52460504268731,1116,445,671,57,1.5,9.95,5.7,0,0,0,0,0,0,0.14881833768439,3510.14684454757,14.883797932624
7.5,"eps_greedy_SVM","SVM",1,30,27040,24035,3005,3100,2628,472,0.51621918853236,0.167770419426049,1.37767210277057,1136,472,664,20,1.4,10.29,5.6,0,0,0,0,0,0,0.151554447706602,3418.71129668131,15.1625874464836
7.5,"eps_greedy_SVM","SVM",1,31,26940,23959,2981,3200,2704,496,0.519489198640033,0.171081677704194,1.42896840446947,1219,496,723,83,1.5,10.62,5.5,0,0,0,0,0,0,0.154338120516058,3481.6767723879,15.4418425396064
7.5,"eps_greedy_SVM","SVM",1,32,26840,23873,2967,3300,2790,510,0.518741944952381,0.169426048565121,1.48087273740224,1268,510,758,49,1.5,10.95,5.5,0,0,0,0,0,0,0.154589769103597,3481.62017498539,15.4756599824639
7.5,"eps_greedy_SVM","SVM",1,33,26740,23790,2950,3400,2873,527,0.521757848015931,0.166666666666667,1.45001220965442,1282,527,755,14,1.4,11.28,5.5,0,0,0,0,0,0,0.154516016211544,3609.61748088568,15.4639668884747
7.5,"eps_greedy_SVM","SVM",1,34,26640,23703,2937,3500,2960,540,0.522729240349389,0.166114790286976,1.46949274175306,1340,540,800,58,1.5,11.61,5.5,0,0,0,0,0,0,0.153796692859971,3753.84353104896,15.383846872556
7.5,"eps_greedy_SVM","SVM",1,35,26540,23623,2917,3600,3040,560,0.522914503322916,0.167770419426049,1.48236854294945,1336,560,776,-4,1.4,11.94,5.4,0,0,0,0,0,0,0.154844036914715,3628.40046579372,15.4904550659956
7.5,"eps_greedy_SVM","SVM",1,36,26440,23541,2899,3700,3122,578,0.522706306200114,0.166666666666667,1.50032378036287,1371,578,793,35,1.4,12.28,5.4,0,0,0,0,0,0,0.155530565915535,3459.61923258761,15.5653738436643
7.5,"eps_greedy_SVM","SVM",1,37,26340,23453,2887,3800,3210,590,0.524240438457645,0.166114790286976,1.47945408193166,1428,590,838,57,1.4,12.61,5.4,0,0,0,0,0,0,0.154179319311622,3618.65886031011,15.4350134454759
7.5,"eps_greedy_SVM","SVM",1,38,26240,23361,2879,3900,3302,598,0.522386643284659,0.16832229580574,1.49304065521547,1431,598,833,3,1.4,12.94,5.5,0,0,0,0,0,0,0.152682826400197,3782.1418212446,15.2715813238866
7.5,"eps_greedy_SVM","SVM",1,39,26140,23278,2862,4000,3385,615,0.521566466494421,0.165562913907285,1.40946791908021,1472,615,857,41,1.4,13.27,5.5,0,0,0,0,0,0,0.15305049378124,3273.74952966683,15.4507046717436
7.5,"eps_greedy_SVM","SVM",1,40,26040,23185,2855,4100,3478,622,0.522446413590203,0.163907284768212,1.51157777532284,1463,622,841,-9,1.4,13.6,5.6,0,0,0,0,0,0,0.150995206636251,3744.05038028721,15.1033918549665
7.5,"eps_greedy_SVM","SVM",1,41,25940,23093,2847,4200,3570,630,0.522983347393508,0.163355408388521,1.37276302535417,1498,630,868,35,1.4,13.93,5.7,0,0,0,0,0,0,0.149140496404288,3360.89838611703,14.9313920671672
7.5,"eps_greedy_SVM","SVM",1,42,25840,23005,2835,4300,3658,642,0.528494619090832,0.16832229580574,1.46222840861715,1548,642,906,50,1.4,14.27,5.7,0,0,0,0,0,0,0.147953432756513,3044.0139661398,14.8055387615541
7.5,"eps_greedy_SVM","SVM",1,43,25740,22926,2814,4400,3737,663,0.523255435476627,0.16280353200883,1.47751510247493,1593,663,930,45,1.4,14.6,5.6,0,0,0,0,0,0,0.149148736584361,3286.98715279723,14.9540300165176
7.5,"eps_greedy_SVM","SVM",1,44,25640,22840,2800,4500,3823,677,0.522523873575321,0.163355408388521,1.41182452175568,1630,677,953,37,1.4,14.93,5.6,0,0,0,0,0,0,0.14757513928206,3071.62047937099,14.8066705016316
7.5,"eps_greedy_SVM","SVM",1,45,25540,22753,2787,4600,3910,690,0.521925962405982,0.166114790286976,1.4755367277871,1665,690,975,35,1.4,15.26,5.7,0,0,0,0,0,0,0.149043285278195,3108.4865623263,15.0515201529459
7.5,"eps_greedy_SVM","SVM",1,46,25440,22676,2764,4700,3987,713,0.527506619269981,0.172185430463576,1.4144616052417,1700,713,987,35,1.4,15.59,5.6,0,0,0,0,0,0,0.150612664145442,3342.52493645687,15.0780150149622
7.5,"eps_greedy_SVM","SVM",1,47,25340,22588,2752,4800,4075,725,0.526321119379615,0.171081677704194,1.39232818897025,1765,725,1040,65,1.4,15.93,5.6,0,0,0,0,0,0,0.14998384238036,3196.44475645201,15.015483210899
7.5,"eps_greedy_SVM","SVM",1,48,25240,22503,2737,4900,4160,740,0.523820381407809,0.171081677704194,1.49682426455623,1777,740,1037,12,1.4,16.26,5.6,0,0,0,0,0,0,0.150426706215071,3505.81777936322,15.0584031213029
7.5,"eps_greedy_SVM","SVM",2,0,30040,26556,3484,100,85,15,0.392620701056113,0.0692737430167598,0.592177763448877,49,15,34,0,2.3,0.33,5.7,0,0,0,0,0,0,0.164657626460328,4581.90324311115,16.6118371305642
7.5,"eps_greedy_SVM","SVM",2,1,29940,26490,3450,200,151,49,0.593110963324353,0.170949720670391,1.4924543494896,117,49,68,68,1.4,0.66,3.1,0,0,0,0,0,0,0.253910183849523,7301.77099844237,25.42836109463
7.5,"eps_greedy_SVM","SVM",2,2,29840,26422,3418,300,219,81,0.57296629494229,0.143016759776536,1.24345712638422,194,81,113,77,1.4,1,2.7,0,0,0,0,0,0,0.28573138906172,8007.14444797245,28.7715287901987
7.5,"eps_greedy_SVM","SVM",2,3,29740,26328,3412,400,313,87,0.544018274520785,0.133519553072626,1.14367476947194,218,87,131,24,1.5,1.33,3.6,0,0,0,0,0,0,0.283251578161218,6471.64963096724,28.6978833836582
7.5,"eps_greedy_SVM","SVM",2,4,29640,26254,3386,500,387,113,0.54698685356786,0.136871508379888,1.05621633527563,270,113,157,52,1.4,1.66,3.4,0,0,0,0,0,0,0.263537112626661,6561.10164530371,27.4801331093076
7.5,"eps_greedy_SVM","SVM",2,5,29540,26173,3367,600,468,132,0.53678001799521,0.126256983240223,1.08615230919104,322,132,190,52,1.4,1.99,3.5,0,0,0,0,0,0,0.289352861875894,6212.0787756148,30.5189686004396
7.5,"eps_greedy_SVM","SVM",2,6,29440,26084,3356,700,557,143,0.553560574416598,0.132402234636872,1.09198139135128,352,143,209,30,1.5,2.32,3.9,0,0,0,0,0,0,0.301958439368514,5433.54999852855,30.6590285578704
7.5,"eps_greedy_SVM","SVM",2,7,29340,26001,3339,800,640,160,0.559033255808384,0.149162011173184,1.22614850572219,400,160,240,48,1.5,2.65,4,0,0,0,0,0,0,0.256945878713733,4842.48485875902,27.3654074467798
7.5,"eps_greedy_SVM","SVM",2,8,29240,25918,3322,900,723,177,0.556159364051391,0.167597765363128,1.30635218077511,436,177,259,36,1.5,2.99,4.1,0,0,0,0,0,0,0.29629612368517,4383.16490274072,34.0583758989632
7.5,"eps_greedy_SVM","SVM",2,9,29140,25832,3308,1000,809,191,0.574780833206091,0.192737430167598,1.66145847299814,471,191,280,35,1.5,3.32,4.2,0,0,0,0,0,0,0.235874578163818,4588.04781811082,26.1270792450513
7.5,"eps_greedy_SVM","SVM",2,10,29040,25749,3291,1100,892,208,0.576804011611503,0.208379888268156,1.9997360934983,522,208,314,51,1.5,3.65,4.3,0,0,0,0,0,0,0.215328083729901,4243.4215631194,22.6688116422085
7.5,"eps_greedy_SVM","SVM",2,11,28940,25692,3248,1200,949,251,0.571720511387086,0.195530726256983,1.47137820686663,591,251,340,69,1.4,3.98,3.8,0,0,0,0,0,0,0.515770057919369,4047.86347897878,58.5994419573326
7.5,"eps_greedy_SVM","SVM",2,12,28840,25608,3232,1300,1033,267,0.575012482653639,0.204469273743017,1.92701038634039,629,267,362,38,1.4,4.31,3.9,0,0,0,0,0,0,0.253262936383325,4070.77632221504,29.2645409544723
7.5,"eps_greedy_SVM","SVM",2,13,28740,25523,3217,1400,1118,282,0.58194640219846,0.19608938547486,1.93612630128221,663,282,381,34,1.4,4.64,4,0,0,0,0,0,0,0.245544424672059,3874.63315387808,27.4419163011183
7.5,"eps_greedy_SVM","SVM",2,14,28640,25438,3202,1500,1203,297,0.596336178158485,0.219553072625698,2.13641522900106,703,297,406,40,1.4,4.98,4.1,0,0,0,0,0,0,0.202083812472384,5335.23013382069,21.2480899227185
7.5,"eps_greedy_SVM","SVM",2,15,28540,25365,3175,1600,1276,324,0.586761951273276,0.216201117318436,1.98763985003631,752,324,428,49,1.3,5.31,3.9,0,0,0,0,0,0,0.216130096835888,5146.57794520674,22.9819721043457
7.5,"eps_greedy_SVM","SVM",2,16,28440,25301,3139,1700,1340,360,0.587965291702892,0.21340782122905,2.07524195452042,833,360,473,81,1.3,5.64,3.7,0,0,0,0,0,0,0.265324547954956,5076.7570254897,29.25249669793
7.5,"eps_greedy_SVM","SVM",2,17,28340,25219,3121,1800,1422,378,0.582563152552539,0.201117318435754,1.96606319521206,889,378,511,56,1.4,5.97,3.8,0,0,0,0,0,0,0.214229380936116,5521.24624500326,21.5748840188856
7.5,"eps_greedy_SVM","SVM",2,18,28240,25132,3108,1900,1509,391,0.579757952197017,0.193854748603352,1.94585226567349,915,391,524,26,1.3,6.3,3.9,0,0,0,0,0,0,0.20691512546552,5416.62199752002,20.7853344459951
7.5,"eps_greedy_SVM","SVM",2,19,28140,25047,3093,2000,1594,406,0.583779532991016,0.201117318435754,2.00963600402512,957,406,551,42,1.4,6.64,3.9,0,0,0,0,0,0,0.205960534348108,5013.52961440577,20.9930878321829
7.5,"eps_greedy_SVM","SVM",2,20,28040,24984,3056,2100,1657,443,0.585528324371487,0.210614525139665,2.08804916201117,1031,443,588,74,1.3,6.97,3.7,0,0,0,0,0,0,0.218716139525327,5313.28124260874,22.0266247747174
7.5,"eps_greedy_SVM","SVM",2,21,27940,24907,3033,2200,1734,466,0.585345259473041,0.205027932960894,2.00785441182297,1086,466,620,55,1.3,7.3,3.7,0,0,0,0,0,0,0.210903299575338,5535.14938777692,21.1014491438842
7.5,"eps_greedy_SVM","SVM",2,22,27840,24839,3001,2300,1802,498,0.579289521427462,0.198324022346369,2.0021652382109,1154,498,656,68,1.3,7.63,3.6,0,0,0,0,0,0,0.217075736115744,5541.13875645963,22.1743931617188
7.5,"eps_greedy_SVM","SVM",2,23,27740,24764,2976,2400,1877,523,0.582931133189394,0.207262569832402,2.04517512579738,1203,523,680,49,1.3,7.96,3.6,0,0,0,0,0,0,0.218054806656896,5142.69877075185,21.8655772304754
7.5,"eps_greedy_SVM","SVM",2,24,27640,24693,2947,2500,1948,552,0.581915863339032,0.199441340782123,1.99292612623321,1264,552,712,61,1.3,8.29,3.5,0,0,0,0,0,0,0.220354264388117,5271.48811971482,22.079628707165
7.5,"eps_greedy_SVM","SVM",2,25,27540,24608,2932,2600,2033,567,0.582159963891787,0.198324022346369,2.02099103869049,1311,567,744,47,1.3,8.63,3.6,0,0,0,0,0,0,0.219233525573184,5001.2078127622,21.9839043906045
7.5,"eps_greedy_SVM","SVM",2,26,27440,24544,2896,2700,2097,603,0.581814950496336,0.199441340782123,2.01142076068944,1377,603,774,66,1.3,8.96,3.5,0,0,0,0,0,0,0.223998306277305,4811.73648728772,22.4835832326449
7.5,"eps_greedy_SVM","SVM",2,27,27340,24474,2866,2800,2167,633,0.583895000166154,0.198324022346369,2.02457753565356,1458,633,825,81,1.3,9.29,3.4,0,0,0,0,0,0,0.225921987758246,5506.14319222092,22.7649299613018
7.5,"eps_greedy_SVM","SVM",2,28,27240,24387,2853,2900,2254,646,0.58582559450873,0.198324022346369,2.02637556188416,1488,646,842,30,1.3,9.62,3.5,0,0,0,0,0,0,0.220112896637493,4836.79160789597,22.2122822531525
7.5,"eps_greedy_SVM","SVM",2,29,27140,24305,2835,3000,2336,664,0.5790378913212,0.202793296089385,2.08995998256666,1526,664,862,38,1.3,9.95,3.5,0,0,0,0,0,0,0.22045912538109,5119.72590062,22.1379523789221
7.5,"eps_greedy_SVM","SVM",2,30,27040,24229,2811,3100,2412,688,0.582337728657609,0.2,2.05645721065902,1575,688,887,49,1.3,10.29,3.5,0,0,0,0,0,0,0.22120917050084,5069.77584031652,22.2170562397922
7.5,"eps_greedy_SVM","SVM",2,31,26940,24141,2799,3200,2500,700,0.581222681707257,0.198882681564246,2.08626093834973,1623,700,923,48,1.3,10.62,3.6,0,0,0,0,0,0,0.217963509610516,5538.99394506178,21.8128705575762
7.5,"eps_greedy_SVM","SVM",2,32,26840,24049,2791,3300,2592,708,0.584236353946218,0.197206703910615,2.1460139714419,1621,708,913,-2,1.3,10.95,3.7,0,0,0,0,0,0,0.213423886265844,4277.63691175057,21.419996521129
7.5,"eps_greedy_SVM","SVM",2,33,26740,23967,2773,3400,2674,726,0.583813773530375,0.200558659217877,2.00607597567433,1670,726,944,49,1.3,11.28,3.7,0,0,0,0,0,0,0.212762951548775,4982.41113315596,21.3121888077646
7.5,"eps_greedy_SVM","SVM",2,34,26640,23878,2762,3500,2763,737,0.581733597666933,0.198882681564246,2.05463894610494,1687,737,950,17,1.3,11.61,3.7,0,0,0,0,0,0,0.210109984144357,4930.45347472785,21.0468990314767
7.5,"eps_greedy_SVM","SVM",2,35,26540,23789,2751,3600,2852,748,0.580525461879204,0.198882681564246,2.02457753565356,1734,748,986,47,1.3,11.94,3.8,0,0,0,0,0,0,0.207007273747713,5198.18476247004,20.7163694868813
7.5,"eps_greedy_SVM","SVM",2,36,26440,23700,2740,3700,2941,759,0.582366879387061,0.199441340782123,1.88175523619638,1741,759,982,7,1.3,12.28,3.9,0,0,0,0,0,0,0.205036242150412,4531.34280536966,20.5451269649726
7.5,"eps_greedy_SVM","SVM",2,37,26340,23611,2729,3800,3030,770,0.584103934759578,0.201117318435754,2.10674279526493,1785,770,1015,44,1.3,12.61,3.9,0,0,0,0,0,0,0.202363791526541,5153.11775555115,20.2430679103106
7.5,"eps_greedy_SVM","SVM",2,38,26240,23523,2717,3900,3118,782,0.579596214022724,0.202234636871508,1.97670001528547,1811,782,1029,26,1.3,12.94,4,0,0,0,0,0,0,0.198417976462545,3906.39457242829,19.9028564224791
7.5,"eps_greedy_SVM","SVM",2,39,26140,23434,2706,4000,3207,793,0.578070575051765,0.197765363128492,2.00750909560826,1834,793,1041,23,1.3,13.27,4,0,0,0,0,0,0,0.197362415777512,4146.2002361104,19.9360852389432
7.5,"eps_greedy_SVM","SVM",2,40,26040,23355,2685,4100,3286,814,0.576591080886336,0.2,1.77762648794836,1908,814,1094,74,1.3,13.6,4,0,0,0,0,0,0,0.197304127488036,3908.36841409546,19.7684479364886
7.5,"eps_greedy_SVM","SVM",2,41,25940,23266,2674,4200,3375,825,0.579418491321447,0.201117318435754,1.88919300392838,1951,825,1126,43,1.4,13.93,4.1,0,0,0,0,0,0,0.195510950951313,4806.1508799761,19.5617397028064
7.5,"eps_greedy_SVM","SVM",2,42,25840,23175,2665,4300,3466,834,0.576248633428096,0.198324022346369,1.81802738913334,1972,834,1138,21,1.4,14.27,4.2,0,0,0,0,0,0,0.192697310293063,4176.23688551352,19.31283876237
7.5,"eps_greedy_SVM","SVM",2,43,25740,23081,2659,4400,3560,840,0.576054211102602,0.201675977653631,1.84783111682405,1989,840,1149,17,1.4,14.6,4.2,0,0,0,0,0,0,0.187877592704424,3782.82731375718,18.8524100727159
7.5,"eps_greedy_SVM","SVM",2,44,25640,22991,2649,4500,3650,850,0.574227432056309,0.197765363128492,1.93088417132216,2023,850,1173,34,1.4,14.93,4.3,0,0,0,0,0,0,0.188358154525802,4714.53207030268,18.8426624094405
7.5,"eps_greedy_SVM","SVM",2,45,25540,22901,2639,4600,3740,860,0.569891629113547,0.198324022346369,1.80526004493131,2062,860,1202,39,1.4,15.26,4.3,0,0,0,0,0,0,0.18500531542682,4289.12089996519,18.5498567570012
7.5,"eps_greedy_SVM","SVM",2,46,25440,22814,2626,4700,3827,873,0.573878590787278,0.199441340782123,1.66598077657101,2105,873,1232,43,1.4,15.59,4.4,0,0,0,0,0,0,0.182629832832797,3931.92696147839,18.3267249318513
7.5,"eps_greedy_SVM","SVM",2,47,25340,22733,2607,4800,3908,892,0.572193611321081,0.194413407821229,1.78437545083252,2168,892,1276,63,1.4,15.93,4.4,0,0,0,0,0,0,0.182098762357051,3910.65950849924,18.2958463833023
7.5,"eps_greedy_SVM","SVM",2,48,25240,22663,2577,4900,3978,922,0.570551705948647,0.202793296089385,1.9937145920214,2255,922,1333,87,1.4,16.26,4.3,0,0,0,0,0,0,0.188823215270141,3959.82045151345,18.8898955027324
7.5,"eps_greedy_SVM","SVM",3,0,30040,26569,3471,100,84,16,0.47723098300019,0.0965593784683685,0.756192135320811,48,16,32,0,2,0.33,5.2,0,0,0,0,0,0,0.372454327789485,5033.72810755521,41.4308361453978
7.5,"eps_greedy_SVM","SVM",3,1,29940,26474,3466,200,179,21,0.519443774591983,0.143729189789123,1.28269761336891,75,21,54,27,2.6,0.66,8.5,0,0,0,0,0,0,0.118657339452101,3130.60536822925,12.0045120455353
7.5,"eps_greedy_SVM","SVM",3,2,29840,26391,3449,300,262,38,0.501917548508957,0.133185349611543,1.12699443486748,128,38,90,53,2.4,1,6.9,0,0,0,0,0,0,0.141550289251137,3735.33581351853,14.3618370037146
7.5,"eps_greedy_SVM","SVM",3,3,29740,26305,3435,400,348,52,0.47869480231016,0.1165371809101,1.12211337432668,153,52,101,25,1.9,1.33,6.7,0,0,0,0,0,0,0.175985286104313,3857.39310760425,26.2692460594303
7.5,"eps_greedy_SVM","SVM",3,4,29640,26230,3410,500,423,77,0.470151611380629,0.123196448390677,1.17447866512859,206,77,129,53,1.7,1.66,5.5,0,0,0,0,0,0,0.197563964840614,4372.09890113131,20.8141836159642
7.5,"eps_greedy_SVM","SVM",3,5,29540,26170,3370,600,483,117,0.445416824859191,0.107103218645949,1.04355872290314,293,117,176,87,1.5,1.99,4.1,0,0,0,0,0,0,0.220972803711157,5237.93011906175,23.1712225336584
7.5,"eps_greedy_SVM","SVM",3,6,29440,26094,3346,700,559,141,0.481962037307253,0.139289678135405,1.33547173771634,337,141,196,44,1.4,2.32,4,0,0,0,0,0,0,0.217543157972299,5126.49956799956,23.0649623332007
7.5,"eps_greedy_SVM","SVM",3,7,29340,26010,3330,800,643,157,0.517138785093122,0.162597114317425,1.60073725516181,376,157,219,39,1.4,2.65,4.1,0,0,0,0,0,0,0.362950789104204,4615.45033570375,39.5057175512392
7.5,"eps_greedy_SVM","SVM",3,8,29240,25940,3300,900,713,187,0.462813402079016,0.121531631520533,1.06974808352477,453,187,266,77,1.4,2.99,3.8,0,0,0,0,0,0,0.215564418581348,5172.65162100924,23.3554497617321
7.5,"eps_greedy_SVM","SVM",3,9,29140,25850,3290,1000,803,197,0.460284621913383,0.121531631520533,1.01738279272285,477,197,280,24,1.4,3.32,4.1,0,0,0,0,0,0,0.204714691536007,4911.6905185685,20.6262397318049
7.5,"eps_greedy_SVM","SVM",3,10,29040,25774,3266,1100,879,221,0.481173730396781,0.160377358490566,1.62644044034728,527,221,306,50,1.4,3.65,4,0,0,0,0,0,0,0.260823683820695,4617.40624322489,30.0608504910716
7.5,"eps_greedy_SVM","SVM",3,11,28940,25703,3237,1200,950,250,0.47789373962443,0.140399556048835,1.27765267155117,596,250,346,69,1.4,3.98,3.8,0,0,0,0,0,0,0.214646548168841,4818.34569684164,22.4542225292534
7.5,"eps_greedy_SVM","SVM",3,12,28840,25627,3213,1300,1026,274,0.487388804143142,0.143729189789123,1.20748277919721,650,274,376,54,1.4,4.31,3.7,0,0,0,0,0,0,0.279844369368277,4510.19901553926,39.4254050561338
7.5,"eps_greedy_SVM","SVM",3,13,28740,25542,3198,1400,1111,289,0.493320448745667,0.132075471698113,1.16016736842003,693,289,404,43,1.4,4.64,3.8,0,0,0,0,0,0,0.207706303319468,5173.68224997673,20.9407006013786
7.5,"eps_greedy_SVM","SVM",3,14,28640,25452,3188,1500,1201,299,0.497446795661429,0.137624861265261,1.22536497154775,722,299,423,29,1.4,4.98,4,0,0,0,0,0,0,0.199157718437471,4526.77551467631,20.3624213459979
7.5,"eps_greedy_SVM","SVM",3,15,28540,25364,3176,1600,1289,311,0.51059812541127,0.137624861265261,1.21533015289212,752,311,441,30,1.4,5.31,4.1,0,0,0,0,0,0,0.192670946008967,4483.27918424139,19.9199264734742
7.5,"eps_greedy_SVM","SVM",3,16,28440,25286,3154,1700,1367,333,0.510027335835472,0.157602663706992,1.3623446847676,799,333,466,47,1.4,5.64,4.1,0,0,0,0,0,0,0.194615050270024,4361.10381940947,19.9689223063672
7.5,"eps_greedy_SVM","SVM",3,17,28340,25195,3145,1800,1458,342,0.507992392371998,0.15149833518313,1.31978272712582,807,342,465,8,1.4,5.97,4.3,0,0,0,0,0,0,0.187942614195968,4185.97171471955,18.8249328797856
7.5,"eps_greedy_SVM","SVM",3,18,28240,25105,3135,1900,1548,352,0.510151715099717,0.155382907880133,1.33171852408571,839,352,487,32,1.4,6.3,4.4,0,0,0,0,0,0,0.181688690151455,4178.33783139726,18.218834598582
7.5,"eps_greedy_SVM","SVM",3,19,28140,25022,3118,2000,1631,369,0.509693385457195,0.145948945615982,1.34076666211431,896,369,527,57,1.4,6.64,4.4,0,0,0,0,0,0,0.181324112456985,4129.86602850216,18.1707819580378
7.5,"eps_greedy_SVM","SVM",3,20,28040,24931,3109,2100,1722,378,0.50912828370249,0.149278579356271,1.34777415337971,915,378,537,19,1.4,6.97,4.6,0,0,0,0,0,0,0.176885346885033,4149.08156517586,17.7004612567491
7.5,"eps_greedy_SVM","SVM",3,21,27940,24852,3088,2200,1801,399,0.511849613341081,0.156492785793563,1.4884792716854,960,399,561,45,1.4,7.3,4.5,0,0,0,0,0,0,0.177198190370273,3880.55695521411,17.7653290040999
7.5,"eps_greedy_SVM","SVM",3,22,27840,24763,3077,2300,1890,410,0.513438271959652,0.154827968923418,1.3482323056067,973,410,563,13,1.4,7.63,4.6,0,0,0,0,0,0,0.175085665631424,3693.0060486902,17.5319243927668
7.5,"eps_greedy_SVM","SVM",3,23,27740,24673,3067,2400,1980,420,0.510437151709828,0.147613762486127,1.32707434440276,997,420,577,24,1.4,7.96,4.7,0,0,0,0,0,0,0.169899462763742,3653.9582044688,17.1168565870936
7.5,"eps_greedy_SVM","SVM",3,24,27640,24594,3046,2500,2059,441,0.511860528938925,0.148723640399556,1.34871274589243,1040,441,599,43,1.4,8.29,4.7,0,0,0,0,0,0,0.172075094803209,4221.04188877777,17.2539454879249
7.5,"eps_greedy_SVM","SVM",3,25,27540,24507,3033,2600,2146,454,0.510138415635689,0.145948945615982,1.37310948034522,1073,454,619,33,1.4,8.63,4.7,0,0,0,0,0,0,0.17052725132543,3554.12115090356,17.0700893615035
7.5,"eps_greedy_SVM","SVM",3,26,27440,24421,3019,2700,2232,468,0.507916631431457,0.142064372918979,1.25668945846009,1116,468,648,43,1.4,8.96,4.8,0,0,0,0,0,0,0.170143094872005,3508.59968840639,17.044028475798
7.5,"eps_greedy_SVM","SVM",3,27,27340,24333,3007,2800,2320,480,0.511331812510346,0.149833518312986,1.38657777907588,1121,480,641,5,1.3,9.29,4.8,0,0,0,0,0,0,0.166412822024447,3426.75872873286,16.8937244287542
7.5,"eps_greedy_SVM","SVM",3,28,27240,24244,2996,2900,2409,491,0.51198055869292,0.157602663706992,1.41939040752515,1181,491,690,60,1.4,9.62,4.9,0,0,0,0,0,0,0.16414611078528,3271.5835209532,16.4494777762168
7.5,"eps_greedy_SVM","SVM",3,29,27140,24160,2980,3000,2493,507,0.50977464601887,0.155382907880133,1.31249110984888,1198,507,691,17,1.4,9.95,4.9,0,0,0,0,0,0,0.16537219316087,3351.73810205318,16.8474404484419
7.5,"eps_greedy_SVM","SVM",3,30,27040,24074,2966,3100,2579,521,0.508813529720413,0.149833518312986,1.33405282474143,1245,521,724,47,1.4,10.29,5,0,0,0,0,0,0,0.163762507694886,3232.80415940349,16.4167850630272
7.5,"eps_greedy_SVM","SVM",3,31,26940,23989,2951,3200,2664,536,0.508318563818484,0.1503884572697,1.29918213850845,1300,536,764,55,1.4,10.62,5,0,0,0,0,0,0,0.164213453362386,3880.88115908233,16.4442497592162
7.5,"eps_greedy_SVM","SVM",3,32,26840,23912,2928,3300,2741,559,0.508533069953755,0.158157602663707,1.26984851038114,1335,559,776,35,1.4,10.95,4.9,0,0,0,0,0,0,0.164903659898472,3517.04139938181,16.5189626678507
7.5,"eps_greedy_SVM","SVM",3,33,26740,23842,2898,3400,2811,589,0.510798077416097,0.163706992230855,1.4579882813064,1443,589,854,108,1.4,11.28,4.8,0,0,0,0,0,0,0.170140883515957,3680.82748207467,17.0396283146791
7.5,"eps_greedy_SVM","SVM",3,34,26640,23752,2888,3500,2901,599,0.510881554555113,0.149278579356271,1.3524866504195,1456,599,857,13,1.4,11.61,4.8,0,0,0,0,0,0,0.167961117627008,3823.74351503281,16.8946883629295
7.5,"eps_greedy_SVM","SVM",3,35,26540,23658,2882,3600,2995,605,0.509336851083391,0.159822419533851,1.39148574754338,1478,605,873,22,1.4,11.94,5,0,0,0,0,0,0,0.164054235990371,3438.90614233448,16.4366076248821
7.5,"eps_greedy_SVM","SVM",3,36,26440,23574,2866,3700,3079,621,0.510904891350492,0.164261931187569,1.48360951599672,1519,621,898,41,1.4,12.28,5,0,0,0,0,0,0,0.164745220127795,3399.52889225472,16.5025019529428
7.5,"eps_greedy_SVM","SVM",3,37,26340,23498,2842,3800,3155,645,0.507994818060403,0.148168701442841,1.31405450348378,1606,645,961,87,1.5,12.61,4.9,0,0,0,0,0,0,0.165083669012562,3400.31978808827,16.550679132757
7.5,"eps_greedy_SVM","SVM",3,38,26240,23403,2837,3900,3250,650,0.509161699651429,0.158157602663707,1.36353243078745,1609,650,959,3,1.5,12.94,5,0,0,0,0,0,0,0.161267006591934,3360.99278192713,16.1437059668406
7.5,"eps_greedy_SVM","SVM",3,39,26140,23317,2823,4000,3336,664,0.510781076686131,0.159822419533851,1.38059266130595,1647,664,983,38,1.5,13.27,5,0,0,0,0,0,0,0.161353672276193,3165.69175634951,16.1715030512364
7.5,"eps_greedy_SVM","SVM",3,40,26040,23227,2813,4100,3426,674,0.51028136396292,0.160932297447281,1.41803033154242,1676,674,1002,29,1.5,13.6,5.1,0,0,0,0,0,0,0.160043798045135,3252.48860134409,16.0316450133638
7.5,"eps_greedy_SVM","SVM",3,41,25940,23144,2796,4200,3509,691,0.508474100632107,0.157047724750277,1.30340026233478,1691,691,1000,15,1.4,13.93,5.1,0,0,0,0,0,0,0.160236090326881,3400.93769818863,16.05822126378
7.5,"eps_greedy_SVM","SVM",3,42,25840,23061,2779,4300,3592,708,0.511836272054838,0.165926748057714,1.4289735891411,1767,708,1059,76,1.5,14.27,5.1,0,0,0,0,0,0,0.160967938095232,3668.11288801846,16.1138770858683
7.5,"eps_greedy_SVM","SVM",3,43,25740,22975,2765,4400,3678,722,0.514611970571549,0.172586015538291,1.49685309594224,1806,722,1084,39,1.5,14.6,5.1,0,0,0,0,0,0,0.15966332952552,3311.05347229833,16.0012343980794
7.5,"eps_greedy_SVM","SVM",3,44,25640,22894,2746,4500,3759,741,0.509992121531335,0.159267480577137,1.44724653766347,1849,741,1108,43,1.5,14.93,5.1,0,0,0,0,0,0,0.159769102571826,3197.05587300123,16.0044984126493
7.5,"eps_greedy_SVM","SVM",3,45,25540,22807,2733,4600,3846,754,0.509759757310714,0.155937846836848,1.30359048420611,1924,754,1170,75,1.6,15.26,5.1,0,0,0,0,0,0,0.159320582710806,3274.09784734208,15.9650820835044
7.5,"eps_greedy_SVM","SVM",3,46,25440,22718,2722,4700,3935,765,0.513188007831461,0.168701442841287,1.52063363939058,1957,765,1192,33,1.6,15.59,5.1,0,0,0,0,0,0,0.158113710965207,3208.080142536,15.8442828025223
7.5,"eps_greedy_SVM","SVM",3,47,25340,22631,2709,4800,4022,778,0.512539638048809,0.169811320754717,1.49911523883316,1985,778,1207,28,1.6,15.93,5.2,0,0,0,0,0,0,0.158505147496407,3192.01927755019,15.8656816350136
7.5,"eps_greedy_SVM","SVM",3,48,25240,22540,2700,4900,4113,787,0.509407363336088,0.160932297447281,1.33613534376504,2015,787,1228,30,1.6,16.26,5.2,0,0,0,0,0,0,0.157064792060754,3213.43583099713,15.7406745428295
7.5,"eps_greedy_SVM","SVM",4,0,30040,26552,3488,100,91,9,0.521074347553334,0.146205357142857,1.17500066151566,33,9,24,0,2.7,0.33,10.1,0,0,0,0,0,0,0.154085261197261,2557.20554563419,15.9632207811215
7.5,"eps_greedy_SVM","SVM",4,1,29940,26459,3481,200,184,16,0.46776279494072,0.117745535714286,1.00834193092963,63,16,47,30,2.9,0.66,11.5,0,0,0,0,0,0,0.104019412601189,2245.03945600425,11.4526472428264
7.5,"eps_greedy_SVM","SVM",4,2,29840,26372,3468,300,271,29,0.487317284171838,0.11328125,0.910222635286225,102,29,73,39,2.5,1,9.3,0,0,0,0,0,0,0.118507955921869,2734.69430546698,12.395105211356
7.5,"eps_greedy_SVM","SVM",4,3,29740,26295,3445,400,348,52,0.515378634733416,0.11328125,0.912671664798206,161,52,109,59,2.1,1.33,6.7,0,0,0,0,0,0,0.140230874428934,3880.04527664388,14.1249198298233
7.5,"eps_greedy_SVM","SVM",4,4,29640,26208,3432,500,435,65,0.484197553972169,0.129464285714286,1.20145089285714,191,65,126,30,1.9,1.66,6.7,0,0,0,0,0,0,0.132791170002298,3847.49091410032,13.3142037348673
7.5,"eps_greedy_SVM","SVM",4,5,29540,26127,3413,600,516,84,0.475919050655977,0,0.882500700672646,234,84,150,43,1.8,1.99,6.1,0,0,0,0,0,0,0.189365508049976,4148.81486899969,19.5996817824177
7.5,"eps_greedy_SVM","SVM",4,6,29440,26063,3377,700,580,120,0.496030819170708,0.126116071428571,1.28581944444444,308,120,188,74,1.6,2.32,4.8,0,0,0,0,0,0,0.195394207301567,4907.54088342892,20.4123457198448
7.5,"eps_greedy_SVM","SVM",4,7,29340,25995,3345,800,648,152,0.503142612227415,0.113839285714286,0.945386269109712,372,152,220,64,1.4,2.65,4.3,0,0,0,0,0,0,0.280733033032806,5118.37539742252,33.5607101380836
7.5,"eps_greedy_SVM","SVM",4,8,29240,25910,3330,900,733,167,0.527990561258109,0.125558035714286,1.0568912934492,414,167,247,42,1.5,2.99,4.4,0,0,0,0,0,0,0.202518944685983,5259.62514104446,20.832739218083
7.5,"eps_greedy_SVM","SVM",4,9,29140,25844,3296,1000,799,201,0.535788773123249,0.118303571428571,0.914311685759209,484,201,283,70,1.4,3.32,4,0,0,0,0,0,0,0.233994859063156,5676.71996261539,24.3918482577708
7.5,"eps_greedy_SVM","SVM",4,10,29040,25754,3286,1100,889,211,0.514360689172213,0.116629464285714,0.997815148305085,511,211,300,27,1.4,3.65,4.2,0,0,0,0,0,0,0.203840432521678,5303.70235363903,20.6983106597745
7.5,"eps_greedy_SVM","SVM",4,11,28940,25673,3267,1200,970,230,0.560762583812519,0.198102678571429,1.68501357491135,562,230,332,51,1.4,3.98,4.2,0,0,0,0,0,0,0.217296003043757,4815.7041540997,22.275216274587
7.5,"eps_greedy_SVM","SVM",4,12,28840,25597,3243,1300,1046,254,0.546987897277388,0.174665178571429,1.70257962478185,623,254,369,61,1.5,4.31,4.1,0,0,0,0,0,0,0.213118154404963,5236.74945179974,22.2319403464807
7.5,"eps_greedy_SVM","SVM",4,13,28740,25510,3230,1400,1133,267,0.52493348873221,0.165736607142857,1.39176922013274,668,267,401,45,1.5,4.64,4.2,0,0,0,0,0,0,0.193323350316197,5286.46752943687,19.4138551494368
7.5,"eps_greedy_SVM","SVM",4,14,28640,25422,3218,1500,1221,279,0.517945414113857,0.14453125,1.25815338379341,701,279,422,33,1.5,4.98,4.4,0,0,0,0,0,0,0.186425335762894,5101.32733613715,18.7507755364504
7.5,"eps_greedy_SVM","SVM",4,15,28540,25338,3202,1600,1305,295,0.54223772279404,0.171875,1.49200477162401,737,295,442,36,1.5,5.31,4.4,0,0,0,0,0,0,0.189295231236507,4948.14882665344,19.3519815949804
7.5,"eps_greedy_SVM","SVM",4,16,28440,25271,3169,1700,1372,328,0.534888032291857,0.155691964285714,1.4226872246696,808,328,480,71,1.5,5.64,4.2,0,0,0,0,0,0,0.19430631095767,5254.43154121936,19.4989702162689
7.5,"eps_greedy_SVM","SVM",4,17,28340,25185,3155,1800,1458,342,0.531784397255861,0.159040178571429,1.56999411152498,858,342,516,50,1.5,5.97,4.3,0,0,0,0,0,0,0.189957765863276,5339.7016714015,19.0020262982711
7.5,"eps_greedy_SVM","SVM",4,18,28240,25093,3147,1900,1550,350,0.538821387724171,0.166852678571429,1.46456546833773,888,350,538,30,1.5,6.3,4.4,0,0,0,0,0,0,0.183663970349742,4880.30248313381,18.3800189216
7.5,"eps_greedy_SVM","SVM",4,19,28140,24999,3141,2000,1644,356,0.543105895082729,0.167410714285714,1.65980176211454,898,356,542,10,1.5,6.64,4.6,0,0,0,0,0,0,0.178745535754871,4444.56850776535,17.8996634569679
7.5,"eps_greedy_SVM","SVM",4,20,28040,24905,3135,2100,1738,362,0.546469826316792,0.174665178571429,1.65999590611354,937,362,575,39,1.6,6.97,4.8,0,0,0,0,0,0,0.172482891042271,4644.52030316645,17.25508098859
7.5,"eps_greedy_SVM","SVM",4,21,27940,24838,3102,2200,1805,395,0.538331766961529,0.165736607142857,1.32170146510097,993,395,598,56,1.5,7.3,4.6,0,0,0,0,0,0,0.179311344886803,4408.72140422279,17.9497465511375
7.5,"eps_greedy_SVM","SVM",4,22,27840,24746,3094,2300,1897,403,0.539990997634556,0.1640625,1.49891283472344,1038,403,635,45,1.6,7.63,4.7,0,0,0,0,0,0,0.174995345494525,4393.38275523585,17.5284819211156
7.5,"eps_greedy_SVM","SVM",4,23,27740,24662,3078,2400,1981,419,0.537859670176058,0.161272321428571,1.41403155259683,1079,419,660,41,1.6,7.96,4.7,0,0,0,0,0,0,0.173578096280197,4362.94677140093,17.3750101294803
7.5,"eps_greedy_SVM","SVM",4,24,27640,24579,3061,2500,2064,436,0.538770832941114,0.166852678571429,1.52911931818182,1127,436,691,48,1.6,8.29,4.7,0,0,0,0,0,0,0.173458576657756,4558.16477941624,17.3622562396421
7.5,"eps_greedy_SVM","SVM",4,25,27540,24488,3052,2600,2155,445,0.53892644753935,0.161272321428571,1.41769095697981,1131,445,686,4,1.5,8.63,4.8,0,0,0,0,0,0,0.170867075756782,4651.19086539672,17.0927437152178
7.5,"eps_greedy_SVM","SVM",4,26,27440,24401,3039,2700,2242,458,0.538882826704084,0.161272321428571,1.42632702658172,1162,458,704,31,1.5,8.96,4.9,0,0,0,0,0,0,0.169719416276916,4099.19970093098,16.9888984516737
7.5,"eps_greedy_SVM","SVM",4,27,27340,24319,3021,2800,2324,476,0.543177083613494,0.168526785714286,1.38563807819383,1239,476,763,77,1.6,9.29,4.9,0,0,0,0,0,0,0.170477653990901,4362.6016403131,17.0592133440477
7.5,"eps_greedy_SVM","SVM",4,28,27240,24240,3000,2900,2403,497,0.537963427249533,0.164620535714286,1.47288200525394,1301,497,804,62,1.6,9.62,4.8,0,0,0,0,0,0,0.170208599839373,4204.40217420186,17.0499698148754
7.5,"eps_greedy_SVM","SVM",4,29,27140,24148,2992,3000,2495,505,0.541778401282097,0.172433035714286,1.54186197916667,1327,505,822,26,1.6,9.95,4.9,0,0,0,0,0,0,0.167370980717053,4045.17889760596,16.7507302358033
7.5,"eps_greedy_SVM","SVM",4,30,27040,24058,2982,3100,2585,515,0.539642955478844,0.168526785714286,1.44446449978204,1361,515,846,34,1.6,10.29,5,0,0,0,0,0,0,0.165039666842046,3791.81311842886,16.5427089679597
7.5,"eps_greedy_SVM","SVM",4,31,26940,23971,2969,3200,2672,528,0.536318778878843,0.165736607142857,1.42507476404741,1416,528,888,55,1.7,10.62,5.1,0,0,0,0,0,0,0.163994591587569,3982.20826492317,16.4321700258725
7.5,"eps_greedy_SVM","SVM",4,32,26840,23877,2963,3300,2766,534,0.536478595869685,0.1640625,1.48108061393805,1379,534,845,-37,1.6,10.95,5.2,0,0,0,0,0,0,0.161325132628116,3964.05179022813,16.1482246380307
7.5,"eps_greedy_SVM","SVM",4,33,26740,23787,2953,3400,2856,544,0.542462971037781,0.168526785714286,1.44977187774846,1422,544,878,43,1.6,11.28,5.2,0,0,0,0,0,0,0.15965481943087,3902.58336789131,15.9721553766396
7.5,"eps_greedy_SVM","SVM",4,34,26640,23703,2937,3500,2940,560,0.543977891548686,0.169084821428571,1.48761082530648,1476,560,916,54,1.6,11.61,5.2,0,0,0,0,0,0,0.159335342244094,3693.11837924202,15.985906161906
7.5,"eps_greedy_SVM","SVM",4,35,26540,23619,2921,3600,3024,576,0.538192499670533,0.172433035714286,1.42143485915493,1533,576,957,57,1.7,11.94,5.2,0,0,0,0,0,0,0.160023415652694,4004.9774046988,16.0194448838084
7.5,"eps_greedy_SVM","SVM",4,36,26440,23545,2895,3700,3098,602,0.54055626146413,0.174665178571429,1.49579064952049,1555,602,953,22,1.6,12.28,5.1,0,0,0,0,0,0,0.161828067723279,3863.65544806213,16.209459376178
7.5,"eps_greedy_SVM","SVM",4,37,26340,23458,2882,3800,3185,615,0.541406027273191,0.172433035714286,1.49628546779141,1616,615,1001,61,1.6,12.61,5.2,0,0,0,0,0,0,0.160696641820337,3922.52168824494,16.0863692108227
7.5,"eps_greedy_SVM","SVM",4,38,26240,23373,2867,3900,3270,630,0.545322573135081,0.170758928571429,1.57598374562172,1607,630,977,-9,1.6,12.94,5.2,0,0,0,0,0,0,0.161081739599538,4131.96616924747,16.1136816350421
7.5,"eps_greedy_SVM","SVM",4,39,26140,23300,2840,4000,3343,657,0.540319078425387,0.174107142857143,1.60577525610288,1673,657,1016,66,1.5,13.27,5.1,0,0,0,0,0,0,0.163445546628738,3889.85615714426,16.3683791889693
7.5,"eps_greedy_SVM","SVM",4,40,26040,23228,2812,4100,3415,685,0.541609675218926,0.167410714285714,1.59451816027337,1764,685,1079,91,1.6,13.6,5,0,0,0,0,0,0,0.166123811082074,3956.55919948105,16.6355767805202
7.5,"eps_greedy_SVM","SVM",4,41,25940,23142,2798,4200,3501,699,0.537247045381806,0.164620535714286,1.43964246724891,1780,699,1081,16,1.5,13.93,5,0,0,0,0,0,0,0.165448829745001,3818.08697999499,16.5647658772917
7.5,"eps_greedy_SVM","SVM",4,42,25840,23054,2786,4300,3589,711,0.541720114096639,0.172433035714286,1.47546600877193,1823,711,1112,43,1.6,14.27,5,0,0,0,0,0,0,0.164833410472961,4084.22877338813,16.5100614337759
7.5,"eps_greedy_SVM","SVM",4,43,25740,22962,2778,4400,3681,719,0.540928677496955,0.171316964285714,1.49283968585237,1859,719,1140,36,1.6,14.6,5.1,0,0,0,0,0,0,0.162357123778234,3929.26000912586,16.247140349284
7.5,"eps_greedy_SVM","SVM",4,44,25640,22879,2761,4500,3764,736,0.535693210715363,0.172991071428571,1.53853342128408,1936,736,1200,77,1.6,14.93,5.1,0,0,0,0,0,0,0.163474902002314,4056.1521019086,16.3626505965767
7.5,"eps_greedy_SVM","SVM",4,45,25540,22790,2750,4600,3853,747,0.537186572952188,0.168526785714286,1.51972998903509,1905,747,1158,-31,1.6,15.26,5.2,0,0,0,0,0,0,0.161492365251616,3735.31616036699,16.1645812748112
7.5,"eps_greedy_SVM","SVM",4,46,25440,22702,2738,4700,3941,759,0.535478300357434,0.175223214285714,1.57322852928322,1941,759,1182,36,1.6,15.59,5.2,0,0,0,0,0,0,0.160948262997046,3859.37475170003,16.1383170905367
7.5,"eps_greedy_SVM","SVM",4,47,25340,22613,2727,4800,4030,770,0.536274107445425,0.171316964285714,1.479359058927,1943,770,1173,2,1.5,15.93,5.2,0,0,0,0,0,0,0.160176082785322,4007.43012562488,16.0196975907489
7.5,"eps_greedy_SVM","SVM",4,48,25240,22531,2709,4900,4112,788,0.535817265345122,0.176897321428571,1.64226343585814,2018,788,1230,75,1.6,16.26,5.2,0,0,0,0,0,0,0.160472325553698,3960.54602428573,16.0516398263819
7.5,"eps_greedy_SVM","SVM",5,0,30040,26491,3549,100,87,13,0.45900690420449,0.0903300521134916,0.858743793812909,45,13,32,0,2.5,0.33,6.7,0,0,0,0,0,0,0.140924006608667,3917.23224647033,14.1410588337234
7.5,"eps_greedy_SVM","SVM",5,1,29940,26404,3536,200,174,26,0.571933658921156,0.196873190503764,1.98474360879524,64,26,38,19,1.5,0.66,6.7,0,0,0,0,0,0,0.452246675941724,3272.70621758451,56.397076292914
7.5,"eps_greedy_SVM","SVM",5,2,29840,26345,3495,300,233,67,0.550987937212477,0.18297625940938,1.59023233281944,157,67,90,93,1.3,1,3.5,0,0,0,0,0,0,0.239948975175828,6568.09006419228,24.347093056235
7.5,"eps_greedy_SVM","SVM",5,3,29740,26255,3485,400,323,77,0.567870623883058,0.194557035321367,1.74067621212723,183,77,106,26,1.4,1.33,4.2,0,0,0,0,0,0,0.198551170033515,5630.06936127167,20.0853783500199
7.5,"eps_greedy_SVM","SVM",5,4,29640,26177,3463,500,401,99,0.571495995155238,0.201505500868558,2.00973768832704,234,99,135,51,1.4,1.66,4.1,0,0,0,0,0,0,0.220877588656043,5253.65899556856,22.5826730570216
7.5,"eps_greedy_SVM","SVM",5,5,29540,26111,3429,600,467,133,0.549192153225885,0.190503763752171,1.7669432844043,306,133,173,72,1.3,1.99,3.5,0,0,0,0,0,0,0.239365994358511,5656.36644644097,24.6231590406463
7.5,"eps_greedy_SVM","SVM",5,6,29440,26028,3412,700,550,150,0.540163548084515,0.154603358425014,1.51802432582787,347,150,197,41,1.3,2.32,3.7,0,0,0,0,0,0,0.214380507862132,6193.6719297152,21.4932533613294
7.5,"eps_greedy_SVM","SVM",5,7,29340,25947,3393,800,631,169,0.559247050824893,0.206716850028952,1.92825633465914,387,169,218,40,1.3,2.65,3.7,0,0,0,0,0,0,0.244041992958227,5270.60638138848,25.7614962726866
7.5,"eps_greedy_SVM","SVM",5,8,29240,25876,3364,900,702,198,0.551106660994312,0.184713375796178,1.73142549709378,453,198,255,66,1.3,2.99,3.5,0,0,0,0,0,0,0.222634076662367,6248.88955887698,22.372025940335
7.5,"eps_greedy_SVM","SVM",5,9,29140,25791,3349,1000,787,213,0.553287993519482,0.204979733642154,2.02091853838418,493,213,280,40,1.3,3.32,3.7,0,0,0,0,0,0,0.225865413650454,4119.52379639929,24.0998552221081
7.5,"eps_greedy_SVM","SVM",5,10,29040,25706,3334,1100,872,228,0.545392080950178,0.161551823972206,1.30708187404503,529,228,301,36,1.3,3.65,3.8,0,0,0,0,0,0,0.21723919049762,4441.85242222167,22.2216127455716
7.5,"eps_greedy_SVM","SVM",5,11,28940,25622,3318,1200,956,244,0.557248230078356,0.173711638679792,1.67466480993663,556,244,312,27,1.3,3.98,3.9,0,0,0,0,0,0,0.198196969323904,4142.37787581754,20.6563853477453
7.5,"eps_greedy_SVM","SVM",5,12,28840,25543,3297,1300,1035,265,0.557310889852108,0.176027793862189,1.59363677541988,611,265,346,55,1.3,4.31,3.9,0,0,0,0,0,0,0.194977074019951,3978.061220367,20.1539786315487
7.5,"eps_greedy_SVM","SVM",5,13,28740,25462,3278,1400,1116,284,0.560519556271599,0.171974522292994,1.73464051425946,665,284,381,54,1.3,4.64,3.9,0,0,0,0,0,0,0.20090630371483,5426.625892134,20.1100196928854
7.5,"eps_greedy_SVM","SVM",5,14,28640,25394,3246,1500,1184,316,0.560903629441546,0.177764910248987,1.72397969719915,721,316,405,56,1.3,4.98,3.7,0,0,0,0,0,0,0.207923708569149,5403.43925927002,20.8078036304805
7.5,"eps_greedy_SVM","SVM",5,15,28540,25311,3229,1600,1267,333,0.562248471344521,0.178922987840185,1.79577321960782,766,333,433,45,1.3,5.31,3.8,0,0,0,0,0,0,0.200129492011801,3939.96771168053,20.058072757754
7.5,"eps_greedy_SVM","SVM",5,16,28440,25237,3203,1700,1341,359,0.561247260153659,0.178343949044586,1.86179680974534,830,359,471,64,1.3,5.64,3.7,0,0,0,0,0,0,0.204873842769402,4409.74970517163,20.5382153958288
7.5,"eps_greedy_SVM","SVM",5,17,28340,25163,3177,1800,1415,385,0.563835794421788,0.187029530978576,1.96045478840789,880,385,495,50,1.3,5.97,3.7,0,0,0,0,0,0,0.208047058677498,4539.24912281764,20.8721092439092
7.5,"eps_greedy_SVM","SVM",5,18,28240,25083,3157,1900,1495,405,0.559076255208923,0.179502026635785,1.81551844218318,939,405,534,59,1.3,6.3,3.7,0,0,0,0,0,0,0.210310798385432,5344.39377237793,21.0485483100252
7.5,"eps_greedy_SVM","SVM",5,19,28140,24995,3145,2000,1583,417,0.56174754030013,0.185292414591778,1.8672838023379,952,417,535,13,1.3,6.64,3.8,0,0,0,0,0,0,0.19901730874165,3628.53674935244,19.9823415024045
7.5,"eps_greedy_SVM","SVM",5,20,28040,24928,3112,2100,1650,450,0.563034452287613,0.186450492182976,1.8852090894968,1017,450,567,65,1.3,6.97,3.7,0,0,0,0,0,0,0.20853946817137,4497.48054141016,22.4085391550472
7.5,"eps_greedy_SVM","SVM",5,21,27940,24852,3088,2200,1726,474,0.564951390074968,0.190503763752171,1.98711726412942,1072,474,598,55,1.3,7.3,3.6,0,0,0,0,0,0,0.209716463082999,4559.12111321509,22.0332780062153
7.5,"eps_greedy_SVM","SVM",5,22,27840,24771,3069,2300,1807,493,0.564248941032469,0.185292414591778,1.9536239354866,1118,493,625,46,1.3,7.63,3.7,0,0,0,0,0,0,0.211966978588704,5373.24264593932,21.2276657832791
7.5,"eps_greedy_SVM","SVM",5,23,27740,24691,3049,2400,1887,513,0.563405073567089,0.18355529820498,1.89511386579889,1164,513,651,46,1.3,7.96,3.7,0,0,0,0,0,0,0.207201760274872,3775.63178811355,20.7651511019394
7.5,"eps_greedy_SVM","SVM",5,24,27640,24611,3029,2500,1967,533,0.566782669695163,0.189924724956572,2.04484373013968,1219,533,686,55,1.3,8.29,3.7,0,0,0,0,0,0,0.211037173573029,5061.93704906707,21.1200078926147
7.5,"eps_greedy_SVM","SVM",5,25,27540,24525,3015,2600,2053,547,0.565478400429624,0.188187608569774,1.95951868722985,1231,547,684,12,1.3,8.63,3.8,0,0,0,0,0,0,0.207188787959125,4583.3238719275,20.7379267025032
7.5,"eps_greedy_SVM","SVM",5,26,27440,24436,3004,2700,2142,558,0.56587141259777,0.192240880138969,1.98576029005452,1252,558,694,21,1.2,8.96,3.8,0,0,0,0,0,0,0.205701167905395,5473.48667181195,20.5725344915848
7.5,"eps_greedy_SVM","SVM",5,27,27340,24354,2986,2800,2224,576,0.56497759956482,0.190503763752171,1.96882723459545,1299,576,723,47,1.3,9.29,3.9,0,0,0,0,0,0,0.200084913203206,4141.32034994267,20.0271775492598
7.5,"eps_greedy_SVM","SVM",5,28,27240,24264,2976,2900,2314,586,0.566920182730484,0.189924724956572,2.00918664417588,1322,586,736,23,1.3,9.62,3.9,0,0,0,0,0,0,0.195198600982134,3469.24070246038,19.5760099413377
7.5,"eps_greedy_SVM","SVM",5,29,27140,24173,2967,3000,2405,595,0.566758065753535,0.191082802547771,1.99749385558702,1349,595,754,27,1.3,9.95,4,0,0,0,0,0,0,0.196568221545474,4903.70460017134,19.6635165001006
7.5,"eps_greedy_SVM","SVM",5,30,27040,24075,2965,3100,2503,597,0.565787403372037,0.188766647365373,1.94432861988698,1330,597,733,-19,1.2,10.29,4.2,0,0,0,0,0,0,0.185892932187372,3447.96167727897,18.6236862897711
7.5,"eps_greedy_SVM","SVM",5,31,26940,23986,2954,3200,2592,608,0.565328173188145,0.188766647365373,1.90801403816007,1368,608,760,38,1.2,10.62,4.3,0,0,0,0,0,0,0.187266669003097,4259.87365074646,18.7391591054047
7.5,"eps_greedy_SVM","SVM",5,32,26840,23896,2944,3300,2682,618,0.565528302604007,0.188766647365373,1.93422821147199,1377,618,759,9,1.2,10.95,4.3,0,0,0,0,0,0,0.184839979434175,4433.92845115219,18.4946950319831
7.5,"eps_greedy_SVM","SVM",5,33,26740,23808,2932,3400,2770,630,0.56568833670759,0.188187608569774,1.93081898682334,1401,630,771,24,1.2,11.28,4.4,0,0,0,0,0,0,0.178882530409252,3452.66805661839,17.9184976055309
7.5,"eps_greedy_SVM","SVM",5,34,26640,23712,2928,3500,2866,634,0.562738467303756,0.18297625940938,1.74230863572026,1426,634,792,25,1.2,11.61,4.5,0,0,0,0,0,0,0.174485673028817,2888.92627341985,17.5098775716451
7.5,"eps_greedy_SVM","SVM",5,35,26540,23622,2918,3600,2956,644,0.566120749896906,0.189345686160973,1.97226323325967,1436,644,792,10,1.2,11.94,4.6,0,0,0,0,0,0,0.17417068324816,3441.64163294305,17.4417379351635
7.5,"eps_greedy_SVM","SVM",5,36,26440,23531,2909,3700,3047,653,0.563564369986348,0.18355529820498,1.78018491040983,1476,653,823,40,1.3,12.28,4.7,0,0,0,0,0,0,0.16943562420923,2966.7732848352,16.9970872813768
7.5,"eps_greedy_SVM","SVM",5,37,26340,23443,2897,3800,3135,665,0.564451283501282,0.187608569774175,1.82247242540987,1510,665,845,34,1.3,12.61,4.7,0,0,0,0,0,0,0.16754418873219,3027.95282035751,16.7968404060257
7.5,"eps_greedy_SVM","SVM",5,38,26240,23349,2891,3900,3229,671,0.562824732975637,0.185292414591778,1.68756620108181,1557,671,886,47,1.3,12.94,4.8,0,0,0,0,0,0,0.166706261600252,3221.84629141886,16.6973432381967
7.5,"eps_greedy_SVM","SVM",5,39,26140,23254,2886,4000,3324,676,0.563815009081328,0.184134337000579,1.83639988922736,1532,676,856,-25,1.3,13.27,4.9,0,0,0,0,0,0,0.161999377481236,2858.10492651109,16.2395546327871
7.5,"eps_greedy_SVM","SVM",5,40,26040,23169,2871,4100,3409,691,0.562081581116111,0.182397220613781,1.66476125241855,1609,691,918,77,1.3,13.6,4.9,0,0,0,0,0,0,0.162736123238489,3052.69624186001,16.3265426076366
7.5,"eps_greedy_SVM","SVM",5,41,25940,23085,2855,4200,3493,707,0.564480118279438,0.188187608569774,1.68903748809235,1618,707,911,9,1.3,13.93,4.9,0,0,0,0,0,0,0.162602430108479,2989.2507283015,16.3039530211646
7.5,"eps_greedy_SVM","SVM",5,42,25840,23000,2840,4300,3578,722,0.562624343200601,0.182397220613781,1.62726725327197,1670,722,948,52,1.3,14.27,5,0,0,0,0,0,0,0.164771336560722,3158.81521790481,16.4915705274658
7.5,"eps_greedy_SVM","SVM",5,43,25740,22911,2829,4400,3667,733,0.560740904959877,0.175448755066589,1.63483593817091,1690,733,957,20,1.3,14.6,5,0,0,0,0,0,0,0.162830539833303,3042.62196835372,16.309792012629
7.5,"eps_greedy_SVM","SVM",5,44,25640,22829,2811,4500,3749,751,0.561796270858238,0.181239143022583,1.63483593817091,1746,751,995,56,1.3,14.93,5,0,0,0,0,0,0,0.162883755940526,3350.21004571349,16.304073212563
7.5,"eps_greedy_SVM","SVM",5,45,25540,22750,2790,4600,3828,772,0.560145637109307,0.171974522292994,1.4884490533593,1776,772,1004,30,1.3,15.26,5,0,0,0,0,0,0,0.161816226690058,2840.91164180193,16.2199447881476
7.5,"eps_greedy_SVM","SVM",5,46,25440,22665,2775,4700,3913,787,0.563782984903333,0.184713375796178,1.76197541543776,1832,787,1045,56,1.3,15.59,5,0,0,0,0,0,0,0.161436957151014,2784.3827034231,16.1883374732118
7.5,"eps_greedy_SVM","SVM",5,47,25340,22581,2759,4800,3997,803,0.563126011929308,0.178922987840185,1.59837879189989,1856,803,1053,24,1.3,15.93,5,0,0,0,0,0,0,0.166388050274116,4065.8126810418,16.6424787168665
7.5,"eps_greedy_SVM","SVM",5,48,25240,22501,2739,4900,4077,823,0.562520546677889,0.180081065431384,1.58392884579101,1915,823,1092,59,1.3,16.26,5,0,0,0,0,0,0,0.16369526354,3154.88942329551,16.3926141293017
7.5,"eps_greedy_SVM","SVM",6,0,30040,26506,3534,100,91,9,0.576072437885362,0.177548682703322,1.66024364046966,30,9,21,0,2.3,0.33,10.1,0,0,0,0,0,0,0.277591882141658,2827.34368003539,29.2067489085634
7.5,"eps_greedy_SVM","SVM",6,1,29940,26438,3502,200,159,41,0.551991472333436,0.127720504009164,1.10388017066159,104,41,63,74,1.5,0.66,3.9,0,0,0,0,0,0,0.252551670979997,6000.99700817523,25.6234072156187
7.5,"eps_greedy_SVM","SVM",6,2,29840,26347,3493,300,250,50,0.568664349926614,0.18213058419244,1.67191160232397,151,50,101,47,2,1,5,0,0,0,0,0,0,0.192252235795732,4901.05812290346,19.5925773858976
7.5,"eps_greedy_SVM","SVM",6,3,29740,26263,3477,400,334,66,0.579090496852625,0.191867124856816,1.82284974351312,177,66,111,26,1.7,1.33,5.1,0,0,0,0,0,0,0.252049671685196,4476.38898497081,32.7068273262987
7.5,"eps_greedy_SVM","SVM",6,4,29640,26201,3439,500,396,104,0.556219071627668,0.176975945017182,1.74316595594435,241,104,137,64,1.3,1.66,3.8,0,0,0,0,0,0,0.314714565355118,4693.77653447823,33.6362084813982
7.5,"eps_greedy_SVM","SVM",6,5,29540,26134,3406,600,463,137,0.533543043439956,0.163802978235968,1.54301716185668,311,137,174,70,1.3,1.99,3.4,0,0,0,0,0,0,0.270954899104682,5785.03154338903,28.4313624071376
7.5,"eps_greedy_SVM","SVM",6,6,29440,26063,3377,700,534,166,0.531709595129256,0.134020618556701,1.19350410215065,382,166,216,71,1.3,2.32,3.2,0,0,0,0,0,0,0.245587225108264,6020.85044619312,24.6539635846336
7.5,"eps_greedy_SVM","SVM",6,7,29340,25975,3365,800,622,178,0.523484566170006,0.115120274914089,1.12120331984037,421,178,243,39,1.4,2.65,3.5,0,0,0,0,0,0,0.235764056857751,4863.72802791848,23.7909016007181
7.5,"eps_greedy_SVM","SVM",6,8,29240,25885,3355,900,712,188,0.525689079729809,0.123138602520046,1.00279254407112,442,188,254,21,1.4,2.99,3.8,0,0,0,0,0,0,0.219315180277975,5043.75706718343,22.2349589616585
7.5,"eps_greedy_SVM","SVM",6,9,29140,25788,3352,1000,809,191,0.53153818215422,0.135166093928981,1.24400701666965,462,191,271,20,1.4,3.32,4.2,0,0,0,0,0,0,0.192180374425068,3854.98716954748,19.5663024174454
7.5,"eps_greedy_SVM","SVM",6,10,29040,25695,3345,1100,902,198,0.5289813005981,0.143757159221077,1.33901503172897,493,198,295,31,1.5,3.65,4.6,0,0,0,0,0,0,0.179948175151881,3763.72748237965,20.0614488251465
7.5,"eps_greedy_SVM","SVM",6,11,28940,25608,3332,1200,989,211,0.5322654408146,0.143757159221077,1.36089271999164,518,211,307,25,1.5,3.98,4.7,0,0,0,0,0,0,0.173652619261025,3387.87415999049,17.5142170102439
7.5,"eps_greedy_SVM","SVM",6,12,28840,25530,3310,1300,1067,233,0.53669866690737,0.15979381443299,1.52144747909178,579,233,346,61,1.5,4.31,4.6,0,0,0,0,0,0,0.176075790152142,4002.79876705069,17.7743086317095
7.5,"eps_greedy_SVM","SVM",6,13,28740,25450,3290,1400,1147,253,0.53130457394978,0.151775486827033,1.52726906974493,630,253,377,51,1.5,4.64,4.5,0,0,0,0,0,0,0.175826212561376,3445.79255017682,17.651921679312
7.5,"eps_greedy_SVM","SVM",6,14,28640,25380,3260,1500,1217,283,0.525510445746803,0.160939289805269,1.5321699410352,684,283,401,54,1.4,4.98,4.3,0,0,0,0,0,0,0.259567219968639,3956.3883856711,26.9322492542314
7.5,"eps_greedy_SVM","SVM",6,15,28540,25308,3232,1600,1289,311,0.529657066594464,0.152920962199313,1.48665994278663,777,311,466,93,1.5,5.31,4.1,0,0,0,0,0,0,0.190566751116803,3449.03188341872,19.1088289324016
7.5,"eps_greedy_SVM","SVM",6,16,28440,25216,3224,1700,1381,319,0.531595305485173,0.162084765177549,1.55279792965933,802,319,483,25,1.5,5.64,4.3,0,0,0,0,0,0,0.183949847905613,3856.37158794999,18.4219122197291
7.5,"eps_greedy_SVM","SVM",6,17,28340,25126,3214,1800,1471,329,0.53139389094129,0.154066437571592,1.48691456291817,821,329,492,19,1.5,5.97,4.5,0,0,0,0,0,0,0.17866850069825,3433.00920484966,17.9391732335069
7.5,"eps_greedy_SVM","SVM",6,18,28240,25035,3205,1900,1562,338,0.531621051817179,0.154066437571592,1.45256419960539,848,338,510,27,1.5,6.3,4.6,0,0,0,0,0,0,0.174833296312671,3561.50139251585,17.520498522546
7.5,"eps_greedy_SVM","SVM",6,19,28140,24955,3185,2000,1642,358,0.530139627645286,0.152920962199313,1.38778692539029,912,358,554,64,1.5,6.64,4.6,0,0,0,0,0,0,0.175011038135535,3330.33718770636,17.5475780772616
7.5,"eps_greedy_SVM","SVM",6,20,28040,24863,3177,2100,1734,366,0.531704179373273,0.150057273768614,1.48167894826001,928,366,562,16,1.5,6.97,4.7,0,0,0,0,0,0,0.169192907470303,3027.69976279322,16.9628651596024
7.5,"eps_greedy_SVM","SVM",6,21,27940,24785,3155,2200,1812,388,0.533625182405672,0.15922107674685,1.52504057735197,965,388,577,37,1.5,7.3,4.7,0,0,0,0,0,0,0.172046062762034,3410.15398288155,17.2601121926838
7.5,"eps_greedy_SVM","SVM",6,22,27840,24694,3146,2300,1903,397,0.534330778042114,0.156930126002291,1.45384512041633,989,397,592,24,1.5,7.63,4.8,0,0,0,0,0,0,0.169792806972543,3752.99778774782,17.0331381998101
7.5,"eps_greedy_SVM","SVM",6,23,27740,24608,3132,2400,1989,411,0.533247755792386,0.15807560137457,1.45641375137113,1032,411,621,43,1.5,7.96,4.8,0,0,0,0,0,0,0.168184543110076,3111.8036916071,16.8682001144471
7.5,"eps_greedy_SVM","SVM",6,24,27640,24515,3125,2500,2082,418,0.533787354209785,0.160939289805269,1.46274677512792,1055,418,637,23,1.5,8.29,5,0,0,0,0,0,0,0.162762350733318,3039.12061021876,16.3279377426622
7.5,"eps_greedy_SVM","SVM",6,25,27540,24434,3106,2600,2163,437,0.534112471497429,0.15979381443299,1.54733994045139,1133,437,696,78,1.6,8.63,4.9,0,0,0,0,0,0,0.164141178678299,3075.93435356466,16.4590185097211
7.5,"eps_greedy_SVM","SVM",6,26,27440,24353,3087,2700,2244,456,0.535397467059521,0.160939289805269,1.51433853821266,1252,456,796,119,1.7,8.96,4.9,0,0,0,0,0,0,0.165285381104038,3315.03869673378,16.5708388311188
7.5,"eps_greedy_SVM","SVM",6,27,27340,24272,3068,2800,2325,475,0.532893754472833,0.155784650630011,1.50315081286438,1275,475,800,23,1.7,9.29,4.9,0,0,0,0,0,0,0.164525567368046,2886.25608401624,16.5018956149057
7.5,"eps_greedy_SVM","SVM",6,28,27240,24194,3046,2900,2403,497,0.532450264233016,0.152920962199313,1.46519245900417,1301,497,804,26,1.6,9.62,4.8,0,0,0,0,0,0,0.168783364583143,3419.59212654188,16.9148722546802
7.5,"eps_greedy_SVM","SVM",6,29,27140,24111,3029,3000,2486,514,0.532397009299191,0.155211912943872,1.43736076852262,1326,514,812,25,1.6,9.95,4.8,0,0,0,0,0,0,0.167643108909644,3152.5160451859,16.8029792037764
7.5,"eps_greedy_SVM","SVM",6,30,27040,24029,3011,3100,2568,532,0.532572161724793,0.155211912943872,1.47278412977621,1356,532,824,30,1.5,10.29,4.8,0,0,0,0,0,0,0.167729742025403,3008.76119491742,16.8283449221628
7.5,"eps_greedy_SVM","SVM",6,31,26940,23949,2991,3200,2648,552,0.535271400295288,0.163230240549828,1.52191023090372,1441,552,889,85,1.6,10.62,4.8,0,0,0,0,0,0,0.168427838588055,2967.13804559203,16.8887820074452
7.5,"eps_greedy_SVM","SVM",6,32,26840,23861,2979,3300,2736,564,0.534115050428854,0.163802978235968,1.51967071616411,1460,564,896,19,1.6,10.95,4.9,0,0,0,0,0,0,0.167586658902501,3137.42313442919,16.7814175220997
7.5,"eps_greedy_SVM","SVM",6,33,26740,23773,2967,3400,2824,576,0.535117309142953,0.15922107674685,1.49526025741628,1474,576,898,14,1.6,11.28,4.9,0,0,0,0,0,0,0.167786681110456,3534.43390902775,16.7994980620136
7.5,"eps_greedy_SVM","SVM",6,34,26640,23689,2951,3500,2908,592,0.535791785673601,0.164375715922108,1.53975494074329,1561,592,969,87,1.6,11.61,4.9,0,0,0,0,0,0,0.165809050494053,3127.08420888026,16.6014905641144
7.5,"eps_greedy_SVM","SVM",6,35,26540,23601,2939,3600,2996,604,0.536426740080244,0.166093928980527,1.51607608463779,1552,604,948,-9,1.6,11.94,5,0,0,0,0,0,0,0.163606943725492,2958.11295264324,16.4314418477015
7.5,"eps_greedy_SVM","SVM",6,36,26440,23513,2927,3700,3084,616,0.53608258168228,0.164948453608247,1.58665919135685,1565,616,949,13,1.5,12.28,5,0,0,0,0,0,0,0.162919280248181,2897.16024392159,16.3407728114736
7.5,"eps_greedy_SVM","SVM",6,37,26340,23437,2903,3800,3160,640,0.536452550885542,0.162084765177549,1.48298439226728,1655,640,1015,90,1.6,12.61,4.9,0,0,0,0,0,0,0.165249638194891,3139.34848683751,16.5493090137659
7.5,"eps_greedy_SVM","SVM",6,38,26240,23352,2888,3900,3245,655,0.536072416394263,0.165521191294387,1.57833027171718,1643,655,988,-12,1.5,12.94,5,0,0,0,0,0,0,0.164151255455204,2864.57658058257,16.4571465365136
7.5,"eps_greedy_SVM","SVM",6,39,26140,23274,2866,4000,3323,677,0.537919038746297,0.171248568155785,1.64092777539137,1750,677,1073,107,1.6,13.27,4.9,0,0,0,0,0,0,0.16686207715548,3139.26816051104,16.7066713156693
7.5,"eps_greedy_SVM","SVM",6,40,26040,23195,2845,4100,3402,698,0.537817686741496,0.175257731958763,1.74122822609314,1789,698,1091,39,1.6,13.6,4.9,0,0,0,0,0,0,0.167947813470036,3240.72843239315,16.8319038343974
7.5,"eps_greedy_SVM","SVM",6,41,25940,23108,2832,4200,3489,711,0.539726482831835,0.186712485681558,1.72782904862563,1833,711,1122,44,1.6,13.93,4.9,0,0,0,0,0,0,0.166784507686317,3053.65280262095,16.7094331375137
7.5,"eps_greedy_SVM","SVM",6,42,25840,23029,2811,4300,3568,732,0.538941671018611,0.170675830469645,1.71585598431335,1865,732,1133,32,1.5,14.27,4.9,0,0,0,0,0,0,0.16786242550638,3089.85940763278,16.8246030077903
7.5,"eps_greedy_SVM","SVM",6,43,25740,22949,2791,4400,3648,752,0.536002247968549,0.164948453608247,1.5156680716088,1910,752,1158,45,1.5,14.6,4.9,0,0,0,0,0,0,0.167515377787497,2818.87019273134,16.7903393733088
7.5,"eps_greedy_SVM","SVM",6,44,25640,22868,2772,4500,3729,771,0.540074165769414,0.186139747995418,1.82894530429094,1966,771,1195,56,1.5,14.93,4.8,0,0,0,0,0,0,0.168853312819838,3182.51726403369,16.9041193375925
7.5,"eps_greedy_SVM","SVM",6,45,25540,22786,2754,4600,3811,789,0.538047856370713,0.178694158075601,1.66869993578091,2004,789,1215,38,1.5,15.26,4.8,0,0,0,0,0,0,0.169750693064961,3580.35571615317,16.9951107196623
7.5,"eps_greedy_SVM","SVM",6,46,25440,22700,2740,4700,3897,803,0.541307969542822,0.188430698739977,1.91651140645054,2024,803,1221,20,1.5,15.59,4.9,0,0,0,0,0,0,0.168399236231132,3241.41591370635,16.8653602783871
7.5,"eps_greedy_SVM","SVM",6,47,25340,22618,2722,4800,3979,821,0.540125830362191,0.180412371134021,1.74129265160193,2053,821,1232,29,1.5,15.93,4.8,0,0,0,0,0,0,0.168212916629605,3038.80366785043,16.8574803288636
7.5,"eps_greedy_SVM","SVM",6,48,25240,22531,2709,4900,4066,834,0.541771876323049,0.195876288659794,1.90483000488643,2123,834,1289,70,1.5,16.26,4.9,0,0,0,0,0,0,0.168084402228564,3084.30814728596,16.8423354900149
7.5,"eps_greedy_SVM","SVM",7,0,30040,26563,3477,100,94,6,0.577387119786251,0.182724252491694,1.68682653744469,29,6,23,0,3.8,0.33,15.7,0,0,0,0,0,0,0.468807193506834,1968.83672971385,57.1773049001874
7.5,"eps_greedy_SVM","SVM",7,1,29940,26487,3453,200,170,30,0.478288479286912,0.147840531561462,1.41834323239083,80,30,50,51,1.7,0.66,5.7,0,0,0,0,0,0,0.335616983380515,3334.53226474812,38.671207185434
7.5,"eps_greedy_SVM","SVM",7,2,29840,26401,3439,300,256,44,0.569487873691539,0.174418604651163,1.57918100601384,117,44,73,37,1.7,1,5.8,0,0,0,0,0,0,0.181069075174791,3872.54099230869,19.7791215964587
7.5,"eps_greedy_SVM","SVM",7,3,29740,26324,3416,400,333,67,0.628098009775177,0.229235880398671,2.16968992248062,169,67,102,52,1.5,1.33,5,0,0,0,0,0,0,0.302598223075288,4653.16415131907,35.4596594202987
7.5,"eps_greedy_SVM","SVM",7,4,29640,26264,3376,500,393,107,0.617056037608026,0.178294573643411,1.62428709856035,264,107,157,95,1.5,1.66,3.7,0,0,0,0,0,0,0.256504691249057,6061.17081949503,28.6785681153119
7.5,"eps_greedy_SVM","SVM",7,5,29540,26191,3349,600,466,134,0.606253289804599,0.175526024363234,1.50373074981502,319,134,185,55,1.4,1.99,3.5,0,0,0,0,0,0,0.296165445830814,6211.28226989624,30.9668564318395
7.5,"eps_greedy_SVM","SVM",7,6,29440,26115,3325,700,542,158,0.597335159135755,0.178848283499446,1.5902111454437,374,158,216,55,1.4,2.32,3.4,0,0,0,0,0,0,0.240616368274545,6275.65615766022,24.5130250393452
7.5,"eps_greedy_SVM","SVM",7,7,29340,26050,3290,800,607,193,0.613750684049774,0.188261351052049,1.61234238063432,449,193,256,75,1.3,2.65,3.1,0,0,0,0,0,0,0.247723886761975,6822.34313933437,24.9274130293099
7.5,"eps_greedy_SVM","SVM",7,8,29240,25972,3268,900,685,215,0.611699682634294,0.229235880398671,1.99239559024704,504,215,289,55,1.3,2.99,3.2,0,0,0,0,0,0,0.259460286788431,6344.52811271004,26.8403250897289
7.5,"eps_greedy_SVM","SVM",7,9,29140,25880,3260,1000,777,223,0.596440123573516,0.199335548172757,1.82363663468315,532,223,309,28,1.4,3.32,3.5,0,0,0,0,0,0,0.228717027666945,5854.52711688899,23.1613197901658
7.5,"eps_greedy_SVM","SVM",7,10,29040,25803,3237,1100,854,246,0.577944169015715,0.197120708748616,1.7104578939766,574,246,328,42,1.3,3.65,3.5,0,0,0,0,0,0,0.239830646575506,6118.98420222383,24.1786969080795
7.5,"eps_greedy_SVM","SVM",7,11,28940,25714,3226,1200,943,257,0.577580552991893,0.209856035437431,1.95880852848465,616,257,359,42,1.4,3.98,3.7,0,0,0,0,0,0,0.213800854712697,6070.57223317038,21.4115977309098
7.5,"eps_greedy_SVM","SVM",7,12,28840,25642,3198,1300,1015,285,0.580922681399982,0.19656699889258,1.74679047950202,682,285,397,66,1.4,4.31,3.6,0,0,0,0,0,0,0.239425921009799,5684.52219974345,25.3209409229259
7.5,"eps_greedy_SVM","SVM",7,13,28740,25552,3188,1400,1105,295,0.580238735980368,0.186600221483942,1.63813939840594,704,295,409,22,1.4,4.64,3.7,0,0,0,0,0,0,0.219196638119261,5453.51594533547,22.9411124326681
7.5,"eps_greedy_SVM","SVM",7,14,28640,25468,3172,1500,1189,311,0.586648204105841,0.203765227021041,1.87560147280016,747,311,436,43,1.4,4.98,3.8,0,0,0,0,0,0,0.208047139947405,4933.58910898425,20.9525208662241
7.5,"eps_greedy_SVM","SVM",7,15,28540,25380,3160,1600,1277,323,0.578028947358538,0.181616832779623,1.66318200524892,776,323,453,29,1.4,5.31,4,0,0,0,0,0,0,0.201911124336636,5316.68633475659,20.2185348548936
7.5,"eps_greedy_SVM","SVM",7,16,28440,25296,3144,1700,1361,339,0.580765313427324,0.192137320044297,1.70973486614897,830,339,491,54,1.4,5.64,4,0,0,0,0,0,0,0.200051810815425,4796.79573644598,20.0530294051733
7.5,"eps_greedy_SVM","SVM",7,17,28340,25212,3128,1800,1445,355,0.582897252906196,0.195459579180509,1.77986935545075,863,355,508,33,1.4,5.97,4.1,0,0,0,0,0,0,0.196742447848387,5184.61320688076,19.6912569783214
7.5,"eps_greedy_SVM","SVM",7,18,28240,25119,3121,1900,1538,362,0.576401503719862,0.166112956810631,1.47178725611029,884,362,522,21,1.4,6.3,4.2,0,0,0,0,0,0,0.190695958783897,4494.22139358103,19.0798960783112
7.5,"eps_greedy_SVM","SVM",7,19,28140,25032,3108,2000,1625,375,0.584107525319757,0.193798449612403,1.75952376108025,911,375,536,27,1.4,6.64,4.3,0,0,0,0,0,0,0.18703665023929,4532.17156666357,18.7339075142363
7.5,"eps_greedy_SVM","SVM",7,20,28040,24950,3090,2100,1707,393,0.581862631534791,0.195459579180509,1.7690447807434,937,393,544,26,1.4,6.97,4.3,0,0,0,0,0,0,0.187428942730571,4533.82244535712,18.7693422076753
7.5,"eps_greedy_SVM","SVM",7,21,27940,24863,3077,2200,1794,406,0.57925128325859,0.193798449612403,1.83022648612545,972,406,566,35,1.4,7.3,4.4,0,0,0,0,0,0,0.183464436523792,4633.77889482765,18.3762619590136
7.5,"eps_greedy_SVM","SVM",7,22,27840,24778,3062,2300,1879,421,0.57592163575868,0.188815060908084,1.59611049050472,1014,421,593,42,1.4,7.63,4.5,0,0,0,0,0,0,0.182389527429717,4400.30620061639,18.249288625833
7.5,"eps_greedy_SVM","SVM",7,23,27740,24688,3052,2400,1969,431,0.576521679420992,0.194352159468439,1.7887274749571,1064,431,633,50,1.5,7.96,4.6,0,0,0,0,0,0,0.179529156677526,4025.53389991524,18.022179254039
7.5,"eps_greedy_SVM","SVM",7,24,27640,24613,3027,2500,2044,456,0.580860569054272,0.186046511627907,1.63112680438871,1138,456,682,74,1.5,8.29,4.5,0,0,0,0,0,0,0.182797297310484,4527.05514785382,18.3008401171493
7.5,"eps_greedy_SVM","SVM",7,25,27540,24530,3010,2600,2127,473,0.582136627124311,0.188815060908084,1.7170103336645,1132,473,659,-6,1.4,8.63,4.5,0,0,0,0,0,0,0.180273033644958,3979.41435391848,18.0627716266099
7.5,"eps_greedy_SVM","SVM",7,26,27440,24456,2984,2700,2201,499,0.579952384709178,0.20874861572536,1.92409728079688,1184,499,685,52,1.4,8.96,4.4,0,0,0,0,0,0,0.199199781947056,3723.51269237127,32.268556064425
7.5,"eps_greedy_SVM","SVM",7,27,27340,24366,2974,2800,2291,509,0.567880549777739,0.19656699889258,1.774753041559,1238,509,729,54,1.4,9.29,4.5,0,0,0,0,0,0,0.180901360343241,4577.96604430097,18.101146850603
7.5,"eps_greedy_SVM","SVM",7,28,27240,24280,2960,2900,2377,523,0.572646753982928,0.196013289036545,1.62080612016521,1240,523,717,2,1.4,9.62,4.5,0,0,0,0,0,0,0.180494876003241,4512.97719541483,18.7638304252284
7.5,"eps_greedy_SVM","SVM",7,29,27140,24199,2941,3000,2458,542,0.563850218248927,0.19656699889258,1.69518393111791,1316,542,774,76,1.4,9.95,4.5,0,0,0,0,0,0,0.18054597650067,4843.06226964062,18.0663111411638
7.5,"eps_greedy_SVM","SVM",7,30,27040,24120,2920,3100,2537,563,0.568693102816384,0.200996677740864,1.84475209315819,1361,563,798,45,1.4,10.29,4.5,0,0,0,0,0,0,0.180940340499824,4523.76186334491,18.1188125767485
7.5,"eps_greedy_SVM","SVM",7,31,26940,24039,2901,3200,2618,582,0.571999666897501,0.201550387596899,1.86167972114556,1411,582,829,50,1.4,10.62,4.5,0,0,0,0,0,0,0.181337688934015,4536.28516260921,18.184811915954
7.5,"eps_greedy_SVM","SVM",7,32,26840,23956,2884,3300,2701,599,0.577349844030385,0.214285714285714,1.91011732480553,1460,599,861,49,1.4,10.95,4.5,0,0,0,0,0,0,0.180136934560936,4355.88596126726,18.0686520360735
7.5,"eps_greedy_SVM","SVM",7,33,26740,23877,2863,3400,2780,620,0.57401410217397,0.20874861572536,1.95539597007266,1452,620,832,-8,1.3,11.28,4.5,0,0,0,0,0,0,0.181451393194424,4174.83102839231,18.1846875955144
7.5,"eps_greedy_SVM","SVM",7,34,26640,23797,2843,3500,2860,640,0.57627185254663,0.217054263565891,2.00453377051835,1563,640,923,111,1.4,11.61,4.5,0,0,0,0,0,0,0.181942859108277,4507.15034143333,18.2237946486864
7.5,"eps_greedy_SVM","SVM",7,35,26540,23717,2823,3600,2940,660,0.575313076694131,0.210409745293466,1.91072833256016,1581,660,921,18,1.4,11.94,4.5,0,0,0,0,0,0,0.182297449801921,4459.12425110387,18.2720494307728
7.5,"eps_greedy_SVM","SVM",7,36,26440,23634,2806,3700,3023,677,0.569089277731105,0.191583610188261,1.70511762139669,1584,677,907,3,1.3,12.28,4.5,0,0,0,0,0,0,0.182706315992054,4543.07929443187,18.297753709382
7.5,"eps_greedy_SVM","SVM",7,37,26340,23538,2802,3800,3119,681,0.569667448497472,0.168881506090808,1.65885080211025,1633,681,952,49,1.4,12.61,4.6,0,0,0,0,0,0,0.179159084845252,4358.25431031499,17.9417395692144
7.5,"eps_greedy_SVM","SVM",7,38,26240,23457,2783,3900,3200,700,0.568923728293554,0.178294573643411,1.64712772079483,1688,700,988,55,1.4,12.94,4.6,0,0,0,0,0,0,0.179915725977057,4481.02240304334,18.0027644323763
7.5,"eps_greedy_SVM","SVM",7,39,26140,23375,2765,4000,3282,718,0.579156612021997,0.205426356589147,1.96182321293374,1740,718,1022,52,1.4,13.27,4.6,0,0,0,0,0,0,0.178758774100218,4319.29279424186,17.9258424394319
7.5,"eps_greedy_SVM","SVM",7,40,26040,23287,2753,4100,3370,730,0.573965096868963,0.185492801771872,1.68628750451862,1763,730,1033,23,1.4,13.6,4.6,0,0,0,0,0,0,0.178032683845281,4341.76758917343,17.8085173920892
7.5,"eps_greedy_SVM","SVM",7,41,25940,23192,2748,4200,3465,735,0.57734713078948,0.213178294573643,2.03219263365064,1757,735,1022,-6,1.4,13.93,4.7,0,0,0,0,0,0,0.174749808587907,4194.79833062355,17.4985705855234
7.5,"eps_greedy_SVM","SVM",7,42,25840,23117,2723,4300,3540,760,0.581393533052906,0.219822812846069,2.20295305469724,1798,760,1038,41,1.4,14.27,4.7,0,0,0,0,0,0,0.176696001639449,4442.24704367671,17.6770838123855
7.5,"eps_greedy_SVM","SVM",7,43,25740,23025,2715,4400,3632,768,0.5782353206362,0.207087486157254,1.92520354720076,1825,768,1057,27,1.4,14.6,4.7,0,0,0,0,0,0,0.174049895621913,4231.14453522812,17.4196669171135
7.5,"eps_greedy_SVM","SVM",7,44,25640,22952,2688,4500,3705,795,0.579499774383576,0.202104097452935,1.8972429300705,1889,795,1094,64,1.4,14.93,4.7,0,0,0,0,0,0,0.176628258416771,4385.12294241835,17.6970590554808
7.5,"eps_greedy_SVM","SVM",7,45,25540,22863,2677,4600,3794,806,0.576744457370599,0.198781838316722,1.9202073442236,1913,806,1107,24,1.4,15.26,4.7,0,0,0,0,0,0,0.173728845575326,3734.68573998207,17.3992756079859
7.5,"eps_greedy_SVM","SVM",7,46,25440,22774,2666,4700,3883,817,0.584165546933025,0.21483942414175,2.14047532680397,1931,817,1114,18,1.4,15.59,4.8,0,0,0,0,0,0,0.173634303851753,4330.65705807148,17.365785552593
7.5,"eps_greedy_SVM","SVM",7,47,25340,22685,2655,4800,3972,828,0.586623367515991,0.217607973421927,2.08984348850598,1916,828,1088,-15,1.3,15.93,4.8,0,0,0,0,0,0,0.172644558154611,4033.74201845534,17.2758998259638
7.5,"eps_greedy_SVM","SVM",7,48,25240,22601,2639,4900,4056,844,0.57921104380883,0.198781838316722,1.94934790127978,1962,844,1118,46,1.3,16.26,4.8,0,0,0,0,0,0,0.172123111495991,4255.40644343604,17.2143723390338
7.5,"eps_greedy_SVM","SVM",8,0,30040,26552,3488,100,86,14,0.399367348613486,0.0861779518746503,0.684625856181052,46,14,32,0,2.3,0.33,6.1,0,0,0,0,0,0,0.208015973736309,4064.62572318119,21.5367078777033
7.5,"eps_greedy_SVM","SVM",8,1,29940,26457,3483,200,181,19,0.58958018760068,0.187465025181869,1.71171536981178,59,19,40,13,2.1,0.66,9.5,0,0,0,0,0,0,0.304825881027286,3369.27117260328,34.2666049021731
7.5,"eps_greedy_SVM","SVM",8,2,29840,26404,3436,300,234,66,0.591558744972503,0.158365976496922,1.41549592202226,148,66,82,89,1.2,1,3.5,0,0,0,0,0,0,0.41078671009589,5113.06292921117,46.9446775850947
7.5,"eps_greedy_SVM","SVM",8,3,29740,26324,3416,400,314,86,0.607258510096766,0.198656966983772,1.82330372433312,194,86,108,46,1.3,1.33,3.7,0,0,0,0,0,0,0.38503630041477,6039.58555492176,44.3706434692953
7.5,"eps_greedy_SVM","SVM",8,4,29640,26243,3397,500,395,105,0.558187776586464,0.160044767767208,1.27073241273017,255,105,150,61,1.4,1.66,3.8,0,0,0,0,0,0,0.318664452139836,5998.42944554367,34.2120672190009
7.5,"eps_greedy_SVM","SVM",8,5,29540,26169,3371,600,469,131,0.563814499209475,0.151091214325686,1.43971965834513,320,131,189,65,1.4,1.99,3.6,0,0,0,0,0,0,0.340372203262892,6237.18741177185,34.6148468110823
7.5,"eps_greedy_SVM","SVM",8,6,29440,26079,3361,700,559,141,0.575658925152333,0.179071068830442,1.6202302798361,354,141,213,34,1.5,2.32,4,0,0,0,0,0,0,0.297287664840853,5584.54657311177,30.0895628440168
7.5,"eps_greedy_SVM","SVM",8,7,29340,25994,3346,800,644,156,0.569165046093038,0.147733631785115,1.2776139732584,398,156,242,44,1.6,2.65,4.1,0,0,0,0,0,0,0.249735823456871,4961.07225816656,25.8558383338682
7.5,"eps_greedy_SVM","SVM",8,8,29240,25906,3334,900,732,168,0.562917391438417,0.172915500839396,1.41766963806642,435,168,267,37,1.6,2.99,4.4,0,0,0,0,0,0,0.202868276794662,4993.70414379962,20.6803974421119
7.5,"eps_greedy_SVM","SVM",8,9,29140,25830,3310,1000,808,192,0.553534409154942,0.159485170677112,1.43864473279848,463,192,271,28,1.4,3.32,4.2,0,0,0,0,0,0,0.19823941402028,5307.42599251946,20.1820684572572
7.5,"eps_greedy_SVM","SVM",8,10,29040,25739,3301,1100,899,201,0.542872702867424,0.172355903749301,1.71297892829177,528,201,327,65,1.6,3.65,4.5,0,0,0,0,0,0,0.208784093491502,4723.18278420684,21.5961188003023
7.5,"eps_greedy_SVM","SVM",8,11,28940,25657,3283,1200,981,219,0.541438408850291,0.166759932848349,1.41539281282694,563,219,344,35,1.6,3.98,4.5,0,0,0,0,0,0,0.207979613173294,4469.42576191113,21.4892025166325
7.5,"eps_greedy_SVM","SVM",8,12,28840,25572,3268,1300,1066,234,0.54442482231823,0.161163961947398,1.46928357923758,609,234,375,46,1.6,4.31,4.6,0,0,0,0,0,0,0.183706939222085,4931.83029150869,18.484910321754
7.5,"eps_greedy_SVM","SVM",8,13,28740,25493,3247,1400,1145,255,0.586756126374918,0.209289311695579,1.83531028643832,645,255,390,36,1.5,4.64,4.5,0,0,0,0,0,0,0.238566479961552,4921.92620919729,25.9993002277586
7.5,"eps_greedy_SVM","SVM",8,14,28640,25421,3219,1500,1217,283,0.578877366682011,0.192501398992725,1.61232265709865,713,283,430,68,1.5,4.98,4.3,0,0,0,0,0,0,0.243774356779787,4902.86111366514,28.2601260823485
7.5,"eps_greedy_SVM","SVM",8,15,28540,25341,3199,1600,1297,303,0.559765339927849,0.176273083379966,1.49083976360249,761,303,458,48,1.5,5.31,4.3,0,0,0,0,0,0,0.20733588110287,4739.35936490639,21.5961391417676
7.5,"eps_greedy_SVM","SVM",8,16,28440,25266,3174,1700,1372,328,0.560994397794503,0.14717403469502,1.30682883768225,803,328,475,42,1.4,5.64,4.2,0,0,0,0,0,0,0.313062889516456,4759.91700881613,36.7884264478214
7.5,"eps_greedy_SVM","SVM",8,17,28340,25194,3146,1800,1444,356,0.566785157685565,0.169557918298825,1.32508461962942,848,356,492,45,1.4,5.97,4.1,0,0,0,0,0,0,0.284892001219559,4519.73726980928,35.4385484841196
7.5,"eps_greedy_SVM","SVM",8,18,28240,25108,3132,1900,1530,370,0.574323163022714,0.175153889199776,1.54532567148023,905,370,535,57,1.4,6.3,4.1,0,0,0,0,0,0,0.223109047569173,3959.83352705897,23.0689211050394
7.5,"eps_greedy_SVM","SVM",8,19,28140,25027,3113,2000,1611,389,0.579138040183479,0.194739787353106,1.79116154167795,932,389,543,27,1.4,6.64,4.1,0,0,0,0,0,0,0.21084063308135,4061.0474707867,22.6016186097941
7.5,"eps_greedy_SVM","SVM",8,20,28040,24953,3087,2100,1685,415,0.585255189584785,0.188024622271964,1.56821785829199,999,415,584,67,1.4,6.97,4.1,0,0,0,0,0,0,0.225045745583274,4490.14591147984,24.4138835154737
7.5,"eps_greedy_SVM","SVM",8,21,27940,24877,3063,2200,1761,439,0.581184377720789,0.187465025181869,1.59911481914839,1059,439,620,60,1.4,7.3,4,0,0,0,0,0,0,0.210378354015348,3945.54142111045,21.7347781670925
7.5,"eps_greedy_SVM","SVM",8,22,27840,24788,3052,2300,1850,450,0.585033692934703,0.185786233911584,1.5438915118839,1084,450,634,25,1.4,7.63,4.1,0,0,0,0,0,0,0.22730895422732,3803.20584711823,23.297018221629
7.5,"eps_greedy_SVM","SVM",8,23,27740,24703,3037,2400,1935,465,0.587342599627579,0.192501398992725,1.84936668124548,1129,465,664,45,1.4,7.96,4.2,0,0,0,0,0,0,0.200717990234866,3413.80005078265,26.8859470616628
7.5,"eps_greedy_SVM","SVM",8,24,27640,24618,3022,2500,2020,480,0.567412956197582,0.195299384443201,1.77475379403476,1166,480,686,37,1.4,8.29,4.2,0,0,0,0,0,0,0.194753736396402,3975.99267204863,19.5998681003257
7.5,"eps_greedy_SVM","SVM",8,25,27540,24536,3004,2600,2102,498,0.568093285390978,0.201454952434247,1.9157651068515,1215,498,717,49,1.4,8.63,4.2,0,0,0,0,0,0,0.196011673080528,3677.40291332259,21.191486627715
7.5,"eps_greedy_SVM","SVM",8,26,27440,24448,2992,2700,2190,510,0.564584556030232,0.186905428091774,1.65826940467842,1233,510,723,18,1.4,8.96,4.3,0,0,0,0,0,0,0.193939342892478,3589.44852265469,19.9485188270371
7.5,"eps_greedy_SVM","SVM",8,27,27340,24362,2978,2800,2276,524,0.565546537297124,0.19306099608282,1.66074330591563,1288,524,764,55,1.5,9.29,4.3,0,0,0,0,0,0,0.192048659777932,3268.99389274273,19.2424428632589
7.5,"eps_greedy_SVM","SVM",8,28,27240,24280,2960,2900,2358,542,0.569249255260694,0.202574146614438,1.74339798342609,1353,542,811,65,1.5,9.62,4.4,0,0,0,0,0,0,0.185077793908282,3593.55587797884,18.5862726201655
7.5,"eps_greedy_SVM","SVM",8,29,27140,24186,2954,3000,2452,548,0.570743788952538,0.196978175713486,1.79116154167795,1366,548,818,13,1.5,9.95,4.5,0,0,0,0,0,0,0.183318444482736,3212.42483340311,18.4115050932662
7.5,"eps_greedy_SVM","SVM",8,30,27040,24094,2946,3100,2544,556,0.5659051950527,0.196978175713486,1.76485403922555,1395,556,839,29,1.5,10.29,4.6,0,0,0,0,0,0,0.179675627907359,3110.72264255607,18.0410195086106
7.5,"eps_greedy_SVM","SVM",8,31,26940,24007,2933,3200,2631,569,0.565583523614878,0.191382204812535,1.72998722970743,1430,569,861,35,1.5,10.62,4.6,0,0,0,0,0,0,0.177811842455544,3638.21774792106,17.8287561311253
7.5,"eps_greedy_SVM","SVM",8,32,26840,23921,2919,3300,2717,583,0.569443622994331,0.201454952434247,1.77092926827624,1464,583,881,34,1.5,10.95,4.7,0,0,0,0,0,0,0.176393359438153,3156.82680118245,17.6870963526901
7.5,"eps_greedy_SVM","SVM",8,33,26740,23837,2903,3400,2801,599,0.566444613958042,0.18970341354225,1.64720463766088,1470,599,871,6,1.5,11.28,4.7,0,0,0,0,0,0,0.175325683396787,3213.99674380391,17.6017452239026
7.5,"eps_greedy_SVM","SVM",8,34,26640,23760,2880,3500,2878,622,0.568088019685156,0.201454952434247,1.69388474196883,1566,622,944,96,1.5,11.61,4.6,0,0,0,0,0,0,0.177551456648046,3588.07616659074,17.8149949124543
7.5,"eps_greedy_SVM","SVM",8,35,26540,23669,2871,3600,2969,631,0.571851904087652,0.202574146614438,1.84917487096307,1592,631,961,26,1.5,11.94,4.7,0,0,0,0,0,0,0.172745725381965,3553.23733015072,17.3093540625111
7.5,"eps_greedy_SVM","SVM",8,36,26440,23586,2854,3700,3052,648,0.56947854515541,0.196978175713486,1.63988372816017,1634,648,986,42,1.5,12.28,4.7,0,0,0,0,0,0,0.172838177363406,3035.53399119414,17.4012846907995
7.5,"eps_greedy_SVM","SVM",8,37,26340,23505,2835,3800,3133,667,0.567220020735926,0.18970341354225,1.75701828017161,1657,667,990,23,1.5,12.61,4.7,0,0,0,0,0,0,0.174018720759625,3210.76134890351,17.47863282151
7.5,"eps_greedy_SVM","SVM",8,38,26240,23430,2810,3900,3208,692,0.572206602032442,0.199776161163962,1.75254749574369,1708,692,1016,51,1.5,12.94,4.6,0,0,0,0,0,0,0.176906011748377,3014.96670690676,17.7734422559924
7.5,"eps_greedy_SVM","SVM",8,39,26140,23348,2792,4000,3290,710,0.569021313386676,0.193620593172915,1.74339798342609,1710,710,1000,2,1.4,13.27,4.6,0,0,0,0,0,0,0.175290312175813,2849.96426091917,17.7071207188707
7.5,"eps_greedy_SVM","SVM",8,40,26040,23258,2782,4100,3380,720,0.572910479462319,0.200895355344152,1.90276585252172,1797,720,1077,87,1.5,13.6,4.7,0,0,0,0,0,0,0.174099487216567,2836.01031422182,17.4629032569641
7.5,"eps_greedy_SVM","SVM",8,41,25940,23187,2753,4200,3451,749,0.569007622551511,0.194739787353106,1.76064099827506,1831,749,1082,34,1.4,13.93,4.6,0,0,0,0,0,0,0.175759421743933,3368.7346749521,17.6561603269132
7.5,"eps_greedy_SVM","SVM",8,42,25840,23095,2745,4300,3543,757,0.572136757710306,0.202014549524342,1.79652520008079,1858,757,1101,27,1.5,14.27,4.7,0,0,0,0,0,0,0.176298814016471,2869.60900089391,17.714304908401
7.5,"eps_greedy_SVM","SVM",8,43,25740,23018,2722,4400,3620,780,0.577316948478817,0.206491326245104,1.93512698254517,1928,780,1148,70,1.5,14.6,4.6,0,0,0,0,0,0,0.176243679547353,3058.72450173421,24.2073644286425
7.5,"eps_greedy_SVM","SVM",8,44,25640,22927,2713,4500,3711,789,0.574085490124322,0.214325685506435,1.98907729830748,1960,789,1171,32,1.5,14.93,4.7,0,0,0,0,0,0,0.172469464834197,2734.97091722475,17.3670620480672
7.5,"eps_greedy_SVM","SVM",8,45,25540,22842,2698,4600,3796,804,0.576559065969941,0.202574146614438,1.98145165845307,1995,804,1191,35,1.5,15.26,4.7,0,0,0,0,0,0,0.174765801479001,2977.29938661737,17.5943320351736
7.5,"eps_greedy_SVM","SVM",8,46,25440,22751,2689,4700,3887,813,0.576463440752045,0.204812534974818,1.94125804868065,2030,813,1217,35,1.5,15.59,4.8,0,0,0,0,0,0,0.171267454912976,2883.44593251829,17.2029116835802
7.5,"eps_greedy_SVM","SVM",8,47,25340,22667,2673,4800,3971,829,0.569385742355839,0.195858981533296,1.65896630682408,2055,829,1226,25,1.5,15.93,4.8,0,0,0,0,0,0,0.1687503505661,2511.52043784351,17.0387301694666
7.5,"eps_greedy_SVM","SVM",8,48,25240,22575,2665,4900,4063,837,0.574622592119108,0.205372132064913,1.78460286750536,2068,837,1231,13,1.5,16.26,4.9,0,0,0,0,0,0,0.167290789258115,2633.86571969456,16.8710950494497
7.5,"eps_greedy_SVM","SVM",9,0,30040,26597,3443,100,89,11,0.398841941266614,0,0.631210719964546,40,11,29,0,2.6,0.33,8.1,0,0,0,0,0,0,0.121547544820757,3343.3127429528,12.1960479657434
7.5,"eps_greedy_SVM","SVM",9,1,29940,26504,3436,200,182,18,0.429638204945145,0.108446866485014,0.981759668649294,68,18,50,28,2.8,0.66,10.1,0,0,0,0,0,0,0.095306462749618,2705.47451207124,9.62481751359382
7.5,"eps_greedy_SVM","SVM",9,2,29840,26421,3419,300,265,35,0.406685177819885,0.0779291553133515,0.642888331308309,119,35,84,51,2.4,1,7.6,0,0,0,0,0,0,0.123692234520589,3476.61047073239,12.4072088472834
7.5,"eps_greedy_SVM","SVM",9,3,29740,26326,3414,400,360,40,0.419150232665761,0.0762942779291553,0.640169135233369,142,40,102,23,2.5,1.33,9,0,0,0,0,0,0,0.114346386672894,2866.50709064616,11.6010672860489
7.5,"eps_greedy_SVM","SVM",9,4,29640,26230,3410,500,456,44,0.569421024157547,0.190735694822888,1.68492118419715,159,44,115,17,2.6,1.66,10.4,0,0,0,0,0,0,0.114368106562037,2665.34243849133,11.9695529886567
7.5,"eps_greedy_SVM","SVM",9,5,29540,26141,3399,600,545,55,0.477408899681572,0.130245231607629,1.14618080532849,192,55,137,33,2.5,1.99,9.9,0,0,0,0,0,0,0.0961540522275579,2703.80198350045,9.69793644910283
7.5,"eps_greedy_SVM","SVM",9,6,29440,26061,3379,700,625,75,0.460767677616086,0.13133514986376,0.994175780086593,231,75,156,39,2.1,2.32,8.3,0,0,0,0,0,0,0.127093401766472,3091.37785988777,13.5659089323549
7.5,"eps_greedy_SVM","SVM",9,7,29340,25986,3354,800,700,100,0.528821157391732,0.164577656675749,1.37857187797949,279,100,179,48,1.8,2.65,7,0,0,0,0,0,0,0.13040654472372,3585.34120321474,15.653030311391
7.5,"eps_greedy_SVM","SVM",9,8,29240,25894,3346,900,792,108,0.514088321586814,0.130790190735695,1.11126786010762,305,108,197,26,1.8,2.99,7.3,0,0,0,0,0,0,0.122170818142307,3478.57077355307,12.2606124432756
7.5,"eps_greedy_SVM","SVM",9,9,29140,25805,3335,1000,881,119,0.483390768962196,0.125340599455041,0.980011209755885,340,119,221,35,1.9,3.32,7.4,0,0,0,0,0,0,0.119632976248215,3435.65361963055,11.9868895487331
7.5,"eps_greedy_SVM","SVM",9,10,29040,25718,3322,1100,968,132,0.489532881588731,0.139509536784741,1.3184153162197,379,132,247,39,1.9,3.65,7.3,0,0,0,0,0,0,0.120156652244002,3419.12181472013,12.0581751027931
7.5,"eps_greedy_SVM","SVM",9,11,28940,25640,3300,1200,1046,154,0.490450781165726,0.126430517711172,1.03736625240912,444,154,290,65,1.9,3.98,6.8,0,0,0,0,0,0,0.128345131900736,3683.62462588594,12.861701996695
7.5,"eps_greedy_SVM","SVM",9,12,28840,25548,3292,1300,1138,162,0.50798787552402,0.156403269754768,1.36066381699425,456,162,294,12,1.8,4.31,7,0,0,0,0,0,0,0.124383478409037,3524.63390806036,12.4607143780227
7.5,"eps_greedy_SVM","SVM",9,13,28740,25481,3259,1400,1205,195,0.520690083934247,0.173297002724796,1.45270163840387,509,195,314,53,1.6,4.64,6.2,0,0,0,0,0,0,0.142735965833922,3890.58995982583,14.4407679279593
7.5,"eps_greedy_SVM","SVM",9,14,28640,25419,3221,1500,1267,233,0.502222450043355,0.159128065395095,1.30087296106902,595,233,362,86,1.6,4.98,5.4,0,0,0,0,0,0,0.15614024987929,4361.16133372649,15.6965298045971
7.5,"eps_greedy_SVM","SVM",9,15,28540,25329,3211,1600,1357,243,0.511630241361393,0.15858310626703,1.31606321899465,632,243,389,37,1.6,5.31,5.6,0,0,0,0,0,0,0.151745188530367,4242.37962167704,15.1924185674138
7.5,"eps_greedy_SVM","SVM",9,16,28440,25241,3199,1700,1445,255,0.484152583615162,0.142234332425068,1.23053100285771,661,255,406,29,1.6,5.64,5.7,0,0,0,0,0,0,0.15002972398127,4189.51228476963,15.0452122252622
7.5,"eps_greedy_SVM","SVM",9,17,28340,25153,3187,1800,1533,267,0.490672289182428,0.14441416893733,1.23302480527938,716,267,449,55,1.7,5.97,5.7,0,0,0,0,0,0,0.148331828527794,4111.18119052714,14.8390068768214
7.5,"eps_greedy_SVM","SVM",9,18,28240,25074,3166,1900,1612,288,0.512773148617056,0.164032697547684,1.38871874105599,748,288,460,32,1.6,6.3,5.6,0,0,0,0,0,0,0.151095284784456,4186.80387686586,15.116867897503
7.5,"eps_greedy_SVM","SVM",9,19,28140,24984,3156,2000,1702,298,0.503785440253359,0.160762942779292,1.55715342954217,780,298,482,32,1.6,6.64,5.7,0,0,0,0,0,0,0.148589951531435,4146.57544851167,14.8616477332734
7.5,"eps_greedy_SVM","SVM",9,20,28040,24899,3141,2100,1787,313,0.504237020165463,0.15858310626703,1.49971813268182,849,313,536,69,1.7,6.97,5.7,0,0,0,0,0,0,0.148780112211287,4145.85471350113,14.8788367094012
7.5,"eps_greedy_SVM","SVM",9,21,27940,24810,3130,2200,1876,324,0.507541853898582,0.155313351498638,1.55616234045604,878,324,554,29,1.7,7.3,5.8,0,0,0,0,0,0,0.146931889341888,4070.59526751423,14.7604649144154
7.5,"eps_greedy_SVM","SVM",9,22,27840,24714,3126,2300,1972,328,0.508991331543155,0.15149863760218,1.35215325314016,901,328,573,23,1.7,7.63,6,0,0,0,0,0,0,0.142266871652246,3934.76041472226,14.2343258541953
7.5,"eps_greedy_SVM","SVM",9,23,27740,24629,3111,2400,2057,343,0.514429229835565,0.171117166212534,1.63550491288911,922,343,579,21,1.7,7.96,6,0,0,0,0,0,0,0.142450384449375,3892.66156684946,14.247234880182
7.5,"eps_greedy_SVM","SVM",9,24,27640,24544,3096,2500,2142,358,0.504455893142556,0.15858310626703,1.40670042075123,995,358,637,73,1.8,8.29,6,0,0,0,0,0,0,0.142783760941733,3914.45334514104,14.2812751761303
7.5,"eps_greedy_SVM","SVM",9,25,27540,24459,3081,2600,2227,373,0.51064506592951,0.163487738419619,1.54359286528688,1026,373,653,31,1.8,8.63,6,0,0,0,0,0,0,0.142894907183715,3868.48900236771,14.2948288083795
7.5,"eps_greedy_SVM","SVM",9,26,27440,24376,3064,2700,2310,390,0.507974659153513,0.167847411444142,1.612250546878,1066,390,676,40,1.7,8.96,5.9,0,0,0,0,0,0,0.143973965390032,3892.90467142663,14.4035269042745
7.5,"eps_greedy_SVM","SVM",9,27,27340,24285,3055,2800,2401,399,0.514639744796415,0.159128065395095,1.59056107763749,1077,399,678,11,1.7,9.29,6,0,0,0,0,0,0,0.141842890497869,3814.12731441574,14.1886537448241
7.5,"eps_greedy_SVM","SVM",9,28,27240,24200,3040,2900,2486,414,0.512685904102672,0.159128065395095,1.63826642392818,1108,414,694,31,1.7,9.62,6,0,0,0,0,0,0,0.142722788713178,3870.19276668566,14.273409415593
7.5,"eps_greedy_SVM","SVM",9,29,27140,24124,3016,3000,2562,438,0.510838823685386,0.159128065395095,1.57195015466026,1129,438,691,21,1.6,9.95,5.8,0,0,0,0,0,0,0.145422768287297,3873.04671066324,14.5513483558632
7.5,"eps_greedy_SVM","SVM",9,30,27040,24032,3008,3100,2654,446,0.514414819462729,0.164577656675749,1.61083256046913,1178,446,732,49,1.6,10.29,6,0,0,0,0,0,0,0.143817204947527,3873.07454764752,14.3823045056673
7.5,"eps_greedy_SVM","SVM",9,31,26940,23947,2993,3200,2739,461,0.508165987732241,0.156403269754768,1.51103302375561,1207,461,746,29,1.6,10.62,5.9,0,0,0,0,0,0,0.143715287650944,3835.8581629764,14.3738197354996
7.5,"eps_greedy_SVM","SVM",9,32,26840,23856,2984,3300,2830,470,0.514860594053205,0.168392370572207,1.60202159154039,1252,470,782,45,1.7,10.95,6,0,0,0,0,0,0,0.141923691376819,3744.5812098859,14.1955590609281
7.5,"eps_greedy_SVM","SVM",9,33,26740,23768,2972,3400,2918,482,0.510933767456103,0.170572207084469,1.71196106202325,1271,482,789,19,1.6,11.28,6.1,0,0,0,0,0,0,0.141278093437332,3706.62150489754,14.1348816224315
7.5,"eps_greedy_SVM","SVM",9,34,26640,23686,2954,3500,3000,500,0.514485389117123,0.168392370572207,1.68584253549405,1297,500,797,26,1.6,11.61,6,0,0,0,0,0,0,0.142775830518651,3791.5009123845,14.2787911635787
7.5,"eps_greedy_SVM","SVM",9,35,26540,23605,2935,3600,3081,519,0.513408975438963,0.168392370572207,1.67008913151936,1367,519,848,70,1.6,11.94,5.9,0,0,0,0,0,0,0.143624438445,3750.30555645616,14.3684471962045
7.5,"eps_greedy_SVM","SVM",9,36,26440,23512,2928,3700,3174,526,0.514392215763632,0.163487738419619,1.63677019597196,1377,526,851,10,1.6,12.28,6,0,0,0,0,0,0,0.141749987150187,3715.6624943641,14.1778398692672
7.5,"eps_greedy_SVM","SVM",9,37,26340,23430,2910,3800,3256,544,0.513159881851409,0.174386920980926,1.65417334684947,1399,544,855,22,1.6,12.61,6,0,0,0,0,0,0,0.143090001372961,3754.42530866515,14.3098001389124
7.5,"eps_greedy_SVM","SVM",9,38,26240,23345,2895,3900,3341,559,0.515777834870299,0.169482288828338,1.63537961084637,1443,559,884,44,1.6,12.94,6,0,0,0,0,0,0,0.142937425919795,3716.28889514173,14.2954427250214
7.5,"eps_greedy_SVM","SVM",9,39,26140,23258,2882,4000,3428,572,0.512559957444109,0.166212534059946,1.55578148819455,1471,572,899,28,1.6,13.27,6,0,0,0,0,0,0,0.142668129169433,3693.18122157633,14.2682685106978
7.5,"eps_greedy_SVM","SVM",9,40,26040,23164,2876,4100,3522,578,0.508639636101033,0.165122615803815,1.60343680496048,1504,578,926,33,1.6,13.6,6.1,0,0,0,0,0,0,0.140620316570887,3627.63639710461,14.0639315270081
7.5,"eps_greedy_SVM","SVM",9,41,25940,23076,2864,4200,3610,590,0.51405171923982,0.171662125340599,1.52041428207763,1509,590,919,5,1.6,13.93,6.1,0,0,0,0,0,0,0.140142777151606,3603.89838132986,14.0151637718429
7.5,"eps_greedy_SVM","SVM",9,42,25840,22990,2850,4300,3696,604,0.515487321753982,0.168937329700272,1.57150689455867,1530,604,926,21,1.5,14.27,6.1,0,0,0,0,0,0,0.14003837242826,3533.98406501747,14.0064217149425
7.5,"eps_greedy_SVM","SVM",9,43,25740,22905,2835,4400,3781,619,0.511403586782969,0.164032697547684,1.46947915133114,1579,619,960,49,1.6,14.6,6.1,0,0,0,0,0,0,0.1403198959045,3577.43296755477,14.0344703367546
7.5,"eps_greedy_SVM","SVM",9,44,25640,22817,2823,4500,3869,631,0.512437633965002,0.164577656675749,1.60659352741527,1594,631,963,15,1.5,14.93,6.1,0,0,0,0,0,0,0.139847202597759,3547.64354413693,13.9873287860394
7.5,"eps_greedy_SVM","SVM",9,45,25540,22735,2805,4600,3951,649,0.513839680896708,0.171117166212534,1.73171657357544,1652,649,1003,58,1.5,15.26,6.1,0,0,0,0,0,0,0.140702032941569,3554.75883831494,14.0725576184075
7.5,"eps_greedy_SVM","SVM",9,46,25440,22648,2792,4700,4038,662,0.513501531205047,0.169482288828338,1.54991085545127,1654,662,992,2,1.5,15.59,6.1,0,0,0,0,0,0,0.140788522083983,3564.18269939813,14.0797277628135
7.5,"eps_greedy_SVM","SVM",9,47,25340,22564,2776,4800,4122,678,0.514496423345466,0.169482288828338,1.52228296028725,1681,678,1003,27,1.5,15.93,6.1,0,0,0,0,0,0,0.140819838732434,3491.1635561213,14.0873699908723
7.5,"eps_greedy_SVM","SVM",9,48,25240,22479,2761,4900,4207,693,0.514729294970453,0.170027247956403,1.52147469097851,1737,693,1044,56,1.5,16.26,6.1,0,0,0,0,0,0,0.141044437798904,3522.86120499115,14.1060616014315
7.5,"eps_greedy_SVM","SVM",10,0,30040,26493,3547,100,88,12,0.410918533981688,0.0705202312138728,0.609577763328333,48,12,36,0,3,0.33,7.3,0,0,0,0,0,0,0.149391249621253,3561.50447692078,15.193414079784
7.5,"eps_greedy_SVM","SVM",10,1,29940,26400,3540,200,181,19,0.433222241141981,0.0878612716763006,0.720393339542402,63,19,44,15,2.3,0.66,9.5,0,0,0,0,0,0,0.13982864871712,2436.19455212131,14.3698883977669
7.5,"eps_greedy_SVM","SVM",10,2,29840,26302,3538,300,279,21,0.567504494164411,0.175722543352601,1.80344589798195,76,21,55,13,2.6,1,13.3,0,0,0,0,0,0,0.162689265745302,2281.04641227408,19.3096897908761
7.5,"eps_greedy_SVM","SVM",10,3,29740,26245,3495,400,336,64,0.549601753558175,0.153757225433526,1.47757919892155,158,64,94,82,1.5,1.33,5.2,0,0,0,0,0,0,0.453255533590493,4974.72025679511,52.4129594415566
7.5,"eps_greedy_SVM","SVM",10,4,29640,26159,3481,500,422,78,0.495049638365453,0.132369942196532,1.20537317773658,196,78,118,38,1.5,1.66,5.4,0,0,0,0,0,0,0.249810557899736,4362.24923255443,26.9146265110285
7.5,"eps_greedy_SVM","SVM",10,5,29540,26075,3465,600,506,94,0.5111421048504,0.113872832369942,1.01297217367926,232,94,138,36,1.5,1.99,5.4,0,0,0,0,0,0,0.192953855974478,4209.42702423849,20.0131437730937
7.5,"eps_greedy_SVM","SVM",10,6,29440,25991,3449,700,590,110,0.546142600952427,0.139884393063584,1.2278560121279,284,110,174,52,1.6,2.32,5.4,0,0,0,0,0,0,0.159971251744268,4558.45819441512,16.045955912248
7.5,"eps_greedy_SVM","SVM",10,7,29340,25909,3431,800,672,128,0.474688571412478,0.114450867052023,0.994935438932091,323,128,195,39,1.5,2.65,5.2,0,0,0,0,0,0,0.161310687331066,4706.1462558666,16.1665288245368
7.5,"eps_greedy_SVM","SVM",10,8,29240,25829,3411,900,752,148,0.499520579135207,0.132947976878613,1.17271009337483,379,148,231,56,1.6,2.99,5.1,0,0,0,0,0,0,0.193694555445259,4455.08366023861,23.404579835087
7.5,"eps_greedy_SVM","SVM",10,9,29140,25747,3393,1000,834,166,0.488186229334319,0.125433526011561,1.2368736480017,425,166,259,46,1.6,3.32,5,0,0,0,0,0,0,0.174448442565881,4444.61824418458,17.9181632172666
7.5,"eps_greedy_SVM","SVM",10,10,29040,25670,3370,1100,911,189,0.519362190439919,0.14393063583815,1.48475295300327,460,189,271,35,1.4,3.65,4.8,0,0,0,0,0,0,0.17626166715261,4536.04024870523,17.8150640572164
7.5,"eps_greedy_SVM","SVM",10,11,28940,25604,3336,1200,977,223,0.532796893231482,0.167630057803468,1.58048279945408,536,223,313,76,1.4,3.98,4.4,0,0,0,0,0,0,0.210619321812012,4609.15372834769,21.5627647575188
7.5,"eps_greedy_SVM","SVM",10,12,28840,25540,3300,1300,1041,259,0.508924073859852,0.149132947976879,1.42649899274167,612,259,353,76,1.4,4.31,4,0,0,0,0,0,0,0.209934783049915,4349.17786904379,21.3170716799961
7.5,"eps_greedy_SVM","SVM",10,13,28740,25456,3284,1400,1125,275,0.517519983812776,0.151445086705202,1.5150540336768,658,275,383,46,1.4,4.64,4.1,0,0,0,0,0,0,0.199960812768945,4276.17152486556,20.9717473839704
7.5,"eps_greedy_SVM","SVM",10,14,28640,25382,3258,1500,1199,301,0.51770009701069,0.160115606936416,1.5332957087758,705,301,404,47,1.3,4.98,4,0,0,0,0,0,0,0.202105407594653,4747.9630621179,20.3594115570113
7.5,"eps_greedy_SVM","SVM",10,15,28540,25296,3244,1600,1285,315,0.514899871880025,0.152023121387283,1.48844532233079,749,315,434,44,1.4,5.31,4.1,0,0,0,0,0,0,0.194849962471742,4563.15037658237,19.5942248394654
7.5,"eps_greedy_SVM","SVM",10,16,28440,25214,3226,1700,1367,333,0.513291374800525,0.152023121387283,1.47344618532387,791,333,458,42,1.4,5.64,4.1,0,0,0,0,0,0,0.195405951598053,5222.32927238262,19.602898029874
7.5,"eps_greedy_SVM","SVM",10,17,28340,25131,3209,1800,1450,350,0.518292776451227,0.150867052023121,1.45825601846486,842,350,492,51,1.4,5.97,4.1,0,0,0,0,0,0,0.193109471212129,4496.70286028748,19.34452959197
7.5,"eps_greedy_SVM","SVM",10,18,28240,25043,3197,1900,1538,362,0.519008723163369,0.155491329479769,1.5694456602122,878,362,516,36,1.4,6.3,4.2,0,0,0,0,0,0,0.187701848356971,4426.87560197922,18.8157491799115
7.5,"eps_greedy_SVM","SVM",10,19,28140,24972,3168,2000,1609,391,0.51725291194557,0.154913294797688,1.51041069819706,953,391,562,75,1.4,6.64,4.1,0,0,0,0,0,0,0.304033553008198,4372.29210120021,32.6407297147002
7.5,"eps_greedy_SVM","SVM",10,20,28040,24880,3160,2100,1701,399,0.514506759769203,0.147976878612717,1.48882939111316,948,399,549,-5,1.4,6.97,4.3,0,0,0,0,0,0,0.188319972610932,4129.27877469302,18.9895698609354
7.5,"eps_greedy_SVM","SVM",10,21,27940,24803,3137,2200,1778,422,0.51558540255538,0.155491329479769,1.53287043564077,1019,422,597,71,1.4,7.3,4.2,0,0,0,0,0,0,0.188799343537045,4789.80520198458,18.8847453748576
7.5,"eps_greedy_SVM","SVM",10,22,27840,24723,3117,2300,1858,442,0.51536612112775,0.158381502890173,1.62868308620256,1079,442,637,60,1.4,7.63,4.2,0,0,0,0,0,0,0.190993795668632,4546.83237767721,19.1090470250046
7.5,"eps_greedy_SVM","SVM",10,23,27740,24639,3101,2400,1942,458,0.51693519001141,0.157225433526012,1.54535511435034,1103,458,645,24,1.4,7.96,4.2,0,0,0,0,0,0,0.188106014912715,4402.62052244619,18.8239614937589
7.5,"eps_greedy_SVM","SVM",10,24,27640,24555,3085,2500,2026,474,0.51637782263638,0.155491329479769,1.60875511067249,1143,474,669,40,1.4,8.29,4.3,0,0,0,0,0,0,0.186694307037307,4041.30103971176,18.6896600887453
7.5,"eps_greedy_SVM","SVM",10,25,27540,24472,3068,2600,2109,491,0.516096972564476,0.158959537572254,1.58737243676643,1172,491,681,29,1.4,8.63,4.3,0,0,0,0,0,0,0.185606783756947,4299.10546739157,18.5934843479082
7.5,"eps_greedy_SVM","SVM",10,26,27440,24379,3061,2700,2202,498,0.517543034142653,0.154913294797688,1.56322430565346,1176,498,678,4,1.4,8.96,4.4,0,0,0,0,0,0,0.181085457822886,3849.70204284769,18.1444672159871
7.5,"eps_greedy_SVM","SVM",10,27,27340,24290,3050,2800,2291,509,0.513501297447605,0.157803468208092,1.5150540336768,1226,509,717,50,1.4,9.29,4.5,0,0,0,0,0,0,0.179436209732895,4231.90780885023,18.0373096360268
7.5,"eps_greedy_SVM","SVM",10,28,27240,24205,3035,2900,2376,524,0.51503015823705,0.158381502890173,1.65323378848138,1236,524,712,10,1.4,9.62,4.5,0,0,0,0,0,0,0.178336669269085,4179.64750017543,17.9210691233528
7.5,"eps_greedy_SVM","SVM",10,29,27140,24119,3021,3000,2462,538,0.512311389159324,0.157225433526012,1.55293038451872,1265,538,727,29,1.4,9.95,4.6,0,0,0,0,0,0,0.17692968280604,3845.92410174674,17.7470514423107
7.5,"eps_greedy_SVM","SVM",10,30,27040,24035,3005,3100,2546,554,0.514093500283576,0.158959537572254,1.57081277315663,1309,554,755,44,1.4,10.29,4.6,0,0,0,0,0,0,0.175869353609335,3877.85037389616,17.6209793883949
7.5,"eps_greedy_SVM","SVM",10,31,26940,23949,2991,3200,2632,568,0.511115978254697,0.15606936416185,1.53777984418196,1358,568,790,49,1.4,10.62,4.6,0,0,0,0,0,0,0.174268529145358,3792.58848376775,17.4512113206556
7.5,"eps_greedy_SVM","SVM",10,32,26840,23868,2972,3300,2713,587,0.511799602511788,0.157225433526012,1.61015768705495,1397,587,810,39,1.4,10.95,4.6,0,0,0,0,0,0,0.174906285050462,3889.33060449193,17.5136462374307
7.5,"eps_greedy_SVM","SVM",10,33,26740,23795,2945,3400,2786,614,0.512804111624254,0.160115606936416,1.568690124904,1451,614,837,54,1.4,11.28,4.5,0,0,0,0,0,0,0.178355249101625,4112.42348142401,17.85424565104
7.5,"eps_greedy_SVM","SVM",10,34,26640,23706,2934,3500,2875,625,0.510946913617156,0.154913294797688,1.59219124949064,1491,625,866,40,1.4,11.61,4.6,0,0,0,0,0,0,0.174843568054695,3716.21582633946,17.5305529745335
7.5,"eps_greedy_SVM","SVM",10,35,26540,23613,2927,3600,2968,632,0.512554154193716,0.159537572254335,1.6031691554271,1519,632,887,28,1.4,11.94,4.7,0,0,0,0,0,0,0.171515057164419,3472.53117799049,17.1926932273132
7.5,"eps_greedy_SVM","SVM",10,36,26440,23524,2916,3700,3057,643,0.511539159780812,0.156647398843931,1.57702752330501,1555,643,912,36,1.4,12.28,4.8,0,0,0,0,0,0,0.169522704918334,3643.16532491441,16.9802607801073
7.5,"eps_greedy_SVM","SVM",10,37,26340,23432,2908,3800,3149,651,0.511288769073393,0.159537572254335,1.64526429114032,1552,651,901,-3,1.4,12.61,4.8,0,0,0,0,0,0,0.167691083151858,3629.04013890861,16.823788874921
7.5,"eps_greedy_SVM","SVM",10,38,26240,23349,2891,3900,3232,668,0.511983961823107,0.157803468208092,1.6121306930892,1615,668,947,63,1.4,12.94,4.8,0,0,0,0,0,0,0.16906955029114,3866.18145687495,16.9324762178614
7.5,"eps_greedy_SVM","SVM",10,39,26140,23258,2882,4000,3323,677,0.510951116402864,0.157225433526012,1.57630512551033,1641,677,964,26,1.4,13.27,4.9,0,0,0,0,0,0,0.165506233669438,3521.00628499514,16.5783000185121
7.5,"eps_greedy_SVM","SVM",10,40,26040,23164,2876,4100,3417,683,0.509314109704842,0.153179190751445,1.49959429863928,1655,683,972,14,1.4,13.6,5,0,0,0,0,0,0,0.164046609213558,3805.98585389717,16.4264884369169
7.5,"eps_greedy_SVM","SVM",10,41,25940,23071,2869,4200,3510,690,0.511069227679633,0.15606936416185,1.56732008986041,1719,690,1029,64,1.5,13.93,5.1,0,0,0,0,0,0,0.160013182680958,3388.39953986567,16.0351981619943
7.5,"eps_greedy_SVM","SVM",10,42,25840,22982,2858,4300,3599,701,0.511853155533832,0.15606936416185,1.55835073490099,1718,701,1017,-1,1.5,14.27,5.1,0,0,0,0,0,0,0.160569526023785,3715.93544136,16.0733565529454
7.5,"eps_greedy_SVM","SVM",10,43,25740,22893,2847,4400,3688,712,0.513065334253613,0.154335260115607,1.52166999015574,1742,712,1030,24,1.4,14.6,5.2,0,0,0,0,0,0,0.159264048087586,3606.80012365092,15.9501269043243
7.5,"eps_greedy_SVM","SVM",10,44,25640,22800,2840,4500,3781,719,0.509561640784875,0.153757225433526,1.43412732960125,1795,719,1076,53,1.5,14.93,5.3,0,0,0,0,0,0,0.156937642497492,3405.35070642288,15.7237845592274
7.5,"eps_greedy_SVM","SVM",10,45,25540,22711,2829,4600,3870,730,0.512059655293583,0.158381502890173,1.64383362653933,1792,730,1062,-3,1.5,15.26,5.3,0,0,0,0,0,0,0.154150943611692,3188.67285530391,15.4311719356018
7.5,"eps_greedy_SVM","SVM",10,46,25440,22619,2821,4700,3962,738,0.51107577016048,0.15028901734104,1.50015511944703,1843,738,1105,51,1.5,15.59,5.4,0,0,0,0,0,0,0.154083436195082,3247.0652306242,15.443231723012
7.5,"eps_greedy_SVM","SVM",10,47,25340,22527,2813,4800,4054,746,0.510209389716523,0.15028901734104,1.48362824040185,1846,746,1100,3,1.5,15.93,5.4,0,0,0,0,0,0,0.152085311259165,3190.63194533338,15.2372918009798
7.5,"eps_greedy_SVM","SVM",10,48,25240,22432,2808,4900,4149,751,0.508061029647837,0.147976878612717,1.44682334894399,1862,751,1111,16,1.5,16.26,5.5,0,0,0,0,0,0,0.149234576133072,3133.51538596867,14.9515436326372
7.5,"eps_greedy_SVM","SVM",11,0,30040,26530,3510,100,92,8,0.556668697435298,0.194805194805195,2.08085619368628,29,8,21,0,2.6,0.33,11.5,0,0,0,0,0,0,0.609083671720449,2377.34085817012,70.7714784826964
7.5,"eps_greedy_SVM","SVM",11,1,29940,26479,3461,200,143,57,0.526977282279671,0.18746470920384,1.72892050017208,120,57,63,91,1.1,0.66,2.5,0,0,0,0,0,0,0.35964914561485,6760.309455092,39.3716166344194
7.5,"eps_greedy_SVM","SVM",11,2,29840,26412,3428,300,210,90,0.481972973087716,0.117447769621683,1.14512916245164,193,90,103,73,1.1,1,2.3,0,0,0,0,0,0,0.343395966582101,6835.18422879379,37.1845527591131
7.5,"eps_greedy_SVM","SVM",11,3,29740,26349,3391,400,273,127,0.507615382329344,0.107848673066064,0.820595708639187,273,127,146,80,1.1,1.33,2.1,0,0,0,0,0,0,0.46753153629574,7511.85178221732,48.496550177316
7.5,"eps_greedy_SVM","SVM",11,4,29640,26257,3383,500,365,135,0.554388455611082,0.14455110107284,1.31509398449513,299,135,164,26,1.2,1.66,2.7,0,0,0,0,0,0,0.300845235317636,7128.86213325764,31.6363375300095
7.5,"eps_greedy_SVM","SVM",11,5,29540,26178,3362,600,444,156,0.516642014409256,0.134952004517222,1.21886322463768,349,156,193,50,1.2,1.99,2.8,0,0,0,0,0,0,0.264531288160727,7300.41805932786,26.7033575130514
7.5,"eps_greedy_SVM","SVM",11,6,29440,26098,3342,700,524,176,0.541135376555441,0.134387351778656,1.13911798574585,381,176,205,32,1.2,2.32,3,0,0,0,0,0,0,0.304479271461688,6402.08314844463,33.247980390399
7.5,"eps_greedy_SVM","SVM",11,7,29340,26014,3326,800,608,192,0.589807084056839,0.203839638622247,1.92564766750259,421,192,229,40,1.2,2.65,3.2,0,0,0,0,0,0,0.238711029074111,5165.20711717535,26.0804933426758
7.5,"eps_greedy_SVM","SVM",11,8,29240,25949,3291,900,673,227,0.582729183206464,0.192546583850932,1.80331988121526,499,227,272,78,1.2,2.99,3,0,0,0,0,0,0,0.230385578756485,4807.27970378602,23.9052439744949
7.5,"eps_greedy_SVM","SVM",11,9,29140,25869,3271,1000,753,247,0.578750228196133,0.207227555053642,1.93169087514246,544,247,297,45,1.2,3.32,3,0,0,0,0,0,0,0.360110370473981,3973.72158868661,42.16568231887
7.5,"eps_greedy_SVM","SVM",11,10,29040,25795,3245,1100,827,273,0.576833062328323,0.204404291360813,1.99263068529756,602,273,329,58,1.2,3.65,3,0,0,0,0,0,0,0.222038130611553,3970.328347554,22.7889598901337
7.5,"eps_greedy_SVM","SVM",11,11,28940,25727,3213,1200,895,305,0.583870248744391,0.224731789949181,2.14805274263804,675,305,370,73,1.2,3.98,2.9,0,0,0,0,0,0,0.231844159004356,3688.4469734558,24.9697847822952
7.5,"eps_greedy_SVM","SVM",11,12,28840,25645,3195,1300,977,323,0.581810879542165,0.210615471485037,2.0974001033534,710,323,387,35,1.2,4.31,3,0,0,0,0,0,0,0.228882938276743,4415.57741270756,23.6631692519252
7.5,"eps_greedy_SVM","SVM",11,13,28740,25562,3178,1400,1060,340,0.580008491018631,0.210615471485037,2.03153667921284,751,340,411,41,1.2,4.64,3.1,0,0,0,0,0,0,0.226869032543159,4842.45253929208,22.8984683046787
7.5,"eps_greedy_SVM","SVM",11,14,28640,25484,3156,1500,1138,362,0.58047967886968,0.214003387916431,2.00188399993035,804,362,442,53,1.2,4.98,3.1,0,0,0,0,0,0,0.220945293302069,4224.8638888403,22.9179900846311
7.5,"eps_greedy_SVM","SVM",11,15,28540,25405,3135,1600,1217,383,0.579351668272879,0.211744776962168,2.06005052051439,848,383,465,44,1.2,5.31,3.2,0,0,0,0,0,0,0.227959987203648,4459.25409628271,24.9901732799458
7.5,"eps_greedy_SVM","SVM",11,16,28440,25324,3116,1700,1298,402,0.588901771651041,0.221908526256352,2.25985457593887,889,402,487,41,1.2,5.64,3.2,0,0,0,0,0,0,0.242129479322602,3575.11044310276,25.0127559814808
7.5,"eps_greedy_SVM","SVM",11,17,28340,25259,3081,1800,1363,437,0.59025214079807,0.220779220779221,2.26532745408859,978,437,541,89,1.2,5.97,3.1,0,0,0,0,0,0,0.224088372873924,4175.69419040862,22.6317161856738
7.5,"eps_greedy_SVM","SVM",11,18,28240,25195,3045,1900,1427,473,0.59198388404665,0.22755505364201,2.19465363012274,1044,473,571,66,1.2,6.3,3,0,0,0,0,0,0,0.246626520363186,4651.77496095896,26.1586843048842
7.5,"eps_greedy_SVM","SVM",11,19,28140,25113,3027,2000,1509,491,0.595566244804555,0.228119706380576,2.21316530876418,1095,491,604,51,1.2,6.64,3.1,0,0,0,0,0,0,0.23274024763323,4610.77869620265,23.3363281361632
7.5,"eps_greedy_SVM","SVM",11,20,28040,25044,2996,2100,1578,522,0.595703926671555,0.226990400903444,2.19585993276168,1169,522,647,74,1.2,6.97,3,0,0,0,0,0,0,0.238711720138287,5415.31023623057,23.9467141342479
7.5,"eps_greedy_SVM","SVM",11,21,27940,24962,2978,2200,1660,540,0.592923967173717,0.231507622811971,2.25152650354149,1208,540,668,39,1.2,7.3,3.1,0,0,0,0,0,0,0.233494354886564,4533.06198738738,23.4370018526898
7.5,"eps_greedy_SVM","SVM",11,22,27840,24879,2961,2300,1743,557,0.590063512819316,0.232072275550536,2.20736662236567,1241,557,684,33,1.2,7.63,3.1,0,0,0,0,0,0,0.233788780859106,5075.35525671831,23.5124980341508
7.5,"eps_greedy_SVM","SVM",11,23,27740,24799,2941,2400,1823,577,0.590304954933923,0.229813664596273,2.21642382008236,1284,577,707,43,1.2,7.96,3.2,0,0,0,0,0,0,0.231516024358085,5206.24520473556,23.2130211695781
7.5,"eps_greedy_SVM","SVM",11,24,27640,24723,2917,2500,1899,601,0.589950157720672,0.235460191981931,2.18467033927647,1341,601,740,57,1.2,8.29,3.2,0,0,0,0,0,0,0.229353796477537,5107.66718914144,22.9958289033113
7.5,"eps_greedy_SVM","SVM",11,25,27540,24634,2906,2600,1988,612,0.590670705561198,0.232072275550536,2.17711745997042,1369,612,757,28,1.2,8.63,3.2,0,0,0,0,0,0,0.220762059520807,4314.40173667486,22.1609102832217
7.5,"eps_greedy_SVM","SVM",11,26,27440,24556,2884,2700,2066,634,0.593376113915509,0.234895539243365,2.16990905320028,1421,634,787,52,1.2,8.96,3.3,0,0,0,0,0,0,0.221740092487291,4254.20000340861,22.2236615068941
7.5,"eps_greedy_SVM","SVM",11,27,27340,24474,2866,2800,2148,652,0.593856493294213,0.236589497459063,2.180887360334,1474,652,822,53,1.3,9.29,3.3,0,0,0,0,0,0,0.21942651413124,4200.46793353516,21.9718391562787
7.5,"eps_greedy_SVM","SVM",11,28,27240,24386,2854,2900,2236,664,0.594289768747108,0.234895539243365,2.15141590951868,1522,664,858,48,1.3,9.62,3.4,0,0,0,0,0,0,0.218139790629308,4328.9081894215,21.8530262158946
7.5,"eps_greedy_SVM","SVM",11,29,27140,24301,2839,3000,2321,679,0.594176901882027,0.235460191981931,2.16990905320028,1562,679,883,40,1.3,9.95,3.4,0,0,0,0,0,0,0.215224162412296,4192.52494229992,21.6025140641917
7.5,"eps_greedy_SVM","SVM",11,30,27040,24226,2814,3100,2396,704,0.596695253096037,0.232072275550536,2.16065446873223,1627,704,923,65,1.3,10.29,3.4,0,0,0,0,0,0,0.21475132613203,3957.60189538554,21.5842225579439
7.5,"eps_greedy_SVM","SVM",11,31,26940,24144,2796,3200,2478,722,0.597654525925207,0.235460191981931,2.17540296339935,1656,722,934,29,1.3,10.62,3.4,0,0,0,0,0,0,0.216922773359046,4668.79732799107,21.7474924803347
7.5,"eps_greedy_SVM","SVM",11,32,26840,24070,2770,3300,2552,748,0.596332474325282,0.234895539243365,2.05741500606243,1727,748,979,71,1.3,10.95,3.4,0,0,0,0,0,0,0.218528062704196,4740.99433908578,21.907352724982
7.5,"eps_greedy_SVM","SVM",11,33,26740,23987,2753,3400,2635,765,0.597935493731502,0.2343308865048,2.15701855511638,1784,765,1019,57,1.3,11.28,3.4,0,0,0,0,0,0,0.213757272995676,4013.98050868957,21.4280008941416
7.5,"eps_greedy_SVM","SVM",11,34,26640,23910,2730,3500,2712,788,0.597505720823801,0.234895539243365,2.11640898473089,1823,788,1035,39,1.3,11.61,3.4,0,0,0,0,0,0,0.21234860102237,3763.04712881059,21.3064350578368
7.5,"eps_greedy_SVM","SVM",11,35,26540,23831,2709,3600,2791,809,0.598229282975933,0.236024844720497,2.01009268093226,1892,809,1083,69,1.3,11.94,3.4,0,0,0,0,0,0,0.217921358311223,4986.62419875788,21.8079313413819
7.5,"eps_greedy_SVM","SVM",11,36,26440,23745,2695,3700,2877,823,0.598117498715739,0.233201581027668,2.10364855157575,1924,823,1101,32,1.3,12.28,3.5,0,0,0,0,0,0,0.214076835836455,4479.12794510854,21.4446651757071
7.5,"eps_greedy_SVM","SVM",11,37,26340,23663,2677,3800,2959,841,0.598420882811211,0.232636928289102,2.04557457642592,1941,841,1100,17,1.3,12.61,3.5,0,0,0,0,0,0,0.213170346939509,4368.63896005413,21.3606494665114
7.5,"eps_greedy_SVM","SVM",11,38,26240,23576,2664,3900,3046,854,0.596983523178359,0.232636928289102,1.9749895452522,1961,854,1107,20,1.3,12.94,3.6,0,0,0,0,0,0,0.210044082243877,4191.85181685856,21.0612894728711
7.5,"eps_greedy_SVM","SVM",11,39,26140,23489,2651,4000,3133,867,0.599068195616087,0.235460191981931,1.9997491508417,2035,867,1168,74,1.3,13.27,3.6,0,0,0,0,0,0,0.206285421215037,3875.76093676328,20.6893621273992
7.5,"eps_greedy_SVM","SVM",11,40,26040,23409,2631,4100,3213,887,0.601875241463341,0.233766233766234,2.09128888709634,2096,887,1209,61,1.4,13.6,3.6,0,0,0,0,0,0,0.208270658045358,4233.36031456985,20.8714712223593
7.5,"eps_greedy_SVM","SVM",11,41,25940,23332,2608,4200,3290,910,0.602648858170274,0.234895539243365,2.12565044952444,2143,910,1233,47,1.4,13.93,3.6,0,0,0,0,0,0,0.209779215478463,4143.34953861797,21.0437183961963
7.5,"eps_greedy_SVM","SVM",11,42,25840,23249,2591,4300,3373,927,0.603478218414481,0.2343308865048,2.06388242878793,2186,927,1259,43,1.4,14.27,3.6,0,0,0,0,0,0,0.206125479690798,3854.60481117605,20.6556257133384
7.5,"eps_greedy_SVM","SVM",11,43,25740,23169,2571,4400,3453,947,0.600973962291388,0.237718802936194,2.17507296265809,2179,947,1232,-7,1.3,14.6,3.6,0,0,0,0,0,0,0.208545065818079,4278.64457277323,22.091401582483
7.5,"eps_greedy_SVM","SVM",11,44,25640,23093,2547,4500,3529,971,0.604663140063606,0.236589497459063,2.00361078022632,2258,971,1287,79,1.3,14.93,3.6,0,0,0,0,0,0,0.210164560388182,4361.47450419517,21.0949398510549
7.5,"eps_greedy_SVM","SVM",11,45,25540,23011,2529,4600,3611,989,0.605941802558352,0.239412761151892,2.17507296265809,2325,989,1336,67,1.4,15.26,3.7,0,0,0,0,0,0,0.206140505333497,3826.86187112078,20.6697095039263
7.5,"eps_greedy_SVM","SVM",11,46,25440,22927,2513,4700,3695,1005,0.605808196380277,0.233766233766234,2.07056648944333,2372,1005,1367,47,1.4,15.59,3.7,0,0,0,0,0,0,0.207107264195296,4158.95435591993,20.7491507786131
7.5,"eps_greedy_SVM","SVM",11,47,25340,22849,2491,4800,3773,1027,0.608186742972621,0.240542066629023,2.12929965096401,2402,1027,1375,30,1.3,15.93,3.7,0,0,0,0,0,0,0.207388918831803,4258.57983390101,20.766721883811
7.5,"eps_greedy_SVM","SVM",11,48,25240,22773,2467,4900,3849,1051,0.607720076588982,0.231507622811971,2.11833958167229,2453,1051,1402,51,1.3,16.26,3.7,0,0,0,0,0,0,0.209760345333417,4639.97085681659,20.9986248733761
7.5,"eps_greedy_SVM","SVM",12,0,30040,26538,3502,100,80,20,0.597180222635802,0.204867006225241,1.82873170549582,51,20,31,0,1.6,0.33,4,0,0,0,0,0,0,0.638699131144972,5758.76342620335,66.1205223952922
7.5,"eps_greedy_SVM","SVM",12,1,29940,26474,3466,200,144,56,0.413502128281542,0.0888511601584607,0.733033091001394,130,56,74,79,1.3,0.66,2.6,0,0,0,0,0,0,0.28400364059979,8405.16520677308,28.4289579869568
7.5,"eps_greedy_SVM","SVM",12,2,29840,26391,3449,300,227,73,0.550359581401663,0.189586870401811,1.7210597057159,171,73,98,41,1.3,1,3.1,0,0,0,0,0,0,0.293002966661697,6954.67245840985,30.3821919384358
7.5,"eps_greedy_SVM","SVM",12,3,29740,26319,3421,400,299,101,0.506349048551979,0.129598189020939,1.04108014012164,242,101,141,71,1.4,1.33,3,0,0,0,0,0,0,0.29504972138008,7293.06422492792,30.7890489064997
7.5,"eps_greedy_SVM","SVM",12,4,29640,26234,3406,500,384,116,0.490195088787867,0.139784946236559,1.34751310429894,279,116,163,37,1.4,1.66,3.3,0,0,0,0,0,0,0.282188703045034,6388.34886041249,32.5968744739111
7.5,"eps_greedy_SVM","SVM",12,5,29540,26157,3383,600,461,139,0.490743068536865,0.142614601018676,1.36127929993983,327,139,188,48,1.4,1.99,3.3,0,0,0,0,0,0,0.305046509910866,5956.84641559584,33.373568153203
7.5,"eps_greedy_SVM","SVM",12,6,29440,26079,3361,700,539,161,0.483003801061824,0.129032258064516,1.20528878015136,395,161,234,68,1.5,2.32,3.3,0,0,0,0,0,0,0.25647493360965,6278.86480478845,26.3661723844938
7.5,"eps_greedy_SVM","SVM",12,7,29340,25997,3343,800,621,179,0.488780091243176,0.117147707979626,0.950237228290853,439,179,260,44,1.5,2.65,3.5,0,0,0,0,0,0,0.227686923267466,6425.17287624263,22.8800286631467
7.5,"eps_greedy_SVM","SVM",12,8,29240,25918,3322,900,700,200,0.491532794048431,0.117147707979626,1.11617878106236,490,200,290,51,1.4,2.99,3.5,0,0,0,0,0,0,0.251560484922252,6035.81746724411,27.1715593753878
7.5,"eps_greedy_SVM","SVM",12,9,29140,25829,3311,1000,789,211,0.496977029430791,0.12450481041313,1.09979062085535,522,211,311,32,1.5,3.32,3.7,0,0,0,0,0,0,0.231588402369854,5599.92949817883,24.2775626067093
7.5,"eps_greedy_SVM","SVM",12,10,29040,25744,3296,1100,874,226,0.516871731561563,0.153933220147142,1.44704532223011,560,226,334,38,1.5,3.65,3.9,0,0,0,0,0,0,0.2128338230107,5527.40652086879,21.4860270966456
7.5,"eps_greedy_SVM","SVM",12,11,28940,25654,3286,1200,964,236,0.510098341138284,0.139784946236559,1.35431569052411,584,236,348,24,1.5,3.98,4.1,0,0,0,0,0,0,0.203458789833656,5089.01717429152,20.586207951139
7.5,"eps_greedy_SVM","SVM",12,12,28840,25566,3274,1300,1052,248,0.501969124093379,0.144312393887946,1.43783475715168,608,248,360,24,1.5,4.31,4.2,0,0,0,0,0,0,0.194962911188526,5092.69906055783,19.9969718978009
7.5,"eps_greedy_SVM","SVM",12,13,28740,25501,3239,1400,1117,283,0.513542463198324,0.131295981890209,1.17515955427788,692,283,409,84,1.4,4.64,3.9,0,0,0,0,0,0,0.215765819117901,4840.40879081226,22.3251832177821
7.5,"eps_greedy_SVM","SVM",12,14,28640,25436,3204,1500,1182,318,0.520757614970258,0.145444255800792,1.43265889533627,780,318,462,88,1.5,4.98,3.7,0,0,0,0,0,0,0.217685277344658,5150.06183551733,22.1058436054073
7.5,"eps_greedy_SVM","SVM",12,15,28540,25349,3191,1600,1269,331,0.520037822598517,0.157894736842105,1.48815818949255,803,331,472,23,1.4,5.31,3.8,0,0,0,0,0,0,0.210517604907188,5166.55733065079,21.6627714125631
7.5,"eps_greedy_SVM","SVM",12,16,28440,25269,3171,1700,1349,351,0.510440775308392,0.12110922467459,1.03942049061371,849,351,498,46,1.4,5.64,3.8,0,0,0,0,0,0,0.20908657382172,5183.60763625085,20.9885784008903
7.5,"eps_greedy_SVM","SVM",12,17,28340,25185,3155,1800,1433,367,0.515765052385199,0.140350877192982,1.25582509608674,904,367,537,55,1.5,5.97,3.9,0,0,0,0,0,0,0.205132215370559,5170.76173105573,20.5589048680454
7.5,"eps_greedy_SVM","SVM",12,18,28240,25102,3138,1900,1516,384,0.521905684015871,0.167515563101302,1.55957252655246,956,384,572,52,1.5,6.3,3.9,0,0,0,0,0,0,0.202509122848064,4980.57891197379,20.2974865704487
7.5,"eps_greedy_SVM","SVM",12,19,28140,25017,3123,2000,1601,399,0.520184409946364,0.160158460667799,1.53374983866003,991,399,592,35,1.5,6.64,4,0,0,0,0,0,0,0.199403387083484,4644.63913068242,20.135114302783
7.5,"eps_greedy_SVM","SVM",12,20,28040,24932,3108,2100,1686,414,0.518495847911241,0.144312393887946,1.36047718742731,1025,414,611,34,1.5,6.97,4.1,0,0,0,0,0,0,0.196837842634107,4653.37125837807,19.7301020429286
7.5,"eps_greedy_SVM","SVM",12,21,27940,24844,3096,2200,1774,426,0.521619911002848,0.155065082059989,1.44750510150555,1066,426,640,41,1.5,7.3,4.2,0,0,0,0,0,0,0.194387964851105,4554.77281146831,19.4810573162967
7.5,"eps_greedy_SVM","SVM",12,22,27840,24765,3075,2300,1853,447,0.517796048590436,0.147142048670062,1.41528401138222,1125,447,678,59,1.5,7.63,4.1,0,0,0,0,0,0,0.193071450344589,4674.74477402346,19.3298414233791
7.5,"eps_greedy_SVM","SVM",12,23,27740,24677,3063,2400,1941,459,0.522969527017163,0.170345217883418,1.58612178437038,1149,459,690,24,1.5,7.96,4.2,0,0,0,0,0,0,0.191097956578262,4857.81575764806,19.1215857350324
7.5,"eps_greedy_SVM","SVM",12,24,27640,24585,3055,2500,2033,467,0.518563228746702,0.156762874929259,1.31103021675897,1161,467,694,12,1.5,8.29,4.4,0,0,0,0,0,0,0.186754663550271,4752.85056444961,18.6868009015958
7.5,"eps_greedy_SVM","SVM",12,25,27540,24490,3050,2600,2128,472,0.518621378748021,0.153933220147142,1.37566862004126,1160,472,688,-1,1.5,8.63,4.5,0,0,0,0,0,0,0.181094602219115,4430.83438784942,18.1314214703999
7.5,"eps_greedy_SVM","SVM",12,26,27440,24399,3041,2700,2219,481,0.520785009703858,0.158460667798529,1.55957252655246,1174,481,693,14,1.4,8.96,4.6,0,0,0,0,0,0,0.178353615683931,4265.21893406898,17.8521790003238
7.5,"eps_greedy_SVM","SVM",12,27,27340,24309,3031,2800,2309,491,0.522910015786851,0.165817770232032,1.45366304962968,1206,491,715,32,1.5,9.29,4.7,0,0,0,0,0,0,0.175097076628731,4000.54922171904,17.5398098829826
7.5,"eps_greedy_SVM","SVM",12,28,27240,24214,3026,2900,2404,496,0.522902231258505,0.170911148839842,1.52121555109671,1218,496,722,12,1.5,9.62,4.8,0,0,0,0,0,0,0.170814544893279,4007.52449812756,17.1032684580391
7.5,"eps_greedy_SVM","SVM",12,29,27140,24128,3012,3000,2490,510,0.522896913957739,0.160158460667799,1.51878642559994,1240,510,730,22,1.4,9.95,4.9,0,0,0,0,0,0,0.171224837533456,3865.30626518656,17.146081878033
7.5,"eps_greedy_SVM","SVM",12,30,27040,24043,2997,3100,2575,525,0.520195725162423,0.153367289190719,1.37327407065912,1295,525,770,55,1.5,10.29,4.9,0,0,0,0,0,0,0.169480083230885,3778.97939435789,16.9853009117737
7.5,"eps_greedy_SVM","SVM",12,31,26940,23953,2987,3200,2665,535,0.522590722509725,0.164685908319185,1.44511285256386,1342,535,807,47,1.5,10.62,5,0,0,0,0,0,0,0.166145409765197,3770.71774055625,16.6403090016627
7.5,"eps_greedy_SVM","SVM",12,32,26840,23858,2982,3300,2760,540,0.524567950169487,0.171477079796265,1.56763910168813,1334,540,794,-8,1.5,10.95,5.1,0,0,0,0,0,0,0.163705936969292,3687.20423187707,16.3889802782792
7.5,"eps_greedy_SVM","SVM",12,33,26740,23773,2967,3400,2845,555,0.520341334126932,0.150537634408602,1.37663400152901,1371,555,816,37,1.5,11.28,5.1,0,0,0,0,0,0,0.16231091661552,3672.96727667863,16.2639741188869
7.5,"eps_greedy_SVM","SVM",12,34,26640,23687,2953,3500,2931,569,0.525643236002058,0.170345217883418,1.593193979596,1409,569,840,38,1.5,11.61,5.2,0,0,0,0,0,0,0.162172731262485,3627.6163758743,16.2503314768082
7.5,"eps_greedy_SVM","SVM",12,35,26540,23600,2940,3600,3018,582,0.521387821458482,0.160724391624222,1.4215242407093,1438,582,856,29,1.5,11.94,5.2,0,0,0,0,0,0,0.160056424791426,3717.65647964303,16.0166704215566
7.5,"eps_greedy_SVM","SVM",12,36,26440,23515,2925,3700,3103,597,0.519842528775529,0.155631013016412,1.34631784115746,1493,597,896,55,1.5,12.28,5.2,0,0,0,0,0,0,0.160892097899692,3913.712077221,16.0996267412118
7.5,"eps_greedy_SVM","SVM",12,37,26340,23431,2909,3800,3187,613,0.52042011525526,0.163554046406338,1.4797732723687,1513,613,900,20,1.5,12.61,5.2,0,0,0,0,0,0,0.16044003657656,3684.37468667115,16.053719635729
7.5,"eps_greedy_SVM","SVM",12,38,26240,23352,2888,3900,3266,634,0.513791440489959,0.142048670062252,1.16878142254329,1582,634,948,69,1.5,12.94,5.2,0,0,0,0,0,0,0.161810328845557,3622.36084751234,16.2052005062154
7.5,"eps_greedy_SVM","SVM",12,39,26140,23257,2883,4000,3361,639,0.5196796917565,0.152801358234295,1.45981029758331,1579,639,940,-3,1.5,13.27,5.3,0,0,0,0,0,0,0.159382057902325,3551.93472231517,15.9495665947655
7.5,"eps_greedy_SVM","SVM",12,40,26040,23163,2877,4100,3455,645,0.524967768649604,0.170911148839842,1.52226217902728,1594,645,949,15,1.5,13.6,5.4,0,0,0,0,0,0,0.155578270015501,3436.66050856067,15.5755446614716
7.5,"eps_greedy_SVM","SVM",12,41,25940,23078,2862,4200,3540,660,0.521006422108268,0.161856253537068,1.37905339344734,1607,660,947,13,1.4,13.93,5.4,0,0,0,0,0,0,0.155929785984528,3550.20997204872,15.6096739006765
7.5,"eps_greedy_SVM","SVM",12,42,25840,22987,2853,4300,3631,669,0.523661073887173,0.165251839275608,1.53465592768616,1638,669,969,31,1.4,14.27,5.4,0,0,0,0,0,0,0.154280269511545,3451.93919124063,15.4498710152709
7.5,"eps_greedy_SVM","SVM",12,43,25740,22899,2841,4400,3719,681,0.52129751242207,0.160724391624222,1.34358165832054,1663,681,982,25,1.4,14.6,5.5,0,0,0,0,0,0,0.154634499494208,3497.05066926379,15.4830655985804
7.5,"eps_greedy_SVM","SVM",12,44,25640,22811,2829,4500,3807,693,0.521792319163282,0.159592529711375,1.41284885301535,1683,693,990,20,1.4,14.93,5.5,0,0,0,0,0,0,0.152885476988086,3394.02924252691,15.3028579435674
7.5,"eps_greedy_SVM","SVM",12,45,25540,22720,2820,4600,3898,702,0.521145863003865,0.162422184493492,1.45160940982484,1748,702,1046,65,1.5,15.26,5.6,0,0,0,0,0,0,0.151725628876692,3425.83935904353,15.1886927291372
7.5,"eps_greedy_SVM","SVM",12,46,25440,22632,2808,4700,3986,714,0.518705392100308,0.156762874929259,1.29967930579136,1761,714,1047,13,1.5,15.59,5.6,0,0,0,0,0,0,0.150715694846291,3396.77048306938,15.0826950499836
7.5,"eps_greedy_SVM","SVM",12,47,25340,22540,2800,4800,4078,722,0.518635203730041,0.147142048670062,1.34945395577823,1765,722,1043,4,1.4,15.93,5.6,0,0,0,0,0,0,0.149230655790557,3229.88904261306,14.9399241030243
7.5,"eps_greedy_SVM","SVM",12,48,25240,22460,2780,4900,4158,742,0.522189117416549,0.162422184493492,1.46535978998227,1816,742,1074,51,1.4,16.26,5.6,0,0,0,0,0,0,0.150346616355751,3323.9807738965,15.0510780143174
7.5,"eps_greedy_SVM","SVM",13,0,30040,26491,3549,100,89,11,0.542648016209965,0.185078079814922,1.86947114281579,36,11,25,0,2.3,0.33,8.1,0,0,0,0,0,0,0.33528458867764,3335.66840176112,37.6636937793988
7.5,"eps_greedy_SVM","SVM",13,1,29940,26433,3507,200,147,53,0.484658222589115,0.112203585887796,1.07537539967006,121,53,68,85,1.3,0.66,2.8,0,0,0,0,0,0,0.553621918414738,7065.47787353255,62.9038205785661
7.5,"eps_greedy_SVM","SVM",13,2,29840,26350,3490,300,230,70,0.43169809779805,0.102371312897629,0.916300184423322,177,70,107,56,1.5,1,3.3,0,0,0,0,0,0,0.250464115531113,6811.19908884299,25.3475175461853
7.5,"eps_greedy_SVM","SVM",13,3,29740,26263,3477,400,317,83,0.466669698241569,0.13128976286871,1.12694818027411,208,83,125,31,1.5,1.33,3.8,0,0,0,0,0,0,0.209864916002287,6120.57809650264,21.810105480955
7.5,"eps_greedy_SVM","SVM",13,4,29640,26179,3461,500,401,99,0.490865047031191,0.124927703875072,1.03880617590295,242,99,143,34,1.4,1.66,4.1,0,0,0,0,0,0,0.215825444409128,5652.98784379542,22.354325357691
7.5,"eps_greedy_SVM","SVM",13,5,29540,26103,3437,600,477,123,0.534903498382531,0.176402544823597,1.65923205947686,300,123,177,58,1.4,1.99,3.9,0,0,0,0,0,0,0.224313089737944,5774.83380550404,22.9921956224977
7.5,"eps_greedy_SVM","SVM",13,6,29440,26019,3421,700,561,139,0.510383982048481,0.152111046847889,1.48892981876944,337,139,198,37,1.4,2.32,4,0,0,0,0,0,0,0.199007214371233,5824.21581639184,19.9183837340642
7.5,"eps_greedy_SVM","SVM",13,7,29340,25940,3400,800,640,160,0.502838481765362,0.123192596876807,1.15858454893151,390,160,230,53,1.4,2.65,4,0,0,0,0,0,0,0.215619729813795,5662.57325314598,22.4530636456776
7.5,"eps_greedy_SVM","SVM",13,8,29240,25861,3379,900,719,181,0.517902865739952,0.128976286871024,1.2419019327207,427,181,246,37,1.4,2.99,4,0,0,0,0,0,0,0.209671450549694,5359.02717680237,21.2984507017892
7.5,"eps_greedy_SVM","SVM",13,9,29140,25774,3366,1000,806,194,0.527292150212278,0.172353961827646,1.64828366289856,464,194,270,37,1.4,3.32,4.2,0,0,0,0,0,0,0.197311816662582,5468.32602285565,19.8014789844347
7.5,"eps_greedy_SVM","SVM",13,10,29040,25687,3353,1100,893,207,0.52585233999291,0.142278773857721,1.29219759926131,496,207,289,32,1.4,3.65,4.3,0,0,0,0,0,0,0.18858587220937,5105.41878750498,18.998642815726
7.5,"eps_greedy_SVM","SVM",13,11,28940,25616,3324,1200,964,236,0.539633232037142,0.152111046847889,1.58136374442477,545,236,309,49,1.3,3.98,4.1,0,0,0,0,0,0,0.195171188273714,5001.32658143998,20.8043464616126
7.5,"eps_greedy_SVM","SVM",13,12,28840,25550,3290,1300,1030,270,0.535260091351288,0.161364950838635,1.60428205956136,632,270,362,87,1.3,4.31,3.8,0,0,0,0,0,0,0.206736098253546,5479.87401465177,20.8651898433252
7.5,"eps_greedy_SVM","SVM",13,13,28740,25474,3266,1400,1106,294,0.536105319859063,0.152111046847889,1.49671142680133,691,294,397,59,1.4,4.64,3.8,0,0,0,0,0,0,0.246999053026055,5368.13513026248,24.8874725083037
7.5,"eps_greedy_SVM","SVM",13,14,28640,25388,3252,1500,1192,308,0.532066447150617,0.147484094852516,1.45402216397986,732,308,424,41,1.4,4.98,3.9,0,0,0,0,0,0,0.204897879001056,5596.45603578981,20.6253537490651
7.5,"eps_greedy_SVM","SVM",13,15,28540,25301,3239,1600,1279,321,0.542203076964723,0.186813186813187,1.9311318796892,753,321,432,21,1.3,5.31,4,0,0,0,0,0,0,0.213539926614435,5390.5869958472,22.3424143166679
7.5,"eps_greedy_SVM","SVM",13,16,28440,25235,3205,1700,1345,355,0.548877165643401,0.1844997108155,1.71598555488158,867,355,512,114,1.4,5.64,3.8,0,0,0,0,0,0,0.212326631045782,5201.91631510054,21.4027105899262
7.5,"eps_greedy_SVM","SVM",13,17,28340,25146,3194,1800,1434,366,0.546172373729226,0.179872758820127,1.65495568818955,875,366,509,8,1.4,5.97,3.9,0,0,0,0,0,0,0.202762590400041,5451.42715340054,20.297706191005
7.5,"eps_greedy_SVM","SVM",13,18,28240,25065,3175,1900,1515,385,0.548014293890028,0.185078079814922,1.80369455106297,927,385,542,52,1.4,6.3,3.9,0,0,0,0,0,0,0.20228200208767,5488.25421607349,20.2376162025569
7.5,"eps_greedy_SVM","SVM",13,19,28140,24991,3149,2000,1589,411,0.55040025024801,0.182764603817235,1.7002369117852,1017,411,606,90,1.5,6.64,3.9,0,0,0,0,0,0,0.205065292184443,5502.27058805945,20.5182894276136
7.5,"eps_greedy_SVM","SVM",13,20,28040,24914,3126,2100,1666,434,0.549043020821915,0.181607865818392,1.7538580408774,1055,434,621,38,1.4,6.97,3.8,0,0,0,0,0,0,0.206732548376726,5440.95983047065,20.6824208387939
7.5,"eps_greedy_SVM","SVM",13,21,27940,24832,3108,2200,1748,452,0.549790539561696,0.185078079814922,1.82719089555769,1088,452,636,33,1.4,7.3,3.9,0,0,0,0,0,0,0.205327424767365,5598.6255807302,20.5346048383056
7.5,"eps_greedy_SVM","SVM",13,22,27840,24749,3091,2300,1831,469,0.554773651030848,0.186813186813187,1.77299336721509,1127,469,658,39,1.4,7.63,3.9,0,0,0,0,0,0,0.203521777718427,5235.47267387139,20.3620748708936
7.5,"eps_greedy_SVM","SVM",13,23,27740,24670,3070,2400,1910,490,0.548183140183894,0.171197223828803,1.57456286151187,1185,490,695,58,1.4,7.96,3.9,0,0,0,0,0,0,0.204313015244575,5338.94155495457,20.4366633643021
7.5,"eps_greedy_SVM","SVM",13,24,27640,24586,3054,2500,1994,506,0.55374548764243,0.1844997108155,1.81970240828081,1235,506,729,50,1.4,8.29,3.9,0,0,0,0,0,0,0.201709363818199,5340.25929326241,20.1757593087152
7.5,"eps_greedy_SVM","SVM",13,25,27540,24498,3042,2600,2082,518,0.558905768509027,0.19491035280509,1.79261680005828,1265,518,747,30,1.4,8.63,4,0,0,0,0,0,0,0.199154922470534,5301.99058449533,19.9202156387802
7.5,"eps_greedy_SVM","SVM",13,26,27440,24411,3029,2700,2169,531,0.551835075275129,0.175245806824754,1.62905441023011,1266,531,735,1,1.4,8.96,4.1,0,0,0,0,0,0,0.19642129028457,5141.06729584844,19.6499800971126
7.5,"eps_greedy_SVM","SVM",13,27,27340,24330,3010,2800,2250,550,0.561306246948765,0.193175245806825,1.84375184936347,1333,550,783,67,1.4,9.29,4.1,0,0,0,0,0,0,0.196066887198788,5102.10679410852,19.6114646485938
7.5,"eps_greedy_SVM","SVM",13,28,27240,24254,2986,2900,2326,574,0.558201339170057,0.188548293811452,1.82093339249071,1388,574,814,55,1.4,9.62,4.1,0,0,0,0,0,0,0.197470890186448,5033.02852256069,19.7530046460615
7.5,"eps_greedy_SVM","SVM",13,29,27140,24171,2969,3000,2409,591,0.559898515357765,0.186234817813765,1.80317631318309,1399,591,808,11,1.4,9.95,4.1,0,0,0,0,0,0,0.196803702975874,5168.36004081285,19.6857998532348
7.5,"eps_greedy_SVM","SVM",13,30,27040,24087,2953,3100,2493,607,0.567663190701663,0.189705031810295,1.84100586346503,1441,607,834,42,1.4,10.29,4.1,0,0,0,0,0,0,0.195500511449503,5082.14811821148,19.5649630844154
7.5,"eps_greedy_SVM","SVM",13,31,26940,24008,2932,3200,2572,628,0.570418918275733,0.19144013880856,1.9220063675388,1488,628,860,47,1.4,10.62,4.1,0,0,0,0,0,0,0.196079024418737,5129.96846618365,19.6369506898962
7.5,"eps_greedy_SVM","SVM",13,32,26840,23928,2912,3300,2652,648,0.57050570397029,0.18796992481203,1.8742946445428,1528,648,880,40,1.4,10.95,4.1,0,0,0,0,0,0,0.19586290582586,5092.0303094077,19.5922488779466
7.5,"eps_greedy_SVM","SVM",13,33,26740,23848,2892,3400,2732,668,0.568585407917498,0.185078079814922,1.81251113447653,1594,668,926,66,1.4,11.28,4.1,0,0,0,0,0,0,0.195966244297048,4876.81242949405,19.6091300972143
7.5,"eps_greedy_SVM","SVM",13,34,26640,23760,2880,3500,2820,680,0.568604091551042,0.189705031810295,1.7945939509407,1624,680,944,30,1.4,11.61,4.1,0,0,0,0,0,0,0.19333023353878,4978.27461695782,19.3398732365351
7.5,"eps_greedy_SVM","SVM",13,35,26540,23673,2867,3600,2907,693,0.573103119178464,0.19144013880856,1.86676735681372,1646,693,953,22,1.4,11.94,4.2,0,0,0,0,0,0,0.191342381638856,4805.12756483104,19.1458427692379
7.5,"eps_greedy_SVM","SVM",13,36,26440,23583,2857,3700,2997,703,0.56771317267261,0.183342972816657,1.74634381002209,1687,703,984,41,1.4,12.28,4.3,0,0,0,0,0,0,0.189232752007554,4582.09807105016,18.9428890747659
7.5,"eps_greedy_SVM","SVM",13,37,26340,23502,2838,3800,3078,722,0.570935340842823,0.185656448814344,1.79878229206192,1735,722,1013,48,1.4,12.61,4.3,0,0,0,0,0,0,0.189501088067698,4562.23516436753,18.9636746939077
7.5,"eps_greedy_SVM","SVM",13,38,26240,23410,2830,3900,3170,730,0.570465085490863,0.174089068825911,1.71898029406985,1746,730,1016,11,1.4,12.94,4.3,0,0,0,0,0,0,0.186364066905646,4484.70431374235,18.647624733302
7.5,"eps_greedy_SVM","SVM",13,39,26140,23328,2812,4000,3252,748,0.573620452084997,0.186234817813765,1.9220063675388,1804,748,1056,58,1.4,13.27,4.3,0,0,0,0,0,0,0.186761582004171,4689.13241587277,18.6820285614143
7.5,"eps_greedy_SVM","SVM",13,40,26040,23241,2799,4100,3339,761,0.571667427161379,0.181029496818971,1.75542622582096,1852,761,1091,48,1.4,13.6,4.4,0,0,0,0,0,0,0.185061646451845,4390.83585300701,18.5274256798184
7.5,"eps_greedy_SVM","SVM",13,41,25940,23152,2788,4200,3428,772,0.573113999902398,0.176402544823597,1.75993727152169,1842,772,1070,-10,1.4,13.93,4.4,0,0,0,0,0,0,0.182338540958945,4188.55475602629,18.2469873517982
7.5,"eps_greedy_SVM","SVM",13,42,25840,23064,2776,4300,3516,784,0.572535370805995,0.185078079814922,1.79592000558425,1911,784,1127,69,1.4,14.27,4.5,0,0,0,0,0,0,0.182174429074138,4596.06595222109,18.2211764974508
7.5,"eps_greedy_SVM","SVM",13,43,25740,22974,2766,4400,3606,794,0.574618877717941,0.190283400809717,1.78879774687555,1917,794,1123,6,1.4,14.6,4.5,0,0,0,0,0,0,0.179876419926173,4435.34966419205,17.9935090641132
7.5,"eps_greedy_SVM","SVM",13,44,25640,22887,2753,4500,3693,807,0.571153648913656,0.179294389820706,1.67334364909454,1929,807,1122,12,1.4,14.93,4.6,0,0,0,0,0,0,0.179198768878893,4500.34140769235,17.9228882820964
7.5,"eps_greedy_SVM","SVM",13,45,25540,22802,2738,4600,3778,822,0.571823485353396,0.183342972816657,1.75086667718247,1955,822,1133,26,1.4,15.26,4.6,0,0,0,0,0,0,0.178075747054863,4317.22928426884,17.8146122121587
7.5,"eps_greedy_SVM","SVM",13,46,25440,22720,2720,4700,3860,840,0.578844803509325,0.186234817813765,1.83268201915602,2031,840,1191,76,1.4,15.59,4.6,0,0,0,0,0,0,0.178073017131785,4398.04767114395,17.8148896522362
7.5,"eps_greedy_SVM","SVM",13,47,25340,22645,2695,4800,3935,865,0.577088888752121,0.196645459803355,1.83349155381823,2070,865,1205,39,1.4,15.93,4.5,0,0,0,0,0,0,0.179519666238537,4307.36556921499,17.9668823161204
7.5,"eps_greedy_SVM","SVM",13,48,25240,22575,2665,4900,4005,895,0.574926225657234,0.177559282822441,1.67272766151565,2157,895,1262,87,1.4,16.26,4.5,0,0,0,0,0,0,0.18212191265605,4356.3506797316,18.2191676511734
7.5,"eps_greedy_SVM","SVM",14,0,30040,26568,3472,100,86,14,0.497267078735722,0.11924570160843,1.02548953666024,48,14,34,0,2.4,0.33,6.1,0,0,0,0,0,0,0.146391721299018,4241.74721837936,14.7039246627353
7.5,"eps_greedy_SVM","SVM",14,1,29940,26481,3459,200,173,27,0.469589904843213,0.0859678313921242,0.727501726449602,90,27,63,42,2.3,0.66,6.4,0,0,0,0,0,0,0.136051280297368,4050.3854953511,13.6093289807633
7.5,"eps_greedy_SVM","SVM",14,2,29840,26390,3450,300,264,36,0.465090152228447,0.124237382140876,1.123941052041,111,36,75,21,2.1,1,7.3,0,0,0,0,0,0,0.144904158909814,3453.46201860005,14.879838034973
7.5,"eps_greedy_SVM","SVM",14,3,29740,26296,3444,400,358,42,0.463783959872594,0.0931780366056572,0.774795028685603,130,42,88,19,2.1,1.33,8.5,0,0,0,0,0,0,0.117549115380984,2789.07417369877,12.0765469763169
7.5,"eps_greedy_SVM","SVM",14,4,29640,26224,3416,500,430,70,0.5824293405407,0.182473655019412,1.89772395438306,171,70,101,41,1.4,1.66,6.1,0,0,0,0,0,0,0.310416344919834,3660.80680075511,37.015870262518
7.5,"eps_greedy_SVM","SVM",14,5,29540,26158,3382,600,496,104,0.496694472633045,0.140321686078758,1.16074151536838,265,104,161,94,1.5,1.99,4.8,0,0,0,0,0,0,0.190004162395842,5023.06536948219,19.6334189130599
7.5,"eps_greedy_SVM","SVM",14,6,29440,26080,3360,700,574,126,0.502656715911296,0.138657792567942,1.22087092997135,313,126,187,48,1.5,2.32,4.6,0,0,0,0,0,0,0.204435666492416,4899.42297722687,21.7527518637292
7.5,"eps_greedy_SVM","SVM",14,7,29340,25991,3349,800,663,137,0.4921581849231,0.12867443150305,1.21637160977391,353,137,216,40,1.6,2.65,4.8,0,0,0,0,0,0,0.242448115252447,4289.68412362239,25.754896593506
7.5,"eps_greedy_SVM","SVM",14,8,29240,25903,3337,900,751,149,0.467937214313531,0.124792013311148,1.15806397271569,375,149,226,22,1.5,2.99,5,0,0,0,0,0,0,0.184227680501232,4289.3445076128,18.9534869143812
7.5,"eps_greedy_SVM","SVM",14,9,29140,25819,3321,1000,835,165,0.448719043613205,0.109262340543539,1.07663137466179,432,165,267,57,1.6,3.32,5.1,0,0,0,0,0,0,0.186157855757389,4245.28994192451,19.2873021903642
7.5,"eps_greedy_SVM","SVM",14,10,29040,25728,3312,1100,926,174,0.450670243427401,0.105379922351636,0.931204814587773,461,174,287,29,1.6,3.65,5.3,0,0,0,0,0,0,0.163984119487333,4094.86157608848,16.6330529492482
7.5,"eps_greedy_SVM","SVM",14,11,28940,25633,3307,1200,1021,179,0.467128885783267,0.113699389905713,1.07713289462155,481,179,302,20,1.7,3.98,5.7,0,0,0,0,0,0,0.15459117100078,3780.2576092538,15.6990713801444
7.5,"eps_greedy_SVM","SVM",14,12,28840,25536,3304,1300,1118,182,0.457520866388395,0.118136439267887,1.01231703408583,495,182,313,14,1.7,4.31,6.1,0,0,0,0,0,0,0.140892585399582,3459.57881517545,14.1910071615744
7.5,"eps_greedy_SVM","SVM",14,13,28740,25447,3293,1400,1207,193,0.45488068323471,0.118691070438159,1.05485876696175,549,193,356,54,1.8,4.64,6.3,0,0,0,0,0,0,0.136998076098045,3420.02304676466,13.8774671572799
7.5,"eps_greedy_SVM","SVM",14,14,28640,25373,3267,1500,1281,219,0.456247405130397,0.128119800332779,1.15069833106439,605,219,386,56,1.8,4.98,5.8,0,0,0,0,0,0,0.148437052188655,3390.76526590151,15.6001815301263
7.5,"eps_greedy_SVM","SVM",14,15,28540,25298,3242,1600,1356,244,0.465866334891215,0.123128119800333,1.07668343110578,662,244,418,57,1.7,5.31,5.6,0,0,0,0,0,0,0.151263167637666,3639.29545774929,15.2940128027557
7.5,"eps_greedy_SVM","SVM",14,16,28440,25208,3232,1700,1446,254,0.467400223658321,0.124792013311148,1.0367561385632,703,254,449,41,1.8,5.64,5.7,0,0,0,0,0,0,0.146092225696313,3497.77319168209,14.8604923965041
7.5,"eps_greedy_SVM","SVM",14,17,28340,25118,3222,1800,1536,264,0.469281446642627,0.129783693843594,1.2065059147076,733,264,469,30,1.8,5.97,5.8,0,0,0,0,0,0,0.145126031865711,3417.0968149273,14.5769907451559
7.5,"eps_greedy_SVM","SVM",14,18,28240,25029,3211,1900,1625,275,0.466578936455855,0.118691070438159,1.06372249556367,743,275,468,10,1.7,6.3,5.9,0,0,0,0,0,0,0.142241428546752,3406.0150944365,14.2759585848461
7.5,"eps_greedy_SVM","SVM",14,19,28140,24939,3201,2000,1715,285,0.458435832250237,0.113699389905713,0.997527833015435,757,285,472,14,1.7,6.64,6,0,0,0,0,0,0,0.143219827955339,3505.03402735722,14.3526808691894
7.5,"eps_greedy_SVM","SVM",14,20,28040,24850,3190,2100,1804,296,0.46099320530834,0.11924570160843,1.08435206309454,787,296,491,30,1.7,6.97,6.1,0,0,0,0,0,0,0.138886949471237,3183.80555612587,13.9376347416131
7.5,"eps_greedy_SVM","SVM",14,21,27940,24755,3185,2200,1899,301,0.46553032906165,0.122573488630061,1.13389568111119,831,301,530,44,1.8,7.3,6.3,0,0,0,0,0,0,0.135070629734452,3046.64100892889,13.5366135908066
7.5,"eps_greedy_SVM","SVM",14,22,27840,24665,3175,2300,1989,311,0.466071792548881,0.120354963948974,1.10631790153665,829,311,518,-2,1.7,7.63,6.4,0,0,0,0,0,0,0.131838353364828,3139.01651364083,13.2173628887951
7.5,"eps_greedy_SVM","SVM",14,23,27740,24573,3167,2400,2081,319,0.460288086331845,0.117581808097615,1.18271871340975,859,319,540,30,1.7,7.96,6.5,0,0,0,0,0,0,0.130276799589613,3060.81428542751,13.0512075881172
7.5,"eps_greedy_SVM","SVM",14,24,27640,24484,3156,2500,2170,330,0.464225850594702,0.116472545757072,0.970611276603312,912,330,582,53,1.8,8.29,6.6,0,0,0,0,0,0,0.130899989311514,3084.06812726442,13.1076345297209
7.5,"eps_greedy_SVM","SVM",14,25,27540,24395,3145,2600,2259,341,0.459090746822497,0.110926234054354,0.916730128350657,953,341,612,41,1.8,8.63,6.6,0,0,0,0,0,0,0.131115115720331,3148.22940059627,13.1286596617569
7.5,"eps_greedy_SVM","SVM",14,26,27440,24304,3136,2700,2350,350,0.465897937330526,0.118691070438159,1.10194678907997,980,350,630,27,1.8,8.96,6.7,0,0,0,0,0,0,0.127402773656471,3129.03393386666,12.7546411512912
7.5,"eps_greedy_SVM","SVM",14,27,27340,24206,3134,2800,2448,352,0.458054512870134,0.1159179145868,1.06385317400292,950,352,598,-30,1.7,9.29,7,0,0,0,0,0,0,0.123050143006406,2815.48785916936,12.3374064639675
7.5,"eps_greedy_SVM","SVM",14,28,27240,24113,3127,2900,2541,359,0.463376388730737,0.118691070438159,1.08368794734216,956,359,597,6,1.7,9.62,7.1,0,0,0,0,0,0,0.123434382920842,3303.54629537445,12.3464751569125
7.5,"eps_greedy_SVM","SVM",14,29,27140,24028,3112,3000,2626,374,0.462968692182378,0.118691070438159,1.10194678907997,985,374,611,29,1.6,9.95,7,0,0,0,0,0,0,0.124554465075634,3340.55096471564,12.4557836740219
7.5,"eps_greedy_SVM","SVM",14,30,27040,23940,3100,3100,2714,386,0.461230683426997,0.115363283416528,1.10290334011216,1002,386,616,17,1.6,10.29,7,0,0,0,0,0,0,0.123987839725733,3288.64517100507,12.4030592285828
7.5,"eps_greedy_SVM","SVM",14,31,26940,23849,3091,3200,2805,395,0.467373846490064,0.117027176927343,1.11694628312347,1014,395,619,12,1.6,10.62,7.1,0,0,0,0,0,0,0.123504891924068,3278.1259801114,12.4080780235014
7.5,"eps_greedy_SVM","SVM",14,32,26840,23756,3084,3300,2898,402,0.474496225347798,0.133666112035496,1.27089323566813,1044,402,642,30,1.6,10.95,7.2,0,0,0,0,0,0,0.121309740139463,3207.87585024619,12.1353303510318
7.5,"eps_greedy_SVM","SVM",14,33,26740,23671,3069,3400,2983,417,0.461421008699703,0.120909595119246,1.11354873749441,1082,417,665,38,1.6,11.28,7.2,0,0,0,0,0,0,0.122014829762584,3163.56957356896,12.2068370229988
7.5,"eps_greedy_SVM","SVM",14,34,26640,23581,3059,3500,3073,427,0.461758686615998,0.11924570160843,1.12174994537723,1120,427,693,38,1.6,11.61,7.2,0,0,0,0,0,0,0.121443038271401,3155.11911455062,12.1489557991405
7.5,"eps_greedy_SVM","SVM",14,35,26540,23499,3041,3600,3155,445,0.474181413217612,0.133666112035496,1.30447558824994,1159,445,714,39,1.6,11.94,7.1,0,0,0,0,0,0,0.123062209756793,3141.01388163632,12.3154545503106
7.5,"eps_greedy_SVM","SVM",14,36,26440,23412,3028,3700,3242,458,0.46902557556988,0.124792013311148,1.20031876898748,1188,458,730,29,1.6,12.28,7.1,0,0,0,0,0,0,0.123378433293917,3151.12914033002,12.3430062187262
7.5,"eps_greedy_SVM","SVM",14,37,26340,23328,3012,3800,3326,474,0.463289565626981,0.121464226289517,1.1309453887926,1285,474,811,97,1.7,12.61,7,0,0,0,0,0,0,0.124640668456374,3237.41317049354,12.4648310250193
7.5,"eps_greedy_SVM","SVM",14,38,26240,23239,3001,3900,3415,485,0.476939144068833,0.134220743205768,1.28090903174608,1243,485,758,-42,1.6,12.94,7,0,0,0,0,0,0,0.123946590611322,3092.03782246804,12.3996264061126
7.5,"eps_greedy_SVM","SVM",14,39,26140,23145,2995,4000,3509,491,0.465523264495195,0.129229062673322,1.24802220065323,1270,491,779,27,1.6,13.27,7.1,0,0,0,0,0,0,0.122252986241545,3138.19781219355,12.2290624966904
7.5,"eps_greedy_SVM","SVM",14,40,26040,23054,2986,4100,3600,500,0.465759070527114,0.12867443150305,1.06541326664475,1301,500,801,31,1.6,13.6,7.2,0,0,0,0,0,0,0.121472303509022,3103.90612072202,12.1504897706208
7.5,"eps_greedy_SVM","SVM",14,41,25940,22968,2972,4200,3686,514,0.476261071095288,0.139212423738214,1.31594854856876,1383,514,869,82,1.7,13.93,7.2,0,0,0,0,0,0,0.121826679463802,3073.45830005532,12.1883871065106
7.5,"eps_greedy_SVM","SVM",14,42,25840,22882,2958,4300,3772,528,0.472476929801286,0.130338325013866,1.26253408670734,1415,528,887,32,1.7,14.27,7.1,0,0,0,0,0,0,0.122221107017472,3088.99034456034,12.2258130139402
7.5,"eps_greedy_SVM","SVM",14,43,25740,22788,2952,4400,3866,534,0.472310933390584,0.12867443150305,1.27643814507332,1404,534,870,-11,1.6,14.6,7.2,0,0,0,0,0,0,0.120855815186201,3052.21389122243,12.0880454739084
7.5,"eps_greedy_SVM","SVM",14,44,25640,22697,2943,4500,3957,543,0.470406886422341,0.129783693843594,1.2386158828296,1501,543,958,97,1.8,14.93,7.3,0,0,0,0,0,0,0.120260964470801,3014.74065136593,12.029924505502
7.5,"eps_greedy_SVM","SVM",14,45,25540,22603,2937,4600,4051,549,0.469760206877262,0.124792013311148,1.12509062405338,1465,549,916,-36,1.7,15.26,7.4,0,0,0,0,0,0,0.118891629737321,2891.03198810762,11.8965361732493
7.5,"eps_greedy_SVM","SVM",14,46,25440,22516,2924,4700,4138,562,0.471236283245474,0.129229062673322,1.14898231851077,1504,562,942,39,1.7,15.59,7.4,0,0,0,0,0,0,0.11898270414231,2928.86743720208,11.903991965275
7.5,"eps_greedy_SVM","SVM",14,47,25340,22423,2917,4800,4231,569,0.473810042753585,0.124237382140876,1.1731714199531,1546,569,977,42,1.7,15.93,7.4,0,0,0,0,0,0,0.117314336701354,2821.7704161969,11.7398215276364
7.5,"eps_greedy_SVM","SVM",14,48,25240,22330,2910,4900,4324,576,0.467251784158348,0.118691070438159,1.09408983863427,1570,576,994,24,1.7,16.26,7.5,0,0,0,0,0,0,0.116871223014425,2794.14880270496,11.6915654384919
7.5,"eps_greedy_SVM","SVM",15,0,30040,26510,3530,100,88,12,0.453053736069744,0.135661133371494,1.31010735480565,41,12,29,0,2.4,0.33,7.3,0,0,0,0,0,0,0.23461872313166,2824.06330194181,26.7333184882528
7.5,"eps_greedy_SVM","SVM",15,1,29940,26435,3505,200,163,37,0.446168213570906,0.115054378935318,1.1507399158303,103,37,66,62,1.8,0.66,4.4,0,0,0,0,0,0,0.199730912066256,5505.91222170226,20.1413420521158
7.5,"eps_greedy_SVM","SVM",15,2,29840,26361,3479,300,237,63,0.546952042159335,0.179164281625644,1.63504119491072,153,63,90,50,1.4,1,3.8,0,0,0,0,0,0,0.311710518022719,6048.69569082748,35.6566654048324
7.5,"eps_greedy_SVM","SVM",15,3,29740,26287,3453,400,311,89,0.538780552225137,0.172295363480252,1.63105056697298,213,89,124,60,1.4,1.33,3.5,0,0,0,0,0,0,0.256464299955489,5889.14836396277,27.6063781750044
7.5,"eps_greedy_SVM","SVM",15,4,29640,26217,3423,500,381,119,0.509558093069272,0.132226674298798,1.17116120981132,266,119,147,53,1.2,1.66,3.2,0,0,0,0,0,0,0.329426738644398,5593.74581715803,35.2377408924962
7.5,"eps_greedy_SVM","SVM",15,5,29540,26133,3407,600,465,135,0.568803242407067,0.187178019461935,1.79131409088038,301,135,166,35,1.2,1.99,3.4,0,0,0,0,0,0,0.249795766513869,5211.94419156822,25.5143042532826
7.5,"eps_greedy_SVM","SVM",15,6,29440,26064,3376,700,534,166,0.559533631183504,0.168860904407556,1.47583511769736,362,166,196,61,1.2,2.32,3.2,0,0,0,0,0,0,0.268777680397007,6126.12619518302,30.6223653130399
7.5,"eps_greedy_SVM","SVM",15,7,29340,25983,3357,800,615,185,0.544068104398897,0.170005724098454,1.38151421756056,418,185,233,56,1.3,2.65,3.3,0,0,0,0,0,0,0.252396702644923,5219.9294084524,29.203934715544
7.5,"eps_greedy_SVM","SVM",15,8,29240,25905,3335,900,693,207,0.572979226557609,0.198053806525472,1.8122247265153,471,207,264,53,1.3,2.99,3.3,0,0,0,0,0,0,0.23707739886248,5321.65034771976,24.5275839131287
7.5,"eps_greedy_SVM","SVM",15,9,29140,25828,3312,1000,770,230,0.544491053582957,0.189467658843732,1.86320460058708,526,230,296,55,1.3,3.32,3.3,0,0,0,0,0,0,0.233625827321079,6007.50151644446,23.8370048958414
7.5,"eps_greedy_SVM","SVM",15,10,29040,25753,3287,1100,845,255,0.55655840169974,0.184888380080137,1.755495009536,576,255,321,50,1.3,3.65,3.3,0,0,0,0,0,0,0.22836443802241,5123.47131731598,23.2427424298361
7.5,"eps_greedy_SVM","SVM",15,11,28940,25671,3269,1200,927,273,0.546238613451859,0.191757298225529,1.81260339683074,629,273,356,53,1.3,3.98,3.4,0,0,0,0,0,0,0.222354495734134,5431.296133883,22.9382191938718
7.5,"eps_greedy_SVM","SVM",15,12,28840,25586,3254,1300,1012,288,0.551304981890297,0.190612478534631,1.80439315898498,670,288,382,41,1.3,4.31,3.5,0,0,0,0,0,0,0.216207859904541,5427.42592664178,21.651465005902
7.5,"eps_greedy_SVM","SVM",15,13,28740,25501,3239,1400,1097,303,0.551356341539825,0.194046937607327,1.74180397393303,706,303,403,36,1.3,4.64,3.6,0,0,0,0,0,0,0.210230226423783,4037.45266545014,21.0428683372898
7.5,"eps_greedy_SVM","SVM",15,14,28640,25433,3207,1500,1165,335,0.549583456272853,0.195191757298226,1.80127945206697,763,335,428,57,1.3,4.98,3.5,0,0,0,0,0,0,0.218165653144051,4606.26748912852,21.8546911178949
7.5,"eps_greedy_SVM","SVM",15,15,28540,25358,3182,1600,1240,360,0.550795466672117,0.192902117916428,1.78948081882808,817,360,457,54,1.3,5.31,3.4,0,0,0,0,0,0,0.219423977147571,4345.57711350905,21.9757323243129
7.5,"eps_greedy_SVM","SVM",15,16,28440,25287,3153,1700,1311,389,0.553440606764742,0.195191757298226,1.78793549860457,882,389,493,65,1.3,5.64,3.4,0,0,0,0,0,0,0.2244685560129,4224.12307995791,22.5212860140842
7.5,"eps_greedy_SVM","SVM",15,17,28340,25205,3135,1800,1393,407,0.549008726543616,0.19118488838008,1.7672935349488,930,407,523,48,1.3,5.97,3.4,0,0,0,0,0,0,0.217007819687591,3842.57655609372,21.7594032750009
7.5,"eps_greedy_SVM","SVM",15,18,28240,25128,3112,1900,1470,430,0.551643770845656,0.194046937607327,1.7672935349488,981,430,551,51,1.3,6.3,3.4,0,0,0,0,0,0,0.222927188025675,4642.45364392917,22.3239403732226
7.5,"eps_greedy_SVM","SVM",15,19,28140,25047,3093,2000,1551,449,0.550241916622683,0.193474527761878,1.7863928450251,1019,449,570,38,1.3,6.64,3.5,0,0,0,0,0,0,0.21651936205164,3896.2011334882,21.735251904845
7.5,"eps_greedy_SVM","SVM",15,20,28040,24963,3077,2100,1635,465,0.553614683970821,0.195191757298226,1.80751764930357,1051,465,586,32,1.3,6.97,3.5,0,0,0,0,0,0,0.218785482230444,4897.89933773796,22.0598230615247
7.5,"eps_greedy_SVM","SVM",15,21,27940,24881,3059,2200,1717,483,0.556018964276714,0.198053806525472,1.79849143266856,1085,483,602,34,1.2,7.3,3.6,0,0,0,0,0,0,0.211722477611215,3464.76128180345,21.2400154483274
7.5,"eps_greedy_SVM","SVM",15,22,27840,24803,3037,2300,1795,505,0.556249341625578,0.195764167143675,1.81184932906343,1134,505,629,49,1.2,7.63,3.6,0,0,0,0,0,0,0.211633918821388,3961.05060549796,21.249759062178
7.5,"eps_greedy_SVM","SVM",15,23,27740,24715,3025,2400,1883,517,0.555958024366344,0.197481396680023,1.80439315898498,1164,517,647,30,1.3,7.96,3.6,0,0,0,0,0,0,0.20939289190334,4085.96944736262,21.0221366972857
7.5,"eps_greedy_SVM","SVM",15,24,27640,24634,3006,2500,1964,536,0.558043986543297,0.198626216370922,1.85018984186993,1202,536,666,38,1.2,8.29,3.7,0,0,0,0,0,0,0.208594902342822,4601.85436932086,20.9226768700698
7.5,"eps_greedy_SVM","SVM",15,25,27540,24547,2993,2600,2051,549,0.558517543562689,0.202633085289067,1.84167400937723,1257,549,708,55,1.3,8.63,3.7,0,0,0,0,0,0,0.204903650667141,3957.7877147811,20.5547988317159
7.5,"eps_greedy_SVM","SVM",15,26,27440,24457,2983,2700,2141,559,0.558108384798951,0.200915855752719,1.83959038489271,1312,559,753,55,1.3,8.96,3.8,0,0,0,0,0,0,0.19662702803138,3418.54546148237,19.7334995419875
7.5,"eps_greedy_SVM","SVM",15,27,27340,24369,2971,2800,2229,571,0.558434156628585,0.200915855752719,1.90884348665342,1311,571,740,-1,1.3,9.29,3.9,0,0,0,0,0,0,0.197201921499101,3869.69848926882,19.7946548136126
7.5,"eps_greedy_SVM","SVM",15,28,27240,24285,2955,2900,2313,587,0.557266610668681,0.20034344590727,1.91132446040946,1358,587,771,47,1.3,9.62,3.9,0,0,0,0,0,0,0.195654426705145,3707.42381452573,19.6202799211793
7.5,"eps_greedy_SVM","SVM",15,29,27140,24206,2934,3000,2392,608,0.558176477684352,0.200915855752719,1.92359034941358,1434,608,826,76,1.4,9.95,3.9,0,0,0,0,0,0,0.197062232044437,3847.39068220959,19.7998741734716
7.5,"eps_greedy_SVM","SVM",15,30,27040,24129,2911,3100,2469,631,0.560579619528742,0.203205495134516,1.92522884204511,1458,631,827,24,1.3,10.29,3.9,0,0,0,0,0,0,0.198052541311871,4145.70060021824,19.8487977433176
7.5,"eps_greedy_SVM","SVM",15,31,26940,24047,2893,3200,2551,649,0.560676453196684,0.202633085289067,1.90480672993918,1498,649,849,40,1.3,10.62,3.9,0,0,0,0,0,0,0.196643558425518,3821.5516037964,19.7321470841997
7.5,"eps_greedy_SVM","SVM",15,32,26840,23960,2880,3300,2638,662,0.56027481257487,0.200915855752719,1.90480672993918,1535,662,873,37,1.3,10.95,4,0,0,0,0,0,0,0.19648055395992,4106.87997703456,19.6855426545703
7.5,"eps_greedy_SVM","SVM",15,33,26740,23874,2866,3400,2724,676,0.561735995677796,0.200915855752719,1.93422459449423,1583,676,907,48,1.3,11.28,4,0,0,0,0,0,0,0.193213449847799,4077.39908992558,19.3673042583808
7.5,"eps_greedy_SVM","SVM",15,34,26640,23787,2853,3500,2811,689,0.558226269264279,0.201488265598168,1.8827433315229,1588,689,899,5,1.3,11.61,4.1,0,0,0,0,0,0,0.190929089123119,4009.78071258399,19.1536322918338
7.5,"eps_greedy_SVM","SVM",15,35,26540,23706,2834,3600,2892,708,0.560709661903574,0.19977103606182,1.9277327669351,1663,708,955,75,1.3,11.94,4.1,0,0,0,0,0,0,0.190886423356294,3914.45932554642,19.1565284760061
7.5,"eps_greedy_SVM","SVM",15,36,26440,23623,2817,3700,2975,725,0.560851389618984,0.203205495134516,1.9277327669351,1694,725,969,31,1.3,12.28,4.1,0,0,0,0,0,0,0.186472779278906,3203.46006459873,18.7436452955644
7.5,"eps_greedy_SVM","SVM",15,37,26340,23544,2796,3800,3054,746,0.560779516182218,0.19977103606182,1.91376741654161,1729,746,983,35,1.3,12.61,4.1,0,0,0,0,0,0,0.189824746586794,3641.15549292351,19.0813749191978
7.5,"eps_greedy_SVM","SVM",15,38,26240,23469,2771,3900,3129,771,0.564128869888378,0.20034344590727,1.94270221896479,1819,771,1048,90,1.4,12.94,4.1,0,0,0,0,0,0,0.190447962303561,3624.42628458745,19.2355333384618
7.5,"eps_greedy_SVM","SVM",15,39,26140,23386,2754,4000,3212,788,0.563008237134052,0.202633085289067,1.90799028972214,1852,788,1064,33,1.4,13.27,4.1,0,0,0,0,0,0,0.192615665550807,4062.50946474708,19.3603919482427
7.5,"eps_greedy_SVM","SVM",15,40,26040,23303,2737,4100,3295,805,0.563458380511468,0.199198626216371,1.78129938988534,1903,805,1098,51,1.4,13.6,4.1,0,0,0,0,0,0,0.191007729245778,3953.72363445101,19.1668606418849
7.5,"eps_greedy_SVM","SVM",15,41,25940,23228,2712,4200,3370,830,0.566551043372036,0.19977103606182,1.92449465479643,1952,830,1122,49,1.4,13.93,4.1,0,0,0,0,0,0,0.190119329483839,3532.40040532175,19.0876628468687
7.5,"eps_greedy_SVM","SVM",15,42,25840,23140,2700,4300,3458,842,0.563829776722357,0.200915855752719,1.84486305528091,2004,842,1162,52,1.4,14.27,4.1,0,0,0,0,0,0,0.19027818468871,3729.66452877202,19.0789820221417
7.5,"eps_greedy_SVM","SVM",15,43,25740,23056,2684,4400,3542,858,0.561644145463933,0.198626216370922,1.8110244740112,2046,858,1188,42,1.4,14.6,4.1,0,0,0,0,0,0,0.189075277129877,3627.79446856616,19.0259885669925
7.5,"eps_greedy_SVM","SVM",15,44,25640,22969,2671,4500,3629,871,0.561632846770639,0.199198626216371,1.69978575802384,2056,871,1185,10,1.4,14.93,4.2,0,0,0,0,0,0,0.187300612375958,3607.52249933297,18.805991198725
7.5,"eps_greedy_SVM","SVM",15,45,25540,22880,2660,4600,3718,882,0.561433981176632,0.196336576989124,1.72238812146123,2105,882,1223,49,1.4,15.26,4.2,0,0,0,0,0,0,0.185022435423685,3574.23572517112,18.606871124888
7.5,"eps_greedy_SVM","SVM",15,46,25440,22792,2648,4700,3806,894,0.559966525795307,0.197481396680023,1.68054326898059,2152,894,1258,47,1.4,15.59,4.3,0,0,0,0,0,0,0.183407938465444,3420.94306815785,18.4955394139749
7.5,"eps_greedy_SVM","SVM",15,47,25340,22703,2637,4800,3895,905,0.562523639186241,0.198053806525472,1.86157021058657,2172,905,1267,20,1.4,15.93,4.3,0,0,0,0,0,0,0.183235463099845,3628.60522451957,18.4318282021096
7.5,"eps_greedy_SVM","SVM",15,48,25240,22619,2621,4900,3979,921,0.559694863107094,0.195764167143675,1.7523164710933,2204,921,1283,32,1.4,16.26,4.3,0,0,0,0,0,0,0.177868397529452,3026.21268849266,18.0403306123766
7.5,"eps_greedy_SVM","SVM",16,0,30040,26566,3474,100,91,9,0.417715292535374,0.0880398671096345,0.706690411341574,31,9,22,0,2.4,0.33,10.1,0,0,0,0,0,0,0.118795583426217,2644.12397670764,12.0736358979685
7.5,"eps_greedy_SVM","SVM",16,1,29940,26474,3466,200,183,17,0.581270331044605,0.187707641196013,1.62900751807295,63,17,46,32,2.7,0.66,10.8,0,0,0,0,0,0,0.927347292286836,3208.61495532818,95.6779538336107
7.5,"eps_greedy_SVM","SVM",16,2,29840,26395,3445,300,262,38,0.453690111990063,0.12624584717608,1.05697914735548,114,38,76,51,2,1,6.9,0,0,0,0,0,0,0.215988044376247,3714.1844188642,28.1193214044434
7.5,"eps_greedy_SVM","SVM",16,3,29740,26310,3430,400,347,53,0.418442232387832,0.0991140642303433,0.813596399994453,163,53,110,49,2.1,1.33,6.5,0,0,0,0,0,0,0.216119532132627,4017.94674425909,22.957420929525
7.5,"eps_greedy_SVM","SVM",16,4,29640,26233,3407,500,424,76,0.516029994252104,0.155592469545958,1.26939554420558,204,76,128,41,1.7,1.66,5.6,0,0,0,0,0,0,0.188873507066095,4336.25310469084,20.3131980733605
7.5,"eps_greedy_SVM","SVM",16,5,29540,26158,3382,600,499,101,0.52767422241646,0.147840531561462,1.19106717882343,250,101,149,46,1.5,1.99,4.9,0,0,0,0,0,0,0.225190772615344,4679.81705527832,24.7230019552045
7.5,"eps_greedy_SVM","SVM",16,6,29440,26069,3371,700,588,112,0.532403484803135,0.161129568106312,1.49819770921186,287,112,175,37,1.6,2.32,5.2,0,0,0,0,0,0,0.173242539509592,4460.41476128057,18.0654582273378
7.5,"eps_greedy_SVM","SVM",16,7,29340,26004,3336,800,653,147,0.536577576357903,0.138427464008859,1.3522273809276,358,147,211,71,1.4,2.65,4.4,0,0,0,0,0,0,0.194521733958208,5152.25824319598,20.0559991700804
7.5,"eps_greedy_SVM","SVM",16,8,29240,25930,3310,900,727,173,0.50847211560577,0.145071982281285,1.15488302879291,416,173,243,58,1.4,2.99,4.2,0,0,0,0,0,0,0.197818023214007,5349.67545854784,20.082063234108
7.5,"eps_greedy_SVM","SVM",16,9,29140,25841,3299,1000,816,184,0.501050441653006,0.135658914728682,1.08750824674254,450,184,266,34,1.4,3.32,4.4,0,0,0,0,0,0,0.186077273388636,5177.75997532536,18.6686317281158
7.5,"eps_greedy_SVM","SVM",16,10,29040,25742,3298,1100,915,185,0.509257744946175,0.154485049833887,1.29729528451982,458,185,273,8,1.5,3.65,4.9,0,0,0,0,0,0,0.169046752505962,4658.70815952621,16.9522565629051
7.5,"eps_greedy_SVM","SVM",16,11,28940,25664,3276,1200,993,207,0.533621103838234,0.187707641196013,1.62705050179356,513,207,306,55,1.5,3.98,4.8,0,0,0,0,0,0,0.174899204227273,4761.86338157275,17.6350042060448
7.5,"eps_greedy_SVM","SVM",16,12,28840,25590,3250,1300,1067,233,0.532377354206083,0.161683277962348,1.5429485626615,567,233,334,54,1.4,4.31,4.6,0,0,0,0,0,0,0.17960152520259,4844.53608917166,18.046519040247
7.5,"eps_greedy_SVM","SVM",16,13,28740,25503,3237,1400,1154,246,0.531201310370132,0.162236987818383,1.50151551728763,609,246,363,42,1.5,4.64,4.7,0,0,0,0,0,0,0.175435480545077,4938.82140908565,17.567204812326
7.5,"eps_greedy_SVM","SVM",16,14,28640,25417,3223,1500,1240,260,0.527577756266651,0.164451827242525,1.44636541463318,637,260,377,28,1.4,4.98,4.8,0,0,0,0,0,0,0.173839739348039,4813.03361249472,17.3984147704031
7.5,"eps_greedy_SVM","SVM",16,15,28540,25334,3206,1600,1323,277,0.526536122211052,0.161683277962348,1.44024711761697,683,277,406,46,1.5,5.31,4.8,0,0,0,0,0,0,0.172615011871678,4658.54531668335,17.2807979486346
7.5,"eps_greedy_SVM","SVM",16,16,28440,25242,3198,1700,1415,285,0.530149825162927,0.168327796234773,1.50180966294205,710,285,425,27,1.5,5.64,5,0,0,0,0,0,0,0.166845324692838,4532.61949875611,16.7069252467528
7.5,"eps_greedy_SVM","SVM",16,17,28340,25153,3187,1800,1504,296,0.520338203392048,0.156146179401993,1.35381774628206,746,296,450,36,1.5,5.97,5.1,0,0,0,0,0,0,0.163424197568955,4426.43038813949,16.3564907809742
7.5,"eps_greedy_SVM","SVM",16,18,28240,25075,3165,1900,1582,318,0.532871414504316,0.171650055370986,1.57839385630971,784,318,466,38,1.5,6.3,5,0,0,0,0,0,0,0.166191886657883,4492.70556137803,16.6256011446154
7.5,"eps_greedy_SVM","SVM",16,19,28140,24985,3155,2000,1672,328,0.52742493819029,0.161683277962348,1.45008516122347,803,328,475,19,1.4,6.64,5.1,0,0,0,0,0,0,0.163717877781171,4449.420230776,16.3808156392811
7.5,"eps_greedy_SVM","SVM",16,20,28040,24893,3147,2100,1764,336,0.529092579536569,0.166112956810631,1.43805359234545,819,336,483,16,1.4,6.97,5.2,0,0,0,0,0,0,0.159843974127194,4321.92796873115,15.987587180124
7.5,"eps_greedy_SVM","SVM",16,21,27940,24805,3135,2200,1852,348,0.528398490770172,0.164451827242525,1.30929564287624,890,348,542,71,1.6,7.3,5.3,0,0,0,0,0,0,0.158077271242195,4303.88294924,15.8116073290949
7.5,"eps_greedy_SVM","SVM",16,22,27840,24713,3127,2300,1944,356,0.531289970734565,0.163898117386489,1.40287909932422,885,356,529,-5,1.5,7.63,5.5,0,0,0,0,0,0,0.154121630719713,4170.26853633232,15.4140044394299
7.5,"eps_greedy_SVM","SVM",16,23,27740,24632,3108,2400,2025,375,0.531867264915414,0.165559246954596,1.4688283805205,941,375,566,56,1.5,7.96,5.4,0,0,0,0,0,0,0.155380776197589,4151.10398073188,15.5409795127327
7.5,"eps_greedy_SVM","SVM",16,24,27640,24550,3090,2500,2107,393,0.529246858588803,0.160022148394241,1.40281676022454,969,393,576,28,1.5,8.29,5.4,0,0,0,0,0,0,0.156807493104871,4189.29798860055,15.6846245578368
7.5,"eps_greedy_SVM","SVM",16,25,27540,24467,3073,2600,2190,410,0.530669723863041,0.166666666666667,1.51129219312702,999,410,589,30,1.4,8.63,5.3,0,0,0,0,0,0,0.159541756240847,4172.99013312863,16.1241185371918
7.5,"eps_greedy_SVM","SVM",16,26,27440,24374,3066,2700,2283,417,0.524994750922402,0.163898117386489,1.42952814290529,1043,417,626,44,1.5,8.96,5.5,0,0,0,0,0,0,0.153653241800506,4067.17104334459,15.3752912245877
7.5,"eps_greedy_SVM","SVM",16,27,27340,24291,3049,2800,2366,434,0.528252393182833,0.168327796234773,1.4722177747535,1095,434,661,52,1.5,9.29,5.5,0,0,0,0,0,0,0.155004976811092,4173.42131513726,15.5019214288612
7.5,"eps_greedy_SVM","SVM",16,28,27240,24213,3027,2900,2444,456,0.528050402832794,0.171650055370986,1.51858046834066,1134,456,678,39,1.5,9.62,5.4,0,0,0,0,0,0,0.157008211529847,4073.5827737793,15.702041645363
7.5,"eps_greedy_SVM","SVM",16,29,27140,24140,3000,3000,2517,483,0.531067067558442,0.181063122923588,1.62024161538666,1179,483,696,45,1.4,9.95,5.2,0,0,0,0,0,0,0.160487929954237,4244.69630499081,16.0522076737862
7.5,"eps_greedy_SVM","SVM",16,30,27040,24052,2988,3100,2605,495,0.529548070071741,0.173311184939092,1.53760964029935,1206,495,711,27,1.4,10.29,5.3,0,0,0,0,0,0,0.159379548692685,4192.79440312347,15.9387976863846
7.5,"eps_greedy_SVM","SVM",16,31,26940,23973,2967,3200,2684,516,0.527259221784073,0.173864894795127,1.39814701482388,1313,516,797,107,1.5,10.62,5.2,0,0,0,0,0,0,0.16079956404646,4118.88526311384,16.0838448370276
7.5,"eps_greedy_SVM","SVM",16,32,26840,23903,2937,3300,2754,546,0.530214775976047,0.171650055370986,1.52732712355808,1358,546,812,45,1.5,10.95,5,0,0,0,0,0,0,0.16501109673461,4201.03850306492,16.5085238803019
7.5,"eps_greedy_SVM","SVM",16,33,26740,23816,2924,3400,2841,559,0.530058159362415,0.172757475083056,1.62080612016521,1365,559,806,7,1.4,11.28,5.1,0,0,0,0,0,0,0.164357226905609,4373.76401595675,16.4361699165168
7.5,"eps_greedy_SVM","SVM",16,34,26640,23734,2906,3500,2923,577,0.528445826388479,0.170542635658915,1.39202276923487,1395,577,818,30,1.4,11.61,5.1,0,0,0,0,0,0,0.1647690925867,4327.49498769804,16.4786461048412
7.5,"eps_greedy_SVM","SVM",16,35,26540,23656,2884,3600,3001,599,0.531467667142938,0.176633444075305,1.58229135205879,1467,599,868,72,1.4,11.94,5,0,0,0,0,0,0,0.165826341301283,4258.42270635243,16.5911489340946
7.5,"eps_greedy_SVM","SVM",16,36,26440,23579,2861,3700,3078,622,0.531914642275884,0.174418604651163,1.62045012964105,1493,622,871,26,1.4,12.28,4.9,0,0,0,0,0,0,0.167901379321885,4404.42239834285,16.7905963814862
7.5,"eps_greedy_SVM","SVM",16,37,26340,23490,2850,3800,3167,633,0.527465553319564,0.173864894795127,1.54884796654498,1537,633,904,44,1.4,12.61,5,0,0,0,0,0,0,0.166035336907811,4286.97086085822,16.6075211517089
7.5,"eps_greedy_SVM","SVM",16,38,26240,23405,2835,3900,3252,648,0.532750779639344,0.176633444075305,1.52442259364155,1549,648,901,12,1.4,12.94,5,0,0,0,0,0,0,0.165771338767978,4229.59220618832,16.5797204459531
7.5,"eps_greedy_SVM","SVM",16,39,26140,23324,2816,4000,3333,667,0.528560032959622,0.167774086378738,1.42928863348754,1663,667,996,114,1.5,13.27,5,0,0,0,0,0,0,0.16669676820145,4330.66447325525,16.6714245449847
7.5,"eps_greedy_SVM","SVM",16,40,26040,23235,2805,4100,3422,678,0.520003639917034,0.166112956810631,1.43878642074312,1703,678,1025,40,1.5,13.6,5,0,0,0,0,0,0,0.164849438678365,4224.03787083505,16.4856733377904
7.5,"eps_greedy_SVM","SVM",16,41,25940,23156,2784,4200,3501,699,0.526018769783184,0.175526024363234,1.58811597172421,1722,699,1023,19,1.5,13.93,5,0,0,0,0,0,0,0.165971107531407,4159.38589994644,16.6006315524525
7.5,"eps_greedy_SVM","SVM",16,42,25840,23077,2763,4300,3580,720,0.522497943154684,0.169988925802879,1.45449148378644,1724,720,1004,2,1.4,14.27,5,0,0,0,0,0,0,0.168555372362278,4079.93219582223,16.9431758359927
7.5,"eps_greedy_SVM","SVM",16,43,25740,22989,2751,4400,3668,732,0.519537254676067,0.172203765227021,1.49385108622835,1796,732,1064,72,1.5,14.6,5,0,0,0,0,0,0,0.165765876571359,4158.63688616037,16.5805965760583
7.5,"eps_greedy_SVM","SVM",16,44,25640,22904,2736,4500,3753,747,0.521292721543426,0.173864894795127,1.51992288790236,1799,747,1052,3,1.4,14.93,5,0,0,0,0,0,0,0.165904462482177,4212.25615088425,16.59166012341
7.5,"eps_greedy_SVM","SVM",16,45,25540,22825,2715,4600,3832,768,0.524917569654114,0.178848283499446,1.51726568005638,1878,768,1110,79,1.4,15.26,5,0,0,0,0,0,0,0.166309500765214,4106.26365679167,16.6356908641156
7.5,"eps_greedy_SVM","SVM",16,46,25440,22735,2705,4700,3922,778,0.521121954334903,0.170542635658915,1.42243657505285,1861,778,1083,-17,1.4,15.59,5,0,0,0,0,0,0,0.165040373601219,4117.8087794259,16.5077363668755
7.5,"eps_greedy_SVM","SVM",16,47,25340,22650,2690,4800,4007,793,0.522548117240393,0.176079734219269,1.45890930774652,1955,793,1162,94,1.5,15.93,5.1,0,0,0,0,0,0,0.164614940742209,4073.64343303874,16.4645232660796
7.5,"eps_greedy_SVM","SVM",16,48,25240,22554,2686,4900,4103,797,0.518524965364436,0.172203765227021,1.45161476120778,1921,797,1124,-34,1.4,16.26,5.1,0,0,0,0,0,0,0.16225288634356,4036.47921111152,16.227110178206
7.5,"eps_greedy_SVM","SVM",17,0,30040,26532,3508,100,91,9,0.591635842373114,0.200338600451467,1.79568364188914,34,9,25,0,2.8,0.33,10.1,0,0,0,0,0,0,0.163433891927637,2769.97440638248,17.7106458292786
7.5,"eps_greedy_SVM","SVM",17,1,29940,26458,3482,200,165,35,0.589654583747282,0.196952595936795,1.68745588796894,94,35,59,60,1.7,0.66,4.7,0,0,0,0,0,0,0.202169306898565,5096.79168317688,21.2381602986727
7.5,"eps_greedy_SVM","SVM",17,2,29840,26376,3464,300,247,53,0.574290515062744,0.163092550790068,1.45282488371906,145,53,92,51,1.7,1,4.7,0,0,0,0,0,0,0.371760505581823,4973.44404524945,40.7154054967979
7.5,"eps_greedy_SVM","SVM",17,3,29740,26296,3444,400,327,73,0.569030441026722,0.146726862302483,1.18693102583396,203,73,130,58,1.8,1.33,4.5,0,0,0,0,0,0,0.212478994225786,5263.28472311944,22.2531475042509
7.5,"eps_greedy_SVM","SVM",17,4,29640,26205,3435,500,418,82,0.565421571438104,0.167042889390519,1.41379266079325,251,82,169,48,2.1,1.66,5.1,0,0,0,0,0,0,0.182778330983756,4684.81629574792,18.5167334025127
7.5,"eps_greedy_SVM","SVM",17,5,29540,26131,3409,600,492,108,0.555768738531068,0.144469525959368,1.17131351233615,282,108,174,31,1.6,1.99,4.6,0,0,0,0,0,0,0.206991322072755,5045.89336043228,21.1442065966799
7.5,"eps_greedy_SVM","SVM",17,6,29440,26041,3399,700,582,118,0.572876115365015,0.180022573363431,1.46742560328109,311,118,193,29,1.6,2.32,4.9,0,0,0,0,0,0,0.212654764062708,4426.07135793786,21.4615885763925
7.5,"eps_greedy_SVM","SVM",17,7,29340,25953,3387,800,670,130,0.539282345606529,0.167042889390519,1.37779300897795,362,130,232,51,1.8,2.65,5.2,0,0,0,0,0,0,0.173706504212453,4369.1303662955,17.5710584226958
7.5,"eps_greedy_SVM","SVM",17,8,29240,25869,3371,900,754,146,0.53400580705248,0.168171557562077,1.55303768254579,397,146,251,35,1.7,2.99,5.2,0,0,0,0,0,0,0.199874123575802,3629.14741681979,20.5192218294526
7.5,"eps_greedy_SVM","SVM",17,9,29140,25792,3348,1000,831,169,0.522944918379271,0.15293453724605,1.38161108756296,452,169,283,55,1.7,3.32,4.9,0,0,0,0,0,0,0.177667082960006,4134.67605922918,18.0426701452235
7.5,"eps_greedy_SVM","SVM",17,10,29040,25703,3337,1100,920,180,0.546351776818531,0.185665914221219,1.6802897602587,485,180,305,33,1.7,3.65,5.1,0,0,0,0,0,0,0.171728480344676,3899.69575940719,17.410251517478
7.5,"eps_greedy_SVM","SVM",17,11,28940,25633,3307,1200,990,210,0.543558876861871,0.165914221218962,1.46484664791504,559,210,349,74,1.7,3.98,4.7,0,0,0,0,0,0,0.19964271054044,3725.8189786912,21.7654135766114
7.5,"eps_greedy_SVM","SVM",17,12,28840,25542,3298,1300,1081,219,0.530822574958959,0.169300225733634,1.68306312798918,605,219,386,46,1.8,4.31,4.9,0,0,0,0,0,0,0.172374261517874,4387.13984288098,17.5324913128946
7.5,"eps_greedy_SVM","SVM",17,13,28740,25463,3277,1400,1160,240,0.544972173267154,0.18058690744921,1.83573506847647,629,240,389,24,1.6,4.64,4.8,0,0,0,0,0,0,0.188347713905818,3647.77754175955,19.0199900379878
7.5,"eps_greedy_SVM","SVM",17,14,28640,25392,3248,1500,1231,269,0.542745644243865,0.186230248306998,1.83953985523002,708,269,439,79,1.6,4.98,4.6,0,0,0,0,0,0,0.192107210169246,3549.70280880972,19.6166152303198
7.5,"eps_greedy_SVM","SVM",17,15,28540,25309,3231,1600,1314,286,0.550972047322079,0.190180586907449,1.75278584748258,732,286,446,24,1.6,5.31,4.6,0,0,0,0,0,0,0.186874247808605,3689.31051890141,18.8959204349288
7.5,"eps_greedy_SVM","SVM",17,16,28440,25221,3219,1700,1402,298,0.531560316913118,0.178329571106095,1.5928501624181,755,298,457,23,1.5,5.64,4.7,0,0,0,0,0,0,0.182770377326353,3608.60466680134,18.3914820539297
7.5,"eps_greedy_SVM","SVM",17,17,28340,25145,3195,1800,1478,322,0.542275556793512,0.192437923250564,1.99556399206512,873,322,551,118,1.7,5.97,4.6,0,0,0,0,0,0,0.199552095650675,3574.2690881915,20.8567430820913
7.5,"eps_greedy_SVM","SVM",17,18,28240,25068,3172,1900,1555,345,0.530025318864251,0.172121896162528,1.7084438179542,900,345,555,27,1.6,6.3,4.5,0,0,0,0,0,0,0.188837855942233,4001.52283217856,19.0530787223188
7.5,"eps_greedy_SVM","SVM",17,19,28140,24988,3152,2000,1635,365,0.533906150040646,0.177765237020316,1.67313029641417,949,365,584,49,1.6,6.64,4.5,0,0,0,0,0,0,0.186317205622575,4409.05708323536,18.7334403430822
7.5,"eps_greedy_SVM","SVM",17,20,28040,24897,3143,2100,1726,374,0.536891277488743,0.165349887133183,1.59423887223712,974,374,600,25,1.6,6.97,4.6,0,0,0,0,0,0,0.188198549691054,3460.96612096776,19.6942395574744
7.5,"eps_greedy_SVM","SVM",17,21,27940,24810,3130,2200,1813,387,0.54527027439901,0.184537246049661,1.7173005479296,985,387,598,11,1.5,7.3,4.7,0,0,0,0,0,0,0.184010227215137,3361.26150045052,18.7674255687042
7.5,"eps_greedy_SVM","SVM",17,22,27840,24733,3107,2300,1890,410,0.554035126624873,0.198645598194131,1.98723729190488,1005,410,595,20,1.5,7.63,4.6,0,0,0,0,0,0,0.180599546758832,4401.8401813936,19.6695109615253
7.5,"eps_greedy_SVM","SVM",17,23,27740,24677,3063,2400,1946,454,0.542746153455757,0.168171557562077,1.48950595565184,1148,454,694,143,1.5,7.96,4.3,0,0,0,0,0,0,0.206639775529472,4938.55906301097,25.8223489308767
7.5,"eps_greedy_SVM","SVM",17,24,27640,24606,3034,2500,2017,483,0.583930872278288,0.185665914221219,1.48933383496363,1182,483,699,34,1.4,8.29,4.2,0,0,0,0,0,0,0.213021200939541,4721.655478001,23.2799917865251
7.5,"eps_greedy_SVM","SVM",17,25,27540,24523,3017,2600,2100,500,0.589311714402739,0.177200902934537,1.36959012475599,1262,500,762,80,1.5,8.63,4.2,0,0,0,0,0,0,0.395304521707137,4451.88175247032,46.1097825505013
7.5,"eps_greedy_SVM","SVM",17,26,27440,24426,3014,2700,2197,503,0.580154174934992,0.161399548532731,1.19315856569823,1255,503,752,-7,1.5,8.96,4.4,0,0,0,0,0,0,0.283246137763444,3813.87839279779,30.7106168632733
7.5,"eps_greedy_SVM","SVM",17,27,27340,24337,3003,2800,2286,514,0.59145795768347,0.172686230248307,1.3922905135641,1283,514,769,28,1.5,9.29,4.4,0,0,0,0,0,0,0.196974568820898,3591.60977283478,21.78227101568
7.5,"eps_greedy_SVM","SVM",17,28,27240,24246,2994,2900,2377,523,0.592473453510737,0.181151241534989,1.70400528430933,1346,523,823,63,1.6,9.62,4.5,0,0,0,0,0,0,0.195603352888474,3255.76005546759,20.0632205577312
7.5,"eps_greedy_SVM","SVM",17,29,27140,24155,2985,3000,2468,532,0.596194731625818,0.203160270880361,1.76435149608568,1337,532,805,-9,1.5,9.95,4.6,0,0,0,0,0,0,0.185498063549994,3190.52823318993,18.8999004416998
7.5,"eps_greedy_SVM","SVM",17,30,27040,24082,2958,3100,2541,559,0.600857712277285,0.207110609480813,1.88918126610599,1407,559,848,70,1.5,10.29,4.5,0,0,0,0,0,0,0.185139342552102,3361.81382629798,18.7326995980177
7.5,"eps_greedy_SVM","SVM",17,31,26940,23991,2949,3200,2632,568,0.59619850828072,0.184537246049661,1.77032202532455,1410,568,842,3,1.5,10.62,4.6,0,0,0,0,0,0,0.181042227894594,3012.83988070896,18.3221259411951
7.5,"eps_greedy_SVM","SVM",17,32,26840,23901,2939,3300,2722,578,0.59548039220179,0.188487584650113,1.71580724310531,1477,578,899,67,1.6,10.95,4.7,0,0,0,0,0,0,0.176781297318259,2996.01653983715,17.8507709905837
7.5,"eps_greedy_SVM","SVM",17,33,26740,23819,2921,3400,2804,596,0.596005898880357,0.195259593679458,1.70250923050397,1507,596,911,30,1.5,11.28,4.7,0,0,0,0,0,0,0.176515648609286,2727.37879053912,17.7415665337078
7.5,"eps_greedy_SVM","SVM",17,34,26640,23730,2910,3500,2893,607,0.597222788013217,0.19920993227991,1.70251581528858,1536,607,929,29,1.5,11.61,4.8,0,0,0,0,0,0,0.174254871029625,2747.63658389368,17.5272903357001
7.5,"eps_greedy_SVM","SVM",17,35,26540,23663,2877,3600,2960,640,0.595767205803257,0.187923250564334,1.61432079566147,1656,640,1016,120,1.6,11.94,4.6,0,0,0,0,0,0,0.183114537533274,3051.60265390354,19.451963502749
7.5,"eps_greedy_SVM","SVM",17,36,26440,23590,2850,3700,3033,667,0.599021536608011,0.204853273137698,1.82198356246916,1644,667,977,-12,1.5,12.28,4.5,0,0,0,0,0,0,0.181007928898424,3368.44629208803,18.2198285408759
7.5,"eps_greedy_SVM","SVM",17,37,26340,23503,2837,3800,3120,680,0.596770607847933,0.205417607223476,1.7508237174544,1724,680,1044,80,1.5,12.61,4.6,0,0,0,0,0,0,0.179466395467379,3813.65365424181,17.9603489129518
7.5,"eps_greedy_SVM","SVM",17,38,26240,23412,2828,3900,3211,689,0.59923014374882,0.192437923250564,1.71758902882553,1801,689,1112,77,1.6,12.94,4.7,0,0,0,0,0,0,0.180124174650445,2701.30049758896,18.0896997221197
7.5,"eps_greedy_SVM","SVM",17,39,26140,23321,2819,4000,3302,698,0.598579264857575,0.195259593679458,1.77874235818255,1765,698,1067,-36,1.5,13.27,4.7,0,0,0,0,0,0,0.174662874674196,2529.95349151447,17.6966459640181
7.5,"eps_greedy_SVM","SVM",17,40,26040,23235,2805,4100,3388,712,0.600156994271536,0.19920993227991,1.9059211591792,1794,712,1082,29,1.5,13.6,4.8,0,0,0,0,0,0,0.17228577511679,3227.54155443266,17.3885242092362
7.5,"eps_greedy_SVM","SVM",17,41,25940,23145,2795,4200,3478,722,0.59857393934981,0.196952595936795,1.92483366995367,1852,722,1130,58,1.6,13.93,4.8,0,0,0,0,0,0,0.171228083352108,2881.93631889563,17.2113409542017
7.5,"eps_greedy_SVM","SVM",17,42,25840,23053,2787,4300,3570,730,0.5963821852557,0.189051918735892,1.74309039714762,1870,730,1140,18,1.6,14.27,4.9,0,0,0,0,0,0,0.168764371198342,2905.13686127509,16.9408307721717
7.5,"eps_greedy_SVM","SVM",17,43,25740,22971,2769,4400,3652,748,0.592445149816081,0.193566591422122,1.76251637265558,1910,748,1162,40,1.6,14.6,4.9,0,0,0,0,0,0,0.170024028640675,3175.17498799777,17.0362323172854
7.5,"eps_greedy_SVM","SVM",17,44,25640,22882,2758,4500,3741,759,0.59448874446508,0.191309255079007,1.72782690855613,1894,759,1135,-16,1.5,14.93,4.9,0,0,0,0,0,0,0.169654609017826,2443.90732490698,17.0631563054428
7.5,"eps_greedy_SVM","SVM",17,45,25540,22793,2747,4600,3830,770,0.600973812589997,0.217268623024831,1.97775046753407,1961,770,1191,67,1.5,15.26,5,0,0,0,0,0,0,0.165154110892801,3118.32597860621,16.5766607599669
7.5,"eps_greedy_SVM","SVM",17,46,25440,22704,2736,4700,3919,781,0.596439832285976,0.191873589164786,1.78817032121178,1955,781,1174,-6,1.5,15.59,5,0,0,0,0,0,0,0.164059025643861,2788.13025367199,16.5002050039586
7.5,"eps_greedy_SVM","SVM",17,47,25340,22632,2708,4800,3991,809,0.598146074052649,0.212189616252822,1.85606018640336,2010,809,1201,55,1.5,15.93,4.9,0,0,0,0,0,0,0.167989906207928,2576.77894625085,16.8948748944401
7.5,"eps_greedy_SVM","SVM",17,48,25240,22564,2676,4900,4059,841,0.599430858105212,0.209367945823928,1.88007009623381,2089,841,1248,79,1.5,16.26,4.8,0,0,0,0,0,0,0.168718075025114,2743.30447587502,16.9831429457729
7.5,"eps_greedy_SVM","SVM",18,0,30040,26469,3571,100,86,14,0.638661082351562,0.247065727699531,2.44912348803469,48,14,34,0,2.4,0.33,6.1,0,0,0,0,0,0,0.886561425724987,4539.48837778769,91.530906699751
7.5,"eps_greedy_SVM","SVM",18,1,29940,26427,3513,200,128,72,0.6309932517225,0.220070422535211,2.09842756008812,145,70,75,97,1.1,0.66,1.8,0,0,0,0,0,0,0.614226976161919,6626.18461877823,64.7153376862935
7.5,"eps_greedy_SVM","SVM",18,2,29840,26348,3492,300,207,93,0.581039696948309,0.193661971830986,1.72151555164319,198,93,105,53,1.1,1,2.2,0,0,0,0,0,0,0.332483744782066,8803.31355943552,34.0493978827086
7.5,"eps_greedy_SVM","SVM",18,3,29740,26287,3453,400,268,132,0.54118581655264,0.150821596244131,1.20100451329078,284,132,152,86,1.2,1.33,2,0,0,0,0,0,0,0.341134391491551,9481.90184479658,34.3807309395184
7.5,"eps_greedy_SVM","SVM",18,4,29640,26206,3434,500,349,151,0.552624012572479,0.179577464788732,1.65784490199794,334,151,183,50,1.2,1.66,2.3,0,0,0,0,0,0,0.376537502196287,8275.7099335168,39.6072301930726
7.5,"eps_greedy_SVM","SVM",18,5,29540,26140,3400,600,415,185,0.50459928030315,0.144366197183099,1.49651512476831,406,185,221,72,1.2,1.99,2.2,0,0,0,0,0,0,0.336261233400233,8555.78700772202,34.5791267361442
7.5,"eps_greedy_SVM","SVM",18,6,29440,26054,3386,700,501,199,0.556493687066916,0.18368544600939,1.86240667204401,444,199,245,38,1.2,2.32,2.5,0,0,0,0,0,0,0.285174530242059,8337.91868007014,28.5396663343447
7.5,"eps_greedy_SVM","SVM",18,7,29340,25978,3362,800,577,223,0.559357758104448,0.173708920187793,1.64254694835681,507,223,284,63,1.3,2.65,2.6,0,0,0,0,0,0,0.285119914512433,7866.30054543694,28.711982189424
7.5,"eps_greedy_SVM","SVM",18,8,29240,25895,3345,900,660,240,0.55130388638406,0.163732394366197,1.51755214036678,539,240,299,32,1.2,2.99,2.8,0,0,0,0,0,0,0.293611891816548,7314.74850553399,31.0074268313779
7.5,"eps_greedy_SVM","SVM",18,9,29140,25808,3332,1000,747,253,0.565596670344,0.179577464788732,1.55940137709606,570,253,317,31,1.3,3.32,3,0,0,0,0,0,0,0.285838744085255,6037.91955468982,29.4213378598033
7.5,"eps_greedy_SVM","SVM",18,10,29040,25729,3311,1100,826,274,0.565689350060117,0.190140845070423,1.70355488250523,613,274,339,43,1.2,3.65,3,0,0,0,0,0,0,0.246814626356474,6849.79698338421,24.8213580327019
7.5,"eps_greedy_SVM","SVM",18,11,28940,25653,3287,1200,902,298,0.545225484349204,0.156103286384977,1.42551338007266,680,298,382,67,1.3,3.98,3,0,0,0,0,0,0,0.251204642058551,6487.31665053067,25.5534665361152
7.5,"eps_greedy_SVM","SVM",18,12,28840,25559,3281,1300,996,304,0.556419446706922,0.18368544600939,1.72976183057044,708,304,404,28,1.3,4.31,3.3,0,0,0,0,0,0,0.234311658920293,6135.36091447177,24.2334081773651
7.5,"eps_greedy_SVM","SVM",18,13,28740,25476,3264,1400,1079,321,0.544695484570474,0.159037558685446,1.46884407391656,762,321,441,54,1.4,4.64,3.4,0,0,0,0,0,0,0.226533743340385,6194.57252275548,22.8141214197679
7.5,"eps_greedy_SVM","SVM",18,14,28640,25386,3254,1500,1169,331,0.554462152958143,0.177816901408451,1.69062694752586,769,331,438,7,1.3,4.98,3.5,0,0,0,0,0,0,0.219104394404521,5399.48296673409,21.9415007443884
7.5,"eps_greedy_SVM","SVM",18,15,28540,25305,3235,1600,1250,350,0.551402536939299,0.178403755868545,1.92543624579334,809,350,459,40,1.3,5.31,3.6,0,0,0,0,0,0,0.216454077242524,5694.19272410792,21.7215964950505
7.5,"eps_greedy_SVM","SVM",18,16,28440,25214,3226,1700,1341,359,0.55377063320046,0.174882629107981,1.62370042556013,837,359,478,28,1.3,5.64,3.7,0,0,0,0,0,0,0.206947961062575,5410.32232861638,20.7519730664731
7.5,"eps_greedy_SVM","SVM",18,17,28340,25143,3197,1800,1412,388,0.547685689584498,0.188380281690141,1.96370912700875,909,388,521,72,1.3,5.97,3.6,0,0,0,0,0,0,0.213028667331388,5695.92761672049,21.356427102756
7.5,"eps_greedy_SVM","SVM",18,18,28240,25064,3176,1900,1491,409,0.552459638883648,0.192488262910798,1.90027365786229,951,409,542,42,1.3,6.3,3.6,0,0,0,0,0,0,0.210478233214621,5214.78939239146,21.0869770674223
7.5,"eps_greedy_SVM","SVM",18,19,28140,24978,3162,2000,1577,423,0.549844411347263,0.179577464788732,1.80785919629377,981,423,558,30,1.3,6.64,3.7,0,0,0,0,0,0,0.208048816646552,5321.39671577568,20.8194315884024
7.5,"eps_greedy_SVM","SVM",18,20,28040,24896,3144,2100,1659,441,0.551665209957535,0.185446009389671,1.81086526481679,1034,441,593,53,1.3,6.97,3.8,0,0,0,0,0,0,0.206685318562256,5068.1992969277,20.6910369392706
7.5,"eps_greedy_SVM","SVM",18,21,27940,24814,3126,2200,1741,459,0.553176315191465,0.187206572769953,1.9369185650402,1068,459,609,34,1.3,7.3,3.8,0,0,0,0,0,0,0.205390002220558,5119.60500126417,20.5608671854895
7.5,"eps_greedy_SVM","SVM",18,22,27840,24730,3110,2300,1825,475,0.554310511205686,0.193075117370892,1.88858480407931,1088,475,613,20,1.3,7.63,3.8,0,0,0,0,0,0,0.203525248278545,5182.37839698762,20.3694704777305
7.5,"eps_greedy_SVM","SVM",18,23,27740,24653,3087,2400,1902,498,0.553998622667904,0.195422535211268,1.94640923593202,1144,498,646,56,1.3,7.96,3.8,0,0,0,0,0,0,0.202718362447685,4995.83285429268,20.3151218679354
7.5,"eps_greedy_SVM","SVM",18,24,27640,24578,3062,2500,1977,523,0.555375647440916,0.200117370892019,1.99989198997667,1188,523,665,44,1.3,8.29,3.8,0,0,0,0,0,0,0.205254606452808,4905.93163805497,20.55077556862
7.5,"eps_greedy_SVM","SVM",18,25,27540,24504,3036,2600,2051,549,0.5535477804108,0.195422535211268,1.99739215904684,1247,549,698,59,1.3,8.63,3.7,0,0,0,0,0,0,0.208113556066013,5437.81591448167,20.8264860832241
7.5,"eps_greedy_SVM","SVM",18,26,27440,24410,3030,2700,2145,555,0.554636273163786,0.204225352112676,1.95764142467977,1258,555,703,11,1.3,8.96,3.9,0,0,0,0,0,0,0.204405228639228,5351.73047818066,20.448374535923
7.5,"eps_greedy_SVM","SVM",18,27,27340,24342,2998,2800,2213,587,0.556301347021301,0.20481220657277,2.04762251620049,1341,587,754,83,1.3,9.29,3.8,0,0,0,0,0,0,0.204670097038028,4855.58804288693,20.519185334458
7.5,"eps_greedy_SVM","SVM",18,28,27240,24258,2982,2900,2297,603,0.556740950051822,0.204225352112676,2.01470645921852,1374,603,771,33,1.3,9.62,3.8,0,0,0,0,0,0,0.204355664500768,5005.30338634269,20.4568806708622
7.5,"eps_greedy_SVM","SVM",18,29,27140,24175,2965,3000,2380,620,0.5559420868996,0.200704225352113,1.96025493329369,1427,620,807,53,1.3,9.95,3.8,0,0,0,0,0,0,0.205547959170021,5308.8825951202,20.5657160787965
7.5,"eps_greedy_SVM","SVM",18,30,27040,24100,2940,3100,2455,645,0.554619985065874,0.202464788732394,2.12174342186688,1486,645,841,59,1.3,10.29,3.8,0,0,0,0,0,0,0.20406419762275,4933.85484975477,20.4249727276978
7.5,"eps_greedy_SVM","SVM",18,31,26940,24019,2921,3200,2536,664,0.557896570841731,0.203051643192488,2.05415262536363,1504,664,840,18,1.3,10.62,3.8,0,0,0,0,0,0,0.203624586546045,4923.70593604994,20.3820501020183
7.5,"eps_greedy_SVM","SVM",18,32,26840,23946,2894,3300,2609,691,0.557704406409036,0.20481220657277,2.01431955607993,1582,691,891,78,1.3,10.95,3.8,0,0,0,0,0,0,0.206402234107634,4887.89839765218,20.6661892481313
7.5,"eps_greedy_SVM","SVM",18,33,26740,23876,2864,3400,2679,721,0.553474330308928,0.197183098591549,1.92575234844831,1627,721,906,45,1.3,11.28,3.7,0,0,0,0,0,0,0.210321217731999,5052.4886907577,21.0783485054679
7.5,"eps_greedy_SVM","SVM",18,34,26640,23792,2848,3500,2763,737,0.557865355646011,0.204225352112676,2.15115173396753,1686,737,949,59,1.3,11.61,3.7,0,0,0,0,0,0,0.206650672755173,5035.5401177541,20.6761273152002
7.5,"eps_greedy_SVM","SVM",18,35,26540,23708,2832,3600,2847,753,0.554984996510565,0.205985915492958,1.97140700519974,1738,753,985,52,1.3,11.94,3.8,0,0,0,0,0,0,0.205741295950579,4601.70246190883,20.6219800341974
7.5,"eps_greedy_SVM","SVM",18,36,26440,23623,2817,3700,2932,768,0.554585872257059,0.203638497652582,1.96373616082154,1741,768,973,3,1.3,12.28,3.8,0,0,0,0,0,0,0.205891581630862,5115.63181506928,20.6007420483841
7.5,"eps_greedy_SVM","SVM",18,37,26340,23539,2801,3800,3016,784,0.5545831941601,0.203638497652582,1.87331075573813,1789,784,1005,48,1.3,12.61,3.8,0,0,0,0,0,0,0.203193866056813,4723.66638457087,20.3375975294737
7.5,"eps_greedy_SVM","SVM",18,38,26240,23458,2782,3900,3097,803,0.554113649127497,0.209507042253521,2.10104762490518,1809,803,1006,20,1.3,12.94,3.9,0,0,0,0,0,0,0.200393143960083,4369.83929778691,20.0783540428132
7.5,"eps_greedy_SVM","SVM",18,39,26140,23372,2768,4000,3183,817,0.553720407906651,0.203638497652582,2.03330347762566,1885,817,1068,76,1.3,13.27,3.9,0,0,0,0,0,0,0.20100871197606,4814.59516974219,20.1375401162467
7.5,"eps_greedy_SVM","SVM",18,40,26040,23290,2750,4100,3265,835,0.552912412882823,0.200704225352113,1.99344577829672,1909,835,1074,24,1.3,13.6,3.9,0,0,0,0,0,0,0.200646962186754,4695.17653438135,20.0923057248811
7.5,"eps_greedy_SVM","SVM",18,41,25940,23207,2733,4200,3348,852,0.551250587864233,0.193661971830986,1.80594167096822,1922,852,1070,13,1.3,13.93,3.9,0,0,0,0,0,0,0.198435365289136,4312.29947696952,19.875421082849
7.5,"eps_greedy_SVM","SVM",18,42,25840,23126,2714,4300,3429,871,0.554332506723345,0.205399061032864,2.08196213023564,1997,871,1126,75,1.3,14.27,3.9,0,0,0,0,0,0,0.198743583786617,4467.04808042436,19.8965992394027
7.5,"eps_greedy_SVM","SVM",18,43,25740,23034,2706,4400,3521,879,0.553015541567401,0.204225352112676,2.01675778488745,1995,879,1116,-2,1.3,14.6,4,0,0,0,0,0,0,0.195977835127268,4478.19777497667,19.6183679371073
7.5,"eps_greedy_SVM","SVM",18,44,25640,22949,2691,4500,3606,894,0.552032987305648,0.207746478873239,1.88918785891753,2065,894,1171,70,1.3,14.93,4,0,0,0,0,0,0,0.196699468186429,4670.28315297048,19.7321369564389
7.5,"eps_greedy_SVM","SVM",18,45,25540,22858,2682,4600,3697,903,0.555250084206388,0.207746478873239,1.96714838699151,2057,903,1154,-8,1.3,15.26,4.1,0,0,0,0,0,0,0.1933940745177,4551.59407993655,20.2970361764192
7.5,"eps_greedy_SVM","SVM",18,46,25440,22775,2665,4700,3780,920,0.553997568990408,0.190727699530516,1.88858480407931,2146,920,1226,89,1.3,15.59,4.1,0,0,0,0,0,0,0.191359271615709,4106.72322423961,19.2030954858849
7.5,"eps_greedy_SVM","SVM",18,47,25340,22697,2643,4800,3858,942,0.553060893602799,0.202464788732394,1.89414202288322,2239,942,1297,93,1.4,15.93,4.1,0,0,0,0,0,0,0.193718019384553,4522.61886396924,19.384607618754
7.5,"eps_greedy_SVM","SVM",18,48,25240,22607,2633,4900,3948,952,0.552672569543594,0.193075117370892,1.77044295200105,2276,952,1324,37,1.4,16.26,4.1,0,0,0,0,0,0,0.191561608375717,4467.62161209948,19.1714280740622
7.5,"eps_greedy_SVM","SVM",19,0,30040,26508,3532,100,92,8,0.442814170775865,0.109205260148656,0.936956080836618,31,8,23,0,2.9,0.33,11.5,0,0,0,0,0,0,0.0845788278334048,2465.2554105781,8.47795330838661
7.5,"eps_greedy_SVM","SVM",19,1,29940,26420,3520,200,180,20,0.415039340042809,0,0.685962640547985,71,20,51,40,2.5,0.66,9,0,0,0,0,0,0,0.140237727049384,2962.09892606507,14.3026628462688
7.5,"eps_greedy_SVM","SVM",19,2,29840,26327,3513,300,273,27,0.431497154227748,0.093767867352773,0.892467124070898,93,27,66,22,2.4,1,10.1,0,0,0,0,0,0,0.133804168860705,2303.21689734114,13.6152294851364
7.5,"eps_greedy_SVM","SVM",19,3,29740,26233,3507,400,367,33,0.436955288496078,0.0880503144654088,0.735965035434585,107,33,74,14,2.2,1.33,11.1,0,0,0,0,0,0,0.113289024257855,2115.83328706206,11.8324816956988
7.5,"eps_greedy_SVM","SVM",19,4,29640,26140,3500,500,460,40,0.424856067623176,0.0714694110920526,0.593745643648971,142,40,102,35,2.5,1.66,11.5,0,0,0,0,0,0,0.0843836468614363,2327.40838789897,8.45974074577674
7.5,"eps_greedy_SVM","SVM",19,5,29540,26053,3487,600,547,53,0.463523325873306,0.107489994282447,0.961710263007433,162,53,109,20,2.1,1.99,10.3,0,0,0,0,0,0,0.107781488475788,2358.71948066778,11.2523519507559
7.5,"eps_greedy_SVM","SVM",19,6,29440,25973,3467,700,627,73,0.534224631245309,0.148084619782733,1.44899973509013,209,73,136,47,1.9,2.32,8.6,0,0,0,0,0,0,0.243640489701535,3184.15083115874,30.7060907914443
7.5,"eps_greedy_SVM","SVM",19,7,29340,25898,3442,800,702,98,0.576645680560895,0.150371640937679,1.31689738911887,248,98,150,39,1.5,2.65,7.2,0,0,0,0,0,0,0.299240725099481,3334.49339193266,37.0836282094733
7.5,"eps_greedy_SVM","SVM",19,8,29240,25807,3433,900,793,107,0.519899805057285,0.124070897655803,1.13461276296165,300,107,193,52,1.8,2.99,7.4,0,0,0,0,0,0,0.138869187341054,3395.14306628284,14.5089348717123
7.5,"eps_greedy_SVM","SVM",19,9,29140,25716,3424,1000,884,116,0.522753946343243,0.153230417381361,1.42981615519043,315,116,199,15,1.7,3.32,7.6,0,0,0,0,0,0,0.126131870074691,3177.23463097606,13.0289495808586
7.5,"eps_greedy_SVM","SVM",19,10,29040,25640,3400,1100,960,140,0.520873359851586,0.14694110920526,1.14479779674048,365,140,225,50,1.6,3.65,6.9,0,0,0,0,0,0,0.156681955980354,3478.62528130667,16.4585366272848
7.5,"eps_greedy_SVM","SVM",19,11,28940,25554,3386,1200,1046,154,0.517367506806172,0.133218982275586,1.21909029613708,400,154,246,35,1.6,3.98,6.8,0,0,0,0,0,0,0.150125855913295,3094.13503011744,15.7067523171208
7.5,"eps_greedy_SVM","SVM",19,12,28840,25469,3371,1300,1131,169,0.519565472847461,0.134362492853059,1.32972584159437,455,169,286,55,1.7,4.31,6.7,0,0,0,0,0,0,0.138302018453429,3394.3570346927,13.978772539255
7.5,"eps_greedy_SVM","SVM",19,13,28740,25396,3344,1400,1204,196,0.523567545277983,0.13893653516295,1.18671672033142,514,196,318,59,1.6,4.64,6.1,0,0,0,0,0,0,0.146004609643232,3755.40589508074,15.3855842256602
7.5,"eps_greedy_SVM","SVM",19,14,28640,25325,3315,1500,1275,225,0.54124114416637,0.142938822184105,1.4073054846063,588,225,363,74,1.6,4.98,5.7,0,0,0,0,0,0,0.15631900714308,3843.395380905,16.5349635783141
7.5,"eps_greedy_SVM","SVM",19,15,28540,25241,3299,1600,1359,241,0.558109427318539,0.152086906803888,1.33891439949813,615,241,374,27,1.6,5.31,5.6,0,0,0,0,0,0,0.162393667919067,3596.68142499779,17.326512134976
7.5,"eps_greedy_SVM","SVM",19,16,28440,25166,3274,1700,1434,266,0.540389863116069,0.142367066895369,1.25132721803764,676,266,410,61,1.5,5.64,5.4,0,0,0,0,0,0,0.159417130430883,4099.35070884922,16.5306646611609
7.5,"eps_greedy_SVM","SVM",19,17,28340,25090,3250,1800,1510,290,0.551032657347081,0.158376214979989,1.45111393018233,734,290,444,58,1.5,5.97,5.2,0,0,0,0,0,0,0.173488081274872,4163.11840668555,18.5571989067826
7.5,"eps_greedy_SVM","SVM",19,18,28240,25024,3216,1900,1576,324,0.547064790663827,0.139508290451687,1.25337075731587,782,324,458,48,1.4,6.3,4.9,0,0,0,0,0,0,0.173011920118696,4559.2951508002,17.3381770832926
7.5,"eps_greedy_SVM","SVM",19,19,28140,24938,3202,2000,1662,338,0.544499445454885,0.148656375071469,1.39369378775449,856,338,518,74,1.5,6.64,4.9,0,0,0,0,0,0,0.174449247629235,4015.30857601057,17.5322220623494
7.5,"eps_greedy_SVM","SVM",19,20,28040,24854,3186,2100,1746,354,0.547913496626494,0.142938822184105,1.31937330476535,887,354,533,31,1.5,6.97,4.9,0,0,0,0,0,0,0.170311156006382,4142.13677644215,17.1489142525334
7.5,"eps_greedy_SVM","SVM",19,21,27940,24771,3169,2200,1829,371,0.545696303264289,0.144654088050314,1.42867402404549,951,371,580,64,1.6,7.3,4.9,0,0,0,0,0,0,0.171769811576517,4431.63469658252,17.3974847214166
7.5,"eps_greedy_SVM","SVM",19,22,27840,24696,3144,2300,1904,396,0.550950082870619,0.152086906803888,1.43615399275777,1013,396,617,62,1.6,7.63,4.8,0,0,0,0,0,0,0.173294792533378,4500.40702162198,17.3579596743466
7.5,"eps_greedy_SVM","SVM",19,23,27740,24615,3125,2400,1985,415,0.543270055705154,0.141223556317896,1.32797615953705,1065,415,650,52,1.6,7.96,4.8,0,0,0,0,0,0,0.173512011334877,4454.34709922682,17.6760483819289
7.5,"eps_greedy_SVM","SVM",19,24,27640,24521,3119,2500,2079,421,0.551130682349287,0.141223556317896,1.34106899065773,1064,421,643,-1,1.5,8.29,4.9,0,0,0,0,0,0,0.169768952087656,4205.41287430183,17.3965543949852
7.5,"eps_greedy_SVM","SVM",19,25,27540,24426,3114,2600,2174,426,0.548589242537125,0.149228130360206,1.38167918613592,1104,426,678,40,1.6,8.63,5.1,0,0,0,0,0,0,0.164219054934082,4318.14178195252,16.4246721700071
7.5,"eps_greedy_SVM","SVM",19,26,27440,24348,3092,2700,2252,448,0.544922832778353,0.145225843339051,1.32106151250192,1125,448,677,21,1.5,8.96,5,0,0,0,0,0,0,0.16705242260383,4045.25373755461,16.7192194299937
7.5,"eps_greedy_SVM","SVM",19,27,27340,24263,3077,2800,2337,463,0.547105756016113,0.144082332761578,1.34756412873883,1162,463,699,37,1.5,9.29,5,0,0,0,0,0,0,0.165009440336313,3917.61429819772,16.5115224861161
7.5,"eps_greedy_SVM","SVM",19,28,27240,24180,3060,2900,2420,480,0.543440741096485,0.141223556317896,1.25789012302734,1202,480,722,40,1.5,9.62,5,0,0,0,0,0,0,0.165843238992273,3994.38749903697,16.5914323546575
7.5,"eps_greedy_SVM","SVM",19,29,27140,24092,3048,3000,2508,492,0.542659287838919,0.144082332761578,1.32339298038421,1242,492,750,40,1.5,9.95,5.1,0,0,0,0,0,0,0.164068395228837,4060.6313025835,16.4087265893642
7.5,"eps_greedy_SVM","SVM",19,30,27040,23999,3041,3100,2601,499,0.548904905361664,0.148084619782733,1.52326905297704,1278,499,779,36,1.6,10.29,5.2,0,0,0,0,0,0,0.161335537109408,3967.68643037983,16.1400582147414
7.5,"eps_greedy_SVM","SVM",19,31,26940,23907,3033,3200,2693,507,0.545313130225875,0.138364779874214,1.33259119397506,1310,507,803,32,1.6,10.62,5.3,0,0,0,0,0,0,0.158835393359571,3848.77797533903,15.8948032910778
7.5,"eps_greedy_SVM","SVM",19,32,26840,23815,3025,3300,2785,515,0.551768831980599,0.154373927958834,1.53873642081189,1328,515,813,18,1.6,10.95,5.4,0,0,0,0,0,0,0.159187546549268,3884.76728805525,16.4120653768658
7.5,"eps_greedy_SVM","SVM",19,33,26740,23740,3000,3400,2860,540,0.559136286426654,0.148084619782733,1.41126397555226,1381,540,841,53,1.6,11.28,5.3,0,0,0,0,0,0,0.158866262227032,3713.86031346462,15.9099473796815
7.5,"eps_greedy_SVM","SVM",19,34,26640,23654,2986,3500,2946,554,0.558761868686154,0.168667810177244,1.52544854153027,1394,554,840,13,1.5,11.61,5.3,0,0,0,0,0,0,0.159058448105239,3603.36906627248,16.7729101259676
7.5,"eps_greedy_SVM","SVM",19,35,26540,23575,2965,3600,3025,575,0.561735408201604,0.168096054888508,1.59932500147526,1458,575,883,64,1.5,11.94,5.3,0,0,0,0,0,0,0.160253293548539,3699.11932812615,16.0370335597114
7.5,"eps_greedy_SVM","SVM",19,36,26440,23487,2953,3700,3113,587,0.561988839741909,0.157804459691252,1.46100094764977,1507,587,920,49,1.6,12.28,5.3,0,0,0,0,0,0,0.158493475795111,3063.92481494138,15.8656410957392
7.5,"eps_greedy_SVM","SVM",19,37,26340,23400,2940,3800,3200,600,0.56218922447717,0.166952544311035,1.67405981462831,1553,600,953,46,1.6,12.61,5.3,0,0,0,0,0,0,0.157194813447238,3492.64332245182,15.7438598627299
7.5,"eps_greedy_SVM","SVM",19,38,26240,23318,2922,3900,3282,618,0.559715852814518,0.159519725557461,1.40623411790865,1580,618,962,27,1.6,12.94,5.3,0,0,0,0,0,0,0.158654720297373,3870.89809148234,15.8703075240589
7.5,"eps_greedy_SVM","SVM",19,39,26140,23227,2913,4000,3373,627,0.557878055695545,0.157804459691252,1.41483118238494,1609,627,982,29,1.6,13.27,5.4,0,0,0,0,0,0,0.156429175124262,3775.96307236631,15.6512975999049
7.5,"eps_greedy_SVM","SVM",19,40,26040,23148,2892,4100,3452,648,0.55780964420101,0.149799885648942,1.35108563778605,1626,648,978,17,1.5,13.6,5.3,0,0,0,0,0,0,0.158072860005584,3608.91482729671,15.8252562997593
7.5,"eps_greedy_SVM","SVM",19,41,25940,23054,2886,4200,3546,654,0.557981702972401,0.155517438536306,1.47374964701844,1662,654,1008,36,1.5,13.93,5.4,0,0,0,0,0,0,0.1556032310639,3556.29933593862,15.5747661728632
7.5,"eps_greedy_SVM","SVM",19,42,25840,22962,2878,4300,3638,662,0.556562658019171,0.159519725557461,1.42490474477272,1687,662,1025,25,1.5,14.27,5.5,0,0,0,0,0,0,0.153575064975698,3403.13228182279,15.373138988504
7.5,"eps_greedy_SVM","SVM",19,43,25740,22870,2870,4400,3730,670,0.559721217580401,0.161234991423671,1.46638881365793,1744,670,1074,57,1.6,14.6,5.6,0,0,0,0,0,0,0.151887311899503,3164.29493504061,15.2252920736745
7.5,"eps_greedy_SVM","SVM",19,44,25640,22783,2857,4500,3817,683,0.558756589756522,0.150943396226415,1.38287131658125,1736,683,1053,-8,1.5,14.93,5.6,0,0,0,0,0,0,0.151799368316985,3355.03055447884,15.201908982124
7.5,"eps_greedy_SVM","SVM",19,45,25540,22690,2850,4600,3910,690,0.562278279590832,0.161806746712407,1.62369732748249,1743,690,1053,7,1.5,15.26,5.7,0,0,0,0,0,0,0.149152111635842,3466.54481271004,14.9251202234715
7.5,"eps_greedy_SVM","SVM",19,46,25440,22605,2835,4700,3995,705,0.55878568824668,0.164093767867353,1.64491192865776,1804,705,1099,61,1.6,15.59,5.7,0,0,0,0,0,0,0.149635389633404,3455.31156548028,14.9834910914776
7.5,"eps_greedy_SVM","SVM",19,47,25340,22518,2822,4800,4082,718,0.564122042329462,0.161234991423671,1.5960041762995,1828,718,1110,24,1.5,15.93,5.7,0,0,0,0,0,0,0.148918901346776,3432.97092130902,14.9085049808424
7.5,"eps_greedy_SVM","SVM",19,48,25240,22424,2816,4900,4176,724,0.558984055829969,0.158376214979989,1.58239421656339,1884,724,1160,56,1.6,16.26,5.8,0,0,0,0,0,0,0.146953815519807,3095.29025385255,14.7361011358821
7.5,"eps_greedy_SVM","SVM",20,0,30040,26527,3513,100,86,14,0.423616502500718,0.0828603859250851,0.728274235470233,45,14,31,0,2.2,0.33,6.1,0,0,0,0,0,0,0.147353808001996,4234.76323888358,14.7857990884244
7.5,"eps_greedy_SVM","SVM",20,1,29940,26450,3490,200,163,37,0.571163897950306,0.185017026106697,1.90916192546315,106,37,69,61,1.9,0.66,4.4,0,0,0,0,0,0,0.219836862146288,5544.17844820857,22.6836971855207
7.5,"eps_greedy_SVM","SVM",20,2,29840,26389,3451,300,224,76,0.527953270678126,0.129965947786606,1.19685892105268,199,76,123,93,1.6,1,2.9,0,0,0,0,0,0,0.279802932441629,7492.72905570845,28.391111579758
7.5,"eps_greedy_SVM","SVM",20,3,29740,26307,3433,400,306,94,0.435238919427501,0.094211123723042,0.751774125407838,241,94,147,42,1.6,1.33,3.3,0,0,0,0,0,0,0.25998614704477,7028.99614290269,26.2999276687805
7.5,"eps_greedy_SVM","SVM",20,4,29640,26212,3428,500,401,99,0.545088287827898,0.140181611804767,1.31763730795671,263,99,164,22,1.7,1.66,4.1,0,0,0,0,0,0,0.220567241341735,5791.20444510903,22.5721274312819
7.5,"eps_greedy_SVM","SVM",20,5,29540,26131,3409,600,482,118,0.523408498034456,0.141316685584563,1.4054088471581,324,118,206,61,1.7,1.99,4.1,0,0,0,0,0,0,0.201315663289592,5779.51742614549,20.9191836453905
7.5,"eps_greedy_SVM","SVM",20,6,29440,26040,3400,700,573,127,0.518065361452644,0.145856980703746,1.43557957585345,335,127,208,11,1.6,2.32,4.5,0,0,0,0,0,0,0.188249167102499,5289.61043552114,18.8629490299649
7.5,"eps_greedy_SVM","SVM",20,7,29340,25967,3373,800,646,154,0.553585307374375,0.145289443813848,1.20060078752547,377,154,223,42,1.4,2.65,4.2,0,0,0,0,0,0,0.225816983151355,5516.52007548454,23.0775644990392
7.5,"eps_greedy_SVM","SVM",20,8,29240,25881,3359,900,732,168,0.513840539916109,0.127695800227015,1.24453482994913,461,168,293,84,1.7,2.99,4.4,0,0,0,0,0,0,0.188299428632788,5417.15558591774,18.9043861697979
7.5,"eps_greedy_SVM","SVM",20,9,29140,25785,3355,1000,828,172,0.509387748418393,0.118047673098751,0.921598543709437,478,172,306,17,1.8,3.32,4.8,0,0,0,0,0,0,0.174261772674442,4944.06716029696,17.5005587486179
7.5,"eps_greedy_SVM","SVM",20,10,29040,25698,3342,1100,915,185,0.523897443708774,0.110102156640182,0.938597530963406,488,185,303,10,1.6,3.65,4.9,0,0,0,0,0,0,0.170696690196116,4835.30608065131,17.2148923749666
7.5,"eps_greedy_SVM","SVM",20,11,28940,25617,3323,1200,996,204,0.557329029565221,0.124858115777526,1.01608926832017,511,204,307,23,1.5,3.98,4.9,0,0,0,0,0,0,0.217384646553954,4755.93287004281,23.1023542214786
7.5,"eps_greedy_SVM","SVM",20,12,28840,25540,3300,1300,1073,227,0.565569465636872,0.142451759364359,1.31298073194633,572,227,345,61,1.5,4.31,4.7,0,0,0,0,0,0,0.184675196832613,4824.71032839395,19.2963064416214
7.5,"eps_greedy_SVM","SVM",20,13,28740,25460,3280,1400,1153,247,0.546731667245043,0.139046538024972,1.12642868318486,605,247,358,33,1.4,4.64,4.7,0,0,0,0,0,0,0.183905543496734,4926.65884960171,19.3505807826522
7.5,"eps_greedy_SVM","SVM",20,14,28640,25366,3274,1500,1247,253,0.560079210393247,0.161180476730988,1.23257860014176,635,253,382,30,1.5,4.98,4.9,0,0,0,0,0,0,0.170071341873151,4787.88209499289,17.0221336541549
7.5,"eps_greedy_SVM","SVM",20,15,28540,25272,3268,1600,1341,259,0.577319811834798,0.171396140749149,1.37648551071482,659,259,400,24,1.5,5.31,5.2,0,0,0,0,0,0,0.183072171283879,3850.32611199427,18.6734230451172
7.5,"eps_greedy_SVM","SVM",20,16,28440,25184,3256,1700,1429,271,0.56741147656903,0.172531214528944,1.30175638759598,694,271,423,35,1.6,5.64,5.3,0,0,0,0,0,0,0.159803075965671,4487.95878376507,16.0192525843744
7.5,"eps_greedy_SVM","SVM",20,17,28340,25100,3240,1800,1513,287,0.565390492586542,0.161748013620885,1.54094267432866,741,287,454,47,1.6,5.97,5.3,0,0,0,0,0,0,0.160061366828164,4415.03527220127,16.0363336113919
7.5,"eps_greedy_SVM","SVM",20,18,28240,25014,3226,1900,1599,301,0.57184456695899,0.162315550510783,1.43422784904998,772,301,471,31,1.6,6.3,5.3,0,0,0,0,0,0,0.159361137779722,4278.53984547426,15.9942795190908
7.5,"eps_greedy_SVM","SVM",20,19,28140,24930,3210,2000,1683,317,0.573338738202884,0.168558456299659,1.5701076732575,795,317,478,23,1.5,6.64,5.3,0,0,0,0,0,0,0.160282691714425,4352.11652356219,16.2006040600254
7.5,"eps_greedy_SVM","SVM",20,20,28040,24840,3200,2100,1773,327,0.569566359855314,0.169125993189557,1.57542126424143,839,327,512,44,1.6,6.97,5.4,0,0,0,0,0,0,0.155586213677553,4265.38106463113,15.5650785238012
7.5,"eps_greedy_SVM","SVM",20,21,27940,24761,3179,2200,1852,348,0.574606773138508,0.16572077185017,1.49273097166674,888,348,540,49,1.6,7.3,5.3,0,0,0,0,0,0,0.158785133958867,4191.87578842799,15.9219505069413
7.5,"eps_greedy_SVM","SVM",20,22,27840,24701,3139,2300,1912,388,0.575508717143187,0.163450624290579,1.47138401094247,958,388,570,70,1.5,7.63,4.9,0,0,0,0,0,0,0.171582498692892,4295.23906317719,17.2260016546351
7.5,"eps_greedy_SVM","SVM",20,23,27740,24617,3123,2400,1996,404,0.569805502306188,0.164018161180477,1.53059919947428,1000,404,596,42,1.5,7.96,4.9,0,0,0,0,0,0,0.168339174737446,4416.15410904473,16.8878487837601
7.5,"eps_greedy_SVM","SVM",20,24,27640,24534,3106,2500,2079,421,0.576775174284448,0.171963677639047,1.47344504180024,1045,421,624,45,1.5,8.29,4.9,0,0,0,0,0,0,0.168582922382515,4343.47499317506,16.8663723886565
7.5,"eps_greedy_SVM","SVM",20,25,27540,24440,3100,2600,2173,427,0.577723556614544,0.170828603859251,1.42679019382587,1054,427,627,9,1.5,8.63,5.1,0,0,0,0,0,0,0.163914510889978,4444.81164963941,16.3948224318103
7.5,"eps_greedy_SVM","SVM",20,26,27440,24363,3077,2700,2250,450,0.580164148606405,0.16572077185017,1.34127058233078,1103,450,653,49,1.5,8.96,5,0,0,0,0,0,0,0.166540437481187,4489.21163993664,16.6559414156532
7.5,"eps_greedy_SVM","SVM",20,27,27340,24279,3061,2800,2334,466,0.578384737730921,0.173098751418842,1.37885876159537,1155,466,689,52,1.5,9.29,5,0,0,0,0,0,0,0.166138346543765,4428.65475122568,16.6205235538929
7.5,"eps_greedy_SVM","SVM",20,28,27240,24190,3050,2900,2423,477,0.572976357220833,0.160045402951192,1.33576882885653,1166,477,689,11,1.4,9.62,5.1,0,0,0,0,0,0,0.164205367062251,4363.10106148571,16.427242122361
7.5,"eps_greedy_SVM","SVM",20,29,27140,24101,3039,3000,2512,488,0.580719532215534,0.175936435868331,1.39856816596693,1204,488,716,38,1.5,9.95,5.1,0,0,0,0,0,0,0.162676846973671,4369.36115857686,16.2686037154537
7.5,"eps_greedy_SVM","SVM",20,30,27040,24018,3022,3100,2595,505,0.580203039104824,0.170261066969353,1.36442780015692,1254,505,749,50,1.5,10.29,5.1,0,0,0,0,0,0,0.162678467836891,4333.51341055631,16.2697583648753
7.5,"eps_greedy_SVM","SVM",20,31,26940,23933,3007,3200,2680,520,0.584385174907886,0.175936435868331,1.51203040502659,1282,520,762,28,1.5,10.62,5.2,0,0,0,0,0,0,0.162449248775316,4346.97618591508,16.2458593806525
7.5,"eps_greedy_SVM","SVM",20,32,26840,23852,2988,3300,2761,539,0.584042750892121,0.16572077185017,1.41316192074224,1306,539,767,24,1.4,10.95,5.1,0,0,0,0,0,0,0.162655723391875,4165.73954455964,16.2912965568531
7.5,"eps_greedy_SVM","SVM",20,33,26740,23767,2973,3400,2846,554,0.578998073299889,0.169125993189557,1.48850479826643,1365,554,811,59,1.5,11.28,5.1,0,0,0,0,0,0,0.162791688667438,4328.18455378437,16.2803743598064
7.5,"eps_greedy_SVM","SVM",20,34,26640,23679,2961,3500,2934,566,0.581910724302282,0.166855845629966,1.44149294897634,1364,566,798,-1,1.4,11.61,5.2,0,0,0,0,0,0,0.161599484104693,4245.04995500917,16.1619286587458
7.5,"eps_greedy_SVM","SVM",20,35,26540,23599,2941,3600,3014,586,0.586015889327201,0.176503972758229,1.53083386997044,1398,586,812,34,1.4,11.94,5.1,0,0,0,0,0,0,0.162879787654197,4093.58081216984,16.3473293263206
7.5,"eps_greedy_SVM","SVM",20,36,26440,23516,2924,3700,3097,603,0.583216583659049,0.167990919409762,1.4897946637762,1450,603,847,52,1.4,12.28,5.1,0,0,0,0,0,0,0.162790261051157,4147.41146799678,16.2924981405753
7.5,"eps_greedy_SVM","SVM",20,37,26340,23437,2903,3800,3176,624,0.587075570123204,0.171396140749149,1.44909031380697,1469,624,845,19,1.4,12.61,5.1,0,0,0,0,0,0,0.164013252557327,4235.83119863734,16.4283258404766
7.5,"eps_greedy_SVM","SVM",20,38,26240,23356,2884,3900,3257,643,0.589508827503502,0.181044267877412,1.52974761932183,1542,643,899,73,1.4,12.94,5.1,0,0,0,0,0,0,0.164506312395269,4231.66737750074,16.455286031223
7.5,"eps_greedy_SVM","SVM",20,39,26140,23276,2864,4000,3337,663,0.588291537845447,0.182179341657208,1.54373905849649,1550,663,887,8,1.3,13.27,5,0,0,0,0,0,0,0.165398019565178,4237.74486066275,16.5430730790322
7.5,"eps_greedy_SVM","SVM",20,40,26040,23188,2852,4100,3425,675,0.588145101473069,0.182179341657208,1.53052211450251,1601,675,926,51,1.4,13.6,5.1,0,0,0,0,0,0,0.164427373711743,4214.96980382785,16.4464126179453
7.5,"eps_greedy_SVM","SVM",20,41,25940,23103,2837,4200,3510,690,0.588568845862192,0.177071509648127,1.60467294831995,1614,690,924,13,1.3,13.93,5.1,0,0,0,0,0,0,0.163791130630857,4119.4278620175,16.3836703020491
7.5,"eps_greedy_SVM","SVM",20,42,25840,23034,2806,4300,3579,721,0.586784360458974,0.184449489216799,1.60191577830566,1689,721,968,75,1.3,14.27,5,0,0,0,0,0,0,0.182255432059489,4062.16983946801,18.580668112313
7.5,"eps_greedy_SVM","SVM",20,43,25740,22950,2790,4400,3663,737,0.587064141774972,0.175368898978434,1.57132571502763,1721,737,984,32,1.3,14.6,5,0,0,0,0,0,0,0.167210019920718,4189.8668297252,16.7242791294864
7.5,"eps_greedy_SVM","SVM",20,44,25640,22868,2772,4500,3745,755,0.587330277302052,0.171396140749149,1.5223930634597,1755,755,1000,34,1.3,14.93,5,0,0,0,0,0,0,0.16815399816572,4080.579309835,16.8234311753837
7.5,"eps_greedy_SVM","SVM",20,45,25540,22791,2749,4600,3822,778,0.586977704230775,0.17366628830874,1.61074391369877,1804,778,1026,49,1.3,15.26,4.9,0,0,0,0,0,0,0.168856776600769,4199.19718619782,16.8898912127224
7.5,"eps_greedy_SVM","SVM",20,46,25440,22708,2732,4700,3905,795,0.586637924086606,0.164018161180477,1.46248963436509,1857,795,1062,53,1.3,15.59,4.9,0,0,0,0,0,0,0.16881280344528,4198.09769784283,16.885806606624
7.5,"eps_greedy_SVM","SVM",20,47,25340,22624,2716,4800,3989,811,0.585718752273409,0.177639046538025,1.61800228966731,1872,811,1061,15,1.3,15.93,4.9,0,0,0,0,0,0,0.168649625885385,4149.04194717529,17.047288954973
7.5,"eps_greedy_SVM","SVM",20,48,25240,22545,2695,4900,4068,832,0.592455592978195,0.179909194097616,1.63169278259184,1988,832,1156,116,1.4,16.26,4.9,0,0,0,0,0,0,0.169638319584467,4185.7908940168,16.9801483051024
