"Imb.R","Policy","Inducer","Repetition","Iteration","Nu","Nu_majority","Nu_minority","Nl","Nl_majority","Nl_minority","AUC","PRBEP","LIFT","SV_total","SV_minority","SV_majority","SV.diff","SV.R","Data_Efficiency","Imb.R.Empirical","tr.alpha","tr.beta","tr.alpha_minority","tr.beta_minority","tr.alpha_majority","tr.beta_majority","Quantile","Nu_minority.est","Qt_minority.est"
24.3,"random_instances_SVM","SVM",1,0,13233,12713,520,100,94,6,0.942341763584092,0.85171102661597,5.23408148125971,32,6,26,0,4.3,0.75,15.7,0,0,0,0,0,0,0.999999996919012,1004.24022006763,99.9999998935655
24.3,"random_instances_SVM","SVM",1,1,13133,12616,517,200,191,9,0.943515578428901,0.85171102661597,5.21190316989844,33,8,25,1,3.1,1.5,21.2,0,0,0,0,0,0,0.99716968907168,611.041969217137,99.9485555012915
24.3,"random_instances_SVM","SVM",1,2,13033,12527,506,300,280,20,0.941175073563823,0.847908745247148,5.22561870455607,44,12,32,11,2.7,2.25,14,0,0,0,0,0,0,0.996931750971748,547.956907251225,99.9469671148664
24.3,"random_instances_SVM","SVM",1,3,12933,12430,503,400,377,23,0.959389687528933,0.859315589353612,5.33680208124875,57,17,40,13,2.4,3,16.4,0,0,0,0,0,0,0.992133396705377,538.049615766665,99.510382130578
24.3,"random_instances_SVM","SVM",1,4,12833,12333,500,500,474,26,0.958167780118409,0.874524714828897,5.29961182284283,59,17,42,2,2.5,3.75,18.2,0,0,0,0,0,0,0.99474054112617,494.227575849475,99.7383901049681
24.3,"random_instances_SVM","SVM",1,5,12733,12235,498,600,572,28,0.962741323744884,0.878326996197719,5.27205751527173,54,18,36,-5,2,4.5,20.4,0,0,0,0,0,0,0.99539154893743,458.390524839455,99.8371015412238
24.3,"random_instances_SVM","SVM",1,6,12633,12135,498,700,672,28,0.966578635501077,0.88212927756654,5.27662998492938,53,18,35,-1,1.9,5.25,24,0,0,0,0,0,0,0.995233276737604,455.479529357626,99.815207975209
24.3,"random_instances_SVM","SVM",1,7,12533,12042,491,800,765,35,0.978130944775473,0.878326996197719,5.48948347881969,65,23,42,12,1.8,6,21.9,0,0,0,0,0,0,0.996457678595608,485.62409082427,99.8981543299073
24.3,"random_instances_SVM","SVM",1,8,12433,11946,487,900,861,39,0.968911421806237,0.874524714828897,5.40168362732936,67,24,43,2,1.8,6.75,22.1,0,0,0,0,0,0,0.999990247407204,482.897185636057,99.9996504514548
24.3,"random_instances_SVM","SVM",1,9,12333,11849,484,1000,958,42,0.974784058442545,0.874524714828897,5.4432107117031,73,25,48,6,1.9,7.5,22.8,0,0,0,0,0,0,0.9999907962837,474.535696428734,99.999673771464
24.3,"random_instances_SVM","SVM",1,10,12233,11752,481,1100,1055,45,0.974447410482511,0.878326996197719,5.46542789828148,77,26,51,4,2,8.25,23.4,0,0,0,0,0,0,0.996402626338971,457.841344430853,99.9010311599674
24.3,"random_instances_SVM","SVM",1,11,12133,11654,479,1200,1153,47,0.972529645207476,0.874524714828897,5.4432107117031,83,27,56,6,2.1,9,24.5,0,0,0,0,0,0,0.999997282854506,479.469984596055,99.9998888975053
24.3,"random_instances_SVM","SVM",1,12,12033,11557,476,1300,1250,50,0.976369331905199,0.88212927756654,5.51469548395704,80,28,52,-3,1.9,9.75,25,0,0,0,0,0,0,0.999987438374039,458.388208802475,99.9995120615102
24.3,"random_instances_SVM","SVM",1,13,11933,11459,474,1400,1348,52,0.976663230917936,0.893536121673004,5.47022213327997,82,30,52,2,1.7,10.5,25.9,0,0,0,0,0,0,0.99998721028494,466.765951773061,99.9995629902457
24.3,"random_instances_SVM","SVM",1,14,11833,11362,471,1500,1445,55,0.973603712508573,0.893536121673004,5.3893296607886,86,31,55,4,1.8,11.25,26.3,0,0,0,0,0,0,0.999992037999351,453.756258912385,99.9997547876336
24.3,"random_instances_SVM","SVM",1,15,11733,11263,470,1600,1544,56,0.978000619859736,0.889733840304182,5.48283979144054,90,32,58,4,1.8,12,27.6,0,0,0,0,0,0,0.9999959058032,460.281525554484,99.9998767056955
24.3,"random_instances_SVM","SVM",1,16,11633,11165,468,1700,1642,58,0.980857377637078,0.889733840304182,5.5175722566407,97,34,63,7,1.9,12.75,28.3,0,0,0,0,0,0,0.999995798413701,468.018668565179,99.999866744321
24.3,"random_instances_SVM","SVM",1,17,11533,11066,467,1800,1741,59,0.981088340699618,0.889733840304182,5.5564283992931,95,35,60,-2,1.7,13.5,29.5,0,0,0,0,0,0,0.999996222977234,467.846660705619,99.9998727242619
24.3,"random_instances_SVM","SVM",1,18,11433,10970,463,1900,1837,63,0.991495928162791,0.889733840304182,5.83090653681729,110,38,72,15,1.9,14.25,29.2,0,0,0,0,0,0,0.999993463668943,459.674073903865,99.9997637229512
24.3,"random_instances_SVM","SVM",1,19,11333,10870,463,2000,1937,63,0.9914870221321,0.889733840304182,5.8534196894691,109,37,72,-1,1.9,15,30.7,0,0,0,0,0,0,0.999998737887595,466.577657028399,99.9999566568061
24.3,"random_instances_SVM","SVM",1,20,11233,10776,457,2100,2031,69,0.994367826192279,0.893536121673004,5.86551452147885,113,38,75,4,2,15.75,29.4,0,0,0,0,0,0,0.99999963471129,462.176003128411,99.9999872631627
24.3,"random_instances_SVM","SVM",1,21,11133,10681,452,2200,2126,74,0.995480486293024,0.893536121673004,5.88798775719332,115,42,73,2,1.7,16.5,28.7,0,0,0,0,0,0,0.999998798227845,456.603767106476,99.9999581159489
24.3,"random_instances_SVM","SVM",1,22,11033,10585,448,2300,2222,78,0.995692449823419,0.901140684410646,5.86200369824719,115,40,75,0,1.9,17.25,28.5,0,0,0,0,0,0,0.999999961666573,463.51724192109,99.9999988108302
24.3,"random_instances_SVM","SVM",1,23,10933,10486,447,2400,2321,79,0.995835540049824,0.901140684410646,5.87236975253233,117,41,76,2,1.9,18,29.4,0,0,0,0,0,0,0.999999116715644,455.47537001705,99.9999724458909
24.3,"random_instances_SVM","SVM",1,24,10833,10388,445,2500,2419,81,0.995763698068931,0.901140684410646,5.87756653992395,122,40,82,5,2,18.75,29.9,0,0,0,0,0,0,0.999996483885313,446.204075175169,99.9998886377878
24.3,"random_instances_SVM","SVM",1,25,10733,10294,439,2600,2513,87,0.997090102906216,0.897338403041825,5.98473967684022,121,43,78,-1,1.8,19.5,28.9,0,0,0,0,0,0,0.9999996644084,437.365388031925,99.9999909597862
24.3,"random_instances_SVM","SVM",1,26,10633,10198,435,2700,2609,91,0.996954731239744,0.897338403041825,5.93149466192171,127,45,82,6,1.8,20.25,28.7,0,0,0,0,0,0,0.999999374478665,433.571856218099,99.9999810232503
24.3,"random_instances_SVM","SVM",1,27,10533,10101,432,2800,2706,94,0.996518335735981,0.897338403041825,5.90368905787917,126,44,82,-1,1.9,21,28.8,0,0,0,0,0,0,0.999998828217512,427.986017288523,99.9999661475531
24.3,"random_instances_SVM","SVM",1,28,10433,10004,429,2900,2803,97,0.997183319360762,0.897338403041825,5.95267857142857,135,45,90,9,2,21.75,28.9,0,0,0,0,0,0,0.999999422808008,428.970059165987,99.9999809867439
24.3,"random_instances_SVM","SVM",1,29,10333,9909,424,3000,2898,102,0.997408938804883,0.901140684410646,5.93677649154052,133,46,87,-2,1.9,22.5,28.4,0,0,0,0,0,0,0.999999633998791,423.564744754621,99.9999875225998
24.3,"random_instances_SVM","SVM",1,30,10233,9815,418,3100,2992,108,0.998046016866835,0.904942965779468,5.94736842105263,137,50,87,4,1.7,23.25,27.7,0,0,0,0,0,0,0.999999595681041,430.086123813262,99.999986766831
24.3,"random_instances_SVM","SVM",1,31,10133,9720,413,3200,3087,113,0.997934394615533,0.908745247148289,5.94206773618538,142,51,91,5,1.8,24,27.3,0,0,0,0,0,0,0.999999512377545,419.579546840349,99.9999840825102
24.3,"random_instances_SVM","SVM",1,32,10033,9624,409,3300,3183,117,0.997777054740028,0.904942965779468,5.93149466192171,148,52,96,6,1.8,24.75,27.2,0,0,0,0,0,0,0.99999957542104,413.750474631081,99.9999859471221
24.3,"random_instances_SVM","SVM",1,33,9933,9526,407,3400,3281,119,0.997829897188783,0.904942965779468,5.92622222222222,150,55,95,2,1.7,25.5,27.6,0,0,0,0,0,0,0.999999887865737,414.890306414475,99.9999966158811
24.3,"random_instances_SVM","SVM",1,34,9833,9433,400,3500,3374,126,0.997894020609743,0.904942965779468,5.92095914742451,146,55,91,-4,1.7,26.25,26.8,0,0,0,0,0,0,0.999999695295004,403.009994288798,99.9999899289802
24.3,"random_instances_SVM","SVM",1,35,9733,9336,397,3600,3471,129,0.997891051932847,0.904942965779468,5.91570541259982,149,57,92,3,1.6,27,26.9,0,0,0,0,0,0,0.999999670572852,400.19933325949,99.9999895140412
24.3,"random_instances_SVM","SVM",1,36,9633,9241,392,3700,3566,134,0.998067985075868,0.904942965779468,5.91570541259982,150,58,92,1,1.6,27.75,26.6,0,0,0,0,0,0,0.999999691834337,399.294278163851,99.9999905599072
24.3,"random_instances_SVM","SVM",1,37,9533,9146,387,3800,3661,139,0.998187325887101,0.908745247148289,5.9052258635961,155,59,96,5,1.6,28.5,26.3,0,0,0,0,0,0,0.999999835409582,390.660221397616,99.9999948084
24.3,"random_instances_SVM","SVM",1,38,9433,9049,384,3900,3758,142,0.998279948606266,0.908745247148289,5.92622222222222,160,60,100,5,1.7,29.25,26.5,0,0,0,0,0,0,0.999999722354999,389.364689019693,99.9999900734548
24.3,"random_instances_SVM","SVM",1,39,9333,8950,383,4000,3857,143,0.998241355806614,0.908745247148289,5.92622222222222,166,60,106,6,1.8,30,27,0,0,0,0,0,0,0.999999651324867,386.734144728734,99.9999877703862
24.3,"random_instances_SVM","SVM",1,40,9233,8855,378,4100,3952,148,0.998033548423871,0.908745247148289,5.97401433691756,163,58,105,-3,1.8,30.75,26.7,0,0,0,0,0,0,0.999999666992149,382.834797493175,99.9999880239822
24.3,"random_instances_SVM","SVM",1,41,9133,8759,374,4200,4048,152,0.998022267451665,0.908745247148289,5.97401433691756,174,63,111,11,1.8,31.5,26.6,0,0,0,0,0,0,0.999999237588848,373.634075609961,99.9999715191612
24.3,"random_instances_SVM","SVM",1,42,9033,8663,370,4300,4144,156,0.998083422195729,0.908745247148289,5.99011680143756,175,63,112,1,1.8,32.25,26.6,0,0,0,0,0,0,0.999998837737635,368.75927706931,99.9999560871483
24.3,"random_instances_SVM","SVM",1,43,8933,8567,366,4400,4240,160,0.9979611127076,0.91254752851711,5.9780829794006,173,63,110,-2,1.7,33,26.5,0,0,0,0,0,0,0.999999880666596,366.213879369796,99.999995966882
24.3,"random_instances_SVM","SVM",1,44,8833,8467,366,4500,4340,160,0.99802642359932,0.916349809885932,5.97937219730942,176,64,112,3,1.8,33.75,27.1,0,0,0,0,0,0,0.99999976481528,363.010187298154,99.9999922235677
24.3,"random_instances_SVM","SVM",1,45,8733,8370,363,4600,4437,163,0.997803772832093,0.91254752851711,5.94065312174783,179,65,114,3,1.8,34.5,27.2,0,0,0,0,0,0,0.999999402439852,357.257963260965,99.999980657308
24.3,"random_instances_SVM","SVM",1,46,8633,8274,359,4700,4533,167,0.997740243146511,0.916349809885932,5.93004481260185,182,68,114,3,1.7,35.25,27.1,0,0,0,0,0,0,0.999999712274254,355.033970586024,99.9999907981784
24.3,"random_instances_SVM","SVM",1,47,8533,8177,356,4800,4630,170,0.997938550763187,0.916349809885932,5.89844599477271,176,66,110,-6,1.7,36,27.2,0,0,0,0,0,0,0.999999894033735,348.783601815835,99.9999965179592
24.3,"random_instances_SVM","SVM",1,48,8433,8081,352,4900,4726,174,0.997962300178358,0.916349809885932,5.89844599477271,176,66,110,0,1.7,36.75,27.2,0,0,0,0,0,0,0.999999948437365,346.336531336853,99.9999984118037
24.3,"random_instances_SVM","SVM",2,0,13233,12702,531,100,90,10,0.946111342837974,0.782258064516129,5.24323242915091,24,8,16,0,2,0.75,9,0,0,0,0,0,0,0.995984091137334,691.500948752757,99.8669048063219
24.3,"random_instances_SVM","SVM",2,1,13133,12605,528,200,187,13,0.955702325254118,0.862903225806452,5.16461558237714,31,11,20,7,1.8,1.5,14.4,0,0,0,0,0,0,0.986798618313825,511.97484972364,99.1644332161178
24.3,"random_instances_SVM","SVM",2,2,13033,12510,523,300,282,18,0.96741025885852,0.838709677419355,5.34870660788034,40,14,26,9,1.9,2.25,15.7,0,0,0,0,0,0,0.994693800461102,469.093145081087,99.7575112679198
24.3,"random_instances_SVM","SVM",2,3,12933,12414,519,400,378,22,0.96758928885516,0.838709677419355,5.34870660788034,45,15,30,5,2,3,17.2,0,0,0,0,0,0,0.997447468961228,452.052560191647,99.9967639413681
24.3,"random_instances_SVM","SVM",2,4,12833,12315,518,500,477,23,0.972253491399001,0.842741935483871,5.508438788769,54,16,38,9,2.4,3.75,20.7,0,0,0,0,0,0,0.994576046962388,454.432963617425,99.7396536095878
24.3,"random_instances_SVM","SVM",2,5,12733,12221,512,600,571,29,0.973044992436757,0.850806451612903,5.48395847334229,57,21,36,3,1.7,4.5,19.7,0,0,0,0,0,0,0.992770432915222,437.262101573845,99.5992851650635
24.3,"random_instances_SVM","SVM",2,6,12633,12124,509,700,668,32,0.975117343169709,0.875,5.55551946217728,68,22,46,11,2.1,5.25,20.9,0,0,0,0,0,0,0.99571575208243,459.942229588193,99.8291412842974
24.3,"random_instances_SVM","SVM",2,7,12533,12029,504,800,763,37,0.98115410902106,0.879032258064516,5.58394942184275,76,25,51,8,2,6,20.6,0,0,0,0,0,0,0.994779069720509,465.486653640226,99.7029110705202
24.3,"random_instances_SVM","SVM",2,8,12433,11933,500,900,859,41,0.983367799225037,0.911290322580645,5.67452549153119,80,25,55,4,2.2,6.75,21,0,0,0,0,0,0,0.996404914693457,470.573605708888,99.85173654767
24.3,"random_instances_SVM","SVM",2,9,12333,11839,494,1000,953,47,0.985139253928571,0.911290322580645,5.72839836285331,91,29,62,11,2.1,7.5,20.3,0,0,0,0,0,0,0.996099002227134,472.727084319294,99.7934694377507
24.3,"random_instances_SVM","SVM",2,10,12233,11741,492,1100,1051,49,0.984020473493467,0.911290322580645,5.70318534189005,91,31,60,0,1.9,8.25,21.4,0,0,0,0,0,0,0.997439234798666,480.110258116157,99.9864130618571
24.3,"random_instances_SVM","SVM",2,11,12133,11644,489,1200,1148,52,0.984573896044464,0.919354838709677,5.69816934774591,94,30,64,3,2.1,9,22.1,0,0,0,0,0,0,0.997019977093554,467.933040764784,99.9132168372423
24.3,"random_instances_SVM","SVM",2,12,12033,11548,485,1300,1244,56,0.989555955354297,0.923387096774194,5.72531522999067,99,32,67,5,2.1,9.75,22.2,0,0,0,0,0,0,0.999980941505247,481.868498415892,99.9990286602424
24.3,"random_instances_SVM","SVM",2,13,11933,11448,485,1400,1344,56,0.989682846790508,0.919354838709677,5.76746596888584,95,34,61,-4,1.8,10.5,24,0,0,0,0,0,0,0.996933574898701,480.267331100893,99.9089594193271
24.3,"random_instances_SVM","SVM",2,14,11833,11351,482,1500,1441,59,0.989560352582285,0.923387096774194,5.73695027592877,97,35,62,2,1.8,11.25,24.4,0,0,0,0,0,0,0.999981053016332,467.241329511901,99.9991145857589
24.3,"random_instances_SVM","SVM",2,15,11733,11257,476,1600,1535,65,0.989089221012196,0.923387096774194,5.75216765066598,97,35,62,0,1.8,12,23.6,0,0,0,0,0,0,0.999986205516457,463.866490371789,99.9993555186911
24.3,"random_instances_SVM","SVM",2,16,11633,11164,469,1700,1628,72,0.992677987225405,0.923387096774194,5.76233666356222,100,36,64,3,1.8,12.75,22.6,0,0,0,0,0,0,0.99999472397526,454.852597373395,99.9997717166088
24.3,"random_instances_SVM","SVM",2,17,11533,11069,464,1800,1723,77,0.994752222484646,0.92741935483871,5.83896348089682,113,40,73,13,1.8,13.5,22.4,0,0,0,0,0,0,0.999990174900621,466.660956745924,99.9995480263218
24.3,"random_instances_SVM","SVM",2,18,11433,10972,461,1900,1820,80,0.994654227118067,0.923387096774194,5.86279598490048,118,41,77,5,1.9,14.25,22.8,0,0,0,0,0,0,0.999990757687305,470.638400638854,99.9995810029563
24.3,"random_instances_SVM","SVM",2,19,11333,10881,452,2000,1911,89,0.994695686696235,0.923387096774194,5.90994984000692,129,46,83,11,1.8,15,21.5,0,0,0,0,0,0,0.997352909343592,451.968725845278,99.9810155281963
24.3,"random_instances_SVM","SVM",2,20,11233,10784,449,2100,2008,92,0.994983391041701,0.923387096774194,5.93115145378273,130,47,83,1,1.8,15.75,21.8,0,0,0,0,0,0,0.999989561214251,447.545661564778,99.9995690978269
24.3,"random_instances_SVM","SVM",2,21,11133,10693,440,2200,2099,101,0.996164360844057,0.923387096774194,5.92583680194242,135,48,87,5,1.8,16.5,20.8,0,0,0,0,0,0,0.999981044343932,448.178311610325,99.9992095789738
24.3,"random_instances_SVM","SVM",2,22,11033,10599,434,2300,2193,107,0.997675122745473,0.923387096774194,5.96060766201425,137,51,86,2,1.7,17.25,20.5,0,0,0,0,0,0,0.999984439361796,447.355535801806,99.9993368421901
24.3,"random_instances_SVM","SVM",2,23,10933,10503,430,2400,2289,111,0.997759298252662,0.923387096774194,5.96060766201425,140,51,89,3,1.7,18,20.6,0,0,0,0,0,0,0.999992115030138,447.91280514527,99.9996693006652
24.3,"random_instances_SVM","SVM",2,24,10833,10406,427,2500,2386,114,0.997633034991877,0.923387096774194,5.96060766201425,143,51,92,3,1.8,18.75,20.9,0,0,0,0,0,0,0.999995942096438,442.789702108459,99.9998216447535
24.3,"random_instances_SVM","SVM",2,25,10733,10311,422,2600,2481,119,0.997945866354417,0.923387096774194,5.96596310465757,149,53,96,6,1.8,19.5,20.8,0,0,0,0,0,0,0.999997336183163,437.685553213484,99.9998874688567
24.3,"random_instances_SVM","SVM",2,26,10633,10214,419,2700,2578,122,0.998040092668434,0.92741935483871,5.97132817939197,148,53,95,-1,1.8,20.25,21.1,0,0,0,0,0,0,0.999999665576394,439.520469174025,99.9999857870115
24.3,"random_instances_SVM","SVM",2,27,10533,10115,418,2800,2677,123,0.998172009508059,0.92741935483871,5.96596310465757,156,55,101,8,1.8,21,21.8,0,0,0,0,0,0,0.99999835256399,434.223515544293,99.9999296625116
24.3,"random_instances_SVM","SVM",2,28,10433,10019,414,2900,2773,127,0.998398780837129,0.92741935483871,5.95526182554607,157,56,101,1,1.8,21.75,21.8,0,0,0,0,0,0,0.999997555382873,424.234987249885,99.9998862697615
24.3,"random_instances_SVM","SVM",2,29,10333,9921,412,3000,2871,129,0.998352924030973,0.92741935483871,5.95526182554607,158,56,102,1,1.8,22.5,22.3,0,0,0,0,0,0,0.999999397175738,422.855033147853,99.9999738510207
24.3,"random_instances_SVM","SVM",2,30,10233,9825,408,3100,2967,133,0.998347270452132,0.92741935483871,5.95526182554607,160,58,102,2,1.8,23.25,22.3,0,0,0,0,0,0,0.999997916746413,417.526364865089,99.9999136708984
24.3,"random_instances_SVM","SVM",2,31,10133,9731,402,3200,3061,139,0.998587233465164,0.92741935483871,5.95526182554607,166,62,104,6,1.7,24,22,0,0,0,0,0,0,0.999999858852176,415.412033771652,99.999994665962
24.3,"random_instances_SVM","SVM",2,32,10033,9635,398,3300,3157,143,0.998506827010535,0.92741935483871,5.95526182554607,169,62,107,3,1.7,24.75,22.1,0,0,0,0,0,0,0.999999646332495,412.577857230556,99.9999867554117
24.3,"random_instances_SVM","SVM",2,33,9933,9537,396,3400,3255,145,0.998542004834436,0.92741935483871,5.95526182554607,165,61,104,-4,1.7,25.5,22.4,0,0,0,0,0,0,0.999999831861088,413.927766565017,99.9999938175419
24.3,"random_instances_SVM","SVM",2,34,9833,9440,393,3500,3352,148,0.998596027921139,0.92741935483871,5.96596310465757,171,63,108,6,1.7,26.25,22.6,0,0,0,0,0,0,0.999999090138997,403.371089128924,99.9999643068368
24.3,"random_instances_SVM","SVM",2,35,9733,9346,387,3600,3446,154,0.998619898587357,0.92741935483871,5.97132817939197,176,64,112,5,1.8,27,22.4,0,0,0,0,0,0,0.999999484741528,392.935454723199,99.9999801791486
24.3,"random_instances_SVM","SVM",2,36,9633,9250,383,3700,3542,158,0.99892016644136,0.92741935483871,5.9955035971223,178,67,111,2,1.7,27.75,22.4,0,0,0,0,0,0,0.999999660856315,391.49372952995,99.9999865677905
24.3,"random_instances_SVM","SVM",2,37,9533,9153,380,3800,3639,161,0.998830965530757,0.92741935483871,5.9955035971223,178,66,112,0,1.7,28.5,22.6,0,0,0,0,0,0,0.999998955902842,388.506907086389,99.9999568363938
24.3,"random_instances_SVM","SVM",2,38,9433,9058,375,3900,3734,166,0.999238023207313,0.935483870967742,5.98473967684022,182,70,112,4,1.6,29.25,22.5,0,0,0,0,0,0,0.999999963024609,387.350445876896,99.9999985747109
24.3,"random_instances_SVM","SVM",2,39,9333,8963,370,4000,3829,171,0.999211639839388,0.935483870967742,5.98473967684022,185,71,114,3,1.6,30,22.4,0,0,0,0,0,0,0.99999982540822,377.164755464358,99.9999923881821
24.3,"random_instances_SVM","SVM",2,40,9233,8864,369,4100,3928,172,0.999236766856459,0.931451612903226,5.98473967684022,182,69,113,-3,1.6,30.75,22.8,0,0,0,0,0,0,0.999999933505216,375.216433905015,99.999997321982
24.3,"random_instances_SVM","SVM",2,41,9133,8766,367,4200,4026,174,0.999258752996397,0.931451612903226,5.9955035971223,186,70,116,4,1.7,31.5,23.1,0,0,0,0,0,0,0.999999845383198,375.11630015104,99.9999939272778
24.3,"random_instances_SVM","SVM",2,42,9033,8667,366,4300,4125,175,0.999239279558166,0.931451612903226,5.99011680143756,188,70,118,2,1.7,32.25,23.6,0,0,0,0,0,0,0.999999990270103,371.344127687767,99.9999996387773
24.3,"random_instances_SVM","SVM",2,43,8933,8571,362,4400,4221,179,0.999251214891275,0.931451612903226,5.99011680143756,187,71,116,-1,1.6,33,23.6,0,0,0,0,0,0,0.999999551845918,368.061551590104,99.9999826535808
24.3,"random_instances_SVM","SVM",2,44,8833,8477,356,4500,4315,185,0.999192166401158,0.92741935483871,5.99011680143756,190,72,118,3,1.6,33.75,23.3,0,0,0,0,0,0,0.99999949251628,357.232921226285,99.9999795477777
24.3,"random_instances_SVM","SVM",2,45,8733,8383,350,4600,4409,191,0.999177718366342,0.92741935483871,5.99011680143756,190,74,116,0,1.6,34.5,23.1,0,0,0,0,0,0,0.99999986028683,352.345671118586,99.9999946806596
24.3,"random_instances_SVM","SVM",2,46,8633,8286,347,4700,4506,194,0.99916829573494,0.92741935483871,5.99011680143756,194,71,123,4,1.7,35.25,23.2,0,0,0,0,0,0,0.999999774904383,350.045073584896,99.9999916361328
24.3,"random_instances_SVM","SVM",2,47,8533,8188,345,4800,4604,196,0.99926000934725,0.92741935483871,5.99011680143756,192,72,120,-2,1.7,36,23.5,0,0,0,0,0,0,0.999999672242265,341.451995592398,99.9999869055396
24.3,"random_instances_SVM","SVM",2,48,8433,8095,338,4900,4697,203,0.999227972400485,0.931451612903226,5.98473967684022,190,73,117,-2,1.6,36.75,23.1,0,0,0,0,0,0,0.999999525118185,332.675350069271,99.9999815261454
24.3,"random_instances_SVM","SVM",3,0,13233,12728,505,100,95,5,0.959547808054075,0.842293906810036,5.31253178058067,30,5,25,0,5,0.75,19,0,0,0,0,0,0,0.999993137490236,743.087079222836,99.9998100023469
24.3,"random_instances_SVM","SVM",3,1,13133,12631,502,200,192,8,0.949600280992793,0.878136200716846,5.35491807702442,35,8,27,5,3.4,1.5,24,0,0,0,0,0,0,0.994269326233542,511.843989760256,99.7487199805188
24.3,"random_instances_SVM","SVM",3,2,13033,12533,500,300,290,10,0.956454250016269,0.881720430107527,5.16893257649176,32,9,23,-3,2.6,2.25,29,0,0,0,0,0,0,0.999989072257469,484.913705075686,99.9996289711522
24.3,"random_instances_SVM","SVM",3,3,12933,12436,497,400,387,13,0.961563235726496,0.881720430107527,5.21443175799677,34,11,23,2,2.1,3,29.8,0,0,0,0,0,0,0.990412377814362,417.052387580522,99.4530540009554
24.3,"random_instances_SVM","SVM",3,4,12833,12345,488,500,478,22,0.975171019586433,0.888888888888889,5.53227384017366,55,16,39,21,2.4,3.75,21.7,0,0,0,0,0,0,0.992928325268556,461.387928715979,99.5891442561635
24.3,"random_instances_SVM","SVM",3,5,12733,12252,481,600,571,29,0.978729158390617,0.89247311827957,5.56310329787032,79,22,57,24,2.6,4.5,19.7,0,0,0,0,0,0,0.990534993450119,493.752632348647,99.399730743902
24.3,"random_instances_SVM","SVM",3,6,12633,12156,477,700,667,33,0.983309879859857,0.89247311827957,5.59898779587322,84,24,60,5,2.5,5.25,20.2,0,0,0,0,0,0,0.999994323513228,537.487146865838,99.9997520149218
24.3,"random_instances_SVM","SVM",3,7,12533,12061,472,800,762,38,0.985118266103778,0.89247311827957,5.68350081920716,92,26,66,8,2.5,6,20.1,0,0,0,0,0,0,0.999981215157936,528.633766096427,99.9992063415699
24.3,"random_instances_SVM","SVM",3,8,12433,11963,470,900,860,40,0.984889903335774,0.89247311827957,5.66456144325809,98,26,72,6,2.8,6.75,21.5,0,0,0,0,0,0,0.99998189505402,504.878914746656,99.999242076982
24.3,"random_instances_SVM","SVM",3,9,12333,11867,466,1000,956,44,0.991299210212695,0.89247311827957,5.74180883265575,101,26,75,3,2.9,7.5,21.7,0,0,0,0,0,0,0.999981395317334,510.629117093732,99.9992034229966
24.3,"random_instances_SVM","SVM",3,10,12233,11772,461,1100,1051,49,0.991504568377536,0.89247311827957,5.73168218568457,104,28,76,3,2.7,8.25,21.4,0,0,0,0,0,0,0.997204194740448,508.14794616704,99.9618044751432
24.3,"random_instances_SVM","SVM",3,11,12133,11674,459,1200,1149,51,0.992755794354557,0.89247311827957,5.75275454666136,114,33,81,10,2.5,9,22.5,0,0,0,0,0,0,0.991949051241248,477.220217920064,99.5041023269452
24.3,"random_instances_SVM","SVM",3,12,12033,11575,458,1300,1248,52,0.993763508190761,0.888888888888889,5.77892295963076,106,32,74,-8,2.3,9.75,24,0,0,0,0,0,0,0.999997052924094,482.342048460681,99.9998904052904
24.3,"random_instances_SVM","SVM",3,13,11933,11481,452,1400,1342,58,0.992655920711547,0.899641577060932,5.73253396828996,119,34,85,13,2.5,10.5,23.1,0,0,0,0,0,0,0.996467631075688,476.083967519404,99.8920327830335
24.3,"random_instances_SVM","SVM",3,14,11833,11384,449,1500,1439,61,0.993302855039576,0.899641577060932,5.79426523297491,121,35,86,2,2.5,11.25,23.6,0,0,0,0,0,0,0.999984555061098,479.914594914948,99.9993876865215
24.3,"random_instances_SVM","SVM",3,15,11733,11284,449,1600,1539,61,0.993369624497544,0.899641577060932,5.77382690763814,123,35,88,2,2.5,12,25.2,0,0,0,0,0,0,0.999989344088568,471.560210307321,99.9995888282066
24.3,"random_instances_SVM","SVM",3,16,11633,11188,445,1700,1635,65,0.993568249607798,0.899641577060932,5.79426523297491,119,36,83,-4,2.3,12.75,25.2,0,0,0,0,0,0,0.999987604035559,456.256024956086,99.9994908133181
24.3,"random_instances_SVM","SVM",3,17,11533,11092,441,1800,1731,69,0.991812044536908,0.899641577060932,5.77823175900264,120,38,82,1,2.2,13.5,25.1,0,0,0,0,0,0,0.999995355727169,456.05561648221,99.9998166336451
24.3,"random_instances_SVM","SVM",3,18,11433,11000,433,1900,1823,77,0.991910796004154,0.899641577060932,5.77823175900264,127,42,85,7,2,14.25,23.7,0,0,0,0,0,0,0.999994038304316,443.965903296278,99.9997600197076
24.3,"random_instances_SVM","SVM",3,19,11333,10902,431,2000,1921,79,0.993437516131272,0.899641577060932,5.78335430488828,130,44,86,3,2,15,24.3,0,0,0,0,0,0,0.999995007859209,445.247316074472,99.9997957141688
24.3,"random_instances_SVM","SVM",3,20,11233,10805,428,2100,2018,82,0.993278728260645,0.903225806451613,5.80453875289153,134,47,87,4,1.9,15.75,24.6,0,0,0,0,0,0,0.999996558695617,443.138067589185,99.9998659301261
24.3,"random_instances_SVM","SVM",3,21,11133,10710,423,2200,2113,87,0.993012772604542,0.906810035842294,5.77823175900264,143,51,92,9,1.8,16.5,24.3,0,0,0,0,0,0,0.999999133573617,440.213888061605,99.9999686708754
24.3,"random_instances_SVM","SVM",3,22,11033,10613,420,2300,2210,90,0.992225566305996,0.903225806451613,5.8718484751701,149,51,98,6,1.9,17.25,24.6,0,0,0,0,0,0,0.999985015699926,436.32560786136,99.9994191538815
24.3,"random_instances_SVM","SVM",3,23,10933,10516,417,2400,2307,93,0.992191339945189,0.906810035842294,5.85603559776838,151,54,97,2,1.8,18,24.8,0,0,0,0,0,0,0.99999390821879,427.971387052459,99.999756689982
24.3,"random_instances_SVM","SVM",3,24,10833,10422,411,2500,2401,99,0.995240291496377,0.906810035842294,5.88276703797093,156,53,103,5,1.9,18.75,24.3,0,0,0,0,0,0,0.999994078971263,426.424555294124,99.9997599495521
24.3,"random_instances_SVM","SVM",3,25,10733,10325,408,2600,2498,102,0.995256001957075,0.906810035842294,5.89893695745899,152,51,101,-4,2,19.5,24.5,0,0,0,0,0,0,0.99999881126007,421.208469813555,99.9999568943168
24.3,"random_instances_SVM","SVM",3,26,10633,10230,403,2700,2593,107,0.996540893207021,0.906810035842294,5.9578828850627,165,54,111,13,2.1,20.25,24.2,0,0,0,0,0,0,0.99999835224406,421.24551150349,99.9999363698077
24.3,"random_instances_SVM","SVM",3,27,10533,10132,401,2800,2691,109,0.996592513292172,0.906810035842294,5.9578828850627,165,55,110,0,2,21,24.7,0,0,0,0,0,0,0.99999871221964,417.882106308621,99.9999509709536
24.3,"random_instances_SVM","SVM",3,28,10433,10033,400,2900,2790,110,0.99662449530145,0.906810035842294,5.96325034712132,165,55,110,0,2,21.75,25.4,0,0,0,0,0,0,0.99999771707836,412.955153031945,99.999913181913
24.3,"random_instances_SVM","SVM",3,29,10333,9937,396,3000,2886,114,0.996672187771426,0.906810035842294,5.9578828850627,165,55,110,0,2,22.5,25.3,0,0,0,0,0,0,0.999997801161901,407.934483105127,99.9999137995445
24.3,"random_instances_SVM","SVM",3,30,10233,9839,394,3100,2984,116,0.996775427941728,0.906810035842294,5.94717689605091,167,56,111,2,2,23.25,25.7,0,0,0,0,0,0,0.999998872110408,402.415085466813,99.9999562609348
24.3,"random_instances_SVM","SVM",3,31,10133,9743,390,3200,3080,120,0.997686634662214,0.906810035842294,5.99011680143756,174,58,116,7,2,24,25.7,0,0,0,0,0,0,0.999999545436,399.456354158195,99.9999831878802
24.3,"random_instances_SVM","SVM",3,32,10033,9646,387,3300,3177,123,0.998166364801386,0.906810035842294,5.98473967684022,175,59,116,1,2,24.75,25.8,0,0,0,0,0,0,0.999999236947756,396.903938306236,99.9999724511106
24.3,"random_instances_SVM","SVM",3,33,9933,9549,384,3400,3274,126,0.99818095308632,0.910394265232975,5.98473967684022,177,61,116,2,1.9,25.5,26,0,0,0,0,0,0,0.999999349288436,396.402541679871,99.9999778113486
24.3,"random_instances_SVM","SVM",3,34,9833,9451,382,3500,3372,128,0.998237622962409,0.910394265232975,5.97401433691756,178,63,115,1,1.8,26.25,26.3,0,0,0,0,0,0,0.999999660367872,390.425149217446,99.9999884527178
24.3,"random_instances_SVM","SVM",3,35,9733,9353,380,3600,3470,130,0.998237622962409,0.910394265232975,5.99011680143756,185,64,121,7,1.9,27,26.7,0,0,0,0,0,0,0.999997356260699,389.296040482994,99.9999050607666
24.3,"random_instances_SVM","SVM",3,36,9633,9257,376,3700,3566,134,0.998304392420376,0.913978494623656,5.97401433691756,181,65,116,-4,1.8,27.75,26.6,0,0,0,0,0,0,0.999999913908015,388.589414498528,99.999997223229
24.3,"random_instances_SVM","SVM",3,37,9533,9158,375,3800,3665,135,0.998371722966225,0.913978494623656,5.97401433691756,182,65,117,1,1.8,28.5,27.1,0,0,0,0,0,0,0.999999972725743,389.622348073772,99.9999991243886
24.3,"random_instances_SVM","SVM",3,38,9433,9061,372,3900,3762,138,0.998362745560112,0.913978494623656,5.97401433691756,183,65,118,1,1.8,29.25,27.3,0,0,0,0,0,0,0.999999961358484,383.546290245001,99.9999988055122
24.3,"random_instances_SVM","SVM",3,39,9333,8965,368,4000,3858,142,0.998444664390894,0.913978494623656,5.97401433691756,182,65,117,-1,1.8,30,27.2,0,0,0,0,0,0,0.999999857228779,380.683080136618,99.9999952619576
24.3,"random_instances_SVM","SVM",3,40,9233,8868,365,4100,3955,145,0.998458130500064,0.913978494623656,5.9686660698299,187,66,121,5,1.8,30.75,27.3,0,0,0,0,0,0,0.999999748328789,376.305335743078,99.9999920473308
24.3,"random_instances_SVM","SVM",3,41,9133,8773,360,4200,4050,150,0.99867639368619,0.917562724014337,5.95267857142857,190,71,119,3,1.7,31.5,27,0,0,0,0,0,0,0.999999936942917,374.447357387359,99.9999980023077
24.3,"random_instances_SVM","SVM",3,42,9033,8674,359,4300,4149,151,0.998696592849945,0.921146953405018,5.96332737030411,194,73,121,4,1.7,32.25,27.5,0,0,0,0,0,0,0.99999996246144,374.413961452115,99.9999987622587
24.3,"random_instances_SVM","SVM",3,43,8933,8578,355,4400,4245,155,0.998564176109776,0.921146953405018,5.96332737030411,195,71,124,1,1.7,33,27.4,0,0,0,0,0,0,0.999999968904478,371.569900527004,99.9999989743436
24.3,"random_instances_SVM","SVM",3,44,8833,8483,350,4500,4340,160,0.99868705435595,0.924731182795699,5.96332737030411,195,71,124,0,1.7,33.75,27.1,0,0,0,0,0,0,0.999999935712004,362.391368698354,99.9999978258868
24.3,"random_instances_SVM","SVM",3,45,8733,8383,350,4600,4440,160,0.998719036365228,0.92831541218638,5.96332737030411,195,72,123,0,1.7,34.5,27.8,0,0,0,0,0,0,0.999999998133832,361.838453127199,99.9999999430811
24.3,"random_instances_SVM","SVM",3,46,8633,8286,347,4700,4537,163,0.998675271510426,0.924731182795699,5.96332737030411,198,73,125,3,1.7,35.25,27.8,0,0,0,0,0,0,0.999999932173545,357.637967829507,99.9999976049109
24.3,"random_instances_SVM","SVM",3,47,8533,8190,343,4800,4633,167,0.998518727991328,0.92831541218638,5.96332737030411,200,75,125,2,1.7,36,27.7,0,0,0,0,0,0,0.999999970697218,357.162623652533,99.9999989936047
24.3,"random_instances_SVM","SVM",3,48,8433,8093,340,4900,4730,170,0.998778511680728,0.921146953405018,5.92095914742451,205,78,127,5,1.6,36.75,27.8,0,0,0,0,0,0,0.99999998938705,352.605088255905,99.9999996262687
24.3,"random_instances_SVM","SVM",4,0,13233,12728,505,100,94,6,0.971594613493727,0.852517985611511,5.47142111485637,35,6,29,0,4.8,0.75,15.7,0,0,0,0,0,0,0.875501141926619,1022.68582891835,94.3625055975028
24.3,"random_instances_SVM","SVM",4,1,13133,12631,502,200,191,9,0.991067155666604,0.87410071942446,5.72704821217653,46,9,37,11,4.1,1.5,21.2,0,0,0,0,0,0,0.988671630466538,641.822127688186,99.4244340684792
24.3,"random_instances_SVM","SVM",4,2,13033,12533,500,300,289,11,0.988633228649512,0.881294964028777,5.64036923771088,49,11,38,3,3.5,2.25,26.3,0,0,0,0,0,0,0.999980894045486,573.463181099996,99.9994504746704
24.3,"random_instances_SVM","SVM",4,3,12933,12436,497,400,386,14,0.976908377821143,0.881294964028777,5.32253890764939,59,14,45,10,3.2,3,27.6,0,0,0,0,0,0,0.996331078097981,564.807124449645,99.9401070593895
24.3,"random_instances_SVM","SVM",4,4,12833,12340,493,500,482,18,0.97830297352352,0.87410071942446,5.42598253003815,64,17,47,5,2.8,3.75,26.8,0,0,0,0,0,0,0.999989098583281,525.068442408545,99.9995721698958
24.3,"random_instances_SVM","SVM",4,5,12733,12246,487,600,576,24,0.978694271066171,0.884892086330935,5.50200330103693,75,21,54,11,2.6,4.5,24,0,0,0,0,0,0,0.999996945371766,556.286282044181,99.9998695137443
24.3,"random_instances_SVM","SVM",4,6,12633,12152,481,700,670,30,0.989195120660409,0.888489208633094,5.67338815256287,83,24,59,8,2.5,5.25,22.3,0,0,0,0,0,0,0.999993130689817,567.126601575076,99.9997021229016
24.3,"random_instances_SVM","SVM",4,7,12533,12056,477,800,766,34,0.994614169362587,0.888489208633094,5.83689239084923,96,27,69,13,2.6,6,22.5,0,0,0,0,0,0,0.999996427409112,565.701824113802,99.9998442742903
24.3,"random_instances_SVM","SVM",4,8,12433,11961,472,900,861,39,0.995287538946775,0.888489208633094,5.85755395683453,97,31,66,1,2.1,6.75,22.1,0,0,0,0,0,0,0.999990460293508,542.070061246076,99.9996379907521
24.3,"random_instances_SVM","SVM",4,9,12333,11867,466,1000,955,45,0.996639908295622,0.888489208633094,5.91570541259982,104,34,70,7,2.1,7.5,21.2,0,0,0,0,0,0,0.999999756780532,548.93739272354,99.999991036438
24.3,"random_instances_SVM","SVM",4,10,12233,11770,463,1100,1052,48,0.996389928282762,0.888489208633094,5.9052258635961,108,36,72,4,2,8.25,21.9,0,0,0,0,0,0,0.999992593135389,523.143953298575,99.9996982450213
24.3,"random_instances_SVM","SVM",4,11,12133,11677,456,1200,1145,55,0.996172603316627,0.888489208633094,5.86321093169595,105,35,70,-3,2,9,20.8,0,0,0,0,0,0,0.999999602403269,517.834791983493,99.9999847679912
24.3,"random_instances_SVM","SVM",4,12,12033,11584,449,1300,1238,62,0.997253034948783,0.892086330935252,5.87918871252205,124,40,84,19,2.1,9.75,20,0,0,0,0,0,0,0.999999972892838,517.450610910517,99.999998999365
24.3,"random_instances_SVM","SVM",4,13,11933,11486,447,1400,1336,64,0.997262043237535,0.892086330935252,5.86839044665328,126,42,84,2,2,10.5,20.9,0,0,0,0,0,0,0.999999656980173,512.41325966498,99.9999863354599
24.3,"random_instances_SVM","SVM",4,14,11833,11390,443,1500,1432,68,0.997039651108977,0.888489208633094,5.87357912078825,126,42,84,0,2,11.25,21.1,0,0,0,0,0,0,0.999999886811601,522.493115024896,99.9999956429171
24.3,"random_instances_SVM","SVM",4,15,11733,11292,441,1600,1530,70,0.997138742285245,0.89568345323741,5.86839044665328,129,45,84,3,1.9,12,21.9,0,0,0,0,0,0,0.999998377615457,505.904156972199,99.9999299790333
24.3,"random_instances_SVM","SVM",4,16,11633,11196,437,1700,1626,74,0.997724844072153,0.899280575539568,5.84824561403509,133,46,87,4,1.9,12.75,22,0,0,0,0,0,0,0.999999906236765,493.817803026502,99.9999962721075
24.3,"random_instances_SVM","SVM",4,17,11533,11103,430,1800,1719,81,0.997802540562636,0.902877697841727,5.88437775816417,136,49,87,3,1.8,13.5,21.2,0,0,0,0,0,0,0.999999960015372,478.692040855268,99.9999984557104
24.3,"random_instances_SVM","SVM",4,18,11433,11007,426,1900,1815,85,0.997830128446938,0.899280575539568,5.86883802816901,141,50,91,5,1.8,14.25,21.4,0,0,0,0,0,0,0.9999999180499,469.662584287439,99.99999708665
24.3,"random_instances_SVM","SVM",4,19,11333,10910,423,2000,1912,88,0.997839699753737,0.899280575539568,5.92095914742451,141,52,89,0,1.7,15,21.7,0,0,0,0,0,0,0.999999760145626,461.062872055577,99.9999909726388
24.3,"random_instances_SVM","SVM",4,20,11233,10816,417,2100,2006,94,0.997818868085998,0.899280575539568,5.9,144,54,90,3,1.7,15.75,21.3,0,0,0,0,0,0,0.999999369594617,452.205924256126,99.9999758791499
24.3,"random_instances_SVM","SVM",4,21,11133,10722,411,2200,2100,100,0.997729348216528,0.899280575539568,5.88957597173145,153,57,96,9,1.7,16.5,21,0,0,0,0,0,0,0.999999349152258,457.31688290007,99.9999745680244
24.3,"random_instances_SVM","SVM",4,22,11033,10627,406,2300,2195,105,0.997786213039273,0.906474820143885,5.92622222222222,156,58,98,3,1.7,17.25,20.9,0,0,0,0,0,0,0.999999531138208,452.604050242931,99.99998205816
24.3,"random_instances_SVM","SVM",4,23,10933,10530,403,2400,2292,108,0.997815489977716,0.899280575539568,5.9104609929078,158,58,100,2,1.7,18,21.2,0,0,0,0,0,0,0.999999933198709,443.532409295469,99.9999975693149
24.3,"random_instances_SVM","SVM",4,24,10833,10434,399,2500,2388,112,0.997875169890696,0.906474820143885,5.88957597173145,160,59,101,2,1.7,18.75,21.3,0,0,0,0,0,0,0.999999902352546,432.554078189147,99.9999965624876
24.3,"random_instances_SVM","SVM",4,25,10733,10336,397,2600,2486,114,0.997622937805649,0.910071942446043,5.87400881057269,156,58,98,-4,1.7,19.5,21.8,0,0,0,0,0,0,0.999999987164299,427.766274343695,99.9999995523837
24.3,"random_instances_SVM","SVM",4,26,10633,10238,395,2700,2584,116,0.997296387338399,0.910071942446043,5.86883802816901,157,58,99,1,1.7,20.25,22.3,0,0,0,0,0,0,0.999999965624394,422.215440659126,99.9999987127468
24.3,"random_instances_SVM","SVM",4,27,10533,10140,393,2800,2682,118,0.998000722915173,0.910071942446043,5.87400881057269,157,59,98,0,1.7,21,22.7,0,0,0,0,0,0,0.999999981617474,419.895130382515,99.9999993797137
24.3,"random_instances_SVM","SVM",4,28,10433,10044,389,2900,2778,122,0.997995092734702,0.913669064748201,5.87918871252205,161,61,100,4,1.6,21.75,22.8,0,0,0,0,0,0,0.999999984029377,415.63885231102,99.9999994404521
24.3,"random_instances_SVM","SVM",4,29,10333,9949,384,3000,2873,127,0.998820477191576,0.910071942446043,5.87918871252205,163,62,101,2,1.6,22.5,22.6,0,0,0,0,0,0,0.999999999488717,419.232335906608,99.9999999837645
24.3,"random_instances_SVM","SVM",4,30,10233,9856,377,3100,2966,134,0.998886350303073,0.913669064748201,5.87400881057269,163,63,100,0,1.6,23.25,22.1,0,0,0,0,0,0,0.999999994624569,409.768337225095,99.9999998118426
24.3,"random_instances_SVM","SVM",4,31,10133,9759,374,3200,3063,137,0.998934206837066,0.913669064748201,5.9052258635961,166,65,101,3,1.6,24,22.4,0,0,0,0,0,0,0.999999999935986,405.746451470633,99.9999999980635
24.3,"random_instances_SVM","SVM",4,32,10033,9665,368,3300,3157,143,0.998858199400724,0.91726618705036,5.9,169,67,102,3,1.5,24.75,22.1,0,0,0,0,0,0,0.999999997834966,394.067362640377,99.9999999342378
24.3,"random_instances_SVM","SVM",4,33,9933,9572,361,3400,3250,150,0.998842434895408,0.913669064748201,5.894783377542,181,70,111,12,1.6,25.5,21.7,0,0,0,0,0,0,0.999999997994333,395.17801080886,99.99999993181
24.3,"random_instances_SVM","SVM",4,34,9833,9476,357,3500,3346,154,0.998782191964381,0.910071942446043,5.92622222222222,185,71,114,4,1.6,26.25,21.7,0,0,0,0,0,0,0.999999998201022,393.763469549238,99.9999999430581
24.3,"random_instances_SVM","SVM",4,35,9733,9384,349,3600,3438,162,0.998880720122603,0.913669064748201,5.9052258635961,183,72,111,-2,1.5,27,21.2,0,0,0,0,0,0,0.999999999854138,382.239177164586,99.9999999957901
24.3,"random_instances_SVM","SVM",4,36,9633,9291,342,3700,3531,169,0.998723638087496,0.913669064748201,5.9052258635961,188,74,114,5,1.5,27.75,20.9,0,0,0,0,0,0,0.999999999752062,371.239656417574,99.999999993251
24.3,"random_instances_SVM","SVM",4,37,9533,9195,338,3800,3627,173,0.998706747546086,0.913669064748201,5.9104609929078,192,75,117,4,1.6,28.5,21,0,0,0,0,0,0,0.999999996055802,369.233100030013,99.9999998872576
24.3,"random_instances_SVM","SVM",4,38,9433,9099,334,3900,3723,177,0.998690983040771,0.913669064748201,5.9052258635961,202,76,126,10,1.7,29.25,21,0,0,0,0,0,0,0.999999996926639,364.085544989111,99.9999999143349
24.3,"random_instances_SVM","SVM",4,39,9333,9002,331,4000,3820,180,0.998709562636321,0.913669064748201,5.9052258635961,202,76,126,0,1.7,30,21.2,0,0,0,0,0,0,0.999999996703596,360.331266170276,99.9999999142648
24.3,"random_instances_SVM","SVM",4,40,9233,8909,324,4100,3913,187,0.998587950738173,0.902877697841727,5.93149466192171,202,78,124,0,1.6,30.75,20.9,0,0,0,0,0,0,0.999999998615834,350.615488973418,99.9999999629786
24.3,"random_instances_SVM","SVM",4,41,9133,8815,318,4200,4007,193,0.998704495473898,0.902877697841727,5.93677649154052,202,78,124,0,1.6,31.5,20.8,0,0,0,0,0,0,0.999999998411593,343.252193886013,99.9999999539575
24.3,"random_instances_SVM","SVM",4,42,9033,8717,316,4300,4105,195,0.998708436600227,0.906474820143885,5.93677649154052,204,78,126,2,1.6,32.25,21.1,0,0,0,0,0,0,0.999999996709345,336.19231241339,99.9999999070309
24.3,"random_instances_SVM","SVM",4,43,8933,8622,311,4400,4200,200,0.998816536065247,0.902877697841727,5.93677649154052,200,78,122,-4,1.6,33,21,0,0,0,0,0,0,0.99999998091542,337.611193398135,99.9999994215179
24.3,"random_instances_SVM","SVM",4,44,8833,8524,309,4500,4298,202,0.998816536065247,0.902877697841727,5.92622222222222,201,79,122,1,1.5,33.75,21.3,0,0,0,0,0,0,0.999999997301913,327.901012311029,99.9999999249328
24.3,"random_instances_SVM","SVM",4,45,8733,8427,306,4600,4395,205,0.998839619805173,0.906474820143885,5.93149466192171,202,79,123,1,1.6,34.5,21.4,0,0,0,0,0,0,0.9999999924363,323.862581873786,99.9999997786083
24.3,"random_instances_SVM","SVM",4,46,8633,8331,302,4700,4491,209,0.99883455264275,0.906474820143885,5.94206773618538,204,80,124,2,1.6,35.25,21.5,0,0,0,0,0,0,0.999999995231264,321.741207268455,99.9999998603974
24.3,"random_instances_SVM","SVM",4,47,8533,8235,298,4800,4587,213,0.998955038504804,0.913669064748201,5.93677649154052,209,83,126,5,1.5,36,21.5,0,0,0,0,0,0,0.999999982047732,314.530236169375,99.999999471665
24.3,"random_instances_SVM","SVM",4,48,8433,8138,295,4900,4684,216,0.999016407471925,0.913669064748201,5.93677649154052,205,82,123,-4,1.5,36.75,21.7,0,0,0,0,0,0,0.999999999613301,312.162882224439,99.9999999890013
24.3,"random_instances_SVM","SVM",5,0,13233,12704,529,100,95,5,0.943628368377862,0.768627450980392,5.06323235378127,24,5,19,0,3.8,0.75,19,0,0,0,0,0,0,0.999994655338299,549.267941212629,99.9998484648429
24.3,"random_instances_SVM","SVM",5,1,13133,12607,526,200,192,8,0.965113206854764,0.780392156862745,5.27429250488074,38,8,30,14,3.8,1.5,24,0,0,0,0,0,0,0.991937548360692,498.446548263664,99.6317724251772
24.3,"random_instances_SVM","SVM",5,2,13033,12513,520,300,286,14,0.972621799811593,0.796078431372549,5.3821519650065,48,11,37,10,3.4,2.25,20.4,0,0,0,0,0,0,0.992792493067064,542.281801122389,99.6327346984152
24.3,"random_instances_SVM","SVM",5,3,12933,12415,518,400,384,16,0.964672244443643,0.8,5.28274241203331,58,13,45,10,3.5,3,24,0,0,0,0,0,0,0.997029794549131,496.392303043986,99.9747179734268
24.3,"random_instances_SVM","SVM",5,4,12833,12320,513,500,479,21,0.971508690812584,0.803921568627451,5.36948720562749,55,14,41,-3,2.9,3.75,22.8,0,0,0,0,0,0,0.995351672618018,460.2899959333,99.8332204703303
24.3,"random_instances_SVM","SVM",5,5,12733,12225,508,600,574,26,0.980779910217351,0.803921568627451,5.60740550797477,55,17,38,0,2.2,4.5,22.1,0,0,0,0,0,0,0.990475778836377,457.281723701653,99.4741838033352
24.3,"random_instances_SVM","SVM",5,6,12633,12127,506,700,672,28,0.980469829853311,0.803921568627451,5.63689230293344,59,20,39,4,2,5.25,24,0,0,0,0,0,0,0.987515483629695,440.826999916698,99.2352046010075
24.3,"random_instances_SVM","SVM",5,7,12533,12032,501,800,767,33,0.979868017075806,0.854901960784314,5.5078397093103,73,23,50,14,2.2,6,23.2,0,0,0,0,0,0,0.990098445897744,477.126293807333,99.3472041038686
24.3,"random_instances_SVM","SVM",5,8,12433,11935,498,900,864,36,0.980064951744876,0.843137254901961,5.51622818264184,78,24,54,5,2.2,6.75,24,0,0,0,0,0,0,0.995715682895695,472.047065150141,99.7905392577813
24.3,"random_instances_SVM","SVM",5,9,12333,11838,495,1000,961,39,0.977282179247229,0.854901960784314,5.56474382189111,74,24,50,-4,2.1,7.5,24.6,0,0,0,0,0,0,0.993765433740707,461.082347512994,99.598762412468
24.3,"random_instances_SVM","SVM",5,10,12233,11741,492,1100,1058,42,0.977136618839663,0.854901960784314,5.55151420920791,76,24,52,2,2.2,8.25,25.2,0,0,0,0,0,0,0.994997358168182,457.213339920631,99.6984263161106
24.3,"random_instances_SVM","SVM",5,11,12133,11644,489,1200,1155,45,0.977413061294374,0.858823529411765,5.55640972438358,75,25,50,-1,2,9,25.7,0,0,0,0,0,0,0.9941702001049,445.477346804564,99.6304097367375
24.3,"random_instances_SVM","SVM",5,12,12033,11552,481,1300,1247,53,0.988398590877382,0.843137254901961,5.76391050247259,84,28,56,9,2,9.75,23.5,0,0,0,0,0,0,0.995451202652335,451.539750155609,99.7559611305499
24.3,"random_instances_SVM","SVM",5,13,11933,11458,475,1400,1341,59,0.991959316477686,0.847058823529412,5.82543298486503,94,29,65,10,2.2,10.5,22.7,0,0,0,0,0,0,0.995417506388379,457.131197291037,99.7430042273768
24.3,"random_instances_SVM","SVM",5,14,11833,11359,474,1500,1440,60,0.992405171675661,0.862745098039216,5.82543298486503,97,30,67,3,2.2,11.25,24,0,0,0,0,0,0,0.996593540591943,458.432016180499,99.8903087438936
24.3,"random_instances_SVM","SVM",5,15,11733,11263,470,1600,1536,64,0.989418736927091,0.87843137254902,5.76627937268796,90,32,58,-7,1.8,12,24,0,0,0,0,0,0,0.994705106555934,444.948090559348,99.708891231371
24.3,"random_instances_SVM","SVM",5,16,11633,11167,466,1700,1632,68,0.989504972294601,0.890196078431372,5.75608259218807,96,34,62,6,1.8,12.75,24,0,0,0,0,0,0,0.999980919569385,469.509802785257,99.9991957444652
24.3,"random_instances_SVM","SVM",5,17,11533,11069,464,1800,1730,70,0.989717196922443,0.890196078431372,5.82045270531911,101,34,67,5,2,13.5,24.7,0,0,0,0,0,0,0.997228290431624,462.216685079737,99.9781654683157
24.3,"random_instances_SVM","SVM",5,18,11433,10973,460,1900,1826,74,0.989250547380531,0.890196078431372,5.84917287669785,106,36,70,5,1.9,14.25,24.7,0,0,0,0,0,0,0.999996208053129,460.276610291992,99.9998507534919
24.3,"random_instances_SVM","SVM",5,19,11333,10878,455,2000,1921,79,0.992956833388381,0.894117647058824,5.9196448390677,116,38,78,10,2.1,15,24.3,0,0,0,0,0,0,0.999989296915878,470.916994273082,99.9995047689897
24.3,"random_instances_SVM","SVM",5,20,11233,10784,449,2100,2015,85,0.991643731728504,0.894117647058824,5.90676832389121,120,41,79,4,1.9,15.75,23.7,0,0,0,0,0,0,0.996261470821378,447.922586101195,99.8721346963544
24.3,"random_instances_SVM","SVM",5,21,11133,10688,445,2200,2111,89,0.991799077709691,0.894117647058824,5.89615418494442,121,42,79,1,1.9,16.5,23.7,0,0,0,0,0,0,0.999987578172654,443.760626185286,99.9995000505395
24.3,"random_instances_SVM","SVM",5,22,11033,10591,442,2300,2208,92,0.991190537350316,0.894117647058824,5.90676832389121,119,42,77,-2,1.8,17.25,24,0,0,0,0,0,0,0.999992972510657,441.641347630605,99.999696529288
24.3,"random_instances_SVM","SVM",5,23,10933,10496,437,2400,2303,97,0.991405208371563,0.894117647058824,5.90676832389121,123,43,80,4,1.9,18,23.7,0,0,0,0,0,0,0.999988389337036,439.21045113914,99.9995035598304
24.3,"random_instances_SVM","SVM",5,24,10833,10397,436,2500,2402,98,0.991331816569428,0.894117647058824,5.90676832389121,124,44,80,1,1.8,18.75,24.5,0,0,0,0,0,0,0.999983293289533,430.093347421627,99.9992888461803
24.3,"random_instances_SVM","SVM",5,25,10733,10303,430,2600,2496,104,0.991514072878064,0.894117647058824,5.84392227267927,124,43,81,0,1.9,19.5,24,0,0,0,0,0,0,0.997283898613554,423.236737414254,99.9782257957557
24.3,"random_instances_SVM","SVM",5,26,10633,10206,427,2700,2593,107,0.991716511932289,0.894117647058824,5.87794470306108,127,44,83,3,1.9,20.25,24.2,0,0,0,0,0,0,0.999988579479886,420.418038968861,99.9995112470449
24.3,"random_instances_SVM","SVM",5,27,10533,10108,425,2800,2691,109,0.99140887796167,0.898039215686275,5.81781001945014,131,45,86,4,1.9,21,24.7,0,0,0,0,0,0,0.999995547217077,424.310873555048,99.9998214810833
24.3,"random_instances_SVM","SVM",5,28,10433,10012,421,2900,2787,113,0.992155639548401,0.898039215686275,5.85407636738906,137,47,90,6,1.9,21.75,24.7,0,0,0,0,0,0,0.999998444942485,419.803025504353,99.9999397339151
24.3,"random_instances_SVM","SVM",5,29,10333,9915,418,3000,2884,116,0.992352574217464,0.898039215686275,5.84365058579086,139,48,91,2,1.9,22.5,24.9,0,0,0,0,0,0,0.99999727801024,414.326726844766,99.9998921819586
24.3,"random_instances_SVM","SVM",5,30,10233,9822,411,3100,2977,123,0.992304869546076,0.894117647058824,5.85407636738906,141,48,93,2,1.9,23.25,24.2,0,0,0,0,0,0,0.999997598099301,407.631867669561,99.9999069704351
24.3,"random_instances_SVM","SVM",5,31,10133,9728,405,3200,3071,129,0.99193362934694,0.894117647058824,5.82291003357865,145,50,95,4,1.9,24,23.8,0,0,0,0,0,0,0.999992120537315,402.44427944213,99.9996723416953
24.3,"random_instances_SVM","SVM",5,32,10033,9634,399,3300,3165,135,0.993962301077639,0.894117647058824,5.85407636738906,154,53,101,9,1.9,24.75,23.4,0,0,0,0,0,0,0.999995986386279,403.357004224498,99.9998388455717
24.3,"random_instances_SVM","SVM",5,33,9933,9539,394,3400,3260,140,0.994986728315782,0.894117647058824,5.90599089635854,159,56,103,5,1.8,25.5,23.3,0,0,0,0,0,0,0.999992211611831,396.151081259115,99.9996834027328
24.3,"random_instances_SVM","SVM",5,34,9833,9441,392,3500,3358,142,0.994550658691426,0.890196078431372,5.8931705777123,164,57,107,5,1.9,26.25,23.6,0,0,0,0,0,0,0.999995087876449,395.58980282255,99.9998049626538
24.3,"random_instances_SVM","SVM",5,35,9733,9347,386,3600,3452,148,0.995960392890783,0.894117647058824,5.90902664204695,180,60,120,16,2,27,23.3,0,0,0,0,0,0,0.999997345209553,399.724637230766,99.9998956065429
24.3,"random_instances_SVM","SVM",5,36,9633,9249,384,3700,3550,150,0.995712695558575,0.898039215686275,5.90373181530677,179,60,119,-1,2,27.75,23.7,0,0,0,0,0,0,0.999998479420793,397.251301675394,99.9999471829019
24.3,"random_instances_SVM","SVM",5,37,9533,9155,378,3800,3644,156,0.995583648306486,0.898039215686275,5.88790411607002,178,63,115,-1,1.8,28.5,23.4,0,0,0,0,0,0,0.999997306149492,391.312411647325,99.9999032812821
24.3,"random_instances_SVM","SVM",5,38,9433,9057,376,3900,3742,158,0.995663767690484,0.898039215686275,5.88790411607002,179,64,115,1,1.8,29.25,23.7,0,0,0,0,0,0,0.999999349222934,386.198858809812,99.9999775675258
24.3,"random_instances_SVM","SVM",5,39,9333,8957,376,4000,3842,158,0.995723092730544,0.898039215686275,5.88790411607002,178,63,115,-1,1.8,30,24.3,0,0,0,0,0,0,0.999999544988637,386.693389970281,99.9999847033052
24.3,"random_instances_SVM","SVM",5,40,9233,8859,374,4100,3940,160,0.995860702359548,0.894117647058824,5.88790411607002,178,63,115,0,1.8,30.75,24.6,0,0,0,0,0,0,0.999998158344811,381.638879656503,99.9999344039717
24.3,"random_instances_SVM","SVM",5,41,9133,8762,371,4200,4037,163,0.996271084853157,0.898039215686275,5.86693206222828,177,63,114,-1,1.8,31.5,24.8,0,0,0,0,0,0,0.999998184327602,375.804154546198,99.99992942805
24.3,"random_instances_SVM","SVM",5,42,9033,8668,365,4300,4131,169,0.996954240211369,0.898039215686275,5.96332737030411,178,64,114,1,1.8,32.25,24.4,0,0,0,0,0,0,0.999997928933169,366.378224190812,99.9999302920494
24.3,"random_instances_SVM","SVM",5,43,8933,8574,359,4400,4225,175,0.997110197790908,0.898039215686275,5.94206773618538,183,66,117,5,1.8,33,24.1,0,0,0,0,0,0,0.999999070915058,361.950222878992,99.9999688567094
24.3,"random_instances_SVM","SVM",5,44,8833,8477,356,4500,4322,178,0.997212946313898,0.901960784313726,5.91876550976897,182,67,115,-1,1.7,33.75,24.3,0,0,0,0,0,0,0.999998996150597,357.047157576508,99.9999675465591
24.3,"random_instances_SVM","SVM",5,45,8733,8381,352,4600,4418,182,0.997005614472864,0.901960784313726,5.93463351381661,178,70,108,-4,1.5,34.5,24.3,0,0,0,0,0,0,0.999998641625932,352.725878210344,99.9999535275898
24.3,"random_instances_SVM","SVM",5,46,8633,8284,349,4700,4515,185,0.99741966655658,0.901960784313726,5.98473967684022,175,69,106,-3,1.5,35.25,24.4,0,0,0,0,0,0,0.999999114243303,348.131088122734,99.9999722791877
24.3,"random_instances_SVM","SVM",5,47,8533,8186,347,4800,4613,187,0.997430063728549,0.901960784313726,5.9579982126899,176,69,107,1,1.6,36,24.7,0,0,0,0,0,0,0.999998963928028,346.374945675576,99.9999695086629
24.3,"random_instances_SVM","SVM",5,48,8433,8092,341,4900,4707,193,0.997513241104302,0.901960784313726,5.95267857142857,174,70,104,-2,1.5,36.75,24.4,0,0,0,0,0,0,0.999986622345652,336.806933660088,99.9995882696818
24.3,"random_instances_SVM","SVM",6,0,13233,12708,525,100,95,5,0.964503227143696,0.810810810810811,5.55470432838854,32,5,27,0,5.4,0.75,19,0,0,0,0,0,0,0.836701931607497,776.217736236457,87.9476444310664
24.3,"random_instances_SVM","SVM",6,1,13133,12611,522,200,192,8,0.969795236649154,0.895752895752896,5.35259393499256,32,8,24,0,3,1.5,24,0,0,0,0,0,0,0.999986676487014,477.121107967268,99.9995801650141
24.3,"random_instances_SVM","SVM",6,2,13033,12520,513,300,283,17,0.989820277741619,0.8996138996139,5.75096352576245,52,16,36,20,2.2,2.25,16.6,0,0,0,0,0,0,0.996664500468185,644.539272778399,99.9246582201323
24.3,"random_instances_SVM","SVM",6,3,12933,12424,509,400,379,21,0.995077340582945,0.915057915057915,5.87847998374314,62,20,42,10,2.1,3,18,0,0,0,0,0,0,0.999997031225917,564.332574930679,99.9998863440896
24.3,"random_instances_SVM","SVM",6,4,12833,12329,504,500,474,26,0.993422194264884,0.915057915057915,5.86801074067325,65,22,43,3,2,3.75,18.2,0,0,0,0,0,0,0.996808251082535,514.186842130942,99.9280081549984
24.3,"random_instances_SVM","SVM",6,5,12733,12231,502,600,572,28,0.99304440877474,0.918918918918919,5.86801074067325,68,23,45,3,2,4.5,20.4,0,0,0,0,0,0,0.999991666562763,498.988531452293,99.9996527365017
24.3,"random_instances_SVM","SVM",6,6,12633,12138,495,700,665,35,0.994293450754126,0.915057915057915,5.84409662059839,86,29,57,18,2,5.25,19,0,0,0,0,0,0,0.990175184908516,480.228977219305,99.3707120656962
24.3,"random_instances_SVM","SVM",6,7,12533,12041,492,800,762,38,0.993284215194328,0.915057915057915,5.79349933718866,91,29,62,5,2.1,6,20.1,0,0,0,0,0,0,0.99308881342792,479.759934395221,99.5851511241443
24.3,"random_instances_SVM","SVM",6,8,12433,11945,488,900,858,42,0.994775473708059,0.915057915057915,5.85757872157872,94,32,62,3,1.9,6.75,20.4,0,0,0,0,0,0,0.994434720402428,484.449858934502,99.7057507275619
24.3,"random_instances_SVM","SVM",6,9,12333,11847,486,1000,956,44,0.994089193527397,0.918918918918919,5.81621894243253,96,33,63,2,1.9,7.5,21.7,0,0,0,0,0,0,0.995215523598407,479.529816151412,99.787441756242
24.3,"random_instances_SVM","SVM",6,10,12233,11753,480,1100,1050,50,0.995308109072155,0.918918918918919,5.82135694503186,101,36,65,5,1.8,8.25,21,0,0,0,0,0,0,0.997495021611069,475.711996916621,99.9992603437224
24.3,"random_instances_SVM","SVM",6,11,12133,11653,480,1200,1150,50,0.99435671626683,0.918918918918919,5.75822468925917,99,35,64,-2,1.8,9,23,0,0,0,0,0,0,0.997473111693314,471.922130716651,99.9967556652678
24.3,"random_instances_SVM","SVM",6,12,12033,11555,478,1300,1248,52,0.997499505926473,0.918918918918919,5.88957597173145,100,37,63,1,1.7,9.75,24,0,0,0,0,0,0,0.999985156239717,469.203316345839,99.999421586415
24.3,"random_instances_SVM","SVM",6,13,11933,11462,471,1400,1341,59,0.997419369610381,0.918918918918919,5.88957597173145,106,39,67,6,1.7,10.5,22.7,0,0,0,0,0,0,0.999984589020133,477.147332643096,99.9994374683684
24.3,"random_instances_SVM","SVM",6,14,11833,11364,469,1500,1439,61,0.997048211935853,0.918918918918919,5.98473967684022,98,38,60,-8,1.6,11.25,23.6,0,0,0,0,0,0,0.995452439338548,453.932019932801,99.8306296579434
24.3,"random_instances_SVM","SVM",6,15,11733,11266,467,1600,1537,63,0.997068697911395,0.918918918918919,5.97401433691756,103,38,65,5,1.7,12,24.4,0,0,0,0,0,0,0.99998261118367,445.599027931277,99.9993857796313
24.3,"random_instances_SVM","SVM",6,16,11633,11170,463,1700,1633,67,0.9970602625097,0.918918918918919,5.98473967684022,104,40,64,1,1.6,12.75,24.4,0,0,0,0,0,0,0.999981431051174,449.328472464598,99.9993472721728
24.3,"random_instances_SVM","SVM",6,17,11533,11073,460,1800,1730,70,0.99684817240997,0.918918918918919,5.91385457458476,111,41,70,7,1.7,13.5,24.7,0,0,0,0,0,0,0.997237493736249,438.402423412162,99.9834250607236
24.3,"random_instances_SVM","SVM",6,18,11433,10975,458,1900,1828,72,0.997714608669666,0.918918918918919,6.01714801444043,114,42,72,3,1.7,14.25,25.4,0,0,0,0,0,0,0.999982460387329,446.610697620833,99.9993238006681
24.3,"random_instances_SVM","SVM",6,19,11333,10876,457,2000,1927,73,0.997443470758079,0.918918918918919,5.98473967684022,117,43,74,3,1.7,15,26.4,0,0,0,0,0,0,0.996418985755178,439.352997900206,99.9263772445245
24.3,"random_instances_SVM","SVM",6,20,11233,10782,451,2100,2021,79,0.9964089289932,0.918918918918919,5.97235493458515,115,41,74,-2,1.8,15.75,25.6,0,0,0,0,0,0,0.999990476627594,427.282114921729,99.9996079337579
24.3,"random_instances_SVM","SVM",6,21,11133,10684,449,2200,2119,81,0.996860825512512,0.918918918918919,5.98311593446729,122,44,78,7,1.8,16.5,26.2,0,0,0,0,0,0,0.999981638218898,424.653284223766,99.9992360775495
24.3,"random_instances_SVM","SVM",6,22,11033,10588,445,2300,2215,85,0.996065487638525,0.918918918918919,5.95992556262827,126,48,78,4,1.6,17.25,26.1,0,0,0,0,0,0,0.999992340777091,430.788470801213,99.9996686753779
24.3,"random_instances_SVM","SVM",6,23,10933,10491,442,2400,2312,88,0.996188403491778,0.918918918918919,5.95992556262827,127,49,78,1,1.6,18,26.3,0,0,0,0,0,0,0.999992776808143,422.326887927699,99.9996969270821
24.3,"random_instances_SVM","SVM",6,24,10833,10396,437,2500,2407,93,0.996101036831379,0.918918918918919,5.949206272048,130,49,81,3,1.7,18.75,25.9,0,0,0,0,0,0,0.999992821024194,418.892882711432,99.9996946431144
24.3,"random_instances_SVM","SVM",6,25,10733,10304,429,2600,2499,101,0.996160084643234,0.922779922779923,5.95992556262827,133,50,83,3,1.7,19.5,24.7,0,0,0,0,0,0,0.999984897891761,406.111653112685,99.9994019316249
24.3,"random_instances_SVM","SVM",6,26,10633,10206,427,2700,2597,103,0.996313126931107,0.922779922779923,5.95456109317495,136,50,86,3,1.7,20.25,25.2,0,0,0,0,0,0,0.999990281578075,402.235355631354,99.9996052512282
24.3,"random_instances_SVM","SVM",6,27,10533,10109,424,2800,2694,106,0.996816840917966,0.922779922779923,5.95992556262827,140,51,89,4,1.7,21,25.4,0,0,0,0,0,0,0.999984385517834,403.602064836238,99.9993469001146
24.3,"random_instances_SVM","SVM",6,28,10433,10013,420,2900,2790,110,0.996682477019557,0.922779922779923,5.95992556262827,141,51,90,1,1.8,21.75,25.4,0,0,0,0,0,0,0.999994304866094,395.200788601963,99.9997704060559
24.3,"random_instances_SVM","SVM",6,29,10333,9917,416,3000,2886,114,0.996952409873758,0.922779922779923,5.965299706508,141,51,90,0,1.8,22.5,25.3,0,0,0,0,0,0,0.999991747065984,387.876904882183,99.9996564631774
24.3,"random_instances_SVM","SVM",6,30,10233,9817,416,3100,2986,114,0.996929513783446,0.922779922779923,5.965299706508,143,51,92,2,1.8,23.25,26.2,0,0,0,0,0,0,0.999995511774175,391.524851147896,99.9998301309869
24.3,"random_instances_SVM","SVM",6,31,10133,9720,413,3200,3083,117,0.996725859085411,0.922779922779923,5.965299706508,143,51,92,0,1.8,24,26.4,0,0,0,0,0,0,0.999986365748262,383.495266836514,99.999457502777
24.3,"random_instances_SVM","SVM",6,32,10033,9625,408,3300,3178,122,0.996046206720364,0.922779922779923,5.94745131929247,149,53,96,6,1.8,24.75,26,0,0,0,0,0,0,0.999986078053434,382.231550626576,99.999412102812
24.3,"random_instances_SVM","SVM",6,33,9933,9533,400,3400,3270,130,0.99639145566112,0.922779922779923,5.93139159475793,146,54,92,-3,1.7,25.5,25.2,0,0,0,0,0,0,0.999991116994168,371.64381765333,99.9996371160263
24.3,"random_instances_SVM","SVM",6,34,9833,9435,398,3500,3368,132,0.996651145527551,0.922779922779923,5.92073320914291,146,56,90,0,1.6,26.25,25.5,0,0,0,0,0,0,0.999996533642538,366.047189282961,99.9998685381902
24.3,"random_instances_SVM","SVM",6,35,9733,9338,395,3600,3465,135,0.996633672195472,0.922779922779923,5.92605760951085,149,55,94,3,1.7,27,25.7,0,0,0,0,0,0,0.999995267593633,358.873558502655,99.999818248136
24.3,"random_instances_SVM","SVM",6,36,9633,9241,392,3700,3562,138,0.996367354513424,0.926640926640927,5.93319943902904,152,55,97,3,1.8,27.75,25.8,0,0,0,0,0,0,0.999995196528757,363.846988650252,99.9998020615082
24.3,"random_instances_SVM","SVM",6,37,9533,9144,389,3800,3659,141,0.996225157742014,0.926640926640927,5.91541836784207,161,58,103,9,1.8,28.5,26,0,0,0,0,0,0,0.999997758688337,362.364599339559,99.9999106606506
24.3,"random_instances_SVM","SVM",6,38,9433,9048,385,3900,3755,145,0.996505333583988,0.926640926640927,5.91011305988884,163,59,104,2,1.8,29.25,25.9,0,0,0,0,0,0,0.999993162343459,354.41856388963,99.9997186232467
24.3,"random_instances_SVM","SVM",6,39,9333,8953,380,4000,3850,150,0.996318549689334,0.938223938223938,5.91011305988884,167,59,108,4,1.8,30,25.7,0,0,0,0,0,0,0.99999819266132,352.4755232394,99.9999277463814
24.3,"random_instances_SVM","SVM",6,40,9233,8857,376,4100,3946,154,0.99759350040249,0.942084942084942,5.9278829520765,170,61,109,3,1.8,30.75,25.6,0,0,0,0,0,0,0.999999330230089,355.744427482268,99.9999725027485
24.3,"random_instances_SVM","SVM",6,41,9133,8762,371,4200,4041,159,0.997604948447646,0.942084942084942,5.9278829520765,176,64,112,6,1.8,31.5,25.4,0,0,0,0,0,0,0.999999881523324,352.951226486892,99.999995782088
24.3,"random_instances_SVM","SVM",6,42,9033,8664,369,4300,4139,161,0.997418164552998,0.942084942084942,5.93319943902904,176,64,112,0,1.8,32.25,25.7,0,0,0,0,0,0,0.999999850325426,351.016972361955,99.999994692148
24.3,"random_instances_SVM","SVM",6,43,8933,8570,363,4400,4233,167,0.997264218472087,0.942084942084942,5.93319943902904,180,64,116,4,1.8,33,25.3,0,0,0,0,0,0,0.999999959294011,345.5984663862,99.9999986820647
24.3,"random_instances_SVM","SVM",6,44,8833,8475,358,4500,4328,172,0.997766426137214,0.942084942084942,5.95628581816923,187,66,121,7,1.8,33.75,25.2,0,0,0,0,0,0,0.999999950380967,341.520462030092,99.9999983673424
24.3,"random_instances_SVM","SVM",6,45,8733,8379,354,4600,4424,176,0.997776669124985,0.942084942084942,5.95628581816923,185,66,119,-2,1.8,34.5,25.1,0,0,0,0,0,0,0.999999925327496,337.912638271134,99.9999975618289
24.3,"random_instances_SVM","SVM",6,46,8633,8284,349,4700,4519,181,0.997560361324408,0.942084942084942,5.95628581816923,187,67,120,2,1.8,35.25,25,0,0,0,0,0,0,0.999999643761965,328.114521749992,99.9999882835221
24.3,"random_instances_SVM","SVM",6,47,8533,8186,347,4800,4617,183,0.998659976188068,0.942084942084942,5.97401433691756,187,69,118,0,1.7,36,25.2,0,0,0,0,0,0,0.999999886265128,331.867483135272,99.9999964424773
24.3,"random_instances_SVM","SVM",6,48,8433,8088,345,4900,4715,185,0.998194221508829,0.942084942084942,5.95628581816923,194,69,125,7,1.8,36.75,25.5,0,0,0,0,0,0,0.999999774021377,327.573595537016,99.9999926616831
24.3,"random_instances_SVM","SVM",7,0,13233,12722,511,100,94,6,0.951119613208817,0.823529411764706,5.46122936016512,29,6,23,0,3.8,0.75,15.7,0,0,0,0,0,0,0.993248616819347,756.567769598505,99.6429962660414
24.3,"random_instances_SVM","SVM",7,1,13133,12625,508,200,191,9,0.952207607045943,0.871323529411765,5.50247599039616,44,9,35,15,3.9,1.5,21.2,0,0,0,0,0,0,0.999999563737559,683.836309832781,99.9999822510602
24.3,"random_instances_SVM","SVM",7,2,13033,12530,503,300,286,14,0.958079036931434,0.875,5.47312828371278,49,13,36,5,2.8,2.25,20.4,0,0,0,0,0,0,0.999999780976807,696.819633398204,99.9999930524733
24.3,"random_instances_SVM","SVM",7,3,12933,12434,499,400,382,18,0.960067033068118,0.871323529411765,5.38820043103448,50,15,35,1,2.3,3,21.2,0,0,0,0,0,0,0.999999959498496,607.17975116254,99.9999989014852
24.3,"random_instances_SVM","SVM",7,4,12833,12336,497,500,480,20,0.963402589339056,0.875,5.34214743589744,51,18,33,1,1.8,3.75,24,0,0,0,0,0,0,0.999999098814231,568.428401246079,99.9999708165799
24.3,"random_instances_SVM","SVM",7,5,12733,12243,490,600,573,27,0.97537655797268,0.878676470588235,5.53823789003686,67,22,45,16,2,4.5,21.2,0,0,0,0,0,0,0.999989960525319,572.915062656724,99.9996772652845
24.3,"random_instances_SVM","SVM",7,6,12633,12146,487,700,670,30,0.968468012693734,0.882352941176471,5.45878820960699,69,24,45,2,1.9,5.25,22.3,0,0,0,0,0,0,0.999997216182017,564.421779286723,99.9999105356027
24.3,"random_instances_SVM","SVM",7,7,12533,12053,480,800,763,37,0.972813664167769,0.882352941176471,5.51173941798942,72,27,45,3,1.7,6,20.6,0,0,0,0,0,0,0.999992980953004,536.372193608321,99.9997350276168
24.3,"random_instances_SVM","SVM",7,8,12433,11962,471,900,854,46,0.978859862944393,0.882352941176471,5.57167012179321,82,28,54,10,1.9,6.75,18.6,0,0,0,0,0,0,0.999997534694768,533.802517640172,99.9999168791864
24.3,"random_instances_SVM","SVM",7,9,12333,11866,467,1000,950,50,0.981190498091336,0.882352941176471,5.60313911531073,86,30,56,4,1.9,7.5,19,0,0,0,0,0,0,0.996766481379398,527.316695569332,99.9315549575878
24.3,"random_instances_SVM","SVM",7,10,12233,11768,465,1100,1048,52,0.97908752242102,0.886029411764706,5.57658341114223,88,30,58,2,1.9,8.25,20.2,0,0,0,0,0,0,0.999987136404745,519.919110871698,99.9995361953145
24.3,"random_instances_SVM","SVM",7,11,12133,11671,462,1200,1145,55,0.982261532447223,0.882352941176471,5.60808888484723,96,31,65,8,2.1,9,20.8,0,0,0,0,0,0,0.999992064435558,517.260758994562,99.9997139863755
24.3,"random_instances_SVM","SVM",7,12,12033,11577,456,1300,1239,61,0.983718898036154,0.886029411764706,5.66139705882353,100,33,67,4,2,9.75,20.3,0,0,0,0,0,0,0.999993766472806,507.90675595889,99.9997933321365
24.3,"random_instances_SVM","SVM",7,13,11933,11480,453,1400,1336,64,0.983270477854949,0.886029411764706,5.70534256674917,98,33,65,-2,2,10.5,20.9,0,0,0,0,0,0,0.99999586353219,501.580987825679,99.9998649032448
24.3,"random_instances_SVM","SVM",7,14,11833,11383,450,1500,1433,67,0.982519661500249,0.882352941176471,5.67324094517163,110,34,76,12,2.2,11.25,21.4,0,0,0,0,0,0,0.999997348444013,489.640794503016,99.9999171464665
24.3,"random_instances_SVM","SVM",7,15,11733,11287,446,1600,1529,71,0.983647035827623,0.882352941176471,5.69006039915966,108,34,74,-2,2.2,12,21.5,0,0,0,0,0,0,0.999997136978509,473.132968782739,99.9999063203985
24.3,"random_instances_SVM","SVM",7,16,11633,11191,442,1700,1625,75,0.984793956675717,0.886029411764706,5.70684984520124,112,35,77,4,2.2,12.75,21.7,0,0,0,0,0,0,0.999998331883359,469.923476232494,99.9999496156706
24.3,"random_instances_SVM","SVM",7,17,11533,11098,435,1800,1718,82,0.983438922871723,0.886029411764706,5.66311919504644,109,37,72,-3,1.9,13.5,21,0,0,0,0,0,0,0.999996102126089,460.15617275811,99.9998694960696
24.3,"random_instances_SVM","SVM",7,18,11433,11001,432,1900,1815,85,0.992281998804231,0.889705882352941,5.8641978969007,116,38,78,7,2.1,14.25,21.4,0,0,0,0,0,0,0.999997518668741,452.98800008262,99.9999089928714
24.3,"random_instances_SVM","SVM",7,19,11333,10903,430,2000,1913,87,0.99220208802835,0.889705882352941,5.84223460889732,117,39,78,1,2,15,22,0,0,0,0,0,0,0.999998846672404,449.483954352974,99.9999584309533
24.3,"random_instances_SVM","SVM",7,20,11233,10808,425,2100,2008,92,0.992165869475248,0.889705882352941,5.83700431828954,122,41,81,5,2,15.75,21.8,0,0,0,0,0,0,0.99999578338808,435.899555425626,99.9998449162593
24.3,"random_instances_SVM","SVM",7,21,11133,10713,420,2200,2103,97,0.991500712873126,0.889705882352941,5.83072064103918,122,41,81,0,2,16.5,21.7,0,0,0,0,0,0,0.999998707776441,433.491581243023,99.9999529510735
24.3,"random_instances_SVM","SVM",7,22,11033,10619,414,2300,2197,103,0.99559915834981,0.889705882352941,5.96809431319698,127,43,84,5,2,17.25,21.3,0,0,0,0,0,0,0.999998240955006,434.26832843343,99.9999380498709
24.3,"random_instances_SVM","SVM",7,23,10933,10523,410,2400,2293,107,0.996585107850802,0.889705882352941,5.96332737030411,133,44,89,6,2,18,21.4,0,0,0,0,0,0,0.999998706183859,432.439991932356,99.9999567228904
24.3,"random_instances_SVM","SVM",7,24,10833,10427,406,2500,2389,111,0.996703536770455,0.889705882352941,5.96332737030411,133,44,89,0,2,18.75,21.5,0,0,0,0,0,0,0.999998176684606,424.044835281075,99.9999385777527
24.3,"random_instances_SVM","SVM",7,25,10733,10329,404,2600,2487,113,0.996355723681184,0.889705882352941,5.96332737030411,130,44,86,-3,2,19.5,22,0,0,0,0,0,0,0.999998179231841,417.576059266553,99.9999406099454
24.3,"random_instances_SVM","SVM",7,26,10633,10233,400,2700,2583,117,0.995289288506643,0.889705882352941,5.91947937493423,124,46,78,-6,1.7,20.25,22.1,0,0,0,0,0,0,0.999998188612769,419.115373902157,99.9999384832295
24.3,"random_instances_SVM","SVM",7,27,10533,10136,397,2800,2680,120,0.995716437474129,0.889705882352941,5.91418940230248,125,47,78,1,1.7,21,22.3,0,0,0,0,0,0,0.999993467450823,405.74932030141,99.9997883282003
24.3,"random_instances_SVM","SVM",7,28,10433,10042,391,2900,2774,126,0.995128317159544,0.889705882352941,5.89755537724929,128,48,80,3,1.7,21.75,22,0,0,0,0,0,0,0.999993086695056,406.736109312632,99.9997535843154
24.3,"random_instances_SVM","SVM",7,29,10333,9946,387,3000,2870,130,0.995600883042818,0.889705882352941,5.9460718249564,132,49,83,4,1.7,22.5,22.1,0,0,0,0,0,0,0.999987636609002,391.670274469081,99.9995431357801
24.3,"random_instances_SVM","SVM",7,30,10233,9850,383,3100,2966,134,0.995288713608975,0.889705882352941,5.94073423803992,135,51,84,3,1.6,23.25,22.1,0,0,0,0,0,0,0.999997301150526,387.176148212774,99.9999007061492
24.3,"random_instances_SVM","SVM",7,31,10133,9754,379,3200,3062,138,0.996540265832682,0.889705882352941,5.98473967684022,142,53,89,7,1.7,24,22.2,0,0,0,0,0,0,0.999989757964592,385.623201234249,99.9996371916902
24.3,"random_instances_SVM","SVM",7,32,10033,9657,376,3300,3159,141,0.996465529135813,0.889705882352941,5.98473967684022,139,51,88,-3,1.7,24.75,22.4,0,0,0,0,0,0,0.999996969433719,379.886885238318,99.9998960943669
24.3,"random_instances_SVM","SVM",7,33,9933,9562,371,3400,3254,146,0.996521869107298,0.889705882352941,5.96273695744007,139,51,88,0,1.7,25.5,22.3,0,0,0,0,0,0,0.999998269054127,376.06720797922,99.9999443810491
24.3,"random_instances_SVM","SVM",7,34,9833,9462,371,3500,3354,146,0.996088971163133,0.889705882352941,5.94140337261917,141,52,89,2,1.7,26.25,23,0,0,0,0,0,0,0.999997531333622,372.157965018769,99.9999184599307
24.3,"random_instances_SVM","SVM",7,35,9733,9364,369,3600,3452,148,0.996133813181252,0.889705882352941,5.91947937493423,145,51,94,4,1.8,27,23.3,0,0,0,0,0,0,0.999998144290791,370.457667832891,99.999938005362
24.3,"random_instances_SVM","SVM",7,36,9633,9268,365,3700,3548,152,0.996183829278386,0.900735294117647,5.94140337261917,145,53,92,0,1.7,27.75,23.3,0,0,0,0,0,0,0.999999648370267,368.038571131346,99.9999886933134
24.3,"random_instances_SVM","SVM",7,37,9533,9173,360,3800,3643,157,0.996287885756333,0.900735294117647,5.88351547439171,149,53,96,4,1.8,28.5,23.2,0,0,0,0,0,0,0.999998941588734,363.407204163691,99.9999673015407
24.3,"random_instances_SVM","SVM",7,38,9433,9075,358,3900,3741,159,0.996704111668122,0.900735294117647,5.9579982126899,151,54,97,2,1.8,29.25,23.5,0,0,0,0,0,0,0.999999223125188,355.699076361319,99.9999748578671
24.3,"random_instances_SVM","SVM",7,39,9333,8984,349,4000,3832,168,0.996512095846938,0.904411764705882,5.87830882352941,155,57,98,4,1.7,30,22.8,0,0,0,0,0,0,0.999999754004934,353.465984116447,99.9999921084222
24.3,"random_instances_SVM","SVM",7,40,9233,8886,347,4100,3930,170,0.996652370877984,0.908088235294118,5.93609380749619,155,57,98,0,1.7,30.75,23.1,0,0,0,0,0,0,0.999999600098577,349.800571201919,99.9999867618665
24.3,"random_instances_SVM","SVM",7,41,9133,8796,337,4200,4020,180,0.997180701835073,0.904411764705882,5.97401433691756,162,59,103,7,1.7,31.5,22.3,0,0,0,0,0,0,0.999999650512484,346.041878274979,99.9999900959668
24.3,"random_instances_SVM","SVM",7,42,9033,8699,334,4300,4117,183,0.997411235800027,0.908088235294118,5.9573892112899,165,60,105,3,1.8,32.25,22.5,0,0,0,0,0,0,0.999999624526652,337.049436924107,99.9999891430792
24.3,"random_instances_SVM","SVM",7,43,8933,8602,331,4400,4214,186,0.997254863634273,0.908088235294118,5.92477881931645,163,60,103,-2,1.7,33,22.7,0,0,0,0,0,0,0.999999294589637,334.190351493476,99.9999780210965
24.3,"random_instances_SVM","SVM",7,44,8833,8504,329,4500,4312,188,0.997221519569516,0.908088235294118,5.95205104891419,169,61,108,6,1.8,33.75,22.9,0,0,0,0,0,0,0.999999819607263,332.680498247544,99.9999947848047
24.3,"random_instances_SVM","SVM",7,45,8733,8409,324,4600,4407,193,0.996944993791104,0.911764705882353,5.94073423803992,172,63,109,3,1.7,34.5,22.8,0,0,0,0,0,0,0.999999894282009,329.531531706943,99.9999964232967
24.3,"random_instances_SVM","SVM",7,46,8633,8312,321,4700,4504,196,0.99702030538564,0.911764705882353,5.93540622527038,176,64,112,4,1.8,35.25,23,0,0,0,0,0,0,0.999999927303182,327.479199795935,99.9999976113364
24.3,"random_instances_SVM","SVM",7,47,8533,8218,315,4800,4598,202,0.997297980959389,0.922794117647059,5.96273695744007,174,64,110,-2,1.7,36,22.8,0,0,0,0,0,0,0.999999979433352,318.942457599011,99.9999993163728
24.3,"random_instances_SVM","SVM",7,48,8433,8122,311,4900,4694,206,0.997120912477579,0.919117647058823,5.96273695744007,175,64,111,1,1.7,36.75,22.8,0,0,0,0,0,0,0.999999841695538,315.160873278354,99.9999947919758
24.3,"random_instances_SVM","SVM",8,0,13233,12730,503,100,94,6,0.971093627681231,0.792857142857143,5.48329173067076,24,6,18,0,3,0.75,15.7,0,0,0,0,0,0,0.930972376999842,828.303847702281,96.5074864752305
24.3,"random_instances_SVM","SVM",8,1,13133,12633,500,200,191,9,0.975393097586642,0.842857142857143,5.60252100840336,36,9,27,12,3,1.5,21.2,0,0,0,0,0,0,0.978781099130822,644.377460059236,99.0410377485632
24.3,"random_instances_SVM","SVM",8,2,13033,12542,491,300,282,18,0.979306739135301,0.857142857142857,5.75856948757764,61,17,44,25,2.6,2.25,15.7,0,0,0,0,0,0,0.981632760795956,640.716256546836,98.9370580089477
24.3,"random_instances_SVM","SVM",8,3,12933,12442,491,400,382,18,0.981739694468664,0.867857142857143,5.75407703207523,63,17,46,2,2.7,3,21.2,0,0,0,0,0,0,0.988092396462849,562.86701149036,99.4276463510054
24.3,"random_instances_SVM","SVM",8,4,12833,12345,488,500,479,21,0.976497461361259,0.889285714285714,5.69480079938112,69,19,50,6,2.6,3.75,22.8,0,0,0,0,0,0,0.9878976650651,517.011660191162,99.4033272046313
24.3,"random_instances_SVM","SVM",8,5,12733,12247,486,600,577,23,0.974846787000431,0.892857142857143,5.58129933791698,76,19,57,7,3,4.5,25.1,0,0,0,0,0,0,0.993985585625972,516.426727362027,99.7816156960277
24.3,"random_instances_SVM","SVM",8,6,12633,12152,481,700,672,28,0.978178330984857,0.892857142857143,5.6794232994728,78,21,57,2,2.7,5.25,24,0,0,0,0,0,0,0.999988524985842,509.843847654811,99.99960593093
24.3,"random_instances_SVM","SVM",8,7,12533,12055,478,800,769,31,0.976720570802338,0.892857142857143,5.55302877334679,83,23,60,5,2.6,6,24.8,0,0,0,0,0,0,0.999989704548378,480.377825368529,99.9996606925005
24.3,"random_instances_SVM","SVM",8,8,12433,11957,476,900,867,33,0.986922096222255,0.889285714285714,5.74595153288386,87,24,63,4,2.6,6.75,26.3,0,0,0,0,0,0,0.996868694688643,496.450037542463,99.9575291490868
24.3,"random_instances_SVM","SVM",8,9,12333,11862,471,1000,962,38,0.989714598850341,0.892857142857143,5.79868421052632,91,25,66,4,2.6,7.5,25.3,0,0,0,0,0,0,0.996194697575291,466.40840939375,99.8916975901078
24.3,"random_instances_SVM","SVM",8,10,12233,11768,465,1100,1056,44,0.988524681831405,0.889285714285714,5.79294658829543,100,31,69,9,2.2,8.25,24,0,0,0,0,0,0,0.999994801739853,487.918597822257,99.9998016829206
24.3,"random_instances_SVM","SVM",8,11,12133,11669,464,1200,1155,45,0.988840613746673,0.896428571428571,5.82944580172303,96,29,67,-4,2.3,9,25.7,0,0,0,0,0,0,0.999993425119077,460.815815503191,99.9997441759688
24.3,"random_instances_SVM","SVM",8,12,12033,11570,463,1300,1254,46,0.989224764588781,0.896428571428571,5.82988789237668,98,30,68,2,2.3,9.75,27.3,0,0,0,0,0,0,0.999994075854983,461.979860993176,99.9997681980369
24.3,"random_instances_SVM","SVM",8,13,11933,11474,459,1400,1350,50,0.990446554385007,0.892857142857143,5.81992481203007,102,33,69,4,2.1,10.5,27,0,0,0,0,0,0,0.99999017052282,454.200569384247,99.9996713189467
24.3,"random_instances_SVM","SVM",8,14,11833,11377,456,1500,1447,53,0.992338231675939,0.892857142857143,5.85718105423988,110,34,76,8,2.2,11.25,27.3,0,0,0,0,0,0,0.999994641708453,456.87122276397,99.9997955350826
24.3,"random_instances_SVM","SVM",8,15,11733,11281,452,1600,1543,57,0.991481021718209,0.892857142857143,5.87732820976492,112,35,77,2,2.2,12,27.1,0,0,0,0,0,0,0.99999701931378,467.035474718585,99.9998906997804
24.3,"random_instances_SVM","SVM",8,16,11633,11186,447,1700,1638,62,0.991480462546673,0.892857142857143,5.84599974398362,116,37,79,4,2.1,12.75,26.4,0,0,0,0,0,0,0.999990795879206,440.462551876293,99.9996143242411
24.3,"random_instances_SVM","SVM",8,17,11533,11092,441,1800,1732,68,0.991503388579463,0.892857142857143,5.84599974398362,118,38,80,2,2.1,13.5,25.5,0,0,0,0,0,0,0.996791860652292,427.182142841335,99.913906860752
24.3,"random_instances_SVM","SVM",8,18,11433,10995,438,1900,1829,71,0.991651569035299,0.896428571428571,5.92038555928701,118,37,81,0,2.2,14.25,25.8,0,0,0,0,0,0,0.999981383896429,428.351256842585,99.9992458293029
24.3,"random_instances_SVM","SVM",8,19,11333,10901,432,2000,1923,77,0.991535820528289,0.892857142857143,5.85124279308136,119,38,81,1,2.1,15,25,0,0,0,0,0,0,0.996550551509872,416.773281174566,99.8993211228244
24.3,"random_instances_SVM","SVM",8,20,11233,10804,429,2100,2020,80,0.991784092688258,0.9,5.84076608261926,123,40,83,4,2.1,15.75,25.2,0,0,0,0,0,0,0.997214163242496,409.288818590585,99.9675907966462
24.3,"random_instances_SVM","SVM",8,21,11133,10707,426,2200,2117,83,0.994799704757432,0.9,5.96889840404827,130,43,87,7,2,16.5,25.5,0,0,0,0,0,0,0.999984995186057,415.378892204712,99.9993502899287
24.3,"random_instances_SVM","SVM",8,22,11033,10610,423,2300,2214,86,0.994796349728243,0.9,5.97432467532468,128,43,85,-2,2,17.25,25.7,0,0,0,0,0,0,0.999987742090605,409.200969024142,99.9994702453948
24.3,"random_instances_SVM","SVM",8,23,10933,10516,417,2400,2308,92,0.994748820148071,0.903571428571429,5.9852068696331,131,41,90,3,2.2,18,25.1,0,0,0,0,0,0,0.9999894416309,402.142111595387,99.9995689174544
24.3,"random_instances_SVM","SVM",8,24,10833,10419,414,2500,2405,95,0.995365586347262,0.896428571428571,5.97976082152606,143,43,100,12,2.3,18.75,25.3,0,0,0,0,0,0,0.997125495652847,401.353510049756,99.9509790521199
24.3,"random_instances_SVM","SVM",8,25,10733,10321,412,2600,2503,97,0.995405846697525,0.896428571428571,6.00142662160406,147,47,100,4,2.1,19.5,25.8,0,0,0,0,0,0,0.999987266377545,400.056754252562,99.9994596999469
24.3,"random_instances_SVM","SVM",8,26,10633,10226,407,2700,2598,102,0.995666420631194,0.903571428571429,5.99597077922078,152,50,102,5,2,20.25,25.5,0,0,0,0,0,0,0.999991657070409,399.948754043325,99.9996603635173
24.3,"random_instances_SVM","SVM",8,27,10533,10128,405,2800,2696,104,0.995623923594803,0.903571428571429,5.99597077922078,151,51,100,-1,2,21,25.9,0,0,0,0,0,0,0.999988979331227,393.092135803898,99.9995539781553
24.3,"random_instances_SVM","SVM",8,28,10433,10028,405,2900,2796,104,0.995635666196964,0.903571428571429,5.99597077922078,155,52,103,4,2,21.75,26.9,0,0,0,0,0,0,0.999998146216813,397.681141718472,99.9999291125956
24.3,"random_instances_SVM","SVM",8,29,10333,9933,400,3000,2891,109,0.995439396989429,0.917857142857143,6.01761688311688,154,53,101,-1,1.9,22.5,26.5,0,0,0,0,0,0,0.999994657737181,391.852044190139,99.99978898851
24.3,"random_instances_SVM","SVM",8,30,10233,9836,397,3100,2988,112,0.9957161868975,0.921428571428571,6.01761688311688,156,52,104,2,2,23.25,26.7,0,0,0,0,0,0,0.999998320904035,392.862659108103,99.9999366582097
24.3,"random_instances_SVM","SVM",8,31,10133,9738,395,3200,3086,114,0.996279831801207,0.921428571428571,6.01215129103413,145,52,93,-11,1.8,24,27.1,0,0,0,0,0,0,0.999991130866891,384.807373265373,99.9996102087088
24.3,"random_instances_SVM","SVM",8,32,10033,9640,393,3300,3184,116,0.996327361381381,0.921428571428571,6.01215129103413,146,52,94,1,1.8,24.75,27.4,0,0,0,0,0,0,0.999997141527807,382.565793830355,99.9998823996523
24.3,"random_instances_SVM","SVM",8,33,9933,9546,387,3400,3278,122,0.995939855510079,0.921428571428571,6.0285779339058,160,53,107,14,2,25.5,26.9,0,0,0,0,0,0,0.999998167021672,382.459908653117,99.9999259524871
24.3,"random_instances_SVM","SVM",8,34,9833,9457,376,3500,3367,133,0.997937775391981,0.921428571428571,6.07194899817851,165,56,109,5,1.9,26.25,25.3,0,0,0,0,0,0,0.999999334196927,377.716083789588,99.9999763221046
24.3,"random_instances_SVM","SVM",8,35,9733,9362,371,3600,3462,138,0.998376725044175,0.925,6.04990925589837,171,57,114,6,2,27,25.1,0,0,0,0,0,0,0.99999830591663,374.280002127894,99.9999389751433
24.3,"random_instances_SVM","SVM",8,36,9633,9267,366,3700,3557,143,0.998430405511194,0.928571428571429,6.04442429737081,172,58,114,1,2,27.75,24.9,0,0,0,0,0,0,0.999999599827878,368.503275667926,99.9999872807175
24.3,"random_instances_SVM","SVM",8,37,9533,9171,362,3800,3653,147,0.998475139233711,0.928571428571429,6.03894927536232,172,58,114,0,2,28.5,24.9,0,0,0,0,0,0,0.999998789850125,360.950539122766,99.9999588780011
24.3,"random_instances_SVM","SVM",8,38,9433,9077,356,3900,3747,153,0.998409156993,0.925,6.03348416289593,169,62,107,-3,1.7,29.25,24.5,0,0,0,0,0,0,0.999998272574278,358.132374414326,99.9999454240882
24.3,"random_instances_SVM","SVM",8,39,9333,8982,351,4000,3842,158,0.998430964682727,0.925,6.02802893309222,169,61,108,0,1.8,30,24.3,0,0,0,0,0,0,0.99999959263362,355.245900073861,99.9999869680985
24.3,"random_instances_SVM","SVM",8,40,9233,8886,347,4100,3938,162,0.998560692478025,0.925,6.00630630630631,174,64,110,5,1.7,30.75,24.3,0,0,0,0,0,0,0.999999791641324,352.015369416027,99.9999934944369
24.3,"random_instances_SVM","SVM",8,41,9133,8790,343,4200,4034,166,0.998568800465231,0.928571428571429,6.00630630630631,174,64,110,0,1.7,31.5,24.3,0,0,0,0,0,0,0.999999930952546,349.748027776115,99.9999979115184
24.3,"random_instances_SVM","SVM",8,42,9033,8692,341,4300,4132,168,0.99868930193026,0.932142857142857,6.02802893309222,188,68,120,14,1.8,32.25,24.6,0,0,0,0,0,0,0.99999966065622,343.439396903756,99.9999898449821
24.3,"random_instances_SVM","SVM",8,43,8933,8598,335,4400,4226,174,0.998908497170593,0.935714285714286,6.01714801444043,189,70,119,1,1.7,33,24.3,0,0,0,0,0,0,0.999999969098616,343.461501666901,99.9999991333128
24.3,"random_instances_SVM","SVM",8,44,8833,8500,333,4500,4324,176,0.998977275268963,0.935714285714286,6.03894927536232,196,71,125,7,1.8,33.75,24.6,0,0,0,0,0,0,0.9999998643135,341.068890112418,99.9999957255354
24.3,"random_instances_SVM","SVM",8,45,8733,8405,328,4600,4419,181,0.998999082958689,0.939285714285714,6.03348416289593,201,74,127,5,1.7,34.5,24.4,0,0,0,0,0,0,0.99999966598325,332.626591113418,99.9999890821668
24.3,"random_instances_SVM","SVM",8,46,8633,8306,327,4700,4518,182,0.999071775257778,0.939285714285714,6.03348416289593,204,76,128,3,1.7,35.25,24.8,0,0,0,0,0,0,0.999999795335731,328.246786698897,99.9999927312919
24.3,"random_instances_SVM","SVM",8,47,8533,8210,323,4800,4614,186,0.99907233442931,0.939285714285714,6.03348416289593,204,76,128,0,1.7,36,24.8,0,0,0,0,0,0,0.999999986338848,326.452073914488,99.9999995750051
24.3,"random_instances_SVM","SVM",8,48,8433,8114,319,4900,4710,190,0.999058914312555,0.939285714285714,6.03348416289593,202,76,126,-2,1.7,36.75,24.8,0,0,0,0,0,0,0.999999931795566,320.04786138303,99.9999977736048
24.3,"random_instances_SVM","SVM",9,0,13233,12708,525,100,95,5,0.945403067594112,0.83011583011583,5.19776507276507,25,5,20,0,4,0.75,19,0,0,0,0,0,0,0.956127517267753,600.756489105308,97.9276055234198
24.3,"random_instances_SVM","SVM",9,1,13133,12611,522,200,192,8,0.968190100212574,0.857142857142857,5.4120427848343,41,8,33,16,4.1,1.5,24,0,0,0,0,0,0,0.995582133785412,601.23951656151,99.9181611964316
24.3,"random_instances_SVM","SVM",9,2,13033,12516,517,300,287,13,0.97679662005506,0.868725868725869,5.61586965415995,50,12,38,9,3.2,2.25,22.1,0,0,0,0,0,0,0.995520408056447,598.484009526136,99.8432109732496
24.3,"random_instances_SVM","SVM",9,3,12933,12419,514,400,384,16,0.973999079336158,0.864864864864865,5.61586965415995,52,14,38,2,2.7,3,24,0,0,0,0,0,0,0.996494969696975,534.908440971554,99.9179263674305
24.3,"random_instances_SVM","SVM",9,4,12833,12324,509,500,479,21,0.969715100333071,0.876447876447876,5.45889418382764,71,19,52,19,2.7,3.75,22.8,0,0,0,0,0,0,0.991961460217604,522.460203159371,99.4444632478869
24.3,"random_instances_SVM","SVM",9,5,12733,12229,504,600,574,26,0.962410042466228,0.888030888030888,5.37606177606178,74,24,50,3,2.1,4.5,22.1,0,0,0,0,0,0,0.98901371960382,540.219715642655,99.2017909594757
24.3,"random_instances_SVM","SVM",9,6,12633,12131,502,700,672,28,0.962057563181185,0.891891891891892,5.27797550560365,75,25,50,1,2,5.25,24,0,0,0,0,0,0,0.991346125448834,512.732592603102,99.440469061677
24.3,"random_instances_SVM","SVM",9,7,12533,12033,500,800,770,30,0.962037077205629,0.884169884169884,5.31491671649152,77,25,52,2,2.1,6,25.7,0,0,0,0,0,0,0.991100688103736,512.903912023754,99.4061293895794
24.3,"random_instances_SVM","SVM",9,8,12433,11935,498,900,868,32,0.961609884362696,0.888030888030888,5.28256504952157,76,25,51,-1,2,6.75,27.1,0,0,0,0,0,0,0.991567276069412,495.157224766191,99.4576089630118
24.3,"random_instances_SVM","SVM",9,9,12333,11837,496,1000,966,34,0.963998910628132,0.888030888030888,5.32346520042855,82,25,57,6,2.3,7.5,28.4,0,0,0,0,0,0,0.99340980562424,474.246915244204,99.5929086576898
24.3,"random_instances_SVM","SVM",9,10,12233,11744,489,1100,1059,41,0.960641620753985,0.895752895752896,5.35527310527311,95,30,65,13,2.2,8.25,25.8,0,0,0,0,0,0,0.996948075532465,518.944338074544,99.9221041220914
24.3,"random_instances_SVM","SVM",9,11,12133,11647,486,1200,1156,44,0.97618324584616,0.891891891891892,5.47880183236384,101,33,68,6,2.1,9,26.3,0,0,0,0,0,0,0.995544125632722,504.836854867583,99.7892909717175
24.3,"random_instances_SVM","SVM",9,12,12033,11551,482,1300,1252,48,0.977936001812406,0.891891891891892,5.45959481454661,109,34,75,8,2.2,9.75,26.1,0,0,0,0,0,0,0.997299195543873,508.489407197979,99.9624949816388
24.3,"random_instances_SVM","SVM",9,13,11933,11455,478,1400,1348,52,0.984379744913455,0.888030888030888,5.64161867533651,125,39,86,16,2.2,10.5,25.9,0,0,0,0,0,0,0.996602932617563,513.499812250325,99.9044315605022
24.3,"random_instances_SVM","SVM",9,14,11833,11356,477,1500,1447,53,0.98487592729165,0.884169884169884,5.64442578235682,130,40,90,5,2.2,11.25,27.3,0,0,0,0,0,0,0.999990911628263,516.639671309417,99.9995959426835
24.3,"random_instances_SVM","SVM",9,15,11733,11259,474,1600,1544,56,0.987452641244771,0.884169884169884,5.67722486500166,134,40,94,4,2.4,12,27.6,0,0,0,0,0,0,0.996608382303769,502.708322376753,99.8992879460266
24.3,"random_instances_SVM","SVM",9,16,11633,11162,471,1700,1641,59,0.988186822456481,0.888030888030888,5.75883816045541,142,44,98,8,2.2,12.75,27.8,0,0,0,0,0,0,0.999996643647822,519.482100384725,99.9998582657382
24.3,"random_instances_SVM","SVM",9,17,11533,11068,465,1800,1735,65,0.989211723762278,0.888030888030888,5.87573443008226,136,42,94,-6,2.2,13.5,26.7,0,0,0,0,0,0,0.996679749802933,498.916985929074,99.8930833796695
24.3,"random_instances_SVM","SVM",9,18,11433,10972,461,1900,1831,69,0.988398912556214,0.888030888030888,5.85772393297325,136,45,91,0,2,14.25,26.5,0,0,0,0,0,0,0.999994946294563,496.477806011972,99.9997831694727
24.3,"random_instances_SVM","SVM",9,19,11333,10876,457,2000,1927,73,0.990073942321125,0.888030888030888,5.90439902407264,132,46,86,-4,1.9,15,26.4,0,0,0,0,0,0,0.999990496089039,489.650352903014,99.9995945670814
24.3,"random_instances_SVM","SVM",9,20,11233,10781,452,2100,2022,78,0.989625660973966,0.888030888030888,5.86510923219784,138,50,88,6,1.8,15.75,25.9,0,0,0,0,0,0,0.999990526992982,480.269019314166,99.9995830329268
24.3,"random_instances_SVM","SVM",9,21,11133,10685,448,2200,2118,82,0.99010527381313,0.888030888030888,5.88306424891791,136,50,86,-2,1.7,16.5,25.8,0,0,0,0,0,0,0.999997396350639,471.580796064665,99.9998976626065
24.3,"random_instances_SVM","SVM",9,22,11033,10590,443,2300,2213,87,0.991871887939296,0.888030888030888,5.9009868558605,133,52,81,-3,1.6,17.25,25.4,0,0,0,0,0,0,0.999995792239701,469.385164380942,99.9998324599129
24.3,"random_instances_SVM","SVM",9,23,10933,10495,438,2400,2308,92,0.992275582163219,0.888030888030888,5.9009868558605,135,51,84,2,1.6,18,25.1,0,0,0,0,0,0,0.999995262701481,459.839953757073,99.9998157529034
24.3,"random_instances_SVM","SVM",9,24,10833,10400,433,2500,2403,97,0.994390457873603,0.891891891891892,5.92421908757649,140,53,87,5,1.6,18.75,24.8,0,0,0,0,0,0,0.999997226920667,459.741679776832,99.9999012404833
24.3,"random_instances_SVM","SVM",9,25,10733,10303,430,2600,2500,100,0.994185598118176,0.891891891891892,5.94745131929247,142,52,90,2,1.7,19.5,25,0,0,0,0,0,0,0.999999172300877,451.810906812548,99.9999705345561
24.3,"random_instances_SVM","SVM",9,26,10633,10208,425,2700,2595,105,0.994048824104995,0.891891891891892,5.90631746729308,150,53,97,8,1.8,20.25,24.7,0,0,0,0,0,0,0.999999217814074,446.860740554005,99.9999685859261
24.3,"random_instances_SVM","SVM",9,27,10533,10112,421,2800,2691,109,0.995916964315836,0.895752895752896,5.94386107324113,154,56,98,4,1.8,21,24.7,0,0,0,0,0,0,0.999999487753427,447.461256808051,99.9999813388183
24.3,"random_instances_SVM","SVM",9,28,10433,10014,419,2900,2789,111,0.995873883514324,0.8996138996139,5.949206272048,156,58,98,2,1.7,21.75,25.1,0,0,0,0,0,0,0.999998118570339,440.245694536354,99.9999279003972
24.3,"random_instances_SVM","SVM",9,29,10333,9917,416,3000,2886,114,0.996002824654502,0.8996138996139,5.94386107324113,158,58,100,2,1.7,22.5,25.3,0,0,0,0,0,0,0.999999855127046,433.896020593636,99.9999948777111
24.3,"random_instances_SVM","SVM",9,30,10233,9818,415,3100,2985,115,0.99555876100819,0.8996138996139,5.93852547084145,165,58,107,7,1.8,23.25,26,0,0,0,0,0,0,0.999999755812792,431.40731714628,99.9999909533116
24.3,"random_instances_SVM","SVM",9,31,10133,9722,411,3200,3081,119,0.99671139839679,0.8996138996139,5.9885109894127,166,60,106,1,1.8,24,25.9,0,0,0,0,0,0,0.999999913562545,431.926487460949,99.9999966904051
24.3,"random_instances_SVM","SVM",9,32,10033,9628,405,3300,3175,125,0.997136783653641,0.8996138996139,5.9885109894127,166,61,105,0,1.7,24.75,25.4,0,0,0,0,0,0,0.999999614711639,419.54566778757,99.9999843903974
24.3,"random_instances_SVM","SVM",9,33,9933,9532,401,3400,3271,129,0.997401293749614,0.8996138996139,5.97773059159198,164,60,104,-2,1.7,25.5,25.4,0,0,0,0,0,0,0.99999973179574,412.890041665464,99.9999901502635
24.3,"random_instances_SVM","SVM",9,34,9833,9434,399,3500,3369,131,0.997568194197413,0.903474903474903,5.97773059159198,163,60,103,-1,1.7,26.25,25.7,0,0,0,0,0,0,0.999999063917553,410.056037037933,99.9999632806224
24.3,"random_instances_SVM","SVM",9,35,9733,9336,397,3600,3467,133,0.997348271224681,0.903474903474903,5.98311593446729,165,61,104,2,1.7,27,26.1,0,0,0,0,0,0,0.999999981847777,410.329894520521,99.9999993897702
24.3,"random_instances_SVM","SVM",9,36,9633,9242,391,3700,3561,139,0.997496493283015,0.907335907335907,5.98311593446729,168,62,106,3,1.7,27.75,25.6,0,0,0,0,0,0,0.999999935161513,399.633782169938,99.9999976672908
24.3,"random_instances_SVM","SVM",9,37,9533,9146,387,3800,3657,143,0.997328990306524,0.903474903474903,5.98311593446729,169,64,105,1,1.6,28.5,25.6,0,0,0,0,0,0,0.999999986176165,396.738843355341,99.9999995226676
24.3,"random_instances_SVM","SVM",9,38,9433,9053,380,3900,3750,150,0.997594102931186,0.903474903474903,5.99391578272445,173,64,109,4,1.7,29.25,25,0,0,0,0,0,0,0.999999922565087,387.421038317697,99.999997111264
24.3,"random_instances_SVM","SVM",9,39,9333,8957,376,4000,3846,154,0.997630254652731,0.911196911196911,5.9885109894127,176,66,110,3,1.7,30,25,0,0,0,0,0,0,0.99999983098645,384.206526154521,99.9999933753922
24.3,"random_instances_SVM","SVM",9,40,9233,8861,372,4100,3942,158,0.997181370776881,0.907335907335907,5.9885109894127,180,67,113,4,1.7,30.75,24.9,0,0,0,0,0,0,0.999999983019174,380.56136834932,99.9999993851225
24.3,"random_instances_SVM","SVM",9,41,9133,8764,369,4200,4039,161,0.997190408707267,0.907335907335907,5.9885109894127,182,67,115,2,1.7,31.5,25.1,0,0,0,0,0,0,0.999999931897079,378.902101817706,99.99999744763
24.3,"random_instances_SVM","SVM",9,42,9033,8669,364,4300,4134,166,0.997204869395885,0.911196911196911,5.9885109894127,182,68,114,0,1.7,32.25,24.9,0,0,0,0,0,0,0.999999975275246,375.242449739409,99.9999991195718
24.3,"random_instances_SVM","SVM",9,43,8933,8570,363,4400,4233,167,0.99725608433474,0.911196911196911,5.9885109894127,182,67,115,0,1.7,33,25.3,0,0,0,0,0,0,0.99999998083889,371.594342625681,99.9999993202115
24.3,"random_instances_SVM","SVM",9,44,8833,8473,360,4500,4330,170,0.997339233294294,0.911196911196911,5.98311593446729,186,69,117,4,1.7,33.75,25.5,0,0,0,0,0,0,0.99999998939999,364.519512120473,99.9999996449686
24.3,"random_instances_SVM","SVM",9,45,8733,8376,357,4600,4427,173,0.99696265286153,0.911196911196911,5.98311593446729,184,72,112,-2,1.6,34.5,25.6,0,0,0,0,0,0,0.999999964046977,365.734868757646,99.9999986736031
24.3,"random_instances_SVM","SVM",9,46,8633,8279,354,4700,4524,176,0.996402301177579,0.907335907335907,5.95456109317495,187,71,116,3,1.6,35.25,25.7,0,0,0,0,0,0,0.999999949098458,360.27837998608,99.9999981619809
24.3,"random_instances_SVM","SVM",9,47,8533,8183,350,4800,4620,180,0.996713205982868,0.907335907335907,5.97235493458515,186,71,115,-1,1.6,36,25.7,0,0,0,0,0,0,0.999999944284634,357.51952492907,99.9999979229026
24.3,"random_instances_SVM","SVM",9,48,8433,8087,346,4900,4716,184,0.997493480639552,0.907335907335907,5.97773059159198,192,73,119,6,1.6,36.75,25.6,0,0,0,0,0,0,0.99999998954803,353.210822662052,99.9999996042012
24.3,"random_instances_SVM","SVM",10,0,13233,12711,522,100,93,7,0.958578357805768,0.776923076923077,5.21423686348862,33,7,26,0,3.7,0.75,13.3,0,0,0,0,0,0,0.962589649590734,747.03913895103,97.567867623861
24.3,"random_instances_SVM","SVM",10,1,13133,12614,519,200,190,10,0.950199601397497,0.8,5.16423110455368,41,9,32,8,3.6,1.5,19,0,0,0,0,0,0,0.974162597375528,521.806843024962,98.4854364908955
24.3,"random_instances_SVM","SVM",10,2,13033,12519,514,300,285,15,0.950459833595455,0.819230769230769,5.17777366863905,45,10,35,4,3.5,2.25,19,0,0,0,0,0,0,0.980983831137341,469.865273627785,98.8308297295959
24.3,"random_instances_SVM","SVM",10,3,12933,12421,512,400,383,17,0.948039404017244,0.823076923076923,5.15066267066267,46,12,34,1,2.8,3,22.5,0,0,0,0,0,0,0.987846437769649,448.214413301248,99.2937547902722
24.3,"random_instances_SVM","SVM",10,4,12833,12327,506,500,477,23,0.989314571802475,0.838461538461538,5.81953082378614,58,15,43,12,2.9,3.75,20.7,0,0,0,0,0,0,0.984667825366082,481.935541256794,99.1500416767945
24.3,"random_instances_SVM","SVM",10,5,12733,12233,500,600,571,29,0.988845733632692,0.838461538461538,5.85912944582299,61,17,44,3,2.6,4.5,19.7,0,0,0,0,0,0,0.989275409128391,477.970172168204,99.4568829694842
24.3,"random_instances_SVM","SVM",10,6,12633,12137,496,700,667,33,0.986934362656237,0.853846153846154,5.79019851116625,71,18,53,10,2.9,5.25,20.2,0,0,0,0,0,0,0.991079810297344,474.20881700008,99.4729200783463
24.3,"random_instances_SVM","SVM",10,7,12533,12041,492,800,763,37,0.986600593101302,0.853846153846154,5.80277624879593,74,18,56,3,3.1,6,20.6,0,0,0,0,0,0,0.993500940813404,466.570441777119,99.6408748380015
24.3,"random_instances_SVM","SVM",10,8,12433,11945,488,900,859,41,0.987401700063632,0.861538461538462,5.77467519076098,83,21,62,9,3,6.75,21,0,0,0,0,0,0,0.997480384718353,506.57283046558,99.9967328448225
24.3,"random_instances_SVM","SVM",10,9,12333,11848,485,1000,956,44,0.977843944723924,0.857692307692308,5.59342977489297,88,22,66,5,3,7.5,21.7,0,0,0,0,0,0,0.997038015883256,505.000671035091,99.9576551184652
24.3,"random_instances_SVM","SVM",10,10,12233,11750,483,1100,1054,46,0.974179683279106,0.865384615384615,5.58545316070069,90,24,66,2,2.8,8.25,22.9,0,0,0,0,0,0,0.997253590662467,502.541729715854,99.9680212763269
24.3,"random_instances_SVM","SVM",10,11,12133,11656,477,1200,1148,52,0.988291652159299,0.865384615384615,5.86769923769924,104,28,76,14,2.7,9,22.1,0,0,0,0,0,0,0.999980903058915,516.966746819782,99.9992531199895
24.3,"random_instances_SVM","SVM",10,12,12033,11563,470,1300,1241,59,0.98760610390079,0.865384615384615,5.81838909968955,118,29,89,14,3.1,9.75,21,0,0,0,0,0,0,0.999996899439981,506.485032810081,99.9998800523545
24.3,"random_instances_SVM","SVM",10,13,11933,11465,468,1400,1339,61,0.988163787203908,0.865384615384615,5.80580551523948,107,31,76,-11,2.5,10.5,22,0,0,0,0,0,0,0.999995286818619,497.112428671932,99.9998239046122
24.3,"random_instances_SVM","SVM",10,14,11833,11370,463,1500,1434,66,0.992091582523921,0.865384615384615,5.90857855016271,107,32,75,0,2.3,11.25,21.7,0,0,0,0,0,0,0.99999664844591,494.332482354322,99.9998735153561
24.3,"random_instances_SVM","SVM",10,15,11733,11273,460,1600,1531,69,0.99118632265191,0.865384615384615,5.88549816520113,111,36,75,4,2.1,12,22.2,0,0,0,0,0,0,0.999995747742009,481.570356900315,99.9998378488358
24.3,"random_instances_SVM","SVM",10,16,11633,11174,459,1700,1630,70,0.991497280618556,0.865384615384615,5.86769923769924,114,37,77,3,2.1,12.75,23.3,0,0,0,0,0,0,0.999996143336512,476.678508383658,99.9998585909504
24.3,"random_instances_SVM","SVM",10,17,11533,11076,457,1800,1728,72,0.991742805345117,0.865384615384615,5.86043707872976,122,39,83,8,2.1,13.5,24,0,0,0,0,0,0,0.99998857257871,477.456754820585,99.999558296208
24.3,"random_instances_SVM","SVM",10,18,11433,10979,454,1900,1825,75,0.989262945576353,0.865384615384615,5.87299021987931,124,39,85,2,2.2,14.25,24.3,0,0,0,0,0,0,0.997231163076568,457.544957072504,99.9756450317423
24.3,"random_instances_SVM","SVM",10,19,11333,10886,447,2000,1918,82,0.989352991319593,0.865384615384615,5.84138668506382,119,40,79,-5,2,15,23.4,0,0,0,0,0,0,0.999987991817983,449.902398820564,99.9995494792765
24.3,"random_instances_SVM","SVM",10,20,11233,10789,444,2100,2015,85,0.989254541306983,0.865384615384615,5.88360086164964,120,41,79,1,1.9,15.75,23.7,0,0,0,0,0,0,0.999986995595652,445.028825604718,99.9995136589281
24.3,"random_instances_SVM","SVM",10,21,11133,10691,442,2200,2113,87,0.988373593785652,0.865384615384615,5.86573584643205,125,40,85,5,2.1,16.5,24.3,0,0,0,0,0,0,0.99998775224218,427.869970762748,99.9995207471152
24.3,"random_instances_SVM","SVM",10,22,11033,10596,437,2300,2208,92,0.990739995917926,0.873076923076923,5.89080041580042,122,41,81,-3,2,17.25,24,0,0,0,0,0,0,0.999993492927014,434.984335097032,99.9997386397543
24.3,"random_instances_SVM","SVM",10,23,10933,10500,433,2400,2304,96,0.994125415711181,0.880769230769231,5.93700277200277,135,47,88,13,1.9,18,24,0,0,0,0,0,0,0.999990117901343,432.75022225959,99.9995899596696
24.3,"random_instances_SVM","SVM",10,24,10833,10403,430,2500,2401,99,0.994446578862062,0.876923076923077,5.93700277200277,132,46,86,-3,1.9,18.75,24.3,0,0,0,0,0,0,0.999986680638998,423.615780559072,99.9994468369699
24.3,"random_instances_SVM","SVM",10,25,10733,10311,422,2600,2493,107,0.994870394160236,0.876923076923077,5.94771938350458,134,47,87,2,1.9,19.5,23.3,0,0,0,0,0,0,0.999994244553106,417.043458044077,99.9997727908601
24.3,"random_instances_SVM","SVM",10,26,10633,10218,415,2700,2586,114,0.995730631160636,0.880769230769231,5.97625599332916,136,47,89,2,1.9,20.25,22.7,0,0,0,0,0,0,0.999996878219531,417.383156074175,99.999874868291
24.3,"random_instances_SVM","SVM",10,27,10533,10120,413,2800,2684,116,0.996398770575455,0.884615384615385,5.99249581939799,132,49,83,-4,1.7,21,23.1,0,0,0,0,0,0,0.99999051025771,408.171221046809,99.9996216231918
24.3,"random_instances_SVM","SVM",10,28,10433,10023,410,2900,2781,119,0.996697122138049,0.892307692307692,5.99792872585257,143,52,91,11,1.8,21.75,23.4,0,0,0,0,0,0,0.999998687618765,412.862838681281,99.9999477889041
24.3,"random_instances_SVM","SVM",10,29,10333,9926,407,3000,2878,122,0.996704325797508,0.896153846153846,5.99249581939799,141,54,87,-2,1.6,22.5,23.6,0,0,0,0,0,0,0.999998495050672,406.770858788982,99.9999443835101
24.3,"random_instances_SVM","SVM",10,30,10233,9826,407,3100,2978,122,0.996789569101106,0.9,5.96010395010395,138,51,87,-3,1.7,23.25,24.4,0,0,0,0,0,0,0.999999365702432,402.517707588601,99.9999763246739
24.3,"random_instances_SVM","SVM",10,31,10133,9732,401,3200,3072,128,0.996766757512819,0.9,5.96010395010395,142,52,90,4,1.7,24,24,0,0,0,0,0,0,0.999997034432393,395.023283147759,99.999889553188
24.3,"random_instances_SVM","SVM",10,32,10033,9641,392,3300,3163,137,0.996958855098391,0.9,5.99249581939799,143,53,90,1,1.7,24.75,23.1,0,0,0,0,0,0,0.999997223073278,386.451855955609,99.9998927706277
24.3,"random_instances_SVM","SVM",10,33,9933,9545,388,3400,3259,141,0.997703233242487,0.9,6.03894927536232,152,56,96,9,1.7,25.5,23.1,0,0,0,0,0,0,0.999996475712396,381.020710827049,99.9998712213422
24.3,"random_instances_SVM","SVM",10,34,9833,9447,386,3500,3357,143,0.997668415555101,0.9,6.03894927536232,155,56,99,3,1.8,26.25,23.5,0,0,0,0,0,0,0.999999124825269,384.523833822675,99.9999687594105
24.3,"random_instances_SVM","SVM",10,35,9733,9348,385,3600,3456,144,0.997688825923569,0.9,6.01572254738016,154,57,97,-1,1.7,27,24,0,0,0,0,0,0,0.9999998335121,383.373741145535,99.9999940821798
24.3,"random_instances_SVM","SVM",10,36,9633,9254,379,3700,3550,150,0.997700832022667,0.9,6.03348416289593,154,57,97,0,1.7,27.75,23.7,0,0,0,0,0,0,0.999999670479756,375.391744274962,99.9999883368827
24.3,"random_instances_SVM","SVM",10,37,9533,9157,376,3800,3647,153,0.99747031491998,0.903846153846154,5.99249581939799,152,57,95,-2,1.7,28.5,23.8,0,0,0,0,0,0,0.999999362751482,367.113366935986,99.9999776639626
24.3,"random_instances_SVM","SVM",10,38,9433,9062,371,3900,3742,158,0.997449304246558,0.903846153846154,6.00337149239146,159,60,99,7,1.6,29.25,23.7,0,0,0,0,0,0,0.999999885308595,364.084835988959,99.9999961375587
24.3,"random_instances_SVM","SVM",10,39,9333,8965,368,4000,3839,161,0.997518339316373,0.903846153846154,5.97625599332916,161,60,101,2,1.7,30,23.8,0,0,0,0,0,0,0.99999785560865,357.425763336218,99.9999221520894
24.3,"random_instances_SVM","SVM",10,40,9233,8870,363,4100,3934,166,0.997289623128549,0.9,6.00337149239146,166,59,107,5,1.8,30.75,23.7,0,0,0,0,0,0,0.999996319683319,357.908884768422,99.9998605840274
24.3,"random_instances_SVM","SVM",10,41,9133,8773,360,4200,4031,169,0.997341249354671,0.9,6.02664037414491,165,60,105,-1,1.8,31.5,23.9,0,0,0,0,0,0,0.999999556497183,353.097149110945,99.9999835083924
24.3,"random_instances_SVM","SVM",10,42,9033,8679,354,4300,4125,175,0.998243507701913,0.9,6.04990925589837,171,61,110,6,1.8,32.25,23.6,0,0,0,0,0,0,0.999999756190996,350.899785226387,99.9999908641223
24.3,"random_instances_SVM","SVM",10,43,8933,8584,349,4400,4220,180,0.998250111056417,0.9,6.04990925589837,178,66,112,7,1.7,33,23.4,0,0,0,0,0,0,0.999999723175457,343.482378180311,99.9999904088492
24.3,"random_instances_SVM","SVM",10,44,8833,8486,347,4500,4318,182,0.998256114105967,0.903846153846154,6.04990925589837,177,63,114,-1,1.8,33.75,23.7,0,0,0,0,0,0,0.999999387288168,336.559576593066,99.9999779325332
24.3,"random_instances_SVM","SVM",10,45,8733,8391,342,4600,4413,187,0.998196083610475,0.9,6.04990925589837,179,65,114,2,1.8,34.5,23.6,0,0,0,0,0,0,0.99999968101127,336.364245160332,99.9999886033329
24.3,"random_instances_SVM","SVM",10,46,8633,8295,338,4700,4509,191,0.998172671717233,0.9,6.04990925589837,180,65,115,1,1.8,35.25,23.6,0,0,0,0,0,0,0.999999750378114,331.715716453206,99.9999913224087
24.3,"random_instances_SVM","SVM",10,47,8533,8198,335,4800,4606,194,0.998064616825348,0.9,6.05540417801998,181,65,116,1,1.8,36,23.7,0,0,0,0,0,0,0.999999861893669,331.501146824246,99.9999958079913
24.3,"random_instances_SVM","SVM",10,48,8433,8103,330,4900,4701,199,0.998456615960909,0.903846153846154,6.04990925589837,182,66,116,1,1.8,36.75,23.6,0,0,0,0,0,0,0.99999993246308,325.807561793924,99.9999980180782
24.3,"random_instances_SVM","SVM",11,0,13233,12705,528,100,94,6,0.941334874561134,0.745098039215686,5.40442643059037,26,6,20,0,3.3,0.75,15.7,0,0,0,0,0,0,0.956448981316428,646.159751095374,98.0534536442741
24.3,"random_instances_SVM","SVM",11,1,13133,12608,525,200,191,9,0.959773953249402,0.847058823529412,5.26104334997341,33,9,24,7,2.7,1.5,21.2,0,0,0,0,0,0,0.995396301174571,562.530549082865,99.7980718266887
24.3,"random_instances_SVM","SVM",11,2,13033,12512,521,300,287,13,0.957387496483293,0.831372549019608,5.09436674240512,43,12,31,10,2.6,2.25,22.1,0,0,0,0,0,0,0.99999247050499,495.976718712708,99.9997367111286
24.3,"random_instances_SVM","SVM",11,3,12933,12413,520,400,386,14,0.951406676207559,0.831372549019608,5.21535492245679,42,13,29,-1,2.2,3,27.6,0,0,0,0,0,0,0.999996963798129,447.399732329457,99.9999061371374
24.3,"random_instances_SVM","SVM",11,4,12833,12322,511,500,477,23,0.952746688194902,0.831372549019608,5.27008520685761,48,18,30,6,1.7,3.75,20.7,0,0,0,0,0,0,0.995442691283036,422.010790056509,99.8457022375641
24.3,"random_instances_SVM","SVM",11,5,12733,12223,510,600,576,24,0.952445781806123,0.83921568627451,5.21541417954866,53,18,35,5,1.9,4.5,24,0,0,0,0,0,0,0.994097434460805,413.936392432272,99.6896691105023
24.3,"random_instances_SVM","SVM",11,6,12633,12127,506,700,672,28,0.954745391606387,0.843137254901961,5.27008520685761,53,19,34,0,1.8,5.25,24,0,0,0,0,0,0,0.997156061767716,438.837685299107,99.9611906796253
24.3,"random_instances_SVM","SVM",11,7,12533,12032,501,800,767,33,0.963592161755512,0.83921568627451,5.44207089390229,57,21,36,4,1.7,6,23.2,0,0,0,0,0,0,0.999992842762802,437.607545652989,99.9996797603209
24.3,"random_instances_SVM","SVM",11,8,12433,11938,495,900,861,39,0.960904798600671,0.854901960784314,5.39026690852552,61,23,38,4,1.7,6.75,22.1,0,0,0,0,0,0,0.996275860769915,422.165072544234,99.8622037613381
24.3,"random_instances_SVM","SVM",11,9,12333,11845,488,1000,954,46,0.960055900089295,0.87843137254902,5.36309703368527,64,26,38,3,1.5,7.5,20.7,0,0,0,0,0,0,0.995508252478435,423.337741674004,99.7678793582621
24.3,"random_instances_SVM","SVM",11,10,12233,11749,484,1100,1050,50,0.959079789120888,0.886274509803922,5.3678431372549,67,27,40,3,1.5,8.25,21,0,0,0,0,0,0,0.995842620483028,426.09499665611,99.8244233722286
24.3,"random_instances_SVM","SVM",11,11,12133,11653,480,1200,1146,54,0.961203870194359,0.886274509803922,5.38213198322807,70,26,44,3,1.7,9,21.2,0,0,0,0,0,0,0.996759642114845,427.751355477456,99.9195231733269
24.3,"random_instances_SVM","SVM",11,12,12033,11558,475,1300,1241,59,0.963221533154742,0.886274509803922,5.40533082798337,76,28,48,6,1.7,9.75,21,0,0,0,0,0,0,0.995097756405811,427.568769495013,99.7659797071173
24.3,"random_instances_SVM","SVM",11,13,11933,11463,470,1400,1336,64,0.96034518610937,0.886274509803922,5.37802105704259,77,29,48,1,1.7,10.5,20.9,0,0,0,0,0,0,0.996595782926961,425.742064441213,99.89486387299
24.3,"random_instances_SVM","SVM",11,14,11833,11367,466,1500,1432,68,0.96596455175957,0.886274509803922,5.40053886802948,89,29,60,12,2.1,11.25,21.1,0,0,0,0,0,0,0.995191248705013,425.195359157138,99.771947785469
24.3,"random_instances_SVM","SVM",11,15,11733,11272,461,1600,1527,73,0.966874610106045,0.886274509803922,5.41013129941142,91,31,60,2,1.9,12,20.9,0,0,0,0,0,0,0.996541072722628,424.60921547374,99.8834203853804
24.3,"random_instances_SVM","SVM",11,16,11633,11177,456,1700,1622,78,0.967689259109765,0.886274509803922,5.40053886802948,91,33,58,0,1.8,12.75,20.8,0,0,0,0,0,0,0.997001775034119,420.285934752972,99.9520756905089
24.3,"random_instances_SVM","SVM",11,17,11533,11080,453,1800,1719,81,0.967702714273482,0.886274509803922,5.38145569181736,94,34,60,3,1.8,13.5,21.2,0,0,0,0,0,0,0.994314329000723,408.345342144393,99.7251887163255
24.3,"random_instances_SVM","SVM",11,18,11433,10983,450,1900,1816,84,0.966779812361627,0.886274509803922,5.38621383124426,101,37,64,7,1.7,14.25,21.6,0,0,0,0,0,0,0.995429655093568,418.897766638978,99.8102813383215
24.3,"random_instances_SVM","SVM",11,19,11333,10884,449,2000,1915,85,0.965911954301373,0.886274509803922,5.36309703368527,100,37,63,-1,1.7,15,22.5,0,0,0,0,0,0,0.995912784497424,409.806794021231,99.8451258570543
24.3,"random_instances_SVM","SVM",11,20,11233,10789,444,2100,2010,90,0.964858781940725,0.886274509803922,5.37605706606017,99,38,61,-1,1.6,15.75,22.3,0,0,0,0,0,0,0.997398818321803,418.088133306718,99.9863304838136
24.3,"random_instances_SVM","SVM",11,21,11133,10694,439,2200,2105,95,0.964439225471847,0.886274509803922,5.37605706606017,99,38,61,0,1.6,16.5,22.2,0,0,0,0,0,0,0.999988000564605,411.556307757741,99.9995250432832
24.3,"random_instances_SVM","SVM",11,22,11033,10600,433,2300,2199,101,0.966996318177928,0.894117647058824,5.3666253869969,106,43,63,7,1.5,17.25,21.8,0,0,0,0,0,0,0.999986254312897,405.308635541862,99.999494963912
24.3,"random_instances_SVM","SVM",11,23,10933,10505,428,2400,2294,106,0.967444008170957,0.890196078431372,5.38078534844017,107,43,64,1,1.5,18,21.6,0,0,0,0,0,0,0.999987212397795,397.772119450773,99.9994894036861
24.3,"random_instances_SVM","SVM",11,24,10833,10408,425,2500,2391,109,0.975113451494144,0.890196078431372,5.52361226180613,113,46,67,6,1.5,18.75,21.9,0,0,0,0,0,0,0.999988478572288,397.164871128951,99.9995708447992
24.3,"random_instances_SVM","SVM",11,25,10733,10311,422,2600,2488,112,0.983138845057681,0.890196078431372,5.67963530115817,115,49,66,2,1.3,19.5,22.2,0,0,0,0,0,0,0.99998978942726,399.718181539324,99.9996347205599
24.3,"random_instances_SVM","SVM",11,26,10633,10215,418,2700,2584,116,0.983039154526447,0.890196078431372,5.66945674327078,116,48,68,1,1.4,20.25,22.3,0,0,0,0,0,0,0.999989976781024,396.240823020901,99.9996354214583
24.3,"random_instances_SVM","SVM",11,27,10533,10118,415,2800,2681,119,0.982387190684142,0.890196078431372,5.66633869375088,118,49,69,2,1.4,21,22.5,0,0,0,0,0,0,0.99998780234786,389.94921582796,99.9995428500438
24.3,"random_instances_SVM","SVM",11,28,10433,10021,412,2900,2778,122,0.979190977701135,0.890196078431372,5.64282691493864,122,48,74,4,1.5,21.75,22.8,0,0,0,0,0,0,0.999993177559715,386.588488958249,99.9997359244229
24.3,"random_instances_SVM","SVM",11,29,10333,9926,407,3000,2873,127,0.983540665174373,0.894117647058824,5.68886992693723,135,49,86,13,1.8,22.5,22.6,0,0,0,0,0,0,0.999993301505385,388.216750358988,99.9997632996206
24.3,"random_instances_SVM","SVM",11,30,10233,9834,399,3100,2965,135,0.985174244370242,0.898039215686275,5.72589477419927,138,53,85,3,1.6,23.25,22,0,0,0,0,0,0,0.999997495250338,388.600874646821,99.9999036925877
24.3,"random_instances_SVM","SVM",11,31,10133,9735,398,3200,3064,136,0.985097182978,0.898039215686275,5.72589477419927,138,53,85,0,1.6,24,22.5,0,0,0,0,0,0,0.999992979029272,385.07132202664,99.9997232241937
24.3,"random_instances_SVM","SVM",11,32,10033,9639,394,3300,3160,140,0.984234829302906,0.898039215686275,5.72589477419927,139,52,87,1,1.7,24.75,22.6,0,0,0,0,0,0,0.999996659828873,379.077887119973,99.99988218448
24.3,"random_instances_SVM","SVM",11,33,9933,9544,389,3400,3255,145,0.988063434980981,0.890196078431372,5.74955549640671,155,55,100,16,1.8,25.5,22.4,0,0,0,0,0,0,0.99999583137419,386.343082407467,99.9998437431618
24.3,"random_instances_SVM","SVM",11,34,9833,9449,384,3500,3350,150,0.988737416363927,0.894117647058824,5.79687694082158,160,56,104,5,1.9,26.25,22.3,0,0,0,0,0,0,0.999995401426831,382.745902952401,99.9998311201954
24.3,"random_instances_SVM","SVM",11,35,9733,9350,383,3600,3449,151,0.988732523577117,0.894117647058824,5.77321621861414,160,58,102,0,1.8,27,22.8,0,0,0,0,0,0,0.999987504813526,370.677834615513,99.9995033683452
24.3,"random_instances_SVM","SVM",11,36,9633,9253,380,3700,3546,154,0.99062542047387,0.894117647058824,5.86785910744388,160,61,99,0,1.6,27.75,23,0,0,0,0,0,0,0.999994654168365,373.137252613587,99.9998023199414
24.3,"random_instances_SVM","SVM",11,37,9533,9155,378,3800,3644,156,0.990067031179286,0.901960784313726,5.82580988917306,165,62,103,5,1.7,28.5,23.4,0,0,0,0,0,0,0.999995341736737,374.383995553962,99.9998222995911
24.3,"random_instances_SVM","SVM",11,38,9433,9060,373,3900,3739,161,0.990184458062703,0.898039215686275,5.87317419721512,170,65,105,5,1.6,29.25,23.2,0,0,0,0,0,0,0.999997991553462,370.086478897631,99.9999254344803
24.3,"random_instances_SVM","SVM",11,39,9333,8965,368,4000,3834,166,0.991884701478848,0.898039215686275,5.89685635123615,163,64,99,-7,1.5,30,23.1,0,0,0,0,0,0,0.999997685223919,359.787408197427,99.9999126499799
24.3,"random_instances_SVM","SVM",11,40,9233,8872,361,4100,3927,173,0.993651609115264,0.913725490196078,5.92053850525718,168,66,102,5,1.5,30.75,22.7,0,0,0,0,0,0,0.999999206953363,359.014573000789,99.9999721251975
24.3,"random_instances_SVM","SVM",11,41,9133,8775,358,4200,4024,176,0.994499896028283,0.917647058823529,5.98616271848106,174,68,106,6,1.6,31.5,22.9,0,0,0,0,0,0,0.999999346030421,360.067470695718,99.9999771141705
24.3,"random_instances_SVM","SVM",11,42,9033,8680,353,4300,4119,181,0.995728597115703,0.917647058823529,5.98075027479346,182,71,111,8,1.6,32.25,22.8,0,0,0,0,0,0,0.9999992046339,355.93491000985,99.999969207821
24.3,"random_instances_SVM","SVM",11,43,8933,8583,350,4400,4216,184,0.995712695558574,0.917647058823529,5.98075027479346,191,73,118,9,1.6,33,22.9,0,0,0,0,0,0,0.999999756971792,355.071537375677,99.9999921897727
24.3,"random_instances_SVM","SVM",11,44,8833,8487,346,4500,4312,188,0.99655975927489,0.917647058823529,6.00438960394284,194,74,120,3,1.6,33.75,22.9,0,0,0,0,0,0,0.999999937975022,352.513036223194,99.9999981279903
24.3,"random_instances_SVM","SVM",11,45,8733,8391,342,4600,4408,192,0.997667363888788,0.917647058823529,6.02802893309222,192,74,118,-2,1.6,34.5,23,0,0,0,0,0,0,0.999999805107802,349.613900539018,99.999993799512
24.3,"random_instances_SVM","SVM",11,46,8633,8299,334,4700,4500,200,0.997650850733307,0.917647058823529,6.02802893309222,191,74,117,-1,1.6,35.25,22.5,0,0,0,0,0,0,0.99999962198844,343.238055411818,99.9999880893102
24.3,"random_instances_SVM","SVM",11,47,8533,8200,333,4800,4599,201,0.997656355118467,0.917647058823529,6.03894927536232,189,75,114,-2,1.5,36,22.9,0,0,0,0,0,0,0.999999907773926,338.127152882859,99.9999970762378
24.3,"random_instances_SVM","SVM",11,48,8433,8102,331,4900,4697,203,0.99769060462613,0.917647058823529,6.03894927536232,190,75,115,1,1.5,36.75,23.1,0,0,0,0,0,0,0.999999891662255,336.746531465823,99.9999965207763
24.3,"random_instances_SVM","SVM",12,0,13233,12703,530,100,95,5,0.977571394718627,0.822834645669291,5.7617630113309,24,5,19,0,3.8,0.75,19,0,0,0,0,0,0,0.973118704684217,866.444699156909,98.3428629319048
24.3,"random_instances_SVM","SVM",12,1,13133,12606,527,200,192,8,0.975422401102062,0.866141732283465,5.7513720951698,31,8,23,7,2.9,1.5,24,0,0,0,0,0,0,0.99359527289237,581.167550911273,99.5898548855238
24.3,"random_instances_SVM","SVM",12,2,13033,12512,521,300,286,14,0.978839733759296,0.874015748031496,5.73070229428868,47,11,36,16,3.3,2.25,20.4,0,0,0,0,0,0,0.999984933580561,585.782363267822,99.9993908306814
24.3,"random_instances_SVM","SVM",12,3,12933,12415,518,400,383,17,0.984062884077691,0.862204724409449,5.70709839747144,53,14,39,6,2.8,3,22.5,0,0,0,0,0,0,0.999987749924089,528.677495447726,99.9995400812261
24.3,"random_instances_SVM","SVM",12,4,12833,12321,512,500,477,23,0.984122433393748,0.866141732283465,5.74757427263081,53,17,36,0,2.1,3.75,20.7,0,0,0,0,0,0,0.992227823144713,501.873768754016,99.5569743334548
24.3,"random_instances_SVM","SVM",12,5,12733,12222,511,600,576,24,0.984305992625679,0.866141732283465,5.67087100223583,56,17,39,3,2.3,4.5,24,0,0,0,0,0,0,0.995562429891079,493.154027103855,99.8163715661604
24.3,"random_instances_SVM","SVM",12,6,12633,12126,507,700,672,28,0.983959747117964,0.862204724409449,5.65590828191331,60,19,41,4,2.2,5.25,24,0,0,0,0,0,0,0.999993688864483,500.757127827948,99.9997396375552
24.3,"random_instances_SVM","SVM",12,7,12533,12028,505,800,770,30,0.982865758652134,0.874015748031496,5.65093823948632,66,20,46,6,2.3,6,25.7,0,0,0,0,0,0,0.999981324418196,508.82302117446,99.9991760680144
24.3,"random_instances_SVM","SVM",12,8,12433,11933,500,900,865,35,0.984831499992025,0.877952755905512,5.73367921668699,84,24,60,18,2.5,6.75,24.7,0,0,0,0,0,0,0.999994743035226,517.768979733167,99.9997956008894
24.3,"random_instances_SVM","SVM",12,9,12333,11837,496,1000,961,39,0.984168476679389,0.885826771653543,5.78547397022527,88,25,63,4,2.5,7.5,24.6,0,0,0,0,0,0,0.999991421213512,508.529990196808,99.9996646647079
24.3,"random_instances_SVM","SVM",12,10,12233,11740,493,1100,1058,42,0.984424477347326,0.877952755905512,5.7594601484167,86,26,60,-2,2.3,8.25,25.2,0,0,0,0,0,0,0.997440294027121,490.91570426583,99.9916958572689
24.3,"random_instances_SVM","SVM",12,11,12133,11644,489,1200,1154,46,0.984534367322282,0.885826771653543,5.68280362470219,85,26,59,-1,2.3,9,25.1,0,0,0,0,0,0,0.999992992495453,494.466950156015,99.9997244800592
24.3,"random_instances_SVM","SVM",12,12,12033,11550,483,1300,1248,52,0.983518345486702,0.885826771653543,5.70304513360585,96,27,69,11,2.6,9.75,24,0,0,0,0,0,0,0.999998545270954,485.146039583905,99.9999424076929
24.3,"random_instances_SVM","SVM",12,13,11933,11450,483,1400,1348,52,0.983237174489309,0.885826771653543,5.67273665636791,96,26,70,0,2.7,10.5,25.9,0,0,0,0,0,0,0.999997409886884,488.305029009432,99.9998937338032
24.3,"random_instances_SVM","SVM",12,14,11833,11352,481,1500,1446,54,0.98655229105251,0.885826771653543,5.73956955380577,95,28,67,-1,2.4,11.25,26.8,0,0,0,0,0,0,0.999999672730187,490.968637377653,99.9999880830197
24.3,"random_instances_SVM","SVM",12,15,11733,11259,474,1600,1539,61,0.986570708366737,0.885826771653543,5.74175688976378,104,32,72,9,2.2,12,25.2,0,0,0,0,0,0,0.999999475776017,482.637422993308,99.9999820416689
24.3,"random_instances_SVM","SVM",12,16,11633,11165,468,1700,1633,67,0.988721850669959,0.893700787401575,5.86442505497624,120,37,83,16,2.2,12.75,24.4,0,0,0,0,0,0,0.999999540694076,492.073999837087,99.9999827817175
24.3,"random_instances_SVM","SVM",12,17,11533,11072,461,1800,1726,74,0.987590413665158,0.901574803149606,5.832895888014,122,40,82,2,2,13.5,23.3,0,0,0,0,0,0,0.999999552747082,486.449459482785,99.9999835151566
24.3,"random_instances_SVM","SVM",12,18,11433,10976,457,1900,1822,78,0.990838613986606,0.897637795275591,5.87501065976861,135,42,93,13,2.2,14.25,23.4,0,0,0,0,0,0,0.999998859948556,484.119483450784,99.9999578867857
24.3,"random_instances_SVM","SVM",12,19,11333,10878,455,2000,1920,80,0.990803621089548,0.905511811023622,5.87501065976861,126,42,84,-9,2,15,24,0,0,0,0,0,0,0.999999451953377,475.662862914519,99.9999807198799
24.3,"random_instances_SVM","SVM",12,20,11233,10780,453,2100,2018,82,0.993934564510336,0.905511811023622,5.97303345921288,132,43,89,6,2.1,15.75,24.6,0,0,0,0,0,0,0.999999731740859,472.789150556421,99.9999900554781
24.3,"random_instances_SVM","SVM",12,21,11133,10686,447,2200,2112,88,0.993819149341092,0.913385826771654,5.96222253892472,128,44,84,-4,1.9,16.5,24,0,0,0,0,0,0,0.999999889366169,467.160572362478,99.9999961766331
24.3,"random_instances_SVM","SVM",12,22,11033,10590,443,2300,2208,92,0.993716012381338,0.917322834645669,5.96004348230313,138,45,93,10,2.1,17.25,24,0,0,0,0,0,0,0.999999870993061,471.351855327421,99.999995485673
24.3,"random_instances_SVM","SVM",12,23,10933,10495,438,2400,2303,97,0.993014312708794,0.917322834645669,5.93620330837392,134,48,86,-4,1.8,18,23.7,0,0,0,0,0,0,0.999999933800734,462.674154122019,99.9999977782722
24.3,"random_instances_SVM","SVM",12,24,10833,10399,434,2500,2399,101,0.994106459443225,0.917322834645669,5.94384771197079,130,48,82,-4,1.7,18.75,23.8,0,0,0,0,0,0,0.999999618542089,454.998882822217,99.9999859387359
24.3,"random_instances_SVM","SVM",12,25,10733,10305,428,2600,2493,107,0.993859053521939,0.917322834645669,5.88031780580273,135,50,85,5,1.7,19.5,23.3,0,0,0,0,0,0,0.999999860718371,446.06650694031,99.9999952248884
24.3,"random_instances_SVM","SVM",12,26,10633,10208,425,2700,2590,110,0.993492548968561,0.917322834645669,5.85117264325845,134,50,84,-1,1.7,20.25,23.5,0,0,0,0,0,0,0.999999857712603,435.971452976734,99.9999949375216
24.3,"random_instances_SVM","SVM",12,27,10533,10115,418,2800,2683,117,0.993036413485894,0.913385826771654,5.80440483349883,137,51,86,3,1.7,21,22.9,0,0,0,0,0,0,0.999999870636734,427.793034045388,99.9999954170401
24.3,"random_instances_SVM","SVM",12,28,10433,10018,415,2900,2780,120,0.996934745000013,0.909448818897638,5.95049459543364,147,52,95,10,1.8,21.75,23.2,0,0,0,0,0,0,0.999999957770728,429.355989173425,99.9999985978277
24.3,"random_instances_SVM","SVM",12,29,10333,9919,414,3000,2879,121,0.997057527094947,0.909448818897638,5.92924282902137,151,54,97,4,1.8,22.5,23.8,0,0,0,0,0,0,0.999999960137728,425.911149903116,99.9999986788299
24.3,"random_instances_SVM","SVM",12,30,10233,9822,411,3100,2976,124,0.997482353143412,0.909448818897638,5.89764828463938,154,55,99,3,1.8,23.25,24,0,0,0,0,0,0,0.999999618844339,420.07617505729,99.9999869067256
24.3,"random_instances_SVM","SVM",12,31,10133,9727,406,3200,3071,129,0.997405000423606,0.909448818897638,5.90814232073304,156,52,104,2,2,24,23.8,0,0,0,0,0,0,0.999999969175199,416.734776842226,99.9999989446189
24.3,"random_instances_SVM","SVM",12,32,10033,9633,400,3300,3165,135,0.997394563945537,0.921259842519685,5.93454152681317,155,53,102,-1,1.9,24.75,23.4,0,0,0,0,0,0,0.999999985931092,414.86784989839,99.999999538841
24.3,"random_instances_SVM","SVM",12,33,9933,9537,396,3400,3261,139,0.997321508599051,0.921259842519685,5.93454152681317,160,54,106,5,2,25.5,23.5,0,0,0,0,0,0,0.999999999780337,408.090062531767,99.9999999930749
24.3,"random_instances_SVM","SVM",12,34,9833,9440,393,3500,3358,142,0.997344223286615,0.925196850393701,5.92395358474927,155,57,98,-5,1.7,26.25,23.6,0,0,0,0,0,0,0.99999958989663,402.889300592252,99.9999848222143
24.3,"random_instances_SVM","SVM",12,35,9733,9345,388,3600,3453,147,0.997917001759469,0.929133858267717,5.91867376872009,165,59,106,10,1.8,27,23.5,0,0,0,0,0,0,0.999999992562485,394.084070118628,99.999999743616
24.3,"random_instances_SVM","SVM",12,36,9633,9249,384,3700,3549,151,0.997893059250958,0.925196850393701,5.92924282902137,161,57,104,-4,1.8,27.75,23.5,0,0,0,0,0,0,0.999999975812838,387.655398987726,99.9999992375752
24.3,"random_instances_SVM","SVM",12,37,9533,9151,382,3800,3647,153,0.998046536869623,0.929133858267717,5.91867376872009,164,58,106,3,1.8,28.5,23.8,0,0,0,0,0,0,0.999999996184796,384.20761717641,99.9999998819379
24.3,"random_instances_SVM","SVM",12,38,9433,9055,378,3900,3743,157,0.997917615669943,0.925196850393701,5.91340335574705,167,62,105,3,1.7,29.25,23.8,0,0,0,0,0,0,0.999999987187286,379.271710834716,99.9999995890508
24.3,"random_instances_SVM","SVM",12,39,9333,8962,371,4000,3836,164,0.998263861177653,0.925196850393701,5.92395358474927,174,63,111,7,1.8,30,23.4,0,0,0,0,0,0,0.999999950348506,371.573581392656,99.9999984561759
24.3,"random_instances_SVM","SVM",12,40,9233,8867,366,4100,3931,169,0.998248513415788,0.925196850393701,5.92395358474927,178,64,114,4,1.8,30.75,23.3,0,0,0,0,0,0,0.999999945309013,369.369811133059,99.9999982876057
24.3,"random_instances_SVM","SVM",12,41,9133,8769,364,4200,4029,171,0.998113760066602,0.925196850393701,5.92924282902137,180,65,115,2,1.8,31.5,23.6,0,0,0,0,0,0,0.999999990081343,367.231616012652,99.9999996694725
24.3,"random_instances_SVM","SVM",12,42,9033,8675,358,4300,4123,177,0.99802566391349,0.925196850393701,5.93454152681317,181,65,116,1,1.8,32.25,23.3,0,0,0,0,0,0,0.999999999385784,362.504226087623,99.9999999812925
24.3,"random_instances_SVM","SVM",12,43,8933,8581,352,4400,4217,183,0.997860521995807,0.925196850393701,5.92924282902137,188,69,119,7,1.7,33,23,0,0,0,0,0,0,0.999999999202098,357.742324929691,99.9999999747978
24.3,"random_instances_SVM","SVM",12,44,8833,8487,346,4500,4311,189,0.997943399909886,0.925196850393701,5.92395358474927,191,70,121,3,1.7,33.75,22.8,0,0,0,0,0,0,0.999999998758342,349.819931220053,99.9999999631678
24.3,"random_instances_SVM","SVM",12,45,8733,8388,345,4600,4410,190,0.99801522743542,0.925196850393701,5.92395358474927,191,69,122,0,1.8,34.5,23.2,0,0,0,0,0,0,0.999999996352142,348.438170929197,99.9999998964735
24.3,"random_instances_SVM","SVM",12,46,8633,8290,343,4700,4508,192,0.998066182004818,0.925196850393701,5.91867376872009,196,72,124,5,1.7,35.25,23.5,0,0,0,0,0,0,0.99999999587718,342.673958490635,99.9999998921243
24.3,"random_instances_SVM","SVM",12,47,8533,8196,337,4800,4602,198,0.998306834910884,0.925196850393701,5.92395358474927,206,73,133,10,1.8,36,23.2,0,0,0,0,0,0,0.999999999157565,338.462609025794,99.9999999783258
24.3,"random_instances_SVM","SVM",12,48,8433,8098,335,4900,4700,200,0.998351036465059,0.925196850393701,5.91867376872009,207,75,132,1,1.8,36.75,23.5,0,0,0,0,0,0,0.999999995372324,338.560429802286,99.9999998767366
24.3,"random_instances_SVM","SVM",13,0,13233,12733,500,100,95,5,0.961754704949107,0.809859154929577,5.18260391318241,20,5,15,0,3,0.75,19,0,0,0,0,0,0,0.993142913907211,714.28865952488,99.7676362479341
24.3,"random_instances_SVM","SVM",13,1,13133,12636,497,200,192,8,0.974439697877052,0.838028169014085,5.44628169014084,37,8,29,17,3.6,1.5,24,0,0,0,0,0,0,0.999995017717449,595.852272603758,99.9998078361437
24.3,"random_instances_SVM","SVM",13,2,13033,12538,495,300,290,10,0.966338844598214,0.845070422535211,5.45890150807586,36,10,26,-1,2.6,2.25,29,0,0,0,0,0,0,0.999998417030585,546.44983789773,99.9999487115634
24.3,"random_instances_SVM","SVM",13,3,12933,12440,493,400,388,12,0.961733742577653,0.880281690140845,5.47481710048276,44,12,32,8,2.7,3,32.3,0,0,0,0,0,0,0.99999758708872,557.260142885656,99.9999244974832
24.3,"random_instances_SVM","SVM",13,4,12833,12341,492,500,487,13,0.95924859827928,0.883802816901408,5.510157936102,48,13,35,4,2.7,3.75,37.5,0,0,0,0,0,0,0.999985241123772,507.101412058794,99.9995046025574
24.3,"random_instances_SVM","SVM",13,5,12733,12247,486,600,581,19,0.964504085455863,0.873239436619718,5.57539612676056,58,16,42,10,2.6,4.5,30.6,0,0,0,0,0,0,0.997272865926492,520.236130403862,99.986326715295
24.3,"random_instances_SVM","SVM",13,6,12633,12151,482,700,677,23,0.971559578369468,0.883802816901408,5.66429407544462,68,20,48,10,2.4,5.25,29.4,0,0,0,0,0,0,0.999983817146756,510.578866646104,99.9993891344402
24.3,"random_instances_SVM","SVM",13,7,12533,12056,477,800,772,28,0.976884572356573,0.894366197183099,5.74734093127623,70,24,46,2,1.9,6,27.6,0,0,0,0,0,0,0.999993584680137,510.082119404043,99.9997393030652
24.3,"random_instances_SVM","SVM",13,8,12433,11958,475,900,870,30,0.975964986219992,0.894366197183099,5.74734093127623,71,24,47,1,2,6.75,29,0,0,0,0,0,0,0.999999652444273,499.92397165573,99.9999872209091
24.3,"random_instances_SVM","SVM",13,9,12333,11865,468,1000,963,37,0.97772748034501,0.887323943661972,5.71646891194976,79,27,52,8,1.9,7.5,26,0,0,0,0,0,0,0.999995062938979,480.555326322057,99.9998150026288
24.3,"random_instances_SVM","SVM",13,10,12233,11770,463,1100,1058,42,0.988661563616376,0.894366197183099,5.76918841017508,86,28,58,7,2.1,8.25,25.2,0,0,0,0,0,0,0.994146814809273,473.794856014491,99.6941656127628
24.3,"random_instances_SVM","SVM",13,11,12133,11676,457,1200,1152,48,0.98597286365852,0.904929577464789,5.79508243356007,97,32,65,11,2,9,24,0,0,0,0,0,0,0.99998779095515,481.048093691312,99.9995403781815
24.3,"random_instances_SVM","SVM",13,12,12033,11582,451,1300,1246,54,0.984365932395234,0.904929577464789,5.79481664763355,110,35,75,13,2.1,9.75,23.1,0,0,0,0,0,0,0.999984977067604,487.166731991935,99.9994176225732
24.3,"random_instances_SVM","SVM",13,13,11933,11489,444,1400,1339,61,0.983521921124102,0.904929577464789,5.79481664763355,119,39,80,9,2.1,10.5,22,0,0,0,0,0,0,0.996251178492505,471.068227442388,99.8505550189056
24.3,"random_instances_SVM","SVM",13,14,11833,11392,441,1500,1436,64,0.982468286138575,0.904929577464789,5.79481664763355,121,41,80,2,2,11.25,22.4,0,0,0,0,0,0,0.999986637043305,471.472868251642,99.9994161652989
24.3,"random_instances_SVM","SVM",13,15,11733,11293,440,1600,1535,65,0.98317714527806,0.908450704225352,5.81577439319461,124,42,82,3,2,12,23.6,0,0,0,0,0,0,0.999998004494236,469.010165195334,99.9999174337388
24.3,"random_instances_SVM","SVM",13,16,11633,11198,435,1700,1630,70,0.982937181289195,0.904929577464789,5.78931447765182,120,43,77,-4,1.8,12.75,23.3,0,0,0,0,0,0,0.997042506085284,456.597752833413,99.9321348848885
24.3,"random_instances_SVM","SVM",13,17,11533,11101,432,1800,1727,73,0.983242790599132,0.904929577464789,5.78408946458535,125,42,83,5,2,13.5,23.7,0,0,0,0,0,0,0.999988913367393,442.918433831702,99.999558412977
24.3,"random_instances_SVM","SVM",13,18,11433,11005,428,1900,1823,77,0.989742780669584,0.915492957746479,5.83186065085382,129,45,84,4,1.9,14.25,23.7,0,0,0,0,0,0,0.999993195277158,448.785125163279,99.9997355791294
24.3,"random_instances_SVM","SVM",13,19,11333,10906,427,2000,1922,78,0.990080936819393,0.915492957746479,5.83186065085382,129,45,84,0,1.9,15,24.6,0,0,0,0,0,0,0.999984570781643,443.310401788729,99.9993785381579
24.3,"random_instances_SVM","SVM",13,20,11233,10809,424,2100,2019,81,0.988504897471931,0.911971830985915,5.81073072095942,127,45,82,-2,1.8,15.75,24.9,0,0,0,0,0,0,0.996286594642427,432.655099471723,99.8709888458388
24.3,"random_instances_SVM","SVM",13,21,11133,10712,421,2200,2116,84,0.988876703744313,0.911971830985915,5.81073072095942,131,45,86,4,1.9,16.5,25.2,0,0,0,0,0,0,0.999980992713454,430.173486491301,99.9992407691446
24.3,"random_instances_SVM","SVM",13,22,11033,10619,414,2300,2209,91,0.989118322657221,0.919014084507042,5.81073072095942,135,46,89,4,1.9,17.25,24.3,0,0,0,0,0,0,0.999989371938643,423.699611807859,99.9995803477116
24.3,"random_instances_SVM","SVM",13,23,10933,10525,408,2400,2303,97,0.989978055706932,0.915492957746479,5.8109391776669,137,47,90,2,1.9,18,23.7,0,0,0,0,0,0,0.994217325525563,404.462689134009,99.7015345507118
24.3,"random_instances_SVM","SVM",13,24,10833,10430,403,2500,2398,102,0.989797944804953,0.919014084507042,5.82661617185125,136,48,88,-1,1.8,18.75,23.5,0,0,0,0,0,0,0.999981764230747,398.438361538648,99.9993654735046
24.3,"random_instances_SVM","SVM",13,25,10733,10333,400,2600,2495,105,0.990419644610553,0.919014084507042,5.83199330512221,140,50,90,4,1.8,19.5,23.8,0,0,0,0,0,0,0.995835943075315,392.359982951456,99.8373962424485
24.3,"random_instances_SVM","SVM",13,26,10633,10242,391,2700,2586,114,0.991721518205246,0.919014084507042,5.85304743257753,147,49,98,7,2,20.25,22.7,0,0,0,0,0,0,0.996424680730214,388.891656257219,99.8884398729958
24.3,"random_instances_SVM","SVM",13,27,10533,10144,389,2800,2684,116,0.991365157890769,0.922535211267606,5.85830151465345,147,50,97,0,1.9,21,23.1,0,0,0,0,0,0,0.995634519617168,385.399677845156,99.8111177134821
24.3,"random_instances_SVM","SVM",13,28,10433,10048,385,2900,2780,120,0.991412599047184,0.919014084507042,5.85830151465345,155,52,103,8,2,21.75,23.2,0,0,0,0,0,0,0.993415863297489,383.146900122446,99.6386438996478
24.3,"random_instances_SVM","SVM",13,29,10333,9952,381,3000,2876,124,0.99132930120278,0.919014084507042,5.8478027664193,151,50,101,-4,2,22.5,23.2,0,0,0,0,0,0,0.996318423019216,374.847410800353,99.8893064063721
24.3,"random_instances_SVM","SVM",13,30,10233,9854,379,3100,2974,126,0.99123000575912,0.919014084507042,5.8635650380269,155,52,103,4,2,23.25,23.6,0,0,0,0,0,0,0.997306903108804,370.115224320514,99.9784048982685
24.3,"random_instances_SVM","SVM",13,31,10133,9757,376,3200,3071,129,0.996066797148239,0.919014084507042,5.92152059574683,165,54,111,10,2.1,24,23.8,0,0,0,0,0,0,0.999989508582487,370.594255471069,99.9996319420353
24.3,"random_instances_SVM","SVM",13,32,10033,9662,371,3300,3166,134,0.996219050161855,0.922535211267606,5.92152059574683,164,56,108,-1,1.9,24.75,23.6,0,0,0,0,0,0,0.999994330070789,369.163137844135,99.9997945701921
24.3,"random_instances_SVM","SVM",13,33,9933,9568,365,3400,3260,140,0.996056867603872,0.922535211267606,5.91105988448678,165,57,108,1,1.9,25.5,23.3,0,0,0,0,0,0,0.99998741278726,361.531756421977,99.9995399036141
24.3,"random_instances_SVM","SVM",13,34,9833,9470,363,3500,3358,142,0.995888065349644,0.922535211267606,5.91638037043141,168,58,110,3,1.9,26.25,23.6,0,0,0,0,0,0,0.999994633760104,362.262492026804,99.9998089634494
24.3,"random_instances_SVM","SVM",13,35,9733,9374,359,3600,3454,146,0.995826281518031,0.926056338028169,5.91105988448678,166,58,108,-2,1.9,27,23.7,0,0,0,0,0,0,0.999986019582797,354.979561608211,99.9994650959359
24.3,"random_instances_SVM","SVM",13,36,9633,9281,352,3700,3547,153,0.999169228121352,0.926056338028169,5.99011680143756,175,63,112,9,1.8,27.75,23.2,0,0,0,0,0,0,0.999998446084129,358.162394619446,99.9999438459293
24.3,"random_instances_SVM","SVM",13,37,9533,9185,348,3800,3643,157,0.999257490737941,0.936619718309859,5.98473967684022,178,65,113,3,1.7,28.5,23.2,0,0,0,0,0,0,0.999998792307234,356.015570490385,99.9999574920838
24.3,"random_instances_SVM","SVM",13,38,9433,9088,345,3900,3740,160,0.999280659674796,0.933098591549296,5.98473967684022,176,64,112,-2,1.8,29.25,23.4,0,0,0,0,0,0,0.999997145997769,350.344075318391,99.9998978422759
24.3,"random_instances_SVM","SVM",13,39,9333,8991,342,4000,3837,163,0.999212256146939,0.933098591549296,5.98473967684022,176,63,113,0,1.8,30,23.5,0,0,0,0,0,0,0.999995888676518,344.516666196726,99.9998533482029
24.3,"random_instances_SVM","SVM",13,40,9233,8895,338,4100,3933,167,0.999276246543967,0.926056338028169,5.9686660698299,172,61,111,-4,1.8,30.75,23.6,0,0,0,0,0,0,0.999997712168973,339.974303395749,99.9999175681075
24.3,"random_instances_SVM","SVM",13,41,9133,8800,333,4200,4028,172,0.999263558792832,0.926056338028169,5.9686660698299,182,67,115,10,1.7,31.5,23.4,0,0,0,0,0,0,0.999998609309478,332.992496830925,99.9999487096647
24.3,"random_instances_SVM","SVM",13,42,9033,8703,330,4300,4125,175,0.999319274569554,0.929577464788732,5.9686660698299,179,67,112,-3,1.7,32.25,23.6,0,0,0,0,0,0,0.99999866760518,330.238265976086,99.9999527123909
24.3,"random_instances_SVM","SVM",13,43,8933,8605,328,4400,4223,177,0.99931706800414,0.929577464788732,5.97401433691756,186,70,116,7,1.7,33,23.9,0,0,0,0,0,0,0.999998560051607,329.968496842914,99.9999485439123
24.3,"random_instances_SVM","SVM",13,44,8833,8507,326,4500,4321,179,0.999313758156017,0.926056338028169,5.97401433691756,187,68,119,1,1.8,33.75,24.1,0,0,0,0,0,0,0.999994373003434,322.741739588975,99.9997861644291
24.3,"random_instances_SVM","SVM",13,45,8733,8414,319,4600,4414,186,0.99938602317335,0.929577464788732,5.97401433691756,192,69,123,5,1.8,34.5,23.7,0,0,0,0,0,0,0.999998251797763,323.809785358166,99.9999389996072
24.3,"random_instances_SVM","SVM",13,46,8633,8316,317,4700,4512,188,0.999456633266621,0.929577464788732,5.9686660698299,196,72,124,4,1.7,35.25,24,0,0,0,0,0,0,0.999995893543477,315.234003680187,99.9998474873833
24.3,"random_instances_SVM","SVM",13,47,8533,8220,313,4800,4608,192,0.999492489954611,0.929577464788732,5.96332737030411,204,75,129,8,1.7,36,24,0,0,0,0,0,0,0.999999140101633,316.784967404372,99.999969169331
24.3,"random_instances_SVM","SVM",13,48,8433,8127,306,4900,4701,199,0.999566961537358,0.933098591549296,5.97937219730942,198,76,122,-6,1.6,36.75,23.6,0,0,0,0,0,0,0.999999663880736,309.453091114066,99.9999878936773
24.3,"random_instances_SVM","SVM",14,0,13233,12705,528,100,93,7,0.961838097073939,0.803149606299213,5.39374960769408,22,7,15,0,2.1,0.75,13.3,0,0,0,0,0,0,0.999999457535359,706.063653728975,99.9999859481965
24.3,"random_instances_SVM","SVM",14,1,13133,12608,525,200,190,10,0.942849539137386,0.858267716535433,5.22637795275591,37,9,28,15,3.1,1.5,19,0,0,0,0,0,0,0.992138883569314,593.516580026953,99.6078092870605
24.3,"random_instances_SVM","SVM",14,2,13033,12513,520,300,285,15,0.963674303303684,0.846456692913386,5.2496062992126,37,12,25,0,2.1,2.25,19,0,0,0,0,0,0,0.995486476039008,483.969874024711,99.8151152883657
24.3,"random_instances_SVM","SVM",14,3,12933,12415,518,400,383,17,0.958642693053325,0.854330708661417,5.1904173296638,35,13,22,-2,1.7,3,22.5,0,0,0,0,0,0,0.996586728734137,471.764875948378,99.9059106379074
24.3,"random_instances_SVM","SVM",14,4,12833,12319,514,500,479,21,0.974198570570804,0.858267716535433,5.58814098105228,49,16,33,14,2.1,3.75,22.8,0,0,0,0,0,0,0.991994746283087,452.447499180372,99.510624216428
24.3,"random_instances_SVM","SVM",14,5,12733,12223,510,600,575,25,0.974597612379357,0.87007874015748,5.60795708382197,48,17,31,-1,1.8,4.5,23,0,0,0,0,0,0,0.993545020282305,448.85484679779,99.6220549578314
24.3,"random_instances_SVM","SVM",14,6,12633,12123,510,700,675,25,0.973183162645762,0.87007874015748,5.53687513465053,50,18,32,2,1.8,5.25,27,0,0,0,0,0,0,0.99405125588131,442.720359848542,99.6517008993556
24.3,"random_instances_SVM","SVM",14,7,12533,12027,506,800,771,29,0.976208513464881,0.87007874015748,5.49431090243007,53,19,34,3,1.8,6,26.6,0,0,0,0,0,0,0.996466900133615,434.926685759432,99.8830653169588
24.3,"random_instances_SVM","SVM",14,8,12433,11928,505,900,870,30,0.975877001808564,0.866141732283465,5.50287677856057,57,20,37,4,1.8,6.75,29,0,0,0,0,0,0,0.996729042337963,424.090311441452,99.9208108881225
24.3,"random_instances_SVM","SVM",14,9,12333,11831,502,1000,967,33,0.976239822899095,0.866141732283465,5.47985218952894,57,20,37,0,1.8,7.5,29.3,0,0,0,0,0,0,0.999984724553077,421.76867528443,99.999384648384
24.3,"random_instances_SVM","SVM",14,10,12233,11736,497,1100,1062,38,0.982298505373566,0.87007874015748,5.69488540494938,69,23,46,12,2,8.25,27.9,0,0,0,0,0,0,0.997125164265036,440.484812750519,99.9640306051155
24.3,"random_instances_SVM","SVM",14,11,12133,11643,490,1200,1155,45,0.990857645211316,0.874015748031496,5.82767395794416,83,28,55,14,2,9,25.7,0,0,0,0,0,0,0.997044420274602,462.114151133114,99.9390243765737
24.3,"random_instances_SVM","SVM",14,12,12033,11549,484,1300,1249,51,0.9907004841298,0.87007874015748,5.85117264325845,85,28,57,2,2,9.75,24.5,0,0,0,0,0,0,0.996125006861592,452.375123126552,99.8296501400271
24.3,"random_instances_SVM","SVM",14,13,11933,11452,481,1400,1346,54,0.991427354131806,0.874015748031496,5.78862837457818,86,29,57,1,2,10.5,24.9,0,0,0,0,0,0,0.995018408506981,450.834250215397,99.7205697993521
24.3,"random_instances_SVM","SVM",14,14,11833,11356,477,1500,1442,58,0.990297144947948,0.874015748031496,5.79653767677972,89,31,58,3,1.9,11.25,24.9,0,0,0,0,0,0,0.996454112823638,442.59295320166,99.8379464592555
24.3,"random_instances_SVM","SVM",14,15,11733,11258,475,1600,1540,60,0.990254785125194,0.874015748031496,5.79380141155278,89,30,59,0,2,12,25.7,0,0,0,0,0,0,0.992868374552014,442.696959503066,99.551137593183
24.3,"random_instances_SVM","SVM",14,16,11633,11161,472,1700,1637,63,0.988803500763096,0.877952755905512,5.72641826939932,91,32,59,2,1.8,12.75,26,0,0,0,0,0,0,0.999991656430431,455.471479274825,99.9996648111363
24.3,"random_instances_SVM","SVM",14,17,11533,11064,469,1800,1734,66,0.99488244228321,0.877952755905512,5.99887260027456,104,32,72,13,2.2,13.5,26.3,0,0,0,0,0,0,0.997303465967978,452.165202487391,99.9783780050727
24.3,"random_instances_SVM","SVM",14,18,11433,10968,465,1900,1830,70,0.994817981683371,0.877952755905512,5.99345845532846,106,33,73,2,2.2,14.25,26.1,0,0,0,0,0,0,0.999997073530264,450.301408428787,99.9998964190798
24.3,"random_instances_SVM","SVM",14,19,11333,10873,460,2000,1925,75,0.993965260034063,0.877952755905512,5.96976889621649,109,35,74,3,2.1,15,25.7,0,0,0,0,0,0,0.999993106723163,438.490478137176,99.9997418972099
24.3,"random_instances_SVM","SVM",14,20,11233,10776,457,2100,2022,78,0.994240291926711,0.885826771653543,5.96438587647238,115,36,79,6,2.2,15.75,25.9,0,0,0,0,0,0,0.999995532225427,443.98980780511,99.9998432680144
24.3,"random_instances_SVM","SVM",14,21,11133,10680,453,2200,2118,82,0.994221260701998,0.893700787401575,5.95145068248583,130,39,91,15,2.3,16.5,25.8,0,0,0,0,0,0,0.999994947084645,451.902510658517,99.9998090104414
24.3,"random_instances_SVM","SVM",14,22,11033,10583,450,2300,2215,85,0.994056118784314,0.889763779527559,5.94607933710452,135,40,95,5,2.4,17.25,26.1,0,0,0,0,0,0,0.999996365056224,457.91711278047,99.9998709625744
24.3,"random_instances_SVM","SVM",14,23,10933,10487,446,2400,2311,89,0.993588319002619,0.893700787401575,5.94607933710452,135,42,93,0,2.2,18,26,0,0,0,0,0,0,0.999997907059743,447.391828761317,99.9999169767454
24.3,"random_instances_SVM","SVM",14,24,10833,10395,438,2500,2403,97,0.992962130318459,0.889763779527559,5.89870021888058,139,44,95,4,2.2,18.75,24.8,0,0,0,0,0,0,0.999998290353011,435.045443894523,99.9999312641148
24.3,"random_instances_SVM","SVM",14,25,10733,10297,436,2600,2501,99,0.992996509305044,0.893700787401575,5.89870021888058,138,45,93,-1,2.1,19.5,25.3,0,0,0,0,0,0,0.999997839439053,433.031123968443,99.9999105478746
24.3,"random_instances_SVM","SVM",14,26,10633,10205,428,2700,2593,107,0.992593784033661,0.893700787401575,5.85914654457572,136,46,90,-2,2,20.25,24.2,0,0,0,0,0,0,0.999995988054312,420.162939653525,99.9998522130312
24.3,"random_instances_SVM","SVM",14,27,10533,10110,423,2800,2688,112,0.992016094277006,0.893700787401575,5.84336787345029,135,46,89,-1,1.9,21,24,0,0,0,0,0,0,0.999993297519644,413.404235480745,99.9997492888564
24.3,"random_instances_SVM","SVM",14,28,10433,10015,418,2900,2783,117,0.992427414295035,0.897637795275591,5.84336787345029,139,47,92,4,2,21.75,23.8,0,0,0,0,0,0,0.999999033367444,415.33481487575,99.9999645870418
24.3,"random_instances_SVM","SVM",14,29,10333,9919,414,3000,2879,121,0.992516431313858,0.893700787401575,5.84336787345029,145,49,96,6,2,22.5,23.8,0,0,0,0,0,0,0.999997557194905,406.577467038276,99.9998996083082
24.3,"random_instances_SVM","SVM",14,30,10233,9823,410,3100,2975,125,0.993271541197693,0.889763779527559,5.89338128270486,151,48,103,6,2.1,23.25,23.8,0,0,0,0,0,0,0.999998411271613,403.866748019356,99.9999353494068
24.3,"random_instances_SVM","SVM",14,31,10133,9728,405,3200,3070,130,0.993868876089539,0.889763779527559,5.91704948062737,151,49,102,0,2.1,24,23.6,0,0,0,0,0,0,0.99999802012883,397.838427911409,99.9999204548689
24.3,"random_instances_SVM","SVM",14,32,10033,9631,402,3300,3167,133,0.993431157921103,0.889763779527559,5.91704948062737,158,50,108,7,2.2,24.75,23.8,0,0,0,0,0,0,0.999995423825714,393.625581940204,99.9998190235407
24.3,"random_instances_SVM","SVM",14,33,9933,9538,395,3400,3260,140,0.995024255602857,0.901574803149606,5.96653366442402,159,56,103,1,1.8,25.5,23.3,0,0,0,0,0,0,0.99999487379902,395.021099840224,99.9998006492669
24.3,"random_instances_SVM","SVM",14,34,9833,9438,395,3500,3360,140,0.994452091040465,0.897637795275591,5.96117770960856,158,55,103,-1,1.9,26.25,24,0,0,0,0,0,0,0.999998759350767,394.218779965594,99.9999525018879
24.3,"random_instances_SVM","SVM",14,35,9733,9342,391,3600,3456,144,0.994410959038663,0.905511811023622,5.95583136188694,160,57,103,2,1.8,27,24,0,0,0,0,0,0,0.999997953954248,386.10287616591,99.9999251802376
24.3,"random_instances_SVM","SVM",14,36,9633,9247,386,3700,3551,149,0.994503659520338,0.905511811023622,5.96117770960856,160,55,105,0,1.9,27.75,23.8,0,0,0,0,0,0,0.999997088248806,380.147173512981,99.9998922761487
24.3,"random_instances_SVM","SVM",14,37,9533,9151,382,3800,3647,153,0.995184486236741,0.905511811023622,5.96117770960856,157,57,100,-3,1.8,28.5,23.8,0,0,0,0,0,0,0.999997997953055,379.056418850833,99.9999269030928
24.3,"random_instances_SVM","SVM",14,38,9433,9055,378,3900,3743,157,0.996230589685573,0.905511811023622,5.96117770960856,156,58,98,-1,1.7,29.25,23.8,0,0,0,0,0,0,0.999999649697062,377.867664956552,99.9999880317869
24.3,"random_instances_SVM","SVM",14,39,9333,8956,377,4000,3842,158,0.996430110589838,0.901574803149606,5.95049459543364,159,59,100,3,1.7,30,24.3,0,0,0,0,0,0,0.999999387644279,374.85908402744,99.9999783066428
24.3,"random_instances_SVM","SVM",14,40,9233,8859,374,4100,3939,161,0.996448527904078,0.905511811023622,5.95583136188694,160,59,101,1,1.7,30.75,24.5,0,0,0,0,0,0,0.999999488873018,370.212841291005,99.9999820702746
24.3,"random_instances_SVM","SVM",14,41,9133,8767,366,4200,4031,169,0.99664743489787,0.909448818897638,5.95583136188694,168,61,107,8,1.8,31.5,23.9,0,0,0,0,0,0,0.999999640600571,361.757946173086,99.9999869291254
24.3,"random_instances_SVM","SVM",14,42,9033,8676,357,4300,4122,178,0.996851253175458,0.909448818897638,5.98265943108463,179,64,115,11,1.8,32.25,23.2,0,0,0,0,0,0,0.999999805429971,356.446909467962,99.9999927030408
24.3,"random_instances_SVM","SVM",14,43,8933,8577,356,4400,4221,179,0.997209162982188,0.909448818897638,5.97189925225174,181,64,117,2,1.8,33,23.6,0,0,0,0,0,0,0.999999506179048,355.504769907811,99.9999809182944
24.3,"random_instances_SVM","SVM",14,44,8833,8482,351,4500,4316,184,0.997436002902577,0.905511811023622,5.96117770960856,177,64,113,-4,1.8,33.75,23.5,0,0,0,0,0,0,0.999999791954453,350.306010358544,99.9999929152191
24.3,"random_instances_SVM","SVM",14,45,8733,8384,349,4600,4414,186,0.997474065352007,0.905511811023622,5.95049459543364,186,67,119,9,1.8,34.5,23.7,0,0,0,0,0,0,0.999999776362137,346.286874325138,99.9999921857725
24.3,"random_instances_SVM","SVM",14,46,8633,8287,346,4700,4511,189,0.997425873379746,0.905511811023622,5.95583136188694,187,67,120,1,1.8,35.25,23.9,0,0,0,0,0,0,0.999999785371152,339.655716880314,99.9999927882152
24.3,"random_instances_SVM","SVM",14,47,8533,8190,343,4800,4608,192,0.9981294147837,0.917322834645669,5.97937219730942,185,69,116,-2,1.7,36,24,0,0,0,0,0,0,0.999999866677953,339.233571969689,99.9999959655556
24.3,"random_instances_SVM","SVM",14,48,8433,8091,342,4900,4707,193,0.998152743381737,0.913385826771654,5.97937219730942,181,69,112,-4,1.6,36.75,24.4,0,0,0,0,0,0,0.99999996899252,339.295430703692,99.999999085303
24.3,"random_instances_SVM","SVM",15,0,13233,12707,526,100,95,5,0.960141443536872,0.779069767441861,5.42055314913719,25,5,20,0,4,0.75,19,0,0,0,0,0,0,0.995422038605488,673.53723576772,99.8947867982168
24.3,"random_instances_SVM","SVM",15,1,13133,12610,523,200,192,8,0.959130873372115,0.84108527131783,5.36717258992456,27,8,19,2,2.4,1.5,24,0,0,0,0,0,0,0.971683098193369,491.002802548487,98.6528496637703
24.3,"random_instances_SVM","SVM",15,2,13033,12513,520,300,289,11,0.982015358731236,0.868217054263566,5.70366296529087,43,11,32,16,2.9,2.25,26.3,0,0,0,0,0,0,0.995299897890215,603.931392068106,99.8449160490288
24.3,"random_instances_SVM","SVM",15,3,12933,12416,517,400,386,14,0.966556235719879,0.868217054263566,5.36751727370931,49,13,36,6,2.8,3,27.6,0,0,0,0,0,0,0.984727069105469,523.98540704493,99.228888538449
24.3,"random_instances_SVM","SVM",15,4,12833,12320,513,500,482,18,0.969685918905213,0.872093023255814,5.42343764953584,59,16,43,10,2.7,3.75,26.8,0,0,0,0,0,0,0.996789144819192,531.34785115412,99.9248178018104
24.3,"random_instances_SVM","SVM",15,5,12733,12225,508,600,577,23,0.977391289622969,0.872093023255814,5.54703924672268,68,20,48,9,2.4,4.5,25.1,0,0,0,0,0,0,0.994933929060654,541.244822631321,99.7494368510776
24.3,"random_instances_SVM","SVM",15,6,12633,12129,504,700,673,27,0.986577136560618,0.872093023255814,5.7476135850106,71,23,48,3,2.1,5.25,24.9,0,0,0,0,0,0,0.993664533811119,553.695762091478,99.6514192004001
24.3,"random_instances_SVM","SVM",15,7,12533,12034,499,800,768,32,0.986246327536005,0.875968992248062,5.73219065052489,74,24,50,3,2.1,6,24,0,0,0,0,0,0,0.99325875394455,527.178041816465,99.6543346581831
24.3,"random_instances_SVM","SVM",15,8,12433,11938,495,900,864,36,0.988900661738996,0.875968992248062,5.75009964813898,84,25,59,10,2.4,6.75,24,0,0,0,0,0,0,0.992114264546047,540.982767220926,99.5700270696622
24.3,"random_instances_SVM","SVM",15,9,12333,11842,491,1000,960,40,0.989056692320986,0.875968992248062,5.72978127482401,87,27,60,3,2.2,7.5,24,0,0,0,0,0,0,0.994429669381116,532.18761413947,99.7600874280984
24.3,"random_instances_SVM","SVM",15,10,12233,11749,484,1100,1053,47,0.990907287595796,0.87984496124031,5.76525094677549,96,30,66,9,2.2,8.25,22.4,0,0,0,0,0,0,0.999989908644445,557.489509212097,99.9995985935513
24.3,"random_instances_SVM","SVM",15,11,12133,11654,479,1200,1148,52,0.991544714857122,0.87984496124031,5.8343428079242,101,32,69,5,2.2,9,22.1,0,0,0,0,0,0,0.99998328653945,539.729921121924,99.9993258450192
24.3,"random_instances_SVM","SVM",15,12,12033,11560,473,1300,1242,58,0.991180038729438,0.87984496124031,5.86562614737688,97,33,64,-4,1.9,9.75,21.4,0,0,0,0,0,0,0.999995228255081,534.622273889802,99.9998115983754
24.3,"random_instances_SVM","SVM",15,13,11933,11463,470,1400,1339,61,0.994963477957955,0.87984496124031,5.94902682505159,108,35,73,11,2.1,10.5,22,0,0,0,0,0,0,0.999994985968636,527.719162512441,99.9998164318781
24.3,"random_instances_SVM","SVM",15,14,11833,11367,466,1500,1435,65,0.994927191776096,0.87984496124031,5.94368178747292,109,35,74,1,2.1,11.25,22.1,0,0,0,0,0,0,0.997380308644492,499.528961676198,99.9915579377568
24.3,"random_instances_SVM","SVM",15,15,11733,11271,462,1600,1531,69,0.99501427861256,0.883720930232558,5.94368178747292,108,37,71,-1,1.9,12,22.2,0,0,0,0,0,0,0.999992579317734,499.612946613531,99.9997233057453
24.3,"random_instances_SVM","SVM",15,16,11633,11177,456,1700,1625,75,0.994889696054843,0.883720930232558,5.95438148466009,113,39,74,5,1.9,12.75,21.7,0,0,0,0,0,0,0.99999392771129,493.098487083432,99.9997737393519
24.3,"random_instances_SVM","SVM",15,17,11533,11078,455,1800,1724,76,0.994961663648862,0.883720930232558,5.94902682505159,116,40,76,3,1.9,13.5,22.7,0,0,0,0,0,0,0.999998162762617,491.935333737216,99.9999308172311
24.3,"random_instances_SVM","SVM",15,18,11433,10979,454,1900,1823,77,0.994912677303354,0.883720930232558,5.94902682505159,117,41,76,1,1.9,14.25,23.7,0,0,0,0,0,0,0.999998950531364,485.372185804532,99.9999610879147
24.3,"random_instances_SVM","SVM",15,19,11333,10883,450,2000,1919,81,0.995173937812741,0.883720930232558,5.94368178747292,119,42,77,2,1.8,15,23.7,0,0,0,0,0,0,0.999998918306211,480.636579421106,99.9999645750838
24.3,"random_instances_SVM","SVM",15,20,11233,10785,448,2100,2017,83,0.995036655091374,0.883720930232558,5.94368178747292,121,44,77,2,1.8,15.75,24.3,0,0,0,0,0,0,0.999998027477233,470.871522318024,99.9999392167922
24.3,"random_instances_SVM","SVM",15,21,11133,10688,445,2200,2114,86,0.993360838259176,0.883720930232558,5.93646553530274,120,44,76,-1,1.7,16.5,24.6,0,0,0,0,0,0,0.999999101898149,465.932855958288,99.9999706260988
24.3,"random_instances_SVM","SVM",15,22,11033,10590,443,2300,2212,88,0.995808945995274,0.883720930232558,5.95974579230393,125,45,80,5,1.8,17.25,25.1,0,0,0,0,0,0,0.999999871359925,473.472688140593,99.9999962156371
24.3,"random_instances_SVM","SVM",15,23,10933,10495,438,2400,2307,93,0.995723068698207,0.883720930232558,5.95438148466009,130,46,84,5,1.8,18,24.8,0,0,0,0,0,0,0.999998147893363,453.066787004265,99.9999445062027
24.3,"random_instances_SVM","SVM",15,24,10833,10399,434,2500,2403,97,0.995630538934465,0.883720930232558,5.95438148466009,130,46,84,0,1.8,18.75,24.8,0,0,0,0,0,0,0.999998192107181,451.500338653541,99.9999397885071
24.3,"random_instances_SVM","SVM",15,25,10733,10300,433,2600,2502,98,0.995636586631441,0.883720930232558,5.95438148466009,132,45,87,2,1.9,19.5,25.5,0,0,0,0,0,0,0.999998268174947,449.023601893353,99.999942459243
24.3,"random_instances_SVM","SVM",15,26,10633,10203,430,2700,2599,101,0.995221109849154,0.883720930232558,5.95438148466009,132,46,86,0,1.9,20.25,25.7,0,0,0,0,0,0,0.99999847025527,441.643162138473,99.9999502355815
24.3,"random_instances_SVM","SVM",15,27,10533,10107,426,2800,2695,105,0.993946255326502,0.883720930232558,5.95438148466009,139,48,91,7,1.9,21,25.7,0,0,0,0,0,0,0.999997881955731,436.812980933649,99.9999319793705
24.3,"random_instances_SVM","SVM",15,28,10433,10013,420,2900,2789,111,0.995340854249287,0.883720930232558,5.93302047484965,145,52,93,6,1.8,21.75,25.1,0,0,0,0,0,0,0.999999720677244,439.68216690308,99.9999913662052
24.3,"random_instances_SVM","SVM",15,29,10333,9919,414,3000,2883,117,0.995346297176565,0.883720930232558,5.93302047484965,144,51,93,-1,1.8,22.5,24.6,0,0,0,0,0,0,0.999999810388238,437.986027998794,99.999994044476
24.3,"random_instances_SVM","SVM",15,30,10233,9822,411,3100,2980,120,0.994678631430358,0.883720930232558,5.93302047484965,144,52,92,0,1.8,23.25,24.8,0,0,0,0,0,0,0.999999956095018,435.62493054614,99.9999985337231
24.3,"random_instances_SVM","SVM",15,31,10133,9724,409,3200,3078,122,0.996033315553099,0.883720930232558,5.95438148466009,156,54,102,12,1.9,24,25.2,0,0,0,0,0,0,0.99999998888995,440.612582514178,99.9999996445371
24.3,"random_instances_SVM","SVM",15,32,10033,9625,408,3300,3177,123,0.995817412771037,0.883720930232558,5.93302047484965,149,54,95,-7,1.8,24.75,25.8,0,0,0,0,0,0,0.999999996457895,434.449887346831,99.9999998847035
24.3,"random_instances_SVM","SVM",15,33,9933,9527,406,3400,3275,125,0.995882727898383,0.883720930232558,5.93302047484965,148,55,93,-1,1.7,25.5,26.2,0,0,0,0,0,0,0.999999916434172,428.454926485744,99.9999975663662
24.3,"random_instances_SVM","SVM",15,34,9833,9430,403,3500,3372,128,0.995892404213545,0.883720930232558,5.93302047484965,149,56,93,1,1.7,26.25,26.3,0,0,0,0,0,0,0.999999898958546,421.526044009282,99.9999966575449
24.3,"random_instances_SVM","SVM",15,35,9733,9333,400,3600,3469,131,0.995528937625257,0.883720930232558,5.93302047484965,151,56,95,2,1.7,27,26.5,0,0,0,0,0,0,0.999999725637961,415.450552910717,99.999990762378
24.3,"random_instances_SVM","SVM",15,36,9633,9240,393,3700,3562,138,0.997215640312011,0.895348837209302,5.98473967684022,166,59,107,15,1.8,27.75,25.8,0,0,0,0,0,0,0.999999959281726,413.64629694383,99.9999987273255
24.3,"random_instances_SVM","SVM",15,37,9533,9140,393,3800,3662,138,0.997242250178708,0.895348837209302,5.97937219730942,165,59,106,-1,1.8,28.5,26.5,0,0,0,0,0,0,0.999999843962459,411.803198677408,99.999994951075
24.3,"random_instances_SVM","SVM",15,38,9433,9043,390,3900,3759,141,0.997689779754971,0.89922480620155,5.94206773618538,164,58,106,-1,1.8,29.25,26.7,0,0,0,0,0,0,0.999999805878579,405.086054987359,99.9999939876245
24.3,"random_instances_SVM","SVM",15,39,9333,8950,383,4000,3852,148,0.997627488476113,0.89922480620155,5.94206773618538,167,60,107,3,1.8,30,26,0,0,0,0,0,0,0.999999988230854,398.332914384195,99.9999996580695
24.3,"random_instances_SVM","SVM",15,40,9233,8858,375,4100,3944,156,0.99800425999775,0.895348837209302,5.94206773618538,171,61,110,4,1.8,30.75,25.3,0,0,0,0,0,0,0.999999957627293,393.156207460339,99.9999987026846
24.3,"random_instances_SVM","SVM",15,41,9133,8761,372,4200,4041,159,0.997860929579406,0.895348837209302,5.97401433691756,171,61,110,0,1.8,31.5,25.4,0,0,0,0,0,0,0.999999957146521,385.754616285763,99.9999987161767
24.3,"random_instances_SVM","SVM",15,42,9033,8662,371,4300,4140,160,0.998091346834211,0.895348837209302,5.97937219730942,172,62,110,1,1.8,32.25,25.9,0,0,0,0,0,0,0.999999976584065,389.107449433418,99.9999992856303
24.3,"random_instances_SVM","SVM",15,43,8933,8564,369,4400,4238,162,0.998329626095086,0.89922480620155,5.97937219730942,175,64,111,3,1.7,33,26.2,0,0,0,0,0,0,0.99999994166116,390.303299158583,99.9999981632561
24.3,"random_instances_SVM","SVM",15,44,8833,8468,365,4500,4334,166,0.998380426749689,0.89922480620155,5.97401433691756,174,64,110,-1,1.7,33.75,26.1,0,0,0,0,0,0,0.999999999393298,386.756901963769,99.9999999819678
24.3,"random_instances_SVM","SVM",15,45,8733,8376,357,4600,4426,174,0.998378612440596,0.89922480620155,5.95267857142857,178,64,114,4,1.8,34.5,25.4,0,0,0,0,0,0,0.999999795580276,369.691286408634,99.9999928392368
24.3,"random_instances_SVM","SVM",15,46,8633,8280,353,4700,4522,178,0.998577581671123,0.895348837209302,5.99011680143756,180,65,115,2,1.8,35.25,25.4,0,0,0,0,0,0,0.999999997005187,368.474245608118,99.9999999135163
24.3,"random_instances_SVM","SVM",15,47,8533,8183,350,4800,4619,181,0.99861447262268,0.895348837209302,5.99011680143756,174,65,109,-6,1.7,36,25.5,0,0,0,0,0,0,0.999999946511529,362.338093588505,99.9999983874917
24.3,"random_instances_SVM","SVM",15,48,8433,8085,348,4900,4717,183,0.998648339725749,0.895348837209302,6.00630630630631,178,66,112,4,1.7,36.75,25.8,0,0,0,0,0,0,0.999999974765786,359.127437761624,99.9999992123394
24.3,"random_instances_SVM","SVM",16,0,13233,12719,514,100,94,6,0.956111982020414,0.828996282527881,5.16789990278374,29,6,23,0,3.8,0.75,15.7,0,0,0,0,0,0,0.927323304247768,791.535966640891,95.53578732042
24.3,"random_instances_SVM","SVM",16,1,13133,12622,511,200,191,9,0.967818126249983,0.840148698884758,5.37102895357528,30,8,22,1,2.8,1.5,21.2,0,0,0,0,0,0,0.987672774728875,512.764986635328,99.3750184064234
24.3,"random_instances_SVM","SVM",16,2,13033,12528,505,300,285,15,0.962200664473452,0.843866171003718,5.31250802598609,48,12,36,18,3,2.25,19,0,0,0,0,0,0,0.997357281771391,520.503001460447,99.9889737730119
24.3,"random_instances_SVM","SVM",16,3,12933,12429,504,400,384,16,0.966541007819606,0.840148698884758,5.34993367505691,45,13,32,-3,2.5,3,24,0,0,0,0,0,0,0.994701972430426,470.627119494282,99.7821772209566
24.3,"random_instances_SVM","SVM",16,4,12833,12330,503,500,483,17,0.957477418012856,0.851301115241636,5.29842894111156,46,13,33,1,2.5,3.75,28.4,0,0,0,0,0,0,0.99122926709233,420.339621946996,99.506931554581
24.3,"random_instances_SVM","SVM",16,5,12733,12236,497,600,577,23,0.968353260951661,0.851301115241636,5.40031807600238,53,15,38,7,2.5,4.5,25.1,0,0,0,0,0,0,0.98612105536359,425.340981815926,99.1334973636898
24.3,"random_instances_SVM","SVM",16,6,12633,12140,493,700,673,27,0.980570136346053,0.840148698884758,5.6119712428148,54,17,37,1,2.2,5.25,24.9,0,0,0,0,0,0,0.989824508971142,429.772137200032,99.4423735651067
24.3,"random_instances_SVM","SVM",16,7,12533,12047,486,800,766,34,0.982349270392349,0.869888475836431,5.63481614029991,65,22,43,11,2,6,22.5,0,0,0,0,0,0,0.99444495656443,478.029175230994,99.7468326640503
24.3,"random_instances_SVM","SVM",16,8,12433,11949,484,900,864,36,0.981347563306831,0.87360594795539,5.59789068853906,69,22,47,4,2.1,6.75,24,0,0,0,0,0,0,0.996360236064539,467.840253402604,99.9108998349784
24.3,"random_instances_SVM","SVM",16,9,12333,11849,484,1000,964,36,0.981781597641439,0.869888475836431,5.63783995304246,76,26,50,7,1.9,7.5,26.8,0,0,0,0,0,0,0.993777975945646,455.002440139755,99.7244962339316
24.3,"random_instances_SVM","SVM",16,10,12233,11751,482,1100,1062,38,0.986136466902411,0.869888475836431,5.73651129028507,79,28,51,3,1.8,8.25,27.9,0,0,0,0,0,0,0.993252376177033,451.725076332344,99.6752161582196
24.3,"random_instances_SVM","SVM",16,11,12133,11656,477,1200,1157,43,0.984695496152942,0.881040892193309,5.64287373871482,93,29,64,14,2.2,9,26.9,0,0,0,0,0,0,0.999985825625687,464.977984974693,99.9995379402234
24.3,"random_instances_SVM","SVM",16,12,12033,11561,472,1300,1252,48,0.984760572251308,0.881040892193309,5.66500265533723,98,30,68,5,2.3,9.75,26.1,0,0,0,0,0,0,0.996256627932732,458.979635246797,99.8629397951347
24.3,"random_instances_SVM","SVM",16,13,11933,11466,467,1400,1347,53,0.984970907497801,0.881040892193309,5.68530732435277,101,32,69,3,2.2,10.5,25.4,0,0,0,0,0,0,0.999987669364512,447.944916428968,99.9995432246663
24.3,"random_instances_SVM","SVM",16,14,11833,11369,464,1500,1444,56,0.986248606964751,0.881040892193309,5.72972378782428,101,34,67,0,2,11.25,25.8,0,0,0,0,0,0,0.99999140875935,460.340718441655,99.9996792603521
24.3,"random_instances_SVM","SVM",16,15,11733,11272,461,1600,1541,59,0.986275915684596,0.881040892193309,5.678838141396,107,36,71,6,2,12,26.1,0,0,0,0,0,0,0.999996718028556,448.74589397911,99.9998720498967
24.3,"random_instances_SVM","SVM",16,16,11633,11174,459,1700,1639,61,0.984912803838554,0.881040892193309,5.678838141396,108,36,72,1,2,12.75,26.9,0,0,0,0,0,0,0.999992808348781,444.194160092426,99.9996884788218
24.3,"random_instances_SVM","SVM",16,17,11533,11080,453,1800,1733,67,0.984693172006579,0.881040892193309,5.69221390580411,106,35,71,-2,2,13.5,25.9,0,0,0,0,0,0,0.996823155946134,426.203353485555,99.9119594855451
24.3,"random_instances_SVM","SVM",16,18,11433,10983,450,1900,1830,70,0.98564781512809,0.881040892193309,5.72459422310823,109,37,72,3,1.9,14.25,26.1,0,0,0,0,0,0,0.999992195732968,433.265784324669,99.9996641833005
24.3,"random_instances_SVM","SVM",16,19,11333,10886,447,2000,1927,73,0.985453748906186,0.881040892193309,5.71947383471547,112,36,76,3,2.1,15,26.4,0,0,0,0,0,0,0.999991637593662,417.589874433428,99.9996505327332
24.3,"random_instances_SVM","SVM",16,20,11233,10790,443,2100,2023,77,0.986428728308439,0.884758364312268,5.77931885241802,105,37,68,-7,1.8,15.75,26.3,0,0,0,0,0,0,0.999995356722889,417.117641204934,99.999817025835
24.3,"random_instances_SVM","SVM",16,21,11133,10697,436,2200,2116,84,0.986188760195747,0.888475836431227,5.77931885241802,115,41,74,10,1.8,16.5,25.2,0,0,0,0,0,0,0.999995177151342,415.590003827338,99.9998006740874
24.3,"random_instances_SVM","SVM",16,22,11033,10599,434,2300,2214,86,0.98580295189831,0.884758364312268,5.75709070298565,114,41,73,-1,1.8,17.25,25.7,0,0,0,0,0,0,0.999994197918661,407.487384751674,99.9997607906278
24.3,"random_instances_SVM","SVM",16,23,10933,10500,433,2400,2313,87,0.985483962809012,0.884758364312268,5.72972378782428,120,40,80,6,2,18,26.6,0,0,0,0,0,0,0.999994161963501,410.043808480935,99.999773543079
24.3,"random_instances_SVM","SVM",16,24,10833,10402,431,2500,2411,89,0.985064454389211,0.884758364312268,5.75193201956003,123,42,81,3,1.9,18.75,27.1,0,0,0,0,0,0,0.999988488579306,408.042897516221,99.9995588683964
24.3,"random_instances_SVM","SVM",16,25,10733,10306,427,2600,2507,93,0.988166027720095,0.881040892193309,5.82900295662504,121,41,80,-2,2,19.5,27,0,0,0,0,0,0,0.999996241854037,406.085105769023,99.9998707525352
24.3,"random_instances_SVM","SVM",16,26,10633,10210,423,2700,2603,97,0.988191593330164,0.881040892193309,5.82900295662504,121,43,78,0,1.8,20.25,26.8,0,0,0,0,0,0,0.999995227874753,398.567344419879,99.9998201735215
24.3,"random_instances_SVM","SVM",16,27,10533,10112,421,2800,2701,99,0.9882508590626,0.884758364312268,5.81197206384834,117,43,74,-4,1.7,21,27.3,0,0,0,0,0,0,0.999990105506795,395.190965095066,99.9996528618483
24.3,"random_instances_SVM","SVM",16,28,10433,10016,417,2900,2797,103,0.988898714863258,0.884758364312268,5.85528340277754,119,44,75,2,1.7,21.75,27.2,0,0,0,0,0,0,0.99999656583066,394.521225170768,99.9998792619139
24.3,"random_instances_SVM","SVM",16,29,10333,9918,415,3000,2895,105,0.988894647607111,0.888475836431227,5.80535182022171,126,45,81,7,1.8,22.5,27.6,0,0,0,0,0,0,0.999995671786688,390.425787944782,99.9998534716373
24.3,"random_instances_SVM","SVM",16,30,10233,9822,411,3100,2991,109,0.989656386579909,0.888475836431227,5.82243465982286,127,46,81,1,1.8,23.25,27.4,0,0,0,0,0,0,0.999998546659058,390.384614324592,99.9999488406272
24.3,"random_instances_SVM","SVM",16,31,10133,9723,410,3200,3090,110,0.990397208235377,0.888475836431227,5.82768009645333,127,47,80,0,1.7,24,28.1,0,0,0,0,0,0,0.9999957846239,388.460376580988,99.9998510844681
24.3,"random_instances_SVM","SVM",16,32,10033,9627,406,3300,3186,114,0.990527941468697,0.888475836431227,5.85528340277754,129,47,82,2,1.7,24.75,27.9,0,0,0,0,0,0,0.999997790932715,384.750342940843,99.9999230999523
24.3,"random_instances_SVM","SVM",16,33,9933,9536,397,3400,3277,123,0.99307869210987,0.888475836431227,5.90530511454377,144,50,94,15,1.9,25.5,26.6,0,0,0,0,0,0,0.999997511150076,379.622788061317,99.999919387027
24.3,"random_instances_SVM","SVM",16,34,9833,9438,395,3500,3375,125,0.99384391730222,0.892193308550186,5.92232863258034,144,51,93,0,1.8,26.25,27,0,0,0,0,0,0,0.999993820771833,376.90914778913,99.9997823950851
24.3,"random_instances_SVM","SVM",16,35,9733,9340,393,3600,3473,127,0.994134435598481,0.892193308550186,5.9276736945231,142,51,91,-2,1.8,27,27.3,0,0,0,0,0,0,0.999998090513649,371.186486091431,99.9999366284963
24.3,"random_instances_SVM","SVM",16,36,9633,9241,392,3700,3572,128,0.994185566818623,0.892193308550186,5.93932147761144,144,51,93,2,1.8,27.75,27.9,0,0,0,0,0,0,0.99999731092395,369.290753511948,99.9999104961392
24.3,"random_instances_SVM","SVM",16,37,9533,9146,387,3800,3667,133,0.99353712998137,0.892193308550186,5.91166737491593,140,49,91,-4,1.9,28.5,27.6,0,0,0,0,0,0,0.999998076391147,364.584168217814,99.9999353096483
24.3,"random_instances_SVM","SVM",16,38,9433,9049,384,3900,3764,136,0.993499362602855,0.892193308550186,5.92863924473804,141,49,92,1,1.9,29.25,27.7,0,0,0,0,0,0,0.999995209180039,359.722972809198,99.9998328080077
24.3,"random_instances_SVM","SVM",16,39,9333,8952,381,4000,3861,139,0.994427278041115,0.892193308550186,5.96164975384306,149,52,97,8,1.9,30,27.8,0,0,0,0,0,0,0.999999296608493,364.033844655381,99.999976387904
24.3,"random_instances_SVM","SVM",16,40,9233,8860,373,4100,3953,147,0.996413842150951,0.895910780669145,5.97859191123573,151,55,96,2,1.7,30.75,26.9,0,0,0,0,0,0,0.999998341909087,361.711354804184,99.9999457750399
24.3,"random_instances_SVM","SVM",16,41,9133,8766,367,4200,4047,153,0.997119801610866,0.903345724907063,5.9955035971223,157,59,98,6,1.7,31.5,26.5,0,0,0,0,0,0,0.999997589498047,353.752911204714,99.9999096944852
24.3,"random_instances_SVM","SVM",16,42,9033,8668,365,4300,4145,155,0.997105275696053,0.903345724907063,5.9955035971223,158,59,99,1,1.7,32.25,26.7,0,0,0,0,0,0,0.99999895163181,352.878456267536,99.9999617434254
24.3,"random_instances_SVM","SVM",16,43,8933,8569,364,4400,4244,156,0.997213929538855,0.903345724907063,6.000900090009,157,59,98,-1,1.7,33,27.2,0,0,0,0,0,0,0.999998181072354,350.139076552035,99.9999329038374
24.3,"random_instances_SVM","SVM",16,44,8833,8474,359,4500,4339,161,0.997426588931718,0.903345724907063,5.9955035971223,158,58,100,1,1.7,33.75,27,0,0,0,0,0,0,0.999998087916365,344.934231580068,99.9999332557882
24.3,"random_instances_SVM","SVM",16,45,8733,8375,358,4600,4438,162,0.997451573505197,0.903345724907063,6.000900090009,160,58,102,2,1.8,34.5,27.4,0,0,0,0,0,0,0.999998596094928,344.103242484369,99.9999496704949
24.3,"random_instances_SVM","SVM",16,46,8633,8279,354,4700,4534,166,0.997645639727098,0.903345724907063,5.97859191123573,163,61,102,3,1.7,35.25,27.3,0,0,0,0,0,0,0.999999458289296,344.888323006356,99.999981158401
24.3,"random_instances_SVM","SVM",16,47,8533,8185,348,4800,4628,172,0.997448668322232,0.910780669144981,5.98937386238314,162,63,99,-1,1.6,36,26.9,0,0,0,0,0,0,0.999999725507546,341.235896419849,99.9999917422845
24.3,"random_instances_SVM","SVM",16,48,8433,8092,341,4900,4721,179,0.997434723444012,0.910780669144981,5.97859191123573,168,66,102,6,1.5,36.75,26.4,0,0,0,0,0,0,0.999998767727082,331.251134818092,99.9999604716971
24.3,"random_instances_SVM","SVM",17,0,13233,12724,509,100,95,5,0.970946637842786,0.807272727272727,5.47299021965689,31,5,26,0,5.2,0.75,19,0,0,0,0,0,0,0.987204928580586,705.8985382956,99.3321637906916
24.3,"random_instances_SVM","SVM",17,1,13133,12627,506,200,192,8,0.977459039708742,0.818181818181818,5.70438502673797,35,8,27,4,3.4,1.5,24,0,0,0,0,0,0,0.980677297736921,538.816277965961,98.8955523002971
24.3,"random_instances_SVM","SVM",17,2,13033,12531,502,300,288,12,0.97879906701558,0.810909090909091,5.64254545454545,52,11,41,17,3.7,2.25,24,0,0,0,0,0,0,0.995869002607245,558.42547864373,99.8852796673334
24.3,"random_instances_SVM","SVM",17,3,12933,12435,498,400,384,16,0.982249402662441,0.854545454545454,5.74535008976661,54,13,41,2,3.2,3,24,0,0,0,0,0,0,0.982700573006571,502.653960859418,98.9726436580146
24.3,"random_instances_SVM","SVM",17,4,12833,12338,495,500,481,19,0.981099670042111,0.854545454545454,5.63105738233398,56,14,42,2,3,3.75,25.3,0,0,0,0,0,0,0.993335288541439,491.747667334883,99.6159294827789
24.3,"random_instances_SVM","SVM",17,5,12733,12240,493,600,579,21,0.979825349869185,0.865454545454545,5.60795858945325,63,15,48,7,3.2,4.5,27.6,0,0,0,0,0,0,0.985224815700911,447.709795713145,99.0439575926866
24.3,"random_instances_SVM","SVM",17,6,12633,12144,489,700,675,25,0.9748156786893,0.88,5.59301126162886,62,17,45,-1,2.6,5.25,27,0,0,0,0,0,0,0.985298741670228,444.603830656318,99.0157196167657
24.3,"random_instances_SVM","SVM",17,7,12533,12048,485,800,771,29,0.974939697348986,0.88,5.58298794395569,66,17,49,4,2.9,6,26.6,0,0,0,0,0,0,0.991090692787785,440.32436396471,99.4317730509505
24.3,"random_instances_SVM","SVM",17,8,12433,11952,481,900,867,33,0.982254522698847,0.887272727272727,5.70053071253071,75,20,55,9,2.8,6.75,26.3,0,0,0,0,0,0,0.990694713174215,445.559686887007,99.4174861851212
24.3,"random_instances_SVM","SVM",17,9,12333,11856,477,1000,963,37,0.980857890545005,0.88,5.65684848484848,78,22,56,3,2.5,7.5,26,0,0,0,0,0,0,0.993026342362809,445.089862095892,99.5536457155923
24.3,"random_instances_SVM","SVM",17,10,12233,11760,473,1100,1059,41,0.991155421549653,0.876363636363636,5.89118173605978,84,24,60,6,2.5,8.25,25.8,0,0,0,0,0,0,0.992873473234491,435.764468850731,99.5529406813162
24.3,"random_instances_SVM","SVM",17,11,12133,11663,470,1200,1156,44,0.992647058823529,0.869090909090909,5.92427903926551,87,24,63,3,2.6,9,26.3,0,0,0,0,0,0,0.992311685357288,424.745773218739,99.5166421106875
24.3,"random_instances_SVM","SVM",17,12,12033,11564,469,1300,1255,45,0.992934918648315,0.869090909090909,5.96766433566434,89,24,65,2,2.7,9.75,27.9,0,0,0,0,0,0,0.993437164468226,421.349943212018,99.6120016439343
24.3,"random_instances_SVM","SVM",17,13,11933,11469,464,1400,1350,50,0.995098418477642,0.876363636363636,6.01714801444043,84,27,57,-5,2.1,10.5,27,0,0,0,0,0,0,0.99350469826172,428.456625466684,99.6186328260249
24.3,"random_instances_SVM","SVM",17,14,11833,11372,461,1500,1447,53,0.994219478894073,0.883636363636364,6.01698945981555,88,28,60,4,2.1,11.25,27.3,0,0,0,0,0,0,0.993785524794744,427.014517548747,99.6375397487085
24.3,"random_instances_SVM","SVM",17,15,11733,11276,457,1600,1543,57,0.996260097849587,0.883636363636364,6.0006832553174,89,29,60,1,2.1,12,27.1,0,0,0,0,0,0,0.996386774637671,434.027846213363,99.8683513045692
24.3,"random_instances_SVM","SVM",17,16,11633,11178,455,1700,1641,59,0.996237911025147,0.883636363636364,5.98418872266974,90,29,61,1,2.1,12.75,27.8,0,0,0,0,0,0,0.99721032234061,424.733234024047,99.9511110456605
24.3,"random_instances_SVM","SVM",17,17,11533,11080,453,1800,1739,61,0.996980316304473,0.883636363636364,6.01714801444043,97,31,66,7,2.1,13.5,28.5,0,0,0,0,0,0,0.996914647952044,426.420191072084,99.9114409188214
24.3,"random_instances_SVM","SVM",17,18,11433,10984,449,1900,1835,65,0.995500625782229,0.876363636363636,5.97878295146588,100,30,70,3,2.3,14.25,28.2,0,0,0,0,0,0,0.995853086617877,421.17241887572,99.8343334531861
24.3,"random_instances_SVM","SVM",17,19,11333,10887,446,2000,1932,68,0.995820343611333,0.876363636363636,5.99502964426877,100,29,71,0,2.4,15,28.4,0,0,0,0,0,0,0.996984324371644,413.722043133932,99.94143661423
24.3,"random_instances_SVM","SVM",17,20,11233,10791,442,2100,2028,72,0.996204915234953,0.876363636363636,6.03894927536232,100,29,71,0,2.4,15.75,28.2,0,0,0,0,0,0,0.999986653821105,403.566772686234,99.9994677205224
24.3,"random_instances_SVM","SVM",17,21,11133,10696,437,2200,2123,77,0.995391398338836,0.876363636363636,5.98960427807487,101,31,70,1,2.3,16.5,27.6,0,0,0,0,0,0,0.999989886964243,401.133948355628,99.9996055738377
24.3,"random_instances_SVM","SVM",17,22,11033,10599,434,2300,2220,80,0.995441460917059,0.876363636363636,5.98960427807487,102,31,71,1,2.3,17.25,27.8,0,0,0,0,0,0,0.999995536825034,395.890879987348,99.9998353896837
24.3,"random_instances_SVM","SVM",17,23,10933,10501,432,2400,2318,82,0.994948799635915,0.876363636363636,6.00046484793538,106,32,74,4,2.3,18,28.3,0,0,0,0,0,0,0.999991157192799,397.266683955541,99.9996549021541
24.3,"random_instances_SVM","SVM",17,24,10833,10408,425,2500,2411,89,0.994910114916372,0.883636363636364,5.93498234376283,118,35,83,12,2.4,18.75,27.1,0,0,0,0,0,0,0.999995642475821,399.111149985699,99.9998238168838
24.3,"random_instances_SVM","SVM",17,25,10733,10313,420,2600,2506,94,0.995644555694621,0.898181818181818,5.98418872266974,118,36,82,0,2.3,19.5,26.7,0,0,0,0,0,0,0.996750258365943,400.334605326717,99.9250371291809
24.3,"random_instances_SVM","SVM",17,26,10633,10218,415,2700,2601,99,0.994804300830584,0.898181818181818,5.96226861745849,119,39,80,1,2.1,20.25,26.3,0,0,0,0,0,0,0.999999302915445,404.088940191225,99.9999726394871
24.3,"random_instances_SVM","SVM",17,27,10533,10120,413,2800,2699,101,0.994038002048018,0.898181818181818,5.93498234376283,119,41,78,0,1.9,21,26.7,0,0,0,0,0,0,0.999996473977634,400.402640776578,99.9998546413768
24.3,"random_instances_SVM","SVM",17,28,10433,10025,408,2900,2794,106,0.995465923313226,0.898181818181818,5.95688264761435,126,43,83,7,1.9,21.75,26.4,0,0,0,0,0,0,0.999999061799281,406.939887180494,99.9999630644881
24.3,"random_instances_SVM","SVM",17,29,10333,9928,405,3000,2891,109,0.997828535669588,0.890909090909091,6.02802893309222,127,44,83,1,1.9,22.5,26.5,0,0,0,0,0,0,0.99999974249761,395.284344623252,99.9999900001347
24.3,"random_instances_SVM","SVM",17,30,10233,9830,403,3100,2989,111,0.997893958357037,0.890909090909091,6.03348416289593,129,44,85,2,1.9,23.25,26.9,0,0,0,0,0,0,0.999998955159697,390.174281127409,99.9999585409384
24.3,"random_instances_SVM","SVM",17,31,10133,9732,401,3200,3087,113,0.997939469791785,0.887272727272727,6.000900090009,130,44,86,1,2,24,27.3,0,0,0,0,0,0,0.999994608435796,384.885421190906,99.9997707614981
24.3,"random_instances_SVM","SVM",17,32,10033,9633,400,3300,3186,114,0.997841051314143,0.887272727272727,6.00630630630631,130,45,85,0,1.9,24.75,27.9,0,0,0,0,0,0,0.999998311908503,384.000901644664,99.9999304139031
24.3,"random_instances_SVM","SVM",17,33,9933,9533,400,3400,3286,114,0.997915007395609,0.887272727272727,6.000900090009,132,46,86,2,1.9,25.5,28.8,0,0,0,0,0,0,0.999998367162643,380.531756479761,99.9999348276857
24.3,"random_instances_SVM","SVM",17,34,9833,9438,395,3500,3381,119,0.997896802821711,0.894545454545455,5.97907863513624,138,47,91,6,1.9,26.25,28.4,0,0,0,0,0,0,0.999999199206516,381.731548733809,99.9999676120893
24.3,"random_instances_SVM","SVM",17,35,9733,9343,390,3600,3476,124,0.997892820571172,0.890909090909091,5.97370176586004,138,47,91,0,1.9,27,28,0,0,0,0,0,0,0.999998991546077,370.637363437145,99.9999599319404
24.3,"random_instances_SVM","SVM",17,36,9633,9246,387,3700,3573,127,0.997780748663105,0.901818181818182,5.97370176586004,141,49,92,3,1.9,27.75,28.1,0,0,0,0,0,0,0.99999969026618,376.523887987047,99.9999874757818
24.3,"random_instances_SVM","SVM",17,37,9533,9151,382,3800,3668,132,0.998445784503356,0.901818181818182,5.97401433691756,152,51,101,11,2,28.5,27.8,0,0,0,0,0,0,0.999999706446138,372.687104302036,99.9999880328821
24.3,"random_instances_SVM","SVM",17,38,9433,9057,376,3900,3762,138,0.998512344976675,0.901818181818182,5.97937219730942,151,51,100,-1,2,29.25,27.3,0,0,0,0,0,0,0.999998619223824,365.523766770091,99.999944199235
24.3,"random_instances_SVM","SVM",17,39,9333,8958,375,4000,3861,139,0.998742177722153,0.909090909090909,5.97937219730942,153,52,101,2,1.9,30,27.8,0,0,0,0,0,0,0.999999100447746,369.001029195943,99.9999626562047
24.3,"random_instances_SVM","SVM",17,40,9233,8865,368,4100,3954,146,0.998708044146092,0.901818181818182,5.97401433691756,156,53,103,3,1.9,30.75,27.1,0,0,0,0,0,0,0.999999779542142,360.04103615874,99.9999917209246
24.3,"random_instances_SVM","SVM",17,41,9133,8770,363,4200,4049,151,0.998656274889066,0.901818181818182,6.0117222723174,156,54,102,0,1.9,31.5,26.8,0,0,0,0,0,0,0.999999661523291,354.805574375054,99.999987239319
24.3,"random_instances_SVM","SVM",17,42,9033,8675,358,4300,4144,156,0.998697235180339,0.901818181818182,6.01714801444043,155,54,101,-1,1.9,32.25,26.6,0,0,0,0,0,0,0.999999875158961,349.841054108712,99.9999957565534
24.3,"random_instances_SVM","SVM",17,43,8933,8579,354,4400,4240,160,0.998800204801456,0.905454545454545,6.03894927536232,156,55,101,1,1.8,33,26.5,0,0,0,0,0,0,0.999999382105224,345.196659052262,99.9999778932984
24.3,"random_instances_SVM","SVM",17,44,8833,8483,350,4500,4336,164,0.998919103424735,0.905454545454545,6.03894927536232,159,56,103,3,1.8,33.75,26.4,0,0,0,0,0,0,0.999999583788978,342.495496237762,99.999984772267
24.3,"random_instances_SVM","SVM",17,45,8733,8386,347,4600,4433,167,0.998908863351917,0.905454545454545,6.02802893309222,162,57,105,3,1.8,34.5,26.5,0,0,0,0,0,0,0.999999947603772,340.574426794722,99.9999983244276
24.3,"random_instances_SVM","SVM",17,46,8633,8290,343,4700,4529,171,0.998975423825236,0.905454545454545,6.02802893309222,168,59,109,6,1.8,35.25,26.5,0,0,0,0,0,0,0.999999486611489,336.586182620424,99.9999815626478
24.3,"random_instances_SVM","SVM",17,47,8533,8191,342,4800,4628,172,0.998955512572534,0.905454545454545,6.03348416289593,170,61,109,2,1.8,36,26.9,0,0,0,0,0,0,0.999999886661127,336.088782683284,99.999996146147
24.3,"random_instances_SVM","SVM",17,48,8433,8095,338,4900,4724,176,0.999032313118671,0.909090909090909,6.03894927536232,173,62,111,3,1.8,36.75,26.8,0,0,0,0,0,0,0.999999739312416,333.744284939366,99.9999908699545
24.3,"random_instances_SVM","SVM",18,0,13233,12705,528,100,95,5,0.908090708352841,0.7109375,4.64176306769494,25,5,20,0,4,0.75,19,0,0,0,0,0,0,0.992733261795642,613.930522213465,99.757139091637
24.3,"random_instances_SVM","SVM",18,1,13133,12608,525,200,192,8,0.955412937724212,0.78125,5.03693151019081,23,7,16,-2,2.3,1.5,24,0,0,0,0,0,0,0.859531692467714,320.739002728175,91.0750613756823
24.3,"random_instances_SVM","SVM",18,2,13033,12513,520,300,287,13,0.953074427741405,0.77734375,5.04057459677419,28,10,18,5,1.8,2.25,22.1,0,0,0,0,0,0,0.945803477951089,357.700840732735,96.6427126460011
24.3,"random_instances_SVM","SVM",18,3,12933,12418,515,400,382,18,0.952551035329871,0.82421875,4.9840853987069,38,13,25,10,1.9,3,21.2,0,0,0,0,0,0,0.956881976142063,394.918094797653,97.1840869148682
24.3,"random_instances_SVM","SVM",18,4,12833,12319,514,500,481,19,0.960663313055689,0.83203125,5.11040260818338,33,11,22,-5,2,3.75,25.3,0,0,0,0,0,0,0.967492987095106,389.36026455367,97.9863484722368
24.3,"random_instances_SVM","SVM",18,5,12733,12225,508,600,575,25,0.963168772422387,0.84765625,5.35834667003594,57,15,42,24,2.8,4.5,23,0,0,0,0,0,0,0.990238405843409,460.465245860213,99.4105862234837
24.3,"random_instances_SVM","SVM",18,6,12633,12130,503,700,670,30,0.965233095460935,0.84765625,5.39544913116592,69,18,51,12,2.8,5.25,22.3,0,0,0,0,0,0,0.974166010429469,448.148869308032,98.2811928159787
24.3,"random_instances_SVM","SVM",18,7,12533,12039,494,800,761,39,0.957814206052087,0.84765625,5.34455164266427,72,22,50,3,2.3,6,19.5,0,0,0,0,0,0,0.989749872752301,463.352482520125,99.3838173319114
24.3,"random_instances_SVM","SVM",18,8,12433,11942,491,900,858,42,0.961045346864759,0.84765625,5.40115672903517,79,23,56,7,2.4,6.75,20.4,0,0,0,0,0,0,0.990430765611669,469.739141330547,99.3930580741679
24.3,"random_instances_SVM","SVM",18,9,12333,11844,489,1000,956,44,0.967552107705503,0.84765625,5.47654487251805,87,25,62,8,2.5,7.5,21.7,0,0,0,0,0,0,0.989628264531506,470.72664951537,99.3521749307875
24.3,"random_instances_SVM","SVM",18,10,12233,11747,486,1100,1053,47,0.982543431211974,0.84765625,5.65744922576302,103,28,75,16,2.7,8.25,22.4,0,0,0,0,0,0,0.987732975541709,469.093960567005,99.2246734957229
24.3,"random_instances_SVM","SVM",18,11,12133,11650,483,1200,1150,50,0.981870759241928,0.84765625,5.71158971683213,98,27,71,-5,2.6,9,23,0,0,0,0,0,0,0.995450575846019,480.709275483069,99.76416162934
24.3,"random_instances_SVM","SVM",18,12,12033,11555,478,1300,1245,55,0.982081578536879,0.84765625,5.70643950067628,105,29,76,7,2.6,9.75,22.6,0,0,0,0,0,0,0.994757202937528,474.713679295876,99.7218466521137
24.3,"random_instances_SVM","SVM",18,13,11933,11461,472,1400,1339,61,0.985056506882694,0.84765625,5.86617279745686,112,29,83,7,2.9,10.5,22,0,0,0,0,0,0,0.993986753780364,470.717536092569,99.658487620341
24.3,"random_instances_SVM","SVM",18,14,11833,11365,468,1500,1435,65,0.986099331227553,0.84765625,5.88220059198543,109,32,77,-3,2.4,11.25,22.1,0,0,0,0,0,0,0.995068675913799,456.691516855799,99.7674403232575
24.3,"random_instances_SVM","SVM",18,15,11733,11270,463,1600,1530,70,0.985329170566201,0.8515625,5.80831397325476,111,34,77,2,2.3,12,21.9,0,0,0,0,0,0,0.99466648080023,442.807955024174,99.7368436827173
24.3,"random_instances_SVM","SVM",18,16,11633,11174,459,1700,1626,74,0.985298096045844,0.8515625,5.81085210591689,114,34,80,3,2.4,12.75,22,0,0,0,0,0,0,0.99428063630184,439.105985133942,99.701771621065
24.3,"random_instances_SVM","SVM",18,17,11533,11077,456,1800,1723,77,0.98833121295429,0.8515625,5.89518110795455,116,34,82,2,2.4,13.5,22.4,0,0,0,0,0,0,0.994877480047005,450.182420716287,99.7733884514344
24.3,"random_instances_SVM","SVM",18,18,11433,10980,453,1900,1820,80,0.98813501696303,0.8515625,5.89518110795455,122,36,86,6,2.4,14.25,22.8,0,0,0,0,0,0,0.994577437713324,447.187047091009,99.7482048740424
24.3,"random_instances_SVM","SVM",18,19,11333,10882,451,2000,1918,82,0.988917973015135,0.8515625,5.90811450771325,120,38,82,-2,2.2,15,23.4,0,0,0,0,0,0,0.995372745678196,444.503712407045,99.812792811736
24.3,"random_instances_SVM","SVM",18,20,11233,10787,446,2100,2013,87,0.988968545273745,0.84765625,5.8814292570009,124,37,87,4,2.4,15.75,23.1,0,0,0,0,0,0,0.9961793748069,443.478888959764,99.8801092241563
24.3,"random_instances_SVM","SVM",18,21,11133,10694,439,2200,2106,94,0.990200558610201,0.84765625,5.95537942377495,129,40,89,5,2.2,16.5,22.4,0,0,0,0,0,0,0.996476535931697,435.197287302745,99.9080371354424
24.3,"random_instances_SVM","SVM",18,22,11033,10599,434,2300,2201,99,0.990279158867575,0.84375,5.94793917766151,129,41,88,0,2.1,17.25,22.2,0,0,0,0,0,0,0.99998280256016,435.387043614142,99.9993156375993
24.3,"random_instances_SVM","SVM",18,23,10933,10503,430,2400,2297,103,0.991010933356724,0.84765625,5.90495497402891,134,43,91,5,2.1,18,22.3,0,0,0,0,0,0,0.99998338683106,437.860478425309,99.9994202176971
24.3,"random_instances_SVM","SVM",18,24,10833,10407,426,2500,2393,107,0.991295478474503,0.84765625,5.91029399299277,129,42,87,-5,2.1,18.75,22.4,0,0,0,0,0,0,0.999991721528196,429.533206403952,99.9996704995261
24.3,"random_instances_SVM","SVM",18,25,10733,10313,420,2600,2487,113,0.991043226485709,0.84765625,5.90182385341727,141,47,94,12,2,19.5,22,0,0,0,0,0,0,0.999983645687316,429.518652955362,99.9993443851466
24.3,"random_instances_SVM","SVM",18,26,10633,10219,414,2700,2581,119,0.991027384573376,0.84765625,5.8943058216862,140,47,93,-1,2,20.25,21.7,0,0,0,0,0,0,0.999990605891988,422.65240960763,99.9996433208431
24.3,"random_instances_SVM","SVM",18,27,10533,10123,410,2800,2677,123,0.990676425284653,0.84765625,5.84972343890386,143,47,96,3,2,21,21.8,0,0,0,0,0,0,0.99999473858481,418.160990452687,99.9998088847756
24.3,"random_instances_SVM","SVM",18,28,10433,10031,402,2900,2769,131,0.991071863788801,0.85546875,5.8943058216862,147,50,97,4,1.9,21.75,21.1,0,0,0,0,0,0,0.999996972813602,413.508805272134,99.9998883973631
24.3,"random_instances_SVM","SVM",18,29,10333,9932,401,3000,2868,132,0.989663761503651,0.8515625,5.88369501012601,143,51,92,-4,1.8,22.5,21.7,0,0,0,0,0,0,0.999994839317655,404.446746330553,99.9998151480374
24.3,"random_instances_SVM","SVM",18,30,10233,9834,399,3100,2966,134,0.990055544181861,0.85546875,5.88369501012601,143,50,93,0,1.9,23.25,22.1,0,0,0,0,0,0,0.999985738896713,396.297223960861,99.999481947434
24.3,"random_instances_SVM","SVM",18,31,10133,9735,398,3200,3065,135,0.991435009163924,0.8515625,5.90713602610261,144,52,92,1,1.8,24,22.7,0,0,0,0,0,0,0.999996678662069,398.770802987763,99.999884219717
24.3,"random_instances_SVM","SVM",18,32,10033,9641,392,3300,3159,141,0.991697314673985,0.8515625,5.94459069293478,150,53,97,6,1.8,24.75,22.4,0,0,0,0,0,0,0.999997605396662,399.69858926123,99.9999120870756
24.3,"random_instances_SVM","SVM",18,33,9933,9546,387,3400,3254,146,0.992168002261723,0.8515625,5.94998016772439,154,55,99,4,1.8,25.5,22.3,0,0,0,0,0,0,0.999997341641958,396.56305659536,99.9999061601976
24.3,"random_instances_SVM","SVM",18,34,9833,9449,384,3500,3351,149,0.992484231204161,0.85546875,5.97359120013599,157,58,99,3,1.7,26.25,22.5,0,0,0,0,0,0,0.999998541339712,396.6561787109,99.9999495407093
24.3,"random_instances_SVM","SVM",18,35,9733,9354,379,3600,3446,154,0.994992737092497,0.85546875,6.00448194507233,165,58,107,8,1.8,27,22.4,0,0,0,0,0,0,0.99999951557915,395.668798788125,99.9999839312965
24.3,"random_instances_SVM","SVM",18,36,9633,9258,375,3700,3542,158,0.995112160739355,0.85546875,6.00991586538462,162,56,106,-3,1.9,27.75,22.4,0,0,0,0,0,0,0.999997621485497,383.773015041507,99.9999090158483
24.3,"random_instances_SVM","SVM",18,37,9533,9162,371,3800,3638,162,0.995165170215256,0.859375,6.00448194507233,160,56,104,-2,1.9,28.5,22.5,0,0,0,0,0,0,0.999998191968765,379.770815179635,99.9999345048659
24.3,"random_instances_SVM","SVM",18,38,9433,9065,368,3900,3735,165,0.99469174075807,0.85546875,5.97013904557762,165,57,108,5,1.9,29.25,22.6,0,0,0,0,0,0,0.999999771136321,377.379878614514,99.9999912308203
24.3,"random_instances_SVM","SVM",18,39,9333,8967,366,4000,3833,167,0.995082914131961,0.85546875,6.00448194507233,170,57,113,5,2,30,23,0,0,0,0,0,0,0.999998893256404,376.042114464514,99.9999562736118
24.3,"random_instances_SVM","SVM",18,40,9233,8873,360,4100,3927,173,0.996710975276869,0.86328125,6.05540417801998,171,58,113,1,1.9,30.75,22.7,0,0,0,0,0,0,0.999999266992726,366.402398099217,99.9999726248795
24.3,"random_instances_SVM","SVM",18,41,9133,8774,359,4200,4026,174,0.996677463539231,0.86328125,6.03175025544959,174,58,116,3,2,31.5,23.1,0,0,0,0,0,0,0.999999534480134,367.795138696976,99.999982656464
24.3,"random_instances_SVM","SVM",18,42,9033,8680,353,4300,4120,180,0.997569485064733,0.8671875,6.04990925589837,172,60,112,-2,1.9,32.25,22.9,0,0,0,0,0,0,0.999999705254322,362.204087727851,99.9999896388732
24.3,"random_instances_SVM","SVM",18,43,8933,8583,350,4400,4217,183,0.997595685150523,0.87109375,6.04442429737081,173,60,113,1,1.9,33,23,0,0,0,0,0,0,0.99999947431501,358.276987881418,99.9999812428037
24.3,"random_instances_SVM","SVM",18,44,8833,8486,347,4500,4314,186,0.997467731243177,0.87109375,6.04442429737081,177,61,116,4,1.9,33.75,23.2,0,0,0,0,0,0,0.999999796729261,352.494720472396,99.9999932913843
24.3,"random_instances_SVM","SVM",18,45,8733,8389,344,4600,4411,189,0.99751403837155,0.8671875,6.04442429737081,178,61,117,1,1.9,34.5,23.3,0,0,0,0,0,0,0.999999766289811,346.686485296799,99.9999923881783
24.3,"random_instances_SVM","SVM",18,46,8633,8291,342,4700,4509,191,0.997966751481828,0.875,6.04442429737081,177,62,115,-1,1.9,35.25,23.6,0,0,0,0,0,0,0.999999857046204,350.95514661968,99.999995407649
24.3,"random_instances_SVM","SVM",18,47,8533,8195,338,4800,4605,195,0.998088003041647,0.87890625,6.03348416289593,183,64,119,6,1.9,36,23.6,0,0,0,0,0,0,0.999999892147967,348.691380732621,99.9999965747272
24.3,"random_instances_SVM","SVM",18,48,8433,8100,333,4900,4700,200,0.998086784433006,0.8828125,6.03348416289593,183,64,119,0,1.9,36.75,23.5,0,0,0,0,0,0,0.999999893291703,343.598795340612,99.9999966379542
24.3,"random_instances_SVM","SVM",19,0,13233,12713,520,100,93,7,0.959913831632005,0.83206106870229,5.18019356597601,26,7,19,0,2.7,0.75,13.3,0,0,0,0,0,0,0.999990414825594,686.110629836404,99.9995534560752
24.3,"random_instances_SVM","SVM",19,1,13133,12616,517,200,190,10,0.93321832299433,0.83206106870229,5.09380090741414,28,9,19,2,2.1,1.5,19,0,0,0,0,0,0,0.989417376920599,490.680472837283,99.2823523073295
24.3,"random_instances_SVM","SVM",19,2,13033,12519,514,300,287,13,0.966445584616021,0.843511450381679,5.31921108323924,36,10,26,8,2.6,2.25,22.1,0,0,0,0,0,0,0.993743642716871,522.151693639984,99.6283722705732
24.3,"random_instances_SVM","SVM",19,3,12933,12425,508,400,381,19,0.970245693071363,0.83206106870229,5.48847477922467,56,16,40,20,2.5,3,20.1,0,0,0,0,0,0,0.990567167602303,545.368479596429,99.4111954191389
24.3,"random_instances_SVM","SVM",19,4,12833,12327,506,500,479,21,0.971835576928805,0.83587786259542,5.49518112670661,55,17,38,-1,2.2,3.75,22.8,0,0,0,0,0,0,0.989460941667296,513.867560563397,99.2887684209227
24.3,"random_instances_SVM","SVM",19,5,12733,12231,502,600,575,25,0.975885371042429,0.851145038167939,5.59594141825844,64,19,45,9,2.4,4.5,23,0,0,0,0,0,0,0.98925562112634,512.462277002909,99.2892241124918
24.3,"random_instances_SVM","SVM",19,6,12633,12132,501,700,674,26,0.976167831667776,0.851145038167939,5.56071516832336,63,20,43,-1,2.1,5.25,25.9,0,0,0,0,0,0,0.991152800730942,503.026005525243,99.4347229153125
24.3,"random_instances_SVM","SVM",19,7,12533,12034,499,800,772,28,0.979397655695993,0.858778625954199,5.63443290893975,71,22,49,8,2.2,6,27.6,0,0,0,0,0,0,0.999992565897608,530.138812611146,99.9996657720042
24.3,"random_instances_SVM","SVM",19,8,12433,11942,491,900,864,36,0.978584836512513,0.858778625954199,5.5614704700683,74,24,50,3,2.1,6.75,24,0,0,0,0,0,0,0.991405034209211,485.223885145202,99.4380585905184
24.3,"random_instances_SVM","SVM",19,9,12333,11845,488,1000,961,39,0.978619399205051,0.854961832061069,5.60416737854258,78,25,53,4,2.1,7.5,24.6,0,0,0,0,0,0,0.997139320812506,491.553541051933,99.9449749512499
24.3,"random_instances_SVM","SVM",19,10,12233,11750,483,1100,1056,44,0.973411754890919,0.862595419847328,5.54867009120739,86,28,58,8,2.1,8.25,24,0,0,0,0,0,0,0.999983976954801,502.778107470092,99.9992835649377
24.3,"random_instances_SVM","SVM",19,11,12133,11659,474,1200,1147,53,0.972756851457912,0.858778625954199,5.52398739507213,90,31,59,4,1.9,9,21.6,0,0,0,0,0,0,0.997457244507095,491.842067980584,99.9991622782417
24.3,"random_instances_SVM","SVM",19,12,12033,11561,472,1300,1245,55,0.974276418113261,0.862595419847328,5.53383407492074,92,31,61,2,2,9.75,22.6,0,0,0,0,0,0,0.999996917490336,481.171843138476,99.9998780264657
24.3,"random_instances_SVM","SVM",19,13,11933,11463,470,1400,1343,57,0.974406922073054,0.858778625954199,5.54460138337649,92,32,60,0,1.9,10.5,23.6,0,0,0,0,0,0,0.999999308101525,484.709819323434,99.9999735473632
24.3,"random_instances_SVM","SVM",19,14,11833,11367,466,1500,1439,61,0.99221475350245,0.862595419847328,5.82728585795182,93,34,59,1,1.7,11.25,23.6,0,0,0,0,0,0,0.99999708918055,472.638695519457,99.9998893159553
24.3,"random_instances_SVM","SVM",19,15,11733,11272,461,1600,1534,66,0.994745278914968,0.862595419847328,5.87576098599379,94,38,56,1,1.5,12,23.2,0,0,0,0,0,0,0.999998700490294,470.932141560609,99.9999531787508
24.3,"random_instances_SVM","SVM",19,16,11633,11173,460,1700,1633,67,0.994932990090043,0.858778625954199,5.84461737652739,101,39,62,7,1.6,12.75,24.4,0,0,0,0,0,0,0.999998862413473,473.365680376763,99.9999594451461
24.3,"random_instances_SVM","SVM",19,17,11533,11077,456,1800,1729,71,0.995433553223567,0.866412213740458,5.86014780356865,104,40,64,3,1.6,13.5,24.4,0,0,0,0,0,0,0.999995886825795,447.69564741421,99.9998565019533
24.3,"random_instances_SVM","SVM",19,18,11433,10979,454,1900,1827,73,0.995401970073472,0.866412213740458,5.86534297006118,103,41,62,-1,1.5,14.25,25,0,0,0,0,0,0,0.999996904966816,445.492052544895,99.9998927092539
24.3,"random_instances_SVM","SVM",19,19,11333,10882,451,2000,1924,76,0.995310200165661,0.858778625954199,5.87054735601509,103,40,63,0,1.6,15,25.3,0,0,0,0,0,0,0.999995319464693,434.903767109912,99.9998366983778
24.3,"random_instances_SVM","SVM",19,20,11233,10784,449,2100,2022,78,0.995377537825291,0.862595419847328,5.87576098599379,107,40,67,4,1.7,15.75,25.9,0,0,0,0,0,0,0.999991797759575,435.690007305394,99.9996798568417
24.3,"random_instances_SVM","SVM",19,21,11133,10688,445,2200,2118,82,0.996757065984947,0.877862595419847,5.95121275547895,115,43,72,8,1.7,16.5,25.8,0,0,0,0,0,0,0.99999755800125,456.839341290787,99.9999031292562
24.3,"random_instances_SVM","SVM",19,22,11033,10590,443,2300,2216,84,0.996521086221998,0.877862595419847,5.97261999560657,126,45,81,11,1.8,17.25,26.4,0,0,0,0,0,0,0.999986386187577,449.24242068527,99.9994219223624
24.3,"random_instances_SVM","SVM",19,23,10933,10494,439,2400,2312,88,0.996252331491975,0.870229007633588,5.95655016602198,127,46,81,1,1.8,18,26.3,0,0,0,0,0,0,0.999994652013534,449.023452090294,99.9997940161489
24.3,"random_instances_SVM","SVM",19,24,10833,10395,438,2500,2411,89,0.996047338970626,0.874045801526718,5.96189715898968,133,47,86,6,1.8,18.75,27.1,0,0,0,0,0,0,0.999998767985879,451.180755455436,99.9999550188829
24.3,"random_instances_SVM","SVM",19,25,10733,10299,434,2600,2507,93,0.996160561584163,0.874045801526718,5.96189715898968,132,47,85,-1,1.8,19.5,27,0,0,0,0,0,0,0.999994244007912,442.870526533768,99.9997796602936
24.3,"random_instances_SVM","SVM",19,26,10633,10200,433,2700,2606,94,0.995629607117531,0.870229007633588,5.98473967684022,133,49,84,1,1.7,20.25,27.7,0,0,0,0,0,0,0.999993800250991,437.919725325692,99.9997656212231
24.3,"random_instances_SVM","SVM",19,27,10533,10103,430,2800,2703,97,0.996502613058737,0.877862595419847,5.96189715898968,140,51,89,7,1.7,21,27.9,0,0,0,0,0,0,0.999994144302677,436.020652554877,99.9997648398694
24.3,"random_instances_SVM","SVM",19,28,10433,10007,426,2900,2799,101,0.996726078743348,0.877862595419847,5.95121275547895,141,50,91,1,1.8,21.75,27.7,0,0,0,0,0,0,0.999997417329075,430.213990005075,99.9998987061275
24.3,"random_instances_SVM","SVM",19,29,10333,9908,425,3000,2898,102,0.995600407601407,0.877862595419847,5.88977685910948,140,50,90,-1,1.8,22.5,28.4,0,0,0,0,0,0,0.999998592276593,427.449063962774,99.999949153439
24.3,"random_instances_SVM","SVM",19,30,10233,9810,423,3100,2996,104,0.995607558503314,0.877862595419847,5.88977685910948,142,51,91,2,1.8,23.25,28.8,0,0,0,0,0,0,0.999993321436439,418.750986539578,99.9997496352902
24.3,"random_instances_SVM","SVM",19,31,10133,9714,419,3200,3092,108,0.995485397262395,0.877862595419847,5.88977685910948,149,51,98,7,1.9,24,28.6,0,0,0,0,0,0,0.999996267008596,411.402899447154,99.9998543420579
24.3,"random_instances_SVM","SVM",19,32,10033,9622,411,3300,3184,116,0.997460238005851,0.885496183206107,5.93525776149643,153,55,98,4,1.8,24.75,27.4,0,0,0,0,0,0,0.999998079918015,410.341797387786,99.9999339219547
24.3,"random_instances_SVM","SVM",19,33,9933,9528,405,3400,3278,122,0.997304705889361,0.881679389312977,5.92995842420938,160,54,106,7,2,25.5,26.9,0,0,0,0,0,0,0.999999216908776,411.04851095414,99.999973349895
24.3,"random_instances_SVM","SVM",19,34,9833,9430,403,3500,3376,124,0.996919749003337,0.881679389312977,5.93525776149643,156,57,99,-4,1.7,26.25,27.2,0,0,0,0,0,0,0.999996738590438,407.943054260471,99.9998797679204
24.3,"random_instances_SVM","SVM",19,35,9733,9332,401,3600,3474,126,0.997110439720872,0.885496183206107,5.93525776149643,156,57,99,0,1.7,27,27.6,0,0,0,0,0,0,0.997425875851317,391.306893272785,99.9967193314687
24.3,"random_instances_SVM","SVM",19,36,9633,9237,396,3700,3569,131,0.997428058947266,0.893129770992366,5.93525776149643,156,57,99,0,1.7,27.75,27.2,0,0,0,0,0,0,0.999996354704706,388.867530480234,99.9998712144969
24.3,"random_instances_SVM","SVM",19,37,9533,9141,392,3800,3665,135,0.997873202591008,0.900763358778626,5.9405665788144,163,61,102,7,1.7,28.5,27.1,0,0,0,0,0,0,0.999996000339368,383.088726122066,99.9998560101582
24.3,"random_instances_SVM","SVM",19,38,9433,9042,391,3900,3764,136,0.998029926524481,0.912213740458015,5.9405665788144,164,62,102,1,1.6,29.25,27.7,0,0,0,0,0,0,0.999998992368651,383.470684706374,99.9999632649898
24.3,"random_instances_SVM","SVM",19,39,9333,8949,384,4000,3857,143,0.998041844694328,0.916030534351145,5.93525776149643,170,63,107,6,1.7,30,27,0,0,0,0,0,0,0.99999887320553,384.147599835846,99.9999608333192
24.3,"random_instances_SVM","SVM",19,40,9233,8854,379,4100,3952,148,0.997855325336239,0.912213740458015,5.96189715898968,166,64,102,-4,1.6,30.75,26.7,0,0,0,0,0,0,0.99999660311886,372.482524894995,99.9998864223053
24.3,"random_instances_SVM","SVM",19,41,9133,8757,376,4200,4049,151,0.997748061807625,0.912213740458015,5.93525776149643,171,65,106,5,1.6,31.5,26.8,0,0,0,0,0,0,0.999998301250936,372.990413994423,99.9999392963863
24.3,"random_instances_SVM","SVM",19,42,9033,8661,372,4300,4145,155,0.99799834337439,0.912213740458015,5.94588490162444,171,64,107,0,1.7,32.25,26.7,0,0,0,0,0,0,0.999999103870664,370.184758538749,99.9999707484104
24.3,"random_instances_SVM","SVM",19,43,8933,8567,366,4400,4239,161,0.997854729427746,0.908396946564885,5.94588490162444,168,64,104,-3,1.6,33,26.3,0,0,0,0,0,0,0.999996220488498,359.461729077199,99.9998741414016
24.3,"random_instances_SVM","SVM",19,44,8833,8473,360,4500,4333,167,0.998298085346016,0.904580152671756,5.9686660698299,179,64,115,11,1.8,33.75,25.9,0,0,0,0,0,0,0.999996098583393,356.760196330966,99.9998814241388
24.3,"random_instances_SVM","SVM",19,45,8733,8377,356,4600,4429,171,0.998279016274262,0.912213740458015,5.9405665788144,184,68,116,5,1.7,34.5,25.9,0,0,0,0,0,0,0.999998191913113,355.468439033564,99.9999475334672
24.3,"random_instances_SVM","SVM",19,46,8633,8282,351,4700,4524,176,0.998014432903682,0.916030534351145,5.94588490162444,185,71,114,1,1.6,35.25,25.7,0,0,0,0,0,0,0.999998517040813,348.899577778658,99.9999556336832
24.3,"random_instances_SVM","SVM",19,47,8533,8186,347,4800,4620,180,0.997907765283561,0.916030534351145,5.93525776149643,188,69,119,3,1.7,36,25.7,0,0,0,0,0,0,0.999999329275067,345.441619304308,99.9999809733195
24.3,"random_instances_SVM","SVM",19,48,8433,8091,342,4900,4715,185,0.998091305099188,0.923664122137405,5.99959659901943,192,70,122,4,1.7,36.75,25.5,0,0,0,0,0,0,0.999999770407286,339.473528032284,99.9999935118776
24.3,"random_instances_SVM","SVM",20,0,13233,12710,523,100,95,5,0.97375365288528,0.793103448275862,5.67901272885909,25,5,20,0,4,0.75,19,0,0,0,0,0,0,0.981409694616639,807.884400267877,98.984936764695
24.3,"random_instances_SVM","SVM",20,1,13133,12613,520,200,192,8,0.973335582182908,0.827586206896552,5.70221332165133,27,8,19,2,2.4,1.5,24,0,0,0,0,0,0,0.960904163483015,509.618091288072,97.4900893976309
24.3,"random_instances_SVM","SVM",20,2,13033,12520,513,300,285,15,0.968003535957117,0.873563218390805,5.52364961973265,44,13,31,17,2.4,2.25,19,0,0,0,0,0,0,0.99513300133222,632.440784347635,99.8049395921803
24.3,"random_instances_SVM","SVM",20,3,12933,12420,513,400,385,15,0.970721294571821,0.881226053639847,5.54813388223146,48,13,35,4,2.7,3,25.7,0,0,0,0,0,0,0.99132632877838,552.498841399572,99.5617962214348
24.3,"random_instances_SVM","SVM",20,4,12833,12324,509,500,481,19,0.981245432024356,0.888888888888889,5.66892960828752,54,14,40,6,2.9,3.75,25.3,0,0,0,0,0,0,0.994060400082123,568.201729971843,99.757802514483
24.3,"random_instances_SVM","SVM",20,5,12733,12230,503,600,575,25,0.982756826394819,0.881226053639847,5.72696036323475,64,18,46,10,2.6,4.5,23,0,0,0,0,0,0,0.997186823608285,568.273585095044,99.9753516841479
24.3,"random_instances_SVM","SVM",20,6,12633,12134,499,700,671,29,0.983417126903339,0.888888888888889,5.71171557078604,63,19,44,-1,2.3,5.25,23.1,0,0,0,0,0,0,0.99723040230632,533.68781449401,99.9621662063115
24.3,"random_instances_SVM","SVM",20,7,12533,12040,493,800,765,35,0.980968512517621,0.89272030651341,5.6941024751094,68,21,47,5,2.2,6,21.9,0,0,0,0,0,0,0.995547259794577,511.47311828047,99.8048164491254
24.3,"random_instances_SVM","SVM",20,8,12433,11945,488,900,860,40,0.984444659759857,0.869731800766284,5.71678814234091,74,24,50,6,2.1,6.75,21.5,0,0,0,0,0,0,0.994789937524025,518.535951499774,99.7330187679216
24.3,"random_instances_SVM","SVM",20,9,12333,11853,480,1000,952,48,0.987804177836156,0.865900383141762,5.7339222114295,82,27,55,8,2,7.5,19.8,0,0,0,0,0,0,0.997498312840473,516.099960211412,99.999175668329
24.3,"random_instances_SVM","SVM",20,10,12233,11756,477,1100,1049,51,0.987939946147246,0.865900383141762,5.75704664674466,86,28,58,4,2.1,8.25,20.6,0,0,0,0,0,0,0.999986644287183,508.035328788969,99.9993975280968
24.3,"random_instances_SVM","SVM",20,11,12133,11661,472,1200,1144,56,0.988609816228335,0.865900383141762,5.79302818828681,89,29,60,3,2.1,9,20.4,0,0,0,0,0,0,0.999980898473079,497.654227664779,99.9992069365119
24.3,"random_instances_SVM","SVM",20,12,12033,11565,468,1300,1240,60,0.990161283184006,0.865900383141762,5.82623938477988,84,29,55,-5,1.9,9.75,20.7,0,0,0,0,0,0,0.997283022837218,471.293770727538,99.9834216440821
24.3,"random_instances_SVM","SVM",20,13,11933,11468,465,1400,1337,63,0.989538662867564,0.865900383141762,5.78484514403544,89,32,57,5,1.8,10.5,21.2,0,0,0,0,0,0,0.997398312755861,460.327672988857,99.9942245920494
24.3,"random_instances_SVM","SVM",20,14,11833,11374,459,1500,1431,69,0.991881413856524,0.877394636015326,5.90006071270542,104,36,68,15,1.9,11.25,20.7,0,0,0,0,0,0,0.999991716819936,499.497144986975,99.9996621212009
24.3,"random_instances_SVM","SVM",20,15,11733,11277,456,1600,1528,72,0.99163858595213,0.885057471264368,5.93564534791073,107,38,69,3,1.8,12,21.2,0,0,0,0,0,0,0.999992049347903,497.621281129637,99.9997125245295
24.3,"random_instances_SVM","SVM",20,16,11633,11182,451,1700,1623,77,0.991748636036862,0.89272030651341,5.93028342799392,112,41,71,5,1.7,12.75,21.1,0,0,0,0,0,0,0.999996032462991,472.319692392734,99.9998526644528
24.3,"random_instances_SVM","SVM",20,17,11533,11087,446,1800,1718,82,0.991228888625744,0.885057471264368,5.91425563494529,117,42,75,5,1.8,13.5,21,0,0,0,0,0,0,0.999999138843691,477.332263483311,99.9999682315014
24.3,"random_instances_SVM","SVM",20,18,11433,10993,440,1900,1812,88,0.991240850591482,0.885057471264368,5.91958859764587,119,43,76,2,1.8,14.25,20.6,0,0,0,0,0,0,0.999999374508718,465.577059026515,99.9999769088499
24.3,"random_instances_SVM","SVM",20,19,11333,10896,437,2000,1909,91,0.990571578608662,0.888888888888889,5.89655517897799,122,44,78,3,1.8,15,21,0,0,0,0,0,0,0.999998656754018,462.367320534116,99.9999482155081
24.3,"random_instances_SVM","SVM",20,20,11233,10799,434,2100,2006,94,0.990630790339044,0.89272030651341,5.89655517897799,121,46,75,-1,1.6,15.75,21.3,0,0,0,0,0,0,0.999999538050986,461.284040457566,99.9999830908892
24.3,"random_instances_SVM","SVM",20,21,11133,10702,431,2200,2103,97,0.990801248350749,0.888888888888889,5.88594031816975,124,46,78,3,1.7,16.5,21.7,0,0,0,0,0,0,0.99999834188983,455.371538697689,99.9999396001436
24.3,"random_instances_SVM","SVM",20,22,11033,10607,426,2300,2198,102,0.991301856616708,0.888888888888889,5.87536360600772,127,48,79,3,1.6,17.25,21.5,0,0,0,0,0,0,0.999998834205059,447.705476883805,99.9999599903127
24.3,"random_instances_SVM","SVM",20,23,10933,10509,424,2400,2296,104,0.990490835339959,0.888888888888889,5.85241296692175,131,50,81,4,1.6,18,22.1,0,0,0,0,0,0,0.999999454499829,439.252579109891,99.9999820855959
24.3,"random_instances_SVM","SVM",20,24,10833,10416,417,2500,2389,111,0.994333616831923,0.888888888888889,5.93887960268818,141,51,90,10,1.8,18.75,21.5,0,0,0,0,0,0,0.999999888259521,451.499202299267,99.9999962903036
24.3,"random_instances_SVM","SVM",20,25,10733,10319,414,2600,2486,114,0.994124880529872,0.888888888888889,5.93887960268818,141,52,89,0,1.7,19.5,21.8,0,0,0,0,0,0,0.999999984102917,443.828544778981,99.9999994069218
24.3,"random_instances_SVM","SVM",20,26,10633,10222,411,2700,2583,117,0.994126076726445,0.888888888888889,5.93887960268818,142,52,90,1,1.7,20.25,22.1,0,0,0,0,0,0,0.99999985590058,435.290518522529,99.9999947792002
24.3,"random_instances_SVM","SVM",20,27,10533,10126,407,2800,2679,121,0.994149402559624,0.888888888888889,5.94421552326562,141,52,89,-1,1.7,21,22.1,0,0,0,0,0,0,0.999999877623752,430.815617398565,99.9999958323393
24.3,"random_instances_SVM","SVM",20,28,10433,10029,404,2900,2776,124,0.994246892580355,0.89272030651341,5.94421552326562,144,53,91,3,1.7,21.75,22.4,0,0,0,0,0,0,0.999999982881418,427.684965300014,99.9999994050472
24.3,"random_instances_SVM","SVM",20,29,10333,9934,399,3000,2871,129,0.994191269439694,0.888888888888889,5.94421552326562,149,56,93,5,1.7,22.5,22.3,0,0,0,0,0,0,0.999999934161328,421.964608427763,99.9999977601304
24.3,"random_instances_SVM","SVM",20,30,10233,9839,394,3100,2966,134,0.994196054225988,0.89272030651341,5.94421552326562,146,55,91,-3,1.7,23.25,22.1,0,0,0,0,0,0,0.999999997804364,420.765524640074,99.9999999314669
24.3,"random_instances_SVM","SVM",20,31,10133,9745,388,3200,3060,140,0.99455072651,0.896551724137931,5.92126488417965,148,55,93,2,1.7,24,21.9,0,0,0,0,0,0,0.999999989992146,411.817554748657,99.9999996869924
24.3,"random_instances_SVM","SVM",20,32,10033,9647,386,3300,3158,142,0.99432643965249,0.896551724137931,5.93887960268818,148,55,93,0,1.7,24.75,22.2,0,0,0,0,0,0,0.999999973888736,407.279819866796,99.9999991848671
24.3,"random_instances_SVM","SVM",20,33,9933,9551,382,3400,3254,146,0.994178111277391,0.900383141762452,5.93192422690545,149,55,94,1,1.7,25.5,22.3,0,0,0,0,0,0,0.999999982833477,403.588547830651,99.9999994963347
24.3,"random_instances_SVM","SVM",20,34,9833,9456,377,3500,3349,151,0.9946224983044,0.900383141762452,5.89301952853615,150,57,93,1,1.6,26.25,22.2,0,0,0,0,0,0,0.999999983563545,398.60420599762,99.9999994955176
24.3,"random_instances_SVM","SVM",20,35,9733,9359,374,3600,3446,154,0.994596780078073,0.900383141762452,5.91594956561217,151,58,93,1,1.6,27,22.4,0,0,0,0,0,0,0.999999933213615,389.60707178421,99.9999980212921
24.3,"random_instances_SVM","SVM",20,36,9633,9265,368,3700,3540,160,0.995035186122217,0.900383141762452,5.92126488417965,151,57,94,0,1.6,27.75,22.1,0,0,0,0,0,0,0.99999992324371,383.068307241616,99.9999979542314
24.3,"random_instances_SVM","SVM",20,37,9533,9172,361,3800,3633,167,0.99545146252975,0.900383141762452,5.9602809706258,156,60,96,5,1.6,28.5,21.8,0,0,0,0,0,0,0.999999936337508,373.798854438749,99.9999981616693
24.3,"random_instances_SVM","SVM",20,38,9433,9075,358,3900,3730,170,0.995599192806561,0.900383141762452,5.96565543498164,161,63,98,5,1.6,29.25,21.9,0,0,0,0,0,0,0.999999936339797,363.735451818864,99.9999980371565
24.3,"random_instances_SVM","SVM",20,39,9333,8977,356,4000,3828,172,0.995689505647852,0.900383141762452,5.96565543498164,163,63,100,2,1.6,30,22.3,0,0,0,0,0,0,0.999999926560168,367.290302754683,99.9999976000423
24.3,"random_instances_SVM","SVM",20,40,9233,8881,352,4100,3924,176,0.995540579174466,0.900383141762452,5.98183714050148,166,64,102,3,1.6,30.75,22.3,0,0,0,0,0,0,0.999999961497997,362.242273173708,99.9999988586534
24.3,"random_instances_SVM","SVM",20,41,9133,8783,350,4200,4022,178,0.995629695819184,0.900383141762452,5.97103960053667,163,63,100,-3,1.6,31.5,22.6,0,0,0,0,0,0,0.999999618998011,354.011454611904,99.9999878054167
24.3,"random_instances_SVM","SVM",20,42,9033,8690,343,4300,4115,185,0.996064513273607,0.900383141762452,5.98868885364952,171,65,106,8,1.6,32.25,22.2,0,0,0,0,0,0,0.999999953208519,354.949989781886,99.9999986758386
24.3,"random_instances_SVM","SVM",20,43,8933,8594,339,4400,4211,189,0.996335451797476,0.904214559386973,5.96565543498164,173,67,106,2,1.6,33,22.3,0,0,0,0,0,0,0.999999964154792,350.262635498188,99.999998925618
24.3,"random_instances_SVM","SVM",20,44,8833,8496,337,4500,4309,191,0.996148845132028,0.904214559386973,5.96565543498164,173,66,107,0,1.6,33.75,22.6,0,0,0,0,0,0,0.999999956559397,351.051479032916,99.9999986724189
24.3,"random_instances_SVM","SVM",20,45,8733,8399,334,4600,4406,194,0.996059130389024,0.904214559386973,5.96565543498164,171,65,106,-2,1.6,34.5,22.7,0,0,0,0,0,0,0.99999996206206,340.569225509977,99.9999987864295
24.3,"random_instances_SVM","SVM",20,46,8633,8302,331,4700,4503,197,0.996021450196961,0.908045977011494,5.97103960053667,171,64,107,0,1.7,35.25,22.9,0,0,0,0,0,0,0.999999960009783,336.11728181647,99.9999987521343
24.3,"random_instances_SVM","SVM",20,47,8533,8206,327,4800,4599,201,0.996044776030143,0.911877394636015,5.96565543498164,171,66,105,0,1.6,36,22.9,0,0,0,0,0,0,0.99999998790433,335.039651991119,99.9999996437237
24.3,"random_instances_SVM","SVM",20,48,8433,8112,321,4900,4693,207,0.996142266050875,0.904214559386973,5.96565543498164,176,67,109,5,1.6,36.75,22.7,0,0,0,0,0,0,0.99999999356014,331.954462982089,99.9999998088458
24.3,"random_policy_SVM","SVM",1,0,13233,12713,520,100,94,6,0.942341763584092,0.85171102661597,5.23408148125971,32,6,26,0,4.3,0.75,15.7,0,0,0,0,0,0,0.999999996919012,1004.24022006763,99.9999998935655
24.3,"random_policy_SVM","SVM",1,1,13133,12669,464,200,138,62,0.971782132364972,0.893536121673004,5.67396466760923,61,21,40,29,1.9,1.5,2.2,0,0,0,0,0,0,0.972975568018785,591.394368387416,98.4080697455851
24.3,"random_policy_SVM","SVM",1,2,13033,12638,395,300,169,131,0.947696662969658,0.893536121673004,5.3356171784776,96,40,56,35,1.4,2.25,1.3,0,0,0,0,0,0,0.993145266134872,425.677762488075,99.6028408682775
24.3,"random_policy_SVM","SVM",1,3,12933,12608,325,400,199,201,0.94433552698766,0.893536121673004,5.05276108837482,117,50,67,21,1.3,3,1,0,0,0,0,0,0,0.999994497814304,281.840845619488,99.9998307808267
24.3,"random_policy_SVM","SVM",1,4,12833,12579,254,500,228,272,0.947843909343712,0.893536121673004,5.2478553798946,138,60,78,21,1.3,3.75,0.8,0,0,0,0,0,0,0.999989971123567,205.605559967369,99.9996966275112
24.3,"random_policy_SVM","SVM",1,5,12733,12540,193,600,267,333,0.946607158548695,0.893536121673004,5.17118517638361,147,63,84,9,1.3,4.5,0.8,0,0,0,0,0,0,0.99743788077107,145.512537295421,99.9918894209066
24.3,"random_policy_SVM","SVM",1,6,12633,12490,143,700,317,383,0.948674545139313,0.893536121673004,5.14439147080649,151,63,88,4,1.4,5.25,0.8,0,0,0,0,0,0,0.00712662591817216,92.1093987708838,85.2465782629749
24.3,"random_policy_SVM","SVM",1,7,12533,12438,95,800,369,431,0.948353334299133,0.893536121673004,5.16222298370357,151,61,90,0,1.5,6,0.9,0,0,0,0,0,0,0.00329169009074926,41.3724614173493,37.2361866730963
24.3,"random_policy_SVM","SVM",1,8,12433,12364,69,900,443,457,0.948698888289864,0.893536121673004,5.14883779014167,145,62,83,-6,1.3,6.75,1,0,0,0,0,0,0,0.00183973287801798,13.5445880777308,11.1864099354988
24.3,"random_policy_SVM","SVM",1,9,12333,12271,62,1000,536,464,0.949168532974864,0.893536121673004,5.17074773818483,140,62,78,-5,1.3,7.5,1.2,0,0,0,0,0,0,0.00127065953703708,5.68623927061123,4.14128461044292
24.3,"random_policy_SVM","SVM",1,10,12233,12174,59,1100,633,467,0.951065517511611,0.893536121673004,5.16628249834184,145,65,80,5,1.2,8.25,1.4,0,0,0,0,0,0,0.000857800745151529,2.12149154452272,1.09714144608878
24.3,"random_policy_SVM","SVM",1,11,12133,12074,59,1200,733,467,0.952160959286356,0.893536121673004,5.18369710350801,144,65,79,-1,1.2,9,1.6,0,0,0,0,0,0,0.000735766179966616,1.97982703229898,1.07974361115384
24.3,"random_policy_SVM","SVM",1,12,12033,11977,56,1300,830,470,0.956446541253903,0.897338403041825,5.22293496787728,148,65,83,4,1.3,9.75,1.8,0,0,0,0,0,0,0.00144624797440568,2.15244846727157,0.281975407842567
24.3,"random_policy_SVM","SVM",1,13,11933,11887,46,1400,920,480,0.960654937622152,0.904942965779468,5.34602732253008,175,80,95,27,1.2,10.5,1.9,0,0,0,0,0,0,0.00211803919074141,3.22982754105258,0.717797499600019
24.3,"random_policy_SVM","SVM",1,14,11833,11798,35,1500,1009,491,0.959740585138047,0.923954372623574,5.3574340480577,208,94,114,33,1.2,11.25,2.1,0,0,0,0,0,0,0.00434886040773129,4.31078345508826,1.1847337185091
24.3,"random_policy_SVM","SVM",1,15,11733,11703,30,1600,1104,496,0.959015040504579,0.923954372623574,5.3482446243046,214,94,120,6,1.3,12,2.2,0,0,0,0,0,0,0.00308950537468255,3.41213006721482,0.419105176451384
24.3,"random_policy_SVM","SVM",1,16,11633,11603,30,1700,1204,496,0.959041758596646,0.923954372623574,5.3436617240267,213,94,119,-1,1.3,12.75,2.4,0,0,0,0,0,0,0.00212492136040018,2.55419547687602,0.239796859803458
24.3,"random_policy_SVM","SVM",1,17,11533,11503,30,1800,1304,496,0.959373656673662,0.923954372623574,5.3482446243046,212,94,118,-1,1.3,13.5,2.6,0,0,0,0,0,0,0.00148823075323574,1.90792965379923,0.169310865216607
24.3,"random_policy_SVM","SVM",1,18,11433,11403,30,1900,1404,496,0.959696054984608,0.923954372623574,5.3482446243046,212,94,118,0,1.3,14.25,2.8,0,0,0,0,0,0,0.00165220077584483,2.50435660584156,0.179691427790756
24.3,"random_policy_SVM","SVM",1,19,11333,11303,30,2000,1504,496,0.960206073675404,0.923954372623574,5.3482446243046,213,95,118,1,1.2,15,3,0,0,0,0,0,0,0.000848131381459018,1.18484044077604,0.0904375606595453
24.3,"random_policy_SVM","SVM",1,20,11233,11203,30,2100,1604,496,0.960656718828267,0.923954372623574,5.3482446243046,212,96,116,-1,1.2,15.75,3.2,0,0,0,0,0,0,0.000715844393846041,0.995149504409977,0.0773948968104235
24.3,"random_policy_SVM","SVM",1,21,11133,11103,30,2200,1704,496,0.960874619712454,0.923954372623574,5.3482446243046,215,98,117,3,1.2,16.5,3.4,0,0,0,0,0,0,0.000818570735641984,1.21004230400281,0.0858091056989166
24.3,"random_policy_SVM","SVM",1,22,11033,11004,29,2300,1803,497,0.963914544854343,0.923954372623574,5.36665510493904,219,100,119,4,1.2,17.25,3.6,0,0,0,0,0,0,0.000650202136136285,1.00313154381076,0.0736570806681754
24.3,"random_policy_SVM","SVM",1,23,10933,10907,26,2400,1900,500,0.970810781284507,0.923954372623574,5.39776124295267,225,103,122,6,1.2,18,3.8,0,0,0,0,0,0,0.00142200916874252,2.56319378234551,0.185749367150078
24.3,"random_policy_SVM","SVM",1,24,10833,10810,23,2500,1997,503,0.98211134675808,0.923954372623574,5.58140550997265,233,108,125,8,1.2,18.75,4,0,0,0,0,0,0,0.00382711457817727,5.14037131630777,0.547210397599255
24.3,"random_policy_SVM","SVM",1,25,10733,10719,14,2600,2088,512,0.995143244597604,0.931558935361217,5.82239449676873,263,113,150,30,1.3,19.5,4.1,0,0,0,0,0,0,0.00742286976675213,9.58662982371575,1.00915616797256
24.3,"random_policy_SVM","SVM",1,26,10633,10623,10,2700,2184,516,0.997592996772453,0.931558935361217,5.87236975253233,278,122,156,15,1.3,20.25,4.2,0,0,0,0,0,0,0.0073749760020052,9.79272839221514,0.957845881027659
24.3,"random_policy_SVM","SVM",1,27,10533,10530,3,2800,2277,523,0.999171739145924,0.935361216730038,5.91570541259982,301,130,171,23,1.3,21,4.4,0,0,0,0,0,0,0.0139772569572692,14.8218167182124,1.8459854516827
24.3,"random_policy_SVM","SVM",1,28,10433,10433,0,2900,2374,526,0.999335610110601,0.939163498098859,5.92095914742451,305,133,172,4,1.3,21.75,4.5,0,0,0,0,0,0,0.00974815952076823,11.1836633606645,1.18495144519172
24.3,"random_policy_SVM","SVM",1,29,10333,10333,0,3000,2474,526,0.999337985052118,0.939163498098859,5.91570541259982,307,134,173,2,1.3,22.5,4.7,0,0,0,0,0,0,0.00755615664101958,9.32734276766004,0.850858008003798
24.3,"random_policy_SVM","SVM",1,30,10233,10233,0,3100,2574,526,0.99934451614129,0.939163498098859,5.91570541259982,306,134,172,-1,1.3,23.25,4.9,0,0,0,0,0,0,0.00541211130093713,6.65820153971063,0.589379603646585
24.3,"random_policy_SVM","SVM",1,31,10133,10133,0,3200,2674,526,0.9993528284366,0.939163498098859,5.91570541259982,302,133,169,-4,1.3,24,5.1,0,0,0,0,0,0,0.00485116705256313,6.27041947632258,0.52348464946923
24.3,"random_policy_SVM","SVM",1,32,10033,10033,0,3300,2774,526,0.999362328202668,0.939163498098859,5.91570541259982,301,133,168,-1,1.3,24.75,5.3,0,0,0,0,0,0,0.00536777930191676,8.16836689142123,0.572061359899539
24.3,"random_policy_SVM","SVM",1,33,9933,9933,0,3400,2874,526,0.999367671821082,0.939163498098859,5.9104609929078,301,133,168,0,1.3,25.5,5.5,0,0,0,0,0,0,0.00367970687933467,5.32325951292694,0.388258631335435
24.3,"random_policy_SVM","SVM",1,34,9833,9833,0,3500,2974,526,0.999377765322529,0.939163498098859,5.91570541259982,301,132,169,0,1.3,26.25,5.7,0,0,0,0,0,0,0.00299781558484305,4.28666430542176,0.314165142011883
24.3,"random_policy_SVM","SVM",1,35,9733,9733,0,3600,3074,526,0.999383108940943,0.939163498098859,5.91570541259982,302,133,169,1,1.3,27,5.8,0,0,0,0,0,0,0.00274570818157674,3.90966519206595,0.285706862666918
24.3,"random_policy_SVM","SVM",1,36,9633,9633,0,3700,3174,526,0.999397952325424,0.939163498098859,5.91570541259982,305,133,172,3,1.3,27.75,6,0,0,0,0,0,0,0.0025053902681563,3.64590424499199,0.262091858523677
24.3,"random_policy_SVM","SVM",1,37,9533,9533,0,3800,3274,526,0.999406264620734,0.939163498098859,5.9104609929078,306,133,173,1,1.3,28.5,6.2,0,0,0,0,0,0,0.00187603394695903,2.65964161930963,0.196782861198014
24.3,"random_policy_SVM","SVM",1,38,9433,9433,0,3900,3374,526,0.999412201974527,0.939163498098859,5.894783377542,309,133,176,3,1.3,29.25,6.4,0,0,0,0,0,0,0.00185420217107429,2.75647177522307,0.194428437325805
24.3,"random_policy_SVM","SVM",1,39,9333,9333,0,4000,3474,526,0.999415764386802,0.939163498098859,5.9,311,133,178,2,1.3,30,6.6,0,0,0,0,0,0,0.00160833817459325,2.42095073016901,0.167234705089017
24.3,"random_policy_SVM","SVM",1,40,9233,9233,0,4100,3574,526,0.999416358122181,0.939163498098859,5.9,309,132,177,-2,1.3,30.75,6.8,0,0,0,0,0,0,0.00155845529320369,2.38705575654654,0.162977421467417
24.3,"random_policy_SVM","SVM",1,41,9133,9133,0,4200,3674,526,0.99942526415287,0.939163498098859,5.894783377542,308,131,177,-1,1.4,31.5,7,0,0,0,0,0,0,0.00141535873420819,2.18318868238053,0.147124297960785
24.3,"random_policy_SVM","SVM",1,42,9033,9033,0,4300,3774,526,0.999430607771284,0.939163498098859,5.894783377542,306,131,175,-2,1.3,32.25,7.2,0,0,0,0,0,0,0.00123842219601345,1.89609601530643,0.128505466470835
24.3,"random_policy_SVM","SVM",1,43,8933,8933,0,4400,3874,526,0.999432388977422,0.939163498098859,5.87400881057269,306,131,175,0,1.3,33,7.4,0,0,0,0,0,0,0.000993272596568345,1.43620140754257,0.102398508563101
24.3,"random_policy_SVM","SVM",1,44,8833,8833,0,4500,3974,526,0.999440107537352,0.939163498098859,5.894783377542,306,131,175,0,1.3,33.75,7.6,0,0,0,0,0,0,0.000969959282917981,1.42445737393536,0.100079076315935
24.3,"random_policy_SVM","SVM",1,45,8733,8733,0,4600,4074,526,0.99944188874349,0.942965779467681,5.894783377542,307,131,176,1,1.3,34.5,7.7,0,0,0,0,0,0,0.00131281396986508,2.05476314647207,0.13462297811571
24.3,"random_policy_SVM","SVM",1,46,8633,8633,0,4700,4174,526,0.999443076214248,0.942965779467681,5.894783377542,308,131,177,1,1.4,35.25,7.9,0,0,0,0,0,0,0.00100675119574835,1.50840214791462,0.103501021900451
24.3,"random_policy_SVM","SVM",1,47,8533,8533,0,4800,4274,526,0.999443669949628,0.942965779467681,5.88957597173145,309,131,178,1,1.4,36,8.1,0,0,0,0,0,0,0.000770380819205783,1.1150087893279,0.0799965860852763
24.3,"random_policy_SVM","SVM",1,48,8433,8433,0,4900,4374,526,0.999444857420386,0.942965779467681,5.87400881057269,309,131,178,0,1.4,36.75,8.3,0,0,0,0,0,0,0.000626437706143474,0.896956904619729,0.065507596841416
24.3,"random_policy_SVM","SVM",2,0,13233,12702,531,100,90,10,0.946111342837974,0.782258064516129,5.24323242915091,24,8,16,0,2,0.75,9,0,0,0,0,0,0,0.995984091137334,691.500948752757,99.8669048063219
24.3,"random_policy_SVM","SVM",2,1,13133,12664,469,200,128,72,0.970272226102949,0.903225806451613,5.47487997978607,58,23,35,34,1.5,1.5,1.8,0,0,0,0,0,0,0.99399701543618,472.082843802754,99.682914432784
24.3,"random_policy_SVM","SVM",2,2,13033,12629,404,300,163,137,0.980333083738289,0.923387096774194,5.51626518642648,97,42,55,39,1.3,2.25,1.2,0,0,0,0,0,0,0.997066581604267,440.710055584391,99.8258043591764
24.3,"random_policy_SVM","SVM",2,3,12933,12580,353,400,212,188,0.966498148138816,0.923387096774194,5.41347057522735,107,45,62,10,1.4,3,1.1,0,0,0,0,0,0,0.995386088512324,338.161240420362,99.7286019615873
24.3,"random_policy_SVM","SVM",2,4,12833,12542,291,500,250,250,0.966495635437125,0.923387096774194,5.37196185400156,131,50,81,24,1.6,3.75,1,0,0,0,0,0,0,0.998807368981303,251.22693202187,99.942519921979
24.3,"random_policy_SVM","SVM",2,5,12733,12503,230,600,289,311,0.968066702179518,0.923387096774194,5.39529791765926,140,54,86,9,1.6,4.5,0.9,0,0,0,0,0,0,0.998015739171357,178.335098229681,99.9076680366353
24.3,"random_policy_SVM","SVM",2,6,12633,12456,177,700,336,364,0.968565473468379,0.923387096774194,5.39988828375925,146,57,89,6,1.6,5.25,0.9,0,0,0,0,0,0,0.995836323794969,115.202777246174,99.8646394018288
24.3,"random_policy_SVM","SVM",2,7,12533,12411,122,800,381,419,0.973405565131743,0.923387096774194,5.49298980589303,163,67,96,17,1.4,6,0.9,0,0,0,0,0,0,0.00615842970957657,59.7908954141467,56.5971081143743
24.3,"random_policy_SVM","SVM",2,8,12433,12357,76,900,435,465,0.975092216152664,0.923387096774194,5.52104531223794,165,75,90,2,1.2,6.75,0.9,0,0,0,0,0,0,0.00497806494997016,14.7933225711601,11.8551763275382
24.3,"random_policy_SVM","SVM",2,9,12333,12266,67,1000,526,474,0.976412640899758,0.923387096774194,5.51149333072888,173,74,99,8,1.3,7.5,1.1,0,0,0,0,0,0,0.00317562802319336,4.79757933542995,4.35257856111944
24.3,"random_policy_SVM","SVM",2,10,12233,12170,63,1100,622,478,0.976704114297784,0.923387096774194,5.52583372968134,172,74,98,-1,1.3,8.25,1.3,0,0,0,0,0,0,0.00301302880953385,0.856487631328938,0.329385726398548
24.3,"random_policy_SVM","SVM",2,11,12133,12070,63,1200,722,478,0.977024483765437,0.923387096774194,5.52104531223794,172,75,97,0,1.3,9,1.5,0,0,0,0,0,0,1.40089829753444e-05,0.0296124386710346,0.0197112859438648
24.3,"random_policy_SVM","SVM",2,12,12033,11970,63,1300,822,478,0.977346109583944,0.923387096774194,5.54507074875769,171,75,96,-1,1.3,9.75,1.7,0,0,0,0,0,0,1.46231038575346e-05,0.0434903459571355,0.0333548494245432
24.3,"random_policy_SVM","SVM",2,13,11933,11870,63,1400,922,478,0.977526395931428,0.923387096774194,5.54507074875769,174,76,98,3,1.3,10.5,1.9,0,0,0,0,0,0,8.01846294831488e-06,0.00604063186960658,0.000912956186415504
24.3,"random_policy_SVM","SVM",2,14,11833,11771,62,1500,1021,479,0.978817296433449,0.923387096774194,5.57817729279748,178,78,100,4,1.3,11.25,2.1,0,0,0,0,0,0,6.73994201802861e-06,0.00792860628911004,0.00337045332352147
24.3,"random_policy_SVM","SVM",2,15,11733,11672,61,1600,1120,480,0.980044751217386,0.923387096774194,5.61139949288632,175,78,97,-3,1.2,12,2.3,0,0,0,0,0,0,7.37373113455915e-06,0.00894264946534341,0.00346120160082561
24.3,"random_policy_SVM","SVM",2,16,11633,11575,58,1700,1217,483,0.982469508364735,0.923387096774194,5.70318534189005,184,81,103,9,1.3,12.75,2.5,0,0,0,0,0,0,0.00252102624132917,0.331134520522908,0.314846319477345
24.3,"random_policy_SVM","SVM",2,17,11533,11481,52,1800,1311,489,0.983364658347887,0.92741935483871,5.73695027592877,196,87,109,12,1.3,13.5,2.7,0,0,0,0,0,0,0.00463767708036554,2.97686818538748,0.592472706090209
24.3,"random_policy_SVM","SVM",2,18,11433,11392,41,1900,1400,500,0.982855836252187,0.955645161290323,5.73189569418786,222,98,124,26,1.3,14.25,2.8,0,0,0,0,0,0,0.00982832484430189,8.17086918515956,1.62851546817521
24.3,"random_policy_SVM","SVM",2,19,11333,11300,33,2000,1492,508,0.982126524581687,0.963709677419355,5.73695027592877,242,108,134,20,1.2,15,2.9,0,0,0,0,0,0,0.00951721816352999,6.31341799015382,1.31800826214867
24.3,"random_policy_SVM","SVM",2,20,11233,11201,32,2100,1591,509,0.981895984200057,0.963709677419355,5.71176612195191,240,107,133,-2,1.2,15.75,3.1,0,0,0,0,0,0,0.00571881362437466,3.01993817303126,0.687657417577482
24.3,"random_policy_SVM","SVM",2,21,11133,11101,32,2200,1691,509,0.98167046922184,0.963709677419355,5.71176612195191,242,108,134,2,1.2,16.5,3.3,0,0,0,0,0,0,0.00385054643328266,1.39580198669762,0.426581686257202
24.3,"random_policy_SVM","SVM",2,22,11033,11001,32,2300,1791,509,0.981482016593804,0.963709677419355,5.71176612195191,245,108,137,3,1.3,17.25,3.5,0,0,0,0,0,0,0.00365782018307124,1.32901643612152,0.39496067207488
24.3,"random_policy_SVM","SVM",2,23,10933,10901,32,2400,1891,509,0.981350727929606,0.963709677419355,5.71176612195191,245,107,138,0,1.3,18,3.7,0,0,0,0,0,0,0.00262030451677277,0.371993589374098,0.28489552764966
24.3,"random_policy_SVM","SVM",2,24,10833,10801,32,2500,1991,509,0.98125398891388,0.963709677419355,5.7067558007923,247,106,141,2,1.3,18.75,3.9,0,0,0,0,0,0,0.00276217354482506,0.549853305473088,0.295012203113025
24.3,"random_policy_SVM","SVM",2,25,10733,10701,32,2600,2091,509,0.981134635582791,0.963709677419355,5.69676148240212,249,106,143,2,1.3,19.5,4.1,0,0,0,0,0,0,0.00258130133694959,0.337991087139446,0.271892804632645
24.3,"random_policy_SVM","SVM",2,26,10633,10601,32,2700,2191,509,0.981000834216885,0.963709677419355,5.70175426196602,251,106,145,2,1.4,20.25,4.3,0,0,0,0,0,0,1.04409776475738e-05,0.00782771089288032,0.00116072419559347
24.3,"random_policy_SVM","SVM",2,27,10533,10501,32,2800,2291,509,0.980940529375914,0.963709677419355,5.68680210918114,249,106,143,-2,1.3,21,4.5,0,0,0,0,0,0,6.81909304116426e-06,0.00516525361053154,0.000760039245403237
24.3,"random_policy_SVM","SVM",2,28,10433,10401,32,2900,2391,509,0.980812381588849,0.963709677419355,5.68183546978448,250,107,143,1,1.3,21.75,4.7,0,0,0,0,0,0,6.16099561470382e-06,0.00488124100366303,0.000679894473889455
24.3,"random_policy_SVM","SVM",2,29,10333,10301,32,3000,2491,509,0.980769665659828,0.963709677419355,5.68680210918114,250,107,143,0,1.3,22.5,4.9,0,0,0,0,0,0,7.5528819601073e-06,0.0062000138263316,0.000825626201288044
24.3,"random_policy_SVM","SVM",2,30,10233,10201,32,3100,2591,509,0.980750820397024,0.963709677419355,5.68680210918114,250,107,143,0,1.3,23.25,5.1,0,0,0,0,0,0,6.00990942343025e-06,0.0051426963198254,0.000654674206633862
24.3,"random_policy_SVM","SVM",2,31,10133,10101,32,3200,2691,509,0.980717527099405,0.963709677419355,5.68680210918114,250,108,142,0,1.3,24,5.3,0,0,0,0,0,0,3.8841491117561e-06,0.00337564000836889,0.0004206579168563
24.3,"random_policy_SVM","SVM",2,32,10033,10001,32,3300,2791,509,0.980726949730806,0.963709677419355,5.68680210918114,248,106,142,-2,1.3,24.75,5.5,0,0,0,0,0,0,2.70116927943195e-06,0.0022638117033655,0.000289837153326855
24.3,"random_policy_SVM","SVM",2,33,9933,9901,32,3400,2891,509,0.980686118328065,0.963709677419355,5.67687749817035,250,107,143,2,1.3,25.5,5.7,0,0,0,0,0,0,1.56538670528176e-06,0.00130564566431976,0.000170579635168687
24.3,"random_policy_SVM","SVM",2,34,9833,9801,32,3500,2991,509,0.980674811170383,0.963709677419355,5.66698746768574,249,107,142,-1,1.3,26.25,5.9,0,0,0,0,0,0,1.01924897501362e-06,0.000848243407405973,0.000111864701868833
24.3,"random_policy_SVM","SVM",2,35,9733,9701,32,3600,3091,509,0.980652825030446,0.963709677419355,5.68183546978448,249,107,142,0,1.3,27,6.1,0,0,0,0,0,0,3.86520649002177e-06,0.00374015534601874,0.000407655365588774
24.3,"random_policy_SVM","SVM",2,36,9633,9601,32,3700,3191,509,0.980662247661848,0.963709677419355,5.67687749817035,250,107,143,1,1.3,27.75,6.3,0,0,0,0,0,0,1.00376000735026e-06,0.000863618779889994,0.000108459983879208
24.3,"random_policy_SVM","SVM",2,37,9533,9502,31,3800,3290,510,0.983261009402464,0.963709677419355,5.69177743911043,253,108,145,3,1.3,28.5,6.5,0,0,0,0,0,0,1.86464403739848e-06,0.0208607777562913,0.019342170239202
24.3,"random_policy_SVM","SVM",2,38,9433,9406,27,3900,3386,514,0.99339787626451,0.963709677419355,5.74040832813652,266,111,155,13,1.4,29.25,6.6,0,0,0,0,0,0,4.28183719867487e-06,1.18852135048126,1.18527837772755
24.3,"random_policy_SVM","SVM",2,39,9333,9325,8,4000,3467,533,0.999842327967878,0.971774193548387,5.83800350262697,312,131,181,46,1.4,30,6.5,0,0,0,0,0,0,8.7836612047109e-06,3.07281025111672,3.07061907544663
24.3,"random_policy_SVM","SVM",2,40,9233,9233,0,4100,3559,541,0.999858660528974,0.971774193548387,5.8277972027972,326,140,186,14,1.3,30.75,6.6,0,0,0,0,0,0,4.31689087123149e-06,0.0635883019167516,0.0614365426745736
24.3,"random_policy_SVM","SVM",2,41,9133,9133,0,4200,3659,541,0.999854891476413,0.971774193548387,5.85338015803336,329,140,189,3,1.4,31.5,6.8,0,0,0,0,0,0,3.3377700642965e-06,0.00294151418391316,0.000417307165241947
24.3,"random_policy_SVM","SVM",2,42,9033,9033,0,4300,3759,541,0.999851750599279,0.971774193548387,5.84824561403509,333,141,192,4,1.4,32.25,6.9,0,0,0,0,0,0,2.35439378439786e-06,0.00212269532325417,0.000269647461481721
24.3,"random_policy_SVM","SVM",2,43,8933,8933,0,4400,3859,541,0.999849866072999,0.971774193548387,5.83800350262697,333,140,193,0,1.4,33,7.1,0,0,0,0,0,0,1.68362118914057e-06,0.00155026136038992,0.000187382216019017
24.3,"random_policy_SVM","SVM",2,44,8833,8833,0,4500,3959,541,0.999846725195865,0.971774193548387,5.85338015803336,336,140,196,3,1.4,33.75,7.3,0,0,0,0,0,0,1.56743474366857e-06,0.00148243938497546,0.000171154250125542
24.3,"random_policy_SVM","SVM",2,45,8733,8733,0,4600,4059,541,0.999846725195865,0.971774193548387,5.84312007011393,336,140,196,0,1.4,34.5,7.5,0,0,0,0,0,0,1.07222393328316e-06,0.000995553235786093,0.000114215415833205
24.3,"random_policy_SVM","SVM",2,46,8633,8633,0,4700,4159,541,0.999845468845012,0.971774193548387,5.8585237258348,336,140,196,0,1.4,35.25,7.7,0,0,0,0,0,0,1.72624517993076e-06,0.00172573118690174,0.000185533612023771
24.3,"random_policy_SVM","SVM",2,47,8533,8533,0,4800,4259,541,0.999845468845012,0.971774193548387,5.83800350262697,336,139,197,0,1.4,36,7.9,0,0,0,0,0,0,7.22845358986136e-07,0.000665594360855501,7.69159228460183e-05
24.3,"random_policy_SVM","SVM",2,48,8433,8433,0,4900,4359,541,0.999842956143304,0.971774193548387,5.85338015803336,335,139,196,-1,1.4,36.75,8.1,0,0,0,0,0,0,9.39169804148905e-07,0.000912142777275756,9.93433867607381e-05
24.3,"random_policy_SVM","SVM",3,0,13233,12728,505,100,95,5,0.959547808054075,0.842293906810036,5.31253178058067,30,5,25,0,5,0.75,19,0,0,0,0,0,0,0.999993137490236,743.087079222836,99.9998100023469
24.3,"random_policy_SVM","SVM",3,1,13133,12694,439,200,129,71,0.971032154824341,0.888888888888889,5.23241255716228,52,19,33,22,1.7,1.5,1.8,0,0,0,0,0,0,0.991871467017599,562.519585933385,99.4849560087389
24.3,"random_policy_SVM","SVM",3,2,13033,12666,367,300,157,143,0.97611504994801,0.899641577060932,5.54354933197271,87,37,50,35,1.4,2.25,1.1,0,0,0,0,0,0,0.99320654657991,338.616042967031,99.6854956270522
24.3,"random_policy_SVM","SVM",3,3,12933,12631,302,400,192,208,0.95658750838824,0.903225806451613,5.28490427030001,109,48,61,22,1.3,3,0.9,0,0,0,0,0,0,0.999983963967846,262.192876968189,99.9995342995321
24.3,"random_policy_SVM","SVM",3,4,12833,12591,242,500,232,268,0.956245244780203,0.903225806451613,5.25921960839555,129,55,74,20,1.3,3.75,0.9,0,0,0,0,0,0,0.996609228132787,198.801592972823,99.9485919976904
24.3,"random_policy_SVM","SVM",3,5,12733,12547,186,600,276,324,0.95833249170151,0.903225806451613,5.3032478148777,135,55,80,6,1.5,4.5,0.9,0,0,0,0,0,0,0.996347589971684,134.815483119379,99.9818765085198
24.3,"random_policy_SVM","SVM",3,6,12633,12504,129,700,319,381,0.955842944768742,0.903225806451613,5.30559315236735,142,58,84,7,1.4,5.25,0.8,0,0,0,0,0,0,0.00371508090431891,74.0738525511578,69.958762420328
24.3,"random_policy_SVM","SVM",3,7,12533,12446,87,800,377,423,0.954104133422199,0.903225806451613,5.18674112972688,150,63,87,8,1.4,6,0.9,0,0,0,0,0,0,0.00182018899744952,30.5932735224115,28.1137454919702
24.3,"random_policy_SVM","SVM",3,8,12433,12367,66,900,456,444,0.956185769464694,0.903225806451613,5.20732343579722,144,61,83,-6,1.4,6.75,1,0,0,0,0,0,0,0.00114521113649835,8.53842621984142,7.13289953362396
24.3,"random_policy_SVM","SVM",3,9,12333,12271,62,1000,552,448,0.958287043583059,0.903225806451613,5.21891536225988,143,62,81,-1,1.3,7.5,1.2,0,0,0,0,0,0,0.00106797730124508,4.45742353205638,3.1161977173499
24.3,"random_policy_SVM","SVM",3,10,12233,12173,60,1100,650,450,0.960414127743996,0.903225806451613,5.25051779092409,143,63,80,0,1.3,8.25,1.4,0,0,0,0,0,0,0.000530126013296065,1.65594538853613,1.05914410289807
24.3,"random_policy_SVM","SVM",3,11,12133,12073,60,1200,750,450,0.961774765858023,0.903225806451613,5.23241255716228,145,65,80,2,1.2,9,1.7,0,0,0,0,0,0,0.000504093404156299,1.61646201809928,1.05528294011891
24.3,"random_policy_SVM","SVM",3,12,12033,11974,59,1300,849,451,0.963209467572485,0.903225806451613,5.23241255716228,144,64,80,-1,1.2,9.75,1.9,0,0,0,0,0,0,0.000339523134773756,0.402398700218975,0.037545736985437
24.3,"random_policy_SVM","SVM",3,13,11933,11875,58,1400,948,452,0.966449750091454,0.903225806451613,5.27816279637928,150,66,84,6,1.3,10.5,2.1,0,0,0,0,0,0,0.000674377339251389,0.917241026840486,0.095530563286044
24.3,"random_policy_SVM","SVM",3,14,11833,11781,52,1500,1042,458,0.970142830531267,0.906810035842294,5.36990052756635,165,71,94,15,1.3,11.25,2.3,0,0,0,0,0,0,0.00145858084973639,2.06259858451575,0.364088349253846
24.3,"random_policy_SVM","SVM",3,15,11733,11691,42,1600,1132,468,0.967244250532447,0.917562724014337,5.36735883626673,183,82,101,18,1.2,12,2.4,0,0,0,0,0,0,0.00159260117404763,1.83509520717681,0.677346524096084
24.3,"random_policy_SVM","SVM",3,16,11633,11603,30,1700,1220,480,0.964875898582204,0.921146953405018,5.35601285378816,216,97,119,33,1.2,12.75,2.5,0,0,0,0,0,0,0.00165562320716405,1.55511825084544,0.333061018924067
24.3,"random_policy_SVM","SVM",3,17,11533,11504,29,1800,1319,481,0.964545978907552,0.921146953405018,5.34679424302432,221,98,123,5,1.3,13.5,2.7,0,0,0,0,0,0,0.00122803377007644,1.3258901203105,0.152732545475126
24.3,"random_policy_SVM","SVM",3,18,11433,11405,28,1900,1418,482,0.966216337532502,0.924731182795699,5.38792342950913,224,99,125,3,1.3,14.25,2.9,0,0,0,0,0,0,0.00112447258026147,1.36978377968402,0.126864446761662
24.3,"random_policy_SVM","SVM",3,19,11333,11305,28,2000,1518,482,0.966860466421116,0.924731182795699,5.39256419043032,221,98,123,-3,1.3,15,3.1,0,0,0,0,0,0,0.000952380787037918,1.24998351384119,0.103883431932394
24.3,"random_policy_SVM","SVM",3,20,11233,11205,28,2100,1618,482,0.967135960571212,0.924731182795699,5.39256419043032,222,98,124,1,1.3,15.75,3.4,0,0,0,0,0,0,0.000757320200399153,1.00017731654957,0.0819068529621016
24.3,"random_policy_SVM","SVM",3,21,11133,11105,28,2200,1718,482,0.967354784845216,0.924731182795699,5.39256419043032,223,100,123,1,1.2,16.5,3.6,0,0,0,0,0,0,0.000795068151429683,1.15710193618433,0.0862029021698348
24.3,"random_policy_SVM","SVM",3,22,11033,11005,28,2300,1818,482,0.967526477737129,0.924731182795699,5.41314649650067,223,100,123,0,1.2,17.25,3.8,0,0,0,0,0,0,0.000479083524483745,0.694430756394961,0.0516278347970419
24.3,"random_policy_SVM","SVM",3,23,10933,10905,28,2400,1918,482,0.96751076727643,0.924731182795699,5.41314649650067,226,100,126,3,1.3,18,4,0,0,0,0,0,0,0.000477485906438133,0.743419622726793,0.0506928746700671
24.3,"random_policy_SVM","SVM",3,24,10833,10805,28,2500,2018,482,0.96785078653297,0.924731182795699,5.40383756013523,226,101,125,0,1.2,18.75,4.2,0,0,0,0,0,0,0.000351367899715995,0.526978299479756,0.0369363330181149
24.3,"random_policy_SVM","SVM",3,25,10733,10705,28,2600,2118,482,0.967889501596834,0.924731182795699,5.42438447101027,224,100,124,-2,1.2,19.5,4.4,0,0,0,0,0,0,0.000593564618172652,1.07275034397005,0.0626162344136658
24.3,"random_policy_SVM","SVM",3,26,10633,10605,28,2700,2218,482,0.968145918758941,0.924731182795699,5.42438447101027,224,100,124,0,1.2,20.25,4.6,0,0,0,0,0,0,0.000304919754392325,0.516888505084451,0.032494445618063
24.3,"random_policy_SVM","SVM",3,27,10533,10506,27,2800,2317,483,0.971246490395283,0.92831541218638,5.41507222299137,224,101,123,0,1.2,21,4.8,0,0,0,0,0,0,0.000465653428930151,0.847141639008818,0.0521485960656473
24.3,"random_policy_SVM","SVM",3,28,10433,10408,25,2900,2415,485,0.977210854581725,0.924731182795699,5.44493138188531,230,104,126,6,1.2,21.75,5,0,0,0,0,0,0,0.00115065422126156,1.90328016058126,0.137160076692452
24.3,"random_policy_SVM","SVM",3,29,10333,10310,23,3000,2513,487,0.981676553035145,0.924731182795699,5.46844144830105,240,106,134,10,1.3,22.5,5.2,0,0,0,0,0,0,0.00182422783261292,2.57952644545703,0.209744073514542
24.3,"random_policy_SVM","SVM",3,30,10233,10213,20,3100,2610,490,0.986993982893549,0.924731182795699,5.55433076251138,250,111,139,10,1.3,23.25,5.3,0,0,0,0,0,0,0.00356093195876157,4.54971981738019,0.42861959989277
24.3,"random_policy_SVM","SVM",3,31,10133,10118,15,3200,2705,495,0.990748783000376,0.924731182795699,5.65574807093331,266,115,151,16,1.3,24,5.5,0,0,0,0,0,0,0.00748965952083275,7.64695964948939,0.94427512491771
24.3,"random_policy_SVM","SVM",3,32,10033,10020,13,3300,2803,497,0.993788757145449,0.92831541218638,5.7535322612141,264,116,148,-2,1.3,24.75,5.6,0,0,0,0,0,0,0.00616290194511619,6.72675148950271,0.759434300090945
24.3,"random_policy_SVM","SVM",3,33,9933,9924,9,3400,2899,501,0.996253616211399,0.92831541218638,5.84735678913839,287,122,165,23,1.4,25.5,5.8,0,0,0,0,0,0,0.00758759555431984,8.32319594914863,0.969711161900395
24.3,"random_policy_SVM","SVM",3,34,9833,9828,5,3500,2995,505,0.997557023361455,0.931899641577061,5.84735678913839,293,126,167,6,1.3,26.25,5.9,0,0,0,0,0,0,0.00752060363134139,8.33374432227039,0.99701985738467
24.3,"random_policy_SVM","SVM",3,35,9733,9730,3,3600,3093,507,0.998152337604334,0.931899641577061,5.88406017949719,302,127,175,9,1.4,27,6.1,0,0,0,0,0,0,0.00571904856675483,6.26753586335823,0.694459375843181
24.3,"random_policy_SVM","SVM",3,36,9633,9633,0,3700,3190,510,0.999217282404508,0.931899641577061,5.9579982126899,303,130,173,1,1.3,27.75,6.3,0,0,0,0,0,0,0.00535360617096687,6.51574218043386,0.670930433413448
24.3,"random_policy_SVM","SVM",3,37,9533,9533,0,3800,3290,510,0.999230748513678,0.931899641577061,5.94206773618538,305,132,173,2,1.3,28.5,6.5,0,0,0,0,0,0,0.00379626553460171,4.45667057617037,0.405548598793378
24.3,"random_policy_SVM","SVM",3,38,9433,9433,0,3900,3390,510,0.999235798304617,0.931899641577061,5.9579982126899,303,131,172,-2,1.3,29.25,6.6,0,0,0,0,0,0,0.00392141677134306,5.05444440619959,0.418976075120846
24.3,"random_policy_SVM","SVM",3,39,9333,9333,0,4000,3490,510,0.999245897886494,0.931899641577061,5.94206773618538,304,132,172,1,1.3,30,6.8,0,0,0,0,0,0,0.00309527519960911,3.87602968161948,0.326350193566723
24.3,"random_policy_SVM","SVM",3,40,9233,9233,0,4100,3590,510,0.999253192028961,0.931899641577061,5.96332737030411,302,131,171,-2,1.3,30.75,7,0,0,0,0,0,0,0.00317593562602396,4.15246721700598,0.331425187318174
24.3,"random_policy_SVM","SVM",3,41,9133,9133,0,4200,3690,510,0.999261608347192,0.931899641577061,5.97401433691756,305,131,174,3,1.3,31.5,7.2,0,0,0,0,0,0,0.00313091815043399,4.37461737216185,0.330169522711798
24.3,"random_policy_SVM","SVM",3,42,9033,9033,0,4300,3790,510,0.999272269016952,0.931899641577061,5.9579982126899,306,131,175,1,1.3,32.25,7.4,0,0,0,0,0,0,0.00217972594535719,2.83289564294365,0.228113869412785
24.3,"random_policy_SVM","SVM",3,43,8933,8933,0,4400,3890,510,0.999284332406416,0.931899641577061,5.9,308,131,177,2,1.4,33,7.6,0,0,0,0,0,0,0.00185018424089356,2.43825804554214,0.195258008521722
24.3,"random_policy_SVM","SVM",3,44,8833,8833,0,4500,3990,510,0.999293029268588,0.931899641577061,5.91570541259982,307,131,176,-1,1.3,33.75,7.8,0,0,0,0,0,0,0.00170452730235545,2.27412534897695,0.177122268216574
24.3,"random_policy_SVM","SVM",3,45,8733,8733,0,4600,4090,510,0.999302567762584,0.931899641577061,5.9052258635961,308,131,177,1,1.4,34.5,8,0,0,0,0,0,0,0.00159686839175153,2.10664631353101,0.167751866074656
24.3,"random_policy_SVM","SVM",3,46,8633,8633,0,4700,4190,510,0.999313789520225,0.931899641577061,5.92095914742451,312,131,181,4,1.4,35.25,8.2,0,0,0,0,0,0,0.001491801451617,2.00972259227887,0.154618326010166
24.3,"random_policy_SVM","SVM",3,47,8533,8533,0,4800,4290,510,0.999322205838456,0.931899641577061,5.92622222222222,313,132,181,1,1.4,36,8.4,0,0,0,0,0,0,0.00136067883919321,1.86490792571984,0.142566668983712
24.3,"random_policy_SVM","SVM",3,48,8433,8433,0,4900,4390,510,0.999330061068805,0.931899641577061,5.92622222222222,311,132,179,-2,1.4,36.75,8.6,0,0,0,0,0,0,0.00145123332552278,2.02693854926442,0.150241975407004
24.3,"random_policy_SVM","SVM",4,0,13233,12728,505,100,94,6,0.971594613493727,0.852517985611511,5.47142111485637,35,6,29,0,4.8,0.75,15.7,0,0,0,0,0,0,0.875501141926619,1022.68582891835,94.3625055975028
24.3,"random_policy_SVM","SVM",4,1,13133,12711,422,200,111,89,0.972126665548148,0.888489208633094,5.41529357159434,72,31,41,37,1.3,1.5,1.2,0,0,0,0,0,0,0.989285255920993,559.99571668788,99.2972540963454
24.3,"random_policy_SVM","SVM",4,2,13033,12666,367,300,156,144,0.962158994044439,0.888489208633094,5.34564131911254,103,45,58,31,1.3,2.25,1.1,0,0,0,0,0,0,0.993275014382248,422.973962817659,99.6796365944364
24.3,"random_policy_SVM","SVM",4,3,12933,12634,299,400,188,212,0.970751775477376,0.892086330935252,5.40322681196464,129,56,73,26,1.3,3,0.9,0,0,0,0,0,0,0.995567353143023,383.652314908227,99.8355948956574
24.3,"random_policy_SVM","SVM",4,4,12833,12588,245,500,234,266,0.977806391606084,0.89568345323741,5.5488622248564,151,60,91,22,1.5,3.75,0.9,0,0,0,0,0,0,0.995402951491079,292.77310840745,99.8282474310415
24.3,"random_policy_SVM","SVM",4,5,12733,12547,186,600,275,325,0.990236141029276,0.924460431654676,5.68993311501941,183,68,115,32,1.7,4.5,0.8,0,0,0,0,0,0,0.993571439812288,238.92848534464,99.7748845186426
24.3,"random_policy_SVM","SVM",4,6,12633,12503,130,700,319,381,0.995272337459529,0.935251798561151,5.80039925842967,201,78,123,18,1.6,5.25,0.8,0,0,0,0,0,0,0.583590768975579,193.810061397597,99.0905331159051
24.3,"random_policy_SVM","SVM",4,7,12533,12464,69,800,358,442,0.996245232644699,0.946043165467626,5.81637607313095,237,99,138,36,1.4,6,0.8,0,0,0,0,0,0,0.0638182027216184,124.788020791812,63.305094057175
24.3,"random_policy_SVM","SVM",4,8,12433,12408,25,900,414,486,0.996910156958173,0.953237410071942,5.86793969080055,266,111,155,29,1.4,6.75,0.9,0,0,0,0,0,0,0.0572855040623887,115.40673956807,26.5990201385957
24.3,"random_policy_SVM","SVM",4,9,12333,12326,7,1000,496,504,0.995219976781132,0.953237410071942,5.80550524369237,302,123,179,36,1.5,7.5,1,0,0,0,0,0,0,0.0291790095965988,54.7414614901489,10.570889468088
24.3,"random_policy_SVM","SVM",4,10,12233,12232,1,1100,590,510,0.995476713010555,0.953237410071942,5.80039925842967,309,124,185,7,1.5,8.25,1.2,0,0,0,0,0,0,0.0182671427777325,30.7901341974708,3.07425163480416
24.3,"random_policy_SVM","SVM",4,11,12133,12132,1,1200,690,510,0.995638299190041,0.949640287769784,5.82149161936941,309,125,184,0,1.5,9,1.4,0,0,0,0,0,0,0.0129769363664148,23.7981280275732,2.41871479305774
24.3,"random_policy_SVM","SVM",4,12,12033,12033,0,1300,789,511,0.995826347217736,0.949640287769784,5.85755395683453,300,123,177,-9,1.4,9.75,1.5,0,0,0,0,0,0,0.0107551747901616,19.5587750237962,1.16877889443551
24.3,"random_policy_SVM","SVM",4,13,11933,11933,0,1400,889,511,0.99606281479747,0.949640287769784,5.85755395683453,300,125,175,0,1.4,10.5,1.7,0,0,0,0,0,0,0.00854118960378257,15.9121606013719,0.918729484935718
24.3,"random_policy_SVM","SVM",4,14,11833,11833,0,1500,989,511,0.996133192053344,0.949640287769784,5.85755395683453,299,123,176,-1,1.4,11.25,1.9,0,0,0,0,0,0,0.00718453055258081,13.7863359462303,0.757966947871768
24.3,"random_policy_SVM","SVM",4,15,11733,11733,0,1600,1089,511,0.996170351244445,0.949640287769784,5.85755395683453,302,125,177,3,1.4,12,2.1,0,0,0,0,0,0,0.00684361895727557,14.3706857257888,0.71930892497172
24.3,"random_policy_SVM","SVM",4,16,11633,11633,0,1700,1189,511,0.996053806508719,0.949640287769784,5.86793969080055,298,125,173,-4,1.4,12.75,2.3,0,0,0,0,0,0,0.00635413416298266,13.706140201915,0.667237032366062
24.3,"random_policy_SVM","SVM",4,17,11533,11533,0,1800,1289,511,0.996116864529982,0.946043165467626,5.8731463808545,297,125,172,-1,1.4,13.5,2.5,0,0,0,0,0,0,0.00489550556666738,10.3003340122461,0.510613144998906
24.3,"random_policy_SVM","SVM",4,18,11433,11433,0,1900,1389,511,0.996242980572506,0.946043165467626,5.8731463808545,300,126,174,3,1.4,14.25,2.7,0,0,0,0,0,0,0.00458252379058725,9.70626858604821,0.477592871290449
24.3,"random_policy_SVM","SVM",4,19,11333,11333,0,2000,1489,511,0.996314483864473,0.946043165467626,5.85755395683453,302,127,175,2,1.4,15,2.9,0,0,0,0,0,0,0.00390222987120458,8.25935059478388,0.405374914179083
24.3,"random_policy_SVM","SVM",4,20,11233,11233,0,2100,1589,511,0.996463120628877,0.946043165467626,5.86274222428966,304,128,176,2,1.4,15.75,3.1,0,0,0,0,0,0,0.00411152426720573,9.17582735454148,0.428881151991322
24.3,"random_policy_SVM","SVM",4,21,11133,11133,0,2200,1689,511,0.996513792253106,0.946043165467626,5.86274222428966,304,129,175,0,1.4,16.5,3.3,0,0,0,0,0,0,0.00307444215821839,6.49123671764828,0.319780617737106
24.3,"random_policy_SVM","SVM",4,22,11033,11033,0,2300,1789,511,0.996595992887965,0.946043165467626,5.86274222428966,306,129,177,2,1.4,17.25,3.5,0,0,0,0,0,0,0.00255254416404838,5.28877426079889,0.264796056994134
24.3,"random_policy_SVM","SVM",4,23,10933,10933,0,2400,1889,511,0.996755326995263,0.946043165467626,5.86274222428966,307,129,178,1,1.4,18,3.7,0,0,0,0,0,0,0.00279970802473168,5.84142015441244,0.291843108528654
24.3,"random_policy_SVM","SVM",4,24,10833,10833,0,2500,1989,511,0.996736184381665,0.946043165467626,5.85755395683453,306,130,176,-1,1.4,18.75,3.9,0,0,0,0,0,0,0.00230007103920133,4.66567893570809,0.238159557198558
24.3,"random_policy_SVM","SVM",4,25,10733,10733,0,2600,2089,511,0.996808813709727,0.946043165467626,5.86793969080055,304,129,175,-2,1.4,19.5,4.1,0,0,0,0,0,0,0.00236077658868522,5.04296231882706,0.244471559789912
24.3,"random_policy_SVM","SVM",4,26,10633,10633,0,2700,2189,511,0.996816695962384,0.946043165467626,5.86793969080055,304,129,175,0,1.4,20.25,4.3,0,0,0,0,0,0,0.00197988135150587,4.01247845718891,0.202908074660308
24.3,"random_policy_SVM","SVM",4,27,10533,10533,0,2800,2289,511,0.996919728264983,0.946043165467626,5.86793969080055,304,130,174,0,1.3,21,4.5,0,0,0,0,0,0,0.00208440549839108,4.33270169959854,0.215662844942917
24.3,"random_policy_SVM","SVM",4,28,10433,10433,0,2900,2389,511,0.996916350156702,0.946043165467626,5.86793969080055,304,130,174,0,1.3,21.75,4.7,0,0,0,0,0,0,0.00189385037818018,3.91953296898004,0.194621245897912
24.3,"random_policy_SVM","SVM",4,29,10333,10333,0,3000,2489,511,0.996982786286246,0.946043165467626,5.8731463808545,304,129,175,0,1.4,22.5,4.9,0,0,0,0,0,0,0.00160644772465183,3.21946639291492,0.165248870588903
24.3,"random_policy_SVM","SVM",4,30,10233,10233,0,3100,2589,511,0.997003617953984,0.946043165467626,5.8731463808545,303,129,174,-1,1.3,23.25,5.1,0,0,0,0,0,0,0.00176838931254396,3.65218881636719,0.181554592096485
24.3,"random_policy_SVM","SVM",4,31,10133,10133,0,3200,2689,511,0.997060482776727,0.946043165467626,5.8731463808545,303,129,174,0,1.3,24,5.3,0,0,0,0,0,0,0.00148248217519713,2.99693461267295,0.153931872925582
24.3,"random_policy_SVM","SVM",4,32,10033,10033,0,3300,2789,511,0.997075684263995,0.946043165467626,5.8731463808545,303,129,174,0,1.3,24.75,5.5,0,0,0,0,0,0,0.00144063816297364,2.84789527190156,0.14823961253677
24.3,"random_policy_SVM","SVM",4,33,9933,9933,0,3400,2889,511,0.997079625390323,0.946043165467626,5.86793969080055,305,129,176,2,1.4,25.5,5.7,0,0,0,0,0,0,0.00128120094309268,2.47479095853296,0.132840147994446
24.3,"random_policy_SVM","SVM",4,34,9833,9833,0,3500,2989,511,0.997113969491188,0.946043165467626,5.8731463808545,306,129,177,1,1.4,26.25,5.8,0,0,0,0,0,0,0.00123340620011047,2.43496094834046,0.127034701037983
24.3,"random_policy_SVM","SVM",4,35,9733,9733,0,3600,3089,511,0.997203489360656,0.946043165467626,5.8731463808545,304,128,176,-2,1.4,27,6,0,0,0,0,0,0,0.00117623511728791,2.31196827770849,0.121627690463646
24.3,"random_policy_SVM","SVM",4,36,9633,9633,0,3700,3189,511,0.997206867468938,0.946043165467626,5.86793969080055,304,128,176,0,1.4,27.75,6.2,0,0,0,0,0,0,0.000947895632267857,1.81305901837204,0.0979519868500992
24.3,"random_policy_SVM","SVM",4,37,9533,9533,0,3800,3289,511,0.997225447064488,0.946043165467626,5.86793969080055,304,128,176,0,1.4,28.5,6.4,0,0,0,0,0,0,0.000961766809016555,1.85802120463277,0.0990644827923864
24.3,"random_policy_SVM","SVM",4,38,9433,9433,0,3900,3389,511,0.997216438775736,0.946043165467626,5.8731463808545,304,128,176,0,1.4,29.25,6.6,0,0,0,0,0,0,0.000936064192508292,1.81574434080736,0.0960985983202225
24.3,"random_policy_SVM","SVM",4,39,9333,9333,0,4000,3489,511,0.997242337605897,0.946043165467626,5.8731463808545,306,128,178,2,1.4,30,6.8,0,0,0,0,0,0,0.000868553223404174,1.65050929927561,0.0888652873492585
24.3,"random_policy_SVM","SVM",4,40,9233,9233,0,4100,3589,511,0.997240085533709,0.946043165467626,5.8731463808545,305,128,177,-1,1.4,30.75,7,0,0,0,0,0,0,0.000951705668882661,1.87960714076622,0.0981455871063415
24.3,"random_policy_SVM","SVM",4,41,9133,9133,0,4200,3689,511,0.997263732291681,0.946043165467626,5.8731463808545,306,128,178,1,1.4,31.5,7.2,0,0,0,0,0,0,0.000908299460498357,1.75664921827631,0.0930034696901124
24.3,"random_policy_SVM","SVM",4,42,9033,9033,0,4300,3789,511,0.997222631974253,0.946043165467626,5.85755395683453,305,128,177,-1,1.4,32.25,7.4,0,0,0,0,0,0,0.00067580102476234,1.24005261134389,0.0694080730432487
24.3,"random_policy_SVM","SVM",4,43,8933,8933,0,4400,3889,511,0.997258102111212,0.946043165467626,5.84720492157511,303,128,175,-2,1.4,33,7.6,0,0,0,0,0,0,0.000618130505585374,1.10508116323097,0.0635604042534762
24.3,"random_policy_SVM","SVM",4,44,8833,8833,0,4500,3989,511,0.99725472400293,0.946043165467626,5.86793969080055,304,128,176,1,1.4,33.75,7.8,0,0,0,0,0,0,0.000589805455241143,1.07890655697181,0.0605196375616125
24.3,"random_policy_SVM","SVM",4,45,8733,8733,0,4600,4089,511,0.997270488508245,0.946043165467626,5.8731463808545,304,129,175,0,1.4,34.5,8,0,0,0,0,0,0,0.000771143435591888,1.50066794473439,0.0794439178607755
24.3,"random_policy_SVM","SVM",4,46,8633,8633,0,4700,4189,511,0.997286816031607,0.946043165467626,5.8731463808545,305,129,176,1,1.4,35.25,8.2,0,0,0,0,0,0,0.000585276296678429,1.08202347411845,0.0601714939245607
24.3,"random_policy_SVM","SVM",4,47,8533,8533,0,4800,4289,511,0.997268799454104,0.946043165467626,5.86274222428966,306,129,177,1,1.4,36,8.4,0,0,0,0,0,0,0.000479639160986736,0.865590232244141,0.0492682068924564
24.3,"random_policy_SVM","SVM",4,48,8433,8433,0,4900,4389,511,0.997312151843721,0.946043165467626,5.84720492157511,305,129,176,-1,1.4,36.75,8.6,0,0,0,0,0,0,0.000450608191185226,0.787935322697009,0.0464080829188188
24.3,"random_policy_SVM","SVM",5,0,13233,12704,529,100,95,5,0.943628368377862,0.768627450980392,5.06323235378127,24,5,19,0,3.8,0.75,19,0,0,0,0,0,0,0.999994655338299,549.267941212629,99.9998484648429
24.3,"random_policy_SVM","SVM",5,1,13133,12690,443,200,109,91,0.974345895563429,0.831372549019608,5.34734381132784,47,18,29,23,1.6,1.5,1.2,0,0,0,0,0,0,0.991809422339447,421.886564212466,99.6115060996379
24.3,"random_policy_SVM","SVM",5,2,13033,12662,371,300,137,163,0.943076095066829,0.87843137254902,5.10312747626996,92,38,54,45,1.4,2.25,0.8,0,0,0,0,0,0,0.996790287078125,358.570118604643,99.9182735992086
24.3,"random_policy_SVM","SVM",5,3,12933,12622,311,400,177,223,0.945882108301823,0.882352941176471,5.08563603676261,105,49,56,13,1.1,3,0.8,0,0,0,0,0,0,0.999981857117099,272.343085044255,99.9993831152768
24.3,"random_policy_SVM","SVM",5,4,12833,12588,245,500,211,289,0.940040120851825,0.882352941176471,5.08999764571352,121,52,69,16,1.3,3.75,0.7,0,0,0,0,0,0,0.997301865879906,214.303969481463,99.9861570626366
24.3,"random_policy_SVM","SVM",5,5,12733,12548,185,600,251,349,0.940554475065131,0.882352941176471,5.12027049988106,139,57,82,18,1.4,4.5,0.7,0,0,0,0,0,0,0.996107878584138,140.050286839337,99.9506476252402
24.3,"random_policy_SVM","SVM",5,6,12633,12505,128,700,294,406,0.941834550414031,0.882352941176471,5.0981813260248,146,58,88,7,1.5,5.25,0.7,0,0,0,0,0,0,0.00439570537127025,76.7968393052881,72.3463204570022
24.3,"random_policy_SVM","SVM",5,7,12533,12444,89,800,355,445,0.940906755715388,0.882352941176471,5.04163153315934,148,59,89,2,1.5,6,0.8,0,0,0,0,0,0,0.00309742964124425,36.9707132992714,33.2411014497133
24.3,"random_policy_SVM","SVM",5,8,12433,12368,65,900,431,469,0.942101818893495,0.882352941176471,5.04163153315934,153,63,90,5,1.4,6.75,0.9,0,0,0,0,0,0,0.00165820074427002,11.4113500063054,9.18331800252167
24.3,"random_policy_SVM","SVM",5,9,12333,12274,59,1000,525,475,0.944816703974153,0.882352941176471,5.04163153315934,146,63,83,-7,1.3,7.5,1.1,0,0,0,0,0,0,0.000882088758929907,4.1971656608232,3.10039215249579
24.3,"random_policy_SVM","SVM",5,10,12233,12176,57,1100,623,477,0.945664379288822,0.882352941176471,5.04593694010482,147,65,82,1,1.3,8.25,1.3,0,0,0,0,0,0,0.000851645808627142,2.28202693821572,1.09230889296618
24.3,"random_policy_SVM","SVM",5,11,12133,12076,57,1200,723,477,0.947052707545877,0.882352941176471,5.04163153315934,144,66,78,-3,1.2,9,1.5,0,0,0,0,0,0,0.000512454813088199,1.68178036403757,1.0576329657542
24.3,"random_policy_SVM","SVM",5,12,12033,11977,56,1300,822,478,0.94822024879818,0.882352941176471,5.04593694010482,145,67,78,1,1.2,9.75,1.7,0,0,0,0,0,0,0.000480699008010415,0.67808171133785,0.0524107687446406
24.3,"random_policy_SVM","SVM",5,13,11933,11877,56,1400,922,478,0.949425097549908,0.882352941176471,5.04163153315934,146,65,81,1,1.2,10.5,1.9,0,0,0,0,0,0,0.000330828210997987,0.475478025585254,0.0371977222300997
24.3,"random_policy_SVM","SVM",5,14,11833,11777,56,1500,1022,478,0.950903942362944,0.882352941176471,5.04593694010482,145,66,79,-1,1.2,11.25,2.1,0,0,0,0,0,0,0.000312752910356914,0.461682306721725,0.0339088807185084
24.3,"random_policy_SVM","SVM",5,15,11733,11677,56,1600,1122,478,0.95185008501214,0.882352941176471,5.04593694010482,143,65,78,-2,1.2,12,2.3,0,0,0,0,0,0,0.000262431986092641,0.384000776185197,0.0284566506929494
24.3,"random_policy_SVM","SVM",5,16,11633,11578,55,1700,1221,479,0.959712181815914,0.886274509803922,5.17081990330379,152,67,85,9,1.3,12.75,2.5,0,0,0,0,0,0,0.000524725060894762,0.851756049476979,0.0826633975935507
24.3,"random_policy_SVM","SVM",5,17,11533,11483,50,1800,1316,484,0.972029772607711,0.894117647058824,5.34531944514333,160,71,89,8,1.3,13.5,2.7,0,0,0,0,0,0,0.000913083750582208,1.38850318987148,0.186599650555773
24.3,"random_policy_SVM","SVM",5,18,11433,11390,43,1900,1409,491,0.974776460802656,0.913725490196078,5.4216912814826,181,78,103,21,1.3,14.25,2.9,0,0,0,0,0,0,0.00182699510296324,2.41432117523933,0.360424820073145
24.3,"random_policy_SVM","SVM",5,19,11333,11298,35,2000,1501,499,0.975505486037156,0.925490196078431,5.47694726166329,205,90,115,24,1.3,15,3,0,0,0,0,0,0,0.0022900367418555,2.55576151449561,0.351562868977195
24.3,"random_policy_SVM","SVM",5,20,11233,11199,34,2100,1600,500,0.975418639071268,0.929411764705882,5.47694726166329,206,90,116,1,1.3,15.75,3.2,0,0,0,0,0,0,0.0020831696308029,2.82008251107281,0.25530750166468
24.3,"random_policy_SVM","SVM",5,21,11133,11099,34,2200,1700,500,0.975299988991147,0.929411764705882,5.47694726166329,206,89,117,0,1.3,16.5,3.4,0,0,0,0,0,0,0.00134139854372507,1.95927659834496,0.147347525006521
24.3,"random_policy_SVM","SVM",5,22,11033,10999,34,2300,1800,500,0.975447995792122,0.925490196078431,5.48640658335873,208,90,118,2,1.3,17.25,3.6,0,0,0,0,0,0,0.00150785775188068,2.53176357207924,0.163060533073013
24.3,"random_policy_SVM","SVM",5,23,10933,10899,34,2400,1900,500,0.975254119114813,0.925490196078431,5.48640658335873,204,89,115,-4,1.3,18,3.8,0,0,0,0,0,0,0.00102003682840866,1.77501353602673,0.110018299410007
24.3,"random_policy_SVM","SVM",5,24,10833,10799,34,2500,2000,500,0.975445549398721,0.925490196078431,5.48167284169923,204,89,115,0,1.3,18.75,4,0,0,0,0,0,0,0.000965008466106923,1.80135681278646,0.103279741094971
24.3,"random_policy_SVM","SVM",5,25,10733,10700,33,2600,2099,501,0.976827150073931,0.925490196078431,5.43943392425463,207,91,116,3,1.3,19.5,4.2,0,0,0,0,0,0,0.00140768576978156,2.48664357503328,0.161620911496678
24.3,"random_policy_SVM","SVM",5,26,10633,10601,32,2700,2198,502,0.979903489780132,0.92156862745098,5.46281928076476,216,95,121,9,1.3,20.25,4.4,0,0,0,0,0,0,0.00135898488429715,2.4017277900749,0.156812838264448
24.3,"random_policy_SVM","SVM",5,27,10533,10503,30,2800,2296,504,0.98416449549245,0.92156862745098,5.53634314572847,218,94,124,2,1.3,21,4.6,0,0,0,0,0,0,0.00187763785793637,3.16660483570944,0.221148569384205
24.3,"random_policy_SVM","SVM",5,28,10433,10408,25,2900,2391,509,0.991537925213701,0.917647058823529,5.70853668978508,228,99,129,10,1.3,21.75,4.7,0,0,0,0,0,0,0.0052269040755989,7.20960740675805,0.693483655047983
24.3,"random_policy_SVM","SVM",5,29,10333,10315,18,3000,2484,516,0.995554291585616,0.92156862745098,5.80237702098383,256,108,148,28,1.4,22.5,4.8,0,0,0,0,0,0,0.00935327979456009,10.4912673770558,1.37498831143733
24.3,"random_policy_SVM","SVM",5,30,10233,10221,12,3100,2578,522,0.997092461438726,0.925490196078431,5.83042572604108,271,115,156,15,1.4,23.25,4.9,0,0,0,0,0,0,0.010259581836683,12.5759506048974,1.24181351671201
24.3,"random_policy_SVM","SVM",5,31,10133,10127,6,3200,2672,528,0.999052634154099,0.937254901960784,5.9104609929078,289,120,169,18,1.4,24,5.1,0,0,0,0,0,0,0.0110258654176658,13.7675882500338,1.65150822079152
24.3,"random_policy_SVM","SVM",5,32,10033,10032,1,3300,2767,533,0.99938350886206,0.937254901960784,5.9104609929078,299,126,173,10,1.4,24.75,5.2,0,0,0,0,0,0,0.00892606454849875,10.1729345256734,1.14069150040247
24.3,"random_policy_SVM","SVM",5,33,9933,9933,0,3400,2866,534,0.999414088779617,0.937254901960784,5.91570541259982,304,127,177,5,1.4,25.5,5.4,0,0,0,0,0,0,0.00770660394000754,9.50825055735241,0.862327827975023
24.3,"random_policy_SVM","SVM",5,34,9833,9833,0,3500,2966,534,0.999420816361479,0.937254901960784,5.9104609929078,306,128,178,2,1.4,26.25,5.6,0,0,0,0,0,0,0.00635508531916407,8.37890205175384,0.688742707713115
24.3,"random_policy_SVM","SVM",5,35,9733,9733,0,3600,3066,534,0.99942693234499,0.937254901960784,5.9104609929078,307,128,179,1,1.4,27,5.7,0,0,0,0,0,0,0.00490047025144868,6.41710062370829,0.520855372384538
24.3,"random_policy_SVM","SVM",5,36,9633,9633,0,3700,3166,534,0.999436106320257,0.937254901960784,5.9104609929078,309,128,181,2,1.4,27.75,5.9,0,0,0,0,0,0,0.0046725239053588,6.51278049562625,0.49000165068476
24.3,"random_policy_SVM","SVM",5,37,9533,9533,0,3800,3266,534,0.999446503492227,0.937254901960784,5.87400881057269,309,128,181,0,1.4,28.5,6.1,0,0,0,0,0,0,0.00380009606148371,5.04246116237546,0.398748669566147
24.3,"random_policy_SVM","SVM",5,38,9433,9433,0,3900,3366,534,0.999449561483982,0.937254901960784,5.87400881057269,310,128,182,1,1.4,29.25,6.3,0,0,0,0,0,0,0.00345809662725992,4.79192769307802,0.363829529639992
24.3,"random_policy_SVM","SVM",5,39,9333,9333,0,4000,3466,534,0.999461793451005,0.937254901960784,5.86883802816901,308,127,181,-2,1.4,30,6.5,0,0,0,0,0,0,0.00249959706104376,3.33254390429277,0.263354107055207
24.3,"random_policy_SVM","SVM",5,40,9233,9233,0,4100,3566,534,0.999468521032867,0.937254901960784,5.86883802816901,311,129,182,3,1.4,30.75,6.7,0,0,0,0,0,0,0.00269993977359906,3.7821501238684,0.280674074939111
24.3,"random_policy_SVM","SVM",5,41,9133,9133,0,4200,3666,534,0.999470967426272,0.937254901960784,5.87400881057269,311,129,182,0,1.4,31.5,6.9,0,0,0,0,0,0,0.00220693958616897,3.15270494916017,0.231434865499683
24.3,"random_policy_SVM","SVM",5,42,9033,9033,0,4300,3766,534,0.999478306606486,0.937254901960784,5.87400881057269,312,128,184,1,1.4,32.25,7.1,0,0,0,0,0,0,0.0018735448781748,2.67366065400894,0.196447475643998
24.3,"random_policy_SVM","SVM",5,43,8933,8933,0,4400,3866,534,0.999482587794943,0.937254901960784,5.87400881057269,312,128,184,0,1.4,33,7.2,0,0,0,0,0,0,0.00156460280396153,2.21045490632294,0.164210289988867
24.3,"random_policy_SVM","SVM",5,44,8833,8833,0,4500,3966,534,0.999489926975157,0.937254901960784,5.88437775816417,310,128,182,-2,1.4,33.75,7.4,0,0,0,0,0,0,0.00138133308637598,1.96596543237476,0.145341422542475
24.3,"random_policy_SVM","SVM",5,45,8733,8733,0,4600,4066,534,0.999497877753722,0.937254901960784,5.88437775816417,310,128,182,0,1.4,34.5,7.6,0,0,0,0,0,0,0.0015499286017243,2.38886357931483,0.161899816977147
24.3,"random_policy_SVM","SVM",5,46,8633,8633,0,4700,4166,534,0.999502770540531,0.941176470588235,5.88957597173145,311,128,183,1,1.4,35.25,7.8,0,0,0,0,0,0,0.00136880072497599,2.10989656918702,0.141699864247041
24.3,"random_policy_SVM","SVM",5,47,8533,8533,0,4800,4266,534,0.99950766332734,0.941176470588235,5.8636763412489,312,128,184,1,1.4,36,8,0,0,0,0,0,0,0.00092070237508569,1.28814451950057,0.0954833183023633
24.3,"random_policy_SVM","SVM",5,48,8433,8433,0,4900,4366,534,0.999511944515798,0.941176470588235,5.88957597173145,311,128,183,-1,1.4,36.75,8.2,0,0,0,0,0,0,0.00106081576304571,1.55596408520448,0.110293044264086
24.3,"random_policy_SVM","SVM",6,0,13233,12708,525,100,95,5,0.964503227143696,0.810810810810811,5.55470432838854,32,5,27,0,5.4,0.75,19,0,0,0,0,0,0,0.836701931607497,776.217736236457,87.9476444310664
24.3,"random_policy_SVM","SVM",6,1,13133,12661,472,200,142,58,0.983884165063924,0.8996138996139,5.74873801727328,56,20,36,24,1.8,1.5,2.4,0,0,0,0,0,0,0.987262652216834,495.230188006636,99.2875635423078
24.3,"random_policy_SVM","SVM",6,2,13033,12647,386,300,156,144,0.980217175441911,0.922779922779923,5.59692275273261,94,41,53,38,1.3,2.25,1.1,0,0,0,0,0,0,0.993506257667356,356.981564021081,99.6997518597173
24.3,"random_policy_SVM","SVM",6,3,12933,12615,318,400,188,212,0.956361256923025,0.922779922779923,5.2847861915441,105,50,55,11,1.1,3,0.9,0,0,0,0,0,0,0.999982031092853,277.33550004684,99.9993772279691
24.3,"random_policy_SVM","SVM",6,4,12833,12576,257,500,227,273,0.96050665432687,0.922779922779923,5.38511837730588,126,58,68,21,1.2,3.75,0.8,0,0,0,0,0,0,0.997377537477816,203.804802998273,99.9915164403284
24.3,"random_policy_SVM","SVM",6,5,12733,12542,191,600,261,339,0.958661711470689,0.922779922779923,5.34421717812721,144,63,81,18,1.3,4.5,0.8,0,0,0,0,0,0,0.999982661365264,133.132662432134,99.9995597613612
24.3,"random_policy_SVM","SVM",6,6,12633,12497,136,700,306,394,0.960401211805709,0.922779922779923,5.26227858425473,153,62,91,9,1.5,5.25,0.8,0,0,0,0,0,0,0.00360282832535663,74.0098668444602,69.7901654230758
24.3,"random_policy_SVM","SVM",6,7,12533,12439,94,800,364,436,0.960945295214967,0.922779922779923,5.23996188118326,158,66,92,5,1.4,6,0.8,0,0,0,0,0,0,0.00394479632634453,29.599770155083,28.3468212587951
24.3,"random_policy_SVM","SVM",6,8,12433,12359,74,900,444,456,0.961376705758752,0.922779922779923,5.19609269018053,150,65,85,-8,1.3,6.75,1,0,0,0,0,0,0,1.33548186755124e-05,8.1198992304544,8.1123885584249
24.3,"random_policy_SVM","SVM",6,9,12333,12267,66,1000,536,464,0.963093912532145,0.922779922779923,5.25288431046263,147,64,83,-3,1.3,7.5,1.2,0,0,0,0,0,0,5.50144515730971e-06,0.00378664666177269,0.00070815660787044
24.3,"random_policy_SVM","SVM",6,10,12233,12167,66,1100,636,464,0.964361030372299,0.922779922779923,5.26179505568819,145,65,80,-2,1.2,8.25,1.4,0,0,0,0,0,0,2.03635186137426e-06,0.00129051481702248,0.00026348661698287
24.3,"random_policy_SVM","SVM",6,11,12133,12067,66,1200,736,464,0.966078839674376,0.922779922779923,5.29774241729835,148,67,81,3,1.2,9,1.6,0,0,0,0,0,0,1.65048760428851e-06,0.00106297315354494,0.000205804867044237
24.3,"random_policy_SVM","SVM",6,12,12033,11967,66,1300,836,464,0.968005123904021,0.922779922779923,5.32502692760204,148,68,80,0,1.2,9.75,1.8,0,0,0,0,0,0,8.10134372100069e-07,0.000499202723658923,0.000102667447583997
24.3,"random_policy_SVM","SVM",6,13,11933,11867,66,1400,936,464,0.969210783817533,0.922779922779923,5.35259393499256,152,68,84,4,1.2,10.5,2,0,0,0,0,0,0,4.47004972029525e-07,0.000276548539331804,5.56369465337344e-05
24.3,"random_policy_SVM","SVM",6,14,11833,11767,66,1500,1036,464,0.969824760555104,0.922779922779923,5.38409479982514,154,69,85,2,1.2,11.25,2.2,0,0,0,0,0,0,3.81636502556026e-07,0.000233139494356429,4.58583909197408e-05
24.3,"random_policy_SVM","SVM",6,15,11733,11667,66,1600,1136,464,0.97019531570094,0.922779922779923,5.38409479982514,154,69,85,0,1.2,12,2.4,0,0,0,0,0,0,2.23828577994392e-07,0.000139963403756672,2.64165812135601e-05
24.3,"random_policy_SVM","SVM",6,16,11633,11570,63,1700,1233,467,0.977482900235718,0.930501930501931,5.51599558742416,163,72,91,9,1.3,12.75,2.6,0,0,0,0,0,0,4.18193555762663e-06,0.116664294426555,0.114878600630388
24.3,"random_policy_SVM","SVM",6,17,11533,11482,51,1800,1321,479,0.98531517070841,0.945945945945946,5.71014035965234,196,89,107,33,1.2,13.5,2.8,0,0,0,0,0,0,0.00717495044157032,3.66050710924411,1.17701585070524
24.3,"random_policy_SVM","SVM",6,18,11433,11398,35,1900,1405,495,0.991732101282645,0.957528957528958,5.75047795628271,234,108,126,38,1.2,14.25,2.8,0,0,0,0,0,0,0.00901500604062793,5.27583788335588,2.19935146329608
24.3,"random_policy_SVM","SVM",6,19,11333,11309,24,2000,1494,506,0.994885133930053,0.961389961389961,5.81917974205208,257,118,139,23,1.2,15,3,0,0,0,0,0,0,0.00863620771810801,4.20530844828162,1.21085398314689
24.3,"random_policy_SVM","SVM",6,20,11233,11214,19,2100,1589,511,0.997729069358282,0.961389961389961,5.91385457458476,272,122,150,15,1.2,15.75,3.1,0,0,0,0,0,0,0.00796946896703739,4.60348840392525,1.16223232431844
24.3,"random_policy_SVM","SVM",6,21,11133,11124,9,2200,1679,521,0.999472787394135,0.961389961389961,6.01714801444043,303,134,169,31,1.3,16.5,3.2,0,0,0,0,0,0,0.0142722836461345,9.90800574743849,2.25219780413413
24.3,"random_policy_SVM","SVM",6,22,11033,11033,0,2300,1770,530,0.999868046216361,0.969111969111969,5.95267857142857,326,143,183,23,1.3,17.25,3.3,0,0,0,0,0,0,0.0137021101243619,10.7507452168388,1.94631606959482
24.3,"random_policy_SVM","SVM",6,23,10933,10933,0,2400,1870,530,0.999874071503285,0.969111969111969,5.94736842105263,328,143,185,2,1.3,18,3.5,0,0,0,0,0,0,0.0093142920140212,7.289235907612,1.07660247785173
24.3,"random_policy_SVM","SVM",6,24,10833,10833,0,2500,1970,530,0.99987527656067,0.969111969111969,5.94206773618538,329,143,186,1,1.3,18.75,3.7,0,0,0,0,0,0,0.00720076425599084,5.18495749920881,0.788367545945005
24.3,"random_policy_SVM","SVM",6,25,10733,10733,0,2600,2070,530,0.999877686675439,0.969111969111969,5.95267857142857,327,143,184,-2,1.3,19.5,3.9,0,0,0,0,0,0,0.00552921606233285,3.61987432968476,0.605687376000828
24.3,"random_policy_SVM","SVM",6,26,10633,10633,0,2700,2170,530,0.99988160311194,0.969111969111969,5.93149466192171,326,143,183,-1,1.3,20.25,4.1,0,0,0,0,0,0,0.00432830116807084,2.22761323817887,0.460668174469912
24.3,"random_policy_SVM","SVM",6,27,10533,10533,0,2800,2270,530,0.999886724605826,0.969111969111969,5.93149466192171,326,142,184,0,1.3,21,4.3,0,0,0,0,0,0,0.00369486397626223,1.54905224435812,0.392551636369231
24.3,"random_policy_SVM","SVM",6,28,10433,10433,0,2900,2370,530,0.999890942306673,0.969111969111969,5.85338015803336,326,142,184,0,1.3,21.75,4.5,0,0,0,0,0,0,0.00287311326031682,0.658856986266425,0.302798391609469
24.3,"random_policy_SVM","SVM",6,29,10333,10333,0,3000,2470,530,0.999894557478827,0.969111969111969,5.92622222222222,327,143,184,1,1.3,22.5,4.7,0,0,0,0,0,0,0.00292726681236923,0.724155787975368,0.308188745719999
24.3,"random_policy_SVM","SVM",6,30,10233,10233,0,3100,2570,530,0.999894557478827,0.969111969111969,5.92095914742451,329,144,185,2,1.3,23.25,4.8,0,0,0,0,0,0,0.00305521735830001,0.940143161771559,0.322679604331314
24.3,"random_policy_SVM","SVM",6,31,10133,10133,0,3200,2670,530,0.999896063800558,0.969111969111969,5.84824561403509,328,144,184,-1,1.3,24,5,0,0,0,0,0,0,1.22928913355911e-05,0.00865037288197509,0.00133307292878067
24.3,"random_policy_SVM","SVM",6,32,10033,10033,0,3300,2770,530,0.999899377708367,0.969111969111969,5.9104609929078,330,145,185,2,1.3,24.75,5.2,0,0,0,0,0,0,1.08434384267631e-05,0.00819061888463575,0.001209875242665
24.3,"random_policy_SVM","SVM",6,33,9933,9933,0,3400,2870,530,0.999901787823136,0.969111969111969,5.77729636048527,330,145,185,0,1.3,25.5,5.4,0,0,0,0,0,0,6.34755854348818e-06,0.00463158994191074,0.000702091921897372
24.3,"random_policy_SVM","SVM",6,34,9833,9833,0,3500,2970,530,0.999902992880521,0.969111969111969,5.7573402417962,332,146,186,2,1.3,26.25,5.6,0,0,0,0,0,0,4.78677435046906e-06,0.0036057988015138,0.000536482325292921
24.3,"random_policy_SVM","SVM",6,35,9733,9733,0,3600,3070,530,0.999904800466598,0.972972972972973,5.82270742358079,328,145,183,-4,1.3,27,5.8,0,0,0,0,0,0,4.15288373718528e-06,0.00329886661552333,0.00045543714170759
24.3,"random_policy_SVM","SVM",6,36,9633,9633,0,3700,3170,530,0.999906005523983,0.972972972972973,5.74741379310345,327,145,182,-1,1.3,27.75,6,0,0,0,0,0,0,0.000922857576064428,1.31008873346955,0.0960336782878873
24.3,"random_policy_SVM","SVM",6,37,9533,9533,0,3800,3270,530,0.999907210581368,0.972972972972973,5.9,327,145,182,0,1.3,28.5,6.2,0,0,0,0,0,0,0.00109705826695629,1.7024083944861,0.114682699251483
24.3,"random_policy_SVM","SVM",6,38,9433,9433,0,3900,3370,530,0.999908415638753,0.972972972972973,5.8585237258348,326,145,181,-1,1.2,29.25,6.4,0,0,0,0,0,0,0.000969887047245572,1.47076507909133,0.0999664036222861
24.3,"random_policy_SVM","SVM",6,39,9333,9333,0,4000,3470,530,0.999909620696138,0.972972972972973,5.9052258635961,326,145,181,0,1.2,30,6.5,0,0,0,0,0,0,0.00110891064851541,1.78399769478187,0.114400220581878
24.3,"random_policy_SVM","SVM",6,40,9233,9233,0,4100,3570,530,0.9999126333396,0.972972972972973,5.84312007011393,325,145,180,-1,1.2,30.75,6.7,0,0,0,0,0,0,0.000742107515504349,1.13071861809031,0.0769218239698348
24.3,"random_policy_SVM","SVM",6,41,9133,9133,0,4200,3670,530,0.999914440925677,0.972972972972973,5.84824561403509,327,145,182,2,1.3,31.5,6.9,0,0,0,0,0,0,0.000713318338387948,1.10432536356008,0.0745415377711835
24.3,"random_policy_SVM","SVM",6,42,9033,9033,0,4300,3770,530,0.999913838396984,0.972972972972973,5.78732638888889,329,145,184,2,1.3,32.25,7.1,0,0,0,0,0,0,0.000577330128587133,0.877086077546828,0.0596229715338951
24.3,"random_policy_SVM","SVM",6,43,8933,8933,0,4400,3870,530,0.999914440925677,0.972972972972973,5.87918871252205,329,145,184,0,1.3,33,7.3,0,0,0,0,0,0,0.000628269152933398,0.982961433993269,0.0650285560365036
24.3,"random_policy_SVM","SVM",6,44,8833,8833,0,4500,3970,530,0.999915645983062,0.972972972972973,5.80749128919861,326,145,181,-3,1.2,33.75,7.5,0,0,0,0,0,0,0.000478311328321066,0.719116232110785,0.0494731489922679
24.3,"random_policy_SVM","SVM",6,45,8733,8733,0,4600,4070,530,0.999915043454369,0.972972972972973,5.74741379310345,327,145,182,1,1.3,34.5,7.7,0,0,0,0,0,0,0.000408650204497846,0.599418354940988,0.0424167843392165
24.3,"random_policy_SVM","SVM",6,46,8633,8633,0,4700,4170,530,0.999915043454369,0.972972972972973,5.76231633535004,327,145,182,0,1.3,35.25,7.9,0,0,0,0,0,0,0.000391873105162772,0.582681468693436,0.0406568699482943
24.3,"random_policy_SVM","SVM",6,47,8533,8533,0,4800,4270,530,0.999915645983062,0.972972972972973,5.85338015803336,327,145,182,0,1.3,36,8.1,0,0,0,0,0,0,0.000479207504476631,0.74696828369225,0.0498928268727962
24.3,"random_policy_SVM","SVM",6,48,8433,8433,0,4900,4370,530,0.999915043454369,0.972972972972973,5.8585237258348,327,145,182,0,1.3,36.75,8.2,0,0,0,0,0,0,0.000426895883505086,0.663319674688921,0.0443338055947758
24.3,"random_policy_SVM","SVM",7,0,13233,12722,511,100,94,6,0.951119613208817,0.823529411764706,5.46122936016512,29,6,23,0,3.8,0.75,15.7,0,0,0,0,0,0,0.993248616819347,756.567769598505,99.6429962660414
24.3,"random_policy_SVM","SVM",7,1,13133,12684,449,200,132,68,0.966081612472938,0.878676470588235,5.48786764705882,67,26,41,38,1.6,1.5,1.9,0,0,0,0,0,0,0.982308186081842,701.749044948695,98.8168174542151
24.3,"random_policy_SVM","SVM",7,2,13033,12645,388,300,171,129,0.972270385871282,0.897058823529412,5.50688325991189,97,45,52,30,1.2,2.25,1.3,0,0,0,0,0,0,0.994244817752542,445.215165747043,99.7090665679379
24.3,"random_policy_SVM","SVM",7,3,12933,12611,322,400,205,195,0.961158763740042,0.900735294117647,5.29455110357396,124,51,73,27,1.4,3,1.1,0,0,0,0,0,0,0.999985683371336,324.386065094199,99.9994901823613
24.3,"random_policy_SVM","SVM",7,4,12833,12563,270,500,253,247,0.957522535988603,0.915441176470588,5.4159741844336,143,57,86,19,1.5,3.75,1,0,0,0,0,0,0,0.995976138798044,274.60913892281,99.8252084585802
24.3,"random_policy_SVM","SVM",7,5,12733,12522,211,600,294,306,0.95901439543761,0.930147058823529,5.36244743375386,163,66,97,20,1.5,4.5,1,0,0,0,0,0,0,0.996335550145118,198.932546067595,99.8729617344114
24.3,"random_policy_SVM","SVM",7,6,12633,12476,157,700,340,360,0.956345145564115,0.930147058823529,5.31665368965691,172,71,101,9,1.4,5.25,0.9,0,0,0,0,0,0,0.99374603694901,137.384932509952,99.8618317682304
24.3,"random_policy_SVM","SVM",7,7,12533,12433,100,800,383,417,0.956906533137131,0.930147058823529,5.28506067112753,187,81,106,15,1.3,6,0.9,0,0,0,0,0,0,0.0195981731173542,85.5923964076549,68.0348814855118
24.3,"random_policy_SVM","SVM",7,8,12433,12378,55,900,438,462,0.960844294715574,0.930147058823529,5.28955095207157,197,88,109,10,1.2,6.75,0.9,0,0,0,0,0,0,0.0115469500601496,36.5947886557167,25.2956178069681
24.3,"random_policy_SVM","SVM",7,9,12333,12293,40,1000,523,477,0.962214850756559,0.930147058823529,5.29855444305382,205,90,115,8,1.3,7.5,1.1,0,0,0,0,0,0,0.00842299340567784,20.8683143368991,10.9608852200845
24.3,"random_policy_SVM","SVM",7,10,12233,12201,32,1100,615,485,0.963866531757313,0.930147058823529,5.30758863647761,202,90,112,-3,1.2,8.25,1.3,0,0,0,0,0,0,0.00618492440771937,10.3368860984953,2.69118398284949
24.3,"random_policy_SVM","SVM",7,11,12133,12102,31,1200,714,486,0.965243411672704,0.930147058823529,5.31211729572375,204,90,114,2,1.3,9,1.5,0,0,0,0,0,0,0.00551485099982713,9.42217929979261,1.60854969611004
24.3,"random_policy_SVM","SVM",7,12,12033,12003,30,1300,813,487,0.96569700593291,0.930147058823529,5.31211729572375,207,93,114,3,1.2,9.75,1.7,0,0,0,0,0,0,0.00338206351276435,5.00003630335144,0.3770335099933
24.3,"random_policy_SVM","SVM",7,13,11933,11904,29,1400,912,488,0.969536172561259,0.930147058823529,5.38149530824337,211,92,119,4,1.3,10.5,1.9,0,0,0,0,0,0,0.00297114589789948,4.56371108222717,0.327545827372749
24.3,"random_policy_SVM","SVM",7,14,11833,11804,29,1500,1012,488,0.969524099710234,0.930147058823529,5.38149530824337,208,91,117,-3,1.3,11.25,2.1,0,0,0,0,0,0,0.00295957756817707,4.74927708601914,0.317592877445614
24.3,"random_policy_SVM","SVM",7,15,11733,11704,29,1600,1112,488,0.970052430667328,0.930147058823529,5.37228041901692,205,91,114,-3,1.3,12,2.3,0,0,0,0,0,0,0.0024461469231497,4.05608622240093,0.261044448338272
24.3,"random_policy_SVM","SVM",7,16,11633,11605,28,1700,1211,489,0.973306351469459,0.930147058823529,5.40715412774552,211,94,117,6,1.2,12.75,2.5,0,0,0,0,0,0,0.00214093847343524,3.6839981462832,0.24279468284001
24.3,"random_policy_SVM","SVM",7,17,11533,11507,26,1800,1309,491,0.978498827208784,0.930147058823529,5.4468954248366,220,98,122,9,1.2,13.5,2.7,0,0,0,0,0,0,0.00270587718560997,5.26633977039859,0.322597159416097
24.3,"random_policy_SVM","SVM",7,18,11433,11409,24,1900,1407,493,0.982505289058565,0.930147058823529,5.48911942037797,224,101,123,4,1.2,14.25,2.9,0,0,0,0,0,0,0.00299020878101111,6.16556870605814,0.349533799456213
24.3,"random_policy_SVM","SVM",7,19,11333,11313,20,2000,1503,497,0.990105436232342,0.930147058823529,5.64328652833853,238,104,134,14,1.3,15,3,0,0,0,0,0,0,0.00547448604731566,9.96256716739381,0.697435609018145
24.3,"random_policy_SVM","SVM",7,20,11233,11218,15,2100,1598,502,0.997015706204293,0.933823529411765,5.80524380804954,255,110,145,17,1.3,15.75,3.2,0,0,0,0,0,0,0.0111019152436985,19.3122445982359,1.38785710190207
24.3,"random_policy_SVM","SVM",7,21,11133,11123,10,2200,1693,507,0.999110633307271,0.933823529411765,5.8277972027972,272,118,154,17,1.3,16.5,3.3,0,0,0,0,0,0,0.0181684842081105,25.1041656517378,2.51569477534896
24.3,"random_policy_SVM","SVM",7,22,11033,11031,2,2300,1785,515,0.9996038955066,0.952205882352941,5.9,299,128,171,27,1.3,17.25,3.5,0,0,0,0,0,0,0.015136883927327,18.2110805804175,2.15233924976664
24.3,"random_policy_SVM","SVM",7,23,10933,10933,0,2400,1883,517,0.999653336706066,0.948529411764706,5.9104609929078,308,129,179,9,1.4,18,3.6,0,0,0,0,0,0,0.0128511921310358,18.96829615594,1.48611961173001
24.3,"random_policy_SVM","SVM",7,24,10833,10833,0,2500,1983,517,0.999654486501403,0.952205882352941,5.894783377542,307,130,177,-1,1.4,18.75,3.8,0,0,0,0,0,0,0.00876656435802278,12.8362311196832,0.952962535109882
24.3,"random_policy_SVM","SVM",7,25,10733,10733,0,2600,2083,517,0.99966196017109,0.952205882352941,5.894783377542,309,131,178,2,1.4,19.5,4,0,0,0,0,0,0,0.00688379586146773,10.2824791476862,0.737388403609732
24.3,"random_policy_SVM","SVM",7,26,10633,10633,0,2700,2183,517,0.999665984454767,0.952205882352941,5.894783377542,308,131,177,-1,1.4,20.25,4.2,0,0,0,0,0,0,0.0060340725562871,9.59889180614311,0.640368800990554
24.3,"random_policy_SVM","SVM",7,27,10533,10533,0,2800,2283,517,0.999671733431449,0.952205882352941,5.894783377542,311,133,178,3,1.3,21,4.4,0,0,0,0,0,0,0.00525438809631637,8.43312104067597,0.558183256999918
24.3,"random_policy_SVM","SVM",7,28,10433,10433,0,2900,2383,517,0.999671733431449,0.952205882352941,5.9,312,134,178,1,1.3,21.75,4.6,0,0,0,0,0,0,0.00412674360569504,6.51134323859442,0.430478703741898
24.3,"random_policy_SVM","SVM",7,29,10333,10333,0,3000,2483,517,0.999678632203468,0.952205882352941,5.9,311,133,178,-1,1.3,22.5,4.8,0,0,0,0,0,0,0.00380013309376216,6.11083493627223,0.39625499994948
24.3,"random_policy_SVM","SVM",7,30,10233,10233,0,3100,2583,517,0.99968438118015,0.955882352941177,5.894783377542,309,133,176,-2,1.3,23.25,5,0,0,0,0,0,0,0.00390611650240163,6.41350613873556,0.403757104955124
24.3,"random_policy_SVM","SVM",7,31,10133,10133,0,3200,2683,517,0.999685530975486,0.955882352941177,5.894783377542,311,133,178,2,1.3,24,5.2,0,0,0,0,0,0,0.00324336752229016,5.2613984780229,0.337484056942196
24.3,"random_policy_SVM","SVM",7,32,10033,10033,0,3300,2783,517,0.999687830566159,0.955882352941177,5.894783377542,312,134,178,1,1.3,24.75,5.4,0,0,0,0,0,0,0.0027722595338963,4.51064997281872,0.288139514875342
24.3,"random_policy_SVM","SVM",7,33,9933,9933,0,3400,2883,517,0.999692429747505,0.955882352941177,5.87400881057269,313,134,179,1,1.3,25.5,5.6,0,0,0,0,0,0,0.00178165254040719,2.6781038826132,0.187275185011852
24.3,"random_policy_SVM","SVM",7,34,9833,9833,0,3500,2983,517,0.999697028928851,0.955882352941177,5.88437775816417,313,134,179,0,1.3,26.25,5.8,0,0,0,0,0,0,0.00182015572888957,2.83330074848273,0.189267469586033
24.3,"random_policy_SVM","SVM",7,35,9733,9733,0,3600,3083,517,0.999701053212528,0.955882352941177,5.894783377542,311,134,177,-2,1.3,27,6,0,0,0,0,0,0,0.00189053473863033,3.10655491450865,0.19736381399699
24.3,"random_policy_SVM","SVM",7,36,9633,9633,0,3700,3183,517,0.999701053212528,0.955882352941177,5.894783377542,311,134,177,0,1.3,27.75,6.2,0,0,0,0,0,0,0.00180789227011901,3.01652302283467,0.187892831667991
24.3,"random_policy_SVM","SVM",7,37,9533,9533,0,3800,3283,517,0.999703927700869,0.955882352941177,5.894783377542,310,133,177,-1,1.3,28.5,6.4,0,0,0,0,0,0,0.00180282093053713,3.07855093469146,0.186856766554841
24.3,"random_policy_SVM","SVM",7,38,9433,9433,0,3900,3383,517,0.999703927700869,0.955882352941177,5.88957597173145,310,133,177,0,1.3,29.25,6.5,0,0,0,0,0,0,0.00140168326511928,2.27191847307485,0.144611164090581
24.3,"random_policy_SVM","SVM",7,39,9333,9333,0,4000,3483,517,0.999706227291542,0.959558823529412,5.88957597173145,313,134,179,3,1.3,30,6.7,0,0,0,0,0,0,0.00123847292767861,2.00715061093039,0.128288929563609
24.3,"random_policy_SVM","SVM",7,40,9233,9233,0,4100,3583,517,0.999708526882215,0.959558823529412,5.88957597173145,313,134,179,0,1.3,30.75,6.9,0,0,0,0,0,0,0.00120902821884359,1.98370554507242,0.125757722640057
24.3,"random_policy_SVM","SVM",7,41,9133,9133,0,4200,3683,517,0.999707951984547,0.959558823529412,5.88957597173145,315,134,181,2,1.4,31.5,7.1,0,0,0,0,0,0,0.00114686851484915,1.84565270881495,0.118981277444023
24.3,"random_policy_SVM","SVM",7,42,9033,9033,0,4300,3783,517,0.999711401370556,0.959558823529412,5.88957597173145,314,134,180,-1,1.3,32.25,7.3,0,0,0,0,0,0,0.00130272030517371,2.22919053429256,0.13418418075607
24.3,"random_policy_SVM","SVM",7,43,8933,8933,0,4400,3883,517,0.999710826472888,0.959558823529412,5.87400881057269,317,134,183,3,1.4,33,7.5,0,0,0,0,0,0,0.00085816656938597,1.32812890509033,0.0883128998453877
24.3,"random_policy_SVM","SVM",7,44,8833,8833,0,4500,3983,517,0.999707951984547,0.959558823529412,5.88957597173145,317,134,183,0,1.4,33.75,7.7,0,0,0,0,0,0,0.000839116185231214,1.29105089851196,0.086117743739278
24.3,"random_policy_SVM","SVM",7,45,8733,8733,0,4600,4083,517,0.999707951984547,0.959558823529412,5.87918871252205,317,134,183,0,1.4,34.5,7.9,0,0,0,0,0,0,0.000788368013537143,1.18714727583553,0.0813652129291404
24.3,"random_policy_SVM","SVM",7,46,8633,8633,0,4700,4183,517,0.999709676677551,0.959558823529412,5.88437775816417,318,134,184,1,1.4,35.25,8.1,0,0,0,0,0,0,0.000714098882691585,1.08433389663238,0.0741157441374034
24.3,"random_policy_SVM","SVM",7,47,8533,8533,0,4800,4283,517,0.999711401370556,0.959558823529412,5.87400881057269,318,134,184,0,1.4,36,8.3,0,0,0,0,0,0,0.000632768683796538,0.938648416662209,0.0652239439214501
24.3,"random_policy_SVM","SVM",7,48,8433,8433,0,4900,4383,517,0.999711976268224,0.959558823529412,5.87918871252205,316,133,183,-2,1.4,36.75,8.5,0,0,0,0,0,0,0.000569337177688631,0.847387489192991,0.0592083498586036
24.3,"random_policy_SVM","SVM",8,0,13233,12730,503,100,94,6,0.971093627681231,0.792857142857143,5.48329173067076,24,6,18,0,3,0.75,15.7,0,0,0,0,0,0,0.930972376999842,828.303847702281,96.5074864752305
24.3,"random_policy_SVM","SVM",8,1,13133,12720,413,200,104,96,0.986644187971094,0.889285714285714,5.81800258564965,57,23,34,33,1.5,1.5,1.1,0,0,0,0,0,0,0.987204031752019,631.388751356077,99.1843856501518
24.3,"random_policy_SVM","SVM",8,2,13033,12691,342,300,133,167,0.981962244738229,0.9,5.69994515421345,100,38,62,43,1.6,2.25,0.8,0,0,0,0,0,0,0.999984475799152,422.014561214553,99.9993875796581
24.3,"random_policy_SVM","SVM",8,3,12933,12646,287,400,178,222,0.965826231854917,0.9,5.36463233473632,115,49,66,15,1.3,3,0.8,0,0,0,0,0,0,0.994740107600161,318.867529557399,99.7674544345061
24.3,"random_policy_SVM","SVM",8,4,12833,12606,227,500,218,282,0.967975687221835,0.9,5.35327690972222,129,54,75,14,1.4,3.75,0.8,0,0,0,0,0,0,0.990721113121667,226.967917709652,99.5585971524588
24.3,"random_policy_SVM","SVM",8,5,12733,12565,168,600,259,341,0.963006329821733,0.9,5.32580815616064,140,57,83,11,1.5,4.5,0.8,0,0,0,0,0,0,0.985345076977858,143.475058467758,99.4583766036258
24.3,"random_policy_SVM","SVM",8,6,12633,12520,113,700,304,396,0.961576528215821,0.9,5.2636391893572,155,67,88,15,1.3,5.25,0.8,0,0,0,0,0,0,0.013675786342081,77.1688435977389,57.7457444065704
24.3,"random_policy_SVM","SVM",8,7,12533,12455,78,800,369,431,0.963810418483995,0.9,5.31675318989242,158,71,87,3,1.2,6,0.9,0,0,0,0,0,0,0.00811484140582287,33.201871675753,22.6564622219045
24.3,"random_policy_SVM","SVM",8,8,12433,12371,62,900,453,447,0.966527432955347,0.9,5.37192944250871,156,70,86,-2,1.2,6.75,1,0,0,0,0,0,0,0.00581272035453663,10.8681270045151,6.61965505304401
24.3,"random_policy_SVM","SVM",8,9,12333,12275,58,1000,549,451,0.967962267105071,0.9,5.40488606485539,154,71,83,-2,1.2,7.5,1.2,0,0,0,0,0,0,0.00392636159654932,3.88626285580659,2.42394417875347
24.3,"random_policy_SVM","SVM",8,10,12233,12177,56,1100,647,453,0.969436243261997,0.9,5.40015323992995,160,75,85,6,1.1,8.25,1.4,0,0,0,0,0,0,0.00262725269390777,0.384693451943269,0.300308425104854
24.3,"random_policy_SVM","SVM",8,11,12133,12077,56,1200,747,453,0.969271287660221,0.9,5.42390061565523,162,75,87,2,1.2,9,1.6,0,0,0,0,0,0,1.51405031648934e-05,0.0667889285080862,0.0533348619465777
24.3,"random_policy_SVM","SVM",8,12,12033,11977,56,1300,847,453,0.97037621060638,0.9,5.38600436681223,163,75,88,1,1.2,9.75,1.9,0,0,0,0,0,0,1.01958518097189e-05,0.019364920579156,0.0118082009906477
24.3,"random_policy_SVM","SVM",8,13,11933,11878,55,1400,946,454,0.973221834529975,0.9,5.45924666162761,170,77,93,7,1.2,10.5,2.1,0,0,0,0,0,0,1.58531773845123e-05,0.171340954263164,0.158363625396042
24.3,"random_policy_SVM","SVM",8,14,11833,11781,52,1500,1043,457,0.980393209420914,0.9,5.60751879699248,177,81,96,7,1.2,11.25,2.3,0,0,0,0,0,0,0.00388368725282042,1.20568128419292,0.603147917138347
24.3,"random_policy_SVM","SVM",8,15,11733,11688,45,1600,1136,464,0.988016954080838,0.914285714285714,5.751072701808,200,88,112,23,1.3,12,2.4,0,0,0,0,0,0,0.00526573843367497,3.22244969145436,0.739278785411503
24.3,"random_policy_SVM","SVM",8,16,11633,11599,34,1700,1225,475,0.99469234382339,0.925,5.86794293340112,227,99,128,27,1.3,12.75,2.6,0,0,0,0,0,0,0.0103918068840505,11.1547669469605,1.31909667696012
24.3,"random_policy_SVM","SVM",8,17,11533,11514,19,1800,1310,490,0.998866559305732,0.942857142857143,5.92612781954887,268,115,153,41,1.3,13.5,2.7,0,0,0,0,0,0,0.0175875846007068,18.2684017027092,3.37370368202113
24.3,"random_policy_SVM","SVM",8,18,11433,11429,4,1900,1395,505,0.999678476369411,0.964285714285714,5.9579982126899,304,131,173,36,1.3,14.25,2.8,0,0,0,0,0,0,0.0158300102084066,13.419146241707,2.41936572273347
24.3,"random_policy_SVM","SVM",8,19,11333,11333,0,2000,1491,509,0.999682949741663,0.964285714285714,5.96332737030411,317,135,182,13,1.3,15,2.9,0,0,0,0,0,0,0.0136887733973897,13.3768932224855,1.77814034797785
24.3,"random_policy_SVM","SVM",8,20,11233,11233,0,2100,1591,509,0.999685186427788,0.967857142857143,5.9686660698299,316,135,181,-1,1.3,15.75,3.1,0,0,0,0,0,0,0.0093141807490828,7.84643734498403,1.01768977543466
24.3,"random_policy_SVM","SVM",8,21,11133,11133,0,2200,1691,509,0.999687423113914,0.967857142857143,5.9686660698299,315,135,180,-1,1.3,16.5,3.3,0,0,0,0,0,0,0.00894658355633444,9.23162369159665,0.974869029361243
24.3,"random_policy_SVM","SVM",8,22,11033,11033,0,2300,1791,509,0.999686304770851,0.967857142857143,5.9579982126899,317,135,182,2,1.3,17.25,3.5,0,0,0,0,0,0,0.00634934250415179,5.12283487222116,0.677590855401303
24.3,"random_policy_SVM","SVM",8,23,10933,10933,0,2400,1891,509,0.999694692343823,0.967857142857143,5.9579982126899,317,135,182,0,1.3,18,3.7,0,0,0,0,0,0,0.00527284275856991,3.90904323735687,0.562929584228299
24.3,"random_policy_SVM","SVM",8,24,10833,10833,0,2500,1991,509,0.999698047373012,0.967857142857143,5.9579982126899,317,135,182,0,1.3,18.75,3.9,0,0,0,0,0,0,0.00536114544803207,4.63145931275087,0.563846241179808
24.3,"random_policy_SVM","SVM",8,25,10733,10733,0,2600,2091,509,0.999705316602921,0.967857142857143,5.9579982126899,316,134,182,-1,1.4,19.5,4.1,0,0,0,0,0,0,0.00373292221392617,1.90201153015855,0.391740893116593
24.3,"random_policy_SVM","SVM",8,26,10633,10633,0,2700,2191,509,0.999705875774452,0.967857142857143,5.94736842105263,316,134,182,0,1.4,20.25,4.3,0,0,0,0,0,0,0.00295081930929866,0.864650352192385,0.309022179170739
24.3,"random_policy_SVM","SVM",8,27,10533,10533,0,2800,2291,509,0.999709789975173,0.967857142857143,5.9579982126899,316,134,182,0,1.4,21,4.5,0,0,0,0,0,0,0.00317530822323107,1.21074295708953,0.330183769987681
24.3,"random_policy_SVM","SVM",8,28,10433,10433,0,2900,2391,509,0.999715940862019,0.967857142857143,5.96332737030411,316,134,182,0,1.4,21.75,4.7,0,0,0,0,0,0,1.77772477047863e-05,0.158726249435185,0.145242270599655
24.3,"random_policy_SVM","SVM",8,29,10333,10333,0,3000,2491,509,0.999725446778054,0.967857142857143,5.96332737030411,315,133,182,-1,1.4,22.5,4.9,0,0,0,0,0,0,1.60058054294167e-05,0.016904252673989,0.00424555107685439
24.3,"random_policy_SVM","SVM",8,30,10233,10233,0,3100,2591,509,0.999730479321837,0.967857142857143,5.96332737030411,313,133,180,-2,1.4,23.25,5.1,0,0,0,0,0,0,1.4404775262965e-05,0.013787095100979,0.00154934706886551
24.3,"random_policy_SVM","SVM",8,31,10133,10133,0,3200,2691,509,0.999734393522557,0.967857142857143,5.96332737030411,314,133,181,1,1.4,24,5.3,0,0,0,0,0,0,9.55836257072304e-06,0.0088527907465188,0.0010308390759952
24.3,"random_policy_SVM","SVM",8,32,10033,10033,0,3300,2791,509,0.99973551186562,0.967857142857143,5.96332737030411,314,133,181,0,1.4,24.75,5.5,0,0,0,0,0,0,9.11056342625141e-06,0.00853456158123032,0.000970113056027857
24.3,"random_policy_SVM","SVM",8,33,9933,9933,0,3400,2891,509,0.999737748551746,0.967857142857143,5.9579982126899,312,134,178,-2,1.3,25.5,5.7,0,0,0,0,0,0,1.08646436659826e-05,0.0104026439806282,0.00115268945688525
24.3,"random_policy_SVM","SVM",8,34,9833,9833,0,3500,2991,509,0.999736630208683,0.967857142857143,5.96332737030411,312,133,179,0,1.3,26.25,5.9,0,0,0,0,0,0,1.23221952734594e-05,0.0123748978286152,0.00132595619632344
24.3,"random_policy_SVM","SVM",8,35,9733,9733,0,3600,3091,509,0.999741662752466,0.967857142857143,5.92095914742451,315,136,179,3,1.3,27,6.1,0,0,0,0,0,0,3.20062867577817e-06,0.00274283906026023,0.000341153087033048
24.3,"random_policy_SVM","SVM",8,36,9633,9633,0,3700,3191,509,0.999750050325438,0.967857142857143,5.95267857142857,314,136,178,-1,1.3,27.75,6.3,0,0,0,0,0,0,0.00105771887857616,1.77271072246732,0.110121646938733
24.3,"random_policy_SVM","SVM",8,37,9533,9533,0,3800,3291,509,0.999754523697689,0.967857142857143,5.97401433691756,314,136,178,0,1.3,28.5,6.5,0,0,0,0,0,0,0.00131634632609001,2.36803977327577,0.137146037273329
24.3,"random_policy_SVM","SVM",8,38,9433,9433,0,3900,3391,509,0.999755082869221,0.967857142857143,5.94206773618538,313,136,177,-1,1.3,29.25,6.7,0,0,0,0,0,0,0.000942818214847976,1.56591184933013,0.0970080529612605
24.3,"random_policy_SVM","SVM",8,39,9333,9333,0,4000,3491,509,0.999757878726878,0.967857142857143,5.96332737030411,312,137,175,-1,1.3,30,6.9,0,0,0,0,0,0,0.00109621821817128,1.88560169359682,0.112776059362691
24.3,"random_policy_SVM","SVM",8,40,9233,9233,0,4100,3591,509,0.99976235209913,0.967857142857143,5.96332737030411,315,137,178,3,1.3,30.75,7.1,0,0,0,0,0,0,0.000883955679935809,1.5018734341267,0.0916410941622338
24.3,"random_policy_SVM","SVM",8,41,9133,9133,0,4200,3691,509,0.999761233756067,0.967857142857143,5.96332737030411,314,137,177,-1,1.3,31.5,7.3,0,0,0,0,0,0,0.00087463727630168,1.49096906951205,0.0901606449220708
24.3,"random_policy_SVM","SVM",8,42,9033,9033,0,4300,3791,509,0.999762911270661,0.967857142857143,5.95267857142857,314,137,177,0,1.3,32.25,7.4,0,0,0,0,0,0,0.000825444643758712,1.38590490778817,0.0850573290420819
24.3,"random_policy_SVM","SVM",8,43,8933,8933,0,4400,3891,509,0.999756760383815,0.967857142857143,5.96332737030411,314,137,177,0,1.3,33,7.6,0,0,0,0,0,0,0.00126149581046156,2.34670231156315,0.129760021616419
24.3,"random_policy_SVM","SVM",8,44,8833,8833,0,4500,3991,509,0.999755642040752,0.967857142857143,5.96332737030411,317,137,180,3,1.3,33.75,7.8,0,0,0,0,0,0,0.000802998337292826,1.38573046282571,0.0832174133070253
24.3,"random_policy_SVM","SVM",8,45,8733,8733,0,4600,4091,509,0.99974725446778,0.967857142857143,5.9579982126899,316,137,179,-1,1.3,34.5,8,0,0,0,0,0,0,0.000654804990443936,1.08861428989938,0.0673141172445944
24.3,"random_policy_SVM","SVM",8,46,8633,8633,0,4700,4191,509,0.999747813639312,0.967857142857143,5.96332737030411,317,138,179,1,1.3,35.25,8.2,0,0,0,0,0,0,0.000611905903811793,1.01591646057147,0.063122461873665
24.3,"random_policy_SVM","SVM",8,47,8533,8533,0,4800,4291,509,0.99974334026706,0.967857142857143,5.94736842105263,317,138,179,0,1.3,36,8.4,0,0,0,0,0,0,0.000539763185195748,0.872135715533025,0.0559553056745707
24.3,"random_policy_SVM","SVM",8,48,8433,8433,0,4900,4391,509,0.999747813639312,0.967857142857143,5.96332737030411,315,136,179,-2,1.3,36.75,8.6,0,0,0,0,0,0,0.000619864334609004,1.0386418179643,0.0639308424809096
24.3,"random_policy_SVM","SVM",9,0,13233,12708,525,100,95,5,0.945403067594112,0.83011583011583,5.19776507276507,25,5,20,0,4,0.75,19,0,0,0,0,0,0,0.956127517267753,600.756489105308,97.9276055234198
24.3,"random_policy_SVM","SVM",9,1,13133,12679,454,200,124,76,0.967223041661246,0.876447876447876,5.51434062325151,67,25,42,42,1.7,1.5,1.6,0,0,0,0,0,0,0.987838406814308,518.427658426534,99.1502777360069
24.3,"random_policy_SVM","SVM",9,2,13033,12638,395,300,165,135,0.95959804105872,0.884169884169884,5.41074105027593,98,43,55,31,1.3,2.25,1.2,0,0,0,0,0,0,0.997279825745488,393.491895776552,99.9734383292809
24.3,"random_policy_SVM","SVM",9,3,12933,12605,328,400,198,202,0.946453275104986,0.884169884169884,5.12154146237191,117,51,66,19,1.3,3,1,0,0,0,0,0,0,0.999996453575377,288.946421387136,99.999868278286
24.3,"random_policy_SVM","SVM",9,4,12833,12565,268,500,238,262,0.949074274916987,0.884169884169884,5.15270453493059,135,61,74,18,1.2,3.75,0.9,0,0,0,0,0,0,0.999997914199319,222.546644007448,99.9999359100872
24.3,"random_policy_SVM","SVM",9,5,12733,12531,202,600,272,328,0.947363695959222,0.884169884169884,5.09948486692673,144,62,82,9,1.3,4.5,0.8,0,0,0,0,0,0,0.999997153796748,151.418692905389,99.9999424384291
24.3,"random_policy_SVM","SVM",9,6,12633,12485,148,700,318,382,0.947467933423011,0.884169884169884,5.0732664357343,149,66,83,5,1.3,5.25,0.8,0,0,0,0,0,0,0.00479516783082931,95.1947338886203,92.4031798441628
24.3,"random_policy_SVM","SVM",9,7,12533,12432,101,800,371,429,0.946920837370302,0.884169884169884,5.04731622378681,152,68,84,3,1.2,6,0.9,0,0,0,0,0,0,0.00155774855302509,46.8601817596033,45.1017912039998
24.3,"random_policy_SVM","SVM",9,8,12433,12365,68,900,438,462,0.947244395278139,0.884169884169884,5.0516228075955,153,70,83,1,1.2,6.75,0.9,0,0,0,0,0,0,0.00111302138364823,13.4292259015839,12.1122047181361
24.3,"random_policy_SVM","SVM",9,9,12333,12273,60,1000,530,470,0.948733846205771,0.884169884169884,5.06458676689643,154,70,84,1,1.2,7.5,1.1,0,0,0,0,0,0,0.000640325515295756,4.78609983491734,4.07405475007315
24.3,"random_policy_SVM","SVM",9,10,12233,12177,56,1100,626,474,0.949758144982878,0.884169884169884,5.07791908048099,154,68,86,0,1.3,8.25,1.3,0,0,0,0,0,0,0.000484618081099272,0.57162674725418,0.0531183312961756
24.3,"random_policy_SVM","SVM",9,11,12133,12077,56,1200,726,474,0.950472141483396,0.884169884169884,5.09990141416273,152,69,83,-2,1.2,9,1.5,0,0,0,0,0,0,0.000380278444749506,0.465672819185237,0.0417839155410713
24.3,"random_policy_SVM","SVM",9,12,12033,11977,56,1300,826,474,0.951289772919003,0.884169884169884,5.09554996244416,153,70,83,1,1.2,9.75,1.7,0,0,0,0,0,0,0.000391834647362582,0.486919372005125,0.0434148478133357
24.3,"random_policy_SVM","SVM",9,13,11933,11878,55,1400,925,475,0.955334548031165,0.884169884169884,5.17026367026367,156,70,86,3,1.2,10.5,1.9,0,0,0,0,0,0,0.000547405786105958,0.75480819936026,0.0761806884541809
24.3,"random_policy_SVM","SVM",9,14,11833,11783,50,1500,1020,480,0.960614506962805,0.888030888030888,5.18783074888967,173,78,95,17,1.2,11.25,2.1,0,0,0,0,0,0,0.000897335396479447,1.2347325370103,0.169769250440082
24.3,"random_policy_SVM","SVM",9,15,11733,11690,43,1600,1113,487,0.960770561894131,0.8996138996139,5.23626703626704,189,86,103,16,1.2,12,2.3,0,0,0,0,0,0,0.00163532669860037,2.07952908584167,0.269085680014729
24.3,"random_policy_SVM","SVM",9,16,11633,11602,31,1700,1201,499,0.961650253785106,0.915057915057915,5.32960169300376,206,97,109,17,1.1,12.75,2.4,0,0,0,0,0,0,0.00324420532309149,3.25269200376368,0.835121724031898
24.3,"random_policy_SVM","SVM",9,17,11533,11505,28,1800,1298,502,0.964269446011039,0.918918918918919,5.38409479982514,217,101,116,11,1.1,13.5,2.6,0,0,0,0,0,0,0.00257516547710506,2.4189105078254,0.339393802544283
24.3,"random_policy_SVM","SVM",9,18,11433,11405,28,1900,1398,502,0.964561672426862,0.918918918918919,5.38409479982514,221,102,119,4,1.2,14.25,2.8,0,0,0,0,0,0,0.0018096369425991,2.0264116249889,0.216696147304999
24.3,"random_policy_SVM","SVM",9,19,11333,11305,28,2000,1498,502,0.964900896080686,0.918918918918919,5.40277335940822,219,101,118,-2,1.2,15,3,0,0,0,0,0,0,0.00140660268369372,1.84071716894277,0.158309412439959
24.3,"random_policy_SVM","SVM",9,20,11233,11206,27,2100,1597,503,0.966645819173923,0.922779922779923,5.37480386833277,224,102,122,5,1.2,15.75,3.2,0,0,0,0,0,0,0.00150374077797555,2.29911319562232,0.176143985952502
24.3,"random_policy_SVM","SVM",9,21,11133,11109,24,2200,1694,506,0.975124000404895,0.918918918918919,5.46027846027846,231,104,127,7,1.2,16.5,3.3,0,0,0,0,0,0,0.00349058456186372,6.39270510625355,0.411457404650547
24.3,"random_policy_SVM","SVM",9,22,11033,11012,21,2300,1791,509,0.980798615630057,0.915057915057915,5.59005740792081,243,108,135,12,1.2,17.25,3.5,0,0,0,0,0,0,0.00536747716644128,8.22411615592846,0.650929181363295
24.3,"random_policy_SVM","SVM",9,23,10933,10915,18,2400,1888,512,0.983215358215342,0.915057915057915,5.66217921606614,256,113,143,13,1.3,18,3.7,0,0,0,0,0,0,0.00566573148349002,9.45358851273849,0.655868403785067
24.3,"random_policy_SVM","SVM",9,24,10833,10820,13,2500,1983,517,0.989555165116951,0.918918918918919,5.75313791833227,270,121,149,14,1.2,18.75,3.8,0,0,0,0,0,0,0.00910438627790592,12.8319951602297,1.17146609854474
24.3,"random_policy_SVM","SVM",9,25,10733,10725,8,2600,2078,522,0.99431634684442,0.926640926640927,5.80150260540678,283,127,156,13,1.2,19.5,4,0,0,0,0,0,0,0.0113009817299887,16.6370519209268,1.47390860131147
24.3,"random_policy_SVM","SVM",9,26,10633,10629,4,2700,2174,526,0.995568401467272,0.922779922779923,5.80888030888031,297,131,166,14,1.3,20.25,4.1,0,0,0,0,0,0,0.00922041130771999,12.606525822058,1.21081940910041
24.3,"random_policy_SVM","SVM",9,27,10533,10530,3,2800,2273,527,0.997135578596256,0.922779922779923,5.84926381478106,299,132,167,2,1.3,21,4.3,0,0,0,0,0,0,0.00830994385106837,12.5227051942762,0.950107228299644
24.3,"random_policy_SVM","SVM",9,28,10433,10432,1,2900,2371,529,0.998558450103394,0.926640926640927,5.894783377542,311,135,176,12,1.3,21.75,4.5,0,0,0,0,0,0,0.00714629852363379,10.5566444733737,0.948319219251092
24.3,"random_policy_SVM","SVM",9,29,10333,10332,1,3000,2471,529,0.998550315966047,0.926640926640927,5.9,307,134,173,-4,1.3,22.5,4.7,0,0,0,0,0,0,0.00567835725940531,8.55206163621776,0.604488011164781
24.3,"random_policy_SVM","SVM",9,30,10233,10232,1,3100,2571,529,0.998565379183357,0.926640926640927,5.9,313,135,178,6,1.3,23.25,4.9,0,0,0,0,0,0,0.00441223038902942,6.5805551466544,0.471183338838633
24.3,"random_policy_SVM","SVM",9,31,10133,10133,0,3200,2670,530,0.999165497761003,0.926640926640927,5.91570541259982,313,134,179,0,1.3,24,5,0,0,0,0,0,0,0.00578787128962467,9.87822940066974,0.674834753476967
24.3,"random_policy_SVM","SVM",9,32,10033,10033,0,3300,2770,530,0.999195021666932,0.926640926640927,5.91570541259982,315,134,181,2,1.4,24.75,5.2,0,0,0,0,0,0,0.00416862972602328,6.83621488353434,0.438854215143883
24.3,"random_policy_SVM","SVM",9,33,9933,9933,0,3400,2870,530,0.999217315228551,0.926640926640927,5.91570541259982,313,134,179,-2,1.3,25.5,5.4,0,0,0,0,0,0,0.00422421053967009,7.35009630424495,0.437565530912004
24.3,"random_policy_SVM","SVM",9,34,9833,9833,0,3500,2970,530,0.999228160745015,0.926640926640927,5.9104609929078,314,135,179,1,1.3,26.25,5.6,0,0,0,0,0,0,0.00337283761526273,5.63059364100846,0.349481325600103
24.3,"random_policy_SVM","SVM",9,35,9733,9733,0,3600,3070,530,0.999241416376248,0.930501930501931,5.91570541259982,311,134,177,-3,1.3,27,5.8,0,0,0,0,0,0,0.00271829612846356,4.47583752922904,0.285573997645903
24.3,"random_policy_SVM","SVM",9,36,9633,9633,0,3700,3170,530,0.999255877064866,0.930501930501931,5.9104609929078,310,134,176,-1,1.3,27.75,6,0,0,0,0,0,0,0.00314328617751055,5.55128957820091,0.323713908557157
24.3,"random_policy_SVM","SVM",9,37,9533,9533,0,3800,3270,530,0.999277568097793,0.930501930501931,5.9104609929078,308,133,175,-2,1.3,28.5,6.2,0,0,0,0,0,0,0.00238307366808526,3.98162632691226,0.245668646251161
24.3,"random_policy_SVM","SVM",9,38,9433,9433,0,3900,3370,530,0.999290823729026,0.930501930501931,5.9,309,133,176,1,1.3,29.25,6.4,0,0,0,0,0,0,0.00199851822337477,3.24268910595381,0.208099423069375
24.3,"random_policy_SVM","SVM",9,39,9333,9333,0,4000,3470,530,0.999292028786411,0.930501930501931,5.9,311,133,178,2,1.3,30,6.5,0,0,0,0,0,0,0.00202975393851655,3.40998202351234,0.210192542846793
24.3,"random_policy_SVM","SVM",9,40,9233,9233,0,4100,3570,530,0.999287208556871,0.930501930501931,5.9,313,134,179,2,1.3,30.75,6.7,0,0,0,0,0,0,0.00213998981999535,3.74156306945288,0.221662819745752
24.3,"random_policy_SVM","SVM",9,41,9133,9133,0,4200,3670,530,0.999298656602027,0.930501930501931,5.9,312,134,178,-1,1.3,31.5,6.9,0,0,0,0,0,0,0.00201633763268114,3.53466301379457,0.207517231780722
24.3,"random_policy_SVM","SVM",9,42,9033,9033,0,4300,3770,530,0.999302271774182,0.934362934362934,5.9,311,134,177,-1,1.3,32.25,7.1,0,0,0,0,0,0,0.00167339333719086,2.86445394592108,0.172796085927653
24.3,"random_policy_SVM","SVM",9,43,8933,8933,0,4400,3870,530,0.999302874302874,0.934362934362934,5.894783377542,314,136,178,3,1.3,33,7.3,0,0,0,0,0,0,0.00147487529893654,2.4490613705408,0.151743785435732
24.3,"random_policy_SVM","SVM",9,44,8833,8833,0,4500,3970,530,0.999299861659412,0.934362934362934,5.9,315,137,178,1,1.3,33.75,7.5,0,0,0,0,0,0,0.00126909954869884,2.03812525913503,0.130558863048812
24.3,"random_policy_SVM","SVM",9,45,8733,8733,0,4600,4070,530,0.99929925913072,0.934362934362934,5.9,315,137,178,0,1.3,34.5,7.7,0,0,0,0,0,0,0.00118909793238914,1.88293361973383,0.122461464645169
24.3,"random_policy_SVM","SVM",9,46,8633,8633,0,4700,4170,530,0.999306489475029,0.934362934362934,5.9,314,136,178,-1,1.3,35.25,7.9,0,0,0,0,0,0,0.00102068338130558,1.54149162101336,0.104759745579474
24.3,"random_policy_SVM","SVM",9,47,8533,8533,0,4800,4270,530,0.999307694532414,0.934362934362934,5.9,315,136,179,1,1.3,36,8.1,0,0,0,0,0,0,0.000886159768467366,1.35571749444179,0.0921105077714432
24.3,"random_policy_SVM","SVM",9,48,8433,8433,0,4900,4370,530,0.999310707175876,0.934362934362934,5.9,313,136,177,-2,1.3,36.75,8.2,0,0,0,0,0,0,0.000821650486033644,1.24434463848279,0.085063490566526
24.3,"random_policy_SVM","SVM",10,0,13233,12711,522,100,93,7,0.958578357805768,0.776923076923077,5.21423686348862,33,7,26,0,3.7,0.75,13.3,0,0,0,0,0,0,0.962589649590734,747.03913895103,97.567867623861
24.3,"random_policy_SVM","SVM",10,1,13133,12694,439,200,110,90,0.957566243651769,0.834615384615385,5.3653741638796,68,27,41,35,1.5,1.5,1.2,0,0,0,0,0,0,0.985156674981021,520.32772669788,99.0484186017317
24.3,"random_policy_SVM","SVM",10,2,13033,12673,360,300,131,169,0.949878138094155,0.861538461538462,5.34022925010358,90,38,52,22,1.4,2.25,0.8,0,0,0,0,0,0,0.989553342235209,463.288014506475,99.3453984598748
24.3,"random_policy_SVM","SVM",10,3,12933,12636,297,400,168,232,0.937654128297155,0.865384615384615,5.3053050397878,120,53,67,30,1.3,3,0.7,0,0,0,0,0,0,0.999989177184247,308.518876234646,99.9996333267037
24.3,"random_policy_SVM","SVM",10,4,12833,12589,244,500,215,285,0.944584048696726,0.865384615384615,5.20644351176552,125,55,70,5,1.3,3.75,0.8,0,0,0,0,0,0,0.996923000994444,220.212210505634,99.9479807899096
24.3,"random_policy_SVM","SVM",10,5,12733,12543,190,600,261,339,0.941508086107725,0.865384615384615,5.16502810914576,139,57,82,14,1.4,4.5,0.8,0,0,0,0,0,0,0.993696912462177,157.236219188264,99.7566511729232
24.3,"random_policy_SVM","SVM",10,6,12633,12499,134,700,305,395,0.936609597675626,0.865384615384615,5.15583766767041,152,59,93,13,1.6,5.25,0.8,0,0,0,0,0,0,0.0109284510801788,100.882528513621,83.2313641931762
24.3,"random_policy_SVM","SVM",10,7,12533,12449,84,800,355,445,0.940156799654216,0.865384615384615,5.09674843707529,155,68,87,3,1.3,6,0.8,0,0,0,0,0,0,0.0070685935775869,47.5553396878038,34.467996161098
24.3,"random_policy_SVM","SVM",10,8,12433,12374,59,900,430,470,0.941408435485224,0.865384615384615,5.06542513675964,150,66,84,-5,1.3,6.75,0.9,0,0,0,0,0,0,0.00394655211014774,15.592583874077,9.44885939631195
24.3,"random_policy_SVM","SVM",10,9,12333,12280,53,1000,524,476,0.942396537441004,0.865384615384615,5.09674843707529,151,67,84,1,1.3,7.5,1.1,0,0,0,0,0,0,0.00295563385559964,8.09928457941391,3.32260908580113
24.3,"random_policy_SVM","SVM",10,10,12233,12182,51,1100,622,478,0.946579462366868,0.865384615384615,5.10586919688241,151,68,83,0,1.2,8.25,1.3,0,0,0,0,0,0,0.00203089006683195,4.39907815455697,1.22724847372027
24.3,"random_policy_SVM","SVM",10,11,12133,12082,51,1200,722,478,0.947825695453289,0.865384615384615,5.11488220517347,158,71,87,7,1.2,9,1.5,0,0,0,0,0,0,0.00152168318270073,3.52061784483914,1.16415877157935
24.3,"random_policy_SVM","SVM",10,12,12033,11983,50,1300,821,479,0.949131959035183,0.865384615384615,5.11037172703839,159,70,89,1,1.3,9.75,1.7,0,0,0,0,0,0,0.00126325682312204,2.15073312043404,0.135072429127058
24.3,"random_policy_SVM","SVM",10,13,11933,11883,50,1400,921,479,0.951044530621547,0.865384615384615,5.14659933346936,158,70,88,-1,1.3,10.5,1.9,0,0,0,0,0,0,0.000928296187268568,1.59274203245053,0.100955121203562
24.3,"random_policy_SVM","SVM",10,14,11833,11784,49,1500,1020,480,0.958413273943156,0.865384615384615,5.30609031288427,158,70,88,0,1.3,11.25,2.1,0,0,0,0,0,0,0.00123188046532332,2.31315408403203,0.143454324615015
24.3,"random_policy_SVM","SVM",10,15,11733,11687,46,1600,1117,483,0.968189840438929,0.865384615384615,5.467004048583,171,77,94,13,1.2,12,2.3,0,0,0,0,0,0,0.00232875312257413,3.84346973626278,0.319361169164745
24.3,"random_policy_SVM","SVM",10,16,11633,11593,40,1700,1211,489,0.973605791742195,0.884615384615385,5.63440841669541,186,84,102,15,1.2,12.75,2.5,0,0,0,0,0,0,0.00512701457937151,8.20112191118605,0.681301055564293
24.3,"random_policy_SVM","SVM",10,17,11533,11498,35,1800,1306,494,0.974135861017387,0.9,5.68040358744395,204,88,116,18,1.3,13.5,2.6,0,0,0,0,0,0,0.00556598209866177,8.21014038254655,0.710482605655198
24.3,"random_policy_SVM","SVM",10,18,11433,11408,25,1900,1396,504,0.971941746407161,0.923076923076923,5.65740600206968,235,101,134,31,1.3,14.25,2.8,0,0,0,0,0,0,0.00968477710112845,13.4898513056179,1.33348447304384
24.3,"random_policy_SVM","SVM",10,19,11333,11311,22,2000,1493,507,0.971920735733734,0.926923076923077,5.60925480769231,242,104,138,7,1.3,15,2.9,0,0,0,0,0,0,0.00942282124873354,13.9736183477638,1.21112243292617
24.3,"random_policy_SVM","SVM",10,20,11233,11211,22,2100,1593,507,0.971394268288273,0.923076923076923,5.59925613602084,239,102,137,-3,1.3,15.75,3.1,0,0,0,0,0,0,0.00594713676132882,8.35902513093206,0.657397569665201
24.3,"random_policy_SVM","SVM",10,21,11133,11111,22,2200,1693,507,0.970913424019385,0.926923076923077,5.59925613602084,243,104,139,4,1.3,16.5,3.3,0,0,0,0,0,0,0.00484026079737921,7.40494029508781,0.525189669865029
24.3,"random_policy_SVM","SVM",10,22,11033,11011,22,2300,1793,507,0.970452990118966,0.926923076923077,5.5942701554901,243,104,139,0,1.3,17.25,3.5,0,0,0,0,0,0,0.0042512923846852,6.68460948049023,0.453422564281293
24.3,"random_policy_SVM","SVM",10,23,10933,10911,22,2400,1893,507,0.970198460818084,0.930769230769231,5.5942701554901,243,104,139,0,1.3,18,3.7,0,0,0,0,0,0,0.00352505606298921,5.83874680804987,0.374927791568339
24.3,"random_policy_SVM","SVM",10,24,10833,10811,22,2500,1993,507,0.969938528772609,0.930769230769231,5.5942701554901,243,104,139,0,1.3,18.75,3.9,0,0,0,0,0,0,0.00298767935895967,5.04923029426971,0.317169433620838
24.3,"random_policy_SVM","SVM",10,25,10733,10712,21,2600,2092,508,0.977255045563109,0.930769230769231,5.63993766696349,244,105,139,1,1.3,19.5,4.1,0,0,0,0,0,0,0.00318103171037323,5.93901178770141,0.34861103531254
24.3,"random_policy_SVM","SVM",10,26,10633,10612,21,2700,2192,508,0.976946488816279,0.930769230769231,5.63993766696349,246,104,142,2,1.4,20.25,4.3,0,0,0,0,0,0,0.00327264924395003,6.58647378995099,0.338165283876366
24.3,"random_policy_SVM","SVM",10,27,10533,10512,21,2800,2292,508,0.976845037278898,0.930769230769231,5.63491992882562,245,104,141,-1,1.4,21,4.5,0,0,0,0,0,0,0.00268272462557089,5.18617245418895,0.276393507861769
24.3,"random_policy_SVM","SVM",10,28,10433,10412,21,2900,2392,508,0.976747187571246,0.930769230769231,5.63491992882562,244,104,140,-1,1.3,21.75,4.7,0,0,0,0,0,0,0.00209306736578556,3.92257316944957,0.219684504849097
24.3,"random_policy_SVM","SVM",10,29,10333,10312,21,3000,2492,508,0.976666746707287,0.930769230769231,5.63993766696349,243,104,139,-1,1.3,22.5,4.9,0,0,0,0,0,0,0.00224195183911495,4.48545747684577,0.233310250777365
24.3,"random_policy_SVM","SVM",10,30,10233,10212,21,3100,2592,508,0.976654140303233,0.930769230769231,5.63993766696349,244,104,140,1,1.3,23.25,5.1,0,0,0,0,0,0,0.00168237178192957,3.16458600636477,0.173921587266391
24.3,"random_policy_SVM","SVM",10,31,10133,10112,21,3200,2692,508,0.976606716211794,0.930769230769231,5.63993766696349,243,103,140,-1,1.4,24,5.3,0,0,0,0,0,0,0.00168458194880343,3.23219758636969,0.173830532580577
24.3,"random_policy_SVM","SVM",10,32,10033,10012,21,3300,2792,508,0.976501062539728,0.930769230769231,5.63993766696349,242,103,139,-1,1.3,24.75,5.5,0,0,0,0,0,0,0.00145350075220398,2.74088245718248,0.149414185747625
24.3,"random_policy_SVM","SVM",10,33,9933,9912,21,3400,2892,508,0.976403813137033,0.930769230769231,5.63993766696349,242,103,139,0,1.3,25.5,5.7,0,0,0,0,0,0,0.00139961181591296,2.66173117078495,0.144532570818339
24.3,"random_policy_SVM","SVM",10,34,9833,9812,21,3500,2992,508,0.976343182336589,0.930769230769231,5.63993766696349,243,103,140,1,1.4,26.25,5.9,0,0,0,0,0,0,0.00126381291380639,2.35420531184754,0.130141019780177
24.3,"random_policy_SVM","SVM",10,35,9733,9712,21,3600,3092,508,0.976332977152357,0.930769230769231,5.63993766696349,241,103,138,-2,1.3,27,6.1,0,0,0,0,0,0,0.00123239424646823,2.3393101648715,0.126804683124058
24.3,"random_policy_SVM","SVM",10,36,9633,9612,21,3700,3192,508,0.976232125919932,0.930769230769231,5.63993766696349,242,103,139,1,1.3,27.75,6.3,0,0,0,0,0,0,0.00117900628675619,2.24662101210466,0.121542628138055
24.3,"random_policy_SVM","SVM",10,37,9533,9514,19,3800,3290,510,0.992036954773033,0.926923076923077,5.79241414835165,250,105,145,8,1.4,28.5,6.5,0,0,0,0,0,0,0.00144614487608261,2.64829062619743,0.238612030601378
24.3,"random_policy_SVM","SVM",10,38,9433,9427,6,3900,3377,523,0.999510751461743,0.942307692307692,5.99011680143756,284,121,163,34,1.3,29.25,6.5,0,0,0,0,0,0,0.00203938640071117,4.78523184045169,1.92770749113008
24.3,"random_policy_SVM","SVM",10,39,9333,9333,0,4000,3471,529,0.999576184701829,0.95,5.99011680143756,304,126,178,20,1.4,30,6.6,0,0,0,0,0,0,0.00187743637221056,2.80090992092502,0.252010920041685
24.3,"random_policy_SVM","SVM",10,40,9233,9233,0,4100,3571,529,0.999565979517595,0.95,5.98473967684022,305,125,180,1,1.4,30.75,6.8,0,0,0,0,0,0,0.00159551400884971,2.74215879400182,0.173550990019522
24.3,"random_policy_SVM","SVM",10,41,9133,9133,0,4200,3671,529,0.999560576773001,0.95,5.98473967684022,305,126,179,0,1.4,31.5,6.9,0,0,0,0,0,0,0.00212178788556894,4.20166418943374,0.221715613787729
24.3,"random_policy_SVM","SVM",10,42,9033,9033,0,4300,3771,529,0.99956657982255,0.95,5.99011680143756,309,128,181,4,1.4,32.25,7.1,0,0,0,0,0,0,0.00152042852609601,2.84602991648629,0.15988554576845
24.3,"random_policy_SVM","SVM",10,43,8933,8933,0,4400,3871,529,0.999563578297775,0.95,5.99011680143756,308,129,179,-1,1.4,33,7.3,0,0,0,0,0,0,0.00149471611157764,2.91512420349926,0.154612450807855
24.3,"random_policy_SVM","SVM",10,44,8833,8833,0,4500,3971,529,0.99956778043246,0.95,5.99011680143756,310,129,181,2,1.4,33.75,7.5,0,0,0,0,0,0,0.00124920033970039,2.35245427702339,0.12880732912792
24.3,"random_policy_SVM","SVM",10,45,8733,8733,0,4600,4071,529,0.999558775858136,0.95,5.99011680143756,309,129,180,-1,1.4,34.5,7.7,0,0,0,0,0,0,0.00106970265299645,1.97712599189736,0.110376785331608
24.3,"random_policy_SVM","SVM",10,46,8633,8633,0,4700,4171,529,0.999561177077956,0.946153846153846,5.98473967684022,311,129,182,2,1.4,35.25,7.9,0,0,0,0,0,0,0.00105759323095812,1.96623509294215,0.109665104225492
24.3,"random_policy_SVM","SVM",10,47,8533,8533,0,4800,4271,529,0.999558175553181,0.946153846153846,5.98473967684022,312,129,183,1,1.4,36,8.1,0,0,0,0,0,0,0.000871563776628613,1.62628682059509,0.0904996910192676
24.3,"random_policy_SVM","SVM",10,48,8433,8433,0,4900,4371,529,0.999555774333361,0.946153846153846,5.98473967684022,312,129,183,0,1.4,36.75,8.3,0,0,0,0,0,0,0.000941804635389702,1.76922951362092,0.096474758899202
24.3,"random_policy_SVM","SVM",11,0,13233,12705,528,100,94,6,0.941334874561134,0.745098039215686,5.40442643059037,26,6,20,0,3.3,0.75,15.7,0,0,0,0,0,0,0.956448981316428,646.159751095374,98.0534536442741
24.3,"random_policy_SVM","SVM",11,1,13133,12685,448,200,114,86,0.959402101451908,0.87843137254902,5.4030150063528,67,29,38,41,1.3,1.5,1.3,0,0,0,0,0,0,0.991793658404151,504.563949878678,99.5654322353643
24.3,"random_policy_SVM","SVM",11,2,13033,12661,372,300,138,162,0.955008990495721,0.87843137254902,5.41494030501089,100,43,57,33,1.3,2.25,0.9,0,0,0,0,0,0,0.998174479207714,371.247964085161,99.8941124092797
24.3,"random_policy_SVM","SVM",11,3,12933,12624,309,400,175,225,0.941088400425623,0.886274509803922,5.15664563403216,118,51,67,18,1.3,3,0.8,0,0,0,0,0,0,0.999423295924879,278.451124670275,99.9723411897612
24.3,"random_policy_SVM","SVM",11,4,12833,12580,253,500,219,281,0.936618839675586,0.886274509803922,5.21986195529,130,55,75,12,1.4,3.75,0.8,0,0,0,0,0,0,0.998971031774476,197.827130589282,99.9509443462435
24.3,"random_policy_SVM","SVM",11,5,12733,12538,195,600,261,339,0.939029148777388,0.886274509803922,5.14329797492768,145,56,89,15,1.6,4.5,0.8,0,0,0,0,0,0,0.998017943438745,139.338029419015,99.9180572939425
24.3,"random_policy_SVM","SVM",11,6,12633,12495,138,700,304,396,0.940062749990819,0.886274509803922,5.20608531131751,144,58,86,-1,1.5,5.25,0.8,0,0,0,0,0,0,0.00364714631038347,81.3265396361991,81.225638272574
24.3,"random_policy_SVM","SVM",11,7,12533,12444,89,800,355,445,0.942980074125713,0.886274509803922,5.16111026228673,151,61,90,7,1.5,6,0.8,0,0,0,0,0,0,1.16069430584338e-05,31.9953863350538,31.9878630368177
24.3,"random_policy_SVM","SVM",11,8,12433,12376,57,900,423,477,0.945133511920039,0.886274509803922,5.17455065359477,146,62,84,-5,1.4,6.75,0.9,0,0,0,0,0,0,5.30207530381665e-06,0.00679821257616898,0.00410117459063918
24.3,"random_policy_SVM","SVM",11,9,12333,12276,57,1000,523,477,0.948482012892471,0.886274509803922,5.16558262819859,150,67,83,4,1.2,7.5,1.1,0,0,0,0,0,0,1.78428072018591e-06,0.00104461799745054,0.000244816351491588
24.3,"random_policy_SVM","SVM",11,10,12233,12176,57,1100,623,477,0.949502770540506,0.886274509803922,5.16111026228673,150,67,83,0,1.2,8.25,1.3,0,0,0,0,0,0,9.43443855834295e-07,0.000542324578369939,0.000120664133759627
24.3,"random_policy_SVM","SVM",11,11,12133,12076,57,1200,723,477,0.951009748877684,0.886274509803922,5.19258044681287,146,64,82,-4,1.3,9,1.5,0,0,0,0,0,0,3.9760165510815e-07,0.000224572374644501,5.1302584703681e-05
24.3,"random_policy_SVM","SVM",11,12,12033,11977,56,1300,822,478,0.955985713062474,0.894117647058824,5.26549053797631,153,67,86,7,1.3,9.75,1.7,0,0,0,0,0,0,1.24564769871346e-06,0.00398784731270741,0.00333911862907736
24.3,"random_policy_SVM","SVM",11,13,11933,11881,52,1400,918,482,0.963872273800326,0.894117647058824,5.38012087496995,163,71,92,10,1.3,10.5,1.9,0,0,0,0,0,0,3.52545953888573e-06,0.094702356295055,0.0928897385974614
24.3,"random_policy_SVM","SVM",11,14,11833,11788,45,1500,1011,489,0.963042334837829,0.909803921568627,5.43927738927739,178,79,99,15,1.3,11.25,2.1,0,0,0,0,0,0,6.93415418255364e-06,0.310713030557573,0.308538547073418
24.3,"random_policy_SVM","SVM",11,15,11733,11699,34,1600,1100,500,0.962899832422015,0.925490196078431,5.4345269286754,205,93,112,27,1.2,12,2.2,0,0,0,0,0,0,1.65365357608031e-05,0.492518949397549,0.489713373509249
24.3,"random_policy_SVM","SVM",11,16,11633,11603,30,1700,1196,504,0.965428791603938,0.925490196078431,5.46691026366802,219,98,121,14,1.2,12.75,2.4,0,0,0,0,0,0,9.24814746871996e-06,0.0907287164659406,0.0882320645404584
24.3,"random_policy_SVM","SVM",11,17,11533,11503,30,1800,1296,504,0.965241642508488,0.925490196078431,5.46691026366802,216,98,118,-3,1.2,13.5,2.6,0,0,0,0,0,0,6.62489578865777e-06,0.00285230366054535,0.000813053623960894
24.3,"random_policy_SVM","SVM",11,18,11433,11403,30,1900,1396,504,0.965256932467261,0.925490196078431,5.46691026366802,214,98,116,-2,1.2,14.25,2.8,0,0,0,0,0,0,3.5494566823603e-06,0.00193707871541624,0.000451686918413332
24.3,"random_policy_SVM","SVM",11,19,11333,11304,29,2000,1495,505,0.967467860506628,0.925490196078431,5.48498560263266,222,100,122,8,1.2,15,3,0,0,0,0,0,0,4.01314707971988e-06,0.00250407991992432,0.000486249283640764
24.3,"random_policy_SVM","SVM",11,20,11233,11204,29,2100,1595,505,0.967305786943578,0.925490196078431,5.48498560263266,221,100,121,-1,1.2,15.75,3.2,0,0,0,0,0,0,2.84948403976493e-06,0.00192542648833676,0.000333979525257486
24.3,"random_policy_SVM","SVM",11,21,11133,11106,27,2200,1693,507,0.973438895208693,0.925490196078431,5.5223213211665,226,101,125,5,1.2,16.5,3.3,0,0,0,0,0,0,3.44401684312845e-06,0.00294747378642248,0.000543285750030772
24.3,"random_policy_SVM","SVM",11,22,11033,11008,25,2300,1791,509,0.978422810172088,0.925490196078431,5.57114821171616,232,101,131,6,1.3,17.25,3.5,0,0,0,0,0,0,1.63860174759658e-05,0.255722913858075,0.243231634738686
24.3,"random_policy_SVM","SVM",11,23,10933,10911,22,2400,1888,512,0.98539197338323,0.925490196078431,5.69382135076253,242,105,137,10,1.3,18,3.7,0,0,0,0,0,0,0.00357228260505557,1.04040720211351,0.451376652722342
24.3,"random_policy_SVM","SVM",11,24,10833,10818,15,2500,1981,519,0.996200751042777,0.929411764705882,5.90599089635854,257,114,143,15,1.3,18.75,3.8,0,0,0,0,0,0,0.00824800585514841,7.81143849310663,1.09118444839694
24.3,"random_policy_SVM","SVM",11,25,10733,10725,8,2600,2074,526,0.999108901202402,0.929411764705882,6.03348416289593,280,124,156,23,1.3,19.5,3.9,0,0,0,0,0,0,0.0148548701627087,11.8896875420162,2.12504763606183
24.3,"random_policy_SVM","SVM",11,26,10633,10632,1,2700,2167,533,0.999547417220163,0.937254901960784,5.9955035971223,304,131,173,24,1.3,20.25,4.1,0,0,0,0,0,0,0.011830058332799,9.55029520931804,1.52731310039738
24.3,"random_policy_SVM","SVM",11,27,10533,10533,0,2800,2266,534,0.999595121891551,0.941176470588235,5.9955035971223,306,132,174,2,1.3,21,4.2,0,0,0,0,0,0,0.0083278361551172,6.19006818266146,0.950281616147972
24.3,"random_policy_SVM","SVM",11,28,10433,10433,0,2900,2366,534,0.999595733489903,0.945098039215686,5.98473967684022,309,132,177,3,1.3,21.75,4.4,0,0,0,0,0,0,0.00699021673057362,5.50908519657492,0.776302770996701
24.3,"random_policy_SVM","SVM",11,29,10333,10333,0,3000,2466,534,0.999601237875063,0.945098039215686,5.99011680143756,309,132,177,0,1.3,22.5,4.6,0,0,0,0,0,0,0.00525952084009146,3.43218464041842,0.567017640424678
24.3,"random_policy_SVM","SVM",11,30,10233,10233,0,3100,2566,534,0.999607965456925,0.945098039215686,5.98473967684022,309,132,177,0,1.3,23.25,4.8,0,0,0,0,0,0,0.00426172023085784,2.1999444153151,0.453846430364824
24.3,"random_policy_SVM","SVM",11,31,10133,10133,0,3200,2666,534,0.999612246645383,0.945098039215686,5.99011680143756,311,132,179,2,1.4,24,5,0,0,0,0,0,0,0.00481168295539489,3.28083729755968,0.511379216762337
24.3,"random_policy_SVM","SVM",11,32,10033,10033,0,3300,2766,534,0.999614081440436,0.941176470588235,5.98473967684022,312,133,179,1,1.3,24.75,5.2,0,0,0,0,0,0,0.00335486201161776,1.23782650682761,0.353127066267292
24.3,"random_policy_SVM","SVM",11,33,9933,9933,0,3400,2866,534,0.999614693038788,0.941176470588235,5.99011680143756,313,134,179,1,1.3,25.5,5.4,0,0,0,0,0,0,0.00267472297929934,0.499361614861088,0.281337292625542
24.3,"random_policy_SVM","SVM",11,34,9833,9833,0,3500,2966,534,0.999618362628894,0.941176470588235,5.98473967684022,313,134,179,0,1.3,26.25,5.6,0,0,0,0,0,0,1.85124659526238e-05,0.245811328013351,0.233397779791428
24.3,"random_policy_SVM","SVM",11,35,9733,9733,0,3600,3066,534,0.999622032219001,0.941176470588235,5.9686660698299,313,135,178,0,1.3,27,5.7,0,0,0,0,0,0,1.27918293622419e-05,0.0102718746134471,0.00142245140447257
24.3,"random_policy_SVM","SVM",11,36,9633,9633,0,3700,3166,534,0.999626313407459,0.941176470588235,5.9686660698299,315,136,179,2,1.3,27.75,5.9,0,0,0,0,0,0,0.0018004695788711,2.71720748945737,0.187966256142164
24.3,"random_policy_SVM","SVM",11,37,9533,9533,0,3800,3266,534,0.999628148202512,0.941176470588235,5.94206773618538,314,136,178,-1,1.3,28.5,6.1,0,0,0,0,0,0,0.00147614223135084,2.22420643020143,0.155762874649308
24.3,"random_policy_SVM","SVM",11,38,9433,9433,0,3900,3366,534,0.999624478612406,0.937254901960784,5.95267857142857,314,136,178,0,1.3,29.25,6.3,0,0,0,0,0,0,0.00150803635665203,2.37766500096191,0.156987899331548
24.3,"random_policy_SVM","SVM",11,39,9333,9333,0,4000,3466,534,0.999624478612406,0.937254901960784,5.9579982126899,312,137,175,-2,1.3,30,6.5,0,0,0,0,0,0,0.0013941149458948,2.21344643268436,0.144760653709311
24.3,"random_policy_SVM","SVM",11,40,9233,9233,0,4100,3566,534,0.999631206194268,0.937254901960784,5.97401433691756,313,136,177,1,1.3,30.75,6.7,0,0,0,0,0,0,0.00166216926102808,2.84717831319743,0.17165259913981
24.3,"random_policy_SVM","SVM",11,41,9133,9133,0,4200,3666,534,0.999631817792619,0.937254901960784,5.9579982126899,312,135,177,-1,1.3,31.5,6.9,0,0,0,0,0,0,0.00103211951561017,1.61006919905415,0.106326842018623
24.3,"random_policy_SVM","SVM",11,42,9033,9033,0,4300,3766,534,0.999631817792619,0.937254901960784,5.97401433691756,315,135,180,3,1.3,32.25,7.1,0,0,0,0,0,0,0.00125612139045584,2.10236850386493,0.130525394860936
24.3,"random_policy_SVM","SVM",11,43,8933,8933,0,4400,3866,534,0.999635487382726,0.937254901960784,5.97401433691756,314,134,180,-1,1.3,33,7.2,0,0,0,0,0,0,0.00130139368458508,2.2057378905839,0.134076656958483
24.3,"random_policy_SVM","SVM",11,44,8833,8833,0,4500,3966,534,0.999638545374482,0.937254901960784,5.9579982126899,315,134,181,1,1.4,33.75,7.4,0,0,0,0,0,0,0.000856577838561982,1.34867544238826,0.0881885916443362
24.3,"random_policy_SVM","SVM",11,45,8733,8733,0,4600,4066,534,0.999644661357993,0.937254901960784,5.9579982126899,313,135,178,-2,1.3,34.5,7.6,0,0,0,0,0,0,0.00072231311526778,1.11395506014728,0.0747586090113961
24.3,"random_policy_SVM","SVM",11,46,8633,8633,0,4700,4166,534,0.999644661357993,0.937254901960784,5.97937219730942,315,135,180,2,1.3,35.25,7.8,0,0,0,0,0,0,0.000995186297916988,1.63240171886087,0.102378310994814
24.3,"random_policy_SVM","SVM",11,47,8533,8533,0,4800,4266,534,0.999642214964588,0.937254901960784,5.96332737030411,315,134,181,0,1.4,36,8,0,0,0,0,0,0,0.000624834855686637,0.947447608584414,0.0643724243269492
24.3,"random_policy_SVM","SVM",11,48,8433,8433,0,4900,4366,534,0.999641603366237,0.937254901960784,5.94736842105263,315,134,181,0,1.4,36.75,8.2,0,0,0,0,0,0,0.000599622350989237,0.885647597639694,0.0616197495969707
24.3,"random_policy_SVM","SVM",12,0,13233,12703,530,100,95,5,0.977571394718627,0.822834645669291,5.7617630113309,24,5,19,0,3.8,0.75,19,0,0,0,0,0,0,0.973118704684217,866.444699156909,98.3428629319048
24.3,"random_policy_SVM","SVM",12,1,13133,12673,460,200,125,75,0.979863736431024,0.874015748031496,5.64122879400288,59,22,37,35,1.7,1.5,1.7,0,0,0,0,0,0,0.995020721892263,617.873242845059,99.7135025464748
24.3,"random_policy_SVM","SVM",12,2,13033,12651,382,300,147,153,0.954738222434497,0.889763779527559,5.39022075365579,99,40,59,40,1.5,2.25,1,0,0,0,0,0,0,0.993910623399265,476.18774686083,99.6558186234789
24.3,"random_policy_SVM","SVM",12,3,12933,12603,330,400,195,205,0.961054133397814,0.897637795275591,5.19515921572898,105,49,56,6,1.1,3,1,0,0,0,0,0,0,0.993101967393581,312.731892647988,99.6243854569773
24.3,"random_policy_SVM","SVM",12,4,12833,12581,252,500,217,283,0.952792740140249,0.897637795275591,5.3007539248028,127,57,70,22,1.2,3.75,0.8,0,0,0,0,0,0,0.992442902479661,227.395874705062,99.7102851700185
24.3,"random_policy_SVM","SVM",12,5,12733,12552,181,600,246,354,0.953053038181504,0.897637795275591,5.29585833709112,141,60,81,14,1.4,4.5,0.7,0,0,0,0,0,0,0.992345497727055,141.540680832287,99.7287043440944
24.3,"random_policy_SVM","SVM",12,6,12633,12514,119,700,284,416,0.954365578776356,0.897637795275591,5.2496062992126,157,62,95,16,1.5,5.25,0.7,0,0,0,0,0,0,0.00749736683089274,74.441773870015,59.8175536235866
24.3,"random_policy_SVM","SVM",12,7,12533,12452,81,800,346,454,0.957262622306318,0.897637795275591,5.17694738849685,152,66,86,-5,1.3,6,0.8,0,0,0,0,0,0,0.00500047187584864,24.8485858820213,22.4336009558008
24.3,"random_policy_SVM","SVM",12,8,12433,12367,66,900,431,469,0.956937249754732,0.897637795275591,5.15021616273869,149,65,84,-3,1.3,6.75,0.9,0,0,0,0,0,0,0.00295610075298176,7.58894305615591,7.31703391342908
24.3,"random_policy_SVM","SVM",12,9,12333,12271,62,1000,527,473,0.958401426236803,0.897637795275591,5.1550593590038,150,66,84,1,1.3,7.5,1.1,0,0,0,0,0,0,0.00277493057181004,3.53971690424672,3.29993806467927
24.3,"random_policy_SVM","SVM",12,10,12233,12174,59,1100,624,476,0.960769892848054,0.897637795275591,5.18646670454853,150,68,82,0,1.2,8.25,1.3,0,0,0,0,0,0,7.19369520442985e-06,0.00511484578092269,0.000903008627359079
24.3,"random_policy_SVM","SVM",12,11,12133,12076,57,1200,722,478,0.966716843616121,0.901574803149606,5.2946672974891,155,68,87,5,1.3,9,1.5,0,0,0,0,0,0,0.00268434936679899,0.537733084404939,0.383846642860211
24.3,"random_policy_SVM","SVM",12,12,12033,11984,49,1300,814,486,0.971269603696234,0.913385826771654,5.40799959272332,181,77,104,26,1.4,9.75,1.7,0,0,0,0,0,0,0.00421233267588411,1.95265334258654,0.70555015534667
24.3,"random_policy_SVM","SVM",12,13,11933,11895,38,1400,903,497,0.972363592162091,0.929133858267717,5.430627206082,204,88,116,23,1.3,10.5,1.8,0,0,0,0,0,0,0.00498087042043572,2.05923844971113,1.05483464365955
24.3,"random_policy_SVM","SVM",12,14,11833,11799,34,1500,999,501,0.973148783659218,0.929133858267717,5.45795995733493,212,93,119,8,1.3,11.25,2,0,0,0,0,0,0,0.00364190937038348,1.03330731009933,0.458386605076108
24.3,"random_policy_SVM","SVM",12,15,11733,11699,34,1600,1099,501,0.972824025018116,0.929133858267717,5.46267322154679,210,91,119,-2,1.3,12,2.2,0,0,0,0,0,0,0.00350296880557303,1.05829648201626,0.3913395876116
24.3,"random_policy_SVM","SVM",12,16,11633,11600,33,1700,1198,502,0.974834581822642,0.933070866141732,5.49008091793193,212,92,120,2,1.3,12.75,2.4,0,0,0,0,0,0,0.00278811606575261,0.514715679949402,0.303494357235709
24.3,"random_policy_SVM","SVM",12,17,11533,11500,33,1800,1298,502,0.97501322977077,0.929133858267717,5.49008091793193,213,92,121,1,1.3,13.5,2.6,0,0,0,0,0,0,1.24240607033652e-05,0.0107531044799674,0.00146038232776597
24.3,"random_policy_SVM","SVM",12,18,11433,11401,32,1900,1397,503,0.977832306670389,0.929133858267717,5.50435322534423,218,93,125,5,1.3,14.25,2.8,0,0,0,0,0,0,1.71410434083941e-05,0.167943180687854,0.152303081735255
24.3,"random_policy_SVM","SVM",12,19,11333,11304,29,2000,1494,506,0.983520187218126,0.929133858267717,5.57399450395071,226,96,130,8,1.4,15,3,0,0,0,0,0,0,0.00429435479758468,3.95221736979566,0.490502433543088
24.3,"random_policy_SVM","SVM",12,20,11233,11208,25,2100,1590,510,0.991369646547204,0.929133858267717,5.75837871587637,239,102,137,13,1.3,15.75,3.1,0,0,0,0,0,0,0.00764052059425872,8.93858952070678,0.928287150856595
24.3,"random_policy_SVM","SVM",12,21,11133,11115,18,2200,1683,517,0.996699003377727,0.929133858267717,5.8691250550203,257,111,146,18,1.3,16.5,3.3,0,0,0,0,0,0,0.0110628484366325,12.0849778033253,1.52592279930611
24.3,"random_policy_SVM","SVM",12,22,11033,11026,7,2300,1772,528,0.999266990893252,0.940944881889764,5.93149466192171,294,125,169,37,1.4,17.25,3.4,0,0,0,0,0,0,0.0157715709148982,16.1915639688042,2.10711185319981
24.3,"random_policy_SVM","SVM",12,23,10933,10931,2,2400,1867,533,0.999448094483278,0.94488188976378,6.00630630630631,310,132,178,16,1.3,18,3.5,0,0,0,0,0,0,0.0147742606539629,14.5551486654706,2.0060085688494
24.3,"random_policy_SVM","SVM",12,24,10833,10833,0,2500,1965,535,0.99948922648508,0.948818897637795,5.93149466192171,315,134,181,5,1.4,18.75,3.7,0,0,0,0,0,0,0.0110434998104532,10.799522942009,1.2763381680942
24.3,"random_policy_SVM","SVM",12,25,10733,10733,0,2600,2065,535,0.999495365589827,0.94488188976378,5.94736842105263,316,136,180,1,1.3,19.5,3.9,0,0,0,0,0,0,0.00898688806275679,8.94865601354694,0.982334959216187
24.3,"random_policy_SVM","SVM",12,26,10633,10633,0,2700,2165,535,0.999504574246947,0.94488188976378,5.94736842105263,316,136,180,0,1.3,20.25,4,0,0,0,0,0,0,0.00748299157215071,6.87544788112929,0.785822389115595
24.3,"random_policy_SVM","SVM",12,27,10533,10533,0,2800,2265,535,0.999509485530744,0.94488188976378,5.94206773618538,316,135,181,0,1.3,21,4.2,0,0,0,0,0,0,0.00551755062338304,3.95170599781967,0.588471883481944
24.3,"random_policy_SVM","SVM",12,28,10433,10433,0,2900,2365,535,0.999515624635491,0.94488188976378,5.94206773618538,315,133,182,-1,1.4,21.75,4.4,0,0,0,0,0,0,0.00512980628007939,3.69095043066929,0.539018563953136
24.3,"random_policy_SVM","SVM",12,29,10333,10333,0,3000,2465,535,0.999521763740237,0.94488188976378,5.93677649154052,317,134,183,2,1.4,22.5,4.6,0,0,0,0,0,0,0.00461363577007264,3.17130866147864,0.483401307352287
24.3,"random_policy_SVM","SVM",12,30,10233,10233,0,3100,2565,535,0.999525447203085,0.94488188976378,5.93677649154052,319,134,185,2,1.4,23.25,4.8,0,0,0,0,0,0,0.00383574643724939,1.90361265099211,0.39946402309899
24.3,"random_policy_SVM","SVM",12,31,10133,10133,0,3200,2665,535,0.999529130665933,0.94488188976378,5.93149466192171,316,131,185,-3,1.4,24,5,0,0,0,0,0,0,0.00305173226199672,0.894895869920879,0.322435026478624
24.3,"random_policy_SVM","SVM",12,32,10033,10033,0,3300,2765,535,0.999530972397357,0.94488188976378,5.93677649154052,318,132,186,2,1.4,24.75,5.2,0,0,0,0,0,0,0.00281605843189342,0.617605899423901,0.294702414041308
24.3,"random_policy_SVM","SVM",12,33,9933,9933,0,3400,2865,535,0.999529744576408,0.94488188976378,5.9052258635961,317,131,186,-1,1.4,25.5,5.4,0,0,0,0,0,0,0.00264099627210786,0.449115715773106,0.277376085345674
24.3,"random_policy_SVM","SVM",12,34,9833,9833,0,3500,2965,535,0.999533428039256,0.948818897637795,5.9,317,131,186,0,1.4,26.25,5.5,0,0,0,0,0,0,1.31100467743182e-05,0.0111575659173834,0.00144062091220056
24.3,"random_policy_SVM","SVM",12,35,9733,9733,0,3600,3065,535,0.999535883681155,0.948818897637795,5.9,317,131,186,0,1.4,27,5.7,0,0,0,0,0,0,1.14033342107285e-05,0.0100467913830347,0.00123897826417601
24.3,"random_policy_SVM","SVM",12,36,9633,9633,0,3700,3165,535,0.999542022785901,0.948818897637795,5.9,318,131,187,1,1.4,27.75,5.9,0,0,0,0,0,0,1.00519432194067e-05,0.00882177301321905,0.00107144809823544
24.3,"random_policy_SVM","SVM",12,37,9533,9533,0,3800,3265,535,0.999546934069699,0.948818897637795,5.9,317,131,186,-1,1.4,28.5,6.1,0,0,0,0,0,0,8.66446997628581e-06,0.00787420546906806,0.000935963893526946
24.3,"random_policy_SVM","SVM",12,38,9433,9433,0,3900,3365,535,0.999550003622072,0.948818897637795,5.8585237258348,317,131,186,0,1.4,29.25,6.3,0,0,0,0,0,0,5.86359818736889e-06,0.00521608138439799,0.000635764432571455
24.3,"random_policy_SVM","SVM",12,39,9333,9333,0,4000,3465,535,0.999550617532546,0.948818897637795,5.8277972027972,317,132,185,0,1.4,30,6.5,0,0,0,0,0,0,3.8924243363949e-06,0.00344032224699673,0.000423897143687285
24.3,"random_policy_SVM","SVM",12,40,9233,9233,0,4100,3565,535,0.99955368708492,0.948818897637795,5.894783377542,314,131,183,-3,1.4,30.75,6.7,0,0,0,0,0,0,4.15359066601405e-06,0.00387345466064468,0.00044534647156642
24.3,"random_policy_SVM","SVM",12,41,9133,9133,0,4200,3665,535,0.999551231443021,0.948818897637795,5.82270742358079,315,131,184,1,1.4,31.5,6.9,0,0,0,0,0,0,2.52432257603009e-06,0.00225041274962272,0.000270590305195941
24.3,"random_policy_SVM","SVM",12,42,9033,9033,0,4300,3765,535,0.999551231443021,0.948818897637795,5.8585237258348,314,132,182,-1,1.4,32.25,7,0,0,0,0,0,0,2.43800889218349e-06,0.00221106996618417,0.000262245553817191
24.3,"random_policy_SVM","SVM",12,43,8933,8933,0,4400,3865,535,0.999552766219208,0.948818897637795,5.80243690165361,314,132,182,0,1.4,33,7.2,0,0,0,0,0,0,1.9277056746106e-06,0.00168781352505049,0.000206175805654429
24.3,"random_policy_SVM","SVM",12,44,8833,8833,0,4500,3965,535,0.999551845353496,0.948818897637795,5.8277972027972,316,132,184,2,1.4,33.75,7.4,0,0,0,0,0,0,1.47468865604566e-06,0.00129428045320982,0.000156583332521863
24.3,"random_policy_SVM","SVM",12,45,8733,8733,0,4600,4065,535,0.999551231443021,0.948818897637795,5.85338015803336,320,132,188,4,1.4,34.5,7.6,0,0,0,0,0,0,1.88879130778218e-06,0.00167002394390809,0.000201091689870448
24.3,"random_policy_SVM","SVM",12,46,8633,8633,0,4700,4165,535,0.999546934069699,0.948818897637795,5.84312007011393,319,131,188,-1,1.4,35.25,7.8,0,0,0,0,0,0,1.45405634836205e-06,0.00124865752259278,0.000155709192499453
24.3,"random_policy_SVM","SVM",12,47,8533,8533,0,4800,4265,535,0.999543864517325,0.948818897637795,5.86883802816901,316,130,186,-3,1.4,36,8,0,0,0,0,0,0,0.000721294676757223,1.10935190404376,0.0745509422459208
24.3,"random_policy_SVM","SVM",12,48,8433,8433,0,4900,4365,535,0.999548161890648,0.948818897637795,5.9,317,130,187,1,1.4,36.75,8.2,0,0,0,0,0,0,0.000753935701510254,1.18600670434195,0.0778284192489878
24.3,"random_policy_SVM","SVM",13,0,13233,12733,500,100,95,5,0.961754704949107,0.809859154929577,5.18260391318241,20,5,15,0,3,0.75,19,0,0,0,0,0,0,0.993142913907211,714.28865952488,99.7676362479341
24.3,"random_policy_SVM","SVM",13,1,13133,12684,449,200,144,56,0.94674288879128,0.852112676056338,5.07467186095295,52,18,34,32,1.9,1.5,2.6,0,0,0,0,0,0,0.974994943338143,483.836315014598,98.7873421693178
24.3,"random_policy_SVM","SVM",13,2,13033,12665,368,300,163,137,0.955717541974367,0.890845070422535,5.36165449487046,90,40,50,38,1.2,2.25,1.2,0,0,0,0,0,0,0.990469933204989,328.120382415407,99.4699255451086
24.3,"random_policy_SVM","SVM",13,3,12933,12640,293,400,188,212,0.953582138294272,0.901408450704225,5.36165449487046,112,53,59,22,1.1,3,0.9,0,0,0,0,0,0,0.994235187321381,261.350821316995,99.7104793038026
24.3,"random_policy_SVM","SVM",13,4,12833,12601,232,500,227,273,0.948164468559743,0.901408450704225,5.22127727267165,133,60,73,21,1.2,3.75,0.8,0,0,0,0,0,0,0.995670913341694,188.213207156779,99.8481750281364
24.3,"random_policy_SVM","SVM",13,5,12733,12564,169,600,264,336,0.947219506920872,0.901408450704225,5.24405771452449,138,62,76,5,1.2,4.5,0.8,0,0,0,0,0,0,0.994077358834419,113.471355002473,99.8397200352465
24.3,"random_policy_SVM","SVM",13,6,12633,12519,114,700,309,391,0.947862720739274,0.901408450704225,5.27165801828515,148,64,84,10,1.3,5.25,0.8,0,0,0,0,0,0,0.00742219593772799,63.3438565749664,56.201777882109
24.3,"random_policy_SVM","SVM",13,7,12533,12454,79,800,374,426,0.950369930691775,0.901408450704225,5.22127727267165,151,67,84,3,1.3,6,0.9,0,0,0,0,0,0,0.0038867688684462,22.3758853294662,21.3800343778485
24.3,"random_policy_SVM","SVM",13,8,12433,12369,64,900,459,441,0.951628224619532,0.901408450704225,5.22581751377832,145,66,79,-6,1.2,6.75,1,0,0,0,0,0,0,1.88819281277322e-05,6.28324898036451,6.27300997525886
24.3,"random_policy_SVM","SVM",13,9,12333,12275,58,1000,553,447,0.952333773910893,0.901408450704225,5.2349217254748,152,68,84,7,1.2,7.5,1.2,0,0,0,0,0,0,5.40748432812899e-06,0.00355620034600739,0.000732040204583967
24.3,"random_policy_SVM","SVM",13,10,12233,12175,58,1100,653,447,0.953343829229483,0.901408450704225,5.2349217254748,149,67,82,-3,1.2,8.25,1.5,0,0,0,0,0,0,3.34209046308198e-06,0.00192864603562183,0.000437503450216517
24.3,"random_policy_SVM","SVM",13,11,12133,12075,58,1200,753,447,0.953601445741653,0.901408450704225,5.2349217254748,148,66,82,-1,1.2,9,1.7,0,0,0,0,0,0,2.42882451892344e-06,0.00141609415569368,0.000297841012992856
24.3,"random_policy_SVM","SVM",13,12,12033,11975,58,1300,853,447,0.954732310516701,0.901408450704225,5.2349217254748,151,68,83,3,1.2,9.75,1.9,0,0,0,0,0,0,9.06302175361669e-07,0.000518616461409648,0.000118776223579667
24.3,"random_policy_SVM","SVM",13,13,11933,11875,58,1400,953,447,0.955140525118427,0.901408450704225,5.2349217254748,154,70,84,3,1.2,10.5,2.1,0,0,0,0,0,0,8.10024977964049e-07,0.000479018721237286,9.84503581389973e-05
24.3,"random_policy_SVM","SVM",13,14,11833,11775,58,1500,1053,447,0.95524423369292,0.901408450704225,5.23948573744121,153,68,85,-1,1.2,11.25,2.4,0,0,0,0,0,0,2.26406633711163e-07,0.000130938869411479,2.79041522079302e-05
24.3,"random_policy_SVM","SVM",13,15,11733,11675,58,1600,1153,447,0.955562530753999,0.901408450704225,5.24405771452449,152,69,83,-1,1.2,12,2.6,0,0,0,0,0,0,2.59689822332464e-07,0.000163793267693765,3.13151267778389e-05
24.3,"random_policy_SVM","SVM",13,16,11633,11576,57,1700,1252,448,0.959018012193473,0.901408450704225,5.32876090901236,153,68,85,1,1.2,12.75,2.8,0,0,0,0,0,0,4.37864162253243e-07,0.000332175667941493,8.54701655787842e-05
24.3,"random_policy_SVM","SVM",13,17,11533,11481,52,1800,1347,453,0.973366203802794,0.901408450704225,5.4574465426097,178,76,102,25,1.3,13.5,3,0,0,0,0,0,0,1.87332439302708e-05,0.44755671409139,0.44247057025782
24.3,"random_policy_SVM","SVM",13,18,11433,11395,38,1900,1433,467,0.987416509081098,0.911971830985915,5.73332311810472,210,95,115,32,1.2,14.25,3.1,0,0,0,0,0,0,0.00565070910681618,2.09477034583565,0.944711649914106
24.3,"random_policy_SVM","SVM",13,19,11333,11306,27,2000,1522,478,0.995169828307146,0.922535211267606,5.86358392071318,232,107,125,22,1.2,15,3.2,0,0,0,0,0,0,0.00790514143084849,4.46840369106048,1.17323712779708
24.3,"random_policy_SVM","SVM",13,20,11233,11218,15,2100,1610,490,0.998843759722679,0.943661971830986,5.99011680143756,269,119,150,37,1.3,15.75,3.3,0,0,0,0,0,0,0.0134071266277793,11.4719484535842,1.85832991686524
24.3,"random_policy_SVM","SVM",13,21,11133,11127,6,2200,1701,499,0.99966901518779,0.954225352112676,5.97401433691756,294,129,165,25,1.3,16.5,3.4,0,0,0,0,0,0,0.0166990265144192,13.7583950899361,2.64096397576061
24.3,"random_policy_SVM","SVM",13,22,11033,11032,1,2300,1796,504,0.999723076040451,0.957746478873239,5.97937219730942,308,139,169,14,1.2,17.25,3.6,0,0,0,0,0,0,0.0121346439707876,10.1264056269709,1.52521341269614
24.3,"random_policy_SVM","SVM",13,23,10933,10933,0,2400,1895,505,0.99974845154272,0.957746478873239,5.97937219730942,311,140,171,3,1.2,18,3.8,0,0,0,0,0,0,0.00874098714121736,6.76558525958673,0.969109135352711
24.3,"random_policy_SVM","SVM",13,24,10833,10833,0,2500,1995,505,0.999753967956257,0.957746478873239,5.97937219730942,309,138,171,-2,1.2,18.75,4,0,0,0,0,0,0,0.0071670965775532,5.86350773695494,0.784205893319324
24.3,"random_policy_SVM","SVM",13,25,10733,10733,0,2600,2095,505,0.999763897500623,0.957746478873239,5.97937219730942,310,138,172,1,1.2,19.5,4.1,0,0,0,0,0,0,0.00574944669998347,4.34070216390455,0.618073299397813
24.3,"random_policy_SVM","SVM",13,26,10633,10633,0,2700,2195,505,0.999772723762282,0.957746478873239,5.97937219730942,312,138,174,2,1.3,20.25,4.3,0,0,0,0,0,0,0.00489190117459788,3.11941333544149,0.514135671873581
24.3,"random_policy_SVM","SVM",13,27,10533,10533,0,2800,2295,505,0.999779343458526,0.957746478873239,5.97937219730942,311,138,173,-1,1.3,21,4.5,0,0,0,0,0,0,0.00408935062512169,2.16151360083138,0.436501586715312
24.3,"random_policy_SVM","SVM",13,28,10433,10433,0,2900,2395,505,0.999785411513417,0.957746478873239,5.9686660698299,313,138,175,2,1.3,21.75,4.7,0,0,0,0,0,0,0.00305347202048098,0.894977940572293,0.323488863125862
24.3,"random_policy_SVM","SVM",13,29,10333,10333,0,3000,2495,505,0.99979478941643,0.961267605633803,5.9686660698299,314,136,178,1,1.3,22.5,4.9,0,0,0,0,0,0,0.00282896983270289,0.673596677104908,0.298605751062387
24.3,"random_policy_SVM","SVM",13,30,10233,10233,0,3100,2595,505,0.999801409112674,0.961267605633803,5.95267857142857,311,135,176,-3,1.3,23.25,5.1,0,0,0,0,0,0,1.79236504513002e-05,0.177736481695669,0.165929097762177
24.3,"random_policy_SVM","SVM",13,31,10133,10133,0,3200,2695,505,0.999812993581101,0.961267605633803,5.9579982126899,312,134,178,1,1.3,24,5.3,0,0,0,0,0,0,0.00270390223444748,0.526176081288555,0.277700548241474
24.3,"random_policy_SVM","SVM",13,32,10033,10033,0,3300,2795,505,0.999816855070577,0.961267605633803,5.95267857142857,312,134,178,0,1.3,24.75,5.5,0,0,0,0,0,0,1.01331172316338e-05,0.00780060019527224,0.00111135314796657
24.3,"random_policy_SVM","SVM",13,33,9933,9933,0,3400,2895,505,0.999821268201406,0.961267605633803,5.9579982126899,312,134,178,0,1.3,25.5,5.7,0,0,0,0,0,0,1.17095912861447e-05,0.00958431291202258,0.00126404054119638
24.3,"random_policy_SVM","SVM",13,34,9833,9833,0,3500,2995,505,0.999826508794266,0.964788732394366,5.94736842105263,310,133,177,-2,1.3,26.25,5.9,0,0,0,0,0,0,7.82833696802908e-06,0.00614811389149553,0.000851374382061961
24.3,"random_policy_SVM","SVM",13,35,9733,9733,0,3600,3095,505,0.999830094463065,0.964788732394366,5.9,309,132,177,-1,1.3,27,6.1,0,0,0,0,0,0,3.68318173629404e-06,0.00282769957895309,0.000408079166269589
24.3,"random_policy_SVM","SVM",13,36,9633,9633,0,3700,3195,505,0.999833404311188,0.964788732394366,5.92622222222222,309,132,177,0,1.3,27.75,6.3,0,0,0,0,0,0,4.03722449200075e-06,0.00322781056280159,0.000438713686211302
24.3,"random_policy_SVM","SVM",13,37,9533,9533,0,3800,3295,505,0.999834507593895,0.964788732394366,5.95267857142857,309,132,177,0,1.3,28.5,6.5,0,0,0,0,0,0,3.63894854084474e-06,0.00300173023377761,0.000392123265580841
24.3,"random_policy_SVM","SVM",13,38,9433,9433,0,3900,3395,505,0.999837265800663,0.964788732394366,5.88957597173145,309,132,177,0,1.3,29.25,6.7,0,0,0,0,0,0,1.77257591403239e-06,0.00143778015136014,0.000195852850342349
24.3,"random_policy_SVM","SVM",13,39,9333,9333,0,4000,3495,505,0.999840575648785,0.964788732394366,5.95267857142857,310,132,178,1,1.3,30,6.9,0,0,0,0,0,0,0.000938534310814488,1.49702639235014,0.0969779130057666
24.3,"random_policy_SVM","SVM",13,40,9233,9233,0,4100,3595,505,0.999842230572846,0.964788732394366,5.95267857142857,310,133,177,0,1.3,30.75,7.1,0,0,0,0,0,0,0.000954751872086642,1.5687141708971,0.0989042244656696
24.3,"random_policy_SVM","SVM",13,41,9133,9133,0,4200,3695,505,0.999844988779615,0.964788732394366,5.92622222222222,310,132,178,0,1.3,31.5,7.3,0,0,0,0,0,0,0.000680966357612797,1.07630125748779,0.0707363695087026
24.3,"random_policy_SVM","SVM",13,42,9033,9033,0,4300,3795,505,0.999845540420969,0.964788732394366,5.832895888014,308,132,176,-2,1.3,32.25,7.5,0,0,0,0,0,0,0.000507543895696928,0.763991058153925,0.0527961906322144
24.3,"random_policy_SVM","SVM",13,43,8933,8933,0,4400,3895,505,0.999844988779615,0.964788732394366,5.894783377542,310,133,177,2,1.3,33,7.7,0,0,0,0,0,0,0.000515187149954553,0.797768896559695,0.0535488802324627
24.3,"random_policy_SVM","SVM",13,44,8833,8833,0,4500,3995,505,0.999845540420969,0.964788732394366,5.95267857142857,307,133,174,-3,1.3,33.75,7.9,0,0,0,0,0,0,0.000665026347498262,1.09398955177544,0.0685073034303408
24.3,"random_policy_SVM","SVM",13,45,8733,8733,0,4600,4095,505,0.99984719534503,0.964788732394366,5.93677649154052,307,133,174,0,1.3,34.5,8.1,0,0,0,0,0,0,0.000532075989431903,0.862498582424911,0.055233940152512
24.3,"random_policy_SVM","SVM",13,46,8633,8633,0,4700,4195,505,0.999848298627737,0.964788732394366,5.92622222222222,308,133,175,1,1.3,35.25,8.3,0,0,0,0,0,0,0.000442823784614806,0.709379503347991,0.0456728193091362
24.3,"random_policy_SVM","SVM",13,47,8533,8533,0,4800,4295,505,0.999849126089768,0.964788732394366,5.77729636048527,308,133,175,0,1.3,36,8.5,0,0,0,0,0,0,0.000335668938374356,0.514044201223,0.0346657205902122
24.3,"random_policy_SVM","SVM",13,48,8433,8433,0,4900,4395,505,0.999849401910444,0.964788732394366,5.88437775816417,308,133,175,0,1.3,36.75,8.7,0,0,0,0,0,0,0.000379786577804776,0.610846752236631,0.0393069707852143
24.3,"random_policy_SVM","SVM",14,0,13233,12705,528,100,93,7,0.961838097073939,0.803149606299213,5.39374960769408,22,7,15,0,2.1,0.75,13.3,0,0,0,0,0,0,0.999999457535359,706.063653728975,99.9999859481965
24.3,"random_policy_SVM","SVM",14,1,13133,12681,452,200,117,83,0.958069914580472,0.877952755905512,5.46052798087739,65,29,36,43,1.2,1.5,1.4,0,0,0,0,0,0,0.989330895592181,411.420399283412,99.4200869215154
24.3,"random_policy_SVM","SVM",14,2,13033,12662,371,300,136,164,0.934571263341777,0.881889763779528,5.198549120352,88,41,47,23,1.1,2.25,0.8,0,0,0,0,0,0,0.996560511583506,356.356589735086,99.8871072516729
24.3,"random_policy_SVM","SVM",14,3,12933,12618,315,400,180,220,0.937405074092836,0.881889763779528,5.09493852263268,101,48,53,13,1.1,3,0.8,0,0,0,0,0,0,0.999988241340406,270.275425085678,99.9996674343111
24.3,"random_policy_SVM","SVM",14,4,12833,12576,257,500,222,278,0.941173256586307,0.881889763779528,5.12603230611867,125,59,66,24,1.1,3.75,0.8,0,0,0,0,0,0,0.99999467739596,207.668773588682,99.9998120527669
24.3,"random_policy_SVM","SVM",14,5,12733,12548,185,600,250,350,0.939953416473162,0.881889763779528,5.11710970854492,140,62,78,15,1.3,4.5,0.7,0,0,0,0,0,0,0.999981483972861,133.562927047117,99.9995729543475
24.3,"random_policy_SVM","SVM",14,6,12633,12500,133,700,298,402,0.94006760382147,0.881889763779528,5.06421968571758,146,66,80,6,1.2,5.25,0.7,0,0,0,0,0,0,0.00383617343385703,76.210147129514,76.0417893382183
24.3,"random_policy_SVM","SVM",14,7,12533,12446,87,800,352,448,0.939147965930433,0.881889763779528,5.05116757312552,150,67,83,4,1.2,6,0.8,0,0,0,0,0,0,0.00301191825999666,31.7676790158782,31.2223977324926
24.3,"random_policy_SVM","SVM",14,8,12433,12377,56,900,421,479,0.941254292769,0.881889763779528,5.05986149321696,147,67,80,-3,1.2,6.75,0.9,0,0,0,0,0,0,7.54419069298902e-06,0.0116859430046739,0.00744122943106779
24.3,"random_policy_SVM","SVM",14,9,12333,12277,56,1000,521,479,0.944489600970479,0.881889763779528,5.06421968571758,145,66,79,-2,1.2,7.5,1.1,0,0,0,0,0,0,2.24847685609822e-06,0.0013393907665407,0.000317417905182784
24.3,"random_policy_SVM","SVM",14,10,12233,12177,56,1100,621,479,0.945854323955663,0.881889763779528,5.09052732044858,145,67,78,0,1.2,8.25,1.3,0,0,0,0,0,0,1.42732013716118e-06,0.00086491997497808,0.000185945193111839
24.3,"random_policy_SVM","SVM",14,11,12133,12077,56,1200,721,479,0.946960590631004,0.881889763779528,5.10378390201225,150,70,80,5,1.1,9,1.5,0,0,0,0,0,0,5.3733853330945e-07,0.000309853454313651,6.72244608310061e-05
24.3,"random_policy_SVM","SVM",14,12,12033,11977,56,1300,821,479,0.947165636729539,0.881889763779528,5.1265686515748,152,72,80,2,1.1,9.75,1.7,0,0,0,0,0,0,4.79378492116609e-07,0.000289503418142685,5.61810414584092e-05
24.3,"random_policy_SVM","SVM",14,13,11933,11877,56,1400,921,479,0.947422865218417,0.881889763779528,5.1221223647998,146,71,75,-6,1.1,10.5,1.9,0,0,0,0,0,0,0.000290908950924543,0.371372123665275,0.0319670178603752
24.3,"random_policy_SVM","SVM",14,14,11833,11777,56,1500,1021,479,0.948350483945633,0.881889763779528,5.1265686515748,147,71,76,1,1.1,11.25,2.1,0,0,0,0,0,0,0.00028189403559063,0.378049673439578,0.0304523237846886
24.3,"random_policy_SVM","SVM",14,15,11733,11677,56,1600,1121,479,0.949416846440115,0.881889763779528,5.1265686515748,146,71,75,-1,1.1,12,2.3,0,0,0,0,0,0,0.000217870363293974,0.282876557084017,0.0236083818519483
24.3,"random_policy_SVM","SVM",14,16,11633,11578,55,1700,1220,480,0.953739390092221,0.881889763779528,5.16729539905073,156,72,84,10,1.2,12.75,2.5,0,0,0,0,0,0,0.00037647570525487,0.544403451993847,0.048019613394811
24.3,"random_policy_SVM","SVM",14,17,11533,11485,48,1800,1313,487,0.974696451965786,0.885826771653543,5.5246744800772,180,81,99,24,1.2,13.5,2.7,0,0,0,0,0,0,0.00321598840479709,3.50227997422485,0.682662869870654
24.3,"random_policy_SVM","SVM",14,18,11433,11397,36,1900,1401,499,0.985940222309264,0.905511811023622,5.72132359122369,205,93,112,25,1.2,14.25,2.8,0,0,0,0,0,0,0.0057266974326497,7.21464493784864,1.27120651535074
24.3,"random_policy_SVM","SVM",14,19,11333,11308,25,2000,1490,510,0.98598319604248,0.925196850393701,5.67587618405599,238,106,132,33,1.2,15,2.9,0,0,0,0,0,0,0.00533774051850256,7.06735257926618,0.883902264124225
24.3,"random_policy_SVM","SVM",14,20,11233,11213,20,2100,1585,515,0.990939909214938,0.929133858267717,5.70207896176566,248,111,137,10,1.2,15.75,3.1,0,0,0,0,0,0,0.00525810230643014,7.42140570224228,0.697769808381825
24.3,"random_policy_SVM","SVM",14,21,11133,11117,16,2200,1681,519,0.99499478790007,0.933070866141732,5.778744334677,259,116,143,11,1.2,16.5,3.2,0,0,0,0,0,0,0.00801740629332688,12.318474444573,1.00131688460137
24.3,"random_policy_SVM","SVM",14,22,11033,11023,10,2300,1775,525,0.998133098246548,0.933070866141732,5.9104609929078,275,125,150,16,1.2,17.25,3.4,0,0,0,0,0,0,0.0112534609618346,13.6930094449976,1.51876671941215
24.3,"random_policy_SVM","SVM",14,23,10933,10927,6,2400,1871,529,0.999295230775087,0.937007874015748,5.93677649154052,288,128,160,13,1.2,18,3.5,0,0,0,0,0,0,0.00905190803583926,9.88209337638071,1.17591752329404
24.3,"random_policy_SVM","SVM",14,24,10833,10832,1,2500,1966,534,0.999577629593432,0.940944881889764,5.97937219730942,306,134,172,18,1.3,18.75,3.7,0,0,0,0,0,0,0.00958280094757507,12.0914073849328,1.26839111061268
24.3,"random_policy_SVM","SVM",14,25,10733,10733,0,2600,2065,535,0.999606483385741,0.940944881889764,5.97401433691756,312,135,177,6,1.3,19.5,3.9,0,0,0,0,0,0,0.00636862238790119,7.74680887615767,0.714757269687484
24.3,"random_policy_SVM","SVM",14,26,10633,10633,0,2700,2165,535,0.999614464221911,0.940944881889764,5.97401433691756,313,135,178,1,1.3,20.25,4,0,0,0,0,0,0,0.00517635528153278,6.55261305764242,0.553813097464177
24.3,"random_policy_SVM","SVM",14,27,10533,10533,0,2800,2265,535,0.99962612852093,0.940944881889764,5.96332737030411,312,135,177,-1,1.3,21,4.2,0,0,0,0,0,0,0.00455789719529467,5.95818269056415,0.493497931345989
24.3,"random_policy_SVM","SVM",14,28,10433,10433,0,2900,2365,535,0.999634723267575,0.940944881889764,5.9579982126899,314,135,179,2,1.3,21.75,4.4,0,0,0,0,0,0,0.0042941031973543,6.20599632554095,0.458349795902859
24.3,"random_policy_SVM","SVM",14,29,10333,10333,0,3000,2465,535,0.999642090193271,0.94488188976378,5.9579982126899,317,136,181,3,1.3,22.5,4.6,0,0,0,0,0,0,0.00345020184637057,4.82610773017787,0.36339700481523
24.3,"random_policy_SVM","SVM",14,30,10233,10233,0,3100,2565,535,0.999645159745645,0.94488188976378,5.94206773618538,317,136,181,0,1.3,23.25,4.8,0,0,0,0,0,0,0.00258384824537151,3.73487165367411,0.276781510854755
24.3,"random_policy_SVM","SVM",14,31,10133,10133,0,3200,2665,535,0.999650071029442,0.94488188976378,5.93677649154052,319,138,181,2,1.3,24,5,0,0,0,0,0,0,0.00202286273226722,2.84194695631221,0.212914345067285
24.3,"random_policy_SVM","SVM",14,32,10033,10033,0,3300,2765,535,0.999654368402765,0.94488188976378,5.94206773618538,318,138,180,-1,1.3,24.75,5.2,0,0,0,0,0,0,0.0023054598778035,3.41966844573837,0.239746625682715
24.3,"random_policy_SVM","SVM",14,33,9933,9933,0,3400,2865,535,0.999664190970359,0.94488188976378,5.93149466192171,318,138,180,0,1.3,25.5,5.4,0,0,0,0,0,0,0.00165479205082366,2.34563833113291,0.172452113789166
24.3,"random_policy_SVM","SVM",14,34,9833,9833,0,3500,2965,535,0.999670330075106,0.94488188976378,5.94206773618538,318,138,180,0,1.3,26.25,5.5,0,0,0,0,0,0,0.0017385402935259,2.62807139167685,0.183254017962228
24.3,"random_policy_SVM","SVM",14,35,9733,9733,0,3600,3065,535,0.999677697000802,0.94488188976378,5.93677649154052,319,138,181,1,1.3,27,5.7,0,0,0,0,0,0,0.00145256032515333,2.18506909505704,0.151824736707915
24.3,"random_policy_SVM","SVM",14,36,9633,9633,0,3700,3165,535,0.999679538732226,0.94488188976378,5.84312007011393,320,138,182,1,1.3,27.75,5.9,0,0,0,0,0,0,0.00103853145461938,1.46123592268871,0.108565843582883
24.3,"random_policy_SVM","SVM",14,37,9533,9533,0,3800,3265,535,0.999683222195074,0.94488188976378,5.9104609929078,320,138,182,0,1.3,28.5,6.1,0,0,0,0,0,0,0.00103671686085597,1.5330499905509,0.10852450495925
24.3,"random_policy_SVM","SVM",14,38,9433,9433,0,3900,3365,535,0.999688133478871,0.94488188976378,5.93149466192171,319,138,181,-1,1.3,29.25,6.3,0,0,0,0,0,0,0.00119643279600092,1.88481917078254,0.123634554436972
24.3,"random_policy_SVM","SVM",14,39,9333,9333,0,4000,3465,535,0.999691203031244,0.94488188976378,5.87918871252205,318,138,180,-1,1.3,30,6.5,0,0,0,0,0,0,0.00081329887621483,1.1995096066483,0.0846281760871678
24.3,"random_policy_SVM","SVM",14,40,9233,9233,0,4100,3565,535,0.999693044762668,0.948818897637795,5.9104609929078,319,138,181,1,1.3,30.75,6.7,0,0,0,0,0,0,0.000821505313444419,1.25432072561907,0.0853794768299213
24.3,"random_policy_SVM","SVM",14,41,9133,9133,0,4200,3665,535,0.999697956046466,0.948818897637795,5.92622222222222,319,138,181,0,1.3,31.5,6.9,0,0,0,0,0,0,0.000768807490978538,1.1969054099333,0.0797099801543341
24.3,"random_policy_SVM","SVM",14,42,9033,9033,0,4300,3765,535,0.999697342135991,0.948818897637795,5.92622222222222,319,138,181,0,1.3,32.25,7,0,0,0,0,0,0,0.000697912708103721,1.10185788196416,0.0728955362409847
24.3,"random_policy_SVM","SVM",14,43,8933,8933,0,4400,3865,535,0.99969856995694,0.948818897637795,5.9104609929078,319,138,181,0,1.3,33,7.2,0,0,0,0,0,0,0.000603914789657671,0.932187010620829,0.0623718387582584
24.3,"random_policy_SVM","SVM",14,44,8833,8833,0,4500,3965,535,0.999694886494092,0.948818897637795,5.93149466192171,318,138,180,-1,1.3,33.75,7.4,0,0,0,0,0,0,0.000745795776942969,1.20427355434039,0.0769840370004541
24.3,"random_policy_SVM","SVM",14,45,8733,8733,0,4600,4065,535,0.999696728225516,0.948818897637795,5.92622222222222,319,139,180,1,1.3,34.5,7.6,0,0,0,0,0,0,0.000578965786525395,0.911649239024039,0.0599651455929295
24.3,"random_policy_SVM","SVM",14,46,8633,8633,0,4700,4165,535,0.99969979777789,0.948818897637795,5.88957597173145,318,139,179,-1,1.3,35.25,7.8,0,0,0,0,0,0,0.000459473107630037,0.715119190131057,0.0479662169826226
24.3,"random_policy_SVM","SVM",14,47,8533,8533,0,4800,4265,535,0.999697956046466,0.948818897637795,5.9,316,139,177,-2,1.3,36,8,0,0,0,0,0,0,0.000426003117454543,0.679565605649017,0.0443939429267351
24.3,"random_policy_SVM","SVM",14,48,8433,8433,0,4900,4365,535,0.999700411688364,0.948818897637795,5.92622222222222,317,140,177,1,1.3,36.75,8.2,0,0,0,0,0,0,0.000512000829009722,0.867209024787208,0.0531583760007075
24.3,"random_policy_SVM","SVM",15,0,13233,12707,526,100,95,5,0.960141443536872,0.779069767441861,5.42055314913719,25,5,20,0,4,0.75,19,0,0,0,0,0,0,0.995422038605488,673.53723576772,99.8947867982168
24.3,"random_policy_SVM","SVM",15,1,13133,12687,446,200,115,85,0.986642451687961,0.87984496124031,5.79678399329562,63,26,37,38,1.4,1.5,1.4,0,0,0,0,0,0,0.99718535939879,497.202371947535,99.9620041147793
24.3,"random_policy_SVM","SVM",15,2,13033,12654,379,300,148,152,0.973028481024115,0.887596899224806,5.57984496124031,94,43,51,31,1.2,2.25,1,0,0,0,0,0,0,0.999996108021487,411.97511726266,99.9998496253614
24.3,"random_policy_SVM","SVM",15,3,12933,12606,327,400,196,204,0.954160875996806,0.891472868217054,5.24862146824519,111,49,62,17,1.3,3,1,0,0,0,0,0,0,0.999997342568391,304.297264187185,99.9999090805004
24.3,"random_policy_SVM","SVM",15,4,12833,12562,271,500,240,260,0.96318524942517,0.891472868217054,5.43782342579456,123,53,70,12,1.3,3.75,0.9,0,0,0,0,0,0,0.999996637060626,225.120549432894,99.9998930887207
24.3,"random_policy_SVM","SVM",15,5,12733,12527,206,600,275,325,0.953961301996581,0.891472868217054,5.30422276621787,129,54,75,6,1.4,4.5,0.8,0,0,0,0,0,0,0.999992413347246,152.55046165755,99.9998084910884
24.3,"random_policy_SVM","SVM",15,6,12633,12492,141,700,310,390,0.95493256213101,0.891472868217054,5.26725954136618,136,59,77,7,1.3,5.25,0.8,0,0,0,0,0,0,0.00475079509575644,87.6309879796808,83.0188119332998
24.3,"random_policy_SVM","SVM",15,7,12533,12442,91,800,360,440,0.955245228064699,0.891472868217054,5.24474988520649,150,64,86,14,1.3,6,0.8,0,0,0,0,0,0,0.00211004181101238,36.234783509046,33.1322530961494
24.3,"random_policy_SVM","SVM",15,8,12433,12366,67,900,436,464,0.958007816043583,0.891472868217054,5.28106022138722,149,68,81,-1,1.2,6.75,0.9,0,0,0,0,0,0,0.00122477159967579,10.3500741690269,9.14478767585563
24.3,"random_policy_SVM","SVM",15,9,12333,12272,61,1000,530,470,0.959117568438775,0.891472868217054,5.33156719820868,150,69,81,1,1.2,7.5,1.1,0,0,0,0,0,0,0.000938166685783595,4.1474425444096,3.1081519392151
24.3,"random_policy_SVM","SVM",15,10,12233,12174,59,1100,628,472,0.96021583020971,0.891472868217054,5.31756132991216,148,69,79,-2,1.1,8.25,1.3,0,0,0,0,0,0,0.000620950458659156,1.79096440782465,1.07107581709579
24.3,"random_policy_SVM","SVM",15,11,12133,12074,59,1200,728,472,0.96199264358141,0.891472868217054,5.30826489402071,148,68,80,0,1.2,9,1.5,0,0,0,0,0,0,0.000358685964801126,1.42790788672806,1.04005779747961
24.3,"random_policy_SVM","SVM",15,12,12033,11975,58,1300,827,473,0.962535726769902,0.891472868217054,5.33551716888102,150,69,81,2,1.2,9.75,1.7,0,0,0,0,0,0,0.000312398352345556,0.402262758695539,0.0340340702623565
24.3,"random_policy_SVM","SVM",15,13,11933,11875,58,1400,927,473,0.963826910074389,0.891472868217054,5.3215498464494,147,69,78,-3,1.1,10.5,2,0,0,0,0,0,0,0.000232708884548979,0.301412492513044,0.0254928353674499
24.3,"random_policy_SVM","SVM",15,14,11833,11775,58,1500,1027,473,0.96498564881509,0.891472868217054,5.3215498464494,147,71,76,0,1.1,11.25,2.2,0,0,0,0,0,0,0.000230072275119788,0.298568987499533,0.0250181239996645
24.3,"random_policy_SVM","SVM",15,15,11733,11677,56,1600,1125,475,0.973023642866547,0.891472868217054,5.39390338851088,156,73,83,9,1.1,12,2.4,0,0,0,0,0,0,0.00062922234575797,0.961106557975965,0.0939076285539918
24.3,"random_policy_SVM","SVM",15,16,11633,11585,48,1700,1217,483,0.981991167943318,0.903100775193798,5.58112991812483,176,79,97,20,1.2,12.75,2.5,0,0,0,0,0,0,0.00187385568743373,3.08317859416985,0.434825167658044
24.3,"random_policy_SVM","SVM",15,17,11533,11500,33,1800,1302,498,0.982786440095724,0.930232558139535,5.59399479580675,204,92,112,28,1.2,13.5,2.6,0,0,0,0,0,0,0.0037679523800089,3.85301756504515,1.45245531134196
24.3,"random_policy_SVM","SVM",15,18,11433,11403,30,1900,1399,501,0.981711764342993,0.930232558139535,5.57445245590874,214,96,118,10,1.2,14.25,2.8,0,0,0,0,0,0,0.00198878917201984,2.00030202536517,0.265442660244608
24.3,"random_policy_SVM","SVM",15,19,11333,11303,30,2000,1499,501,0.981459575379071,0.930232558139535,5.57445245590874,218,100,118,4,1.2,15,3,0,0,0,0,0,0,0.00144370043396,1.76122021793231,0.17120672688687
24.3,"random_policy_SVM","SVM",15,20,11233,11205,28,2100,1597,503,0.984890433873861,0.930232558139535,5.64709031278799,225,102,123,7,1.2,15.75,3.2,0,0,0,0,0,0,0.00131426312264477,2.14692640357647,0.173874499421401
24.3,"random_policy_SVM","SVM",15,21,11133,11109,24,2200,1693,507,0.990263207867796,0.930232558139535,5.72978127482401,242,106,136,17,1.3,16.5,3.3,0,0,0,0,0,0,0.00478667271661478,7.37497658890999,0.601213714357567
24.3,"random_policy_SVM","SVM",15,22,11033,11013,20,2300,1789,511,0.994297021751139,0.934108527131783,5.80621187712559,248,112,136,6,1.2,17.25,3.5,0,0,0,0,0,0,0.00824993275931531,11.0977490726407,1.03916799924034
24.3,"random_policy_SVM","SVM",15,23,10933,10919,14,2400,1883,517,0.997926244706754,0.934108527131783,5.94736842105263,264,118,146,16,1.2,18,3.6,0,0,0,0,0,0,0.00936230503838148,11.3260937400506,1.41536006033645
24.3,"random_policy_SVM","SVM",15,24,10833,10827,6,2500,1975,525,0.99936136319928,0.934108527131783,5.99011680143756,279,126,153,15,1.2,18.75,3.8,0,0,0,0,0,0,0.0100109830710564,11.71546111758,1.40894816434263
24.3,"random_policy_SVM","SVM",15,25,10733,10732,1,2600,2070,530,0.999545817957064,0.937984496124031,6.00630630630631,300,131,169,21,1.3,19.5,3.9,0,0,0,0,0,0,0.00920812617687505,11.108237292324,1.31698793665601
24.3,"random_policy_SVM","SVM",15,26,10633,10633,0,2700,2169,531,0.999567589666179,0.937984496124031,6.00630630630631,304,134,170,4,1.3,20.25,4.1,0,0,0,0,0,0,0.00757448109517329,9.88786980468643,0.848649409264223
24.3,"random_policy_SVM","SVM",15,27,10533,10533,0,2800,2269,531,0.999570613514668,0.937984496124031,6.00630630630631,304,132,172,0,1.3,21,4.3,0,0,0,0,0,0,0.00615309476989984,8.357200862854,0.661916021843901
24.3,"random_policy_SVM","SVM",15,28,10433,10433,0,2900,2369,531,0.999578475520737,0.937984496124031,5.99011680143756,307,134,173,3,1.3,21.75,4.5,0,0,0,0,0,0,0.00438755903863613,5.74487348072815,0.473636524515957
24.3,"random_policy_SVM","SVM",15,29,10333,10333,0,3000,2469,531,0.999579685060132,0.937984496124031,5.94736842105263,308,133,175,1,1.3,22.5,4.6,0,0,0,0,0,0,0.00376883482705336,4.96453262703365,0.402470237684887
24.3,"random_policy_SVM","SVM",15,30,10233,10233,0,3100,2569,531,0.999588756605597,0.937984496124031,5.94206773618538,310,133,177,2,1.3,23.25,4.8,0,0,0,0,0,0,0.00294326545521224,4.07715669302559,0.317174359504795
24.3,"random_policy_SVM","SVM",15,31,10133,10133,0,3200,2669,531,0.999593594763178,0.937984496124031,5.94736842105263,308,134,174,-2,1.3,24,5,0,0,0,0,0,0,0.00255410186333929,3.57675583513353,0.27034867378462
24.3,"random_policy_SVM","SVM",15,32,10033,10033,0,3300,2769,531,0.999602061538945,0.937984496124031,5.94736842105263,306,133,173,-2,1.3,24.75,5.2,0,0,0,0,0,0,0.00225865277545562,3.25227296225126,0.237892618504056
24.3,"random_policy_SVM","SVM",15,33,9933,9933,0,3400,2869,531,0.999603875848038,0.937984496124031,5.9,306,132,174,0,1.3,25.5,5.4,0,0,0,0,0,0,0.00180005800051749,2.54940355710089,0.18921935229954
24.3,"random_policy_SVM","SVM",15,34,9833,9833,0,3500,2969,531,0.999613552163201,0.937984496124031,5.93149466192171,310,133,177,4,1.3,26.25,5.6,0,0,0,0,0,0,0.00181080923849208,2.69198929829675,0.189764131117521
24.3,"random_policy_SVM","SVM",15,35,9733,9733,0,3600,3069,531,0.999615971241991,0.937984496124031,5.92622222222222,308,133,175,-2,1.3,27,5.8,0,0,0,0,0,0,0.00142444178861261,2.13909654510318,0.149303066721055
24.3,"random_policy_SVM","SVM",15,36,9633,9633,0,3700,3169,531,0.999619599860177,0.937984496124031,5.832895888014,308,133,175,0,1.3,27.75,6,0,0,0,0,0,0,0.00111828321238648,1.63218217652699,0.116930016415908
24.3,"random_policy_SVM","SVM",15,37,9533,9533,0,3800,3269,531,0.999622018938968,0.941860465116279,5.9579982126899,305,132,173,-3,1.3,28.5,6.2,0,0,0,0,0,0,0.00140891146884411,2.3224518073211,0.147667847302478
24.3,"random_policy_SVM","SVM",15,38,9433,9433,0,3900,3369,531,0.999625647557154,0.941860465116279,5.96332737030411,307,133,174,2,1.3,29.25,6.3,0,0,0,0,0,0,0.00145064976884779,2.39697502891121,0.150241916536697
24.3,"random_policy_SVM","SVM",15,39,9333,9333,0,4000,3469,531,0.999626252326851,0.941860465116279,5.93149466192171,306,132,174,-1,1.3,30,6.5,0,0,0,0,0,0,0.00105641069882056,1.61681193159774,0.10908220440744
24.3,"random_policy_SVM","SVM",15,40,9233,9233,0,4100,3569,531,0.999628671405642,0.941860465116279,5.8585237258348,307,132,175,1,1.3,30.75,6.7,0,0,0,0,0,0,0.000776564054924782,1.14004865168323,0.0809317283775524
24.3,"random_policy_SVM","SVM",15,41,9133,9133,0,4200,3669,531,0.999630485714735,0.941860465116279,5.96332737030411,309,132,177,2,1.3,31.5,6.9,0,0,0,0,0,0,0.00114763656234316,1.88724508538046,0.118876551795401
24.3,"random_policy_SVM","SVM",15,42,9033,9033,0,4300,3769,531,0.999632904793526,0.941860465116279,5.83800350262697,309,132,177,0,1.3,32.25,7.1,0,0,0,0,0,0,0.000642310469702481,0.929991295744736,0.0668603357639199
24.3,"random_policy_SVM","SVM",15,43,8933,8933,0,4400,3869,531,0.999631090484433,0.941860465116279,5.894783377542,309,133,176,0,1.3,33,7.3,0,0,0,0,0,0,0.000666013527359016,0.974536616728423,0.0686488856931425
24.3,"random_policy_SVM","SVM",15,44,8833,8833,0,4500,3969,531,0.999634719102619,0.941860465116279,5.94206773618538,309,133,176,0,1.3,33.75,7.5,0,0,0,0,0,0,0.000733952359992913,1.12665427441634,0.0759298590087464
24.3,"random_policy_SVM","SVM",15,45,8733,8733,0,4600,4069,531,0.999635928642014,0.945736434108527,5.94206773618538,309,132,177,0,1.3,34.5,7.7,0,0,0,0,0,0,0.000609056207513285,0.92022949760565,0.0629169941998469
24.3,"random_policy_SVM","SVM",15,46,8633,8633,0,4700,4169,531,0.999635323872316,0.945736434108527,5.94206773618538,308,132,176,-1,1.3,35.25,7.9,0,0,0,0,0,0,0.000580002876359491,0.886248172593276,0.0600653567263407
24.3,"random_policy_SVM","SVM",15,47,8533,8533,0,4800,4269,531,0.999634719102619,0.945736434108527,5.93149466192171,308,132,176,0,1.3,36,8,0,0,0,0,0,0,0.000495330439348407,0.739011600284487,0.0512965687155249
24.3,"random_policy_SVM","SVM",15,48,8433,8433,0,4900,4369,531,0.999637138181409,0.945736434108527,5.93149466192171,310,133,177,2,1.3,36.75,8.2,0,0,0,0,0,0,0.000483511585603849,0.726636243188389,0.0503479846120794
24.3,"random_policy_SVM","SVM",16,0,13233,12719,514,100,94,6,0.956111982020414,0.828996282527881,5.16789990278374,29,6,23,0,3.8,0.75,15.7,0,0,0,0,0,0,0.927323304247768,791.535966640891,95.53578732042
24.3,"random_policy_SVM","SVM",16,1,13133,12683,450,200,130,70,0.956729042881688,0.87360594795539,5.1175951888552,53,22,31,24,1.4,1.5,1.9,0,0,0,0,0,0,0.975763829651485,526.710904489058,98.3623953506812
24.3,"random_policy_SVM","SVM",16,2,13033,12656,377,300,157,143,0.966649080625831,0.884758364312268,5.44047511107081,95,43,52,42,1.2,2.25,1.1,0,0,0,0,0,0,0.996399420251507,364.727455877154,99.8708476657891
24.3,"random_policy_SVM","SVM",16,3,12933,12621,312,400,192,208,0.940427480241867,0.884758364312268,5.28587360594796,113,51,62,18,1.2,3,0.9,0,0,0,0,0,0,0.999994142352052,281.240195584573,99.9998019764286
24.3,"random_policy_SVM","SVM",16,4,12833,12578,255,500,235,265,0.944269294191626,0.884758364312268,5.22007434944238,130,56,74,17,1.3,3.75,0.9,0,0,0,0,0,0,0.999994306762875,210.286943306515,99.9998542640661
24.3,"random_policy_SVM","SVM",16,5,12733,12540,193,600,273,327,0.944606295415273,0.884758364312268,5.26258781913761,145,60,85,15,1.4,4.5,0.8,0,0,0,0,0,0,0.999986701189071,143.451764210615,99.9996794332638
24.3,"random_policy_SVM","SVM",16,6,12633,12496,137,700,317,383,0.944048500286456,0.884758364312268,5.1598156807378,154,66,88,9,1.3,5.25,0.8,0,0,0,0,0,0,0.00446630410532994,85.7309177511001,81.9186340769738
24.3,"random_policy_SVM","SVM",16,7,12533,12441,92,800,372,428,0.944896813711535,0.884758364312268,5.11967882583145,151,68,83,-3,1.2,6,0.9,0,0,0,0,0,0,0.00204303338153173,39.2293924640405,37.1242795685803
24.3,"random_policy_SVM","SVM",16,8,12433,12367,66,900,446,454,0.945236720118154,0.884758364312268,5.11525768694904,152,68,84,1,1.2,6.75,1,0,0,0,0,0,0,0.00144845683616197,12.8859668264647,11.1528858285942
24.3,"random_policy_SVM","SVM",16,9,12333,12274,59,1000,539,461,0.94670790477043,0.884758364312268,5.08889037928435,149,70,79,-3,1.1,7.5,1.2,0,0,0,0,0,0,0.000893635863164583,5.07775288284896,4.10046604959022
24.3,"random_policy_SVM","SVM",16,10,12233,12178,55,1100,635,465,0.947514964597445,0.884758364312268,5.13222846255745,150,70,80,1,1.1,8.25,1.4,0,0,0,0,0,0,0.000784242954958416,0.988066282030543,0.0879114285628153
24.3,"random_policy_SVM","SVM",16,11,12133,12079,54,1200,734,466,0.95201799818951,0.884758364312268,5.17053582873991,157,72,85,7,1.2,9,1.6,0,0,0,0,0,0,0.00120440062466697,1.62934318579055,0.162785831292425
24.3,"random_policy_SVM","SVM",16,12,12033,11981,52,1300,832,468,0.953463617231705,0.888475836431227,5.18742975706752,159,73,86,2,1.2,9.75,1.8,0,0,0,0,0,0,0.000981030622026693,1.28965609909978,0.127218196182943
24.3,"random_policy_SVM","SVM",16,13,11933,11889,44,1400,924,476,0.95984049383462,0.903345724907063,5.2987309319318,182,82,100,23,1.2,10.5,1.9,0,0,0,0,0,0,0.00190540790284207,2.60401884460881,0.468948696732133
24.3,"random_policy_SVM","SVM",16,14,11833,11802,31,1500,1011,489,0.957850443505228,0.925650557620818,5.34607131516402,214,96,118,32,1.2,11.25,2.1,0,0,0,0,0,0,0.00519203180331545,4.49407212059643,0.970749337621051
24.3,"random_policy_SVM","SVM",16,15,11733,11704,29,1600,1109,491,0.958594170343651,0.925650557620818,5.35820933754711,221,98,123,7,1.3,12,2.3,0,0,0,0,0,0,0.00263265149443646,2.67807349047345,0.333739496036926
24.3,"random_policy_SVM","SVM",16,16,11633,11605,28,1700,1208,492,0.960238503900503,0.925650557620818,5.37673382963889,221,99,122,0,1.2,12.75,2.5,0,0,0,0,0,0,0.00170798171596703,1.82875299591439,0.197962325297425
24.3,"random_policy_SVM","SVM",16,17,11533,11505,28,1800,1308,492,0.959865478408105,0.925650557620818,5.4000703479967,219,99,120,-2,1.2,13.5,2.7,0,0,0,0,0,0,0.00133100188372496,1.52840731319263,0.147950976146346
24.3,"random_policy_SVM","SVM",16,18,11433,11405,28,1900,1408,492,0.959577865294808,0.925650557620818,5.4000703479967,217,97,120,-2,1.2,14.25,2.9,0,0,0,0,0,0,0.000965082380210912,1.29450666634452,0.108036295570327
24.3,"random_policy_SVM","SVM",16,19,11333,11305,28,2000,1508,492,0.959915447555061,0.925650557620818,5.40476198166133,218,97,121,1,1.2,15,3.1,0,0,0,0,0,0,0.000851207797565891,1.22329965635373,0.0924823697468887
24.3,"random_policy_SVM","SVM",16,20,11233,11206,27,2100,1607,493,0.962419134232241,0.925650557620818,5.40476198166133,221,99,122,3,1.2,15.75,3.3,0,0,0,0,0,0,0.00134193078169325,2.34220149702386,0.149648829936231
24.3,"random_policy_SVM","SVM",16,21,11133,11109,24,2200,1704,496,0.973096843693063,0.925650557620818,5.46427421479378,229,101,128,8,1.3,16.5,3.4,0,0,0,0,0,0,0.00158736265953488,2.80007080907802,0.204638211574134
24.3,"random_policy_SVM","SVM",16,22,11033,11013,20,2300,1800,500,0.982679299176921,0.925650557620818,5.65373275615552,241,106,135,12,1.3,17.25,3.6,0,0,0,0,0,0,0.0039070902514654,6.86902893558021,0.501532908189122
24.3,"random_policy_SVM","SVM",16,23,10933,10918,15,2400,1895,505,0.990161888415406,0.929368029739777,5.75155827606758,261,113,148,20,1.3,18,3.8,0,0,0,0,0,0,0.00863645384433322,12.1107271027061,1.02077060410183
24.3,"random_policy_SVM","SVM",16,24,10833,10820,13,2500,1993,507,0.992198421672189,0.929368029739777,5.81090414468428,262,118,144,1,1.2,18.75,3.9,0,0,0,0,0,0,0.00817033294182403,12.5972836202739,0.96541529828023
24.3,"random_policy_SVM","SVM",16,25,10733,10722,11,2600,2091,509,0.994847367497513,0.929368029739777,5.86416290493893,271,120,151,9,1.3,19.5,4.1,0,0,0,0,0,0,0.00825166339653869,12.0972492325873,1.00185885117305
24.3,"random_policy_SVM","SVM",16,26,10633,10628,5,2700,2185,515,0.998606093214539,0.936802973977695,5.97859191123573,294,125,169,23,1.4,20.25,4.2,0,0,0,0,0,0,0.012575434701074,15.4860184008354,1.80066994396843
24.3,"random_policy_SVM","SVM",16,27,10533,10530,3,2800,2283,517,0.998953553096868,0.944237918215613,6.000900090009,303,128,175,9,1.4,21,4.4,0,0,0,0,0,0,0.00990193171708898,13.0604591475852,1.16413188560527
24.3,"random_policy_SVM","SVM",16,28,10433,10433,0,2900,2380,520,0.999441042797993,0.944237918215613,6.00630630630631,315,132,183,12,1.4,21.75,4.6,0,0,0,0,0,0,0.0091601726530979,12.7545067444534,1.36020730600669
24.3,"random_policy_SVM","SVM",16,29,10333,10333,0,3000,2480,520,0.999448596273696,0.947955390334573,6.00630630630631,316,132,184,1,1.4,22.5,4.8,0,0,0,0,0,0,0.00826897454725332,12.2305957860477,0.894063776582376
24.3,"random_policy_SVM","SVM",16,30,10233,10233,0,3100,2580,520,0.999458473895769,0.947955390334573,6.00630630630631,316,132,184,0,1.4,23.25,5,0,0,0,0,0,0,0.00570837126637645,7.87996181513255,0.607337020579381
24.3,"random_policy_SVM","SVM",16,31,10133,10133,0,3200,2680,520,0.999467770481249,0.947955390334573,6.00630630630631,319,133,186,3,1.4,24,5.2,0,0,0,0,0,0,0.00464311423350287,6.38875665557101,0.490086228315763
24.3,"random_policy_SVM","SVM",16,32,10033,10033,0,3300,2780,520,0.999481134322877,0.947955390334573,6.00630630630631,320,133,187,1,1.4,24.75,5.3,0,0,0,0,0,0,0.0040123663400216,5.67384057911536,0.424709739554273
24.3,"random_policy_SVM","SVM",16,33,9933,9933,0,3400,2880,520,0.999486944688803,0.947955390334573,6.00630630630631,320,132,188,0,1.4,25.5,5.5,0,0,0,0,0,0,0.00353463834105961,4.89329547606221,0.37158299258519
24.3,"random_policy_SVM","SVM",16,34,9833,9833,0,3500,2980,520,0.999499727493838,0.947955390334573,6.00630630630631,320,132,188,0,1.4,26.25,5.7,0,0,0,0,0,0,0.00311733900452375,4.5313775523277,0.32956611860865
24.3,"random_policy_SVM","SVM",16,35,9733,9733,0,3600,3080,520,0.999504956823171,0.947955390334573,6.00630630630631,320,132,188,0,1.4,27,5.9,0,0,0,0,0,0,0.00309671812127566,4.66915332679761,0.322531429251401
24.3,"random_policy_SVM","SVM",16,36,9633,9633,0,3700,3180,520,0.999509024079318,0.947955390334573,6.00630630630631,320,132,188,0,1.4,27.75,6.1,0,0,0,0,0,0,0.00275780034750772,4.33235684554899,0.291055260518116
24.3,"random_policy_SVM","SVM",16,37,9533,9533,0,3800,3280,520,0.999523549994132,0.947955390334573,6.00630630630631,319,132,187,-1,1.4,28.5,6.3,0,0,0,0,0,0,0.00194836389568327,2.95404691551948,0.205113598247856
24.3,"random_policy_SVM","SVM",16,38,9433,9433,0,3900,3380,520,0.999527617250279,0.947955390334573,6.00630630630631,320,132,188,1,1.4,29.25,6.5,0,0,0,0,0,0,0.00189092140923841,2.99273734117406,0.198263587920536
24.3,"random_policy_SVM","SVM",16,39,9333,9333,0,4000,3480,520,0.999534008652797,0.947955390334573,6.00630630630631,318,132,186,-2,1.4,30,6.7,0,0,0,0,0,0,0.00178806861132249,2.90418636499982,0.187371202250493
24.3,"random_policy_SVM","SVM",16,40,9233,9233,0,4100,3580,520,0.999540400055315,0.947955390334573,6.00630630630631,317,132,185,-1,1.4,30.75,6.9,0,0,0,0,0,0,0.00161595388913085,2.64701327602244,0.168728973492851
24.3,"random_policy_SVM","SVM",16,41,9133,9133,0,4200,3680,520,0.999542143165092,0.947955390334573,6.00630630630631,319,132,187,2,1.4,31.5,7.1,0,0,0,0,0,0,0.00175212394616663,3.00627906319049,0.181888462576524
24.3,"random_policy_SVM","SVM",16,42,9033,9033,0,4300,3780,520,0.999549115604202,0.947955390334573,6.00630630630631,318,132,186,-1,1.4,32.25,7.3,0,0,0,0,0,0,0.00105544416622759,1.66371948982124,0.109216269341083
24.3,"random_policy_SVM","SVM",16,43,8933,8933,0,4400,3880,520,0.999550277677388,0.947955390334573,6.00630630630631,318,132,186,0,1.4,33,7.5,0,0,0,0,0,0,0.00126719089019068,2.15534019867365,0.130988951015421
24.3,"random_policy_SVM","SVM",16,44,8833,8833,0,4500,3980,520,0.99955318286035,0.947955390334573,6.00630630630631,318,131,187,0,1.4,33.75,7.7,0,0,0,0,0,0,0.00108598324436741,1.76123875872773,0.111481964089226
24.3,"random_policy_SVM","SVM",16,45,8733,8733,0,4600,4080,520,0.999553763896943,0.947955390334573,6.000900090009,316,131,185,-2,1.4,34.5,7.8,0,0,0,0,0,0,0.000900266322990013,1.41940523041752,0.0927226792531857
24.3,"random_policy_SVM","SVM",16,46,8633,8633,0,4700,4180,520,0.999552020787165,0.947955390334573,6.000900090009,315,132,183,-1,1.4,35.25,8,0,0,0,0,0,0,0.000870936178742284,1.35659514794006,0.0898891574947163
24.3,"random_policy_SVM","SVM",16,47,8533,8533,0,4800,4280,520,0.999552601823758,0.947955390334573,6.00630630630631,316,132,184,1,1.4,36,8.2,0,0,0,0,0,0,0.000768794496088138,1.18035495595974,0.0792194583823684
24.3,"random_policy_SVM","SVM",16,48,8433,8433,0,4900,4380,520,0.999551439750573,0.947955390334573,6.00630630630631,317,132,185,1,1.4,36.75,8.4,0,0,0,0,0,0,0.00102737453489748,1.69486463870377,0.106422209778595
24.3,"random_policy_SVM","SVM",17,0,13233,12724,509,100,95,5,0.970946637842786,0.807272727272727,5.47299021965689,31,5,26,0,5.2,0.75,19,0,0,0,0,0,0,0.987204928580586,705.8985382956,99.3321637906916
24.3,"random_policy_SVM","SVM",17,1,13133,12686,447,200,133,67,0.981277164637633,0.890909090909091,5.62606973186247,70,26,44,39,1.7,1.5,2,0,0,0,0,0,0,0.990876509056099,609.600227514889,99.4034912108032
24.3,"random_policy_SVM","SVM",17,2,13033,12654,379,300,165,135,0.975100694049356,0.887272727272727,5.71219925280199,98,42,56,28,1.3,2.25,1.2,0,0,0,0,0,0,0.993117822673609,492.345563480141,99.6384580846676
24.3,"random_policy_SVM","SVM",17,3,12933,12611,322,400,208,192,0.975934691091128,0.894545454545455,5.62329832622251,114,49,65,16,1.3,3,1.1,0,0,0,0,0,0,0.994576011621694,400.0997094852,99.6817770462862
24.3,"random_policy_SVM","SVM",17,4,12833,12564,269,500,255,245,0.968610763454309,0.890909090909091,5.52276559315124,131,55,76,17,1.4,3.75,1,0,0,0,0,0,0,0.994340449718827,277.839519706551,99.7139988521673
24.3,"random_policy_SVM","SVM",17,5,12733,12531,202,600,288,312,0.970070542723858,0.901818181818182,5.50794600748089,149,63,86,18,1.4,4.5,0.9,0,0,0,0,0,0,0.992811383926962,193.17317486255,99.6057753274626
24.3,"random_policy_SVM","SVM",17,6,12633,12489,144,700,330,370,0.977822277847293,0.912727272727273,5.6851654006371,177,70,107,28,1.5,5.25,0.9,0,0,0,0,0,0,0.0720747629915759,143.785640806031,98.7703288257215
24.3,"random_policy_SVM","SVM",17,7,12533,12441,92,800,378,422,0.978940721356221,0.927272727272727,5.75051212938005,182,74,108,5,1.5,6,0.9,0,0,0,0,0,0,0.0330797631549904,103.949117106825,52.1380342605853
24.3,"random_policy_SVM","SVM",17,8,12433,12382,51,900,437,463,0.97834964159747,0.945454545454545,5.75568345323741,215,88,127,33,1.4,6.75,0.9,0,0,0,0,0,0,0.0283834804401875,64.0798986621745,21.8699004870518
24.3,"random_policy_SVM","SVM",17,9,12333,12299,34,1000,520,480,0.976624758220523,0.949090909090909,5.70438502673797,228,93,135,13,1.5,7.5,1.1,0,0,0,0,0,0,0.0179320981687789,27.1456185154413,9.30686666450332
24.3,"random_policy_SVM","SVM",17,10,12233,12205,28,1100,614,486,0.977756286266949,0.949090909090909,5.70947368421053,232,96,136,4,1.4,8.25,1.3,0,0,0,0,0,0,0.01288202505728,17.7076118847548,2.44120081002025
24.3,"random_policy_SVM","SVM",17,11,12133,12105,28,1200,714,486,0.977785299806602,0.949090909090909,5.70438502673797,226,93,133,-6,1.4,9,1.5,0,0,0,0,0,0,0.00826274636722567,9.75293710060613,1.91098879761521
24.3,"random_policy_SVM","SVM",17,12,12033,12006,27,1300,813,487,0.9777636818751,0.945454545454545,5.70438502673797,229,94,135,3,1.4,9.75,1.7,0,0,0,0,0,0,0.00800677156449135,10.5546478946363,0.874300753053777
24.3,"random_policy_SVM","SVM",17,13,11933,11906,27,1400,913,487,0.978011150301544,0.941818181818182,5.71967828418231,232,95,137,3,1.4,10.5,1.9,0,0,0,0,0,0,0.00484421491124997,3.85770442502008,0.523023130215008
24.3,"random_policy_SVM","SVM",17,14,11833,11806,27,1500,1013,487,0.97799465240645,0.941818181818182,5.76086408640864,229,94,135,-3,1.4,11.25,2.1,0,0,0,0,0,0,0.00464952464013693,4.20750623047915,0.492505193423625
24.3,"random_policy_SVM","SVM",17,15,11733,11706,27,1600,1113,487,0.978133462282433,0.941818181818182,5.76086408640864,231,95,136,2,1.4,12,2.3,0,0,0,0,0,0,0.00396133195401298,2.85649340419837,0.417210694148017
24.3,"random_policy_SVM","SVM",17,16,11633,11606,27,1700,1213,487,0.978230174081275,0.941818181818182,5.76086408640864,229,95,134,-2,1.4,12.75,2.5,0,0,0,0,0,0,0.00323993043841294,1.39582073113101,0.3416841392941
24.3,"random_policy_SVM","SVM",17,17,11533,11506,27,1800,1313,487,0.97832347252251,0.941818181818182,5.76605405405405,231,97,134,2,1.4,13.5,2.7,0,0,0,0,0,0,0.00285610741765301,0.84272090258881,0.298209349143266
24.3,"random_policy_SVM","SVM",17,18,11433,11406,27,1900,1413,487,0.978461144612622,0.941818181818182,5.75051212938005,229,97,132,-2,1.4,14.25,2.9,0,0,0,0,0,0,1.72782786021956e-05,0.121878081110903,0.104551869905603
24.3,"random_policy_SVM","SVM",17,19,11333,11306,27,2000,1513,487,0.97842416657188,0.941818181818182,5.75568345323741,231,97,134,2,1.4,15,3.1,0,0,0,0,0,0,0.00256478410028398,0.349522580610778,0.268088586268785
24.3,"random_policy_SVM","SVM",17,20,11233,11207,26,2100,1612,488,0.985840254864061,0.941818181818182,5.78789516789517,235,98,137,4,1.4,15.75,3.3,0,0,0,0,0,0,0.00288867442945473,0.960048377965976,0.387306927491448
24.3,"random_policy_SVM","SVM",17,21,11133,11112,21,2200,1707,493,0.99731937649333,0.941818181818182,6.0006832553174,256,102,154,21,1.5,16.5,3.5,0,0,0,0,0,0,0.00357469717148815,4.82346329734575,4.00259966030112
24.3,"random_policy_SVM","SVM",17,22,11033,11026,7,2300,1793,507,0.999648993059506,0.945454545454545,6.02258355916892,277,119,158,21,1.3,17.25,3.5,0,0,0,0,0,0,0.00568368864908897,5.40665876973099,1.81200827676651
24.3,"random_policy_SVM","SVM",17,23,10933,10933,0,2400,1886,514,0.999656957560587,0.949090909090909,6.0117222723174,301,128,173,24,1.4,18,3.7,0,0,0,0,0,0,0.0052293130209806,4.03055645211146,0.694928887582367
24.3,"random_policy_SVM","SVM",17,24,10833,10833,0,2500,1986,514,0.999668335419274,0.949090909090909,6.03348416289593,308,129,179,7,1.4,18.75,3.9,0,0,0,0,0,0,0.00401423771464593,2.47232898869828,0.446260605293666
24.3,"random_policy_SVM","SVM",17,25,10733,10733,0,2600,2086,514,0.999666059847537,0.945454545454545,6.03894927536232,308,130,178,0,1.4,19.5,4.1,0,0,0,0,0,0,0.00366948269031562,2.04419400631974,0.388853841026083
24.3,"random_policy_SVM","SVM",17,26,10633,10633,0,2700,2186,514,0.999668904312208,0.945454545454545,6.03894927536232,308,130,178,0,1.4,20.25,4.3,0,0,0,0,0,0,0.00280180876601133,0.645524011202052,0.298523731946681
24.3,"random_policy_SVM","SVM",17,27,10533,10533,0,2800,2286,514,0.99966776652634,0.945454545454545,6.03894927536232,309,130,179,1,1.4,21,4.4,0,0,0,0,0,0,0.00324971507145895,1.67189489088702,0.338356362791015
24.3,"random_policy_SVM","SVM",17,28,10433,10433,0,2900,2386,514,0.999664922061668,0.945454545454545,6.03894927536232,307,129,178,-2,1.4,21.75,4.6,0,0,0,0,0,0,0.00296902081505226,1.08477286564217,0.304491232479464
24.3,"random_policy_SVM","SVM",17,29,10333,10333,0,3000,2486,514,0.99966776652634,0.945454545454545,6.03894927536232,307,131,176,0,1.3,22.5,4.8,0,0,0,0,0,0,1.66900738888223e-05,0.0299621398393996,0.014426146965831
24.3,"random_policy_SVM","SVM",17,30,10233,10233,0,3100,2586,514,0.999670042098077,0.945454545454545,6.03894927536232,305,130,175,-2,1.3,23.25,5,0,0,0,0,0,0,1.86247555788011e-05,0.187101112580479,0.169208527594266
24.3,"random_policy_SVM","SVM",17,31,10133,10133,0,3200,2686,514,0.999668904312208,0.945454545454545,6.03894927536232,305,130,175,0,1.3,24,5.2,0,0,0,0,0,0,1.33338658871543e-05,0.0141540639609587,0.00141094286901736
24.3,"random_policy_SVM","SVM",17,32,10033,10033,0,3300,2786,514,0.999666628740471,0.945454545454545,6.03894927536232,305,130,175,0,1.3,24.75,5.4,0,0,0,0,0,0,1.25838386340896e-05,0.0137080488689667,0.00133857693244505
24.3,"random_policy_SVM","SVM",17,33,9933,9933,0,3400,2886,514,0.999668904312208,0.945454545454545,6.03894927536232,305,130,175,0,1.3,25.5,5.6,0,0,0,0,0,0,8.27276794072392e-06,0.00850456470699366,0.000876539145286237
24.3,"random_policy_SVM","SVM",17,34,9833,9833,0,3500,2986,514,0.999671179883946,0.945454545454545,6.03894927536232,305,130,175,0,1.3,26.25,5.8,0,0,0,0,0,0,7.37513432155698e-06,0.00767473651438689,0.000778597090832444
24.3,"random_policy_SVM","SVM",17,35,9733,9733,0,3600,3086,514,0.999669473205143,0.945454545454545,6.03894927536232,305,130,175,0,1.3,27,6,0,0,0,0,0,0,8.89392941113519e-06,0.00992772186665237,0.00094254841214354
24.3,"random_policy_SVM","SVM",17,36,9633,9633,0,3700,3186,514,0.999668904312208,0.945454545454545,6.03894927536232,306,130,176,1,1.4,27.75,6.2,0,0,0,0,0,0,6.91178781393773e-06,0.00763080096159008,0.000734299876571991
24.3,"random_policy_SVM","SVM",17,37,9533,9533,0,3800,3286,514,0.999665490954602,0.945454545454545,6.03894927536232,305,130,175,-1,1.3,28.5,6.4,0,0,0,0,0,0,6.80980331472269e-06,0.00773988501602042,0.000724242964146001
24.3,"random_policy_SVM","SVM",17,38,9433,9433,0,3900,3386,514,0.999664922061668,0.945454545454545,6.03894927536232,305,130,175,0,1.3,29.25,6.6,0,0,0,0,0,0,5.9386589764557e-06,0.00672111399636073,0.000632085458164687
24.3,"random_policy_SVM","SVM",17,39,9333,9333,0,4000,3486,514,0.999664353168734,0.945454545454545,6.03894927536232,305,130,175,0,1.3,30,6.8,0,0,0,0,0,0,3.74610052584325e-06,0.00411231208405661,0.000399968956007275
24.3,"random_policy_SVM","SVM",17,40,9233,9233,0,4100,3586,514,0.999661508704062,0.945454545454545,6.03894927536232,305,129,176,0,1.4,30.75,7,0,0,0,0,0,0,6.07961904809849e-06,0.00710687830482598,0.000637342982334322
24.3,"random_policy_SVM","SVM",17,41,9133,9133,0,4200,3686,514,0.999663784275799,0.945454545454545,6.03894927536232,306,130,176,1,1.4,31.5,7.2,0,0,0,0,0,0,4.07761345908961e-06,0.00464817887341709,0.000428377161569634
24.3,"random_policy_SVM","SVM",17,42,9033,9033,0,4300,3786,514,0.999659802025259,0.941818181818182,6.03894927536232,307,131,176,1,1.3,32.25,7.4,0,0,0,0,0,0,3.22482915726818e-06,0.00358064321685479,0.000336586599974235
24.3,"random_policy_SVM","SVM",17,43,8933,8933,0,4400,3886,514,0.99965866423939,0.941818181818182,6.03894927536232,304,130,174,-3,1.3,33,7.6,0,0,0,0,0,0,3.58666051924027e-06,0.00398411098672241,0.00037516456540065
24.3,"random_policy_SVM","SVM",17,44,8833,8833,0,4500,3986,514,0.999661508704062,0.945454545454545,6.03894927536232,307,130,177,3,1.4,33.75,7.8,0,0,0,0,0,0,3.49560843797293e-06,0.00390907884973906,0.000369325802618755
24.3,"random_policy_SVM","SVM",17,45,8733,8733,0,4600,4086,514,0.999661508704062,0.945454545454545,6.03894927536232,307,131,176,0,1.3,34.5,7.9,0,0,0,0,0,0,2.81225336018943e-06,0.00310535185495884,0.000297364796555058
24.3,"random_policy_SVM","SVM",17,46,8633,8633,0,4700,4186,514,0.999661508704062,0.945454545454545,6.03894927536232,306,131,175,-1,1.3,35.25,8.1,0,0,0,0,0,0,1.86658958179669e-06,0.0020006140169666,0.000194504684150045
24.3,"random_policy_SVM","SVM",17,47,8533,8533,0,4800,4286,514,0.999661508704062,0.945454545454545,6.03894927536232,306,131,175,0,1.3,36,8.3,0,0,0,0,0,0,0.000785823439026798,1.47752042586635,0.0804274037808085
24.3,"random_policy_SVM","SVM",17,48,8433,8433,0,4900,4386,514,0.999660939811127,0.945454545454545,6.03894927536232,307,131,176,1,1.3,36.75,8.5,0,0,0,0,0,0,0.000708066883013786,1.28617920919377,0.07248445880751
24.3,"random_policy_SVM","SVM",18,0,13233,12705,528,100,95,5,0.908090708352841,0.7109375,4.64176306769494,25,5,20,0,4,0.75,19,0,0,0,0,0,0,0.992733261795642,613.930522213465,99.757139091637
24.3,"random_policy_SVM","SVM",18,1,13133,12705,428,200,95,105,0.92818434624084,0.75390625,4.89143238100343,42,17,25,17,1.5,1.5,0.9,0,0,0,0,0,0,0.993501259329071,475.320327629722,99.625960052945
24.3,"random_policy_SVM","SVM",18,2,13033,12668,365,300,132,168,0.96061030357978,0.84765625,5.23133870087336,80,34,46,38,1.4,2.25,0.8,0,0,0,0,0,0,0.995235930145432,293.844623526134,99.777344528197
24.3,"random_policy_SVM","SVM",18,3,12933,12653,280,400,147,253,0.935630654344093,0.859375,5.12692590374564,95,43,52,15,1.2,3,0.6,0,0,0,0,0,0,0.995571685910011,265.646676621703,99.7735658108222
24.3,"random_policy_SVM","SVM",18,4,12833,12609,224,500,191,309,0.929459620184053,0.86328125,4.99454195205479,116,50,66,21,1.3,3.75,0.6,0,0,0,0,0,0,0.994411270285154,190.91505888399,99.7930356266138
24.3,"random_policy_SVM","SVM",18,5,12733,12573,160,600,227,373,0.933560238262378,0.86328125,5.20859375,129,56,73,13,1.3,4.5,0.6,0,0,0,0,0,0,0.991204464478367,117.561046495661,99.7279516985625
24.3,"random_policy_SVM","SVM",18,6,12633,12535,98,700,265,435,0.937825977811574,0.86328125,5.12208738527098,139,59,80,10,1.4,5.25,0.6,0,0,0,0,0,0,0.00422105834849705,53.5181496106089,46.8291839333236
24.3,"random_policy_SVM","SVM",18,7,12533,12468,65,800,332,468,0.932720007604119,0.86328125,5.01434437337381,150,64,86,11,1.3,6,0.7,0,0,0,0,0,0,0.00310182814183332,14.5943866689429,14.3315204199074
24.3,"random_policy_SVM","SVM",18,8,12433,12379,54,900,421,479,0.934677093082204,0.86328125,5.01869710286458,148,65,83,-2,1.3,6.75,0.9,0,0,0,0,0,0,1.00954114537097e-05,3.04367204415708,3.03905237926114
24.3,"random_policy_SVM","SVM",18,9,12333,12282,51,1000,518,482,0.936584824910304,0.86328125,5.03256675151646,151,64,87,3,1.4,7.5,1.1,0,0,0,0,0,0,5.73534458927078e-06,0.00363592807231081,0.000790091100236023
24.3,"random_policy_SVM","SVM",18,10,12233,12182,51,1100,618,482,0.937813791725165,0.86328125,5.04568378040834,151,66,85,0,1.3,8.25,1.3,0,0,0,0,0,0,2.35928055289492e-06,0.00140633669612831,0.000292052218096414
24.3,"random_policy_SVM","SVM",18,11,12133,12082,51,1200,718,482,0.939537513648418,0.86328125,5.06831016507385,152,67,85,1,1.3,9,1.5,0,0,0,0,0,0,1.97455729525468e-06,0.00118753129956304,0.000248651390294451
24.3,"random_policy_SVM","SVM",18,12,12033,11982,51,1300,818,482,0.940066389798784,0.86328125,5.07271739130435,154,67,87,2,1.3,9.75,1.7,0,0,0,0,0,0,7.4567420082153e-07,0.000476395367822517,9.48290224948118e-05
24.3,"random_policy_SVM","SVM",18,13,11933,11882,51,1400,918,482,0.940691536031819,0.86328125,5.07713228894691,151,68,83,-3,1.2,10.5,1.9,0,0,0,0,0,0,6.35731141519013e-07,0.000430557663308531,7.58729905344918e-05
24.3,"random_policy_SVM","SVM",18,14,11833,11782,51,1500,1018,482,0.941799251286842,0.86328125,5.08598517872711,151,68,83,0,1.2,11.25,2.1,0,0,0,0,0,0,3.04162594168435e-07,0.000200144540865143,3.69362570646264e-05
24.3,"random_policy_SVM","SVM",18,15,11733,11683,50,1600,1117,483,0.942652886640153,0.86328125,5.1172149122807,149,67,82,-2,1.2,12,2.3,0,0,0,0,0,0,8.01065753063323e-07,0.00063765496690421,0.000123809596596671
24.3,"random_policy_SVM","SVM",18,16,11633,11585,48,1700,1215,485,0.949414336686945,0.86328125,5.1627030561674,162,72,90,13,1.2,12.75,2.5,0,0,0,0,0,0,3.94949103066006e-06,0.0272083736429875,0.0249622709442122
24.3,"random_policy_SVM","SVM",18,17,11533,11492,41,1800,1308,492,0.957542456325065,0.87109375,5.3576769342576,180,77,103,18,1.3,13.5,2.7,0,0,0,0,0,0,0.00373234925606395,0.935930302156955,0.610252307955519
24.3,"random_policy_SVM","SVM",18,18,11433,11399,34,1900,1401,499,0.969757789346431,0.87890625,5.54055977894973,201,86,115,21,1.3,14.25,2.8,0,0,0,0,0,0,0.00557305974550567,2.79751967184508,0.807136842136785
24.3,"random_policy_SVM","SVM",18,19,11333,11310,23,2000,1490,510,0.969026014857287,0.89453125,5.56893671383648,223,100,123,22,1.2,15,2.9,0,0,0,0,0,0,0.00952906263498823,6.68573181270861,1.63003358739645
24.3,"random_policy_SVM","SVM",18,20,11233,11216,17,2100,1584,516,0.965958776906881,0.8984375,5.49126654248221,241,106,135,18,1.3,15.75,3.1,0,0,0,0,0,0,0.00848376294234134,5.44352114214751,1.16759733774135
24.3,"random_policy_SVM","SVM",18,21,11133,11116,17,2200,1684,516,0.965789390305723,0.8984375,5.50105489639037,247,106,141,6,1.3,16.5,3.3,0,0,0,0,0,0,0.00612980069429769,3.51082008994492,0.704330226907928
24.3,"random_policy_SVM","SVM",18,22,11033,11017,16,2300,1783,517,0.969701124044631,0.8984375,5.52426609848485,247,108,139,0,1.3,17.25,3.4,0,0,0,0,0,0,0.0053109875306925,3.15033084355564,0.594034565405167
24.3,"random_policy_SVM","SVM",18,23,10933,10918,15,2400,1882,518,0.973615295000784,0.8984375,5.52426609848485,248,107,141,1,1.3,18,3.6,0,0,0,0,0,0,0.00463776389537278,2.68799215530699,0.506856407487727
24.3,"random_policy_SVM","SVM",18,24,10833,10819,14,2500,1981,519,0.979490816565269,0.8984375,5.58891849398931,250,108,142,2,1.3,18.75,3.8,0,0,0,0,0,0,0.00460140791454497,2.68751979962599,0.518904702139679
24.3,"random_policy_SVM","SVM",18,25,10733,10721,12,2600,2079,521,0.989279899781603,0.90234375,5.73316691733512,249,109,140,-1,1.3,19.5,4,0,0,0,0,0,0,0.0037942232150412,1.68916360585629,0.433801424632363
24.3,"random_policy_SVM","SVM",18,26,10633,10626,7,2700,2174,526,0.997760806621433,0.90625,5.94736842105263,263,114,149,14,1.3,20.25,4.1,0,0,0,0,0,0,0.00384177450350159,1.73429833813253,0.508562287835094
24.3,"random_policy_SVM","SVM",18,27,10533,10530,3,2800,2270,530,0.998967229176415,0.921875,5.95267857142857,274,117,157,11,1.3,21,4.3,0,0,0,0,0,0,0.00491976700214458,3.48143312215808,0.547800392876829
24.3,"random_policy_SVM","SVM",18,28,10433,10431,2,2900,2369,531,0.999196936905319,0.92578125,5.95267857142857,279,119,160,5,1.3,21.75,4.5,0,0,0,0,0,0,0.00390045486314016,1.93972218349147,0.418141662950698
24.3,"random_policy_SVM","SVM",18,29,10333,10333,0,3000,2467,533,0.999343169942287,0.92578125,5.95267857142857,284,123,161,5,1.3,22.5,4.6,0,0,0,0,0,0,0.00374935080456583,1.94039160348964,0.409123497833552
24.3,"random_policy_SVM","SVM",18,30,10233,10233,0,3100,2567,533,0.999354137420059,0.92578125,5.95267857142857,283,122,161,-1,1.3,23.25,4.8,0,0,0,0,0,0,0.00373120537554144,2.14304257150824,0.389307652073427
24.3,"random_policy_SVM","SVM",18,31,10133,10133,0,3200,2667,533,0.999359011854625,0.92578125,5.94736842105263,284,122,162,1,1.3,24,5,0,0,0,0,0,0,0.00318811500211865,1.1855926339001,0.333253188570789
24.3,"random_policy_SVM","SVM",18,32,10033,10033,0,3300,2767,533,0.999374853766963,0.92578125,5.94736842105263,282,121,161,-2,1.3,24.75,5.2,0,0,0,0,0,0,0.00259733533151851,0.399829541862933,0.270354065440089
24.3,"random_policy_SVM","SVM",18,33,9933,9933,0,3400,2867,533,0.999380337505849,0.92578125,5.94736842105263,281,122,159,-1,1.3,25.5,5.4,0,0,0,0,0,0,0.00254638222833862,0.342793788599138,0.2668473413003
24.3,"random_policy_SVM","SVM",18,34,9833,9833,0,3500,2967,533,0.999396788722508,0.92578125,5.94736842105263,281,122,159,0,1.3,26.25,5.6,0,0,0,0,0,0,1.76313585464816e-05,0.115746015762507,0.101162113345151
24.3,"random_policy_SVM","SVM",18,35,9733,9733,0,3600,3067,533,0.999403491070036,0.9296875,5.94736842105263,282,122,160,1,1.3,27,5.8,0,0,0,0,0,0,1.51102485623088e-05,0.0136971199292567,0.0016067660041022
24.3,"random_policy_SVM","SVM",18,36,9633,9633,0,3700,3167,533,0.999405318982998,0.9296875,5.94736842105263,284,122,162,2,1.3,27.75,5.9,0,0,0,0,0,0,1.16944234963844e-05,0.0109107824545097,0.00125645607413759
24.3,"random_policy_SVM","SVM",18,37,9533,9533,0,3800,3267,533,0.999412021330526,0.9296875,5.94206773618538,284,122,162,0,1.3,28.5,6.1,0,0,0,0,0,0,6.30211800220699e-06,0.00557126899525388,0.000678268745542163
24.3,"random_policy_SVM","SVM",18,38,9433,9433,0,3900,3367,533,0.999418114373733,0.9296875,5.94736842105263,286,122,164,2,1.3,29.25,6.3,0,0,0,0,0,0,7.8721178812639e-06,0.00712472081653464,0.000845253575849745
24.3,"random_policy_SVM","SVM",18,39,9333,9333,0,4000,3467,533,0.999421770199657,0.9296875,5.94736842105263,286,123,163,0,1.3,30,6.5,0,0,0,0,0,0,6.28803750321482e-06,0.00570912279264829,0.000674064277126743
24.3,"random_policy_SVM","SVM",18,40,9233,9233,0,4100,3567,533,0.999427253938543,0.9296875,5.94736842105263,285,123,162,-1,1.3,30.75,6.7,0,0,0,0,0,0,5.75415546428671e-06,0.00515063877874254,0.000609397528725908
24.3,"random_policy_SVM","SVM",18,41,9133,9133,0,4200,3667,533,0.99943334698175,0.93359375,5.94736842105263,286,123,163,1,1.3,31.5,6.9,0,0,0,0,0,0,3.53951601471401e-06,0.00312811545814371,0.00038035295610589
24.3,"random_policy_SVM","SVM",18,42,9033,9033,0,4300,3767,533,0.999438830720636,0.93359375,5.94206773618538,286,123,163,0,1.3,32.25,7.1,0,0,0,0,0,0,5.01696264298616e-06,0.00461070686635308,0.000532123352550375
24.3,"random_policy_SVM","SVM",18,43,8933,8933,0,4400,3867,533,0.999440049329278,0.93359375,5.94736842105263,286,123,163,0,1.3,33,7.3,0,0,0,0,0,0,3.19858486236185e-06,0.00274569141229962,0.000337520309937027
24.3,"random_policy_SVM","SVM",18,44,8833,8833,0,4500,3967,533,0.999447970285447,0.93359375,5.94736842105263,285,123,162,-1,1.3,33.75,7.4,0,0,0,0,0,0,3.03845452715044e-06,0.00269257111979652,0.000323757923540769
24.3,"random_policy_SVM","SVM",18,45,8733,8733,0,4600,4067,533,0.999449188894088,0.93359375,5.94206773618538,285,123,162,0,1.3,34.5,7.6,0,0,0,0,0,0,1.87972030441803e-06,0.00160937557837542,0.000202244092084525
24.3,"random_policy_SVM","SVM",18,46,8633,8633,0,4700,4167,533,0.999453454024333,0.93359375,5.94736842105263,286,123,163,1,1.3,35.25,7.8,0,0,0,0,0,0,3.12064609993452e-06,0.00288043471894036,0.000332464613724142
24.3,"random_policy_SVM","SVM",18,47,8533,8533,0,4800,4267,533,0.999460765676181,0.93359375,5.94736842105263,288,123,165,2,1.3,36,8,0,0,0,0,0,0,1.71738246303116e-06,0.00152876087676592,0.000184997053522842
24.3,"random_policy_SVM","SVM",18,48,8433,8433,0,4900,4367,533,0.999448579589768,0.93359375,5.94736842105263,288,123,165,0,1.3,36.75,8.2,0,0,0,0,0,0,1.64619521766007e-06,0.00146642224701956,0.000176496901283259
24.3,"random_policy_SVM","SVM",19,0,13233,12713,520,100,93,7,0.959913831632005,0.83206106870229,5.18019356597601,26,7,19,0,2.7,0.75,13.3,0,0,0,0,0,0,0.999990414825594,686.110629836404,99.9995534560752
24.3,"random_policy_SVM","SVM",19,1,13133,12682,451,200,124,76,0.967484253118096,0.870229007633588,5.44957796382938,83,33,50,57,1.5,1.5,1.6,0,0,0,0,0,0,0.994097345225066,449.851146590859,99.7101796691154
24.3,"random_policy_SVM","SVM",19,2,13033,12665,368,300,141,159,0.939572495247624,0.870229007633588,5.39219364120072,103,44,59,20,1.3,2.25,0.9,0,0,0,0,0,0,0.994768814118465,367.471573943802,99.7526607792568
24.3,"random_policy_SVM","SVM",19,3,12933,12623,310,400,183,217,0.937586332242808,0.870229007633588,5.08931297709924,121,50,71,18,1.4,3,0.8,0,0,0,0,0,0,0.999994449108741,278.837902106672,99.9997781785359
24.3,"random_policy_SVM","SVM",19,4,12833,12576,257,500,230,270,0.944780139561766,0.870229007633588,5.20190839694656,129,53,76,8,1.4,3.75,0.9,0,0,0,0,0,0,0.999989570413826,214.999324808017,99.9996332905388
24.3,"random_policy_SVM","SVM",19,5,12733,12535,198,600,271,329,0.936767553974405,0.870229007633588,5.09817937601404,134,57,77,5,1.4,4.5,0.8,0,0,0,0,0,0,0.999988349185291,154.088913785814,99.999600149391
24.3,"random_policy_SVM","SVM",19,6,12633,12490,143,700,316,384,0.93798559093266,0.870229007633588,5.10256639631043,140,58,82,6,1.4,5.25,0.8,0,0,0,0,0,0,0.00656536839707731,94.2649390202035,91.0751945856106
24.3,"random_policy_SVM","SVM",19,7,12533,12439,94,800,367,433,0.940192240079596,0.870229007633588,5.11577387646024,153,67,86,13,1.3,6,0.8,0,0,0,0,0,0,0.00184106257115056,44.1901008130769,42.1237992703671
24.3,"random_policy_SVM","SVM",19,8,12433,12370,63,900,436,464,0.943167015273123,0.870229007633588,5.12021080089776,151,67,84,-2,1.3,6.75,0.9,0,0,0,0,0,0,4.03894723406165e-06,11.003957365025,11.0021863471362
24.3,"random_policy_SVM","SVM",19,9,12333,12281,52,1000,525,475,0.943783184654158,0.870229007633588,5.12465542832909,154,69,85,3,1.2,7.5,1.1,0,0,0,0,0,0,1.73530603176743e-06,0.00102317797164042,0.000235795856117674
24.3,"random_policy_SVM","SVM",19,10,12233,12181,52,1100,625,475,0.946803844801568,0.870229007633588,5.13803572970854,154,69,85,0,1.2,8.25,1.3,0,0,0,0,0,0,9.12983761286994e-07,0.000476782093557298,0.000121705262784
24.3,"random_policy_SVM","SVM",19,11,12133,12082,51,1200,724,476,0.949868006268941,0.870229007633588,5.2278280800756,163,71,92,9,1.3,9,1.5,0,0,0,0,0,0,2.08456631304137e-06,0.00131204292698697,0.000293379634602025
24.3,"random_policy_SVM","SVM",19,12,12033,11982,51,1300,824,476,0.950784513530088,0.870229007633588,5.20953296868426,163,70,93,0,1.3,9.75,1.7,0,0,0,0,0,0,1.0590871099941e-06,0.000670929651628983,0.000140793043730844
24.3,"random_policy_SVM","SVM",19,13,11933,11882,51,1400,924,476,0.951554427302126,0.870229007633588,5.21866449010176,163,70,93,0,1.3,10.5,1.9,0,0,0,0,0,0,8.17787141668976e-07,0.000502138680158851,9.41219849634107e-05
24.3,"random_policy_SVM","SVM",19,14,11833,11782,51,1500,1024,476,0.952476893648201,0.870229007633588,5.20953296868426,162,71,91,-1,1.3,11.25,2.2,0,0,0,0,0,0,4.78857115764801e-07,0.000288906677194779,5.78769364269071e-05
24.3,"random_policy_SVM","SVM",19,15,11733,11683,50,1600,1123,477,0.954106107466115,0.870229007633588,5.26867202475031,171,73,98,9,1.3,12,2.4,0,0,0,0,0,0,8.43630154041194e-07,0.00060057586003854,0.00011860491159709
24.3,"random_policy_SVM","SVM",19,16,11633,11586,47,1700,1220,480,0.961347587464446,0.870229007633588,5.44637845240194,173,75,98,2,1.3,12.75,2.5,0,0,0,0,0,0,1.27712355430652e-05,0.137521276124005,0.131636302106035
24.3,"random_policy_SVM","SVM",19,17,11533,11491,42,1800,1315,485,0.970620519513025,0.877862595419847,5.55860504213166,188,81,107,15,1.3,13.5,2.7,0,0,0,0,0,0,0.0033758778542054,0.820967063824601,0.504131482269637
24.3,"random_policy_SVM","SVM",19,18,11433,11393,40,1900,1413,487,0.972591784805497,0.877862595419847,5.64210190908219,195,84,111,7,1.3,14.25,2.9,0,0,0,0,0,0,0.00321666750783681,0.735927774897289,0.389519721012504
24.3,"random_policy_SVM","SVM",19,19,11333,11297,36,2000,1509,491,0.97687636686511,0.889312977099237,5.65226998794697,206,88,118,11,1.3,15,3.1,0,0,0,0,0,0,0.00424208384129437,1.83000314930563,0.551402287223079
24.3,"random_policy_SVM","SVM",19,20,11233,11206,27,2100,1600,500,0.979141415044276,0.908396946564885,5.72832985314757,232,101,131,26,1.3,15.75,3.2,0,0,0,0,0,0,0.00931435101950545,7.0491777709964,1.37714281811239
24.3,"random_policy_SVM","SVM",19,21,11133,11114,19,2200,1692,508,0.9761457830535,0.916030534351145,5.61454456548314,248,110,138,16,1.3,16.5,3.3,0,0,0,0,0,0,0.010782877748193,9.99911588166898,1.4074083933881
24.3,"random_policy_SVM","SVM",19,22,11033,11014,19,2300,1792,508,0.976514650410227,0.916030534351145,5.61454456548314,249,110,139,1,1.3,17.25,3.5,0,0,0,0,0,0,0.0077770444528335,6.24263779382637,0.852666026924174
24.3,"random_policy_SVM","SVM",19,23,10933,10914,19,2400,1892,508,0.976381762816446,0.919847328244275,5.61454456548314,250,108,142,1,1.3,18,3.7,0,0,0,0,0,0,0.00672571812378457,5.62956770510406,0.724614107482916
24.3,"random_policy_SVM","SVM",19,24,10833,10814,19,2500,1992,508,0.976301315169986,0.919847328244275,5.6371838580859,249,108,141,-1,1.3,18.75,3.9,0,0,0,0,0,0,0.00486419076919546,2.95749713907568,0.517221082554329
24.3,"random_policy_SVM","SVM",19,25,10733,10714,19,2600,2092,508,0.976205373902727,0.919847328244275,5.6371838580859,247,108,139,-2,1.3,19.5,4.1,0,0,0,0,0,0,0.00418713940614757,2.11401209325381,0.445923093671226
24.3,"random_policy_SVM","SVM",19,26,10633,10614,19,2700,2192,508,0.976176174386606,0.919847328244275,5.6371838580859,249,109,140,2,1.3,20.25,4.3,0,0,0,0,0,0,0.00465610425736982,3.04388744627548,0.487328086566289
24.3,"random_policy_SVM","SVM",19,27,10533,10514,19,2800,2292,508,0.976250662948144,0.919847328244275,5.6371838580859,250,109,141,1,1.3,21,4.5,0,0,0,0,0,0,0.00338930729021238,1.28829561829838,0.358676433074506
24.3,"random_policy_SVM","SVM",19,28,10433,10414,19,2900,2392,508,0.976222655249008,0.919847328244275,5.6371838580859,250,109,141,0,1.3,21.75,4.7,0,0,0,0,0,0,0.00310662853382086,0.989213820372347,0.328364311986004
24.3,"random_policy_SVM","SVM",19,29,10333,10314,19,3000,2492,508,0.976297739719038,0.919847328244275,5.6371838580859,250,109,141,0,1.3,22.5,4.9,0,0,0,0,0,0,1.61799300480784e-05,0.0485670926162032,0.0372907180777279
24.3,"random_policy_SVM","SVM",19,30,10233,10214,19,3100,2592,508,0.97631770265353,0.919847328244275,5.65479219677693,251,110,141,1,1.3,23.25,5.1,0,0,0,0,0,0,1.28686335298861e-05,0.0110724997448781,0.00141161165573941
24.3,"random_policy_SVM","SVM",19,31,10133,10114,19,3200,2692,508,0.976327535143654,0.919847328244275,5.65982315068865,250,109,141,-1,1.3,24,5.3,0,0,0,0,0,0,1.01673082597108e-05,0.00919087114886831,0.001104743355225
24.3,"random_policy_SVM","SVM",19,32,10033,10014,19,3300,2792,508,0.976300123353009,0.919847328244275,5.65982315068865,249,109,140,-1,1.3,24.75,5.5,0,0,0,0,0,0,9.06958647096914e-06,0.00893070469928715,0.00097730105508593
24.3,"random_policy_SVM","SVM",19,33,9933,9914,19,3400,2892,508,0.976282842006736,0.919847328244275,5.65982315068865,248,108,140,-1,1.3,25.5,5.7,0,0,0,0,0,0,1.19096731558594e-05,0.0118771338158112,0.00126526461887042
24.3,"random_policy_SVM","SVM",19,34,9833,9815,18,3500,2991,509,0.979473931982961,0.919847328244275,5.68752251670485,247,108,139,-1,1.3,26.25,5.9,0,0,0,0,0,0,7.27967241959119e-06,0.0100711149361449,0.00393594687389269
24.3,"random_policy_SVM","SVM",19,35,9733,9719,14,3600,3087,513,0.993812086216052,0.923664122137405,5.82347923025157,257,114,143,10,1.3,27,6,0,0,0,0,0,0,1.14754565597395e-05,0.294469724993419,0.286418495912985
24.3,"random_policy_SVM","SVM",19,36,9633,9631,2,3700,3175,525,0.999618618564933,0.950381679389313,5.93149466192171,290,126,164,33,1.3,27.75,6,0,0,0,0,0,0,1.41146995021509e-05,0.370701683741586,0.363268905382188
24.3,"random_policy_SVM","SVM",19,37,9533,9533,0,3800,3273,527,0.999661523976378,0.954198473282443,5.93149466192171,299,129,170,9,1.3,28.5,6.2,0,0,0,0,0,0,1.29079142953017e-05,0.0794871623180079,0.0700063977468898
24.3,"random_policy_SVM","SVM",19,38,9433,9433,0,3900,3373,527,0.99966211988487,0.954198473282443,5.93149466192171,297,128,169,-2,1.3,29.25,6.4,0,0,0,0,0,0,1.57024838922664e-05,0.0357232919338186,0.0219181607289283
24.3,"random_policy_SVM","SVM",19,39,9333,9333,0,4000,3473,527,0.999659140342409,0.954198473282443,5.93149466192171,297,128,169,0,1.3,30,6.6,0,0,0,0,0,0,7.62924367516558e-06,0.00745141092940451,0.000841766439108296
24.3,"random_policy_SVM","SVM",19,40,9233,9233,0,4100,3573,527,0.99966211988487,0.954198473282443,5.93149466192171,294,128,166,-3,1.3,30.75,6.8,0,0,0,0,0,0,7.13458190702522e-06,0.00709565848528266,0.000767810357042248
24.3,"random_policy_SVM","SVM",19,41,9133,9133,0,4200,3673,527,0.999660332159394,0.954198473282443,5.93149466192171,293,128,165,-1,1.3,31.5,7,0,0,0,0,0,0,7.90374958440343e-06,0.0080528903760995,0.000838933829579186
24.3,"random_policy_SVM","SVM",19,42,9033,9033,0,4300,3773,527,0.999660928067886,0.954198473282443,5.93149466192171,293,128,165,0,1.3,32.25,7.2,0,0,0,0,0,0,4.29465696594497e-06,0.00427535452293991,0.000467008235035529
24.3,"random_policy_SVM","SVM",19,43,8933,8933,0,4400,3873,527,0.999663907610347,0.954198473282443,5.93149466192171,293,128,165,0,1.3,33,7.3,0,0,0,0,0,0,4.64803626334177e-06,0.00474747365471862,0.00049724405742331
24.3,"random_policy_SVM","SVM",19,44,8833,8833,0,4500,3973,527,0.999665695335824,0.954198473282443,5.93149466192171,293,128,165,0,1.3,33.75,7.5,0,0,0,0,0,0,3.73991293405362e-06,0.00373908970867648,0.000397215728250917
24.3,"random_policy_SVM","SVM",19,45,8733,8733,0,4600,4073,527,0.999665099427332,0.954198473282443,5.93149466192171,293,128,165,0,1.3,34.5,7.7,0,0,0,0,0,0,3.97720063120979e-06,0.00414453218122842,0.000420108693309603
24.3,"random_policy_SVM","SVM",19,46,8633,8633,0,4700,4173,527,0.999665099427332,0.954198473282443,5.93149466192171,293,128,165,0,1.3,35.25,7.9,0,0,0,0,0,0,3.30946518922474e-06,0.00331407037738874,0.000350186954960117
24.3,"random_policy_SVM","SVM",19,47,8533,8533,0,4800,4273,527,0.999666291244316,0.954198473282443,5.93149466192171,295,129,166,2,1.3,36,8.1,0,0,0,0,0,0,2.5411481944048e-06,0.00247308018232585,0.000270113870782365
24.3,"random_policy_SVM","SVM",19,48,8433,8433,0,4900,4373,527,0.999666887152809,0.954198473282443,5.93149466192171,296,130,166,1,1.3,36.75,8.3,0,0,0,0,0,0,2.00391511120861e-06,0.00190892138695806,0.000212317364476053
24.3,"random_policy_SVM","SVM",20,0,13233,12710,523,100,95,5,0.97375365288528,0.793103448275862,5.67901272885909,25,5,20,0,4,0.75,19,0,0,0,0,0,0,0.981409694616639,807.884400267877,98.984936764695
24.3,"random_policy_SVM","SVM",20,1,13133,12670,463,200,135,65,0.966880905473002,0.865900383141762,5.44345061821346,59,24,35,34,1.5,1.5,2.1,0,0,0,0,0,0,0.987407175743088,822.917376159777,99.154048648907
24.3,"random_policy_SVM","SVM",20,2,13033,12635,398,300,170,130,0.985790380904891,0.896551724137931,5.7709805463305,99,41,58,40,1.4,2.25,1.3,0,0,0,0,0,0,0.99394986248333,430.896720355045,99.6783721206737
24.3,"random_policy_SVM","SVM",20,3,12933,12601,332,400,204,196,0.977823113627954,0.896551724137931,5.71744332406601,132,57,75,33,1.3,3,1,0,0,0,0,0,0,0.992618480286391,460.426428747975,99.5631221014209
24.3,"random_policy_SVM","SVM",20,4,12833,12563,270,500,242,258,0.985512265201559,0.9272030651341,5.68394679822211,151,65,86,19,1.3,3.75,0.9,0,0,0,0,0,0,0.995331940906791,317.692551798881,99.725171737555
24.3,"random_policy_SVM","SVM",20,5,12733,12523,210,600,282,318,0.971239845786331,0.931034482758621,5.45322657023548,172,74,98,21,1.3,4.5,0.9,0,0,0,0,0,0,0.990918190126991,226.988894961127,99.5366084953951
24.3,"random_policy_SVM","SVM",20,6,12633,12480,153,700,325,375,0.972209961207351,0.9272030651341,5.41843724602345,196,83,113,24,1.4,5.25,0.9,0,0,0,0,0,0,0.990550462237559,166.902988762276,99.5898912988771
24.3,"random_policy_SVM","SVM",20,7,12533,12433,100,800,372,428,0.976289589620838,0.9272030651341,5.49286632907323,208,88,120,12,1.4,6,0.9,0,0,0,0,0,0,0.0290805993539187,110.37661989397,73.2304268736843
24.3,"random_policy_SVM","SVM",20,8,12433,12376,57,900,429,471,0.981927264071143,0.9272030651341,5.5863555582585,225,94,131,17,1.4,6.75,0.9,0,0,0,0,0,0,0.0188781937817281,60.9779290693152,31.5685729012345
24.3,"random_policy_SVM","SVM",20,9,12333,12294,39,1000,511,489,0.986024237334963,0.9272030651341,5.6363771629925,233,98,135,8,1.4,7.5,1,0,0,0,0,0,0,0.0171696280071365,45.1357278646081,15.607028111933
24.3,"random_policy_SVM","SVM",20,10,12233,12207,26,1100,598,502,0.988698334774751,0.9272030651341,5.71171557078604,242,103,139,9,1.3,8.25,1.2,0,0,0,0,0,0,0.0137374746753997,26.3376855627385,4.51632009148697
24.3,"random_policy_SVM","SVM",20,11,12133,12113,20,1200,692,508,0.992768991713961,0.931034482758621,5.78998722860792,258,109,149,16,1.4,9,1.4,0,0,0,0,0,0,0.0123060152431179,21.5045279782331,3.49956916126074
24.3,"random_policy_SVM","SVM",20,12,12033,12020,13,1300,785,515,0.995909007719067,0.938697318007663,5.86853768129292,275,117,158,17,1.4,9.75,1.5,0,0,0,0,0,0,0.012779577211791,20.4387384308406,1.62743724231273
24.3,"random_policy_SVM","SVM",20,13,11933,11925,8,1400,880,520,0.998566956505098,0.942528735632184,5.92458156886469,279,122,157,4,1.3,10.5,1.7,0,0,0,0,0,0,0.0117288498420915,14.8413514575467,1.51888370243529
24.3,"random_policy_SVM","SVM",20,14,11833,11832,1,1500,973,527,0.999007754942386,0.938697318007663,5.93517063333094,306,127,179,27,1.4,11.25,1.8,0,0,0,0,0,0,0.0114029863742883,13.5945939719606,1.63627769162416
24.3,"random_policy_SVM","SVM",20,15,11733,11733,0,1600,1072,528,0.99900895113896,0.942528735632184,5.93517063333094,314,129,185,8,1.4,12,2,0,0,0,0,0,0,0.00856365321161017,8.501426612204,0.919649886079336
24.3,"random_policy_SVM","SVM",20,16,11633,11633,0,1700,1172,528,0.999043042741301,0.942528735632184,5.94579761745507,310,127,183,-4,1.4,12.75,2.2,0,0,0,0,0,0,0.00686620119936165,6.42726624001928,0.738760941160724
24.3,"random_policy_SVM","SVM",20,17,11533,11533,0,1800,1272,528,0.999052612313887,0.942528735632184,5.94579761745507,311,127,184,1,1.4,13.5,2.4,0,0,0,0,0,0,0.00643991370199418,5.94382631350945,0.674172733131324
24.3,"random_policy_SVM","SVM",20,18,11433,11433,0,1900,1372,528,0.999057397100181,0.942528735632184,5.94579761745507,311,127,184,0,1.4,14.25,2.6,0,0,0,0,0,0,0.00523012163495851,4.0447388000915,0.556606319589591
24.3,"random_policy_SVM","SVM",20,19,11333,11333,0,2000,1472,528,0.999057397100181,0.942528735632184,5.94579761745507,313,127,186,2,1.5,15,2.8,0,0,0,0,0,0,0.00358003504278249,1.61729482471545,0.380017821447198
24.3,"random_policy_SVM","SVM",20,20,11233,11233,0,2100,1572,528,0.999068162869341,0.942528735632184,5.94579761745507,312,127,185,-1,1.5,15.75,3,0,0,0,0,0,0,0.00329003967523761,1.30566762911404,0.346179930373005
24.3,"random_policy_SVM","SVM",20,21,11133,11133,0,2200,1672,528,0.999072349557348,0.942528735632184,5.94579761745507,312,126,186,0,1.5,16.5,3.2,0,0,0,0,0,0,0.00305145385293968,1.0530224943478,0.318621751834169
24.3,"random_policy_SVM","SVM",20,22,11033,11033,0,2300,1772,528,0.999075340048782,0.942528735632184,5.94047937271674,315,128,187,3,1.5,17.25,3.4,0,0,0,0,0,0,0.00280378282167842,0.695004053787764,0.293228887815011
24.3,"random_policy_SVM","SVM",20,23,10933,10933,0,2400,1872,528,0.999074741950495,0.942528735632184,5.94047937271674,314,128,186,-1,1.5,18,3.5,0,0,0,0,0,0,1.14330088347366e-05,0.0105935413051336,0.00124722468597466
24.3,"random_policy_SVM","SVM",20,24,10833,10833,0,2500,1972,528,0.999078330540215,0.942528735632184,5.94579761745507,314,128,186,0,1.5,18.75,3.7,0,0,0,0,0,0,9.22168850253141e-06,0.00876954202360501,0.00102170923144516
24.3,"random_policy_SVM","SVM",20,25,10733,10733,0,2600,2072,528,0.999084311523082,0.942528735632184,5.94579761745507,312,127,185,-2,1.5,19.5,3.9,0,0,0,0,0,0,7.95478755519607e-06,0.00785091182760936,0.000853829476636437
24.3,"random_policy_SVM","SVM",20,26,10633,10633,0,2700,2172,528,0.999078330540215,0.942528735632184,5.94047937271674,312,128,184,0,1.4,20.25,4.1,0,0,0,0,0,0,6.59256567765576e-06,0.00662635760485054,0.000722911801002982
24.3,"random_policy_SVM","SVM",20,27,10533,10533,0,2800,2272,528,0.999083115326508,0.942528735632184,5.93517063333094,311,128,183,-1,1.4,21,4.3,0,0,0,0,0,0,8.4690710143508e-06,0.00882879994133516,0.00090107032656182
24.3,"random_policy_SVM","SVM",20,28,10433,10433,0,2900,2372,528,0.999083713424795,0.942528735632184,5.94047937271674,307,126,181,-4,1.4,21.75,4.5,0,0,0,0,0,0,8.7656819892686e-06,0.00933988012508568,0.000939813683900204
24.3,"random_policy_SVM","SVM",20,29,10333,10333,0,3000,2472,528,0.999085507719655,0.942528735632184,5.90876862873427,307,127,180,0,1.4,22.5,4.7,0,0,0,0,0,0,4.23496426799403e-06,0.00424759831952061,0.000456097274819421
24.3,"random_policy_SVM","SVM",20,30,10233,10233,0,3100,2572,528,0.999090890604235,0.942528735632184,5.94579761745507,307,127,180,0,1.4,23.25,4.9,0,0,0,0,0,0,5.33396229165411e-06,0.00574785658641434,0.000570565053551697
24.3,"random_policy_SVM","SVM",20,31,10133,10133,0,3200,2672,528,0.999091488702521,0.942528735632184,5.96332737030411,306,127,179,-1,1.4,24,5.1,0,0,0,0,0,0,3.58151479074201e-06,0.0038790367096157,0.000389221508403354
24.3,"random_policy_SVM","SVM",20,32,10033,10033,0,3300,2772,528,0.999093282997381,0.942528735632184,5.96332737030411,307,127,180,1,1.4,24.75,5.2,0,0,0,0,0,0,3.14975393584339e-06,0.00338715676551225,0.000334154610069971
24.3,"random_policy_SVM","SVM",20,33,9933,9933,0,3400,2872,528,0.999095077292241,0.942528735632184,5.96332737030411,308,128,180,1,1.4,25.5,5.4,0,0,0,0,0,0,2.51107890970015e-06,0.00260847099735042,0.000262167958460591
24.3,"random_policy_SVM","SVM",20,34,9833,9833,0,3500,2972,528,0.999092086800808,0.938697318007663,5.95267857142857,309,128,181,1,1.4,26.25,5.6,0,0,0,0,0,0,1.93928041942943e-06,0.00195339016902388,0.000204045465211026
24.3,"random_policy_SVM","SVM",20,35,9733,9733,0,3600,3072,528,0.999094479193954,0.938697318007663,5.97937219730942,308,127,181,-1,1.4,27,5.8,0,0,0,0,0,0,2.3149766643274e-06,0.00237639266030118,0.000243893323825719
24.3,"random_policy_SVM","SVM",20,36,9633,9633,0,3700,3172,528,0.999089096309374,0.938697318007663,5.97937219730942,309,127,182,1,1.4,27.75,6,0,0,0,0,0,0,2.24193021462425e-06,0.00229769862993449,0.000235580083639625
24.3,"random_policy_SVM","SVM",20,37,9533,9533,0,3800,3272,528,0.999091488702521,0.938697318007663,5.97937219730942,308,128,180,-1,1.4,28.5,6.2,0,0,0,0,0,0,2.9478000216861e-06,0.00313179073774412,0.000309941510502396
24.3,"random_policy_SVM","SVM",20,38,9433,9433,0,3900,3372,528,0.999093282997381,0.938697318007663,5.97937219730942,308,127,181,0,1.4,29.25,6.4,0,0,0,0,0,0,1.78367082455452e-06,0.00180043101334143,0.000188985658631981
24.3,"random_policy_SVM","SVM",20,39,9333,9333,0,4000,3472,528,0.999091488702521,0.938697318007663,5.93149466192171,308,127,181,0,1.4,30,6.6,0,0,0,0,0,0,1.01153045939553e-06,0.000961038545317754,0.00010738669006113
24.3,"random_policy_SVM","SVM",20,40,9233,9233,0,4100,3572,528,0.999092684899094,0.938697318007663,5.97937219730942,309,128,181,1,1.4,30.75,6.8,0,0,0,0,0,0,1.31408390875054e-06,0.00130220701241561,0.000138748227356447
24.3,"random_policy_SVM","SVM",20,41,9133,9133,0,4200,3672,528,0.999083713424794,0.938697318007663,5.92622222222222,313,129,184,4,1.4,31.5,7,0,0,0,0,0,0,7.12356517357468e-07,0.000678861646799268,7.80020272219692e-05
24.3,"random_policy_SVM","SVM",20,42,9033,9033,0,4300,3772,528,0.999079526736787,0.938697318007663,5.94736842105263,311,129,182,-2,1.4,32.25,7.1,0,0,0,0,0,0,7.49212935851682e-07,0.00071953296402337,7.92692888359819e-05
24.3,"random_policy_SVM","SVM",20,43,8933,8933,0,4400,3872,528,0.999083713424794,0.938697318007663,5.94206773618538,311,129,182,0,1.4,33,7.3,0,0,0,0,0,0,7.11367764375679e-07,0.000669890918821689,7.51891833537421e-05
24.3,"random_policy_SVM","SVM",20,44,8833,8833,0,4500,3972,528,0.999080124835074,0.938697318007663,5.94736842105263,310,129,181,-1,1.4,33.75,7.5,0,0,0,0,0,0,6.6194132932747e-07,0.000614315458975717,6.94138133600436e-05
24.3,"random_policy_SVM","SVM",20,45,8733,8733,0,4600,4072,528,0.999075938147067,0.942528735632184,5.97937219730942,311,129,182,1,1.4,34.5,7.7,0,0,0,0,0,0,7.16018348539023e-07,0.00068226897428584,7.5755135859308e-05
24.3,"random_policy_SVM","SVM",20,46,8633,8633,0,4700,4172,528,0.99908251722822,0.942528735632184,5.97937219730942,310,129,181,-1,1.4,35.25,7.9,0,0,0,0,0,0,5.40196650974045e-07,0.000502931944427689,5.74971103376628e-05
24.3,"random_policy_SVM","SVM",20,47,8533,8533,0,4800,4272,528,0.999079526736787,0.942528735632184,5.91570541259982,311,129,182,1,1.4,36,8.1,0,0,0,0,0,0,3.27638265674605e-07,0.000291163831753121,3.47593926509885e-05
24.3,"random_policy_SVM","SVM",20,48,8433,8433,0,4900,4372,528,0.99908072293336,0.942528735632184,5.97937219730942,310,129,181,-1,1.4,36.75,8.3,0,0,0,0,0,0,3.79331918402572e-07,0.000350547302058151,4.08010163002842e-05
24.3,"max_tuv_SVM","SVM",1,0,13233,12713,520,100,94,6,0.942341763584092,0.85171102661597,5.23408148125971,32,6,26,0,4.3,0.75,15.7,0,0,0,0,0,0,0.999999996919012,1004.24022006763,99.9999998935655
24.3,"max_tuv_SVM","SVM",1,1,13133,12628,505,200,179,21,0.971281019704848,0.878326996197719,5.60816489893936,63,21,42,31,2,1.5,8.5,0,0,0,0,0,0,0.975253842823178,650.784749914313,98.5764601797245
24.3,"max_tuv_SVM","SVM",1,2,13033,12569,464,300,238,62,0.941971272707429,0.893536121673004,5.18920324320028,98,42,56,35,1.3,2.25,3.8,0,0,0,0,0,0,0.999996904428004,478.683684309121,99.9998899195213
24.3,"max_tuv_SVM","SVM",1,3,12933,12486,447,400,321,79,0.958510365432232,0.893536121673004,5.31564295405437,126,54,72,28,1.3,3,4.1,0,0,0,0,0,0,0.999999349894057,412.274863865039,99.9999741349159
24.3,"max_tuv_SVM","SVM",1,4,12833,12393,440,500,414,86,0.954764488924461,0.893536121673004,5.21972627538295,137,57,80,11,1.4,3.75,4.8,0,0,0,0,0,0,0.999999729045147,394.749912663222,99.9999888718263
24.3,"max_tuv_SVM","SVM",1,5,12733,12315,418,600,492,108,0.963688925410185,0.897338403041825,5.37927000231969,157,67,90,20,1.3,4.5,4.6,0,0,0,0,0,0,0.999999845857588,376.923910825106,99.9999939165983
24.3,"max_tuv_SVM","SVM",1,6,12633,12220,413,700,587,113,0.972120561531167,0.897338403041825,5.43844432754223,167,72,95,10,1.3,5.25,5.2,0,0,0,0,0,0,0.999999775266866,376.195635569461,99.9999910720826
24.3,"max_tuv_SVM","SVM",1,7,12533,12128,405,800,679,121,0.975837938740742,0.904942965779468,5.5175722566407,182,79,103,15,1.3,6,5.6,0,0,0,0,0,0,0.999999818229972,374.304968951047,99.9999924876627
24.3,"max_tuv_SVM","SVM",1,8,12433,12032,401,900,775,125,0.978605933078873,0.91254752851711,5.61842752089248,193,84,109,11,1.3,6.75,6.2,0,0,0,0,0,0,0.999999943687209,373.704544579374,99.9999977470604
24.3,"max_tuv_SVM","SVM",1,9,12333,11938,395,1000,869,131,0.978805428166339,0.931558935361217,5.67566539923954,214,90,124,21,1.4,7.5,6.6,0,0,0,0,0,0,0.999999941452292,378.507747005941,99.9999975754783
24.3,"max_tuv_SVM","SVM",1,10,12233,11844,389,1100,963,137,0.978754960659099,0.942965779467681,5.70596254549883,229,97,132,15,1.4,8.25,7,0,0,0,0,0,0,0.999999995448651,375.79484829688,99.9999998250126
24.3,"max_tuv_SVM","SVM",1,11,12133,11744,389,1200,1063,137,0.978286503444859,0.942965779467681,5.67064712744534,226,98,128,-3,1.3,9,7.8,0,0,0,0,0,0,0.99999999557576,373.710662310798,99.9999998291215
24.3,"max_tuv_SVM","SVM",1,12,12033,11644,389,1300,1163,137,0.97837318881023,0.942965779467681,5.67566539923954,226,97,129,0,1.3,9.75,8.5,0,0,0,0,0,0,0.999999985958536,374.190984953874,99.999999455258
24.3,"max_tuv_SVM","SVM",1,13,11933,11544,389,1400,1263,137,0.978240785820648,0.942965779467681,5.67566539923954,224,96,128,-2,1.3,10.5,9.2,0,0,0,0,0,0,0.999999997776185,370.057598529448,99.9999999189406
24.3,"max_tuv_SVM","SVM",1,14,11833,11444,389,1500,1363,137,0.97811253897873,0.942965779467681,5.67064712744534,225,97,128,1,1.3,11.25,9.9,0,0,0,0,0,0,0.999999999409556,367.553124522448,99.999999979203
24.3,"max_tuv_SVM","SVM",1,15,11733,11344,389,1600,1463,137,0.977903544125224,0.942965779467681,5.67064712744534,227,97,130,2,1.3,12,10.7,0,0,0,0,0,0,0.999999998780084,367.655393971665,99.9999999558799
24.3,"max_tuv_SVM","SVM",1,16,11633,11244,389,1700,1563,137,0.977697517948617,0.942965779467681,5.67064712744534,231,97,134,4,1.4,12.75,11.4,0,0,0,0,0,0,0.99999999971199,366.239486109053,99.9999999897647
24.3,"max_tuv_SVM","SVM",1,17,11533,11144,389,1800,1663,137,0.977534834454694,0.942965779467681,5.67064712744534,230,97,133,-1,1.4,13.5,12.1,0,0,0,0,0,0,0.999999999766652,365.481928597124,99.9999999918786
24.3,"max_tuv_SVM","SVM",1,18,11433,11044,389,1900,1763,137,0.977427368351042,0.942965779467681,5.66563772185573,230,97,133,0,1.4,14.25,12.9,0,0,0,0,0,0,0.999999999758119,365.006378036556,99.9999999918557
24.3,"max_tuv_SVM","SVM",1,19,11333,10944,389,2000,1863,137,0.977379275785318,0.942965779467681,5.66563772185573,230,97,133,0,1.4,15,13.6,0,0,0,0,0,0,0.999999999935707,364.49725817992,99.9999999979487
24.3,"max_tuv_SVM","SVM",1,20,11233,10844,389,2100,1963,137,0.977439243058625,0.942965779467681,5.66563772185573,229,97,132,-1,1.4,15.75,14.3,0,0,0,0,0,0,0.999999999932391,363.779361539367,99.9999999979093
24.3,"max_tuv_SVM","SVM",1,21,11133,10744,389,2200,2063,137,0.97750099153807,0.942965779467681,5.66563772185573,230,97,133,1,1.4,16.5,15.1,0,0,0,0,0,0,0.99999999990539,363.695044533873,99.9999999971947
24.3,"max_tuv_SVM","SVM",1,22,11033,10644,389,2300,2163,137,0.977565114959032,0.942965779467681,5.66563772185573,231,97,134,1,1.4,17.25,15.8,0,0,0,0,0,0,0.999999999809474,363.730629683662,99.9999999942693
24.3,"max_tuv_SVM","SVM",1,23,10933,10544,389,2400,2263,137,0.977702861567028,0.942965779467681,5.66563772185573,229,97,132,-2,1.4,18,16.5,0,0,0,0,0,0,0.999999999268786,364.343704206439,99.9999999765702
24.3,"max_tuv_SVM","SVM",1,24,10833,10444,389,2500,2363,137,0.97801457264115,0.942965779467681,5.66063715899443,228,97,131,-1,1.4,18.75,17.2,0,0,0,0,0,0,0.999999999980722,362.85213799992,99.9999999994342
24.3,"max_tuv_SVM","SVM",1,25,10733,10348,385,2600,2459,141,0.98563813491092,0.939163498098859,5.71326682433595,232,101,131,4,1.3,19.5,17.4,0,0,0,0,0,0,0.999999999907605,360.584791927609,99.9999999969469
24.3,"max_tuv_SVM","SVM",1,26,10633,10254,379,2700,2553,147,0.997687400697757,0.939163498098859,5.88638823863713,251,107,144,19,1.3,20.25,17.4,0,0,0,0,0,0,0.999999999986497,362.601444091356,99.9999999995712
24.3,"max_tuv_SVM","SVM",1,27,10533,10172,361,2800,2635,165,0.999627134181821,0.942965779467681,5.9052258635961,294,124,170,43,1.4,21,16,0,0,0,0,0,0,0.999999999959994,363.096730076382,99.9999999987499
24.3,"max_tuv_SVM","SVM",1,28,10433,10075,358,2900,2732,168,0.999598634883616,0.942965779467681,5.88957597173145,296,126,170,2,1.3,21.75,16.3,0,0,0,0,0,0,0.999999999989816,361.629049932788,99.999999999659
24.3,"max_tuv_SVM","SVM",1,29,10333,9975,358,3000,2832,168,0.999568948114653,0.942965779467681,5.9,298,127,171,2,1.3,22.5,16.9,0,0,0,0,0,0,0.999999999989555,361.158542029363,99.9999999996438
24.3,"max_tuv_SVM","SVM",1,30,10233,9875,358,3100,2932,168,0.999558854613205,0.939163498098859,5.88957597173145,300,129,171,2,1.3,23.25,17.5,0,0,0,0,0,0,0.999999999995939,360.71570880733,99.9999999998627
24.3,"max_tuv_SVM","SVM",1,31,10133,9775,358,3200,3032,168,0.999548167376378,0.939163498098859,5.832895888014,301,129,172,1,1.3,24,18,0,0,0,0,0,0,0.999999999999098,360.218209887734,99.9999999999701
24.3,"max_tuv_SVM","SVM",1,32,10033,9675,358,3300,3132,168,0.999536292668793,0.939163498098859,5.88957597173145,301,130,171,0,1.3,24.75,18.6,0,0,0,0,0,0,0.999999999991893,360.563881946276,99.9999999997232
24.3,"max_tuv_SVM","SVM",1,33,9933,9575,358,3400,3232,168,0.999521449284311,0.939163498098859,5.8585237258348,305,130,175,4,1.3,25.5,19.2,0,0,0,0,0,0,0.999999999998363,360.051460000724,99.9999999999459
24.3,"max_tuv_SVM","SVM",1,34,9833,9475,358,3500,3332,168,0.999521449284311,0.939163498098859,5.8636763412489,304,130,174,-1,1.3,26.25,19.8,0,0,0,0,0,0,0.999999999997833,359.899752665488,99.9999999999296
24.3,"max_tuv_SVM","SVM",1,35,9733,9375,358,3600,3432,168,0.999505418429071,0.939163498098859,5.8277972027972,306,130,176,2,1.4,27,20.4,0,0,0,0,0,0,0.999999999999365,359.41332115607,99.9999999999797
24.3,"max_tuv_SVM","SVM",1,36,9633,9275,358,3700,3532,168,0.99950660589983,0.939163498098859,5.85338015803336,304,129,175,-2,1.4,27.75,21,0,0,0,0,0,0,0.999999999998114,359.718819180753,99.999999999941
24.3,"max_tuv_SVM","SVM",1,37,9533,9175,358,3800,3632,168,0.999494731192244,0.939163498098859,5.8585237258348,306,130,176,2,1.4,28.5,21.6,0,0,0,0,0,0,0.999999999997857,359.537535054481,99.9999999999333
24.3,"max_tuv_SVM","SVM",1,38,9433,9075,358,3900,3732,168,0.99948998130921,0.939163498098859,5.83800350262697,307,129,178,1,1.4,29.25,22.2,0,0,0,0,0,0,0.999999999998867,359.267949733254,99.9999999999653
24.3,"max_tuv_SVM","SVM",1,39,9333,8975,358,4000,3832,168,0.999478700337004,0.939163498098859,5.88957597173145,308,130,178,1,1.4,30,22.8,0,0,0,0,0,0,0.999999999994927,359.488719206086,99.9999999998407
24.3,"max_tuv_SVM","SVM",1,40,9233,8875,358,4100,3932,168,0.999477512866246,0.939163498098859,5.83800350262697,305,130,175,-3,1.3,30.75,23.4,0,0,0,0,0,0,0.999999999998735,359.037220122088,99.999999999961
24.3,"max_tuv_SVM","SVM",1,41,9133,8775,358,4200,4032,168,0.999486418896935,0.939163498098859,5.832895888014,306,130,176,1,1.4,31.5,24,0,0,0,0,0,0,0.999999999998927,358.962178199941,99.9999999999665
24.3,"max_tuv_SVM","SVM",1,42,9033,8675,358,4300,4132,168,0.999488200103072,0.939163498098859,5.88957597173145,307,130,177,1,1.4,32.25,24.6,0,0,0,0,0,0,0.999999999993783,359.091119494449,99.9999999998002
24.3,"max_tuv_SVM","SVM",1,43,8933,8575,358,4400,4232,168,0.99948998130921,0.939163498098859,5.8277972027972,304,130,174,-3,1.3,33,25.2,0,0,0,0,0,0,0.999999999999123,358.807642539645,99.9999999999722
24.3,"max_tuv_SVM","SVM",1,44,8833,8475,358,4500,4332,168,0.99949057504459,0.939163498098859,5.87918871252205,305,130,175,1,1.3,33.75,25.8,0,0,0,0,0,0,0.999999999997318,358.97127071358,99.9999999999133
24.3,"max_tuv_SVM","SVM",1,45,8733,8375,358,4600,4432,168,0.999494137456865,0.939163498098859,5.88437775816417,305,130,175,0,1.3,34.5,26.4,0,0,0,0,0,0,0.999999999996757,358.878982682268,99.9999999998955
24.3,"max_tuv_SVM","SVM",1,46,8633,8275,358,4700,4532,168,0.999494731192244,0.939163498098859,5.84824561403509,304,130,174,-1,1.3,35.25,27,0,0,0,0,0,0,0.999999999998738,358.712037864327,99.9999999999597
24.3,"max_tuv_SVM","SVM",1,47,8533,8175,358,4800,4632,168,0.999494731192244,0.939163498098859,5.87400881057269,303,129,174,-1,1.3,36,27.6,0,0,0,0,0,0,0.999999999997608,358.757179452515,99.9999999999233
24.3,"max_tuv_SVM","SVM",1,48,8433,8075,358,4900,4732,168,0.999497699869141,0.939163498098859,5.85338015803336,301,129,172,-2,1.3,36.75,28.2,0,0,0,0,0,0,0.999999999998382,358.710861286946,99.9999999999476
24.3,"max_tuv_SVM","SVM",2,0,13233,12702,531,100,90,10,0.946111342837974,0.782258064516129,5.24323242915091,24,8,16,0,2,0.75,9,0,0,0,0,0,0,0.995984091137334,691.500948752757,99.8669048063219
24.3,"max_tuv_SVM","SVM",2,1,13133,12625,508,200,167,33,0.972996622928904,0.915322580645161,5.45115866271594,64,26,38,40,1.5,1.5,5.1,0,0,0,0,0,0,0.987962951552888,482.053002178463,99.302998081147
24.3,"max_tuv_SVM","SVM",2,2,13033,12583,450,300,209,91,0.969074923739483,0.923387096774194,5.39061449932796,116,53,63,52,1.2,2.25,2.3,0,0,0,0,0,0,0.996158874726505,442.007527744591,99.853254323529
24.3,"max_tuv_SVM","SVM",2,3,12933,12510,423,400,282,118,0.970149731894717,0.923387096774194,5.418472346244,141,64,77,25,1.2,3,2.4,0,0,0,0,0,0,0.999999805541611,364.32872037188,99.9999923516985
24.3,"max_tuv_SVM","SVM",2,4,12833,12411,422,500,381,119,0.969644678851584,0.923387096774194,5.35805686214479,144,62,82,3,1.3,3.75,3.2,0,0,0,0,0,0,0.999999864734877,361.476679412992,99.9999951260342
24.3,"max_tuv_SVM","SVM",2,5,12733,12331,402,600,461,139,0.974269934518986,0.923387096774194,5.53063046034946,158,72,86,14,1.2,4.5,3.3,0,0,0,0,0,0,0.999999820555746,341.600048273912,99.99999331021
24.3,"max_tuv_SVM","SVM",2,6,12633,12234,399,700,558,142,0.976731125841129,0.923387096774194,5.51626518642648,168,71,97,10,1.4,5.25,3.9,0,0,0,0,0,0,0.999999675721131,339.441051808535,99.9999871194207
24.3,"max_tuv_SVM","SVM",2,7,12533,12137,396,800,655,145,0.977574137263864,0.923387096774194,5.52583372968134,174,77,97,6,1.3,6,4.5,0,0,0,0,0,0,0.999999751185843,337.009515639258,99.9999901107434
24.3,"max_tuv_SVM","SVM",2,8,12433,12041,392,900,751,149,0.977662081823612,0.923387096774194,5.52583372968134,177,77,100,3,1.3,6.75,5,0,0,0,0,0,0,0.999999795860514,331.912727251503,99.9999917590837
24.3,"max_tuv_SVM","SVM",2,9,12333,11949,384,1000,843,157,0.978145148726805,0.923387096774194,5.55473957307984,176,76,100,-1,1.3,7.5,5.4,0,0,0,0,0,0,0.999999797536305,323.53783796439,99.9999916855598
24.3,"max_tuv_SVM","SVM",2,10,12233,11849,384,1100,943,157,0.978351818442215,0.923387096774194,5.58792083392027,175,76,99,-1,1.3,8.25,6,0,0,0,0,0,0,0.999999851614719,323.373595703962,99.9999939676585
24.3,"max_tuv_SVM","SVM",2,11,12133,11750,383,1200,1042,158,0.979357527300478,0.923387096774194,5.59280538010377,176,77,99,1,1.3,9,6.6,0,0,0,0,0,0,0.999999842357178,323.146068847652,99.9999935405884
24.3,"max_tuv_SVM","SVM",2,12,12033,11698,335,1300,1094,206,0.980059827427626,0.923387096774194,5.61630456237311,174,78,96,-2,1.2,9.75,5.3,0,0,0,0,0,0,0.999678540330343,273.856738897939,99.9810049706582
24.3,"max_tuv_SVM","SVM",2,13,11933,11696,237,1400,1096,304,0.980051032971653,0.923387096774194,5.61139949288632,179,80,99,5,1.2,10.5,3.6,0,0,0,0,0,0,0.999700400097108,175.957564748728,99.9820900282847
24.3,"max_tuv_SVM","SVM",2,14,11833,11696,137,1500,1096,404,0.980010201568913,0.923387096774194,5.60161501251512,177,78,99,-2,1.3,11.25,2.7,0,0,0,0,0,0,1.02186218990096e-05,76.0006574055256,75.995000426366
24.3,"max_tuv_SVM","SVM",2,15,11733,11675,58,1600,1117,483,0.982510967942901,0.923387096774194,5.69816934774591,181,79,102,4,1.3,12,2.3,0,0,0,0,0,0,0.00309928821170592,0.939054725584894,0.396972363031466
24.3,"max_tuv_SVM","SVM",2,16,11633,11581,52,1700,1211,489,0.983232741508261,0.92741935483871,5.73695027592877,198,88,110,17,1.2,12.75,2.5,0,0,0,0,0,0,0.00495986556913493,3.61376354789473,0.613050397633098
24.3,"max_tuv_SVM","SVM",2,17,11533,11492,41,1800,1300,500,0.982535466784526,0.955645161290323,5.72685001135847,224,98,126,26,1.3,13.5,2.6,0,0,0,0,0,0,0.0111659499852439,9.91378235037973,1.85017448608512
24.3,"max_tuv_SVM","SVM",2,18,11433,11400,33,1900,1392,508,0.981805526938599,0.963709677419355,5.73695027592877,240,107,133,16,1.2,14.25,2.7,0,0,0,0,0,0,0.00922815402632826,5.90977561381827,1.29074431796274
24.3,"max_tuv_SVM","SVM",2,19,11333,11301,32,2000,1491,509,0.98149458010234,0.963709677419355,5.71176612195191,245,109,136,5,1.2,15,2.9,0,0,0,0,0,0,0.00648161910695598,3.64294640463076,0.765633144946666
24.3,"max_tuv_SVM","SVM",2,20,11233,11201,32,2100,1591,509,0.98128351315894,0.963709677419355,5.7067558007923,246,105,141,1,1.3,15.75,3.1,0,0,0,0,0,0,0.00409181001757499,1.70353072430751,0.455935251352973
24.3,"max_tuv_SVM","SVM",2,21,11133,11101,32,2200,1691,509,0.981163531652423,0.963709677419355,5.7067558007923,247,105,142,1,1.4,16.5,3.3,0,0,0,0,0,0,0.0034353477315607,1.03612861143579,0.372006023961107
24.3,"max_tuv_SVM","SVM",2,22,11033,11001,32,2300,1791,509,0.981052972777309,0.963709677419355,5.7067558007923,248,105,143,1,1.4,17.25,3.5,0,0,0,0,0,0,0.00293003865887728,0.618864680048804,0.316973026830967
24.3,"max_tuv_SVM","SVM",2,23,10933,10901,32,2400,1891,509,0.980932363095366,0.963709677419355,5.70175426196602,253,107,146,5,1.4,18,3.7,0,0,0,0,0,0,1.54729044025451e-05,0.0673001072154742,0.0581452552982075
24.3,"max_tuv_SVM","SVM",2,24,10833,10801,32,2500,1991,509,0.980853212991591,0.963709677419355,5.70175426196602,252,107,145,-1,1.4,18.75,3.9,0,0,0,0,0,0,1.50326177550765e-05,0.0109489183716716,0.00165405587617119
24.3,"max_tuv_SVM","SVM",2,25,10733,10701,32,2600,2091,509,0.980748307695317,0.963709677419355,5.68680210918114,252,107,145,0,1.4,19.5,4.1,0,0,0,0,0,0,1.48345776064878e-05,0.0143750559916043,0.00421067551125143
24.3,"max_tuv_SVM","SVM",2,26,10633,10601,32,2700,2191,509,0.980620159908253,0.963709677419355,5.68680210918114,254,108,146,2,1.4,20.25,4.3,0,0,0,0,0,0,7.65714102268072e-06,0.00602320767903267,0.000850311887820855
24.3,"max_tuv_SVM","SVM",2,27,10533,10501,32,2800,2291,509,0.980545407032465,0.963709677419355,5.68680210918114,253,108,145,-1,1.3,21,4.5,0,0,0,0,0,0,6.43849264924264e-06,0.0052379700573882,0.000703336798490503
24.3,"max_tuv_SVM","SVM",2,28,10433,10401,32,2900,2391,509,0.980509601033138,0.963709677419355,5.68183546978448,252,108,144,-1,1.3,21.75,4.7,0,0,0,0,0,0,4.0263696426489e-06,0.00326069190393358,0.000438144115529659
24.3,"max_tuv_SVM","SVM",2,29,10333,10301,32,3000,2491,509,0.980505203805151,0.963709677419355,5.68680210918114,253,108,145,1,1.3,22.5,4.9,0,0,0,0,0,0,5.85583242704421e-06,0.00493080642660422,0.000632696730363432
24.3,"max_tuv_SVM","SVM",2,30,10233,10201,32,3100,2591,509,0.980549176085026,0.963709677419355,5.69177743911043,251,108,143,-2,1.3,23.25,5.1,0,0,0,0,0,0,3.64342840465158e-06,0.00308335744997524,0.000401585361920422
24.3,"max_tuv_SVM","SVM",2,31,10133,10101,32,3200,2691,509,0.980534099874783,0.963709677419355,5.69177743911043,249,107,142,-2,1.3,24,5.3,0,0,0,0,0,0,2.91448157624048e-06,0.0025541350218238,0.000316416311110675
24.3,"max_tuv_SVM","SVM",2,32,10033,10001,32,3300,2791,509,0.980528446295942,0.963709677419355,5.69177743911043,249,107,142,0,1.3,24.75,5.5,0,0,0,0,0,0,2.47210973621377e-06,0.00210648042089315,0.000265284426458367
24.3,"max_tuv_SVM","SVM",2,33,9933,9901,32,3400,2891,509,0.980525305418808,0.963709677419355,5.69177743911043,249,107,142,0,1.3,25.5,5.7,0,0,0,0,0,0,1.64855540935039e-06,0.00141789169714905,0.000177480828431703
24.3,"max_tuv_SVM","SVM",2,34,9833,9801,32,3500,2991,509,0.980508972857712,0.963709677419355,5.67687749817035,251,107,144,2,1.3,26.25,5.9,0,0,0,0,0,0,1.16834830403054e-06,0.00101042932801094,0.000128846096002812
24.3,"max_tuv_SVM","SVM",2,35,9733,9701,32,3600,3091,509,0.980510229208565,0.963709677419355,5.69177743911043,250,107,143,-1,1.3,27,6.1,0,0,0,0,0,0,2.03351314536344e-06,0.00184407352481658,0.000216140050315672
24.3,"max_tuv_SVM","SVM",2,36,9633,9601,32,3700,3191,509,0.980494524822896,0.963709677419355,5.68680210918114,250,107,143,0,1.3,27.75,6.3,0,0,0,0,0,0,1.02052149854079e-06,0.000894341727172976,0.000109800239588011
24.3,"max_tuv_SVM","SVM",2,37,9533,9501,32,3800,3291,509,0.980517767313687,0.963709677419355,5.68183546978448,250,107,143,0,1.3,28.5,6.5,0,0,0,0,0,0,7.35195725193772e-07,0.000637339437304995,7.82833638667566e-05
24.3,"max_tuv_SVM","SVM",2,38,9433,9402,31,3900,3390,510,0.983200704561492,0.963709677419355,5.69177743911043,252,108,144,2,1.3,29.25,6.6,0,0,0,0,0,0,1.36258687635639e-06,0.0168231642537662,0.015682173979562
24.3,"max_tuv_SVM","SVM",2,39,9333,9307,26,4000,3485,515,0.994511631296187,0.963709677419355,5.78257313999264,268,112,156,16,1.4,30,6.8,0,0,0,0,0,0,2.47468475815533e-06,1.79634643562623,1.79500075761032
24.3,"max_tuv_SVM","SVM",2,40,9233,9227,6,4100,3565,535,0.999845468845012,0.971774193548387,5.84312007011393,316,133,183,48,1.4,30.75,6.7,0,0,0,0,0,0,1.35390480782868e-05,2.51115721031629,2.50703825141645
24.3,"max_tuv_SVM","SVM",2,41,9133,9133,0,4200,3659,541,0.999859916879828,0.971774193548387,5.832895888014,328,139,189,12,1.4,31.5,6.8,0,0,0,0,0,0,4.53639775685911e-06,0.0477788656298954,0.0453400429998294
24.3,"max_tuv_SVM","SVM",2,42,9033,9033,0,4300,3759,541,0.999856147827267,0.971774193548387,5.85338015803336,329,139,190,1,1.4,32.25,6.9,0,0,0,0,0,0,3.71498959994e-06,0.00320276642692035,0.000440552430744212
24.3,"max_tuv_SVM","SVM",2,43,8933,8933,0,4400,3859,541,0.999850494248426,0.971774193548387,5.85338015803336,335,141,194,6,1.4,33,7.1,0,0,0,0,0,0,2.42826972382902e-06,0.00209132075679116,0.000287216008312711
24.3,"max_tuv_SVM","SVM",2,44,8833,8833,0,4500,3959,541,0.999848609722145,0.971774193548387,5.8585237258348,336,140,196,1,1.4,33.75,7.3,0,0,0,0,0,0,2.16972947362542e-06,0.00204709372366102,0.000240501263534613
24.3,"max_tuv_SVM","SVM",2,45,8733,8733,0,4600,4059,541,0.999846097020438,0.971774193548387,5.80243690165361,335,139,196,-1,1.4,34.5,7.5,0,0,0,0,0,0,6.29140648590986e-07,0.000540491184283463,6.85183479112267e-05
24.3,"max_tuv_SVM","SVM",2,46,8633,8633,0,4700,4159,541,0.999846097020438,0.971774193548387,5.8585237258348,335,139,196,0,1.4,35.25,7.7,0,0,0,0,0,0,1.99056362454961e-06,0.00195435661369292,0.000212488366526469
24.3,"max_tuv_SVM","SVM",2,47,8533,8533,0,4800,4259,541,0.999844212494158,0.971774193548387,5.84312007011393,336,139,197,1,1.4,36,7.9,0,0,0,0,0,0,7.86753000576568e-07,0.000734227075572317,8.4568372814027e-05
24.3,"max_tuv_SVM","SVM",2,48,8433,8433,0,4900,4359,541,0.999844212494158,0.971774193548387,5.85338015803336,337,139,198,1,1.4,36.75,8.1,0,0,0,0,0,0,9.6131768679651e-07,0.000931099095566128,0.000102059045162843
24.3,"max_tuv_SVM","SVM",3,0,13233,12728,505,100,95,5,0.959547808054075,0.842293906810036,5.31253178058067,30,5,25,0,5,0.75,19,0,0,0,0,0,0,0.999993137490236,743.087079222836,99.9998100023469
24.3,"max_tuv_SVM","SVM",3,1,13133,12664,469,200,159,41,0.976349584682721,0.881720430107527,5.52897382978523,60,22,38,30,1.7,1.5,3.9,0,0,0,0,0,0,0.999983135105598,558.893532236619,99.9993787572964
24.3,"max_tuv_SVM","SVM",3,2,13033,12620,413,300,203,97,0.966189405314159,0.899641577060932,5.39055399113391,98,47,51,38,1.1,2.25,2.1,0,0,0,0,0,0,0.99999097589156,385.701923556076,99.9997447795198
24.3,"max_tuv_SVM","SVM",3,3,12933,12539,394,400,284,116,0.958327441910561,0.903225806451613,5.25051779092409,127,58,69,29,1.2,3,2.4,0,0,0,0,0,0,0.999999778353592,339.265651460057,99.9999933150006
24.3,"max_tuv_SVM","SVM",3,4,12833,12454,379,500,369,131,0.958105812197141,0.903225806451613,5.19836845138484,143,61,82,16,1.3,3.75,2.8,0,0,0,0,0,0,0.999999993204217,321.620817783829,99.9999997885292
24.3,"max_tuv_SVM","SVM",3,5,12733,12356,377,600,467,133,0.960139194681772,0.903225806451613,5.24597974616097,143,64,79,0,1.2,4.5,3.5,0,0,0,0,0,0,0.999999995772262,318.803575095893,99.9999998703454
24.3,"max_tuv_SVM","SVM",3,6,12633,12256,377,700,567,133,0.961603072966106,0.903225806451613,5.23692714953257,146,65,81,3,1.2,5.25,4.3,0,0,0,0,0,0,0.999999994969879,318.71833708652,99.9999998404684
24.3,"max_tuv_SVM","SVM",3,7,12533,12156,377,800,667,133,0.96323808305448,0.903225806451613,5.25506369377337,144,64,80,-2,1.2,6,5,0,0,0,0,0,0,0.999999994802637,318.501295478267,99.9999998349389
24.3,"max_tuv_SVM","SVM",3,8,12433,12056,377,900,767,133,0.964703083514571,0.903225806451613,5.27332629566311,150,67,83,6,1.2,6.75,5.8,0,0,0,0,0,0,0.999999995387082,318.276418284793,99.99999986192
24.3,"max_tuv_SVM","SVM",3,9,12333,11956,377,1000,867,133,0.965508244625352,0.903225806451613,5.27575292091421,147,66,81,-3,1.2,7.5,6.5,0,0,0,0,0,0,0.999999991624161,318.272715598896,99.9999997270209
24.3,"max_tuv_SVM","SVM",3,10,12233,11857,376,1100,966,134,0.967642061840865,0.903225806451613,5.3240998094026,151,68,83,4,1.2,8.25,7.2,0,0,0,0,0,0,0.99999999217806,318.453954373444,99.99999975986
24.3,"max_tuv_SVM","SVM",3,11,12133,11764,369,1200,1059,141,0.970601800418805,0.906810035842294,5.41395049283154,171,77,94,20,1.2,9,7.5,0,0,0,0,0,0,0.999999979261674,318.152253984474,99.9999992666941
24.3,"max_tuv_SVM","SVM",3,12,12033,11674,359,1300,1149,151,0.966046888992102,0.910394265232975,5.41395049283154,189,86,103,18,1.2,9.75,7.6,0,0,0,0,0,0,0.999999991699226,318.752198300107,99.9999997199403
24.3,"max_tuv_SVM","SVM",3,13,11933,11585,348,1400,1238,162,0.965461113243229,0.921146953405018,5.40925495901295,214,96,118,25,1.2,10.5,7.6,0,0,0,0,0,0,0.99999999963856,318.208615737258,99.9999999884871
24.3,"max_tuv_SVM","SVM",3,14,11833,11487,346,1500,1336,164,0.964827645024357,0.921146953405018,5.38589893587386,219,97,122,5,1.3,11.25,8.1,0,0,0,0,0,0,0.999999999038123,318.255446298638,99.9999999700073
24.3,"max_tuv_SVM","SVM",3,15,11733,11388,345,1600,1435,165,0.966899742572858,0.921146953405018,5.41120745470147,221,98,123,2,1.3,12,8.7,0,0,0,0,0,0,0.999999999740346,318.200840287374,99.9999999919261
24.3,"max_tuv_SVM","SVM",3,16,11633,11288,345,1700,1535,165,0.967194874798826,0.921146953405018,5.42057751090009,220,98,122,-1,1.2,12.75,9.3,0,0,0,0,0,0,0.999999999800244,318.041593373803,99.9999999935967
24.3,"max_tuv_SVM","SVM",3,17,11533,11188,345,1800,1635,165,0.967414260160715,0.921146953405018,5.42248756034278,220,98,122,0,1.2,13.5,9.9,0,0,0,0,0,0,0.999999999906112,317.614649065787,99.9999999973002
24.3,"max_tuv_SVM","SVM",3,18,11433,11088,345,1900,1735,165,0.967685826695636,0.921146953405018,5.43186091826904,220,97,123,0,1.3,14.25,10.5,0,0,0,0,0,0,0.999999999801072,317.68878022306,99.9999999940536
24.3,"max_tuv_SVM","SVM",3,19,11333,10988,345,2000,1835,165,0.967451853048811,0.921146953405018,5.43186091826904,220,97,123,0,1.3,15,11.1,0,0,0,0,0,0,0.999999999676526,317.646980119235,99.9999999908194
24.3,"max_tuv_SVM","SVM",3,20,11233,10888,345,2100,1935,165,0.96759829698603,0.921146953405018,5.43186091826904,219,96,123,-1,1.3,15.75,11.7,0,0,0,0,0,0,0.999999999556238,317.673725815029,99.9999999868126
24.3,"max_tuv_SVM","SVM",3,21,11133,10788,345,2200,2035,165,0.968130769386113,0.921146953405018,5.4525143818366,219,96,123,0,1.3,16.5,12.3,0,0,0,0,0,0,0.999999999561387,317.772050791656,99.9999999864486
24.3,"max_tuv_SVM","SVM",3,22,11033,10688,345,2300,2135,165,0.967763256823358,0.921146953405018,5.4525143818366,220,96,124,1,1.3,17.25,12.9,0,0,0,0,0,0,0.999999999773581,317.431877837364,99.9999999931156
24.3,"max_tuv_SVM","SVM",3,23,10933,10588,345,2400,2235,165,0.968093737585896,0.921146953405018,5.4525143818366,217,96,121,-3,1.3,18,13.5,0,0,0,0,0,0,0.999999999433248,317.522235242676,99.9999999829082
24.3,"max_tuv_SVM","SVM",3,24,10833,10489,344,2500,2334,166,0.97100915022116,0.921146953405018,5.45723108977937,221,98,123,4,1.3,18.75,14.1,0,0,0,0,0,0,0.999999998936116,317.846947613223,99.9999999652006
24.3,"max_tuv_SVM","SVM",3,25,10733,10390,343,2600,2433,167,0.974422247807823,0.924731182795699,5.47316784540416,228,101,127,7,1.3,19.5,14.6,0,0,0,0,0,0,0.999999998310634,318.142400987886,99.9999999468026
24.3,"max_tuv_SVM","SVM",3,26,10633,10292,341,2700,2531,169,0.979010263419523,0.924731182795699,5.46372320718949,231,102,129,3,1.3,20.25,15,0,0,0,0,0,0,0.999999999267204,318.567478678571,99.9999999771656
24.3,"max_tuv_SVM","SVM",3,27,10533,10194,339,2800,2629,171,0.983285191993052,0.924731182795699,5.5336056477259,243,107,136,12,1.3,21,15.4,0,0,0,0,0,0,0.999999995911816,320.275963635775,99.9999998502756
24.3,"max_tuv_SVM","SVM",3,28,10433,10097,336,2900,2726,174,0.988180122676248,0.924731182795699,5.62505273223275,252,112,140,9,1.2,21.75,15.7,0,0,0,0,0,0,0.999999998943758,321.062360394666,99.9999999616695
24.3,"max_tuv_SVM","SVM",3,29,10333,10002,331,3000,2821,179,0.992683975105648,0.924731182795699,5.73757577477043,262,116,146,10,1.3,22.5,15.8,0,0,0,0,0,0,0.999999999730805,323.840415935,99.9999999907393
24.3,"max_tuv_SVM","SVM",3,30,10233,9904,329,3100,2919,181,0.994227527869231,0.92831541218638,5.80513760654534,265,118,147,3,1.2,23.25,16.1,0,0,0,0,0,0,0.999999999862221,323.676377821543,99.9999999958151
24.3,"max_tuv_SVM","SVM",3,31,10133,9808,325,3200,3015,185,0.99652686600997,0.92831541218638,5.84735678913839,280,121,159,15,1.3,24,16.3,0,0,0,0,0,0,0.999999999931269,323.322609969056,99.9999999977008
24.3,"max_tuv_SVM","SVM",3,32,10033,9712,321,3300,3111,189,0.997732082780662,0.931899641577061,5.93134280593958,298,125,173,18,1.4,24.75,16.5,0,0,0,0,0,0,0.999999999983215,323.828592503188,99.9999999994534
24.3,"max_tuv_SVM","SVM",3,33,9933,9613,320,3400,3210,190,0.998078835091783,0.931899641577061,5.93134280593958,302,126,176,4,1.4,25.5,16.9,0,0,0,0,0,0,0.999999999948534,323.563434091905,99.9999999982734
24.3,"max_tuv_SVM","SVM",3,34,9833,9516,317,3500,3307,193,0.999193716713461,0.931899641577061,5.96332737030411,304,129,175,2,1.4,26.25,17.1,0,0,0,0,0,0,0.99999999989284,323.907873595825,99.9999999963492
24.3,"max_tuv_SVM","SVM",3,35,9733,9416,317,3600,3407,193,0.999225137634858,0.931899641577061,5.9579982126899,303,130,173,-1,1.3,27,17.7,0,0,0,0,0,0,0.999999999987529,322.06369413568,99.999999999592
24.3,"max_tuv_SVM","SVM",3,36,9633,9316,317,3700,3507,193,0.999240848095555,0.931899641577061,5.94736842105263,302,129,173,-1,1.3,27.75,18.2,0,0,0,0,0,0,0.999999999993677,320.960595139794,99.9999999997981
24.3,"max_tuv_SVM","SVM",3,37,9533,9216,317,3800,3607,193,0.999258802907782,0.931899641577061,5.94736842105263,303,129,174,1,1.3,28.5,18.7,0,0,0,0,0,0,0.99999999999505,320.890006823817,99.9999999998426
24.3,"max_tuv_SVM","SVM",3,38,9433,9116,317,3900,3707,193,0.999273952280598,0.931899641577061,5.9052258635961,304,129,175,1,1.4,29.25,19.2,0,0,0,0,0,0,0.999999999998016,320.142728818607,99.9999999999393
24.3,"max_tuv_SVM","SVM",3,39,9333,9016,317,4000,3807,193,0.999285174038239,0.931899641577061,5.94206773618538,304,129,175,0,1.4,30,19.7,0,0,0,0,0,0,0.999999999996988,319.814505755867,99.9999999999073
24.3,"max_tuv_SVM","SVM",3,40,9233,8916,317,4100,3907,193,0.999294151444353,0.931899641577061,5.9,304,129,175,0,1.4,30.75,20.2,0,0,0,0,0,0,0.999999999997937,319.38599738807,99.9999999999377
24.3,"max_tuv_SVM","SVM",3,41,9133,8816,317,4200,4007,193,0.999302567762584,0.931899641577061,5.94736842105263,305,129,176,1,1.4,31.5,20.8,0,0,0,0,0,0,0.999999999987039,319.574309715207,99.9999999995977
24.3,"max_tuv_SVM","SVM",3,42,9033,8716,317,4300,4107,193,0.999312667344461,0.931899641577061,5.93149466192171,308,129,179,3,1.4,32.25,21.3,0,0,0,0,0,0,0.999999999994878,319.197572537038,99.9999999998453
24.3,"max_tuv_SVM","SVM",3,43,8933,8616,317,4400,4207,193,0.999323889102102,0.931899641577061,5.92622222222222,308,129,179,0,1.4,33,21.8,0,0,0,0,0,0,0.999999999997202,318.839514405552,99.9999999999155
24.3,"max_tuv_SVM","SVM",3,44,8833,8516,317,4500,4307,193,0.999330622156687,0.931899641577061,5.9686660698299,310,129,181,2,1.4,33.75,22.3,0,0,0,0,0,0,0.999999999968123,319.112440868394,99.999999998983
24.3,"max_tuv_SVM","SVM",3,45,8733,8416,317,4600,4407,193,0.999341843914329,0.931899641577061,5.79235447437011,307,129,178,-3,1.4,34.5,22.8,0,0,0,0,0,0,0.99999999999961,318.228590751718,99.9999999999877
24.3,"max_tuv_SVM","SVM",3,46,8633,8316,317,4700,4507,193,0.99935306567197,0.931899641577061,5.83800350262697,306,129,177,-1,1.4,35.25,23.4,0,0,0,0,0,0,0.999999999999224,318.130517374533,99.9999999999762
24.3,"max_tuv_SVM","SVM",3,47,8533,8216,317,4800,4607,193,0.999360359814437,0.931899641577061,5.80243690165361,307,129,178,1,1.4,36,23.9,0,0,0,0,0,0,0.999999999999588,317.94177007293,99.9999999999869
24.3,"max_tuv_SVM","SVM",3,48,8433,8116,317,4900,4707,193,0.999373264835725,0.931899641577061,5.9,308,129,179,1,1.4,36.75,24.4,0,0,0,0,0,0,0.999999999993461,318.304654115622,99.9999999997919
24.3,"max_tuv_SVM","SVM",4,0,13233,12728,505,100,94,6,0.971594613493727,0.852517985611511,5.47142111485637,35,6,29,0,4.8,0.75,15.7,0,0,0,0,0,0,0.875501141926619,1022.68582891835,94.3625055975028
24.3,"max_tuv_SVM","SVM",4,1,13133,12692,441,200,130,70,0.971250046449025,0.888489208633094,5.47438432046286,81,37,44,46,1.2,1.5,1.9,0,0,0,0,0,0,0.989074677906706,572.2020119679,99.4082678317097
24.3,"max_tuv_SVM","SVM",4,2,13033,12606,427,300,216,84,0.946744122936112,0.888489208633094,5.17911672396688,119,53,66,38,1.2,2.25,2.6,0,0,0,0,0,0,0.99712745803933,427.237570447743,99.9532115825569
24.3,"max_tuv_SVM","SVM",4,3,12933,12526,407,400,296,104,0.955431491401006,0.888489208633094,5.2873732510055,142,60,82,23,1.4,3,2.8,0,0,0,0,0,0,0.99999928876442,375.574346026166,99.9999730773198
24.3,"max_tuv_SVM","SVM",4,4,12833,12444,389,500,378,122,0.95700062269795,0.888489208633094,5.2873732510055,147,67,80,5,1.2,3.75,3.1,0,0,0,0,0,0,0.999999279854884,344.334703603768,99.9999727995435
24.3,"max_tuv_SVM","SVM",4,5,12733,12352,381,600,470,130,0.9603939324671,0.899280575539568,5.36191762747008,163,75,88,16,1.2,4.5,3.6,0,0,0,0,0,0,0.999999716865025,341.137190925235,99.9999893991521
24.3,"max_tuv_SVM","SVM",4,6,12633,12260,373,700,562,138,0.958403100653009,0.910071942446043,5.39438510220594,188,82,106,25,1.3,5.25,4.1,0,0,0,0,0,0,0.999999920937617,342.729419529576,99.9999969982254
24.3,"max_tuv_SVM","SVM",4,7,12533,12169,364,800,653,147,0.957424575287342,0.920863309352518,5.33853297000019,204,92,112,16,1.2,6,4.4,0,0,0,0,0,0,0.999999993872214,338.776793647581,99.9999997723173
24.3,"max_tuv_SVM","SVM",4,8,12433,12074,359,900,748,152,0.963269265633039,0.924460431654676,5.35702139587032,214,97,117,10,1.2,6.75,4.9,0,0,0,0,0,0,0.999999988552003,337.963520810322,99.9999995684184
24.3,"max_tuv_SVM","SVM",4,9,12333,11975,358,1000,847,153,0.962919068407818,0.924460431654676,5.35702139587032,215,98,117,1,1.2,7.5,5.5,0,0,0,0,0,0,0.999999999036451,334.519121717422,99.9999999661845
24.3,"max_tuv_SVM","SVM",4,10,12233,11875,358,1100,947,153,0.962855447368509,0.924460431654676,5.35702139587032,216,97,119,1,1.2,8.25,6.2,0,0,0,0,0,0,0.99999999806611,335.122290180579,99.9999999322401
24.3,"max_tuv_SVM","SVM",4,11,12133,11775,358,1200,1047,153,0.962295807429818,0.924460431654676,5.36166352879568,215,96,119,-1,1.2,9,6.8,0,0,0,0,0,0,0.999999999514808,333.60690826774,99.9999999836597
24.3,"max_tuv_SVM","SVM",4,12,12033,11675,358,1300,1147,153,0.962261463328954,0.924460431654676,5.36166352879568,216,96,120,1,1.2,9.75,7.5,0,0,0,0,0,0,0.999999999382345,333.479631166966,99.9999999783835
24.3,"max_tuv_SVM","SVM",4,13,11933,11576,357,1400,1246,154,0.964217951042211,0.924460431654676,5.36631371398978,220,97,123,4,1.3,10.5,8.1,0,0,0,0,0,0,0.999999998328185,333.797988335307,99.9999999384679
24.3,"max_tuv_SVM","SVM",4,14,11833,11476,357,1500,1346,154,0.964459485784359,0.924460431654676,5.37097197242206,221,97,124,1,1.3,11.25,8.7,0,0,0,0,0,0,0.999999999117055,333.275168944519,99.9999999694925
24.3,"max_tuv_SVM","SVM",4,15,11733,11377,356,1600,1445,155,0.967951323711729,0.920863309352518,5.38968616047928,221,99,122,0,1.2,12,9.3,0,0,0,0,0,0,0.999999998144477,334.017923275648,99.9999999327515
24.3,"max_tuv_SVM","SVM",4,16,11633,11279,354,1700,1543,157,0.974082590243341,0.920863309352518,5.46958222895368,226,103,123,5,1.2,12.75,9.8,0,0,0,0,0,0,0.999999998228073,334.482339322993,99.9999999391069
24.3,"max_tuv_SVM","SVM",4,17,11533,11182,351,1800,1640,160,0.982752505148811,0.924460431654676,5.68557560368817,244,105,139,18,1.3,13.5,10.2,0,0,0,0,0,0,0.999999998780403,337.188228384949,99.9999999556026
24.3,"max_tuv_SVM","SVM",4,18,11433,11086,347,1900,1736,164,0.987097315417355,0.924460431654676,5.79172082727378,256,109,147,12,1.3,14.25,10.6,0,0,0,0,0,0,0.999999999687939,336.97722253411,99.999999989205
24.3,"max_tuv_SVM","SVM",4,19,11333,10990,343,2000,1832,168,0.991792322911129,0.920863309352518,5.81837591699246,266,113,153,10,1.4,15,10.9,0,0,0,0,0,0,0.9999999990706,341.674784332266,99.9999999657264
24.3,"max_tuv_SVM","SVM",4,20,11233,10896,337,2100,1926,174,0.995957530422686,0.920863309352518,5.89897491666774,281,119,162,15,1.4,15.75,11.1,0,0,0,0,0,0,0.999999999965794,342.446586429308,99.9999999988361
24.3,"max_tuv_SVM","SVM",4,21,11133,10800,333,2200,2022,178,0.997415747164361,0.920863309352518,5.89931904743585,295,124,171,14,1.4,16.5,11.4,0,0,0,0,0,0,0.999999999918582,343.720223570179,99.9999999971821
24.3,"max_tuv_SVM","SVM",4,22,11033,10702,331,2300,2120,180,0.997521031539146,0.928057553956835,5.88882203845465,307,128,179,12,1.4,17.25,11.8,0,0,0,0,0,0,0.999999999980468,341.343328708201,99.9999999993666
24.3,"max_tuv_SVM","SVM",4,23,10933,10602,331,2400,2220,180,0.997494006672892,0.928057553956835,5.88882203845465,309,128,181,2,1.4,18,12.3,0,0,0,0,0,0,0.999999999973511,340.201893535481,99.9999999991285
24.3,"max_tuv_SVM","SVM",4,24,10833,10502,331,2500,2320,180,0.997446713156946,0.928057553956835,5.88882203845465,311,128,183,2,1.4,18.75,12.9,0,0,0,0,0,0,0.999999999881806,339.881203792186,99.9999999958394
24.3,"max_tuv_SVM","SVM",4,25,10733,10402,331,2600,2420,180,0.99741631018241,0.928057553956835,5.88882203845465,309,127,182,-2,1.4,19.5,13.4,0,0,0,0,0,0,0.999999999936236,339.050626164683,99.9999999976721
24.3,"max_tuv_SVM","SVM",4,26,10633,10302,331,2700,2520,180,0.997406175857565,0.931654676258993,5.87836231902577,306,127,179,-3,1.4,20.25,14,0,0,0,0,0,0,0.999999999995229,336.215320454256,99.9999999998335
24.3,"max_tuv_SVM","SVM",4,27,10533,10202,331,2800,2620,180,0.997374083828887,0.935251798561151,5.8731463808545,305,127,178,-1,1.4,21,14.6,0,0,0,0,0,0,0.999999999997189,335.75009413447,99.999999999901
24.3,"max_tuv_SVM","SVM",4,28,10433,10102,331,2900,2720,180,0.997386470225921,0.935251798561151,5.87836231902577,307,127,180,2,1.4,21.75,15.1,0,0,0,0,0,0,0.999999999995894,335.222508079665,99.9999999998548
24.3,"max_tuv_SVM","SVM",4,29,10333,10002,331,3000,2820,180,0.997357756305525,0.935251798561151,5.88358752997602,307,127,180,0,1.4,22.5,15.7,0,0,0,0,0,0,0.999999999994079,335.343878116716,99.9999999997826
24.3,"max_tuv_SVM","SVM",4,30,10233,9902,331,3100,2920,180,0.99733073143927,0.935251798561151,5.86274222428966,308,127,181,1,1.4,23.25,16.2,0,0,0,0,0,0,0.999999999998675,334.176323296588,99.9999999999532
24.3,"max_tuv_SVM","SVM",4,31,10133,9802,331,3200,3020,180,0.997318345042236,0.935251798561151,5.8731463808545,308,127,181,0,1.4,24,16.8,0,0,0,0,0,0,0.999999999997761,334.061225870383,99.9999999999201
24.3,"max_tuv_SVM","SVM",4,32,10033,9702,331,3300,3120,180,0.997330168421223,0.935251798561151,5.88882203845465,309,127,182,1,1.4,24.75,17.3,0,0,0,0,0,0,0.999999999989952,334.790409296172,99.9999999996289
24.3,"max_tuv_SVM","SVM",4,33,9933,9602,331,3400,3220,180,0.997339176709974,0.935251798561151,5.86793969080055,307,127,180,-2,1.4,25.5,17.9,0,0,0,0,0,0,0.999999999998545,333.619459172918,99.9999999999481
24.3,"max_tuv_SVM","SVM",4,34,9833,9502,331,3500,3320,180,0.997357756305524,0.935251798561151,5.8731463808545,307,127,180,0,1.4,26.25,18.4,0,0,0,0,0,0,0.999999999998186,333.318731080742,99.9999999999352
24.3,"max_tuv_SVM","SVM",4,35,9733,9402,331,3600,3420,180,0.997372394774745,0.938848920863309,5.8731463808545,308,127,181,1,1.4,27,19,0,0,0,0,0,0,0.999999999998284,333.181346655417,99.9999999999382
24.3,"max_tuv_SVM","SVM",4,36,9633,9302,331,3700,3520,180,0.997361134413805,0.938848920863309,5.83689239084923,309,127,182,1,1.4,27.75,19.6,0,0,0,0,0,0,0.999999999999302,332.838079575027,99.9999999999747
24.3,"max_tuv_SVM","SVM",4,37,9533,9202,331,3800,3620,180,0.997354378197241,0.938848920863309,5.87836231902577,310,126,184,1,1.5,28.5,20.1,0,0,0,0,0,0,0.999999999997811,332.983599338841,99.9999999999194
24.3,"max_tuv_SVM","SVM",4,38,9433,9102,331,3900,3720,180,0.997379150991308,0.938848920863309,5.79600347742822,309,127,182,-1,1.4,29.25,20.7,0,0,0,0,0,0,0.999999999999734,332.257908035531,99.9999999999899
24.3,"max_tuv_SVM","SVM",4,39,9333,9002,331,4000,3820,180,0.997446150138898,0.938848920863309,5.83174975438152,307,127,180,-2,1.4,30,21.2,0,0,0,0,0,0,0.999999999999367,332.39967164576,99.9999999999768
24.3,"max_tuv_SVM","SVM",4,40,9233,8902,331,4100,3920,180,0.997463040680307,0.938848920863309,5.760692751282,306,127,179,-1,1.4,30.75,21.8,0,0,0,0,0,0,0.999999999999873,332.025685412971,99.9999999999945
24.3,"max_tuv_SVM","SVM",4,41,9133,8802,331,4200,4020,180,0.997455721445696,0.938848920863309,5.87836231902577,307,127,180,1,1.4,31.5,22.3,0,0,0,0,0,0,0.999999999998119,332.231544970119,99.9999999999304
24.3,"max_tuv_SVM","SVM",4,42,9033,8702,331,4300,4120,180,0.99748105725781,0.938848920863309,5.81126950941442,307,127,180,0,1.4,32.25,22.9,0,0,0,0,0,0,0.9999999999996,331.993334911808,99.9999999999849
24.3,"max_tuv_SVM","SVM",4,43,8933,8602,331,4400,4220,180,0.997477679149528,0.938848920863309,5.80108323507714,305,127,178,-2,1.4,33,23.4,0,0,0,0,0,0,0.999999999999752,331.978359585721,99.9999999999903
24.3,"max_tuv_SVM","SVM",4,44,8833,8502,331,4500,4320,180,0.997504140997736,0.942446043165468,5.8731463808545,305,127,178,0,1.4,33.75,24,0,0,0,0,0,0,0.999999999998502,331.951294984646,99.9999999999439
24.3,"max_tuv_SVM","SVM",4,45,8733,8402,331,4600,4420,180,0.997512023250394,0.942446043165468,5.78587060421593,307,127,180,2,1.4,34.5,24.6,0,0,0,0,0,0,0.999999999999821,331.693308611608,99.9999999999927
24.3,"max_tuv_SVM","SVM",4,46,8633,8302,331,4700,4520,180,0.997493443654843,0.942446043165468,5.83689239084923,306,127,179,-1,1.4,35.25,25.1,0,0,0,0,0,0,0.999999999999278,331.778533695505,99.9999999999728
24.3,"max_tuv_SVM","SVM",4,47,8533,8202,331,4800,4620,180,0.997504704015783,0.942446043165468,5.88882203845465,306,127,179,0,1.4,36,25.7,0,0,0,0,0,0,0.999999999994096,331.991479336746,99.9999999997745
24.3,"max_tuv_SVM","SVM",4,48,8433,8102,331,4900,4720,180,0.997500762889454,0.942446043165468,5.79093260824411,308,127,181,2,1.4,36.75,26.2,0,0,0,0,0,0,0.999999999999761,331.566005277811,99.9999999999907
24.3,"max_tuv_SVM","SVM",5,0,13233,12704,529,100,95,5,0.943628368377862,0.768627450980392,5.06323235378127,24,5,19,0,3.8,0.75,19,0,0,0,0,0,0,0.999994655338299,549.267941212629,99.9998484648429
24.3,"max_tuv_SVM","SVM",5,1,13133,12671,462,200,128,72,0.96588749036731,0.835294117647059,5.39903166890658,51,20,31,27,1.6,1.5,1.8,0,0,0,0,0,0,0.986834256136003,456.621860869889,99.2544740828376
24.3,"max_tuv_SVM","SVM",5,2,13033,12612,421,300,187,113,0.947176862011142,0.882352941176471,5.18394185260311,100,45,55,49,1.2,2.25,1.7,0,0,0,0,0,0,0.99998243501247,416.315873455701,99.9994216464148
24.3,"max_tuv_SVM","SVM",5,3,12933,12543,390,400,256,144,0.940988098296088,0.882352941176471,5.01169818224151,131,58,73,31,1.3,3,1.8,0,0,0,0,0,0,0.999999704931735,340.909756340577,99.9999909846059
24.3,"max_tuv_SVM","SVM",5,4,12833,12469,364,500,330,170,0.941283500299657,0.882352941176471,5.03651289282836,137,57,80,6,1.4,3.75,1.9,0,0,0,0,0,0,0.999999714046995,312.029805141242,99.9999902800508
24.3,"max_tuv_SVM","SVM",5,5,12733,12382,351,600,417,183,0.943679131041039,0.882352941176471,5.00650813516896,144,64,80,7,1.2,4.5,2.3,0,0,0,0,0,0,0.999999959202077,296.546696082554,99.9999987075503
24.3,"max_tuv_SVM","SVM",5,6,12633,12284,349,700,515,185,0.945783640967287,0.882352941176471,5.02360978550259,146,66,80,2,1.2,5.25,2.8,0,0,0,0,0,0,0.999999975969536,293.828694340565,99.9999993034004
24.3,"max_tuv_SVM","SVM",5,7,12533,12188,345,800,611,189,0.948279573838241,0.882352941176471,5.02875928243638,140,65,75,-6,1.2,6,3.2,0,0,0,0,0,0,0.999999988388528,289.571091113609,99.9999996626696
24.3,"max_tuv_SVM","SVM",5,8,12433,12088,345,900,711,189,0.94910645480897,0.882352941176471,5.02875928243638,143,65,78,3,1.2,6.75,3.8,0,0,0,0,0,0,0.999999855508209,289.786556735919,99.9999953239904
24.3,"max_tuv_SVM","SVM",5,9,12333,11988,345,1000,811,189,0.949735177913926,0.882352941176471,5.02448312658397,141,65,76,-2,1.2,7.5,4.3,0,0,0,0,0,0,0.999999926245196,289.444827682314,99.9999977989775
24.3,"max_tuv_SVM","SVM",5,10,12233,11888,345,1100,911,189,0.952151602999246,0.882352941176471,5.04163153315934,143,67,76,2,1.1,8.25,4.8,0,0,0,0,0,0,0.99999993906091,289.389155260683,99.9999982090675
24.3,"max_tuv_SVM","SVM",5,11,12133,11788,345,1200,1011,189,0.953381527283377,0.882352941176471,5.05024970672029,143,66,77,0,1.2,9,5.3,0,0,0,0,0,0,0.999999972194006,289.270579289399,99.9999991982353
24.3,"max_tuv_SVM","SVM",5,12,12033,11689,344,1300,1110,190,0.95329162232576,0.882352941176471,5.05024970672029,142,64,78,-1,1.2,9.75,5.8,0,0,0,0,0,0,0.999999986181713,288.178965918063,99.9999996069325
24.3,"max_tuv_SVM","SVM",5,13,11933,11590,343,1400,1209,191,0.961085831712574,0.882352941176471,5.15757271311599,150,67,83,8,1.2,10.5,6.3,0,0,0,0,0,0,0.999999862430558,288.524143113517,99.9999958657834
24.3,"max_tuv_SVM","SVM",5,14,11833,11496,337,1500,1303,197,0.972704365589015,0.890196078431372,5.37228041901692,165,72,93,15,1.3,11.25,6.6,0,0,0,0,0,0,0.999999914270017,288.10041797969,99.9999974513195
24.3,"max_tuv_SVM","SVM",5,15,11733,11415,318,1600,1384,216,0.97367925336073,0.901960784313726,5.42634110247873,176,78,98,11,1.3,12,6.4,0,0,0,0,0,0,0.999803069023624,272.940668415949,99.9904635454392
24.3,"max_tuv_SVM","SVM",5,16,11633,11408,225,1700,1391,309,0.975666948001882,0.92156862745098,5.44033854298383,196,85,111,20,1.3,12.75,4.5,0,0,0,0,0,0,0.999905648653594,188.71688774224,99.9956148930581
24.3,"max_tuv_SVM","SVM",5,17,11533,11311,222,1800,1488,312,0.975476740914635,0.925490196078431,5.47694726166329,207,91,116,11,1.3,13.5,4.8,0,0,0,0,0,0,0.999926165993819,188.460527538016,99.9967161090558
24.3,"max_tuv_SVM","SVM",5,18,11433,11211,222,1900,1588,312,0.975414357882816,0.925490196078431,5.47694726166329,203,90,113,-4,1.3,14.25,5.1,0,0,0,0,0,0,0.99991320865585,188.110372244484,99.9960602556886
24.3,"max_tuv_SVM","SVM",5,19,11333,11151,182,2000,1648,352,0.975468178537715,0.929411764705882,5.48167284169923,203,89,114,0,1.3,15,4.7,0,0,0,0,0,0,0.99990882317266,147.99683273779,99.9958854929733
24.3,"max_tuv_SVM","SVM",5,20,11233,11151,82,2100,1648,452,0.975423531858079,0.929411764705882,5.47694726166329,207,89,118,4,1.3,15.75,3.6,0,0,0,0,0,0,1.14395214453331e-05,48.0077261160704,48.0025415984967
24.3,"max_tuv_SVM","SVM",5,21,11133,11094,39,2200,1705,495,0.975388670752067,0.925490196078431,5.47222982216142,207,89,118,0,1.3,16.5,3.4,0,0,0,0,0,0,1.15002677706351e-05,5.00811840330917,5.00127018282048
24.3,"max_tuv_SVM","SVM",5,22,11033,10994,39,2300,1805,495,0.975565422675546,0.925490196078431,5.47694726166329,209,90,119,2,1.3,17.25,3.6,0,0,0,0,0,0,1.04715066365046e-05,5.00860624161389,5.00101318805005
24.3,"max_tuv_SVM","SVM",5,23,10933,10899,34,2400,1900,500,0.975359314031216,0.925490196078431,5.47694726166329,206,89,117,-3,1.3,18,3.8,0,0,0,0,0,0,3.32562632864858e-06,0.0028007080469998,0.000398715568562727
24.3,"max_tuv_SVM","SVM",5,24,10833,10799,34,2500,2000,500,0.975541570339856,0.925490196078431,5.47694726166329,206,89,117,0,1.3,18.75,4,0,0,0,0,0,0,3.95351782109402e-06,0.00381456946372861,0.000457854192848709
24.3,"max_tuv_SVM","SVM",5,25,10733,10700,33,2600,2099,501,0.976926229006813,0.925490196078431,5.43478085845117,207,92,115,1,1.2,19.5,4.2,0,0,0,0,0,0,6.60447226887919e-06,0.00542947809823774,0.000851650039776378
24.3,"max_tuv_SVM","SVM",5,26,10633,10601,32,2700,2198,502,0.980023974655303,0.92156862745098,5.44876399959641,213,95,118,6,1.2,20.25,4.4,0,0,0,0,0,0,9.58341612730179e-06,0.027945739722512,0.0206422920370697
24.3,"max_tuv_SVM","SVM",5,27,10533,10503,30,2800,2296,504,0.984215869753944,0.925490196078431,5.53634314572847,219,94,125,6,1.3,21,4.6,0,0,0,0,0,0,1.5789859160773e-05,0.163678809710851,0.152508270981588
24.3,"max_tuv_SVM","SVM",5,28,10433,10408,25,2900,2391,509,0.991660244883929,0.917647058823529,5.70853668978508,229,99,130,10,1.3,21.75,4.7,0,0,0,0,0,0,0.00546822613012094,3.44511680066965,0.719532290082541
24.3,"max_tuv_SVM","SVM",5,29,10333,10315,18,3000,2484,516,0.995568358347692,0.92156862745098,5.81257452014198,253,108,145,24,1.3,22.5,4.8,0,0,0,0,0,0,0.0105460608454047,8.47402568323317,1.48423488102018
24.3,"max_tuv_SVM","SVM",5,30,10233,10221,12,3100,2578,522,0.997097354225535,0.925490196078431,5.83042572604108,274,115,159,21,1.4,23.25,4.9,0,0,0,0,0,0,0.0102840018123742,8.5192562498361,1.23881544823914
24.3,"max_tuv_SVM","SVM",5,31,10133,10127,6,3200,2672,528,0.999050799359045,0.937254901960784,5.91570541259982,291,120,171,17,1.4,24,5.1,0,0,0,0,0,0,0.0107834403283468,9.69947679180023,1.59920805677246
24.3,"max_tuv_SVM","SVM",5,32,10033,10032,1,3300,2767,533,0.999394517632381,0.937254901960784,5.92095914742451,298,125,173,7,1.4,24.75,5.2,0,0,0,0,0,0,0.00988665236285328,7.94809859828677,1.23567204428402
24.3,"max_tuv_SVM","SVM",5,33,9933,9933,0,3400,2866,534,0.999420204763128,0.937254901960784,5.91570541259982,304,127,177,6,1.4,25.5,5.4,0,0,0,0,0,0,0.00801581907130646,6.56426770364547,0.893417410114779
24.3,"max_tuv_SVM","SVM",5,34,9833,9833,0,3500,2966,534,0.999425709148288,0.937254901960784,5.9104609929078,304,127,177,0,1.4,26.25,5.6,0,0,0,0,0,0,0.00650882126774496,5.10899356548901,0.702904888666809
24.3,"max_tuv_SVM","SVM",5,35,9733,9733,0,3600,3066,534,0.9994318251318,0.937254901960784,5.9104609929078,305,128,177,1,1.4,27,5.7,0,0,0,0,0,0,0.00497912239106227,3.1526192140786,0.526256003793765
24.3,"max_tuv_SVM","SVM",5,36,9633,9633,0,3700,3166,534,0.999439164312013,0.937254901960784,5.9104609929078,306,128,178,1,1.4,27.75,5.9,0,0,0,0,0,0,0.00454045398757405,2.69216730267718,0.477309159101169
24.3,"max_tuv_SVM","SVM",5,37,9533,9533,0,3800,3266,534,0.999450784680684,0.937254901960784,5.9104609929078,307,128,179,1,1.4,28.5,6.1,0,0,0,0,0,0,0.00363354513143549,1.58193542840612,0.383576378616968
24.3,"max_tuv_SVM","SVM",5,38,9433,9433,0,3900,3366,534,0.999455677467494,0.937254901960784,5.87400881057269,307,128,179,0,1.4,29.25,6.3,0,0,0,0,0,0,0.00324973441940821,1.16996350324351,0.344519167957664
24.3,"max_tuv_SVM","SVM",5,39,9333,9333,0,4000,3466,534,0.999464239844409,0.937254901960784,5.86883802816901,308,128,180,1,1.4,30,6.5,0,0,0,0,0,0,0.00328638388256763,1.3239786733223,0.34445097938124
24.3,"max_tuv_SVM","SVM",5,40,9233,9233,0,4100,3566,534,0.999467909434516,0.937254901960784,5.87400881057269,309,128,181,1,1.4,30.75,6.7,0,0,0,0,0,0,1.56950419229483e-05,0.0160896712764454,0.00674211497884548
24.3,"max_tuv_SVM","SVM",5,41,9133,9133,0,4200,3666,534,0.999470967426272,0.937254901960784,5.86883802816901,311,129,182,2,1.4,31.5,6.9,0,0,0,0,0,0,1.2062745268914e-05,0.00853929109142218,0.00133168880292676
24.3,"max_tuv_SVM","SVM",5,42,9033,9033,0,4300,3766,534,0.999481976196592,0.941176470588235,5.86883802816901,311,129,182,0,1.4,32.25,7.1,0,0,0,0,0,0,9.27829990202756e-06,0.00664204919909543,0.00102452413111228
24.3,"max_tuv_SVM","SVM",5,43,8933,8933,0,4400,3866,534,0.999487480581752,0.941176470588235,5.85338015803336,313,129,184,2,1.4,33,7.2,0,0,0,0,0,0,5.42807575109839e-06,0.0038682578683282,0.000601189521511949
24.3,"max_tuv_SVM","SVM",5,44,8833,8833,0,4500,3966,534,0.999492984966913,0.941176470588235,5.84824561403509,312,129,183,-1,1.4,33.75,7.4,0,0,0,0,0,0,0.00125509954963181,1.71709783794786,0.132361495339269
24.3,"max_tuv_SVM","SVM",5,45,8733,8733,0,4600,4066,534,0.999497877753722,0.941176470588235,5.88957597173145,312,129,183,0,1.4,34.5,7.6,0,0,0,0,0,0,0.00132500508066415,1.93388328964072,0.13952894551748
24.3,"max_tuv_SVM","SVM",5,46,8633,8633,0,4700,4166,534,0.999502770540531,0.941176470588235,5.88957597173145,311,129,182,-1,1.4,35.25,7.8,0,0,0,0,0,0,0.00125101087991358,1.85330995152257,0.130426152962158
24.3,"max_tuv_SVM","SVM",5,47,8533,8533,0,4800,4266,534,0.999512556114149,0.941176470588235,5.8585237258348,310,129,181,-1,1.4,36,8,0,0,0,0,0,0,0.000902165158548548,1.2305549009567,0.0928146493140961
24.3,"max_tuv_SVM","SVM",5,48,8433,8433,0,4900,4366,534,0.99951867209766,0.941176470588235,5.88957597173145,309,129,180,-1,1.4,36.75,8.2,0,0,0,0,0,0,0.000971339234223254,1.38545247748031,0.100898441595596
24.3,"max_tuv_SVM","SVM",6,0,13233,12708,525,100,95,5,0.964503227143696,0.810810810810811,5.55470432838854,32,5,27,0,5.4,0.75,19,0,0,0,0,0,0,0.836701931607497,776.217736236457,87.9476444310664
24.3,"max_tuv_SVM","SVM",6,1,13133,12623,510,200,180,20,0.99023361242462,0.891891891891892,5.90631746729308,48,17,31,16,1.8,1.5,9,0,0,0,0,0,0,0.988861748299486,523.755626930972,99.392552634623
24.3,"max_tuv_SVM","SVM",6,2,13033,12607,426,300,196,104,0.974377467354947,0.922779922779923,5.72808503326215,97,44,53,49,1.2,2.25,1.9,0,0,0,0,0,0,0.997462631118879,414.070294604951,99.8425486834544
24.3,"max_tuv_SVM","SVM",6,3,12933,12524,409,400,279,121,0.95603107119963,0.922779922779923,5.21812870667832,127,58,69,30,1.2,3,2.3,0,0,0,0,0,0,0.999673489380949,353.730845707687,99.9796356713837
24.3,"max_tuv_SVM","SVM",6,4,12833,12430,403,500,373,127,0.961626152637422,0.922779922779923,5.28083583276716,144,62,82,17,1.3,3.75,2.9,0,0,0,0,0,0,0.999858613544373,337.691556090885,99.992414217358
24.3,"max_tuv_SVM","SVM",6,5,12733,12348,385,600,455,145,0.962411247523632,0.922779922779923,5.21812870667832,150,67,83,6,1.2,4.5,3.1,0,0,0,0,0,0,0.999952284923109,318.935106773981,99.9975837363744
24.3,"max_tuv_SVM","SVM",6,6,12633,12275,358,700,528,172,0.964427308528458,0.922779922779923,5.26179505568819,150,68,82,0,1.2,5.25,3.1,0,0,0,0,0,0,0.999960435571889,291.95917676961,99.9979416770802
24.3,"max_tuv_SVM","SVM",6,7,12533,12275,258,800,528,272,0.963007148400431,0.922779922779923,5.2667647552558,153,68,85,3,1.2,6,1.9,0,0,0,0,0,0,0.999950082806389,191.99180057389,99.9973318783812
24.3,"max_tuv_SVM","SVM",6,8,12433,12275,158,900,528,372,0.961936454913988,0.922779922779923,5.2667647552558,153,68,85,0,1.2,6.75,1.4,0,0,0,0,0,0,1.28050356008413e-05,92.0018679439007,91.9960619106133
24.3,"max_tuv_SVM","SVM",6,9,12333,12246,87,1000,557,443,0.962664309574448,0.922779922779923,5.24844024590218,152,66,86,-1,1.3,7.5,1.3,0,0,0,0,0,0,1.07101493232657e-05,21.0145633600347,21.0082967930055
24.3,"max_tuv_SVM","SVM",6,10,12233,12167,66,1100,636,464,0.96338131871843,0.922779922779923,5.23108811000428,149,66,83,-3,1.3,8.25,1.4,0,0,0,0,0,0,2.66203112897459e-06,0.00182138714136159,0.000340399399016133
24.3,"max_tuv_SVM","SVM",6,11,12133,12067,66,1200,736,464,0.965054540897269,0.922779922779923,5.26179505568819,148,66,82,-1,1.2,9,1.6,0,0,0,0,0,0,1.65365387725721e-06,0.00104055891046181,0.000204944197079496
24.3,"max_tuv_SVM","SVM",6,12,12033,11967,66,1300,836,464,0.966845256171128,0.922779922779923,5.32046000913925,150,67,83,2,1.2,9.75,1.8,0,0,0,0,0,0,8.30257414915831e-07,0.000515796891886159,0.000103307263357631
24.3,"max_tuv_SVM","SVM",6,13,11933,11867,66,1400,936,464,0.968556437657573,0.922779922779923,5.34337327360583,150,68,82,0,1.2,10.5,2,0,0,0,0,0,0,5.89743527385055e-07,0.000375065855941685,7.08044830481821e-05
24.3,"max_tuv_SVM","SVM",6,14,11833,11767,66,1500,1036,464,0.96969401182885,0.922779922779923,5.35721620954782,152,68,84,2,1.2,11.25,2.2,0,0,0,0,0,0,3.9151508777789e-07,0.000238235956514105,4.74256823305488e-05
24.3,"max_tuv_SVM","SVM",6,15,11733,11667,66,1600,1136,464,0.970230262365101,0.922779922779923,5.3794453224505,154,69,85,2,1.2,12,2.4,0,0,0,0,0,0,2.66974337477805e-07,0.000169802510537374,3.24680778065383e-05
24.3,"max_tuv_SVM","SVM",6,16,11633,11569,64,1700,1234,466,0.9763549665235,0.930501930501931,5.46501007072931,161,71,90,7,1.3,12.75,2.6,0,0,0,0,0,0,1.03879266277437e-06,0.0478685714305421,0.0473308445320598
24.3,"max_tuv_SVM","SVM",6,17,11533,11479,54,1800,1324,476,0.981345109154064,0.945945945945946,5.54462532230698,182,81,101,21,1.2,13.5,2.8,0,0,0,0,0,0,1.5435442528007e-05,0.436537045833504,0.430070070265102
24.3,"max_tuv_SVM","SVM",6,18,11433,11394,39,1900,1409,491,0.98516935876483,0.961389961389961,5.51914938707391,220,102,118,38,1.2,14.25,2.9,0,0,0,0,0,0,0.00310068852172052,0.97192443684643,0.852775902353538
24.3,"max_tuv_SVM","SVM",6,19,11333,11298,35,2000,1505,495,0.987370396078241,0.961389961389961,5.56807794919383,235,107,128,15,1.2,15,3,0,0,0,0,0,0,0.00285343625301869,0.483170471293637,0.375677535414126
24.3,"max_tuv_SVM","SVM",6,20,11233,11201,32,2100,1602,498,0.991140418106693,0.961389961389961,5.68547255329864,240,112,128,5,1.1,15.75,3.2,0,0,0,0,0,0,0.00389867664018493,1.2519831196219,0.523985176658792
24.3,"max_tuv_SVM","SVM",6,21,11133,11105,28,2200,1698,502,0.994215724552797,0.961389961389961,5.80374425202012,249,114,135,9,1.2,16.5,3.4,0,0,0,0,0,0,0.00727727581919295,3.91734177976898,1.03364689589441
24.3,"max_tuv_SVM","SVM",6,22,11033,11013,20,2300,1790,510,0.998000809798564,0.961389961389961,5.84409662059839,275,124,151,26,1.2,17.25,3.5,0,0,0,0,0,0,0.0105439525792352,8.6777421246248,1.46473488303689
24.3,"max_tuv_SVM","SVM",6,23,10933,10925,8,2400,1878,522,0.999661981403555,0.957528957528958,5.9579982126899,302,135,167,27,1.2,18,3.6,0,0,0,0,0,0,0.0165580229786145,12.6890091583979,2.95869476257707
24.3,"max_tuv_SVM","SVM",6,24,10833,10833,0,2500,1970,530,0.999863225986822,0.965250965250965,5.9579982126899,338,144,194,36,1.3,18.75,3.7,0,0,0,0,0,0,0.0141491234820974,11.6051334451715,2.0918802736667
24.3,"max_tuv_SVM","SVM",6,25,10733,10733,0,2600,2070,530,0.999866841158976,0.969111969111969,5.95267857142857,333,144,189,-5,1.3,19.5,3.9,0,0,0,0,0,0,0.00958838149462487,7.24582525513024,1.07216757434966
24.3,"max_tuv_SVM","SVM",6,26,10633,10633,0,2700,2170,530,0.999870456331131,0.969111969111969,5.94736842105263,331,144,187,-2,1.3,20.25,4.1,0,0,0,0,0,0,0.00740408753541698,5.44821552984775,0.807166165937882
24.3,"max_tuv_SVM","SVM",6,27,10533,10533,0,2800,2270,530,0.999871058859823,0.969111969111969,5.93677649154052,330,144,186,-1,1.3,21,4.3,0,0,0,0,0,0,0.0053617881895755,3.23358270250151,0.586199734032953
24.3,"max_tuv_SVM","SVM",6,28,10433,10433,0,2900,2370,530,0.999873468974593,0.969111969111969,5.94736842105263,328,144,184,-2,1.3,21.75,4.5,0,0,0,0,0,0,0.00460239012747628,2.55217055514178,0.487782143070722
24.3,"max_tuv_SVM","SVM",6,29,10333,10333,0,3000,2470,530,0.999875879089362,0.969111969111969,5.93149466192171,330,144,186,2,1.3,22.5,4.7,0,0,0,0,0,0,0.00383731368894364,1.69259559418579,0.412055368512476
24.3,"max_tuv_SVM","SVM",6,30,10233,10233,0,3100,2570,530,0.999877084146747,0.969111969111969,5.95267857142857,329,144,185,-1,1.3,23.25,4.8,0,0,0,0,0,0,0.00447451208911265,2.74330519353879,0.471193761629666
24.3,"max_tuv_SVM","SVM",6,31,10133,10133,0,3200,2670,530,0.999878891732824,0.969111969111969,5.93677649154052,330,144,186,1,1.3,24,5,0,0,0,0,0,0,0.00279054370301653,0.601580403271328,0.294050754004996
24.3,"max_tuv_SVM","SVM",6,32,10033,10033,0,3300,2770,530,0.999882506904979,0.969111969111969,5.8585237258348,331,145,186,1,1.3,24.75,5.2,0,0,0,0,0,0,1.83135476054859e-05,0.205533947019124,0.194679476626582
24.3,"max_tuv_SVM","SVM",6,33,9933,9933,0,3400,2870,530,0.999884314491056,0.969111969111969,5.87400881057269,332,145,187,1,1.3,25.5,5.4,0,0,0,0,0,0,1.21158643343393e-05,0.00869609988827426,0.00134530213675293
24.3,"max_tuv_SVM","SVM",6,34,9833,9833,0,3500,2970,530,0.999887327134518,0.969111969111969,5.9104609929078,332,145,187,0,1.3,26.25,5.6,0,0,0,0,0,0,1.36797210449633e-05,0.0103363480483144,0.00151295049444857
24.3,"max_tuv_SVM","SVM",6,35,9733,9733,0,3600,3070,530,0.999889134720595,0.969111969111969,5.7573402417962,332,145,187,0,1.3,27,5.8,0,0,0,0,0,0,5.38771322551296e-06,0.00387897515271529,0.000593066502887849
24.3,"max_tuv_SVM","SVM",6,36,9633,9633,0,3700,3170,530,0.99989033977798,0.969111969111969,5.9052258635961,333,145,188,1,1.3,27.75,6,0,0,0,0,0,0,8.41044593066096e-06,0.00658438476142107,0.000914959530690363
24.3,"max_tuv_SVM","SVM",6,37,9533,9533,0,3800,3270,530,0.999890942306673,0.969111969111969,5.73258813413586,334,145,189,1,1.3,28.5,6.2,0,0,0,0,0,0,3.22458920567204e-06,0.00241614869206851,0.000354610414330172
24.3,"max_tuv_SVM","SVM",6,38,9433,9433,0,3900,3370,530,0.99989516000752,0.972972972972973,5.84824561403509,332,145,187,-2,1.3,29.25,6.4,0,0,0,0,0,0,0.00115174810408356,1.68669113017699,0.119616850036848
24.3,"max_tuv_SVM","SVM",6,39,9333,9333,0,4000,3470,530,0.999896967593597,0.972972972972973,5.87400881057269,333,145,188,1,1.3,30,6.5,0,0,0,0,0,0,0.00112387095613185,1.67289652876364,0.116795468396068
24.3,"max_tuv_SVM","SVM",6,40,9233,9233,0,4100,3570,530,0.999898172650982,0.972972972972973,5.84824561403509,333,145,188,0,1.3,30.75,6.7,0,0,0,0,0,0,0.000942102304989841,1.38811138968859,0.098593563318422
24.3,"max_tuv_SVM","SVM",6,41,9133,9133,0,4200,3670,530,0.999899377708367,0.972972972972973,5.84824561403509,332,145,187,-1,1.3,31.5,6.9,0,0,0,0,0,0,0.000884895586013486,1.31741087529655,0.0923434366182903
24.3,"max_tuv_SVM","SVM",6,42,9033,9033,0,4300,3770,530,0.999900582765751,0.972972972972973,5.7573402417962,333,145,188,1,1.3,32.25,7.1,0,0,0,0,0,0,0.00061931133113136,0.897976146518752,0.0647757984358473
24.3,"max_tuv_SVM","SVM",6,43,8933,8933,0,4400,3870,530,0.999901787823136,0.972972972972973,5.79235447437011,334,145,189,1,1.3,33,7.3,0,0,0,0,0,0,0.000653576899599369,0.955266966193744,0.0673859994733608
24.3,"max_tuv_SVM","SVM",6,44,8833,8833,0,4500,3970,530,0.999901185294444,0.972972972972973,5.76730103806228,334,145,189,0,1.3,33.75,7.5,0,0,0,0,0,0,0.000519552846252798,0.749750943985831,0.053958841143157
24.3,"max_tuv_SVM","SVM",6,45,8733,8733,0,4600,4070,530,0.999904800466598,0.972972972972973,5.7573402417962,332,145,187,-2,1.3,34.5,7.7,0,0,0,0,0,0,0.000517176894186282,0.742490366977845,0.0535607486453587
24.3,"max_tuv_SVM","SVM",6,46,8633,8633,0,4700,4170,530,0.999905402995291,0.972972972972973,5.57907949790795,334,145,189,2,1.3,35.25,7.9,0,0,0,0,0,0,0.000358160091497596,0.483723688634226,0.0369586916685752
24.3,"max_tuv_SVM","SVM",6,47,8533,8533,0,4800,4270,530,0.999905402995291,0.972972972972973,5.832895888014,333,145,188,-1,1.3,36,8.1,0,0,0,0,0,0,0.000514972543138888,0.746268996039075,0.0532524928149488
24.3,"max_tuv_SVM","SVM",6,48,8433,8433,0,4900,4370,530,0.999905402995291,0.972972972972973,5.75237273511648,334,145,189,1,1.3,36.75,8.2,0,0,0,0,0,0,0.000392411097758609,0.551959844312715,0.0410283789370697
24.3,"max_tuv_SVM","SVM",7,0,13233,12722,511,100,94,6,0.951119613208817,0.823529411764706,5.46122936016512,29,6,23,0,3.8,0.75,15.7,0,0,0,0,0,0,0.993248616819347,756.567769598505,99.6429962660414
24.3,"max_tuv_SVM","SVM",7,1,13133,12647,486,200,169,31,0.962146437934074,0.867647058823529,5.54390157665916,77,27,50,48,1.9,1.5,5.5,0,0,0,0,0,0,0.960428609086286,644.211549001744,97.7012860298771
24.3,"max_tuv_SVM","SVM",7,2,13033,12619,414,300,197,103,0.979580209722647,0.897058823529412,5.55496874675796,103,44,59,26,1.3,2.25,1.9,0,0,0,0,0,0,0.999991589757093,485.427864921941,99.9995847798607
24.3,"max_tuv_SVM","SVM",7,3,12933,12547,386,400,269,131,0.967200363335307,0.908088235294118,5.46833989501312,143,62,81,40,1.3,3,2.1,0,0,0,0,0,0,0.999993540413889,428.298172590809,99.9997246573165
24.3,"max_tuv_SVM","SVM",7,4,12833,12459,374,500,357,143,0.954521570160523,0.926470588235294,5.30758863647761,169,75,94,26,1.3,3.75,2.5,0,0,0,0,0,0,0.999999108855461,354.983253679332,99.999968489537
24.3,"max_tuv_SVM","SVM",7,5,12733,12371,362,600,445,155,0.959209285747128,0.930147058823529,5.30306769215352,196,84,112,27,1.3,4.5,2.9,0,0,0,0,0,0,0.999999841709145,344.047321806551,99.9999945488462
24.3,"max_tuv_SVM","SVM",7,6,12633,12274,359,700,542,158,0.964412109644475,0.930147058823529,5.30306769215352,203,88,115,7,1.3,5.25,3.4,0,0,0,0,0,0,0.999999967701402,338.786862417184,99.9999989878366
24.3,"max_tuv_SVM","SVM",7,7,12533,12174,359,800,642,158,0.965564204571578,0.930147058823529,5.30758863647761,200,88,112,-3,1.3,6,4.1,0,0,0,0,0,0,0.999999991506718,335.458032844467,99.9999997289052
24.3,"max_tuv_SVM","SVM",7,8,12433,12075,358,900,741,159,0.96605804166857,0.930147058823529,5.30306769215352,200,88,112,0,1.3,6.75,4.7,0,0,0,0,0,0,0.999999994389924,333.785208035614,99.9999998080767
24.3,"max_tuv_SVM","SVM",7,9,12333,11976,357,1000,840,160,0.965972381916008,0.930147058823529,5.30306769215352,202,89,113,2,1.3,7.5,5.2,0,0,0,0,0,0,0.99999999467295,332.26542761384,99.9999998335899
24.3,"max_tuv_SVM","SVM",7,10,12233,11877,356,1100,939,161,0.969073954836031,0.930147058823529,5.34482413067442,204,89,115,2,1.3,8.25,5.8,0,0,0,0,0,0,0.999999999210303,330.875030762758,99.9999999768376
24.3,"max_tuv_SVM","SVM",7,11,12133,11778,355,1200,1038,162,0.969384399576872,0.930147058823529,5.35394499096567,203,89,114,-1,1.3,9,6.4,0,0,0,0,0,0,0.999999947117476,332.451701315887,99.9999982657426
24.3,"max_tuv_SVM","SVM",7,12,12033,11681,352,1300,1135,165,0.970227774456143,0.930147058823529,5.34938067298531,205,90,115,2,1.3,9.75,6.9,0,0,0,0,0,0,0.999999998180524,325.712985672755,99.9999999421292
24.3,"max_tuv_SVM","SVM",7,13,11933,11591,342,1400,1225,175,0.973101113001896,0.930147058823529,5.40251677429119,206,91,115,1,1.3,10.5,7,0,0,0,0,0,0,0.999999993436195,317.467281880633,99.9999997852526
24.3,"max_tuv_SVM","SVM",7,14,11833,11492,341,1500,1324,176,0.976663753851818,0.930147058823529,5.41179944916111,211,91,120,5,1.3,11.25,7.5,0,0,0,0,0,0,0.999999984099292,318.428117163092,99.999999469581
24.3,"max_tuv_SVM","SVM",7,15,11733,11393,340,1600,1423,177,0.979372096766803,0.930147058823529,5.46572652397173,215,93,122,4,1.3,12,8,0,0,0,0,0,0,0.999999994654723,317.709608020023,99.9999998302242
24.3,"max_tuv_SVM","SVM",7,16,11633,11300,333,1700,1516,184,0.984884790507284,0.930147058823529,5.54088844338426,228,99,129,13,1.3,12.75,8.2,0,0,0,0,0,0,0.999999978016789,317.103464663454,99.9999992255114
24.3,"max_tuv_SVM","SVM",7,17,11533,11204,329,1800,1612,188,0.993052361679626,0.930147058823529,5.77111539060068,240,102,138,12,1.4,13.5,8.6,0,0,0,0,0,0,0.999999925741777,324.864944878271,99.9999972370889
24.3,"max_tuv_SVM","SVM",7,18,11433,11107,326,1900,1709,191,0.995861886584196,0.933823529411765,5.82461741321971,252,108,144,12,1.3,14.25,8.9,0,0,0,0,0,0,0.999999987222429,324.379781306619,99.9999995322387
24.3,"max_tuv_SVM","SVM",7,19,11333,11013,320,2000,1803,197,0.997836660074505,0.930147058823529,5.84111027464825,269,115,154,17,1.3,15,9.2,0,0,0,0,0,0,0.99999999431086,328.873465207848,99.9999997778017
24.3,"max_tuv_SVM","SVM",7,20,11233,10918,315,2100,1898,202,0.998949087062502,0.941176470588235,5.9052258635961,288,123,165,19,1.3,15.75,9.4,0,0,0,0,0,0,0.999999993367694,329.087643516507,99.9999997249294
24.3,"max_tuv_SVM","SVM",7,21,11133,10821,312,2200,1995,205,0.999464195373224,0.941176470588235,5.94736842105263,295,126,169,7,1.3,16.5,9.7,0,0,0,0,0,0,0.999999999219655,324.081965065735,99.999999971881
24.3,"max_tuv_SVM","SVM",7,22,11033,10723,310,2300,2093,207,0.999610794278618,0.944852941176471,5.96332737030411,301,127,174,6,1.4,17.25,10.1,0,0,0,0,0,0,0.99999999974741,322.3308321642,99.999999991024
24.3,"max_tuv_SVM","SVM",7,23,10933,10623,310,2400,2193,207,0.999617693050637,0.944852941176471,5.96332737030411,303,128,175,2,1.4,18,10.6,0,0,0,0,0,0,0.999999999750846,320.868946886341,99.9999999912038
24.3,"max_tuv_SVM","SVM",7,24,10833,10523,310,2500,2293,207,0.99962976590167,0.948529411764706,5.96332737030411,302,128,174,-1,1.4,18.75,11.1,0,0,0,0,0,0,0.999999999939612,318.108587057797,99.9999999979902
24.3,"max_tuv_SVM","SVM",7,25,10733,10423,310,2600,2393,207,0.999638389366693,0.948529411764706,5.96332737030411,303,128,175,1,1.4,19.5,11.6,0,0,0,0,0,0,0.999999999712975,318.345430013806,99.9999999900982
24.3,"max_tuv_SVM","SVM",7,26,10633,10323,310,2700,2493,207,0.999644138343375,0.948529411764706,5.9686660698299,304,128,176,1,1.4,20.25,12,0,0,0,0,0,0,0.999999999947734,316.353914276937,99.9999999982989
24.3,"max_tuv_SVM","SVM",7,27,10533,10223,310,2800,2593,207,0.999654486501403,0.952205882352941,5.9686660698299,303,128,175,-1,1.4,21,12.5,0,0,0,0,0,0,0.999999999934065,315.895292432096,99.9999999978576
24.3,"max_tuv_SVM","SVM",7,28,10433,10123,310,2900,2693,207,0.999660235478085,0.952205882352941,5.9686660698299,305,128,177,2,1.4,21.75,13,0,0,0,0,0,0,0.999999999977698,314.768442836994,99.999999999277
24.3,"max_tuv_SVM","SVM",7,29,10333,10023,310,3000,2793,207,0.999667134250103,0.952205882352941,5.9686660698299,305,128,177,0,1.4,22.5,13.5,0,0,0,0,0,0,0.99999999995949,314.660310767489,99.9999999986048
24.3,"max_tuv_SVM","SVM",7,30,10233,9923,310,3100,2893,207,0.999674033022122,0.952205882352941,5.9104609929078,305,128,177,0,1.4,23.25,14,0,0,0,0,0,0,0.999999999977135,313.676511690063,99.9999999992457
24.3,"max_tuv_SVM","SVM",7,31,10133,9823,310,3200,2993,207,0.999683806282482,0.952205882352941,5.9104609929078,305,128,177,0,1.4,24,14.5,0,0,0,0,0,0,0.999999999987997,313.39747075126,99.9999999996004
24.3,"max_tuv_SVM","SVM",7,32,10033,9723,310,3300,3093,207,0.999687255668491,0.952205882352941,5.87918871252205,305,128,177,0,1.4,24.75,14.9,0,0,0,0,0,0,0.999999999997691,312.52656932135,99.9999999999242
24.3,"max_tuv_SVM","SVM",7,33,9933,9623,310,3400,3193,207,0.999689555259164,0.952205882352941,5.9104609929078,304,128,176,-1,1.4,25.5,15.4,0,0,0,0,0,0,0.99999999998442,312.758552514767,99.9999999994721
24.3,"max_tuv_SVM","SVM",7,34,9833,9523,310,3500,3293,207,0.999692429747505,0.955882352941177,5.9,304,128,176,0,1.4,26.25,15.9,0,0,0,0,0,0,0.999999999985929,312.612151272711,99.9999999995248
24.3,"max_tuv_SVM","SVM",7,35,9733,9423,310,3600,3393,207,0.999697603826519,0.955882352941177,5.9,304,128,176,0,1.4,27,16.4,0,0,0,0,0,0,0.999999999978051,312.600232738425,99.9999999992662
24.3,"max_tuv_SVM","SVM",7,36,9633,9323,310,3700,3493,207,0.999699903417192,0.955882352941177,5.87918871252205,303,128,175,-1,1.4,27.75,16.9,0,0,0,0,0,0,0.999999999997085,311.71006363358,99.9999999999071
24.3,"max_tuv_SVM","SVM",7,37,9533,9223,310,3800,3593,207,0.999703927700869,0.955882352941177,5.9,303,128,175,0,1.4,28.5,17.4,0,0,0,0,0,0,0.999999999974078,312.18807335305,99.9999999991297
24.3,"max_tuv_SVM","SVM",7,38,9433,9123,310,3900,3693,207,0.999706227291542,0.955882352941177,5.9,303,128,175,0,1.4,29.25,17.8,0,0,0,0,0,0,0.999999999991357,311.646452338897,99.9999999997286
24.3,"max_tuv_SVM","SVM",7,39,9333,9023,310,4000,3793,207,0.999708526882215,0.955882352941177,5.88957597173145,303,128,175,0,1.4,30,18.3,0,0,0,0,0,0,0.999999999992729,311.540007252844,99.9999999997741
24.3,"max_tuv_SVM","SVM",7,40,9233,8923,310,4100,3893,207,0.999712551165893,0.955882352941177,5.9,303,129,174,0,1.3,30.75,18.8,0,0,0,0,0,0,0.999999999990527,311.518548250064,99.9999999997116
24.3,"max_tuv_SVM","SVM",7,41,9133,8823,310,4200,3993,207,0.999713700961229,0.955882352941177,5.87918871252205,300,129,171,-3,1.3,31.5,19.3,0,0,0,0,0,0,0.999999999996206,311.225065768146,99.9999999998861
24.3,"max_tuv_SVM","SVM",7,42,9033,8723,310,4300,4093,207,0.999716000551902,0.955882352941177,5.88437775816417,299,128,171,-1,1.3,32.25,19.8,0,0,0,0,0,0,0.999999999994774,311.058380136432,99.9999999998375
24.3,"max_tuv_SVM","SVM",7,43,8933,8623,310,4400,4193,207,0.99971657544957,0.955882352941177,5.87918871252205,302,129,173,3,1.3,33,20.3,0,0,0,0,0,0,0.999999999996919,310.88647332405,99.9999999999045
24.3,"max_tuv_SVM","SVM",7,44,8833,8523,310,4500,4293,207,0.99971657544957,0.955882352941177,5.88437775816417,301,129,172,-1,1.3,33.75,20.7,0,0,0,0,0,0,0.999999999995524,310.920909588078,99.9999999998546
24.3,"max_tuv_SVM","SVM",7,45,8733,8423,310,4600,4393,207,0.99971657544957,0.955882352941177,5.88437775816417,301,129,172,0,1.3,34.5,21.2,0,0,0,0,0,0,0.999999999995703,310.923841367433,99.9999999998527
24.3,"max_tuv_SVM","SVM",7,46,8633,8323,310,4700,4493,207,0.999719162489077,0.955882352941177,5.87400881057269,300,128,172,-1,1.3,35.25,21.7,0,0,0,0,0,0,0.999999999997096,310.84484086567,99.9999999999
24.3,"max_tuv_SVM","SVM",7,47,8533,8223,310,4800,4593,207,0.999721174630916,0.955882352941177,5.84312007011393,300,128,172,0,1.3,36,22.2,0,0,0,0,0,0,0.999999999998534,310.570800823072,99.9999999999504
24.3,"max_tuv_SVM","SVM",7,48,8433,8123,310,4900,4693,207,0.999723474221589,0.955882352941177,5.8277972027972,301,128,173,1,1.4,36.75,22.7,0,0,0,0,0,0,0.99999999999912,310.559080579772,99.999999999971
24.3,"max_tuv_SVM","SVM",8,0,13233,12730,503,100,94,6,0.971093627681231,0.792857142857143,5.48329173067076,24,6,18,0,3,0.75,15.7,0,0,0,0,0,0,0.930972376999842,828.303847702281,96.5074864752305
24.3,"max_tuv_SVM","SVM",8,1,13133,12713,420,200,111,89,0.987925249949664,0.889285714285714,5.82900051619564,60,23,37,36,1.6,1.5,1.2,0,0,0,0,0,0,0.989540942906133,609.849651665157,99.326062608896
24.3,"max_tuv_SVM","SVM",8,2,13033,12664,369,300,160,140,0.957991120356092,0.9,5.43759398496241,116,53,63,56,1.2,2.25,1.1,0,0,0,0,0,0,0.991306775366608,425.29593605065,99.4406420202491
24.3,"max_tuv_SVM","SVM",8,3,12933,12573,360,400,251,149,0.963858507235693,0.9,5.19134886572655,134,58,76,18,1.3,3,1.7,0,0,0,0,0,0,0.999991371033645,352.168198668613,99.9996677115374
24.3,"max_tuv_SVM","SVM",8,4,12833,12476,357,500,348,152,0.962940347581066,0.9,5.18872585209794,139,61,78,5,1.3,3.75,2.3,0,0,0,0,0,0,0.999998100087276,310.885510847792,99.9999307716383
24.3,"max_tuv_SVM","SVM",8,5,12733,12402,331,600,422,178,0.963061128631865,0.9,5.17980284977275,149,68,81,10,1.2,4.5,2.4,0,0,0,0,0,0,0.999999776145139,280.210666087013,99.999992563112
24.3,"max_tuv_SVM","SVM",8,6,12633,12307,326,700,517,183,0.964062604844687,0.9,5.27730870712401,158,72,86,9,1.2,5.25,2.8,0,0,0,0,0,0,0.999998687628674,275.378347434442,99.9999538042592
24.3,"max_tuv_SVM","SVM",8,7,12533,12212,321,800,612,188,0.963742199557158,0.9,5.28195422535211,157,73,84,-1,1.2,6,3.3,0,0,0,0,0,0,0.999999630035389,267.288778871881,99.999987477701
24.3,"max_tuv_SVM","SVM",8,8,12433,12136,297,900,688,212,0.965341989308661,0.9,5.32856513530522,158,74,84,1,1.1,6.75,3.2,0,0,0,0,0,0,0.999999532986473,242.295810361892,99.9999826770877
24.3,"max_tuv_SVM","SVM",8,9,12333,12045,288,1000,779,221,0.965173119506158,0.9,5.28660792951542,156,73,83,-2,1.1,7.5,3.5,0,0,0,0,0,0,0.99999943203409,232.919751168502,99.999979566774
24.3,"max_tuv_SVM","SVM",8,10,12233,11945,288,1100,879,221,0.96680086783423,0.9,5.33075692963753,157,72,85,1,1.2,8.25,4,0,0,0,0,0,0,0.999999478029242,232.691438590377,99.999981433981
24.3,"max_tuv_SVM","SVM",8,11,12133,11851,282,1200,973,227,0.966695743586317,0.9,5.33544125031383,160,73,87,3,1.2,9,4.3,0,0,0,0,0,0,0.999999773464907,226.193005456823,99.9999921306904
24.3,"max_tuv_SVM","SVM",8,12,12033,11751,282,1300,1073,227,0.968701491869668,0.9,5.3376032024018,158,73,85,-2,1.2,9.75,4.7,0,0,0,0,0,0,0.999999635135457,225.924309538473,99.9999872715571
24.3,"max_tuv_SVM","SVM",8,13,11933,11654,279,1400,1170,230,0.977692970095544,0.907142857142857,5.4819043434597,174,79,95,16,1.2,10.5,5.1,0,0,0,0,0,0,0.99999922812785,227.463742318979,99.999972380628
24.3,"max_tuv_SVM","SVM",8,14,11833,11561,272,1500,1263,237,0.977483280771245,0.914285714285714,5.49478021978022,188,85,103,14,1.2,11.25,5.3,0,0,0,0,0,0,0.999999518512515,227.560343542791,99.9999830933042
24.3,"max_tuv_SVM","SVM",8,15,11733,11472,261,1600,1352,248,0.980014091122597,0.935714285714286,5.53929811507937,211,98,113,23,1.2,12,5.5,0,0,0,0,0,0,0.999999710404703,229.567610889113,99.9999899990173
24.3,"max_tuv_SVM","SVM",8,16,11633,11377,256,1700,1447,253,0.980984253729689,0.935714285714286,5.55033114632335,223,102,121,12,1.2,12.75,5.7,0,0,0,0,0,0,0.999999966864274,228.820778893491,99.9999989615167
24.3,"max_tuv_SVM","SVM",8,17,11533,11277,256,1800,1547,253,0.981075957860849,0.935714285714286,5.55033114632335,222,101,121,-1,1.2,13.5,6.1,0,0,0,0,0,0,0.999999962662086,228.500832273966,99.9999987731362
24.3,"max_tuv_SVM","SVM",8,18,11433,11179,254,1900,1645,255,0.987302892035172,0.935714285714286,5.64540994875641,225,104,121,3,1.2,14.25,6.5,0,0,0,0,0,0,0.9999998930904,232.787214847645,99.9999963542252
24.3,"max_tuv_SVM","SVM",8,19,11333,11084,249,2000,1740,260,0.99289013397748,0.935714285714286,5.76911579609817,245,112,133,20,1.2,15,6.7,0,0,0,0,0,0,0.999999930925133,236.146819524073,99.99999756746
24.3,"max_tuv_SVM","SVM",8,20,11233,10991,242,2100,1833,267,0.997124180813704,0.946428571428571,5.88912684290798,265,118,147,20,1.2,15.75,6.9,0,0,0,0,0,0,0.999999984194502,240.741160759664,99.999999460851
24.3,"max_tuv_SVM","SVM",8,21,11133,10896,237,2200,1928,272,0.998365541613545,0.946428571428571,5.94736842105263,280,125,155,15,1.2,16.5,7.1,0,0,0,0,0,0,0.99999999563455,238.343864624007,99.9999998531248
24.3,"max_tuv_SVM","SVM",8,22,11033,10800,233,2300,2024,276,0.999016976447695,0.953571428571429,5.95267857142857,292,129,163,12,1.3,17.25,7.3,0,0,0,0,0,0,0.999999996287728,238.067966423586,99.9999998792449
24.3,"max_tuv_SVM","SVM",8,23,10933,10701,232,2400,2123,277,0.999202621396139,0.957142857142857,5.95267857142857,299,130,169,7,1.3,18,7.7,0,0,0,0,0,0,0.999999994145727,238.265813629053,99.9999998153813
24.3,"max_tuv_SVM","SVM",8,24,10833,10604,229,2500,2220,280,0.999564964548525,0.957142857142857,5.9579982126899,301,133,168,2,1.3,18.75,7.9,0,0,0,0,0,0,0.999999999614449,236.179727132908,99.9999999875156
24.3,"max_tuv_SVM","SVM",8,25,10733,10508,225,2600,2316,284,0.999606902413384,0.960714285714286,5.97937219730942,319,136,183,18,1.3,19.5,8.2,0,0,0,0,0,0,0.999999999827174,235.194987583453,99.999999994475
24.3,"max_tuv_SVM","SVM",8,26,10633,10408,225,2700,2416,284,0.999613612471762,0.960714285714286,5.97937219730942,318,136,182,-1,1.3,20.25,8.5,0,0,0,0,0,0,0.999999999820727,233.760070909599,99.9999999941732
24.3,"max_tuv_SVM","SVM",8,27,10533,10308,225,2800,2516,284,0.999619763358608,0.960714285714286,5.9686660698299,320,136,184,2,1.4,21,8.9,0,0,0,0,0,0,0.99999999992925,232.310617649633,99.9999999977555
24.3,"max_tuv_SVM","SVM",8,28,10433,10208,225,2900,2616,284,0.99962815093158,0.964285714285714,5.9686660698299,321,136,185,1,1.4,21.75,9.2,0,0,0,0,0,0,0.99999999998088,230.420082616514,99.9999999994099
24.3,"max_tuv_SVM","SVM",8,29,10333,10108,225,3000,2716,284,0.999633742646894,0.964285714285714,5.9686660698299,323,137,186,2,1.4,22.5,9.6,0,0,0,0,0,0,0.999999999968162,230.387338100471,99.9999999990001
24.3,"max_tuv_SVM","SVM",8,30,10233,10008,225,3100,2816,284,0.999644926077523,0.964285714285714,5.9686660698299,324,136,188,1,1.4,23.25,9.9,0,0,0,0,0,0,0.999999999981779,229.515012623657,99.9999999994275
24.3,"max_tuv_SVM","SVM",8,31,10133,9908,225,3200,2916,284,0.999649399449775,0.964285714285714,5.9686660698299,325,136,189,1,1.4,24,10.3,0,0,0,0,0,0,0.99999999992686,229.919134944632,99.9999999976301
24.3,"max_tuv_SVM","SVM",8,32,10033,9808,225,3300,3016,284,0.999650517792838,0.964285714285714,5.95267857142857,326,137,189,1,1.4,24.75,10.6,0,0,0,0,0,0,0.99999999999493,228.149609731845,99.9999999998485
24.3,"max_tuv_SVM","SVM",8,33,9933,9708,225,3400,3116,284,0.999653313650495,0.964285714285714,5.96332737030411,327,137,190,1,1.4,25.5,11,0,0,0,0,0,0,0.99999999998726,228.243141554428,99.999999999607
24.3,"max_tuv_SVM","SVM",8,34,9833,9608,225,3500,3216,284,0.999655550336621,0.964285714285714,5.96332737030411,327,136,191,0,1.4,26.25,11.3,0,0,0,0,0,0,0.999999999959624,228.477514947865,99.9999999987109
24.3,"max_tuv_SVM","SVM",8,35,9733,9508,225,3600,3316,284,0.999655550336621,0.964285714285714,5.9579982126899,327,136,191,0,1.4,27,11.7,0,0,0,0,0,0,0.999999999990832,227.697310932703,99.9999999997113
24.3,"max_tuv_SVM","SVM",8,36,9633,9408,225,3700,3416,284,0.999658346194278,0.964285714285714,5.94206773618538,326,136,190,-1,1.4,27.75,12,0,0,0,0,0,0,0.999999999996534,227.275111915567,99.9999999998914
24.3,"max_tuv_SVM","SVM",8,37,9533,9308,225,3800,3516,284,0.999658346194278,0.967857142857143,5.87400881057269,326,136,190,0,1.4,28.5,12.4,0,0,0,0,0,0,0.999999999999395,226.515472451908,99.9999999999812
24.3,"max_tuv_SVM","SVM",8,38,9433,9208,225,3900,3616,284,0.999660023708873,0.967857142857143,5.94206773618538,322,136,186,-4,1.4,29.25,12.7,0,0,0,0,0,0,0.999999999997125,226.909707311919,99.9999999999091
24.3,"max_tuv_SVM","SVM",8,39,9333,9108,225,4000,3716,284,0.999660582880404,0.967857142857143,5.94206773618538,322,136,186,0,1.4,30,13.1,0,0,0,0,0,0,0.999999999996957,226.678544459169,99.999999999904
24.3,"max_tuv_SVM","SVM",8,40,9233,9008,225,4100,3816,284,0.999664497081124,0.967857142857143,5.96332737030411,323,136,187,1,1.4,30.75,13.4,0,0,0,0,0,0,0.999999999985481,226.870274247302,99.9999999995297
24.3,"max_tuv_SVM","SVM",8,41,9133,8908,225,4200,3916,284,0.999668970453376,0.967857142857143,5.96332737030411,320,135,185,-3,1.4,31.5,13.8,0,0,0,0,0,0,0.99999999998538,226.707981667906,99.9999999995186
24.3,"max_tuv_SVM","SVM",8,42,9033,8808,225,4300,4016,284,0.999670088796439,0.967857142857143,5.94206773618538,322,135,187,2,1.4,32.25,14.1,0,0,0,0,0,0,0.999999999995102,226.428831161136,99.9999999998413
24.3,"max_tuv_SVM","SVM",8,43,8933,8708,225,4400,4116,284,0.999677358026348,0.967857142857143,5.94206773618538,320,135,185,-2,1.4,33,14.5,0,0,0,0,0,0,0.999999999995575,226.212772183183,99.9999999998556
24.3,"max_tuv_SVM","SVM",8,44,8833,8608,225,4500,4216,284,0.999677917197879,0.967857142857143,5.93677649154052,321,135,186,1,1.4,33.75,14.8,0,0,0,0,0,0,0.99999999999842,226.001117857089,99.9999999999489
24.3,"max_tuv_SVM","SVM",8,45,8733,8508,225,4600,4316,284,0.999679594712474,0.967857142857143,5.9579982126899,320,135,185,-1,1.4,34.5,15.2,0,0,0,0,0,0,0.999999999993075,226.097973136321,99.9999999997726
24.3,"max_tuv_SVM","SVM",8,46,8633,8408,225,4700,4416,284,0.999681272227068,0.967857142857143,5.94736842105263,320,135,185,0,1.4,35.25,15.5,0,0,0,0,0,0,0.999999999995422,225.986032610773,99.9999999998498
24.3,"max_tuv_SVM","SVM",8,47,8533,8308,225,4800,4516,284,0.9996818313986,0.967857142857143,5.87400881057269,320,135,185,0,1.4,36,15.9,0,0,0,0,0,0,0.999999999999513,225.626415116316,99.9999999999839
24.3,"max_tuv_SVM","SVM",8,48,8433,8208,225,4900,4616,284,0.999683508913194,0.967857142857143,5.94206773618538,320,135,185,0,1.4,36.75,16.3,0,0,0,0,0,0,0.999999999997964,225.699826946914,99.9999999999338
24.3,"max_tuv_SVM","SVM",9,0,13233,12708,525,100,95,5,0.945403067594112,0.83011583011583,5.19776507276507,25,5,20,0,4,0.75,19,0,0,0,0,0,0,0.956127517267753,600.756489105308,97.9276055234198
24.3,"max_tuv_SVM","SVM",9,1,13133,12650,483,200,153,47,0.967744228980194,0.884169884169884,5.63236680234872,79,34,45,54,1.3,1.5,3.3,0,0,0,0,0,0,0.973092671784862,475.154821262328,98.5897162846474
24.3,"max_tuv_SVM","SVM",9,2,13033,12616,417,300,187,113,0.961657484129388,0.884169884169884,5.3675319380732,105,46,59,26,1.3,2.25,1.7,0,0,0,0,0,0,0.999987841878363,389.840926451991,99.9994373856961
24.3,"max_tuv_SVM","SVM",9,3,12933,12557,376,400,246,154,0.950447437807012,0.884169884169884,5.15270453493059,142,66,76,37,1.2,3,1.6,0,0,0,0,0,0,0.999999906401303,327.756195321362,99.9999965197358
24.3,"max_tuv_SVM","SVM",9,4,12833,12468,365,500,335,165,0.949672585908533,0.884169884169884,5.08225918225918,150,67,83,8,1.2,3.75,2,0,0,0,0,0,0,0.999999992440582,310.316674200311,99.999999757429
24.3,"max_tuv_SVM","SVM",9,5,12733,12371,362,600,432,168,0.950623376185155,0.884169884169884,5.06494313734518,152,70,82,2,1.2,4.5,2.6,0,0,0,0,0,0,0.99999999173217,306.657053202463,99.9999997189776
24.3,"max_tuv_SVM","SVM",9,6,12633,12272,361,700,531,169,0.95206281723136,0.884169884169884,5.09532411588967,153,70,83,1,1.2,5.25,3.1,0,0,0,0,0,0,0.999999996476576,305.39122973345,99.9999998884737
24.3,"max_tuv_SVM","SVM",9,7,12533,12172,361,800,631,169,0.952901537171217,0.884169884169884,5.11738179604504,150,68,82,-3,1.2,6,3.7,0,0,0,0,0,0,0.999999988321188,305.566345140221,99.9999996025138
24.3,"max_tuv_SVM","SVM",9,8,12433,12072,361,900,731,169,0.95399331916185,0.884169884169884,5.11738179604504,155,70,85,5,1.2,6.75,4.3,0,0,0,0,0,0,0.999999981727549,305.278255735579,99.9999994095291
24.3,"max_tuv_SVM","SVM",9,9,12333,11972,361,1000,831,169,0.953989101461006,0.884169884169884,5.11738179604504,155,72,83,0,1.2,7.5,4.9,0,0,0,0,0,0,0.999999994949975,305.266446262957,99.9999998364763
24.3,"max_tuv_SVM","SVM",9,10,12233,11872,361,1100,931,169,0.954688034744206,0.884169884169884,5.13498242131088,153,71,82,-2,1.2,8.25,5.5,0,0,0,0,0,0,0.999999991534555,305.151922826733,99.9999997269285
24.3,"max_tuv_SVM","SVM",9,11,12133,11774,359,1200,1029,171,0.958006160253327,0.884169884169884,5.21483490880043,158,72,86,5,1.2,9,6,0,0,0,0,0,0,0.999999983844808,304.370672312552,99.9999994760002
24.3,"max_tuv_SVM","SVM",9,12,12033,11679,354,1300,1124,176,0.961985259738049,0.888030888030888,5.19670642168504,172,77,95,14,1.2,9.75,6.4,0,0,0,0,0,0,0.999999959074569,304.77945417522,99.9999986276881
24.3,"max_tuv_SVM","SVM",9,13,11933,11595,338,1400,1208,192,0.960881427173556,0.895752895752896,5.23179541625315,185,84,101,13,1.2,10.5,6.3,0,0,0,0,0,0,0.999999910817732,297.170068657221,99.9999968558652
24.3,"max_tuv_SVM","SVM",9,14,11833,11508,325,1500,1295,205,0.963401804693962,0.915057915057915,5.37480386833277,211,102,109,26,1.1,11.25,6.3,0,0,0,0,0,0,0.999999992459871,297.970843716741,99.9999997423201
24.3,"max_tuv_SVM","SVM",9,15,11733,11410,323,1600,1393,207,0.964238114519042,0.915057915057915,5.38875232127827,214,103,111,3,1.1,12,6.7,0,0,0,0,0,0,0.999999992767065,297.274922256723,99.9999997511047
24.3,"max_tuv_SVM","SVM",9,16,11633,11310,323,1700,1493,207,0.96469965149743,0.915057915057915,5.39809158006732,216,104,112,2,1.1,12.75,7.2,0,0,0,0,0,0,0.999999994876042,296.852294958873,99.999999818893
24.3,"max_tuv_SVM","SVM",9,17,11533,11210,323,1800,1593,207,0.964734598161589,0.915057915057915,5.40277335940822,218,104,114,2,1.1,13.5,7.7,0,0,0,0,0,0,0.999999995538342,296.611002018773,99.9999998429012
24.3,"max_tuv_SVM","SVM",9,18,11433,11110,323,1900,1693,207,0.964737610805045,0.915057915057915,5.40277335940822,219,104,115,1,1.1,14.25,8.2,0,0,0,0,0,0,0.999999997446341,296.265338018171,99.9999999100066
24.3,"max_tuv_SVM","SVM",9,19,11333,11012,321,2000,1791,209,0.970004916634129,0.918918918918919,5.3794453224505,223,105,118,4,1.1,15,8.6,0,0,0,0,0,0,0.999999996617687,297.799699809497,99.9999998757029
24.3,"max_tuv_SVM","SVM",9,20,11233,10915,318,2100,1888,212,0.977677517003352,0.915057915057915,5.51599558742416,236,108,128,13,1.2,15.75,8.9,0,0,0,0,0,0,0.999999994254254,299.715579502197,99.9999997792628
24.3,"max_tuv_SVM","SVM",9,21,11133,10818,315,2200,1985,215,0.983328633609533,0.915057915057915,5.59495666945273,247,110,137,11,1.2,16.5,9.2,0,0,0,0,0,0,0.999999946761175,303.970685301238,99.9999979970317
24.3,"max_tuv_SVM","SVM",9,22,11033,10723,310,2300,2080,220,0.987790961105558,0.915057915057915,5.72789849119636,259,115,144,12,1.3,17.25,9.5,0,0,0,0,0,0,0.999999990330495,305.796442088976,99.9999996224208
24.3,"max_tuv_SVM","SVM",9,23,10933,10629,304,2400,2174,226,0.993590299770058,0.922779922779923,5.80665491677925,286,124,162,27,1.3,18,9.6,0,0,0,0,0,0,0.999999996143768,310.410951114079,99.9999998539002
24.3,"max_tuv_SVM","SVM",9,24,10833,10534,299,2500,2269,231,0.995214114596127,0.922779922779923,5.82434316684539,296,129,167,10,1.3,18.75,9.8,0,0,0,0,0,0,0.999999998697977,308.45803155164,99.999999953919
24.3,"max_tuv_SVM","SVM",9,25,10733,10434,299,2600,2369,231,0.99523942080121,0.922779922779923,5.82434316684539,298,128,170,2,1.3,19.5,10.3,0,0,0,0,0,0,0.999999998344941,306.272337960102,99.9999999409144
24.3,"max_tuv_SVM","SVM",9,26,10633,10335,298,2700,2468,232,0.996696937708177,0.922779922779923,5.87324069677011,299,129,170,1,1.3,20.25,10.6,0,0,0,0,0,0,0.999999999335551,305.180166265237,99.9999999743576
24.3,"max_tuv_SVM","SVM",9,27,10533,10237,296,2800,2566,234,0.998367749772244,0.926640926640927,5.93677649154052,302,131,171,3,1.3,21,11,0,0,0,0,0,0,0.999999998673155,305.904463299753,99.9999999475971
24.3,"max_tuv_SVM","SVM",9,28,10433,10137,296,2900,2666,234,0.998381607932169,0.926640926640927,5.92095914742451,303,131,172,1,1.3,21.75,11.4,0,0,0,0,0,0,0.999999999433702,303.379224993672,99.9999999778863
24.3,"max_tuv_SVM","SVM",9,29,10333,10037,296,3000,2766,234,0.998418964711099,0.926640926640927,5.91570541259982,305,131,174,2,1.3,22.5,11.8,0,0,0,0,0,0,0.999999999914447,301.309217229735,99.9999999968749
24.3,"max_tuv_SVM","SVM",9,30,10233,9937,296,3100,2866,234,0.998465961949108,0.926640926640927,5.91570541259982,305,131,174,0,1.3,23.25,12.2,0,0,0,0,0,0,0.999999999981949,300.210543894524,99.9999999993683
24.3,"max_tuv_SVM","SVM",9,31,10133,9838,295,3200,2965,235,0.999111872707378,0.926640926640927,5.92622222222222,308,131,177,3,1.4,24,12.6,0,0,0,0,0,0,0.999999999930641,300.612521304815,99.9999999973966
24.3,"max_tuv_SVM","SVM",9,32,10033,9738,295,3300,3065,235,0.999145614314153,0.926640926640927,5.92622222222222,308,131,177,0,1.4,24.75,13,0,0,0,0,0,0,0.999999999946326,300.253883636153,99.9999999980337
24.3,"max_tuv_SVM","SVM",9,33,9933,9638,295,3400,3165,235,0.999184176150468,0.926640926640927,5.92622222222222,307,131,176,-1,1.3,25.5,13.5,0,0,0,0,0,0,0.999999999968098,299.487186734209,99.9999999988511
24.3,"max_tuv_SVM","SVM",9,34,9833,9538,295,3500,3265,235,0.999199841896471,0.930501930501931,5.93149466192171,308,131,177,1,1.4,26.25,13.9,0,0,0,0,0,0,0.999999999908496,299.816283996813,99.99999999659
24.3,"max_tuv_SVM","SVM",9,35,9733,9438,295,3600,3365,235,0.999222737986783,0.930501930501931,5.93149466192171,307,131,176,-1,1.3,27,14.3,0,0,0,0,0,0,0.9999999999751,298.649049335762,99.9999999991301
24.3,"max_tuv_SVM","SVM",9,36,9633,9338,295,3700,3465,235,0.999245634077095,0.930501930501931,5.93149466192171,308,131,177,1,1.4,27.75,14.7,0,0,0,0,0,0,0.999999999977274,298.40810260581,99.9999999992224
24.3,"max_tuv_SVM","SVM",9,37,9533,9238,295,3800,3565,235,0.99926431246656,0.930501930501931,5.92622222222222,311,131,180,3,1.4,28.5,15.2,0,0,0,0,0,0,0.999999999933849,298.744864002996,99.9999999976514
24.3,"max_tuv_SVM","SVM",9,38,9433,9138,295,3900,3665,235,0.999278170626485,0.930501930501931,5.9104609929078,313,131,182,2,1.4,29.25,15.6,0,0,0,0,0,0,0.999999999987786,297.597147313839,99.9999999995846
24.3,"max_tuv_SVM","SVM",9,39,9333,9038,295,4000,3765,235,0.99929443890118,0.930501930501931,5.91570541259982,315,131,184,2,1.4,30,16,0,0,0,0,0,0,0.999999999987568,297.480418131367,99.9999999995824
24.3,"max_tuv_SVM","SVM",9,40,9233,8938,295,4100,3865,235,0.999307694532414,0.930501930501931,5.9104609929078,314,131,183,-1,1.4,30.75,16.4,0,0,0,0,0,0,0.999999999959123,297.528035317078,99.9999999985683
24.3,"max_tuv_SVM","SVM",9,41,9133,8838,295,4200,3965,235,0.999316129934108,0.930501930501931,5.9104609929078,314,130,184,0,1.4,31.5,16.9,0,0,0,0,0,0,0.999999999993686,296.849609664589,99.9999999997867
24.3,"max_tuv_SVM","SVM",9,42,9033,8738,295,4300,4065,235,0.999330590622725,0.934362934362934,5.9104609929078,317,132,185,3,1.4,32.25,17.3,0,0,0,0,0,0,0.999999999968706,297.082598224703,99.9999999988968
24.3,"max_tuv_SVM","SVM",9,43,8933,8638,295,4400,4165,235,0.99933179568011,0.934362934362934,5.9,316,130,186,-1,1.4,33,17.7,0,0,0,0,0,0,0.999999999969856,296.945852300896,99.9999999989417
24.3,"max_tuv_SVM","SVM",9,44,8833,8538,295,4500,4265,235,0.999332398208803,0.934362934362934,5.9,317,130,187,1,1.4,33.75,18.1,0,0,0,0,0,0,0.999999999970942,296.681876243026,99.9999999989906
24.3,"max_tuv_SVM","SVM",9,45,8733,8438,295,4600,4365,235,0.999337218438342,0.934362934362934,5.88957597173145,316,130,186,-1,1.4,34.5,18.6,0,0,0,0,0,0,0.999999999996709,296.14307431702,99.999999999893
24.3,"max_tuv_SVM","SVM",9,46,8633,8338,295,4700,4465,235,0.999343846253959,0.934362934362934,5.9,315,131,184,-1,1.4,35.25,19,0,0,0,0,0,0,0.999999999984293,296.365727835993,99.999999999468
24.3,"max_tuv_SVM","SVM",9,47,8533,8238,295,4800,4565,235,0.999350474069575,0.934362934362934,5.9,315,131,184,0,1.4,36,19.4,0,0,0,0,0,0,0.99999999999532,296.010966527999,99.9999999998417
24.3,"max_tuv_SVM","SVM",9,48,8433,8138,295,4900,4665,235,0.999358306942577,0.934362934362934,5.9,316,131,185,1,1.4,36.75,19.9,0,0,0,0,0,0,0.999999999994632,295.997110072148,99.999999999821
24.3,"max_tuv_SVM","SVM",10,0,13233,12711,522,100,93,7,0.958578357805768,0.776923076923077,5.21423686348862,33,7,26,0,3.7,0.75,13.3,0,0,0,0,0,0,0.962589649590734,747.03913895103,97.567867623861
24.3,"max_tuv_SVM","SVM",10,1,13133,12679,454,200,125,75,0.955871582764049,0.861538461538462,5.29419279105096,80,32,48,47,1.5,1.5,1.7,0,0,0,0,0,0,0.982333772310808,703.387081208888,98.9132418900336
24.3,"max_tuv_SVM","SVM",10,2,13033,12609,424,300,195,105,0.940915585117236,0.865384615384615,5.11947999461134,122,56,66,42,1.2,2.25,1.9,0,0,0,0,0,0,0.995132299947766,453.66733853308,99.7549088820941
24.3,"max_tuv_SVM","SVM",10,3,12933,12546,387,400,258,142,0.944859588671042,0.865384615384615,5.12390695450198,141,64,77,19,1.2,3,1.8,0,0,0,0,0,0,0.999996351647339,365.413527688643,99.9998536269452
24.3,"max_tuv_SVM","SVM",10,4,12833,12461,372,500,343,157,0.942696089613524,0.865384615384615,5.0388814242526,156,68,88,15,1.3,3.75,2.2,0,0,0,0,0,0,0.999999494964623,329.151807684535,99.9999793049196
24.3,"max_tuv_SVM","SVM",10,5,12733,12375,358,600,429,171,0.941678572714939,0.865384615384615,5.05211841573488,153,66,87,-3,1.3,4.5,2.5,0,0,0,0,0,0,0.999999860395526,312.78792291175,99.9999942585748
24.3,"max_tuv_SVM","SVM",10,6,12633,12282,351,700,522,178,0.945599164375499,0.865384615384615,5.0476983646275,153,68,85,0,1.2,5.25,2.9,0,0,0,0,0,0,0.999999845203231,304.890783298549,99.9999937208426
24.3,"max_tuv_SVM","SVM",10,7,12533,12182,351,800,622,178,0.948124047015883,0.865384615384615,5.10586919688241,154,69,85,1,1.2,6,3.5,0,0,0,0,0,0,0.999999922945727,303.144231591457,99.9999970530902
24.3,"max_tuv_SVM","SVM",10,8,12433,12087,346,900,717,183,0.947768066177621,0.865384615384615,5.09674843707529,148,69,79,-6,1.1,6.75,3.9,0,0,0,0,0,0,0.999999829980549,298.568059054755,99.9999937076268
24.3,"max_tuv_SVM","SVM",10,9,12333,11987,346,1000,817,183,0.95034517534907,0.865384615384615,5.15571642706275,153,73,80,5,1.1,7.5,4.5,0,0,0,0,0,0,0.999999746206272,297.698290588047,99.9999907283384
24.3,"max_tuv_SVM","SVM",10,10,12233,11887,346,1100,917,183,0.950961688537767,0.865384615384615,5.15571642706275,150,71,79,-3,1.1,8.25,5,0,0,0,0,0,0,0.999999913078398,297.44493049336,99.9999970056207
24.3,"max_tuv_SVM","SVM",10,11,12133,11787,346,1200,1017,183,0.951376499261619,0.865384615384615,5.14199309924904,156,73,83,6,1.1,9,5.6,0,0,0,0,0,0,0.999999819772715,297.038501857066,99.9999936392095
24.3,"max_tuv_SVM","SVM",10,12,12033,11687,346,1300,1117,183,0.951405914204409,0.865384615384615,5.16470508290296,157,73,84,1,1.2,9.75,6.1,0,0,0,0,0,0,0.999999703919821,296.774371420264,99.9999895203277
24.3,"max_tuv_SVM","SVM",10,13,11933,11588,345,1400,1216,184,0.957067990539178,0.865384615384615,5.23728830850847,164,74,90,7,1.2,10.5,6.6,0,0,0,0,0,0,0.999999766162289,297.196416269751,99.9999914723837
24.3,"max_tuv_SVM","SVM",10,14,11833,11498,335,1500,1306,194,0.962716860164931,0.869230769230769,5.33741568440417,178,80,98,14,1.2,11.25,6.7,0,0,0,0,0,0,0.999999885817336,293.758353852281,99.9999956258312
24.3,"max_tuv_SVM","SVM",10,15,11733,11406,327,1600,1398,202,0.966696281711095,0.892307692307692,5.4447543205693,200,89,111,22,1.2,12,6.9,0,0,0,0,0,0,0.999999885758578,295.024161210326,99.9999961211456
24.3,"max_tuv_SVM","SVM",10,16,11633,11313,320,1700,1491,209,0.966248454214723,0.903846153846154,5.46884615384615,213,96,117,13,1.2,12.75,7.1,0,0,0,0,0,0,0.999999926956187,295.03094989753,99.9999974520894
24.3,"max_tuv_SVM","SVM",10,17,11533,11214,319,1800,1590,210,0.965566507785948,0.9,5.47854268957992,214,99,115,1,1.2,13.5,7.6,0,0,0,0,0,0,0.999999940605436,294.961227289891,99.9999978058108
24.3,"max_tuv_SVM","SVM",10,18,11433,11115,318,1900,1689,211,0.968741520692504,0.9,5.48827367126657,217,100,117,3,1.2,14.25,8,0,0,0,0,0,0,0.999999943755374,295.315233441283,99.9999977759907
24.3,"max_tuv_SVM","SVM",10,19,11333,11016,317,2000,1788,212,0.972557659290922,0.903846153846154,5.56647960580345,219,103,116,2,1.1,15,8.4,0,0,0,0,0,0,0.999999914804676,296.698666706461,99.9999964359812
24.3,"max_tuv_SVM","SVM",10,20,11233,10917,316,2100,1887,213,0.975743477686679,0.903846153846154,5.6171039112268,225,104,121,6,1.2,15.75,8.9,0,0,0,0,0,0,0.999999830055261,297.048965325261,99.9999927762953
24.3,"max_tuv_SVM","SVM",10,21,11133,10819,314,2200,1985,215,0.982279598035807,0.903846153846154,5.68301367979652,236,107,129,11,1.2,16.5,9.2,0,0,0,0,0,0,0.999999902531081,297.659871716111,99.9999958915167
24.3,"max_tuv_SVM","SVM",10,22,11033,10720,313,2300,2084,216,0.984745050485647,0.907692307692308,5.71103275079125,238,108,130,2,1.2,17.25,9.6,0,0,0,0,0,0,0.999999740530029,298.742693252466,99.9999890128686
24.3,"max_tuv_SVM","SVM",10,23,10933,10624,309,2400,2180,220,0.991224742169025,0.907692307692308,5.83408619258439,243,109,134,5,1.2,18,9.9,0,0,0,0,0,0,0.999999872472745,300.222244493865,99.9999946843514
24.3,"max_tuv_SVM","SVM",10,24,10833,10531,302,2500,2273,227,0.996337539470054,0.911538461538462,5.98707274625827,261,118,143,18,1.2,18.75,10,0,0,0,0,0,0,0.999999958953489,305.432057339918,99.9999983295395
24.3,"max_tuv_SVM","SVM",10,25,10733,10438,295,2600,2366,234,0.998939261144661,0.926923076923077,6.02802893309222,296,127,169,35,1.3,19.5,10.1,0,0,0,0,0,0,0.999999986457383,307.15540227466,99.9999994480247
24.3,"max_tuv_SVM","SVM",10,26,10633,10341,292,2700,2463,237,0.999382886506345,0.930769230769231,6.02802893309222,308,133,175,12,1.3,20.25,10.4,0,0,0,0,0,0,0.999999994740028,305.823985414227,99.9999997920873
24.3,"max_tuv_SVM","SVM",10,27,10533,10242,291,2800,2562,238,0.999448319746431,0.930769230769231,6.02802893309222,310,132,178,2,1.3,21,10.8,0,0,0,0,0,0,0.999999984454076,305.123510853728,99.9999993562087
24.3,"max_tuv_SVM","SVM",10,28,10433,10142,291,2900,2662,238,0.99946032584553,0.930769230769231,6.02258355916892,310,132,178,0,1.3,21.75,11.2,0,0,0,0,0,0,0.999999997791513,301.60313206046,99.9999999132552
24.3,"max_tuv_SVM","SVM",10,29,10333,10042,291,3000,2762,238,0.999472932249583,0.930769230769231,6.02258355916892,308,131,177,-2,1.4,22.5,11.6,0,0,0,0,0,0,0.999999999321568,299.467880835977,99.9999999746439
24.3,"max_tuv_SVM","SVM",10,30,10233,9942,291,3100,2862,238,0.999483137433816,0.930769230769231,6.02802893309222,311,132,179,3,1.4,23.25,12,0,0,0,0,0,0,0.999999998275009,300.273720270737,99.9999999350822
24.3,"max_tuv_SVM","SVM",10,31,10133,9842,291,3200,2962,238,0.999495143532915,0.930769230769231,6.02802893309222,312,132,180,1,1.4,24,12.4,0,0,0,0,0,0,0.999999999159442,298.889479671775,99.9999999689093
24.3,"max_tuv_SVM","SVM",10,32,10033,9742,291,3300,3062,238,0.999508950546878,0.930769230769231,6.02802893309222,313,131,182,1,1.4,24.75,12.9,0,0,0,0,0,0,0.999999999553602,297.448180588012,99.9999999835502
24.3,"max_tuv_SVM","SVM",10,33,9933,9642,291,3400,3162,238,0.999519155731111,0.930769230769231,6.02802893309222,313,130,183,0,1.4,25.5,13.3,0,0,0,0,0,0,0.999999999248635,297.691883660668,99.9999999720342
24.3,"max_tuv_SVM","SVM",10,34,9833,9542,291,3500,3262,238,0.99953116183021,0.934615384615385,6.02802893309222,314,129,185,1,1.4,26.25,13.7,0,0,0,0,0,0,0.999999999710862,296.276456050569,99.9999999893999
24.3,"max_tuv_SVM","SVM",10,35,9733,9442,291,3600,3362,238,0.99953236244012,0.934615384615385,6.02802893309222,312,129,183,-2,1.4,27,14.1,0,0,0,0,0,0,0.99999999990893,295.468947077116,99.9999999966828
24.3,"max_tuv_SVM","SVM",10,36,9633,9342,291,3700,3462,238,0.999541367014443,0.934615384615385,6.02258355916892,312,128,184,0,1.4,27.75,14.5,0,0,0,0,0,0,0.999999999029807,296.316818501407,99.999999963819
24.3,"max_tuv_SVM","SVM",10,37,9533,9242,291,3800,3562,238,0.999548570673902,0.934615384615385,6.02802893309222,313,128,185,1,1.4,28.5,15,0,0,0,0,0,0,0.99999999991563,294.723263482029,99.9999999970089
24.3,"max_tuv_SVM","SVM",10,38,9433,9142,291,3900,3662,238,0.999558175553181,0.934615384615385,6.02802893309222,313,128,185,0,1.4,29.25,15.4,0,0,0,0,0,0,0.999999999763313,294.864906298746,99.9999999915252
24.3,"max_tuv_SVM","SVM",10,39,9333,9042,291,4000,3762,238,0.999560576773001,0.934615384615385,6.02802893309222,312,128,184,-1,1.4,30,15.8,0,0,0,0,0,0,0.999999999877815,294.32692474371,99.9999999958132
24.3,"max_tuv_SVM","SVM",10,40,9233,8942,291,4100,3862,238,0.999567180127505,0.938461538461538,6.02802893309222,312,129,183,0,1.4,30.75,16.2,0,0,0,0,0,0,0.999999999726554,294.432343709395,99.9999999903243
24.3,"max_tuv_SVM","SVM",10,41,9133,8842,291,4200,3962,238,0.999568380737415,0.938461538461538,6.02802893309222,311,129,182,-1,1.4,31.5,16.6,0,0,0,0,0,0,0.999999999955078,293.40613368077,99.9999999984588
24.3,"max_tuv_SVM","SVM",10,42,9033,8742,291,4300,4062,238,0.99956898104237,0.938461538461538,6.02802893309222,312,129,183,1,1.4,32.25,17.1,0,0,0,0,0,0,0.999999998615314,294.407547044487,99.999999948994
24.3,"max_tuv_SVM","SVM",10,43,8933,8642,291,4400,4162,238,0.999569581347324,0.938461538461538,6.02802893309222,310,129,181,-2,1.4,33,17.5,0,0,0,0,0,0,0.999999999882659,293.48133495152,99.9999999958865
24.3,"max_tuv_SVM","SVM",10,44,8833,8542,291,4500,4262,238,0.999570781957234,0.938461538461538,6.02802893309222,309,129,180,-1,1.4,33.75,17.9,0,0,0,0,0,0,0.99999999995097,293.069553819304,99.9999999983088
24.3,"max_tuv_SVM","SVM",10,45,8733,8442,291,4600,4362,238,0.999572582872099,0.942307692307692,6.02802893309222,309,129,180,0,1.4,34.5,18.3,0,0,0,0,0,0,0.999999999970869,292.711507674737,99.9999999990156
24.3,"max_tuv_SVM","SVM",10,46,8633,8342,291,4700,4462,238,0.999573183177054,0.942307692307692,6.02802893309222,309,129,180,0,1.4,35.25,18.7,0,0,0,0,0,0,0.999999999836391,293.08133175568,99.9999999941743
24.3,"max_tuv_SVM","SVM",10,47,8533,8242,291,4800,4562,238,0.999577385311738,0.942307692307692,5.9955035971223,310,129,181,1,1.4,36,19.2,0,0,0,0,0,0,0.999999999985119,292.402487526947,99.9999999995005
24.3,"max_tuv_SVM","SVM",10,48,8433,8142,291,4900,4662,238,0.999574383786964,0.946153846153846,5.9955035971223,310,129,181,0,1.4,36.75,19.6,0,0,0,0,0,0,0.99999999977201,292.744018805031,99.9999999919611
24.3,"max_tuv_SVM","SVM",11,0,13233,12705,528,100,94,6,0.941334874561134,0.745098039215686,5.40442643059037,26,6,20,0,3.3,0.75,15.7,0,0,0,0,0,0,0.956448981316428,646.159751095374,98.0534536442741
24.3,"max_tuv_SVM","SVM",11,1,13133,12665,468,200,134,66,0.945250327205074,0.874509803921569,5.30247379021846,74,32,42,48,1.3,1.5,2,0,0,0,0,0,0,0.991493542280642,538.197422879326,99.4730685489831
24.3,"max_tuv_SVM","SVM",11,2,13033,12599,434,300,200,100,0.955500715570015,0.886274509803922,5.32542822221075,111,47,64,37,1.4,2.25,2,0,0,0,0,0,0,0.999999911566276,410.00299928655,99.9999972413527
24.3,"max_tuv_SVM","SVM",11,3,12933,12511,422,400,288,112,0.951458050469031,0.894117647058824,5.28367834938854,130,58,72,19,1.2,3,2.6,0,0,0,0,0,0,0.999999225606563,386.091555357888,99.9999719151649
24.3,"max_tuv_SVM","SVM",11,4,12833,12423,410,500,376,124,0.957491468202934,0.894117647058824,5.3390077503394,154,65,89,24,1.4,3.75,3,0,0,0,0,0,0,0.999999851314086,365.879884195647,99.9999947796318
24.3,"max_tuv_SVM","SVM",11,5,12733,12332,401,600,467,133,0.956972832801197,0.913725490196078,5.43927738927739,168,73,95,14,1.3,4.5,3.5,0,0,0,0,0,0,0.99999999958611,358.697313731789,99.9999999872335
24.3,"max_tuv_SVM","SVM",11,6,12633,12241,392,700,558,142,0.958260858928697,0.925490196078431,5.47276458516564,192,82,110,24,1.3,5.25,3.9,0,0,0,0,0,0,0.999999999163919,359.521909894045,99.9999999735845
24.3,"max_tuv_SVM","SVM",11,7,12533,12147,386,800,652,148,0.960070578449683,0.929411764705882,5.43927738927739,207,88,119,15,1.4,6,4.4,0,0,0,0,0,0,0.999999999357181,357.52606035221,99.9999999803083
24.3,"max_tuv_SVM","SVM",11,8,12433,12047,386,900,752,148,0.961085220114214,0.925490196078431,5.43927738927739,206,88,118,-1,1.3,6.75,5.1,0,0,0,0,0,0,0.999999999536681,356.749121042725,99.9999999855153
24.3,"max_tuv_SVM","SVM",11,9,12333,11949,384,1000,850,150,0.961039961836232,0.929411764705882,5.43927738927739,205,89,116,-1,1.3,7.5,5.7,0,0,0,0,0,0,0.999999999885294,354.645789825667,99.9999999963326
24.3,"max_tuv_SVM","SVM",11,10,12233,11851,382,1100,948,152,0.964289383875777,0.929411764705882,5.45259898025528,206,90,116,1,1.3,8.25,6.2,0,0,0,0,0,0,0.999999996930952,354.215303315794,99.999999900488
24.3,"max_tuv_SVM","SVM",11,11,12133,11752,381,1200,1047,153,0.96413587268965,0.929411764705882,5.42978475858057,209,90,119,3,1.3,9,6.8,0,0,0,0,0,0,0.999999998950545,353.117085394055,99.9999999648131
24.3,"max_tuv_SVM","SVM",11,12,12033,11652,381,1300,1147,153,0.964147493058325,0.929411764705882,5.42505085730892,210,91,119,1,1.3,9.75,7.5,0,0,0,0,0,0,0.99999999986883,352.250262914314,99.9999999960508
24.3,"max_tuv_SVM","SVM",11,13,11933,11552,381,1400,1247,153,0.964028231379855,0.929411764705882,5.42505085730892,211,91,120,1,1.3,10.5,8.2,0,0,0,0,0,0,0.999999999912092,351.871056411146,99.9999999975113
24.3,"max_tuv_SVM","SVM",11,14,11833,11452,381,1500,1347,153,0.964915048988992,0.929411764705882,5.46213149595503,212,91,121,1,1.3,11.25,8.8,0,0,0,0,0,0,0.999999999474567,352.245106633671,99.9999999826196
24.3,"max_tuv_SVM","SVM",11,15,11733,11353,380,1600,1446,154,0.966794490722024,0.929411764705882,5.48019522219368,215,91,124,3,1.4,12,9.4,0,0,0,0,0,0,0.999999999377214,352.257661536731,99.9999999798869
24.3,"max_tuv_SVM","SVM",11,16,11633,11254,379,1700,1545,155,0.970716059349492,0.929411764705882,5.49459153188421,217,92,125,2,1.4,12.75,10,0,0,0,0,0,0,0.999999999362469,352.574616498457,99.9999999789446
24.3,"max_tuv_SVM","SVM",11,17,11533,11156,377,1800,1643,157,0.974939757562396,0.925490196078431,5.55151420920791,226,96,130,9,1.4,13.5,10.5,0,0,0,0,0,0,0.999999998978442,353.248087051414,99.9999999661626
24.3,"max_tuv_SVM","SVM",11,18,11433,11057,376,1900,1742,158,0.97744180641688,0.925490196078431,5.62235294117647,229,98,131,3,1.3,14.25,11,0,0,0,0,0,0,0.999999998043432,353.275706818134,99.9999999383692
24.3,"max_tuv_SVM","SVM",11,19,11333,10961,372,2000,1838,162,0.983197558499368,0.925490196078431,5.64734117647059,242,102,140,13,1.4,15,11.3,0,0,0,0,0,0,0.999999998155928,353.711950813428,99.9999999389904
24.3,"max_tuv_SVM","SVM",11,20,11233,10868,365,2100,1931,169,0.996180568297189,0.929411764705882,5.93994177277351,260,109,151,18,1.4,15.75,11.4,0,0,0,0,0,0,0.999999999595384,361.548099433721,99.9999999862667
24.3,"max_tuv_SVM","SVM",11,21,11133,10775,358,2200,2024,176,0.999070370506281,0.929411764705882,6.01714801444043,278,116,162,18,1.4,16.5,11.5,0,0,0,0,0,0,0.999999999946428,365.355881418808,99.9999999981299
24.3,"max_tuv_SVM","SVM",11,22,11033,10682,351,2300,2117,183,0.999574327547613,0.937254901960784,5.99011680143756,305,126,179,27,1.4,17.25,11.6,0,0,0,0,0,0,0.999999999992184,362.169352699799,99.9999999997374
24.3,"max_tuv_SVM","SVM",11,23,10933,10583,350,2400,2216,184,0.999631817792619,0.941176470588235,5.98473967684022,310,126,184,5,1.5,18,12,0,0,0,0,0,0,0.999999999986031,360.688254180913,99.9999999995679
24.3,"max_tuv_SVM","SVM",11,24,10833,10483,350,2500,2316,184,0.999638545374482,0.941176470588235,5.96332737030411,306,125,181,-4,1.4,18.75,12.6,0,0,0,0,0,0,0.999999999999012,357.375725782482,99.9999999999718
24.3,"max_tuv_SVM","SVM",11,25,10733,10383,350,2600,2416,184,0.999643438161291,0.941176470588235,5.95267857142857,307,125,182,1,1.5,19.5,13.1,0,0,0,0,0,0,0.999999999998807,356.315748865959,99.9999999999655
24.3,"max_tuv_SVM","SVM",11,26,10633,10283,350,2700,2516,184,0.999650777341504,0.941176470588235,5.97937219730942,310,125,185,3,1.5,20.25,13.7,0,0,0,0,0,0,0.999999999975783,356.714733255972,99.9999999992361
24.3,"max_tuv_SVM","SVM",11,27,10533,10183,350,2800,2616,184,0.999654446931611,0.941176470588235,5.94736842105263,308,125,183,-2,1.5,21,14.2,0,0,0,0,0,0,0.99999999999873,354.572311693159,99.9999999999612
24.3,"max_tuv_SVM","SVM",11,28,10433,10083,350,2900,2716,184,0.99965933971842,0.941176470588235,5.96332737030411,309,125,184,1,1.5,21.75,14.8,0,0,0,0,0,0,0.99999999998554,355.031032779171,99.9999999995616
24.3,"max_tuv_SVM","SVM",11,29,10333,9983,350,3000,2816,184,0.999659951316771,0.941176470588235,5.88437775816417,307,125,182,-2,1.5,22.5,15.3,0,0,0,0,0,0,0.999999999999848,352.927965033171,99.9999999999947
24.3,"max_tuv_SVM","SVM",11,30,10233,9883,350,3100,2916,184,0.99966484410358,0.945098039215686,5.80243690165361,306,125,181,-1,1.4,23.25,15.8,0,0,0,0,0,0,0.999999999999948,352.162819134963,99.9999999999968
24.3,"max_tuv_SVM","SVM",11,31,10133,9783,350,3200,3016,184,0.999666678898634,0.945098039215686,5.92095914742451,307,125,182,1,1.5,24,16.4,0,0,0,0,0,0,0.999999999999683,352.466317889476,99.9999999999903
24.3,"max_tuv_SVM","SVM",11,32,10033,9683,350,3300,3116,184,0.999668513693687,0.945098039215686,5.93677649154052,306,124,182,-1,1.5,24.75,16.9,0,0,0,0,0,0,0.99999999999934,352.315818014958,99.99999999998
24.3,"max_tuv_SVM","SVM",11,33,9933,9583,350,3400,3216,184,0.999668513693687,0.941176470588235,5.95267857142857,309,124,185,3,1.5,25.5,17.5,0,0,0,0,0,0,0.999999999998475,352.466258396713,99.9999999999545
24.3,"max_tuv_SVM","SVM",11,34,9833,9483,350,3500,3316,184,0.99967034848874,0.941176470588235,5.95267857142857,308,124,184,-1,1.5,26.25,18,0,0,0,0,0,0,0.999999999997713,352.29310814968,99.9999999999307
24.3,"max_tuv_SVM","SVM",11,35,9733,9383,350,3600,3416,184,0.999676464472252,0.945098039215686,5.94206773618538,309,124,185,1,1.5,27,18.6,0,0,0,0,0,0,0.999999999999382,351.788761311785,99.9999999999808
24.3,"max_tuv_SVM","SVM",11,36,9633,9283,350,3700,3516,184,0.999677687668954,0.945098039215686,5.93677649154052,308,124,184,-1,1.5,27.75,19.1,0,0,0,0,0,0,0.99999999999902,351.606259153384,99.9999999999702
24.3,"max_tuv_SVM","SVM",11,37,9533,9183,350,3800,3616,184,0.999680134062359,0.945098039215686,5.81255448997384,310,124,186,2,1.5,28.5,19.7,0,0,0,0,0,0,0.999999999999937,351.170005803235,99.9999999999966
24.3,"max_tuv_SVM","SVM",11,38,9433,9083,350,3900,3716,184,0.999681357259061,0.945098039215686,5.93677649154052,310,124,186,0,1.5,29.25,20.2,0,0,0,0,0,0,0.999999999998703,351.4810285641,99.9999999999596
24.3,"max_tuv_SVM","SVM",11,39,9333,8983,350,4000,3816,184,0.999682580455763,0.945098039215686,5.91570541259982,310,124,186,0,1.5,30,20.7,0,0,0,0,0,0,0.999999999999617,351.15429684504,99.9999999999875
24.3,"max_tuv_SVM","SVM",11,40,9233,8883,350,4100,3916,184,0.999682580455763,0.945098039215686,5.91570541259982,308,123,185,-2,1.5,30.75,21.3,0,0,0,0,0,0,0.999999999999664,350.992461409346,99.999999999989
24.3,"max_tuv_SVM","SVM",11,41,9133,8783,350,4200,4016,184,0.999687473242572,0.945098039215686,5.94206773618538,308,123,185,0,1.5,31.5,21.8,0,0,0,0,0,0,0.999999999998216,351.110627371889,99.9999999999457
24.3,"max_tuv_SVM","SVM",11,42,9033,8683,350,4300,4116,184,0.999688696439274,0.945098039215686,5.92095914742451,309,123,186,1,1.5,32.25,22.4,0,0,0,0,0,0,0.999999999999562,350.912507141093,99.9999999999863
24.3,"max_tuv_SVM","SVM",11,43,8933,8583,350,4400,4216,184,0.999691142832679,0.945098039215686,5.92622222222222,311,123,188,2,1.5,33,22.9,0,0,0,0,0,0,0.999999999999505,350.887320817097,99.9999999999851
24.3,"max_tuv_SVM","SVM",11,44,8833,8483,350,4500,4316,184,0.999692366029381,0.945098039215686,5.92095914742451,310,123,187,-1,1.5,33.75,23.5,0,0,0,0,0,0,0.99999999999959,350.719849415259,99.9999999999876
24.3,"max_tuv_SVM","SVM",11,45,8733,8383,350,4600,4416,184,0.99969175443103,0.945098039215686,5.93149466192171,310,123,187,0,1.5,34.5,24,0,0,0,0,0,0,0.999999999999651,350.664397125171,99.9999999999893
24.3,"max_tuv_SVM","SVM",11,46,8633,8283,350,4700,4516,184,0.999690531234328,0.945098039215686,5.81255448997384,310,123,187,0,1.5,35.25,24.5,0,0,0,0,0,0,0.999999999999928,350.497127434001,99.9999999999965
24.3,"max_tuv_SVM","SVM",11,47,8533,8183,350,4800,4616,184,0.999689308037625,0.945098039215686,5.95267857142857,310,123,187,0,1.5,36,25.1,0,0,0,0,0,0,0.999999999998929,350.653103597577,99.9999999999686
24.3,"max_tuv_SVM","SVM",11,48,8433,8083,350,4900,4716,184,0.999687473242572,0.945098039215686,5.832895888014,310,123,187,0,1.5,36.75,25.6,0,0,0,0,0,0,0.999999999999904,350.415378423093,99.9999999999959
24.3,"max_tuv_SVM","SVM",12,0,13233,12703,530,100,95,5,0.977571394718627,0.822834645669291,5.7617630113309,24,5,19,0,3.8,0.75,19,0,0,0,0,0,0,0.973118704684217,866.444699156909,98.3428629319048
24.3,"max_tuv_SVM","SVM",12,1,13133,12649,484,200,149,51,0.976592207511558,0.889763779527559,5.65487213559705,72,27,45,48,1.7,1.5,2.9,0,0,0,0,0,0,0.997142729659785,644.216492509688,99.9456343425072
24.3,"max_tuv_SVM","SVM",12,2,13033,12574,459,300,224,76,0.953797097676817,0.889763779527559,5.16870483227268,99,40,59,27,1.5,2.25,2.9,0,0,0,0,0,0,0.995471525471247,554.254574531401,99.7826200934887
24.3,"max_tuv_SVM","SVM",12,3,12933,12497,436,400,301,99,0.958758722133037,0.897637795275591,5.2314100902032,129,55,74,30,1.3,3,3,0,0,0,0,0,0,0.999998503623349,418.868485241029,99.9999393080407
24.3,"max_tuv_SVM","SVM",12,4,12833,12416,417,500,382,118,0.955954992995251,0.897637795275591,5.22678192399863,147,61,86,18,1.4,3.75,3.2,0,0,0,0,0,0,0.999998918856567,371.519779008957,99.9999576800362
24.3,"max_tuv_SVM","SVM",12,5,12733,12335,398,600,463,137,0.962011833738301,0.897637795275591,5.25417514716666,160,70,90,13,1.3,4.5,3.4,0,0,0,0,0,0,0.999999366155445,346.923323409161,99.9999769741568
24.3,"max_tuv_SVM","SVM",12,6,12633,12259,374,700,539,161,0.963113803040325,0.897637795275591,5.27253034418733,160,70,90,0,1.3,5.25,3.3,0,0,0,0,0,0,0.999999775807558,320.175788553128,99.999991505164
24.3,"max_tuv_SVM","SVM",12,7,12533,12161,372,800,637,163,0.965640044643562,0.897637795275591,5.30884664807524,159,69,90,-1,1.3,6,3.9,0,0,0,0,0,0,0.999999623412456,317.707098906806,99.999985142886
24.3,"max_tuv_SVM","SVM",12,8,12433,12070,363,900,728,172,0.969514433649165,0.897637795275591,5.41480370023677,167,70,97,8,1.4,6.75,4.2,0,0,0,0,0,0,0.999678691813303,306.098021092107,99.9816616958754
24.3,"max_tuv_SVM","SVM",12,9,12333,11988,345,1000,810,190,0.976414787384377,0.901574803149606,5.5573260035409,182,77,105,15,1.4,7.5,4.3,0,0,0,0,0,0,0.999691910810033,295.684622920907,99.9823617688089
24.3,"max_tuv_SVM","SVM",12,10,12233,11899,334,1100,899,201,0.982062763751288,0.917322834645669,5.60480813140888,209,90,119,27,1.3,8.25,4.5,0,0,0,0,0,0,0.999792786223124,303.191900919625,99.9883287962461
24.3,"max_tuv_SVM","SVM",12,11,12133,11808,325,1200,990,210,0.981019115944352,0.929133858267717,5.53669414370079,227,100,127,18,1.3,9,4.7,0,0,0,0,0,0,0.999818619396198,300.786759908069,99.9897019927553
24.3,"max_tuv_SVM","SVM",12,12,12033,11709,324,1300,1089,211,0.981590666596262,0.929133858267717,5.54277802970964,227,101,126,0,1.2,9.75,5.2,0,0,0,0,0,0,0.999894166264087,297.177495427165,99.9944438920987
24.3,"max_tuv_SVM","SVM",12,13,11933,11609,324,1400,1189,211,0.981082962633711,0.929133858267717,5.56219231352648,226,101,125,-1,1.2,10.5,5.6,0,0,0,0,0,0,0.999870324327143,296.886857774832,99.9932056389519
24.3,"max_tuv_SVM","SVM",12,14,11833,11511,322,1500,1287,213,0.985981968221546,0.929133858267717,5.63608038259021,230,101,129,4,1.3,11.25,6,0,0,0,0,0,0,0.999923970995596,301.284866036441,99.9960274720149
24.3,"max_tuv_SVM","SVM",12,15,11733,11415,318,1600,1383,217,0.993321881856632,0.929133858267717,5.81487723346144,251,108,143,21,1.3,12,6.4,0,0,0,0,0,0,0.999931047347857,306.758139836432,99.9962659051327
24.3,"max_tuv_SVM","SVM",12,16,11633,11323,310,1700,1475,225,0.997554794579418,0.929133858267717,5.92166869920132,268,115,153,17,1.3,12.75,6.6,0,0,0,0,0,0,0.999950098536548,310.702330353258,99.9973943257636
24.3,"max_tuv_SVM","SVM",12,17,11533,11231,302,1800,1567,233,0.999084659482277,0.940944881889764,5.91570541259982,292,126,166,24,1.3,13.5,6.7,0,0,0,0,0,0,0.999963457187983,311.853534447377,99.9981187758893
24.3,"max_tuv_SVM","SVM",12,18,11433,11136,297,1900,1662,238,0.999391000809134,0.94488188976378,5.93677649154052,303,132,171,11,1.3,14.25,7,0,0,0,0,0,0,0.999989845349017,310.993591396582,99.9994916810727
24.3,"max_tuv_SVM","SVM",12,19,11333,11039,294,2000,1759,241,0.999445638841379,0.94488188976378,5.94206773618538,316,135,181,13,1.3,15,7.3,0,0,0,0,0,0,0.999988441572821,309.438472830806,99.9994238750428
24.3,"max_tuv_SVM","SVM",12,20,11233,10939,294,2100,1859,241,0.999468967439416,0.94488188976378,5.94206773618538,316,136,180,0,1.3,15.75,7.7,0,0,0,0,0,0,0.99999165217663,306.64546939071,99.9995819715685
24.3,"max_tuv_SVM","SVM",12,21,11133,10839,294,2200,1959,241,0.999491682126979,0.94488188976378,5.94206773618538,313,136,177,-3,1.3,16.5,8.1,0,0,0,0,0,0,0.999985544017066,305.417422266248,99.9992719020192
24.3,"max_tuv_SVM","SVM",12,22,11033,10739,294,2300,2059,241,0.999518080277389,0.94488188976378,5.94206773618538,317,135,182,4,1.3,17.25,8.5,0,0,0,0,0,0,0.999998432723607,298.97481289773,99.9999283958719
24.3,"max_tuv_SVM","SVM",12,23,10933,10639,294,2400,2159,241,0.999530972397357,0.94488188976378,5.93149466192171,323,135,188,6,1.4,18,9,0,0,0,0,0,0,0.999998051609136,297.797744433385,99.9999095444238
24.3,"max_tuv_SVM","SVM",12,24,10833,10539,294,2500,2259,241,0.999537111502104,0.94488188976378,5.93677649154052,321,134,187,-2,1.4,18.75,9.4,0,0,0,0,0,0,0.999995922003321,298.485089369916,99.99980894527
24.3,"max_tuv_SVM","SVM",12,25,10733,10439,294,2600,2359,241,0.9995444784278,0.94488188976378,5.9104609929078,319,131,188,-2,1.4,19.5,9.8,0,0,0,0,0,0,0.999999226004487,295.742799411392,99.9999650236662
24.3,"max_tuv_SVM","SVM",12,26,10633,10339,294,2700,2459,241,0.999555528816344,0.94488188976378,5.93149466192171,323,132,191,4,1.4,20.25,10.2,0,0,0,0,0,0,0.999994553606937,297.559087170143,99.9997377052211
24.3,"max_tuv_SVM","SVM",12,27,10533,10239,294,2800,2559,241,0.999564737473464,0.948818897637795,5.9,320,129,191,-3,1.5,21,10.6,0,0,0,0,0,0,0.999998510562626,295.140520766872,99.9999319408979
24.3,"max_tuv_SVM","SVM",12,28,10433,10139,294,2900,2659,241,0.999560440100141,0.948818897637795,5.87400881057269,321,129,192,1,1.5,21.75,11,0,0,0,0,0,0,0.999999153620743,294.332108140751,99.9999616606851
24.3,"max_tuv_SVM","SVM",12,29,10333,10039,294,3000,2759,241,0.99956289574204,0.948818897637795,5.894783377542,320,129,191,-1,1.5,22.5,11.4,0,0,0,0,0,0,0.999998523308428,294.340611979069,99.9999322479555
24.3,"max_tuv_SVM","SVM",12,30,10233,9939,294,3100,2859,241,0.999563509652514,0.948818897637795,5.894783377542,319,130,189,-1,1.5,23.25,11.9,0,0,0,0,0,0,0.999998929921145,294.05480169308,99.99995062269
24.3,"max_tuv_SVM","SVM",12,31,10133,9844,289,3200,2954,246,0.999567193115362,0.948818897637795,5.86883802816901,320,130,190,1,1.5,24,12,0,0,0,0,0,0,0.999999159490831,289.008275749831,99.999961485297
24.3,"max_tuv_SVM","SVM",12,32,10033,9755,278,3300,3043,257,0.99957087657821,0.948818897637795,5.9,319,131,188,-1,1.4,24.75,11.8,0,0,0,0,0,0,0.999998514656341,278.009481510653,99.9999316790544
24.3,"max_tuv_SVM","SVM",12,33,9933,9655,278,3400,3143,257,0.999576401772482,0.948818897637795,5.85338015803336,317,130,187,-2,1.4,25.5,12.2,0,0,0,0,0,0,0.99999929970952,278.005678746237,99.9999681102262
24.3,"max_tuv_SVM","SVM",12,34,9833,9570,263,3500,3228,272,0.999577015682957,0.948818897637795,5.894783377542,317,131,186,0,1.4,26.25,11.9,0,0,0,0,0,0,0.999998899725738,263.006264251498,99.9999497229914
24.3,"max_tuv_SVM","SVM",12,35,9733,9470,263,3600,3328,272,0.999581926966754,0.948818897637795,5.8277972027972,319,131,188,2,1.4,27,12.2,0,0,0,0,0,0,0.999999549131411,263.003586401528,99.9999784372379
24.3,"max_tuv_SVM","SVM",12,36,9633,9398,235,3700,3400,300,0.999578243503906,0.948818897637795,5.832895888014,317,131,186,-2,1.4,27.75,11.3,0,0,0,0,0,0,0.999999494475338,235.003528648118,99.9999759760539
24.3,"max_tuv_SVM","SVM",12,37,9533,9298,235,3800,3500,300,0.999584382608653,0.948818897637795,5.87918871252205,318,131,187,1,1.4,28.5,11.7,0,0,0,0,0,0,0.99999902378349,235.00339882763,99.999954751438
24.3,"max_tuv_SVM","SVM",12,38,9433,9198,235,3900,3600,300,0.999583768698178,0.948818897637795,5.894783377542,317,131,186,-1,1.4,29.25,12,0,0,0,0,0,0,0.999998875003261,235.004024721703,99.9999474633213
24.3,"max_tuv_SVM","SVM",12,39,9333,9107,226,4000,3691,309,0.999584382608653,0.948818897637795,5.832895888014,317,131,186,0,1.4,30,11.9,0,0,0,0,0,0,0.999999541615592,226.002208096607,99.9999776836062
24.3,"max_tuv_SVM","SVM",12,40,9233,9014,219,4100,3784,316,0.999586224340077,0.948818897637795,5.86883802816901,319,132,187,2,1.4,30.75,12,0,0,0,0,0,0,0.99999914371872,219.002295094922,99.9999594060194
24.3,"max_tuv_SVM","SVM",12,41,9133,8956,177,4200,3842,358,0.999578243503906,0.948818897637795,5.8277972027972,318,131,187,-1,1.4,31.5,10.7,0,0,0,0,0,0,0.999999616343096,177.00163911684,99.9999805266625
24.3,"max_tuv_SVM","SVM",12,42,9033,8856,177,4300,3942,358,0.99958008523533,0.948818897637795,5.8277972027972,319,131,188,1,1.4,32.25,11,0,0,0,0,0,0,0.999999575310053,177.001221866057,99.9999784504733
24.3,"max_tuv_SVM","SVM",12,43,8933,8756,177,4400,4042,358,0.999577629593432,0.948818897637795,5.80243690165361,320,132,188,1,1.4,33,11.3,0,0,0,0,0,0,0.999999707222487,177.00091061742,99.9999840409275
24.3,"max_tuv_SVM","SVM",12,44,8833,8665,168,4500,4133,367,0.99957210439916,0.948818897637795,5.8585237258348,319,131,188,-1,1.4,33.75,11.3,0,0,0,0,0,0,0.999999332715825,168.001291711773,99.9999676477476
24.3,"max_tuv_SVM","SVM",12,45,8733,8566,167,4600,4232,368,0.999573946130584,0.948818897637795,5.8277972027972,318,131,187,-1,1.4,34.5,11.5,0,0,0,0,0,0,0.999999642850268,167.000753017631,99.9999814674747
24.3,"max_tuv_SVM","SVM",12,46,8633,8488,145,4700,4310,390,0.999569648757261,0.948818897637795,5.8585237258348,317,132,185,-1,1.4,35.25,11.1,0,0,0,0,0,0,0.999999361397334,145.000959141753,99.999968697814
24.3,"max_tuv_SVM","SVM",12,47,8533,8388,145,4800,4410,390,0.999569648757261,0.948818897637795,5.82270742358079,316,132,184,-1,1.4,36,11.3,0,0,0,0,0,0,0.999999999999572,145.79547323969,99.9999999999857
24.3,"max_tuv_SVM","SVM",12,48,8433,8288,145,4900,4510,390,0.999565965294413,0.948818897637795,5.8585237258348,318,132,186,2,1.4,36.75,11.6,0,0,0,0,0,0,0.999999999998605,145.748314855647,99.9999999999544
24.3,"max_tuv_SVM","SVM",13,0,13233,12733,500,100,95,5,0.961754704949107,0.809859154929577,5.18260391318241,20,5,15,0,3,0.75,19,0,0,0,0,0,0,0.993142913907211,714.28865952488,99.7676362479341
24.3,"max_tuv_SVM","SVM",13,1,13133,12647,486,200,181,19,0.94107229149613,0.880281690140845,5.14088121543633,53,18,35,33,1.9,1.5,9.5,0,0,0,0,0,0,0.847320336564693,530.910389183629,91.7212604710568
24.3,"max_tuv_SVM","SVM",13,2,13033,12620,413,300,208,92,0.958239094602063,0.901408450704225,5.30551151586658,83,35,48,30,1.4,2.25,2.3,0,0,0,0,0,0,0.997901962712631,444.601161537248,99.8745157748681
24.3,"max_tuv_SVM","SVM",13,3,12933,12558,375,400,270,130,0.947690056995602,0.901408450704225,5.27628633963571,125,54,71,42,1.3,3,2.1,0,0,0,0,0,0,0.997278972669321,333.485140992655,99.8394338574668
24.3,"max_tuv_SVM","SVM",13,4,12833,12487,346,500,341,159,0.947725913683584,0.901408450704225,5.19420064031553,144,64,80,19,1.2,3.75,2.1,0,0,0,0,0,0,0.999906104826517,289.111116471863,99.9952205920161
24.3,"max_tuv_SVM","SVM",13,5,12733,12387,346,600,441,159,0.9513369579848,0.901408450704225,5.24863767759395,147,65,82,3,1.3,4.5,2.8,0,0,0,0,0,0,0.9998981771553,288.011762897636,99.994531854629
24.3,"max_tuv_SVM","SVM",13,6,12633,12368,265,700,460,240,0.950391444704584,0.901408450704225,5.25782164553375,154,71,83,7,1.2,5.25,1.9,0,0,0,0,0,0,0.999923237751624,207.182943063236,99.9960637275914
24.3,"max_tuv_SVM","SVM",13,7,12533,12339,194,800,489,311,0.949921446271239,0.901408450704225,5.25322564759185,151,68,83,-3,1.2,6,1.6,0,0,0,0,0,0,0.999909599981524,136.16364251145,99.995345004195
24.3,"max_tuv_SVM","SVM",13,8,12433,12321,112,900,507,393,0.94981332456591,0.901408450704225,5.25322564759185,152,68,84,1,1.2,6.75,1.3,0,0,0,0,0,0,0.00273261727671674,54.2451817879359,54.1306095029425
24.3,"max_tuv_SVM","SVM",13,9,12333,12256,77,1000,572,428,0.952893138243523,0.901408450704225,5.23036565782861,151,67,84,-1,1.3,7.5,1.3,0,0,0,0,0,0,7.6267482161776e-06,19.0274989102553,19.0245669952516
24.3,"max_tuv_SVM","SVM",13,10,12233,12173,60,1100,655,445,0.953969942165904,0.901408450704225,5.2349217254748,152,68,84,1,1.2,8.25,1.5,0,0,0,0,0,0,4.24565829008791e-06,2.00249089379974,2.0005212945697
24.3,"max_tuv_SVM","SVM",13,11,12133,12074,59,1200,754,446,0.954813953437044,0.901408450704225,5.23036565782861,148,66,82,-4,1.2,9,1.7,0,0,0,0,0,0,2.2148469225253e-06,1.00113958825064,1.00027616049434
24.3,"max_tuv_SVM","SVM",13,12,12033,11975,58,1300,853,447,0.955215548342536,0.901408450704225,5.2349217254748,149,66,83,1,1.3,9.75,1.9,0,0,0,0,0,0,1.19114914976168e-06,0.000676514485820085,0.000151857754188092
24.3,"max_tuv_SVM","SVM",13,13,11933,11875,58,1400,953,447,0.955928268971481,0.901408450704225,5.24405771452449,151,68,83,2,1.2,10.5,2.1,0,0,0,0,0,0,1.06027856452479e-06,0.00058706430624837,0.000132302894494565
24.3,"max_tuv_SVM","SVM",13,14,11833,11775,58,1500,1053,447,0.955935991950434,0.901408450704225,5.23948573744121,152,69,83,1,1.2,11.25,2.4,0,0,0,0,0,0,3.26685695469025e-07,0.000187114988429644,4.09352150237501e-05
24.3,"max_tuv_SVM","SVM",13,15,11733,11675,58,1600,1153,447,0.956114723749032,0.901408450704225,5.24863767759395,153,69,84,1,1.2,12,2.6,0,0,0,0,0,0,3.29649050339119e-07,0.000199650493753724,3.94700270743864e-05
24.3,"max_tuv_SVM","SVM",13,16,11633,11576,57,1700,1252,448,0.959204466971017,0.901408450704225,5.32409474359291,154,69,85,1,1.2,12.75,2.8,0,0,0,0,0,0,6.10585320588926e-07,0.000426208103760205,0.00011032416159254
24.3,"max_tuv_SVM","SVM",13,17,11533,11480,53,1800,1348,452,0.97024446538228,0.901408450704225,5.45260838078114,174,75,99,20,1.3,13.5,3,0,0,0,0,0,0,1.46991666816229e-05,0.294736498575297,0.290393041046001
24.3,"max_tuv_SVM","SVM",13,18,11433,11393,40,1900,1435,465,0.985059897218168,0.908450704225352,5.69162622270032,203,92,111,29,1.2,14.25,3.1,0,0,0,0,0,0,0.00473930868697928,1.52398190600901,0.782790581410115
24.3,"max_tuv_SVM","SVM",13,19,11333,11303,30,2000,1525,475,0.991475486161505,0.919014084507042,5.77983691623425,225,105,120,22,1.1,15,3.2,0,0,0,0,0,0,0.00621552389080972,3.45183667907797,0.938835923374458
24.3,"max_tuv_SVM","SVM",13,20,11233,11214,19,2100,1614,486,0.996263733111505,0.936619718309859,5.8897981639839,254,113,141,29,1.2,15.75,3.3,0,0,0,0,0,0,0.00932456690922684,7.93347034073449,1.24388072781766
24.3,"max_tuv_SVM","SVM",13,21,11133,11120,13,2200,1708,492,0.998923196077609,0.943661971830986,5.97401433691756,276,124,152,22,1.2,16.5,3.5,0,0,0,0,0,0,0.0113629039678784,10.203848193493,1.55790729508093
24.3,"max_tuv_SVM","SVM",13,22,11033,11027,6,2300,1801,499,0.999602266583994,0.954225352112676,5.9686660698299,296,132,164,20,1.2,17.25,3.6,0,0,0,0,0,0,0.0119213407159482,8.85813176559374,1.67730429386116
24.3,"max_tuv_SVM","SVM",13,23,10933,10932,1,2400,1896,504,0.999711491572023,0.957746478873239,5.9686660698299,307,137,170,11,1.2,18,3.8,0,0,0,0,0,0,0.0105404788915552,8.54719679678115,1.30708301839293
24.3,"max_tuv_SVM","SVM",13,24,10833,10833,0,2500,1995,505,0.999737970357,0.957746478873239,5.9686660698299,312,138,174,5,1.3,18.75,4,0,0,0,0,0,0,0.00766668188391111,5.7921456034764,0.861347696662004
24.3,"max_tuv_SVM","SVM",13,25,10733,10733,0,2600,2095,505,0.999751209749489,0.957746478873239,5.97937219730942,314,138,176,2,1.3,19.5,4.1,0,0,0,0,0,0,0.00615031626710075,4.51361581238861,0.668123929335909
24.3,"max_tuv_SVM","SVM",13,26,10633,10633,0,2700,2195,505,0.99976334585927,0.957746478873239,5.97937219730942,313,138,175,-1,1.3,20.25,4.3,0,0,0,0,0,0,0.00542254297205372,3.8952479534819,0.579399781301598
24.3,"max_tuv_SVM","SVM",13,27,10533,10533,0,2800,2295,505,0.999770517196868,0.957746478873239,5.97401433691756,313,138,175,0,1.3,21,4.5,0,0,0,0,0,0,0.00413446996912801,2.08396827700364,0.440371711633615
24.3,"max_tuv_SVM","SVM",13,28,10433,10433,0,2900,2395,505,0.999776585251758,0.957746478873239,5.96332737030411,313,137,176,0,1.3,21.75,4.7,0,0,0,0,0,0,0.00306182110241454,0.842618075947986,0.327105670049905
24.3,"max_tuv_SVM","SVM",13,29,10333,10333,0,3000,2495,505,0.999783204948002,0.957746478873239,5.95267857142857,311,136,175,-2,1.3,22.5,4.9,0,0,0,0,0,0,0.00283488962568522,0.669149402572337,0.301682551424971
24.3,"max_tuv_SVM","SVM",13,30,10233,10233,0,3100,2595,505,0.999792582851015,0.961267605633803,5.9579982126899,310,135,175,-1,1.3,23.25,5.1,0,0,0,0,0,0,0.00271860882719121,0.499736448736122,0.284404315938621
24.3,"max_tuv_SVM","SVM",13,31,10133,10133,0,3200,2695,505,0.999801409112674,0.961267605633803,5.95267857142857,313,135,178,3,1.3,24,5.3,0,0,0,0,0,0,1.59856390481701e-05,0.0149316384800346,0.00432219057065442
24.3,"max_tuv_SVM","SVM",13,32,10033,10033,0,3300,2795,505,0.999810787015686,0.961267605633803,5.94736842105263,313,134,179,0,1.3,24.75,5.5,0,0,0,0,0,0,1.05642478108454e-05,0.00785007316030522,0.00115093209259732
24.3,"max_tuv_SVM","SVM",13,33,9933,9933,0,3400,2895,505,0.999814096863809,0.961267605633803,5.95267857142857,313,134,179,0,1.3,25.5,5.7,0,0,0,0,0,0,9.33494012264426e-06,0.00719606217391764,0.00102489738047429
24.3,"max_tuv_SVM","SVM",13,34,9833,9833,0,3500,2995,505,0.999819061635992,0.961267605633803,5.9579982126899,312,134,178,-1,1.3,26.25,5.9,0,0,0,0,0,0,1.22648931346787e-05,0.0101725440384922,0.00132908573588725
24.3,"max_tuv_SVM","SVM",13,35,9733,9733,0,3600,3095,505,0.999824578049529,0.964788732394366,5.91570541259982,312,134,178,0,1.3,27,6.1,0,0,0,0,0,0,4.41079452030102e-06,0.00334092505421662,0.000495878010020389
24.3,"max_tuv_SVM","SVM",13,36,9633,9633,0,3700,3195,505,0.999828439539004,0.964788732394366,5.94736842105263,310,132,178,-2,1.3,27.75,6.3,0,0,0,0,0,0,4.30680882636604e-06,0.00343696904812603,0.00047349129658216
24.3,"max_tuv_SVM","SVM",13,37,9533,9533,0,3800,3295,505,0.999831749387126,0.964788732394366,5.94736842105263,310,132,178,0,1.3,28.5,6.5,0,0,0,0,0,0,3.69837896964957e-06,0.00296708047349743,0.000399633711459392
24.3,"max_tuv_SVM","SVM",13,38,9433,9433,0,3900,3395,505,0.999832852669834,0.964788732394366,5.9104609929078,311,132,179,1,1.4,29.25,6.7,0,0,0,0,0,0,2.06082174113137e-06,0.00162146138630623,0.000223756652901204
24.3,"max_tuv_SVM","SVM",13,39,9333,9333,0,4000,3495,505,0.999835610876602,0.964788732394366,5.95267857142857,310,132,178,-1,1.3,30,6.9,0,0,0,0,0,0,0.000984768420266644,1.54725007014749,0.101767056880612
24.3,"max_tuv_SVM","SVM",13,40,9233,9233,0,4100,3595,505,0.999837817442017,0.964788732394366,5.92622222222222,308,132,176,-2,1.3,30.75,7.1,0,0,0,0,0,0,0.000772086872613839,1.18809224193462,0.0804215335312734
24.3,"max_tuv_SVM","SVM",13,41,9133,9133,0,4200,3695,505,0.999840575648785,0.964788732394366,5.95267857142857,310,133,177,2,1.3,31.5,7.3,0,0,0,0,0,0,0.000845228188990959,1.37982211371179,0.0877802491068537
24.3,"max_tuv_SVM","SVM",13,42,9033,9033,0,4300,3795,505,0.999843333855554,0.964788732394366,5.92622222222222,309,132,177,-1,1.3,32.25,7.5,0,0,0,0,0,0,0.000631959021046591,0.989242095669073,0.065734932134251
24.3,"max_tuv_SVM","SVM",13,43,8933,8933,0,4400,3895,505,0.999844437138261,0.964788732394366,5.8277972027972,310,133,177,1,1.3,33,7.7,0,0,0,0,0,0,0.000513587030715969,0.770233457417139,0.0534755496795713
24.3,"max_tuv_SVM","SVM",13,44,8833,8833,0,4500,3995,505,0.999844437138261,0.964788732394366,5.95267857142857,308,133,175,-2,1.3,33.75,7.9,0,0,0,0,0,0,0.000786545629458917,1.32708847799354,0.0812025409338485
24.3,"max_tuv_SVM","SVM",13,45,8733,8733,0,4600,4095,505,0.999846092062322,0.964788732394366,5.9,310,133,177,2,1.3,34.5,8.1,0,0,0,0,0,0,0.000474748453106884,0.748844070784032,0.0496042331746147
24.3,"max_tuv_SVM","SVM",13,46,8633,8633,0,4700,4195,505,0.999846643703676,0.964788732394366,5.93149466192171,308,133,175,-2,1.3,35.25,8.3,0,0,0,0,0,0,0.000467811623625369,0.755183454901409,0.0484692306167907
24.3,"max_tuv_SVM","SVM",13,47,8533,8533,0,4800,4295,505,0.999847746986383,0.964788732394366,5.9,308,133,175,0,1.3,36,8.5,0,0,0,0,0,0,0.000456804044457005,0.738151411154125,0.0471732005406852
24.3,"max_tuv_SVM","SVM",13,48,8433,8433,0,4900,4395,505,0.999848298627737,0.964788732394366,5.87400881057269,308,132,176,0,1.3,36.75,8.7,0,0,0,0,0,0,0.000371663704025667,0.592053820374348,0.0385811616847496
24.3,"max_tuv_SVM","SVM",14,0,13233,12705,528,100,93,7,0.961838097073939,0.803149606299213,5.39374960769408,22,7,15,0,2.1,0.75,13.3,0,0,0,0,0,0,0.999999457535359,706.063653728975,99.9999859481965
24.3,"max_tuv_SVM","SVM",14,1,13133,12653,480,200,145,55,0.947069866695433,0.877952755905512,5.36678501124859,73,30,43,51,1.4,1.5,2.6,0,0,0,0,0,0,0.988264432833714,545.817409504947,99.4206036399482
24.3,"max_tuv_SVM","SVM",14,2,13033,12586,447,300,212,88,0.938932483353797,0.881889763779528,5.05986149321696,107,49,58,34,1.2,2.25,2.4,0,0,0,0,0,0,0.999999735396696,408.893027157394,99.9999898016456
24.3,"max_tuv_SVM","SVM",14,3,12933,12503,430,400,295,105,0.942348895145317,0.881889763779528,5.05986149321696,138,62,76,31,1.2,3,2.8,0,0,0,0,0,0,0.999999955202612,377.049870093982,99.9999980788757
24.3,"max_tuv_SVM","SVM",14,4,12833,12423,410,500,375,125,0.942624540948448,0.881889763779528,5.04683180696833,149,68,81,11,1.2,3.75,3,0,0,0,0,0,0,0.999999979470147,355.687272293166,99.9999992112208
24.3,"max_tuv_SVM","SVM",14,5,12733,12324,409,600,474,126,0.943670030486791,0.881889763779528,5.05116757312552,141,66,75,-8,1.1,4.5,3.8,0,0,0,0,0,0,0.999999984665976,353.972666414025,99.9999994635061
24.3,"max_tuv_SVM","SVM",14,6,12633,12225,408,700,573,127,0.945495186327968,0.881889763779528,5.07733942583602,145,69,76,4,1.1,5.25,4.5,0,0,0,0,0,0,0.999999993783584,352.439788734041,99.9999997950905
24.3,"max_tuv_SVM","SVM",14,7,12533,12126,407,800,672,128,0.946249682301328,0.881889763779528,5.08612375010217,143,68,75,-2,1.1,6,5.2,0,0,0,0,0,0,0.999999979356615,351.437886716121,99.9999993025701
24.3,"max_tuv_SVM","SVM",14,8,12433,12026,407,900,772,128,0.948025725304529,0.881889763779528,5.11768378389443,145,67,78,2,1.2,6.75,6,0,0,0,0,0,0,0.999999981714318,351.289205263991,99.999999362368
24.3,"max_tuv_SVM","SVM",14,9,12333,11926,407,1000,872,128,0.949042974961036,0.881889763779528,5.1221223647998,147,69,78,2,1.1,7.5,6.8,0,0,0,0,0,0,0.999999985887507,351.230711877573,99.9999995240681
24.3,"max_tuv_SVM","SVM",14,10,12233,11827,406,1100,971,129,0.949703542631776,0.881889763779528,5.1221223647998,147,67,80,0,1.2,8.25,7.5,0,0,0,0,0,0,0.999999987075918,350.198531598293,99.9999995570914
24.3,"max_tuv_SVM","SVM",14,11,12133,11729,404,1200,1069,131,0.951399163362794,0.881889763779528,5.14935340113736,148,70,78,1,1.1,9,8.2,0,0,0,0,0,0,0.999999932877478,348.245018928898,99.9999976816198
24.3,"max_tuv_SVM","SVM",14,12,12033,11630,403,1300,1168,132,0.95449634170748,0.881889763779528,5.17180045170901,153,70,83,5,1.2,9.75,8.8,0,0,0,0,0,0,0.999999928064979,348.425958288521,99.9999974289927
24.3,"max_tuv_SVM","SVM",14,13,11933,11538,395,1400,1260,140,0.971348184236969,0.885826771653543,5.48674529058536,173,80,93,20,1.2,10.5,9,0,0,0,0,0,0,0.999999812201114,346.978229423118,99.999992819654
24.3,"max_tuv_SVM","SVM",14,14,11833,11479,354,1500,1319,181,0.979439524293017,0.901574803149606,5.62125984251969,200,92,108,27,1.2,11.25,7.3,0,0,0,0,0,0,0.99999994889579,318.264722939698,99.9999980732393
24.3,"max_tuv_SVM","SVM",14,15,11733,11391,342,1600,1407,193,0.983446517961156,0.921259842519685,5.65770290197824,228,106,122,28,1.2,12,7.3,0,0,0,0,0,0,0.999999926490942,320.917573469637,99.9999970783825
24.3,"max_tuv_SVM","SVM",14,16,11633,11297,336,1700,1501,199,0.986845740259404,0.925196850393701,5.70103520969453,245,111,134,17,1.2,12.75,7.5,0,0,0,0,0,0,0.999999989931249,319.864659481284,99.9999996106881
24.3,"max_tuv_SVM","SVM",14,17,11533,11199,334,1800,1599,201,0.99057217684061,0.925196850393701,5.76802827360103,244,112,132,-1,1.2,13.5,8,0,0,0,0,0,0,0.999999993034975,321.361510644111,99.9999997252548
24.3,"max_tuv_SVM","SVM",14,18,11433,11103,330,1900,1695,205,0.994765185382549,0.929133858267717,5.7941133355671,261,118,143,17,1.2,14.25,8.3,0,0,0,0,0,0,0.999999997720527,325.133632534787,99.9999999045
24.3,"max_tuv_SVM","SVM",14,19,11333,11009,324,2000,1789,211,0.997660387181058,0.933070866141732,5.93149466192171,278,126,152,17,1.2,15,8.5,0,0,0,0,0,0,0.999999999362583,327.463113407532,99.9999999717931
24.3,"max_tuv_SVM","SVM",14,20,11233,10913,320,2100,1885,215,0.999169993038255,0.933070866141732,5.93677649154052,292,130,162,14,1.2,15.75,8.8,0,0,0,0,0,0,0.999999999461633,327.490524035269,99.9999999766315
24.3,"max_tuv_SVM","SVM",14,21,11133,10818,315,2200,1980,220,0.999496593410776,0.940944881889764,5.97937219730942,307,135,172,15,1.3,16.5,9,0,0,0,0,0,0,0.999999999944041,325.268773835685,99.9999999977209
24.3,"max_tuv_SVM","SVM",14,22,11033,10719,314,2300,2079,221,0.999518694187864,0.940944881889764,5.97401433691756,314,136,178,7,1.3,17.25,9.4,0,0,0,0,0,0,0.999999999450498,325.662927459109,99.9999999775811
24.3,"max_tuv_SVM","SVM",14,23,10933,10619,314,2400,2179,221,0.999527288934509,0.940944881889764,5.97401433691756,314,136,178,0,1.3,18,9.9,0,0,0,0,0,0,0.99999999981607,323.494867512186,99.9999999927114
24.3,"max_tuv_SVM","SVM",14,24,10833,10519,314,2500,2279,221,0.999545706248749,0.940944881889764,5.97401433691756,316,136,180,2,1.3,18.75,10.3,0,0,0,0,0,0,0.999999999991448,319.95608185256,99.9999999996725
24.3,"max_tuv_SVM","SVM",14,25,10733,10419,314,2600,2379,221,0.999556756637293,0.940944881889764,5.97937219730942,315,136,179,-1,1.3,19.5,10.8,0,0,0,0,0,0,0.999999999961018,320.443726287307,99.9999999984682
24.3,"max_tuv_SVM","SVM",14,26,10633,10319,314,2700,2479,221,0.999573332220109,0.940944881889764,5.97937219730942,317,136,181,2,1.3,20.25,11.2,0,0,0,0,0,0,0.999999999973324,319.248007104602,99.9999999989798
24.3,"max_tuv_SVM","SVM",14,27,10533,10219,314,2800,2579,221,0.9995905217134,0.940944881889764,5.97937219730942,316,136,180,-1,1.3,21,11.7,0,0,0,0,0,0,0.999999999895597,319.749916817526,99.9999999959388
24.3,"max_tuv_SVM","SVM",14,28,10433,10119,314,2900,2679,221,0.999605869475266,0.940944881889764,5.96332737030411,314,135,179,-2,1.3,21.75,12.1,0,0,0,0,0,0,0.999999999994576,317.398816622776,99.9999999998005
24.3,"max_tuv_SVM","SVM",14,29,10333,10019,314,3000,2779,221,0.999612622490488,0.940944881889764,5.96332737030411,314,135,179,0,1.3,22.5,12.6,0,0,0,0,0,0,0.999999999994122,317.346853402535,99.999999999782
24.3,"max_tuv_SVM","SVM",14,30,10233,9919,314,3100,2879,221,0.999620603326658,0.940944881889764,5.95267857142857,315,135,180,1,1.3,23.25,13,0,0,0,0,0,0,0.999999999998115,316.656707535395,99.9999999999311
24.3,"max_tuv_SVM","SVM",14,31,10133,9819,314,3200,2979,221,0.999634723267575,0.940944881889764,5.96332737030411,317,135,182,2,1.3,24,13.5,0,0,0,0,0,0,0.99999999996512,317.419882662213,99.999999998645
24.3,"max_tuv_SVM","SVM",14,32,10033,9719,314,3300,3079,221,0.999639634551373,0.940944881889764,5.9579982126899,321,135,186,4,1.4,24.75,13.9,0,0,0,0,0,0,0.999999999975505,316.811177985257,99.9999999990491
24.3,"max_tuv_SVM","SVM",14,33,9933,9619,314,3400,3179,221,0.999646387566594,0.94488188976378,5.93677649154052,322,136,186,1,1.4,25.5,14.4,0,0,0,0,0,0,0.999999999996294,316.270702664737,99.9999999998625
24.3,"max_tuv_SVM","SVM",14,34,9833,9519,314,3500,3279,221,0.999643318014221,0.94488188976378,5.9104609929078,321,136,185,-1,1.4,26.25,14.8,0,0,0,0,0,0,0.999999999998843,315.685202924072,99.9999999999581
24.3,"max_tuv_SVM","SVM",14,35,9733,9419,314,3600,3379,221,0.999654982313239,0.94488188976378,5.92095914742451,322,136,186,1,1.4,27,15.3,0,0,0,0,0,0,0.999999999998302,315.592302718848,99.9999999999384
24.3,"max_tuv_SVM","SVM",14,36,9633,9319,314,3700,3479,221,0.999658051865613,0.94488188976378,5.93149466192171,321,136,185,-1,1.4,27.75,15.7,0,0,0,0,0,0,0.999999999997666,315.610227482081,99.9999999999137
24.3,"max_tuv_SVM","SVM",14,37,9533,9219,314,3800,3579,221,0.999663270104647,0.94488188976378,5.8636763412489,320,136,184,-1,1.4,28.5,16.2,0,0,0,0,0,0,0.99999999999962,315.071590126486,99.9999999999856
24.3,"max_tuv_SVM","SVM",14,38,9433,9119,314,3900,3679,221,0.999670330075106,0.94488188976378,5.92095914742451,318,136,182,-2,1.3,29.25,16.6,0,0,0,0,0,0,0.99999999999843,315.243249668673,99.9999999999408
24.3,"max_tuv_SVM","SVM",14,39,9333,9019,314,4000,3779,221,0.999675855269378,0.94488188976378,5.80243690165361,320,136,184,2,1.4,30,17.1,0,0,0,0,0,0,0.999999999999876,314.780220427984,99.9999999999947
24.3,"max_tuv_SVM","SVM",14,40,9233,8919,314,4100,3879,221,0.999680766553175,0.94488188976378,5.894783377542,320,136,184,0,1.4,30.75,17.6,0,0,0,0,0,0,0.999999999999312,314.980282117336,99.9999999999753
24.3,"max_tuv_SVM","SVM",14,41,9133,8819,314,4200,3979,221,0.99968138046365,0.94488188976378,5.94736842105263,319,135,184,-1,1.4,31.5,18,0,0,0,0,0,0,0.999999999990767,315.371640157139,99.9999999996599
24.3,"max_tuv_SVM","SVM",14,42,9033,8719,314,4300,4079,221,0.999681994374124,0.94488188976378,5.92622222222222,321,137,184,2,1.3,32.25,18.5,0,0,0,0,0,0,0.999999999998167,314.930090518385,99.9999999999338
24.3,"max_tuv_SVM","SVM",14,43,8933,8619,314,4400,4179,221,0.999687519568396,0.94488188976378,5.88957597173145,320,136,184,-1,1.4,33,18.9,0,0,0,0,0,0,0.999999999999287,314.685996401423,99.9999999999742
24.3,"max_tuv_SVM","SVM",14,44,8833,8519,314,4500,4279,221,0.999689975210295,0.94488188976378,5.93149466192171,320,136,184,0,1.4,33.75,19.4,0,0,0,0,0,0,0.999999999998658,314.705564814719,99.9999999999518
24.3,"max_tuv_SVM","SVM",14,45,8733,8419,314,4600,4379,221,0.999691816941719,0.948818897637795,5.88957597173145,319,135,184,-1,1.4,34.5,19.8,0,0,0,0,0,0,0.99999999999937,314.567497152323,99.9999999999773
24.3,"max_tuv_SVM","SVM",14,46,8633,8319,314,4700,4479,221,0.99968936129982,0.948818897637795,5.9,320,136,184,1,1.4,35.25,20.3,0,0,0,0,0,0,0.999999999999183,314.589038915272,99.9999999999706
24.3,"max_tuv_SVM","SVM",14,47,8533,8219,314,4800,4579,221,0.99968936129982,0.948818897637795,5.94736842105263,320,137,183,0,1.3,36,20.7,0,0,0,0,0,0,0.999999999997259,314.667452950316,99.9999999998992
24.3,"max_tuv_SVM","SVM",14,48,8433,8119,314,4900,4679,221,0.999692430852194,0.948818897637795,5.9,321,137,184,1,1.3,36.75,21.2,0,0,0,0,0,0,0.999999999999532,314.471743447672,99.9999999999827
24.3,"max_tuv_SVM","SVM",15,0,13233,12707,526,100,95,5,0.960141443536872,0.779069767441861,5.42055314913719,25,5,20,0,4,0.75,19,0,0,0,0,0,0,0.995422038605488,673.53723576772,99.8947867982168
24.3,"max_tuv_SVM","SVM",15,1,13133,12666,467,200,136,64,0.977936791890258,0.883720930232558,5.596598681756,71,28,43,46,1.5,1.5,2.1,0,0,0,0,0,0,0.995868594447171,574.214207525079,99.8883182805233
24.3,"max_tuv_SVM","SVM",15,2,13033,12595,438,300,207,93,0.958151146461913,0.891472868217054,5.26226606478309,91,39,52,20,1.3,2.25,2.2,0,0,0,0,0,0,0.999999265173582,429.688947474838,99.9999734956965
24.3,"max_tuv_SVM","SVM",15,3,12933,12517,416,400,285,115,0.963122353376603,0.891472868217054,5.37133475508615,128,56,72,37,1.3,3,2.5,0,0,0,0,0,0,0.999999977402169,361.771989672353,99.9999992799631
24.3,"max_tuv_SVM","SVM",15,4,12833,12447,386,500,355,145,0.959332261681425,0.891472868217054,5.25809908998989,148,68,80,20,1.2,3.75,2.4,0,0,0,0,0,0,0.999999978759065,329.081234618924,99.9999992597455
24.3,"max_tuv_SVM","SVM",15,5,12733,12358,375,600,444,156,0.959287508723803,0.891472868217054,5.26267532940676,152,70,82,4,1.2,4.5,2.8,0,0,0,0,0,0,0.999999996621061,317.826105439456,99.9999998777023
24.3,"max_tuv_SVM","SVM",15,6,12633,12258,375,700,544,156,0.961343120926129,0.891472868217054,5.26267532940676,152,72,80,0,1.1,5.25,3.5,0,0,0,0,0,0,0.999999990347414,317.457519329726,99.9999996674132
24.3,"max_tuv_SVM","SVM",15,7,12533,12158,375,800,644,156,0.9621486741634,0.891472868217054,5.30826489402071,156,73,83,4,1.1,6,4.1,0,0,0,0,0,0,0.999999991960401,317.405185828731,99.9999997245493
24.3,"max_tuv_SVM","SVM",15,8,12433,12059,374,900,743,157,0.963733170771249,0.891472868217054,5.32619748823669,151,72,79,-5,1.1,6.75,4.7,0,0,0,0,0,0,0.999999986350599,316.228838624049,99.999999579684
24.3,"max_tuv_SVM","SVM",15,9,12333,11959,374,1000,843,157,0.963870453492618,0.891472868217054,5.33085325527186,151,71,80,0,1.1,7.5,5.4,0,0,0,0,0,0,0.999999997973838,316.191796002062,99.9999999429064
24.3,"max_tuv_SVM","SVM",15,10,12233,11859,374,1100,943,157,0.964347012014365,0.891472868217054,5.33085325527186,149,71,78,-2,1.1,8.25,6,0,0,0,0,0,0,0.999999994833444,316.126011905115,99.9999998530378
24.3,"max_tuv_SVM","SVM",15,11,12133,11759,374,1200,1043,157,0.96513865554859,0.891472868217054,5.32619748823669,149,69,80,0,1.2,9,6.6,0,0,0,0,0,0,0.999999994172734,316.152634237306,99.9999998319388
24.3,"max_tuv_SVM","SVM",15,12,12033,11661,372,1300,1141,159,0.973318165709302,0.891472868217054,5.43546053033854,157,71,86,8,1.2,9.75,7.2,0,0,0,0,0,0,0.999999920652904,316.638354185683,99.999997211884
24.3,"max_tuv_SVM","SVM",15,13,11933,11571,362,1400,1231,169,0.981833323052231,0.903100775193798,5.59890180878553,178,81,97,21,1.2,10.5,7.3,0,0,0,0,0,0,0.999999738102626,316.707962003047,99.9999902628217
24.3,"max_tuv_SVM","SVM",15,14,11833,11508,325,1500,1294,206,0.981291449403124,0.930232558139535,5.58420652844751,208,98,110,30,1.1,11.25,6.3,0,0,0,0,0,0,0.999999999320481,295.511003921467,99.9999999820644
24.3,"max_tuv_SVM","SVM",15,15,11733,11410,323,1600,1392,208,0.981469856463932,0.930232558139535,5.57932522903453,212,99,113,4,1.1,12,6.7,0,0,0,0,0,0,0.999999998070252,294.734281935634,99.9999999453522
24.3,"max_tuv_SVM","SVM",15,16,11633,11310,323,1700,1492,208,0.981257582300055,0.930232558139535,5.56958818675,214,99,115,2,1.2,12.75,7.2,0,0,0,0,0,0,0.999999996624943,294.838264365886,99.9999999018782
24.3,"max_tuv_SVM","SVM",15,17,11533,11211,322,1800,1591,209,0.983044676756622,0.930232558139535,5.58726168028494,216,99,117,2,1.2,13.5,7.6,0,0,0,0,0,0,0.99999998612748,295.436852769312,99.9999995687208
24.3,"max_tuv_SVM","SVM",15,18,11433,11113,320,1900,1689,211,0.985948176075056,0.930232558139535,5.65698013820443,227,103,124,11,1.2,14.25,8,0,0,0,0,0,0,0.999999986902324,297.601896349363,99.9999995882417
24.3,"max_tuv_SVM","SVM",15,19,11333,11019,314,2000,1783,217,0.992192423203314,0.930232558139535,5.78840310077519,250,110,140,23,1.3,15,8.2,0,0,0,0,0,0,0.999999998091133,303.304585941034,99.9999999415349
24.3,"max_tuv_SVM","SVM",15,20,11233,10923,310,2100,1879,221,0.995857932340782,0.930232558139535,5.89398635437035,258,114,144,8,1.3,15.75,8.5,0,0,0,0,0,0,0.999999998324096,303.391937670773,99.999999946485
24.3,"max_tuv_SVM","SVM",15,21,11133,10832,301,2200,1970,230,0.998066551276606,0.930232558139535,5.938346346012,276,124,152,18,1.2,16.5,8.6,0,0,0,0,0,0,0.999999998129477,307.812964414728,99.999999938425
24.3,"max_tuv_SVM","SVM",15,22,11033,10735,298,2300,2067,233,0.999088007295941,0.934108527131783,5.98473967684022,286,127,159,10,1.3,17.25,8.9,0,0,0,0,0,0,0.999999999581652,304.712047557254,99.9999999866077
24.3,"max_tuv_SVM","SVM",15,23,10933,10637,296,2400,2165,235,0.999381925369,0.934108527131783,5.99011680143756,293,128,165,7,1.3,18,9.2,0,0,0,0,0,0,0.999999999400051,304.627459867664,99.9999999804722
24.3,"max_tuv_SVM","SVM",15,24,10833,10540,293,2500,2262,238,0.999508322235809,0.937984496124031,5.9955035971223,302,132,170,9,1.3,18.75,9.5,0,0,0,0,0,0,0.999999999982307,301.600830874247,99.9999999994829
24.3,"max_tuv_SVM","SVM",15,25,10733,10440,293,2600,2362,238,0.999520417629763,0.937984496124031,6.000900090009,301,131,170,-1,1.3,19.5,9.9,0,0,0,0,0,0,0.999999999983203,300.536308832864,99.999999999509
24.3,"max_tuv_SVM","SVM",15,26,10633,10340,293,2700,2462,238,0.999530698714623,0.937984496124031,6.000900090009,302,131,171,1,1.3,20.25,10.3,0,0,0,0,0,0,0.999999999952197,299.845754522116,99.9999999985816
24.3,"max_tuv_SVM","SVM",15,27,10533,10240,293,2800,2562,238,0.999542189338878,0.937984496124031,5.9955035971223,304,131,173,2,1.3,21,10.8,0,0,0,0,0,0,0.999999999989406,298.047727959703,99.9999999996953
24.3,"max_tuv_SVM","SVM",15,28,10433,10140,293,2900,2662,238,0.999551260884343,0.937984496124031,6.00630630630631,305,133,172,1,1.3,21.75,11.2,0,0,0,0,0,0,0.999999999983397,297.817782008438,99.9999999995109
24.3,"max_tuv_SVM","SVM",15,29,10333,10040,293,3000,2762,238,0.999557913351017,0.937984496124031,5.97401433691756,305,133,172,0,1.3,22.5,11.6,0,0,0,0,0,0,0.999999999998322,296.442658372016,99.9999999999506
24.3,"max_tuv_SVM","SVM",15,30,10233,9940,293,3100,2862,238,0.999562751508598,0.937984496124031,5.98473967684022,306,132,174,1,1.3,23.25,12,0,0,0,0,0,0,0.999999999997261,296.179438129082,99.9999999999186
24.3,"max_tuv_SVM","SVM",15,31,10133,9840,293,3200,2962,238,0.999570613514668,0.937984496124031,5.9955035971223,308,132,176,2,1.3,24,12.4,0,0,0,0,0,0,0.999999999992116,296.454766374654,99.9999999997649
24.3,"max_tuv_SVM","SVM",15,32,10033,9740,293,3300,3062,238,0.999576661211644,0.937984496124031,5.88437775816417,308,132,176,0,1.3,24.75,12.9,0,0,0,0,0,0,0.999999999999632,295.266790668655,99.9999999999885
24.3,"max_tuv_SVM","SVM",15,33,9933,9640,293,3400,3162,238,0.999585127987411,0.937984496124031,5.81762652705061,307,131,176,-1,1.3,25.5,13.3,0,0,0,0,0,0,0.999999999999819,294.805747807972,99.9999999999937
24.3,"max_tuv_SVM","SVM",15,34,9833,9540,293,3500,3262,238,0.999589966144992,0.937984496124031,5.88437775816417,309,131,178,2,1.4,26.25,13.7,0,0,0,0,0,0,0.99999999999949,295.035756104806,99.9999999999842
24.3,"max_tuv_SVM","SVM",15,35,9733,9440,293,3600,3362,238,0.999599037690457,0.937984496124031,5.83800350262697,310,131,179,1,1.4,27,14.1,0,0,0,0,0,0,0.999999999999766,294.533470793648,99.9999999999922
24.3,"max_tuv_SVM","SVM",15,36,9633,9340,293,3700,3462,238,0.999601456769248,0.937984496124031,5.79739130434783,311,131,180,1,1.4,27.75,14.5,0,0,0,0,0,0,0.999999999999882,294.265623934256,99.9999999999954
24.3,"max_tuv_SVM","SVM",15,37,9533,9240,293,3800,3562,238,0.999605690157131,0.937984496124031,5.9579982126899,309,130,179,-2,1.4,28.5,15,0,0,0,0,0,0,0.999999999988355,295.343445272482,99.9999999996434
24.3,"max_tuv_SVM","SVM",15,38,9433,9140,293,3900,3662,238,0.999609923545015,0.941860465116279,5.87400881057269,307,131,176,-2,1.3,29.25,15.4,0,0,0,0,0,0,0.999999999999578,294.312409761246,99.9999999999872
24.3,"max_tuv_SVM","SVM",15,39,9333,9040,293,4000,3762,238,0.999615971241991,0.941860465116279,5.88437775816417,309,131,178,2,1.4,30,15.8,0,0,0,0,0,0,0.999999999999406,294.290402121396,99.9999999999821
24.3,"max_tuv_SVM","SVM",15,40,9233,8940,293,4100,3862,238,0.999622018938968,0.941860465116279,5.91570541259982,308,130,178,-1,1.4,30.75,16.2,0,0,0,0,0,0,0.999999999998935,294.196974032339,99.9999999999683
24.3,"max_tuv_SVM","SVM",15,41,9133,8840,293,4200,3962,238,0.999623228478363,0.941860465116279,5.92622222222222,308,130,178,0,1.4,31.5,16.6,0,0,0,0,0,0,0.99999999999888,294.094322553506,99.9999999999664
24.3,"max_tuv_SVM","SVM",15,42,9033,8740,293,4300,4062,238,0.999626252326851,0.941860465116279,5.94206773618538,307,130,177,-1,1.4,32.25,17.1,0,0,0,0,0,0,0.999999999996822,294.183542642893,99.9999999999059
24.3,"max_tuv_SVM","SVM",15,43,8933,8640,293,4400,4162,238,0.999626252326851,0.941860465116279,5.9104609929078,306,131,175,-1,1.3,33,17.5,0,0,0,0,0,0,0.999999999999168,293.935398219551,99.9999999999756
24.3,"max_tuv_SVM","SVM",15,44,8833,8540,293,4500,4262,238,0.999626857096549,0.941860465116279,5.8636763412489,307,130,177,1,1.4,33.75,17.9,0,0,0,0,0,0,0.999999999999684,293.741362905944,99.9999999999903
24.3,"max_tuv_SVM","SVM",15,45,8733,8440,293,4600,4362,238,0.999632904793526,0.941860465116279,5.87918871252205,306,130,176,-1,1.4,34.5,18.3,0,0,0,0,0,0,0.999999999999642,293.646555737478,99.9999999999892
24.3,"max_tuv_SVM","SVM",15,46,8633,8340,293,4700,4462,238,0.999640766799595,0.941860465116279,5.84312007011393,308,130,178,2,1.4,35.25,18.7,0,0,0,0,0,0,0.999999999999746,293.605613873946,99.9999999999921
24.3,"max_tuv_SVM","SVM",15,47,8533,8240,293,4800,4562,238,0.999644395417781,0.941860465116279,5.9686660698299,310,131,179,2,1.4,36,19.2,0,0,0,0,0,0,0.99999999997173,294.025648698463,99.9999999991506
24.3,"max_tuv_SVM","SVM",15,48,8433,8140,293,4900,4662,238,0.99964983834506,0.941860465116279,5.88437775816417,309,131,178,-1,1.4,36.75,19.6,0,0,0,0,0,0,0.999999999999619,293.533905013143,99.9999999999886
24.3,"max_tuv_SVM","SVM",16,0,13233,12719,514,100,94,6,0.956111982020414,0.828996282527881,5.16789990278374,29,6,23,0,3.8,0.75,15.7,0,0,0,0,0,0,0.927323304247768,791.535966640891,95.53578732042
24.3,"max_tuv_SVM","SVM",16,1,13133,12652,481,200,161,39,0.951737357515312,0.884758364312268,5.30170357200582,70,25,45,41,1.8,1.5,4.1,0,0,0,0,0,0,0.985747694844788,608.956668304483,99.1183578245399
24.3,"max_tuv_SVM","SVM",16,2,13033,12605,428,300,208,92,0.951730385076201,0.884758364312268,5.37732673924588,107,48,59,37,1.2,2.25,2.3,0,0,0,0,0,0,0.999997813820138,437.879904524903,99.9999097829881
24.3,"max_tuv_SVM","SVM",16,3,12933,12524,409,400,289,111,0.947991414603323,0.884758364312268,5.11967882583145,142,64,78,35,1.2,3,2.6,0,0,0,0,0,0,0.999999978269372,357.48390576911,99.9999991611543
24.3,"max_tuv_SVM","SVM",16,4,12833,12429,404,500,384,116,0.945718980489971,0.884758364312268,5.08507242661197,144,63,81,2,1.3,3.75,3.3,0,0,0,0,0,0,0.999999907917159,351.086220051127,99.9999970236864
24.3,"max_tuv_SVM","SVM",16,5,12733,12348,385,600,465,135,0.946999585139883,0.884758364312268,5.10643827714396,151,70,81,7,1.2,4.5,3.4,0,0,0,0,0,0,0.99999996731307,330.992711631139,99.9999988319186
24.3,"max_tuv_SVM","SVM",16,6,12633,12248,385,700,565,135,0.948042545823452,0.884758364312268,5.13666043877728,150,70,80,-1,1.1,5.25,4.2,0,0,0,0,0,0,0.999999987123152,330.498944769659,99.9999995233925
24.3,"max_tuv_SVM","SVM",16,7,12533,12149,384,800,664,136,0.948128539239149,0.884758364312268,5.13222846255745,151,71,80,1,1.1,6,4.9,0,0,0,0,0,0,0.999999990512748,329.436390695819,99.9999996442978
24.3,"max_tuv_SVM","SVM",16,8,12433,12049,384,900,764,136,0.948968718151941,0.884758364312268,5.13222846255745,158,73,85,7,1.2,6.75,5.6,0,0,0,0,0,0,0.99999996927418,329.32097550583,99.9999988237697
24.3,"max_tuv_SVM","SVM",16,9,12333,11952,381,1000,861,139,0.953395054913764,0.888475836431227,5.21776560360008,162,74,88,4,1.2,7.5,6.2,0,0,0,0,0,0,0.999999964844412,329.758301357398,99.9999985916685
24.3,"max_tuv_SVM","SVM",16,10,12233,11861,372,1100,952,148,0.960211195180671,0.903345724907063,5.37102895357528,186,83,103,24,1.2,8.25,6.4,0,0,0,0,0,0,0.999999934220287,330.034227620647,99.9999972241935
24.3,"max_tuv_SVM","SVM",16,11,12133,11777,356,1200,1036,164,0.957303107035095,0.925650557620818,5.38791013415225,218,98,120,32,1.2,9,6.3,0,0,0,0,0,0,0.999999984917547,328.654228315449,99.9999993818617
24.3,"max_tuv_SVM","SVM",16,12,12033,11679,354,1300,1134,166,0.959140925777223,0.925650557620818,5.35994520266012,221,99,122,3,1.2,9.75,6.8,0,0,0,0,0,0,0.999999995345574,327.302560894301,99.999999817143
24.3,"max_tuv_SVM","SVM",16,13,11933,11580,353,1400,1233,167,0.961175134887647,0.925650557620818,5.39071147391005,221,100,121,0,1.2,10.5,7.4,0,0,0,0,0,0,0.999999992352969,327.163007242649,99.9999997042
24.3,"max_tuv_SVM","SVM",16,14,11833,11480,353,1500,1333,167,0.961233819583492,0.925650557620818,5.39071147391005,218,100,118,-3,1.2,11.25,8,0,0,0,0,0,0,0.999999991878036,326.72836111725,99.9999996887476
24.3,"max_tuv_SVM","SVM",16,15,11733,11380,353,1600,1433,167,0.960925870189453,0.925650557620818,5.39538685246504,219,100,119,1,1.2,12,8.6,0,0,0,0,0,0,0.999999996111709,326.64377461139,99.9999998534479
24.3,"max_tuv_SVM","SVM",16,16,11633,11280,353,1700,1533,167,0.960651620917785,0.925650557620818,5.4000703479967,219,100,119,0,1.2,12.75,9.2,0,0,0,0,0,0,0.999999996904037,326.279483260947,99.9999998857888
24.3,"max_tuv_SVM","SVM",16,17,11533,11181,352,1800,1632,168,0.963489403635661,0.925650557620818,5.41416974838311,223,101,122,4,1.2,13.5,9.7,0,0,0,0,0,0,0.999999996944104,326.404638299645,99.9999998827252
24.3,"max_tuv_SVM","SVM",16,18,11433,11084,349,1900,1729,171,0.973649990529133,0.925650557620818,5.46905904335315,235,105,130,12,1.2,14.25,10.1,0,0,0,0,0,0,0.999999985286222,327.992756996659,99.9999993993176
24.3,"max_tuv_SVM","SVM",16,19,11333,10988,345,2000,1825,175,0.982525324479897,0.925650557620818,5.65873605947955,242,109,133,7,1.2,15,10.4,0,0,0,0,0,0,0.99999998476258,331.401284531609,99.9999993569645
24.3,"max_tuv_SVM","SVM",16,20,11233,10893,340,2100,1920,180,0.990292621648722,0.925650557620818,5.77200826104915,258,113,145,16,1.3,15.75,10.7,0,0,0,0,0,0,0.999999990693188,338.272894437269,99.9999995961588
24.3,"max_tuv_SVM","SVM",16,21,11133,10795,338,2200,2018,182,0.992163559476637,0.925650557620818,5.83162038049421,265,116,149,7,1.3,16.5,11.1,0,0,0,0,0,0,0.999999981395381,338.651202763756,99.9999992089923
24.3,"max_tuv_SVM","SVM",16,22,11033,10697,336,2300,2116,184,0.994620763226425,0.925650557620818,5.90635112727662,271,119,152,6,1.3,17.25,11.5,0,0,0,0,0,0,0.999999985163217,339.733153349615,99.9999993628867
24.3,"max_tuv_SVM","SVM",16,23,10933,10602,331,2400,2211,189,0.997668881190792,0.936802973977695,5.97859191123573,287,125,162,16,1.3,18,11.7,0,0,0,0,0,0,0.999999995566544,341.267110564453,99.9999998183607
24.3,"max_tuv_SVM","SVM",16,24,10833,10505,328,2500,2308,192,0.998786795594814,0.940520446096654,6.00630630630631,297,128,169,10,1.3,18.75,12,0,0,0,0,0,0,0.999999996822401,339.11767725503,99.9999998699563
24.3,"max_tuv_SVM","SVM",16,25,10733,10406,327,2600,2407,193,0.999131350294179,0.936802973977695,6.00630630630631,308,129,179,11,1.4,19.5,12.5,0,0,0,0,0,0,0.999999999795787,335.804637491823,99.9999999924486
24.3,"max_tuv_SVM","SVM",16,26,10633,10308,325,2700,2505,195,0.999394559870591,0.944237918215613,6.00630630630631,313,131,182,5,1.4,20.25,12.8,0,0,0,0,0,0,0.999999999588,335.61502473104,99.9999999847674
24.3,"max_tuv_SVM","SVM",16,27,10533,10208,325,2800,2605,195,0.99941024785859,0.944237918215613,6.00630630630631,310,131,179,-3,1.4,21,13.4,0,0,0,0,0,0,0.999999997892683,336.624268421384,99.9999999196922
24.3,"max_tuv_SVM","SVM",16,28,10433,10108,325,2900,2705,195,0.999424773773403,0.944237918215613,6.00630630630631,310,131,179,0,1.4,21.75,13.9,0,0,0,0,0,0,0.999999999595152,333.58842356118,99.9999999852997
24.3,"max_tuv_SVM","SVM",16,29,10333,10008,325,3000,2805,195,0.999441623834586,0.944237918215613,6.00630630630631,309,131,178,-1,1.4,22.5,14.4,0,0,0,0,0,0,0.999999999914785,331.230359064128,99.9999999969975
24.3,"max_tuv_SVM","SVM",16,30,10233,9908,325,3100,2905,195,0.999457311822584,0.947955390334573,6.00630630630631,309,131,178,0,1.4,23.25,14.9,0,0,0,0,0,0,0.999999999940347,330.725727419851,99.9999999978803
24.3,"max_tuv_SVM","SVM",16,31,10133,9808,325,3200,3005,195,0.999468351517842,0.947955390334573,6.00630630630631,311,132,179,2,1.4,24,15.4,0,0,0,0,0,0,0.999999999945868,329.719117275222,99.9999999980537
24.3,"max_tuv_SVM","SVM",16,32,10033,9708,325,3300,3105,195,0.99948868779858,0.947955390334573,6.00630630630631,313,132,181,2,1.4,24.75,15.9,0,0,0,0,0,0,0.999999999994533,328.560863121309,99.9999999998145
24.3,"max_tuv_SVM","SVM",16,33,9933,9608,325,3400,3205,195,0.999498565420653,0.947955390334573,6.00630630630631,316,132,184,3,1.4,25.5,16.4,0,0,0,0,0,0,0.999999999947313,329.120909435312,99.9999999981699
24.3,"max_tuv_SVM","SVM",16,34,9833,9508,325,3500,3305,195,0.999510767189096,0.947955390334573,6.00630630630631,314,131,183,-2,1.4,26.25,16.9,0,0,0,0,0,0,0.999999999987207,328.206939613872,99.9999999995584
24.3,"max_tuv_SVM","SVM",16,35,9733,9408,325,3600,3405,195,0.999520063774576,0.947955390334573,6.00630630630631,314,130,184,0,1.4,27,17.5,0,0,0,0,0,0,0.999999999991182,327.910867754039,99.9999999996946
24.3,"max_tuv_SVM","SVM",16,36,9633,9308,325,3700,3505,195,0.999527617250279,0.947955390334573,6.00630630630631,315,130,185,1,1.4,27.75,18,0,0,0,0,0,0,0.999999999866376,328.647728357718,99.9999999952067
24.3,"max_tuv_SVM","SVM",16,37,9533,9208,325,3800,3605,195,0.999538656945537,0.947955390334573,6.00630630630631,315,130,185,0,1.4,28.5,18.5,0,0,0,0,0,0,0.99999999999362,327.338819128211,99.999999999787
24.3,"max_tuv_SVM","SVM",16,38,9433,9108,325,3900,3705,195,0.999542724201685,0.947955390334573,6.00630630630631,317,130,187,2,1.4,29.25,19,0,0,0,0,0,0,0.999999999968163,327.657542505286,99.9999999988983
24.3,"max_tuv_SVM","SVM",16,39,9333,9008,325,4000,3805,195,0.999546791457832,0.947955390334573,6.00630630630631,316,130,186,-1,1.4,30,19.5,0,0,0,0,0,0,0.999999999992873,327.062579446169,99.9999999997578
24.3,"max_tuv_SVM","SVM",16,40,9233,8908,325,4100,3905,195,0.99955085871398,0.947955390334573,6.000900090009,315,130,185,-1,1.4,30.75,20,0,0,0,0,0,0,0.999999999995859,326.606664343279,99.9999999998619
24.3,"max_tuv_SVM","SVM",16,41,9133,8808,325,4200,4005,195,0.99955085871398,0.947955390334573,6.00630630630631,314,130,184,-1,1.4,31.5,20.5,0,0,0,0,0,0,0.999999999991417,326.550194051423,99.9999999997024
24.3,"max_tuv_SVM","SVM",16,42,9033,8708,325,4300,4105,195,0.999553763896943,0.947955390334573,6.00630630630631,313,130,183,-1,1.4,32.25,21.1,0,0,0,0,0,0,0.999999999989177,326.549780260157,99.9999999996208
24.3,"max_tuv_SVM","SVM",16,43,8933,8608,325,4400,4205,195,0.999559574262868,0.947955390334573,6.00630630630631,313,130,183,0,1.4,33,21.6,0,0,0,0,0,0,0.999999999995428,326.292862475578,99.9999999998423
24.3,"max_tuv_SVM","SVM",16,44,8833,8508,325,4500,4305,195,0.999559574262868,0.947955390334573,6.00630630630631,312,130,182,-1,1.4,33.75,22.1,0,0,0,0,0,0,0.999999999983716,326.417359491745,99.9999999994318
24.3,"max_tuv_SVM","SVM",16,45,8733,8408,325,4600,4405,195,0.999562479445831,0.947955390334573,6.00630630630631,312,130,182,0,1.4,34.5,22.6,0,0,0,0,0,0,0.999999999963164,326.541071831921,99.9999999986966
24.3,"max_tuv_SVM","SVM",16,46,8633,8308,325,4700,4505,195,0.999564803592201,0.947955390334573,6.00630630630631,311,130,181,-1,1.4,35.25,23.1,0,0,0,0,0,0,0.999999999984149,326.265753827558,99.9999999994485
24.3,"max_tuv_SVM","SVM",16,47,8533,8208,325,4800,4605,195,0.999566546701978,0.947955390334573,6.00630630630631,311,130,181,0,1.4,36,23.6,0,0,0,0,0,0,0.999999999994348,325.953041551364,99.9999999998064
24.3,"max_tuv_SVM","SVM",16,48,8433,8108,325,4900,4705,195,0.999568289811756,0.947955390334573,6.00630630630631,310,130,180,-1,1.4,36.75,24.1,0,0,0,0,0,0,0.999999999995386,325.862238256625,99.999999999845
24.3,"max_tuv_SVM","SVM",17,0,13233,12724,509,100,95,5,0.970946637842786,0.807272727272727,5.47299021965689,31,5,26,0,5.2,0.75,19,0,0,0,0,0,0,0.987204928580586,705.8985382956,99.3321637906916
24.3,"max_tuv_SVM","SVM",17,1,13133,12660,473,200,159,41,0.974192172033199,0.883636363636364,5.47024982041663,75,27,48,44,1.8,1.5,3.9,0,0,0,0,0,0,0.996246668077243,579.114323580231,99.8552459297817
24.3,"max_tuv_SVM","SVM",17,2,13033,12599,434,300,220,80,0.947222664694525,0.887272727272727,5.35362167455525,113,50,63,38,1.3,2.25,2.8,0,0,0,0,0,0,0.996917912801325,425.71762690357,99.79986575606
24.3,"max_tuv_SVM","SVM",17,3,12933,12511,422,400,308,92,0.950621799977234,0.887272727272727,5.20268009914448,136,60,76,23,1.3,3,3.3,0,0,0,0,0,0,0.999999586982282,381.796337375447,99.9999829080598
24.3,"max_tuv_SVM","SVM",17,4,12833,12425,408,500,394,106,0.951701558766638,0.887272727272727,5.20268009914448,145,64,81,9,1.3,3.75,3.7,0,0,0,0,0,0,0.999999528988036,360.707652233351,99.9999821444028
24.3,"max_tuv_SVM","SVM",17,5,12733,12328,405,600,491,109,0.952653316645806,0.887272727272727,5.17990128960357,151,66,85,6,1.3,4.5,4.5,0,0,0,0,0,0,0.999999724860894,354.342492422423,99.9999901186252
24.3,"max_tuv_SVM","SVM",17,6,12633,12251,382,700,568,132,0.952141881897837,0.887272727272727,5.23490909090909,152,67,85,1,1.3,5.25,4.3,0,0,0,0,0,0,0.999999622422548,331.457337494451,99.999985996887
24.3,"max_tuv_SVM","SVM",17,7,12533,12151,382,800,668,132,0.95338832631699,0.887272727272727,5.2361146140953,155,67,88,3,1.3,6,5.1,0,0,0,0,0,0,0.999999802961039,329.879584135282,99.9999928207152
24.3,"max_tuv_SVM","SVM",17,8,12433,12051,382,900,768,132,0.954655250881785,0.887272727272727,5.2499423815621,154,66,88,-1,1.3,6.75,5.8,0,0,0,0,0,0,0.99999977289699,329.569241403749,99.9999919443033
24.3,"max_tuv_SVM","SVM",17,9,12333,11951,382,1000,868,132,0.954639321879626,0.887272727272727,5.24532501798993,152,66,86,-2,1.3,7.5,6.6,0,0,0,0,0,0,0.999999804363019,329.355607377375,99.9999933275342
24.3,"max_tuv_SVM","SVM",17,10,12233,11853,380,1100,966,134,0.963289338946411,0.887272727272727,5.37557661419852,160,69,91,8,1.3,8.25,7.2,0,0,0,0,0,0,0.999999455286568,330.765679176164,99.9999809653154
24.3,"max_tuv_SVM","SVM",17,11,12133,11772,361,1200,1047,153,0.964526681078596,0.901818181818182,5.43244927304681,175,77,98,15,1.3,9,6.8,0,0,0,0,0,0,0.999999830445928,318.85051548964,99.9999939295858
24.3,"max_tuv_SVM","SVM",17,12,12033,11681,352,1300,1138,162,0.962860393673906,0.909090909090909,5.44896480166015,200,88,112,25,1.3,9.75,7,0,0,0,0,0,0,0.99999973524265,318.82275182301,99.9999898462144
24.3,"max_tuv_SVM","SVM",17,13,11933,11590,343,1400,1229,171,0.963251792012758,0.916363636363636,5.39215543795909,214,101,113,14,1.1,10.5,7.2,0,0,0,0,0,0,0.999999925788008,319.565168661037,99.9999972823199
24.3,"max_tuv_SVM","SVM",17,14,11833,11492,341,1500,1327,173,0.966868244396405,0.92,5.41095981612111,223,105,118,9,1.1,11.25,7.7,0,0,0,0,0,0,0.999999955978958,319.534656297204,99.9999984492605
24.3,"max_tuv_SVM","SVM",17,15,11733,11393,340,1600,1426,174,0.969345773125503,0.92,5.4415847558555,229,106,123,6,1.2,12,8.2,0,0,0,0,0,0,0.999999934941867,320.423676840962,99.9999976380669
24.3,"max_tuv_SVM","SVM",17,16,11633,11294,339,1700,1525,175,0.974061326658338,0.92,5.5108882659191,231,108,123,2,1.1,12.75,8.7,0,0,0,0,0,0,0.999999958698462,320.073394310945,99.9999984848433
24.3,"max_tuv_SVM","SVM",17,17,11533,11195,338,1800,1624,176,0.977876891569028,0.92,5.56832637327337,234,109,125,3,1.1,13.5,9.2,0,0,0,0,0,0,0.999999929553537,321.140026789271,99.999997326905
24.3,"max_tuv_SVM","SVM",17,18,11433,11096,337,1900,1723,177,0.982838206849508,0.92,5.67771715372784,237,108,129,3,1.2,14.25,9.7,0,0,0,0,0,0,0.99999990467817,322.215307061679,99.9999962605446
24.3,"max_tuv_SVM","SVM",17,19,11333,10996,337,2000,1823,177,0.982814882239197,0.92,5.62760491053518,236,107,129,-1,1.2,15,10.3,0,0,0,0,0,0,0.999999908658931,320.811783194206,99.99999630076
24.3,"max_tuv_SVM","SVM",17,20,11233,10897,336,2100,1922,178,0.984746273751289,0.92,5.69423487544484,235,106,129,-1,1.2,15.75,10.8,0,0,0,0,0,0,0.999999922117533,322.39872694763,99.999996858625
24.3,"max_tuv_SVM","SVM",17,21,11133,10800,333,2200,2019,181,0.989015246330651,0.92,5.85416353843643,248,109,139,13,1.3,16.5,11.2,0,0,0,0,0,0,0.999999974738967,323.839748910802,99.9999990144659
24.3,"max_tuv_SVM","SVM",17,22,11033,10705,328,2300,2114,186,0.992726134941423,0.92,5.91361427051796,261,116,145,13,1.2,17.25,11.4,0,0,0,0,0,0,0.999999983993041,327.021197991803,99.9999993702658
24.3,"max_tuv_SVM","SVM",17,23,10933,10608,325,2400,2211,189,0.994656388667667,0.927272727272727,5.91361427051796,272,119,153,11,1.3,18,11.7,0,0,0,0,0,0,0.999999986818236,327.636240853755,99.9999994887386
24.3,"max_tuv_SVM","SVM",17,24,10833,10511,322,2500,2308,192,0.99669245647969,0.930909090909091,5.96262407862408,279,124,155,7,1.2,18.75,12,0,0,0,0,0,0,0.999999994625129,326.715117983662,99.9999997985206
24.3,"max_tuv_SVM","SVM",17,25,10733,10415,318,2600,2404,196,0.999127887131642,0.934545454545455,6.02802893309222,295,130,165,16,1.3,19.5,12.3,0,0,0,0,0,0,0.999999998997882,325.560427712424,99.9999999621349
24.3,"max_tuv_SVM","SVM",17,26,10633,10317,316,2700,2502,198,0.999455000568893,0.934545454545455,6.02802893309222,299,131,168,4,1.3,20.25,12.6,0,0,0,0,0,0,0.999999999614167,324.856345292753,99.9999999853811
24.3,"max_tuv_SVM","SVM",17,27,10533,10218,315,2800,2601,199,0.999549721242462,0.938181818181818,6.02258355916892,299,132,167,0,1.3,21,13.1,0,0,0,0,0,0,0.999999999872875,323.515109955934,99.999999995245
24.3,"max_tuv_SVM","SVM",17,28,10433,10118,315,2900,2701,199,0.999559107975879,0.938181818181818,6.02802893309222,301,132,169,2,1.3,21.75,13.6,0,0,0,0,0,0,0.999999999555395,324.007264584471,99.9999999831047
24.3,"max_tuv_SVM","SVM",17,29,10333,10018,315,3000,2801,199,0.99956707247696,0.938181818181818,6.02802893309222,301,131,170,0,1.3,22.5,14.1,0,0,0,0,0,0,0.999999998558522,323.840616881172,99.9999999449981
24.3,"max_tuv_SVM","SVM",17,30,10233,9918,315,3100,2901,199,0.999575605870975,0.938181818181818,6.02802893309222,301,131,170,0,1.3,23.25,14.6,0,0,0,0,0,0,0.999999999967519,320.428731686013,99.9999999988638
24.3,"max_tuv_SVM","SVM",17,31,10133,9818,315,3200,3001,199,0.999576743656844,0.938181818181818,6.02802893309222,300,132,168,-1,1.3,24,15.1,0,0,0,0,0,0,0.999999999958841,319.883549795084,99.9999999985557
24.3,"max_tuv_SVM","SVM",17,32,10033,9718,315,3300,3101,199,0.999583001479122,0.938181818181818,6.02802893309222,301,131,170,1,1.3,24.75,15.6,0,0,0,0,0,0,0.999999999705463,320.472070673042,99.9999999893427
24.3,"max_tuv_SVM","SVM",17,33,9933,9618,315,3400,3201,199,0.9995892593014,0.938181818181818,6.02802893309222,302,131,171,1,1.3,25.5,16.1,0,0,0,0,0,0,0.999999999980126,318.861395627821,99.9999999993217
24.3,"max_tuv_SVM","SVM",17,34,9833,9518,315,3500,3301,199,0.999592103766071,0.938181818181818,6.02802893309222,301,130,171,-1,1.3,26.25,16.6,0,0,0,0,0,0,0.999999999949218,319.062265866699,99.9999999982458
24.3,"max_tuv_SVM","SVM",17,35,9733,9418,315,3600,3401,199,0.999597792695415,0.938181818181818,6.02802893309222,304,130,174,3,1.3,27,17.1,0,0,0,0,0,0,0.999999999991093,318.043611081515,99.9999999997053
24.3,"max_tuv_SVM","SVM",17,36,9633,9318,315,3700,3501,199,0.999601774945955,0.941818181818182,6.03348416289593,305,130,175,1,1.3,27.75,17.6,0,0,0,0,0,0,0.999999999987738,317.907097598206,99.9999999995905
24.3,"max_tuv_SVM","SVM",17,37,9533,9218,315,3800,3601,199,0.999611446125839,0.941818181818182,6.03348416289593,306,130,176,1,1.4,28.5,18.1,0,0,0,0,0,0,0.999999999991352,317.476127788901,99.9999999997113
24.3,"max_tuv_SVM","SVM",17,38,9433,9118,315,3900,3701,199,0.999617135055183,0.941818181818182,6.03348416289593,306,130,176,0,1.4,29.25,18.6,0,0,0,0,0,0,0.999999999985534,317.390967251765,99.9999999995191
24.3,"max_tuv_SVM","SVM",17,39,9333,9018,315,4000,3801,199,0.99962851291387,0.945454545454545,6.03348416289593,305,130,175,-1,1.3,30,19.1,0,0,0,0,0,0,0.999999999942352,317.774335517454,99.9999999980637
24.3,"max_tuv_SVM","SVM",17,40,9233,8918,315,4100,3901,199,0.999630788485607,0.945454545454545,6.03348416289593,305,130,175,0,1.3,30.75,19.6,0,0,0,0,0,0,0.999999999985436,317.260116872004,99.9999999995263
24.3,"max_tuv_SVM","SVM",17,41,9133,8818,315,4200,4001,199,0.999640459665491,0.945454545454545,6.03348416289593,304,130,174,-1,1.3,31.5,20.1,0,0,0,0,0,0,0.99999999998951,317.019784768514,99.9999999996621
24.3,"max_tuv_SVM","SVM",17,42,9033,8718,315,4300,4101,199,0.999639890772557,0.945454545454545,6.03348416289593,306,130,176,2,1.4,32.25,20.6,0,0,0,0,0,0,0.999999999967412,316.999557879405,99.9999999989074
24.3,"max_tuv_SVM","SVM",17,43,8933,8618,315,4400,4201,199,0.999640459665491,0.945454545454545,6.03348416289593,307,130,177,1,1.4,33,21.1,0,0,0,0,0,0,0.999999999991707,316.507986747454,99.9999999997275
24.3,"max_tuv_SVM","SVM",17,44,8833,8518,315,4500,4301,199,0.999639321879622,0.945454545454545,6.02802893309222,309,129,180,2,1.4,33.75,21.6,0,0,0,0,0,0,0.999999999969612,316.807452118182,99.9999999989616
24.3,"max_tuv_SVM","SVM",17,45,8733,8418,315,4600,4401,199,0.999642735237228,0.945454545454545,6.02802893309222,309,129,180,0,1.4,34.5,22.1,0,0,0,0,0,0,0.999999999995877,316.241046634305,99.9999999998656
24.3,"max_tuv_SVM","SVM",17,46,8633,8318,315,4700,4501,199,0.999646148594834,0.945454545454545,6.03348416289593,307,129,178,-2,1.4,35.25,22.6,0,0,0,0,0,0,0.999999999987125,316.369739240065,99.9999999995629
24.3,"max_tuv_SVM","SVM",17,47,8533,8218,315,4800,4601,199,0.999646717487769,0.945454545454545,6.03348416289593,307,129,178,0,1.4,36,23.1,0,0,0,0,0,0,0.999999999938756,316.539445983469,99.9999999978563
24.3,"max_tuv_SVM","SVM",17,48,8433,8118,315,4900,4701,199,0.999651268631244,0.945454545454545,6.03348416289593,306,129,177,-1,1.4,36.75,23.6,0,0,0,0,0,0,0.999999999992838,316.065693403139,99.999999999761
24.3,"max_tuv_SVM","SVM",18,0,13233,12705,528,100,95,5,0.908090708352841,0.7109375,4.64176306769494,25,5,20,0,4,0.75,19,0,0,0,0,0,0,0.992733261795642,613.930522213465,99.757139091637
24.3,"max_tuv_SVM","SVM",18,1,13133,12704,429,200,96,104,0.935041457065991,0.7578125,4.89983690399484,37,14,23,12,1.6,1.5,0.9,0,0,0,0,0,0,0.996929765250672,438.39143724463,99.8174271881975
24.3,"max_tuv_SVM","SVM",18,2,13033,12644,389,300,156,144,0.957823954921215,0.86328125,5.30973149271845,87,38,49,50,1.3,2.25,1.1,0,0,0,0,0,0,0.997007344842141,317.318597936957,99.8386039731373
24.3,"max_tuv_SVM","SVM",18,3,12933,12606,327,400,194,206,0.933985532678193,0.86328125,5.1856484030837,115,54,61,28,1.1,3,0.9,0,0,0,0,0,0,0.999270630882286,297.192707230927,99.9591425294324
24.3,"max_tuv_SVM","SVM",18,4,12833,12514,319,500,286,214,0.929808142255507,0.86328125,4.96695795747423,137,65,72,22,1.1,3.75,1.3,0,0,0,0,0,0,0.999488946905503,278.555052936435,99.9717924730008
24.3,"max_tuv_SVM","SVM",18,5,12733,12423,310,600,377,223,0.935846348073607,0.86328125,4.99175723655681,143,63,80,6,1.3,4.5,1.7,0,0,0,0,0,0,0.999772213095624,259.208676762792,99.9874657791458
24.3,"max_tuv_SVM","SVM",18,6,12633,12339,294,700,461,239,0.936308200748712,0.86328125,4.9744996488764,147,66,81,4,1.2,5.25,1.9,0,0,0,0,0,0,0.999862065756528,242.949411048733,99.9922497932164
24.3,"max_tuv_SVM","SVM",18,7,12533,12329,204,800,471,329,0.935569114607706,0.86328125,4.97020388061313,146,64,82,-1,1.3,6,1.4,0,0,0,0,0,0,0.999857003222787,152.986400727411,99.9921103241143
24.3,"max_tuv_SVM","SVM",18,8,12433,12305,128,900,495,405,0.93529188114178,0.86328125,5.01434437337381,146,63,83,0,1.3,6.75,1.2,0,0,0,0,0,0,9.5587212506083e-06,76.9986939105496,76.9946131389651
24.3,"max_tuv_SVM","SVM",18,9,12333,12280,53,1000,520,480,0.934668562821703,0.86328125,4.99700869706137,150,65,85,4,1.3,7.5,1.1,0,0,0,0,0,0,7.60044730418558e-06,2.00559695692547,2.00089444837746
24.3,"max_tuv_SVM","SVM",18,10,12233,12182,51,1100,618,482,0.937389715917957,0.86328125,5.07271739130435,150,66,84,0,1.3,8.25,1.3,0,0,0,0,0,0,2.7826046188259e-06,0.00159129452043877,0.00039174299228134
24.3,"max_tuv_SVM","SVM",18,11,12133,12082,51,1200,718,482,0.938537645258154,0.86328125,5.08598517872711,152,68,84,2,1.2,9,1.5,0,0,0,0,0,0,2.10008147351182e-06,0.00124501331945086,0.000256790332916612
24.3,"max_tuv_SVM","SVM",18,12,12033,11982,51,1300,818,482,0.939736146856964,0.86328125,5.07271739130435,151,67,84,-1,1.3,9.75,1.7,0,0,0,0,0,0,8.05677811077501e-07,0.000516835776023005,0.000107332586167843
24.3,"max_tuv_SVM","SVM",18,13,11933,11882,51,1400,918,482,0.940287567267197,0.86328125,5.07713228894691,148,67,81,-3,1.2,10.5,1.9,0,0,0,0,0,0,5.03892940670747e-07,0.000340349953999391,6.16557761348221e-05
24.3,"max_tuv_SVM","SVM",18,14,11833,11782,51,1500,1018,482,0.94139284530494,0.86328125,5.08598517872711,148,66,82,0,1.2,11.25,2.1,0,0,0,0,0,0,3.40373190079896e-07,0.000224423497729851,4.10821177304208e-05
24.3,"max_tuv_SVM","SVM",18,15,11733,11683,50,1600,1117,483,0.942336048393391,0.86328125,5.1172149122807,149,67,82,1,1.2,12,2.3,0,0,0,0,0,0,9.22846699740817e-07,0.000750434778617294,0.000149119793307462
24.3,"max_tuv_SVM","SVM",18,16,11633,11585,48,1700,1215,485,0.949136493916709,0.86328125,5.1627030561674,160,71,89,11,1.3,12.75,2.5,0,0,0,0,0,0,3.78431290733366e-06,0.0268775651098944,0.0246743220283702
24.3,"max_tuv_SVM","SVM",18,17,11533,11492,41,1800,1308,492,0.957169562080799,0.87109375,5.3576769342576,181,77,104,21,1.4,13.5,2.7,0,0,0,0,0,0,0.00361174532975871,0.862762158381559,0.559028686646997
24.3,"max_tuv_SVM","SVM",18,18,11433,11400,33,1900,1400,500,0.969861371080946,0.8828125,5.54553782008086,202,88,114,21,1.3,14.25,2.8,0,0,0,0,0,0,0.00603486480473667,3.19897283773639,0.903546609887269
24.3,"max_tuv_SVM","SVM",18,19,11333,11312,21,2000,1488,512,0.965151448681961,0.89453125,5.49126654248221,232,101,131,30,1.3,15,2.9,0,0,0,0,0,0,0.0125457197833519,8.79613464995969,2.09000309491722
24.3,"max_tuv_SVM","SVM",18,20,11233,11216,17,2100,1584,516,0.965853367259396,0.8984375,5.49615636130899,242,106,136,10,1.3,15.75,3.1,0,0,0,0,0,0,0.00820106390279055,5.29022233527905,1.05651990656546
24.3,"max_tuv_SVM","SVM",18,21,11133,11116,17,2200,1684,516,0.965595022227417,0.8984375,5.49615636130899,246,106,140,4,1.3,16.5,3.3,0,0,0,0,0,0,0.00590504187879203,3.35690327555299,0.666947311663729
24.3,"max_tuv_SVM","SVM",18,22,11033,11017,16,2300,1783,517,0.969386113710832,0.8984375,5.50105489639037,246,107,139,0,1.3,17.25,3.4,0,0,0,0,0,0,0.00501668107741253,2.81970363910024,0.554072375896629
24.3,"max_tuv_SVM","SVM",18,23,10933,10918,15,2400,1882,518,0.973469671268137,0.8984375,5.52426609848485,250,108,142,4,1.3,18,3.6,0,0,0,0,0,0,0.0051539344417746,3.58250420240189,0.558578567996399
24.3,"max_tuv_SVM","SVM",18,24,10833,10818,15,2500,1982,518,0.973529383091563,0.8984375,5.52426609848485,248,108,140,-2,1.3,18.75,3.8,0,0,0,0,0,0,0.00404064118754285,1.99126636896339,0.430580853832225
24.3,"max_tuv_SVM","SVM",18,25,10733,10719,14,2600,2081,519,0.979672998557162,0.8984375,5.59389970476827,248,108,140,0,1.3,19.5,4,0,0,0,0,0,0,0.00333024891872137,1.13227587206491,0.382528206647175
24.3,"max_tuv_SVM","SVM",18,26,10633,10622,11,2700,2178,522,0.992114383481509,0.8984375,5.82601172571301,254,110,144,6,1.3,20.25,4.2,0,0,0,0,0,0,0.00420674885746387,2.39814650079041,0.533742604213692
24.3,"max_tuv_SVM","SVM",18,27,10533,10529,4,2800,2271,529,0.998647953712369,0.9140625,5.94736842105263,273,116,157,19,1.4,21,4.3,0,0,0,0,0,0,0.00469458086437168,3.0467175171104,0.555600140252837
24.3,"max_tuv_SVM","SVM",18,28,10433,10431,2,2900,2369,531,0.999217653252223,0.92578125,5.9579982126899,278,119,159,5,1.3,21.75,4.5,0,0,0,0,0,0,0.00423648459935331,2.37222974797019,0.453478482467626
24.3,"max_tuv_SVM","SVM",18,29,10333,10333,0,3000,2467,533,0.999359621158945,0.92578125,5.95267857142857,283,122,161,5,1.3,22.5,4.6,0,0,0,0,0,0,0.00374223610212058,1.88991176717038,0.409192828001288
24.3,"max_tuv_SVM","SVM",18,30,10233,10233,0,3100,2567,533,0.999365104897832,0.92578125,5.95267857142857,283,121,162,0,1.3,23.25,4.8,0,0,0,0,0,0,0.00335646576093014,1.36585251495534,0.35001940129123
24.3,"max_tuv_SVM","SVM",18,31,10133,10133,0,3200,2667,533,0.999370588636718,0.92578125,5.94736842105263,283,121,162,0,1.3,24,5,0,0,0,0,0,0,0.00316201942045753,1.15514254987502,0.331995370176273
24.3,"max_tuv_SVM","SVM",18,32,10033,10033,0,3300,2767,533,0.999384602636094,0.92578125,5.94736842105263,282,121,161,-1,1.3,24.75,5.2,0,0,0,0,0,0,1.79837065092939e-05,0.159371777454782,0.146317112193851
24.3,"max_tuv_SVM","SVM",18,33,9933,9933,0,3400,2867,533,0.999393742200905,0.92578125,5.94736842105263,282,122,160,0,1.3,25.5,5.4,0,0,0,0,0,0,1.6390110547463e-05,0.0418870067775488,0.0295176612396986
24.3,"max_tuv_SVM","SVM",18,34,9833,9833,0,3500,2967,533,0.999404100374357,0.9296875,5.94736842105263,283,122,161,1,1.3,26.25,5.6,0,0,0,0,0,0,1.33571554300139e-05,0.0118434187249708,0.00143095321894597
24.3,"max_tuv_SVM","SVM",18,35,9733,9733,0,3600,3067,533,0.999410802721884,0.9296875,5.94736842105263,283,122,161,0,1.3,27,5.8,0,0,0,0,0,0,1.58856879167705e-05,0.0145130432462009,0.00170218167556148
24.3,"max_tuv_SVM","SVM",18,36,9633,9633,0,3700,3167,533,0.999418723678053,0.9296875,5.94736842105263,283,122,161,0,1.3,27.75,5.9,0,0,0,0,0,0,1.04897828480006e-05,0.00960863504404161,0.00112524558084824
24.3,"max_tuv_SVM","SVM",18,37,9533,9533,0,3800,3267,533,0.999421160895336,0.9296875,5.94736842105263,285,122,163,2,1.3,28.5,6.1,0,0,0,0,0,0,7.99757207309713e-06,0.00726472404944827,0.000852435052148316
24.3,"max_tuv_SVM","SVM",18,38,9433,9433,0,3900,3367,533,0.999432737677429,0.93359375,5.94736842105263,285,122,163,0,1.3,29.25,6.3,0,0,0,0,0,0,7.42313064755666e-06,0.00668348051668492,0.000791961388616462
24.3,"max_tuv_SVM","SVM",18,39,9333,9333,0,4000,3467,533,0.999434565590391,0.93359375,5.94206773618538,285,122,163,0,1.3,30,6.5,0,0,0,0,0,0,4.50722346037307e-06,0.00389543136861503,0.000484558935288586
24.3,"max_tuv_SVM","SVM",18,40,9233,9233,0,4100,3567,533,0.999436393503354,0.93359375,5.94736842105263,286,123,163,1,1.3,30.75,6.7,0,0,0,0,0,0,5.83500174770212e-06,0.00527628025706929,0.000615905816998986
24.3,"max_tuv_SVM","SVM",18,41,9133,9133,0,4200,3667,533,0.999441267937919,0.93359375,5.94736842105263,285,123,162,-1,1.3,31.5,6.9,0,0,0,0,0,0,4.66355487800356e-06,0.00428917624280082,0.000499303667427728
24.3,"max_tuv_SVM","SVM",18,42,9033,9033,0,4300,3767,533,0.999446751676806,0.93359375,5.94206773618538,286,123,163,1,1.3,32.25,7.1,0,0,0,0,0,0,3.114749182443e-06,0.00267102182549619,0.000329723095306171
24.3,"max_tuv_SVM","SVM",18,43,8933,8933,0,4400,3867,533,0.999449798198409,0.93359375,5.94736842105263,285,123,162,-1,1.3,33,7.3,0,0,0,0,0,0,4.38066858250349e-06,0.0040072905359909,0.00046507432899359
24.3,"max_tuv_SVM","SVM",18,44,8833,8833,0,4500,3967,533,0.999455891241616,0.93359375,5.94736842105263,285,123,162,0,1.3,33.75,7.4,0,0,0,0,0,0,2.12848978248398e-06,0.0018358899778142,0.000228716083448124
24.3,"max_tuv_SVM","SVM",18,45,8733,8733,0,4600,4067,533,0.999455586589456,0.93359375,5.92622222222222,286,123,163,1,1.3,34.5,7.6,0,0,0,0,0,0,1.62499965404088e-06,0.00137074577031776,0.000175320544522805
24.3,"max_tuv_SVM","SVM",18,46,8633,8633,0,4700,4167,533,0.999458328458899,0.93359375,5.94736842105263,287,123,164,1,1.3,35.25,7.8,0,0,0,0,0,0,3.84723240399234e-06,0.00363570998160589,0.000407532021410878
24.3,"max_tuv_SVM","SVM",18,47,8533,8533,0,4800,4267,533,0.999454672632975,0.93359375,5.94736842105263,287,123,164,0,1.3,36,8,0,0,0,0,0,0,1.51783982855335e-06,0.00132149794643459,0.000164187269560676
24.3,"max_tuv_SVM","SVM",18,48,8433,8433,0,4900,4367,533,0.999454063328654,0.93359375,5.94736842105263,287,123,164,0,1.3,36.75,8.2,0,0,0,0,0,0,1.13769767369841e-06,0.000980724689391435,0.000122077560790438
24.3,"max_tuv_SVM","SVM",19,0,13233,12713,520,100,93,7,0.959913831632005,0.83206106870229,5.18019356597601,26,7,19,0,2.7,0.75,13.3,0,0,0,0,0,0,0.999990414825594,686.110629836404,99.9995534560752
24.3,"max_tuv_SVM","SVM",19,1,13133,12651,482,200,155,45,0.951341092061898,0.870229007633588,5.18813458830505,87,34,53,61,1.6,1.5,3.4,0,0,0,0,0,0,0.996659915557563,458.971488878882,99.9570648507613
24.3,"max_tuv_SVM","SVM",19,2,13033,12616,417,300,190,110,0.951034795096854,0.870229007633588,5.12021080089776,111,49,62,24,1.3,2.25,1.7,0,0,0,0,0,0,0.99999831688653,392.49113670725,99.9999340513185
24.3,"max_tuv_SVM","SVM",19,3,12933,12538,395,400,268,132,0.941343535286708,0.870229007633588,5.18273568035018,133,63,70,22,1.1,3,2,0,0,0,0,0,0,0.999999665869815,347.319688282538,99.9999905959866
24.3,"max_tuv_SVM","SVM",19,4,12833,12451,382,500,355,145,0.944192573788353,0.870229007633588,5.12465542832909,145,65,80,12,1.2,3.75,2.4,0,0,0,0,0,0,0.999999950967908,331.118955708041,99.9999982772695
24.3,"max_tuv_SVM","SVM",19,5,12733,12357,376,600,449,151,0.945387966223876,0.870229007633588,5.15598519950665,152,68,84,7,1.2,4.5,3,0,0,0,0,0,0,0.999999978486284,324.608920019465,99.9999992918385
24.3,"max_tuv_SVM","SVM",19,6,12633,12259,374,700,547,153,0.946591105469816,0.870229007633588,5.15598519950665,153,71,82,1,1.2,5.25,3.6,0,0,0,0,0,0,0.999999959638532,322.47945981915,99.9999985840333
24.3,"max_tuv_SVM","SVM",19,7,12533,12159,374,800,647,153,0.947865753734835,0.870229007633588,5.16952981912007,154,70,84,1,1.2,6,4.2,0,0,0,0,0,0,0.999999986172429,322.346325377137,99.9999995390238
24.3,"max_tuv_SVM","SVM",19,8,12433,12060,373,900,746,154,0.951177217226513,0.870229007633588,5.24163396408988,159,70,89,5,1.3,6.75,4.8,0,0,0,0,0,0,0.99999989522479,322.584549616678,99.9999960913462
24.3,"max_tuv_SVM","SVM",19,9,12333,11962,371,1000,844,156,0.951406641996036,0.870229007633588,5.24163396408988,159,71,88,0,1.2,7.5,5.4,0,0,0,0,0,0,0.999999860798815,320.446715013102,99.9999946260997
24.3,"max_tuv_SVM","SVM",19,10,12233,11867,366,1100,939,161,0.952165829415215,0.870229007633588,5.24163396408988,161,72,89,2,1.2,8.25,5.8,0,0,0,0,0,0,0.999999838421887,315.422341570032,99.999993925382
24.3,"max_tuv_SVM","SVM",19,11,12133,11768,365,1200,1038,162,0.952797492417044,0.870229007633588,5.21866449010176,163,72,91,2,1.3,9,6.4,0,0,0,0,0,0,0.999999894345207,314.254946917782,99.9999962270893
24.3,"max_tuv_SVM","SVM",19,12,12033,11668,365,1300,1138,162,0.952976264964736,0.870229007633588,5.21866449010176,164,74,90,1,1.2,9.75,7,0,0,0,0,0,0,0.999999899990504,314.254645210846,99.9999962114503
24.3,"max_tuv_SVM","SVM",19,13,11933,11569,364,1400,1237,163,0.9594412761976,0.870229007633588,5.35835154857585,167,74,93,3,1.3,10.5,7.6,0,0,0,0,0,0,0.999999703685674,314.580233795997,99.9999881187034
24.3,"max_tuv_SVM","SVM",19,14,11833,11480,353,1500,1326,174,0.964135247391398,0.870229007633588,5.45606951726386,179,80,99,12,1.2,11.25,7.6,0,0,0,0,0,0,0.99999922998055,307.360295855276,99.9999682127482
24.3,"max_tuv_SVM","SVM",19,15,11733,11407,326,1600,1399,201,0.970796908426734,0.877862595419847,5.58359876983909,190,84,106,11,1.3,12,7,0,0,0,0,0,0,0.999998724898137,286.575642514427,99.9999480698396
24.3,"max_tuv_SVM","SVM",19,16,11633,11327,306,1700,1479,221,0.976661839807877,0.881679389312977,5.67265480750682,206,90,116,16,1.3,12.75,6.7,0,0,0,0,0,0,0.999999181897227,273.565000593031,99.9999638313626
24.3,"max_tuv_SVM","SVM",19,17,11533,11232,301,1800,1574,226,0.984749509865258,0.904580152671756,5.81045209028027,217,97,120,11,1.2,13.5,7,0,0,0,0,0,0,0.999998241210633,276.585079373096,99.9999224629628
24.3,"max_tuv_SVM","SVM",19,18,11433,11144,289,1900,1662,238,0.992644105571153,0.916030534351145,5.85293855407639,241,109,132,24,1.2,14.25,7,0,0,0,0,0,0,0.999999281946378,283.290875056401,99.9999674406173
24.3,"max_tuv_SVM","SVM",19,19,11333,11052,281,2000,1754,246,0.997925046629841,0.919847328244275,5.9955035971223,265,117,148,24,1.3,15,7.1,0,0,0,0,0,0,0.999999910526179,289.260589107929,99.9999962395964
24.3,"max_tuv_SVM","SVM",19,20,11233,10958,275,2100,1848,252,0.999185988999529,0.931297709923664,6.0117222723174,286,125,161,21,1.3,15.75,7.3,0,0,0,0,0,0,0.999999964409561,286.987274450329,99.9999986030942
24.3,"max_tuv_SVM","SVM",19,21,11133,10864,269,2200,1942,258,0.999455935546537,0.938931297709924,5.9955035971223,303,132,171,17,1.3,16.5,7.5,0,0,0,0,0,0,0.999999988827033,288.672387686057,99.9999995621758
24.3,"max_tuv_SVM","SVM",19,22,11033,10764,269,2300,2042,258,0.999465470082414,0.942748091603053,5.9955035971223,298,131,167,-5,1.3,17.25,7.9,0,0,0,0,0,0,0.99999999077642,284.879880779908,99.9999996355595
24.3,"max_tuv_SVM","SVM",19,23,10933,10664,269,2400,2142,258,0.999482155520198,0.942748091603053,5.98473967684022,297,131,166,-1,1.3,18,8.3,0,0,0,0,0,0,0.999999987985506,283.592354158983,99.9999995166582
24.3,"max_tuv_SVM","SVM",19,24,10833,10565,268,2500,2241,259,0.999531020016566,0.942748091603053,5.96332737030411,298,133,165,1,1.2,18.75,8.7,0,0,0,0,0,0,0.999999992449508,281.580069051028,99.9999996827034
24.3,"max_tuv_SVM","SVM",19,25,10733,10465,268,2600,2341,259,0.999552472722289,0.942748091603053,5.95267857142857,303,133,170,5,1.3,19.5,9,0,0,0,0,0,0,0.999999999310562,277.825558102678,99.9999999725677
24.3,"max_tuv_SVM","SVM",19,26,10633,10365,268,2700,2441,259,0.999572733611027,0.946564885496183,5.95267857142857,300,131,169,-3,1.3,20.25,9.4,0,0,0,0,0,0,0.999999999527734,276.697335964524,99.9999999812045
24.3,"max_tuv_SVM","SVM",19,27,10533,10265,268,2800,2541,259,0.999585843597857,0.946564885496183,5.95267857142857,304,131,173,4,1.3,21,9.8,0,0,0,0,0,0,0.999999998940193,276.218415435109,99.9999999572573
24.3,"max_tuv_SVM","SVM",19,28,10433,10165,268,2900,2641,259,0.999595974042226,0.946564885496183,5.95267857142857,303,129,174,-1,1.3,21.75,10.2,0,0,0,0,0,0,0.999999999620758,274.964710334805,99.9999999856346
24.3,"max_tuv_SVM","SVM",19,29,10333,10065,268,3000,2741,259,0.99960491266961,0.950381679389313,5.95267857142857,303,129,174,0,1.3,22.5,10.6,0,0,0,0,0,0,0.999999999910627,273.541063168654,99.9999999966858
24.3,"max_tuv_SVM","SVM",19,30,10233,9965,268,3100,2841,259,0.999606700395087,0.950381679389313,5.95267857142857,303,129,174,0,1.3,23.25,11,0,0,0,0,0,0,0.999999999616389,274.058312343227,99.9999999854395
24.3,"max_tuv_SVM","SVM",19,31,10133,9865,268,3200,2941,259,0.999615639022472,0.950381679389313,5.95267857142857,302,129,173,-1,1.3,24,11.4,0,0,0,0,0,0,0.999999999741772,273.196063033688,99.9999999901597
24.3,"max_tuv_SVM","SVM",19,32,10033,9765,268,3300,3041,259,0.999619214473425,0.950381679389313,5.93149466192171,303,130,173,1,1.3,24.75,11.7,0,0,0,0,0,0,0.999999999716888,272.817987993653,99.9999999891271
24.3,"max_tuv_SVM","SVM",19,33,9933,9665,268,3400,3141,259,0.999625769466841,0.950381679389313,5.93149466192171,302,129,173,-1,1.3,25.5,12.1,0,0,0,0,0,0,0.999999999551511,272.790032872922,99.9999999831016
24.3,"max_tuv_SVM","SVM",19,34,9833,9565,268,3500,3241,259,0.999631132643271,0.950381679389313,5.93149466192171,303,130,173,1,1.3,26.25,12.5,0,0,0,0,0,0,0.999999999740261,272.187304588358,99.9999999904155
24.3,"max_tuv_SVM","SVM",19,35,9733,9465,268,3600,3341,259,0.999630536734779,0.950381679389313,5.93149466192171,301,129,172,-2,1.3,27,12.9,0,0,0,0,0,0,0.999999999727197,272.137680228526,99.9999999898654
24.3,"max_tuv_SVM","SVM",19,36,9633,9365,268,3700,3441,259,0.999637091728194,0.950381679389313,5.93149466192171,302,129,173,1,1.3,27.75,13.3,0,0,0,0,0,0,0.999999999547857,272.009018936453,99.9999999832191
24.3,"max_tuv_SVM","SVM",19,37,9533,9265,268,3800,3541,259,0.999641858996133,0.950381679389313,5.93149466192171,300,129,171,-2,1.3,28.5,13.7,0,0,0,0,0,0,0.999999999691804,271.378995285875,99.9999999887919
24.3,"max_tuv_SVM","SVM",19,38,9433,9165,268,3900,3641,259,0.999645434447086,0.954198473282443,5.93149466192171,300,128,172,0,1.3,29.25,14.1,0,0,0,0,0,0,0.999999999936584,270.685325244878,99.999999997817
24.3,"max_tuv_SVM","SVM",19,39,9333,9065,268,4000,3741,259,0.999646626264071,0.954198473282443,5.93149466192171,299,128,171,-1,1.3,30,14.4,0,0,0,0,0,0,0.99999999992963,270.582777052827,99.9999999976024
24.3,"max_tuv_SVM","SVM",19,40,9233,8965,268,4100,3841,259,0.999650201715025,0.954198473282443,5.93149466192171,300,128,172,1,1.3,30.75,14.8,0,0,0,0,0,0,0.999999999649118,271.07076811052,99.9999999875388
24.3,"max_tuv_SVM","SVM",19,41,9133,8865,268,4200,3941,259,0.999651393532009,0.954198473282443,5.93149466192171,297,128,169,-3,1.3,31.5,15.2,0,0,0,0,0,0,0.999999999952088,270.236162771431,99.9999999983561
24.3,"max_tuv_SVM","SVM",19,42,9033,8765,268,4300,4041,259,0.999653777165978,0.954198473282443,5.93149466192171,297,128,169,0,1.3,32.25,15.6,0,0,0,0,0,0,0.999999999907602,270.15730615323,99.9999999968872
24.3,"max_tuv_SVM","SVM",19,43,8933,8665,268,4400,4141,259,0.999657948525424,0.954198473282443,5.93149466192171,297,128,169,0,1.3,33,16,0,0,0,0,0,0,0.999999999920805,270.101940639182,99.9999999973143
24.3,"max_tuv_SVM","SVM",19,44,8833,8565,268,4500,4241,259,0.999663907610347,0.954198473282443,5.93149466192171,296,127,169,-1,1.3,33.75,16.4,0,0,0,0,0,0,0.999999999870649,270.182639106734,99.9999999956297
24.3,"max_tuv_SVM","SVM",19,45,8733,8465,268,4600,4341,259,0.999669270786778,0.954198473282443,5.93149466192171,298,127,171,2,1.3,34.5,16.8,0,0,0,0,0,0,0.999999999952225,269.669227260459,99.9999999984044
24.3,"max_tuv_SVM","SVM",19,46,8633,8365,268,4700,4441,259,0.99966450351884,0.954198473282443,5.93149466192171,298,127,171,0,1.3,35.25,17.1,0,0,0,0,0,0,0.999999999681107,270.045231734761,99.99999998881
24.3,"max_tuv_SVM","SVM",19,47,8533,8265,268,4800,4541,259,0.999668078969793,0.954198473282443,5.93149466192171,298,127,171,0,1.3,36,17.5,0,0,0,0,0,0,0.999999999766963,269.875923729858,99.9999999918984
24.3,"max_tuv_SVM","SVM",19,48,8433,8165,268,4900,4641,259,0.999663907610347,0.954198473282443,5.93149466192171,298,128,170,0,1.3,36.75,17.9,0,0,0,0,0,0,0.999999999816705,269.639995542208,99.999999993579
24.3,"max_tuv_SVM","SVM",20,0,13233,12710,523,100,95,5,0.97375365288528,0.793103448275862,5.67901272885909,25,5,20,0,4,0.75,19,0,0,0,0,0,0,0.981409694616639,807.884400267877,98.984936764695
24.3,"max_tuv_SVM","SVM",20,1,13133,12637,496,200,168,32,0.973893009786105,0.854406130268199,5.50248605994726,60,23,37,35,1.6,1.5,5.2,0,0,0,0,0,0,0.995179482388346,660.289110487513,99.8003059900333
24.3,"max_tuv_SVM","SVM",20,2,13033,12567,466,300,238,62,0.98414351727251,0.896551724137931,5.83070964517741,98,41,57,38,1.4,2.25,3.8,0,0,0,0,0,0,0.997295937666605,544.779511241757,99.980852101352
24.3,"max_tuv_SVM","SVM",20,3,12933,12506,427,400,299,101,0.966940715301623,0.923371647509579,5.55600272366027,163,71,92,65,1.3,3,3,0,0,0,0,0,0,0.999999977258749,430.414877808438,99.9999993379592
24.3,"max_tuv_SVM","SVM",20,4,12833,12418,415,500,387,113,0.959814374215779,0.915708812260536,5.40439984383168,190,83,107,27,1.3,3.75,3.4,0,0,0,0,0,0,0.999999978002403,394.876161863318,99.9999993291414
24.3,"max_tuv_SVM","SVM",20,5,12733,12327,406,600,478,122,0.961984872898153,0.923371647509579,5.39043498635408,208,88,120,18,1.4,4.5,3.9,0,0,0,0,0,0,0.999999983807687,380.642294785651,99.9999995343557
24.3,"max_tuv_SVM","SVM",20,6,12633,12232,401,700,573,127,0.96371517124153,0.923371647509579,5.42783609640684,214,91,123,6,1.4,5.25,4.5,0,0,0,0,0,0,0.999999988661592,372.98614924219,99.9999996430632
24.3,"max_tuv_SVM","SVM",20,7,12533,12132,401,800,673,127,0.965791170394625,0.923371647509579,5.45622931051185,214,92,122,0,1.3,6,5.3,0,0,0,0,0,0,0.999999996093331,372.354094373932,99.9999998891606
24.3,"max_tuv_SVM","SVM",20,8,12433,12037,396,900,768,132,0.966170962806672,0.923371647509579,5.46420789605197,213,92,121,-1,1.3,6.75,5.8,0,0,0,0,0,0,0.999999998945406,366.661868867777,99.9999999666956
24.3,"max_tuv_SVM","SVM",20,9,12333,11938,395,1000,867,133,0.969313969303218,0.9272030651341,5.49119507551127,214,93,121,1,1.3,7.5,6.5,0,0,0,0,0,0,0.999999993418333,367.86673193523,99.9999997912316
24.3,"max_tuv_SVM","SVM",20,10,12233,11838,395,1100,967,133,0.969373181033603,0.9272030651341,5.4864201232717,216,93,123,2,1.3,8.25,7.3,0,0,0,0,0,0,0.999999999317634,366.524218351625,99.9999999809015
24.3,"max_tuv_SVM","SVM",20,11,12133,11743,390,1200,1062,138,0.969889339855011,0.9272030651341,5.49597834648297,218,95,123,2,1.3,9,7.7,0,0,0,0,0,0,0.999999999062101,360.79389147211,99.9999999732271
24.3,"max_tuv_SVM","SVM",20,12,12033,11643,390,1300,1162,138,0.970309802950557,0.9272030651341,5.5007699579446,217,95,122,-1,1.3,9.75,8.4,0,0,0,0,0,0,0.999999997330128,361.234837627973,99.9999999273683
24.3,"max_tuv_SVM","SVM",20,13,11933,11543,390,1400,1262,138,0.97085885717774,0.9272030651341,5.49597834648297,215,93,122,-2,1.3,10.5,9.1,0,0,0,0,0,0,0.999999999521789,360.500743154098,99.9999999867779
24.3,"max_tuv_SVM","SVM",20,14,11833,11444,389,1500,1361,139,0.97378295970137,0.9272030651341,5.49597834648297,221,95,126,6,1.3,11.25,9.8,0,0,0,0,0,0,0.999999995493159,361.343584969948,99.999999857415
24.3,"max_tuv_SVM","SVM",20,15,11733,11346,387,1600,1459,141,0.981205359439136,0.9272030651341,5.57447087148801,226,99,127,5,1.3,12,10.3,0,0,0,0,0,0,0.999999995595884,362.543149749274,99.9999998642341
24.3,"max_tuv_SVM","SVM",20,16,11633,11250,383,1700,1555,145,0.988271890696362,0.923371647509579,5.69898369451371,239,102,137,13,1.3,12.75,10.7,0,0,0,0,0,0,0.999999997644973,363.493551187899,99.9999999179707
24.3,"max_tuv_SVM","SVM",20,17,11533,11156,377,1800,1649,151,0.994011839953697,0.919540229885057,5.88245856163913,256,111,145,17,1.3,13.5,10.9,0,0,0,0,0,0,0.999999999198775,369.247274844007,99.9999999726168
24.3,"max_tuv_SVM","SVM",20,18,11433,11063,370,1900,1742,158,0.996682946902037,0.923371647509579,5.92658976267262,275,118,157,19,1.3,14.25,11,0,0,0,0,0,0,0.999999999610778,371.298657797683,99.9999999863176
24.3,"max_tuv_SVM","SVM",20,19,11333,10970,363,2000,1835,165,0.998441953963182,0.9272030651341,5.97790813564115,303,127,176,28,1.4,15,11.1,0,0,0,0,0,0,0.999999999837728,372.097743727205,99.9999999942479
24.3,"max_tuv_SVM","SVM",20,20,11233,10873,360,2100,1932,168,0.998595067124574,0.934865900383142,5.97790813564115,313,129,184,10,1.4,15.75,11.5,0,0,0,0,0,0,0.999999999971404,368.638667237798,99.9999999990678
24.3,"max_tuv_SVM","SVM",20,21,11133,10774,359,2200,2031,169,0.998649494068663,0.934865900383142,5.98329363846605,315,129,186,2,1.4,16.5,12,0,0,0,0,0,0,0.999999999920807,368.943445965226,99.999999997279
24.3,"max_tuv_SVM","SVM",20,22,11033,10674,359,2300,2131,169,0.99866085793611,0.934865900383142,5.99409380748855,317,129,188,2,1.5,17.25,12.6,0,0,0,0,0,0,0.999999999981152,366.623772623777,99.9999999993704
24.3,"max_tuv_SVM","SVM",20,23,10933,10574,359,2400,2231,169,0.998660259837823,0.934865900383142,5.96716616235159,316,129,187,-1,1.4,18,13.2,0,0,0,0,0,0,0.999999999992045,364.597179074026,99.9999999997402
24.3,"max_tuv_SVM","SVM",20,24,10833,10474,359,2500,2331,169,0.998676408491564,0.934865900383142,5.96716616235159,321,129,192,5,1.5,18.75,13.8,0,0,0,0,0,0,0.99999999999678,363.946306266944,99.9999999999
24.3,"max_tuv_SVM","SVM",20,25,10733,10374,359,2600,2431,169,0.998686576162437,0.934865900383142,5.97790813564115,324,130,194,3,1.5,19.5,14.4,0,0,0,0,0,0,0.999999999996726,363.157106386937,99.999999999896
24.3,"max_tuv_SVM","SVM",20,26,10633,10274,359,2700,2531,169,0.998689566653871,0.934865900383142,5.91403022145799,324,130,194,0,1.5,20.25,15,0,0,0,0,0,0,0.999999999998734,362.553394934247,99.9999999999594
24.3,"max_tuv_SVM","SVM",20,27,10533,10174,359,2800,2631,169,0.998701528619605,0.934865900383142,5.91403022145799,322,129,193,-2,1.5,21,15.6,0,0,0,0,0,0,0.999999999998732,362.078588953216,99.999999999959
24.3,"max_tuv_SVM","SVM",20,28,10433,10074,359,2900,2731,169,0.998715882978485,0.934865900383142,5.9618096397642,320,129,191,-2,1.5,21.75,16.2,0,0,0,0,0,0,0.999999999995571,362.097989210029,99.999999999854
24.3,"max_tuv_SVM","SVM",20,29,10333,9974,359,3000,2831,169,0.998725452551072,0.934865900383142,5.9618096397642,318,128,190,-2,1.5,22.5,16.8,0,0,0,0,0,0,0.999999999997358,361.605577315354,99.9999999999137
24.3,"max_tuv_SVM","SVM",20,30,10233,9874,359,3100,2931,169,0.998738610713379,0.938697318007663,5.94579761745507,317,129,188,-1,1.5,23.25,17.3,0,0,0,0,0,0,0.999999999997739,361.522094070758,99.9999999999262
24.3,"max_tuv_SVM","SVM",20,31,10133,9774,359,3200,3031,169,0.998736816418519,0.938697318007663,5.898273480193,317,129,188,0,1.5,24,17.9,0,0,0,0,0,0,0.999999999999263,360.899148661817,99.9999999999768
24.3,"max_tuv_SVM","SVM",20,32,10033,9674,359,3300,3131,169,0.998750572679113,0.938697318007663,5.9618096397642,316,128,188,-1,1.5,24.75,18.5,0,0,0,0,0,0,0.999999999996177,361.099607841749,99.9999999998818
24.3,"max_tuv_SVM","SVM",20,33,9933,9574,359,3400,3231,169,0.998755955563693,0.938697318007663,5.88260047714554,315,128,187,-1,1.5,25.5,19.1,0,0,0,0,0,0,0.999999999999599,360.4403605312,99.9999999999877
24.3,"max_tuv_SVM","SVM",20,34,9833,9474,359,3500,3331,169,0.998763132743133,0.934865900383142,5.898273480193,315,129,186,0,1.4,26.25,19.7,0,0,0,0,0,0,0.99999999999904,360.553875112365,99.999999999971
24.3,"max_tuv_SVM","SVM",20,35,9733,9374,359,3600,3431,169,0.998780477593447,0.934865900383142,5.898273480193,313,127,186,-2,1.5,27,20.3,0,0,0,0,0,0,0.999999999998946,360.299501311154,99.999999999968
24.3,"max_tuv_SVM","SVM",20,36,9633,9274,359,3700,3531,169,0.998787654772887,0.934865900383142,5.97253231897241,314,127,187,1,1.5,27.75,20.9,0,0,0,0,0,0,0.999999999994952,360.525503635259,99.9999999998437
24.3,"max_tuv_SVM","SVM",20,37,9533,9174,359,3800,3631,169,0.998794233854041,0.934865900383142,5.96716616235159,310,126,184,-4,1.5,28.5,21.5,0,0,0,0,0,0,0.999999999996756,360.424894884437,99.9999999998994
24.3,"max_tuv_SVM","SVM",20,38,9433,9074,359,3900,3731,169,0.998798420542047,0.934865900383142,5.97253231897241,315,127,188,5,1.5,29.25,22.1,0,0,0,0,0,0,0.99999999999762,360.351031995209,99.9999999999249
24.3,"max_tuv_SVM","SVM",20,39,9333,8974,359,4000,3831,169,0.998809784409494,0.934865900383142,5.90876862873427,312,127,185,-3,1.5,30,22.7,0,0,0,0,0,0,0.99999999999909,359.919384557875,99.9999999999716
24.3,"max_tuv_SVM","SVM",20,40,9233,8874,359,4100,3931,169,0.998824138768375,0.934865900383142,5.898273480193,312,127,185,0,1.5,30.75,23.3,0,0,0,0,0,0,0.999999999999425,359.772390870336,99.9999999999821
24.3,"max_tuv_SVM","SVM",20,41,9133,8774,359,4200,4031,169,0.998832512144388,0.934865900383142,5.94047937271674,311,127,184,-1,1.4,31.5,23.9,0,0,0,0,0,0,0.99999999999801,359.879323802072,99.9999999999382
24.3,"max_tuv_SVM","SVM",20,42,9033,8674,359,4300,4131,169,0.998844474110122,0.934865900383142,5.89303987462051,313,127,186,2,1.5,32.25,24.4,0,0,0,0,0,0,0.999999999999276,359.677460383157,99.9999999999774
24.3,"max_tuv_SVM","SVM",20,43,8933,8574,359,4400,4231,169,0.998858828469002,0.934865900383142,5.84635205871243,315,127,188,2,1.5,33,25,0,0,0,0,0,0,0.999999999999814,359.542630144983,99.9999999999935
24.3,"max_tuv_SVM","SVM",20,44,8833,8474,359,4500,4331,169,0.998875575221029,0.934865900383142,5.91403022145799,316,126,190,1,1.5,33.75,25.6,0,0,0,0,0,0,0.99999999999833,359.743478454549,99.9999999999495
24.3,"max_tuv_SVM","SVM",20,45,8733,8374,359,4600,4431,169,0.998874379024456,0.934865900383142,5.898273480193,315,127,188,-1,1.5,34.5,26.2,0,0,0,0,0,0,0.999999999998753,359.548944163111,99.9999999999624
24.3,"max_tuv_SVM","SVM",20,46,8633,8274,359,4700,4531,169,0.998882752400469,0.938697318007663,5.78020534264344,315,128,187,0,1.5,35.25,26.8,0,0,0,0,0,0,0.999999999999934,359.355975852513,99.9999999999966
24.3,"max_tuv_SVM","SVM",20,47,8533,8174,359,4800,4631,169,0.998894116267916,0.938697318007663,5.9618096397642,314,127,187,-1,1.5,36,27.4,0,0,0,0,0,0,0.999999999996102,359.563959938102,99.9999999998862
24.3,"max_tuv_SVM","SVM",20,48,8433,8074,359,4900,4731,169,0.998903685840503,0.938697318007663,5.88260047714554,315,128,187,1,1.5,36.75,28,0,0,0,0,0,0,0.999999999999634,359.371189360695,99.9999999999891
24.3,"greedy_SVM","SVM",1,0,13233,12713,520,100,94,6,0.942341763584092,0.85171102661597,5.23408148125971,32,6,26,0,4.3,0.75,15.7,0,0,0,0,0,0,0.999999996919012,1004.24022006763,99.9999998935655
24.3,"greedy_SVM","SVM",1,1,13133,12713,420,200,94,106,0.947700225381959,0.840304182509506,5.15737511472401,48,18,30,16,1.7,1.5,0.9,0,0,0,0,0,0,0.977752355498745,527.909439377714,98.5026344774137
24.3,"greedy_SVM","SVM",1,2,13033,12713,320,300,94,206,0.949558023383671,0.840304182509506,5.15737511472401,58,19,39,10,2.1,2.25,0.5,0,0,0,0,0,0,0.965693838902393,442.784131747079,98.3059184038156
24.3,"greedy_SVM","SVM",1,3,12933,12713,220,400,94,306,0.948891852288114,0.840304182509506,5.19714960464168,71,24,47,13,2,3,0.3,0,0,0,0,0,0,0.766784632360342,325.192321125671,93.6691116938984
24.3,"greedy_SVM","SVM",1,4,12833,12702,131,500,105,395,0.956828313102783,0.878326996197719,5.35187124437999,99,38,61,28,1.6,3.75,0.3,0,0,0,0,0,0,0.115001200861551,81.3045795611589,49.7674051404139
24.3,"greedy_SVM","SVM",1,5,12733,12659,74,600,148,452,0.957918411259138,0.893536121673004,5.50687072925982,120,56,64,21,1.1,4.5,0.3,0,0,0,0,0,0,0.0167582083691919,31.1634327033473,14.0315650369816
24.3,"greedy_SVM","SVM",1,6,12633,12574,59,700,233,467,0.941231478424842,0.893536121673004,5.30945215970937,144,60,84,24,1.4,5.25,0.5,0,0,0,0,0,0,0.00938416031757273,17.4670403571153,2.53504153441682
24.3,"greedy_SVM","SVM",1,7,12533,12475,58,800,332,468,0.943096994986517,0.893536121673004,5.18468696535589,157,69,88,13,1.3,6,0.7,0,0,0,0,0,0,0.0040847473499316,6.7426805164475,0.454466267956055
24.3,"greedy_SVM","SVM",1,8,12433,12375,58,900,432,468,0.952308205660429,0.893536121673004,5.19714960464168,159,69,90,2,1.3,6.75,0.9,0,0,0,0,0,0,0.00400495458082132,4.59593640417097,0.752552116105766
24.3,"greedy_SVM","SVM",1,9,12333,12275,58,1000,532,468,0.952847317384781,0.893536121673004,5.2333666750573,155,65,90,-4,1.4,7.5,1.1,0,0,0,0,0,0,0.00242201829497099,3.27885968677634,0.29255029311254
24.3,"greedy_SVM","SVM",1,10,12233,12175,58,1100,632,468,0.952966064460646,0.893536121673004,5.21067211011776,148,67,81,-7,1.2,8.25,1.4,0,0,0,0,0,0,0.00138599441851926,1.82287748059818,0.17304173899365
24.3,"greedy_SVM","SVM",1,11,12133,12078,55,1200,729,471,0.958229528597843,0.897338403041825,5.2364775823143,156,69,87,8,1.3,9,1.5,0,0,0,0,0,0,0.00246722150698426,3.22540053554909,0.453275509683567
24.3,"greedy_SVM","SVM",1,12,12033,11987,46,1300,820,480,0.960559939961473,0.904942965779468,5.33680208124875,172,78,94,16,1.2,9.75,1.7,0,0,0,0,0,0,0.00307710556016203,4.01987708139024,0.674488702316924
24.3,"greedy_SVM","SVM",1,13,11933,11897,36,1400,910,490,0.960591407936548,0.923954372623574,5.3574340480577,198,89,109,26,1.2,10.5,1.9,0,0,0,0,0,0,0.00326153763201071,3.81706648653673,0.980124582461188
24.3,"greedy_SVM","SVM",1,14,11833,11803,30,1500,1004,496,0.95934040749242,0.923954372623574,5.35283539222246,212,93,119,14,1.3,11.25,2,0,0,0,0,0,0,0.0034410814107933,3.54379898295842,0.430336115086793
24.3,"greedy_SVM","SVM",1,15,11733,11703,30,1600,1104,496,0.959219879210435,0.923954372623574,5.36204061215749,213,93,120,1,1.3,12,2.2,0,0,0,0,0,0,0.00284117810327994,3.46885993356966,0.323489365561548
24.3,"greedy_SVM","SVM",1,16,11633,11603,30,1700,1204,496,0.959248378508647,0.923954372623574,5.36204061215749,213,93,120,0,1.3,12.75,2.4,0,0,0,0,0,0,0.00186367932210958,2.45674905014149,0.206318235447805
24.3,"greedy_SVM","SVM",1,17,11533,11503,30,1800,1304,496,0.959969766994457,0.923954372623574,5.36204061215749,210,93,117,-3,1.3,13.5,2.6,0,0,0,0,0,0,0.00143876301445508,1.92952934530831,0.162364597800437
24.3,"greedy_SVM","SVM",1,18,11433,11403,30,1900,1404,496,0.960180543054092,0.923954372623574,5.3574340480577,209,92,117,-1,1.3,14.25,2.8,0,0,0,0,0,0,0.00132726197431263,1.91686501007259,0.142288457729891
24.3,"greedy_SVM","SVM",1,19,11333,11303,30,2000,1504,496,0.960634750619231,0.923954372623574,5.36204061215749,206,92,114,-3,1.2,15,3,0,0,0,0,0,0,0.000771888089027815,1.05915478137069,0.0827598780265844
24.3,"greedy_SVM","SVM",1,20,11233,11203,30,2100,1604,496,0.961009397643551,0.923954372623574,5.36204061215749,208,94,114,2,1.2,15.75,3.2,0,0,0,0,0,0,0.00106632795971861,1.61178892862521,0.112410992520141
24.3,"greedy_SVM","SVM",1,21,11133,11103,30,2200,1704,496,0.961467761356345,0.923954372623574,5.36665510493904,213,98,115,5,1.2,16.5,3.4,0,0,0,0,0,0,0.00102564473455001,1.55348754236861,0.107787054273252
24.3,"greedy_SVM","SVM",1,22,11033,11005,28,2300,1802,498,0.966840472803364,0.923954372623574,5.39311200846261,220,101,119,7,1.2,17.25,3.6,0,0,0,0,0,0,0.000935688116195549,1.60456380275873,0.115077088898537
24.3,"greedy_SVM","SVM",1,23,10933,10907,26,2400,1900,500,0.971337424565912,0.923954372623574,5.39311200846261,225,104,121,5,1.2,18,3.8,0,0,0,0,0,0,0.00141884398601451,2.68480799971919,0.165886080191052
24.3,"greedy_SVM","SVM",1,24,10833,10812,21,2500,1995,505,0.987479308322026,0.931558935361217,5.64316539090852,241,109,132,16,1.2,18.75,4,0,0,0,0,0,0,0.00540248373538994,7.72439533812016,0.761550116076218
24.3,"greedy_SVM","SVM",1,25,10733,10719,14,2600,2088,512,0.995450799524069,0.931558935361217,5.84478832175631,260,114,146,19,1.3,19.5,4.1,0,0,0,0,0,0,0.00697268309018028,9.4286472799867,0.902103782259044
24.3,"greedy_SVM","SVM",1,26,10633,10623,10,2700,2184,516,0.997551435295904,0.931558935361217,5.87236975253233,275,122,153,15,1.3,20.25,4.2,0,0,0,0,0,0,0.00800067727106243,11.2047254589074,1.00757235199867
24.3,"greedy_SVM","SVM",1,27,10533,10530,3,2800,2277,523,0.999159864438339,0.935361216730038,5.9052258635961,299,129,170,24,1.3,21,4.4,0,0,0,0,0,0,0.0134848550965767,14.0759627998789,1.81288825116222
24.3,"greedy_SVM","SVM",1,28,10433,10433,0,2900,2374,526,0.999327297815292,0.939163498098859,5.92095914742451,306,133,173,7,1.3,21.75,4.5,0,0,0,0,0,0,0.00934847933283019,10.3243564665706,1.13780727817001
24.3,"greedy_SVM","SVM",1,29,10333,10333,0,3000,2474,526,0.999333828904463,0.939163498098859,5.92095914742451,308,134,174,2,1.3,22.5,4.7,0,0,0,0,0,0,0.00744003188995041,9.01504685084893,0.828404573935388
24.3,"greedy_SVM","SVM",1,30,10233,10233,0,3100,2574,526,0.999334422639843,0.939163498098859,5.92095914742451,307,134,173,-1,1.3,23.25,4.9,0,0,0,0,0,0,0.00545935032970658,7.10607560236273,0.596158778551718
24.3,"greedy_SVM","SVM",1,31,10133,10133,0,3200,2674,526,0.999340953729015,0.939163498098859,5.92622222222222,305,133,172,-2,1.3,24,5.1,0,0,0,0,0,0,0.00461563483573112,6.19049991140535,0.50089088366895
24.3,"greedy_SVM","SVM",1,32,10033,10033,0,3300,2774,526,0.9993528284366,0.939163498098859,5.92622222222222,303,133,170,-2,1.3,24.75,5.3,0,0,0,0,0,0,0.00552677031173815,8.68187484891415,0.584588845225488
24.3,"greedy_SVM","SVM",1,33,9933,9933,0,3400,2874,526,0.999354609642738,0.939163498098859,5.92095914742451,303,133,170,0,1.3,25.5,5.5,0,0,0,0,0,0,0.00368951612708152,5.39251555022627,0.391007392101651
24.3,"greedy_SVM","SVM",1,34,9833,9833,0,3500,2974,526,0.99936885929184,0.939163498098859,5.92095914742451,302,133,169,-1,1.3,26.25,5.7,0,0,0,0,0,0,0.0031493997557445,4.64419971960969,0.330056655479166
24.3,"greedy_SVM","SVM",1,35,9733,9733,0,3600,3074,526,0.99937717158715,0.939163498098859,5.92095914742451,305,133,172,3,1.3,27,5.8,0,0,0,0,0,0,0.00278230002807135,4.06070251217802,0.291669937924948
24.3,"greedy_SVM","SVM",1,36,9633,9633,0,3700,3174,526,0.99939320244239,0.939163498098859,5.92095914742451,307,133,174,2,1.3,27.75,6,0,0,0,0,0,0,0.00265799803025769,3.99662866091614,0.277985975781949
24.3,"greedy_SVM","SVM",1,37,9533,9533,0,3800,3274,526,0.999403889679217,0.939163498098859,5.91570541259982,304,132,172,-3,1.3,28.5,6.2,0,0,0,0,0,0,0.0018803710867841,2.6907933530623,0.19707637849193
24.3,"greedy_SVM","SVM",1,38,9433,9433,0,3900,3374,526,0.999408045826872,0.939163498098859,5.91570541259982,308,132,176,4,1.3,29.25,6.4,0,0,0,0,0,0,0.00210954852121464,3.36926503467129,0.221827386298654
24.3,"greedy_SVM","SVM",1,39,9333,9333,0,4000,3474,526,0.999413389445285,0.939163498098859,5.894783377542,310,132,178,2,1.3,30,6.6,0,0,0,0,0,0,0.00157343800732834,2.36859020251066,0.163002134052064
24.3,"greedy_SVM","SVM",1,40,9233,9233,0,4100,3574,526,0.999418733063698,0.939163498098859,5.894783377542,309,131,178,-1,1.4,30.75,6.8,0,0,0,0,0,0,0.00159278204357124,2.4790559667677,0.165443433742522
24.3,"greedy_SVM","SVM",1,41,9133,9133,0,4200,3674,526,0.999426451623629,0.939163498098859,5.88437775816417,309,131,178,0,1.4,31.5,7,0,0,0,0,0,0,0.00123608160093313,1.85375836868954,0.127980632513514
24.3,"greedy_SVM","SVM",1,42,9033,9033,0,4300,3774,526,0.999432388977422,0.939163498098859,5.894783377542,309,131,178,0,1.4,32.25,7.2,0,0,0,0,0,0,0.00122025107894671,1.86209467051915,0.126449945329427
24.3,"greedy_SVM","SVM",1,43,8933,8933,0,4400,3874,526,0.999432388977422,0.939163498098859,5.88957597173145,308,131,177,-1,1.4,33,7.4,0,0,0,0,0,0,0.00106780275670094,1.5963290568363,0.110354131728513
24.3,"greedy_SVM","SVM",1,44,8833,8833,0,4500,3974,526,0.999437732595835,0.939163498098859,5.894783377542,308,131,177,0,1.4,33.75,7.6,0,0,0,0,0,0,0.000980954237115824,1.4482407407109,0.101498204588021
24.3,"greedy_SVM","SVM",1,45,8733,8733,0,4600,4074,526,0.999440107537352,0.939163498098859,5.9,308,131,177,0,1.4,34.5,7.7,0,0,0,0,0,0,0.00133499582021756,2.12828136234475,0.137687504852516
24.3,"greedy_SVM","SVM",1,46,8633,8633,0,4700,4174,526,0.999438920066594,0.942965779467681,5.9,309,131,178,1,1.4,35.25,7.9,0,0,0,0,0,0,0.000917571072205823,1.3395898573206,0.0940828144842836
24.3,"greedy_SVM","SVM",1,47,8533,8533,0,4800,4274,526,0.999443076214248,0.942965779467681,5.894783377542,309,131,178,0,1.4,36,8.1,0,0,0,0,0,0,0.000791075629843609,1.16450881868929,0.082153025086153
24.3,"greedy_SVM","SVM",1,48,8433,8433,0,4900,4374,526,0.999444263685007,0.942965779467681,5.894783377542,309,131,178,0,1.4,36.75,8.3,0,0,0,0,0,0,0.000726173518480881,1.0729520587164,0.0756871450972223
24.3,"greedy_SVM","SVM",2,0,13233,12702,531,100,90,10,0.946111342837974,0.782258064516129,5.24323242915091,24,8,16,0,2,0.75,9,0,0,0,0,0,0,0.995984091137334,691.500948752757,99.8669048063219
24.3,"greedy_SVM","SVM",2,1,13133,12702,431,200,90,110,0.94939544396921,0.786290322580645,5.11842677392179,35,9,26,11,2.9,1.5,0.8,0,0,0,0,0,0,0.977940482356282,496.665801096153,98.729232046185
24.3,"greedy_SVM","SVM",2,2,13033,12702,331,300,90,210,0.948479564196957,0.786290322580645,5.11842677392179,54,17,37,19,2.2,2.25,0.4,0,0,0,0,0,0,0.954141991546358,371.271928833559,97.6102579162938
24.3,"greedy_SVM","SVM",2,3,12933,12702,231,400,90,310,0.956252606928001,0.80241935483871,5.19951163360942,67,23,44,13,1.9,3,0.3,0,0,0,0,0,0,0.732964387614873,275.730971854535,92.8850817298002
24.3,"greedy_SVM","SVM",2,4,12833,12691,142,500,101,399,0.95966925307426,0.870967741935484,5.30251660137256,91,33,58,24,1.8,3.75,0.3,0,0,0,0,0,0,0.0854219637585844,50.4260894666451,34.0426667260404
24.3,"greedy_SVM","SVM",2,5,12733,12637,96,600,155,445,0.976212881114014,0.923387096774194,5.49400619805606,117,54,63,26,1.2,4.5,0.3,0,0,0,0,0,0,0.00887409589822694,18.7506726767098,16.5233253495074
24.3,"greedy_SVM","SVM",2,6,12633,12566,67,700,226,474,0.96221461990359,0.923387096774194,5.49662658410138,136,64,72,19,1.1,5.25,0.5,0,0,0,0,0,0,0.0103666407960439,12.4847370656683,2.3015190085673
24.3,"greedy_SVM","SVM",2,7,12533,12467,66,800,325,475,0.966515108875353,0.923387096774194,5.39529791765926,154,68,86,18,1.3,6,0.7,0,0,0,0,0,0,0.00565019890917033,6.82380670528807,0.886895815006498
24.3,"greedy_SVM","SVM",2,8,12433,12368,65,900,424,476,0.973823929965984,0.923387096774194,5.55473957307984,165,72,93,11,1.3,6.75,0.9,0,0,0,0,0,0,0.0042789338588462,1.61349294734774,0.552903625099404
24.3,"greedy_SVM","SVM",2,9,12333,12269,64,1000,523,477,0.976215393815756,0.923387096774194,5.56930619783442,167,75,92,2,1.2,7.5,1.1,0,0,0,0,0,0,0.00321977391571774,0.706146576376986,0.377237872585753
24.3,"greedy_SVM","SVM",2,10,12233,12170,63,1100,622,478,0.977139439868536,0.923387096774194,5.56444217495422,168,75,93,1,1.2,8.25,1.3,0,0,0,0,0,0,0.00317456417421837,0.890317178372838,0.357166989183257
24.3,"greedy_SVM","SVM",2,11,12133,12070,63,1200,722,478,0.977467347441314,0.923387096774194,5.5741787316908,169,75,94,1,1.3,9,1.5,0,0,0,0,0,0,1.80019191619263e-05,0.194952066117746,0.184201370511999
24.3,"greedy_SVM","SVM",2,12,12033,11970,63,1300,822,478,0.97772364301544,0.923387096774194,5.5741787316908,169,75,94,0,1.3,9.75,1.7,0,0,0,0,0,0,1.5207464378185e-05,0.0392729994200314,0.0301446312793227
24.3,"greedy_SVM","SVM",2,13,11933,11870,63,1400,922,478,0.977974285010724,0.923387096774194,5.56444217495422,171,74,97,2,1.3,10.5,1.9,0,0,0,0,0,0,8.37556420324415e-06,0.00583234751194434,0.000971442109756526
24.3,"greedy_SVM","SVM",2,14,11833,11771,62,1500,1021,479,0.978944187869659,0.923387096774194,5.58792083392027,178,76,102,7,1.3,11.25,2.1,0,0,0,0,0,0,7.19190317292828e-06,0.00779153597662769,0.00342910956796624
24.3,"greedy_SVM","SVM",2,15,11733,11672,61,1600,1120,480,0.980399042158084,0.923387096774194,5.63107135789206,177,77,100,-1,1.3,12,2.3,0,0,0,0,0,0,7.72969402317402e-06,0.0113918217424662,0.00614359251393126
24.3,"greedy_SVM","SVM",2,16,11633,11575,58,1700,1217,483,0.982706958676058,0.923387096774194,5.70318534189005,183,81,102,6,1.3,12.75,2.5,0,0,0,0,0,0,1.82280164479446e-05,0.297369290321336,0.284561942374864
24.3,"greedy_SVM","SVM",2,17,11533,11481,52,1800,1311,489,0.983874736794438,0.92741935483871,5.73189569418786,198,87,111,15,1.3,13.5,2.7,0,0,0,0,0,0,0.00466666118176382,2.92202003601633,0.589471622972622
24.3,"greedy_SVM","SVM",2,18,11433,11392,41,1900,1400,500,0.98343187311855,0.951612903225806,5.71678524859686,229,100,129,31,1.3,14.25,2.8,0,0,0,0,0,0,0.0102995790245133,8.6181481613586,1.66481960229052
24.3,"greedy_SVM","SVM",2,19,11333,11301,32,2000,1491,509,0.98317180849186,0.959677419354839,5.7067558007923,249,109,140,20,1.3,15,2.9,0,0,0,0,0,0,0.010793427986099,7.3260857918451,1.60436005868214
24.3,"greedy_SVM","SVM",2,20,11233,11201,32,2100,1591,509,0.98275155913134,0.963709677419355,5.70175426196602,248,108,140,-1,1.3,15.75,3.1,0,0,0,0,0,0,0.00570722748156699,2.83594527380859,0.669442115771793
24.3,"greedy_SVM","SVM",2,21,11133,11101,32,2200,1691,509,0.982543633065073,0.963709677419355,5.70175426196602,247,108,139,-1,1.3,16.5,3.3,0,0,0,0,0,0,0.00438116272016061,1.90660157891181,0.483962347910913
24.3,"greedy_SVM","SVM",2,22,11033,11001,32,2300,1791,509,0.982378422927829,0.963709677419355,5.70175426196602,246,107,139,-1,1.3,17.25,3.5,0,0,0,0,0,0,0.00432265847710471,2.07572105116263,0.458002328711661
24.3,"greedy_SVM","SVM",2,23,10933,10901,32,2400,1891,509,0.982209443738023,0.963709677419355,5.70175426196602,247,106,141,1,1.3,18,3.7,0,0,0,0,0,0,0.00323099409259801,0.932565446315049,0.3452790736976
24.3,"greedy_SVM","SVM",2,24,10833,10801,32,2500,1991,509,0.981994607742062,0.963709677419355,5.69676148240212,249,107,142,2,1.3,18.75,3.9,0,0,0,0,0,0,0.00305090417817806,0.864466726938748,0.328905419707219
24.3,"greedy_SVM","SVM",2,25,10733,10701,32,2600,2091,509,0.981830653955671,0.963709677419355,5.69177743911043,249,106,143,0,1.3,19.5,4.1,0,0,0,0,0,0,0.00283489687335744,0.615307842490682,0.298296533758478
24.3,"greedy_SVM","SVM",2,26,10633,10601,32,2700,2191,509,0.981691199010924,0.963709677419355,5.69177743911043,252,106,146,3,1.4,20.25,4.3,0,0,0,0,0,0,9.8688494261168e-06,0.0075533287477612,0.00113098437036752
24.3,"greedy_SVM","SVM",2,27,10533,10501,32,2800,2291,509,0.981576242907822,0.963709677419355,5.69177743911043,251,106,145,-1,1.4,21,4.5,0,0,0,0,0,0,1.01264088881041e-05,0.0082838637892328,0.0011115863992704
24.3,"greedy_SVM","SVM",2,28,10433,10401,32,2900,2391,509,0.981402238314602,0.963709677419355,5.69177743911043,251,106,145,0,1.4,21.75,4.7,0,0,0,0,0,0,5.68244277924394e-06,0.00447158155367535,0.00062380470507329
24.3,"greedy_SVM","SVM",2,29,10333,10301,32,3000,2491,509,0.981351984280459,0.963709677419355,5.68680210918114,251,106,145,0,1.4,22.5,4.9,0,0,0,0,0,0,6.72095968563577e-06,0.00560167133430332,0.000741442088654899
24.3,"greedy_SVM","SVM",2,30,10233,10201,32,3100,2591,509,0.981314921930279,0.963709677419355,5.67192817166803,251,107,144,0,1.3,23.25,5.1,0,0,0,0,0,0,5.72578367233693e-06,0.00499039976635829,0.000617528839230551
24.3,"greedy_SVM","SVM",2,31,10133,10101,32,3200,2691,509,0.981273462352111,0.963709677419355,5.67192817166803,253,107,146,2,1.4,24,5.3,0,0,0,0,0,0,2.9751432019911e-06,0.00246269110008462,0.000322828269183226
24.3,"greedy_SVM","SVM",2,32,10033,10001,32,3300,2791,509,0.981272834176684,0.963709677419355,5.67192817166803,250,106,144,-3,1.4,24.75,5.5,0,0,0,0,0,0,3.47502081452179e-06,0.00297093122152972,0.000375257351001786
24.3,"greedy_SVM","SVM",2,33,9933,9902,31,3400,2890,510,0.983870339566447,0.963709677419355,5.68680210918114,254,107,147,4,1.4,25.5,5.7,0,0,0,0,0,0,3.42762566569494e-06,0.0303394045977961,0.0276184657378937
24.3,"greedy_SVM","SVM",2,34,9833,9807,26,3500,2985,515,0.995438190050699,0.963709677419355,5.75391907187323,273,113,160,19,1.4,26.25,5.8,0,0,0,0,0,0,8.70213652351548e-06,1.3893457154781,1.38402431334869
24.3,"greedy_SVM","SVM",2,35,9733,9727,6,3600,3065,535,0.999852378774706,0.971774193548387,5.832895888014,314,134,180,41,1.3,27,5.7,0,0,0,0,0,0,1.11968156840164e-05,2.56327875572086,2.55980749354217
24.3,"greedy_SVM","SVM",2,36,9633,9633,0,3700,3159,541,0.999849866072999,0.971774193548387,5.82270742358079,333,140,193,19,1.4,27.75,5.8,0,0,0,0,0,0,5.21009761848351e-06,0.0468369929698847,0.043885745307274
24.3,"greedy_SVM","SVM",2,37,9533,9533,0,3800,3259,541,0.999849237897572,0.971774193548387,5.85338015803336,336,141,195,3,1.4,28.5,6,0,0,0,0,0,0,5.42944738668293e-06,0.00494938140585814,0.00065470784049491
24.3,"greedy_SVM","SVM",2,38,9433,9433,0,3900,3359,541,0.999849866072999,0.971774193548387,5.85338015803336,336,141,195,0,1.4,29.25,6.2,0,0,0,0,0,0,3.62426476125527e-06,0.0034844906015468,0.000406688380134026
24.3,"greedy_SVM","SVM",2,39,9333,9333,0,4000,3459,541,0.999846097020438,0.971774193548387,5.83800350262697,337,141,196,1,1.4,30,6.4,0,0,0,0,0,0,2.31060876754228e-06,0.00213283068539318,0.000245745409667055
24.3,"greedy_SVM","SVM",2,40,9233,9233,0,4100,3559,541,0.999847353371292,0.971774193548387,5.83800350262697,336,141,195,-1,1.4,30.75,6.6,0,0,0,0,0,0,1.85656665456841e-06,0.00174354588085865,0.000200249956863992
24.3,"greedy_SVM","SVM",2,41,9133,9133,0,4200,3659,541,0.999848609722145,0.971774193548387,5.85338015803336,337,141,196,1,1.4,31.5,6.8,0,0,0,0,0,0,2.49039683020096e-06,0.00248306050057536,0.000263891188583396
24.3,"greedy_SVM","SVM",2,42,9033,9033,0,4300,3759,541,0.999844212494158,0.971774193548387,5.84312007011393,337,141,196,0,1.4,32.25,6.9,0,0,0,0,0,0,1.75383432317372e-06,0.0016981403244701,0.000188831186185192
24.3,"greedy_SVM","SVM",2,43,8933,8933,0,4400,3859,541,0.999842327967878,0.971774193548387,5.8585237258348,337,141,196,0,1.4,33,7.1,0,0,0,0,0,0,1.87472651520574e-06,0.00190686126646798,0.000199317138691657
24.3,"greedy_SVM","SVM",2,44,8833,8833,0,4500,3959,541,0.999842327967878,0.971774193548387,5.84824561403509,337,141,196,0,1.4,33.75,7.3,0,0,0,0,0,0,1.4182900208054e-06,0.00139873544457337,0.000150300097613168
24.3,"greedy_SVM","SVM",2,45,8733,8733,0,4600,4059,541,0.999842956143304,0.971774193548387,5.832895888014,338,142,196,1,1.4,34.5,7.5,0,0,0,0,0,0,1.19861372493581e-06,0.00118482204537479,0.000127200715352893
24.3,"greedy_SVM","SVM",2,46,8633,8633,0,4700,4159,541,0.999841699792451,0.971774193548387,5.83800350262697,337,141,196,-1,1.4,35.25,7.7,0,0,0,0,0,0,1.76706742336517e-06,0.0018283721217382,0.000185145171072383
24.3,"greedy_SVM","SVM",2,47,8533,8533,0,4800,4259,541,0.999841071617024,0.971774193548387,5.80243690165361,338,141,197,1,1.4,36,7.9,0,0,0,0,0,0,5.87665993738554e-07,0.000548673566657865,6.29188460931843e-05
24.3,"greedy_SVM","SVM",2,48,8433,8433,0,4900,4359,541,0.999842327967878,0.971774193548387,5.84312007011393,341,142,199,3,1.4,36.75,8.1,0,0,0,0,0,0,7.46044852876276e-07,0.000730348980646216,7.96963822553172e-05
24.3,"greedy_SVM","SVM",3,0,13233,12728,505,100,95,5,0.959547808054075,0.842293906810036,5.31253178058067,30,5,25,0,5,0.75,19,0,0,0,0,0,0,0.999993137490236,743.087079222836,99.9998100023469
24.3,"greedy_SVM","SVM",3,1,13133,12728,405,200,95,105,0.957830879134917,0.824372759856631,5.28710676507687,44,12,32,14,2.7,1.5,0.9,0,0,0,0,0,0,0.925647419352749,364.572958222203,95.8883917259754
24.3,"greedy_SVM","SVM",3,2,13033,12727,306,300,96,204,0.956496051063473,0.842293906810036,5.31254980266427,72,27,45,28,1.7,2.25,0.5,0,0,0,0,0,0,0.838681320356004,307.884970039797,92.4895546018123
24.3,"greedy_SVM","SVM",3,3,12933,12726,207,400,97,303,0.960160516021307,0.867383512544803,5.37084344249656,78,27,51,6,1.9,3,0.3,0,0,0,0,0,0,0.524410156515882,203.939106334424,80.8163792786216
24.3,"greedy_SVM","SVM",3,4,12833,12718,115,500,105,395,0.960244679203611,0.896057347670251,5.45336798410444,98,40,58,20,1.4,3.75,0.3,0,0,0,0,0,0,0.0190498631217726,42.0992716300224,37.4059135175102
24.3,"greedy_SVM","SVM",3,5,12733,12667,66,600,156,444,0.958550754887597,0.903225806451613,5.51773970727732,125,54,71,27,1.3,4.5,0.4,0,0,0,0,0,0,0.00898818393445516,17.7288182886648,5.26396755486433
24.3,"greedy_SVM","SVM",3,6,12633,12574,59,700,249,451,0.952220000314194,0.903225806451613,5.24547600314713,140,62,78,15,1.3,5.25,0.6,0,0,0,0,0,0,0.00486220946672928,9.59973330170445,0.86723436437222
24.3,"greedy_SVM","SVM",3,7,12533,12474,59,800,349,451,0.95268514216843,0.903225806451613,5.20917513115303,149,64,85,9,1.3,6,0.8,0,0,0,0,0,0,0.00296285429477342,5.0650372380414,0.361911940721586
24.3,"greedy_SVM","SVM",3,8,12433,12374,59,900,449,451,0.957529574942259,0.903225806451613,5.19836845138484,145,64,81,-4,1.3,6.75,1,0,0,0,0,0,0,0.00131331461446143,1.73734777350402,0.166644307111542
24.3,"greedy_SVM","SVM",3,9,12333,12274,59,1000,549,451,0.958078879978807,0.903225806451613,5.22790574186757,143,62,81,-2,1.3,7.5,1.2,0,0,0,0,0,0,0.000837159351186419,1.11110575108073,0.0971111352181461
24.3,"greedy_SVM","SVM",3,10,12233,12174,59,1100,649,451,0.960058398026762,0.903225806451613,5.24597974616097,144,64,80,1,1.2,8.25,1.4,0,0,0,0,0,0,0.00053544935861259,0.6457993857211,0.060361499737557
24.3,"greedy_SVM","SVM",3,11,12133,12074,59,1200,749,451,0.96153013154144,0.903225806451613,5.24597974616097,146,65,81,2,1.2,9,1.7,0,0,0,0,0,0,0.00053432481884616,0.654930423459656,0.05887862770671
24.3,"greedy_SVM","SVM",3,12,12033,11974,59,1300,849,451,0.963005792671293,0.903225806451613,5.23692714953257,143,63,80,-3,1.3,9.75,1.9,0,0,0,0,0,0,0.000358938611928398,0.42518171740163,0.0393746072874015
24.3,"greedy_SVM","SVM",3,13,11933,11875,58,1400,948,452,0.966268518705545,0.903225806451613,5.2872866732961,151,67,84,8,1.3,10.5,2.1,0,0,0,0,0,0,0.000663938916150032,0.884700722906867,0.0925737957487147
24.3,"greedy_SVM","SVM",3,14,11833,11781,52,1500,1042,458,0.96992737278455,0.906810035842294,5.37919905661841,164,71,93,13,1.3,11.25,2.3,0,0,0,0,0,0,0.00162565594327118,2.33946161368826,0.398577874309655
24.3,"greedy_SVM","SVM",3,15,11733,11691,42,1600,1132,468,0.967052919564659,0.917562724014337,5.36274373838515,184,82,102,20,1.2,12,2.4,0,0,0,0,0,0,0.00160207954099515,1.76340343296893,0.695391935710522
24.3,"greedy_SVM","SVM",3,16,11633,11603,30,1700,1220,480,0.964778269290723,0.921146953405018,5.35601285378816,216,96,120,32,1.2,12.75,2.5,0,0,0,0,0,0,0.0014639737568818,1.33518748773542,0.311895572459535
24.3,"greedy_SVM","SVM",3,17,11533,11504,29,1800,1319,481,0.964471354219237,0.921146953405018,5.34679424302432,221,98,123,5,1.3,13.5,2.7,0,0,0,0,0,0,0.00121601949429813,1.26022005997989,0.151436939346804
24.3,"greedy_SVM","SVM",3,18,11433,11405,28,1900,1418,482,0.966150690250298,0.924731182795699,5.38792342950913,224,99,125,3,1.3,14.25,2.9,0,0,0,0,0,0,0.00130154871262618,1.57449040487068,0.145891315241454
24.3,"greedy_SVM","SVM",3,19,11333,11305,28,2000,1518,482,0.96678303629339,0.924731182795699,5.39256419043032,221,98,123,-3,1.3,15,3.1,0,0,0,0,0,0,0.000954914504635344,1.2332991983025,0.104630110233624
24.3,"greedy_SVM","SVM",3,20,11233,11205,28,2100,1618,482,0.967102295298287,0.924731182795699,5.39256419043032,222,98,124,1,1.3,15.75,3.4,0,0,0,0,0,0,0.000780633427413973,1.05614507420894,0.0841265901908989
24.3,"greedy_SVM","SVM",3,21,11133,11105,28,2200,1718,482,0.967219001577758,0.924731182795699,5.39256419043032,225,100,125,3,1.2,16.5,3.6,0,0,0,0,0,0,0.000713287825914113,0.981694606012565,0.0769909419645855
24.3,"greedy_SVM","SVM",3,22,11033,11005,28,2300,1818,482,0.967491690288442,0.924731182795699,5.41314649650067,225,100,125,0,1.2,17.25,3.8,0,0,0,0,0,0,0.000510310274438355,0.750323776942286,0.0555289332414793
24.3,"greedy_SVM","SVM",3,23,10933,10905,28,2400,1918,482,0.967483273970208,0.924731182795699,5.41314649650067,226,100,126,1,1.3,18,4,0,0,0,0,0,0,0.000487073939449992,0.734270447110314,0.0512777470276929
24.3,"greedy_SVM","SVM",3,24,10833,10805,28,2500,2018,482,0.967726786111031,0.924731182795699,5.40383756013523,226,101,125,0,1.2,18.75,4.2,0,0,0,0,0,0,0.000320748803403111,0.471872291407918,0.0338402853450736
24.3,"greedy_SVM","SVM",3,25,10733,10705,28,2600,2118,482,0.967929899924342,0.924731182795699,5.42438447101027,225,101,124,-1,1.2,19.5,4.4,0,0,0,0,0,0,0.000582597365053437,1.04118968860249,0.0618110428153553
24.3,"greedy_SVM","SVM",3,26,10633,10605,28,2700,2218,482,0.968144796583177,0.924731182795699,5.42438447101027,226,101,125,1,1.2,20.25,4.6,0,0,0,0,0,0,0.00033909136174587,0.572784668969108,0.0359547186687314
24.3,"greedy_SVM","SVM",3,27,10533,10506,27,2800,2317,483,0.971225169055765,0.92831541218638,5.41507222299137,225,102,123,-1,1.2,21,4.8,0,0,0,0,0,0,0.000563037964641022,1.05892782671778,0.0625954709263899
24.3,"greedy_SVM","SVM",3,28,10433,10408,25,2900,2415,485,0.977114908553891,0.924731182795699,5.44493138188531,230,104,126,5,1.2,21.75,5,0,0,0,0,0,0,0.00106722354018543,1.7118940012113,0.127622273592278
24.3,"greedy_SVM","SVM",3,29,10333,10310,23,3000,2513,487,0.981613150104472,0.924731182795699,5.47316784540416,238,106,132,8,1.2,22.5,5.2,0,0,0,0,0,0,0.00197138242341077,2.81581900362978,0.226268244134222
24.3,"greedy_SVM","SVM",3,30,10233,10213,20,3100,2610,490,0.98695639000545,0.924731182795699,5.55433076251138,250,111,139,12,1.3,23.25,5.3,0,0,0,0,0,0,0.00348641882149152,4.35876026798204,0.420143445694
24.3,"greedy_SVM","SVM",3,31,10133,10118,15,3200,2705,495,0.990740366682145,0.924731182795699,5.65574807093331,265,114,151,15,1.3,24,5.5,0,0,0,0,0,0,0.00782934147987224,8.13643161819263,0.983528116671376
24.3,"greedy_SVM","SVM",3,32,10033,10020,13,3300,2803,497,0.993788757145449,0.92831541218638,5.76873983547282,264,116,148,-1,1.3,24.75,5.6,0,0,0,0,0,0,0.00630234473554253,6.79328421883102,0.78006931070254
24.3,"greedy_SVM","SVM",3,33,9933,9924,9,3400,2899,501,0.996249127508342,0.92831541218638,5.84735678913839,287,122,165,23,1.4,25.5,5.8,0,0,0,0,0,0,0.00713515485409467,7.65596174285262,0.917934608055635
24.3,"greedy_SVM","SVM",3,34,9833,9828,5,3500,2995,505,0.99755029030687,0.931899641577061,5.85252686587503,291,125,166,4,1.3,26.25,5.9,0,0,0,0,0,0,0.00693560096659133,7.49384436268239,0.926482798845854
24.3,"greedy_SVM","SVM",3,35,9733,9730,3,3600,3093,507,0.998149532164924,0.931899641577061,5.93664338038635,302,127,175,11,1.4,27,6.1,0,0,0,0,0,0,0.00647028905606411,7.54649516892618,0.779332737181194
24.3,"greedy_SVM","SVM",3,36,9633,9633,0,3700,3190,510,0.999219526756037,0.931899641577061,5.9579982126899,302,130,172,0,1.3,27.75,6.3,0,0,0,0,0,0,0.00533053738721944,6.42726785384675,0.668131833813287
24.3,"greedy_SVM","SVM",3,37,9533,9533,0,3800,3290,510,0.999232431777324,0.931899641577061,5.9579982126899,304,131,173,2,1.3,28.5,6.5,0,0,0,0,0,0,0.00405230693326562,4.90637451079961,0.431332552436221
24.3,"greedy_SVM","SVM",3,38,9433,9433,0,3900,3390,510,0.999234676128853,0.931899641577061,5.9579982126899,304,131,173,0,1.3,29.25,6.6,0,0,0,0,0,0,0.0038461228265663,4.92949293443702,0.410614826316626
24.3,"greedy_SVM","SVM",3,39,9333,9333,0,4000,3490,510,0.999246458974376,0.931899641577061,5.94206773618538,304,131,173,0,1.3,30,6.8,0,0,0,0,0,0,0.00308591420424502,3.85038806767404,0.324407801507219
24.3,"greedy_SVM","SVM",3,40,9233,9233,0,4100,3590,510,0.999252069853197,0.931899641577061,5.9686660698299,304,131,173,0,1.3,30.75,7,0,0,0,0,0,0,0.00289557417278272,3.73016630804675,0.304105300394526
24.3,"greedy_SVM","SVM",3,41,9133,9133,0,4200,3690,510,0.99926104725931,0.931899641577061,5.97401433691756,307,131,176,3,1.3,31.5,7.2,0,0,0,0,0,0,0.00308602058864857,4.33373695169145,0.324741747713541
24.3,"greedy_SVM","SVM",3,42,9033,9033,0,4300,3790,510,0.99927170792907,0.931899641577061,5.92095914742451,307,131,176,0,1.3,32.25,7.4,0,0,0,0,0,0,0.00232804799944787,3.09108981406097,0.243085026668256
24.3,"greedy_SVM","SVM",3,43,8933,8933,0,4400,3890,510,0.999282368598829,0.931899641577061,5.92622222222222,308,131,177,1,1.4,33,7.6,0,0,0,0,0,0,0.00215734031673909,3.01752812204122,0.226657367082364
24.3,"greedy_SVM","SVM",3,44,8833,8833,0,4500,3990,510,0.99929359035647,0.931899641577061,5.9104609929078,309,132,177,1,1.3,33.75,7.8,0,0,0,0,0,0,0.00163605305063372,2.15791545502888,0.170241036661559
24.3,"greedy_SVM","SVM",3,45,8733,8733,0,4600,4090,510,0.999302567762584,0.931899641577061,5.92095914742451,308,131,177,-1,1.4,34.5,8,0,0,0,0,0,0,0.00183769909199208,2.56350604155323,0.192249673784106
24.3,"greedy_SVM","SVM",3,46,8633,8633,0,4700,4190,510,0.999313228432343,0.931899641577061,5.92622222222222,312,131,181,4,1.4,35.25,8.2,0,0,0,0,0,0,0.00153132180778671,2.087559788224,0.158771757567477
24.3,"greedy_SVM","SVM",3,47,8533,8533,0,4800,4290,510,0.999322766926338,0.931899641577061,5.92095914742451,312,132,180,0,1.4,36,8.4,0,0,0,0,0,0,0.00128735318343303,1.74697899377373,0.134891787967156
24.3,"greedy_SVM","SVM",3,48,8433,8433,0,4900,4390,510,0.999328938893041,0.931899641577061,5.92622222222222,312,132,180,0,1.4,36.75,8.6,0,0,0,0,0,0,0.0014070279380396,1.96350473024153,0.14612853930817
24.3,"greedy_SVM","SVM",4,0,13233,12728,505,100,94,6,0.971594613493727,0.852517985611511,5.47142111485637,35,6,29,0,4.8,0.75,15.7,0,0,0,0,0,0,0.875501141926619,1022.68582891835,94.3625055975028
24.3,"greedy_SVM","SVM",4,1,13133,12728,405,200,94,106,0.974308923498221,0.834532374100719,5.53920863309353,53,19,34,18,1.8,1.5,0.9,0,0,0,0,0,0,0.946181035530511,607.850961509644,96.8119129574014
24.3,"greedy_SVM","SVM",4,2,13033,12728,305,300,94,206,0.977636923173926,0.830935251798561,5.65032402775742,62,24,38,9,1.6,2.25,0.5,0,0,0,0,0,0,0.935515135912223,515.986888792568,97.0387892032393
24.3,"greedy_SVM","SVM",4,3,12933,12728,205,400,94,306,0.974136076957789,0.834532374100719,5.56043165467626,75,32,43,13,1.3,3,0.3,0,0,0,0,0,0,0.515508824315925,418.534212706452,87.9341875884964
24.3,"greedy_SVM","SVM",4,4,12833,12717,116,500,105,395,0.949354837619977,0.884892086330935,5.46104122879984,98,42,56,23,1.3,3.75,0.3,0,0,0,0,0,0,0.132190484000283,215.133544538526,44.1020589637621
24.3,"greedy_SVM","SVM",4,5,12733,12673,60,600,149,451,0.95461567825096,0.89568345323741,5.41942318031696,140,66,74,42,1.1,4.5,0.3,0,0,0,0,0,0,0.084004840455972,111.221075376382,23.5148497034416
24.3,"greedy_SVM","SVM",4,6,12633,12588,45,700,234,466,0.979069241085485,0.902877697841727,5.48458242101971,159,71,88,19,1.2,5.25,0.5,0,0,0,0,0,0,0.081169673042807,114.699020982956,15.270968233536
24.3,"greedy_SVM","SVM",4,7,12533,12494,39,800,328,472,0.985237666808176,0.913669064748201,5.59858872483894,185,84,101,26,1.2,6,0.7,0,0,0,0,0,0,0.0385218987080895,81.9601713824061,5.5755998263678
24.3,"greedy_SVM","SVM",4,8,12433,12401,32,900,421,479,0.985214020050214,0.931654676258993,5.61684021204089,217,92,125,32,1.4,6.75,0.9,0,0,0,0,0,0,0.0178498580478865,27.4344243874498,3.52578989750348
24.3,"greedy_SVM","SVM",4,9,12333,12307,26,1000,515,485,0.984438744199526,0.935251798561151,5.57623761130955,245,97,148,28,1.5,7.5,1.1,0,0,0,0,0,0,0.0145492870670285,22.337043687203,1.89233076167372
24.3,"greedy_SVM","SVM",4,10,12233,12207,26,1100,615,485,0.984100933371338,0.935251798561151,5.54714419768533,245,99,146,0,1.5,8.25,1.3,0,0,0,0,0,0,0.010762709766052,17.2434687879668,1.23327528669291
24.3,"greedy_SVM","SVM",4,11,12133,12108,25,1200,714,486,0.989503654550148,0.931654676258993,5.6860244088194,247,100,147,2,1.5,9,1.5,0,0,0,0,0,0,0.00945761196286838,16.7950435919041,1.09494442882943
24.3,"greedy_SVM","SVM",4,12,12033,12011,22,1300,811,489,0.995164237994486,0.938848920863309,5.71894860091039,251,104,147,4,1.4,9.75,1.7,0,0,0,0,0,0,0.00998314076419999,21.0651257485424,2.6224154075365
24.3,"greedy_SVM","SVM",4,13,11933,11924,9,1400,898,502,0.997315529952006,0.946043165467626,5.82661617185125,273,118,155,22,1.3,10.5,1.8,0,0,0,0,0,0,0.0205178123106185,33.1976798748041,12.6094144800891
24.3,"greedy_SVM","SVM",4,14,11833,11833,0,1500,989,511,0.995786935954448,0.946043165467626,5.86793969080055,299,127,172,26,1.4,11.25,1.9,0,0,0,0,0,0,0.00891786534835045,14.6838506700462,1.26188525390296
24.3,"greedy_SVM","SVM",4,15,11733,11733,0,1600,1089,511,0.995884338076577,0.949640287769784,5.86793969080055,300,126,174,1,1.4,12,2.1,0,0,0,0,0,0,0.00749173949144312,13.7429033028015,0.810093665513555
24.3,"greedy_SVM","SVM",4,16,11633,11633,0,1700,1189,511,0.995961471549012,0.946043165467626,5.8731463808545,298,126,172,-2,1.4,12.75,2.3,0,0,0,0,0,0,0.00599260109415034,11.4656066229621,0.656662457552947
24.3,"greedy_SVM","SVM",4,17,11533,11533,0,1800,1289,511,0.996019462407852,0.946043165467626,5.86793969080055,298,126,172,0,1.4,13.5,2.5,0,0,0,0,0,0,0.00445794472065509,8.45170844893178,0.473074164117673
24.3,"greedy_SVM","SVM",4,18,11433,11433,0,1900,1389,511,0.996151208630847,0.946043165467626,5.8731463808545,298,125,173,0,1.4,14.25,2.7,0,0,0,0,0,0,0.00579193429271933,13.0439305968261,0.601133264054717
24.3,"greedy_SVM","SVM",4,19,11333,11333,0,2000,1489,511,0.996245232644693,0.946043165467626,5.86793969080055,299,126,173,1,1.4,15,2.9,0,0,0,0,0,0,0.00386737291649795,7.89095960610939,0.409075374037273
24.3,"greedy_SVM","SVM",4,20,11233,11233,0,2100,1589,511,0.996368533596983,0.946043165467626,5.86793969080055,304,128,176,5,1.4,15.75,3.1,0,0,0,0,0,0,0.00366445110916219,7.56392825933308,0.380618744248563
24.3,"greedy_SVM","SVM",4,21,11133,11133,0,2200,1689,511,0.996412449004648,0.946043165467626,5.85755395683453,304,128,176,0,1.4,16.5,3.3,0,0,0,0,0,0,0.00357620680597217,7.83426248402821,0.372001194863815
24.3,"greedy_SVM","SVM",4,22,11033,11033,0,2300,1789,511,0.996555455588582,0.946043165467626,5.86274222428966,306,129,177,2,1.4,17.25,3.5,0,0,0,0,0,0,0.00276422656076352,5.62265235154064,0.286250472220994
24.3,"greedy_SVM","SVM",4,23,10933,10933,0,2400,1889,511,0.996708596497362,0.946043165467626,5.86274222428966,305,129,176,-1,1.4,18,3.7,0,0,0,0,0,0,0.00282893692865955,5.88876429684204,0.294551374300381
24.3,"greedy_SVM","SVM",4,24,10833,10833,0,2500,1989,511,0.996700151226657,0.946043165467626,5.86274222428966,304,129,175,-1,1.4,18.75,3.9,0,0,0,0,0,0,0.00235582886478263,4.80828396595368,0.244917207348911
24.3,"greedy_SVM","SVM",4,25,10733,10733,0,2600,2089,511,0.996724361002678,0.946043165467626,5.86274222428966,306,130,176,2,1.4,19.5,4.1,0,0,0,0,0,0,0.0021512095104709,4.37621435307251,0.221965202487349
24.3,"greedy_SVM","SVM",4,26,10633,10633,0,2700,2189,511,0.996745755688463,0.946043165467626,5.85755395683453,307,131,176,1,1.3,20.25,4.3,0,0,0,0,0,0,0.00195861648649668,3.89076399988403,0.202159259757458
24.3,"greedy_SVM","SVM",4,27,10533,10533,0,2800,2289,511,0.996816132944338,0.946043165467626,5.86793969080055,305,131,174,-2,1.3,21,4.5,0,0,0,0,0,0,0.00218185675296658,4.5416721093985,0.22527238475091
24.3,"greedy_SVM","SVM",4,28,10433,10433,0,2900,2389,511,0.996892140380681,0.946043165467626,5.8731463808545,305,131,174,0,1.3,21.75,4.7,0,0,0,0,0,0,0.00196215534770016,4.01314367654456,0.203475496171208
24.3,"greedy_SVM","SVM",4,29,10333,10333,0,3000,2489,511,0.996909593940137,0.946043165467626,5.8731463808545,305,131,174,0,1.3,22.5,4.9,0,0,0,0,0,0,0.00171245473734765,3.4534298753952,0.175761292372968
24.3,"greedy_SVM","SVM",4,30,10233,10233,0,3100,2589,511,0.996950131239521,0.946043165467626,5.8731463808545,305,131,174,0,1.3,23.25,5.1,0,0,0,0,0,0,0.00169146283310113,3.39273428759771,0.173477562602629
24.3,"greedy_SVM","SVM",4,31,10133,10133,0,3200,2689,511,0.996980534214058,0.946043165467626,5.86793969080055,305,131,174,0,1.3,24,5.3,0,0,0,0,0,0,0.00139453049843426,2.72509517465156,0.143388024347609
24.3,"greedy_SVM","SVM",4,32,10033,10033,0,3300,2789,511,0.997030079802191,0.946043165467626,5.8731463808545,306,131,175,1,1.3,24.75,5.5,0,0,0,0,0,0,0.0014249550737492,2.83152599144516,0.147093149483346
24.3,"greedy_SVM","SVM",4,33,9933,9933,0,3400,2889,511,0.997030642820238,0.946043165467626,5.86274222428966,306,130,176,0,1.4,25.5,5.7,0,0,0,0,0,0,0.00119757510221312,2.26578872921083,0.123905942184878
24.3,"greedy_SVM","SVM",4,34,9833,9833,0,3500,2989,511,0.99706554993915,0.946043165467626,5.8731463808545,307,130,177,1,1.4,26.25,5.8,0,0,0,0,0,0,0.0013306403558934,2.62791897797666,0.136597261408084
24.3,"greedy_SVM","SVM",4,35,9733,9733,0,3600,3089,511,0.997127481924316,0.946043165467626,5.8731463808545,303,128,175,-4,1.4,27,6,0,0,0,0,0,0,0.00122557501709617,2.41784422867032,0.126413416753091
24.3,"greedy_SVM","SVM",4,36,9633,9633,0,3700,3189,511,0.997184909765106,0.946043165467626,5.84720492157511,303,128,175,0,1.4,27.75,6.2,0,0,0,0,0,0,0.000936701992739328,1.74560034346489,0.0964299234559815
24.3,"greedy_SVM","SVM",4,37,9533,9533,0,3800,3289,511,0.997190539945576,0.946043165467626,5.8523748640345,303,128,175,0,1.4,28.5,6.4,0,0,0,0,0,0,0.000801789637144344,1.50553080030446,0.0826365068725384
24.3,"greedy_SVM","SVM",4,38,9433,9433,0,3900,3389,511,0.997228825172769,0.946043165467626,5.8731463808545,303,128,175,0,1.4,29.25,6.6,0,0,0,0,0,0,0.00105013003580347,2.08152606237391,0.107754920094289
24.3,"greedy_SVM","SVM",4,39,9333,9333,0,4000,3489,511,0.997198422198233,0.946043165467626,5.8731463808545,303,128,175,0,1.4,30,6.8,0,0,0,0,0,0,0.000880240395526386,1.66891250015335,0.0898260086400375
24.3,"greedy_SVM","SVM",4,40,9233,9233,0,4100,3589,511,0.99725472400293,0.946043165467626,5.8731463808545,306,128,178,3,1.4,30.75,7,0,0,0,0,0,0,0.00101968610024983,2.00707248921811,0.10515635446913
24.3,"greedy_SVM","SVM",4,41,9133,9133,0,4200,3689,511,0.99724177458785,0.946043165467626,5.8731463808545,306,128,178,0,1.4,31.5,7.2,0,0,0,0,0,0,0.000886036199974252,1.70062374025141,0.0907487528782383
24.3,"greedy_SVM","SVM",4,42,9033,9033,0,4300,3789,511,0.997214186703548,0.946043165467626,5.8731463808545,305,129,176,-1,1.4,32.25,7.4,0,0,0,0,0,0,0.000766647120510792,1.43218891758679,0.0784100570595256
24.3,"greedy_SVM","SVM",4,43,8933,8933,0,4400,3889,511,0.997244026660038,0.946043165467626,5.86793969080055,304,129,175,-1,1.4,33,7.6,0,0,0,0,0,0,0.000695378742876808,1.28224498570182,0.0716025680485262
24.3,"greedy_SVM","SVM",4,44,8833,8833,0,4500,3989,511,0.997215875757689,0.946043165467626,5.8731463808545,305,129,176,1,1.4,33.75,7.8,0,0,0,0,0,0,0.000701177426311077,1.31632256390605,0.0721265157379002
24.3,"greedy_SVM","SVM",4,45,8733,8733,0,4600,4089,511,0.997247967786366,0.946043165467626,5.8731463808545,305,129,176,0,1.4,34.5,8,0,0,0,0,0,0,0.000721453256467992,1.37677661767973,0.0745030054679604
24.3,"greedy_SVM","SVM",4,46,8633,8633,0,4700,4189,511,0.997246278732225,0.946043165467626,5.8731463808545,305,129,176,0,1.4,35.25,8.2,0,0,0,0,0,0,0.000659269385319114,1.2405296837364,0.0675476547112985
24.3,"greedy_SVM","SVM",4,47,8533,8533,0,4800,4289,511,0.997254160984883,0.946043165467626,5.85755395683453,305,129,176,0,1.4,36,8.4,0,0,0,0,0,0,0.000486675439176006,0.874832488046412,0.0500400888654892
24.3,"greedy_SVM","SVM",4,48,8433,8433,0,4900,4389,511,0.997274992652621,0.946043165467626,5.8523748640345,305,129,176,0,1.4,36.75,8.6,0,0,0,0,0,0,0.000462154324017368,0.823687264447416,0.047372108607885
24.3,"greedy_SVM","SVM",5,0,13233,12704,529,100,95,5,0.943628368377862,0.768627450980392,5.06323235378127,24,5,19,0,3.8,0.75,19,0,0,0,0,0,0,0.999994655338299,549.267941212629,99.9998484648429
24.3,"greedy_SVM","SVM",5,1,13133,12704,429,200,95,105,0.959035142441222,0.752941176470588,5.1525193209814,35,14,21,11,1.5,1.5,0.9,0,0,0,0,0,0,0.892457622011474,328.92078219696,94.795666070192
24.3,"greedy_SVM","SVM",5,2,13033,12704,329,300,95,205,0.960776362946899,0.752941176470588,5.2972242114237,53,18,35,18,1.9,2.25,0.5,0,0,0,0,0,0,0.830715529259667,264.945717512049,93.6820590064617
24.3,"greedy_SVM","SVM",5,3,12933,12704,229,400,95,305,0.960074248039813,0.768627450980392,5.27468790136142,64,22,42,11,1.9,3,0.3,0,0,0,0,0,0,0.680468584877785,244.136118963573,90.2683390824403
24.3,"greedy_SVM","SVM",5,4,12833,12695,138,500,104,396,0.963342018029887,0.815686274509804,5.33010786036735,88,35,53,24,1.5,3.75,0.3,0,0,0,0,0,0,0.118089769864067,79.2816478483281,47.6154624644053
24.3,"greedy_SVM","SVM",5,5,12733,12654,79,600,145,455,0.948329724903011,0.882352941176471,5.18823869235736,120,54,66,32,1.2,4.5,0.3,0,0,0,0,0,0,0.0184119394810077,24.8031777717318,19.3264177322703
24.3,"greedy_SVM","SVM",5,6,12633,12576,57,700,223,477,0.935628661945107,0.882352941176471,5.10699408544749,138,58,80,18,1.4,5.25,0.5,0,0,0,0,0,0,0.0110264439903028,18.3911020893174,2.90315397974422
24.3,"greedy_SVM","SVM",5,7,12533,12477,56,800,322,478,0.936151578535311,0.882352941176471,5.09320091673033,147,63,84,9,1.3,6,0.7,0,0,0,0,0,0,0.0041706476559958,6.81291066474943,0.469507242667123
24.3,"greedy_SVM","SVM",5,8,12433,12377,56,900,422,478,0.952985211551834,0.882352941176471,5.12516170544211,147,65,82,0,1.3,6.75,0.9,0,0,0,0,0,0,0.0045956701847104,5.85773806816965,0.802481412821944
24.3,"greedy_SVM","SVM",5,9,12333,12277,56,1000,522,478,0.951573642557422,0.882352941176471,5.11632521974307,152,66,86,5,1.3,7.5,1.1,0,0,0,0,0,0,0.0019942557437228,2.73040545110218,0.245158799835737
24.3,"greedy_SVM","SVM",5,10,12233,12177,56,1100,622,478,0.953103861631947,0.882352941176471,5.09436674240512,146,63,83,-6,1.3,8.25,1.3,0,0,0,0,0,0,0.00134929953313177,1.62598295118495,0.159966580037758
24.3,"greedy_SVM","SVM",5,11,12133,12077,56,1200,722,478,0.953892211906558,0.882352941176471,5.09436674240512,148,64,84,2,1.3,9,1.5,0,0,0,0,0,0,0.000783464153036817,1.04415226748947,0.0884181612857028
24.3,"greedy_SVM","SVM",5,12,12033,11977,56,1300,822,478,0.954673223000956,0.882352941176471,5.1124205428312,149,66,83,1,1.3,9.75,1.7,0,0,0,0,0,0,0.000662826330548823,0.907022941937023,0.0731614899918369
24.3,"greedy_SVM","SVM",5,13,11933,11877,56,1400,922,478,0.955415703399237,0.882352941176471,5.10803971974394,149,68,81,0,1.2,10.5,1.9,0,0,0,0,0,0,0.000538284454575674,0.707673689532127,0.0583242295106725
24.3,"greedy_SVM","SVM",5,14,11833,11777,56,1500,1022,478,0.955393685858599,0.882352941176471,5.09930055854677,147,66,81,-2,1.2,11.25,2.1,0,0,0,0,0,0,0.000374258449448023,0.494601406162685,0.0405953720375817
24.3,"greedy_SVM","SVM",5,15,11733,11677,56,1600,1122,478,0.955908040071897,0.882352941176471,5.09930055854677,147,66,81,0,1.2,12,2.3,0,0,0,0,0,0,0.000319373551116005,0.442316821633813,0.0350473582891353
24.3,"greedy_SVM","SVM",5,16,11633,11579,54,1700,1220,480,0.964308955023026,0.886274509803922,5.24695792553728,154,69,85,7,1.2,12.75,2.5,0,0,0,0,0,0,0.000526284677452535,0.847860177209797,0.113843632905753
24.3,"greedy_SVM","SVM",5,17,11533,11487,46,1800,1312,488,0.973448069183983,0.898039215686275,5.40391820536105,174,77,97,20,1.3,13.5,2.7,0,0,0,0,0,0,0.00150229507485136,2.19313806024891,0.25806075441625
24.3,"greedy_SVM","SVM",5,18,11433,11397,36,1900,1402,498,0.976388022457847,0.925490196078431,5.51374582676632,202,89,113,28,1.3,14.25,2.8,0,0,0,0,0,0,0.00302620933337858,3.54466369081679,0.4888854941716
24.3,"greedy_SVM","SVM",5,19,11333,11299,34,2000,1500,500,0.975913422137329,0.925490196078431,5.49114850780416,205,90,115,3,1.3,15,3,0,0,0,0,0,0,0.00248114087536812,3.29554641732192,0.33832762925828
24.3,"greedy_SVM","SVM",5,20,11233,11199,34,2100,1600,500,0.975375827186687,0.925490196078431,5.48640658335873,206,89,117,1,1.3,15.75,3.2,0,0,0,0,0,0,0.00196488823925085,3.19642277600185,0.224431661898255
24.3,"greedy_SVM","SVM",5,21,11133,11099,34,2200,1700,500,0.975487138086595,0.925490196078431,5.48640658335873,206,91,115,0,1.3,16.5,3.4,0,0,0,0,0,0,0.00175002258334644,3.15040477152739,0.188895625072567
24.3,"greedy_SVM","SVM",5,22,11033,10999,34,2300,1800,500,0.975298154196096,0.925490196078431,5.48640658335873,206,90,116,0,1.3,17.25,3.6,0,0,0,0,0,0,0.00156212841976682,3.02179084709738,0.165029261808255
24.3,"greedy_SVM","SVM",5,23,10933,10899,34,2400,1900,500,0.975514048414049,0.925490196078431,5.48640658335873,205,89,116,-1,1.3,18,3.8,0,0,0,0,0,0,0.000864414426830501,1.58223723986955,0.0930653209210639
24.3,"greedy_SVM","SVM",5,24,10833,10800,33,2500,1999,501,0.977021026751238,0.925490196078431,5.45344105023984,207,91,116,2,1.3,18.75,4,0,0,0,0,0,0,0.00178208954296399,3.21992916434991,0.199069034707907
24.3,"greedy_SVM","SVM",5,25,10733,10701,32,2600,2098,502,0.979997675926204,0.92156862745098,5.47222982216142,214,93,121,7,1.3,19.5,4.2,0,0,0,0,0,0,0.00182259806648017,3.34595875455125,0.210156747645538
24.3,"greedy_SVM","SVM",5,26,10633,10603,30,2700,2196,504,0.984207307377027,0.92156862745098,5.53634314572847,220,94,126,6,1.3,20.25,4.4,0,0,0,0,0,0,0.00211205466549919,3.58171217251018,0.242955921960471
24.3,"greedy_SVM","SVM",5,27,10533,10508,25,2800,2291,509,0.991457805829702,0.917647058823529,5.69858283330769,230,99,131,10,1.3,21,4.5,0,0,0,0,0,0,0.00610990213284536,8.77862852054789,0.80305103552748
24.3,"greedy_SVM","SVM",5,28,10433,10415,18,2900,2384,516,0.995482122980181,0.92156862745098,5.80747129404879,254,107,147,24,1.4,21.75,4.6,0,0,0,0,0,0,0.0108674776906865,13.1391999285606,1.57111895805063
24.3,"greedy_SVM","SVM",5,29,10333,10321,12,3000,2478,522,0.997008672464621,0.929411764705882,5.83042572604108,271,115,156,17,1.4,22.5,4.7,0,0,0,0,0,0,0.0110827605079877,14.4772815916425,1.33158858712444
24.3,"greedy_SVM","SVM",5,30,10233,10227,6,3100,2572,528,0.999023889031595,0.937254901960784,5.9052258635961,286,120,166,15,1.4,23.25,4.9,0,0,0,0,0,0,0.0134936143740876,19.1455451704658,1.93226724086022
24.3,"greedy_SVM","SVM",5,31,10133,10132,1,3200,2667,533,0.999352928944504,0.937254901960784,5.9104609929078,300,126,174,14,1.4,24,5,0,0,0,0,0,0,0.0100430299252235,11.9293371725315,1.26790141743451
24.3,"greedy_SVM","SVM",5,32,10033,10033,0,3300,2766,534,0.999384732058762,0.937254901960784,5.9104609929078,306,127,179,6,1.4,24.75,5.2,0,0,0,0,0,0,0.00768643080701075,9.64451518956285,0.859834550000638
24.3,"greedy_SVM","SVM",5,33,9933,9933,0,3400,2866,534,0.999396352427434,0.937254901960784,5.9104609929078,307,127,180,1,1.4,25.5,5.4,0,0,0,0,0,0,0.00551807701228078,7.05131630351555,0.598293875882904
24.3,"greedy_SVM","SVM",5,34,9833,9833,0,3500,2966,534,0.999400633615892,0.937254901960784,5.9104609929078,308,128,180,1,1.4,26.25,5.6,0,0,0,0,0,0,0.00608537154204878,8.6634256947675,0.639937897243384
24.3,"greedy_SVM","SVM",5,35,9733,9733,0,3600,3066,534,0.999416535173021,0.937254901960784,5.9104609929078,309,128,181,1,1.4,27,5.7,0,0,0,0,0,0,0.00437709613172517,5.99115979539723,0.461075977680627
24.3,"greedy_SVM","SVM",5,36,9633,9633,0,3700,3166,534,0.999423874353235,0.937254901960784,5.9104609929078,309,128,181,0,1.4,27.75,5.9,0,0,0,0,0,0,0.00379447340474441,5.27986349254647,0.400479665679311
24.3,"greedy_SVM","SVM",5,37,9533,9533,0,3800,3266,534,0.999428155541693,0.937254901960784,5.87400881057269,311,128,183,2,1.4,28.5,6.1,0,0,0,0,0,0,0.00302590389328346,4.07109101306568,0.318399164054172
24.3,"greedy_SVM","SVM",5,38,9433,9433,0,3900,3366,534,0.999438552713662,0.937254901960784,5.87400881057269,312,128,184,1,1.4,29.25,6.3,0,0,0,0,0,0,0.00268980270891391,3.71858687753022,0.281212263559603
24.3,"greedy_SVM","SVM",5,39,9333,9333,0,4000,3466,534,0.999444668697173,0.937254901960784,5.87400881057269,311,128,183,-1,1.4,30,6.5,0,0,0,0,0,0,0.00267534961911073,3.91497975352965,0.280955484419253
24.3,"greedy_SVM","SVM",5,40,9233,9233,0,4100,3566,534,0.999452007877387,0.937254901960784,5.86883802816901,313,128,185,2,1.4,30.75,6.7,0,0,0,0,0,0,0.00252427341306639,3.76378257160708,0.264912622726383
24.3,"greedy_SVM","SVM",5,41,9133,9133,0,4200,3666,534,0.999456289065845,0.937254901960784,5.86883802816901,312,128,184,-1,1.4,31.5,6.9,0,0,0,0,0,0,0.00178335682647175,2.52924943794317,0.186122173643445
24.3,"greedy_SVM","SVM",5,42,9033,9033,0,4300,3766,534,0.999460876053478,0.937254901960784,5.86883802816901,311,128,183,-1,1.4,32.25,7.1,0,0,0,0,0,0,0.00197861230622733,3.02459539573213,0.20757771785957
24.3,"greedy_SVM","SVM",5,43,8933,8933,0,4400,3866,534,0.999469132631219,0.937254901960784,5.8636763412489,312,128,184,1,1.4,33,7.2,0,0,0,0,0,0,0.00142067444014864,2.08534380244981,0.150222442906812
24.3,"greedy_SVM","SVM",5,44,8833,8833,0,4500,3966,534,0.999477083409783,0.937254901960784,5.87400881057269,311,128,183,-1,1.4,33.75,7.4,0,0,0,0,0,0,0.00153823893639823,2.4102753494583,0.161093277006107
24.3,"greedy_SVM","SVM",5,45,8733,8733,0,4600,4066,534,0.999483199393295,0.937254901960784,5.87400881057269,312,128,184,1,1.4,34.5,7.6,0,0,0,0,0,0,0.00136317133707786,2.11698575880029,0.141351751141119
24.3,"greedy_SVM","SVM",5,46,8633,8633,0,4700,4166,534,0.999483810991646,0.937254901960784,5.87400881057269,312,128,184,0,1.4,35.25,7.8,0,0,0,0,0,0,0.00107924912782625,1.61569655478111,0.112227062045587
24.3,"greedy_SVM","SVM",5,47,8533,8533,0,4800,4266,534,0.999488092180104,0.937254901960784,5.87918871252205,311,128,183,-1,1.4,36,8,0,0,0,0,0,0,0.00127224603404699,2.01335082051885,0.13168114210345
24.3,"greedy_SVM","SVM",5,48,8433,8433,0,4900,4366,534,0.999493596565264,0.937254901960784,5.88957597173145,311,128,183,0,1.4,36.75,8.2,0,0,0,0,0,0,0.000995447463108468,1.50076658293249,0.102813590870264
24.3,"greedy_SVM","SVM",6,0,13233,12708,525,100,95,5,0.964503227143696,0.810810810810811,5.55470432838854,32,5,27,0,5.4,0.75,19,0,0,0,0,0,0,0.836701931607497,776.217736236457,87.9476444310664
24.3,"greedy_SVM","SVM",6,1,13133,12708,425,200,95,105,0.973743607170536,0.841698841698842,5.54983605115069,57,21,36,25,1.7,1.5,0.9,0,0,0,0,0,0,0.967664960278252,537.371794167269,97.9965249869346
24.3,"greedy_SVM","SVM",6,2,13033,12708,325,300,95,205,0.973744209699241,0.868725868725869,5.52727574199967,62,22,40,5,1.8,2.25,0.5,0,0,0,0,0,0,0.954522817269212,464.790207710859,97.8806516376247
24.3,"greedy_SVM","SVM",6,3,12933,12708,225,400,95,305,0.973341118004033,0.888030888030888,5.4157047585619,76,32,44,14,1.4,3,0.3,0,0,0,0,0,0,0.8726246453812,302.990748645327,95.9612925684272
24.3,"greedy_SVM","SVM",6,4,12833,12705,128,500,98,402,0.980408779566066,0.903474903474903,5.54808398525676,89,36,53,13,1.5,3.75,0.2,0,0,0,0,0,0,0.260583990980097,119.926920678008,66.0545509226423
24.3,"greedy_SVM","SVM",6,5,12733,12657,76,600,146,454,0.972684964258009,0.922779922779923,5.5644665504068,127,56,71,38,1.3,4.5,0.3,0,0,0,0,0,0,0.0104047479065468,10.7026395896582,8.05098219186769
24.3,"greedy_SVM","SVM",6,6,12633,12567,66,700,236,464,0.95510498459938,0.922779922779923,5.3173498229678,141,65,76,14,1.2,5.25,0.5,0,0,0,0,0,0,0.00597966807304743,5.81660737107364,0.889105492130652
24.3,"greedy_SVM","SVM",6,7,12533,12467,66,800,336,464,0.956628177133803,0.922779922779923,5.21370656370656,147,68,79,6,1.2,6,0.7,0,0,0,0,0,0,0.00347314306367466,1.33277176619602,0.454436157697639
24.3,"greedy_SVM","SVM",6,8,12433,12367,66,900,436,464,0.960184301476467,0.922779922779923,5.20048499169378,149,63,86,2,1.4,6.75,0.9,0,0,0,0,0,0,8.97106491807169e-06,0.0253823913599411,0.0202675401264212
24.3,"greedy_SVM","SVM",6,9,12333,12267,66,1000,536,464,0.962476320622422,0.922779922779923,5.23996188118326,146,64,82,-3,1.3,7.5,1.2,0,0,0,0,0,0,5.7093628682298e-06,0.00372245568625691,0.000740190534034135
24.3,"greedy_SVM","SVM",6,10,12233,12167,66,1100,636,464,0.964915959298021,0.922779922779923,5.27970754949478,149,66,83,3,1.3,8.25,1.4,0,0,0,0,0,0,2.08856393931891e-06,0.00125214913210374,0.000270756906595324
24.3,"greedy_SVM","SVM",6,11,12133,12067,66,1200,736,464,0.966225254146641,0.922779922779923,5.29774241729835,148,67,81,-1,1.2,9,1.6,0,0,0,0,0,0,1.73741243280199e-06,0.00108331502216767,0.000214720221068337
24.3,"greedy_SVM","SVM",6,12,12033,11967,66,1300,836,464,0.967868349890841,0.922779922779923,5.34337327360583,148,66,82,0,1.2,9.75,1.8,0,0,0,0,0,0,6.72242969670993e-07,0.000383619027213596,8.16272764126719e-05
24.3,"greedy_SVM","SVM",6,13,11933,11867,66,1400,936,464,0.968987245672649,0.922779922779923,5.35259393499256,148,66,82,0,1.2,10.5,2,0,0,0,0,0,0,5.31475760334196e-07,0.00032481779866177,6.66150626996313e-05
24.3,"greedy_SVM","SVM",6,14,11833,11767,66,1500,1036,464,0.969927792961508,0.922779922779923,5.38409479982514,152,68,84,4,1.2,11.25,2.2,0,0,0,0,0,0,2.68120618511471e-07,0.000152089840863265,3.22122480974791e-05
24.3,"greedy_SVM","SVM",6,15,11733,11667,66,1600,1136,464,0.970093488351923,0.922779922779923,5.38409479982514,154,68,86,2,1.3,12,2.4,0,0,0,0,0,0,1.39828581076835e-07,8.30357874912131e-05,1.68472200400637e-05
24.3,"greedy_SVM","SVM",6,16,11633,11570,63,1700,1233,467,0.977432890354245,0.926640926640927,5.51599558742416,160,72,88,6,1.2,12.75,2.6,0,0,0,0,0,0,4.01332073936064e-06,0.111749902141491,0.10994077934438
24.3,"greedy_SVM","SVM",6,17,11533,11482,51,1800,1321,479,0.985324208638796,0.945945945945946,5.71014035965234,198,90,108,38,1.2,13.5,2.8,0,0,0,0,0,0,0.00699226895578565,3.43433674071645,1.15255967810618
24.3,"greedy_SVM","SVM",6,18,11433,11399,34,1900,1404,496,0.99149892267868,0.961389961389961,5.73534511955565,235,108,127,37,1.2,14.25,2.8,0,0,0,0,0,0,0.00844725648875226,4.81466994507789,2.32935864204769
24.3,"greedy_SVM","SVM",6,19,11333,11309,24,2000,1494,506,0.994941771627141,0.961389961389961,5.81917974205208,255,118,137,20,1.2,15,3,0,0,0,0,0,0,0.00855569443513228,3.9288804790272,1.24234279116523
24.3,"greedy_SVM","SVM",6,20,11233,11214,19,2100,1589,511,0.997736902231285,0.961389961389961,5.89093265762901,271,122,149,16,1.2,15.75,3.1,0,0,0,0,0,0,0.00934330168384687,6.25240420737289,1.31437000483802
24.3,"greedy_SVM","SVM",6,21,11133,11124,9,2200,1679,521,0.999470979808058,0.961389961389961,6.02258355916892,301,133,168,30,1.3,16.5,3.2,0,0,0,0,0,0,0.0149852746062681,10.9648899318905,2.38537302555152
24.3,"greedy_SVM","SVM",6,22,11033,11033,0,2300,1770,530,0.999862623458129,0.965250965250965,5.95267857142857,325,143,182,24,1.3,17.25,3.3,0,0,0,0,0,0,0.0140532802548144,11.2633147221736,2.0417699712628
24.3,"greedy_SVM","SVM",6,23,10933,10933,0,2400,1870,530,0.999871058859823,0.969111969111969,5.94736842105263,325,143,182,0,1.3,18,3.5,0,0,0,0,0,0,0.0110479021042145,10.1426909062494,1.25923345024903
24.3,"greedy_SVM","SVM",6,24,10833,10833,0,2500,1970,530,0.999874071503285,0.969111969111969,5.94736842105263,328,143,185,3,1.3,18.75,3.7,0,0,0,0,0,0,0.00788072716894765,6.20808818952171,0.859564980274517
24.3,"greedy_SVM","SVM",6,25,10733,10733,0,2600,2070,530,0.999875879089362,0.969111969111969,5.94206773618538,328,143,185,0,1.3,19.5,3.9,0,0,0,0,0,0,0.00592880642062076,4.05474323531321,0.641471196162238
24.3,"greedy_SVM","SVM",6,26,10633,10633,0,2700,2170,530,0.999878891732824,0.969111969111969,5.93677649154052,324,142,182,-4,1.3,20.25,4.1,0,0,0,0,0,0,0.00461542108957418,2.56435896534306,0.488428988621128
24.3,"greedy_SVM","SVM",6,27,10533,10533,0,2800,2270,530,0.999883711962364,0.969111969111969,5.96332737030411,325,142,183,1,1.3,21,4.3,0,0,0,0,0,0,0.00469893366080636,2.9244803291078,0.497591508957335
24.3,"greedy_SVM","SVM",6,28,10433,10433,0,2900,2370,530,0.999886122077133,0.969111969111969,5.9579982126899,326,143,183,1,1.3,21.75,4.5,0,0,0,0,0,0,0.00344111515508383,1.32654526551865,0.361792754102458
24.3,"greedy_SVM","SVM",6,29,10333,10333,0,3000,2470,530,0.999889134720595,0.969111969111969,5.91570541259982,325,143,182,-1,1.3,22.5,4.7,0,0,0,0,0,0,0.0029019706241786,0.717222437922344,0.307265819575042
24.3,"greedy_SVM","SVM",6,30,10233,10233,0,3100,2570,530,0.999893352421442,0.969111969111969,5.93149466192171,325,143,182,0,1.3,23.25,4.8,0,0,0,0,0,0,0.00352487553223245,1.58018077431067,0.370801242140829
24.3,"greedy_SVM","SVM",6,31,10133,10133,0,3200,2670,530,0.999894557478827,0.969111969111969,5.84824561403509,326,143,183,1,1.3,24,5,0,0,0,0,0,0,1.22323154517574e-05,0.00862578777137515,0.00134411027303219
24.3,"greedy_SVM","SVM",6,32,10033,10033,0,3300,2770,530,0.99989516000752,0.969111969111969,5.84824561403509,328,144,184,2,1.3,24.75,5.2,0,0,0,0,0,0,1.05823160233135e-05,0.00780555693224788,0.00119231521241409
24.3,"greedy_SVM","SVM",6,33,9933,9933,0,3400,2870,530,0.999898775179674,0.969111969111969,5.80749128919861,329,145,184,1,1.3,25.5,5.4,0,0,0,0,0,0,6.90441523406801e-06,0.00509317481513896,0.000767274220374434
24.3,"greedy_SVM","SVM",6,34,9833,9833,0,3500,2970,530,0.999901185294444,0.969111969111969,5.9104609929078,330,145,185,1,1.3,26.25,5.6,0,0,0,0,0,0,1.00862118038049e-05,0.00824296516919368,0.00111475993190994
24.3,"greedy_SVM","SVM",6,35,9733,9733,0,3600,3070,530,0.999902992880521,0.972972972972973,5.75237273511648,332,145,187,2,1.3,27,5.8,0,0,0,0,0,0,3.10691719131831e-06,0.00239943419147199,0.000346115781611496
24.3,"greedy_SVM","SVM",6,36,9633,9633,0,3700,3170,530,0.999903595409213,0.972972972972973,5.85338015803336,331,145,186,-1,1.3,27.75,6,0,0,0,0,0,0,0.00114165637259646,1.6987429780678,0.118056887695688
24.3,"greedy_SVM","SVM",6,37,9533,9533,0,3800,3270,530,0.999904800466598,0.972972972972973,5.8585237258348,329,145,184,-2,1.3,28.5,6.2,0,0,0,0,0,0,0.00106726740260389,1.61979976550448,0.111064197461457
24.3,"greedy_SVM","SVM",6,38,9433,9433,0,3900,3370,530,0.999906608052675,0.972972972972973,5.70316509837468,326,145,181,-3,1.2,29.25,6.4,0,0,0,0,0,0,0.000738387914572958,1.04702622300071,0.0767204389748075
24.3,"greedy_SVM","SVM",6,39,9333,9333,0,4000,3470,530,0.99990781311006,0.972972972972973,5.77229437229437,327,145,182,1,1.3,30,6.5,0,0,0,0,0,0,0.00077068664729395,1.12517159909489,0.0799189943774787
24.3,"greedy_SVM","SVM",6,40,9233,9233,0,4100,3570,530,0.999909018167445,0.972972972972973,5.79235447437011,327,145,182,0,1.3,30.75,6.7,0,0,0,0,0,0,0.000695375054298311,1.03356110260303,0.0722865223788389
24.3,"greedy_SVM","SVM",6,41,9133,9133,0,4200,3670,530,0.999910825753522,0.972972972972973,5.84312007011393,326,145,181,-1,1.2,31.5,6.9,0,0,0,0,0,0,0.000705697520686809,1.0873662350049,0.0739946115270353
24.3,"greedy_SVM","SVM",6,42,9033,9033,0,4300,3770,530,0.999913235868292,0.972972972972973,5.84312007011393,328,145,183,2,1.3,32.25,7.1,0,0,0,0,0,0,0.000646367329293991,0.993094069639056,0.0666981544742539
24.3,"greedy_SVM","SVM",6,43,8933,8933,0,4400,3870,530,0.999914440925677,0.972972972972973,5.76231633535004,329,145,184,1,1.3,33,7.3,0,0,0,0,0,0,0.000503366458693649,0.740268848975856,0.0518812163715999
24.3,"greedy_SVM","SVM",6,44,8833,8833,0,4500,3970,530,0.999914440925677,0.972972972972973,5.72274678111588,326,145,181,-3,1.2,33.75,7.5,0,0,0,0,0,0,0.000402312350535096,0.577214162588537,0.0413539432683374
24.3,"greedy_SVM","SVM",6,45,8733,8733,0,4600,4070,530,0.999914440925677,0.972972972972973,5.78732638888889,328,145,183,2,1.3,34.5,7.7,0,0,0,0,0,0,0.000484933841452938,0.720774701337197,0.0503157963031522
24.3,"greedy_SVM","SVM",6,46,8633,8633,0,4700,4170,530,0.999913838396984,0.972972972972973,5.78230702515178,327,145,182,-1,1.3,35.25,7.9,0,0,0,0,0,0,0.000409795646573044,0.609348527156965,0.0425907454885546
24.3,"greedy_SVM","SVM",6,47,8533,8533,0,4800,4270,530,0.999915043454369,0.972972972972973,5.84312007011393,327,145,182,0,1.3,36,8.1,0,0,0,0,0,0,0.000482930433125498,0.742134627922968,0.0500378410874058
24.3,"greedy_SVM","SVM",6,48,8433,8433,0,4900,4370,530,0.999915645983062,0.972972972972973,5.83800350262697,328,145,183,1,1.3,36.75,8.2,0,0,0,0,0,0,0.000405640820444675,0.617050230485566,0.0420124813965679
24.3,"greedy_SVM","SVM",7,0,13233,12722,511,100,94,6,0.951119613208817,0.823529411764706,5.46122936016512,29,6,23,0,3.8,0.75,15.7,0,0,0,0,0,0,0.993248616819347,756.567769598505,99.6429962660414
24.3,"greedy_SVM","SVM",7,1,13133,12722,411,200,94,106,0.952657177022488,0.794117647058823,5.32940415165203,43,16,27,14,1.7,1.5,0.9,0,0,0,0,0,0,0.95053859288554,580.792703238711,97.2932126963653
24.3,"greedy_SVM","SVM",7,2,13033,12722,311,300,94,206,0.950353562065937,0.805147058823529,5.3375853970965,67,22,45,24,2,2.25,0.5,0,0,0,0,0,0,0.944646112563348,534.58444970892,97.0655242065367
24.3,"greedy_SVM","SVM",7,3,12933,12722,211,400,94,306,0.950391217863207,0.805147058823529,5.30306769215352,70,22,48,3,2.2,3,0.3,0,0,0,0,0,0,0.78790395974908,423.636479884713,93.87756852466
24.3,"greedy_SVM","SVM",7,4,12833,12715,118,500,101,399,0.95784505358043,0.863970588235294,5.46122936016512,88,33,55,18,1.7,3.75,0.3,0,0,0,0,0,0,0.173456102934196,146.884571037956,48.2048170467568
24.3,"greedy_SVM","SVM",7,5,12733,12664,69,600,152,448,0.96131801039418,0.919117647058823,5.42091283607979,134,59,75,46,1.3,4.5,0.3,0,0,0,0,0,0,0.0741500859008953,89.9443800896033,24.3417562902082
24.3,"greedy_SVM","SVM",7,6,12633,12591,42,700,225,475,0.962078600009218,0.930147058823529,5.43745539810378,166,77,89,32,1.2,5.25,0.5,0,0,0,0,0,0,0.0307800640931082,44.757341897212,11.3712902836579
24.3,"greedy_SVM","SVM",7,7,12533,12501,32,800,315,485,0.952335234328291,0.930147058823529,5.31665368965691,195,88,107,29,1.2,6,0.6,0,0,0,0,0,0,0.0191328137532561,26.1458434811188,3.62609360323711
24.3,"greedy_SVM","SVM",7,8,12433,12403,30,900,413,487,0.960451639608169,0.930147058823529,5.28057800728434,206,90,116,11,1.3,6.75,0.8,0,0,0,0,0,0,0.0166079130636719,19.3288539958385,2.39008996132856
24.3,"greedy_SVM","SVM",7,9,12333,12303,30,1000,513,487,0.961758382008011,0.930147058823529,5.30306769215352,204,90,114,-2,1.3,7.5,1.1,0,0,0,0,0,0,0.0100911985160123,13.1672031431809,1.24796623808191
24.3,"greedy_SVM","SVM",7,10,12233,12203,30,1100,613,487,0.963225520857268,0.930147058823529,5.30758863647761,205,90,115,1,1.3,8.25,1.3,0,0,0,0,0,0,0.00650634027534896,8.71199992181817,0.740772382694466
24.3,"greedy_SVM","SVM",7,11,12133,12103,30,1200,713,487,0.964570781400889,0.930147058823529,5.31665368965691,206,90,116,1,1.3,9,1.5,0,0,0,0,0,0,0.00482546325391312,6.94953948979699,0.546706543891519
24.3,"greedy_SVM","SVM",7,12,12033,12003,30,1300,813,487,0.965162351101469,0.930147058823529,5.31211729572375,208,92,116,2,1.3,9.75,1.7,0,0,0,0,0,0,0.00347203735440258,5.05363741311071,0.387900457539873
24.3,"greedy_SVM","SVM",7,13,11933,11904,29,1400,912,488,0.968906084716891,0.930147058823529,5.36768479847029,211,93,118,3,1.3,10.5,1.9,0,0,0,0,0,0,0.00280461033656867,4.18901810672392,0.313608794202784
24.3,"greedy_SVM","SVM",7,14,11833,11804,29,1500,1012,488,0.969520075426559,0.930147058823529,5.37688391551994,207,91,116,-4,1.3,11.25,2.1,0,0,0,0,0,0,0.00266862893338276,4.13682043225747,0.287230360291403
24.3,"greedy_SVM","SVM",7,15,11733,11704,29,1600,1112,488,0.970142689601237,0.930147058823529,5.37228041901692,204,91,113,-3,1.2,12,2.3,0,0,0,0,0,0,0.00241449826174542,3.93105744644835,0.258588314706762
24.3,"greedy_SVM","SVM",7,16,11633,11605,28,1700,1211,489,0.973193671526488,0.930147058823529,5.40251677429119,211,94,117,7,1.2,12.75,2.5,0,0,0,0,0,0,0.00240991685443314,4.33219607100734,0.271470061418881
24.3,"greedy_SVM","SVM",7,17,11533,11507,26,1800,1309,491,0.978508025571476,0.930147058823529,5.4468954248366,220,98,122,9,1.2,13.5,2.7,0,0,0,0,0,0,0.00261387941987884,5.04585207580328,0.311714721005469
24.3,"greedy_SVM","SVM",7,18,11433,11409,24,1900,1407,493,0.982511038035247,0.930147058823529,5.48911942037797,224,101,123,4,1.2,14.25,2.9,0,0,0,0,0,0,0.00280817056351232,5.69027192089071,0.328787601892429
24.3,"greedy_SVM","SVM",7,19,11333,11313,20,2000,1503,497,0.990094513176646,0.930147058823529,5.63349765318096,237,103,134,13,1.3,15,3,0,0,0,0,0,0,0.00556812354208496,10.1105032000589,0.714763758316828
24.3,"greedy_SVM","SVM",7,20,11233,11218,15,2100,1598,502,0.997045025985372,0.933823529411765,5.80524380804954,255,110,145,18,1.3,15.75,3.2,0,0,0,0,0,0,0.0114297743922457,20.1666996599124,1.42213993462667
24.3,"greedy_SVM","SVM",7,21,11133,11123,10,2200,1693,507,0.99910775881893,0.933823529411765,5.832895888014,272,118,154,17,1.3,16.5,3.3,0,0,0,0,0,0,0.0173232906106653,23.3060404971664,2.41469116610028
24.3,"greedy_SVM","SVM",7,22,11033,11031,2,2300,1785,515,0.999607344892609,0.952205882352941,5.9579982126899,301,128,173,29,1.4,17.25,3.5,0,0,0,0,0,0,0.0147624312719685,17.614625696465,2.11061773633885
24.3,"greedy_SVM","SVM",7,23,10933,10933,0,2400,1883,517,0.999654486501403,0.948529411764706,5.9052258635961,307,129,178,6,1.4,18,3.6,0,0,0,0,0,0,0.0121800185184262,17.3972265919245,1.40972033902697
24.3,"greedy_SVM","SVM",7,24,10833,10833,0,2500,1983,517,0.999657360989744,0.952205882352941,5.894783377542,306,129,177,-1,1.4,18.75,3.8,0,0,0,0,0,0,0.00864455753852081,12.4727590044959,0.943049442487004
24.3,"greedy_SVM","SVM",7,25,10733,10733,0,2600,2083,517,0.999662535068758,0.952205882352941,5.894783377542,309,131,178,3,1.4,19.5,4,0,0,0,0,0,0,0.00769712266638994,12.1032989919063,0.823711015532962
24.3,"greedy_SVM","SVM",7,26,10633,10633,0,2700,2183,517,0.999671158533781,0.952205882352941,5.894783377542,310,132,178,1,1.3,20.25,4.2,0,0,0,0,0,0,0.00651559150710625,10.629171328661,0.690132897741242
24.3,"greedy_SVM","SVM",7,27,10533,10533,0,2800,2283,517,0.99967317067562,0.952205882352941,5.894783377542,310,132,178,0,1.3,21,4.4,0,0,0,0,0,0,0.00522598214049551,8.32934776136007,0.555256132393249
24.3,"greedy_SVM","SVM",7,28,10433,10433,0,2900,2383,517,0.999672308329117,0.952205882352941,5.894783377542,311,133,178,1,1.3,21.75,4.6,0,0,0,0,0,0,0.00422329664370154,6.73025260988144,0.43985230572655
24.3,"greedy_SVM","SVM",7,29,10333,10333,0,3000,2483,517,0.999679781998804,0.952205882352941,5.9,312,133,179,1,1.3,22.5,4.8,0,0,0,0,0,0,0.0037000918974112,5.79641467065735,0.386184040018232
24.3,"greedy_SVM","SVM",7,30,10233,10233,0,3100,2583,517,0.999682656487145,0.955882352941177,5.894783377542,309,133,176,-3,1.3,23.25,5,0,0,0,0,0,0,0.0035957793756755,5.66833345231147,0.372457012931204
24.3,"greedy_SVM","SVM",7,31,10133,10133,0,3200,2683,517,0.999686680770823,0.955882352941177,5.894783377542,311,133,178,2,1.3,24,5.2,0,0,0,0,0,0,0.00330229579289754,5.40608494797654,0.343982752706439
24.3,"greedy_SVM","SVM",7,32,10033,10033,0,3300,2783,517,0.999689842707998,0.955882352941177,5.88957597173145,312,134,178,1,1.3,24.75,5.4,0,0,0,0,0,0,0.00320032608008691,5.48689156174745,0.331834444884539
24.3,"greedy_SVM","SVM",7,33,9933,9933,0,3400,2883,517,0.99969415444051,0.955882352941177,5.88437775816417,311,133,178,-1,1.3,25.5,5.6,0,0,0,0,0,0,0.00204440687825509,3.16731370965345,0.214665454501507
24.3,"greedy_SVM","SVM",7,34,9833,9833,0,3500,2983,517,0.99970047831486,0.955882352941177,5.894783377542,313,134,179,2,1.3,26.25,5.8,0,0,0,0,0,0,0.00194926941859866,3.13285089200971,0.202645494901688
24.3,"greedy_SVM","SVM",7,35,9733,9733,0,3600,3083,517,0.999703352803201,0.955882352941177,5.894783377542,312,134,178,-1,1.3,27,6,0,0,0,0,0,0,0.00190603543170648,3.15354300874708,0.198578095732624
24.3,"greedy_SVM","SVM",7,36,9633,9633,0,3700,3183,517,0.999701053212528,0.955882352941177,5.894783377542,312,134,178,0,1.3,27.75,6.2,0,0,0,0,0,0,0.0016903335135608,2.76330481244825,0.176343299675827
24.3,"greedy_SVM","SVM",7,37,9533,9533,0,3800,3283,517,0.999705077496206,0.955882352941177,5.894783377542,310,133,177,-2,1.3,28.5,6.4,0,0,0,0,0,0,0.00208341513029742,3.68846496347962,0.215249550438641
24.3,"greedy_SVM","SVM",7,38,9433,9433,0,3900,3383,517,0.999703927700869,0.955882352941177,5.894783377542,310,133,177,0,1.3,29.25,6.5,0,0,0,0,0,0,0.00178607596164897,3.08346953018577,0.183578567881675
24.3,"greedy_SVM","SVM",7,39,9333,9333,0,4000,3483,517,0.999707951984547,0.959558823529412,5.88437775816417,311,133,178,1,1.3,30,6.7,0,0,0,0,0,0,0.00117498833995307,1.87928698212176,0.121572846317052
24.3,"greedy_SVM","SVM",7,40,9233,9233,0,4100,3583,517,0.999709101779883,0.959558823529412,5.88957597173145,314,134,180,3,1.3,30.75,6.9,0,0,0,0,0,0,0.00135796599004122,2.2854962207869,0.140835421507025
24.3,"greedy_SVM","SVM",7,41,9133,9133,0,4200,3683,517,0.999709101779883,0.959558823529412,5.88437775816417,315,134,181,1,1.4,31.5,7.1,0,0,0,0,0,0,0.0010838976709446,1.73913444414974,0.11259819911995
24.3,"greedy_SVM","SVM",7,42,9033,9033,0,4300,3783,517,0.999711401370556,0.959558823529412,5.88957597173145,315,134,181,0,1.4,32.25,7.3,0,0,0,0,0,0,0.00110429425426229,1.79586589992814,0.113624704464219
24.3,"greedy_SVM","SVM",7,43,8933,8933,0,4400,3883,517,0.999710826472888,0.959558823529412,5.8636763412489,317,134,183,2,1.4,33,7.5,0,0,0,0,0,0,0.000801717596554864,1.22388703753367,0.0824750217548387
24.3,"greedy_SVM","SVM",7,44,8833,8833,0,4500,3983,517,0.999708526882215,0.959558823529412,5.86883802816901,317,134,183,0,1.4,33.75,7.7,0,0,0,0,0,0,0.0007885831059098,1.19729972239155,0.0811190556227683
24.3,"greedy_SVM","SVM",7,45,8733,8733,0,4600,4083,517,0.999707951984547,0.959558823529412,5.88437775816417,318,134,184,1,1.4,34.5,7.9,0,0,0,0,0,0,0.000800473408792751,1.22056950874171,0.0824530683226628
24.3,"greedy_SVM","SVM",7,46,8633,8633,0,4700,4183,517,0.999711401370556,0.959558823529412,5.88437775816417,319,134,185,1,1.4,35.25,8.1,0,0,0,0,0,0,0.000768389479457387,1.18553024120339,0.0793688934465401
24.3,"greedy_SVM","SVM",7,47,8533,8533,0,4800,4283,517,0.999711401370556,0.959558823529412,5.87918871252205,319,134,185,0,1.4,36,8.3,0,0,0,0,0,0,0.000684894561989998,1.02253593651129,0.0707459547541513
24.3,"greedy_SVM","SVM",7,48,8433,8433,0,4900,4383,517,0.999711401370556,0.959558823529412,5.87918871252205,318,134,184,-1,1.4,36.75,8.5,0,0,0,0,0,0,0.000565978728324872,0.84082649010728,0.0589642540868167
24.3,"greedy_SVM","SVM",8,0,13233,12730,503,100,94,6,0.971093627681231,0.792857142857143,5.48329173067076,24,6,18,0,3,0.75,15.7,0,0,0,0,0,0,0.930972376999842,828.303847702281,96.5074864752305
24.3,"greedy_SVM","SVM",8,1,13133,12730,403,200,94,106,0.974098615491272,0.789285714285714,5.54729902713774,51,18,33,27,1.8,1.5,0.9,0,0,0,0,0,0,0.884606160291057,487.972102761643,93.6661414213889
24.3,"greedy_SVM","SVM",8,2,13033,12730,303,300,94,206,0.975349202621396,0.828571428571429,5.46544865277072,67,24,43,16,1.8,2.25,0.5,0,0,0,0,0,0,0.91179488553773,437.23367319763,96.8782057627776
24.3,"greedy_SVM","SVM",8,3,12933,12730,203,400,94,306,0.977281979019885,0.825,5.5437969924812,77,28,49,10,1.8,3,0.3,0,0,0,0,0,0,0.641671840570831,368.021289679337,87.5235819854774
24.3,"greedy_SVM","SVM",8,4,12833,12716,117,500,108,392,0.980181283410559,0.882142857142857,5.74220308250227,104,43,61,27,1.4,3.75,0.3,0,0,0,0,0,0,0.0490136876632161,47.1815045395063,26.9148359423057
24.3,"greedy_SVM","SVM",8,5,12733,12662,71,600,162,438,0.9537995705563,0.9,5.40670716193868,132,60,72,28,1.2,4.5,0.4,0,0,0,0,0,0,0.0400497566815604,73.9021278316867,18.6707049416699
24.3,"greedy_SVM","SVM",8,6,12633,12576,57,700,248,452,0.956639043593036,0.9,5.18426051143349,147,68,79,15,1.2,5.25,0.5,0,0,0,0,0,0,0.0165747501872535,35.6201859999889,2.05065592760723
24.3,"greedy_SVM","SVM",8,7,12533,12476,57,800,348,452,0.960647185130509,0.9,5.20216814705157,158,72,86,11,1.2,6,0.8,0,0,0,0,0,0,0.00588804228342052,3.72492117771479,0.771634809306999
24.3,"greedy_SVM","SVM",8,8,12433,12376,57,900,448,452,0.961049788633151,0.9,5.22019992572419,160,73,87,2,1.2,6.75,1,0,0,0,0,0,0,0.00384168481326662,1.40873408378811,0.4411676077758
24.3,"greedy_SVM","SVM",8,9,12333,12276,57,1000,548,452,0.962822362387897,0.9,5.2453785156734,153,72,81,-7,1.1,7.5,1.2,0,0,0,0,0,0,1.87637005741892e-05,0.278304495958868,0.267502194172207
24.3,"greedy_SVM","SVM",8,10,12233,12176,57,1100,648,452,0.96397705160037,0.9,5.27281728733342,155,70,85,2,1.2,8.25,1.4,0,0,0,0,0,0,1.2796512459386e-05,0.0251138337405946,0.0173494885856704
24.3,"greedy_SVM","SVM",8,11,12133,12076,57,1200,748,452,0.964672660985507,0.9,5.26822424091588,160,74,86,5,1.2,9,1.7,0,0,0,0,0,0,6.05220180037688e-06,0.0046169577081837,0.000723492805436477
24.3,"greedy_SVM","SVM",8,12,12033,11976,57,1300,848,452,0.965418036636943,0.9,5.25906211180124,159,73,86,-1,1.2,9.75,1.9,0,0,0,0,0,0,3.76049449660187e-06,0.00297343982174473,0.000458206585469368
24.3,"greedy_SVM","SVM",8,13,11933,11876,57,1400,948,452,0.965892214095618,0.9,5.25906211180124,155,72,83,-4,1.2,10.5,2.1,0,0,0,0,0,0,2.48580803239687e-06,0.00202038534451846,0.000285745772231563
24.3,"greedy_SVM","SVM",8,14,11833,11776,57,1500,1048,452,0.968019302601287,0.9,5.28436217829168,158,74,84,3,1.1,11.25,2.3,0,0,0,0,0,0,2.01044384130744e-06,0.00159962866269264,0.000235476734091919
24.3,"greedy_SVM","SVM",8,15,11733,11677,56,1600,1147,453,0.97321344695702,0.9,5.37192944250871,161,77,84,3,1.1,12,2.5,0,0,0,0,0,0,2.85721915920386e-06,0.0648945368684269,0.0629146763680568
24.3,"greedy_SVM","SVM",8,16,11633,11584,49,1700,1240,460,0.978744771746215,0.907142857142857,5.52525331498624,183,83,100,22,1.2,12.75,2.7,0,0,0,0,0,0,7.29208215165045e-06,0.190979696544035,0.186910912095194
24.3,"greedy_SVM","SVM",8,17,11533,11493,40,1800,1331,469,0.980019123666396,0.932142857142857,5.5296979450359,200,92,108,17,1.2,13.5,2.8,0,0,0,0,0,0,0.00314243634556806,0.79918381104274,0.665039537139626
24.3,"greedy_SVM","SVM",8,18,11433,11402,31,1900,1422,478,0.982627099689126,0.935714285714286,5.53593962217558,217,101,116,17,1.1,14.25,3,0,0,0,0,0,0,0.00377303282776521,1.12358157864139,0.6873382893835
24.3,"greedy_SVM","SVM",8,19,11333,11303,30,2000,1521,479,0.986171128855501,0.935714285714286,5.58063616071429,220,103,117,3,1.1,15,3.2,0,0,0,0,0,0,0.00326386621906851,0.834944776504842,0.410733223911722
24.3,"greedy_SVM","SVM",8,20,11233,11207,26,2100,1617,483,0.991299290970471,0.935714285714286,5.73802613393642,238,107,131,18,1.2,15.75,3.3,0,0,0,0,0,0,0.00560078310792262,4.39742918065269,0.700702213316313
24.3,"greedy_SVM","SVM",8,21,11133,11112,21,2200,1712,488,0.995792234225774,0.939285714285714,5.8731681719883,251,115,136,13,1.2,16.5,3.5,0,0,0,0,0,0,0.00741170328003534,6.27829961990273,1.00508156575473
24.3,"greedy_SVM","SVM",8,22,11033,11021,12,2300,1803,497,0.998183810865821,0.95,5.91557371835644,280,123,157,29,1.3,17.25,3.6,0,0,0,0,0,0,0.0120812781816307,10.4629495182717,1.63958321690156
24.3,"greedy_SVM","SVM",8,23,10933,10925,8,2400,1899,501,0.999078485316155,0.953571428571429,5.94206773618538,291,127,164,11,1.3,18,3.8,0,0,0,0,0,0,0.0105742648932663,9.87839875194072,1.31051645876988
24.3,"greedy_SVM","SVM",8,24,10833,10826,7,2500,1998,502,0.999259656892348,0.957142857142857,5.94206773618538,297,129,168,6,1.3,18.75,4,0,0,0,0,0,0,0.00927445953538618,9.15944311377975,1.06524186959966
24.3,"greedy_SVM","SVM",8,25,10733,10728,5,2600,2096,504,0.999485003019526,0.960714285714286,5.95267857142857,303,132,171,6,1.3,19.5,4.2,0,0,0,0,0,0,0.00780962502827022,6.75487582198662,1.00385795597
24.3,"greedy_SVM","SVM",8,26,10633,10632,1,2700,2192,508,0.999629269274642,0.964285714285714,5.96332737030411,317,135,182,14,1.3,20.25,4.3,0,0,0,0,0,0,0.00717469628097497,5.54835283242125,0.96698767626693
24.3,"greedy_SVM","SVM",8,27,10533,10533,0,2800,2291,509,0.999638216019146,0.964285714285714,5.96332737030411,322,136,186,5,1.4,21,4.5,0,0,0,0,0,0,0.00675816349465794,5.63246755487554,0.758105828118335
24.3,"greedy_SVM","SVM",8,28,10433,10433,0,2900,2391,509,0.99963989353374,0.964285714285714,5.96332737030411,324,136,188,2,1.4,21.75,4.7,0,0,0,0,0,0,0.00475816466644803,2.97634499500343,0.514261580471424
24.3,"greedy_SVM","SVM",8,29,10333,10333,0,3000,2491,509,0.999647721935181,0.964285714285714,5.96332737030411,321,135,186,-3,1.4,22.5,4.9,0,0,0,0,0,0,0.00429022038063574,2.5090345082402,0.453499207555344
24.3,"greedy_SVM","SVM",8,30,10233,10233,0,3100,2591,509,0.999646603592118,0.964285714285714,5.9686660698299,322,135,187,1,1.4,23.25,5.1,0,0,0,0,0,0,0.00366702025705607,1.74376917540259,0.385706310482095
24.3,"greedy_SVM","SVM",8,31,10133,10133,0,3200,2691,509,0.999648001520946,0.964285714285714,5.9579982126899,324,136,188,2,1.4,24,5.3,0,0,0,0,0,0,0.00311366103667815,1.03857109609865,0.327131130991307
24.3,"greedy_SVM","SVM",8,32,10033,10033,0,3300,2791,509,0.999651636135901,0.964285714285714,5.96332737030411,324,136,188,0,1.4,24.75,5.5,0,0,0,0,0,0,0.00320851052176326,1.27249469602584,0.334774098533156
24.3,"greedy_SVM","SVM",8,33,9933,9933,0,3400,2891,509,0.999652754478964,0.964285714285714,5.95267857142857,322,136,186,-2,1.4,25.5,5.7,0,0,0,0,0,0,0.00269459683917675,0.522430350600217,0.281806383836753
24.3,"greedy_SVM","SVM",8,34,9833,9833,0,3500,2991,509,0.999655550336621,0.967857142857143,5.95267857142857,320,136,184,-2,1.4,26.25,5.9,0,0,0,0,0,0,0.00256063055605154,0.344761624028548,0.266879085543624
24.3,"greedy_SVM","SVM",8,35,9733,9733,0,3600,3091,509,0.999656668679684,0.967857142857143,5.94206773618538,322,136,186,2,1.4,27,6.1,0,0,0,0,0,0,9.67821001660492e-06,0.00774527904615261,0.00105597009427162
24.3,"greedy_SVM","SVM",8,36,9633,9633,0,3700,3191,509,0.999659464537341,0.967857142857143,5.95267857142857,322,137,185,0,1.4,27.75,6.3,0,0,0,0,0,0,1.25924019255303e-05,0.0109463997146679,0.00136765908437779
24.3,"greedy_SVM","SVM",8,37,9533,9533,0,3800,3291,509,0.999661142051936,0.967857142857143,5.93677649154052,321,137,184,-1,1.3,28.5,6.5,0,0,0,0,0,0,5.98024808612447e-06,0.00490165197236484,0.000649115370440541
24.3,"greedy_SVM","SVM",8,38,9433,9433,0,3900,3391,509,0.999662260394999,0.967857142857143,5.95267857142857,321,136,185,0,1.4,29.25,6.7,0,0,0,0,0,0,9.39593339889092e-06,0.00858314750322758,0.00100547673108204
24.3,"greedy_SVM","SVM",8,39,9333,9333,0,4000,3491,509,0.999665615424187,0.967857142857143,5.95267857142857,321,136,185,0,1.4,30,6.9,0,0,0,0,0,0,0.00137880841478459,2.22078682021756,0.143211510812951
24.3,"greedy_SVM","SVM",8,40,9233,9233,0,4100,3591,509,0.999668411281845,0.967857142857143,5.95267857142857,321,136,185,0,1.4,30.75,7.1,0,0,0,0,0,0,0.00120622294999306,1.95505719302854,0.124626314914593
24.3,"greedy_SVM","SVM",8,41,9133,9133,0,4200,3691,509,0.999672325482565,0.967857142857143,5.94736842105263,321,137,184,0,1.3,31.5,7.3,0,0,0,0,0,0,0.00110202092894109,1.73626752135805,0.113456651656918
24.3,"greedy_SVM","SVM",8,42,9033,9033,0,4300,3791,509,0.999674282582925,0.967857142857143,5.93149466192171,322,137,185,1,1.4,32.25,7.4,0,0,0,0,0,0,0.000981107897562547,1.49579387801135,0.102109650199719
24.3,"greedy_SVM","SVM",8,43,8933,8933,0,4400,3891,509,0.999674002997159,0.967857142857143,5.95267857142857,319,137,182,-3,1.3,33,7.6,0,0,0,0,0,0,0.0013032698351065,2.13712272087051,0.13456497722682
24.3,"greedy_SVM","SVM",8,44,8833,8833,0,4500,3991,509,0.999674562168691,0.967857142857143,5.95267857142857,321,137,184,2,1.3,33.75,7.8,0,0,0,0,0,0,0.00105686073693085,1.6947095399644,0.108816637594104
24.3,"greedy_SVM","SVM",8,45,8733,8733,0,4600,4091,509,0.999677358026348,0.967857142857143,5.93677649154052,321,137,184,0,1.3,34.5,8,0,0,0,0,0,0,0.000719340765147449,1.099276415921,0.0750815171515719
24.3,"greedy_SVM","SVM",8,46,8633,8633,0,4700,4191,509,0.999680153884005,0.967857142857143,5.91570541259982,319,137,182,-2,1.3,35.25,8.2,0,0,0,0,0,0,0.000592600078068459,0.887290153581702,0.06155034633736
24.3,"greedy_SVM","SVM",8,47,8533,8533,0,4800,4291,509,0.999680153884005,0.967857142857143,5.894783377542,319,137,182,0,1.3,36,8.4,0,0,0,0,0,0,0.000512174696373743,0.739744453050423,0.0527538234842152
24.3,"greedy_SVM","SVM",8,48,8433,8433,0,4900,4391,509,0.999679594712474,0.967857142857143,5.95267857142857,320,137,183,1,1.3,36.75,8.6,0,0,0,0,0,0,0.000663934377045379,1.03124720723862,0.0685612583298667
24.3,"greedy_SVM","SVM",9,0,13233,12708,525,100,95,5,0.945403067594112,0.83011583011583,5.19776507276507,25,5,20,0,4,0.75,19,0,0,0,0,0,0,0.956127517267753,600.756489105308,97.9276055234198
24.3,"greedy_SVM","SVM",9,1,13133,12708,425,200,95,105,0.957004155037865,0.818532818532819,5.21088259663412,37,13,24,12,1.8,1.5,0.9,0,0,0,0,0,0,0.886867372623006,389.056225070627,94.799552160255
24.3,"greedy_SVM","SVM",9,2,13033,12708,325,300,95,205,0.953854135033918,0.814671814671815,5.14826254826255,47,15,32,10,2.1,2.25,0.5,0,0,0,0,0,0,0.876675392289501,293.582109555787,95.3671796429713
24.3,"greedy_SVM","SVM",9,3,12933,12707,226,400,96,304,0.950948139150381,0.818532818532819,5.0866067093612,62,21,41,15,2,3,0.3,0,0,0,0,0,0,0.571355132893444,215.89990484673,87.5236603123685
24.3,"greedy_SVM","SVM",9,4,12833,12700,133,500,103,397,0.954756723015153,0.837837837837838,5.35895656714162,93,36,57,31,1.6,3.75,0.3,0,0,0,0,0,0,0.0737459073981261,53.1115936443488,24.9090683167488
24.3,"greedy_SVM","SVM",9,5,12733,12626,107,600,177,423,0.953354036219194,0.868725868725869,5.4421865474497,118,52,66,25,1.3,4.5,0.4,0,0,0,0,0,0,0.0298576765881821,60.5845018020889,25.6512160528354
24.3,"greedy_SVM","SVM",9,6,12633,12576,57,700,227,473,0.938160070182552,0.884169884169884,5.17538245633066,146,67,79,28,1.2,5.25,0.5,0,0,0,0,0,0,0.00825209214025672,15.1382553769898,2.60332270921416
24.3,"greedy_SVM","SVM",9,7,12533,12477,56,800,326,474,0.946221904087109,0.884169884169884,5.077617436108,149,67,82,3,1.2,6,0.7,0,0,0,0,0,0,0.00238337822110181,3.58828678648763,0.29950842447862
24.3,"greedy_SVM","SVM",9,8,12433,12377,56,900,426,474,0.948010811774872,0.884169884169884,5.09554996244416,153,69,84,4,1.2,6.75,0.9,0,0,0,0,0,0,0.00126705267129161,1.31171362804658,0.176744241237237
24.3,"greedy_SVM","SVM",9,9,12333,12277,56,1000,526,474,0.948533204151197,0.884169884169884,5.11738179604504,157,70,87,4,1.2,7.5,1.1,0,0,0,0,0,0,0.000757497070763984,0.855469908654221,0.0888916005885528
24.3,"greedy_SVM","SVM",9,10,12233,12177,56,1100,626,474,0.949760555097645,0.884169884169884,5.10862665182597,156,69,87,-1,1.3,8.25,1.3,0,0,0,0,0,0,0.000519717088086796,0.565933390214509,0.0595545712451004
24.3,"greedy_SVM","SVM",9,11,12133,12077,56,1200,726,474,0.950678808824894,0.884169884169884,5.10862665182597,152,68,84,-4,1.2,9,1.5,0,0,0,0,0,0,0.000473519371151389,0.556777472005502,0.0532403128426563
24.3,"greedy_SVM","SVM",9,12,12033,11977,56,1300,826,474,0.951698287372457,0.884169884169884,5.12177063120459,153,71,82,1,1.2,9.75,1.7,0,0,0,0,0,0,0.000444858180496816,0.53823256503963,0.0505191409511932
24.3,"greedy_SVM","SVM",9,13,11933,11877,56,1400,926,474,0.952270689630254,0.884169884169884,5.12616700084511,152,70,82,-1,1.2,10.5,2,0,0,0,0,0,0,0.000300185905102437,0.346117329797269,0.0319921067200129
24.3,"greedy_SVM","SVM",9,14,11833,11778,55,1500,1025,475,0.955956960170432,0.884169884169884,5.19245364309742,157,70,87,5,1.2,11.25,2.2,0,0,0,0,0,0,0.000469356416599044,0.638739185336338,0.0669311788796341
24.3,"greedy_SVM","SVM",9,15,11733,11683,50,1600,1120,480,0.961308620016466,0.888030888030888,5.21454919051486,172,78,94,15,1.2,12,2.3,0,0,0,0,0,0,0.000749042541539974,0.999640275601243,0.141426712522096
24.3,"greedy_SVM","SVM",9,16,11633,11590,43,1700,1213,487,0.961479135636418,0.8996138996139,5.23626703626704,187,85,102,15,1.2,12.75,2.5,0,0,0,0,0,0,0.00145269374602212,1.83566507481023,0.250834470446357
24.3,"greedy_SVM","SVM",9,17,11533,11502,31,1800,1301,499,0.962269653280914,0.915057915057915,5.33418432558587,207,98,109,20,1.1,13.5,2.6,0,0,0,0,0,0,0.00305812533397452,3.03708765504255,0.778393992644777
24.3,"greedy_SVM","SVM",9,18,11433,11405,28,1900,1398,502,0.964697843911351,0.918918918918919,5.38409479982514,215,101,114,8,1.1,14.25,2.8,0,0,0,0,0,0,0.00233324153234686,2.11405688252059,0.30804193608594
24.3,"greedy_SVM","SVM",9,19,11333,11305,28,2000,1498,502,0.964854501371377,0.918918918918919,5.3794453224505,219,102,117,4,1.1,15,3,0,0,0,0,0,0,0.0017051676066407,1.84012157891204,0.199872765925836
24.3,"greedy_SVM","SVM",9,20,11233,11205,28,2100,1598,502,0.965115998823881,0.918918918918919,5.40277335940822,218,101,117,-1,1.2,15.75,3.2,0,0,0,0,0,0,0.00106887138673534,1.30762603959748,0.121161163562219
24.3,"greedy_SVM","SVM",9,21,11133,11106,27,2200,1697,503,0.966886228122198,0.918918918918919,5.3655449469403,224,103,121,6,1.2,16.5,3.4,0,0,0,0,0,0,0.00129656408375502,1.82668695609344,0.155708060170018
24.3,"greedy_SVM","SVM",9,22,11033,11009,24,2300,1794,506,0.975287285680539,0.918918918918919,5.46027846027846,233,104,129,9,1.2,17.25,3.5,0,0,0,0,0,0,0.00227386828466916,3.65549493513076,0.272859259348302
24.3,"greedy_SVM","SVM",9,23,10933,10913,20,2400,1890,510,0.983215960744054,0.915057915057915,5.63446210048152,249,108,141,16,1.3,18,3.7,0,0,0,0,0,0,0.00658480285944327,10.0146912255283,0.807257534975754
24.3,"greedy_SVM","SVM",9,24,10833,10818,15,2500,1985,515,0.988041010512918,0.918918918918919,5.72282506472055,263,114,149,14,1.3,18.75,3.9,0,0,0,0,0,0,0.007025743664572,11.1644014738128,0.84000884729717
24.3,"greedy_SVM","SVM",9,25,10733,10724,9,2600,2079,521,0.994080758125685,0.922779922779923,5.80150260540678,283,125,158,20,1.3,19.5,4,0,0,0,0,0,0,0.011826377556153,15.794996541093,1.47815201020642
24.3,"greedy_SVM","SVM",9,26,10633,10629,4,2700,2174,526,0.995497303081565,0.922779922779923,5.8295157629083,297,130,167,14,1.3,20.25,4.1,0,0,0,0,0,0,0.0115625327074678,15.7879800376887,1.51034644547493
24.3,"greedy_SVM","SVM",9,27,10533,10530,3,2800,2273,527,0.997012060214311,0.922779922779923,5.8700242897226,298,131,167,1,1.3,21,4.3,0,0,0,0,0,0,0.00897300444567291,12.4912590963624,1.02720203266743
24.3,"greedy_SVM","SVM",9,28,10433,10432,1,2900,2371,529,0.998507536428885,0.926640926640927,5.92095914742451,306,133,173,8,1.3,21.75,4.5,0,0,0,0,0,0,0.00858409386830774,13.0951064414122,1.1184561390502
24.3,"greedy_SVM","SVM",9,29,10333,10332,1,3000,2471,529,0.998505728842808,0.926640926640927,5.92622222222222,307,133,174,1,1.3,22.5,4.7,0,0,0,0,0,0,0.00649704708010897,9.66645509864741,0.695003231528349
24.3,"greedy_SVM","SVM",9,30,10233,10232,1,3100,2571,529,0.998504523785423,0.926640926640927,5.9104609929078,308,133,175,1,1.3,23.25,4.9,0,0,0,0,0,0,0.00551810556535544,8.41035643273713,0.582126606634217
24.3,"greedy_SVM","SVM",9,31,10133,10132,1,3200,2671,529,0.998518984474041,0.926640926640927,5.9104609929078,310,134,176,2,1.3,24,5,0,0,0,0,0,0,0.00555130230407293,9.1741165483894,0.584191874519275
24.3,"greedy_SVM","SVM",9,32,10033,10032,1,3300,2771,529,0.998526817347043,0.926640926640927,5.9104609929078,311,133,178,1,1.3,24.75,5.2,0,0,0,0,0,0,0.00397132043919511,6.34655804203314,0.418964335486311
24.3,"greedy_SVM","SVM",9,33,9933,9933,0,3400,2870,530,0.999161280060156,0.926640926640927,5.91570541259982,315,134,181,4,1.4,25.5,5.4,0,0,0,0,0,0,0.00369932956013431,5.63799417838669,0.44115365507691
24.3,"greedy_SVM","SVM",9,34,9833,9833,0,3500,2970,530,0.999186586265238,0.926640926640927,5.91570541259982,316,134,182,1,1.4,26.25,5.6,0,0,0,0,0,0,0.0034483315548746,5.5686431137558,0.360921204242609
24.3,"greedy_SVM","SVM",9,35,9733,9733,0,3600,3070,530,0.999206469712088,0.926640926640927,5.91570541259982,314,134,180,-2,1.3,27,5.8,0,0,0,0,0,0,0.00273135857505367,4.08000965432038,0.286254375136259
24.3,"greedy_SVM","SVM",9,36,9633,9633,0,3700,3170,530,0.999225148101553,0.926640926640927,5.9,312,134,178,-2,1.3,27.75,6,0,0,0,0,0,0,0.00316562993897952,5.36996862771413,0.330800846939058
24.3,"greedy_SVM","SVM",9,37,9533,9533,0,3800,3270,530,0.999232980974554,0.930501930501931,5.91570541259982,312,134,178,0,1.3,28.5,6.2,0,0,0,0,0,0,0.00261606695740887,4.27127931799173,0.269553965191679
24.3,"greedy_SVM","SVM",9,38,9433,9433,0,3900,3370,530,0.999249851777942,0.930501930501931,5.91570541259982,311,134,177,-1,1.3,29.25,6.4,0,0,0,0,0,0,0.00232855237706545,3.71005493463977,0.241325871927622
24.3,"greedy_SVM","SVM",9,39,9333,9333,0,4000,3470,530,0.999261299823098,0.930501930501931,5.9104609929078,312,134,178,1,1.3,30,6.5,0,0,0,0,0,0,0.00176811255302269,2.72548847250035,0.184751538243025
24.3,"greedy_SVM","SVM",9,40,9233,9233,0,4100,3570,530,0.999272747868253,0.930501930501931,5.9,312,134,178,0,1.3,30.75,6.7,0,0,0,0,0,0,0.00193930573514014,3.19406502188657,0.20125322003675
24.3,"greedy_SVM","SVM",9,41,9133,9133,0,4200,3670,530,0.999278170626485,0.930501930501931,5.9,311,134,177,-1,1.3,31.5,6.9,0,0,0,0,0,0,0.001698624464335,2.79533461640943,0.176544217962902
24.3,"greedy_SVM","SVM",9,42,9033,9033,0,4300,3770,530,0.999291426257718,0.934362934362934,5.9,313,135,178,2,1.3,32.25,7.1,0,0,0,0,0,0,0.00181403680942197,3.08638082836774,0.187289874876836
24.3,"greedy_SVM","SVM",9,43,8933,8933,0,4400,3870,530,0.999296246487258,0.934362934362934,5.9,315,135,180,2,1.3,33,7.3,0,0,0,0,0,0,0.00153678788996243,2.50581626380945,0.158029366903101
24.3,"greedy_SVM","SVM",9,44,8833,8833,0,4500,3970,530,0.999298054073335,0.934362934362934,5.894783377542,316,136,180,1,1.3,33.75,7.5,0,0,0,0,0,0,0.00145371327745974,2.40062342884302,0.149636815774126
24.3,"greedy_SVM","SVM",9,45,8733,8733,0,4600,4070,530,0.999298656602027,0.934362934362934,5.9,316,137,179,0,1.3,34.5,7.7,0,0,0,0,0,0,0.0013351979620532,2.14803645436538,0.136978459572481
24.3,"greedy_SVM","SVM",9,46,8633,8633,0,4700,4170,530,0.999297451544642,0.934362934362934,5.9,317,137,180,1,1.3,35.25,7.9,0,0,0,0,0,0,0.00122390738836776,1.92819838744931,0.12531436535628
24.3,"greedy_SVM","SVM",9,47,8533,8533,0,4800,4270,530,0.999301669245489,0.934362934362934,5.9,315,136,179,-2,1.3,36,8.1,0,0,0,0,0,0,0.00093144752479281,1.42858701770907,0.0971610222858573
24.3,"greedy_SVM","SVM",9,48,8433,8433,0,4900,4370,530,0.999307694532414,0.934362934362934,5.9,315,136,179,0,1.3,36.75,8.2,0,0,0,0,0,0,0.000970797245404417,1.50863689747324,0.100403898003603
24.3,"greedy_SVM","SVM",10,0,13233,12711,522,100,93,7,0.958578357805768,0.776923076923077,5.21423686348862,33,7,26,0,3.7,0.75,13.3,0,0,0,0,0,0,0.962589649590734,747.03913895103,97.567867623861
24.3,"greedy_SVM","SVM",10,1,13133,12711,422,200,93,107,0.955141011633916,0.757692307692308,5.20082078415412,47,18,29,14,1.6,1.5,0.9,0,0,0,0,0,0,0.946688012418829,632.548598076308,97.2089513978114
24.3,"greedy_SVM","SVM",10,2,13033,12711,322,300,93,207,0.951835132247172,0.769230769230769,5.13290561258499,60,20,40,13,2,2.25,0.4,0,0,0,0,0,0,0.936475631491141,504.122137214768,96.622950404756
24.3,"greedy_SVM","SVM",10,3,12933,12711,222,400,93,307,0.955436361671702,0.784615384615385,5.21348838770305,73,27,46,13,1.7,3,0.3,0,0,0,0,0,0,0.769549793279633,421.760824772919,92.2818673246174
24.3,"greedy_SVM","SVM",10,4,12833,12702,131,500,102,398,0.95881607856789,0.826923076923077,5.27525113526902,95,36,59,22,1.6,3.75,0.3,0,0,0,0,0,0,0.13369392579381,125.080997889619,45.9701138635087
24.3,"greedy_SVM","SVM",10,5,12733,12661,72,600,143,457,0.946489416623624,0.865384615384615,5.4008100810081,136,58,78,41,1.3,4.5,0.3,0,0,0,0,0,0,0.0373813365879995,67.6341031046714,21.3765283733814
24.3,"greedy_SVM","SVM",10,6,12633,12584,49,700,220,480,0.946844797156944,0.865384615384615,5.31244222145567,161,72,89,25,1.2,5.25,0.5,0,0,0,0,0,0,0.0282156939772875,60.4993708863008,3.46546712737422
24.3,"greedy_SVM","SVM",10,7,12533,12486,47,800,318,482,0.949292840763112,0.880769230769231,5.36012809157185,169,72,97,8,1.3,6,0.7,0,0,0,0,0,0,0.0137543059928079,27.1006670722606,2.03165663097444
24.3,"greedy_SVM","SVM",10,8,12433,12389,44,900,415,485,0.954107286501544,0.888461538461538,5.3638366487881,186,76,110,17,1.4,6.75,0.9,0,0,0,0,0,0,0.0115712999463001,23.3740467737851,1.46528722351898
24.3,"greedy_SVM","SVM",10,9,12333,12294,39,1000,510,490,0.960742457168282,0.903846153846154,5.43996140303359,200,84,116,14,1.4,7.5,1,0,0,0,0,0,0,0.0119409525477624,24.5628765396388,1.42992611874103
24.3,"greedy_SVM","SVM",10,10,12233,12200,33,1100,604,496,0.963113061435221,0.915384615384615,5.57640202934321,208,89,119,8,1.3,8.25,1.2,0,0,0,0,0,0,0.0131184844267517,24.9300035711147,1.76681427227847
24.3,"greedy_SVM","SVM",10,11,12133,12109,24,1200,695,505,0.957802763804016,0.926923076923077,5.58635989010989,229,99,130,21,1.3,9,1.4,0,0,0,0,0,0,0.0147597989180598,22.2134412292765,2.09073819396972
24.3,"greedy_SVM","SVM",10,12,12033,12011,22,1300,793,507,0.959014179203056,0.930769230769231,5.58137651821862,239,100,139,10,1.4,9.75,1.6,0,0,0,0,0,0,0.00917156383428585,14.1532830034009,1.1093160433988
24.3,"greedy_SVM","SVM",10,13,11933,11911,22,1400,893,507,0.958776458440902,0.930769230769231,5.57640202934321,240,101,139,1,1.4,10.5,1.8,0,0,0,0,0,0,0.00651957111613403,10.3870168258582,0.730570788294004
24.3,"greedy_SVM","SVM",10,14,11833,11811,22,1500,993,507,0.958702620931446,0.930769230769231,5.57143639975341,238,101,137,-2,1.4,11.25,2,0,0,0,0,0,0,0.0067699907927865,12.3995823524106,0.716511905343217
24.3,"greedy_SVM","SVM",10,15,11733,11711,22,1600,1093,507,0.958955949622425,0.930769230769231,5.56647960580345,239,101,138,1,1.4,12,2.2,0,0,0,0,0,0,0.00490680855003023,8.72512687966026,0.521122967033983
24.3,"greedy_SVM","SVM",10,16,11633,11611,22,1700,1193,507,0.959036990791338,0.930769230769231,5.56647960580345,236,100,136,-3,1.4,12.75,2.4,0,0,0,0,0,0,0.00461685510553999,9.04612410234343,0.491857946413168
24.3,"greedy_SVM","SVM",10,17,11533,11511,22,1800,1293,507,0.959022583472418,0.930769230769231,5.56647960580345,236,101,135,0,1.3,13.5,2.6,0,0,0,0,0,0,0.00336473841334467,6.16907626266256,0.351218525387678
24.3,"greedy_SVM","SVM",10,18,11433,11411,22,1900,1393,507,0.959148647512951,0.930769230769231,5.56153162393162,238,101,137,2,1.4,14.25,2.7,0,0,0,0,0,0,0.00255103004493482,4.75626449965245,0.273293539752511
24.3,"greedy_SVM","SVM",10,19,11333,11311,22,2000,1493,507,0.959172659711148,0.930769230769231,5.56153162393162,235,101,134,-3,1.3,15,2.9,0,0,0,0,0,0,0.0027151640023245,5.45449597161212,0.283093188214975
24.3,"greedy_SVM","SVM",10,20,11233,11211,22,2100,1593,507,0.959405578033657,0.930769230769231,5.56153162393162,236,101,135,1,1.3,15.75,3.1,0,0,0,0,0,0,0.00226338183715937,4.5356019044116,0.236447078591906
24.3,"greedy_SVM","SVM",10,21,11133,11111,22,2200,1693,507,0.959388769494921,0.930769230769231,5.56647960580345,236,101,135,0,1.3,16.5,3.3,0,0,0,0,0,0,0.00188927475035538,3.74795197526844,0.197821105910282
24.3,"greedy_SVM","SVM",10,22,11033,11011,22,2300,1793,507,0.959583868605267,0.930769230769231,5.57143639975341,238,101,137,2,1.4,17.25,3.5,0,0,0,0,0,0,0.00224552182603455,4.7680834136475,0.231622486608121
24.3,"greedy_SVM","SVM",10,23,10933,10911,22,2400,1893,507,0.959612683243104,0.930769230769231,5.57143639975341,236,101,135,-2,1.3,18,3.7,0,0,0,0,0,0,0.00175857332084793,3.62271396001052,0.182511008289383
24.3,"greedy_SVM","SVM",10,24,10833,10811,22,2500,1993,507,0.95971233386562,0.930769230769231,5.57143639975341,237,101,136,1,1.3,18.75,3.9,0,0,0,0,0,0,0.00163624091647933,3.41805929982937,0.170371370514009
24.3,"greedy_SVM","SVM",10,25,10733,10711,22,2600,2093,507,0.959936847918758,0.930769230769231,5.57143639975341,238,101,137,1,1.4,19.5,4.1,0,0,0,0,0,0,0.00141028701180012,2.91770963615616,0.145568546273542
24.3,"greedy_SVM","SVM",10,26,10633,10611,22,2700,2193,507,0.960368467181347,0.930769230769231,5.57143639975341,236,101,135,-2,1.3,20.25,4.3,0,0,0,0,0,0,0.00139775219258042,2.94512955121623,0.145987342437686
24.3,"greedy_SVM","SVM",10,27,10533,10511,22,2800,2293,507,0.960989782809684,0.930769230769231,5.56647960580345,234,101,133,-2,1.3,21,4.5,0,0,0,0,0,0,0.00134106306047031,2.75665378831453,0.138622434152746
24.3,"greedy_SVM","SVM",10,28,10433,10411,22,2900,2393,507,0.961364373101549,0.930769230769231,5.56647960580345,234,101,133,0,1.3,21.75,4.7,0,0,0,0,0,0,0.00143851809961329,3.0182141791855,0.148229368267793
24.3,"greedy_SVM","SVM",10,29,10333,10311,22,3000,2493,507,0.961663324969099,0.930769230769231,5.56647960580345,233,101,132,-1,1.3,22.5,4.9,0,0,0,0,0,0,0.00115840796513381,2.34450106248719,0.119414546513324
24.3,"greedy_SVM","SVM",10,30,10233,10211,22,3100,2593,507,0.961934662808719,0.930769230769231,5.56153162393162,233,102,131,0,1.3,23.25,5.1,0,0,0,0,0,0,0.000998893943039561,1.91396541073995,0.102773878275339
24.3,"greedy_SVM","SVM",10,31,10133,10111,22,3200,2693,507,0.96223241406636,0.930769230769231,5.56647960580345,232,102,130,-1,1.3,24,5.3,0,0,0,0,0,0,0.000827217880060513,1.55357542878897,0.085665230560399
24.3,"greedy_SVM","SVM",10,32,10033,10011,22,3300,2793,507,0.962359678716804,0.930769230769231,5.56647960580345,232,102,130,0,1.3,24.75,5.5,0,0,0,0,0,0,0.00108682306700064,2.20780366566066,0.111681996767054
24.3,"greedy_SVM","SVM",10,33,9933,9911,22,3400,2893,507,0.963450432819882,0.930769230769231,5.57143639975341,232,101,131,0,1.3,25.5,5.7,0,0,0,0,0,0,0.000763686840656264,1.39323283968666,0.0801336679957683
24.3,"greedy_SVM","SVM",10,34,9833,9811,22,3500,2993,507,0.963913267940119,0.930769230769231,5.57143639975341,232,101,131,0,1.3,26.25,5.9,0,0,0,0,0,0,0.000953921251922487,1.85462377777455,0.0984172366259636
24.3,"greedy_SVM","SVM",10,35,9733,9711,22,3600,3093,507,0.964261444813968,0.926923076923077,5.57640202934321,232,101,131,0,1.3,27,6.1,0,0,0,0,0,0,0.000761713940723084,1.43310597911373,0.0789291459658205
24.3,"greedy_SVM","SVM",10,36,9633,9612,21,3700,3192,508,0.974314751893931,0.930769230769231,5.5942701554901,239,103,136,7,1.3,27.75,6.3,0,0,0,0,0,0,0.000877549940863607,1.70806286902496,0.106383111150672
24.3,"greedy_SVM","SVM",10,37,9533,9512,21,3800,3292,508,0.974472031792119,0.930769230769231,5.5942701554901,239,103,136,0,1.3,28.5,6.5,0,0,0,0,0,0,0.000900178611659637,1.7878456125534,0.0941685676974708
24.3,"greedy_SVM","SVM",10,38,9433,9412,21,3900,3392,508,0.974671933342108,0.930769230769231,5.5942701554901,242,105,137,3,1.3,29.25,6.7,0,0,0,0,0,0,0.000873784016377208,1.75508190737364,0.0903576730764127
24.3,"greedy_SVM","SVM",10,39,9333,9313,20,4000,3491,509,0.985654512492329,0.930769230769231,5.76951923076923,243,106,137,1,1.3,30,6.9,0,0,0,0,0,0,0.0011740157123274,2.38243335312413,0.153169772616043
24.3,"greedy_SVM","SVM",10,40,9233,9219,14,4100,3585,515,0.998605491589729,0.934615384615385,5.96332737030411,270,111,159,27,1.4,30.75,7,0,0,0,0,0,0,0.00221958330257152,4.51967656812892,1.53197509798484
24.3,"greedy_SVM","SVM",10,41,9133,9132,1,4200,3672,528,0.999585189276152,0.95,5.99011680143756,303,126,177,33,1.4,31.5,7,0,0,0,0,0,0,0.00180043876384425,2.28105798147354,0.389314319802181
24.3,"greedy_SVM","SVM",10,42,9033,9033,0,4300,3771,529,0.999574984091919,0.95,5.99011680143756,307,128,179,4,1.4,32.25,7.1,0,0,0,0,0,0,0.00187178751084762,2.9861574889938,0.218417094515097
24.3,"greedy_SVM","SVM",10,43,8933,8933,0,4400,3871,529,0.99956657982255,0.95,5.99011680143756,306,127,179,-1,1.4,33,7.3,0,0,0,0,0,0,0.00155603805226249,2.64724364386078,0.166842814973353
24.3,"greedy_SVM","SVM",10,44,8833,8833,0,4500,3971,529,0.99956417860273,0.95,5.99011680143756,306,127,179,0,1.4,33.75,7.5,0,0,0,0,0,0,0.00136725573915431,2.39911595614951,0.143768275304847
24.3,"greedy_SVM","SVM",10,45,8733,8733,0,4600,4071,529,0.999559976468046,0.95,5.99011680143756,308,128,180,2,1.4,34.5,7.7,0,0,0,0,0,0,0.0011577732159704,2.04914969414084,0.120657009323275
24.3,"greedy_SVM","SVM",10,46,8633,8633,0,4700,4171,529,0.999558775858136,0.95,5.98473967684022,312,129,183,4,1.4,35.25,7.9,0,0,0,0,0,0,0.000961784033145441,1.68165059619253,0.0993980128496442
24.3,"greedy_SVM","SVM",10,47,8533,8533,0,4800,4271,529,0.999556374638316,0.95,5.98473967684022,311,129,182,-1,1.4,36,8.1,0,0,0,0,0,0,0.0010960259606409,2.06870478878311,0.113754266179044
24.3,"greedy_SVM","SVM",10,48,8433,8433,0,4900,4371,529,0.999555174028406,0.95,5.98473967684022,313,129,184,2,1.4,36.75,8.3,0,0,0,0,0,0,0.000943001731051139,1.72771775318921,0.0970191703199523
24.3,"greedy_SVM","SVM",11,0,13233,12705,528,100,94,6,0.941334874561134,0.745098039215686,5.40442643059037,26,6,20,0,3.3,0.75,15.7,0,0,0,0,0,0,0.956448981316428,646.159751095374,98.0534536442741
24.3,"greedy_SVM","SVM",11,1,13133,12704,429,200,95,105,0.949119909972674,0.76078431372549,5.45781900727474,44,17,27,18,1.6,1.5,0.9,0,0,0,0,0,0,0.840623288495759,324.714129930056,91.9716045407871
24.3,"greedy_SVM","SVM",11,2,13033,12704,329,300,95,205,0.949025112228242,0.792156862745098,5.45781900727474,73,28,45,29,1.6,2.25,0.5,0,0,0,0,0,0,0.859515821766378,329.263199258666,93.7194442314566
24.3,"greedy_SVM","SVM",11,3,12933,12704,229,400,95,305,0.950132716842159,0.831372549019608,5.51050880206097,90,42,48,17,1.1,3,0.3,0,0,0,0,0,0,0.733807993818555,258.704532161473,90.6238354077219
24.3,"greedy_SVM","SVM",11,4,12833,12691,142,500,108,392,0.951650703949682,0.870588235294118,5.47824446325293,107,46,61,17,1.3,3.75,0.3,0,0,0,0,0,0,0.07040683721689,73.2086300030863,61.6499160152355
24.3,"greedy_SVM","SVM",11,5,12733,12668,65,600,131,469,0.94732915000056,0.886274509803922,5.38621383124426,125,61,64,18,1,4.5,0.3,0,0,0,0,0,0,0.00594366502180092,5.04663193347951,4.13912141714265
24.3,"greedy_SVM","SVM",11,6,12633,12576,57,700,223,477,0.93290704928258,0.886274509803922,5.2382094489817,151,67,84,26,1.3,5.25,0.5,0,0,0,0,0,0,0.00926524822231036,13.4008296170624,1.256709499484
24.3,"greedy_SVM","SVM",11,7,12533,12476,57,800,323,477,0.941232126038156,0.886274509803922,5.19710754397661,140,63,77,-11,1.2,6,0.7,0,0,0,0,0,0,6.27162176350767e-06,0.106917321214091,0.103161218723755
24.3,"greedy_SVM","SVM",11,8,12433,12376,57,900,423,477,0.946692476117064,0.886274509803922,5.206185461084,152,68,84,12,1.2,6.75,0.9,0,0,0,0,0,0,9.02130563922776e-06,0.122752549558578,0.11987641245352
24.3,"greedy_SVM","SVM",11,9,12333,12276,57,1000,523,477,0.949168226242444,0.886274509803922,5.21529514693016,148,66,82,-4,1.2,7.5,1.1,0,0,0,0,0,0,2.1082001646983e-06,0.00108461214607957,0.00029684177562732
24.3,"greedy_SVM","SVM",11,10,12233,12176,57,1100,623,477,0.951288026127454,0.886274509803922,5.20164254183349,150,67,83,2,1.2,8.25,1.3,0,0,0,0,0,0,1.41933199220033e-06,0.000713945672705552,0.000189538011425985
24.3,"greedy_SVM","SVM",11,11,12133,12076,57,1200,723,477,0.952349149266665,0.886274509803922,5.20164254183349,148,66,82,-2,1.2,9,1.5,0,0,0,0,0,0,6.96739961193747e-07,0.000389649099750464,8.66770433954033e-05
24.3,"greedy_SVM","SVM",11,12,12033,11977,56,1300,822,478,0.957234596895489,0.894117647058824,5.27008520685761,153,68,85,5,1.2,9.75,1.7,0,0,0,0,0,0,2.07598661039395e-06,0.00490813855700713,0.00390309428552252
24.3,"greedy_SVM","SVM",11,13,11933,11881,52,1400,918,482,0.964563991535459,0.894117647058824,5.3666253869969,161,71,90,8,1.3,10.5,1.9,0,0,0,0,0,0,5.49325994779262e-06,0.111348929558626,0.10880349935969
24.3,"greedy_SVM","SVM",11,14,11833,11788,45,1500,1011,489,0.964544420388204,0.905882352941176,5.48129686962504,178,81,97,17,1.2,11.25,2.1,0,0,0,0,0,0,7.34189197046626e-06,0.295753831274118,0.293291669150182
24.3,"greedy_SVM","SVM",11,15,11733,11699,34,1600,1100,500,0.963775029662488,0.925490196078431,5.43927738927739,208,93,115,30,1.2,12,2.2,0,0,0,0,0,0,1.77315081590174e-05,0.477239352671534,0.474259423997356
24.3,"greedy_SVM","SVM",11,16,11633,11603,30,1700,1196,504,0.966113781757205,0.925490196078431,5.46691026366802,217,98,119,9,1.2,12.75,2.4,0,0,0,0,0,0,7.46238090250696e-06,0.0768919161072043,0.0747864609374379
24.3,"greedy_SVM","SVM",11,17,11533,11503,30,1800,1296,504,0.965921739874949,0.925490196078431,5.46213149595503,219,98,121,2,1.2,13.5,2.6,0,0,0,0,0,0,7.81718121197901e-06,0.00359820741720136,0.000979505018677902
24.3,"greedy_SVM","SVM",11,18,11433,11403,30,1900,1396,504,0.965822660942057,0.925490196078431,5.46213149595503,216,97,119,-3,1.2,14.25,2.8,0,0,0,0,0,0,3.01894421768961e-06,0.00159245145186432,0.000392820276624417
24.3,"greedy_SVM","SVM",11,19,11333,11304,29,2000,1495,505,0.967831149927204,0.925490196078431,5.49459153188421,222,100,122,6,1.2,15,3,0,0,0,0,0,0,3.33067852041902e-06,0.00211167050474452,0.000424239319073673
24.3,"greedy_SVM","SVM",11,20,11233,11206,27,2100,1593,507,0.973233398162715,0.925490196078431,5.5271654626763,226,100,126,4,1.3,15.75,3.1,0,0,0,0,0,0,5.38629398621907e-06,0.00437981645708488,0.000745310827314883
24.3,"greedy_SVM","SVM",11,21,11133,11107,26,2200,1692,508,0.975122013871021,0.925490196078431,5.56622670269521,227,101,126,1,1.2,16.5,3.3,0,0,0,0,0,0,7.05770390504004e-06,0.0762429037535782,0.0714142416310163
24.3,"greedy_SVM","SVM",11,22,11033,11009,24,2300,1790,510,0.980372585715491,0.925490196078431,5.642325775781,234,103,131,7,1.3,17.25,3.5,0,0,0,0,0,0,0.00290765794250424,0.597432437843916,0.371338192983057
24.3,"greedy_SVM","SVM",11,23,10933,10913,20,2400,1886,514,0.987766198182335,0.925490196078431,5.7170614379085,247,108,139,13,1.3,18,3.7,0,0,0,0,0,0,0.00312071128703307,0.704104630600728,0.403138103995578
24.3,"greedy_SVM","SVM",11,24,10833,10819,14,2500,1980,520,0.997228236272675,0.929411764705882,5.92404540763674,263,115,148,16,1.3,18.75,3.8,0,0,0,0,0,0,0.00840016482242005,8.43199702267255,1.09277134313855
24.3,"greedy_SVM","SVM",11,25,10733,10728,5,2600,2071,529,0.99931867943684,0.929411764705882,5.97401433691756,294,127,167,31,1.3,19.5,3.9,0,0,0,0,0,0,0.0167546473096173,14.3924081682677,2.4734633977717
24.3,"greedy_SVM","SVM",11,26,10633,10633,0,2700,2166,534,0.999592063899796,0.941176470588235,6.000900090009,307,132,175,13,1.3,20.25,4.1,0,0,0,0,0,0,0.0117236262026153,9.68115769562848,1.43238433136674
24.3,"greedy_SVM","SVM",11,27,10533,10533,0,2800,2266,534,0.999595121891551,0.945098039215686,5.99011680143756,307,132,175,0,1.3,21,4.2,0,0,0,0,0,0,0.00792160354142378,6.26808844694204,0.889397768107059
24.3,"greedy_SVM","SVM",11,28,10433,10433,0,2900,2366,534,0.999599403080009,0.945098039215686,5.99011680143756,307,132,175,0,1.3,21.75,4.4,0,0,0,0,0,0,0.00635425199467507,4.87289199089862,0.694206773240245
24.3,"greedy_SVM","SVM",11,29,10333,10333,0,3000,2466,534,0.999602461071765,0.945098039215686,5.97401433691756,308,132,176,1,1.3,22.5,4.6,0,0,0,0,0,0,0.00443795625773498,2.27883644184215,0.477521793367015
24.3,"greedy_SVM","SVM",11,30,10233,10233,0,3100,2566,534,0.999609800251979,0.945098039215686,5.99011680143756,308,133,175,0,1.3,23.25,4.8,0,0,0,0,0,0,0.00430656539829634,2.41818026020755,0.459241852862132
24.3,"greedy_SVM","SVM",11,31,10133,10133,0,3200,2666,534,0.999611635047032,0.941176470588235,5.99011680143756,309,133,176,1,1.3,24,5,0,0,0,0,0,0,0.00464797858888964,3.14501356107528,0.491193385287698
24.3,"greedy_SVM","SVM",11,32,10033,10033,0,3300,2766,534,0.999611635047032,0.941176470588235,5.98473967684022,310,134,176,1,1.3,24.75,5.2,0,0,0,0,0,0,0.00309218378374932,0.932177182654266,0.326561076303252
24.3,"greedy_SVM","SVM",11,33,9933,9933,0,3400,2866,534,0.999615304637139,0.937254901960784,5.97401433691756,312,136,176,2,1.3,25.5,5.4,0,0,0,0,0,0,1.68209109419616e-05,0.0969084666855391,0.0858960571288
24.3,"greedy_SVM","SVM",11,34,9833,9833,0,3500,2966,534,0.99962142062065,0.937254901960784,5.98473967684022,310,135,175,-2,1.3,26.25,5.6,0,0,0,0,0,0,1.60786183555852e-05,0.0688988671851374,0.0574065616306398
24.3,"greedy_SVM","SVM",11,35,9733,9733,0,3600,3066,534,0.999623867014054,0.937254901960784,5.95267857142857,312,135,177,2,1.3,27,5.7,0,0,0,0,0,0,1.10428070253393e-05,0.00896174567453181,0.0011961893876953
24.3,"greedy_SVM","SVM",11,36,9633,9633,0,3700,3166,534,0.99962692500581,0.937254901960784,5.95267857142857,315,136,179,3,1.3,27.75,5.9,0,0,0,0,0,0,0.0015962253820253,2.42299217015603,0.166946398402965
24.3,"greedy_SVM","SVM",11,37,9533,9533,0,3800,3266,534,0.999627536604161,0.937254901960784,5.92622222222222,315,136,179,0,1.3,28.5,6.1,0,0,0,0,0,0,0.0014171862914763,2.17379487788773,0.147818821734598
24.3,"greedy_SVM","SVM",11,38,9433,9433,0,3900,3366,534,0.999623255415703,0.937254901960784,5.9579982126899,312,135,177,-3,1.3,29.25,6.3,0,0,0,0,0,0,0.00140978875172796,2.23293389872358,0.147061095633204
24.3,"greedy_SVM","SVM",11,39,9333,9333,0,4000,3466,534,0.999630594595917,0.937254901960784,5.97401433691756,314,136,178,2,1.3,30,6.5,0,0,0,0,0,0,0.00172204407526322,3.03711350122473,0.178909558870243
24.3,"greedy_SVM","SVM",11,40,9233,9233,0,4100,3566,534,0.999630594595917,0.937254901960784,5.97401433691756,314,135,179,0,1.3,30.75,6.7,0,0,0,0,0,0,0.00156552444917371,2.6984506438913,0.161361144762794
24.3,"greedy_SVM","SVM",11,41,9133,9133,0,4200,3666,534,0.999634875784375,0.937254901960784,5.95267857142857,312,134,178,-2,1.3,31.5,6.9,0,0,0,0,0,0,0.00109764332599618,1.78157858136893,0.11274984504204
24.3,"greedy_SVM","SVM",11,42,9033,9033,0,4300,3766,534,0.999637933776131,0.937254901960784,5.9686660698299,314,134,180,2,1.3,32.25,7.1,0,0,0,0,0,0,0.00112783283667261,1.87917846684024,0.117253155531987
24.3,"greedy_SVM","SVM",11,43,8933,8933,0,4400,3866,534,0.999641909165413,0.937254901960784,5.9686660698299,315,134,181,1,1.4,33,7.2,0,0,0,0,0,0,0.00127150594901586,2.18176944060272,0.130830038049625
24.3,"greedy_SVM","SVM",11,44,8833,8833,0,4500,3966,534,0.999642214964588,0.937254901960784,5.9579982126899,313,134,179,-2,1.3,33.75,7.4,0,0,0,0,0,0,0.000880162237896476,1.42114585057518,0.0909566220780272
24.3,"greedy_SVM","SVM",11,45,8733,8733,0,4600,4066,534,0.999644049759642,0.937254901960784,5.96332737030411,311,134,177,-2,1.3,34.5,7.6,0,0,0,0,0,0,0.00074603710783698,1.17094506633147,0.0768681283598764
24.3,"greedy_SVM","SVM",11,46,8633,8633,0,4700,4166,534,0.999645884554695,0.937254901960784,5.97937219730942,314,135,179,3,1.3,35.25,7.8,0,0,0,0,0,0,0.000947781041071248,1.56344181492856,0.0976210378325467
24.3,"greedy_SVM","SVM",11,47,8533,8533,0,4800,4266,534,0.999644661357993,0.937254901960784,5.96332737030411,315,134,181,1,1.4,36,8,0,0,0,0,0,0,0.000667738425747005,1.03250414254307,0.0685086091291805
24.3,"greedy_SVM","SVM",11,48,8433,8433,0,4900,4366,534,0.99964282656294,0.937254901960784,5.9686660698299,314,134,180,-1,1.3,36.75,8.2,0,0,0,0,0,0,0.000675377470050833,1.03998818978683,0.0692960363446034
24.3,"greedy_SVM","SVM",12,0,13233,12703,530,100,95,5,0.977571394718627,0.822834645669291,5.7617630113309,24,5,19,0,3.8,0.75,19,0,0,0,0,0,0,0.973118704684217,866.444699156909,98.3428629319048
24.3,"greedy_SVM","SVM",12,1,13133,12703,430,200,95,105,0.976597732705809,0.818897637795276,5.72042300766216,57,20,37,33,1.8,1.5,0.9,0,0,0,0,0,0,0.959419853307251,555.565591578257,97.6114095028114
24.3,"greedy_SVM","SVM",12,2,13033,12703,330,300,95,205,0.974665142531571,0.818897637795276,5.69177743911043,66,25,41,9,1.6,2.25,0.5,0,0,0,0,0,0,0.888360240310251,433.281569669318,95.7516265735301
24.3,"greedy_SVM","SVM",12,3,12933,12702,231,400,96,304,0.974107711820545,0.822834645669291,5.64473795614258,87,31,56,21,1.8,3,0.3,0,0,0,0,0,0,0.768064875318192,405.077057089833,91.1339354559727
24.3,"greedy_SVM","SVM",12,4,12833,12698,135,500,100,400,0.978311156840598,0.858267716535433,5.75070508231926,102,38,64,15,1.7,3.75,0.2,0,0,0,0,0,0,0.250001856449883,205.048362894391,58.0656928721621
24.3,"greedy_SVM","SVM",12,5,12733,12661,72,600,137,463,0.962587681763595,0.897637795275591,5.47519367822979,130,59,71,28,1.2,4.5,0.3,0,0,0,0,0,0,0.0617893370571451,76.7746564809227,19.757787362454
24.3,"greedy_SVM","SVM",12,6,12633,12574,59,700,224,476,0.949865614997079,0.897637795275591,5.34251968503937,141,61,80,11,1.3,5.25,0.5,0,0,0,0,0,0,0.0163484010129059,31.2533408852408,2.19351054533736
24.3,"greedy_SVM","SVM",12,7,12533,12474,59,800,324,476,0.952736260376583,0.897637795275591,5.29101423671734,152,65,87,11,1.3,6,0.7,0,0,0,0,0,0,0.00828955154412157,14.6745575704449,1.02267034974322
24.3,"greedy_SVM","SVM",12,8,12433,12374,59,900,424,476,0.961291716751533,0.897637795275591,5.22697868585392,155,64,91,3,1.4,6.75,0.9,0,0,0,0,0,0,0.00488012776831941,6.02917136034043,0.753122883357202
24.3,"greedy_SVM","SVM",12,9,12333,12274,59,1000,524,476,0.96138011985987,0.897637795275591,5.2496062992126,156,65,91,1,1.4,7.5,1.1,0,0,0,0,0,0,0.00259447551552253,3.90790556432407,0.309532702736158
24.3,"greedy_SVM","SVM",12,10,12233,12174,59,1100,624,476,0.962121109802778,0.897637795275591,5.2359473062398,155,68,87,-1,1.3,8.25,1.3,0,0,0,0,0,0,0.00166546672102297,2.52160822198325,0.191829950765809
24.3,"greedy_SVM","SVM",12,11,12133,12075,58,1200,723,477,0.966834100516771,0.897637795275591,5.32239113525021,153,67,86,-2,1.3,9,1.5,0,0,0,0,0,0,0.00187255305093359,2.92044260501176,0.239299987287046
24.3,"greedy_SVM","SVM",12,12,12033,11982,51,1300,816,484,0.97203146659529,0.905511811023622,5.44083220083179,172,74,98,19,1.3,9.75,1.7,0,0,0,0,0,0,0.00384908275883714,6.02631268563297,0.581754655504459
24.3,"greedy_SVM","SVM",12,13,11933,11892,41,1400,906,494,0.973185618287665,0.929133858267717,5.42128017130389,194,84,110,22,1.3,10.5,1.8,0,0,0,0,0,0,0.00570799134582575,7.26613454366476,1.16686224451043
24.3,"greedy_SVM","SVM",12,14,11833,11799,34,1500,999,501,0.974215146153714,0.929133858267717,5.47588243279935,210,92,118,16,1.3,11.25,2,0,0,0,0,0,0,0.00463868276773585,6.16309294578813,0.668825913567526
24.3,"greedy_SVM","SVM",12,15,11733,11699,34,1600,1099,501,0.973745504640592,0.929133858267717,5.49008091793193,210,91,119,0,1.3,12,2.2,0,0,0,0,0,0,0.00320121468262011,4.99045446610284,0.373714438623102
24.3,"greedy_SVM","SVM",12,16,11633,11600,33,1700,1198,502,0.975640646275877,0.929133858267717,5.49008091793193,215,93,122,5,1.3,12.75,2.4,0,0,0,0,0,0,0.00260967108815797,4.45061102566711,0.280714031752929
24.3,"greedy_SVM","SVM",12,17,11533,11501,32,1800,1297,503,0.978176710446679,0.929133858267717,5.51390939413823,221,94,127,6,1.4,13.5,2.6,0,0,0,0,0,0,0.00320014296287416,6.52203231768701,0.364068983317243
24.3,"greedy_SVM","SVM",12,18,11433,11404,29,1900,1394,506,0.983730758510936,0.929133858267717,5.56430902262326,230,97,133,9,1.4,14.25,2.8,0,0,0,0,0,0,0.00441799336994051,10.2647409592863,0.503949541868298
24.3,"greedy_SVM","SVM",12,19,11333,11308,25,2000,1490,510,0.991289838185495,0.929133858267717,5.75837871587637,235,101,134,5,1.3,15,2.9,0,0,0,0,0,0,0.00765209988206648,14.4929746590948,0.940816256607182
24.3,"greedy_SVM","SVM",12,20,11233,11215,18,2100,1583,517,0.996696547735829,0.929133858267717,5.86392192997152,257,111,146,22,1.3,15.75,3.1,0,0,0,0,0,0,0.0115255708889784,18.9628546425938,1.61945980600963
24.3,"greedy_SVM","SVM",12,21,11133,11127,6,2200,1671,529,0.999300755969359,0.940944881889764,5.92622222222222,296,128,168,39,1.3,16.5,3.2,0,0,0,0,0,0,0.0166144736032238,21.6089259154184,2.32210587191093
24.3,"greedy_SVM","SVM",12,22,11033,11032,1,2300,1766,534,0.99946282833467,0.94488188976378,5.93149466192171,314,135,179,18,1.3,17.25,3.3,0,0,0,0,0,0,0.0137386314309876,16.1825241714805,1.80251040305618
24.3,"greedy_SVM","SVM",12,23,10933,10933,0,2400,1865,535,0.999486156932707,0.94488188976378,5.94736842105263,315,135,180,1,1.3,18,3.5,0,0,0,0,0,0,0.0113670786679231,15.6450775243702,1.29233219088547
24.3,"greedy_SVM","SVM",12,24,10833,10833,0,2500,1965,535,0.999494751679352,0.94488188976378,5.94206773618538,317,136,181,2,1.3,18.75,3.7,0,0,0,0,0,0,0.00858821504980925,12.3782879101304,0.946138600757428
24.3,"greedy_SVM","SVM",12,25,10733,10733,0,2600,2065,535,0.999505188157421,0.94488188976378,5.94206773618538,315,135,180,-2,1.3,19.5,3.9,0,0,0,0,0,0,0.00825076222653694,12.8252451669895,0.876953275327507
24.3,"greedy_SVM","SVM",12,26,10633,10633,0,2700,2165,535,0.999512555083117,0.94488188976378,5.93677649154052,315,133,182,0,1.4,20.25,4,0,0,0,0,0,0,0.00597470205415983,9.05477348572341,0.62837667604507
24.3,"greedy_SVM","SVM",12,27,10533,10533,0,2800,2265,535,0.99951685245644,0.94488188976378,5.93677649154052,316,133,183,1,1.4,21,4.2,0,0,0,0,0,0,0.00504097361611514,7.91632748423697,0.537899523669774
24.3,"greedy_SVM","SVM",12,28,10433,10433,0,2900,2365,535,0.999519922008813,0.94488188976378,5.93677649154052,318,133,185,2,1.4,21.75,4.4,0,0,0,0,0,0,0.00431018363121637,6.82883767608164,0.450017414867512
24.3,"greedy_SVM","SVM",12,29,10333,10333,0,3000,2465,535,0.999523605471661,0.94488188976378,5.93677649154052,315,131,184,-3,1.4,22.5,4.6,0,0,0,0,0,0,0.00360638658189978,5.62646158405428,0.377479446461697
24.3,"greedy_SVM","SVM",12,30,10233,10233,0,3100,2565,535,0.999528516755459,0.94488188976378,5.9052258635961,316,132,184,1,1.4,23.25,4.8,0,0,0,0,0,0,0.00307148316518452,4.84430434893063,0.324444836492663
24.3,"greedy_SVM","SVM",12,31,10133,10133,0,3200,2665,535,0.999528516755459,0.948818897637795,5.9052258635961,315,131,184,-1,1.4,24,5,0,0,0,0,0,0,0.00337470850138874,5.65929475608116,0.351150922639359
24.3,"greedy_SVM","SVM",12,32,10033,10033,0,3300,2765,535,0.999530358486883,0.948818897637795,5.9,317,132,185,2,1.4,24.75,5.2,0,0,0,0,0,0,0.00260522351570446,4.26399344515846,0.271919707031114
24.3,"greedy_SVM","SVM",12,33,9933,9933,0,3400,2865,535,0.999535883681155,0.948818897637795,5.894783377542,316,131,185,-1,1.4,25.5,5.4,0,0,0,0,0,0,0.00218333235451073,3.56590314516659,0.227424926904418
24.3,"greedy_SVM","SVM",12,34,9833,9833,0,3500,2965,535,0.999539567144002,0.948818897637795,5.894783377542,315,131,184,-1,1.4,26.25,5.5,0,0,0,0,0,0,0.0019527465500038,3.24148385450219,0.203411362666257
24.3,"greedy_SVM","SVM",12,35,9733,9733,0,3600,3065,535,0.999545706248749,0.948818897637795,5.8585237258348,314,130,184,-1,1.4,27,5.7,0,0,0,0,0,0,0.00160652898350676,2.58073038702022,0.166168394660086
24.3,"greedy_SVM","SVM",12,36,9633,9633,0,3700,3165,535,0.99955245926397,0.948818897637795,5.8277972027972,315,131,184,1,1.4,27.75,5.9,0,0,0,0,0,0,0.00134588144814125,2.15538902660855,0.141015069439138
24.3,"greedy_SVM","SVM",12,37,9533,9533,0,3800,3265,535,0.99955245926397,0.948818897637795,5.87918871252205,316,131,185,1,1.4,28.5,6.1,0,0,0,0,0,0,0.00138834918541669,2.30173708081943,0.14363955961637
24.3,"greedy_SVM","SVM",12,38,9433,9433,0,3900,3365,535,0.999549389711597,0.948818897637795,5.86883802816901,315,131,184,-1,1.4,29.25,6.3,0,0,0,0,0,0,0.00125585731794368,2.07589720045564,0.129596605655634
24.3,"greedy_SVM","SVM",12,39,9333,9333,0,4000,3465,535,0.999551845353496,0.948818897637795,5.86883802816901,313,131,182,-2,1.4,30,6.5,0,0,0,0,0,0,0.00118258939056581,1.96790141307578,0.122874697478863
24.3,"greedy_SVM","SVM",12,40,9233,9233,0,4100,3565,535,0.99955368708492,0.948818897637795,5.8277972027972,315,132,183,2,1.4,30.75,6.7,0,0,0,0,0,0,0.000894080229575698,1.43567309356856,0.0927067669145397
24.3,"greedy_SVM","SVM",12,41,9133,9133,0,4200,3665,535,0.999551845353496,0.948818897637795,5.85338015803336,316,132,184,1,1.4,31.5,6.9,0,0,0,0,0,0,0.000960008097359546,1.56941027093743,0.0996530791797638
24.3,"greedy_SVM","SVM",12,42,9033,9033,0,4300,3765,535,0.999551231443021,0.948818897637795,5.81762652705061,315,132,183,-1,1.4,32.25,7,0,0,0,0,0,0,0.000788903225817601,1.25688749601104,0.0820172150289899
24.3,"greedy_SVM","SVM",12,43,8933,8933,0,4400,3865,535,0.999553073174445,0.948818897637795,5.8585237258348,316,133,183,1,1.4,33,7.2,0,0,0,0,0,0,0.000872484610915425,1.42026218477037,0.0898208489900056
24.3,"greedy_SVM","SVM",12,44,8833,8833,0,4500,3965,535,0.999550003622072,0.948818897637795,5.83800350262697,318,132,186,2,1.4,33.75,7.4,0,0,0,0,0,0,0.000712769275622073,1.12439790678827,0.073403877850194
24.3,"greedy_SVM","SVM",12,45,8733,8733,0,4600,4065,535,0.999546934069699,0.948818897637795,5.83800350262697,319,132,187,1,1.4,34.5,7.6,0,0,0,0,0,0,0.000691471836348956,1.08157107355412,0.0714180903166048
24.3,"greedy_SVM","SVM",12,46,8633,8633,0,4700,4165,535,0.9995444784278,0.948818897637795,5.9,314,130,184,-5,1.4,35.25,7.8,0,0,0,0,0,0,0.000993983352914379,1.66825981179575,0.102167191185981
24.3,"greedy_SVM","SVM",12,47,8533,8533,0,4800,4265,535,0.999543864517325,0.948818897637795,5.894783377542,315,130,185,1,1.4,36,8,0,0,0,0,0,0,0.000720679692056979,1.14042495226403,0.0744561807687103
24.3,"greedy_SVM","SVM",12,48,8433,8433,0,4900,4365,535,0.999545092338274,0.948818897637795,5.894783377542,319,131,188,4,1.4,36.75,8.2,0,0,0,0,0,0,0.000661268933711657,1.03943750549885,0.0685819939025576
24.3,"greedy_SVM","SVM",13,0,13233,12733,500,100,95,5,0.961754704949107,0.809859154929577,5.18260391318241,20,5,15,0,3,0.75,19,0,0,0,0,0,0,0.993142913907211,714.28865952488,99.7676362479341
24.3,"greedy_SVM","SVM",13,1,13133,12733,400,200,95,105,0.968044795484471,0.809859154929577,5.43966308866414,45,16,29,25,1.8,1.5,0.9,0,0,0,0,0,0,0.949863580259523,518.647612944309,97.3983090766664
24.3,"greedy_SVM","SVM",13,2,13033,12733,300,300,95,205,0.970715015456972,0.827464788732394,5.46516133840077,60,22,38,15,1.7,2.25,0.5,0,0,0,0,0,0,0.933095884373834,378.036523817611,97.0367374078373
24.3,"greedy_SVM","SVM",13,3,12933,12733,200,400,95,305,0.977742374661561,0.827464788732394,5.62408613169701,71,30,41,11,1.4,3,0.3,0,0,0,0,0,0,0.742163186668488,279.403347461647,93.2451463372683
24.3,"greedy_SVM","SVM",13,4,12833,12717,116,500,111,389,0.958588283578944,0.873239436619718,5.4964631398759,97,40,57,26,1.4,3.75,0.3,0,0,0,0,0,0,0.0333422654969435,29.3730276832454,20.1538158441545
24.3,"greedy_SVM","SVM",13,5,12733,12662,71,600,166,434,0.940985407982916,0.901408450704225,5.34669941356323,123,59,64,26,1.1,4.5,0.4,0,0,0,0,0,0,0.0299050950841875,67.2089285572021,15.9889347089842
24.3,"greedy_SVM","SVM",13,6,12633,12575,58,700,253,447,0.946139944791731,0.901408450704225,5.29022019440587,143,63,80,20,1.3,5.25,0.6,0,0,0,0,0,0,0.00915682496538941,15.2609920640054,1.15339725178092
24.3,"greedy_SVM","SVM",13,7,12533,12475,58,800,353,447,0.953640612277769,0.901408450704225,5.24863767759395,152,67,85,9,1.3,6,0.8,0,0,0,0,0,0,0.00570912430227942,2.61907308736686,0.757972987206939
24.3,"greedy_SVM","SVM",13,8,12433,12375,58,900,453,447,0.954880150399482,0.901408450704225,5.24405771452449,148,67,81,-4,1.2,6.75,1,0,0,0,0,0,0,0.00286932849093058,0.463324705293752,0.333643184026631
24.3,"greedy_SVM","SVM",13,9,12333,12275,58,1000,553,447,0.955506814977264,0.901408450704225,5.23948573744121,146,66,80,-2,1.2,7.5,1.2,0,0,0,0,0,0,9.58576338332972e-06,0.0297382071603698,0.0256609119755456
24.3,"greedy_SVM","SVM",13,10,12233,12175,58,1100,653,447,0.955943163288026,0.901408450704225,5.24405771452449,144,65,79,-2,1.2,8.25,1.5,0,0,0,0,0,0,3.80661146531546e-06,0.00199950971283417,0.00046107665993605
24.3,"greedy_SVM","SVM",13,11,12133,12075,58,1200,753,447,0.956217329040807,0.901408450704225,5.24405771452449,148,66,82,4,1.2,9,1.7,0,0,0,0,0,0,2.40992022296645e-06,0.00123136018782482,0.000293007086023726
24.3,"greedy_SVM","SVM",13,12,12033,11975,58,1300,853,447,0.956472738987564,0.901408450704225,5.25782164553375,151,67,84,3,1.3,9.75,1.9,0,0,0,0,0,0,1.00029973870082e-06,0.000514630007975654,0.00012394242305177
24.3,"greedy_SVM","SVM",13,13,11933,11875,58,1400,953,447,0.957085612531501,0.901408450704225,5.25782164553375,151,68,83,0,1.2,10.5,2.1,0,0,0,0,0,0,7.96650694363696e-07,0.000429388968688505,0.000101994263379038
24.3,"greedy_SVM","SVM",13,14,11833,11775,58,1500,1053,447,0.956872678968982,0.901408450704225,5.25782164553375,153,68,85,2,1.2,11.25,2.4,0,0,0,0,0,0,2.76026394726358e-07,0.000152517918396741,3.41365179890409e-05
24.3,"greedy_SVM","SVM",13,15,11733,11676,57,1600,1152,448,0.95968715315549,0.901408450704225,5.32876090901236,153,69,84,0,1.2,12,2.6,0,0,0,0,0,0,6.80749061018924e-07,0.000453389682297459,0.000118775325445463
24.3,"greedy_SVM","SVM",13,16,11633,11580,53,1700,1248,452,0.97052359590724,0.901408450704225,5.45260838078114,172,75,97,19,1.3,12.75,2.8,0,0,0,0,0,0,1.66024616510052e-05,0.312888760794868,0.308139031680602
24.3,"greedy_SVM","SVM",13,17,11533,11492,41,1800,1336,464,0.98486240961355,0.908450704225352,5.69162622270032,196,90,106,24,1.2,13.5,2.9,0,0,0,0,0,0,0.00485960690144377,1.57478581239872,0.788376066038432
24.3,"greedy_SVM","SVM",13,18,11433,11403,30,1900,1425,475,0.991669663918003,0.919014084507042,5.77983691623425,224,104,120,28,1.2,14.25,3,0,0,0,0,0,0,0.00600071309453535,3.06721856353891,0.946916992537992
24.3,"greedy_SVM","SVM",13,19,11333,11314,19,2000,1514,486,0.996363028555167,0.936619718309859,5.89506161185163,256,113,143,32,1.3,15,3.1,0,0,0,0,0,0,0.00946259218369791,8.16417561040647,1.26093956303362
24.3,"greedy_SVM","SVM",13,20,11233,11220,13,2100,1608,492,0.998925402643024,0.943661971830986,5.97401433691756,272,120,152,16,1.3,15.75,3.3,0,0,0,0,0,0,0.0126371032961228,12.9798599253502,1.70613447743996
24.3,"greedy_SVM","SVM",13,21,11133,11127,6,2200,1701,499,0.999598956735872,0.954225352112676,5.9686660698299,294,131,163,22,1.2,16.5,3.4,0,0,0,0,0,0,0.0140465182226225,12.6691266897271,1.90785448193444
24.3,"greedy_SVM","SVM",13,22,11033,11032,1,2300,1796,504,0.999714249778792,0.957746478873239,5.9686660698299,311,140,171,17,1.2,17.25,3.6,0,0,0,0,0,0,0.0103414992260468,8.12208292256159,1.28814756006701
24.3,"greedy_SVM","SVM",13,23,10933,10933,0,2400,1895,505,0.999744590053244,0.957746478873239,5.97937219730942,310,138,172,-1,1.2,18,3.8,0,0,0,0,0,0,0.00756601089693898,5.70879223467984,0.844467565822354
24.3,"greedy_SVM","SVM",13,24,10833,10833,0,2500,1995,505,0.999754519597611,0.957746478873239,5.97937219730942,310,138,172,0,1.2,18.75,4,0,0,0,0,0,0,0.00679438113202415,5.67297440732518,0.729764280295469
24.3,"greedy_SVM","SVM",13,25,10733,10733,0,2600,2095,505,0.999766655707392,0.957746478873239,5.97937219730942,311,138,173,1,1.3,19.5,4.1,0,0,0,0,0,0,0.00502755192333627,3.23551599928178,0.538087418110505
24.3,"greedy_SVM","SVM",13,26,10633,10633,0,2700,2195,505,0.999772172120929,0.957746478873239,5.97937219730942,312,138,174,1,1.3,20.25,4.3,0,0,0,0,0,0,0.00446960167167019,2.54988758018115,0.471435909480516
24.3,"greedy_SVM","SVM",13,27,10533,10533,0,2800,2295,505,0.99977989509988,0.957746478873239,5.97401433691756,312,138,174,0,1.3,21,4.5,0,0,0,0,0,0,0.00380381338682246,1.84204684018922,0.404098279127954
24.3,"greedy_SVM","SVM",13,28,10433,10433,0,2900,2395,505,0.999788721361539,0.957746478873239,5.9686660698299,309,136,173,-3,1.3,21.75,4.7,0,0,0,0,0,0,0.00292509379607451,0.78722209793295,0.308095763706738
24.3,"greedy_SVM","SVM",13,29,10333,10333,0,3000,2495,505,0.999793686133722,0.961267605633803,5.96332737030411,310,135,175,1,1.3,22.5,4.9,0,0,0,0,0,0,1.83869496104484e-05,0.210364690755386,0.198597233925619
24.3,"greedy_SVM","SVM",13,30,10233,10233,0,3100,2595,505,0.999801960754028,0.961267605633803,5.9579982126899,313,135,178,3,1.3,23.25,5.1,0,0,0,0,0,0,1.81190962664755e-05,0.21193930098623,0.199287797900717
24.3,"greedy_SVM","SVM",13,31,10133,10133,0,3200,2695,505,0.999810235374333,0.961267605633803,5.95267857142857,313,135,178,0,1.3,24,5.3,0,0,0,0,0,0,1.25259835329742e-05,0.00965951154243324,0.001354758382749
24.3,"greedy_SVM","SVM",13,32,10033,10033,0,3300,2795,505,0.999816303429223,0.961267605633803,5.9579982126899,310,134,176,-3,1.3,24.75,5.5,0,0,0,0,0,0,1.12700594370288e-05,0.00907558296683391,0.00122413682571572
24.3,"greedy_SVM","SVM",13,33,9933,9933,0,3400,2895,505,0.999820716560053,0.961267605633803,5.95267857142857,311,133,178,1,1.3,25.5,5.7,0,0,0,0,0,0,7.52883418509039e-06,0.00589417460095165,0.000816115889902162
24.3,"greedy_SVM","SVM",13,34,9833,9833,0,3500,2995,505,0.999825129690882,0.964788732394366,5.94736842105263,311,133,178,0,1.3,26.25,5.9,0,0,0,0,0,0,7.08454863683145e-06,0.00554944574239848,0.000774690525603923
24.3,"greedy_SVM","SVM",13,35,9733,9733,0,3600,3095,505,0.999830094463065,0.964788732394366,5.95267857142857,309,132,177,-2,1.3,27,6.1,0,0,0,0,0,0,4.40612053816892e-06,0.00358266810638592,0.000486624517664208
24.3,"greedy_SVM","SVM",13,36,9633,9633,0,3700,3195,505,0.999831749387126,0.964788732394366,5.9579982126899,310,132,178,1,1.3,27.75,6.3,0,0,0,0,0,0,5.69931898886156e-06,0.00493366458778022,0.000614566600936478
24.3,"greedy_SVM","SVM",13,37,9533,9533,0,3800,3295,505,0.999832852669834,0.964788732394366,5.95267857142857,310,132,178,0,1.3,28.5,6.5,0,0,0,0,0,0,4.26333587926113e-06,0.00361087543874853,0.000454235595211627
24.3,"greedy_SVM","SVM",13,38,9433,9433,0,3900,3395,505,0.999837265800663,0.964788732394366,5.95267857142857,310,132,178,0,1.3,29.25,6.7,0,0,0,0,0,0,0.000969906006210191,1.56731666217865,0.101197430672029
24.3,"greedy_SVM","SVM",13,39,9333,9333,0,4000,3495,505,0.999839472366078,0.964788732394366,5.94736842105263,309,133,176,-1,1.3,30,6.9,0,0,0,0,0,0,0.000900505070434703,1.43600024691206,0.093083535871504
24.3,"greedy_SVM","SVM",13,40,9233,9233,0,4100,3595,505,0.999840575648785,0.964788732394366,5.88437775816417,310,134,176,1,1.3,30.75,7.1,0,0,0,0,0,0,0.000676977292020547,1.04574064349332,0.0703025026909383
24.3,"greedy_SVM","SVM",13,41,9133,9133,0,4200,3695,505,0.999843333855554,0.964788732394366,5.9104609929078,310,134,176,0,1.3,31.5,7.3,0,0,0,0,0,0,0.000608662781007044,0.948283406061321,0.0630967113164187
24.3,"greedy_SVM","SVM",13,42,9033,9033,0,4300,3795,505,0.999844437138261,0.964788732394366,5.8585237258348,310,133,177,0,1.3,32.25,7.5,0,0,0,0,0,0,0.000513066528326654,0.784720132822527,0.0534253356985622
24.3,"greedy_SVM","SVM",13,43,8933,8933,0,4400,3895,505,0.999845540420969,0.964788732394366,5.94736842105263,307,133,174,-3,1.3,33,7.7,0,0,0,0,0,0,0.000615287155067466,0.99812176714118,0.063549074482237
24.3,"greedy_SVM","SVM",13,44,8833,8833,0,4500,3995,505,0.999846092062322,0.964788732394366,5.94736842105263,308,134,174,1,1.3,33.75,7.9,0,0,0,0,0,0,0.000602428686416553,0.99275016553898,0.0627999682845085
24.3,"greedy_SVM","SVM",13,45,8733,8733,0,4600,4095,505,0.999847746986383,0.964788732394366,5.94736842105263,308,134,174,0,1.3,34.5,8.1,0,0,0,0,0,0,0.000533152492798087,0.890404838834445,0.0556976839667739
24.3,"greedy_SVM","SVM",13,46,8633,8633,0,4700,4195,505,0.999847471165706,0.964788732394366,5.94206773618538,307,133,174,-1,1.3,35.25,8.3,0,0,0,0,0,0,0.000473959386943069,0.779855226598077,0.0486965924746566
24.3,"greedy_SVM","SVM",13,47,8533,8533,0,4800,4295,505,0.999848298627737,0.964788732394366,5.8277972027972,308,133,175,1,1.3,36,8.5,0,0,0,0,0,0,0.000338054056663851,0.52963162030059,0.0350319831205821
24.3,"greedy_SVM","SVM",13,48,8433,8433,0,4900,4395,505,0.999847746986383,0.964788732394366,5.832895888014,307,133,174,-1,1.3,36.75,8.7,0,0,0,0,0,0,0.000335838405168052,0.533511660760231,0.0348717965171897
24.3,"greedy_SVM","SVM",14,0,13233,12705,528,100,93,7,0.961838097073939,0.803149606299213,5.39374960769408,22,7,15,0,2.1,0.75,13.3,0,0,0,0,0,0,0.999999457535359,706.063653728975,99.9999859481965
24.3,"greedy_SVM","SVM",14,1,13133,12705,428,200,93,107,0.961807401550192,0.791338582677165,5.27738199391743,36,13,23,14,1.8,1.5,0.9,0,0,0,0,0,0,0.965725860889064,473.347376837993,97.9954568158707
24.3,"greedy_SVM","SVM",14,2,13033,12705,328,300,93,207,0.956311061070537,0.783464566929134,5.21728682331595,66,24,42,30,1.8,2.25,0.4,0,0,0,0,0,0,0.943674568848362,304.854542584392,97.2010926842661
24.3,"greedy_SVM","SVM",14,3,12933,12705,228,400,93,307,0.955203566574279,0.807086614173228,5.27283464566929,69,22,47,3,2.1,3,0.3,0,0,0,0,0,0,0.721525014183329,257.895564425178,91.7689602900592
24.3,"greedy_SVM","SVM",14,4,12833,12694,139,500,104,396,0.950687641122669,0.850393700787402,5.315167840862,94,37,57,25,1.5,3.75,0.3,0,0,0,0,0,0,0.0444283253878971,49.7870629337778,39.0592813081753
24.3,"greedy_SVM","SVM",14,5,12733,12656,77,600,142,458,0.940278175114296,0.881889763779528,5.31575795374813,128,54,74,34,1.4,4.5,0.3,0,0,0,0,0,0,0.0352770353022098,49.7273621917083,25.1369155283136
24.3,"greedy_SVM","SVM",14,6,12633,12578,55,700,220,480,0.939800552764989,0.881889763779528,5.08682780931453,145,68,77,17,1.1,5.25,0.5,0,0,0,0,0,0,0.0136194224158036,19.7171304487854,1.97554949852538
24.3,"greedy_SVM","SVM",14,7,12533,12479,54,800,319,481,0.94638412869529,0.881889763779528,5.17213815069991,157,71,86,12,1.2,6,0.7,0,0,0,0,0,0,0.00758076134996653,9.44481702098052,0.981594518752094
24.3,"greedy_SVM","SVM",14,8,12433,12382,51,900,416,484,0.9562134493051,0.881889763779528,5.26777102689153,163,72,91,6,1.3,6.75,0.9,0,0,0,0,0,0,0.00649878447488998,4.38559650397432,0.916557326213862
24.3,"greedy_SVM","SVM",14,9,12333,12287,46,1000,511,489,0.963165371520183,0.893700787401575,5.36839634601811,181,77,104,18,1.4,7.5,1,0,0,0,0,0,0,0.00602465052107296,4.07835841194649,0.865828870033113
24.3,"greedy_SVM","SVM",14,10,12233,12194,39,1100,604,496,0.965600140462724,0.901574803149606,5.56004197621811,197,86,111,16,1.3,8.25,1.2,0,0,0,0,0,0,0.00772179090209897,5.96177839649152,1.17060967295174
24.3,"greedy_SVM","SVM",14,11,12133,12103,30,1200,695,505,0.966125033918544,0.925196850393701,5.59460706843261,228,98,130,31,1.3,9,1.4,0,0,0,0,0,0,0.0096500103286539,5.01829410496823,1.99988156071177
24.3,"greedy_SVM","SVM",14,12,12033,12009,24,1300,789,511,0.967082734259014,0.929133858267717,5.61956071280564,242,105,137,14,1.3,9.75,1.5,0,0,0,0,0,0,0.00773252875383079,4.81831613731776,1.05183539152355
24.3,"greedy_SVM","SVM",14,13,11933,11909,24,1400,889,511,0.967088873363765,0.929133858267717,5.61956071280564,245,106,139,3,1.3,10.5,1.7,0,0,0,0,0,0,0.00542883734990309,3.12653645497918,0.622706368797828
24.3,"greedy_SVM","SVM",14,14,11833,11809,24,1500,989,511,0.967013362375384,0.933070866141732,5.60456188528035,243,106,137,-2,1.3,11.25,1.9,0,0,0,0,0,0,0.00417903608806365,1.91636222226192,0.452076874802476
24.3,"greedy_SVM","SVM",14,15,11733,11709,24,1600,1089,511,0.967055108287662,0.933070866141732,5.60456188528035,239,105,134,-4,1.3,12,2.1,0,0,0,0,0,0,0.00345738759473146,1.26824117525497,0.36951314856682
24.3,"greedy_SVM","SVM",14,16,11633,11609,24,1700,1189,511,0.966949515686021,0.933070866141732,5.60456188528035,239,105,134,0,1.3,12.75,2.3,0,0,0,0,0,0,0.00279538198001852,0.558429495031474,0.294026635684386
24.3,"greedy_SVM","SVM",14,17,11533,11509,24,1800,1289,511,0.9669040863109,0.933070866141732,5.60456188528035,241,104,137,2,1.3,13.5,2.5,0,0,0,0,0,0,1.33586948626194e-05,0.00969302012057215,0.00150825353640907
24.3,"greedy_SVM","SVM",14,18,11433,11409,24,1900,1389,511,0.966892422011885,0.933070866141732,5.59958005249344,240,104,136,-1,1.3,14.25,2.7,0,0,0,0,0,0,1.50042346816502e-05,0.0223628347094784,0.01173120826821
24.3,"greedy_SVM","SVM",14,19,11333,11309,24,2000,1489,511,0.966967319089794,0.933070866141732,5.59958005249344,241,104,137,1,1.3,15,2.9,0,0,0,0,0,0,0.00134923132353976,2.19103105968267,0.14345385144244
24.3,"greedy_SVM","SVM",14,20,11233,11209,24,2100,1589,511,0.966983280762135,0.933070866141732,5.59958005249344,239,104,135,-2,1.3,15.75,3.1,0,0,0,0,0,0,0.0015719028681732,2.83192398752684,0.165987069516775
24.3,"greedy_SVM","SVM",14,21,11133,11109,24,2200,1689,511,0.967083962079978,0.933070866141732,5.59958005249344,240,105,135,1,1.3,16.5,3.3,0,0,0,0,0,0,0.00135852059957032,2.43150169477004,0.14231067096686
24.3,"greedy_SVM","SVM",14,22,11033,11009,24,2300,1789,511,0.967150878321718,0.933070866141732,5.59958005249344,241,106,135,1,1.3,17.25,3.5,0,0,0,0,0,0,0.00120853616090024,2.19151489752514,0.126101488452429
24.3,"greedy_SVM","SVM",14,23,10933,10909,24,2400,1889,511,0.967104835036119,0.933070866141732,5.60456188528035,242,107,135,1,1.3,18,3.7,0,0,0,0,0,0,0.00103565540662106,1.90853068171585,0.108681240746007
24.3,"greedy_SVM","SVM",14,24,10833,10809,24,2500,1989,511,0.967120796708459,0.929133858267717,5.60456188528035,244,108,136,2,1.3,18.75,3.9,0,0,0,0,0,0,0.00101024199644269,1.87364073985333,0.105629191383395
24.3,"greedy_SVM","SVM",14,25,10733,10709,24,2600,2089,511,0.967210427637757,0.929133858267717,5.60955259043198,242,107,135,-2,1.3,19.5,4.1,0,0,0,0,0,0,0.000788459362579832,1.44321029413139,0.0827117450507745
24.3,"greedy_SVM","SVM",14,26,10633,10609,24,2700,2189,511,0.967269976953798,0.929133858267717,5.60955259043198,243,108,135,1,1.2,20.25,4.3,0,0,0,0,0,0,0.000744753855592743,1.39335009532815,0.0769658844464367
24.3,"greedy_SVM","SVM",14,27,10533,10509,24,2800,2289,511,0.967416087646766,0.929133858267717,5.60955259043198,244,109,135,1,1.2,21,4.5,0,0,0,0,0,0,0.000791592759860572,1.51639598553898,0.0813157830105247
24.3,"greedy_SVM","SVM",14,28,10433,10409,24,2900,2389,511,0.967487301261824,0.929133858267717,5.60955259043198,243,108,135,-1,1.2,21.75,4.7,0,0,0,0,0,0,0.000581161122619109,1.0599869860463,0.0604390674142274
24.3,"greedy_SVM","SVM",14,29,10333,10309,24,3000,2489,511,0.967726112436464,0.929133858267717,5.60955259043198,245,110,135,2,1.2,22.5,4.9,0,0,0,0,0,0,0.000691472144102669,1.30086962249451,0.0713916891020789
24.3,"greedy_SVM","SVM",14,30,10233,10209,24,3100,2589,511,0.968044118062332,0.929133858267717,5.60456188528035,247,111,136,2,1.2,23.25,5.1,0,0,0,0,0,0,0.000649473581369817,1.21241657989795,0.0673833800529325
24.3,"greedy_SVM","SVM",14,31,10133,10109,24,3200,2689,511,0.968233816399002,0.929133858267717,5.60456188528035,250,112,138,3,1.2,24,5.3,0,0,0,0,0,0,0.000538971584547024,0.963087178968702,0.0555573244730264
24.3,"greedy_SVM","SVM",14,32,10033,10009,24,3300,2789,511,0.968343092463492,0.929133858267717,5.60456188528035,253,112,141,3,1.3,24.75,5.5,0,0,0,0,0,0,0.000785712201094343,1.50448054824891,0.0814338299244647
24.3,"greedy_SVM","SVM",14,33,9933,9909,24,3400,2889,511,0.96865373116367,0.929133858267717,5.60456188528035,250,111,139,-3,1.3,25.5,5.7,0,0,0,0,0,0,0.000503856210085277,0.899473718920328,0.0525510420230492
24.3,"greedy_SVM","SVM",14,34,9833,9809,24,3500,2989,511,0.968777127169076,0.929133858267717,5.60456188528035,250,112,138,0,1.2,26.25,5.8,0,0,0,0,0,0,0.000498200834033264,0.886005727174169,0.0515250989522951
24.3,"greedy_SVM","SVM",14,35,9733,9710,23,3600,3088,512,0.979394094917914,0.925196850393701,5.65629886201892,249,111,138,-1,1.2,27,6,0,0,0,0,0,0,0.00063590482417903,1.17951213715821,0.102360865701348
24.3,"greedy_SVM","SVM",14,36,9633,9614,19,3700,3184,516,0.992976250259385,0.929133858267717,5.86417146918297,262,116,146,13,1.3,27.75,6.2,0,0,0,0,0,0,0.000867988095687404,1.93000049775876,0.60232214187024
24.3,"greedy_SVM","SVM",14,37,9533,9527,6,3800,3271,529,0.999665418791309,0.948818897637795,5.95267857142857,309,129,180,47,1.4,28.5,6.2,0,0,0,0,0,0,0.00137395224981476,3.49872932882136,1.79315538387553
24.3,"greedy_SVM","SVM",14,38,9433,9433,0,3900,3365,535,0.999713917718807,0.948818897637795,5.94736842105263,314,138,176,5,1.3,29.25,6.3,0,0,0,0,0,0,0.00118440417848288,1.56413219485805,0.153464704881705
24.3,"greedy_SVM","SVM",14,39,9333,9333,0,4000,3465,535,0.999709620345484,0.948818897637795,5.9052258635961,313,138,175,-1,1.3,30,6.5,0,0,0,0,0,0,0.000840303913152605,1.14157652663155,0.0920463905791569
24.3,"greedy_SVM","SVM",14,40,9233,9233,0,4100,3565,535,0.999709620345484,0.948818897637795,5.9104609929078,313,138,175,0,1.3,30.75,6.7,0,0,0,0,0,0,0.000783015606742178,1.17332896137985,0.0847655296242128
24.3,"greedy_SVM","SVM",14,41,9133,9133,0,4200,3665,535,0.99970777861406,0.948818897637795,5.92095914742451,316,138,178,3,1.3,31.5,6.9,0,0,0,0,0,0,0.000725159321356832,1.13488959386936,0.0765075164709281
24.3,"greedy_SVM","SVM",14,42,9033,9033,0,4300,3765,535,0.999708392524535,0.948818897637795,5.92095914742451,316,138,178,0,1.3,32.25,7,0,0,0,0,0,0,0.000577042744473251,0.916795697553824,0.0605310981918902
24.3,"greedy_SVM","SVM",14,43,8933,8933,0,4400,3865,535,0.999702867330263,0.948818897637795,5.93149466192171,315,138,177,-1,1.3,33,7.2,0,0,0,0,0,0,0.000736478370869074,1.25359136412417,0.0764165128796193
24.3,"greedy_SVM","SVM",14,44,8833,8833,0,4500,3965,535,0.999702253419788,0.948818897637795,5.93149466192171,315,138,177,0,1.3,33.75,7.4,0,0,0,0,0,0,0.000711068591030054,1.18567916745691,0.0733757096991064
24.3,"greedy_SVM","SVM",14,45,8733,8733,0,4600,4065,535,0.999702253419788,0.948818897637795,5.88437775816417,317,139,178,2,1.3,34.5,7.6,0,0,0,0,0,0,0.000485013838825895,0.763021738729986,0.0503773831078631
24.3,"greedy_SVM","SVM",14,46,8633,8633,0,4700,4165,535,0.999700411688364,0.948818897637795,5.91570541259982,318,140,178,1,1.3,35.25,7.8,0,0,0,0,0,0,0.000505102266699865,0.822605618656656,0.0524151115137232
24.3,"greedy_SVM","SVM",14,47,8533,8533,0,4800,4265,535,0.999700411688364,0.948818897637795,5.9052258635961,318,139,179,0,1.3,36,8,0,0,0,0,0,0,0.000383953817144593,0.623039976698147,0.0399583174599048
24.3,"greedy_SVM","SVM",14,48,8433,8433,0,4900,4365,535,0.999701639509314,0.948818897637795,5.92095914742451,317,139,178,-1,1.3,36.75,8.2,0,0,0,0,0,0,0.000515182786472119,0.896696657682995,0.0533889706022171
24.3,"greedy_SVM","SVM",15,0,13233,12707,526,100,95,5,0.960141443536872,0.779069767441861,5.42055314913719,25,5,20,0,4,0.75,19,0,0,0,0,0,0,0.995422038605488,673.53723576772,99.8947867982168
24.3,"greedy_SVM","SVM",15,1,13133,12706,427,200,96,104,0.969999794378283,0.786821705426357,5.53737541528239,46,17,29,21,1.7,1.5,0.9,0,0,0,0,0,0,0.850230338812412,364.595823139165,91.8341498536476
24.3,"greedy_SVM","SVM",15,2,13033,12705,328,300,97,203,0.967529914933067,0.806201550387597,5.48919543117102,64,26,38,18,1.5,2.25,0.5,0,0,0,0,0,0,0.859374951255295,344.332993869065,92.6448875937614
24.3,"greedy_SVM","SVM",15,3,12933,12705,228,400,97,303,0.96890395168613,0.86046511627907,5.51900101722263,81,34,47,17,1.4,3,0.3,0,0,0,0,0,0,0.775067173253983,298.216272359434,91.6777959855561
24.3,"greedy_SVM","SVM",15,4,12833,12703,130,500,99,401,0.970477562439422,0.868217054263566,5.51401096205335,99,41,58,18,1.4,3.75,0.2,0,0,0,0,0,0,0.304930529218394,176.359835509324,69.3060139148522
24.3,"greedy_SVM","SVM",15,5,12733,12665,68,600,137,463,0.971798379459097,0.891472868217054,5.48979500430663,125,59,66,26,1.1,4.5,0.3,0,0,0,0,0,0,0.0503069234913955,45.5439818305837,18.0148423021457
24.3,"greedy_SVM","SVM",15,6,12633,12575,58,700,227,473,0.955719367507663,0.891472868217054,5.40646819506295,142,68,74,17,1.1,5.25,0.5,0,0,0,0,0,0,0.00701172149319069,9.55284779797344,1.51815692718061
24.3,"greedy_SVM","SVM",15,7,12533,12475,58,800,327,473,0.954723311815617,0.891472868217054,5.26769279809016,149,68,81,7,1.2,6,0.7,0,0,0,0,0,0,0.00336500352521067,5.47382992535831,0.43636356835016
24.3,"greedy_SVM","SVM",15,8,12433,12375,58,900,427,473,0.959891673651769,0.891472868217054,5.34094550462594,151,66,85,2,1.3,6.75,0.9,0,0,0,0,0,0,0.00158061684476351,1.84317145841982,0.243270738624682
24.3,"greedy_SVM","SVM",15,9,12333,12275,58,1000,527,473,0.96108125564705,0.891472868217054,5.34955800353597,148,65,83,-3,1.3,7.5,1.1,0,0,0,0,0,0,0.00150447030526403,1.8097930127079,0.168073377992465
24.3,"greedy_SVM","SVM",15,10,12233,12175,58,1100,627,473,0.962553265091133,0.891472868217054,5.34486952149957,147,66,81,-1,1.2,8.25,1.3,0,0,0,0,0,0,0.000672171182082806,0.722066053011819,0.0856050042481254
24.3,"greedy_SVM","SVM",15,11,12133,12075,58,1200,727,473,0.963087276734159,0.891472868217054,5.34486952149957,149,68,81,2,1.2,9,1.5,0,0,0,0,0,0,0.000488850527210825,0.575039093812479,0.0549168982069348
24.3,"greedy_SVM","SVM",15,12,12033,11975,58,1300,827,473,0.964165581105074,0.891472868217054,5.34018925046498,150,68,82,1,1.2,9.75,1.7,0,0,0,0,0,0,0.000314940794722278,0.379893267670975,0.0352499286444549
24.3,"greedy_SVM","SVM",15,13,11933,11875,58,1400,927,473,0.964688102123845,0.891472868217054,5.34018925046498,150,70,80,0,1.1,10.5,2,0,0,0,0,0,0,0.000251890906239061,0.324290960479204,0.0278054809566598
24.3,"greedy_SVM","SVM",15,14,11833,11777,56,1500,1025,475,0.972947441884643,0.891472868217054,5.39861833902532,159,72,87,9,1.2,11.25,2.2,0,0,0,0,0,0,0.000763970692343632,1.15542983499314,0.112204102120456
24.3,"greedy_SVM","SVM",15,15,11733,11685,48,1600,1117,483,0.981953672222064,0.903100775193798,5.57623419012648,180,79,101,21,1.3,12,2.3,0,0,0,0,0,0,0.00241415954011338,3.87670837414271,0.501030293126467
24.3,"greedy_SVM","SVM",15,16,11633,11600,33,1700,1202,498,0.983120272968829,0.930232558139535,5.58420652844751,207,94,113,27,1.2,12.75,2.4,0,0,0,0,0,0,0.00428109035228215,4.58948532796915,1.49792695161835
24.3,"greedy_SVM","SVM",15,17,11533,11503,30,1800,1299,501,0.981738978979387,0.930232558139535,5.56473239931605,217,99,118,10,1.2,13.5,2.6,0,0,0,0,0,0,0.00241608523948001,2.48970410407835,0.310681474761785
24.3,"greedy_SVM","SVM",15,18,11433,11403,30,1900,1399,501,0.981530938203395,0.930232558139535,5.57445245590874,219,101,118,2,1.2,14.25,2.8,0,0,0,0,0,0,0.0014752541598016,1.79762802108176,0.175406928156418
24.3,"greedy_SVM","SVM",15,19,11333,11305,28,2000,1497,503,0.984789437334353,0.930232558139535,5.61468606680466,225,103,122,6,1.2,15,3,0,0,0,0,0,0,0.001916094521447,3.17946999200822,0.248112008254605
24.3,"greedy_SVM","SVM",15,20,11233,11208,25,2100,1594,506,0.989216956290866,0.930232558139535,5.71463647850288,235,106,129,10,1.2,15.75,3.2,0,0,0,0,0,0,0.00335739719474645,5.91828611739906,0.405423569202139
24.3,"greedy_SVM","SVM",15,21,11133,11112,21,2200,1690,510,0.993489049435074,0.934108527131783,5.7907835018985,242,110,132,7,1.2,16.5,3.3,0,0,0,0,0,0,0.00726219565505278,8.48659578470155,0.932235795928677
24.3,"greedy_SVM","SVM",15,22,11033,11016,17,2300,1786,514,0.996318162080696,0.934108527131783,5.86252379375983,255,115,140,13,1.2,17.25,3.5,0,0,0,0,0,0,0.00800287853825916,10.1448239039469,1.13445426094954
24.3,"greedy_SVM","SVM",15,23,10933,10924,9,2400,1878,522,0.998439089410361,0.937984496124031,5.9579982126899,274,123,151,19,1.2,18,3.6,0,0,0,0,0,0,0.010341673239491,12.2937668561817,1.4156417961232
24.3,"greedy_SVM","SVM",15,24,10833,10829,4,2500,1973,527,0.999376482441722,0.934108527131783,5.96332737030411,290,129,161,16,1.2,18.75,3.7,0,0,0,0,0,0,0.00846033431073363,9.80345954444472,1.12230188697966
24.3,"greedy_SVM","SVM",15,25,10733,10733,0,2600,2069,531,0.999551260884343,0.937984496124031,6.000900090009,303,133,170,13,1.3,19.5,3.9,0,0,0,0,0,0,0.00921846906117639,11.8423462373679,1.33314698892236
24.3,"greedy_SVM","SVM",15,26,10633,10633,0,2700,2169,531,0.999562751508598,0.937984496124031,6.00630630630631,302,132,170,-1,1.3,20.25,4.1,0,0,0,0,0,0,0.00576927596840648,7.36541257675527,0.640007700390034
24.3,"greedy_SVM","SVM",15,27,10533,10533,0,2800,2269,531,0.999574242132853,0.937984496124031,5.9686660698299,308,134,174,6,1.3,21,4.3,0,0,0,0,0,0,0.00500423650634112,6.6812200110554,0.536928307198386
24.3,"greedy_SVM","SVM",15,28,10433,10433,0,2900,2369,531,0.999579685060132,0.937984496124031,5.9686660698299,309,133,176,1,1.3,21.75,4.5,0,0,0,0,0,0,0.00452255289254857,6.43966584214295,0.477421224900027
24.3,"greedy_SVM","SVM",15,29,10333,10333,0,3000,2469,531,0.999588151835899,0.937984496124031,5.94736842105263,310,134,176,1,1.3,22.5,4.6,0,0,0,0,0,0,0.00338391756977157,4.70143458412819,0.359653134223764
24.3,"greedy_SVM","SVM",15,30,10233,10233,0,3100,2569,531,0.999589966144992,0.937984496124031,5.94736842105263,312,134,178,2,1.3,23.25,4.8,0,0,0,0,0,0,0.00273857233100473,3.91875643136912,0.290913863539361
24.3,"greedy_SVM","SVM",15,31,10133,10133,0,3200,2669,531,0.999596013841969,0.937984496124031,5.87918871252205,306,132,174,-6,1.3,24,5,0,0,0,0,0,0,0.00197756445010949,2.74856258161241,0.208261336573728
24.3,"greedy_SVM","SVM",15,32,10033,10033,0,3300,2769,531,0.999599642460155,0.937984496124031,5.95267857142857,310,133,177,4,1.3,24.75,5.2,0,0,0,0,0,0,0.00227824110259299,3.51219795668826,0.23842669219329
24.3,"greedy_SVM","SVM",15,33,9933,9933,0,3400,2869,531,0.999605085387434,0.937984496124031,5.9,309,132,177,-1,1.3,25.5,5.4,0,0,0,0,0,0,0.00166342938404678,2.47595738222505,0.174532432437651
24.3,"greedy_SVM","SVM",15,34,9833,9833,0,3500,2969,531,0.999612342623805,0.937984496124031,5.94206773618538,308,133,175,-1,1.3,26.25,5.6,0,0,0,0,0,0,0.00180359543324163,2.860660299244,0.187681168152865
24.3,"greedy_SVM","SVM",15,35,9733,9733,0,3600,3069,531,0.999617785551084,0.937984496124031,5.92622222222222,306,132,174,-2,1.3,27,5.8,0,0,0,0,0,0,0.00140800348874971,2.18032671019556,0.147275145450196
24.3,"greedy_SVM","SVM",15,36,9633,9633,0,3700,3169,531,0.999619599860177,0.941860465116279,5.92622222222222,306,132,174,0,1.3,27.75,6,0,0,0,0,0,0,0.00120985575769527,1.87970403032546,0.126072331938511
24.3,"greedy_SVM","SVM",15,37,9533,9533,0,3800,3269,531,0.999622018938968,0.941860465116279,5.93149466192171,308,133,175,2,1.3,28.5,6.2,0,0,0,0,0,0,0.00121471200250808,1.90147572635106,0.125882521395027
24.3,"greedy_SVM","SVM",15,38,9433,9433,0,3900,3369,531,0.999623833248061,0.941860465116279,5.94206773618538,306,132,174,-2,1.3,29.25,6.3,0,0,0,0,0,0,0.00132472248337253,2.12488264849256,0.136788049852751
24.3,"greedy_SVM","SVM",15,39,9333,9333,0,4000,3469,531,0.999625647557154,0.941860465116279,5.9,307,133,174,1,1.3,30,6.5,0,0,0,0,0,0,0.000979413991363842,1.48092265217325,0.101141071784971
24.3,"greedy_SVM","SVM",15,40,9233,9233,0,4100,3569,531,0.999626252326851,0.941860465116279,5.94206773618538,306,132,174,-1,1.3,30.75,6.7,0,0,0,0,0,0,0.0010088912812714,1.576658717483,0.10445040738301
24.3,"greedy_SVM","SVM",15,41,9133,9133,0,4200,3669,531,0.999628671405642,0.941860465116279,5.894783377542,308,133,175,2,1.3,31.5,6.9,0,0,0,0,0,0,0.000725326101204819,1.08501843554443,0.0753696359888591
24.3,"greedy_SVM","SVM",15,42,9033,9033,0,4300,3769,531,0.999623833248061,0.941860465116279,5.88437775816417,310,133,177,2,1.3,32.25,7.1,0,0,0,0,0,0,0.000669098653098052,0.986181469784842,0.0696227607677346
24.3,"greedy_SVM","SVM",15,43,8933,8933,0,4400,3869,531,0.999622018938968,0.941860465116279,5.84312007011393,308,132,176,-2,1.3,33,7.3,0,0,0,0,0,0,0.000557427583862269,0.805792397477202,0.0578296380445397
24.3,"greedy_SVM","SVM",15,44,8833,8833,0,4500,3969,531,0.99963169525413,0.941860465116279,5.9,308,132,176,0,1.3,33.75,7.5,0,0,0,0,0,0,0.000592266598565761,0.876811494436693,0.0616101937150572
24.3,"greedy_SVM","SVM",15,45,8733,8733,0,4600,4069,531,0.999632300023828,0.941860465116279,5.9579982126899,308,132,176,0,1.3,34.5,7.7,0,0,0,0,0,0,0.000736619896693928,1.16959368508911,0.0763467819920532
24.3,"greedy_SVM","SVM",15,46,8633,8633,0,4700,4169,531,0.99962927617534,0.941860465116279,5.94206773618538,308,132,176,0,1.3,35.25,7.9,0,0,0,0,0,0,0.000558669045840704,0.847211372183013,0.0577704358018361
24.3,"greedy_SVM","SVM",15,47,8533,8533,0,4800,4269,531,0.999631090484433,0.941860465116279,5.8277972027972,308,132,176,0,1.3,36,8,0,0,0,0,0,0,0.000419432228233642,0.604268387222954,0.0434832991427994
24.3,"greedy_SVM","SVM",15,48,8433,8433,0,4900,4369,531,0.999635323872316,0.945736434108527,5.94206773618538,307,132,175,-1,1.3,36.75,8.2,0,0,0,0,0,0,0.000578883481094615,0.898644440540642,0.0599076424369524
24.3,"greedy_SVM","SVM",16,0,13233,12719,514,100,94,6,0.956111982020414,0.828996282527881,5.16789990278374,29,6,23,0,3.8,0.75,15.7,0,0,0,0,0,0,0.927323304247768,791.535966640891,95.53578732042
24.3,"greedy_SVM","SVM",16,1,13133,12719,414,200,94,106,0.962294211364832,0.802973977695167,5.4372795309762,49,16,33,20,2.1,1.5,0.9,0,0,0,0,0,0,0.948700499380263,584.976627577086,96.8635109326077
24.3,"greedy_SVM","SVM",16,2,13033,12719,314,300,94,206,0.962422329933481,0.836431226765799,5.34016323287654,66,22,44,17,2,2.25,0.5,0,0,0,0,0,0,0.940412031269755,499.062514351633,96.9520121037647
24.3,"greedy_SVM","SVM",16,3,12933,12719,214,400,94,306,0.962747419907049,0.840148698884758,5.27556448409174,74,24,50,8,2.1,3,0.3,0,0,0,0,0,0,0.748262448562934,448.406233316313,91.1641387842595
24.3,"greedy_SVM","SVM",16,4,12833,12702,131,500,111,389,0.952008701604008,0.877323420074349,5.12410761374307,96,41,55,22,1.3,3.75,0.3,0,0,0,0,0,0,0.110836562841718,98.4144165065312,49.8062965684424
24.3,"greedy_SVM","SVM",16,5,12733,12669,64,600,144,456,0.942479701486642,0.884758364312268,5.3030155787708,117,55,62,21,1.1,4.5,0.3,0,0,0,0,0,0,0.00853370695368295,11.4664232749224,10.6128581256918
24.3,"greedy_SVM","SVM",16,6,12633,12578,55,700,235,465,0.939612866939124,0.884758364312268,5.15532497953611,143,65,78,26,1.2,5.25,0.5,0,0,0,0,0,0,0.00749942095267459,7.38442634133911,1.22573845130402
24.3,"greedy_SVM","SVM",16,7,12533,12478,55,800,335,465,0.941673803732831,0.884758364312268,5.14270620302519,148,66,82,5,1.2,6,0.7,0,0,0,0,0,0,0.00238925300237111,3.63743641598333,0.297600004457549
24.3,"greedy_SVM","SVM",16,8,12433,12378,55,900,435,465,0.945338401521856,0.884758364312268,5.08889037928435,149,67,82,1,1.2,6.75,0.9,0,0,0,0,0,0,0.00153751538377541,1.91341284789544,0.21150374015722
24.3,"greedy_SVM","SVM",16,9,12333,12278,55,1000,535,465,0.946694540928804,0.884758364312268,5.12338741438767,147,69,78,-2,1.1,7.5,1.2,0,0,0,0,0,0,0.0010573421058874,1.30395129762621,0.1217437086015
24.3,"greedy_SVM","SVM",16,10,12233,12178,55,1100,635,465,0.947768296551785,0.884758364312268,5.14554739455371,150,69,81,3,1.2,8.25,1.4,0,0,0,0,0,0,0.000681058070617696,0.825638875639494,0.076268337846605
24.3,"greedy_SVM","SVM",16,11,12133,12079,54,1200,734,466,0.952062738007136,0.884758364312268,5.18842695617499,154,71,83,4,1.2,9,1.6,0,0,0,0,0,0,0.00123046639084096,1.64195324988649,0.166716562399096
24.3,"greedy_SVM","SVM",16,12,12033,11981,52,1300,832,468,0.953858722114617,0.888475836431227,5.20877720462747,161,74,87,7,1.2,9.75,1.8,0,0,0,0,0,0,0.00095525035189251,1.22913330780892,0.125242734426609
24.3,"greedy_SVM","SVM",16,13,11933,11889,44,1400,924,476,0.960050829081114,0.903345724907063,5.32166916107437,183,83,100,22,1.2,10.5,1.9,0,0,0,0,0,0,0.00212179986369492,2.91595005812249,0.505651591865696
24.3,"greedy_SVM","SVM",16,14,11833,11802,31,1500,1011,489,0.957720872345095,0.925650557620818,5.34607131516402,214,96,118,31,1.2,11.25,2.1,0,0,0,0,0,0,0.00562641516367666,4.87661626067543,1.01417659724459
24.3,"greedy_SVM","SVM",16,15,11733,11704,29,1600,1109,491,0.958753955406593,0.925650557620818,5.35820933754711,222,98,124,8,1.3,12,2.3,0,0,0,0,0,0,0.00242306726531245,2.42166413787694,0.310862116673716
24.3,"greedy_SVM","SVM",16,16,11633,11605,28,1700,1208,492,0.960454649512921,0.925650557620818,5.39071147391005,221,99,122,-1,1.2,12.75,2.5,0,0,0,0,0,0,0.00158785786526063,1.61039720694761,0.183205945573219
24.3,"greedy_SVM","SVM",16,17,11533,11505,28,1800,1308,492,0.960096149935337,0.925650557620818,5.4000703479967,218,98,120,-3,1.2,13.5,2.7,0,0,0,0,0,0,0.00150580965047395,1.82857230444104,0.168045676318115
24.3,"greedy_SVM","SVM",16,18,11433,11405,28,1900,1408,492,0.959642360356576,0.925650557620818,5.40476198166133,217,97,120,-1,1.2,14.25,2.9,0,0,0,0,0,0,0.000971566686205489,1.28764527176357,0.108605281846323
24.3,"greedy_SVM","SVM",16,19,11333,11305,28,2000,1508,492,0.960058963593415,0.925650557620818,5.40476198166133,218,97,121,1,1.2,15,3.1,0,0,0,0,0,0,0.000796215480242291,1.11863389211235,0.0869523937179367
24.3,"greedy_SVM","SVM",16,20,11233,11206,27,2100,1607,493,0.962527788075045,0.925650557620818,5.40476198166133,221,99,122,3,1.2,15.75,3.3,0,0,0,0,0,0,0.00126003888543037,2.15311754442534,0.141384343210962
24.3,"greedy_SVM","SVM",16,21,11133,11109,24,2200,1704,496,0.973132867961799,0.925650557620818,5.45949775131931,230,102,128,9,1.3,16.5,3.4,0,0,0,0,0,0,0.00162692299775405,2.85797284666738,0.211601550043229
24.3,"greedy_SVM","SVM",16,22,11033,11013,20,2300,1800,500,0.982731011433655,0.925650557620818,5.65373275615552,242,106,136,12,1.3,17.25,3.6,0,0,0,0,0,0,0.00370308031026287,6.35379205418799,0.476439132368997
24.3,"greedy_SVM","SVM",16,23,10933,10918,15,2400,1895,505,0.990161307378813,0.929368029739777,5.75155827606758,258,112,146,16,1.3,18,3.8,0,0,0,0,0,0,0.00862872901649165,12.6817359973016,1.02431092030021
24.3,"greedy_SVM","SVM",16,24,10833,10820,13,2500,1993,507,0.992204813074707,0.929368029739777,5.81090414468428,265,118,147,7,1.2,18.75,3.9,0,0,0,0,0,0,0.00749324193230646,10.9488936338626,0.893586739257384
24.3,"greedy_SVM","SVM",16,25,10733,10722,11,2600,2091,509,0.99485375890003,0.929368029739777,5.86416290493893,271,120,151,6,1.3,19.5,4.1,0,0,0,0,0,0,0.00814638940941512,11.9257814367249,0.990218531463589
24.3,"greedy_SVM","SVM",16,26,10633,10628,5,2700,2185,515,0.99862003809276,0.936802973977695,5.97859191123573,294,125,169,23,1.4,20.25,4.2,0,0,0,0,0,0,0.0131712367226187,16.5362074717143,1.83761043972265
24.3,"greedy_SVM","SVM",16,27,10533,10530,3,2800,2283,517,0.998952391023683,0.944237918215613,6.00630630630631,302,128,174,8,1.4,21,4.4,0,0,0,0,0,0,0.00958165861320554,12.1088026120743,1.12880447685353
24.3,"greedy_SVM","SVM",16,28,10433,10433,0,2900,2380,520,0.999441623834586,0.944237918215613,6.00630630630631,315,132,183,13,1.4,21.75,4.6,0,0,0,0,0,0,0.00872715095327528,11.8672914216432,1.32171027297062
24.3,"greedy_SVM","SVM",16,29,10333,10333,0,3000,2480,520,0.999450920420066,0.947955390334573,6.00630630630631,316,132,184,1,1.4,22.5,4.8,0,0,0,0,0,0,0.00785566574211938,11.2935577400911,0.852289354974757
24.3,"greedy_SVM","SVM",16,30,10233,10233,0,3100,2580,520,0.999457311822584,0.947955390334573,6.00630630630631,317,132,185,1,1.4,23.25,5,0,0,0,0,0,0,0.00586576176941257,8.42284846441049,0.623170254436255
24.3,"greedy_SVM","SVM",16,31,10133,10133,0,3200,2680,520,0.999467770481249,0.947955390334573,6.00630630630631,318,133,185,1,1.4,24,5.2,0,0,0,0,0,0,0.00503136251811743,7.22849528739003,0.531002063814091
24.3,"greedy_SVM","SVM",16,32,10033,10033,0,3300,2780,520,0.999480553286285,0.947955390334573,6.00630630630631,320,132,188,2,1.4,24.75,5.3,0,0,0,0,0,0,0.00425539109924518,6.24252318889965,0.449116487923106
24.3,"greedy_SVM","SVM",16,33,9933,9933,0,3400,2880,520,0.99948868779858,0.947955390334573,6.000900090009,319,131,188,-1,1.4,25.5,5.5,0,0,0,0,0,0,0.00389323594677621,5.63639170509415,0.406292922513764
24.3,"greedy_SVM","SVM",16,34,9833,9833,0,3500,2980,520,0.999497403347468,0.947955390334573,6.00630630630631,320,132,188,1,1.4,26.25,5.7,0,0,0,0,0,0,0.00380154955927212,5.98257461590047,0.399514796383898
24.3,"greedy_SVM","SVM",16,35,9733,9733,0,3600,3080,520,0.999505537859763,0.947955390334573,6.00630630630631,320,132,188,0,1.4,27,5.9,0,0,0,0,0,0,0.00317787770207275,4.85976034561802,0.33157234429646
24.3,"greedy_SVM","SVM",16,36,9633,9633,0,3700,3180,520,0.999511638743985,0.947955390334573,6.000900090009,320,132,188,0,1.4,27.75,6.1,0,0,0,0,0,0,0.00288880228120192,4.56018747699168,0.305163630776184
24.3,"greedy_SVM","SVM",16,37,9533,9533,0,3800,3280,520,0.999524131030724,0.947955390334573,6.00630630630631,318,132,186,-2,1.4,28.5,6.3,0,0,0,0,0,0,0.00194439893192533,2.93873810498163,0.204592504445878
24.3,"greedy_SVM","SVM",16,38,9433,9433,0,3900,3380,520,0.999526455177094,0.947955390334573,6.00630630630631,318,132,186,0,1.4,29.25,6.5,0,0,0,0,0,0,0.0017761833647046,2.71953835795626,0.185848358023346
24.3,"greedy_SVM","SVM",16,39,9333,9333,0,4000,3480,520,0.999532265543019,0.947955390334573,6.00630630630631,318,132,186,0,1.4,30,6.7,0,0,0,0,0,0,0.00169196370831037,2.6742942317155,0.177533876277878
24.3,"greedy_SVM","SVM",16,40,9233,9233,0,4100,3580,520,0.99953923798213,0.947955390334573,6.00630630630631,318,132,186,0,1.4,30.75,6.9,0,0,0,0,0,0,0.00178806767504672,3.03012454936309,0.186454009044751
24.3,"greedy_SVM","SVM",16,41,9133,9133,0,4200,3680,520,0.9995415621285,0.947955390334573,6.00630630630631,318,132,186,0,1.4,31.5,7.1,0,0,0,0,0,0,0.00193653166978314,3.47944476835803,0.200947074065021
24.3,"greedy_SVM","SVM",16,42,9033,9033,0,4300,3780,520,0.999546791457832,0.947955390334573,6.00630630630631,317,132,185,-1,1.4,32.25,7.3,0,0,0,0,0,0,0.00108631946402726,1.73091676581454,0.112596600823617
24.3,"greedy_SVM","SVM",16,43,8933,8933,0,4400,3880,520,0.999552601823758,0.947955390334573,6.00630630630631,318,132,186,1,1.4,33,7.5,0,0,0,0,0,0,0.00102189043354987,1.64560609759547,0.106045204200852
24.3,"greedy_SVM","SVM",16,44,8833,8833,0,4500,3980,520,0.99955318286035,0.947955390334573,5.99011680143756,316,131,185,-2,1.4,33.75,7.7,0,0,0,0,0,0,0.000848548522063859,1.3103004053781,0.087275139445146
24.3,"greedy_SVM","SVM",16,45,8733,8733,0,4600,4080,520,0.99955318286035,0.947955390334573,6.00630630630631,317,132,185,1,1.4,34.5,7.8,0,0,0,0,0,0,0.000946734037096223,1.50194396398248,0.0976773919359925
24.3,"greedy_SVM","SVM",16,46,8633,8633,0,4700,4180,520,0.999554925970128,0.947955390334573,6.00630630630631,316,132,184,-1,1.4,35.25,8,0,0,0,0,0,0,0.00126057889639043,2.1770929405565,0.129468574630381
24.3,"greedy_SVM","SVM",16,47,8533,8533,0,4800,4280,520,0.999551439750573,0.947955390334573,6.00630630630631,316,132,184,0,1.4,36,8.2,0,0,0,0,0,0,0.00081001061921603,1.2599056172425,0.0831829012356623
24.3,"greedy_SVM","SVM",16,48,8433,8433,0,4900,4380,520,0.99955085871398,0.947955390334573,6.00630630630631,318,132,186,2,1.4,36.75,8.4,0,0,0,0,0,0,0.00102092017567051,1.67850421989209,0.105809744380076
24.3,"greedy_SVM","SVM",17,0,13233,12724,509,100,95,5,0.970946637842786,0.807272727272727,5.47299021965689,31,5,26,0,5.2,0.75,19,0,0,0,0,0,0,0.987204928580586,705.8985382956,99.3321637906916
24.3,"greedy_SVM","SVM",17,1,13133,12724,409,200,95,105,0.966758448060079,0.778181818181818,5.29027803811309,45,13,32,14,2.5,1.5,0.9,0,0,0,0,0,0,0.931047088275532,559.746012727176,96.0044748891285
24.3,"greedy_SVM","SVM",17,2,13033,12724,309,300,95,205,0.966229093184665,0.785454545454545,5.28573702692158,66,21,45,21,2.1,2.25,0.5,0,0,0,0,0,0,0.942984058526477,479.037535015908,96.9918207343565
24.3,"greedy_SVM","SVM",17,3,12933,12723,210,400,96,304,0.968862783024206,0.8,5.3182270000779,82,26,56,16,2.2,3,0.3,0,0,0,0,0,0,0.780249389493667,383.339838114449,93.3529823145333
24.3,"greedy_SVM","SVM",17,4,12833,12719,114,500,100,400,0.969819092046859,0.850909090909091,5.25313530837177,96,35,61,14,1.7,3.75,0.2,0,0,0,0,0,0,0.224578137941635,179.596303787453,50.9907204114779
24.3,"greedy_SVM","SVM",17,5,12733,12663,70,600,156,444,0.972768233018541,0.887272727272727,5.53340545777491,128,52,76,32,1.5,4.5,0.4,0,0,0,0,0,0,0.0547924348026078,75.2244477524077,22.8601239470106
24.3,"greedy_SVM","SVM",17,6,12633,12579,54,700,240,460,0.945936966662883,0.887272727272727,5.23954585715436,148,67,81,20,1.2,5.25,0.5,0,0,0,0,0,0,0.0182069515098996,43.7132828130106,3.22700687787377
24.3,"greedy_SVM","SVM",17,7,12533,12479,54,800,340,460,0.949647855273637,0.887272727272727,5.23954585715436,147,63,84,-1,1.3,6,0.7,0,0,0,0,0,0,0.00808929673269968,12.2245213259872,0.92758506370542
24.3,"greedy_SVM","SVM",17,8,12433,12379,54,900,440,460,0.953445215610407,0.887272727272727,5.25456788145775,151,66,85,4,1.3,6.75,1,0,0,0,0,0,0,0.00477585767503878,1.79835096340128,0.640077166849678
24.3,"greedy_SVM","SVM",17,9,12333,12279,54,1000,540,460,0.954919786096253,0.887272727272727,5.24071576929222,151,65,86,0,1.3,7.5,1.2,0,0,0,0,0,0,0.00320427171471576,0.771677423887309,0.369266214349037
24.3,"greedy_SVM","SVM",17,10,12233,12179,54,1100,640,460,0.955727614063035,0.887272727272727,5.24071576929222,151,67,84,0,1.3,8.25,1.4,0,0,0,0,0,0,1.65059984631382e-05,0.180995405127654,0.172364305870572
24.3,"greedy_SVM","SVM",17,11,12133,12079,54,1200,740,460,0.955662760268522,0.887272727272727,5.23152153110048,149,68,81,-2,1.2,9,1.6,0,0,0,0,0,0,8.39831732972524e-06,0.00576290727202997,0.00107671666108771
24.3,"greedy_SVM","SVM",17,12,12033,11979,54,1300,840,460,0.956159972693143,0.887272727272727,5.23152153110048,153,69,84,4,1.2,9.75,1.8,0,0,0,0,0,0,3.71373631130611e-06,0.00249242545728719,0.000452847634604986
24.3,"greedy_SVM","SVM",17,13,11933,11879,54,1400,940,460,0.95655137103197,0.887272727272727,5.20867645891227,152,68,84,-1,1.2,10.5,2,0,0,0,0,0,0,3.13695899018808e-06,0.00213230766309958,0.000370106189178708
24.3,"greedy_SVM","SVM",17,14,11833,11781,52,1500,1038,462,0.965492092388212,0.887272727272727,5.38032955550197,159,70,89,7,1.3,11.25,2.2,0,0,0,0,0,0,9.1228103360956e-06,0.151393291334759,0.146023752453614
24.3,"greedy_SVM","SVM",17,15,11733,11689,44,1600,1130,470,0.970984753669368,0.898181818181818,5.50210186976144,181,78,103,22,1.3,12,2.4,0,0,0,0,0,0,0.00301212915091218,1.00979794236617,0.664332116715863
24.3,"greedy_SVM","SVM",17,16,11633,11597,36,1700,1222,478,0.968716008647141,0.909090909090909,5.46545135566188,197,90,107,16,1.2,12.75,2.6,0,0,0,0,0,0,0.0028116442166277,0.663269389937021,0.463799934569821
24.3,"greedy_SVM","SVM",17,17,11533,11506,27,1800,1313,487,0.970812948003195,0.92,5.45110633898036,221,103,118,24,1.1,13.5,2.7,0,0,0,0,0,0,0.00443038662217219,1.35420348587341,0.660023585159501
24.3,"greedy_SVM","SVM",17,18,11433,11409,24,1900,1410,490,0.975172943452056,0.92,5.5244044299259,231,105,126,10,1.2,14.25,2.9,0,0,0,0,0,0,0.00414311463675465,1.48331162201,0.555896876635379
24.3,"greedy_SVM","SVM",17,19,11333,11309,24,2000,1510,490,0.975196836955298,0.923636363636364,5.50315672058003,231,106,125,0,1.2,15,3.1,0,0,0,0,0,0,0.00330117671530894,0.925752530473619,0.363197007902854
24.3,"greedy_SVM","SVM",17,20,11233,11210,23,2100,1609,491,0.979036295369237,0.923636363636364,5.56027160888321,238,107,131,7,1.2,15.75,3.3,0,0,0,0,0,0,0.00299918666056906,0.861676785346313,0.329970637096574
24.3,"greedy_SVM","SVM",17,21,11133,11111,22,2200,1708,492,0.983264876550261,0.923636363636364,5.66259002099144,238,106,132,0,1.2,16.5,3.5,0,0,0,0,0,0,0.00437129262819135,4.20644790803065,0.478929360781897
24.3,"greedy_SVM","SVM",17,22,11033,11012,21,2300,1807,493,0.985321424507921,0.923636363636364,5.69553513862024,239,106,133,1,1.3,17.25,3.7,0,0,0,0,0,0,0.00358391500223675,1.82421807105368,0.410368896340678
24.3,"greedy_SVM","SVM",17,23,10933,10915,18,2400,1904,496,0.989662646489942,0.923636363636364,5.82280194805195,252,111,141,13,1.3,18,3.8,0,0,0,0,0,0,0.00664145491302799,5.92075298225862,0.771561698719036
24.3,"greedy_SVM","SVM",17,24,10833,10821,12,2500,1998,502,0.993939583570391,0.927272727272727,5.91361427051796,266,115,151,14,1.3,18.75,4,0,0,0,0,0,0,0.00933596683585093,8.75819529346923,1.21845953416846
24.3,"greedy_SVM","SVM",17,25,10733,10725,8,2600,2094,506,0.996049607463891,0.930909090909091,5.95189993459778,279,122,157,13,1.3,19.5,4.1,0,0,0,0,0,0,0.0088118591611033,8.8684569054256,1.05078014786595
24.3,"greedy_SVM","SVM",17,26,10633,10629,4,2700,2190,510,0.999093753555581,0.934545454545455,6.03348416289593,293,129,164,14,1.3,20.25,4.3,0,0,0,0,0,0,0.00950136517405804,9.29610294286892,1.25878238835109
24.3,"greedy_SVM","SVM",17,27,10533,10532,1,2800,2287,513,0.99949254750256,0.938181818181818,6.03894927536232,296,131,165,3,1.3,21,4.5,0,0,0,0,0,0,0.00826629127567511,7.01974227529101,0.985659727553817
24.3,"greedy_SVM","SVM",17,28,10433,10433,0,2900,2386,514,0.999576743656844,0.938181818181818,6.03348416289593,291,131,160,-5,1.2,21.75,4.6,0,0,0,0,0,0,0.00713667451245865,5.76802497258086,0.800819229519284
24.3,"greedy_SVM","SVM",17,29,10333,10333,0,3000,2486,514,0.999581863693253,0.938181818181818,6.03348416289593,295,131,164,4,1.3,22.5,4.8,0,0,0,0,0,0,0.00595743741598126,4.77379213348902,0.647479906061355
24.3,"greedy_SVM","SVM",17,30,10233,10233,0,3100,2586,514,0.999590965980202,0.938181818181818,6.03348416289593,296,131,165,1,1.3,23.25,5,0,0,0,0,0,0,0.00498414124685783,3.40883099987399,0.527468290741424
24.3,"greedy_SVM","SVM",17,31,10133,10133,0,3200,2686,514,0.999594948230743,0.938181818181818,6.03348416289593,297,130,167,1,1.3,24,5.2,0,0,0,0,0,0,0.00450736803452775,3.11519955457044,0.479397149838853
24.3,"greedy_SVM","SVM",17,32,10033,10033,0,3300,2786,514,0.99959722380248,0.938181818181818,6.03348416289593,299,131,168,2,1.3,24.75,5.4,0,0,0,0,0,0,0.00374871481147479,2.00056109105872,0.394081450761795
24.3,"greedy_SVM","SVM",17,33,9933,9933,0,3400,2886,514,0.999600637160087,0.938181818181818,6.03348416289593,300,132,168,1,1.3,25.5,5.6,0,0,0,0,0,0,0.00345774432297624,1.58770949492854,0.359904286196351
24.3,"greedy_SVM","SVM",17,34,9833,9833,0,3500,2986,514,0.999602912731824,0.941818181818182,6.03348416289593,301,132,169,1,1.3,26.25,5.8,0,0,0,0,0,0,0.00301837426256486,0.926707685778333,0.313396639151322
24.3,"greedy_SVM","SVM",17,35,9733,9733,0,3600,3086,514,0.999612015018774,0.941818181818182,6.03348416289593,300,131,169,-1,1.3,27,6,0,0,0,0,0,0,0.00260414552180685,0.39430966048099,0.2740077702419
24.3,"greedy_SVM","SVM",17,36,9633,9633,0,3700,3186,514,0.999617135055183,0.941818181818182,6.03348416289593,302,131,171,2,1.3,27.75,6.2,0,0,0,0,0,0,1.88473586406651e-05,0.24880846328058,0.232770564213914
24.3,"greedy_SVM","SVM",17,37,9533,9533,0,3800,3286,514,0.999621117305723,0.941818181818182,6.03348416289593,302,131,171,0,1.3,28.5,6.4,0,0,0,0,0,0,0.00259304417371442,0.416305913056886,0.268285103942021
24.3,"greedy_SVM","SVM",17,38,9433,9433,0,3900,3386,514,0.999624530663329,0.941818181818182,6.03348416289593,302,131,171,0,1.3,29.25,6.6,0,0,0,0,0,0,1.41205419463953e-05,0.0136715760502387,0.00149687704055687
24.3,"greedy_SVM","SVM",17,39,9333,9333,0,4000,3486,514,0.999626806235067,0.941818181818182,6.03348416289593,303,131,172,1,1.3,30,6.8,0,0,0,0,0,0,1.08876325332865e-05,0.0105233493505211,0.00116332261570105
24.3,"greedy_SVM","SVM",17,40,9233,9233,0,4100,3586,514,0.999627944020935,0.941818181818182,6.02802893309222,303,130,173,0,1.3,30.75,7,0,0,0,0,0,0,1.12833060987908e-05,0.0111065529832914,0.00119477665255388
24.3,"greedy_SVM","SVM",17,41,9133,9133,0,4200,3686,514,0.999630788485607,0.941818181818182,6.02802893309222,306,131,175,3,1.3,31.5,7.2,0,0,0,0,0,0,6.27795095462844e-06,0.00615218789057376,0.000683937939046147
24.3,"greedy_SVM","SVM",17,42,9033,9033,0,4300,3786,514,0.999631357378541,0.941818181818182,6.03348416289593,308,131,177,2,1.4,32.25,7.4,0,0,0,0,0,0,8.80098827605081e-06,0.00932030685726432,0.000938852614681423
24.3,"greedy_SVM","SVM",17,43,8933,8933,0,4400,3886,514,0.999631926271476,0.941818181818182,6.03348416289593,309,131,178,1,1.4,33,7.6,0,0,0,0,0,0,4.36201020252141e-06,0.00428254608667522,0.000462656698123127
24.3,"greedy_SVM","SVM",17,44,8833,8833,0,4500,3986,514,0.999634770736147,0.945454545454545,6.03348416289593,309,131,178,0,1.4,33.75,7.8,0,0,0,0,0,0,4.16525751228121e-06,0.00410926375762157,0.000439803906274113
24.3,"greedy_SVM","SVM",17,45,8733,8733,0,4600,4086,514,0.999637615200819,0.945454545454545,6.03348416289593,309,131,178,0,1.4,34.5,7.9,0,0,0,0,0,0,3.60298203985183e-06,0.00352629249623341,0.000381496907831747
24.3,"greedy_SVM","SVM",17,46,8633,8633,0,4700,4186,514,0.999634770736147,0.945454545454545,6.03348416289593,308,131,177,-1,1.4,35.25,8.1,0,0,0,0,0,0,2.44143617540804e-06,0.00235864590970971,0.000259466173711719
24.3,"greedy_SVM","SVM",17,47,8533,8533,0,4800,4286,514,0.99963647741495,0.945454545454545,6.03348416289593,311,131,180,3,1.4,36,8.3,0,0,0,0,0,0,3.50968830403877e-06,0.00353645126112943,0.0003700669674589
24.3,"greedy_SVM","SVM",17,48,8433,8433,0,4900,4386,514,0.999635908522016,0.945454545454545,6.03348416289593,310,131,179,-1,1.4,36.75,8.5,0,0,0,0,0,0,2.02147328020208e-06,0.00190313587742832,0.00021386845581453
24.3,"greedy_SVM","SVM",18,0,13233,12705,528,100,95,5,0.908090708352841,0.7109375,4.64176306769494,25,5,20,0,4,0.75,19,0,0,0,0,0,0,0.992733261795642,613.930522213465,99.757139091637
24.3,"greedy_SVM","SVM",18,1,13133,12705,428,200,95,105,0.911146369521115,0.69140625,4.71061450258398,40,13,27,15,2.1,1.5,0.9,0,0,0,0,0,0,0.920369696286014,421.104671348558,95.9714585790519
24.3,"greedy_SVM","SVM",18,2,13033,12705,328,300,95,205,0.918919264740285,0.703125,4.84363173118512,58,20,38,18,1.9,2.25,0.5,0,0,0,0,0,0,0.885850188716721,354.900786366978,94.816384348584
24.3,"greedy_SVM","SVM",18,3,12933,12704,229,400,96,304,0.929426717750759,0.78125,5.0203313253012,65,20,45,7,2.2,3,0.3,0,0,0,0,0,0,0.730430168540521,217.876251550539,91.1859814998579
24.3,"greedy_SVM","SVM",18,4,12833,12701,132,500,99,401,0.937841819723918,0.7890625,5.17694430881076,85,32,53,20,1.7,3.75,0.2,0,0,0,0,0,0,0.0427621238516016,40.6261510410991,32.500624615688
24.3,"greedy_SVM","SVM",18,5,12733,12640,93,600,160,440,0.942036879971926,0.86328125,5.11397396734429,116,49,67,31,1.4,4.5,0.4,0,0,0,0,0,0,0.0297753124526129,51.1666631085497,22.0503471951758
24.3,"greedy_SVM","SVM",18,6,12633,12579,54,700,221,479,0.933815536772736,0.86328125,5.19013991917626,131,57,74,15,1.3,5.25,0.5,0,0,0,0,0,0,0.0110859040603926,17.3471918934965,3.64083401386701
24.3,"greedy_SVM","SVM",18,7,12533,12482,51,800,318,482,0.932403778661645,0.86328125,5.07152549342105,136,60,76,5,1.3,6,0.7,0,0,0,0,0,0,0.00297579269433579,0.859136141360994,0.404722518737727
24.3,"greedy_SVM","SVM",18,8,12433,12382,51,900,418,482,0.934584478825446,0.86328125,5.00133136894464,141,62,79,5,1.3,6.75,0.9,0,0,0,0,0,0,8.45018995094188e-06,0.0782629331072285,0.0743051304086056
24.3,"greedy_SVM","SVM",18,9,12333,12282,51,1000,518,482,0.937087500974895,0.86328125,5.07271739130435,146,64,82,5,1.3,7.5,1.1,0,0,0,0,0,0,7.04054287379325e-06,0.0164211100519226,0.0132972438855497
24.3,"greedy_SVM","SVM",18,10,12233,12182,51,1100,618,482,0.938319514311344,0.86328125,5.07713228894691,148,66,82,2,1.2,8.25,1.3,0,0,0,0,0,0,2.23103722148642e-06,0.00127809431673248,0.000281658380150781
24.3,"greedy_SVM","SVM",18,11,12133,12082,51,1200,718,482,0.93947475530339,0.86328125,5.07271739130435,153,68,85,5,1.2,9,1.5,0,0,0,0,0,0,2.35016400078616e-06,0.00144268698744967,0.000297073879333652
24.3,"greedy_SVM","SVM",18,12,12033,11982,51,1300,818,482,0.94026685092029,0.86328125,5.07713228894691,151,68,83,-2,1.2,9.75,1.7,0,0,0,0,0,0,6.64010266939385e-07,0.000425731005415723,8.41478587390371e-05
24.3,"greedy_SVM","SVM",18,13,11933,11882,51,1400,918,482,0.940939522890343,0.86328125,5.08598517872711,151,68,83,0,1.2,10.5,1.9,0,0,0,0,0,0,4.54229896608195e-07,0.000295806198105172,5.42794285667015e-05
24.3,"greedy_SVM","SVM",18,14,11833,11782,51,1500,1018,482,0.941819967633744,0.86328125,5.08598517872711,148,67,81,-3,1.2,11.25,2.1,0,0,0,0,0,0,2.1037469243529e-07,0.000138930113297539,2.51490039916785e-05
24.3,"greedy_SVM","SVM",18,15,11733,11683,50,1600,1117,483,0.94307330662144,0.86328125,5.12170763827919,150,68,82,2,1.2,12,2.3,0,0,0,0,0,0,7.14081178748583e-07,0.000552501242453574,0.000113358867050412
24.3,"greedy_SVM","SVM",18,16,11633,11586,47,1700,1214,486,0.950156469349542,0.86328125,5.2039884504863,166,75,91,16,1.2,12.75,2.5,0,0,0,0,0,0,8.19992660997998e-06,0.0953539181138368,0.0919089269173491
24.3,"greedy_SVM","SVM",18,17,11533,11493,40,1800,1307,493,0.95965857023085,0.87109375,5.36178768382353,185,79,106,19,1.3,13.5,2.7,0,0,0,0,0,0,0.00414456474327429,1.13825174503485,0.599899717328587
24.3,"greedy_SVM","SVM",18,18,11433,11401,32,1900,1399,501,0.970750955389177,0.88671875,5.56893671383648,206,89,117,21,1.3,14.25,2.8,0,0,0,0,0,0,0.0062398261447583,3.31994226296197,0.974346068057235
24.3,"greedy_SVM","SVM",18,19,11333,11313,20,2000,1487,513,0.966759402784291,0.8984375,5.51580303284182,233,103,130,27,1.3,15,2.9,0,0,0,0,0,0,0.0118392713664772,7.92007289631888,1.89337244410261
24.3,"greedy_SVM","SVM",18,20,11233,11216,17,2100,1584,516,0.965861897519892,0.8984375,5.49126654248221,241,106,135,8,1.3,15.75,3.1,0,0,0,0,0,0,0.00812038480928998,5.28782764001832,0.993124699747202
24.3,"greedy_SVM","SVM",18,21,11133,11116,17,2200,1684,516,0.96577842282795,0.8984375,5.49615636130899,246,107,139,5,1.3,16.5,3.3,0,0,0,0,0,0,0.00560283242950253,3.00485020482813,0.642963557167528
24.3,"greedy_SVM","SVM",18,22,11033,11017,16,2300,1783,517,0.969627398221826,0.8984375,5.51934689447907,245,107,138,-1,1.3,17.25,3.4,0,0,0,0,0,0,0.00512870907387388,3.01193001784658,0.567177342299192
24.3,"greedy_SVM","SVM",18,23,10933,10918,15,2400,1882,518,0.973668913781005,0.8984375,5.52426609848485,248,108,140,3,1.3,18,3.6,0,0,0,0,0,0,0.00476197103679731,2.89796051301515,0.516844966521575
24.3,"greedy_SVM","SVM",18,24,10833,10819,14,2500,1981,519,0.979439025698009,0.8984375,5.58891849398931,249,109,140,1,1.3,18.75,3.8,0,0,0,0,0,0,0.00431199895103316,2.29642151669817,0.483601332265383
24.3,"greedy_SVM","SVM",18,25,10733,10722,11,2600,2078,522,0.991608051591006,0.8984375,5.82601172571301,255,110,145,6,1.3,19.5,4,0,0,0,0,0,0,0.00423110084920036,2.31519361824134,0.537949668569273
24.3,"greedy_SVM","SVM",18,26,10633,10629,4,2700,2171,529,0.998548027803775,0.9140625,5.9686660698299,268,116,152,13,1.3,20.25,4.1,0,0,0,0,0,0,0.00474910545419397,2.97853085171235,0.560050585133448
24.3,"greedy_SVM","SVM",18,27,10533,10531,2,2800,2269,531,0.999187797340508,0.92578125,5.98473967684022,278,120,158,10,1.3,21,4.3,0,0,0,0,0,0,0.0043807337909406,2.5365217395166,0.474949677249477
24.3,"greedy_SVM","SVM",18,28,10433,10432,1,2900,2368,532,0.999312095421931,0.92578125,5.9686660698299,281,120,161,3,1.3,21.75,4.5,0,0,0,0,0,0,0.00432436827007453,2.71273510280125,0.465579689450095
24.3,"greedy_SVM","SVM",18,29,10333,10333,0,3000,2467,533,0.999340732725004,0.92578125,5.95267857142857,282,122,160,1,1.3,22.5,4.6,0,0,0,0,0,0,0.00371436826730178,1.90629176152656,0.396281335201085
24.3,"greedy_SVM","SVM",18,30,10233,10233,0,3100,2567,533,0.999346825768211,0.92578125,5.95267857142857,283,122,161,1,1.3,23.25,4.8,0,0,0,0,0,0,0.00331136231800257,1.36352804975592,0.343850055398651
24.3,"greedy_SVM","SVM",18,31,10133,10133,0,3200,2667,533,0.999352918811418,0.92578125,5.94736842105263,284,122,162,1,1.3,24,5,0,0,0,0,0,0,0.00306838291273992,1.01651149543218,0.321570647057027
24.3,"greedy_SVM","SVM",18,32,10033,10033,0,3300,2767,533,0.999364495593511,0.92578125,5.94736842105263,283,121,162,-1,1.3,24.75,5.2,0,0,0,0,0,0,0.00290187254953166,0.773007853277985,0.300347726276755
24.3,"greedy_SVM","SVM",18,33,9933,9933,0,3400,2867,533,0.999374853766963,0.92578125,5.94736842105263,283,120,163,0,1.4,25.5,5.4,0,0,0,0,0,0,1.49772166236473e-05,0.0127191611453037,0.00162851743829035
24.3,"greedy_SVM","SVM",18,34,9833,9833,0,3500,2967,533,0.999388867766339,0.92578125,5.94736842105263,282,122,160,-1,1.3,26.25,5.6,0,0,0,0,0,0,1.5152396284155e-05,0.0136918870707592,0.00161494155857696
24.3,"greedy_SVM","SVM",18,35,9733,9733,0,3600,3067,533,0.999396179418187,0.92578125,5.94736842105263,284,122,162,2,1.3,27,5.8,0,0,0,0,0,0,1.62956582782105e-05,0.0146797653264589,0.0017132551382624
24.3,"greedy_SVM","SVM",18,36,9633,9633,0,3700,3167,533,0.999399835244112,0.92578125,5.94736842105263,284,122,162,0,1.3,27.75,5.9,0,0,0,0,0,0,9.50400664766723e-06,0.00859696527219547,0.0010273323931384
24.3,"greedy_SVM","SVM",18,37,9533,9533,0,3800,3267,533,0.999404100374357,0.92578125,5.94736842105263,284,122,162,0,1.3,28.5,6.1,0,0,0,0,0,0,7.15699566117841e-06,0.00634723249796471,0.000760841477447823
24.3,"greedy_SVM","SVM",18,38,9433,9433,0,3900,3367,533,0.999412021330526,0.9296875,5.94736842105263,284,122,162,0,1.3,29.25,6.3,0,0,0,0,0,0,6.02546535991264e-06,0.00527601460186289,0.000649415033028312
24.3,"greedy_SVM","SVM",18,39,9333,9333,0,4000,3467,533,0.999418723678053,0.9296875,5.94736842105263,284,122,162,0,1.3,30,6.5,0,0,0,0,0,0,5.81713954864663e-06,0.00523990464643294,0.000622319267102557
24.3,"greedy_SVM","SVM",18,40,9233,9233,0,4100,3567,533,0.999420551591015,0.9296875,5.94736842105263,286,123,163,2,1.3,30.75,6.7,0,0,0,0,0,0,5.64175620578393e-06,0.00506269497280901,0.000597055966437861
24.3,"greedy_SVM","SVM",18,41,9133,9133,0,4200,3667,533,0.999432128373109,0.93359375,5.94736842105263,286,123,163,0,1.3,31.5,6.9,0,0,0,0,0,0,4.30776934606066e-06,0.00392116095104782,0.000461835716742488
24.3,"greedy_SVM","SVM",18,42,9033,9033,0,4300,3767,533,0.99943334698175,0.93359375,5.94736842105263,286,123,163,0,1.3,32.25,7.1,0,0,0,0,0,0,3.61422040287615e-06,0.00319197328582526,0.00038624995728348
24.3,"greedy_SVM","SVM",18,43,8933,8933,0,4400,3867,533,0.999438221416316,0.93359375,5.94736842105263,286,123,163,0,1.3,33,7.3,0,0,0,0,0,0,2.82022057554777e-06,0.00238717360001733,0.000298583003964101
24.3,"greedy_SVM","SVM",18,44,8833,8833,0,4500,3967,533,0.999443095850881,0.93359375,5.94206773618538,285,123,162,-1,1.3,33.75,7.4,0,0,0,0,0,0,2.11169813931942e-06,0.00180221818019105,0.000226644590472239
24.3,"greedy_SVM","SVM",18,45,8733,8733,0,4600,4067,533,0.999446751676805,0.93359375,5.94736842105263,285,123,162,0,1.3,34.5,7.6,0,0,0,0,0,0,2.44502818736411e-06,0.00219412605927465,0.00026349436032477
24.3,"greedy_SVM","SVM",18,46,8633,8633,0,4700,4167,533,0.99945040750273,0.93359375,5.94736842105263,285,123,162,0,1.3,35.25,7.8,0,0,0,0,0,0,3.91545418751216e-06,0.0036737199414883,0.000415264856453108
24.3,"greedy_SVM","SVM",18,47,8533,8533,0,4800,4267,533,0.999457109850257,0.93359375,5.94736842105263,286,123,163,1,1.3,36,8,0,0,0,0,0,0,1.92250628311525e-06,0.00174351708701199,0.000206745936442864
24.3,"greedy_SVM","SVM",18,48,8433,8433,0,4900,4367,533,0.999449188894088,0.93359375,5.94736842105263,289,123,166,3,1.3,36.75,8.2,0,0,0,0,0,0,1.44395799211459e-06,0.00128729639711549,0.000155119889995156
24.3,"greedy_SVM","SVM",19,0,13233,12713,520,100,93,7,0.959913831632005,0.83206106870229,5.18019356597601,26,7,19,0,2.7,0.75,13.3,0,0,0,0,0,0,0.999990414825594,686.110629836404,99.9995534560752
24.3,"greedy_SVM","SVM",19,1,13133,12713,420,200,93,107,0.965660773131676,0.82824427480916,5.31753328997364,46,16,30,20,1.9,1.5,0.9,0,0,0,0,0,0,0.973845243008716,449.414901027646,98.3019414346355
24.3,"greedy_SVM","SVM",19,2,13033,12713,320,300,93,207,0.963523845278295,0.824427480916031,5.28996689375906,61,20,41,15,2,2.25,0.4,0,0,0,0,0,0,0.964305213217857,348.349511885847,97.820336085788
24.3,"greedy_SVM","SVM",19,3,12933,12713,220,400,93,307,0.964443332081885,0.816793893129771,5.31276847519768,69,25,44,8,1.8,3,0.3,0,0,0,0,0,0,0.732889293515635,266.034737480226,93.9211853475169
24.3,"greedy_SVM","SVM",19,4,12833,12707,126,500,99,401,0.962217017954727,0.83969465648855,5.4151391460569,86,30,56,17,1.9,3.75,0.2,0,0,0,0,0,0,0.0455449060212374,28.2007247159916,19.4449838461787
24.3,"greedy_SVM","SVM",19,5,12733,12653,80,600,153,447,0.946340823903086,0.870229007633588,5.36317735254852,125,54,71,39,1.3,4.5,0.3,0,0,0,0,0,0,0.0286122897163821,59.2840812407901,24.6994937845351
24.3,"greedy_SVM","SVM",19,6,12633,12581,52,700,225,475,0.935892760307722,0.870229007633588,5.17406052010089,150,70,80,25,1.1,5.25,0.5,0,0,0,0,0,0,0.00718718249532158,7.95605564987031,1.05564258551404
24.3,"greedy_SVM","SVM",19,7,12533,12481,52,800,325,475,0.939310295511027,0.870229007633588,5.10699955564693,144,67,77,-6,1.1,6,0.7,0,0,0,0,0,0,1.02939759845635e-05,0.184064708404332,0.179737065800604
24.3,"greedy_SVM","SVM",19,8,12433,12381,52,900,425,475,0.940263153190166,0.870229007633588,5.08051554757962,149,68,81,5,1.2,6.75,0.9,0,0,0,0,0,0,2.95337862956896e-06,0.00174807502977618,0.000453494584519874
24.3,"greedy_SVM","SVM",19,9,12333,12281,52,1000,525,475,0.943919647698876,0.870229007633588,5.12021080089776,153,68,85,4,1.2,7.5,1.1,0,0,0,0,0,0,1.74400661607679e-06,0.000931638253810614,0.000242007579367447
24.3,"greedy_SVM","SVM",19,10,12233,12181,52,1100,625,475,0.945923687958454,0.870229007633588,5.13356787255227,154,70,84,1,1.2,8.25,1.3,0,0,0,0,0,0,1.05390712881654e-06,0.000540905853655357,0.000131092655342336
24.3,"greedy_SVM","SVM",19,11,12133,12082,51,1200,724,476,0.949896609876569,0.870229007633588,5.20497918112422,159,69,90,5,1.3,9,1.5,0,0,0,0,0,0,2.54492979671016e-06,0.0015620472143873,0.000359371966705254
24.3,"greedy_SVM","SVM",19,12,12033,11982,51,1300,824,476,0.95034830851373,0.870229007633588,5.20953296868426,162,69,93,3,1.3,9.75,1.7,0,0,0,0,0,0,1.22905002440813e-06,0.00075380757328396,0.000154539706063872
24.3,"greedy_SVM","SVM",19,13,11933,11882,51,1400,924,476,0.951472787838681,0.870229007633588,5.20953296868426,163,70,93,1,1.3,10.5,1.9,0,0,0,0,0,0,7.47448543193912e-07,0.000455530783949799,8.87004659686614e-05
24.3,"greedy_SVM","SVM",19,14,11833,11782,51,1500,1024,476,0.952457228667953,0.870229007633588,5.21409473135386,163,71,92,0,1.3,11.25,2.2,0,0,0,0,0,0,4.03131864310616e-07,0.000242448938009269,4.77523122578458e-05
24.3,"greedy_SVM","SVM",19,15,11733,11683,50,1600,1123,477,0.954122792903897,0.870229007633588,5.26867202475031,170,73,97,7,1.3,12,2.4,0,0,0,0,0,0,9.03986197363804e-07,0.000634096183689644,0.000123557852632349
24.3,"greedy_SVM","SVM",19,16,11633,11586,47,1700,1220,480,0.961257009373617,0.870229007633588,5.44637845240194,173,75,98,3,1.3,12.75,2.5,0,0,0,0,0,0,1.35058879515107e-05,0.156051425452337,0.15008471292606
24.3,"greedy_SVM","SVM",19,17,11533,11491,42,1800,1315,485,0.970628266323423,0.877862595419847,5.55363312348933,188,80,108,15,1.4,13.5,2.7,0,0,0,0,0,0,0.00341122711133528,0.860542786451594,0.515592660009838
24.3,"greedy_SVM","SVM",19,18,11433,11393,40,1900,1413,487,0.972556030295961,0.877862595419847,5.64210190908219,196,84,112,8,1.3,14.25,2.9,0,0,0,0,0,0,0.00322699226073884,0.741719398450834,0.391526133462634
24.3,"greedy_SVM","SVM",19,19,11333,11297,36,2000,1509,491,0.976875770956618,0.889312977099237,5.65226998794697,206,88,118,10,1.3,15,3.1,0,0,0,0,0,0,0.00442424952802613,2.02566425006013,0.57294586247893
24.3,"greedy_SVM","SVM",19,20,11233,11206,27,2100,1600,500,0.97911877052157,0.908396946564885,5.72832985314757,232,101,131,26,1.3,15.75,3.2,0,0,0,0,0,0,0.00940589990424211,7.2293536184723,1.39096675941925
24.3,"greedy_SVM","SVM",19,21,11133,11114,19,2200,1692,508,0.9761690234847,0.916030534351145,5.61454456548314,248,110,138,16,1.3,16.5,3.3,0,0,0,0,0,0,0.0109003315995631,10.0543023406288,1.40697005484457
24.3,"greedy_SVM","SVM",19,22,11033,11014,19,2300,1792,508,0.976531335848011,0.916030534351145,5.61454456548314,247,110,137,-1,1.2,17.25,3.5,0,0,0,0,0,0,0.00807799662154189,6.91199861352669,0.881815892295372
24.3,"greedy_SVM","SVM",19,23,10933,10914,19,2400,1892,508,0.97647889590069,0.919847328244275,5.61454456548314,249,108,141,2,1.3,18,3.7,0,0,0,0,0,0,0.00645978973823062,5.20720729137823,0.697418618291142
24.3,"greedy_SVM","SVM",19,24,10833,10814,19,2500,1992,508,0.976347796032384,0.919847328244275,5.6371838580859,248,108,140,-1,1.3,18.75,3.9,0,0,0,0,0,0,0.00508999028045709,3.29310569872961,0.540557865136169
24.3,"greedy_SVM","SVM",19,25,10733,10714,19,2600,2092,508,0.976240532503771,0.919847328244275,5.6371838580859,248,108,140,0,1.3,19.5,4.1,0,0,0,0,0,0,0.00426038735297984,2.21616526110623,0.453029259496948
24.3,"greedy_SVM","SVM",19,26,10633,10614,19,2700,2192,508,0.976194051641375,0.919847328244275,5.6371838580859,248,109,139,0,1.3,20.25,4.3,0,0,0,0,0,0,0.00440333630615638,2.62868313797461,0.463537661682672
24.3,"greedy_SVM","SVM",19,27,10533,10514,19,2800,2292,508,0.976207161628206,0.919847328244275,5.6371838580859,250,109,141,2,1.3,21,4.5,0,0,0,0,0,0,0.00368644344389458,1.67198504634205,0.388666112736438
24.3,"greedy_SVM","SVM",19,28,10433,10414,19,2900,2392,508,0.976226230699961,0.919847328244275,5.6371838580859,250,109,141,0,1.3,21.75,4.7,0,0,0,0,0,0,0.00300976827038971,0.844172576136551,0.318393722237013
24.3,"greedy_SVM","SVM",19,29,10333,10314,19,3000,2492,508,0.976288205183161,0.919847328244275,5.6371838580859,249,109,140,-1,1.3,22.5,4.9,0,0,0,0,0,0,1.65233797215132e-05,0.061339788669982,0.0500741976968786
24.3,"greedy_SVM","SVM",19,30,10233,10214,19,3100,2592,508,0.976312041522852,0.919847328244275,5.65982315068865,252,110,142,3,1.3,23.25,5.1,0,0,0,0,0,0,1.18362919959245e-05,0.00999076358684431,0.00130300462096649
24.3,"greedy_SVM","SVM",19,31,10133,10114,19,3200,2692,508,0.976300719261499,0.919847328244275,5.65982315068865,251,109,142,-1,1.3,24,5.3,0,0,0,0,0,0,9.85481133204967e-06,0.00866065177422962,0.00106724415942079
24.3,"greedy_SVM","SVM",19,32,10033,10014,19,3300,2792,508,0.976324555601193,0.919847328244275,5.65982315068865,250,109,141,-1,1.3,24.75,5.5,0,0,0,0,0,0,7.9441267348244e-06,0.00751773517163917,0.000861120458068878
24.3,"greedy_SVM","SVM",19,33,9933,9914,19,3400,2892,508,0.976288205183165,0.919847328244275,5.65982315068865,248,108,140,-2,1.3,25.5,5.7,0,0,0,0,0,0,1.11381744911076e-05,0.010990745058009,0.0011788861141643
24.3,"greedy_SVM","SVM",19,34,9833,9815,18,3500,2991,509,0.97946618517256,0.919847328244275,5.68752251670485,247,108,139,-1,1.3,26.25,5.9,0,0,0,0,0,0,9.45623365015545e-06,0.0128228136836048,0.00450522944260735
24.3,"greedy_SVM","SVM",19,35,9733,9718,15,3600,3088,512,0.990315891091772,0.923664122137405,5.75550087347821,256,113,143,9,1.3,27,6,0,0,0,0,0,0,1.13365396438775e-05,0.13393691988556,0.124522270717908
24.3,"greedy_SVM","SVM",19,36,9633,9628,5,3700,3178,522,0.999553068630781,0.946564885496183,5.93149466192171,285,122,163,29,1.3,27.75,6.1,0,0,0,0,0,0,1.30853930664571e-05,0.842114977425814,0.833814074355584
24.3,"greedy_SVM","SVM",19,37,9533,9533,0,3800,3273,527,0.99965675670844,0.954198473282443,5.93149466192171,300,129,171,15,1.3,28.5,6.2,0,0,0,0,0,0,1.15594051044359e-05,0.107375657291818,0.099479855748922
24.3,"greedy_SVM","SVM",19,38,9433,9433,0,3900,3373,527,0.999660332159394,0.954198473282443,5.93149466192171,297,129,168,-3,1.3,29.25,6.4,0,0,0,0,0,0,1.45165233407842e-05,0.0163498125518554,0.00413503510228945
24.3,"greedy_SVM","SVM",19,39,9333,9333,0,4000,3473,527,0.999656160799948,0.954198473282443,5.93149466192171,296,128,168,-1,1.3,30,6.6,0,0,0,0,0,0,7.85593800979888e-06,0.00755420252598247,0.000866025818783236
24.3,"greedy_SVM","SVM",19,40,9233,9233,0,4100,3573,527,0.999659736250901,0.954198473282443,5.93149466192171,296,128,168,0,1.3,30.75,6.8,0,0,0,0,0,0,7.51684863934975e-06,0.00754334057166077,0.000809018868406584
24.3,"greedy_SVM","SVM",19,41,9133,9133,0,4200,3673,527,0.999659140342409,0.954198473282443,5.93149466192171,293,128,165,-3,1.3,31.5,7,0,0,0,0,0,0,6.30786799318658e-06,0.00621855182953864,0.000671891368657037
24.3,"greedy_SVM","SVM",19,42,9033,9033,0,4300,3773,527,0.999660928067886,0.954198473282443,5.93149466192171,293,128,165,0,1.3,32.25,7.2,0,0,0,0,0,0,4.24614462508529e-06,0.0041889148748707,0.000465116924690691
24.3,"greedy_SVM","SVM",19,43,8933,8933,0,4400,3873,527,0.999662715793363,0.954198473282443,5.93149466192171,295,129,166,2,1.3,33,7.3,0,0,0,0,0,0,4.59207080697827e-06,0.00461352621905418,0.000491756872957249
24.3,"greedy_SVM","SVM",19,44,8833,8833,0,4500,3973,527,0.999665099427332,0.954198473282443,5.93149466192171,295,128,167,0,1.3,33.75,7.5,0,0,0,0,0,0,2.88465732012606e-06,0.0027778961791162,0.000308021574938948
24.3,"greedy_SVM","SVM",19,45,8733,8733,0,4600,4073,527,0.999665099427332,0.954198473282443,5.93149466192171,294,128,166,-1,1.3,34.5,7.7,0,0,0,0,0,0,3.87546168160333e-06,0.00397322075210282,0.000406678965530201
24.3,"greedy_SVM","SVM",19,46,8633,8633,0,4700,4173,527,0.99966450351884,0.954198473282443,5.93149466192171,293,128,165,-1,1.3,35.25,7.9,0,0,0,0,0,0,3.52245443232438e-06,0.00355914774274375,0.000372886792233425
24.3,"greedy_SVM","SVM",19,47,8533,8533,0,4800,4273,527,0.999666291244316,0.954198473282443,5.93149466192171,297,129,168,4,1.3,36,8.1,0,0,0,0,0,0,2.19741138751191e-06,0.00212097126183448,0.00023242295614777
24.3,"greedy_SVM","SVM",19,48,8433,8433,0,4900,4373,527,0.99966450351884,0.954198473282443,5.93149466192171,296,130,166,-1,1.3,36.75,8.3,0,0,0,0,0,0,1.9581998611161e-06,0.0018737500866909,0.000208272454965457
24.3,"greedy_SVM","SVM",20,0,13233,12710,523,100,95,5,0.97375365288528,0.793103448275862,5.67901272885909,25,5,20,0,4,0.75,19,0,0,0,0,0,0,0.981409694616639,807.884400267877,98.984936764695
24.3,"greedy_SVM","SVM",20,1,13133,12710,423,200,95,105,0.979117398320311,0.762452107279693,5.69934701108227,53,18,35,28,1.9,1.5,0.9,0,0,0,0,0,0,0.954497876108524,657.856323540808,97.4263635997949
24.3,"greedy_SVM","SVM",20,2,13033,12710,323,300,95,205,0.978876962809053,0.808429118773946,5.73765977149191,75,30,45,22,1.5,2.25,0.5,0,0,0,0,0,0,0.932156369639527,559.924330949489,96.8706898077607
24.3,"greedy_SVM","SVM",20,3,12933,12709,224,400,96,304,0.977712465444882,0.823754789272031,5.73250926900404,84,28,56,9,2,3,0.3,0,0,0,0,0,0,0.793726285936835,466.152397726075,92.063643532414
24.3,"greedy_SVM","SVM",20,4,12833,12700,133,500,105,395,0.978300994158985,0.846743295019157,5.60888118550954,103,46,57,19,1.2,3.75,0.3,0,0,0,0,0,0,0.116150605133032,130.66632579823,41.7133874452266
24.3,"greedy_SVM","SVM",20,5,12733,12646,87,600,159,441,0.968807380054395,0.911877394636015,5.56874063703659,135,58,77,32,1.3,4.5,0.4,0,0,0,0,0,0,0.108394985207234,133.472877011067,38.4030062718997
24.3,"greedy_SVM","SVM",20,6,12633,12589,44,700,216,484,0.966374914322418,0.911877394636015,5.68412895654275,158,75,83,23,1.1,5.25,0.4,0,0,0,0,0,0,0.0733445720020426,73.3321664043065,26.6308861530021
24.3,"greedy_SVM","SVM",20,7,12533,12502,31,800,303,497,0.962234877981973,0.9272030651341,5.39973685863424,191,87,104,33,1.2,6,0.6,0,0,0,0,0,0,0.0180466216969857,18.2673463511894,2.72435032434072
24.3,"greedy_SVM","SVM",20,8,12433,12402,31,900,403,497,0.965223575120575,0.9272030651341,5.42313259892295,208,90,118,17,1.3,6.75,0.8,0,0,0,0,0,0,0.00836855142901606,4.50346778018976,1.25421922737377
24.3,"greedy_SVM","SVM",20,9,12333,12302,31,1000,503,497,0.965842008749,0.9272030651341,5.43584695541503,215,90,125,7,1.4,7.5,1,0,0,0,0,0,0,0.00580984486966403,2.74136569340773,0.704227991866626
24.3,"greedy_SVM","SVM",20,10,12233,12202,31,1100,603,497,0.966897652224995,0.9272030651341,5.44055331641538,216,92,124,1,1.3,8.25,1.2,0,0,0,0,0,0,0.00360864811406119,1.04057761309304,0.404488445898755
24.3,"greedy_SVM","SVM",20,11,12133,12102,31,1200,703,497,0.967136293441379,0.9272030651341,5.4452678340206,215,92,123,-1,1.3,9,1.4,0,0,0,0,0,0,0.00266313085086016,0.407687754626601,0.300764294226647
24.3,"greedy_SVM","SVM",20,12,12033,12002,31,1300,803,497,0.96750532008426,0.9272030651341,5.47372742200328,215,92,123,0,1.3,9.75,1.6,0,0,0,0,0,0,1.30484739134724e-05,0.0235006011439521,0.0171076234594092
24.3,"greedy_SVM","SVM",20,13,11933,11902,31,1400,903,497,0.967797790146452,0.9272030651341,5.4689635165011,216,93,123,1,1.3,10.5,1.8,0,0,0,0,0,0,1.05902256630177e-05,0.00711384782412906,0.00127237627743248
24.3,"greedy_SVM","SVM",20,14,11833,11802,31,1500,1003,497,0.968533451039084,0.9272030651341,5.49597834648297,220,94,126,4,1.3,11.25,2,0,0,0,0,0,0,6.3046426654444e-06,0.00439884178562316,0.000801156350413319
24.3,"greedy_SVM","SVM",20,15,11733,11702,31,1600,1103,497,0.968726636785688,0.9272030651341,5.49597834648297,217,94,123,-3,1.3,12,2.2,0,0,0,0,0,0,5.81948694956795e-06,0.00438737439322925,0.000663178287187961
24.3,"greedy_SVM","SVM",20,16,11633,11603,30,1700,1202,498,0.972683655050421,0.9272030651341,5.49597834648297,223,97,126,6,1.3,12.75,2.4,0,0,0,0,0,0,5.89582121709934e-06,0.00490844511512489,0.00074713640495738
24.3,"greedy_SVM","SVM",20,17,11533,11503,30,1800,1302,498,0.972804470904331,0.9272030651341,5.49597834648297,222,97,125,-1,1.3,13.5,2.6,0,0,0,0,0,0,6.07279798909696e-06,0.00529229128341154,0.000676838546502456
24.3,"greedy_SVM","SVM",20,18,11433,11405,28,1900,1400,500,0.981578572770035,0.9272030651341,5.5695895484832,223,98,125,1,1.3,14.25,2.8,0,0,0,0,0,0,7.76658084328899e-06,0.0640588724371596,0.0578036984795875
24.3,"greedy_SVM","SVM",20,19,11333,11309,24,2000,1496,504,0.988241387683746,0.9272030651341,5.70401368894841,235,102,133,12,1.3,15,3,0,0,0,0,0,0,0.00279216012632474,0.528727578787635,0.356971307693538
24.3,"greedy_SVM","SVM",20,20,11233,11216,17,2100,1589,511,0.995047148087955,0.923371647509579,5.86144978106185,252,110,142,17,1.3,15.75,3.1,0,0,0,0,0,0,0.0101915584868083,10.3091823212639,1.41887674490053
24.3,"greedy_SVM","SVM",20,21,11133,11123,10,2200,1682,518,0.997072308886669,0.931034482758621,5.92126488417965,282,120,162,30,1.4,16.5,3.2,0,0,0,0,0,0,0.0107230620304107,8.35022415862708,1.53836325449671
24.3,"greedy_SVM","SVM",20,22,11033,11029,4,2300,1776,524,0.998544228770206,0.9272030651341,5.9618096397642,301,129,172,19,1.3,17.25,3.4,0,0,0,0,0,0,0.0111828655782664,9.04148678235902,1.60282762931316
24.3,"greedy_SVM","SVM",20,23,10933,10933,0,2400,1872,528,0.998694949538451,0.934865900383142,5.96716616235159,320,131,189,19,1.4,18,3.5,0,0,0,0,0,0,0.00722304194316956,4.89920819950848,1.05733394863059
24.3,"greedy_SVM","SVM",20,24,10833,10833,0,2500,1972,528,0.998710500093905,0.934865900383142,5.96716616235159,321,131,190,1,1.5,18.75,3.7,0,0,0,0,0,0,0.00608109625773244,4.08501128587079,0.661389390187811
24.3,"greedy_SVM","SVM",20,25,10733,10733,0,2600,2072,528,0.998697341931598,0.934865900383142,5.94579761745507,319,130,189,-2,1.5,19.5,3.9,0,0,0,0,0,0,0.00407589429358638,1.84899424208772,0.451180283889744
24.3,"greedy_SVM","SVM",20,26,10633,10633,0,2700,2172,528,0.998729639239079,0.934865900383142,5.97790813564115,319,129,190,0,1.5,20.25,4.1,0,0,0,0,0,0,0.00379501392099351,1.69353088770145,0.40646865596209
24.3,"greedy_SVM","SVM",20,27,10533,10533,0,2800,2272,528,0.998732629730512,0.934865900383142,5.96716616235159,320,130,190,1,1.5,21,4.3,0,0,0,0,0,0,0.00361293171247141,1.55040470321346,0.385372583647197
24.3,"greedy_SVM","SVM",20,28,10433,10433,0,2900,2372,528,0.998738012615092,0.934865900383142,5.96716616235159,323,130,193,3,1.5,21.75,4.5,0,0,0,0,0,0,0.00303010143716995,0.889054068916834,0.318216207161877
24.3,"greedy_SVM","SVM",20,29,10333,10333,0,3000,2472,528,0.998757749858553,0.934865900383142,5.95646272528907,322,131,191,-1,1.5,22.5,4.7,0,0,0,0,0,0,0.00255268183034727,0.324553301748725,0.268143443166183
24.3,"greedy_SVM","SVM",20,30,10233,10233,0,3100,2572,528,0.998758946055126,0.934865900383142,5.95646272528907,321,130,191,-1,1.5,23.25,4.9,0,0,0,0,0,0,0.00260435636940526,0.372281351638802,0.272753076122062
24.3,"greedy_SVM","SVM",20,31,10133,10133,0,3200,2672,528,0.998766123234566,0.934865900383142,5.96716616235159,317,129,188,-4,1.5,24,5.1,0,0,0,0,0,0,1.23579173577239e-05,0.0108549576771616,0.00134032384753757
24.3,"greedy_SVM","SVM",20,32,10033,10033,0,3300,2772,528,0.9987780852003,0.934865900383142,5.96716616235159,315,129,186,-2,1.4,24.75,5.2,0,0,0,0,0,0,1.03566383029669e-05,0.00930920567964304,0.00111768937244365
24.3,"greedy_SVM","SVM",20,33,9933,9933,0,3400,2872,528,0.99877629090544,0.934865900383142,5.96716616235159,317,129,188,2,1.5,25.5,5.4,0,0,0,0,0,0,6.73307503732444e-06,0.00592107453590849,0.000727307250279047
24.3,"greedy_SVM","SVM",20,34,9833,9833,0,3500,2972,528,0.998785860478027,0.934865900383142,5.94047937271674,318,128,190,1,1.5,26.25,5.6,0,0,0,0,0,0,5.08766094943089e-06,0.0046000674898788,0.000549973114333829
24.3,"greedy_SVM","SVM",20,35,9733,9733,0,3600,3072,528,0.99879064526432,0.934865900383142,5.91930119313486,319,128,191,1,1.5,27,5.8,0,0,0,0,0,0,4.20884081805758e-06,0.00382015291892723,0.000453733209162735
24.3,"greedy_SVM","SVM",20,36,9633,9633,0,3700,3172,528,0.998797224345474,0.934865900383142,5.92458156886469,318,127,191,-1,1.5,27.75,6,0,0,0,0,0,0,3.63928070272197e-06,0.00330150877271705,0.000387538620130548
24.3,"greedy_SVM","SVM",20,37,9533,9533,0,3800,3272,528,0.998812176802641,0.934865900383142,5.95112539309796,317,127,190,-1,1.5,28.5,6.2,0,0,0,0,0,0,4.32519408114112e-06,0.0040203142194753,0.000460412037712415
24.3,"greedy_SVM","SVM",20,38,9433,9433,0,3900,3372,528,0.998819952080368,0.934865900383142,5.95112539309796,316,128,188,-1,1.5,29.25,6.4,0,0,0,0,0,0,3.48325042977599e-06,0.003234280460851,0.00037294761692537
24.3,"greedy_SVM","SVM",20,39,9333,9333,0,4000,3472,528,0.998832512144388,0.934865900383142,5.90351638995317,318,129,189,2,1.5,30,6.6,0,0,0,0,0,0,2.07036387744973e-06,0.00185367399915092,0.000223456764177426
24.3,"greedy_SVM","SVM",20,40,9233,9233,0,4100,3572,528,0.998831914046101,0.934865900383142,5.95112539309796,319,129,190,1,1.5,30.75,6.8,0,0,0,0,0,0,2.12849335060659e-06,0.00193179752480018,0.0002270536511549
24.3,"greedy_SVM","SVM",20,41,9133,9133,0,4200,3672,528,0.998842081716975,0.934865900383142,5.92458156886469,320,129,191,1,1.5,31.5,7,0,0,0,0,0,0,1.61829577629276e-06,0.00146159042185794,0.000172683804136815
24.3,"greedy_SVM","SVM",20,42,9033,9033,0,4300,3772,528,0.998851651289562,0.934865900383142,5.95112539309796,319,129,190,-1,1.5,32.25,7.1,0,0,0,0,0,0,1.50610481781809e-06,0.00134231175656537,0.000158204005171871
24.3,"greedy_SVM","SVM",20,43,8933,8933,0,4400,3872,528,0.998855239879282,0.934865900383142,5.95646272528907,319,128,191,0,1.5,33,7.3,0,0,0,0,0,0,1.7934903576031e-06,0.00163502699831867,0.000190353560666811
24.3,"greedy_SVM","SVM",20,44,8833,8833,0,4500,3972,528,0.998864211353582,0.934865900383142,5.91930119313486,319,128,191,0,1.5,33.75,7.5,0,0,0,0,0,0,1.11766721234092e-06,0.000970250623331352,0.00011943219577975
24.3,"greedy_SVM","SVM",20,45,8733,8733,0,4600,4072,528,0.998880360007322,0.934865900383142,5.95112539309796,320,128,192,1,1.5,34.5,7.7,0,0,0,0,0,0,1.0853818438235e-06,0.000962165177190908,0.00011622644138358
24.3,"greedy_SVM","SVM",20,46,8633,8633,0,4700,4172,528,0.998885144793616,0.934865900383142,5.88260047714554,319,128,191,-1,1.5,35.25,7.9,0,0,0,0,0,0,6.22999024556674e-07,0.000520940816297012,6.61698536246706e-05
24.3,"greedy_SVM","SVM",20,47,8533,8533,0,4800,4272,528,0.998900097250783,0.934865900383142,5.88260047714554,318,128,190,-1,1.5,36,8.1,0,0,0,0,0,0,4.82984939225906e-07,0.000400766746888689,5.20824286550745e-05
24.3,"greedy_SVM","SVM",20,48,8433,8433,0,4900,4372,528,0.998909068725083,0.938697318007663,5.90876862873427,317,128,189,-1,1.5,36.75,8.3,0,0,0,0,0,0,5.5904901578329e-07,0.000472025110608931,6.00594811843617e-05
24.3,"eps_greedy_SVM","SVM",1,0,13233,12713,520,100,94,6,0.942341763584092,0.85171102661597,5.23408148125971,32,6,26,0,4.3,0.75,15.7,0,0,0,0,0,0,0.999999996919012,1004.24022006763,99.9999998935655
24.3,"eps_greedy_SVM","SVM",1,1,13133,12713,420,200,94,106,0.947700225381959,0.840304182509506,5.15737511472401,48,18,30,16,1.7,1.5,0.9,0,0,0,0,0,0,0.977752355498745,527.909439377714,98.5026344774137
24.3,"eps_greedy_SVM","SVM",1,2,13033,12713,320,300,94,206,0.953755732515099,0.859315589353612,5.23195558094788,64,22,42,16,1.9,2.25,0.5,0,0,0,0,0,0,0.98283219603646,506.893029249972,98.9913284111165
24.3,"eps_greedy_SVM","SVM",1,3,12933,12713,220,400,94,306,0.951176546027549,0.859315589353612,5.26377459838197,79,28,51,15,1.8,3,0.3,0,0,0,0,0,0,0.899778821676633,366.26004909027,96.9548352585959
24.3,"eps_greedy_SVM","SVM",1,4,12833,12705,128,500,102,398,0.943624825738702,0.874524714828897,5.24175043688246,86,35,51,7,1.5,3.75,0.3,0,0,0,0,0,0,0.34201079858824,172.90562283617,73.822043063403
24.3,"eps_greedy_SVM","SVM",1,5,12733,12644,89,600,163,437,0.959416999356422,0.893536121673004,5.40022358485514,126,57,69,40,1.2,4.5,0.4,0,0,0,0,0,0,0.0179852352177875,51.0769945625882,29.19428426012
24.3,"eps_greedy_SVM","SVM",1,6,12633,12568,65,700,239,461,0.943428299328141,0.893536121673004,5.31418851310786,146,67,79,20,1.2,5.25,0.5,0,0,0,0,0,0,0.0109344677767412,27.1725306269336,8.26786799155444
24.3,"eps_greedy_SVM","SVM",1,7,12533,12470,63,800,337,463,0.940708397555703,0.893536121673004,5.13995282415351,144,66,78,-2,1.2,6,0.7,0,0,0,0,0,0,0.0035996776369909,10.2413787614071,5.41923078692658
24.3,"eps_greedy_SVM","SVM",1,8,12433,12372,61,900,435,465,0.949469556812147,0.893536121673004,5.17476739273538,146,64,82,2,1.3,6.75,0.9,0,0,0,0,0,0,0.00313015180008986,6.16043299582685,3.47353022455382
24.3,"eps_greedy_SVM","SVM",1,9,12333,12274,59,1000,533,467,0.950686120604275,0.893536121673004,5.21519526299113,148,67,81,2,1.2,7.5,1.1,0,0,0,0,0,0,0.00154220006991933,2.87602998952044,1.19464327763596
24.3,"eps_greedy_SVM","SVM",1,10,12233,12175,58,1100,632,468,0.951007331444452,0.893536121673004,5.20615679633083,148,68,80,0,1.2,8.25,1.4,0,0,0,0,0,0,0.00110742807541261,1.33885260916821,0.130642277224094
24.3,"eps_greedy_SVM","SVM",1,11,12133,12076,57,1200,731,469,0.954877892381901,0.893536121673004,5.24100740721249,152,66,86,4,1.3,9,1.6,0,0,0,0,0,0,0.0015720065419611,2.11794486862727,0.228946866656772
24.3,"eps_greedy_SVM","SVM",1,12,12033,11983,50,1300,824,476,0.96007485815662,0.901140684410646,5.3149299415715,164,73,91,12,1.2,9.75,1.7,0,0,0,0,0,0,0.00305075159598577,4.42864959488753,0.559810635415364
24.3,"eps_greedy_SVM","SVM",1,13,11933,11892,41,1400,915,485,0.959379594027471,0.91254752851711,5.36665510493904,190,87,103,26,1.2,10.5,1.9,0,0,0,0,0,0,0.002667865069449,3.42670227770491,0.682082452276632
24.3,"eps_greedy_SVM","SVM",1,14,11833,11801,32,1500,1006,494,0.958168373853759,0.923954372623574,5.3574340480577,211,94,117,21,1.2,11.25,2,0,0,0,0,0,0,0.00312766817994449,3.390558446437,0.587690308757193
24.3,"eps_greedy_SVM","SVM",1,15,11733,11703,30,1600,1104,496,0.958968729144999,0.923954372623574,5.3482446243046,213,94,119,2,1.3,12,2.2,0,0,0,0,0,0,0.00271592450209324,3.06385129569912,0.319088741880326
24.3,"eps_greedy_SVM","SVM",1,16,11633,11603,30,1700,1204,496,0.95912963143278,0.923954372623574,5.3574340480577,213,94,119,0,1.3,12.75,2.4,0,0,0,0,0,0,0.00192712652273207,2.50840551930334,0.215933118124185
24.3,"eps_greedy_SVM","SVM",1,17,11533,11503,30,1800,1304,496,0.959590370087101,0.923954372623574,5.35283539222246,214,94,120,1,1.3,13.5,2.6,0,0,0,0,0,0,0.00125979796720769,1.65868338583869,0.147481572442469
24.3,"eps_greedy_SVM","SVM",1,18,11433,11403,30,1900,1404,496,0.95988070668756,0.923954372623574,5.36204061215749,215,94,121,1,1.3,14.25,2.8,0,0,0,0,0,0,0.00145322698307317,2.18490441384055,0.156490993426433
24.3,"eps_greedy_SVM","SVM",1,19,11333,11303,30,2000,1504,496,0.960356882461731,0.923954372623574,5.36204061215749,212,95,117,-3,1.2,15,3,0,0,0,0,0,0,0.000799395559863384,1.11300738485279,0.0858957428432924
24.3,"eps_greedy_SVM","SVM",1,20,11233,11203,30,2100,1604,496,0.960926868425827,0.923954372623574,5.36204061215749,214,96,118,2,1.2,15.75,3.2,0,0,0,0,0,0,0.000766537419349812,1.06952435251289,0.0824594032035807
24.3,"eps_greedy_SVM","SVM",1,21,11133,11103,30,2200,1704,496,0.961130519660917,0.923954372623574,5.3574340480577,215,99,116,1,1.2,16.5,3.4,0,0,0,0,0,0,0.000824749783350138,1.1922280467753,0.0864376229543587
24.3,"eps_greedy_SVM","SVM",1,22,11033,11005,28,2300,1802,498,0.966401108622703,0.923954372623574,5.39311200846261,222,101,121,7,1.2,17.25,3.6,0,0,0,0,0,0,0.000785843884535021,1.33873794888347,0.0973003127378858
24.3,"eps_greedy_SVM","SVM",1,23,10933,10907,26,2400,1900,500,0.971011463842697,0.923954372623574,5.38847077609733,225,103,122,3,1.2,18,3.8,0,0,0,0,0,0,0.00137968336718886,2.61319524378793,0.160556495722934
24.3,"eps_greedy_SVM","SVM",1,24,10833,10812,21,2500,1995,505,0.987430028285546,0.931558935361217,5.6530743731577,240,108,132,15,1.2,18.75,4,0,0,0,0,0,0,0.00529994436699939,7.19868322554687,0.741362345856664
24.3,"eps_greedy_SVM","SVM",1,25,10733,10719,14,2600,2088,512,0.995387269838487,0.931558935361217,5.84478832175631,261,114,147,21,1.3,19.5,4.1,0,0,0,0,0,0,0.00676603071133735,9.32766263863684,0.877361822008803
24.3,"eps_greedy_SVM","SVM",1,26,10633,10623,10,2700,2184,516,0.997515811173148,0.931558935361217,5.87236975253233,277,122,155,16,1.3,20.25,4.2,0,0,0,0,0,0,0.00739798411580384,10.0217187480678,0.934524781427506
24.3,"eps_greedy_SVM","SVM",1,27,10533,10530,3,2800,2277,523,0.999159270702959,0.935361216730038,5.9052258635961,301,129,172,24,1.3,21,4.4,0,0,0,0,0,0,0.013711945242294,14.147538256692,1.80740100297822
24.3,"eps_greedy_SVM","SVM",1,28,10433,10433,0,2900,2374,526,0.999324922873775,0.939163498098859,5.92095914742451,306,133,173,5,1.3,21.75,4.5,0,0,0,0,0,0,0.00914353478226734,9.78356672620952,1.11892725444239
24.3,"eps_greedy_SVM","SVM",1,29,10333,10333,0,3000,2474,526,0.999326110344533,0.939163498098859,5.92095914742451,308,134,174,2,1.3,22.5,4.7,0,0,0,0,0,0,0.00771883694216489,9.60285552290108,0.860066051482159
24.3,"eps_greedy_SVM","SVM",1,30,10233,10233,0,3100,2574,526,0.999332047698326,0.939163498098859,5.92095914742451,307,134,173,-1,1.3,23.25,4.9,0,0,0,0,0,0,0.00523092636265303,6.35875333296644,0.567369281366005
24.3,"eps_greedy_SVM","SVM",1,31,10133,10133,0,3200,2674,526,0.999342141199773,0.939163498098859,5.92095914742451,302,133,169,-5,1.3,24,5.1,0,0,0,0,0,0,0.00489026746283929,6.54315337398033,0.527415083387222
24.3,"eps_greedy_SVM","SVM",1,32,10033,10033,0,3300,2774,526,0.9993528284366,0.939163498098859,5.92095914742451,303,133,170,1,1.3,24.75,5.3,0,0,0,0,0,0,0.00537706952650168,8.22347299663058,0.568640178707005
24.3,"eps_greedy_SVM","SVM",1,33,9933,9933,0,3400,2874,526,0.999359359525772,0.939163498098859,5.91570541259982,299,132,167,-4,1.3,25.5,5.5,0,0,0,0,0,0,0.00351247575886364,5.01575891334275,0.371424644816923
24.3,"eps_greedy_SVM","SVM",1,34,9833,9833,0,3500,2974,526,0.999366484350323,0.939163498098859,5.91570541259982,302,133,169,3,1.3,26.25,5.7,0,0,0,0,0,0,0.00302753826634212,4.31702726961143,0.316290041726582
24.3,"eps_greedy_SVM","SVM",1,35,9733,9733,0,3600,3074,526,0.999378952793288,0.939163498098859,5.91570541259982,302,133,169,0,1.3,27,5.8,0,0,0,0,0,0,0.00308562336097467,4.66714649742492,0.3223286040912
24.3,"eps_greedy_SVM","SVM",1,36,9633,9633,0,3700,3174,526,0.999393796177769,0.939163498098859,5.91570541259982,306,133,173,4,1.3,27.75,6,0,0,0,0,0,0,0.00249728704168633,3.65412754928935,0.261065709731664
24.3,"eps_greedy_SVM","SVM",1,37,9533,9533,0,3800,3274,526,0.999404483414596,0.939163498098859,5.91570541259982,310,133,177,4,1.3,28.5,6.2,0,0,0,0,0,0,0.00210223767410803,3.12905052043051,0.220167168287046
24.3,"eps_greedy_SVM","SVM",1,38,9433,9433,0,3900,3374,526,0.99940982703301,0.939163498098859,5.894783377542,309,133,176,-1,1.3,29.25,6.4,0,0,0,0,0,0,0.00191172911801277,2.94873224161388,0.201082200298656
24.3,"eps_greedy_SVM","SVM",1,39,9333,9333,0,4000,3474,526,0.999414576916044,0.939163498098859,5.9,310,132,178,1,1.3,30,6.6,0,0,0,0,0,0,0.00169847170030773,2.62496436393886,0.176291688880575
24.3,"eps_greedy_SVM","SVM",1,40,9233,9233,0,4100,3574,526,0.999418733063698,0.939163498098859,5.8636763412489,310,132,178,0,1.3,30.75,6.8,0,0,0,0,0,0,0.0013010347517061,1.9029723682787,0.135857510561116
24.3,"eps_greedy_SVM","SVM",1,41,9133,9133,0,4200,3674,526,0.99942585788825,0.939163498098859,5.9,308,131,177,-2,1.4,31.5,7,0,0,0,0,0,0,0.0014292332406896,2.20851626498192,0.148204105822462
24.3,"eps_greedy_SVM","SVM",1,42,9033,9033,0,4300,3774,526,0.999429420300525,0.939163498098859,5.894783377542,306,131,175,-2,1.3,32.25,7.2,0,0,0,0,0,0,0.001163145627666,1.73790573150973,0.120249679893778
24.3,"eps_greedy_SVM","SVM",1,43,8933,8933,0,4400,3874,526,0.999430607771284,0.939163498098859,5.8636763412489,306,131,175,0,1.3,33,7.4,0,0,0,0,0,0,0.000901293581666908,1.30502571036192,0.0934780674583183
24.3,"eps_greedy_SVM","SVM",1,44,8833,8833,0,4500,3974,526,0.999437732595835,0.939163498098859,5.894783377542,307,131,176,1,1.3,33.75,7.6,0,0,0,0,0,0,0.000880337481573077,1.28581096567753,0.0911729890484102
24.3,"eps_greedy_SVM","SVM",1,45,8733,8733,0,4600,4074,526,0.999438920066594,0.939163498098859,5.894783377542,307,131,176,0,1.3,34.5,7.7,0,0,0,0,0,0,0.00139151916207747,2.24059684275663,0.142889523903927
24.3,"eps_greedy_SVM","SVM",1,46,8633,8633,0,4700,4174,526,0.999443076214248,0.942965779467681,5.894783377542,307,131,176,0,1.3,35.25,7.9,0,0,0,0,0,0,0.000986928671672477,1.4901199137295,0.101537708139936
24.3,"eps_greedy_SVM","SVM",1,47,8533,8533,0,4800,4274,526,0.999444263685007,0.942965779467681,5.894783377542,309,131,178,2,1.4,36,8.1,0,0,0,0,0,0,0.000800947864400789,1.1835890749606,0.0831405210456511
24.3,"eps_greedy_SVM","SVM",1,48,8433,8433,0,4900,4374,526,0.999445451155765,0.942965779467681,5.8585237258348,310,131,179,1,1.4,36.75,8.3,0,0,0,0,0,0,0.000612792487944199,0.87831760976357,0.0641646568470946
24.3,"eps_greedy_SVM","SVM",2,0,13233,12702,531,100,90,10,0.946111342837974,0.782258064516129,5.24323242915091,24,8,16,0,2,0.75,9,0,0,0,0,0,0,0.995984091137334,691.500948752757,99.8669048063219
24.3,"eps_greedy_SVM","SVM",2,1,13133,12702,431,200,90,110,0.94939544396921,0.786290322580645,5.11842677392179,35,9,26,11,2.9,1.5,0.8,0,0,0,0,0,0,0.977940482356282,496.665801096153,98.729232046185
24.3,"eps_greedy_SVM","SVM",2,2,13033,12701,332,300,91,209,0.952580293383001,0.834677419354839,5.1584578572792,54,15,39,19,2.6,2.25,0.4,0,0,0,0,0,0,0.969197450753178,353.968258392192,98.1826380186817
24.3,"eps_greedy_SVM","SVM",2,3,12933,12699,234,400,93,307,0.961331405253543,0.842741935483871,5.24492221556234,70,25,45,16,1.8,3,0.3,0,0,0,0,0,0,0.765039354181222,218.216619325122,95.9543564486057
24.3,"eps_greedy_SVM","SVM",2,4,12833,12684,149,500,108,392,0.964416374774455,0.887096774193548,5.39513697868912,88,33,55,18,1.7,3.75,0.3,0,0,0,0,0,0,0.0444737271396291,72.6282644685844,41.7040408419855
24.3,"eps_greedy_SVM","SVM",2,5,12733,12635,98,600,157,443,0.975921407715995,0.923387096774194,5.65704774889766,126,57,69,38,1.2,4.5,0.4,0,0,0,0,0,0,0.021275883729227,48.1446198983408,28.9650591317469
24.3,"eps_greedy_SVM","SVM",2,6,12633,12559,74,700,233,467,0.961522998758699,0.923387096774194,5.30708773637375,147,62,85,21,1.4,5.25,0.5,0,0,0,0,0,0,0.0113310756705547,30.9478279294837,9.68265620167561
24.3,"eps_greedy_SVM","SVM",2,7,12533,12461,72,800,331,469,0.97054987964158,0.923387096774194,5.48442641392693,158,69,89,11,1.3,6,0.7,0,0,0,0,0,0,0.00430764881129383,7.37552973565529,6.53053652668287
24.3,"eps_greedy_SVM","SVM",2,8,12433,12365,68,900,427,473,0.97430322781662,0.923387096774194,5.5741787316908,167,71,96,9,1.4,6.75,0.9,0,0,0,0,0,0,0.00382320022118057,4.34879771891293,3.47873330873866
24.3,"eps_greedy_SVM","SVM",2,9,12333,12268,65,1000,524,476,0.976600465352371,0.923387096774194,5.57905979888142,171,80,91,4,1.1,7.5,1.1,0,0,0,0,0,0,0.0030880623492096,1.73633911347182,1.36128608207217
24.3,"eps_greedy_SVM","SVM",2,10,12233,12170,63,1100,622,478,0.977467347441316,0.923387096774194,5.57905979888142,169,77,92,-2,1.2,8.25,1.3,0,0,0,0,0,0,0.00300751198895022,0.700594745688711,0.337912897255983
24.3,"eps_greedy_SVM","SVM",2,11,12133,12070,63,1200,722,478,0.977571624562161,0.923387096774194,5.57905979888142,165,73,92,-4,1.3,9,1.5,0,0,0,0,0,0,1.86670926774055e-05,0.250154162734991,0.238677412234596
24.3,"eps_greedy_SVM","SVM",2,12,12033,11970,63,1300,822,478,0.977939735362252,0.923387096774194,5.57905979888142,167,73,94,2,1.3,9.75,1.7,0,0,0,0,0,0,1.50789441554092e-05,0.0288454544137539,0.0196183964760063
24.3,"eps_greedy_SVM","SVM",2,13,11933,11870,63,1400,922,478,0.978212363497474,0.923387096774194,5.5741787316908,168,73,95,1,1.3,10.5,1.9,0,0,0,0,0,0,7.35331288435085e-06,0.00528666872019478,0.000854930845301131
24.3,"eps_greedy_SVM","SVM",2,14,11833,11771,62,1500,1021,479,0.979160908391897,0.923387096774194,5.58792083392027,174,76,98,6,1.3,11.25,2.1,0,0,0,0,0,0,7.02026925142395e-06,0.00521925181002016,0.000831527616111516
24.3,"eps_greedy_SVM","SVM",2,15,11733,11672,61,1600,1120,480,0.980757730326775,0.923387096774194,5.63601089417091,176,79,97,2,1.2,12,2.3,0,0,0,0,0,0,7.26124895409125e-06,0.00849347574019683,0.00359507733875281
24.3,"eps_greedy_SVM","SVM",2,16,11633,11575,58,1700,1217,483,0.982664870922464,0.923387096774194,5.6931621690572,182,82,100,6,1.2,12.75,2.5,0,0,0,0,0,0,1.88188347652354e-05,0.298680285687222,0.285504940992298
24.3,"eps_greedy_SVM","SVM",2,17,11533,11481,52,1800,1311,489,0.984041831457963,0.931451612903226,5.73189569418786,198,88,110,16,1.2,13.5,2.7,0,0,0,0,0,0,0.00458954842330579,2.93203095583904,0.580359488686229
24.3,"eps_greedy_SVM","SVM",2,18,11433,11392,41,1900,1400,500,0.983640427360243,0.951612903225806,5.71678524859686,229,101,128,31,1.3,14.25,2.8,0,0,0,0,0,0,0.0104142882568382,9.59050248257865,1.6419851175199
24.3,"eps_greedy_SVM","SVM",2,19,11333,11301,32,2000,1491,509,0.983338903155385,0.959677419354839,5.7067558007923,249,108,141,20,1.3,15,2.9,0,0,0,0,0,0,0.0103815602273018,6.86000262751906,1.55300916428202
24.3,"eps_greedy_SVM","SVM",2,20,11233,11201,32,2100,1591,509,0.982931217303401,0.963709677419355,5.7067558007923,250,108,142,1,1.3,15.75,3.1,0,0,0,0,0,0,0.006014664876573,3.28020619899315,0.70504159868403
24.3,"eps_greedy_SVM","SVM",2,21,11133,11101,32,2200,1691,509,0.982725803938841,0.963709677419355,5.7067558007923,249,107,142,-1,1.3,16.5,3.3,0,0,0,0,0,0,0.00430198925794779,1.85208517311164,0.480112471926587
24.3,"eps_greedy_SVM","SVM",2,22,11033,11001,32,2300,1791,509,0.982546773942207,0.963709677419355,5.69177743911043,248,107,141,-1,1.3,17.25,3.5,0,0,0,0,0,0,0.00405325715586344,1.70533654244506,0.42813983835488
24.3,"eps_greedy_SVM","SVM",2,23,10933,10901,32,2400,1891,509,0.982402293594046,0.963709677419355,5.69177743911043,246,105,141,-2,1.3,18,3.7,0,0,0,0,0,0,0.00312045013509167,0.811101138090094,0.333784854148386
24.3,"eps_greedy_SVM","SVM",2,24,10833,10801,32,2500,1991,509,0.98221195643973,0.963709677419355,5.68680210918114,248,107,141,2,1.3,18.75,3.9,0,0,0,0,0,0,0.00286572223587748,0.621466398562895,0.304772604323495
24.3,"eps_greedy_SVM","SVM",2,25,10733,10701,32,2600,2091,509,0.982041092723644,0.963709677419355,5.69177743911043,250,107,143,2,1.3,19.5,4.1,0,0,0,0,0,0,1.76567836688192e-05,0.200330467467666,0.189332963767859
24.3,"eps_greedy_SVM","SVM",2,26,10633,10601,32,2700,2191,509,0.981921739392554,0.963709677419355,5.69177743911043,251,107,144,1,1.3,20.25,4.3,0,0,0,0,0,0,1.30067441841258e-05,0.0102456250427732,0.00146795446519078
24.3,"eps_greedy_SVM","SVM",2,27,10533,10501,32,2800,2291,509,0.981806783289452,0.963709677419355,5.69177743911043,252,107,145,1,1.4,21,4.5,0,0,0,0,0,0,8.44517607402948e-06,0.00675406858577538,0.000942954596173555
24.3,"eps_greedy_SVM","SVM",2,28,10433,10401,32,2900,2391,509,0.981666700169279,0.963709677419355,5.69177743911043,251,107,144,-1,1.3,21.75,4.7,0,0,0,0,0,0,4.89046902006209e-06,0.00395454583505904,0.000546124550063913
24.3,"eps_greedy_SVM","SVM",2,29,10333,10301,32,3000,2491,509,0.981578755609529,0.963709677419355,5.67687749817035,251,108,143,0,1.3,22.5,4.9,0,0,0,0,0,0,6.88544973894118e-06,0.00591132900072473,0.00075308895044227
24.3,"eps_greedy_SVM","SVM",2,30,10233,10201,32,3100,2591,509,0.981527873399959,0.963709677419355,5.67192817166803,251,108,143,0,1.3,23.25,5.1,0,0,0,0,0,0,5.55196468880732e-06,0.0048440513237316,0.000594797432562051
24.3,"eps_greedy_SVM","SVM",2,31,10133,10102,31,3200,2690,510,0.984134173245697,0.963709677419355,5.69177743911043,254,108,146,3,1.4,24,5.3,0,0,0,0,0,0,7.47136547299324e-06,0.0488719650566862,0.0427950505922061
24.3,"eps_greedy_SVM","SVM",2,32,10033,10006,27,3300,2786,514,0.993972028604593,0.963709677419355,5.73033743633277,270,112,158,16,1.4,24.75,5.4,0,0,0,0,0,0,1.02824081050315e-05,0.681720499295168,0.674730054847693
24.3,"eps_greedy_SVM","SVM",2,33,9933,9928,5,3400,2864,536,0.999847353371292,0.971774193548387,5.83800350262697,321,134,187,51,1.4,25.5,5.3,0,0,0,0,0,0,1.82852248799886e-05,3.41910380967309,3.41528212087824
24.3,"eps_greedy_SVM","SVM",2,34,9833,9833,0,3500,2959,541,0.999843584318731,0.971774193548387,5.832895888014,334,141,193,13,1.4,26.25,5.5,0,0,0,0,0,0,1.02356002593234e-05,0.120238146457589,0.114289584284116
24.3,"eps_greedy_SVM","SVM",2,35,9733,9733,0,3600,3059,541,0.999844212494158,0.971774193548387,5.85338015803336,337,141,196,3,1.4,27,5.7,0,0,0,0,0,0,5.76303916247753e-06,0.00492726196268295,0.000693381563654765
24.3,"eps_greedy_SVM","SVM",2,36,9633,9633,0,3700,3159,541,0.999844840669585,0.971774193548387,5.85338015803336,338,141,197,1,1.4,27.75,5.8,0,0,0,0,0,0,6.06273992016615e-06,0.00588357312802548,0.000679951034190485
24.3,"eps_greedy_SVM","SVM",2,37,9533,9533,0,3800,3259,541,0.999845468845012,0.971774193548387,5.85338015803336,337,141,196,-1,1.4,28.5,6,0,0,0,0,0,0,4.51314081911859e-06,0.00433797168359356,0.000487987625535075
24.3,"eps_greedy_SVM","SVM",2,38,9433,9433,0,3900,3359,541,0.999843584318731,0.971774193548387,5.82270742358079,338,141,197,1,1.4,29.25,6.2,0,0,0,0,0,0,3.16897837018872e-06,0.00306852872092333,0.000341774732239423
24.3,"eps_greedy_SVM","SVM",2,39,9333,9333,0,4000,3459,541,0.999842327967878,0.971774193548387,5.83800350262697,338,141,197,0,1.4,30,6.4,0,0,0,0,0,0,3.16484436650061e-06,0.00313325043338666,0.000335301353804838
24.3,"eps_greedy_SVM","SVM",2,40,9233,9233,0,4100,3559,541,0.999844212494158,0.971774193548387,5.82270742358079,337,141,196,-1,1.4,30.75,6.6,0,0,0,0,0,0,2.06449443973274e-06,0.00198057988484383,0.000221361759147711
24.3,"eps_greedy_SVM","SVM",2,41,9133,9133,0,4200,3659,541,0.999844212494158,0.971774193548387,5.832895888014,338,141,197,1,1.4,31.5,6.8,0,0,0,0,0,0,2.36642977631061e-06,0.00234740911030449,0.000251165078891232
24.3,"eps_greedy_SVM","SVM",2,42,9033,9033,0,4300,3759,541,0.999843584318731,0.971774193548387,5.832895888014,337,141,196,-1,1.4,32.25,6.9,0,0,0,0,0,0,2.12939359185672e-06,0.0021478435357119,0.000226625199737691
24.3,"eps_greedy_SVM","SVM",2,43,8933,8933,0,4400,3859,541,0.999842327967878,0.971774193548387,5.82270742358079,336,142,194,-1,1.4,33,7.1,0,0,0,0,0,0,1.57704647260847e-06,0.00155796693513803,0.000167858052982113
24.3,"eps_greedy_SVM","SVM",2,44,8833,8833,0,4500,3959,541,0.999842956143304,0.971774193548387,5.832895888014,336,142,194,0,1.4,33.75,7.3,0,0,0,0,0,0,1.49417650651053e-06,0.00150777249716232,0.000159189784382406
24.3,"eps_greedy_SVM","SVM",2,45,8733,8733,0,4600,4059,541,0.999843584318731,0.971774193548387,5.80749128919861,337,142,195,1,1.4,34.5,7.5,0,0,0,0,0,0,7.12413825227293e-07,0.000667959253676097,7.58509111674364e-05
24.3,"eps_greedy_SVM","SVM",2,46,8633,8633,0,4700,4159,541,0.999841699792451,0.971774193548387,5.832895888014,336,141,195,-1,1.4,35.25,7.7,0,0,0,0,0,0,1.13759155673511e-06,0.00113643607656578,0.000120316413435478
24.3,"eps_greedy_SVM","SVM",2,47,8533,8533,0,4800,4259,541,0.999841699792451,0.971774193548387,5.832895888014,339,141,198,3,1.4,36,7.9,0,0,0,0,0,0,9.26325825037639e-07,0.000914281724592775,9.79489675033403e-05
24.3,"eps_greedy_SVM","SVM",2,48,8433,8433,0,4900,4359,541,0.999842327967878,0.971774193548387,5.82270742358079,340,141,199,1,1.4,36.75,8.1,0,0,0,0,0,0,6.42614538319561e-07,0.000625557757715889,6.89521064988043e-05
24.3,"eps_greedy_SVM","SVM",3,0,13233,12728,505,100,95,5,0.959547808054075,0.842293906810036,5.31253178058067,30,5,25,0,5,0.75,19,0,0,0,0,0,0,0.999993137490236,743.087079222836,99.9998100023469
24.3,"eps_greedy_SVM","SVM",3,1,13133,12728,405,200,95,105,0.957830879134917,0.824372759856631,5.28710676507687,44,12,32,14,2.7,1.5,0.9,0,0,0,0,0,0,0.925647419352749,364.572958222203,95.8883917259754
24.3,"eps_greedy_SVM","SVM",3,2,13033,12724,309,300,99,201,0.954993457715276,0.870967741935484,5.30792214604174,66,22,44,22,2,2.25,0.5,0,0,0,0,0,0,0.921697792240842,260.200632001761,96.5958390856071
24.3,"eps_greedy_SVM","SVM",3,3,12933,12722,211,400,101,299,0.960715431936669,0.888888888888889,5.42125856197145,80,31,49,14,1.6,3,0.3,0,0,0,0,0,0,0.761479494850781,193.840024353228,92.9037276873358
24.3,"eps_greedy_SVM","SVM",3,4,12833,12717,116,500,106,394,0.965803376851301,0.899641577060932,5.45523242941443,95,43,52,15,1.2,3.75,0.3,0,0,0,0,0,0,0.0369619006174956,60.4036167638773,52.5641823618949
24.3,"eps_greedy_SVM","SVM",3,5,12733,12641,92,600,182,418,0.961108754541996,0.903225806451613,5.44520149903091,131,57,74,36,1.3,4.5,0.4,0,0,0,0,0,0,0.0204757438482401,51.5416875453149,35.2178931281296
24.3,"eps_greedy_SVM","SVM",3,6,12633,12549,84,700,274,426,0.951115779362265,0.903225806451613,5.24547600314713,139,61,78,8,1.3,5.25,0.6,0,0,0,0,0,0,0.00407837708024784,31.6478539730592,25.4793285793717
24.3,"eps_greedy_SVM","SVM",3,7,12533,12451,82,800,372,428,0.954142287398185,0.903225806451613,5.17337324021727,146,62,84,7,1.4,6,0.9,0,0,0,0,0,0,0.00189006611033743,25.4447367106266,23.1710800594312
24.3,"eps_greedy_SVM","SVM",3,8,12433,12356,77,900,467,433,0.956506150645359,0.903225806451613,5.20732343579722,145,63,82,-1,1.3,6.75,1.1,0,0,0,0,0,0,0.00134002011301649,19.7833103029974,18.1288360790516
24.3,"eps_greedy_SVM","SVM",3,9,12333,12257,76,1000,566,434,0.95861696325772,0.903225806451613,5.22340668356992,145,64,81,0,1.3,7.5,1.3,0,0,0,0,0,0,0.000846363922906902,18.00292018554,17.0795840908473
24.3,"eps_greedy_SVM","SVM",3,10,12233,12158,75,1100,665,435,0.960430960380457,0.903225806451613,5.24144953912629,142,62,80,-3,1.3,8.25,1.5,0,0,0,0,0,0,0.00093204898008762,17.1847654839523,16.085712320223
24.3,"eps_greedy_SVM","SVM",3,11,12133,12059,74,1200,764,436,0.96215798888148,0.903225806451613,5.23241255716228,145,65,80,3,1.2,9,1.8,0,0,0,0,0,0,0.000402231957651202,15.4561166006433,15.0373790333281
24.3,"eps_greedy_SVM","SVM",3,12,12033,11960,73,1300,863,437,0.963525921137974,0.903225806451613,5.23241255716228,144,64,80,-1,1.2,9.75,2,0,0,0,0,0,0,0.000309747132958077,14.3569373058974,14.0295062490036
24.3,"eps_greedy_SVM","SVM",3,13,11933,11862,71,1400,961,439,0.966549062646581,0.903225806451613,5.27816279637928,150,66,84,6,1.3,10.5,2.2,0,0,0,0,0,0,0.000510589210901436,13.6681967742196,13.0615483245642
24.3,"eps_greedy_SVM","SVM",3,14,11833,11769,64,1500,1054,446,0.970343138905167,0.906810035842294,5.36990052756635,165,71,94,15,1.3,11.25,2.4,0,0,0,0,0,0,0.00103033121265852,13.3295156971423,12.2740346229993
24.3,"eps_greedy_SVM","SVM",3,15,11733,11680,53,1600,1143,457,0.967248739235503,0.917562724014337,5.37198188435998,185,83,102,20,1.2,12,2.5,0,0,0,0,0,0,0.00149562762676475,12.5302516105428,11.6143663193742
24.3,"eps_greedy_SVM","SVM",3,16,11633,11593,40,1700,1230,470,0.965049274737767,0.921146953405018,5.35601285378816,215,96,119,30,1.2,12.75,2.6,0,0,0,0,0,0,0.00167603398735666,11.4543749210663,10.3118248907066
24.3,"eps_greedy_SVM","SVM",3,17,11533,11495,38,1800,1328,472,0.964680078911365,0.921146953405018,5.34679424302432,219,97,122,4,1.3,13.5,2.8,0,0,0,0,0,0,0.00131348061881284,10.300571040738,9.14529089787136
24.3,"eps_greedy_SVM","SVM",3,18,11433,11397,36,1900,1426,474,0.966414401554874,0.924731182795699,5.38792342950913,223,98,125,4,1.3,14.25,3,0,0,0,0,0,0,0.00131016175787666,9.62021451706056,8.13429223925556
24.3,"eps_greedy_SVM","SVM",3,19,11333,11298,35,2000,1525,475,0.967029353873622,0.924731182795699,5.39256419043032,223,99,124,0,1.3,15,3.2,0,0,0,0,0,0,0.000957945805168439,8.21890621917958,7.09745507926616
24.3,"eps_greedy_SVM","SVM",3,20,11233,11199,34,2100,1624,476,0.967267816223499,0.924731182795699,5.39256419043032,224,99,125,1,1.3,15.75,3.4,0,0,0,0,0,0,0.000785378098656133,7.01865661370108,6.07963355265172
24.3,"eps_greedy_SVM","SVM",3,21,11133,11100,33,2200,1723,477,0.967490568112679,0.924731182795699,5.39256419043032,223,99,124,-1,1.3,16.5,3.6,0,0,0,0,0,0,0.000716422752054865,5.99434848584845,5.0734370011787
24.3,"eps_greedy_SVM","SVM",3,22,11033,11001,32,2300,1822,478,0.967739130044437,0.924731182795699,5.41314649650067,222,99,123,-1,1.2,17.25,3.8,0,0,0,0,0,0,0.000628737039160049,4.95751315242289,4.0652317522084
24.3,"eps_greedy_SVM","SVM",3,23,10933,10902,31,2400,1921,479,0.967647672719658,0.924731182795699,5.41314649650067,225,99,126,3,1.3,18,4,0,0,0,0,0,0,0.00040940827239878,3.60925256002162,3.04187528982842
24.3,"eps_greedy_SVM","SVM",3,24,10833,10803,30,2500,2020,480,0.968009013315716,0.924731182795699,5.42438447101027,223,99,124,-2,1.3,18.75,4.2,0,0,0,0,0,0,0.000394584169547091,2.60033594161001,2.0408137366976
24.3,"eps_greedy_SVM","SVM",3,25,10733,10704,29,2600,2119,481,0.96797759239432,0.924731182795699,5.42438447101027,224,100,124,1,1.2,19.5,4.4,0,0,0,0,0,0,0.000422808705622365,1.70914853489123,1.04467969108201
24.3,"eps_greedy_SVM","SVM",3,26,10633,10605,28,2700,2218,482,0.968324905793322,0.924731182795699,5.42438447101027,224,101,123,0,1.2,20.25,4.6,0,0,0,0,0,0,0.000280731708147153,0.460216575998093,0.0299493126634779
24.3,"eps_greedy_SVM","SVM",3,27,10533,10506,27,2800,2317,483,0.97134075315947,0.92831541218638,5.42438447101027,224,101,123,0,1.2,21,4.8,0,0,0,0,0,0,0.000507083628429345,0.935576619070702,0.0566950716629519
24.3,"eps_greedy_SVM","SVM",3,28,10433,10408,25,2900,2415,485,0.977224881778777,0.924731182795699,5.44961720923633,230,104,126,6,1.2,21.75,5,0,0,0,0,0,0,0.00106465748342599,1.71950868776387,0.127026225603425
24.3,"eps_greedy_SVM","SVM",3,29,10333,10310,23,3000,2513,487,0.981651304080452,0.924731182795699,5.46844144830105,239,106,133,9,1.3,22.5,5.2,0,0,0,0,0,0,0.00200108172954338,2.88911156413145,0.228948888042545
24.3,"eps_greedy_SVM","SVM",3,30,10233,10213,20,3100,2610,490,0.986987810926846,0.924731182795699,5.55433076251138,250,111,139,11,1.3,23.25,5.3,0,0,0,0,0,0,0.003534485794533,4.52234601378862,0.425142095640405
24.3,"eps_greedy_SVM","SVM",3,31,10133,10118,15,3200,2705,495,0.990765054548956,0.924731182795699,5.65574807093331,266,115,151,16,1.3,24,5.5,0,0,0,0,0,0,0.00762412987085539,7.84644609919446,0.962806330162678
24.3,"eps_greedy_SVM","SVM",3,32,10033,10020,13,3300,2803,497,0.993817372627434,0.92831541218638,5.75859253585018,266,117,149,0,1.3,24.75,5.6,0,0,0,0,0,0,0.00619907842714021,6.74962103198521,0.763956988984782
24.3,"eps_greedy_SVM","SVM",3,33,9933,9924,9,3400,2899,501,0.996259788178102,0.92831541218638,5.84735678913839,288,122,166,22,1.4,25.5,5.8,0,0,0,0,0,0,0.00688623125771132,7.1614036708084,0.890513827452141
24.3,"eps_greedy_SVM","SVM",3,34,9833,9828,5,3500,2995,505,0.997560389888748,0.931899641577061,5.84735678913839,294,126,168,6,1.3,26.25,5.9,0,0,0,0,0,0,0.00708583871287238,7.66693444337412,0.947249769088611
24.3,"eps_greedy_SVM","SVM",3,35,9733,9730,3,3600,3093,507,0.99815121542857,0.931899641577061,5.88406017949719,300,127,173,6,1.4,27,6.1,0,0,0,0,0,0,0.00613143095457293,7.12772253365659,0.735901412543168
24.3,"eps_greedy_SVM","SVM",3,36,9633,9633,0,3700,3190,510,0.999219526756037,0.931899641577061,5.9579982126899,303,130,173,3,1.3,27.75,6.3,0,0,0,0,0,0,0.00502235058437753,5.89886638930552,0.634019801974202
24.3,"eps_greedy_SVM","SVM",3,37,9533,9533,0,3800,3290,510,0.999230748513678,0.931899641577061,5.9579982126899,306,132,174,3,1.3,28.5,6.5,0,0,0,0,0,0,0.00419276339341453,5.09780270391339,0.44524128486088
24.3,"eps_greedy_SVM","SVM",3,38,9433,9433,0,3900,3390,510,0.999237481568263,0.931899641577061,5.95267857142857,304,131,173,-2,1.3,29.25,6.6,0,0,0,0,0,0,0.0036688939177982,4.57184298031552,0.392174541711189
24.3,"eps_greedy_SVM","SVM",3,39,9333,9333,0,4000,3490,510,0.999246458974376,0.931899641577061,5.95267857142857,304,131,173,0,1.3,30,6.8,0,0,0,0,0,0,0.00309179017864427,3.89649383804189,0.325826263220811
24.3,"eps_greedy_SVM","SVM",3,40,9233,9233,0,4100,3590,510,0.999255436380489,0.931899641577061,5.97401433691756,303,131,172,-1,1.3,30.75,7,0,0,0,0,0,0,0.00304380110712992,3.96688830366991,0.318364766432978
24.3,"eps_greedy_SVM","SVM",3,41,9133,9133,0,4200,3690,510,0.999264413786603,0.931899641577061,5.97401433691756,306,131,175,3,1.3,31.5,7.2,0,0,0,0,0,0,0.00336441009709541,4.97308419793316,0.353493229058055
24.3,"eps_greedy_SVM","SVM",3,42,9033,9033,0,4300,3790,510,0.999272830104834,0.931899641577061,5.97401433691756,307,131,176,1,1.3,32.25,7.4,0,0,0,0,0,0,0.00247387613105486,3.41313438071163,0.258015139825557
24.3,"eps_greedy_SVM","SVM",3,43,8933,8933,0,4400,3890,510,0.999286857301885,0.931899641577061,5.92622222222222,308,131,177,1,1.4,33,7.6,0,0,0,0,0,0,0.00217288719781107,3.03147198291688,0.22843761357821
24.3,"eps_greedy_SVM","SVM",3,44,8833,8833,0,4500,3990,510,0.999293870900411,0.931899641577061,5.894783377542,307,131,176,-1,1.3,33.75,7.8,0,0,0,0,0,0,0.00156935078868442,2.03086302582596,0.163027483122091
24.3,"eps_greedy_SVM","SVM",3,45,8733,8733,0,4600,4090,510,0.999305373201994,0.931899641577061,5.91570541259982,307,131,176,0,1.3,34.5,8,0,0,0,0,0,0,0.00173812919294596,2.34379011549552,0.181580706221561
24.3,"eps_greedy_SVM","SVM",3,46,8633,8633,0,4700,4190,510,0.999315472783871,0.931899641577061,5.91570541259982,313,132,181,6,1.4,35.25,8.2,0,0,0,0,0,0,0.00146416178818753,1.95304754360545,0.15178257874513
24.3,"eps_greedy_SVM","SVM",3,47,8533,8533,0,4800,4290,510,0.999325011277866,0.931899641577061,5.92095914742451,312,132,180,-1,1.4,36,8.4,0,0,0,0,0,0,0.00125795405347947,1.70183840845172,0.132238978937815
24.3,"eps_greedy_SVM","SVM",3,48,8433,8433,0,4900,4390,510,0.999329499980923,0.931899641577061,5.92622222222222,312,133,179,0,1.3,36.75,8.6,0,0,0,0,0,0,0.0013195636027099,1.79861882547543,0.136920759171442
24.3,"eps_greedy_SVM","SVM",4,0,13233,12728,505,100,94,6,0.971594613493727,0.852517985611511,5.47142111485637,35,6,29,0,4.8,0.75,15.7,0,0,0,0,0,0,0.875501141926619,1022.68582891835,94.3625055975028
24.3,"eps_greedy_SVM","SVM",4,1,13133,12725,408,200,97,103,0.974578327633698,0.877697841726619,5.50026867785209,64,23,41,29,1.8,1.5,0.9,0,0,0,0,0,0,0.971938623258547,703.689224979279,98.2813898897887
24.3,"eps_greedy_SVM","SVM",4,2,13033,12724,309,300,98,202,0.972934596445528,0.884892086330935,5.51139461101926,79,35,44,15,1.3,2.25,0.5,0,0,0,0,0,0,0.971826259244379,648.426334951116,98.3589326459622
24.3,"eps_greedy_SVM","SVM",4,3,12933,12722,211,400,100,300,0.974762153026034,0.884892086330935,5.50823652032438,85,34,51,6,1.5,3,0.3,0,0,0,0,0,0,0.923007584517689,421.889865531248,97.1092195139439
24.3,"eps_greedy_SVM","SVM",4,4,12833,12717,116,500,105,395,0.977594133802359,0.888489208633094,5.57179309555889,98,42,56,13,1.3,3.75,0.3,0,0,0,0,0,0,0.155075432019672,231.533177224533,57.1420917473011
24.3,"eps_greedy_SVM","SVM",4,5,12733,12665,68,600,157,443,0.950556881150271,0.892086330935252,5.38153840240363,137,61,76,39,1.2,4.5,0.4,0,0,0,0,0,0,0.122830744553411,147.365042493504,32.2665371679941
24.3,"eps_greedy_SVM","SVM",4,6,12633,12585,48,700,237,463,0.973609655083899,0.906474820143885,5.44287456990929,165,74,91,28,1.2,5.25,0.5,0,0,0,0,0,0,0.0599378505335071,103.613425031203,11.2870150661878
24.3,"eps_greedy_SVM","SVM",4,7,12533,12495,38,800,327,473,0.988634917703656,0.91726618705036,5.63420250699004,199,86,113,34,1.3,6,0.7,0,0,0,0,0,0,0.0318561392827815,65.1288422091121,4.9789712358711
24.3,"eps_greedy_SVM","SVM",4,8,12433,12403,30,900,419,481,0.991180322294057,0.928057553956835,5.65633237535298,225,97,128,26,1.3,6.75,0.9,0,0,0,0,0,0,0.0244109354239888,43.5951115832165,3.55865772884777
24.3,"eps_greedy_SVM","SVM",4,9,12333,12310,23,1000,512,488,0.994731840134419,0.938848920863309,5.73391967054629,257,102,155,32,1.5,7.5,1,0,0,0,0,0,0,0.0206549910451123,40.8439262882464,3.66200618051314
24.3,"eps_greedy_SVM","SVM",4,10,12233,12218,15,1100,604,496,0.998185955852621,0.946043165467626,5.80176243284848,267,107,160,10,1.5,8.25,1.2,0,0,0,0,0,0,0.0172927612788326,36.7423481261792,9.33778138811204
24.3,"eps_greedy_SVM","SVM",4,11,12133,12131,2,1200,691,509,0.9954772760286,0.949640287769784,5.85755395683453,291,122,169,24,1.4,9,1.4,0,0,0,0,0,0,0.0178018589188103,29.4762728704409,2.80576583112281
24.3,"eps_greedy_SVM","SVM",4,12,12033,12033,0,1300,789,511,0.995534140851351,0.949640287769784,5.86793969080055,301,125,176,10,1.4,9.75,1.5,0,0,0,0,0,0,0.0125924754733285,21.1823195068979,1.42275812966502
24.3,"eps_greedy_SVM","SVM",4,13,11933,11933,0,1400,889,511,0.995785809918354,0.949640287769784,5.86793969080055,302,125,177,1,1.4,10.5,1.7,0,0,0,0,0,0,0.0112585413442707,22.4366725669091,1.21119872057098
24.3,"eps_greedy_SVM","SVM",4,14,11833,11833,0,1500,989,511,0.995942328935416,0.949640287769784,5.86793969080055,300,123,177,-2,1.4,11.25,1.9,0,0,0,0,0,0,0.0068637750258438,12.3437876606898,0.747332630662512
24.3,"eps_greedy_SVM","SVM",4,15,11733,11733,0,1600,1089,511,0.995944581007604,0.949640287769784,5.86793969080055,300,124,176,0,1.4,12,2.1,0,0,0,0,0,0,0.0063099647056449,12.2364352075302,0.674468060367631
24.3,"eps_greedy_SVM","SVM",4,16,11633,11633,0,1700,1189,511,0.995961471549012,0.946043165467626,5.86793969080055,299,125,174,-1,1.4,12.75,2.3,0,0,0,0,0,0,0.00713824835230854,15.578596814448,0.753660592424013
24.3,"eps_greedy_SVM","SVM",4,17,11533,11533,0,1800,1289,511,0.995989059433315,0.946043165467626,5.86793969080055,297,125,172,-2,1.4,13.5,2.5,0,0,0,0,0,0,0.00478911214797522,9.82776646278054,0.498077312529317
24.3,"eps_greedy_SVM","SVM",4,18,11433,11433,0,1900,1389,511,0.996080831374974,0.946043165467626,5.86793969080055,301,126,175,4,1.4,14.25,2.7,0,0,0,0,0,0,0.00439220151924614,8.98281025760084,0.458795992959598
24.3,"eps_greedy_SVM","SVM",4,19,11333,11333,0,2000,1489,511,0.996182174623431,0.946043165467626,5.86274222428966,302,127,175,1,1.4,15,2.9,0,0,0,0,0,0,0.00442699719986166,9.71343487676238,0.462041560967908
24.3,"eps_greedy_SVM","SVM",4,20,11233,11233,0,2100,1589,511,0.996318988008848,0.946043165467626,5.86274222428966,306,129,177,4,1.4,15.75,3.1,0,0,0,0,0,0,0.00376973050971855,7.98862824693299,0.392515324490096
24.3,"eps_greedy_SVM","SVM",4,21,11133,11133,0,2200,1689,511,0.996454675358172,0.946043165467626,5.86274222428966,306,129,177,0,1.4,16.5,3.3,0,0,0,0,0,0,0.00347079657814172,7.55958222240859,0.360939089004818
24.3,"eps_greedy_SVM","SVM",4,22,11033,11033,0,2300,1789,511,0.996583043472884,0.946043165467626,5.86274222428966,307,130,177,1,1.4,17.25,3.5,0,0,0,0,0,0,0.00268786714625356,5.50201154153231,0.280098588661955
24.3,"eps_greedy_SVM","SVM",4,23,10933,10933,0,2400,1889,511,0.996662429017509,0.946043165467626,5.86274222428966,306,130,176,-1,1.4,18,3.7,0,0,0,0,0,0,0.00270010087090745,5.63871026048065,0.27951141105426
24.3,"eps_greedy_SVM","SVM",4,24,10833,10833,0,2500,1989,511,0.996664118071651,0.946043165467626,5.86274222428966,305,130,175,-1,1.3,18.75,3.9,0,0,0,0,0,0,0.00232323158324453,4.7981000693036,0.242178804240916
24.3,"eps_greedy_SVM","SVM",4,25,10733,10733,0,2600,2089,511,0.9967389994719,0.946043165467626,5.86274222428966,305,130,175,0,1.3,19.5,4.1,0,0,0,0,0,0,0.00207903071569337,4.25872985780426,0.215644506549052
24.3,"eps_greedy_SVM","SVM",4,26,10633,10633,0,2700,2189,511,0.996719856858302,0.946043165467626,5.86274222428966,305,130,175,0,1.3,20.25,4.3,0,0,0,0,0,0,0.00228390725402871,4.78157290124791,0.23444885653314
24.3,"eps_greedy_SVM","SVM",4,27,10533,10533,0,2800,2289,511,0.996859485333956,0.946043165467626,5.8731463808545,304,131,173,-1,1.3,21,4.5,0,0,0,0,0,0,0.00214764485276063,4.46587467027167,0.222936545698397
24.3,"eps_greedy_SVM","SVM",4,28,10433,10433,0,2900,2389,511,0.996898333579198,0.946043165467626,5.8731463808545,304,130,174,0,1.3,21.75,4.7,0,0,0,0,0,0,0.00189782019927843,3.83070065771384,0.195544956153006
24.3,"eps_greedy_SVM","SVM",4,29,10333,10333,0,3000,2489,511,0.996880317001695,0.946043165467626,5.86793969080055,304,130,174,0,1.3,22.5,4.9,0,0,0,0,0,0,0.00157046812430127,3.10275215465492,0.16163942035674
24.3,"eps_greedy_SVM","SVM",4,30,10233,10233,0,3100,2589,511,0.996952383311709,0.946043165467626,5.8731463808545,306,131,175,2,1.3,23.25,5.1,0,0,0,0,0,0,0.00168084700892292,3.34911223398693,0.173166382318411
24.3,"eps_greedy_SVM","SVM",4,31,10133,10133,0,3200,2689,511,0.997014315296876,0.946043165467626,5.8731463808545,304,130,174,-2,1.3,24,5.3,0,0,0,0,0,0,0.00150986006611886,3.05502305901223,0.156813285978239
24.3,"eps_greedy_SVM","SVM",4,32,10033,10033,0,3300,2789,511,0.997017130387111,0.946043165467626,5.8731463808545,305,130,175,1,1.3,24.75,5.5,0,0,0,0,0,0,0.00144502522913304,2.87215446814157,0.147595451718787
24.3,"eps_greedy_SVM","SVM",4,33,9933,9933,0,3400,2889,511,0.997035146964613,0.946043165467626,5.86793969080055,307,130,177,2,1.4,25.5,5.7,0,0,0,0,0,0,0.00127255082183211,2.46949321907089,0.132357234622781
24.3,"eps_greedy_SVM","SVM",4,34,9833,9833,0,3500,2989,511,0.997084692552746,0.946043165467626,5.8731463808545,306,129,177,-1,1.4,26.25,5.8,0,0,0,0,0,0,0.001133323040599,2.19913405367838,0.116688032162258
24.3,"eps_greedy_SVM","SVM",4,35,9733,9733,0,3600,3089,511,0.997166893187603,0.946043165467626,5.8731463808545,305,129,176,-1,1.4,27,6,0,0,0,0,0,0,0.0010661290429012,2.05261900090998,0.110369049015975
24.3,"eps_greedy_SVM","SVM",4,36,9633,9633,0,3700,3189,511,0.997170271295885,0.946043165467626,5.8731463808545,304,128,176,-1,1.4,27.75,6.2,0,0,0,0,0,0,0.00107915607028543,2.11529092777213,0.111307869363253
24.3,"eps_greedy_SVM","SVM",4,37,9533,9533,0,3800,3289,511,0.997201800306515,0.946043165467626,5.86793969080055,304,128,176,0,1.4,28.5,6.4,0,0,0,0,0,0,0.000902540615265049,1.73913638273251,0.092806240738578
24.3,"eps_greedy_SVM","SVM",4,38,9433,9433,0,3900,3389,511,0.997204052378703,0.946043165467626,5.8731463808545,304,128,176,0,1.4,29.25,6.6,0,0,0,0,0,0,0.000957433288842007,1.86066464267644,0.0984560382524825
24.3,"eps_greedy_SVM","SVM",4,39,9333,9333,0,4000,3489,511,0.997227136118628,0.946043165467626,5.8731463808545,304,128,176,0,1.4,30,6.8,0,0,0,0,0,0,0.000986572846939445,1.91803790870406,0.100783155625694
24.3,"eps_greedy_SVM","SVM",4,40,9233,9233,0,4100,3589,511,0.997235018371286,0.946043165467626,5.8731463808545,306,128,178,2,1.4,30.75,7,0,0,0,0,0,0,0.00100807160700142,2.01831380190379,0.103869086889771
24.3,"eps_greedy_SVM","SVM",4,41,9133,9133,0,4200,3689,511,0.997236707425427,0.946043165467626,5.8731463808545,306,128,178,0,1.4,31.5,7.2,0,0,0,0,0,0,0.000863284102864954,1.64641107704503,0.0882702444603683
24.3,"eps_greedy_SVM","SVM",4,42,9033,9033,0,4300,3789,511,0.997193918053857,0.946043165467626,5.8731463808545,305,128,177,-1,1.4,32.25,7.4,0,0,0,0,0,0,0.000759259767498423,1.44627760542228,0.0780656089794735
24.3,"eps_greedy_SVM","SVM",4,43,8933,8933,0,4400,3889,511,0.997244026660038,0.946043165467626,5.8731463808545,303,128,175,-2,1.4,33,7.6,0,0,0,0,0,0,0.000724932355663698,1.35259877850455,0.0746393992281577
24.3,"eps_greedy_SVM","SVM",4,44,8833,8833,0,4500,3989,511,0.997220942920112,0.946043165467626,5.8523748640345,305,129,176,2,1.4,33.75,7.8,0,0,0,0,0,0,0.000570173629651217,1.02400392997898,0.0585935848059804
24.3,"eps_greedy_SVM","SVM",4,45,8733,8733,0,4600,4089,511,0.997246841750272,0.946043165467626,5.8731463808545,304,129,175,-1,1.4,34.5,8,0,0,0,0,0,0,0.00075224703731498,1.46660529814854,0.0775625896919437
24.3,"eps_greedy_SVM","SVM",4,46,8633,8633,0,4700,4189,511,0.997260917201447,0.946043165467626,5.8731463808545,305,129,176,1,1.4,35.25,8.2,0,0,0,0,0,0,0.000669933827277824,1.26294478266466,0.0687525270551063
24.3,"eps_greedy_SVM","SVM",4,47,8533,8533,0,4800,4289,511,0.997250782876601,0.946043165467626,5.8731463808545,306,129,177,1,1.4,36,8.4,0,0,0,0,0,0,0.000539200607112622,0.992866724944774,0.0551970053723877
24.3,"eps_greedy_SVM","SVM",4,48,8433,8433,0,4900,4389,511,0.997297513374499,0.946043165467626,5.85755395683453,305,129,176,-1,1.4,36.75,8.6,0,0,0,0,0,0,0.000474400677110044,0.841998588546334,0.0488652969411227
24.3,"eps_greedy_SVM","SVM",5,0,13233,12704,529,100,95,5,0.943628368377862,0.768627450980392,5.06323235378127,24,5,19,0,3.8,0.75,19,0,0,0,0,0,0,0.999994655338299,549.267941212629,99.9998484648429
24.3,"eps_greedy_SVM","SVM",5,1,13133,12704,429,200,95,105,0.959035142441222,0.752941176470588,5.1525193209814,35,14,21,11,1.5,1.5,0.9,0,0,0,0,0,0,0.892457622011474,328.92078219696,94.795666070192
24.3,"eps_greedy_SVM","SVM",5,2,13033,12703,330,300,96,204,0.964493657725086,0.784313725490196,5.32922730067637,50,15,35,15,2.3,2.25,0.5,0,0,0,0,0,0,0.968968078804158,323.702095062362,98.5620674305719
24.3,"eps_greedy_SVM","SVM",5,3,12933,12701,232,400,98,302,0.963187895245405,0.788235294117647,5.36723157985661,66,22,44,16,2,3,0.3,0,0,0,0,0,0,0.638450941420269,172.62232435844,92.867678357288
24.3,"eps_greedy_SVM","SVM",5,4,12833,12691,142,500,108,392,0.956794246082695,0.827450980392157,5.26090387374462,97,42,55,31,1.3,3.75,0.3,0,0,0,0,0,0,0.100616015222761,79.6537107552995,53.3260386286979
24.3,"eps_greedy_SVM","SVM",5,5,12733,12635,98,600,164,436,0.953139945934676,0.882352941176471,5.1521887233718,121,53,68,24,1.3,4.5,0.4,0,0,0,0,0,0,0.0279881830582833,53.0918895171829,41.4693394422402
24.3,"eps_greedy_SVM","SVM",5,6,12633,12558,75,700,241,459,0.933077073624183,0.882352941176471,5.10646446078431,135,59,76,14,1.3,5.25,0.5,0,0,0,0,0,0,0.00557429505353593,24.9176349012537,19.7078382794165
24.3,"eps_greedy_SVM","SVM",5,7,12533,12459,74,800,340,460,0.947524861472953,0.882352941176471,5.12073965047624,140,61,79,5,1.3,6,0.7,0,0,0,0,0,0,0.00319881914955758,18.5414873155661,18.3137614387868
24.3,"eps_greedy_SVM","SVM",5,8,12433,12364,69,900,435,465,0.945912688219365,0.882352941176471,5.09436674240512,146,63,83,6,1.3,6.75,0.9,0,0,0,0,0,0,9.3747883204965e-06,13.0562131965969,13.0518262376301
24.3,"eps_greedy_SVM","SVM",5,9,12333,12277,56,1000,522,478,0.946865558450424,0.882352941176471,5.05889739457427,145,63,82,-1,1.3,7.5,1.1,0,0,0,0,0,0,5.60279015632204e-06,0.00360733369893677,0.000740093090685736
24.3,"eps_greedy_SVM","SVM",5,10,12233,12177,56,1100,622,478,0.948890560591024,0.882352941176471,5.07693520521981,146,66,80,1,1.2,8.25,1.3,0,0,0,0,0,0,1.77779448636667e-06,0.00109013136825875,0.000229253333669629
24.3,"eps_greedy_SVM","SVM",5,11,12133,12077,56,1200,722,478,0.950709454087279,0.882352941176471,5.05456985189285,147,66,81,1,1.2,9,1.5,0,0,0,0,0,0,1.51102500869095e-06,0.000937867616766898,0.000185735120742463
24.3,"eps_greedy_SVM","SVM",5,12,12033,11977,56,1300,822,478,0.952147933409141,0.882352941176471,5.05889739457427,144,66,78,-3,1.2,9.75,1.7,0,0,0,0,0,0,9.08436292605502e-07,0.000570693777330515,0.000104479978593208
24.3,"eps_greedy_SVM","SVM",5,13,11933,11877,56,1400,922,478,0.952950350445825,0.882352941176471,5.07693520521981,144,66,78,0,1.2,10.5,1.9,0,0,0,0,0,0,7.65772507360411e-07,0.00051346373704961,9.4465897912544e-05
24.3,"eps_greedy_SVM","SVM",5,14,11833,11777,56,1500,1022,478,0.95363289420569,0.882352941176471,5.07693520521981,145,66,79,1,1.2,11.25,2.1,0,0,0,0,0,0,3.71770872228956e-07,0.000259653714275614,4.38861219601244e-05
24.3,"eps_greedy_SVM","SVM",5,15,11733,11677,56,1600,1122,478,0.954978410578184,0.882352941176471,5.06826409470705,146,67,79,1,1.2,12,2.3,0,0,0,0,0,0,2.67228040266313e-07,0.000190045420309381,3.18480960502112e-05
24.3,"eps_greedy_SVM","SVM",5,16,11633,11579,54,1700,1220,480,0.963513265568205,0.886274509803922,5.2200581346506,153,68,85,7,1.2,12.75,2.5,0,0,0,0,0,0,9.46315183505267e-07,0.0475998799539017,0.0469908362344394
24.3,"eps_greedy_SVM","SVM",5,17,11533,11487,46,1800,1312,488,0.973456019962546,0.901960784313726,5.39466492076283,173,76,97,20,1.3,13.5,2.7,0,0,0,0,0,0,7.12990086304152e-06,0.136640713034541,0.133799160945878
24.3,"eps_greedy_SVM","SVM",5,18,11433,11397,36,1900,1402,498,0.976369674507309,0.925490196078431,5.45812613705276,201,89,112,28,1.3,14.25,2.8,0,0,0,0,0,0,0.00320795699459318,0.780405240985117,0.599157919823042
24.3,"eps_greedy_SVM","SVM",5,19,11333,11299,34,2000,1500,500,0.976002715496597,0.925490196078431,5.48167284169923,209,92,117,8,1.3,15,3,0,0,0,0,0,0,1.64914698733828e-05,0.259504229103883,0.253782438653721
24.3,"eps_greedy_SVM","SVM",5,20,11233,11199,34,2100,1600,500,0.975649823247994,0.925490196078431,5.48640658335873,206,89,117,-3,1.3,15.75,3.2,0,0,0,0,0,0,8.53973025693967e-06,0.00801629777330903,0.00364490420513956
24.3,"eps_greedy_SVM","SVM",5,21,11133,11099,34,2200,1700,500,0.975616185338684,0.925490196078431,5.48640658335873,207,90,117,1,1.3,16.5,3.4,0,0,0,0,0,0,5.88090545765605e-06,0.00410662174702524,0.000676562357797182
24.3,"eps_greedy_SVM","SVM",5,22,11033,10999,34,2300,1800,500,0.975566645872244,0.925490196078431,5.48640658335873,205,90,115,-2,1.3,17.25,3.6,0,0,0,0,0,0,5.18732845834823e-06,0.0041737607013412,0.000591162281360821
24.3,"eps_greedy_SVM","SVM",5,23,10933,10899,34,2400,1900,500,0.975510990422292,0.925490196078431,5.48640658335873,204,89,115,-1,1.3,18,3.8,0,0,0,0,0,0,4.4673346869251e-06,0.00424529409767425,0.000512113106374538
24.3,"eps_greedy_SVM","SVM",5,24,10833,10800,33,2500,1999,501,0.977244260149399,0.925490196078431,5.45344105023984,208,92,116,4,1.3,18.75,4,0,0,0,0,0,0,1.01114426990732e-05,0.0166682348983312,0.00911869574472405
24.3,"eps_greedy_SVM","SVM",5,25,10733,10701,32,2600,2098,502,0.979979327975671,0.92156862745098,5.47222982216142,214,95,119,6,1.3,19.5,4.2,0,0,0,0,0,0,9.57840774249652e-06,0.0256952862026554,0.0181732121617342
24.3,"eps_greedy_SVM","SVM",5,26,10633,10603,30,2700,2196,504,0.98426296282698,0.92156862745098,5.53634314572847,219,94,125,5,1.3,20.25,4.4,0,0,0,0,0,0,1.43097120700641e-05,0.103356874865413,0.0932722478008558
24.3,"eps_greedy_SVM","SVM",5,27,10533,10508,25,2800,2291,509,0.991462698616512,0.917647058823529,5.69858283330769,229,99,130,10,1.3,21,4.5,0,0,0,0,0,0,0.00544410097892426,3.335322039071,0.723937820006
24.3,"eps_greedy_SVM","SVM",5,28,10433,10415,18,2900,2384,516,0.995488850562044,0.92156862745098,5.80747129404879,254,107,147,25,1.4,21.75,4.6,0,0,0,0,0,0,0.0109598943707415,9.26026574157533,1.5578044207832
24.3,"eps_greedy_SVM","SVM",5,29,10333,10321,12,3000,2478,522,0.997025797218453,0.929411764705882,5.83042572604108,270,115,155,16,1.3,22.5,4.7,0,0,0,0,0,0,0.0101262481617675,8.33061254505991,1.23092347014563
24.3,"eps_greedy_SVM","SVM",5,30,10233,10227,6,3100,2572,528,0.999016549851382,0.937254901960784,5.9104609929078,289,120,169,19,1.4,23.25,4.9,0,0,0,0,0,0,0.0117031286082734,10.4598955607491,1.6615120237429
24.3,"eps_greedy_SVM","SVM",5,31,10133,10132,1,3200,2667,533,0.999355375337908,0.937254901960784,5.91570541259982,299,126,173,10,1.4,24,5,0,0,0,0,0,0,0.00992204372371287,8.09368885476033,1.23765076433581
24.3,"eps_greedy_SVM","SVM",5,32,10033,10033,0,3300,2766,534,0.999393294435678,0.937254901960784,5.9104609929078,307,127,180,8,1.4,24.75,5.2,0,0,0,0,0,0,0.0078853021809861,6.33567535948022,0.881640614291056
24.3,"eps_greedy_SVM","SVM",5,33,9933,9933,0,3400,2866,534,0.999400633615892,0.937254901960784,5.9104609929078,307,127,180,0,1.4,25.5,5.4,0,0,0,0,0,0,0.00698281751091832,5.96504489371603,0.752304205944967
24.3,"eps_greedy_SVM","SVM",5,34,9833,9833,0,3500,2966,534,0.999408584394457,0.937254901960784,5.9104609929078,309,128,181,2,1.4,26.25,5.6,0,0,0,0,0,0,0.0048068820045632,2.84985118362648,0.507221188582091
24.3,"eps_greedy_SVM","SVM",5,35,9733,9733,0,3600,3066,534,0.999418981566426,0.937254901960784,5.9104609929078,309,128,181,0,1.4,27,5.7,0,0,0,0,0,0,0.00414204157371957,2.10165645257563,0.434930039361569
24.3,"eps_greedy_SVM","SVM",5,36,9633,9633,0,3700,3166,534,0.999431213533448,0.937254901960784,5.9104609929078,309,128,181,0,1.4,27.75,5.9,0,0,0,0,0,0,0.00396921924258826,2.02240061345649,0.417606186665539
24.3,"eps_greedy_SVM","SVM",5,37,9533,9533,0,3800,3266,534,0.999433659926853,0.937254901960784,5.87400881057269,311,128,183,2,1.4,28.5,6.1,0,0,0,0,0,0,0.00348652496350372,1.43852569346572,0.364957083893695
24.3,"eps_greedy_SVM","SVM",5,38,9433,9433,0,3900,3366,534,0.999441610705418,0.937254901960784,5.87400881057269,311,128,183,0,1.4,29.25,6.3,0,0,0,0,0,0,0.00298437365534542,0.853874982106868,0.312349679073027
24.3,"eps_greedy_SVM","SVM",5,39,9333,9333,0,4000,3466,534,0.999449561483982,0.937254901960784,5.8585237258348,313,128,185,2,1.4,30,6.5,0,0,0,0,0,0,1.46801797391591e-05,0.0104107143519224,0.00161714618492834
24.3,"eps_greedy_SVM","SVM",5,40,9233,9233,0,4100,3566,534,0.999455677467494,0.937254901960784,5.87400881057269,312,128,184,-1,1.4,30.75,6.7,0,0,0,0,0,0,1.39727634599352e-05,0.010298551687286,0.00153441915186216
24.3,"eps_greedy_SVM","SVM",5,41,9133,9133,0,4200,3666,534,0.999466074639463,0.937254901960784,5.8636763412489,312,128,184,0,1.4,31.5,6.9,0,0,0,0,0,0,1.01765925806347e-05,0.00751197927675588,0.00111534522919356
24.3,"eps_greedy_SVM","SVM",5,42,9033,9033,0,4300,3766,534,0.999469132631219,0.937254901960784,5.87400881057269,312,128,184,0,1.4,32.25,7.1,0,0,0,0,0,0,8.93431297993718e-06,0.0068501436005306,0.000983347470575767
24.3,"eps_greedy_SVM","SVM",5,43,8933,8933,0,4400,3866,534,0.999476471811432,0.937254901960784,5.8636763412489,313,128,185,1,1.4,33,7.2,0,0,0,0,0,0,0.00139631417379632,1.98598796611831,0.14638236798561
24.3,"eps_greedy_SVM","SVM",5,44,8833,8833,0,4500,3966,534,0.999480141401539,0.937254901960784,5.84824561403509,312,128,184,-1,1.4,33.75,7.4,0,0,0,0,0,0,0.00110680821541166,1.58044877819262,0.116278246711928
24.3,"eps_greedy_SVM","SVM",5,45,8733,8733,0,4600,4066,534,0.999486868983401,0.937254901960784,5.88437775816417,311,128,183,-1,1.4,34.5,7.6,0,0,0,0,0,0,0.00128113284834573,1.93189840329195,0.132997391198401
24.3,"eps_greedy_SVM","SVM",5,46,8633,8633,0,4700,4166,534,0.999491150171859,0.937254901960784,5.88437775816417,313,128,185,2,1.4,35.25,7.8,0,0,0,0,0,0,0.00119512118854633,1.80948274242403,0.124159178101849
24.3,"eps_greedy_SVM","SVM",5,47,8533,8533,0,4800,4266,534,0.999496654557019,0.937254901960784,5.88957597173145,311,128,183,-2,1.4,36,8,0,0,0,0,0,0,0.00102276884781829,1.52435519543161,0.106075836843251
24.3,"eps_greedy_SVM","SVM",5,48,8433,8433,0,4900,4366,534,0.999501547343828,0.937254901960784,5.88957597173145,311,128,183,0,1.4,36.75,8.2,0,0,0,0,0,0,0.00110921827691032,1.69373889045956,0.114654100493722
24.3,"eps_greedy_SVM","SVM",6,0,13233,12708,525,100,95,5,0.964503227143696,0.810810810810811,5.55470432838854,32,5,27,0,5.4,0.75,19,0,0,0,0,0,0,0.836701931607497,776.217736236457,87.9476444310664
24.3,"eps_greedy_SVM","SVM",6,1,13133,12696,437,200,107,93,0.985576065632267,0.891891891891892,5.70262091621315,66,22,44,34,2,1.5,1.2,0,0,0,0,0,0,0.977586826083931,521.550582936756,98.6375996605167
24.3,"eps_greedy_SVM","SVM",6,2,13033,12695,338,300,108,192,0.987023942080131,0.911196911196911,5.71776061776062,76,30,46,10,1.5,2.25,0.6,0,0,0,0,0,0,0.971849736793992,386.168781423835,98.3465917607248
24.3,"eps_greedy_SVM","SVM",6,3,12933,12693,240,400,110,290,0.987278811717021,0.911196911196911,5.70262091621315,91,39,52,15,1.3,3,0.4,0,0,0,0,0,0,0.893665642802146,210.558354246553,95.9544434092259
24.3,"eps_greedy_SVM","SVM",6,4,12833,12692,141,500,111,389,0.982611624465505,0.915057915057915,5.70247942400967,97,39,58,6,1.5,3.75,0.3,0,0,0,0,0,0,0.237671490820788,112.203113200852,76.5857043934699
24.3,"eps_greedy_SVM","SVM",6,5,12733,12628,105,600,175,425,0.95860206113009,0.922779922779923,5.61586965415995,135,60,75,38,1.2,4.5,0.4,0,0,0,0,0,0,0.0442587551127985,60.2769519999991,45.3704678224371
24.3,"eps_greedy_SVM","SVM",6,6,12633,12539,94,700,264,436,0.954186730872106,0.922779922779923,5.17424200603343,146,60,86,11,1.4,5.25,0.6,0,0,0,0,0,0,0.0135862989767133,46.4216757861633,29.1201921329536
24.3,"eps_greedy_SVM","SVM",6,7,12533,12448,85,800,355,445,0.959142529367258,0.922779922779923,5.24035242348701,153,64,89,7,1.4,6,0.8,0,0,0,0,0,0,0.00344252170852007,19.9500715479516,19.2502332440282
24.3,"eps_greedy_SVM","SVM",6,8,12433,12366,67,900,437,463,0.960800688328808,0.922779922779923,5.20488472518929,149,65,84,-4,1.3,6.75,0.9,0,0,0,0,0,0,1.50241397682574e-05,1.21863433374014,1.21059362769834
24.3,"eps_greedy_SVM","SVM",6,9,12333,12267,66,1000,536,464,0.962780597612082,0.922779922779923,5.23108811000428,149,64,85,0,1.3,7.5,1.2,0,0,0,0,0,0,6.92289506846955e-06,0.00470466547812406,0.000897762641326946
24.3,"eps_greedy_SVM","SVM",6,10,12233,12167,66,1100,636,464,0.964655064374197,0.922779922779923,5.26179505568819,146,65,81,-3,1.2,8.25,1.4,0,0,0,0,0,0,2.49883765850661e-06,0.00153046471568522,0.000338360221298156
24.3,"eps_greedy_SVM","SVM",6,11,12133,12067,66,1200,736,464,0.966108363580308,0.922779922779923,5.27521800225882,149,67,82,3,1.2,9,1.6,0,0,0,0,0,0,1.39038941977808e-06,0.0008531033413893,0.000180222751644117
24.3,"eps_greedy_SVM","SVM",6,12,12033,11967,66,1300,836,464,0.967652042090265,0.922779922779923,5.34337327360583,149,67,82,0,1.2,9.75,1.8,0,0,0,0,0,0,7.90558883718105e-07,0.00045700151565759,9.30123637559906e-05
24.3,"eps_greedy_SVM","SVM",6,13,11933,11867,66,1400,936,464,0.969008334176887,0.922779922779923,5.35721620954782,149,66,83,0,1.3,10.5,2,0,0,0,0,0,0,3.80693192957735e-07,0.000217690520521009,4.73060461017641e-05
24.3,"eps_greedy_SVM","SVM",6,14,11833,11767,66,1500,1036,464,0.969818132739491,0.922779922779923,5.36184647420603,154,69,85,5,1.2,11.25,2.2,0,0,0,0,0,0,4.29638808795899e-07,0.00026471154370906,5.2613820866313e-05
24.3,"eps_greedy_SVM","SVM",6,15,11733,11667,66,1600,1136,464,0.970373061665205,0.922779922779923,5.38409479982514,153,68,85,-1,1.2,12,2.4,0,0,0,0,0,0,1.38427053413654e-07,8.15958508557686e-05,1.70190725282372e-05
24.3,"eps_greedy_SVM","SVM",6,16,11633,11570,63,1700,1233,467,0.977452171272405,0.930501930501931,5.51599558742416,163,72,91,10,1.3,12.75,2.6,0,0,0,0,0,0,4.20029299175427e-06,0.111776251681366,0.109903616097977
24.3,"eps_greedy_SVM","SVM",6,17,11533,11482,51,1800,1321,479,0.985385064036731,0.945945945945946,5.71014035965234,196,90,106,33,1.2,13.5,2.8,0,0,0,0,0,0,0.0070203334053788,3.50056598940682,1.15917835218213
24.3,"eps_greedy_SVM","SVM",6,18,11433,11398,35,1900,1405,495,0.99175077967211,0.957528957528958,5.75553999673718,234,108,126,38,1.2,14.25,2.8,0,0,0,0,0,0,0.00855695943168381,4.85290561971758,2.22960540364256
24.3,"eps_greedy_SVM","SVM",6,19,11333,11309,24,2000,1494,506,0.994895376917824,0.961389961389961,5.81917974205208,256,118,138,22,1.2,15,3,0,0,0,0,0,0,0.00810757393821163,3.72613438169301,1.15535595281273
24.3,"eps_greedy_SVM","SVM",6,20,11233,11214,19,2100,1589,511,0.997735697173899,0.961389961389961,5.91385457458476,271,122,149,15,1.2,15.75,3.1,0,0,0,0,0,0,0.00908556199936547,5.84404061430029,1.28315959493495
24.3,"eps_greedy_SVM","SVM",6,21,11133,11124,9,2200,1679,521,0.99947640256629,0.961389961389961,6.02258355916892,301,133,168,30,1.3,16.5,3.2,0,0,0,0,0,0,0.0149659217609931,10.7036829632672,2.37471305508769
24.3,"eps_greedy_SVM","SVM",6,22,11033,11033,0,2300,1770,530,0.999865033572899,0.969111969111969,5.94206773618538,326,143,183,25,1.3,17.25,3.3,0,0,0,0,0,0,0.0125145020205924,9.03619254214369,1.83995379984015
24.3,"eps_greedy_SVM","SVM",6,23,10933,10933,0,2400,1870,530,0.999873468974593,0.969111969111969,5.94736842105263,327,143,184,1,1.3,18,3.5,0,0,0,0,0,0,0.00976586765177332,7.84948443669682,1.11891829449881
24.3,"eps_greedy_SVM","SVM",6,24,10833,10833,0,2500,1970,530,0.99987527656067,0.969111969111969,5.94206773618538,329,143,186,2,1.3,18.75,3.7,0,0,0,0,0,0,0.00757689703532179,5.63117072887253,0.827752805879247
24.3,"eps_greedy_SVM","SVM",6,25,10733,10733,0,2600,2070,530,0.999877084146747,0.969111969111969,5.94206773618538,329,143,186,0,1.3,19.5,3.9,0,0,0,0,0,0,0.00546852722674074,3.45605617096407,0.595528335018648
24.3,"eps_greedy_SVM","SVM",6,26,10633,10633,0,2700,2170,530,0.999879494261517,0.969111969111969,5.95267857142857,326,143,183,-3,1.3,20.25,4.1,0,0,0,0,0,0,0.00499668450942408,3.0856523919831,0.52704965855269
24.3,"eps_greedy_SVM","SVM",6,27,10533,10533,0,2800,2270,530,0.999884314491056,0.969111969111969,5.95267857142857,326,143,183,0,1.3,21,4.3,0,0,0,0,0,0,0.00427452413955813,2.35241657696413,0.453837394033946
24.3,"eps_greedy_SVM","SVM",6,28,10433,10433,0,2900,2370,530,0.999886122077133,0.969111969111969,5.93677649154052,325,142,183,-1,1.3,21.75,4.5,0,0,0,0,0,0,0.00306426884457848,0.855213783730095,0.32271953417439
24.3,"eps_greedy_SVM","SVM",6,29,10333,10333,0,3000,2470,530,0.999892147364058,0.969111969111969,5.81255448997384,326,142,184,1,1.3,22.5,4.7,0,0,0,0,0,0,0.00253210365106104,0.287757772933981,0.266910438828007
24.3,"eps_greedy_SVM","SVM",6,30,10233,10233,0,3100,2570,530,0.999893954950135,0.969111969111969,5.92622222222222,329,144,185,3,1.3,23.25,4.8,0,0,0,0,0,0,0.00284897163338733,0.664638726017715,0.298898616710838
24.3,"eps_greedy_SVM","SVM",6,31,10133,10133,0,3200,2670,530,0.999896365064904,0.969111969111969,5.8636763412489,328,143,185,-1,1.3,24,5,0,0,0,0,0,0,1.18042450439341e-05,0.0084355144718453,0.00129855823053892
24.3,"eps_greedy_SVM","SVM",6,32,10033,10033,0,3300,2770,530,0.999898172650982,0.969111969111969,5.9104609929078,330,145,185,2,1.3,24.75,5.2,0,0,0,0,0,0,1.40554990395548e-05,0.0107291865429108,0.00155747481624124
24.3,"eps_greedy_SVM","SVM",6,33,9933,9933,0,3400,2870,530,0.999899980237059,0.969111969111969,5.76730103806228,330,145,185,0,1.3,25.5,5.4,0,0,0,0,0,0,5.32659927759895e-06,0.00382182788253885,0.000591169790145395
24.3,"eps_greedy_SVM","SVM",6,34,9833,9833,0,3500,2970,530,0.999902390351829,0.969111969111969,5.84312007011393,331,145,186,1,1.3,26.25,5.6,0,0,0,0,0,0,6.08212135581379e-06,0.00475582495411673,0.000684198997472376
24.3,"eps_greedy_SVM","SVM",6,35,9733,9733,0,3600,3070,530,0.999903595409213,0.972972972972973,5.76730103806228,331,145,186,0,1.3,27,5.8,0,0,0,0,0,0,3.0877855266802e-06,0.00241036929260042,0.000340356467669557
24.3,"eps_greedy_SVM","SVM",6,36,9633,9633,0,3700,3170,530,0.999904800466598,0.972972972972973,5.9,328,145,183,-3,1.3,27.75,6,0,0,0,0,0,0,0.00141663926342933,2.23284715930829,0.146827066083733
24.3,"eps_greedy_SVM","SVM",6,37,9533,9533,0,3800,3270,530,0.999906608052675,0.972972972972973,5.84824561403509,327,145,182,-1,1.3,28.5,6.2,0,0,0,0,0,0,0.00104451914999944,1.58690828263624,0.108865069350253
24.3,"eps_greedy_SVM","SVM",6,38,9433,9433,0,3900,3370,530,0.99990781311006,0.972972972972973,5.9052258635961,327,145,182,0,1.3,29.25,6.4,0,0,0,0,0,0,0.00107708014740021,1.69752306849371,0.111892686183362
24.3,"eps_greedy_SVM","SVM",6,39,9333,9333,0,4000,3470,530,0.999909620696138,0.972972972972973,5.83800350262697,326,145,181,-1,1.2,30,6.5,0,0,0,0,0,0,0.000860966753823266,1.29554675428578,0.0890331498262495
24.3,"eps_greedy_SVM","SVM",6,40,9233,9233,0,4100,3570,530,0.9999126333396,0.972972972972973,5.7573402417962,325,145,180,-1,1.2,30.75,6.7,0,0,0,0,0,0,0.000612266341731609,0.898743521990697,0.0638689320097893
24.3,"eps_greedy_SVM","SVM",6,41,9133,9133,0,4200,3670,530,0.999913838396984,0.972972972972973,5.77729636048527,325,145,180,0,1.2,31.5,6.9,0,0,0,0,0,0,0.00064128434926982,0.965399806872844,0.0671253450282499
24.3,"eps_greedy_SVM","SVM",6,42,9033,9033,0,4300,3770,530,0.999913838396984,0.972972972972973,5.73752151462995,327,145,182,2,1.3,32.25,7.1,0,0,0,0,0,0,0.000512046691625682,0.757436071057954,0.0531462350343379
24.3,"eps_greedy_SVM","SVM",6,43,8933,8933,0,4400,3870,530,0.999914440925677,0.972972972972973,5.8585237258348,328,145,183,1,1.3,33,7.3,0,0,0,0,0,0,0.000622784531743916,0.960957374353818,0.0642894875614088
24.3,"eps_greedy_SVM","SVM",6,44,8833,8833,0,4500,3970,530,0.999914440925677,0.972972972972973,5.7573402417962,328,145,183,0,1.3,33.75,7.5,0,0,0,0,0,0,0.000433958833294036,0.639996625910921,0.0449359022944606
24.3,"eps_greedy_SVM","SVM",6,45,8733,8733,0,4600,4070,530,0.999914440925677,0.972972972972973,5.81255448997384,327,145,182,-1,1.3,34.5,7.7,0,0,0,0,0,0,0.000500054598725218,0.76020922275957,0.0519902738319329
24.3,"eps_greedy_SVM","SVM",6,46,8633,8633,0,4700,4170,530,0.999915043454369,0.972972972972973,5.7573402417962,327,145,182,0,1.3,35.25,7.9,0,0,0,0,0,0,0.000372442129755067,0.551244801409041,0.0387209164408668
24.3,"eps_greedy_SVM","SVM",6,47,8533,8533,0,4800,4270,530,0.999915645983062,0.972972972972973,5.87918871252205,327,145,182,0,1.3,36,8.1,0,0,0,0,0,0,0.000494364509836382,0.77652249949528,0.0514215536787953
24.3,"eps_greedy_SVM","SVM",6,48,8433,8433,0,4900,4370,530,0.999915645983062,0.972972972972973,5.78732638888889,326,145,181,-1,1.2,36.75,8.2,0,0,0,0,0,0,0.000374408393953963,0.565442285936289,0.0389422449717626
24.3,"eps_greedy_SVM","SVM",7,0,13233,12722,511,100,94,6,0.951119613208817,0.823529411764706,5.46122936016512,29,6,23,0,3.8,0.75,15.7,0,0,0,0,0,0,0.993248616819347,756.567769598505,99.6429962660414
24.3,"eps_greedy_SVM","SVM",7,1,13133,12722,411,200,94,106,0.952657177022488,0.794117647058823,5.32940415165203,43,16,27,14,1.7,1.5,0.9,0,0,0,0,0,0,0.95053859288554,580.792703238711,97.2932126963653
24.3,"eps_greedy_SVM","SVM",7,2,13033,12719,314,300,97,203,0.955256289380503,0.819852941176471,5.35129494863014,69,25,44,26,1.8,2.25,0.5,0,0,0,0,0,0,0.945029321746445,451.847846677123,96.8215840601578
24.3,"eps_greedy_SVM","SVM",7,3,12933,12719,214,400,97,303,0.959605390240536,0.849264705882353,5.38820043103448,78,27,51,9,1.9,3,0.3,0,0,0,0,0,0,0.929300631081844,379.39306910297,98.5401920241445
24.3,"eps_greedy_SVM","SVM",7,4,12833,12714,119,500,102,398,0.963591155774275,0.871323529411765,5.44926983435048,90,34,56,12,1.6,3.75,0.3,0,0,0,0,0,0,0.191623113543525,187.399014897469,58.1640690635285
24.3,"eps_greedy_SVM","SVM",7,5,12733,12668,65,600,148,452,0.961236374925273,0.930147058823529,5.45402486910995,138,61,77,48,1.3,4.5,0.3,0,0,0,0,0,0,0.0913518522897121,101.656491347586,30.634719198536
24.3,"eps_greedy_SVM","SVM",7,6,12633,12594,39,700,222,478,0.961335257324197,0.933823529411765,5.38098657786364,170,83,87,32,1,5.25,0.5,0,0,0,0,0,0,0.0235525214374788,33.1363134910956,11.3320932905931
24.3,"eps_greedy_SVM","SVM",7,7,12533,12503,30,800,313,487,0.952132295451417,0.933823529411765,5.32574976098224,193,88,105,23,1.2,6,0.6,0,0,0,0,0,0,0.0234993256922695,34.0420278252622,3.22780111786446
24.3,"eps_greedy_SVM","SVM",7,8,12433,12403,30,900,413,487,0.959657705928371,0.930147058823529,5.28057800728434,205,92,113,12,1.2,6.75,0.8,0,0,0,0,0,0,0.0137083765278856,18.0451400065534,1.70496898836663
24.3,"eps_greedy_SVM","SVM",7,9,12333,12303,30,1000,513,487,0.961981154854455,0.930147058823529,5.29404886954782,206,91,115,1,1.3,7.5,1.1,0,0,0,0,0,0,0.00975312036422945,13.8620653638809,1.15939829686312
24.3,"eps_greedy_SVM","SVM",7,10,12233,12203,30,1100,613,487,0.963928620705497,0.930147058823529,5.31665368965691,204,90,114,-2,1.3,8.25,1.3,0,0,0,0,0,0,0.00567761959444322,7.66012287220613,0.642190285907486
24.3,"eps_greedy_SVM","SVM",7,11,12133,12103,30,1200,713,487,0.964714505817943,0.930147058823529,5.31211729572375,204,90,114,0,1.3,9,1.5,0,0,0,0,0,0,0.00489244464305312,7.33637338422562,0.555442300295021
24.3,"eps_greedy_SVM","SVM",7,12,12033,12003,30,1300,813,487,0.965698155728245,0.930147058823529,5.3211978381096,208,92,116,4,1.3,9.75,1.7,0,0,0,0,0,0,0.00342487756191537,5.18748477801897,0.373241577752793
24.3,"eps_greedy_SVM","SVM",7,13,11933,11904,29,1400,912,488,0.969034861794579,0.930147058823529,5.37228041901692,209,91,118,1,1.3,10.5,1.9,0,0,0,0,0,0,0.00271394662226814,4.08104321049461,0.302546102763194
24.3,"eps_greedy_SVM","SVM",7,14,11833,11804,29,1500,1012,488,0.969503978291845,0.930147058823529,5.38149530824337,207,91,116,-2,1.3,11.25,2.1,0,0,0,0,0,0,0.00299820787293578,4.86746493555093,0.31876232572966
24.3,"eps_greedy_SVM","SVM",7,15,11733,11704,29,1600,1112,488,0.970023685783918,0.930147058823529,5.37228041901692,205,91,114,-2,1.3,12,2.3,0,0,0,0,0,0,0.00202843620047291,3.17075901112441,0.218011805519942
24.3,"eps_greedy_SVM","SVM",7,16,11633,11605,28,1700,1211,489,0.973201720093844,0.930147058823529,5.40251677429119,211,94,117,6,1.2,12.75,2.5,0,0,0,0,0,0,0.00195503246327799,3.26197034781207,0.222026357099926
24.3,"eps_greedy_SVM","SVM",7,17,11533,11507,26,1800,1309,491,0.978526997194527,0.930147058823529,5.4468954248366,220,98,122,9,1.2,13.5,2.7,0,0,0,0,0,0,0.00246219165889625,4.60931186858638,0.29580037539547
24.3,"eps_greedy_SVM","SVM",7,18,11433,11409,24,1900,1407,493,0.982479993561164,0.930147058823529,5.47967983410045,224,101,123,4,1.2,14.25,2.9,0,0,0,0,0,0,0.00280573414425654,5.71967147967483,0.328831208168691
24.3,"eps_greedy_SVM","SVM",7,19,11333,11313,20,2000,1503,497,0.990114634595034,0.930147058823529,5.63349765318096,237,103,134,13,1.3,15,3,0,0,0,0,0,0,0.00613807751652048,11.5934228364877,0.779158388044988
24.3,"eps_greedy_SVM","SVM",7,20,11233,11218,15,2100,1598,502,0.997032953134339,0.933823529411765,5.80524380804954,255,110,145,18,1.3,15.75,3.2,0,0,0,0,0,0,0.0111062752158928,19.3742804583446,1.3853528780506
24.3,"eps_greedy_SVM","SVM",7,21,11133,11123,10,2200,1693,507,0.999116382283953,0.933823529411765,5.832895888014,272,118,154,17,1.3,16.5,3.3,0,0,0,0,0,0,0.0177236920363011,23.6426097915405,2.47347376038908
24.3,"eps_greedy_SVM","SVM",7,22,11033,11031,2,2300,1785,515,0.999607919790277,0.948529411764706,5.9579982126899,301,128,173,29,1.4,17.25,3.5,0,0,0,0,0,0,0.0155176128691527,18.9425217558194,2.20582563790962
24.3,"eps_greedy_SVM","SVM",7,23,10933,10933,0,2400,1883,517,0.999655061399071,0.948529411764706,5.9052258635961,306,129,177,5,1.4,18,3.6,0,0,0,0,0,0,0.0120380621312801,16.9726675020167,1.39594910662793
24.3,"eps_greedy_SVM","SVM",7,24,10833,10833,0,2500,1983,517,0.99965851078508,0.952205882352941,5.894783377542,306,129,177,0,1.4,18.75,3.8,0,0,0,0,0,0,0.0087929064797772,12.7657582417311,0.959533603827623
24.3,"eps_greedy_SVM","SVM",7,25,10733,10733,0,2600,2083,517,0.99966196017109,0.952205882352941,5.894783377542,309,131,178,3,1.4,19.5,4,0,0,0,0,0,0,0.00675037147684575,9.80437144847351,0.725683682946757
24.3,"eps_greedy_SVM","SVM",7,26,10633,10633,0,2700,2183,517,0.999667421698938,0.952205882352941,5.88957597173145,309,131,178,0,1.4,20.25,4.2,0,0,0,0,0,0,0.00657699246907156,10.9069836238271,0.69683414429124
24.3,"eps_greedy_SVM","SVM",7,27,10533,10533,0,2800,2283,517,0.999671158533781,0.952205882352941,5.9,311,133,178,2,1.3,21,4.4,0,0,0,0,0,0,0.00573269626297108,9.67094109592989,0.608168743942302
24.3,"eps_greedy_SVM","SVM",7,28,10433,10433,0,2900,2383,517,0.999672883226786,0.952205882352941,5.9,311,134,177,0,1.3,21.75,4.6,0,0,0,0,0,0,0.0041488824765845,6.49609393372741,0.432212152029899
24.3,"eps_greedy_SVM","SVM",7,29,10333,10333,0,3000,2483,517,0.999680356896472,0.952205882352941,5.9,312,133,179,1,1.3,22.5,4.8,0,0,0,0,0,0,0.00359655654057352,5.6226075869815,0.375178496748224
24.3,"eps_greedy_SVM","SVM",7,30,10233,10233,0,3100,2583,517,0.999685530975486,0.955882352941177,5.894783377542,310,133,177,-2,1.3,23.25,5,0,0,0,0,0,0,0.00363099864658956,5.81195007496102,0.376043551550641
24.3,"eps_greedy_SVM","SVM",7,31,10133,10133,0,3200,2683,517,0.999686680770823,0.955882352941177,5.894783377542,309,133,176,-1,1.3,24,5.2,0,0,0,0,0,0,0.00289982191401633,4.48834327561447,0.30287939268714
24.3,"eps_greedy_SVM","SVM",7,32,10033,10033,0,3300,2783,517,0.999689555259164,0.955882352941177,5.894783377542,311,134,177,2,1.3,24.75,5.4,0,0,0,0,0,0,0.00285011714412729,4.63856786500646,0.295776309684849
24.3,"eps_greedy_SVM","SVM",7,33,9933,9933,0,3400,2883,517,0.999693579542841,0.955882352941177,5.87918871252205,311,133,178,0,1.3,25.5,5.6,0,0,0,0,0,0,0.00189247916213136,2.91338787773814,0.198992209913349
24.3,"eps_greedy_SVM","SVM",7,34,9833,9833,0,3500,2983,517,0.999701053212528,0.955882352941177,5.894783377542,312,134,178,1,1.3,26.25,5.8,0,0,0,0,0,0,0.00199706309363038,3.23342650290708,0.207469017064947
24.3,"eps_greedy_SVM","SVM",7,35,9733,9733,0,3600,3083,517,0.999703352803201,0.955882352941177,5.88957597173145,311,134,177,-1,1.3,27,6,0,0,0,0,0,0,0.00174211638381082,2.82147023063763,0.181390096890164
24.3,"eps_greedy_SVM","SVM",7,36,9633,9633,0,3700,3183,517,0.999701053212528,0.955882352941177,5.894783377542,314,134,180,3,1.3,27.75,6.2,0,0,0,0,0,0,0.00185565512873537,3.09593441910753,0.192759014416929
24.3,"eps_greedy_SVM","SVM",7,37,9533,9533,0,3800,3283,517,0.999704502598537,0.955882352941177,5.894783377542,310,133,177,-4,1.3,28.5,6.4,0,0,0,0,0,0,0.00187373334657306,3.19722955040496,0.194057534723373
24.3,"eps_greedy_SVM","SVM",7,38,9433,9433,0,3900,3383,517,0.999705652393874,0.955882352941177,5.88957597173145,309,133,176,-1,1.3,29.25,6.5,0,0,0,0,0,0,0.00149364379894484,2.44928990059323,0.153812922128496
24.3,"eps_greedy_SVM","SVM",7,39,9333,9333,0,4000,3483,517,0.999707377086879,0.959558823529412,5.88957597173145,313,134,179,4,1.3,30,6.7,0,0,0,0,0,0,0.00130300696996959,2.1381806857716,0.134723920621012
24.3,"eps_greedy_SVM","SVM",7,40,9233,9233,0,4100,3583,517,0.999709101779883,0.959558823529412,5.88957597173145,313,134,179,0,1.3,30.75,6.9,0,0,0,0,0,0,0.00119712469199648,1.95053444214093,0.124357999834138
24.3,"eps_greedy_SVM","SVM",7,41,9133,9133,0,4200,3683,517,0.999709676677551,0.959558823529412,5.88437775816417,315,134,181,2,1.4,31.5,7.1,0,0,0,0,0,0,0.00113204809995297,1.81957308692089,0.117547424275032
24.3,"eps_greedy_SVM","SVM",7,42,9033,9033,0,4300,3783,517,0.999711401370556,0.959558823529412,5.88957597173145,314,134,180,-1,1.3,32.25,7.3,0,0,0,0,0,0,0.00119645925631558,1.98137036905599,0.123061950157535
24.3,"eps_greedy_SVM","SVM",7,43,8933,8933,0,4400,3883,517,0.99971025157522,0.959558823529412,5.88957597173145,318,134,184,4,1.4,33,7.5,0,0,0,0,0,0,0.000905031494527671,1.42003205211267,0.0930786723803848
24.3,"eps_greedy_SVM","SVM",7,44,8833,8833,0,4500,3983,517,0.999708526882215,0.959558823529412,5.88957597173145,317,134,183,-1,1.4,33.75,7.7,0,0,0,0,0,0,0.00104576957803364,1.70438900130217,0.107223064527107
24.3,"eps_greedy_SVM","SVM",7,45,8733,8733,0,4600,4083,517,0.999707951984547,0.959558823529412,5.87918871252205,317,134,183,0,1.4,34.5,7.9,0,0,0,0,0,0,0.000807048401698867,1.22005644634613,0.0832389470579487
24.3,"eps_greedy_SVM","SVM",7,46,8633,8633,0,4700,4183,517,0.99971025157522,0.959558823529412,5.88437775816417,319,134,185,2,1.4,35.25,8.1,0,0,0,0,0,0,0.000760915033740754,1.16898774497276,0.078550459636376
24.3,"eps_greedy_SVM","SVM",7,47,8533,8533,0,4800,4283,517,0.999710826472888,0.959558823529412,5.8585237258348,317,134,183,-2,1.4,36,8.3,0,0,0,0,0,0,0.000648229994746278,0.955707408222226,0.0669919383049184
24.3,"eps_greedy_SVM","SVM",7,48,8433,8433,0,4900,4383,517,0.999711401370556,0.959558823529412,5.87918871252205,318,134,184,1,1.4,36.75,8.5,0,0,0,0,0,0,0.00061694200898859,0.925412646563324,0.0642944542919305
24.3,"eps_greedy_SVM","SVM",8,0,13233,12730,503,100,94,6,0.971093627681231,0.792857142857143,5.48329173067076,24,6,18,0,3,0.75,15.7,0,0,0,0,0,0,0.930972376999842,828.303847702281,96.5074864752305
24.3,"eps_greedy_SVM","SVM",8,1,13133,12730,403,200,94,106,0.974715381690491,0.825,5.48663256227758,52,16,36,28,2.2,1.5,0.9,0,0,0,0,0,0,0.969059088259588,531.213680282595,98.1833229494134
24.3,"eps_greedy_SVM","SVM",8,2,13033,12730,303,300,94,206,0.973076449931775,0.817857142857143,5.4849681122449,72,26,46,20,1.8,2.25,0.5,0,0,0,0,0,0,0.981229535770339,459.504140020592,98.822230712789
24.3,"eps_greedy_SVM","SVM",8,3,12933,12729,204,400,95,305,0.978445614976859,0.821428571428571,5.64275455244935,80,32,48,8,1.5,3,0.3,0,0,0,0,0,0,0.508407226597588,302.339457438679,85.3931815932335
24.3,"eps_greedy_SVM","SVM",8,4,12833,12699,134,500,125,375,0.984172090630509,0.892857142857143,5.74815616119866,103,45,58,23,1.3,3.75,0.3,0,0,0,0,0,0,0.139886529287027,128.060964978038,59.3876056057944
24.3,"eps_greedy_SVM","SVM",8,5,12733,12641,92,600,183,417,0.959753069851729,0.903571428571429,5.44426474326385,139,64,75,36,1.2,4.5,0.4,0,0,0,0,0,0,0.0345670701808836,78.4696904554839,34.6888629980211
24.3,"eps_greedy_SVM","SVM",8,6,12633,12564,69,700,260,440,0.956682658972498,0.9,5.23380600719871,148,69,79,9,1.1,5.25,0.6,0,0,0,0,0,0,0.019748015898194,52.0061076776314,14.0272419300129
24.3,"eps_greedy_SVM","SVM",8,7,12533,12466,67,800,358,442,0.961535708693995,0.9,5.24291620042273,155,70,85,7,1.2,6,0.8,0,0,0,0,0,0,0.00655893028054281,14.1852844320186,10.7614947001346
24.3,"eps_greedy_SVM","SVM",8,8,12433,12370,63,900,454,446,0.961657608087854,0.9,5.25205816415494,156,72,84,1,1.2,6.75,1,0,0,0,0,0,0,0.00375967384993187,7.30171900579939,6.39521250138018
24.3,"eps_greedy_SVM","SVM",8,9,12333,12272,61,1000,552,448,0.964112930282503,0.9,5.2636391893572,154,72,82,-2,1.1,7.5,1.2,0,0,0,0,0,0,0.00275337918893606,4.43327921224532,4.2942335865025
24.3,"eps_greedy_SVM","SVM",8,10,12233,12175,58,1100,649,451,0.964601646201007,0.9,5.27281728733342,156,72,84,2,1.2,8.25,1.4,0,0,0,0,0,0,1.52858951617809e-05,1.04780687378101,1.03882252588434
24.3,"eps_greedy_SVM","SVM",8,11,12133,12076,57,1200,748,452,0.965589702297099,0.9,5.282027448534,161,73,88,5,1.2,9,1.7,0,0,0,0,0,0,6.04895825395237e-06,0.00463328090116297,0.000728344367169302
24.3,"eps_greedy_SVM","SVM",8,12,12033,11976,57,1300,848,452,0.96624113713125,0.9,5.282027448534,160,76,84,-1,1.1,9.75,1.9,0,0,0,0,0,0,4.09852933916714e-06,0.00307025293246958,0.0005153454832047
24.3,"eps_greedy_SVM","SVM",8,13,11933,11876,57,1400,948,452,0.966421749535911,0.9,5.27281728733342,158,75,83,-2,1.1,10.5,2.1,0,0,0,0,0,0,2.50035519002401e-06,0.00204504926598928,0.000292176338162983
24.3,"eps_greedy_SVM","SVM",8,14,11833,11776,57,1500,1048,452,0.968302243396207,0.9,5.28896528123444,160,74,86,2,1.2,11.25,2.3,0,0,0,0,0,0,1.64318372141463e-06,0.00123226626942725,0.000194761236519068
24.3,"eps_greedy_SVM","SVM",8,15,11733,11676,57,1600,1148,452,0.968349213804849,0.9,5.28896528123444,160,74,86,0,1.2,12,2.5,0,0,0,0,0,0,1.48656838766428e-06,0.00118206733068404,0.00016455648702933
24.3,"eps_greedy_SVM","SVM",8,16,11633,11579,54,1700,1245,455,0.978512715560659,0.907142857142857,5.51406015037594,172,78,94,12,1.2,12.75,2.7,0,0,0,0,0,0,3.79196926151536e-06,0.509935585545856,0.507699288958434
24.3,"eps_greedy_SVM","SVM",8,17,11533,11486,47,1800,1338,462,0.978613925607844,0.917857142857143,5.5412510936133,187,85,102,15,1.2,13.5,2.9,0,0,0,0,0,0,5.92676438830306e-06,0.0989314373477292,0.095839216344243
24.3,"eps_greedy_SVM","SVM",8,18,11433,11398,35,1900,1426,474,0.981519380885288,0.935714285714286,5.51059708857636,213,98,115,26,1.2,14.25,3,0,0,0,0,0,0,0.00291381219721891,0.728420975257832,0.574340168941626
24.3,"eps_greedy_SVM","SVM",8,19,11333,11302,31,2000,1522,478,0.982568386678323,0.935714285714286,5.53593962217558,217,101,116,4,1.1,15,3.2,0,0,0,0,0,0,0.00293085836491522,0.620379048714411,0.445577113080098
24.3,"eps_greedy_SVM","SVM",8,20,11233,11204,29,2100,1620,480,0.987259276655707,0.935714285714286,5.61104658385093,229,105,124,12,1.2,15.75,3.4,0,0,0,0,0,0,0.00307527144141669,0.741394667346077,0.401973734133039
24.3,"eps_greedy_SVM","SVM",8,21,11133,11109,24,2200,1715,485,0.993060122123045,0.939285714285714,5.79009439899308,243,111,132,14,1.2,16.5,3.5,0,0,0,0,0,0,0.00733194807076981,5.85264317534267,0.952165989390176
24.3,"eps_greedy_SVM","SVM",8,22,11033,11016,17,2300,1808,492,0.997143751817305,0.946428571428571,5.89437094517237,265,118,147,22,1.2,17.25,3.7,0,0,0,0,0,0,0.0143924313619818,12.3206974233316,2.16108534812764
24.3,"eps_greedy_SVM","SVM",8,23,10933,10921,12,2400,1903,497,0.998454449887047,0.946428571428571,5.94206773618538,277,124,153,12,1.2,18,3.8,0,0,0,0,0,0,0.0100744943685932,8.43701287200938,1.30550906773225
24.3,"eps_greedy_SVM","SVM",8,24,10833,10825,8,2500,1999,501,0.999075689458498,0.953571428571429,5.94206773618538,293,128,165,16,1.3,18.75,4,0,0,0,0,0,0,0.00950289032395301,8.66752356553705,1.14746495712421
24.3,"eps_greedy_SVM","SVM",8,25,10733,10727,6,2600,2097,503,0.999451452727639,0.960714285714286,5.9579982126899,295,130,165,2,1.3,19.5,4.2,0,0,0,0,0,0,0.007934802775197,6.86337807640769,0.958000099311829
24.3,"eps_greedy_SVM","SVM",8,26,10633,10630,3,2700,2194,506,0.999605784070321,0.960714285714286,5.95267857142857,306,133,173,11,1.3,20.25,4.3,0,0,0,0,0,0,0.00835585226975597,7.78823731057057,1.18220141177739
24.3,"eps_greedy_SVM","SVM",8,27,10533,10533,0,2800,2291,509,0.999633183475363,0.964285714285714,5.9579982126899,322,136,186,16,1.4,21,4.5,0,0,0,0,0,0,0.00857768486110942,8.53882451305934,0.997214110823659
24.3,"eps_greedy_SVM","SVM",8,28,10433,10433,0,2900,2391,509,0.999635420161489,0.964285714285714,5.9686660698299,321,136,185,-1,1.4,21.75,4.7,0,0,0,0,0,0,0.0052187411885461,3.44011024954403,0.567074723732602
24.3,"eps_greedy_SVM","SVM",8,29,10333,10333,0,3000,2491,509,0.999642130219866,0.964285714285714,5.96332737030411,321,135,186,0,1.4,22.5,4.9,0,0,0,0,0,0,0.00506168328388697,3.5759917790296,0.533713461416356
24.3,"eps_greedy_SVM","SVM",8,30,10233,10233,0,3100,2591,509,0.999649399449775,0.964285714285714,5.9686660698299,321,135,186,0,1.4,23.25,5.1,0,0,0,0,0,0,0.00395197213062723,2.07847428581617,0.417384196236019
24.3,"eps_greedy_SVM","SVM",8,31,10133,10133,0,3200,2691,509,0.999649958621306,0.964285714285714,5.96332737030411,323,135,188,2,1.4,24,5.3,0,0,0,0,0,0,0.00360857251413322,1.67904498642552,0.376883989910928
24.3,"eps_greedy_SVM","SVM",8,32,10033,10033,0,3300,2791,509,0.999651076964369,0.964285714285714,5.96332737030411,323,135,188,0,1.4,24.75,5.5,0,0,0,0,0,0,0.00291892223357799,0.783971146789302,0.307223584543871
24.3,"eps_greedy_SVM","SVM",8,33,9933,9933,0,3400,2891,509,0.999652195307432,0.964285714285714,5.96332737030411,323,135,188,0,1.4,25.5,5.7,0,0,0,0,0,0,0.00299026329289838,0.940340193391546,0.311484808623006
24.3,"eps_greedy_SVM","SVM",8,34,9833,9833,0,3500,2991,509,0.999654431993558,0.964285714285714,5.95267857142857,322,135,187,-1,1.4,26.25,5.9,0,0,0,0,0,0,0.00275417406218582,0.611318960532302,0.286539728318842
24.3,"eps_greedy_SVM","SVM",8,35,9733,9733,0,3600,3091,509,0.999656668679684,0.967857142857143,5.95267857142857,321,136,185,-1,1.4,27,6.1,0,0,0,0,0,0,1.33504483843958e-05,0.0108159497525886,0.00144431159490419
24.3,"eps_greedy_SVM","SVM",8,36,9633,9633,0,3700,3191,509,0.999656668679684,0.967857142857143,5.95267857142857,321,137,184,0,1.3,27.75,6.3,0,0,0,0,0,0,1.02534055188772e-05,0.0084411164505211,0.0011303682238893
24.3,"eps_greedy_SVM","SVM",8,37,9533,9533,0,3800,3291,509,0.999657787022747,0.967857142857143,5.95267857142857,322,137,185,1,1.4,28.5,6.5,0,0,0,0,0,0,8.56367053020782e-06,0.00712806699508934,0.000917319993497534
24.3,"eps_greedy_SVM","SVM",8,38,9433,9433,0,3900,3391,509,0.999661142051936,0.967857142857143,5.95267857142857,320,136,184,-2,1.4,29.25,6.7,0,0,0,0,0,0,6.58353988651517e-06,0.00558279048356065,0.000720224856371842
24.3,"eps_greedy_SVM","SVM",8,39,9333,9333,0,4000,3491,509,0.999662260394999,0.967857142857143,5.95267857142857,320,136,184,0,1.4,30,6.9,0,0,0,0,0,0,0.00146977829812507,2.34775622728776,0.152473675587017
24.3,"eps_greedy_SVM","SVM",8,40,9233,9233,0,4100,3591,509,0.999664497081124,0.967857142857143,5.92095914742451,322,136,186,2,1.4,30.75,7.1,0,0,0,0,0,0,0.000984232437449067,1.48987467113942,0.103290195309578
24.3,"eps_greedy_SVM","SVM",8,41,9133,9133,0,4200,3691,509,0.99966869086761,0.967857142857143,5.94736842105263,323,137,186,1,1.4,31.5,7.3,0,0,0,0,0,0,0.00118555173129717,1.88944140047559,0.121841798042509
24.3,"eps_greedy_SVM","SVM",8,42,9033,9033,0,4300,3791,509,0.999670088796439,0.967857142857143,5.93677649154052,322,137,185,-1,1.4,32.25,7.4,0,0,0,0,0,0,0.00103898199689792,1.58877042008079,0.107036867992894
24.3,"eps_greedy_SVM","SVM",8,43,8933,8933,0,4400,3891,509,0.999672325482565,0.967857142857143,5.95267857142857,321,137,184,-1,1.3,33,7.6,0,0,0,0,0,0,0.00153086938776901,2.58716902175818,0.157641276527131
24.3,"eps_greedy_SVM","SVM",8,44,8833,8833,0,4500,3991,509,0.999673443825628,0.967857142857143,5.95267857142857,320,137,183,-1,1.3,33.75,7.8,0,0,0,0,0,0,0.000974706599636532,1.5276413915364,0.100508793214661
24.3,"eps_greedy_SVM","SVM",8,45,8733,8733,0,4600,4091,509,0.999675121340222,0.967857142857143,5.93677649154052,321,138,183,1,1.3,34.5,8,0,0,0,0,0,0,0.000787635122010426,1.19888543683469,0.0816977347614541
24.3,"eps_greedy_SVM","SVM",8,46,8633,8633,0,4700,4191,509,0.999676798854817,0.967857142857143,5.93149466192171,321,138,183,0,1.3,35.25,8.2,0,0,0,0,0,0,0.000660854862298315,0.997436633830744,0.0687161334874934
24.3,"eps_greedy_SVM","SVM",8,47,8533,8533,0,4800,4291,509,0.999679035540942,0.967857142857143,5.94206773618538,319,137,182,-2,1.3,36,8.4,0,0,0,0,0,0,0.000660581612299949,1.00073945151132,0.0680292248332815
24.3,"eps_greedy_SVM","SVM",8,48,8433,8433,0,4900,4391,509,0.999680153884005,0.967857142857143,5.93677649154052,318,137,181,-1,1.3,36.75,8.6,0,0,0,0,0,0,0.000626355535098781,0.946661037163301,0.0647939178849308
24.3,"eps_greedy_SVM","SVM",9,0,13233,12708,525,100,95,5,0.945403067594112,0.83011583011583,5.19776507276507,25,5,20,0,4,0.75,19,0,0,0,0,0,0,0.956127517267753,600.756489105308,97.9276055234198
24.3,"eps_greedy_SVM","SVM",9,1,13133,12707,426,200,96,104,0.962027436746565,0.837837837837838,5.39664363611732,45,14,31,20,2.2,1.5,0.9,0,0,0,0,0,0,0.967288186028006,552.908283160544,98.376049791083
24.3,"eps_greedy_SVM","SVM",9,2,13033,12707,326,300,96,204,0.957854323022841,0.853281853281853,5.27040937497879,60,21,39,15,1.9,2.25,0.5,0,0,0,0,0,0,0.979492399589286,418.483118185178,98.80484785587
24.3,"eps_greedy_SVM","SVM",9,3,12933,12705,228,400,98,302,0.959107582703098,0.864864864864865,5.33605504335042,75,32,43,15,1.3,3,0.3,0,0,0,0,0,0,0.954348503001379,231.812791114923,97.7059785638137
24.3,"eps_greedy_SVM","SVM",9,4,12833,12703,130,500,100,400,0.961811731474645,0.876447876447876,5.40221271880465,89,41,48,14,1.2,3.75,0.2,0,0,0,0,0,0,0.352415889387033,177.265441050884,75.6890225595186
24.3,"eps_greedy_SVM","SVM",9,5,12733,12655,78,600,148,452,0.958970808689884,0.884169884169884,5.3988416988417,122,58,64,33,1.1,4.5,0.3,0,0,0,0,0,0,0.0360582990029599,52.9967165762407,25.3215193464643
24.3,"eps_greedy_SVM","SVM",9,6,12633,12572,61,700,231,469,0.941456504658755,0.884169884169884,5.13033996323814,140,61,79,18,1.3,5.25,0.5,0,0,0,0,0,0,0.00635573133402876,16.1609894343065,5.90314444352978
24.3,"eps_greedy_SVM","SVM",9,7,12533,12475,58,800,328,472,0.948158431304517,0.884169884169884,5.09532411588967,147,68,79,7,1.2,6,0.7,0,0,0,0,0,0,0.00167160026185936,4.28839445056161,2.23603812416161
24.3,"eps_greedy_SVM","SVM",9,8,12433,12377,56,900,426,474,0.947830053167152,0.884169884169884,5.0516228075955,151,69,82,4,1.2,6.75,0.9,0,0,0,0,0,0,0.00091297502575056,1.10475532251752,0.116617980030713
24.3,"eps_greedy_SVM","SVM",9,9,12333,12277,56,1000,526,474,0.948764575169086,0.884169884169884,5.0866067093612,154,70,84,3,1.2,7.5,1.1,0,0,0,0,0,0,0.000637827226759365,0.751824081450726,0.0744907709007166
24.3,"eps_greedy_SVM","SVM",9,10,12233,12177,56,1100,626,474,0.950076882661167,0.884169884169884,5.09990141416273,156,70,86,2,1.2,8.25,1.3,0,0,0,0,0,0,0.000436915065679078,0.492706881602536,0.0492727784370047
24.3,"eps_greedy_SVM","SVM",9,11,12133,12077,56,1200,726,474,0.95063482423035,0.884169884169884,5.09990141416273,153,69,84,-3,1.2,9,1.5,0,0,0,0,0,0,0.000453433782955519,0.547549974514565,0.0494333246780519
24.3,"eps_greedy_SVM","SVM",9,12,12033,11977,56,1300,826,474,0.951539219797662,0.884169884169884,5.09554996244416,153,71,82,0,1.2,9.75,1.7,0,0,0,0,0,0,0.000386898263078782,0.477416919608068,0.0427925939312147
24.3,"eps_greedy_SVM","SVM",9,13,11933,11878,55,1400,925,475,0.955517114224968,0.884169884169884,5.17911686147988,155,70,85,2,1.2,10.5,1.9,0,0,0,0,0,0,0.000470710129600715,0.636432948766498,0.0658832755450589
24.3,"eps_greedy_SVM","SVM",9,14,11833,11783,50,1500,1020,480,0.960861543726694,0.888030888030888,5.19226479226479,173,78,95,18,1.2,11.25,2.1,0,0,0,0,0,0,0.000885251904813613,1.21048133891621,0.168505658156876
24.3,"eps_greedy_SVM","SVM",9,15,11733,11690,43,1600,1113,487,0.960958550846165,0.8996138996139,5.23626703626704,189,86,103,16,1.2,12,2.3,0,0,0,0,0,0,0.0016993277607855,2.20461603046966,0.278212709623537
24.3,"eps_greedy_SVM","SVM",9,16,11633,11602,31,1700,1201,499,0.961798475843441,0.915057915057915,5.33418432558587,208,98,110,19,1.1,12.75,2.4,0,0,0,0,0,0,0.00320213977622985,3.17425046372504,0.819704118790364
24.3,"eps_greedy_SVM","SVM",9,17,11533,11505,28,1800,1298,502,0.964359825314903,0.918918918918919,5.3794453224505,218,101,117,10,1.2,13.5,2.6,0,0,0,0,0,0,0.00251558725372634,2.32663974788001,0.330613913815122
24.3,"eps_greedy_SVM","SVM",9,18,11433,11405,28,1900,1398,502,0.964645423915109,0.918918918918919,5.38409479982514,220,102,118,2,1.2,14.25,2.8,0,0,0,0,0,0,0.00178972189474851,1.96208432595325,0.212110070004111
24.3,"eps_greedy_SVM","SVM",9,19,11333,11305,28,2000,1498,502,0.964961751478622,0.918918918918919,5.40277335940822,220,102,118,0,1.2,15,3,0,0,0,0,0,0,0.00147640856459509,1.93671750754859,0.168421443817301
24.3,"eps_greedy_SVM","SVM",9,20,11233,11206,27,2100,1597,503,0.966713302387474,0.922779922779923,5.37480386833277,225,103,122,5,1.2,15.75,3.2,0,0,0,0,0,0,0.00147367314978485,2.25180572882567,0.173363894329256
24.3,"eps_greedy_SVM","SVM",9,21,11133,11109,24,2200,1694,506,0.975122192818817,0.918918918918919,5.46027846027846,231,103,128,6,1.2,16.5,3.3,0,0,0,0,0,0,0.00320944194027932,5.67204208085262,0.380563813940286
24.3,"eps_greedy_SVM","SVM",9,22,11033,11012,21,2300,1791,509,0.980837779995064,0.915057915057915,5.59005740792081,244,108,136,13,1.3,17.25,3.5,0,0,0,0,0,0,0.00500560388655158,7.58578256113657,0.609045113601822
24.3,"eps_greedy_SVM","SVM",9,23,10933,10915,18,2400,1888,512,0.983255727637734,0.915057915057915,5.64721310360077,254,113,141,10,1.2,18,3.7,0,0,0,0,0,0,0.00600921953630141,10.074569094572,0.691043066662898
24.3,"eps_greedy_SVM","SVM",9,24,10833,10820,13,2500,1983,517,0.98956239546126,0.918918918918919,5.75313791833227,270,121,149,16,1.2,18.75,3.8,0,0,0,0,0,0,0.00909540736698922,12.9640387998996,1.17000656820256
24.3,"eps_greedy_SVM","SVM",9,25,10733,10724,9,2600,2079,521,0.994019300199064,0.922779922779923,5.78098447063964,284,126,158,14,1.3,19.5,4,0,0,0,0,0,0,0.00989835262717157,14.7147577454012,1.2644990089998
24.3,"eps_greedy_SVM","SVM",9,26,10633,10629,4,2700,2174,526,0.995584669741968,0.922779922779923,5.80888030888031,297,131,166,13,1.3,20.25,4.1,0,0,0,0,0,0,0.0102096918802152,14.5291522512801,1.33919911432472
24.3,"eps_greedy_SVM","SVM",9,27,10533,10530,3,2800,2273,527,0.99712172043633,0.922779922779923,5.84926381478106,301,132,169,4,1.3,21,4.3,0,0,0,0,0,0,0.00856300352332221,13.0958635813006,0.98389383927884
24.3,"eps_greedy_SVM","SVM",9,28,10433,10432,1,2900,2371,529,0.998543989414776,0.926640926640927,5.9,312,135,177,11,1.3,21.75,4.5,0,0,0,0,0,0,0.00697051136225445,10.2682836176303,0.934207409340172
24.3,"eps_greedy_SVM","SVM",9,29,10333,10332,1,3000,2471,529,0.998537060334813,0.926640926640927,5.9,309,134,175,-3,1.3,22.5,4.7,0,0,0,0,0,0,0.00584264606979873,8.90454218370919,0.619559927409891
24.3,"eps_greedy_SVM","SVM",9,30,10233,10232,1,3100,2571,529,0.998549110908662,0.926640926640927,5.9,313,134,179,4,1.3,23.25,4.9,0,0,0,0,0,0,0.00451974660150534,6.95599094516966,0.481735615368123
24.3,"eps_greedy_SVM","SVM",9,31,10133,10132,1,3200,2671,529,0.99856116148251,0.926640926640927,5.9052258635961,313,134,179,0,1.3,24,5,0,0,0,0,0,0,0.00506268452941963,8.54252312607723,0.529773150197537
24.3,"eps_greedy_SVM","SVM",9,32,10033,10033,0,3300,2770,530,0.999178150863544,0.926640926640927,5.91570541259982,316,134,182,3,1.4,24.75,5.2,0,0,0,0,0,0,0.00463864553336545,7.73892074229581,0.54436641526677
24.3,"eps_greedy_SVM","SVM",9,33,9933,9933,0,3400,2870,530,0.99920707224078,0.926640926640927,5.91570541259982,315,134,181,-1,1.4,25.5,5.4,0,0,0,0,0,0,0.00314300567374224,4.83803477916709,0.329462650238018
24.3,"eps_greedy_SVM","SVM",9,34,9833,9833,0,3500,2970,530,0.999228160745015,0.926640926640927,5.91570541259982,314,134,180,-1,1.3,26.25,5.6,0,0,0,0,0,0,0.00299548829464503,4.76162708564686,0.312961685416636
24.3,"eps_greedy_SVM","SVM",9,35,9733,9733,0,3600,3070,530,0.999235391089324,0.930501930501931,5.91570541259982,310,134,176,-4,1.3,27,5.8,0,0,0,0,0,0,0.00259865597386308,4.16284999393603,0.273444818957592
24.3,"eps_greedy_SVM","SVM",9,36,9633,9633,0,3700,3170,530,0.999252261892711,0.930501930501931,5.91570541259982,310,134,176,0,1.3,27.75,6,0,0,0,0,0,0,0.00291335842170418,4.99594562903764,0.300110432908374
24.3,"eps_greedy_SVM","SVM",9,37,9533,9533,0,3800,3270,530,0.999264914995252,0.930501930501931,5.9,309,134,175,-1,1.3,28.5,6.2,0,0,0,0,0,0,0.00217137009900559,3.50728213414466,0.224577548333318
24.3,"eps_greedy_SVM","SVM",9,38,9433,9433,0,3900,3370,530,0.999280580741255,0.930501930501931,5.9,308,133,175,-1,1.3,29.25,6.4,0,0,0,0,0,0,0.00245455258544968,4.33087081060208,0.254883122461672
24.3,"eps_greedy_SVM","SVM",9,39,9333,9333,0,4000,3470,530,0.999287811085564,0.930501930501931,5.9,310,133,177,2,1.3,30,6.5,0,0,0,0,0,0,0.00214337677594489,3.67589385417994,0.221948963028345
24.3,"eps_greedy_SVM","SVM",9,40,9233,9233,0,4100,3570,530,0.999283894649063,0.930501930501931,5.894783377542,312,134,178,2,1.3,30.75,6.7,0,0,0,0,0,0,0.0020076342000337,3.4726625188786,0.208567727500192
24.3,"eps_greedy_SVM","SVM",9,41,9133,9133,0,4200,3670,530,0.999298656602027,0.930501930501931,5.9,312,134,178,0,1.3,31.5,6.9,0,0,0,0,0,0,0.0015850785845472,2.58328839563168,0.163877423524576
24.3,"eps_greedy_SVM","SVM",9,42,9033,9033,0,4300,3770,530,0.999301066716797,0.934362934362934,5.9,312,134,178,0,1.3,32.25,7.1,0,0,0,0,0,0,0.00176034090957277,3.0388128946991,0.181674388274551
24.3,"eps_greedy_SVM","SVM",9,43,8933,8933,0,4400,3870,530,0.999302271774182,0.934362934362934,5.9,314,136,178,2,1.3,33,7.3,0,0,0,0,0,0,0.00138976972739717,2.25332632660722,0.143068584411151
24.3,"eps_greedy_SVM","SVM",9,44,8833,8833,0,4500,3970,530,0.99929925913072,0.934362934362934,5.9,316,137,179,2,1.3,33.75,7.5,0,0,0,0,0,0,0.00116930546372432,1.84082823429621,0.120130166819954
24.3,"eps_greedy_SVM","SVM",9,45,8733,8733,0,4600,4070,530,0.999296246487258,0.934362934362934,5.9,316,137,179,0,1.3,34.5,7.7,0,0,0,0,0,0,0.00140012303931194,2.30381807760835,0.143794861050329
24.3,"eps_greedy_SVM","SVM",9,46,8633,8633,0,4700,4170,530,0.999304079360259,0.934362934362934,5.9,314,136,178,-2,1.3,35.25,7.9,0,0,0,0,0,0,0.00100331549736474,1.51746933014908,0.103055569260572
24.3,"eps_greedy_SVM","SVM",9,47,8533,8533,0,4800,4270,530,0.999308297061106,0.934362934362934,5.9,315,136,179,1,1.3,36,8.1,0,0,0,0,0,0,0.000842796595522698,1.2576603471894,0.0875562673292236
24.3,"eps_greedy_SVM","SVM",9,48,8433,8433,0,4900,4370,530,0.999310707175876,0.934362934362934,5.9,314,136,178,-1,1.3,36.75,8.2,0,0,0,0,0,0,0.000922694051048168,1.44278624278722,0.0955156555743699
24.3,"eps_greedy_SVM","SVM",10,0,13233,12711,522,100,93,7,0.958578357805768,0.776923076923077,5.21423686348862,33,7,26,0,3.7,0.75,13.3,0,0,0,0,0,0,0.962589649590734,747.03913895103,97.567867623861
24.3,"eps_greedy_SVM","SVM",10,1,13133,12710,423,200,94,106,0.9688903963213,0.769230769230769,5.38171889838556,49,14,35,16,2.5,1.5,0.9,0,0,0,0,0,0,0.965355495472883,745.833145111374,97.9458185521881
24.3,"eps_greedy_SVM","SVM",10,2,13033,12709,324,300,95,205,0.966355908801624,0.792307692307692,5.26342105263158,72,25,47,23,1.9,2.25,0.5,0,0,0,0,0,0,0.95468893477394,474.864473101022,97.5821270283416
24.3,"eps_greedy_SVM","SVM",10,3,12933,12707,226,400,97,303,0.95763467841662,0.792307692307692,5.25067553805418,81,32,49,9,1.5,3,0.3,0,0,0,0,0,0,0.887780691712705,284.123296409768,96.5074764813042
24.3,"eps_greedy_SVM","SVM",10,4,12833,12702,131,500,102,398,0.95807049981386,0.807692307692308,5.37550607287449,96,41,55,15,1.3,3.75,0.3,0,0,0,0,0,0,0.166164472547277,179.038530861396,52.0459957457335
24.3,"eps_greedy_SVM","SVM",10,5,12733,12642,91,600,162,438,0.935704337803575,0.865384615384615,5.27525113526902,135,59,76,39,1.3,4.5,0.4,0,0,0,0,0,0,0.0589506001404462,139.211364515335,38.5990660705223
24.3,"eps_greedy_SVM","SVM",10,6,12633,12570,63,700,234,466,0.946539241934876,0.873076923076923,5.36914745903916,164,70,94,29,1.3,5.25,0.5,0,0,0,0,0,0,0.0368159568895664,69.5230761843872,20.7024785219821
24.3,"eps_greedy_SVM","SVM",10,7,12533,12477,56,800,327,473,0.958580759025591,0.876923076923077,5.41387945093776,167,71,96,3,1.4,6,0.7,0,0,0,0,0,0,0.0201172586702745,48.990032381975,11.2570408825544
24.3,"eps_greedy_SVM","SVM",10,8,12433,12388,45,900,416,484,0.956425063932476,0.9,5.39838056680162,194,79,115,27,1.5,6.75,0.9,0,0,0,0,0,0,0.0153845020197014,32.9293668850456,3.86907592630033
24.3,"eps_greedy_SVM","SVM",10,9,12333,12294,39,1000,510,490,0.960607388553425,0.907692307692308,5.42087381916329,207,84,123,13,1.5,7.5,1,0,0,0,0,0,0,0.0138407171589039,26.7934299983613,1.68724572462243
24.3,"eps_greedy_SVM","SVM",10,10,12233,12200,33,1100,604,496,0.963435425196015,0.919230769230769,5.53202747738557,213,90,123,6,1.4,8.25,1.2,0,0,0,0,0,0,0.0134135444219629,23.8796726979694,1.75425158384219
24.3,"eps_greedy_SVM","SVM",10,11,12133,12108,25,1200,696,504,0.958755447767481,0.926923076923077,5.55166200259368,231,97,134,18,1.4,9,1.4,0,0,0,0,0,0,0.0121784017933921,19.0995609669809,1.79179643741859
24.3,"eps_greedy_SVM","SVM",10,12,12033,12010,23,1300,794,506,0.958456495899931,0.926923076923077,5.56647960580345,231,98,133,0,1.4,9.75,1.6,0,0,0,0,0,0,0.00988692848674411,16.7990272651064,1.17162439523263
24.3,"eps_greedy_SVM","SVM",10,13,11933,11911,22,1400,893,507,0.959192469774664,0.930769230769231,5.56153162393162,236,100,136,5,1.4,10.5,1.8,0,0,0,0,0,0,0.00716209573756428,12.1065241837564,0.820788708342596
24.3,"eps_greedy_SVM","SVM",10,14,11833,11811,22,1500,993,507,0.958918130410263,0.930769230769231,5.56647960580345,236,100,136,0,1.4,11.25,2,0,0,0,0,0,0,0.00614855596171879,10.9784674313391,0.657799721662835
24.3,"eps_greedy_SVM","SVM",10,15,11733,11711,22,1600,1093,507,0.959292720702133,0.930769230769231,5.56647960580345,237,100,137,1,1.4,12,2.2,0,0,0,0,0,0,0.0044046923605069,7.56527955522572,0.466169724692807
24.3,"eps_greedy_SVM","SVM",10,16,11633,11611,22,1700,1193,507,0.959305327106186,0.930769230769231,5.56647960580345,238,101,137,1,1.4,12.75,2.4,0,0,0,0,0,0,0.00436902107988066,8.50339062415206,0.464561806328094
24.3,"eps_greedy_SVM","SVM",10,17,11533,11511,22,1800,1293,507,0.959336542963842,0.930769230769231,5.56647960580345,238,101,137,0,1.4,13.5,2.6,0,0,0,0,0,0,0.00346178421314839,6.64938002255886,0.365461440187715
24.3,"eps_greedy_SVM","SVM",10,18,11433,11411,22,1900,1393,507,0.95928011429808,0.930769230769231,5.56647960580345,236,101,135,-2,1.3,14.25,2.7,0,0,0,0,0,0,0.00272155000813144,5.31753294074339,0.286445837218857
24.3,"eps_greedy_SVM","SVM",10,19,11333,11311,22,2000,1493,507,0.959430190536811,0.930769230769231,5.56647960580345,238,101,137,2,1.4,15,2.9,0,0,0,0,0,0,0.00260642548747874,5.10981724604547,0.272615757718053
24.3,"eps_greedy_SVM","SVM",10,20,11233,11211,22,2100,1593,507,0.959615084462924,0.930769230769231,5.56647960580345,238,101,137,0,1.4,15.75,3.1,0,0,0,0,0,0,0.00248928802572658,5.24047870620553,0.260446444664519
24.3,"eps_greedy_SVM","SVM",10,21,11133,11111,22,2200,1693,507,0.959564658846712,0.930769230769231,5.56647960580345,238,101,137,0,1.4,16.5,3.3,0,0,0,0,0,0,0.00185808999906556,3.68385753213732,0.193795522271831
24.3,"eps_greedy_SVM","SVM",10,22,11033,11011,22,2300,1793,507,0.959568260676442,0.930769230769231,5.56647960580345,238,101,137,0,1.4,17.25,3.5,0,0,0,0,0,0,0.00196054890856415,4.10347889408873,0.204089175823283
24.3,"eps_greedy_SVM","SVM",10,23,10933,10911,22,2400,1893,507,0.959571862506173,0.930769230769231,5.57143639975341,238,101,137,0,1.4,18,3.7,0,0,0,0,0,0,0.00185935732364841,3.91503195699742,0.192710780742869
24.3,"eps_greedy_SVM","SVM",10,24,10833,10811,22,2500,1993,507,0.959658306419683,0.930769230769231,5.57143639975341,239,101,138,1,1.4,18.75,3.9,0,0,0,0,0,0,0.00146409903546572,3.01094222526348,0.153476051992373
24.3,"eps_greedy_SVM","SVM",10,25,10733,10711,22,2600,2093,507,0.960009484818307,0.930769230769231,5.57143639975341,241,101,140,2,1.4,19.5,4.1,0,0,0,0,0,0,0.00128273886179778,2.59850200429207,0.132994750338915
24.3,"eps_greedy_SVM","SVM",10,26,10633,10611,22,2700,2193,507,0.960355260472339,0.930769230769231,5.57143639975341,238,101,137,-3,1.4,20.25,4.3,0,0,0,0,0,0,0.00122393459884073,2.48692006563324,0.127066680865795
24.3,"eps_greedy_SVM","SVM",10,27,10533,10511,22,2800,2293,507,0.960443505300712,0.930769230769231,5.57143639975341,238,100,138,0,1.4,21,4.5,0,0,0,0,0,0,0.00113347195281708,2.21356929855749,0.117291658024098
24.3,"eps_greedy_SVM","SVM",10,28,10433,10411,22,2900,2393,507,0.960949562377701,0.926923076923077,5.56647960580345,237,101,136,-1,1.3,21.75,4.7,0,0,0,0,0,0,0.00147492983921877,3.15865714968764,0.154425897842308
24.3,"eps_greedy_SVM","SVM",10,29,10333,10311,22,3000,2493,507,0.961610498133066,0.926923076923077,5.56153162393162,232,101,131,-5,1.3,22.5,4.9,0,0,0,0,0,0,0.00121392263821522,2.47723830145792,0.125988272288241
24.3,"eps_greedy_SVM","SVM",10,30,10233,10211,22,3100,2593,507,0.962138166188439,0.930769230769231,5.56153162393162,234,102,132,2,1.3,23.25,5.1,0,0,0,0,0,0,0.00101340855699448,1.941085959606,0.104435828051134
24.3,"eps_greedy_SVM","SVM",10,31,10133,10111,22,3200,2693,507,0.962362680241578,0.930769230769231,5.56647960580345,233,102,131,-1,1.3,24,5.3,0,0,0,0,0,0,0.000826694337553675,1.54312134444975,0.0858953515344618
24.3,"eps_greedy_SVM","SVM",10,32,10033,10011,22,3300,2793,507,0.962463531474003,0.930769230769231,5.56647960580345,231,101,130,-2,1.3,24.75,5.5,0,0,0,0,0,0,0.00110146265411876,2.22445586984713,0.113466360060772
24.3,"eps_greedy_SVM","SVM",10,33,9933,9911,22,3400,2893,507,0.96354528100276,0.930769230769231,5.57143639975341,234,101,133,3,1.3,25.5,5.7,0,0,0,0,0,0,0.000912914605440497,1.73476739716274,0.0955197230501756
24.3,"eps_greedy_SVM","SVM",10,34,9833,9811,22,3500,2993,507,0.963988906364437,0.926923076923077,5.57143639975341,233,101,132,-1,1.3,26.25,5.9,0,0,0,0,0,0,0.000872703687550572,1.65036270032008,0.0899519599257668
24.3,"eps_greedy_SVM","SVM",10,35,9733,9711,22,3600,3093,507,0.96423142956622,0.926923076923077,5.57143639975341,233,101,132,0,1.3,27,6.1,0,0,0,0,0,0,0.00080694493176068,1.54064426109927,0.0834333638333277
24.3,"eps_greedy_SVM","SVM",10,36,9633,9611,22,3700,3193,507,0.964359294521617,0.926923076923077,5.57143639975341,235,102,133,2,1.3,27.75,6.3,0,0,0,0,0,0,0.00077311233245505,1.45451034717286,0.0792129739032589
24.3,"eps_greedy_SVM","SVM",10,37,9533,9512,21,3800,3292,508,0.974370580254738,0.930769230769231,5.5942701554901,237,103,134,2,1.3,28.5,6.5,0,0,0,0,0,0,0.000865731765487438,1.7005090310327,0.104791489099602
24.3,"eps_greedy_SVM","SVM",10,38,9433,9412,21,3900,3392,508,0.974803400127236,0.930769230769231,5.5942701554901,242,105,137,5,1.3,29.25,6.7,0,0,0,0,0,0,0.000760966380310727,1.45291402255681,0.0798673423546385
24.3,"eps_greedy_SVM","SVM",10,39,9333,9313,20,4000,3491,509,0.985668319506294,0.926923076923077,5.74662431318681,241,106,135,-1,1.3,30,6.9,0,0,0,0,0,0,0.00125640551364181,2.62467404754193,0.160180391934877
24.3,"eps_greedy_SVM","SVM",10,40,9233,9219,14,4100,3585,515,0.99863610714243,0.934615384615385,5.96332737030411,271,111,160,30,1.4,30.75,7,0,0,0,0,0,0,0.00210136597122462,4.22229451823238,1.64971474511992
24.3,"eps_greedy_SVM","SVM",10,41,9133,9132,1,4200,3672,528,0.999588791105882,0.953846153846154,5.99011680143756,304,126,178,33,1.4,31.5,7,0,0,0,0,0,0,0.00204251628073589,2.65265968449742,0.439644390689007
24.3,"eps_greedy_SVM","SVM",10,42,9033,9033,0,4300,3771,529,0.999576785006783,0.95,5.99011680143756,308,128,180,4,1.4,32.25,7.1,0,0,0,0,0,0,0.0017637350413528,2.76692616606351,0.207633816883019
24.3,"eps_greedy_SVM","SVM",10,43,8933,8933,0,4400,3871,529,0.999568380737415,0.95,5.99011680143756,308,128,180,0,1.4,33,7.3,0,0,0,0,0,0,0.00183303266369725,3.23608376061953,0.196136213999487
24.3,"eps_greedy_SVM","SVM",10,44,8833,8833,0,4500,3971,529,0.999565979517595,0.95,5.99011680143756,307,127,180,-1,1.4,33.75,7.5,0,0,0,0,0,0,0.00148564481180337,2.69504818696038,0.156332564257217
24.3,"eps_greedy_SVM","SVM",10,45,8733,8733,0,4600,4071,529,0.999561177077956,0.95,5.99011680143756,308,128,180,1,1.4,34.5,7.7,0,0,0,0,0,0,0.00118086322759469,2.10413608182386,0.123264624878205
24.3,"eps_greedy_SVM","SVM",10,46,8633,8633,0,4700,4171,529,0.999557575248226,0.95,5.98473967684022,310,129,181,2,1.4,35.25,7.9,0,0,0,0,0,0,0.00115632627446081,2.13203139250177,0.119321716734078
24.3,"eps_greedy_SVM","SVM",10,47,8533,8533,0,4800,4271,529,0.999556374638316,0.95,5.98473967684022,311,129,182,1,1.4,36,8.1,0,0,0,0,0,0,0.000901737153358729,1.62067706271048,0.0940266349683084
24.3,"eps_greedy_SVM","SVM",10,48,8433,8433,0,4900,4371,529,0.999553973418497,0.95,5.98473967684022,310,129,181,-1,1.4,36.75,8.3,0,0,0,0,0,0,0.000852750527285454,1.53123370358749,0.0878178158414655
24.3,"eps_greedy_SVM","SVM",11,0,13233,12705,528,100,94,6,0.941334874561134,0.745098039215686,5.40442643059037,26,6,20,0,3.3,0.75,15.7,0,0,0,0,0,0,0.956448981316428,646.159751095374,98.0534536442741
24.3,"eps_greedy_SVM","SVM",11,1,13133,12704,429,200,95,105,0.952215209227737,0.823529411764706,5.46279876914269,48,20,28,22,1.4,1.5,0.9,0,0,0,0,0,0,0.954892722451884,461.104035722235,97.4677263002592
24.3,"eps_greedy_SVM","SVM",11,2,13033,12703,330,300,96,204,0.95036390101891,0.831372549019608,5.539418032053,71,28,43,23,1.5,2.25,0.5,0,0,0,0,0,0,0.939216840603909,365.261150417923,96.7518557723679
24.3,"eps_greedy_SVM","SVM",11,3,12933,12699,234,400,100,300,0.940034616466625,0.866666666666667,5.46173710174351,82,35,47,11,1.3,3,0.3,0,0,0,0,0,0,0.834154682120871,181.567972321497,94.9115618760789
24.3,"eps_greedy_SVM","SVM",11,4,12833,12691,142,500,108,392,0.949908260247299,0.87843137254902,5.46456103161985,108,47,61,26,1.3,3.75,0.3,0,0,0,0,0,0,0.0790170476683693,82.9752425443939,75.4771180154635
24.3,"eps_greedy_SVM","SVM",11,5,12733,12624,109,600,175,425,0.947671645077189,0.886274509803922,5.3164768019884,134,62,72,26,1.2,4.5,0.4,0,0,0,0,0,0,0.0285960028852386,72.3050467789158,53.228344859935
24.3,"eps_greedy_SVM","SVM",11,6,12633,12532,101,700,267,433,0.936248822673154,0.886274509803922,5.20152257221907,149,66,83,15,1.3,5.25,0.6,0,0,0,0,0,0,0.0121769997620052,58.3766613156222,44.8660203794181
24.3,"eps_greedy_SVM","SVM",11,7,12533,12435,98,800,364,436,0.94355253018235,0.886274509803922,5.18354987212276,147,62,85,-2,1.4,6,0.8,0,0,0,0,0,0,0.0026257194094049,41.2064020200066,41.172056690071
24.3,"eps_greedy_SVM","SVM",11,8,12433,12376,57,900,423,477,0.944408767873945,0.886274509803922,5.18354987212276,147,62,85,0,1.4,6.75,0.9,0,0,0,0,0,0,8.44067657493728e-06,0.0118528400585046,0.00661572408843422
24.3,"eps_greedy_SVM","SVM",11,9,12333,12276,57,1000,523,477,0.949149878291895,0.886274509803922,5.15664563403216,151,67,84,4,1.3,7.5,1.1,0,0,0,0,0,0,1.93310744483931e-06,0.00108235170291671,0.000310490753314624
24.3,"eps_greedy_SVM","SVM",11,10,12233,12176,57,1100,623,477,0.949969420082413,0.886274509803922,5.16111026228673,150,65,85,-1,1.3,8.25,1.3,0,0,0,0,0,0,1.05832225553998e-06,0.000587404946732709,0.000135937589223347
24.3,"eps_greedy_SVM","SVM",11,11,12133,12076,57,1200,723,477,0.951184054407757,0.886274509803922,5.17006275190041,147,65,82,-3,1.3,9,1.5,0,0,0,0,0,0,3.96588640487941e-07,0.000225517842077772,5.11015019556347e-05
24.3,"eps_greedy_SVM","SVM",11,12,12033,11977,56,1300,822,478,0.956056046872853,0.894117647058824,5.26090387374462,151,67,84,4,1.3,9.75,1.7,0,0,0,0,0,0,1.48259371917899e-06,0.00440198369305373,0.00361823868385905
24.3,"eps_greedy_SVM","SVM",11,13,11933,11881,52,1400,918,482,0.963902853717882,0.894117647058824,5.38483614304617,162,71,91,11,1.3,10.5,1.9,0,0,0,0,0,0,4.20395124768826e-06,0.105367295881563,0.1031681474383
24.3,"eps_greedy_SVM","SVM",11,14,11833,11788,45,1500,1011,489,0.963132239795444,0.909803921568627,5.43927738927739,178,79,99,16,1.3,11.25,2.1,0,0,0,0,0,0,5.46896508563992e-06,0.26613443099832,0.264385656917177
24.3,"eps_greedy_SVM","SVM",11,15,11733,11699,34,1600,1100,500,0.962986679387875,0.929411764705882,5.4345269286754,205,93,112,27,1.2,12,2.2,0,0,0,0,0,0,1.43976193094115e-05,0.42361804065816,0.421189811560966
24.3,"eps_greedy_SVM","SVM",11,16,11633,11603,30,1700,1196,504,0.965485058652243,0.925490196078431,5.46691026366802,220,98,122,15,1.2,12.75,2.4,0,0,0,0,0,0,8.61109175890675e-06,0.0878566792684757,0.0856076636525114
24.3,"eps_greedy_SVM","SVM",11,17,11533,11503,30,1800,1296,504,0.965275892016152,0.925490196078431,5.46691026366802,217,98,119,-3,1.2,13.5,2.6,0,0,0,0,0,0,8.21064553451533e-06,0.00374502370960351,0.00101496453174274
24.3,"eps_greedy_SVM","SVM",11,18,11433,11403,30,1900,1396,504,0.965245312098591,0.925490196078431,5.46691026366802,216,99,117,-1,1.2,14.25,2.8,0,0,0,0,0,0,2.51973386425555e-06,0.00131073558940639,0.000323889928419346
24.3,"eps_greedy_SVM","SVM",11,19,11333,11304,29,2000,1495,505,0.967456240137957,0.925490196078431,5.48978436518965,221,99,122,5,1.2,15,3,0,0,0,0,0,0,3.86504334240347e-06,0.00237472928014568,0.0004746719488751
24.3,"eps_greedy_SVM","SVM",11,20,11233,11205,28,2100,1594,506,0.97047814759089,0.925490196078431,5.49940712481312,224,100,124,3,1.2,15.75,3.2,0,0,0,0,0,0,4.20121675966295e-06,0.00312866162930569,0.000558112322068558
24.3,"eps_greedy_SVM","SVM",11,21,11133,11107,26,2200,1692,508,0.975035778503512,0.925490196078431,5.55640972438358,228,101,127,4,1.3,16.5,3.3,0,0,0,0,0,0,7.12051883557959e-06,0.072991000459952,0.0683480838577457
24.3,"eps_greedy_SVM","SVM",11,22,11033,11008,25,2300,1791,509,0.977364745024637,0.925490196078431,5.63232165206508,234,102,132,6,1.3,17.25,3.5,0,0,0,0,0,0,1.31485725429738e-05,0.136129267621256,0.127325594062508
24.3,"eps_greedy_SVM","SVM",11,23,10933,10912,21,2400,1887,513,0.986813327951262,0.925490196078431,5.7170614379085,247,109,138,13,1.3,18,3.7,0,0,0,0,0,0,0.00262542754680711,0.409979902919046,0.335558818512877
24.3,"eps_greedy_SVM","SVM",11,24,10833,10819,14,2500,1980,520,0.997272271353957,0.929411764705882,5.92404540763674,263,115,148,16,1.3,18.75,3.8,0,0,0,0,0,0,0.0090061546843056,9.19097070741046,1.15450589879801
24.3,"eps_greedy_SVM","SVM",11,25,10733,10728,5,2600,2071,529,0.999310117059925,0.933333333333333,5.99011680143756,293,127,166,30,1.3,19.5,3.9,0,0,0,0,0,0,0.0191321914651941,15.8422303999481,2.97263774332341
24.3,"eps_greedy_SVM","SVM",11,26,10633,10633,0,2700,2166,534,0.999587782711338,0.941176470588235,6.0117222723174,308,132,176,15,1.3,20.25,4.1,0,0,0,0,0,0,0.0118258895657771,9.63713235385723,1.51341708725524
24.3,"eps_greedy_SVM","SVM",11,27,10533,10533,0,2800,2266,534,0.999592063899796,0.941176470588235,6.000900090009,310,132,178,2,1.3,21,4.2,0,0,0,0,0,0,0.00764537974067582,5.53257541519195,0.867139334189753
24.3,"eps_greedy_SVM","SVM",11,28,10433,10433,0,2900,2366,534,0.999595733489903,0.945098039215686,5.99011680143756,310,132,178,0,1.3,21.75,4.4,0,0,0,0,0,0,0.0064661970574184,4.8044317551803,0.713287896463187
24.3,"eps_greedy_SVM","SVM",11,29,10333,10333,0,3000,2466,534,0.999596345088254,0.945098039215686,5.98473967684022,308,132,176,-2,1.3,22.5,4.6,0,0,0,0,0,0,0.00517119756791998,3.28590601696246,0.553206919818457
24.3,"eps_greedy_SVM","SVM",11,30,10233,10233,0,3100,2566,534,0.999604295866818,0.945098039215686,5.98473967684022,307,132,175,-1,1.3,23.25,4.8,0,0,0,0,0,0,0.00395937122615487,1.83251921054088,0.421914947261193
24.3,"eps_greedy_SVM","SVM",11,31,10133,10133,0,3200,2666,534,0.999609188653627,0.941176470588235,5.99011680143756,310,133,177,3,1.3,24,5,0,0,0,0,0,0,0.00455312800452268,2.97136726218623,0.483697352208743
24.3,"eps_greedy_SVM","SVM",11,32,10033,10033,0,3300,2766,534,0.999614081440436,0.941176470588235,5.99011680143756,312,133,179,2,1.3,24.75,5.2,0,0,0,0,0,0,0.00331558773965544,1.28093036343034,0.350485932846307
24.3,"eps_greedy_SVM","SVM",11,33,9933,9933,0,3400,2866,534,0.999614081440436,0.937254901960784,5.98473967684022,312,134,178,0,1.3,25.5,5.4,0,0,0,0,0,0,1.71108395658402e-05,0.125994786645973,0.114720792311662
24.3,"eps_greedy_SVM","SVM",11,34,9833,9833,0,3500,2966,534,0.999618974227245,0.937254901960784,5.9686660698299,314,135,179,2,1.3,26.25,5.6,0,0,0,0,0,0,1.4466491549777e-05,0.0112805135829574,0.00160429159059541
24.3,"eps_greedy_SVM","SVM",11,35,9733,9733,0,3600,3066,534,0.999622643817352,0.937254901960784,5.96332737030411,316,135,181,2,1.3,27,5.7,0,0,0,0,0,0,1.02807013820221e-05,0.00816835324904747,0.00112905633819478
24.3,"eps_greedy_SVM","SVM",11,36,9633,9633,0,3700,3166,534,0.999624478612406,0.937254901960784,5.96332737030411,316,136,180,0,1.3,27.75,5.9,0,0,0,0,0,0,0.00162546277933799,2.44293491540165,0.17059168736521
24.3,"eps_greedy_SVM","SVM",11,37,9533,9533,0,3800,3266,534,0.99962692500581,0.937254901960784,5.9579982126899,315,136,179,-1,1.3,28.5,6.1,0,0,0,0,0,0,0.00147337333299538,2.27081168668174,0.153808267727735
24.3,"eps_greedy_SVM","SVM",11,38,9433,9433,0,3900,3366,534,0.999627536604161,0.937254901960784,5.97401433691756,315,136,179,0,1.3,29.25,6.3,0,0,0,0,0,0,0.00162767401507385,2.69215834286731,0.169307188852206
24.3,"eps_greedy_SVM","SVM",11,39,9333,9333,0,4000,3466,534,0.999625090210757,0.937254901960784,5.9686660698299,313,135,178,-2,1.3,30,6.5,0,0,0,0,0,0,0.00141344782758444,2.34930608870183,0.147465016079088
24.3,"eps_greedy_SVM","SVM",11,40,9233,9233,0,4100,3566,534,0.999630594595917,0.937254901960784,5.97401433691756,314,135,179,1,1.3,30.75,6.7,0,0,0,0,0,0,0.0017319342501868,3.06657714105295,0.178012731422412
24.3,"eps_greedy_SVM","SVM",11,41,9133,9133,0,4200,3666,534,0.99963518158355,0.937254901960784,5.9686660698299,316,134,182,2,1.4,31.5,6.9,0,0,0,0,0,0,0.00125822890750446,2.09213395869403,0.129175344858898
24.3,"eps_greedy_SVM","SVM",11,42,9033,9033,0,4300,3766,534,0.999634875784375,0.937254901960784,5.9686660698299,316,135,181,0,1.3,32.25,7.1,0,0,0,0,0,0,0.00104737790727074,1.73733465063636,0.108788386323599
24.3,"eps_greedy_SVM","SVM",11,43,8933,8933,0,4400,3866,534,0.999642520763764,0.937254901960784,5.9686660698299,313,134,179,-3,1.3,33,7.2,0,0,0,0,0,0,0.00137373367095099,2.37580801281312,0.141579269818867
24.3,"eps_greedy_SVM","SVM",11,44,8833,8833,0,4500,3966,534,0.999643438161291,0.937254901960784,5.96332737030411,312,134,178,-1,1.3,33.75,7.4,0,0,0,0,0,0,0.000763722485689468,1.1830442709459,0.0788703155771752
24.3,"eps_greedy_SVM","SVM",11,45,8733,8733,0,4600,4066,534,0.999645884554695,0.937254901960784,5.97401433691756,314,134,180,2,1.3,34.5,7.6,0,0,0,0,0,0,0.000825143453527571,1.33261266736519,0.0851552252779574
24.3,"eps_greedy_SVM","SVM",11,46,8633,8633,0,4700,4166,534,0.999646496153046,0.937254901960784,5.97937219730942,315,134,181,1,1.4,35.25,7.8,0,0,0,0,0,0,0.000944348479161656,1.54101601594898,0.097009702965779
24.3,"eps_greedy_SVM","SVM",11,47,8533,8533,0,4800,4266,534,0.999643438161291,0.937254901960784,5.97401433691756,315,135,180,0,1.3,36,8,0,0,0,0,0,0,0.000743643408132103,1.18013507766336,0.0762577181124398
24.3,"eps_greedy_SVM","SVM",11,48,8433,8433,0,4900,4366,534,0.999644661357993,0.941176470588235,5.96332737030411,315,134,181,0,1.4,36.75,8.2,0,0,0,0,0,0,0.000631098556545056,0.949112447208873,0.0647710936775401
24.3,"eps_greedy_SVM","SVM",12,0,13233,12703,530,100,95,5,0.977571394718627,0.822834645669291,5.7617630113309,24,5,19,0,3.8,0.75,19,0,0,0,0,0,0,0.973118704684217,866.444699156909,98.3428629319048
24.3,"eps_greedy_SVM","SVM",12,1,13133,12703,430,200,95,105,0.97826572746548,0.826771653543307,5.70918374598482,54,16,38,30,2.4,1.5,0.9,0,0,0,0,0,0,0.975427032721626,700.070777381862,98.4953437429955
24.3,"eps_greedy_SVM","SVM",12,2,13033,12702,331,300,96,204,0.976492754014651,0.838582677165354,5.6534221683828,69,25,44,15,1.8,2.25,0.5,0,0,0,0,0,0,0.952768528264833,552.811313540909,98.0107786166266
24.3,"eps_greedy_SVM","SVM",12,3,12933,12699,234,400,99,301,0.977326444439227,0.87007874015748,5.67396139515258,83,29,54,14,1.9,3,0.3,0,0,0,0,0,0,0.873897659389731,409.553546197129,95.0346344658961
24.3,"eps_greedy_SVM","SVM",12,4,12833,12687,146,500,111,389,0.976020656859617,0.897637795275591,5.72770389724729,99,39,60,16,1.5,3.75,0.3,0,0,0,0,0,0,0.223389288421644,174.584863237183,80.8523124468239
24.3,"eps_greedy_SVM","SVM",12,5,12733,12636,97,600,162,438,0.945927993212579,0.897637795275591,5.38003130043527,138,60,78,39,1.3,4.5,0.4,0,0,0,0,0,0,0.0386510220777312,89.3538692286343,40.8747835502311
24.3,"eps_greedy_SVM","SVM",12,6,12633,12542,91,700,256,444,0.954673147924172,0.897637795275591,5.32837356054235,145,60,85,7,1.4,5.25,0.6,0,0,0,0,0,0,0.011779493996912,47.264568926482,32.9120764101836
24.3,"eps_greedy_SVM","SVM",12,7,12533,12451,82,800,347,453,0.954355142298295,0.897637795275591,5.18591956767969,146,64,82,1,1.3,6,0.8,0,0,0,0,0,0,0.00716170974631678,28.883559371524,23.5412129313239
24.3,"eps_greedy_SVM","SVM",12,8,12433,12356,77,900,442,458,0.958705925832208,0.897637795275591,5.21784550051382,148,65,83,2,1.3,6.75,1,0,0,0,0,0,0,0.00458485036860769,19.3661328726739,18.4742385710354
24.3,"eps_greedy_SVM","SVM",12,9,12333,12260,73,1000,538,462,0.96049731659728,0.897637795275591,5.29065448052703,154,67,87,6,1.3,7.5,1.2,0,0,0,0,0,0,0.00293507011302372,14.4274659307947,14.2646212349969
24.3,"eps_greedy_SVM","SVM",12,10,12233,12174,59,1100,624,476,0.960874257628718,0.897637795275591,5.28606189851269,152,68,84,-2,1.2,8.25,1.3,0,0,0,0,0,0,9.39421441220666e-06,0.0195034077815707,0.0145637662944288
24.3,"eps_greedy_SVM","SVM",12,11,12133,12076,57,1200,722,478,0.966831030964403,0.901574803149606,5.35441614720035,161,69,92,9,1.3,9,1.5,0,0,0,0,0,0,0.00291112164181771,0.706780256742667,0.416868225437682
24.3,"eps_greedy_SVM","SVM",12,12,12033,11984,49,1300,814,486,0.970777247495551,0.913385826771654,5.43141084637148,178,76,102,17,1.3,9.75,1.7,0,0,0,0,0,0,0.0045990806637999,2.36236591857676,0.730673670831697
24.3,"eps_greedy_SVM","SVM",12,13,11933,11895,38,1400,903,497,0.972344560937367,0.929133858267717,5.4353128205825,201,88,113,23,1.3,10.5,1.8,0,0,0,0,0,0,0.00488724840847386,1.97809109261914,1.03062096036618
24.3,"eps_greedy_SVM","SVM",12,14,11833,11799,34,1500,999,501,0.972807449435304,0.929133858267717,5.46267322154679,211,93,118,10,1.3,11.25,2,0,0,0,0,0,0,0.00373760653552642,1.14825869791391,0.473808573051398
24.3,"eps_greedy_SVM","SVM",12,15,11733,11699,34,1600,1099,501,0.97251277240746,0.929133858267717,5.46739463314709,211,93,118,0,1.3,12,2.2,0,0,0,0,0,0,0.00298882028797753,0.668156580874147,0.33738586486765
24.3,"eps_greedy_SVM","SVM",12,16,11633,11600,33,1700,1198,502,0.974493247598727,0.933070866141732,5.48533991541213,213,93,120,2,1.3,12.75,2.4,0,0,0,0,0,0,0.00286863753782481,0.613733367048202,0.30891730235947
24.3,"eps_greedy_SVM","SVM",12,17,11533,11500,33,1800,1298,502,0.974742495251443,0.929133858267717,5.48533991541213,213,93,120,0,1.3,13.5,2.6,0,0,0,0,0,0,1.43133771334177e-05,0.0174048369457576,0.00673996722136332
24.3,"eps_greedy_SVM","SVM",12,18,11433,11401,32,1900,1397,503,0.977560344330113,0.929133858267717,5.51869993227389,217,94,123,4,1.3,14.25,2.8,0,0,0,0,0,0,1.57254020167069e-05,0.132705662452701,0.118459961321569
24.3,"eps_greedy_SVM","SVM",12,19,11333,11304,29,2000,1494,506,0.983449587513538,0.929133858267717,5.57399450395071,228,96,132,11,1.4,15,3,0,0,0,0,0,0,0.00408723388061697,3.21907501415163,0.470044364523628
24.3,"eps_greedy_SVM","SVM",12,20,11233,11208,25,2100,1590,510,0.99126313307985,0.929133858267717,5.75837871587637,237,102,135,9,1.3,15.75,3.1,0,0,0,0,0,0,0.00749941812075784,8.16742818643069,0.908114693685179
24.3,"eps_greedy_SVM","SVM",12,21,11133,11115,18,2200,1683,517,0.996648048808329,0.929133858267717,5.8691250550203,255,111,144,18,1.3,16.5,3.3,0,0,0,0,0,0,0.0113243509528078,11.8723887496106,1.55253118728015
24.3,"eps_greedy_SVM","SVM",12,22,11033,11025,8,2300,1773,527,0.999165081754458,0.940944881889764,5.92622222222222,291,124,167,36,1.3,17.25,3.4,0,0,0,0,0,0,0.0147059980562088,13.8578832379041,2.00674551937655
24.3,"eps_greedy_SVM","SVM",12,23,10933,10930,3,2400,1868,532,0.999436430184259,0.94488188976378,6.00630630630631,311,132,179,20,1.4,18,3.5,0,0,0,0,0,0,0.0135701371892556,12.467131399545,1.82465493460902
24.3,"eps_greedy_SVM","SVM",12,24,10833,10833,0,2500,1965,535,0.999480631738435,0.94488188976378,5.93149466192171,315,133,182,4,1.4,18.75,3.7,0,0,0,0,0,0,0.0115014022246777,11.5648737669331,1.39345170281885
24.3,"eps_greedy_SVM","SVM",12,25,10733,10733,0,2600,2065,535,0.99948922648508,0.94488188976378,5.93149466192171,316,136,180,1,1.3,19.5,3.9,0,0,0,0,0,0,0.00867042731809419,8.06633799084108,0.955820483125283
24.3,"eps_greedy_SVM","SVM",12,26,10633,10633,0,2700,2165,535,0.999501504694573,0.94488188976378,5.94206773618538,317,135,182,1,1.3,20.25,4,0,0,0,0,0,0,0.00685506000005592,5.73492167904844,0.725718534666353
24.3,"eps_greedy_SVM","SVM",12,27,10533,10533,0,2800,2265,535,0.999508871620269,0.94488188976378,5.94206773618538,315,134,181,-2,1.4,21,4.2,0,0,0,0,0,0,0.00585805181432527,4.63918081893441,0.6241136153375
24.3,"eps_greedy_SVM","SVM",12,28,10433,10433,0,2900,2365,535,0.999513782904067,0.94488188976378,5.93677649154052,313,133,180,-2,1.4,21.75,4.4,0,0,0,0,0,0,0.0050858029273701,3.68683631975799,0.536291054523284
24.3,"eps_greedy_SVM","SVM",12,29,10333,10333,0,3000,2465,535,0.999517466366915,0.94488188976378,5.93677649154052,317,133,184,4,1.4,22.5,4.6,0,0,0,0,0,0,0.00441900586312023,2.80415805803376,0.464028710282394
24.3,"eps_greedy_SVM","SVM",12,30,10233,10233,0,3100,2565,535,0.999521763740237,0.94488188976378,5.93677649154052,317,133,184,0,1.4,23.25,4.8,0,0,0,0,0,0,0.00400213004710501,2.1687202530021,0.417575580933648
24.3,"eps_greedy_SVM","SVM",12,31,10133,10133,0,3200,2665,535,0.999525447203085,0.94488188976378,5.93677649154052,316,131,185,-1,1.4,24,5,0,0,0,0,0,0,0.00353273077852396,1.54974551855304,0.372432963575047
24.3,"eps_greedy_SVM","SVM",12,32,10033,10033,0,3300,2765,535,0.999527902844984,0.94488188976378,5.93677649154052,316,131,185,0,1.4,24.75,5.2,0,0,0,0,0,0,0.00331297333106646,1.30532749639601,0.345843856561947
24.3,"eps_greedy_SVM","SVM",12,33,9933,9933,0,3400,2865,535,0.999527288934509,0.94488188976378,5.9052258635961,316,131,185,0,1.4,25.5,5.4,0,0,0,0,0,0,0.00291906118095051,0.801079863615979,0.305259978311164
24.3,"eps_greedy_SVM","SVM",12,34,9833,9833,0,3500,2965,535,0.999532814128781,0.948818897637795,5.9,318,132,186,2,1.4,26.25,5.5,0,0,0,0,0,0,1.26784080181182e-05,0.0107479751354694,0.00140172520582
24.3,"eps_greedy_SVM","SVM",12,35,9733,9733,0,3600,3065,535,0.999534655860205,0.948818897637795,5.894783377542,318,131,187,0,1.4,27,5.7,0,0,0,0,0,0,1.23193550039194e-05,0.0107519193887054,0.00132455293412806
24.3,"eps_greedy_SVM","SVM",12,36,9633,9633,0,3700,3165,535,0.999539567144003,0.948818897637795,5.894783377542,318,131,187,0,1.4,27.75,5.9,0,0,0,0,0,0,9.35636470198471e-06,0.00808404215104584,0.00100096876206444
24.3,"eps_greedy_SVM","SVM",12,37,9533,9533,0,3800,3265,535,0.999543864517325,0.948818897637795,5.9,317,131,186,-1,1.4,28.5,6.1,0,0,0,0,0,0,9.22911509826119e-06,0.00832848705485616,0.00100002976554269
24.3,"eps_greedy_SVM","SVM",12,38,9433,9433,0,3900,3365,535,0.999550003622072,0.948818897637795,5.894783377542,317,131,186,0,1.4,29.25,6.3,0,0,0,0,0,0,7.04827361576927e-06,0.00638893380561794,0.000762605281551808
24.3,"eps_greedy_SVM","SVM",12,39,9333,9333,0,4000,3465,535,0.999550617532546,0.948818897637795,5.87918871252205,317,131,186,0,1.4,30,6.5,0,0,0,0,0,0,4.96185321720183e-06,0.0044941007947442,0.000537541397385429
24.3,"eps_greedy_SVM","SVM",12,40,9233,9233,0,4100,3565,535,0.99955245926397,0.948818897637795,5.894783377542,315,131,184,-2,1.4,30.75,6.7,0,0,0,0,0,0,4.36946907548494e-06,0.0040970942214357,0.000470801390558078
24.3,"eps_greedy_SVM","SVM",12,41,9133,9133,0,4200,3665,535,0.999550617532546,0.948818897637795,5.8585237258348,319,132,187,4,1.4,31.5,6.9,0,0,0,0,0,0,2.76242277185849e-06,0.00249648557543023,0.000296118324977155
24.3,"eps_greedy_SVM","SVM",12,42,9033,9033,0,4300,3765,535,0.999550003622072,0.948818897637795,5.8585237258348,318,132,186,-1,1.4,32.25,7,0,0,0,0,0,0,2.4540338527466e-06,0.00219724310554365,0.000260663422352489
24.3,"eps_greedy_SVM","SVM",12,43,8933,8933,0,4400,3865,535,0.999548775801123,0.948818897637795,5.8277972027972,318,132,186,0,1.4,33,7.2,0,0,0,0,0,0,2.0491135941941e-06,0.00180944200963012,0.000219710725551585
24.3,"eps_greedy_SVM","SVM",12,44,8833,8833,0,4500,3965,535,0.999551231443021,0.948818897637795,5.81255448997384,318,132,186,0,1.4,33.75,7.4,0,0,0,0,0,0,1.41020690827284e-06,0.00123116605707215,0.000150648885334173
24.3,"eps_greedy_SVM","SVM",12,45,8733,8733,0,4600,4065,535,0.999548775801123,0.948818897637795,5.87918871252205,321,132,189,3,1.4,34.5,7.6,0,0,0,0,0,0,1.99069456243844e-06,0.00177842123527591,0.000210412936144339
24.3,"eps_greedy_SVM","SVM",12,46,8633,8633,0,4700,4165,535,0.999545706248749,0.948818897637795,5.8277972027972,323,131,192,2,1.5,35.25,7.8,0,0,0,0,0,0,1.36437936854496e-06,0.00115815376245432,0.000146142596198369
24.3,"eps_greedy_SVM","SVM",12,47,8533,8533,0,4800,4265,535,0.999543864517325,0.948818897637795,5.84312007011393,318,130,188,-5,1.4,36,8,0,0,0,0,0,0,1.17966360204937e-06,0.000988724229584123,0.000125946094806685
24.3,"eps_greedy_SVM","SVM",12,48,8433,8433,0,4900,4365,535,0.999546320159224,0.948818897637795,5.894783377542,317,130,187,-1,1.4,36.75,8.2,0,0,0,0,0,0,0.000720453795620537,1.12032021772434,0.074585596156258
24.3,"eps_greedy_SVM","SVM",13,0,13233,12733,500,100,95,5,0.961754704949107,0.809859154929577,5.18260391318241,20,5,15,0,3,0.75,19,0,0,0,0,0,0,0.993142913907211,714.28865952488,99.7676362479341
24.3,"eps_greedy_SVM","SVM",13,1,13133,12733,400,200,95,105,0.968044795484471,0.809859154929577,5.43966308866414,45,16,29,25,1.8,1.5,0.9,0,0,0,0,0,0,0.949863580259523,518.647612944309,97.3983090766664
24.3,"eps_greedy_SVM","SVM",13,2,13033,12729,304,300,99,201,0.971725622416927,0.859154929577465,5.49555504404519,57,22,35,12,1.6,2.25,0.5,0,0,0,0,0,0,0.944744610613323,301.486763128173,97.6373647875476
24.3,"eps_greedy_SVM","SVM",13,3,12933,12726,207,400,102,298,0.966853525981201,0.869718309859155,5.53466931482131,74,29,45,17,1.6,3,0.3,0,0,0,0,0,0,0.710256150200428,175.232832409198,93.6966162769057
24.3,"eps_greedy_SVM","SVM",13,4,12833,12714,119,500,114,386,0.966569982325354,0.883802816901408,5.54337473859256,107,51,56,33,1.1,3.75,0.3,0,0,0,0,0,0,0.0372070109044464,41.8109769922953,35.8118619048084
24.3,"eps_greedy_SVM","SVM",13,5,12733,12657,76,600,171,429,0.940359846687817,0.901408450704225,5.36100815418829,133,65,68,26,1,4.5,0.4,0,0,0,0,0,0,0.0176069777618961,39.6417756951703,18.691879654217
24.3,"eps_greedy_SVM","SVM",13,6,12633,12567,66,700,261,439,0.946009205790895,0.901408450704225,5.33246685079421,142,65,77,9,1.2,5.25,0.6,0,0,0,0,0,0,0.00836862098885397,18.9263012219,8.91216303747523
24.3,"eps_greedy_SVM","SVM",13,7,12533,12471,62,800,357,443,0.954933107969445,0.901408450704225,5.25537063846494,151,64,87,9,1.4,6,0.8,0,0,0,0,0,0,0.00614224755429806,7.02357206832331,4.81198840573493
24.3,"eps_greedy_SVM","SVM",13,8,12433,12372,61,900,456,444,0.955449444276494,0.901408450704225,5.26242569250882,152,65,87,1,1.3,6.75,1,0,0,0,0,0,0,0.00376602637224339,4.13079147435745,3.41753560966993
24.3,"eps_greedy_SVM","SVM",13,9,12333,12275,58,1000,553,447,0.955598939083333,0.901408450704225,5.24405771452449,146,66,80,-6,1.2,7.5,1.2,0,0,0,0,0,0,1.05359575818392e-05,0.0799065993928541,0.0757636648731063
24.3,"eps_greedy_SVM","SVM",13,10,12233,12175,58,1100,653,447,0.956041907090336,0.901408450704225,5.23948573744121,144,66,78,-2,1.2,8.25,1.5,0,0,0,0,0,0,5.03170927961349e-06,0.00272664722629085,0.000642628733546422
24.3,"eps_greedy_SVM","SVM",13,11,12133,12075,58,1200,753,447,0.956298971961153,0.901408450704225,5.25782164553375,142,65,77,-2,1.2,9,1.7,0,0,0,0,0,0,2.66076712506655e-06,0.00140739891759049,0.000322246263370091
24.3,"eps_greedy_SVM","SVM",13,12,12033,11975,58,1300,853,447,0.956672433157601,0.901408450704225,5.25782164553375,147,66,81,5,1.2,9.75,1.9,0,0,0,0,0,0,1.05699258225938e-06,0.000549134776367573,0.000134676272860921
24.3,"eps_greedy_SVM","SVM",13,13,11933,11875,58,1400,953,447,0.957200353933073,0.901408450704225,5.25782164553375,148,67,81,1,1.2,10.5,2.1,0,0,0,0,0,0,1.12458801005087e-06,0.000592038112611112,0.000143585283792609
24.3,"eps_greedy_SVM","SVM",13,14,11833,11775,58,1500,1053,447,0.957229039283464,0.901408450704225,5.25782164553375,151,68,83,3,1.2,11.25,2.4,0,0,0,0,0,0,3.32416363335354e-07,0.000179992583657765,4.1984446080514e-05
24.3,"eps_greedy_SVM","SVM",13,15,11733,11676,57,1600,1152,448,0.959830579907447,0.901408450704225,5.32876090901236,152,69,83,1,1.2,12,2.6,0,0,0,0,0,0,8.28221250160233e-07,0.000565812903241339,0.000145118972634339
24.3,"eps_greedy_SVM","SVM",13,16,11633,11580,53,1700,1248,452,0.970694604726882,0.901408450704225,5.4574465426097,170,75,95,18,1.3,12.75,2.8,0,0,0,0,0,0,1.6010695546913e-05,0.298572269988966,0.294072198236679
24.3,"eps_greedy_SVM","SVM",13,17,11533,11493,40,1800,1335,465,0.985248006919773,0.908450704225352,5.69162622270032,202,92,110,32,1.2,13.5,2.9,0,0,0,0,0,0,0.00521763167555465,1.76072784874015,0.844279339996644
24.3,"eps_greedy_SVM","SVM",13,18,11433,11403,30,1900,1425,475,0.991623326044294,0.919014084507042,5.77983691623425,222,104,118,20,1.1,14.25,3,0,0,0,0,0,0,0.00615022091424015,3.17592502252906,0.950826622462311
24.3,"eps_greedy_SVM","SVM",13,19,11333,11314,19,2000,1514,486,0.996341514542374,0.936619718309859,5.89506161185163,257,113,144,35,1.3,15,3.1,0,0,0,0,0,0,0.0099665482431854,9.48652640417846,1.31512082810187
24.3,"eps_greedy_SVM","SVM",13,20,11233,11220,13,2100,1608,492,0.998920437870841,0.943661971830986,5.97937219730942,273,121,152,16,1.3,15.75,3.3,0,0,0,0,0,0,0.012387561247809,12.1670233937947,1.68225209683384
24.3,"eps_greedy_SVM","SVM",13,21,11133,11127,6,2200,1701,499,0.999592337039628,0.954225352112676,5.9686660698299,293,131,162,20,1.2,16.5,3.4,0,0,0,0,0,0,0.0141534523019852,12.4467602257158,1.91455118186147
24.3,"eps_greedy_SVM","SVM",13,22,11033,11032,1,2300,1796,504,0.999709285006609,0.957746478873239,5.9686660698299,311,140,171,18,1.2,17.25,3.6,0,0,0,0,0,0,0.0108729267297971,8.78970354488789,1.34638817134096
24.3,"eps_greedy_SVM","SVM",13,23,10933,10933,0,2400,1895,505,0.999740176922415,0.957746478873239,5.9686660698299,312,138,174,1,1.3,18,3.8,0,0,0,0,0,0,0.00824956840549473,6.71111412140717,0.921287653390414
24.3,"eps_greedy_SVM","SVM",13,24,10833,10833,0,2500,1995,505,0.999750658108135,0.957746478873239,5.9686660698299,312,138,174,0,1.3,18.75,4,0,0,0,0,0,0,0.00584406883748034,3.91838501849254,0.631752441911115
24.3,"eps_greedy_SVM","SVM",13,25,10733,10733,0,2600,2095,505,0.999761690935209,0.957746478873239,5.9686660698299,312,138,174,0,1.3,19.5,4.1,0,0,0,0,0,0,0.00538531078960413,3.89633982868552,0.575072901823144
24.3,"eps_greedy_SVM","SVM",13,26,10633,10633,0,2700,2195,505,0.999768862272806,0.957746478873239,5.97937219730942,312,138,174,0,1.3,20.25,4.3,0,0,0,0,0,0,0.00516889825957915,3.78636945325449,0.541861549841948
24.3,"eps_greedy_SVM","SVM",13,27,10533,10533,0,2800,2295,505,0.999775481969051,0.957746478873239,5.97401433691756,311,138,173,-1,1.3,21,4.5,0,0,0,0,0,0,0.00390692793770194,2.00755952503051,0.41461639279203
24.3,"eps_greedy_SVM","SVM",13,28,10433,10433,0,2900,2395,505,0.999784859872063,0.957746478873239,5.9686660698299,310,136,174,-1,1.3,21.75,4.7,0,0,0,0,0,0,0.00276165989289577,0.570515200948629,0.291559996124756
24.3,"eps_greedy_SVM","SVM",13,29,10333,10333,0,3000,2495,505,0.999793686133722,0.961267605633803,5.96332737030411,309,135,174,-1,1.3,22.5,4.9,0,0,0,0,0,0,0.00261995860381938,0.407977575025457,0.274833285637593
24.3,"eps_greedy_SVM","SVM",13,30,10233,10233,0,3100,2595,505,0.999798650905905,0.961267605633803,5.95267857142857,311,135,176,2,1.3,23.25,5.1,0,0,0,0,0,0,1.82253758456436e-05,0.211990356799644,0.199439755367353
24.3,"eps_greedy_SVM","SVM",13,31,10133,10133,0,3200,2695,505,0.999806373884857,0.961267605633803,5.9579982126899,314,135,179,3,1.3,24,5.3,0,0,0,0,0,0,1.77525850580715e-05,0.15655571804389,0.143911787595892
24.3,"eps_greedy_SVM","SVM",13,32,10033,10033,0,3300,2795,505,0.999815200146516,0.961267605633803,5.95267857142857,310,134,176,-4,1.3,24.75,5.5,0,0,0,0,0,0,9.84233982860829e-06,0.00761033590706831,0.00107612389994801
24.3,"eps_greedy_SVM","SVM",13,33,9933,9933,0,3400,2895,505,0.999817958353284,0.961267605633803,5.95267857142857,312,134,178,2,1.3,25.5,5.7,0,0,0,0,0,0,7.86260526839055e-06,0.00620315488618611,0.000851462787423871
24.3,"eps_greedy_SVM","SVM",13,34,9833,9833,0,3500,2995,505,0.999822371484114,0.961267605633803,5.95267857142857,311,133,178,-1,1.3,26.25,5.9,0,0,0,0,0,0,8.82453798255328e-06,0.00713764764921933,0.000962882531580799
24.3,"eps_greedy_SVM","SVM",13,35,9733,9733,0,3600,3095,505,0.999827887897651,0.964788732394366,5.95267857142857,308,132,176,-3,1.3,27,6.1,0,0,0,0,0,0,4.88931569408986e-06,0.00403654938902421,0.000541385325459131
24.3,"eps_greedy_SVM","SVM",13,36,9633,9633,0,3700,3195,505,0.999829542821712,0.964788732394366,5.95267857142857,310,132,178,2,1.3,27.75,6.3,0,0,0,0,0,0,4.42086053094252e-06,0.00363668226877672,0.000475024115971901
24.3,"eps_greedy_SVM","SVM",13,37,9533,9533,0,3800,3295,505,0.999830646104419,0.964788732394366,5.9579982126899,309,132,177,-1,1.3,28.5,6.5,0,0,0,0,0,0,5.08975889066065e-06,0.00447192458148157,0.000543943598283483
24.3,"eps_greedy_SVM","SVM",13,38,9433,9433,0,3900,3395,505,0.999834507593895,0.964788732394366,5.95267857142857,310,132,178,1,1.3,29.25,6.7,0,0,0,0,0,0,0.000969378831704214,1.54280249159834,0.100955160564009
24.3,"eps_greedy_SVM","SVM",13,39,9333,9333,0,4000,3495,505,0.999837265800663,0.964788732394366,5.94736842105263,309,132,177,-1,1.3,30,6.9,0,0,0,0,0,0,0.000899014539622677,1.42925683362529,0.0930294735897783
24.3,"eps_greedy_SVM","SVM",13,40,9233,9233,0,4100,3595,505,0.999839472366078,0.964788732394366,5.92095914742451,309,133,176,0,1.3,30.75,7.1,0,0,0,0,0,0,0.000745203453450833,1.160854306966,0.0771788224083379
24.3,"eps_greedy_SVM","SVM",13,41,9133,9133,0,4200,3695,505,0.999841127290139,0.964788732394366,5.92622222222222,310,134,176,1,1.3,31.5,7.3,0,0,0,0,0,0,0.000657018398166527,1.03486508773485,0.06795380762669
24.3,"eps_greedy_SVM","SVM",13,42,9033,9033,0,4300,3795,505,0.9998427822142,0.964788732394366,5.80243690165361,310,133,177,0,1.3,32.25,7.5,0,0,0,0,0,0,0.000468091629629771,0.697075720918777,0.04883778516171
24.3,"eps_greedy_SVM","SVM",13,43,8933,8933,0,4400,3895,505,0.999843885496908,0.964788732394366,5.84312007011393,308,133,175,-2,1.3,33,7.7,0,0,0,0,0,0,0.000484620727642198,0.739634674252545,0.0503207182565671
24.3,"eps_greedy_SVM","SVM",13,44,8833,8833,0,4500,3995,505,0.999844437138261,0.964788732394366,5.9579982126899,307,133,174,-1,1.3,33.75,7.9,0,0,0,0,0,0,0.000779982466953758,1.34364946087188,0.0805629294202534
24.3,"eps_greedy_SVM","SVM",13,45,8733,8733,0,4600,4095,505,0.999846092062322,0.964788732394366,5.92622222222222,308,133,175,1,1.3,34.5,8.1,0,0,0,0,0,0,0.000463507939041762,0.751460058556923,0.048573488082745
24.3,"eps_greedy_SVM","SVM",13,46,8633,8633,0,4700,4195,505,0.99984719534503,0.964788732394366,5.94206773618538,307,133,174,-1,1.3,35.25,8.3,0,0,0,0,0,0,0.000474811107500785,0.780760944186393,0.0487616588333686
24.3,"eps_greedy_SVM","SVM",13,47,8533,8533,0,4800,4295,505,0.99984719534503,0.964788732394366,5.94206773618538,308,133,175,1,1.3,36,8.5,0,0,0,0,0,0,0.000449290825397717,0.734245607244052,0.0466042790170636
24.3,"eps_greedy_SVM","SVM",13,48,8433,8433,0,4900,4395,505,0.999847746986383,0.964788732394366,5.88957597173145,307,133,174,-1,1.3,36.75,8.7,0,0,0,0,0,0,0.000382044852246026,0.620670587027465,0.0396254849632768
24.3,"eps_greedy_SVM","SVM",14,0,13233,12705,528,100,93,7,0.961838097073939,0.803149606299213,5.39374960769408,22,7,15,0,2.1,0.75,13.3,0,0,0,0,0,0,0.999999457535359,706.063653728975,99.9999859481965
24.3,"eps_greedy_SVM","SVM",14,1,13133,12705,428,200,93,107,0.961807401550192,0.791338582677165,5.27738199391743,36,13,23,14,1.8,1.5,0.9,0,0,0,0,0,0,0.965725860889064,473.347376837993,97.9954568158707
24.3,"eps_greedy_SVM","SVM",14,2,13033,12704,329,300,94,206,0.962558214060726,0.811023622047244,5.35626791129907,62,20,42,26,2.1,2.25,0.5,0,0,0,0,0,0,0.9716423675691,323.600072528421,98.5827001532714
24.3,"eps_greedy_SVM","SVM",14,3,12933,12703,230,400,95,305,0.962130318459901,0.81496062992126,5.39374960769408,76,26,50,14,1.9,3,0.3,0,0,0,0,0,0,0.697317120367424,170.022526691509,93.2674448902117
24.3,"eps_greedy_SVM","SVM",14,4,12833,12684,149,500,114,386,0.954859776708491,0.87007874015748,5.36678501124859,101,41,60,25,1.5,3.75,0.3,0,0,0,0,0,0,0.0602504614056049,100.117462886985,55.0001813733632
24.3,"eps_greedy_SVM","SVM",14,5,12733,12647,86,600,151,449,0.931738066501241,0.881889763779528,5.24492333195193,132,60,72,31,1.2,4.5,0.3,0,0,0,0,0,0,0.0215883675457338,48.0587253288978,31.4121745118498
24.3,"eps_greedy_SVM","SVM",14,6,12633,12557,76,700,241,459,0.937231337428546,0.881889763779528,5.07733942583602,140,67,73,8,1.1,5.25,0.5,0,0,0,0,0,0,0.00497033667675034,24.1440404096944,20.5330429488516
24.3,"eps_greedy_SVM","SVM",14,7,12533,12461,72,800,337,463,0.942881155526867,0.881889763779528,5.09052732044858,152,68,84,12,1.2,6,0.7,0,0,0,0,0,0,0.00320567875721814,16.5375441910006,16.3144139908859
24.3,"eps_greedy_SVM","SVM",14,8,12433,12364,69,900,434,466,0.944350243292742,0.881889763779528,5.11266004792879,152,68,84,0,1.2,6.75,0.9,0,0,0,0,0,0,1.57605924082025e-05,13.158828598236,13.1521818829168
24.3,"eps_greedy_SVM","SVM",14,9,12333,12277,56,1000,521,479,0.945571311226849,0.881889763779528,5.10821811912955,148,67,81,-4,1.2,7.5,1.1,0,0,0,0,0,0,2.48227705560167e-06,0.00143191784425329,0.00034935492415106
24.3,"eps_greedy_SVM","SVM",14,10,12233,12177,56,1100,621,479,0.947133099474387,0.881889763779528,5.13102266430423,148,67,81,0,1.2,8.25,1.3,0,0,0,0,0,0,1.57177405987914e-06,0.000869325555710836,0.000222892962080178
24.3,"eps_greedy_SVM","SVM",14,11,12133,12077,56,1200,721,479,0.947813926190788,0.881889763779528,5.13548442314276,149,69,80,1,1.2,9,1.5,0,0,0,0,0,0,7.69045943659945e-07,0.000444339493692976,9.66999243105375e-05
24.3,"eps_greedy_SVM","SVM",14,12,12033,11977,56,1300,821,479,0.948731108439925,0.881889763779528,5.1265686515748,149,70,79,0,1.1,9.75,1.7,0,0,0,0,0,0,5.23439274351879e-07,0.000286799071390369,6.10296373632151e-05
24.3,"eps_greedy_SVM","SVM",14,13,11933,11877,56,1400,921,479,0.948759962232232,0.881889763779528,5.1265686515748,149,70,79,0,1.1,10.5,1.9,0,0,0,0,0,0,0.000295792863954559,0.375018419808566,0.0326197710457511
24.3,"eps_greedy_SVM","SVM",14,14,11833,11777,56,1500,1021,479,0.949572779700683,0.881889763779528,5.1265686515748,150,71,79,1,1.1,11.25,2.1,0,0,0,0,0,0,0.000257884067166823,0.332403159850877,0.0285729823710974
24.3,"eps_greedy_SVM","SVM",14,15,11733,11677,56,1600,1121,479,0.950451899500394,0.881889763779528,5.13102266430423,151,71,80,1,1.1,12,2.3,0,0,0,0,0,0,0.000219207366343958,0.288334865297149,0.0240498244968702
24.3,"eps_greedy_SVM","SVM",14,16,11633,11580,53,1700,1218,482,0.962217493747305,0.885826771653543,5.30910488848005,163,73,90,12,1.2,12.75,2.5,0,0,0,0,0,0,0.000786634579006736,1.12537896701233,0.210668316402653
24.3,"eps_greedy_SVM","SVM",14,17,11533,11491,42,1800,1307,493,0.974636902649714,0.909448818897638,5.56004197621811,200,90,110,37,1.2,13.5,2.7,0,0,0,0,0,0,0.0032402469329506,4.20446422419305,0.750205084066879
24.3,"eps_greedy_SVM","SVM",14,18,11433,11403,30,1900,1395,505,0.979259034613455,0.925196850393701,5.62457817772778,225,100,125,25,1.2,14.25,2.8,0,0,0,0,0,0,0.00437774899938701,5.32592239215033,0.781541558283462
24.3,"eps_greedy_SVM","SVM",14,19,11333,11310,23,2000,1488,512,0.985959867444446,0.925196850393701,5.71116138235829,240,107,133,15,1.2,15,2.9,0,0,0,0,0,0,0.00475262494810353,5.43601134352089,0.6746282304198
24.3,"eps_greedy_SVM","SVM",14,20,11233,11212,21,2100,1586,514,0.989127031583259,0.929133858267717,5.75267416107148,245,109,136,5,1.2,15.75,3.1,0,0,0,0,0,0,0.00421777889534979,6.33917424016308,0.530803936168396
24.3,"eps_greedy_SVM","SVM",14,21,11133,11116,17,2200,1682,518,0.994487083937525,0.929133858267717,5.77363943685485,259,115,144,14,1.3,16.5,3.2,0,0,0,0,0,0,0.00961789665601339,13.7701461634467,1.20904109471669
24.3,"eps_greedy_SVM","SVM",14,22,11033,11022,11,2300,1776,524,0.997538218996599,0.933070866141732,5.85872802215046,276,123,153,17,1.2,17.25,3.4,0,0,0,0,0,0,0.0103880596975667,13.0254387215684,1.40919812086463
24.3,"eps_greedy_SVM","SVM",14,23,10933,10927,6,2400,1871,529,0.999278655192271,0.937007874015748,5.93677649154052,287,127,160,11,1.3,18,3.5,0,0,0,0,0,0,0.011362499449312,12.2218711987596,1.50761047311401
24.3,"eps_greedy_SVM","SVM",14,24,10833,10832,1,2500,1966,534,0.999523605471661,0.940944881889764,5.9686660698299,306,135,171,19,1.3,18.75,3.7,0,0,0,0,0,0,0.0101458818158701,12.0763084797895,1.37651978238684
24.3,"eps_greedy_SVM","SVM",14,25,10733,10733,0,2600,2065,535,0.999538953233528,0.940944881889764,5.97401433691756,315,135,180,9,1.3,19.5,3.9,0,0,0,0,0,0,0.00786216245155813,9.65353669272848,0.882869415061274
24.3,"eps_greedy_SVM","SVM",14,26,10633,10633,0,2700,2165,535,0.999556756637293,0.940944881889764,5.96332737030411,316,135,181,1,1.3,20.25,4,0,0,0,0,0,0,0.00665465387872958,9.03975376086336,0.705541555233154
24.3,"eps_greedy_SVM","SVM",14,27,10533,10533,0,2800,2265,535,0.999577015682957,0.940944881889764,5.96332737030411,316,135,181,0,1.3,21,4.2,0,0,0,0,0,0,0.00559076209074619,7.63951328380489,0.605388264125088
24.3,"eps_greedy_SVM","SVM",14,28,10433,10433,0,2900,2365,535,0.999591749534349,0.940944881889764,5.96332737030411,317,136,181,1,1.3,21.75,4.4,0,0,0,0,0,0,0.00456641532308187,6.48688776507059,0.483227437421004
24.3,"eps_greedy_SVM","SVM",14,29,10333,10333,0,3000,2465,535,0.999604641654317,0.940944881889764,5.95267857142857,319,136,183,2,1.3,22.5,4.6,0,0,0,0,0,0,0.00369036085549853,5.11270829066747,0.388305238148948
24.3,"eps_greedy_SVM","SVM",14,30,10233,10233,0,3100,2565,535,0.999609552938114,0.940944881889764,5.93149466192171,318,136,182,-1,1.3,23.25,4.8,0,0,0,0,0,0,0.00264338413432357,3.60469646305987,0.281364230123078
24.3,"eps_greedy_SVM","SVM",14,31,10133,10133,0,3200,2665,535,0.999613850311437,0.940944881889764,5.92622222222222,322,137,185,4,1.4,24,5,0,0,0,0,0,0,0.00240631419041179,3.39295538957252,0.256872331184117
24.3,"eps_greedy_SVM","SVM",14,32,10033,10033,0,3300,2765,535,0.999624900699981,0.940944881889764,5.93677649154052,324,137,187,2,1.4,24.75,5.2,0,0,0,0,0,0,0.00246937524900012,3.6154468613021,0.257147289575574
24.3,"eps_greedy_SVM","SVM",14,33,9933,9933,0,3400,2865,535,0.999638406730423,0.940944881889764,5.93677649154052,324,137,187,0,1.4,25.5,5.4,0,0,0,0,0,0,0.00243975556772229,3.84080534086687,0.254181045931187
24.3,"eps_greedy_SVM","SVM",14,34,9833,9833,0,3500,2965,535,0.999645159745645,0.940944881889764,5.94206773618538,323,137,186,-1,1.4,26.25,5.5,0,0,0,0,0,0,0.00226717634627563,3.511774862097,0.235459093150054
24.3,"eps_greedy_SVM","SVM",14,35,9733,9733,0,3600,3065,535,0.999654982313239,0.940944881889764,5.91570541259982,326,137,189,3,1.4,27,5.7,0,0,0,0,0,0,0.00149810422630296,2.16920362885867,0.156543926353504
24.3,"eps_greedy_SVM","SVM",14,36,9633,9633,0,3700,3165,535,0.999659279686562,0.94488188976378,5.93149466192171,324,137,187,-2,1.4,27.75,5.9,0,0,0,0,0,0,0.00139006685239514,2.06098597007071,0.144843796505843
24.3,"eps_greedy_SVM","SVM",14,37,9533,9533,0,3800,3265,535,0.999658665776087,0.94488188976378,5.93677649154052,324,137,187,0,1.4,28.5,6.1,0,0,0,0,0,0,0.00124825947951279,1.89931881124883,0.130870998348821
24.3,"eps_greedy_SVM","SVM",14,38,9433,9433,0,3900,3365,535,0.999665418791309,0.94488188976378,5.93149466192171,321,136,185,-3,1.4,29.25,6.3,0,0,0,0,0,0,0.00143084070027478,2.32147890930819,0.148212575885647
24.3,"eps_greedy_SVM","SVM",14,39,9333,9333,0,4000,3465,535,0.999669716164631,0.94488188976378,5.87400881057269,320,136,184,-1,1.4,30,6.5,0,0,0,0,0,0,0.000864770893149831,1.25163102012176,0.0892511575353743
24.3,"eps_greedy_SVM","SVM",14,40,9233,9233,0,4100,3565,535,0.999673399627479,0.94488188976378,5.86883802816901,319,136,183,-1,1.3,30.75,6.7,0,0,0,0,0,0,0.0008161287756672,1.18234422552031,0.0844840398687482
24.3,"eps_greedy_SVM","SVM",14,41,9133,9133,0,4200,3665,535,0.999673399627479,0.94488188976378,5.92095914742451,321,138,183,2,1.3,31.5,6.9,0,0,0,0,0,0,0.00085094893366437,1.28408263825983,0.0882684266456821
24.3,"eps_greedy_SVM","SVM",14,42,9033,9033,0,4300,3765,535,0.999675855269378,0.94488188976378,5.9104609929078,319,137,182,-2,1.3,32.25,7,0,0,0,0,0,0,0.000720768543869727,1.0872378180402,0.0751502689297775
24.3,"eps_greedy_SVM","SVM",14,43,8933,8933,0,4400,3865,535,0.999675855269378,0.94488188976378,5.87918871252205,321,139,182,2,1.3,33,7.2,0,0,0,0,0,0,0.000589115683254009,0.879581172425025,0.0617871046792463
24.3,"eps_greedy_SVM","SVM",14,44,8833,8833,0,4500,3965,535,0.999676469179853,0.94488188976378,5.93149466192171,321,139,182,0,1.3,33.75,7.4,0,0,0,0,0,0,0.000869278714760104,1.40633332844233,0.0893306355807914
24.3,"eps_greedy_SVM","SVM",14,45,8733,8733,0,4600,4065,535,0.999678310911276,0.94488188976378,5.92622222222222,321,139,182,0,1.3,34.5,7.6,0,0,0,0,0,0,0.000616858190448538,0.942204317803765,0.0637845752902577
24.3,"eps_greedy_SVM","SVM",14,46,8633,8633,0,4700,4165,535,0.999675241358903,0.94488188976378,5.93149466192171,321,139,182,0,1.3,35.25,7.8,0,0,0,0,0,0,0.000590823046909865,0.916993202908149,0.0615270749661886
24.3,"eps_greedy_SVM","SVM",14,47,8533,8533,0,4800,4265,535,0.99968138046365,0.94488188976378,5.84824561403509,321,139,182,0,1.3,36,8,0,0,0,0,0,0,0.000404002277248133,0.60260860831339,0.0421867123262434
24.3,"eps_greedy_SVM","SVM",14,48,8433,8433,0,4900,4365,535,0.999682608284599,0.94488188976378,5.93677649154052,322,139,183,1,1.3,36.75,8.2,0,0,0,0,0,0,0.000514373805373818,0.831843447285981,0.0533230522497896
24.3,"eps_greedy_SVM","SVM",15,0,13233,12707,526,100,95,5,0.960141443536872,0.779069767441861,5.42055314913719,25,5,20,0,4,0.75,19,0,0,0,0,0,0,0.995422038605488,673.53723576772,99.8947867982168
24.3,"eps_greedy_SVM","SVM",15,1,13133,12706,427,200,96,104,0.969999794378283,0.786821705426357,5.53737541528239,46,17,29,21,1.7,1.5,0.9,0,0,0,0,0,0,0.850230338812412,364.595823139165,91.8341498536476
24.3,"eps_greedy_SVM","SVM",15,2,13033,12701,332,300,101,199,0.975604799936116,0.868217054263566,5.62066926930289,74,27,47,28,1.7,2.25,0.5,0,0,0,0,0,0,0.957545915516655,297.444958952911,98.0043000966329
24.3,"eps_greedy_SVM","SVM",15,3,12933,12701,232,400,101,299,0.977201996707616,0.872093023255814,5.61254340734505,90,34,56,16,1.6,3,0.3,0,0,0,0,0,0,0.91262706147863,292.852578011717,96.5998347300677
24.3,"eps_greedy_SVM","SVM",15,4,12833,12696,137,500,106,394,0.977063504446855,0.883720930232558,5.60240331085481,99,43,56,9,1.3,3.75,0.3,0,0,0,0,0,0,0.195803901621285,107.610713389605,71.3729240270919
24.3,"eps_greedy_SVM","SVM",15,5,12733,12639,94,600,163,437,0.95690169226657,0.891472868217054,5.38166714349941,124,63,61,25,1,4.5,0.4,0,0,0,0,0,0,0.0335044724165538,65.545583417215,38.9789259047086
24.3,"eps_greedy_SVM","SVM",15,6,12633,12550,83,700,252,448,0.953991540481456,0.891472868217054,5.33301405510811,141,65,76,17,1.2,5.25,0.6,0,0,0,0,0,0,0.00527512742836482,35.3803335406701,25.7125510854138
24.3,"eps_greedy_SVM","SVM",15,7,12533,12458,75,800,344,456,0.959138130608483,0.891472868217054,5.30362885481196,153,68,85,12,1.2,6,0.8,0,0,0,0,0,0,0.00281517992098652,20.6804592302666,17.3104452811146
24.3,"eps_greedy_SVM","SVM",15,8,12433,12365,68,900,437,463,0.958103369655811,0.891472868217054,5.29030092168711,152,68,84,-1,1.2,6.75,0.9,0,0,0,0,0,0,0.0011545749796875,11.4487145518648,10.1194953018988
24.3,"eps_greedy_SVM","SVM",15,9,12333,12266,67,1000,536,464,0.961082465186445,0.891472868217054,5.30826489402071,149,68,81,-3,1.2,7.5,1.2,0,0,0,0,0,0,0.000963132542691093,9.93865802603594,9.1114288360174
24.3,"eps_greedy_SVM","SVM",15,10,12233,12167,66,1100,635,465,0.9617120304417,0.891472868217054,5.33551716888102,148,68,80,-1,1.2,8.25,1.4,0,0,0,0,0,0,0.000555537781764374,8.63534237882056,8.05939223703328
24.3,"eps_greedy_SVM","SVM",15,11,12133,12068,65,1200,734,466,0.962206127284681,0.891472868217054,5.33085325527186,150,69,81,2,1.2,9,1.6,0,0,0,0,0,0,0.000476355670352881,7.61409564223489,7.04917388768305
24.3,"eps_greedy_SVM","SVM",15,12,12033,11969,64,1300,833,467,0.963522710916471,0.891472868217054,5.32619748823669,151,69,82,1,1.2,9.75,1.8,0,0,0,0,0,0,0.000280235445910143,6.34952336487098,6.02935339310697
24.3,"eps_greedy_SVM","SVM",15,13,11933,11870,63,1400,932,468,0.96410510413531,0.891472868217054,5.3215498464494,148,69,79,-3,1.1,10.5,2,0,0,0,0,0,0,0.000270670404152997,5.3430339124635,5.02729778928695
24.3,"eps_greedy_SVM","SVM",15,14,11833,11772,61,1500,1030,470,0.969315195080567,0.891472868217054,5.39390338851088,154,72,82,6,1.1,11.25,2.2,0,0,0,0,0,0,0.000413583834221076,4.56147656036807,4.04561417161732
24.3,"eps_greedy_SVM","SVM",15,15,11733,11676,57,1600,1126,474,0.97850346109696,0.891472868217054,5.52605153917752,168,76,92,14,1.2,12,2.4,0,0,0,0,0,0,0.00143304333711496,5.09877107892006,3.28677217218026
24.3,"eps_greedy_SVM","SVM",15,16,11633,11587,46,1700,1215,485,0.983330128053922,0.910852713178295,5.64423704610363,179,81,98,11,1.2,12.75,2.5,0,0,0,0,0,0,0.0018807774458057,3.11133007017057,0.460683218039711
24.3,"eps_greedy_SVM","SVM",15,17,11533,11501,32,1800,1301,499,0.98235705361039,0.930232558139535,5.58909637654598,212,96,116,33,1.2,13.5,2.6,0,0,0,0,0,0,0.00355748210486164,2.89188473115676,0.762096387909525
24.3,"eps_greedy_SVM","SVM",15,18,11433,11403,30,1900,1399,501,0.981729302664225,0.930232558139535,5.56473239931605,216,99,117,4,1.2,14.25,2.8,0,0,0,0,0,0,0.00171528997947529,1.75548640360948,0.236780291210894
24.3,"eps_greedy_SVM","SVM",15,19,11333,11305,28,2000,1497,503,0.985005340116415,0.930232558139535,5.63723500683199,228,103,125,12,1.2,15,3,0,0,0,0,0,0,0.0020309192375218,3.25014331948428,0.268411148250307
24.3,"eps_greedy_SVM","SVM",15,20,11233,11208,25,2100,1594,506,0.989336095921303,0.930232558139535,5.71463647850288,238,106,132,10,1.2,15.75,3.2,0,0,0,0,0,0,0.00303068375875774,5.21272345982565,0.370246965947515
24.3,"eps_greedy_SVM","SVM",15,21,11133,11112,21,2200,1690,510,0.993696485441369,0.934108527131783,5.7907835018985,244,109,135,6,1.2,16.5,3.3,0,0,0,0,0,0,0.0066787334131602,7.60346054770791,0.8552363226155
24.3,"eps_greedy_SVM","SVM",15,22,11033,11018,15,2300,1784,516,0.997586364136674,0.930232558139535,5.91903646589009,260,116,144,16,1.2,17.25,3.5,0,0,0,0,0,0,0.00894240449562751,10.3974903703354,1.40135348957202
24.3,"eps_greedy_SVM","SVM",15,23,10933,10926,7,2400,1876,524,0.999233152023378,0.937984496124031,5.9686660698299,279,125,154,19,1.2,18,3.6,0,0,0,0,0,0,0.0112988165974271,14.219275962566,1.50038339224052
24.3,"eps_greedy_SVM","SVM",15,24,10833,10830,3,2500,1972,528,0.999471431284253,0.934108527131783,6.0117222723174,295,130,165,16,1.3,18.75,3.7,0,0,0,0,0,0,0.00756298897389355,8.47816946678138,1.01599928754505
24.3,"eps_greedy_SVM","SVM",15,25,10733,10733,0,2600,2069,531,0.999567589666179,0.937984496124031,6.00630630630631,305,133,172,10,1.3,19.5,3.9,0,0,0,0,0,0,0.00874425083123172,11.9089837502815,1.14473255417929
24.3,"eps_greedy_SVM","SVM",15,26,10633,10633,0,2700,2169,531,0.999577870751039,0.937984496124031,5.98473967684022,305,132,173,0,1.3,20.25,4.1,0,0,0,0,0,0,0.00503924081111709,6.21685000068979,0.553295492979304
24.3,"eps_greedy_SVM","SVM",15,27,10533,10533,0,2800,2269,531,0.999579080290435,0.937984496124031,5.96332737030411,303,132,171,-2,1.3,21,4.3,0,0,0,0,0,0,0.00463953682647238,6.14157271631408,0.49664332756065
24.3,"eps_greedy_SVM","SVM",15,28,10433,10433,0,2900,2369,531,0.99959057091469,0.937984496124031,5.9686660698299,302,133,169,-1,1.3,21.75,4.5,0,0,0,0,0,0,0.00400461386960611,5.5985646342359,0.426439408314025
24.3,"eps_greedy_SVM","SVM",15,29,10333,10333,0,3000,2469,531,0.999594804302574,0.937984496124031,5.9579982126899,301,132,169,-1,1.3,22.5,4.6,0,0,0,0,0,0,0.00348384713010623,4.86739499183283,0.369871751717863
24.3,"eps_greedy_SVM","SVM",15,30,10233,10233,0,3100,2569,531,0.999603271078341,0.937984496124031,5.96332737030411,303,132,171,2,1.3,23.25,4.8,0,0,0,0,0,0,0.00274196628853682,3.97471888407415,0.289714653238818
24.3,"eps_greedy_SVM","SVM",15,31,10133,10133,0,3200,2669,531,0.999609923545015,0.937984496124031,5.94206773618538,304,132,172,1,1.3,24,5,0,0,0,0,0,0,0.00211719615786486,3.10641875483247,0.225300727697584
24.3,"eps_greedy_SVM","SVM",15,32,10033,10033,0,3300,2769,531,0.999613552163201,0.937984496124031,5.94736842105263,305,133,172,1,1.3,24.75,5.2,0,0,0,0,0,0,0.0020556384468013,3.12694664908125,0.215791584244649
24.3,"eps_greedy_SVM","SVM",15,33,9933,9933,0,3400,2869,531,0.999622623708666,0.937984496124031,5.94206773618538,303,132,171,-2,1.3,25.5,5.4,0,0,0,0,0,0,0.00184848356957627,2.81778350873692,0.193672545200854
24.3,"eps_greedy_SVM","SVM",15,34,9833,9833,0,3500,2969,531,0.999628066635944,0.941860465116279,5.94206773618538,307,133,174,4,1.3,26.25,5.6,0,0,0,0,0,0,0.00169599785088297,2.63928486652949,0.177592177615485
24.3,"eps_greedy_SVM","SVM",15,35,9733,9733,0,3600,3069,531,0.99963169525413,0.941860465116279,5.80243690165361,306,133,173,-1,1.3,27,5.8,0,0,0,0,0,0,0.00106503063664426,1.54489023853431,0.11121989378254
24.3,"eps_greedy_SVM","SVM",15,36,9633,9633,0,3700,3169,531,0.999633509563223,0.941860465116279,5.86883802816901,305,132,173,-1,1.3,27.75,6,0,0,0,0,0,0,0.00106409818897198,1.59855462578862,0.111383209690971
24.3,"eps_greedy_SVM","SVM",15,37,9533,9533,0,3800,3269,531,0.999631090484433,0.941860465116279,5.95267857142857,308,132,176,3,1.3,28.5,6.2,0,0,0,0,0,0,0.00136734026678287,2.23435521110253,0.142937842114992
24.3,"eps_greedy_SVM","SVM",15,38,9433,9433,0,3900,3369,531,0.999633509563223,0.941860465116279,5.94736842105263,306,132,174,-2,1.3,29.25,6.3,0,0,0,0,0,0,0.00123583786917137,1.96545644359512,0.126804012413336
24.3,"eps_greedy_SVM","SVM",15,39,9333,9333,0,4000,3469,531,0.999637138181409,0.945736434108527,5.94206773618538,304,132,172,-2,1.3,30,6.5,0,0,0,0,0,0,0.000982455761618458,1.5248356215786,0.101904923516467
24.3,"eps_greedy_SVM","SVM",15,40,9233,9233,0,4100,3569,531,0.999638952490502,0.945736434108527,5.94206773618538,304,132,172,0,1.3,30.75,6.7,0,0,0,0,0,0,0.000881211302572516,1.36551826645477,0.0911583672809705
24.3,"eps_greedy_SVM","SVM",15,41,9133,9133,0,4200,3669,531,0.999640766799595,0.945736434108527,5.94206773618538,306,133,173,2,1.3,31.5,6.9,0,0,0,0,0,0,0.000864141238642353,1.34018587707253,0.08936239379968
24.3,"eps_greedy_SVM","SVM",15,42,9033,9033,0,4300,3769,531,0.999635323872316,0.945736434108527,5.894783377542,304,132,172,-2,1.3,32.25,7.1,0,0,0,0,0,0,0.000629716018661178,0.931262379665751,0.0652977845481002
24.3,"eps_greedy_SVM","SVM",15,43,8933,8933,0,4400,3869,531,0.999638952490502,0.945736434108527,5.85338015803336,305,132,173,1,1.3,33,7.3,0,0,0,0,0,0,0.000545295978274357,0.785636444913628,0.0560873511285853
24.3,"eps_greedy_SVM","SVM",15,44,8833,8833,0,4500,3969,531,0.99964197633899,0.945736434108527,5.87918871252205,304,132,172,-1,1.3,33.75,7.5,0,0,0,0,0,0,0.000539682465860336,0.790572339252758,0.0560067650212822
24.3,"eps_greedy_SVM","SVM",15,45,8733,8733,0,4600,4069,531,0.999643185878386,0.941860465116279,5.93149466192171,305,133,172,1,1.3,34.5,7.7,0,0,0,0,0,0,0.000560029178478615,0.849802540730362,0.0584504494804497
24.3,"eps_greedy_SVM","SVM",15,46,8633,8633,0,4700,4169,531,0.999643790648083,0.941860465116279,5.88437775816417,305,132,173,0,1.3,35.25,7.9,0,0,0,0,0,0,0.000446166947279254,0.656435132113664,0.0461931829400345
24.3,"eps_greedy_SVM","SVM",15,47,8533,8533,0,4800,4269,531,0.999646814496572,0.941860465116279,5.92622222222222,306,133,173,1,1.3,36,8,0,0,0,0,0,0,0.000446219008457297,0.676556455251089,0.0463515099756167
24.3,"eps_greedy_SVM","SVM",15,48,8433,8433,0,4900,4369,531,0.999648628805665,0.941860465116279,5.92095914742451,304,132,172,-2,1.3,36.75,8.2,0,0,0,0,0,0,0.000440736911551775,0.664746389954575,0.0457731825440982
24.3,"eps_greedy_SVM","SVM",16,0,13233,12719,514,100,94,6,0.956111982020414,0.828996282527881,5.16789990278374,29,6,23,0,3.8,0.75,15.7,0,0,0,0,0,0,0.927323304247768,791.535966640891,95.53578732042
24.3,"eps_greedy_SVM","SVM",16,1,13133,12713,420,200,100,100,0.969469432245915,0.836431226765799,5.26562480175597,39,13,26,10,2,1.5,1,0,0,0,0,0,0,0.953794749900941,564.99441377408,97.168621134091
24.3,"eps_greedy_SVM","SVM",16,2,13033,12710,323,300,103,197,0.952784385455027,0.862453531598513,5.07859573356333,63,23,40,24,1.7,2.25,0.5,0,0,0,0,0,0,0.946892074362122,377.551152799524,97.0938795567473
24.3,"eps_greedy_SVM","SVM",16,3,12933,12708,225,400,105,295,0.962029258678654,0.862453531598513,5.22113045674083,78,30,48,15,1.6,3,0.4,0,0,0,0,0,0,0.805566481321719,196.218925648662,95.4973843491768
24.3,"eps_greedy_SVM","SVM",16,4,12833,12706,127,500,107,393,0.961558038002124,0.877323420074349,5.27098500103263,99,42,57,21,1.4,3.75,0.3,0,0,0,0,0,0,0.0703385017648864,64.497165948036,54.6169893735134
24.3,"eps_greedy_SVM","SVM",16,5,12733,12656,77,600,157,443,0.934230143946031,0.884758364312268,5.17053582873991,131,61,70,32,1.1,4.5,0.4,0,0,0,0,0,0,0.0317303486368625,38.5937028845955,25.8112116286257
24.3,"eps_greedy_SVM","SVM",16,6,12633,12565,68,700,248,452,0.936723953001126,0.884758364312268,5.16882059466578,147,65,82,16,1.3,5.25,0.5,0,0,0,0,0,0,0.00823164403439514,19.7851738999838,14.0433879334396
24.3,"eps_greedy_SVM","SVM",16,7,12533,12467,66,800,346,454,0.941299616167262,0.884758364312268,5.06324808143338,148,65,83,1,1.3,6,0.8,0,0,0,0,0,0,0.00192635967824348,13.4555884515364,11.1995342199233
24.3,"eps_greedy_SVM","SVM",16,8,12433,12375,58,900,438,462,0.9432141317396,0.884758364312268,5.07632015049044,151,67,84,3,1.3,6.75,0.9,0,0,0,0,0,0,0.00153998714172181,4.96167416997021,3.17538354301419
24.3,"eps_greedy_SVM","SVM",16,9,12333,12276,57,1000,537,463,0.946190201166485,0.884758364312268,5.14110007614874,149,69,80,-2,1.2,7.5,1.2,0,0,0,0,0,0,0.0012729245045068,3.49129551717504,2.15114444538237
24.3,"eps_greedy_SVM","SVM",16,10,12233,12177,56,1100,636,464,0.947173315081039,0.884758364312268,5.14554739455371,149,69,80,0,1.2,8.25,1.4,0,0,0,0,0,0,0.000865789478571403,2.05160391381684,1.09689416679145
24.3,"eps_greedy_SVM","SVM",16,11,12133,12079,54,1200,734,466,0.95200637745766,0.884758364312268,5.18394257678331,154,71,83,5,1.2,9,1.6,0,0,0,0,0,0,0.00116591232877693,1.5410826725255,0.164924929096097
24.3,"eps_greedy_SVM","SVM",16,12,12033,11981,52,1300,832,468,0.95354321924488,0.888475836431227,5.20877720462747,160,73,87,6,1.2,9.75,1.8,0,0,0,0,0,0,0.00097544998053802,1.28239061859667,0.127878827866904
24.3,"eps_greedy_SVM","SVM",16,13,11933,11889,44,1400,924,476,0.959914285481872,0.903345724907063,5.2987309319318,182,83,99,22,1.2,10.5,1.9,0,0,0,0,0,0,0.00173080183071769,2.35223016553749,0.43468304350309
24.3,"eps_greedy_SVM","SVM",16,14,11833,11802,31,1500,1011,489,0.957733655150131,0.925650557620818,5.34607131516402,213,96,117,31,1.2,11.25,2.1,0,0,0,0,0,0,0.00494427891392281,4.13495384042981,0.947950537120088
24.3,"eps_greedy_SVM","SVM",16,15,11733,11704,29,1600,1109,491,0.958635423941719,0.925650557620818,5.35820933754711,222,98,124,9,1.3,12,2.3,0,0,0,0,0,0,0.00209714358743767,2.03053628246119,0.270458768347518
24.3,"eps_greedy_SVM","SVM",16,16,11633,11605,28,1700,1208,492,0.960241409083465,0.925650557620818,5.37673382963889,221,99,122,-1,1.2,12.75,2.5,0,0,0,0,0,0,0.00177763582641718,1.97328879469287,0.204134914118793
24.3,"eps_greedy_SVM","SVM",16,17,11533,11505,28,1800,1308,492,0.959909056152544,0.925650557620818,5.4000703479967,219,99,120,-2,1.2,13.5,2.7,0,0,0,0,0,0,0.00141997976929266,1.7055078207927,0.159055725023663
24.3,"eps_greedy_SVM","SVM",16,18,11433,11405,28,1900,1408,492,0.959526153038073,0.925650557620818,5.4000703479967,217,97,120,-2,1.2,14.25,2.9,0,0,0,0,0,0,0.00101092040692792,1.38545476576644,0.113175936703822
24.3,"eps_greedy_SVM","SVM",16,19,11333,11305,28,2000,1508,492,0.959828292066182,0.925650557620818,5.40476198166133,218,97,121,1,1.2,15,3.1,0,0,0,0,0,0,0.000876011522820673,1.2643724646938,0.0953068009066901
24.3,"eps_greedy_SVM","SVM",16,20,11233,11206,27,2100,1607,493,0.962368003012099,0.925650557620818,5.40476198166133,222,100,122,4,1.2,15.75,3.3,0,0,0,0,0,0,0.00126888027793853,2.18943434649392,0.141591276930536
24.3,"eps_greedy_SVM","SVM",16,21,11133,11109,24,2200,1704,496,0.973099748876026,0.925650557620818,5.46427421479378,229,101,128,7,1.3,16.5,3.4,0,0,0,0,0,0,0.00173633216607317,3.12485706233925,0.225812022762845
24.3,"eps_greedy_SVM","SVM",16,22,11033,11013,20,2300,1800,500,0.982678137103736,0.925650557620818,5.65373275615552,243,106,137,14,1.3,17.25,3.6,0,0,0,0,0,0,0.00361475002825437,6.21145501978091,0.464271199023897
24.3,"eps_greedy_SVM","SVM",16,23,10933,10918,15,2400,1895,505,0.990145619390815,0.929368029739777,5.75155827606758,260,113,147,17,1.3,18,3.8,0,0,0,0,0,0,0.00864897208478001,12.3276311057349,1.02608728114692
24.3,"eps_greedy_SVM","SVM",16,24,10833,10820,13,2500,1993,507,0.992171693988933,0.929368029739777,5.81090414468428,262,117,145,2,1.2,18.75,3.9,0,0,0,0,0,0,0.00793431065825111,11.8187281456539,0.941426927593156
24.3,"eps_greedy_SVM","SVM",16,25,10733,10722,11,2600,2091,509,0.994827612253367,0.929368029739777,5.86416290493893,270,119,151,8,1.3,19.5,4.1,0,0,0,0,0,0,0.00846629278398045,12.609025479675,1.02776350381602
24.3,"eps_greedy_SVM","SVM",16,26,10633,10628,5,2700,2185,515,0.998593891446096,0.936802973977695,5.97859191123573,293,125,168,23,1.3,20.25,4.2,0,0,0,0,0,0,0.0125647328080375,15.5444145558945,1.77975040671884
24.3,"eps_greedy_SVM","SVM",16,27,10533,10530,3,2800,2283,517,0.99894948584072,0.944237918215613,6.00630630630631,303,128,175,10,1.4,21,4.4,0,0,0,0,0,0,0.0095099362643268,11.9853292274831,1.12211906854269
24.3,"eps_greedy_SVM","SVM",16,28,10433,10433,0,2900,2380,520,0.999440461761401,0.944237918215613,6.00630630630631,316,132,184,13,1.4,21.75,4.6,0,0,0,0,0,0,0.00849980841641572,11.5379937454986,1.27639010677939
24.3,"eps_greedy_SVM","SVM",16,29,10333,10333,0,3000,2480,520,0.999448596273696,0.947955390334573,6.00630630630631,315,132,183,-1,1.4,22.5,4.8,0,0,0,0,0,0,0.0078885305452947,11.3100999853965,0.854688229499084
24.3,"eps_greedy_SVM","SVM",16,30,10233,10233,0,3100,2580,520,0.99945760234088,0.947955390334573,6.000900090009,316,132,184,1,1.4,23.25,5,0,0,0,0,0,0,0.00597879596194475,8.47614426418597,0.634668765429149
24.3,"eps_greedy_SVM","SVM",16,31,10133,10133,0,3200,2680,520,0.999466608408064,0.947955390334573,6.00630630630631,318,133,185,2,1.4,24,5.2,0,0,0,0,0,0,0.00471362603614868,6.5419048087172,0.498727335831973
24.3,"eps_greedy_SVM","SVM",16,32,10033,10033,0,3300,2780,520,0.999479972249692,0.947955390334573,6.00630630630631,319,132,187,1,1.4,24.75,5.3,0,0,0,0,0,0,0.00446938929969219,6.67491942217292,0.471856490676568
24.3,"eps_greedy_SVM","SVM",16,33,9933,9933,0,3400,2880,520,0.999486944688803,0.947955390334573,6.00630630630631,320,132,188,1,1.4,25.5,5.5,0,0,0,0,0,0,0.00351240485504211,4.92261112227206,0.368200272112137
24.3,"eps_greedy_SVM","SVM",16,34,9833,9833,0,3500,2980,520,0.999498565420653,0.947955390334573,6.00630630630631,320,132,188,0,1.4,26.25,5.7,0,0,0,0,0,0,0.00324340203909265,4.7810028215366,0.342179144300692
24.3,"eps_greedy_SVM","SVM",16,35,9733,9733,0,3600,3080,520,0.999504956823171,0.947955390334573,6.00630630630631,320,132,188,0,1.4,27,5.9,0,0,0,0,0,0,0.00308032619775008,4.66784477550866,0.321019249190305
24.3,"eps_greedy_SVM","SVM",16,36,9633,9633,0,3700,3180,520,0.999509314597615,0.947955390334573,6.000900090009,320,132,188,0,1.4,27.75,6.1,0,0,0,0,0,0,0.00290272310018131,4.58191855476023,0.306425921835493
24.3,"eps_greedy_SVM","SVM",16,37,9533,9533,0,3800,3280,520,0.999522387920946,0.947955390334573,6.00630630630631,317,132,185,-3,1.4,28.5,6.3,0,0,0,0,0,0,0.00180371802651687,2.67534595194067,0.190200242878821
24.3,"eps_greedy_SVM","SVM",16,38,9433,9433,0,3900,3380,520,0.999527036213687,0.947955390334573,6.00630630630631,320,132,188,3,1.4,29.25,6.5,0,0,0,0,0,0,0.00191548261497254,3.02305146649317,0.200764376868466
24.3,"eps_greedy_SVM","SVM",16,39,9333,9333,0,4000,3480,520,0.999532846579612,0.947955390334573,5.9955035971223,317,132,185,-3,1.4,30,6.7,0,0,0,0,0,0,0.00181713070615333,2.96490633915556,0.18996157202249
24.3,"eps_greedy_SVM","SVM",16,40,9233,9233,0,4100,3580,520,0.99953923798213,0.947955390334573,6.00630630630631,317,132,185,0,1.4,30.75,6.9,0,0,0,0,0,0,0.00151524501081005,2.44022237341483,0.158006070373208
24.3,"eps_greedy_SVM","SVM",16,41,9133,9133,0,4200,3680,520,0.999540109537018,0.947955390334573,6.000900090009,318,132,186,1,1.4,31.5,7.1,0,0,0,0,0,0,0.00166845205378314,2.84788270100422,0.173416074479558
24.3,"eps_greedy_SVM","SVM",16,42,9033,9033,0,4300,3780,520,0.99954853456761,0.947955390334573,6.00630630630631,317,132,185,-1,1.4,32.25,7.3,0,0,0,0,0,0,0.00106854470454929,1.69029062052323,0.11069577027973
24.3,"eps_greedy_SVM","SVM",16,43,8933,8933,0,4400,3880,520,0.999549696640795,0.947955390334573,6.00630630630631,318,132,186,1,1.4,33,7.5,0,0,0,0,0,0,0.00125051853732571,2.1129431809197,0.129222543247175
24.3,"eps_greedy_SVM","SVM",16,44,8833,8833,0,4500,3980,520,0.999553763896943,0.947955390334573,6.00630630630631,318,131,187,0,1.4,33.75,7.7,0,0,0,0,0,0,0.000973959074360204,1.54374453644149,0.099992297092431
24.3,"eps_greedy_SVM","SVM",16,45,8733,8733,0,4600,4080,520,0.99955318286035,0.947955390334573,6.00630630630631,317,132,185,-1,1.4,34.5,7.8,0,0,0,0,0,0,0.00103077324084053,1.66581412483,0.106170666235635
24.3,"eps_greedy_SVM","SVM",16,46,8633,8633,0,4700,4180,520,0.999552601823758,0.947955390334573,6.00630630630631,315,132,183,-2,1.4,35.25,8,0,0,0,0,0,0,0.000861986760319934,1.34379334049593,0.0890466406047646
24.3,"eps_greedy_SVM","SVM",16,47,8533,8533,0,4800,4280,520,0.999552020787165,0.947955390334573,6.00630630630631,316,132,184,1,1.4,36,8.2,0,0,0,0,0,0,0.000766135486210649,1.17291398308728,0.0788504435084391
24.3,"eps_greedy_SVM","SVM",16,48,8433,8433,0,4900,4380,520,0.999551439750573,0.947955390334573,6.00630630630631,317,132,185,1,1.4,36.75,8.4,0,0,0,0,0,0,0.000860444775107927,1.36151256871445,0.0893736241265466
24.3,"eps_greedy_SVM","SVM",17,0,13233,12724,509,100,95,5,0.970946637842786,0.807272727272727,5.47299021965689,31,5,26,0,5.2,0.75,19,0,0,0,0,0,0,0.987204928580586,705.8985382956,99.3321637906916
24.3,"eps_greedy_SVM","SVM",17,1,13133,12724,409,200,95,105,0.966768688132912,0.818181818181818,5.32278808669889,52,15,37,21,2.5,1.5,0.9,0,0,0,0,0,0,0.943373978421512,653.45593705108,96.6899691430125
24.3,"eps_greedy_SVM","SVM",17,2,13033,12722,311,300,97,203,0.970463363295003,0.861818181818182,5.30199594573523,72,22,50,20,2.3,2.25,0.5,0,0,0,0,0,0,0.967289962569377,536.055299446185,98.1201013080452
24.3,"eps_greedy_SVM","SVM",17,3,12933,12720,213,400,99,301,0.974333826373847,0.865454545454545,5.34358022766256,79,26,53,7,2,3,0.3,0,0,0,0,0,0,0.912588672156976,368.046067415021,96.0083712470426
24.3,"eps_greedy_SVM","SVM",17,4,12833,12714,119,500,105,395,0.980785072249387,0.887272727272727,5.42236771863715,93,35,58,14,1.7,3.75,0.3,0,0,0,0,0,0,0.174556015417041,176.887904889863,68.0230426593521
24.3,"eps_greedy_SVM","SVM",17,5,12733,12650,83,600,169,431,0.954671179883963,0.887272727272727,5.25841938549256,134,55,79,41,1.4,4.5,0.4,0,0,0,0,0,0,0.061953015306527,144.70474144521,35.4776128860768
24.3,"eps_greedy_SVM","SVM",17,6,12633,12565,68,700,254,446,0.965164978950962,0.894545454545455,5.48419781295903,151,64,87,17,1.4,5.25,0.6,0,0,0,0,0,0,0.02586586003008,77.0617446376603,18.6397833806412
24.3,"eps_greedy_SVM","SVM",17,7,12533,12472,61,800,347,453,0.971086016611699,0.905454545454545,5.49034393670273,166,69,97,15,1.4,6,0.8,0,0,0,0,0,0,0.0190240420235555,44.803758493591,14.1694159358401
24.3,"eps_greedy_SVM","SVM",17,8,12433,12381,52,900,438,462,0.977838206849484,0.912727272727273,5.56341169862794,180,73,107,14,1.5,6.75,0.9,0,0,0,0,0,0,0.0156039433828969,34.6695201979992,9.64072566411331
24.3,"eps_greedy_SVM","SVM",17,9,12333,12288,45,1000,531,469,0.979501649789521,0.923636363636364,5.67907719609583,191,81,110,11,1.4,7.5,1.1,0,0,0,0,0,0,0.0145683133098254,29.1039291043241,7.88955277602183
24.3,"eps_greedy_SVM","SVM",17,10,12233,12202,31,1100,617,483,0.975864717260229,0.945454545454545,5.74019730941704,225,94,131,34,1.4,8.25,1.3,0,0,0,0,0,0,0.0152741124775883,16.3043966084602,5.41676271622111
24.3,"eps_greedy_SVM","SVM",17,11,12133,12105,28,1200,714,486,0.978071452952586,0.945454545454545,5.72991942703671,231,96,135,6,1.4,9,1.5,0,0,0,0,0,0,0.0108858385787514,12.6738787768868,2.27281915446928
24.3,"eps_greedy_SVM","SVM",17,12,12033,12006,27,1300,813,487,0.977944020935295,0.945454545454545,5.72479427549195,228,95,133,-3,1.4,9.75,1.7,0,0,0,0,0,0,0.00886749738070114,10.9792600601642,1.00528210700844
24.3,"eps_greedy_SVM","SVM",17,13,11933,11906,27,1400,913,487,0.977949140971703,0.945454545454545,5.71967828418231,229,95,134,1,1.4,10.5,1.9,0,0,0,0,0,0,0.00461568807203883,2.95048193230769,0.508463099987816
24.3,"eps_greedy_SVM","SVM",17,14,11833,11806,27,1500,1013,487,0.978091933098226,0.941818181818182,5.72991942703671,228,94,134,-1,1.4,11.25,2.1,0,0,0,0,0,0,0.00512795713606256,5.25446356830126,0.542612864672964
24.3,"eps_greedy_SVM","SVM",17,15,11733,11706,27,1600,1113,487,0.978143702355252,0.941818181818182,5.76605405405405,230,96,134,2,1.4,12,2.3,0,0,0,0,0,0,0.00407932071336735,3.06121882785762,0.430335192295082
24.3,"eps_greedy_SVM","SVM",17,16,11633,11606,27,1700,1213,487,0.978343383775213,0.941818181818182,5.76086408640864,229,96,133,-1,1.4,12.75,2.5,0,0,0,0,0,0,0.0031587997877511,1.18608806192191,0.336773778841778
24.3,"eps_greedy_SVM","SVM",17,17,11533,11506,27,1800,1313,487,0.978340539310539,0.941818181818182,5.76605405405405,228,96,132,-1,1.4,13.5,2.7,0,0,0,0,0,0,0.00301774904178569,1.05603680188914,0.315770466526125
24.3,"eps_greedy_SVM","SVM",17,18,11433,11406,27,1900,1413,487,0.978515189441386,0.941818181818182,5.74535008976661,229,97,132,1,1.4,14.25,2.9,0,0,0,0,0,0,1.69704984277682e-05,0.116562092418384,0.0995253210664734
24.3,"eps_greedy_SVM","SVM",17,19,11333,11306,27,2000,1513,487,0.978465695756089,0.941818181818182,5.75568345323741,228,97,131,-1,1.4,15,3.1,0,0,0,0,0,0,1.83915200397278e-05,0.215651823425861,0.196767990248007
24.3,"eps_greedy_SVM","SVM",17,20,11233,11207,26,2100,1612,488,0.985848788258077,0.941818181818182,5.78789516789517,233,97,136,5,1.4,15.75,3.3,0,0,0,0,0,0,0.00305020046625762,1.49135994718522,0.404482734796168
24.3,"eps_greedy_SVM","SVM",17,21,11133,11112,21,2200,1707,493,0.9973586301058,0.941818181818182,6.0006832553174,255,102,153,22,1.5,16.5,3.5,0,0,0,0,0,0,0.00414533867851162,5.67225533752614,3.92799836406427
24.3,"eps_greedy_SVM","SVM",17,22,11033,11026,7,2300,1793,507,0.999652406417112,0.945454545454545,6.01714801444043,278,119,159,23,1.3,17.25,3.5,0,0,0,0,0,0,0.00550786763578277,4.9759594611292,1.87958905042203
24.3,"eps_greedy_SVM","SVM",17,23,10933,10933,0,2400,1886,514,0.999658095346456,0.949090909090909,6.0117222723174,301,128,173,23,1.4,18,3.7,0,0,0,0,0,0,0.00472398370046689,3.01915136863978,0.627172804331768
24.3,"eps_greedy_SVM","SVM",17,24,10833,10833,0,2500,1986,514,0.999666628740471,0.949090909090909,6.03348416289593,306,129,177,5,1.4,18.75,3.9,0,0,0,0,0,0,0.00457725784537695,3.78161920836362,0.505797267282115
24.3,"eps_greedy_SVM","SVM",17,25,10733,10733,0,2600,2086,514,0.999666059847537,0.945454545454545,6.03894927536232,309,130,179,3,1.4,19.5,4.1,0,0,0,0,0,0,0.00399422585442572,2.82749414926875,0.423306041353835
24.3,"eps_greedy_SVM","SVM",17,26,10633,10633,0,2700,2186,514,0.99967174877688,0.945454545454545,6.03894927536232,309,130,179,0,1.4,20.25,4.3,0,0,0,0,0,0,0.00352852195767707,1.99897420692705,0.373679391198278
24.3,"eps_greedy_SVM","SVM",17,27,10533,10533,0,2800,2286,514,0.999670042098077,0.945454545454545,6.03894927536232,309,130,179,0,1.4,21,4.4,0,0,0,0,0,0,0.00298747209346078,1.07407675070588,0.311698704902323
24.3,"eps_greedy_SVM","SVM",17,28,10433,10433,0,2900,2386,514,0.999667197633405,0.945454545454545,6.03894927536232,308,131,177,-1,1.4,21.75,4.6,0,0,0,0,0,0,0.00277741172136479,0.693139137465729,0.285425947035198
24.3,"eps_greedy_SVM","SVM",17,29,10333,10333,0,3000,2486,514,0.999668335419274,0.945454545454545,6.03894927536232,306,130,176,-2,1.4,22.5,4.8,0,0,0,0,0,0,0.00257944084891501,0.367894977613279,0.2674467559478
24.3,"eps_greedy_SVM","SVM",17,30,10233,10233,0,3100,2586,514,0.999670042098077,0.945454545454545,6.03894927536232,304,130,174,-2,1.3,23.25,5,0,0,0,0,0,0,0.00280180298125306,0.830897475566603,0.289652898295327
24.3,"eps_greedy_SVM","SVM",17,31,10133,10133,0,3200,2686,514,0.999671179883946,0.945454545454545,6.03894927536232,304,130,174,0,1.3,24,5.2,0,0,0,0,0,0,1.61292634509885e-05,0.0177450305667903,0.00169907588845728
24.3,"eps_greedy_SVM","SVM",17,32,10033,10033,0,3300,2786,514,0.99966776652634,0.945454545454545,6.03894927536232,304,130,174,0,1.3,24.75,5.4,0,0,0,0,0,0,1.40050855606628e-05,0.0154558288179659,0.00149850457440102
24.3,"eps_greedy_SVM","SVM",17,33,9933,9933,0,3400,2886,514,0.999669473205143,0.945454545454545,6.03894927536232,304,130,174,0,1.3,25.5,5.6,0,0,0,0,0,0,9.34871655251292e-06,0.0096910800071104,0.000988552199771509
24.3,"eps_greedy_SVM","SVM",17,34,9833,9833,0,3500,2986,514,0.99967174877688,0.945454545454545,6.03894927536232,306,130,176,2,1.4,26.25,5.8,0,0,0,0,0,0,9.21927303502743e-06,0.00974929831537382,0.000983441920418381
24.3,"eps_greedy_SVM","SVM",17,35,9733,9733,0,3600,3086,514,0.99967174877688,0.945454545454545,6.03894927536232,306,130,176,0,1.4,27,6,0,0,0,0,0,0,7.34658984803833e-06,0.0079702159588761,0.000784561922916076
24.3,"eps_greedy_SVM","SVM",17,36,9633,9633,0,3700,3186,514,0.999669473205143,0.945454545454545,6.03894927536232,305,130,175,-1,1.3,27.75,6.2,0,0,0,0,0,0,5.60847327216614e-06,0.0060389784494049,0.000600170026134151
24.3,"eps_greedy_SVM","SVM",17,37,9533,9533,0,3800,3286,514,0.999670042098077,0.945454545454545,6.03894927536232,305,131,174,0,1.3,28.5,6.4,0,0,0,0,0,0,7.10462577340719e-06,0.00805885650050191,0.000749410560159578
24.3,"eps_greedy_SVM","SVM",17,38,9433,9433,0,3900,3386,514,0.999666628740471,0.945454545454545,6.03894927536232,305,130,175,0,1.3,29.25,6.6,0,0,0,0,0,0,6.55481966451328e-06,0.00746948152184969,0.000694835943662462
24.3,"eps_greedy_SVM","SVM",17,39,9333,9333,0,4000,3486,514,0.999665490954602,0.945454545454545,6.03894927536232,305,129,176,0,1.4,30,6.8,0,0,0,0,0,0,6.45971154944557e-06,0.00751979689953455,0.000680266384659265
24.3,"eps_greedy_SVM","SVM",17,40,9233,9233,0,4100,3586,514,0.999659802025259,0.945454545454545,6.03894927536232,305,130,175,0,1.3,30.75,7,0,0,0,0,0,0,5.9522521660593e-06,0.00698957281337134,0.000628090785212447
24.3,"eps_greedy_SVM","SVM",17,41,9133,9133,0,4200,3686,514,0.999663215382865,0.945454545454545,6.03894927536232,305,130,175,0,1.3,31.5,7.2,0,0,0,0,0,0,4.72919837096904e-06,0.00553292213746836,0.000497882356215148
24.3,"eps_greedy_SVM","SVM",17,42,9033,9033,0,4300,3786,514,0.99965866423939,0.941818181818182,6.03894927536232,305,130,175,0,1.3,32.25,7.4,0,0,0,0,0,0,3.61442140704331e-06,0.00406205431534127,0.000378740080069071
24.3,"eps_greedy_SVM","SVM",17,43,8933,8933,0,4400,3886,514,0.999659802025259,0.941818181818182,6.03894927536232,305,130,175,0,1.3,33,7.6,0,0,0,0,0,0,2.33563382329889e-06,0.00246982263088382,0.000245684195523907
24.3,"eps_greedy_SVM","SVM",17,44,8833,8833,0,4500,3986,514,0.999662077596996,0.945454545454545,6.03894927536232,306,130,176,1,1.4,33.75,7.8,0,0,0,0,0,0,2.29671726027135e-06,0.00242310859499596,0.000243326330694145
24.3,"eps_greedy_SVM","SVM",17,45,8733,8733,0,4600,4086,514,0.999662077596996,0.945454545454545,6.03894927536232,308,131,177,2,1.4,34.5,7.9,0,0,0,0,0,0,2.23177986697969e-06,0.00241389225999369,0.000236650674745005
24.3,"eps_greedy_SVM","SVM",17,46,8633,8633,0,4700,4186,514,0.999661508704062,0.945454545454545,6.03894927536232,307,131,176,-1,1.3,35.25,8.1,0,0,0,0,0,0,1.59372231782513e-06,0.00166870824467414,0.000166235834622692
24.3,"eps_greedy_SVM","SVM",17,47,8533,8533,0,4800,4286,514,0.999661508704062,0.945454545454545,6.03894927536232,307,131,176,0,1.3,36,8.3,0,0,0,0,0,0,0.000781186713798556,1.46802926996796,0.0799852925301592
24.3,"eps_greedy_SVM","SVM",17,48,8433,8433,0,4900,4386,514,0.999660939811128,0.945454545454545,6.03894927536232,306,131,175,-1,1.3,36.75,8.5,0,0,0,0,0,0,0.000746793387598155,1.37050384232433,0.0764699569949173
24.3,"eps_greedy_SVM","SVM",18,0,13233,12705,528,100,95,5,0.908090708352841,0.7109375,4.64176306769494,25,5,20,0,4,0.75,19,0,0,0,0,0,0,0.992733261795642,613.930522213465,99.757139091637
24.3,"eps_greedy_SVM","SVM",18,1,13133,12705,428,200,95,105,0.911146369521115,0.69140625,4.71061450258398,40,13,27,15,2.1,1.5,0.9,0,0,0,0,0,0,0.920369696286014,421.104671348558,95.9714585790519
24.3,"eps_greedy_SVM","SVM",18,2,13033,12702,331,300,98,202,0.933362214358147,0.765625,5.03618385235192,56,18,38,16,2.1,2.25,0.5,0,0,0,0,0,0,0.940522589407421,272.96008868336,97.0730212007628
24.3,"eps_greedy_SVM","SVM",18,3,12933,12701,232,400,99,301,0.940907229761359,0.7734375,5.02113793380463,70,24,46,14,1.9,3,0.3,0,0,0,0,0,0,0.825070464545384,221.898291390742,96.6154237600942
24.3,"eps_greedy_SVM","SVM",18,4,12833,12694,139,500,106,394,0.937308678443303,0.83984375,5.06016232189119,90,41,49,20,1.2,3.75,0.3,0,0,0,0,0,0,0.0799982162662688,85.2898630021119,54.10000239574
24.3,"eps_greedy_SVM","SVM",18,5,12733,12660,73,600,140,460,0.946172837700835,0.86328125,5.10514154253022,117,53,64,27,1.2,4.5,0.3,0,0,0,0,0,0,0.0408417741400808,67.176606189524,26.5625343864375
24.3,"eps_greedy_SVM","SVM",18,6,12633,12575,58,700,225,475,0.930234045975647,0.86328125,5.16707263064659,131,59,72,14,1.2,5.25,0.5,0,0,0,0,0,0,0.00701997091950718,18.9407089856051,7.83974647930445
24.3,"eps_greedy_SVM","SVM",18,7,12533,12480,53,800,320,480,0.932213066409277,0.86328125,4.98311350108225,138,62,76,7,1.2,6,0.7,0,0,0,0,0,0,0.00251030695752896,5.67497294956003,2.3664158852074
24.3,"eps_greedy_SVM","SVM",18,8,12433,12382,51,900,418,482,0.933819801902974,0.86328125,5.00133136894464,140,61,79,2,1.3,6.75,0.9,0,0,0,0,0,0,0.00172608889394677,2.34395910201519,0.203146153004296
24.3,"eps_greedy_SVM","SVM",18,9,12333,12282,51,1000,518,482,0.93724652940259,0.86328125,5.08155487804878,149,66,83,9,1.3,7.5,1.1,0,0,0,0,0,0,0.00130608189212136,1.62924042164768,0.162462317553546
24.3,"eps_greedy_SVM","SVM",18,10,12233,12182,51,1100,618,482,0.938062997192327,0.86328125,5.08155487804878,151,67,84,2,1.3,8.25,1.3,0,0,0,0,0,0,0.00111591755545103,1.40664946906604,0.125244828277595
24.3,"eps_greedy_SVM","SVM",18,11,12133,12082,51,1200,718,482,0.939211535836846,0.86328125,5.07713228894691,153,67,86,2,1.3,9,1.5,0,0,0,0,0,0,0.000910861833530002,1.20582052128854,0.101851723880421
24.3,"eps_greedy_SVM","SVM",18,12,12033,11982,51,1300,818,482,0.940007896583994,0.86328125,5.09486899563319,151,68,83,-2,1.2,9.75,1.7,0,0,0,0,0,0,0.000517367661620274,0.702267235226471,0.0578732932671387
24.3,"eps_greedy_SVM","SVM",18,13,11933,11882,51,1400,918,482,0.940831676025579,0.86328125,5.08598517872711,152,68,84,1,1.2,10.5,1.9,0,0,0,0,0,0,0.000419300375749024,0.579816979706781,0.0456395701755041
24.3,"eps_greedy_SVM","SVM",18,14,11833,11782,51,1500,1018,482,0.941567106340655,0.86328125,5.08598517872711,148,67,81,-4,1.2,11.25,2.1,0,0,0,0,0,0,0.000321713065335362,0.447250410659552,0.0347706160848516
24.3,"eps_greedy_SVM","SVM",18,15,11733,11683,50,1600,1117,483,0.943011766885051,0.86328125,5.12170763827919,150,68,82,2,1.2,12,2.3,0,0,0,0,0,0,0.000543786569883046,0.841652960446771,0.0663370678770788
24.3,"eps_greedy_SVM","SVM",18,16,11633,11586,47,1700,1214,486,0.950004143269366,0.86328125,5.2039884504863,167,75,92,17,1.2,12.75,2.5,0,0,0,0,0,0,0.00161916443703478,2.22841810615513,0.237310876971143
24.3,"eps_greedy_SVM","SVM",18,17,11533,11493,40,1800,1307,493,0.959493448759943,0.87109375,5.38578852394808,185,79,106,18,1.3,13.5,2.7,0,0,0,0,0,0,0.00353528633678525,3.75553250192588,0.527597079392768
24.3,"eps_greedy_SVM","SVM",18,18,11433,11401,32,1900,1399,501,0.97060594096085,0.88671875,5.56893671383648,206,89,117,21,1.3,14.25,2.8,0,0,0,0,0,0,0.00614030639082695,7.50804757514081,0.965287868616214
24.3,"eps_greedy_SVM","SVM",18,19,11333,11313,20,2000,1487,513,0.966612560443001,0.8984375,5.52073666703936,232,102,130,26,1.3,15,2.9,0,0,0,0,0,0,0.0111177329347969,10.149862185715,1.85922600849678
24.3,"eps_greedy_SVM","SVM",18,20,11233,11216,17,2100,1584,516,0.965800357783501,0.8984375,5.49615636130899,241,106,135,9,1.3,15.75,3.1,0,0,0,0,0,0,0.00859673660028771,9.54513804233748,1.05433868407557
24.3,"eps_greedy_SVM","SVM",18,21,11133,11116,17,2200,1684,516,0.965708962135389,0.8984375,5.49615636130899,245,106,139,4,1.3,16.5,3.3,0,0,0,0,0,0,0.0055780239193898,6.70246160859998,0.636019921208862
24.3,"eps_greedy_SVM","SVM",18,22,11033,11017,16,2300,1783,517,0.969514676922497,0.8984375,5.52426609848485,245,107,138,0,1.3,17.25,3.4,0,0,0,0,0,0,0.00461548559855833,5.74561440912818,0.515638158594441
24.3,"eps_greedy_SVM","SVM",18,23,10933,10918,15,2400,1882,518,0.973606764740294,0.8984375,5.52426609848485,248,108,140,3,1.3,18,3.6,0,0,0,0,0,0,0.00465668591354387,6.61450622161245,0.505569181567768
24.3,"eps_greedy_SVM","SVM",18,24,10833,10819,14,2500,1981,519,0.97948350491342,0.8984375,5.59389970476827,251,109,142,3,1.3,18.75,3.8,0,0,0,0,0,0,0.00429952066968691,6.06490629718374,0.485593641800116
24.3,"eps_greedy_SVM","SVM",18,25,10733,10722,11,2600,2078,522,0.991678730892208,0.8984375,5.82601172571301,254,110,144,3,1.3,19.5,4,0,0,0,0,0,0,0.00449420664613826,6.68459252351942,0.562799642044718
24.3,"eps_greedy_SVM","SVM",18,26,10633,10629,4,2700,2171,529,0.998564479020434,0.9140625,5.94736842105263,269,116,153,15,1.3,20.25,4.1,0,0,0,0,0,0,0.00534364117199991,8.06536445152296,0.630189682218782
24.3,"eps_greedy_SVM","SVM",18,27,10533,10531,2,2800,2269,531,0.999192671775074,0.92578125,5.98473967684022,277,118,159,8,1.3,21,4.3,0,0,0,0,0,0,0.00452851708839214,6.75384801002668,0.491250373097126
24.3,"eps_greedy_SVM","SVM",18,28,10433,10432,1,2900,2368,532,0.999323062899704,0.92578125,5.9686660698299,281,120,161,4,1.3,21.75,4.5,0,0,0,0,0,0,0.00385202709420002,5.64287156157628,0.414649012867393
24.3,"eps_greedy_SVM","SVM",18,29,10333,10333,0,3000,2467,533,0.999344388550928,0.92578125,5.95267857142857,284,122,162,3,1.3,22.5,4.6,0,0,0,0,0,0,0.00410488341456604,6.6856523379285,0.439723903081599
24.3,"eps_greedy_SVM","SVM",18,30,10233,10233,0,3100,2567,533,0.999352918811418,0.92578125,5.95267857142857,283,122,161,-1,1.3,23.25,4.8,0,0,0,0,0,0,0.00334439053222645,5.2447257009682,0.347788977223942
24.3,"eps_greedy_SVM","SVM",18,31,10133,10133,0,3200,2667,533,0.999355965333021,0.92578125,5.94736842105263,283,122,161,0,1.3,24,5,0,0,0,0,0,0,0.0030474918974567,4.96246515236697,0.318491942000175
24.3,"eps_greedy_SVM","SVM",18,32,10033,10033,0,3300,2767,533,0.999366323506473,0.92578125,5.94736842105263,283,121,162,0,1.3,24.75,5.2,0,0,0,0,0,0,0.00287918498209663,4.79941359767116,0.298780110591263
24.3,"eps_greedy_SVM","SVM",18,33,9933,9933,0,3400,2867,533,0.999380337505849,0.92578125,5.94736842105263,284,121,163,1,1.3,25.5,5.4,0,0,0,0,0,0,0.00207263559901486,3.22713802363272,0.216617673352318
24.3,"eps_greedy_SVM","SVM",18,34,9833,9833,0,3500,2967,533,0.999395570113867,0.92578125,5.94736842105263,284,122,162,0,1.3,26.25,5.6,0,0,0,0,0,0,0.00230151425552724,3.86449159423028,0.237639758558145
24.3,"eps_greedy_SVM","SVM",18,35,9733,9733,0,3600,3067,533,0.999401053852753,0.9296875,5.94736842105263,283,122,161,-1,1.3,27,5.8,0,0,0,0,0,0,0.00193772764519058,3.13998189061599,0.199127439515633
24.3,"eps_greedy_SVM","SVM",18,36,9633,9633,0,3700,3167,533,0.999405928287319,0.9296875,5.94736842105263,284,122,162,1,1.3,27.75,5.9,0,0,0,0,0,0,0.00164918130514152,2.66911499059115,0.1712406709576
24.3,"eps_greedy_SVM","SVM",18,37,9533,9533,0,3800,3267,533,0.999410193417564,0.9296875,5.94736842105263,284,122,162,0,1.3,28.5,6.1,0,0,0,0,0,0,0.00164745765560565,2.76776824216676,0.169686373284197
24.3,"eps_greedy_SVM","SVM",18,38,9433,9433,0,3900,3367,533,0.999419332982374,0.9296875,5.94736842105263,284,122,162,0,1.3,29.25,6.3,0,0,0,0,0,0,0.00172594951843781,2.91583357994244,0.17842289546082
24.3,"eps_greedy_SVM","SVM",18,39,9333,9333,0,4000,3467,533,0.999423598112619,0.9296875,5.94736842105263,286,123,163,2,1.3,30,6.5,0,0,0,0,0,0,0.0012329760622092,1.96012361710997,0.127133094300834
24.3,"eps_greedy_SVM","SVM",18,40,9233,9233,0,4100,3567,533,0.999426644634222,0.9296875,5.94736842105263,286,123,163,0,1.3,30.75,6.7,0,0,0,0,0,0,0.00115806916486042,1.8580303302941,0.119093872065727
24.3,"eps_greedy_SVM","SVM",18,41,9133,9133,0,4200,3667,533,0.999436393503354,0.93359375,5.94736842105263,286,123,163,0,1.3,31.5,6.9,0,0,0,0,0,0,0.00109309759216534,1.7796182097609,0.11372921611409
24.3,"eps_greedy_SVM","SVM",18,42,9033,9033,0,4300,3767,533,0.999437612111995,0.93359375,5.94736842105263,286,123,163,0,1.3,32.25,7.1,0,0,0,0,0,0,0.000931727340158778,1.4764988096878,0.0964919229704702
24.3,"eps_greedy_SVM","SVM",18,43,8933,8933,0,4400,3867,533,0.999443705155202,0.93359375,5.94736842105263,286,123,163,0,1.3,33,7.3,0,0,0,0,0,0,0.000982509025366707,1.57256294093303,0.101100353713667
24.3,"eps_greedy_SVM","SVM",18,44,8833,8833,0,4500,3967,533,0.999447970285447,0.93359375,5.94736842105263,285,123,162,-1,1.3,33.75,7.4,0,0,0,0,0,0,0.00121669578561097,2.08654527935123,0.125677832966957
24.3,"eps_greedy_SVM","SVM",18,45,8733,8733,0,4600,4067,533,0.999449188894088,0.93359375,5.94736842105263,285,123,162,0,1.3,34.5,7.6,0,0,0,0,0,0,0.000949998604423406,1.59215024335623,0.0987034482645075
24.3,"eps_greedy_SVM","SVM",18,46,8633,8633,0,4700,4167,533,0.999454063328654,0.93359375,5.94736842105263,285,123,162,0,1.3,35.25,7.8,0,0,0,0,0,0,0.000793894373082953,1.28530884723037,0.0817498596158831
24.3,"eps_greedy_SVM","SVM",18,47,8533,8533,0,4800,4267,533,0.999461374980502,0.93359375,5.94206773618538,286,123,163,1,1.3,36,8,0,0,0,0,0,0,0.000703210467728215,1.14029011215707,0.0728662181816026
24.3,"eps_greedy_SVM","SVM",18,48,8433,8433,0,4900,4367,533,0.999453454024333,0.93359375,5.94736842105263,288,123,165,2,1.3,36.75,8.2,0,0,0,0,0,0,0.000809611083836183,1.37391793291603,0.0835276121217562
24.3,"eps_greedy_SVM","SVM",19,0,13233,12713,520,100,93,7,0.959913831632005,0.83206106870229,5.18019356597601,26,7,19,0,2.7,0.75,13.3,0,0,0,0,0,0,0.999990414825594,686.110629836404,99.9995534560752
24.3,"eps_greedy_SVM","SVM",19,1,13133,12713,420,200,93,107,0.965660773131676,0.82824427480916,5.31753328997364,46,16,30,20,1.9,1.5,0.9,0,0,0,0,0,0,0.973845243008716,449.414901027646,98.3019414346355
24.3,"eps_greedy_SVM","SVM",19,2,13033,12712,321,300,94,206,0.963707981002449,0.816793893129771,5.33667832432098,58,18,40,12,2.2,2.25,0.5,0,0,0,0,0,0,0.972467244841465,381.975100241029,98.358842807613
24.3,"eps_greedy_SVM","SVM",19,3,12933,12711,222,400,95,305,0.963657328780556,0.83969465648855,5.33079336007709,70,25,45,12,1.8,3,0.3,0,0,0,0,0,0,0.844949885173904,225.553880377858,95.9216467605952
24.3,"eps_greedy_SVM","SVM",19,4,12833,12700,133,500,106,394,0.948498012645167,0.862595419847328,5.38599938383596,86,34,52,16,1.5,3.75,0.3,0,0,0,0,0,0,0.0543820425739442,49.715722305303,41.9508541472491
24.3,"eps_greedy_SVM","SVM",19,5,12733,12663,70,600,143,457,0.953508411248373,0.870229007633588,5.38117321951353,127,58,69,41,1.2,4.5,0.3,0,0,0,0,0,0,0.00977736767179171,19.3598113207453,17.5853962342358
24.3,"eps_greedy_SVM","SVM",19,6,12633,12576,57,700,230,470,0.937183498101998,0.870229007633588,5.14228067503956,154,70,84,27,1.2,5.25,0.5,0,0,0,0,0,0,0.0147160008291382,22.183770828836,7.04518471393734
24.3,"eps_greedy_SVM","SVM",19,7,12533,12478,55,800,328,472,0.939316850504446,0.870229007633588,5.14251137058808,154,67,87,0,1.3,6,0.7,0,0,0,0,0,0,1.89114364960895e-05,3.33719270086634,3.32638534088933
24.3,"eps_greedy_SVM","SVM",19,8,12433,12381,52,900,425,475,0.94536472579269,0.870229007633588,5.14674446034775,150,67,83,-4,1.2,6.75,0.9,0,0,0,0,0,0,4.27645239531186e-06,0.0162969259460129,0.0150534926157894
24.3,"eps_greedy_SVM","SVM",19,9,12333,12281,52,1000,525,475,0.946895018800885,0.870229007633588,5.15569532027879,151,69,82,1,1.2,7.5,1.1,0,0,0,0,0,0,1.98349967033627e-06,0.000976933525779949,0.000282303865328771
24.3,"eps_greedy_SVM","SVM",19,10,12233,12181,52,1100,625,475,0.948206017483926,0.870229007633588,5.1646773678751,148,68,80,-3,1.2,8.25,1.3,0,0,0,0,0,0,9.96203010918366e-07,0.000468810888926757,0.000128213268442262
24.3,"eps_greedy_SVM","SVM",19,11,12133,12082,51,1200,724,476,0.951448355590491,0.870229007633588,5.22722268189825,162,69,93,14,1.3,9,1.5,0,0,0,0,0,0,2.3260270254138e-06,0.00129576669216998,0.000321519623391465
24.3,"eps_greedy_SVM","SVM",19,12,12033,11982,51,1300,824,476,0.951742734385684,0.870229007633588,5.21409473135386,163,68,95,1,1.4,9.75,1.7,0,0,0,0,0,0,1.16401083441278e-06,0.000670488876745217,0.000147570863767446
24.3,"eps_greedy_SVM","SVM",19,13,11933,11882,51,1400,924,476,0.952446502315086,0.870229007633588,5.21409473135386,165,70,95,2,1.4,10.5,1.9,0,0,0,0,0,0,7.95639912707677e-07,0.000465083396355998,9.36633422612756e-05
24.3,"eps_greedy_SVM","SVM",19,14,11833,11782,51,1500,1024,476,0.95291905774948,0.870229007633588,5.21409473135386,166,72,94,1,1.3,11.25,2.2,0,0,0,0,0,0,4.58751068726536e-07,0.000268072071867047,5.31709708090512e-05
24.3,"eps_greedy_SVM","SVM",19,15,11733,11684,49,1600,1122,478,0.959547347909229,0.870229007633588,5.38077142953223,171,74,97,5,1.3,12,2.3,0,0,0,0,0,0,1.97402150846284e-06,0.00148583974033305,0.000345622891685671
24.3,"eps_greedy_SVM","SVM",19,16,11633,11588,45,1700,1218,482,0.96721728611352,0.870229007633588,5.48044873762697,179,78,101,8,1.3,12.75,2.5,0,0,0,0,0,0,0.00309600272499022,0.595720221832794,0.410863053877639
24.3,"eps_greedy_SVM","SVM",19,17,11533,11492,41,1800,1314,486,0.971400563729433,0.877862595419847,5.55860504213166,191,83,108,12,1.3,13.5,2.7,0,0,0,0,0,0,0.00358390353135367,0.870476593999302,0.489434676598809
24.3,"eps_greedy_SVM","SVM",19,18,11433,11394,39,1900,1412,488,0.974115522820314,0.877862595419847,5.63199061533831,196,86,110,5,1.3,14.25,2.9,0,0,0,0,0,0,0.00316328639069055,0.768484069344244,0.381760496484715
24.3,"eps_greedy_SVM","SVM",19,19,11333,11298,35,2000,1508,492,0.977434733122382,0.893129770992366,5.67251088315895,211,91,120,15,1.3,15,3.1,0,0,0,0,0,0,0.00503636378524708,2.64337083402866,0.650832693525134
24.3,"eps_greedy_SVM","SVM",19,20,11233,11207,26,2100,1599,501,0.978999588823102,0.908396946564885,5.70550782186013,235,102,133,24,1.3,15.75,3.2,0,0,0,0,0,0,0.00899349979123241,7.27216079287769,1.33868215206066
24.3,"eps_greedy_SVM","SVM",19,21,11133,11114,19,2200,1692,508,0.976313829248331,0.916030534351145,5.61454456548314,248,110,138,13,1.3,16.5,3.3,0,0,0,0,0,0,0.0101555354302908,8.91302913140131,1.31709238585304
24.3,"eps_greedy_SVM","SVM",19,22,11033,11014,19,2300,1792,508,0.976551000828257,0.916030534351145,5.61954415993148,246,109,137,-2,1.3,17.25,3.5,0,0,0,0,0,0,0.00809038124666945,7.17337005683069,0.882819182245703
24.3,"eps_greedy_SVM","SVM",19,23,10933,10914,19,2400,1892,508,0.976517034044195,0.919847328244275,5.61454456548314,249,110,139,3,1.3,18,3.7,0,0,0,0,0,0,0.00637710934170734,5.01380038478081,0.686474845344509
24.3,"eps_greedy_SVM","SVM",19,24,10833,10814,19,2500,1992,508,0.976423476410904,0.919847328244275,5.61454456548314,249,109,140,0,1.3,18.75,3.9,0,0,0,0,0,0,0.00499729044529124,3.06799421825734,0.524663181418748
24.3,"eps_greedy_SVM","SVM",19,25,10733,10714,19,2600,2092,508,0.976369844646598,0.919847328244275,5.6371838580859,249,109,140,0,1.3,19.5,4.1,0,0,0,0,0,0,0.00430021098150473,2.31014893703943,0.457199364678789
24.3,"eps_greedy_SVM","SVM",19,26,10633,10614,19,2700,2192,508,0.976295356085061,0.919847328244275,5.6371838580859,249,110,139,0,1.3,20.25,4.3,0,0,0,0,0,0,0.0043150247201242,2.47098532608438,0.453108745220056
24.3,"eps_greedy_SVM","SVM",19,27,10533,10514,19,2800,2292,508,0.976266156568939,0.919847328244275,5.6371838580859,249,110,139,0,1.3,21,4.5,0,0,0,0,0,0,0.00330668919262838,1.16030269999911,0.348762576087606
24.3,"eps_greedy_SVM","SVM",19,28,10433,10414,19,2900,2392,508,0.976217292072571,0.919847328244275,5.6371838580859,249,109,140,0,1.3,21.75,4.7,0,0,0,0,0,0,0.00278233029610412,0.582873627704824,0.295731421670859
24.3,"eps_greedy_SVM","SVM",19,29,10333,10314,19,3000,2492,508,0.976217292072573,0.919847328244275,5.6371838580859,251,110,141,2,1.3,22.5,4.9,0,0,0,0,0,0,0.00257127574718135,0.34048408684136,0.27240735941875
24.3,"eps_greedy_SVM","SVM",19,30,10233,10214,19,3100,2592,508,0.976238744778297,0.919847328244275,5.65982315068865,253,110,143,2,1.3,23.25,5.1,0,0,0,0,0,0,1.3208714850433e-05,0.0116437918907461,0.00144050448580586
24.3,"eps_greedy_SVM","SVM",19,31,10133,10114,19,3200,2692,508,0.976281650189742,0.919847328244275,5.65982315068865,252,110,142,-1,1.3,24,5.3,0,0,0,0,0,0,8.51662080291078e-06,0.00763130669426522,0.000946808205583294
24.3,"eps_greedy_SVM","SVM",19,32,10033,10015,18,3300,2791,509,0.9792540417493,0.919847328244275,5.65982315068865,250,111,139,-2,1.3,24.75,5.5,0,0,0,0,0,0,1.06227422723354e-05,0.0167423972693828,0.00737940198880299
24.3,"eps_greedy_SVM","SVM",19,33,9933,9918,15,3400,2888,512,0.989833801121507,0.923664122137405,5.75550087347821,256,114,142,6,1.2,25.5,5.6,0,0,0,0,0,0,1.59808245111329e-05,0.194591809051388,0.181047244574638
24.3,"eps_greedy_SVM","SVM",19,34,9833,9828,5,3500,2978,522,0.999541150460935,0.946564885496183,5.93149466192171,286,123,163,30,1.3,26.25,5.7,0,0,0,0,0,0,1.80336375040346e-05,0.909077178587487,0.898313654151301
24.3,"eps_greedy_SVM","SVM",19,35,9733,9733,0,3600,3073,527,0.999657948525424,0.954198473282443,5.93149466192171,298,129,169,12,1.3,27,5.8,0,0,0,0,0,0,1.65208982913692e-05,0.220820060245851,0.209266501322155
24.3,"eps_greedy_SVM","SVM",19,36,9633,9633,0,3700,3173,527,0.999663907610347,0.954198473282443,5.93149466192171,296,129,167,-2,1.3,27.75,6,0,0,0,0,0,0,1.54618327749988e-05,0.0341735683561433,0.0218951023197103
24.3,"eps_greedy_SVM","SVM",19,37,9533,9533,0,3800,3273,527,0.999661523976378,0.954198473282443,5.93149466192171,297,129,168,1,1.3,28.5,6.2,0,0,0,0,0,0,1.48553195399533e-05,0.0148655171275772,0.00160876974716925
24.3,"eps_greedy_SVM","SVM",19,38,9433,9433,0,3900,3373,527,0.999660928067886,0.954198473282443,5.93149466192171,295,129,166,-2,1.3,29.25,6.4,0,0,0,0,0,0,1.27905505519101e-05,0.0129703681587716,0.00138168728816583
24.3,"eps_greedy_SVM","SVM",19,39,9333,9333,0,4000,3473,527,0.999663311701855,0.954198473282443,5.93149466192171,293,128,165,-2,1.3,30,6.6,0,0,0,0,0,0,7.58386323209247e-06,0.00732896678891461,0.000803050602100188
24.3,"eps_greedy_SVM","SVM",19,40,9233,9233,0,4100,3573,527,0.999658544433917,0.954198473282443,5.93149466192171,292,128,164,-1,1.3,30.75,6.8,0,0,0,0,0,0,7.81483197190405e-06,0.00816911604445091,0.000829803279015307
24.3,"eps_greedy_SVM","SVM",19,41,9133,9133,0,4200,3673,527,0.999660928067886,0.954198473282443,5.93149466192171,293,128,165,1,1.3,31.5,7,0,0,0,0,0,0,6.43680667668399e-06,0.00671370024549782,0.000693711521273277
24.3,"eps_greedy_SVM","SVM",19,42,9033,9033,0,4300,3773,527,0.999663907610347,0.954198473282443,5.93149466192171,293,128,165,0,1.3,32.25,7.2,0,0,0,0,0,0,4.40088211287866e-06,0.00447544679725583,0.000466049213945504
24.3,"eps_greedy_SVM","SVM",19,43,8933,8933,0,4400,3873,527,0.999666291244316,0.954198473282443,5.93149466192171,293,128,165,0,1.3,33,7.3,0,0,0,0,0,0,4.87056868368387e-06,0.00500930041576379,0.000514463317908779
24.3,"eps_greedy_SVM","SVM",19,44,8833,8833,0,4500,3973,527,0.999665695335824,0.954198473282443,5.93149466192171,294,128,166,1,1.3,33.75,7.5,0,0,0,0,0,0,3.63936265945678e-06,0.00363625528677264,0.000388216648639893
24.3,"eps_greedy_SVM","SVM",19,45,8733,8733,0,4600,4073,527,0.999667483061301,0.954198473282443,5.93149466192171,293,128,165,-1,1.3,34.5,7.7,0,0,0,0,0,0,4.24787134273305e-06,0.00445314137722511,0.000445334647660133
24.3,"eps_greedy_SVM","SVM",19,46,8633,8633,0,4700,4173,527,0.999667483061301,0.954198473282443,5.93149466192171,295,128,167,2,1.3,35.25,7.9,0,0,0,0,0,0,3.37844368964568e-06,0.00343551036124489,0.000358010385204248
24.3,"eps_greedy_SVM","SVM",19,47,8533,8533,0,4800,4273,527,0.999663907610347,0.954198473282443,5.93677649154052,296,130,166,1,1.3,36,8.1,0,0,0,0,0,0,2.73809060786058e-06,0.00273581595183269,0.000288238595289685
24.3,"eps_greedy_SVM","SVM",19,48,8433,8433,0,4900,4373,527,0.999665099427332,0.954198473282443,5.93677649154052,298,130,168,2,1.3,36.75,8.3,0,0,0,0,0,0,2.24517835635374e-06,0.0021757763239486,0.000236178857765774
24.3,"eps_greedy_SVM","SVM",20,0,13233,12710,523,100,95,5,0.97375365288528,0.793103448275862,5.67901272885909,25,5,20,0,4,0.75,19,0,0,0,0,0,0,0.981409694616639,807.884400267877,98.984936764695
24.3,"eps_greedy_SVM","SVM",20,1,13133,12710,423,200,95,105,0.978941557424028,0.762452107279693,5.75027747710599,55,20,35,30,1.8,1.5,0.9,0,0,0,0,0,0,0.963378599725764,725.790640317897,97.9756498937579
24.3,"eps_greedy_SVM","SVM",20,2,13033,12708,325,300,97,203,0.981013967987395,0.81992337164751,5.74741379310345,76,29,47,21,1.6,2.25,0.5,0,0,0,0,0,0,0.954620039451189,501.331941794506,97.7377842456737
24.3,"eps_greedy_SVM","SVM",20,3,12933,12704,229,400,101,299,0.983194036242392,0.865900383141762,5.74968639642219,88,34,54,12,1.6,3,0.3,0,0,0,0,0,0,0.841363739219449,323.191587531306,93.8113907507973
24.3,"eps_greedy_SVM","SVM",20,4,12833,12696,137,500,109,391,0.979644322910898,0.877394636015326,5.66382125055015,103,42,61,15,1.5,3.75,0.3,0,0,0,0,0,0,0.270175783081332,194.465515092466,78.2435550189933
24.3,"eps_greedy_SVM","SVM",20,5,12733,12648,85,600,157,443,0.951888375720534,0.877394636015326,5.30117559433943,129,57,72,26,1.3,4.5,0.4,0,0,0,0,0,0,0.0636720453457585,113.671912821305,37.0857668801139
24.3,"eps_greedy_SVM","SVM",20,6,12633,12563,70,700,242,458,0.963648782331678,0.881226053639847,5.42049046210759,140,64,76,11,1.2,5.25,0.5,0,0,0,0,0,0,0.0131828722255078,38.8535827798581,18.158939668608
24.3,"eps_greedy_SVM","SVM",20,7,12533,12478,55,800,327,473,0.963254635560775,0.900383141762452,5.31706393117405,167,68,99,27,1.5,6,0.7,0,0,0,0,0,0,0.00971039520363229,19.2451696042092,8.76661877415171
24.3,"eps_greedy_SVM","SVM",20,8,12433,12389,44,900,416,484,0.967432352093296,0.919540229885057,5.50730857183153,188,81,107,21,1.3,6.75,0.9,0,0,0,0,0,0,0.0099915463184253,10.8312756380134,8.52669134737356
24.3,"eps_greedy_SVM","SVM",20,9,12333,12297,36,1000,508,492,0.962887403212761,0.9272030651341,5.40907088950483,212,89,123,24,1.4,7.5,1,0,0,0,0,0,0,0.00487314859752576,5.52569118047079,4.69041584389633
24.3,"eps_greedy_SVM","SVM",20,10,12233,12199,34,1100,606,494,0.964440066364993,0.9272030651341,5.42313259892295,214,90,124,2,1.4,8.25,1.2,0,0,0,0,0,0,0.00443636910577086,3.55094059758771,2.51658869908795
24.3,"eps_greedy_SVM","SVM",20,11,12133,12100,33,1200,705,495,0.964843782708509,0.9272030651341,5.45946053906149,214,91,123,0,1.4,9,1.4,0,0,0,0,0,0,0.0043198527303747,2.45079531963085,1.45383529925686
24.3,"eps_greedy_SVM","SVM",20,12,12033,12002,31,1300,803,497,0.967809154013901,0.9272030651341,5.46420789605197,218,94,124,4,1.3,9.75,1.6,0,0,0,0,0,0,1.17346500855679e-05,0.0337453875603895,0.0284044181085752
24.3,"eps_greedy_SVM","SVM",20,13,11933,11902,31,1400,903,497,0.967893485872328,0.9272030651341,5.46420789605197,218,94,124,0,1.3,10.5,1.8,0,0,0,0,0,0,1.10268771746029e-05,0.00727186172264097,0.00132711960674687
24.3,"eps_greedy_SVM","SVM",20,14,11833,11802,31,1500,1003,497,0.968507134714471,0.9272030651341,5.49597834648297,219,95,124,1,1.3,11.25,2,0,0,0,0,0,0,6.52854598231812e-06,0.00446269882147229,0.000792601680925025
24.3,"eps_greedy_SVM","SVM",20,15,11733,11702,31,1600,1103,497,0.968800202874954,0.9272030651341,5.49597834648297,218,95,123,-1,1.3,12,2.2,0,0,0,0,0,0,4.16442659897343e-06,0.00299657838434871,0.000494631734041959
24.3,"eps_greedy_SVM","SVM",20,16,11633,11603,30,1700,1202,498,0.972637601482345,0.9272030651341,5.49597834648297,224,97,127,6,1.3,12.75,2.4,0,0,0,0,0,0,4.94021189096834e-06,0.00400932763318621,0.000620036196416181
24.3,"eps_greedy_SVM","SVM",20,17,11533,11503,30,1800,1302,498,0.972883419878171,0.9272030651341,5.49119507551127,221,97,124,-3,1.3,13.5,2.6,0,0,0,0,0,0,5.66207497382728e-06,0.00482576247729909,0.00063752793901842
24.3,"eps_greedy_SVM","SVM",20,18,11433,11405,28,1900,1400,500,0.981484671339025,0.9272030651341,5.564716766726,227,99,128,6,1.3,14.25,2.8,0,0,0,0,0,0,7.24136782329006e-06,0.0618324495333156,0.055860459589199
24.3,"eps_greedy_SVM","SVM",20,19,11333,11309,24,2000,1496,504,0.988196530312246,0.9272030651341,5.69898369451371,236,102,134,9,1.3,15,3,0,0,0,0,0,0,0.00295523870195623,0.64772146609319,0.375877814919085
24.3,"eps_greedy_SVM","SVM",20,20,11233,11216,17,2100,1589,511,0.995045951891382,0.923371647509579,5.86144978106185,253,110,143,17,1.3,15.75,3.1,0,0,0,0,0,0,0.0101612351475224,10.3029317857609,1.40682063160408
24.3,"eps_greedy_SVM","SVM",20,21,11133,11123,10,2200,1682,518,0.997061543117508,0.931034482758621,5.92126488417965,284,121,163,31,1.3,16.5,3.2,0,0,0,0,0,0,0.0108631247460213,8.57899413175472,1.56138895474273
24.3,"eps_greedy_SVM","SVM",20,22,11033,11029,4,2300,1776,524,0.99855260214622,0.9272030651341,5.9618096397642,300,129,171,16,1.3,17.25,3.4,0,0,0,0,0,0,0.0114426238507122,9.75382986673102,1.62047268756537
24.3,"eps_greedy_SVM","SVM",20,23,10933,10933,0,2400,1872,528,0.998693753341878,0.934865900383142,5.96716616235159,320,131,189,20,1.4,18,3.5,0,0,0,0,0,0,0.00744095685965012,5.28402128421621,1.08407405775051
24.3,"eps_greedy_SVM","SVM",20,24,10833,10833,0,2500,1972,528,0.998712892487052,0.934865900383142,5.96716616235159,318,129,189,-2,1.5,18.75,3.7,0,0,0,0,0,0,0.00582136146867268,3.60783544352025,0.634250745407158
24.3,"eps_greedy_SVM","SVM",20,25,10733,10733,0,2600,2072,528,0.998706313405898,0.934865900383142,5.97790813564115,319,129,190,1,1.5,19.5,3.9,0,0,0,0,0,0,0.00457344985594685,2.48185398789276,0.500738375827866
24.3,"eps_greedy_SVM","SVM",20,26,10633,10633,0,2700,2172,528,0.998735620221946,0.934865900383142,5.97253231897241,320,129,191,1,1.5,20.25,4.1,0,0,0,0,0,0,0.00380698620296211,1.69272701383995,0.407550311463598
24.3,"eps_greedy_SVM","SVM",20,27,10533,10533,0,2800,2272,528,0.998732629730512,0.934865900383142,5.96716616235159,324,130,194,4,1.5,21,4.3,0,0,0,0,0,0,0.0034528654333794,1.35558403494881,0.369247000822222
24.3,"eps_greedy_SVM","SVM",20,28,10433,10433,0,2900,2372,528,0.998741601204812,0.934865900383142,5.96716616235159,322,130,192,-2,1.5,21.75,4.5,0,0,0,0,0,0,0.00329859021357131,1.21460023519711,0.345771267688225
24.3,"eps_greedy_SVM","SVM",20,29,10333,10333,0,3000,2472,528,0.998758946055126,0.934865900383142,5.95646272528907,321,130,191,-1,1.5,22.5,4.7,0,0,0,0,0,0,0.00283391591087969,0.634194805227482,0.296435831899507
24.3,"eps_greedy_SVM","SVM",20,30,10233,10233,0,3100,2572,528,0.998758946055126,0.934865900383142,5.95646272528907,321,130,191,0,1.5,23.25,4.9,0,0,0,0,0,0,0.00276443011770938,0.595869993957154,0.288541337978795
24.3,"eps_greedy_SVM","SVM",20,31,10133,10133,0,3200,2672,528,0.99876731943114,0.934865900383142,5.96716616235159,317,129,188,-4,1.5,24,5.1,0,0,0,0,0,0,1.07388113236948e-05,0.00924122893673186,0.00116736958907521
24.3,"eps_greedy_SVM","SVM",20,32,10033,10033,0,3300,2772,528,0.998769711824287,0.934865900383142,5.96716616235159,317,129,188,0,1.5,24.75,5.2,0,0,0,0,0,0,9.73994901873233e-06,0.00866079849366666,0.00105412608524965
24.3,"eps_greedy_SVM","SVM",20,33,9933,9933,0,3400,2872,528,0.998775692807153,0.934865900383142,5.96716616235159,319,129,190,2,1.5,25.5,5.4,0,0,0,0,0,0,6.51929570149768e-06,0.0057793484803262,0.000704581768100313
24.3,"eps_greedy_SVM","SVM",20,34,9833,9833,0,3500,2972,528,0.998784664281454,0.934865900383142,5.96716616235159,319,128,191,0,1.5,26.25,5.6,0,0,0,0,0,0,5.23808009566414e-06,0.00482780461824886,0.000562129457270118
24.3,"eps_greedy_SVM","SVM",20,35,9733,9733,0,3600,3072,528,0.99879064526432,0.934865900383142,5.90351638995317,318,127,191,-1,1.5,27,5.8,0,0,0,0,0,0,3.90953475220596e-06,0.00350420923664834,0.000421162864802936
24.3,"eps_greedy_SVM","SVM",20,36,9633,9633,0,3700,3172,528,0.998794831952327,0.934865900383142,5.91403022145799,318,127,191,0,1.5,27.75,6,0,0,0,0,0,0,3.45185894930979e-06,0.00309699119952252,0.000366056304134262
24.3,"eps_greedy_SVM","SVM",20,37,9533,9533,0,3800,3272,528,0.998812176802641,0.934865900383142,5.95112539309796,319,128,191,1,1.5,28.5,6.2,0,0,0,0,0,0,4.78951124319258e-06,0.00447451707959212,0.000509197466454769
24.3,"eps_greedy_SVM","SVM",20,38,9433,9433,0,3900,3372,528,0.998820550178654,0.934865900383142,5.95112539309796,318,128,190,-1,1.5,29.25,6.4,0,0,0,0,0,0,3.65731868219282e-06,0.00339487133358394,0.000390367278404047
24.3,"eps_greedy_SVM","SVM",20,39,9333,9333,0,4000,3472,528,0.998828923554668,0.934865900383142,5.92987137383689,318,128,190,0,1.5,30,6.6,0,0,0,0,0,0,2.40370035950059e-06,0.00218212376494656,0.00025714084739822
24.3,"eps_greedy_SVM","SVM",20,40,9233,9233,0,4100,3572,528,0.998830119751241,0.934865900383142,5.95112539309796,319,129,190,1,1.5,30.75,6.8,0,0,0,0,0,0,2.42586781226283e-06,0.00223030051248697,0.000260505793873502
24.3,"eps_greedy_SVM","SVM",20,41,9133,9133,0,4200,3672,528,0.998840885520402,0.934865900383142,5.94047937271674,320,129,191,1,1.5,31.5,7,0,0,0,0,0,0,1.63090262212021e-06,0.0014719601476558,0.000174198084243161
24.3,"eps_greedy_SVM","SVM",20,42,9033,9033,0,4300,3772,528,0.998854043682708,0.934865900383142,5.89303987462051,320,129,191,0,1.5,32.25,7.1,0,0,0,0,0,0,1.01749162039104e-06,0.000873648989685071,0.000107963945797221
24.3,"eps_greedy_SVM","SVM",20,43,8933,8933,0,4400,3872,528,0.998854043682708,0.934865900383142,5.95112539309796,320,128,192,0,1.5,33,7.3,0,0,0,0,0,0,1.59680146610644e-06,0.00143321449526264,0.000169344523341664
24.3,"eps_greedy_SVM","SVM",20,44,8833,8833,0,4500,3972,528,0.998863613255295,0.934865900383142,5.95112539309796,318,128,190,-2,1.5,33.75,7.5,0,0,0,0,0,0,1.45846778910349e-06,0.00131524536304586,0.000156467932080003
24.3,"eps_greedy_SVM","SVM",20,45,8733,8733,0,4600,4072,528,0.998879163810749,0.934865900383142,5.88260047714554,319,128,191,1,1.5,34.5,7.7,0,0,0,0,0,0,6.85638180555512e-07,0.000584669111876005,7.35709070204256e-05
24.3,"eps_greedy_SVM","SVM",20,46,8633,8633,0,4700,4172,528,0.998888135285049,0.934865900383142,5.88260047714554,319,128,191,0,1.5,35.25,7.9,0,0,0,0,0,0,6.3755791668205e-07,0.0005365697289943,6.81272083314136e-05
24.3,"eps_greedy_SVM","SVM",20,47,8533,8533,0,4800,4272,528,0.998900097250783,0.938697318007663,5.84121014837055,318,128,190,-1,1.5,36,8.1,0,0,0,0,0,0,3.82772245976064e-07,0.000310146719670674,4.12432048354628e-05
24.3,"eps_greedy_SVM","SVM",20,48,8433,8433,0,4900,4372,528,0.998910863019943,0.938697318007663,5.94579761745507,317,128,189,-1,1.5,36.75,8.3,0,0,0,0,0,0,8.36128804119994e-07,0.000733917585729821,8.9197754348983e-05
