"Imb.R","Policy","Inducer","Repetition","Iteration","Nu","Nu_majority","Nu_minority","Nl","Nl_majority","Nl_minority","AUC","PRBEP","LIFT","SV_total","SV_minority","SV_majority","SV.diff","SV.R","Data_Efficiency","Imb.R.Empirical","tr.alpha","tr.beta","tr.alpha_minority","tr.beta_minority","tr.alpha_majority","tr.beta_majority","Quantile","Nu_minority.est","Qt_minority.est"
9.7,"random_instances_SVM","SVM",1,0,2684,2444,240,100,92,8,0.8167944055944,0.286713286713287,1.25693661177532,19,8,11,0,1.4,3.59,11.5,0,0,0,0,0,0,0.274861358709326,209.038902484711,33.7440753435211
9.7,"random_instances_SVM","SVM",1,1,2584,2357,227,200,179,21,0.745784615384616,0.286713286713287,1.17613354387548,54,21,33,35,1.6,7.18,8.5,0,0,0,0,0,0,0.184878234674596,279.237029400762,21.5404920386183
9.7,"random_instances_SVM","SVM",1,2,2484,2269,215,300,267,33,0.780212587412586,0.293706293706294,1.24795849311978,92,33,59,38,1.8,10.78,8.1,0,0,0,0,0,0,0.137503646543166,281.181606235611,14.3344883587763
9.7,"random_instances_SVM","SVM",1,3,2384,2177,207,400,359,41,0.787071328671325,0.293706293706294,1.24795849311978,123,41,82,31,2,14.37,8.8,0,0,0,0,0,0,0.203500781770379,279.461228051539,28.463543645462
9.7,"random_instances_SVM","SVM",1,4,2284,2083,201,500,453,47,0.768330069930073,0.342657342657343,1.25693661177532,127,47,80,4,1.7,17.96,9.6,0,0,0,0,0,0,0.191671245569733,230.963246517614,25.3525403785309
9.7,"random_instances_SVM","SVM",1,5,2184,1997,187,600,539,61,0.759188811188809,0.328671328671329,1.21204601849763,160,61,99,33,1.6,21.55,8.8,0,0,0,0,0,0,0.196907137464841,223.048029252817,31.6032861024999
9.7,"random_instances_SVM","SVM",1,6,2084,1907,177,700,629,71,0.732033566433563,0.300699300699301,1.17613354387548,180,71,109,20,1.5,25.14,8.9,0,0,0,0,0,0,0.179153506765093,200.761653987882,24.434218502388
9.7,"random_instances_SVM","SVM",1,7,1984,1815,169,800,721,79,0.74511888111888,0.286713286713287,1.21204601849763,205,79,126,25,1.6,28.74,9.1,0,0,0,0,0,0,0.16583829012943,196.75948003073,22.5024390412306
9.7,"random_instances_SVM","SVM",1,8,1884,1719,165,900,817,83,0.738808391608387,0.230769230769231,1.22102413715317,227,83,144,22,1.7,32.33,9.8,0,0,0,0,0,0,0.145069464474484,178.936537364031,19.6255175258482
9.7,"random_instances_SVM","SVM",1,9,1784,1627,157,1000,909,91,0.759586013986015,0.244755244755245,1.23000225580871,247,91,156,20,1.7,35.92,10,0,0,0,0,0,0,0.178043518281366,159.708662151429,26.9065872114993
9.7,"random_instances_SVM","SVM",1,10,1684,1532,152,1100,1004,96,0.753247552447552,0.202797202797203,1.26591473043086,269,96,173,22,1.8,39.51,10.5,0,0,0,0,0,0,0.15134607777553,150.193714262955,19.4301046500228
9.7,"random_instances_SVM","SVM",1,11,1584,1441,143,1200,1095,105,0.7591944055944,0.244755244755245,1.27371891460289,303,105,198,34,1.9,43.1,10.4,0,0,0,0,0,0,0.166471416578492,156.341686674047,21.8590480347918
9.7,"random_instances_SVM","SVM",1,12,1484,1356,128,1300,1180,120,0.756111888111886,0.202797202797203,1.27371891460289,340,120,220,37,1.8,46.7,9.8,0,0,0,0,0,0,0.169968058903299,150.216460695689,21.0331060437226
9.7,"random_instances_SVM","SVM",1,13,1384,1263,121,1400,1273,127,0.756542657342652,0.195804195804196,1.27371891460289,360,127,233,20,1.8,50.29,10,0,0,0,0,0,0,0.157278509093688,136.639550676429,19.0119830074208
9.7,"random_instances_SVM","SVM",1,14,1284,1173,111,1500,1363,137,0.778069930069929,0.216783216783217,1.28268876611418,382,137,245,22,1.8,53.88,9.9,0,0,0,0,0,0,0.182573911270049,121.828835827627,24.211205805656
9.7,"random_instances_SVM","SVM",1,15,1184,1082,102,1600,1454,146,0.798495104895105,0.244755244755245,1.28268876611418,399,146,253,17,1.7,57.47,10,0,0,0,0,0,0,0.175544664989629,116.30295883562,21.4880058148828
9.7,"random_instances_SVM","SVM",1,16,1084,988,96,1700,1548,152,0.745174825174823,0.146853146853147,1.28268876611418,429,152,277,30,1.8,61.06,10.2,0,0,0,0,0,0,0.175691621046868,103.775805400236,22.1920246042165
9.7,"random_instances_SVM","SVM",1,17,984,898,86,1800,1638,162,0.78532027972028,0.216783216783217,1.28268876611418,467,162,305,38,1.9,64.66,10.1,0,0,0,0,0,0,0.186387972635388,92.9656431031782,23.330958079099
9.7,"random_instances_SVM","SVM",1,18,884,804,80,1900,1732,168,0.809381818181816,0.265734265734266,1.28268876611418,472,168,304,5,1.8,68.25,10.3,0,0,0,0,0,0,0.16890655256015,79.8792902975968,19.6624840263266
9.7,"random_instances_SVM","SVM",1,19,784,712,72,2000,1824,176,0.808850349650348,0.244755244755245,1.28268876611418,474,176,298,2,1.7,71.84,10.4,0,0,0,0,0,0,0.15862367033607,72.0784639383712,20.9801228109967
9.7,"random_instances_SVM","SVM",1,20,684,627,57,2100,1909,191,0.787116083916085,0.251748251748252,1.25693661177532,530,191,339,56,1.8,75.43,10,0,0,0,0,0,0,0.150857684967419,66.1119966443726,19.2912772410202
9.7,"random_instances_SVM","SVM",1,21,584,533,51,2200,2003,197,0.802058741258739,0.244755244755245,1.26591473043086,522,197,325,-8,1.6,79.02,10.2,0,0,0,0,0,0,0.123035950316116,57.2196828531014,14.4154536022556
9.7,"random_instances_SVM","SVM",1,22,484,444,40,2300,2092,208,0.798735664335665,0.293706293706294,1.25693661177532,572,208,364,50,1.8,82.61,10.1,0,0,0,0,0,0,0.128328481928194,46.2867104502608,15.768125160034
9.7,"random_instances_SVM","SVM",1,23,384,353,31,2400,2183,217,0.808145454545456,0.286713286713287,1.2647490630916,586,217,369,14,1.7,86.21,10.1,0,0,0,0,0,0,0.133457666916166,36.8458046911135,17.2052572406955
9.7,"random_instances_SVM","SVM",1,24,284,261,23,2500,2275,225,0.752223776223777,0.188811188811189,1.25577921158032,615,225,390,29,1.7,89.8,10.1,0,0,0,0,0,0,0.12373692206748,28.1336678560254,18.0400179291825
9.7,"random_instances_SVM","SVM",1,25,184,171,13,2600,2365,235,0.790148251748251,0.237762237762238,1.28387096774194,638,235,403,23,1.7,93.39,10.1,0,0,0,0,0,0,0.0978230260104164,18.4872857342549,14.1582954319421
9.7,"random_instances_SVM","SVM",1,26,84,75,9,2700,2461,239,0.823586013986011,0.286713286713287,1.28268876611418,662,239,423,24,1.8,96.98,10.3,0,0,0,0,0,0,6.18093158851865e-05,9.09036881487463,9.09036881487463
9.7,"random_instances_SVM","SVM",1,27,0,0,0,2784,2536,248,0.76430769230769,0.202797202797203,1.27371891460289,708,248,460,46,1.9,100,10.2,0,0,0,0,0,0,0,0,0
9.7,"random_instances_SVM","SVM",2,0,2684,2438,246,100,89,11,0.750903939397533,0.246268656716418,1.23596533461724,32,11,21,0,1.9,3.59,8.1,0,0,0,0,0,0,0.125532650621015,301.852585932197,14.578560630903
9.7,"random_instances_SVM","SVM",2,1,2584,2352,232,200,175,25,0.812964565575623,0.417910447761194,1.2263842079923,67,25,42,35,1.7,7.18,7,0,0,0,0,0,0,0.332180017510323,310.323332394095,37.8991570312254
9.7,"random_instances_SVM","SVM",2,2,2484,2263,221,300,264,36,0.782106149158897,0.402985074626866,1.19764082811748,88,36,52,21,1.4,10.78,7.3,0,0,0,0,0,0,0.3604979416279,273.19850901916,41.8958818116189
9.7,"random_instances_SVM","SVM",2,3,2384,2173,211,400,354,46,0.790078598271552,0.388059701492537,1.20722195474242,115,46,69,27,1.5,14.37,7.7,0,0,0,0,0,0,0.270329215666499,245.303713756502,32.3738624867318
9.7,"random_instances_SVM","SVM",2,4,2284,2080,204,500,447,53,0.78733417898593,0.373134328358209,1.2263842079923,133,53,80,18,1.5,17.96,8.4,0,0,0,0,0,0,0.235851123917258,222.977691494326,31.9284273087013
9.7,"random_instances_SVM","SVM",2,5,2184,1985,199,600,542,58,0.77309046506941,0.32089552238806,1.2263842079923,149,58,91,16,1.6,21.55,9.3,0,0,0,0,0,0,0.174898146496988,213.957553487767,22.8090339802061
9.7,"random_instances_SVM","SVM",2,6,2084,1891,193,700,636,64,0.770452740270058,0.32089552238806,1.21680308136736,169,64,105,20,1.6,25.14,9.9,0,0,0,0,0,0,0.247876723960722,200.483924970046,39.4246418367314
9.7,"random_instances_SVM","SVM",2,7,1984,1804,180,800,723,77,0.78061242635117,0.335820895522388,1.21680308136736,193,77,116,24,1.5,28.74,9.4,0,0,0,0,0,0,0.169221775345787,187.616101177172,24.0893170997684
9.7,"random_instances_SVM","SVM",2,8,1884,1712,172,900,815,85,0.823995589961237,0.335820895522388,1.274289841117,222,85,137,29,1.6,32.33,9.6,0,0,0,0,0,0,0.193021690210579,179.282580494628,25.989967164812
9.7,"random_instances_SVM","SVM",2,9,1784,1617,167,1000,910,90,0.824742451365099,0.335820895522388,1.274289841117,235,90,145,13,1.6,35.92,10.1,0,0,0,0,0,0,0.147566720071526,156.943896890476,17.5825006432678
9.7,"random_instances_SVM","SVM",2,10,1684,1530,154,1100,997,103,0.83277417519235,0.305970149253731,1.274289841117,277,103,174,42,1.7,39.51,9.7,0,0,0,0,0,0,0.195660787164429,156.478696519849,25.2097265182224
9.7,"random_instances_SVM","SVM",2,11,1584,1440,144,1200,1087,113,0.824291963534201,0.261194029850746,1.274289841117,292,113,179,15,1.6,43.1,9.6,0,0,0,0,0,0,0.224444498625932,150.681030571606,31.5247603552195
9.7,"random_instances_SVM","SVM",2,12,1484,1347,137,1300,1180,120,0.821526798098472,0.283582089552239,1.274289841117,321,120,201,29,1.7,46.7,9.8,0,0,0,0,0,0,0.229987231517137,143.17043696715,32.0504154594801
9.7,"random_instances_SVM","SVM",2,13,1384,1257,127,1400,1270,130,0.802158785105452,0.208955223880597,1.274289841117,336,130,206,15,1.6,50.29,9.8,0,0,0,0,0,0,0.208625473537368,136.399842256467,29.2273112234304
9.7,"random_instances_SVM","SVM",2,14,1284,1167,117,1500,1360,140,0.814707242184636,0.23134328358209,1.274289841117,364,140,224,28,1.6,53.88,9.7,0,0,0,0,0,0,0.23033586136677,131.946287559191,33.279220938805
9.7,"random_instances_SVM","SVM",2,15,1184,1072,112,1600,1455,145,0.814351593897082,0.26865671641791,1.274289841117,397,145,252,33,1.7,57.47,10,0,0,0,0,0,0,0.204135015958416,117.771484148557,26.6511661178895
9.7,"random_instances_SVM","SVM",2,16,1084,981,103,1700,1546,154,0.795869737887217,0.216417910447761,1.274289841117,416,154,262,19,1.7,61.06,10,0,0,0,0,0,0,0.187812028855585,109.066532800658,21.9131246085509
9.7,"random_instances_SVM","SVM",2,17,984,886,98,1800,1641,159,0.811630884497298,0.276119402985075,1.26470871449206,440,159,281,24,1.8,64.66,10.3,0,0,0,0,0,0,0.191791291853787,95.0151034297347,22.2072181949398
9.7,"random_instances_SVM","SVM",2,18,884,791,93,1900,1736,164,0.787114862541943,0.223880597014925,1.26470871449206,470,164,306,30,1.9,68.25,10.6,0,0,0,0,0,0,0.170886718991879,85.4920097277754,20.5568849525788
9.7,"random_instances_SVM","SVM",2,19,784,704,80,2000,1823,177,0.8021232202767,0.201492537313433,1.26470871449206,498,177,321,28,1.8,71.84,10.3,0,0,0,0,0,0,0.174116526057688,72.5490164085038,21.3241285345314
9.7,"random_instances_SVM","SVM",2,20,684,610,74,2100,1917,183,0.809443647528842,0.238805970149254,1.26470871449206,517,183,334,19,1.8,75.43,10.5,0,0,0,0,0,0,0.179729872206846,63.2757274182226,21.500388748311
9.7,"random_instances_SVM","SVM",2,21,584,519,65,2200,2008,192,0.809811150759315,0.26865671641791,1.26470871449206,534,192,342,17,1.8,79.02,10.5,0,0,0,0,0,0,0.167571807088738,52.510622628026,21.8803694437197
9.7,"random_instances_SVM","SVM",2,22,484,432,52,2300,2095,205,0.826615532346216,0.298507462686567,1.26470871449206,553,205,348,19,1.7,82.61,10.2,0,0,0,0,0,0,0.174265819963845,47.1808149051637,21.8578113598437
9.7,"random_instances_SVM","SVM",2,23,384,342,42,2400,2185,215,0.8206287861724,0.276119402985075,1.26470871449206,580,215,365,27,1.7,86.21,10.2,0,0,0,0,0,0,0.154507094283746,34.730990284133,18.3270897478537
9.7,"random_instances_SVM","SVM",2,24,284,253,31,2500,2274,226,0.832116225860376,0.305970149253731,1.26470871449206,640,226,414,60,1.8,89.8,10.1,0,0,0,0,0,0,0.131903831322921,26.3432702227515,18.2080009010106
9.7,"random_instances_SVM","SVM",2,25,184,162,22,2600,2365,235,0.787867651417264,0.201492537313433,1.26470871449206,654,235,419,14,1.8,93.39,10.1,0,0,0,0,0,0,0.0910223422206041,16.8192555638543,14.8273685933704
9.7,"random_instances_SVM","SVM",2,26,84,72,12,2700,2455,245,0.824220833876691,0.261194029850746,1.26470871449206,689,245,444,35,1.8,96.98,10,0,0,0,0,0,0,1.47711219869378e-07,7.62848983395768,7.62848983395768
9.7,"random_instances_SVM","SVM",2,27,0,0,0,2784,2527,257,0.774791649378214,0.216417910447761,1.26470871449206,699,257,442,10,1.7,100,9.8,0,0,0,0,0,0,0,0,0
9.7,"random_instances_SVM","SVM",3,0,2684,2447,237,100,85,15,0.690435211639306,0.172661870503597,1.05295892318403,41,15,26,0,1.7,3.59,5.7,0,0,0,0,0,0,0.397026325721534,414.697482464903,42.1728417550085
9.7,"random_instances_SVM","SVM",3,1,2584,2360,224,200,172,28,0.742820097988599,0.330935251798561,1.13608725922488,65,28,37,24,1.3,7.18,6.1,0,0,0,0,0,0,0.156705335629248,318.139000883617,17.7408717703039
9.7,"random_instances_SVM","SVM",3,2,2484,2268,216,300,264,36,0.780816495129256,0.338129496402878,1.23768855883036,102,36,66,37,1.8,10.78,7.3,0,0,0,0,0,0,0.139787262536986,296.669490243956,15.356554785318
9.7,"random_instances_SVM","SVM",3,3,2384,2176,208,400,356,44,0.766301791102999,0.237410071942446,1.25616152239499,122,44,78,20,1.8,14.37,8.1,0,0,0,0,0,0,0.151704229823439,261.754259395599,22.2019736892964
9.7,"random_instances_SVM","SVM",3,4,2284,2080,204,500,452,48,0.786438791550495,0.258992805755396,1.25616152239499,133,48,85,11,1.8,17.96,9.4,0,0,0,0,0,0,0.143671519524247,222.8766205254,21.4770587114732
9.7,"random_instances_SVM","SVM",3,5,2184,1990,194,600,542,58,0.78130414328824,0.20863309352518,1.23768855883036,160,58,102,27,1.8,21.55,9.3,0,0,0,0,0,0,0.163892474174616,215.509365765802,26.8791735163736
9.7,"random_instances_SVM","SVM",3,6,2084,1893,191,700,639,61,0.777374272830538,0.237410071942446,1.23768855883036,169,61,108,9,1.8,25.14,10.5,0,0,0,0,0,0,0.132740414981193,190.683597435272,20.6336016223596
9.7,"random_instances_SVM","SVM",3,7,1984,1800,184,800,732,68,0.784746365586952,0.251798561151079,1.23768855883036,201,68,133,32,2,28.74,10.8,0,0,0,0,0,0,0.15210945665875,183.319038142343,30.7117340542104
9.7,"random_instances_SVM","SVM",3,8,1884,1710,174,900,822,78,0.796828565855447,0.251798561151079,1.25616152239499,220,78,142,19,1.8,32.33,10.5,0,0,0,0,0,0,0.135326401815338,172.177598549518,20.8824904721971
9.7,"random_instances_SVM","SVM",3,9,1784,1619,165,1000,913,87,0.801234610397805,0.266187050359712,1.23768855883036,249,87,162,29,1.9,35.92,10.5,0,0,0,0,0,0,0.158184486889223,173.339058298134,28.711554408757
9.7,"random_instances_SVM","SVM",3,10,1684,1528,156,1100,1004,96,0.81388477734559,0.251798561151079,1.23768855883036,268,96,172,19,1.8,39.51,10.5,0,0,0,0,0,0,0.142433467033291,154.444716604036,24.4123575350461
9.7,"random_instances_SVM","SVM",3,11,1584,1434,150,1200,1098,102,0.805634917903009,0.258992805755396,1.24692504061267,269,102,167,1,1.6,43.1,10.8,0,0,0,0,0,0,0.14360515442388,145.871977163541,20.8120733663379
9.7,"random_instances_SVM","SVM",3,12,1484,1346,138,1300,1186,114,0.830235333264494,0.244604316546763,1.28387096774194,320,114,206,51,1.8,46.7,10.4,0,0,0,0,0,0,0.16036834771747,146.260744799473,26.8508939122245
9.7,"random_instances_SVM","SVM",3,13,1384,1251,133,1400,1281,119,0.815795210721377,0.237410071942446,1.28387096774194,317,119,198,-3,1.7,50.29,10.8,0,0,0,0,0,0,0.139798650574731,133.882927085403,22.1641105636103
9.7,"random_instances_SVM","SVM",3,14,1284,1158,126,1500,1374,126,0.823792640528727,0.280575539568345,1.28387096774194,349,126,223,32,1.8,53.88,10.9,0,0,0,0,0,0,0.15634057253921,123.917970635035,28.3166974190397
9.7,"random_instances_SVM","SVM",3,15,1184,1065,119,1600,1467,133,0.834262733353987,0.273381294964029,1.27463448595962,386,133,253,37,1.9,57.47,11,0,0,0,0,0,0,0.125907309960433,110.835179788221,16.1415179614629
9.7,"random_instances_SVM","SVM",3,16,1084,969,115,1700,1563,137,0.839804711254924,0.330935251798561,1.28387096774194,388,137,251,2,1.8,61.06,11.4,0,0,0,0,0,0,0.151013350310084,90.8376005933006,22.4103777647906
9.7,"random_instances_SVM","SVM",3,17,984,878,106,1800,1654,146,0.820625796013907,0.323741007194245,1.27463448595962,408,146,262,20,1.8,64.66,11.3,0,0,0,0,0,0,0.140079185789895,87.9659679448938,19.527964367032
9.7,"random_instances_SVM","SVM",3,18,884,783,101,1900,1749,151,0.828789599899029,0.273381294964029,1.28387096774194,409,151,258,1,1.7,68.25,11.6,0,0,0,0,0,0,0.136104069441607,76.2228602728045,17.8555788188116
9.7,"random_instances_SVM","SVM",3,19,784,696,88,2000,1836,164,0.841147177951415,0.338129496402878,1.27463448595962,472,164,308,63,1.9,71.84,11.2,0,0,0,0,0,0,0.146476565959994,68.4566214259561,17.786332253466
9.7,"random_instances_SVM","SVM",3,20,684,605,79,2100,1927,173,0.79415510653678,0.20863309352518,1.27463448595962,492,173,319,20,1.8,75.43,11.1,0,0,0,0,0,0,0.127161287490001,61.4351403908328,14.8601678999537
9.7,"random_instances_SVM","SVM",3,21,584,514,70,2200,2018,182,0.780082154372199,0.158273381294964,1.27463448595962,513,182,331,21,1.8,79.02,11.1,0,0,0,0,0,0,0.123199678289931,50.5068065232238,15.6824636958443
9.7,"random_instances_SVM","SVM",3,22,484,426,58,2300,2106,194,0.790890732390164,0.179856115107914,1.27463448595962,534,194,340,21,1.8,82.61,10.9,0,0,0,0,0,0,0.12613531580839,44.3548650768801,15.6229938133457
9.7,"random_instances_SVM","SVM",3,23,384,341,43,2400,2191,209,0.790999736096294,0.18705035971223,1.27463448595962,577,209,368,43,1.8,86.21,10.5,0,0,0,0,0,0,0.125006073576326,35.0158675253622,15.8450206450942
9.7,"random_instances_SVM","SVM",3,24,284,250,34,2500,2282,218,0.791711128704696,0.18705035971223,1.28387096774194,595,218,377,18,1.7,89.8,10.5,0,0,0,0,0,0,0.107136044755182,25.4333323255565,15.4261569225244
9.7,"random_instances_SVM","SVM",3,25,184,163,21,2600,2369,231,0.776823517262745,0.151079136690647,1.27463448595962,637,231,406,42,1.8,93.39,10.3,0,0,0,0,0,0,0.0894355013778092,17.7033487614374,13.7854010465034
9.7,"random_instances_SVM","SVM",3,26,84,77,7,2700,2455,245,0.798607047376456,0.223021582733813,1.27463448595962,664,245,419,27,1.7,96.98,10,0,0,0,0,0,0,1.78456930503507e-07,8.11675798463467,8.11675798463467
9.7,"random_instances_SVM","SVM",3,27,0,0,0,2784,2532,252,0.830436129565247,0.302158273381295,1.27463448595962,669,252,417,5,1.7,100,10,0,0,0,0,0,0,0,0,0
9.7,"random_instances_SVM","SVM",4,0,2684,2435,249,100,92,8,0.719227531919439,0.26865671641791,1.21680308136736,29,8,21,0,2.6,3.59,11.5,0,0,0,0,0,0,0.109879871932389,230.430067283199,11.9707329096446
9.7,"random_instances_SVM","SVM",4,1,2584,2349,235,200,178,22,0.783303498393662,0.350746268656716,1.24554646124218,55,22,33,26,1.5,7.18,8.1,0,0,0,0,0,0,0.294551687993681,269.110978542309,37.9401639223839
9.7,"random_instances_SVM","SVM",4,2,2484,2259,225,300,268,32,0.727846075421149,0.23134328358209,1.20722195474242,93,32,61,38,1.9,10.78,8.4,0,0,0,0,0,0,0.129565938740196,267.531201174214,13.6817215887792
9.7,"random_instances_SVM","SVM",4,3,2384,2169,215,400,358,42,0.762990053702894,0.238805970149254,1.26470871449206,115,42,73,22,1.7,14.37,8.5,0,0,0,0,0,0,0.156188561424373,241.48343936885,31.1477879734325
9.7,"random_instances_SVM","SVM",4,4,2284,2075,209,500,452,48,0.772948205754393,0.246268656716418,1.26470871449206,140,48,92,25,1.9,17.96,9.4,0,0,0,0,0,0,0.131543399342649,223.343000937365,21.1457418876694
9.7,"random_instances_SVM","SVM",4,5,2184,1981,203,600,546,54,0.77090322810096,0.223880597014925,1.26470871449206,163,54,109,23,2,21.55,10.1,0,0,0,0,0,0,0.131403887129851,216.494305276594,23.5126846017307
9.7,"random_instances_SVM","SVM",4,6,2084,1888,196,700,639,61,0.76699109693787,0.216417910447761,1.25512758786712,180,61,119,17,2,25.14,10.5,0,0,0,0,0,0,0.12499048352104,198.473978977687,23.7453381553864
9.7,"random_instances_SVM","SVM",4,7,1984,1795,189,800,732,68,0.751164748141742,0.201492537313433,1.25512758786712,200,68,132,20,1.9,28.74,10.8,0,0,0,0,0,0,0.128073317387956,191.014003952716,16.2985174575243
9.7,"random_instances_SVM","SVM",4,8,1884,1703,181,900,824,76,0.78031605277821,0.305970149253731,1.26470871449206,232,76,156,32,2.1,32.33,10.8,0,0,0,0,0,0,0.120283023103098,177.84954111168,14.649038602721
9.7,"random_instances_SVM","SVM",4,9,1784,1617,167,1000,910,90,0.776978886346666,0.32089552238806,1.24554646124218,256,90,166,24,1.8,35.92,10.1,0,0,0,0,0,0,0.117642478563076,171.207489612812,13.5559494299629
9.7,"random_instances_SVM","SVM",4,10,1684,1527,157,1100,1000,100,0.741734141050114,0.216417910447761,1.24554646124218,321,100,221,65,2.2,39.51,10,0,0,0,0,0,0,0.133307286273605,157.295297719526,15.1194665032305
9.7,"random_instances_SVM","SVM",4,11,1584,1430,154,1200,1097,103,0.755580714378864,0.26865671641791,1.24554646124218,325,103,222,4,2.2,43.1,10.7,0,0,0,0,0,0,0.136290102767795,143.882497770488,14.845105597611
9.7,"random_instances_SVM","SVM",4,12,1484,1348,136,1300,1179,121,0.742492857396892,0.26865671641791,1.23596533461724,358,121,237,33,2,46.7,9.7,0,0,0,0,0,0,0.158454776324852,151.933111936815,19.9084004412837
9.7,"random_instances_SVM","SVM",4,13,1384,1253,131,1400,1274,126,0.719079345132952,0.194029850746269,1.21680308136736,377,126,251,19,2,50.29,10.1,0,0,0,0,0,0,0.133599851817001,133.895369405334,15.591990664849
9.7,"random_instances_SVM","SVM",4,14,1284,1169,115,1500,1358,142,0.804926914276909,0.291044776119403,1.26470871449206,399,142,257,22,1.8,53.88,9.6,0,0,0,0,0,0,0.144001205686525,118.95873036118,17.2229932150366
9.7,"random_instances_SVM","SVM",4,15,1184,1081,103,1600,1446,154,0.785757471577775,0.246268656716418,1.274289841117,448,154,294,49,1.9,57.47,9.4,0,0,0,0,0,0,0.157483396931599,109.477217608249,19.5299109005327
9.7,"random_instances_SVM","SVM",4,16,1084,989,95,1700,1538,162,0.768573731817484,0.223880597014925,1.274289841117,470,162,308,22,1.9,61.06,9.5,0,0,0,0,0,0,0.169756813002732,111.247916511436,20.9341181699163
9.7,"random_instances_SVM","SVM",4,17,984,900,84,1800,1627,173,0.78327978850782,0.298507462686567,1.274289841117,482,173,309,12,1.8,64.66,9.4,0,0,0,0,0,0,0.171399277974638,93.0970746026583,21.5831017722848
9.7,"random_instances_SVM","SVM",4,18,884,810,74,1900,1717,183,0.767992839614479,0.291044776119403,1.274289841117,514,183,331,32,1.8,68.25,9.4,0,0,0,0,0,0,0.17191262269376,86.034781414051,20.2866236163763
9.7,"random_instances_SVM","SVM",4,19,784,714,70,2000,1813,187,0.785763399049235,0.238805970149254,1.274289841117,534,187,347,20,1.9,71.84,9.7,0,0,0,0,0,0,0.162436334304601,72.6954816338581,19.653538475131
9.7,"random_instances_SVM","SVM",4,20,684,622,62,2100,1905,195,0.738711130605908,0.253731343283582,1.274289841117,553,195,358,19,1.8,75.43,9.8,0,0,0,0,0,0,0.160074322137376,66.3093409990479,18.7216369850744
9.7,"random_instances_SVM","SVM",4,21,584,530,54,2200,1997,203,0.794648678766614,0.238805970149254,1.274289841117,575,203,372,22,1.8,79.02,9.8,0,0,0,0,0,0,0.165507479800488,53.6056857164603,21.0060073613128
9.7,"random_instances_SVM","SVM",4,22,484,441,43,2300,2086,214,0.763114530603539,0.156716417910448,1.274289841117,621,214,407,46,1.9,82.61,9.7,0,0,0,0,0,0,0.15740525014563,46.2871518271079,18.7711128864364
9.7,"random_instances_SVM","SVM",4,23,384,350,34,2400,2177,223,0.790985501404814,0.246268656716418,1.274289841117,613,223,390,-8,1.7,86.21,9.8,0,0,0,0,0,0,0.156512702563552,35.0281355894385,19.5016926661377
9.7,"random_instances_SVM","SVM",4,24,284,261,23,2500,2266,234,0.767174848553106,0.171641791044776,1.274289841117,635,234,401,22,1.7,89.8,9.7,0,0,0,0,0,0,0.134288247488651,27.3450276341503,17.3340106392197
9.7,"random_instances_SVM","SVM",4,25,184,170,14,2600,2357,243,0.759783291643452,0.201492537313433,1.274289841117,650,243,407,15,1.7,93.39,9.7,0,0,0,0,0,0,0.0658267260890431,16.0195338981215,14.3041005542166
9.7,"random_instances_SVM","SVM",4,26,84,78,6,2700,2449,251,0.712381302384032,0.104477611940299,1.26470871449206,692,251,441,42,1.8,96.98,9.8,0,0,0,0,0,0,7.85289044344794e-06,8.19936262042427,8.19936262042427
9.7,"random_instances_SVM","SVM",4,27,0,0,0,2784,2527,257,0.774157409932073,0.186567164179104,1.274289841117,714,257,457,22,1.8,100,9.8,0,0,0,0,0,0,0,0,0
9.7,"random_instances_SVM","SVM",5,0,2684,2432,252,100,89,11,0.74890686758893,0.34375,1.07323588709677,25,11,14,0,1.3,3.59,8.1,0,0,0,0,0,0,0.181600994689075,287.759373159024,18.9537319833917
9.7,"random_instances_SVM","SVM",5,1,2584,2346,238,200,175,25,0.851019021739129,0.375,1.28387096774194,59,25,34,34,1.4,7.18,7,0,0,0,0,0,0,0.153418096525105,315.624251317759,15.5523000834278
9.7,"random_instances_SVM","SVM",5,2,2484,2259,225,300,262,38,0.847795207509884,0.3515625,1.28387096774194,84,38,46,25,1.2,10.78,6.9,0,0,0,0,0,0,0.181473177283092,265.198197491572,19.5309172184401
9.7,"random_instances_SVM","SVM",5,3,2384,2168,216,400,353,47,0.828785820158106,0.234375,1.28387096774194,114,47,67,30,1.4,14.37,7.5,0,0,0,0,0,0,0.216131698289667,276.255445250015,31.6718840730752
9.7,"random_instances_SVM","SVM",5,4,2284,2074,210,500,447,53,0.821739130434784,0.234375,1.28387096774194,127,53,74,13,1.4,17.96,8.4,0,0,0,0,0,0,0.270262729791032,257.279585056401,49.3763906817518
9.7,"random_instances_SVM","SVM",5,5,2184,1983,201,600,538,62,0.826167243083005,0.2890625,1.27384072580645,152,62,90,25,1.5,21.55,8.7,0,0,0,0,0,0,0.210112564301886,233.76834332743,25.6006452104275
9.7,"random_instances_SVM","SVM",5,6,2084,1887,197,700,634,66,0.824629446640317,0.234375,1.28387096774194,166,66,100,14,1.5,25.14,9.6,0,0,0,0,0,0,0.23036234328728,215.281244568566,34.9647947865832
9.7,"random_instances_SVM","SVM",5,7,1984,1795,189,800,726,74,0.827050395256919,0.265625,1.28387096774194,191,74,117,25,1.6,28.74,9.8,0,0,0,0,0,0,0.216914832640369,207.729447116698,28.6331635399482
9.7,"random_instances_SVM","SVM",5,8,1884,1706,178,900,815,85,0.817564229249012,0.25,1.28387096774194,220,85,135,29,1.6,32.33,9.6,0,0,0,0,0,0,0.208973981891779,186.830945793441,26.9001933005447
9.7,"random_instances_SVM","SVM",5,9,1784,1612,172,1000,909,91,0.818509140316205,0.2578125,1.28387096774194,249,91,158,29,1.7,35.92,10,0,0,0,0,0,0,0.181000200958087,171.709710028822,23.2001354764729
9.7,"random_instances_SVM","SVM",5,10,1684,1520,164,1100,1001,99,0.809745553359687,0.21875,1.28387096774194,287,99,188,38,1.9,39.51,10.1,0,0,0,0,0,0,0.162571912750494,166.927584626833,21.2731328177095
9.7,"random_instances_SVM","SVM",5,11,1584,1426,158,1200,1095,105,0.825710227272726,0.2890625,1.28387096774194,315,105,210,28,2,43.1,10.4,0,0,0,0,0,0,0.164652851476571,156.348191968066,21.3120400016796
9.7,"random_instances_SVM","SVM",5,12,1484,1340,144,1300,1181,119,0.803680830039528,0.265625,1.28387096774194,347,119,228,32,1.9,46.7,9.9,0,0,0,0,0,0,0.141255998184771,153.330283572059,16.000660809334
9.7,"random_instances_SVM","SVM",5,13,1384,1250,134,1400,1271,129,0.808436264822137,0.2734375,1.28387096774194,364,129,235,17,1.8,50.29,9.9,0,0,0,0,0,0,0.152495372195966,141.649204505469,18.5502818904927
9.7,"random_instances_SVM","SVM",5,14,1284,1157,127,1500,1364,136,0.814377470355734,0.265625,1.28387096774194,394,136,258,30,1.9,53.88,10,0,0,0,0,0,0,0.156508909276805,125.201912906919,18.5295922309846
9.7,"random_instances_SVM","SVM",5,15,1184,1069,115,1600,1452,148,0.783831521739131,0.1953125,1.28387096774194,444,148,296,50,2,57.47,9.8,0,0,0,0,0,0,0.17566290676762,118.685138604027,24.4601158683189
9.7,"random_instances_SVM","SVM",5,16,1084,983,101,1700,1538,162,0.789550395256919,0.21875,1.28387096774194,483,162,321,39,2,61.06,9.5,0,0,0,0,0,0,0.173338308110763,108.626793870683,22.755125307437
9.7,"random_instances_SVM","SVM",5,17,984,892,92,1800,1629,171,0.783145998023717,0.171875,1.28387096774194,509,171,338,26,2,64.66,9.5,0,0,0,0,0,0,0.163238228104379,101.370482615233,19.0195878980865
9.7,"random_instances_SVM","SVM",5,18,884,804,80,1900,1717,183,0.728007658102767,0.125,1.28387096774194,512,183,329,3,1.8,68.25,9.4,0,0,0,0,0,0,0.173214532506748,91.0252576933554,22.2088132237651
9.7,"random_instances_SVM","SVM",5,19,784,716,68,2000,1805,195,0.783856225296443,0.171875,1.28387096774194,563,195,368,51,1.9,71.84,9.3,0,0,0,0,0,0,0.1729780681343,81.7868745335204,23.9905153656474
9.7,"random_instances_SVM","SVM",5,20,684,625,59,2100,1896,204,0.754119318181819,0.1328125,1.28387096774194,564,204,360,1,1.8,75.43,9.3,0,0,0,0,0,0,0.16957703379459,73.03601141231,23.8708876224206
9.7,"random_instances_SVM","SVM",5,21,584,526,58,2200,1995,205,0.706805830039524,0.1328125,1.28387096774194,585,205,380,21,1.9,79.02,9.7,0,0,0,0,0,0,0.126842324858203,60.8079283580133,16.2034229200952
9.7,"random_instances_SVM","SVM",5,22,484,437,47,2300,2084,216,0.739074851778657,0.1328125,1.28387096774194,607,216,391,22,1.8,82.61,9.6,0,0,0,0,0,0,0.129897537070151,51.0095426701628,18.4544464284356
9.7,"random_instances_SVM","SVM",5,23,384,343,41,2400,2178,222,0.794744318181815,0.234375,1.28387096774194,612,222,390,5,1.8,86.21,9.8,0,0,0,0,0,0,0.131030402789634,40.33547925396,17.4485990156941
9.7,"random_instances_SVM","SVM",5,24,284,252,32,2500,2269,231,0.816588438735179,0.2578125,1.27384072580645,640,231,409,28,1.8,89.8,9.8,0,0,0,0,0,0,0.119505386656404,28.3903343607013,16.4038619338907
9.7,"random_instances_SVM","SVM",5,25,184,161,23,2600,2360,240,0.724116847826091,0.15625,1.27384072580645,681,240,441,41,1.8,93.39,9.8,0,0,0,0,0,0,0.0949014284840126,17.7453978515211,13.6067789937895
9.7,"random_instances_SVM","SVM",5,26,84,72,12,2700,2449,251,0.744633152173915,0.171875,1.28387096774194,704,251,453,23,1.8,96.98,9.8,0,0,0,0,0,0,1.31353545587148e-08,9.18179057294621,9.18179057294621
9.7,"random_instances_SVM","SVM",5,27,0,0,0,2784,2521,263,0.761166007905139,0.1953125,1.28268876611418,729,263,466,25,1.8,100,9.6,0,0,0,0,0,0,0,0,0
9.7,"random_instances_SVM","SVM",6,0,2684,2422,262,100,93,7,0.68016019398692,0.0901639344262295,1.26282390269699,26,7,19,0,2.7,3.59,13.3,0,0,0,0,0,0,0.102415930980949,216.141262833793,11.3377992104366
9.7,"random_instances_SVM","SVM",6,1,2584,2336,248,200,179,21,0.781848550902227,0.204918032786885,1.26282390269699,56,21,35,30,1.7,7.18,8.5,0,0,0,0,0,0,0.171420611505544,281.709983338796,27.4496358087318
9.7,"random_instances_SVM","SVM",6,2,2484,2245,239,300,270,30,0.778675626523585,0.131147540983607,1.25230037017451,74,30,44,18,1.5,10.78,9,0,0,0,0,0,0,0.240415598081102,274.866752769312,38.6438323406753
9.7,"random_instances_SVM","SVM",6,3,2384,2154,230,400,361,39,0.77078200977674,0.180327868852459,1.25230037017451,107,39,68,33,1.7,14.37,9.3,0,0,0,0,0,0,0.134102052890112,243.963555627904,21.0531773904304
9.7,"random_instances_SVM","SVM",6,4,2284,2067,217,500,448,52,0.808844204253788,0.254098360655738,1.24177683765204,130,52,78,23,1.5,17.96,8.6,0,0,0,0,0,0,0.229694714995426,261.951074179688,36.0407863984444
9.7,"random_instances_SVM","SVM",6,5,2184,1976,208,600,539,61,0.788136358359883,0.180327868852459,1.24177683765204,161,61,100,31,1.6,21.55,8.8,0,0,0,0,0,0,0.126259223362393,224.194163479633,16.5302710027785
9.7,"random_instances_SVM","SVM",6,6,2084,1883,201,700,632,68,0.801763165701469,0.204918032786885,1.24177683765204,169,68,101,8,1.5,25.14,9.3,0,0,0,0,0,0,0.192943166066062,220.676658583756,37.3999434517191
9.7,"random_instances_SVM","SVM",6,7,1984,1789,195,800,726,74,0.802736969728242,0.204918032786885,1.25230037017451,180,74,106,11,1.4,28.74,9.8,0,0,0,0,0,0,0.227821920497171,199.205865668302,43.0671112748787
9.7,"random_instances_SVM","SVM",6,8,1884,1700,184,900,815,85,0.819033676851845,0.270491803278689,1.25230037017451,203,85,118,23,1.4,32.33,9.6,0,0,0,0,0,0,0.204653142517446,186.970583962099,31.535553102949
9.7,"random_instances_SVM","SVM",6,9,1784,1609,175,1000,906,94,0.821232797203705,0.237704918032787,1.25230037017451,230,94,136,27,1.4,35.92,9.6,0,0,0,0,0,0,0.203290606307294,185.781699843943,34.2774531862836
9.7,"random_instances_SVM","SVM",6,10,1684,1516,168,1100,999,101,0.805774464407791,0.213114754098361,1.25230037017451,245,101,144,15,1.4,39.51,9.9,0,0,0,0,0,0,0.211525246984551,168.540224845885,38.2227520524886
9.7,"random_instances_SVM","SVM",6,11,1584,1427,157,1200,1088,112,0.794714372315588,0.262295081967213,1.26282390269699,291,112,179,46,1.6,43.1,9.7,0,0,0,0,0,0,0.172266386002733,175.190609098508,30.198864535736
9.7,"random_instances_SVM","SVM",6,12,1484,1338,146,1300,1177,123,0.785666378609846,0.262295081967213,1.28387096774194,319,123,196,28,1.6,46.7,9.6,0,0,0,0,0,0,0.189229109229753,167.25662838367,35.171100161299
9.7,"random_instances_SVM","SVM",6,13,1384,1246,138,1400,1269,131,0.789664779249592,0.254098360655738,1.27334743521946,358,131,227,39,1.7,50.29,9.7,0,0,0,0,0,0,0.18429041812739,150.85060494643,34.5280212896973
9.7,"random_instances_SVM","SVM",6,14,1284,1158,126,1500,1357,143,0.801318182404465,0.262295081967213,1.26282390269699,375,143,232,17,1.6,53.88,9.5,0,0,0,0,0,0,0.174280694164554,146.320986259201,33.9975041914653
9.7,"random_instances_SVM","SVM",6,15,1184,1066,118,1600,1449,151,0.767228592433998,0.237704918032787,1.26282390269699,387,151,236,12,1.6,57.47,9.6,0,0,0,0,0,0,0.145664486553463,133.597156686028,28.5876769866667
9.7,"random_instances_SVM","SVM",6,16,1084,977,107,1700,1538,162,0.814158207684663,0.352459016393443,1.27334743521946,432,162,270,45,1.7,61.06,9.5,0,0,0,0,0,0,0.160550266174788,112.278035067167,20.7814441689441
9.7,"random_instances_SVM","SVM",6,17,984,886,98,1800,1629,171,0.818646734854441,0.30327868852459,1.27334743521946,454,171,283,22,1.7,64.66,9.5,0,0,0,0,0,0,0.173116996404036,108.300078711085,22.27470282207
9.7,"random_instances_SVM","SVM",6,18,884,796,88,1900,1719,181,0.826985334898294,0.30327868852459,1.27334743521946,481,181,300,27,1.7,68.25,9.5,0,0,0,0,0,0,0.158974482448457,93.8119704815088,19.9005169791506
9.7,"random_instances_SVM","SVM",6,19,784,703,81,2000,1812,188,0.81599618217229,0.30327868852459,1.27334743521946,500,188,312,19,1.7,71.84,9.6,0,0,0,0,0,0,0.153872596530318,79.3845893103714,20.5331036950028
9.7,"random_instances_SVM","SVM",6,20,684,612,72,2100,1903,197,0.821477860468713,0.311475409836066,1.27334743521946,525,197,328,25,1.7,75.43,9.7,0,0,0,0,0,0,0.126674816720432,69.0430507590961,14.8618878037726
9.7,"random_instances_SVM","SVM",6,21,584,522,62,2200,1993,207,0.800770014574814,0.262295081967213,1.28387096774194,551,207,344,26,1.7,79.02,9.6,0,0,0,0,0,0,0.151062640254322,59.5463921620826,21.4186324017622
9.7,"random_instances_SVM","SVM",6,22,484,433,51,2300,2082,218,0.802595090995856,0.254098360655738,1.28387096774194,573,218,355,22,1.6,82.61,9.6,0,0,0,0,0,0,0.140507005207382,47.9557632157492,20.7481046419382
9.7,"random_instances_SVM","SVM",6,23,384,346,38,2400,2169,231,0.787246391765872,0.237704918032787,1.27334743521946,624,231,393,51,1.7,86.21,9.4,0,0,0,0,0,0,0.137168325219753,40.5019555188977,17.101326358829
9.7,"random_instances_SVM","SVM",6,24,284,260,24,2500,2255,245,0.797887296694228,0.262295081967213,1.26282390269699,669,245,424,45,1.7,89.8,9.2,0,0,0,0,0,0,0.129381175518094,30.0947905964597,15.5533233932573
9.7,"random_instances_SVM","SVM",6,25,184,171,13,2600,2344,256,0.771091563374651,0.221311475409836,1.25230037017451,683,256,427,14,1.7,93.39,9.2,0,0,0,0,0,0,0.11848091270819,19.7312348815732,14.4914336418018
9.7,"random_instances_SVM","SVM",6,26,84,79,5,2700,2436,264,0.754968980149878,0.172131147540984,1.26282390269699,713,264,449,30,1.7,96.98,9.2,0,0,0,0,0,0,4.54139835558951e-08,9.94876973994317,9.94876973994317
9.7,"random_instances_SVM","SVM",6,27,0,0,0,2784,2515,269,0.829997033444688,0.270491803278689,1.26282390269699,699,269,430,-14,1.6,100,9.3,0,0,0,0,0,0,0,0,0
9.7,"random_instances_SVM","SVM",7,0,2684,2441,243,100,90,10,0.816525203533693,0.347826086956522,1.21906201519551,23,10,13,0,1.3,3.59,9,0,0,0,0,0,0,0.482200116001966,311.201412339137,50.9779478307274
9.7,"random_instances_SVM","SVM",7,1,2584,2354,230,200,177,23,0.826055199491893,0.405797101449275,1.24093870495945,56,23,33,33,1.4,7.18,7.7,0,0,0,0,0,0,0.669924021432679,335.121188852134,76.0808171146442
9.7,"random_instances_SVM","SVM",7,2,2484,2263,221,300,268,32,0.799064611120737,0.289855072463768,1.27456755493221,75,32,43,19,1.3,10.78,8.4,0,0,0,0,0,0,0.363731742459954,257.925037804849,46.1003184584064
9.7,"random_instances_SVM","SVM",7,3,2384,2174,210,400,357,43,0.794445406778686,0.326086956521739,1.26526414212249,111,43,68,36,1.6,14.37,8.3,0,0,0,0,0,0,0.235685329639966,257.381231309375,28.9554950912212
9.7,"random_instances_SVM","SVM",7,4,2284,2079,205,500,452,48,0.798781684854789,0.181159420289855,1.26526414212249,138,48,90,27,1.9,17.96,9.4,0,0,0,0,0,0,0.186205959560685,226.427973495671,22.4418686680259
9.7,"random_instances_SVM","SVM",7,5,2184,1988,196,600,543,57,0.779975749177207,0.253623188405797,1.26526414212249,166,57,109,28,1.9,21.55,9.5,0,0,0,0,0,0,0.144755167926489,222.936546935719,17.6487817005838
9.7,"random_instances_SVM","SVM",7,6,2084,1900,184,700,631,69,0.801980483861656,0.282608695652174,1.28387096774194,201,69,132,35,1.9,25.14,9.1,0,0,0,0,0,0,0.159978892626142,211.902064863361,20.6449093014607
9.7,"random_instances_SVM","SVM",7,7,1984,1810,174,800,721,79,0.834210982158326,0.326086956521739,1.28387096774194,239,79,160,38,2,28.74,9.1,0,0,0,0,0,0,0.159910673539599,207.671064149506,21.2004675503782
9.7,"random_instances_SVM","SVM",7,8,1884,1718,166,900,813,87,0.810768520122412,0.202898550724638,1.28387096774194,255,87,168,16,1.9,32.33,9.3,0,0,0,0,0,0,0.198297423226379,198.858685847452,26.2458811533395
9.7,"random_instances_SVM","SVM",7,9,1784,1625,159,1000,906,94,0.829274207517758,0.27536231884058,1.28387096774194,273,94,179,18,1.9,35.92,9.6,0,0,0,0,0,0,0.161314544222463,168.34282622002,21.056813590314
9.7,"random_instances_SVM","SVM",7,10,1684,1531,153,1100,1000,100,0.825538426006121,0.253623188405797,1.28387096774194,294,100,194,21,1.9,39.51,10,0,0,0,0,0,0,0.169462032665017,159.930607552,20.3806321691708
9.7,"random_instances_SVM","SVM",7,11,1584,1439,145,1200,1092,108,0.836116403949422,0.27536231884058,1.28387096774194,301,108,193,7,1.8,43.1,10.1,0,0,0,0,0,0,0.161327594684714,151.282610462061,18.8531390479838
9.7,"random_instances_SVM","SVM",7,12,1484,1353,131,1300,1178,122,0.842860442288818,0.289855072463768,1.28387096774194,352,122,230,51,1.9,46.7,9.7,0,0,0,0,0,0,0.178759320024629,147.299953674398,22.8370122451861
9.7,"random_instances_SVM","SVM",7,13,1384,1259,125,1400,1272,128,0.830180726369886,0.246376811594203,1.28387096774194,374,128,246,22,1.9,50.29,9.9,0,0,0,0,0,0,0.171666168323429,131.489431391121,20.6276915868086
9.7,"random_instances_SVM","SVM",7,14,1284,1164,120,1500,1367,133,0.828719902996712,0.253623188405797,1.28387096774194,357,133,224,-17,1.7,53.88,10.3,0,0,0,0,0,0,0.166758509471895,114.974345704492,20.696597269046
9.7,"random_instances_SVM","SVM",7,15,1184,1072,112,1600,1459,141,0.793209769617186,0.231884057971014,1.26526414212249,403,141,262,46,1.9,57.47,10.3,0,0,0,0,0,0,0.146504591508939,109.748772556013,16.7989643998606
9.7,"random_instances_SVM","SVM",7,16,1084,978,106,1700,1553,147,0.834586292511117,0.27536231884058,1.27456755493221,410,147,263,7,1.8,61.06,10.6,0,0,0,0,0,0,0.136409282442555,99.9399988339495,15.1943939592473
9.7,"random_instances_SVM","SVM",7,17,984,888,96,1800,1643,157,0.849044402101741,0.340579710144928,1.27456755493221,429,157,272,19,1.7,64.66,10.5,0,0,0,0,0,0,0.130364217195379,87.894275500781,14.4681585200055
9.7,"random_instances_SVM","SVM",7,18,884,794,90,1900,1737,163,0.836226110052548,0.289855072463768,1.27456755493221,456,163,293,27,1.8,68.25,10.7,0,0,0,0,0,0,0.136026284879367,80.2820715291663,15.596020271998
9.7,"random_instances_SVM","SVM",7,19,784,707,77,2000,1824,176,0.799480339511523,0.159420289855072,1.27456755493221,491,176,315,35,1.8,71.84,10.4,0,0,0,0,0,0,0.132332347648747,72.0200324007276,15.6650038896792
9.7,"random_instances_SVM","SVM",7,20,684,618,66,2100,1913,187,0.816842773832212,0.239130434782609,1.27456755493221,518,187,331,27,1.8,75.43,10.2,0,0,0,0,0,0,0.140514437367872,63.2305622182677,16.0353029725793
9.7,"random_instances_SVM","SVM",7,21,584,527,57,2200,2004,196,0.821993186673599,0.253623188405797,1.27456755493221,542,196,346,24,1.8,79.02,10.2,0,0,0,0,0,0,0.139399089543831,53.7399289136799,15.4970313994369
9.7,"random_instances_SVM","SVM",7,22,484,437,47,2300,2094,206,0.830504070673831,0.318840579710145,1.27456755493221,569,206,363,27,1.8,82.61,10.2,0,0,0,0,0,0,0.142408323402117,46.0740918761596,16.7762199783866
9.7,"random_instances_SVM","SVM",7,23,384,347,37,2400,2184,216,0.83909001674462,0.311594202898551,1.27456755493221,593,216,377,24,1.7,86.21,10.1,0,0,0,0,0,0,0.14579634373291,36.7522210069689,17.0490347646513
9.7,"random_instances_SVM","SVM",7,24,284,256,28,2500,2275,225,0.807246376811598,0.217391304347826,1.27456755493221,604,225,379,11,1.7,89.8,10.1,0,0,0,0,0,0,0.134430646964696,27.7327693056411,16.3471116656144
9.7,"random_instances_SVM","SVM",7,25,184,165,19,2600,2366,234,0.80216525203534,0.22463768115942,1.27456755493221,653,234,419,49,1.8,93.39,10.1,0,0,0,0,0,0,0.0849881008387731,17.0403659827664,13.7913697360594
9.7,"random_instances_SVM","SVM",7,26,84,77,7,2700,2454,246,0.832553842600615,0.297101449275362,1.27456755493221,691,246,445,38,1.8,96.98,10,0,0,0,0,0,0,0.000155800780639631,7.08695853144791,7.08695853144791
9.7,"random_instances_SVM","SVM",7,27,0,0,0,2784,2531,253,0.842207979675505,0.355072463768116,1.27456755493221,720,253,467,29,1.8,100,10,0,0,0,0,0,0,0,0,0
9.7,"random_instances_SVM","SVM",8,0,2684,2452,232,100,89,11,0.726598285032022,0.297297297297297,1.17109851787271,30,11,19,0,1.7,3.59,8.1,0,0,0,0,0,0,0.269087920593453,241.128425181546,33.9629128268824
9.7,"random_instances_SVM","SVM",8,1,2584,2365,219,200,176,24,0.710740258330622,0.304054054054054,1.17109851787271,63,24,39,33,1.6,7.18,7.3,0,0,0,0,0,0,0.323534230566056,290.301338009736,39.5026472370456
9.7,"random_instances_SVM","SVM",8,2,2484,2273,211,300,268,32,0.73557473135787,0.22972972972973,1.19712292938099,83,32,51,20,1.6,10.78,8.4,0,0,0,0,0,0,0.176530847238958,257.392313288554,22.7183425019954
9.7,"random_instances_SVM","SVM",8,3,2384,2181,203,400,360,40,0.737501356778466,0.175675675675676,1.24049694856146,106,40,66,23,1.6,14.37,9,0,0,0,0,0,0,0.132675681404228,248.975440850932,15.899549101953
9.7,"random_instances_SVM","SVM",8,4,2284,2093,191,500,448,52,0.755714750895473,0.310810810810811,1.23182214472537,134,52,82,28,1.6,17.96,8.6,0,0,0,0,0,0,0.179685143425614,242.387307734488,23.3830170743884
9.7,"random_instances_SVM","SVM",8,5,2184,2000,184,600,541,59,0.73271464235319,0.304054054054054,1.23182214472537,160,59,101,26,1.7,21.55,9.2,0,0,0,0,0,0,0.154648828088317,222.806114256246,18.6649450293072
9.7,"random_instances_SVM","SVM",8,6,2084,1909,175,700,632,68,0.778524910452625,0.290540540540541,1.25784655623365,188,68,120,28,1.8,25.14,9.3,0,0,0,0,0,0,0.130444711286582,210.444815968068,15.2962824947242
9.7,"random_instances_SVM","SVM",8,7,1984,1819,165,800,722,78,0.77266362748291,0.236486486486486,1.25784655623365,215,78,137,27,1.8,28.74,9.3,0,0,0,0,0,0,0.159632250266745,191.129197069466,24.2789827521133
9.7,"random_instances_SVM","SVM",8,8,1884,1730,154,900,811,89,0.781026809942472,0.222972972972973,1.25784655623365,259,89,170,44,1.9,32.33,9.1,0,0,0,0,0,0,0.141931622544467,183.09947332454,17.9704560254941
9.7,"random_instances_SVM","SVM",8,9,1784,1636,148,1000,905,95,0.7984044285249,0.25,1.26652136006975,261,95,166,2,1.7,35.92,9.5,0,0,0,0,0,0,0.135148493002528,174.556541957115,16.6594141513622
9.7,"random_instances_SVM","SVM",8,10,1684,1550,134,1100,991,109,0.804249430153035,0.27027027027027,1.26652136006975,298,109,189,37,1.7,39.51,9.1,0,0,0,0,0,0,0.159768368918141,161.867601737313,22.5428851411827
9.7,"random_instances_SVM","SVM",8,11,1584,1452,132,1200,1089,111,0.8059589710192,0.236486486486486,1.26652136006975,322,111,211,24,1.9,43.1,9.8,0,0,0,0,0,0,0.146761023845736,146.219268387182,19.4284250272048
9.7,"random_instances_SVM","SVM",8,12,1484,1359,125,1300,1182,118,0.814506675350048,0.277027027027027,1.26652136006975,336,118,218,14,1.8,46.7,10,0,0,0,0,0,0,0.148997944211897,134.048359375772,20.0770139202631
9.7,"random_instances_SVM","SVM",8,13,1384,1269,115,1400,1272,128,0.774194073591659,0.236486486486486,1.25784655623365,383,128,255,47,2,50.29,9.9,0,0,0,0,0,0,0.131368655752141,132.480561281342,16.9965923629156
9.7,"random_instances_SVM","SVM",8,14,1284,1175,109,1500,1366,134,0.759855638771298,0.222972972972973,1.25784655623365,400,134,266,17,2,53.88,10.2,0,0,0,0,0,0,0.13294879566529,123.196767267167,17.45524654244
9.7,"random_instances_SVM","SVM",8,15,1184,1081,103,1600,1460,140,0.789563660045581,0.236486486486486,1.26652136006975,416,140,276,16,2,57.47,10.4,0,0,0,0,0,0,0.121908583270906,107.44087782863,15.6714346037439
9.7,"random_instances_SVM","SVM",8,16,1084,993,91,1700,1548,152,0.745902529035055,0.222972972972973,1.26652136006975,460,152,308,44,2,61.06,10.2,0,0,0,0,0,0,0.106475238384793,98.5362629542732,12.2060958108392
9.7,"random_instances_SVM","SVM",8,17,984,911,73,1800,1630,170,0.740719635297949,0.195945945945946,1.23182214472537,465,170,295,5,1.7,64.66,9.6,0,0,0,0,0,0,0.125040331979948,95.9831081561814,14.6517023119244
9.7,"random_instances_SVM","SVM",8,18,884,815,69,1900,1726,174,0.793351785520458,0.256756756756757,1.22314734088928,488,174,314,23,1.8,68.25,9.9,0,0,0,0,0,0,0.125480654162512,83.6935048279841,14.440613413352
9.7,"random_instances_SVM","SVM",8,19,784,721,63,2000,1820,180,0.729686312818845,0.189189189189189,1.22314734088928,506,180,326,18,1.8,71.84,10.1,0,0,0,0,0,0,0.121621553812924,72.3712526983493,14.2167874242605
9.7,"random_instances_SVM","SVM",8,20,684,631,53,2100,1910,190,0.780218169977208,0.290540540540541,1.26652136006975,527,190,337,21,1.8,75.43,10.1,0,0,0,0,0,0,0.119691140122115,60.0901519868847,14.3614770746747
9.7,"random_instances_SVM","SVM",8,21,584,538,46,2200,2003,197,0.798399001411049,0.277027027027027,1.26652136006975,546,197,349,19,1.8,79.02,10.2,0,0,0,0,0,0,0.120522197210289,52.3628185998915,13.7849957127302
9.7,"random_instances_SVM","SVM",8,22,484,446,38,2300,2095,205,0.739943558015845,0.202702702702703,1.24049694856146,558,205,353,12,1.7,82.61,10.2,0,0,0,0,0,0,0.120579546895962,44.2966362002123,13.8079865172074
9.7,"random_instances_SVM","SVM",8,23,384,351,33,2400,2190,210,0.817741235211113,0.317567567567568,1.27519616390584,583,210,373,25,1.8,86.21,10.4,0,0,0,0,0,0,0.125757066019089,33.1862721974041,16.6570654999358
9.7,"random_instances_SVM","SVM",8,24,284,260,24,2500,2281,219,0.777113860848802,0.216216216216216,1.26652136006975,610,219,391,27,1.8,89.8,10.4,0,0,0,0,0,0,0.109483182730586,24.6354129880626,13.5439773558768
9.7,"random_instances_SVM","SVM",8,25,184,165,19,2600,2376,224,0.787897536090306,0.236486486486486,1.25668831815241,620,224,396,10,1.8,93.39,10.6,0,0,0,0,0,0,0.0900605840328169,15.9210125586897,12.2894460202822
9.7,"random_instances_SVM","SVM",8,26,84,75,9,2700,2466,234,0.82694019320525,0.324324324324324,1.26652136006975,662,234,428,42,1.8,96.98,10.5,0,0,0,0,0,0,0.00495729150912154,6.86099983348573,6.86099983348573
9.7,"random_instances_SVM","SVM",8,27,0,0,0,2784,2541,243,0.774465429284698,0.243243243243243,1.26652136006975,685,243,442,23,1.8,100,10.5,0,0,0,0,0,0,0,0,0
9.7,"random_instances_SVM","SVM",9,0,2684,2439,245,100,95,5,0.380956427163347,0.0354609929078014,0.965179592770533,25,5,20,0,4,3.59,19,0,0,0,0,0,0,0.102036450108841,94.3547580401493,14.0076778099553
9.7,"random_instances_SVM","SVM",9,1,2584,2353,231,200,181,19,0.739214420048493,0.184397163120567,1.24744909631663,61,19,42,36,2.2,7.18,9.5,0,0,0,0,0,0,0.130719934989007,258.704774253362,14.7164236163372
9.7,"random_instances_SVM","SVM",9,2,2484,2268,216,300,266,34,0.777292502209235,0.212765957446809,1.22013269274766,84,34,50,23,1.5,10.78,7.8,0,0,0,0,0,0,0.188728859968387,276.428191447922,21.2694711076486
9.7,"random_instances_SVM","SVM",9,3,2384,2180,204,400,354,46,0.789635873382735,0.276595744680851,1.23834362846031,106,46,60,22,1.3,14.37,7.7,0,0,0,0,0,0,0.276312324851072,249.333877260825,36.4891715851857
9.7,"random_instances_SVM","SVM",9,4,2284,2088,196,500,446,54,0.790145695964472,0.304964539007092,1.24630043232371,126,54,72,20,1.3,17.96,8.3,0,0,0,0,0,0,0.316420953233051,227.198344546578,45.2355830583718
9.7,"random_instances_SVM","SVM",9,5,2184,1995,189,600,539,61,0.780144676319309,0.319148936170213,1.23720334887609,150,61,89,24,1.5,21.55,8.8,0,0,0,0,0,0,0.378135952802837,224.093098516222,55.3711808764341
9.7,"random_instances_SVM","SVM",9,6,2084,1906,178,700,628,72,0.756293476536835,0.333333333333333,1.24744909631663,172,72,100,22,1.4,25.14,8.7,0,0,0,0,0,0,0.249430626563233,199.538327611195,38.0526924578017
9.7,"random_instances_SVM","SVM",9,7,1984,1816,168,800,718,82,0.758978542134004,0.319148936170213,1.22923816060398,190,82,108,18,1.3,28.74,8.8,0,0,0,0,0,0,0.352959024517942,203.89354031684,53.5960795838831
9.7,"random_instances_SVM","SVM",9,8,1884,1723,161,900,811,89,0.77949606870143,0.297872340425532,1.25655456417296,220,89,131,30,1.5,32.33,9.1,0,0,0,0,0,0,0.16144742384951,182.203752290154,21.3438929741402
9.7,"random_instances_SVM","SVM",9,9,1784,1628,156,1000,906,94,0.786469308680582,0.283687943262411,1.27476549988561,247,94,153,27,1.6,35.92,9.6,0,0,0,0,0,0,0.169978977434358,164.877083731589,23.7043565128307
9.7,"random_instances_SVM","SVM",9,10,1684,1537,147,1100,997,103,0.790038066752771,0.26241134751773,1.26566003202928,265,103,162,18,1.6,39.51,9.7,0,0,0,0,0,0,0.19389530480858,164.878127071531,28.266229782326
9.7,"random_instances_SVM","SVM",9,11,1584,1443,141,1200,1091,109,0.796824371785288,0.276595744680851,1.26566003202928,279,109,170,14,1.6,43.1,10,0,0,0,0,0,0,0.172473985816218,148.413112775872,24.7328909492853
9.7,"random_instances_SVM","SVM",9,12,1484,1349,135,1300,1185,115,0.803514376996809,0.26241134751773,1.27476549988561,303,115,188,24,1.6,46.7,10.3,0,0,0,0,0,0,0.165545255572791,135.85523324299,24.0610861884534
9.7,"random_instances_SVM","SVM",9,13,1384,1258,126,1400,1276,124,0.804975868397799,0.312056737588652,1.26566003202928,328,124,204,25,1.6,50.29,10.3,0,0,0,0,0,0,0.166537810222493,125.67635638543,24.969404777845
9.7,"random_instances_SVM","SVM",9,14,1284,1165,119,1500,1369,131,0.788936283506676,0.297872340425532,1.26449459921894,344,131,213,16,1.6,53.88,10.5,0,0,0,0,0,0,0.164319030055963,116.361297394504,25.6964115564793
9.7,"random_instances_SVM","SVM",9,15,1184,1074,110,1600,1460,140,0.790443092470491,0.304964539007092,1.26449459921894,370,140,230,26,1.6,57.47,10.4,0,0,0,0,0,0,0.182757082730692,108.171898148481,29.7439076264199
9.7,"random_instances_SVM","SVM",9,16,1084,986,98,1700,1548,152,0.795872702966038,0.290780141843972,1.26566003202928,399,152,247,29,1.6,61.06,10.2,0,0,0,0,0,0,0.153928361488012,99.4844374037965,23.3069883531783
9.7,"random_instances_SVM","SVM",9,17,984,897,87,1800,1637,163,0.778159200598195,0.24113475177305,1.25655456417296,438,163,275,39,1.7,64.66,10,0,0,0,0,0,0,0.145762039854676,92.8647409865141,20.9559176647954
9.7,"random_instances_SVM","SVM",9,18,884,805,79,1900,1729,171,0.766886456846356,0.24113475177305,1.25655456417296,458,171,287,20,1.7,68.25,10.1,0,0,0,0,0,0,0.164019541221768,84.5078297409483,25.1035032770194
9.7,"random_instances_SVM","SVM",9,19,784,712,72,2000,1822,178,0.812742165726332,0.276595744680851,1.25655456417296,479,178,301,21,1.7,71.84,10.2,0,0,0,0,0,0,0.140934061336608,72.0640703959464,20.8278489166039
9.7,"random_instances_SVM","SVM",9,20,684,623,61,2100,1911,189,0.790848118188207,0.24822695035461,1.25655456417296,494,189,305,15,1.6,75.43,10.1,0,0,0,0,0,0,0.145676272439311,67.2025706249377,21.1873620229216
9.7,"random_instances_SVM","SVM",9,21,584,531,53,2200,2003,197,0.790009743276013,0.219858156028369,1.25655456417296,531,197,334,37,1.7,79.02,10.2,0,0,0,0,0,0,0.142595609067544,56.7264224284443,21.5681447394633
9.7,"random_instances_SVM","SVM",9,22,484,441,43,2300,2093,207,0.791125688260491,0.26241134751773,1.25655456417296,559,207,352,28,1.7,82.61,10.1,0,0,0,0,0,0,0.140041988117315,47.0971470647783,18.7937683364888
9.7,"random_instances_SVM","SVM",9,23,384,351,33,2400,2183,217,0.779156186980269,0.24113475177305,1.25655456417296,590,217,373,31,1.7,86.21,10.1,0,0,0,0,0,0,0.134297469405677,38.1484725331974,18.1863511536474
9.7,"random_instances_SVM","SVM",9,24,284,259,25,2500,2275,225,0.744159699091388,0.191489361702128,1.25655456417296,603,225,378,13,1.7,89.8,10.1,0,0,0,0,0,0,0.126014323062619,27.7583538485067,15.6118457334325
9.7,"random_instances_SVM","SVM",9,25,184,169,15,2600,2365,235,0.795334556907536,0.226950354609929,1.26566003202928,618,235,383,15,1.6,93.39,10.1,0,0,0,0,0,0,0.109261676556113,17.5700819920815,13.9419649862131
9.7,"random_instances_SVM","SVM",9,26,84,78,6,2700,2456,244,0.739169102485674,0.170212765957447,1.25655456417296,660,244,416,42,1.7,96.98,10.1,0,0,0,0,0,0,4.99524080845184e-10,7.94597295751628,7.94597295751628
9.7,"random_instances_SVM","SVM",9,27,0,0,0,2784,2534,250,0.800795323227521,0.26241134751773,1.25655456417296,668,250,418,8,1.7,100,10.1,0,0,0,0,0,0,0,0,0
9.7,"random_instances_SVM","SVM",10,0,2684,2445,239,100,89,11,0.729595767339634,0.163120567375887,1.25655456417296,28,11,17,0,1.5,3.59,8.1,0,0,0,0,0,0,0.127218838944274,294.964904199328,13.0446125902909
9.7,"random_instances_SVM","SVM",10,1,2584,2358,226,200,176,24,0.781705299888978,0.198581560283688,1.25655456417296,68,24,44,40,1.8,7.18,7.3,0,0,0,0,0,0,0.213932659995855,288.226596418789,28.5623730643352
9.7,"random_instances_SVM","SVM",10,2,2484,2267,217,300,267,33,0.775309858835794,0.163120567375887,1.25655456417296,99,33,66,31,2,10.78,8.1,0,0,0,0,0,0,0.207425392261937,254.791238122458,29.2313281833984
9.7,"random_instances_SVM","SVM",10,3,2384,2174,210,400,360,40,0.792564520880067,0.219858156028369,1.25655456417296,116,40,76,17,1.9,14.37,9,0,0,0,0,0,0,0.18814871383587,243.381014857317,24.528258780402
9.7,"random_instances_SVM","SVM",10,4,2284,2083,201,500,451,49,0.792207645072851,0.269503546099291,1.26566003202928,142,49,93,26,1.9,17.96,9.2,0,0,0,0,0,0,0.164320454460988,226.90373890182,19.256648567753
9.7,"random_instances_SVM","SVM",10,5,2184,1987,197,600,547,53,0.790485577685637,0.191489361702128,1.26566003202928,157,53,104,15,2,21.55,10.3,0,0,0,0,0,0,0.166795802003638,186.469127343008,20.4635311068759
9.7,"random_instances_SVM","SVM",10,6,2084,1899,185,700,635,65,0.826025876328375,0.297872340425532,1.26566003202928,183,65,118,26,1.8,25.14,9.8,0,0,0,0,0,0,0.161498504669819,182.62838553887,20.3063964545553
9.7,"random_instances_SVM","SVM",10,7,1984,1807,177,800,727,73,0.818406861079017,0.26241134751773,1.25655456417296,215,73,142,32,1.9,28.74,10,0,0,0,0,0,0,0.161640140293728,177.695018682668,20.1026378177736
9.7,"random_instances_SVM","SVM",10,8,1884,1715,169,900,819,81,0.81835587882084,0.276595744680851,1.25655456417296,225,81,144,10,1.8,32.33,10.1,0,0,0,0,0,0,0.185148549121279,176.6772579914,24.2134902136117
9.7,"random_instances_SVM","SVM",10,9,1784,1628,156,1000,906,94,0.78785715904199,0.198581560283688,1.25655456417296,257,94,163,32,1.7,35.92,9.6,0,0,0,0,0,0,0.166250622184839,173.590201577793,20.1818022720055
9.7,"random_instances_SVM","SVM",10,10,1684,1537,147,1100,997,103,0.804148822876307,0.26241134751773,1.25655456417296,292,103,189,35,1.8,39.51,9.7,0,0,0,0,0,0,0.190000129320983,170.762196998689,23.2819179083897
9.7,"random_instances_SVM","SVM",10,11,1584,1445,139,1200,1089,111,0.781104842181591,0.212765957446809,1.25655456417296,310,111,199,18,1.8,43.1,9.8,0,0,0,0,0,0,0.161010078833816,155.81747972184,19.5069856526819
9.7,"random_instances_SVM","SVM",10,12,1484,1353,131,1300,1181,119,0.808278385788415,0.226950354609929,1.25655456417296,332,119,213,22,1.8,46.7,9.9,0,0,0,0,0,0,0.175186799502441,143.111202067288,21.5114821899533
9.7,"random_instances_SVM","SVM",10,13,1384,1261,123,1400,1273,127,0.809496295289244,0.269503546099291,1.25655456417296,352,127,225,20,1.8,50.29,10,0,0,0,0,0,0,0.17707138585519,128.694638829621,21.2535682504334
9.7,"random_instances_SVM","SVM",10,14,1284,1170,114,1500,1364,136,0.77451680148642,0.184397163120567,1.25655456417296,379,136,243,27,1.8,53.88,10,0,0,0,0,0,0,0.175695865311565,120.551053391197,21.2996770442005
9.7,"random_instances_SVM","SVM",10,15,1184,1076,108,1600,1458,142,0.788440622663314,0.198581560283688,1.25655456417296,412,142,270,33,1.9,57.47,10.3,0,0,0,0,0,0,0.176656217977004,118.175608674184,20.5607624674114
9.7,"random_instances_SVM","SVM",10,16,1084,981,103,1700,1553,147,0.760825232818982,0.212765957446809,1.25655456417296,420,147,273,8,1.9,61.06,10.6,0,0,0,0,0,0,0.162389864216637,101.414608452678,19.0882359283298
9.7,"random_instances_SVM","SVM",10,17,984,892,92,1800,1642,158,0.79710194185757,0.226950354609929,1.25655456417296,435,158,277,15,1.8,64.66,10.4,0,0,0,0,0,0,0.17767101440497,91.682245313528,21.2228042889814
9.7,"random_instances_SVM","SVM",10,18,884,803,81,1900,1731,169,0.819721070400836,0.333333333333333,1.25655456417296,485,169,316,50,1.9,68.25,10.2,0,0,0,0,0,0,0.164983354886993,86.5900038413028,20.9045726007142
9.7,"random_instances_SVM","SVM",10,19,784,714,70,2000,1820,180,0.820378175061747,0.354609929078014,1.26566003202928,496,180,316,11,1.8,71.84,10.1,0,0,0,0,0,0,0.164929722151006,81.7635450453606,19.2962225996873
9.7,"random_instances_SVM","SVM",10,20,684,627,57,2100,1907,193,0.823969591915349,0.361702127659574,1.25655456417296,543,193,350,47,1.8,75.43,9.9,0,0,0,0,0,0,0.165227446108965,67.8562802121469,18.7775254734461
9.7,"random_instances_SVM","SVM",10,21,584,534,50,2200,2000,200,0.76455260236105,0.148936170212766,1.25655456417296,548,200,348,5,1.7,79.02,10,0,0,0,0,0,0,0.143235037229555,57.9093478156535,16.6538973784784
9.7,"random_instances_SVM","SVM",10,22,484,446,38,2300,2088,212,0.772766410622442,0.170212765957447,1.26566003202928,584,212,372,36,1.8,82.61,9.8,0,0,0,0,0,0,0.149550692956683,46.9235021785672,18.4060011265009
9.7,"random_instances_SVM","SVM",10,23,384,357,27,2400,2177,223,0.765147395373082,0.156028368794326,1.26566003202928,615,223,392,31,1.8,86.21,9.8,0,0,0,0,0,0,0.14370697528972,38.773816646701,17.7870553246545
9.7,"random_instances_SVM","SVM",10,24,284,262,22,2500,2272,228,0.726678449233004,0.0921985815602837,1.26566003202928,619,228,391,4,1.7,89.8,10,0,0,0,0,0,0,0.134709885630594,29.2691078133704,17.832973855284
9.7,"random_instances_SVM","SVM",10,25,184,172,12,2600,2362,238,0.770914055242112,0.170212765957447,1.26566003202928,639,238,401,20,1.7,93.39,9.9,0,0,0,0,0,0,0.105248225565578,17.2695305429117,13.5198344031072
9.7,"random_instances_SVM","SVM",10,26,84,79,5,2700,2455,245,0.724457888654753,0.148936170212766,1.26566003202928,647,245,402,8,1.6,96.98,10,0,0,0,0,0,0,0.00482753346018289,8.18972745097145,8.18972745097145
9.7,"random_instances_SVM","SVM",10,27,0,0,0,2784,2534,250,0.836182675095737,0.404255319148936,1.26566003202928,675,250,425,28,1.7,100,10.1,0,0,0,0,0,0,0,0,0
9.7,"random_instances_SVM","SVM",11,0,2684,2444,240,100,88,12,0.753995846385101,0.402877697841727,1.13608725922488,33,12,21,0,1.8,3.59,7.3,0,0,0,0,0,0,0.176985676770523,327.884472399507,18.997685921107
9.7,"random_instances_SVM","SVM",11,1,2584,2357,227,200,175,25,0.76176379470587,0.39568345323741,1.15456022278951,62,25,37,29,1.5,7.18,7,0,0,0,0,0,0,0.218255980295616,318.167208571094,25.7493741204959
9.7,"random_instances_SVM","SVM",11,2,2484,2268,216,300,264,36,0.765567450345943,0.39568345323741,1.20074263170109,90,36,54,28,1.5,10.78,7.3,0,0,0,0,0,0,0.291609989421305,278.263523965062,40.636147000675
9.7,"random_instances_SVM","SVM",11,3,2384,2180,204,400,352,48,0.764729842919928,0.366906474820144,1.13608725922488,126,48,78,36,1.6,14.37,7.3,0,0,0,0,0,0,0.163848305427263,272.851205840056,18.554168026469
9.7,"random_instances_SVM","SVM",11,4,2284,2090,194,500,442,58,0.791051369430772,0.381294964028777,1.23768855883036,158,58,100,32,1.7,17.96,7.6,0,0,0,0,0,0,0.150117423334503,255.826640660977,17.0458176645799
9.7,"random_instances_SVM","SVM",11,5,2184,1997,187,600,535,65,0.809272199465304,0.309352517985612,1.27463448595962,180,65,115,22,1.8,21.55,8.2,0,0,0,0,0,0,0.124892256774008,239.80325743446,13.4306036105176
9.7,"random_instances_SVM","SVM",11,6,2084,1905,179,700,627,73,0.788676236044658,0.244604316546763,1.24692504061267,206,73,133,26,1.8,25.14,8.6,0,0,0,0,0,0,0.157118281020588,227.733859014817,20.5138223434228
9.7,"random_instances_SVM","SVM",11,7,1984,1815,169,800,717,83,0.79451080284099,0.23021582733813,1.2653980041773,228,83,145,22,1.7,28.74,8.6,0,0,0,0,0,0,0.155344813214923,211.010553862124,20.4681862617225
9.7,"random_instances_SVM","SVM",11,8,1884,1727,157,900,805,95,0.801613254850674,0.223021582733813,1.24692504061267,269,95,174,41,1.8,32.33,8.5,0,0,0,0,0,0,0.14136603585772,201.800812268766,17.362977137679
9.7,"random_instances_SVM","SVM",11,9,1784,1635,149,1000,897,103,0.81169322914874,0.258992805755396,1.25616152239499,277,103,174,8,1.7,35.92,8.7,0,0,0,0,0,0,0.167367665060969,174.51940424974,22.9975505609087
9.7,"random_instances_SVM","SVM",11,10,1684,1543,141,1100,989,111,0.819375121912042,0.266187050359712,1.25616152239499,301,111,190,24,1.7,39.51,8.9,0,0,0,0,0,0,0.152044940318863,160.875146452072,20.4541675198197
9.7,"random_instances_SVM","SVM",11,11,1584,1448,136,1200,1084,116,0.828009362844654,0.280575539568345,1.2653980041773,309,116,193,8,1.7,43.1,9.3,0,0,0,0,0,0,0.147782793225223,148.781592005678,19.8453113873109
9.7,"random_instances_SVM","SVM",11,12,1484,1359,125,1300,1173,127,0.798389039964209,0.237410071942446,1.2653980041773,351,127,224,42,1.8,46.7,9.2,0,0,0,0,0,0,0.141645709619186,150.401982866997,17.9398589744494
9.7,"random_instances_SVM","SVM",11,13,1384,1269,115,1400,1263,137,0.791539017589765,0.251798561151079,1.25616152239499,379,137,242,28,1.8,50.29,9.2,0,0,0,0,0,0,0.134099099565055,141.274597142273,16.5549889854124
9.7,"random_instances_SVM","SVM",11,14,1284,1176,108,1500,1356,144,0.810316340229262,0.251798561151079,1.2653980041773,397,144,253,18,1.8,53.88,9.4,0,0,0,0,0,0,0.149899133645567,125.733015098239,21.7469235668877
9.7,"random_instances_SVM","SVM",11,15,1184,1084,100,1600,1448,152,0.804504721581599,0.244604316546763,1.2653980041773,421,152,269,24,1.8,57.47,9.5,0,0,0,0,0,0,0.142968985775077,116.21789442144,19.3509850377801
9.7,"random_instances_SVM","SVM",11,16,1084,991,93,1700,1541,159,0.794407536172024,0.244604316546763,1.23768855883036,425,159,266,4,1.7,61.06,9.7,0,0,0,0,0,0,0.135447519672613,106.122575180194,17.4639511978079
9.7,"random_instances_SVM","SVM",11,17,984,896,88,1800,1636,164,0.818417036705567,0.294964028776978,1.24692504061267,450,164,286,25,1.7,64.66,10,0,0,0,0,0,0,0.145244502668852,97.3783139834385,20.3798610054289
9.7,"random_instances_SVM","SVM",11,18,884,806,78,1900,1726,174,0.793426502816889,0.23021582733813,1.2653980041773,484,174,310,34,1.8,68.25,9.9,0,0,0,0,0,0,0.140188666701971,87.6460509724385,19.2465434121114
9.7,"random_instances_SVM","SVM",11,19,784,713,71,2000,1819,181,0.792416784275932,0.258992805755396,1.24692504061267,505,181,324,21,1.8,71.84,10,0,0,0,0,0,0,0.114180889155223,73.5523875677791,12.8497155452356
9.7,"random_instances_SVM","SVM",11,20,684,621,63,2100,1911,189,0.787362454533985,0.223021582733813,1.25616152239499,520,189,331,15,1.8,75.43,10.1,0,0,0,0,0,0,0.138242585467221,65.9450835007801,17.8651092191087
9.7,"random_instances_SVM","SVM",11,21,584,527,57,2200,2005,195,0.788039424919403,0.237410071942446,1.23768855883036,554,195,359,34,1.8,79.02,10.3,0,0,0,0,0,0,0.120318739633799,53.3505796974814,14.2706399872859
9.7,"random_instances_SVM","SVM",11,22,484,441,43,2300,2091,209,0.74232671279245,0.172661870503597,1.22845207704804,570,209,361,16,1.7,82.61,10,0,0,0,0,0,0,0.130312578858825,48.0494432510529,16.5493012474947
9.7,"random_instances_SVM","SVM",11,23,384,349,35,2400,2183,217,0.765160120707268,0.194244604316547,1.21921559526572,609,217,392,39,1.8,86.21,10.1,0,0,0,0,0,0,0.125075314070927,38.0753849270338,15.1409177414091
9.7,"random_instances_SVM","SVM",11,24,284,256,28,2500,2276,224,0.758814957603303,0.172661870503597,1.22845207704804,607,224,383,-2,1.7,89.8,10.2,0,0,0,0,0,0,0.111688162532634,27.6517834863247,12.7746024525536
9.7,"random_instances_SVM","SVM",11,25,184,167,17,2600,2365,235,0.731655823666432,0.172661870503597,1.22845207704804,649,235,414,42,1.8,93.39,10.1,0,0,0,0,0,0,0.0998475474885998,19.1102419569973,13.7478514995874
9.7,"random_instances_SVM","SVM",11,26,84,78,6,2700,2454,246,0.756170183470456,0.18705035971223,1.21921559526572,673,246,427,24,1.7,96.98,10,0,0,0,0,0,0,0.0228772776003822,8.43030350203236,8.43030350203236
9.7,"random_instances_SVM","SVM",11,27,0,0,0,2784,2532,252,0.810092595779839,0.287769784172662,1.23768855883036,701,252,449,28,1.8,100,10,0,0,0,0,0,0,0,0,0
9.7,"random_instances_SVM","SVM",12,0,2684,2440,244,100,85,15,0.774727849470121,0.356060606060606,1.19633431085044,40,15,25,0,1.7,3.59,5.7,0,0,0,0,0,0,0.249820912546197,383.905119266374,28.1817993338521
9.7,"random_instances_SVM","SVM",12,1,2584,2354,230,200,171,29,0.785058154903515,0.393939393939394,1.19523271387912,68,29,39,28,1.3,7.18,5.9,0,0,0,0,0,0,0.334974569276722,338.707846899745,39.8554926566207
9.7,"random_instances_SVM","SVM",12,2,2484,2265,219,300,260,40,0.767957128781867,0.371212121212121,1.16715542521994,113,40,73,45,1.8,10.78,6.5,0,0,0,0,0,0,0.207625010695147,309.837310011572,23.8949070818295
9.7,"random_instances_SVM","SVM",12,3,2384,2176,208,400,349,51,0.759095715281279,0.242424242424242,1.22551319648094,126,51,75,13,1.5,14.37,6.8,0,0,0,0,0,0,0.198022308377309,287.573950086819,24.9782197044073
9.7,"random_instances_SVM","SVM",12,4,2284,2083,201,500,442,58,0.761955398553337,0.227272727272727,1.20606060606061,153,58,95,27,1.6,17.96,7.6,0,0,0,0,0,0,0.195848058176409,260.780040274176,25.8545298185182
9.7,"random_instances_SVM","SVM",12,5,2184,1986,198,600,539,61,0.763319155071729,0.25,1.20606060606061,164,61,103,11,1.7,21.55,8.8,0,0,0,0,0,0,0.178569762981015,227.099113110065,27.3364941616905
9.7,"random_instances_SVM","SVM",12,6,2084,1897,187,700,628,72,0.765193569317278,0.166666666666667,1.22551319648094,201,72,129,37,1.8,25.14,8.7,0,0,0,0,0,0,0.16690391742546,213.515139085591,26.6103084635807
9.7,"random_instances_SVM","SVM",12,7,1984,1808,176,800,717,83,0.765650157402724,0.166666666666667,1.2352394916911,228,83,145,27,1.7,28.74,8.6,0,0,0,0,0,0,0.188420203161889,216.17336944347,34.2968858343301
9.7,"random_instances_SVM","SVM",12,8,1884,1719,165,900,806,94,0.801834763174968,0.257575757575758,1.22551319648094,244,94,150,16,1.6,32.33,8.6,0,0,0,0,0,0,0.195133767545004,183.830368311089,36.0899252647781
9.7,"random_instances_SVM","SVM",12,9,1784,1630,154,1000,895,105,0.790462115204379,0.242424242424242,1.20606060606061,262,105,157,18,1.5,35.92,8.5,0,0,0,0,0,0,0.170375442397221,170.06291307906,27.0047339425954
9.7,"random_instances_SVM","SVM",12,10,1684,1541,143,1100,984,116,0.802237281618724,0.287878787878788,1.20606060606061,285,116,169,23,1.5,39.51,8.5,0,0,0,0,0,0,0.171937686052965,165.506711686515,26.9883502048229
9.7,"random_instances_SVM","SVM",12,11,1584,1451,133,1200,1074,126,0.798638646576784,0.25,1.23410207042804,317,126,191,32,1.5,43.1,8.5,0,0,0,0,0,0,0.176890792141742,160.879101727912,31.0469846636293
9.7,"random_instances_SVM","SVM",12,12,1484,1360,124,1300,1165,135,0.795226251411812,0.234848484848485,1.22551319648094,336,135,201,19,1.5,46.7,8.6,0,0,0,0,0,0,0.149130193500019,149.14086155486,21.7522019904228
9.7,"random_instances_SVM","SVM",12,13,1384,1270,114,1400,1255,145,0.783306899286276,0.234848484848485,1.20606060606061,366,145,221,30,1.5,50.29,8.7,0,0,0,0,0,0,0.162968378745414,143.846837804328,24.2503642690374
9.7,"random_instances_SVM","SVM",12,14,1284,1175,109,1500,1350,150,0.774890058395208,0.204545454545455,1.20606060606061,373,150,223,7,1.5,53.88,9,0,0,0,0,0,0,0.158088936162698,124.321748574359,24.2946803675424
9.7,"random_instances_SVM","SVM",12,15,1184,1088,96,1600,1437,163,0.783577247494775,0.196969696969697,1.20606060606061,411,163,248,38,1.5,57.47,8.8,0,0,0,0,0,0,0.149480963570885,117.072032402624,20.0769564474139
9.7,"random_instances_SVM","SVM",12,16,1084,994,90,1700,1531,169,0.783006512387955,0.227272727272727,1.20606060606061,424,169,255,13,1.5,61.06,9.1,0,0,0,0,0,0,0.132767322384636,107.396511780959,16.4759001330218
9.7,"random_instances_SVM","SVM",12,17,984,905,79,1800,1620,180,0.760717804532239,0.204545454545455,1.20606060606061,460,180,280,36,1.6,64.66,9,0,0,0,0,0,0,0.163972339207353,100.527568054045,23.253130905989
9.7,"random_instances_SVM","SVM",12,18,884,818,66,1900,1707,193,0.771309446567175,0.212121212121212,1.20606060606061,491,193,298,31,1.5,68.25,8.8,0,0,0,0,0,0,0.148687671300043,94.2136474450095,20.3891621480064
9.7,"random_instances_SVM","SVM",12,19,784,728,56,2000,1797,203,0.78254391656453,0.21969696969697,1.21578690127077,535,203,332,44,1.6,71.84,8.9,0,0,0,0,0,0,0.150259583370816,83.0047503746059,19.8098468350017
9.7,"random_instances_SVM","SVM",12,20,684,633,51,2100,1892,208,0.788245259894736,0.242424242424242,1.24496578690127,552,208,344,17,1.7,75.43,9.1,0,0,0,0,0,0,0.14701456376828,70.241258180663,19.0260209520681
9.7,"random_instances_SVM","SVM",12,21,584,539,45,2200,1986,214,0.774854011967407,0.196969696969697,1.20606060606061,572,214,358,20,1.7,79.02,9.3,0,0,0,0,0,0,0.152141426574641,62.852969356978,20.1599400692652
9.7,"random_instances_SVM","SVM",12,22,484,447,37,2300,2078,222,0.757683896859148,0.159090909090909,1.21578690127077,579,222,357,7,1.6,82.61,9.4,0,0,0,0,0,0,0.150623970267666,49.3682253827786,20.346876479721
9.7,"random_instances_SVM","SVM",12,23,384,353,31,2400,2172,228,0.770894912647487,0.204545454545455,1.20606060606061,602,228,374,23,1.6,86.21,9.5,0,0,0,0,0,0,0.137120029034457,40.4376592342031,18.9545357512483
9.7,"random_instances_SVM","SVM",12,24,284,257,27,2500,2268,232,0.783102636195417,0.234848484848485,1.20606060606061,606,232,374,4,1.6,89.8,9.8,0,0,0,0,0,0,0.125239969580218,28.674554687343,18.0149745519636
9.7,"random_instances_SVM","SVM",12,25,184,169,15,2600,2356,244,0.734049455698937,0.159090909090909,1.22551319648094,633,244,389,27,1.6,93.39,9.7,0,0,0,0,0,0,0.0836870054902222,19.1083714247695,15.9607133546761
9.7,"random_instances_SVM","SVM",12,26,84,77,7,2700,2448,252,0.784123951649719,0.272727272727273,1.2352394916911,682,252,430,49,1.7,96.98,9.7,0,0,0,0,0,0,0.000184271854435736,8.43152824749932,8.43152824749932
9.7,"random_instances_SVM","SVM",12,27,0,0,0,2784,2525,259,0.764785043135552,0.189393939393939,1.2352394916911,695,259,436,13,1.7,100,9.7,0,0,0,0,0,0,0,0,0
9.7,"random_instances_SVM","SVM",13,0,2684,2445,239,100,91,9,0.8194965034965,0.370629370629371,1.24795849311978,22,9,13,0,1.4,3.59,10.1,0,0,0,0,0,0,0.104841394030106,227.475756392162,10.797660394731
9.7,"random_instances_SVM","SVM",13,1,2584,2358,226,200,178,22,0.856268531468525,0.363636363636364,1.28387096774194,55,22,33,33,1.5,7.18,8.1,0,0,0,0,0,0,0.219372167722271,237.59697399508,24.2552709891412
9.7,"random_instances_SVM","SVM",13,2,2484,2267,217,300,269,31,0.834551048951045,0.314685314685315,1.28387096774194,79,31,48,24,1.5,10.78,8.7,0,0,0,0,0,0,0.246165681181194,238.151504237121,28.1956607507477
9.7,"random_instances_SVM","SVM",13,3,2384,2180,204,400,356,44,0.843569230769221,0.34965034965035,1.2748928490864,110,44,66,31,1.5,14.37,8.1,0,0,0,0,0,0,0.219151433309275,270.119568163311,25.8791196918981
9.7,"random_instances_SVM","SVM",13,4,2284,2091,193,500,445,55,0.837499300699302,0.363636363636364,1.26591473043086,136,55,81,26,1.5,17.96,8.1,0,0,0,0,0,0,0.212564915951713,248.168476974872,26.3442314215857
9.7,"random_instances_SVM","SVM",13,5,2184,1996,188,600,540,60,0.817790209790207,0.342657342657343,1.2748928490864,157,60,97,21,1.6,21.55,9,0,0,0,0,0,0,0.171958093278481,233.913977147495,20.2717675578982
9.7,"random_instances_SVM","SVM",13,6,2084,1902,182,700,634,66,0.83475804195804,0.300699300699301,1.2748928490864,175,66,109,18,1.7,25.14,9.6,0,0,0,0,0,0,0.138781939562195,208.456893387465,15.7630862494376
9.7,"random_instances_SVM","SVM",13,7,1984,1810,174,800,726,74,0.840593006993005,0.356643356643357,1.26591473043086,195,74,121,20,1.6,28.74,9.8,0,0,0,0,0,0,0.196182326981357,203.620876686789,25.6142579861796
9.7,"random_instances_SVM","SVM",13,8,1884,1718,166,900,818,82,0.835110489510484,0.377622377622378,1.2748928490864,223,82,141,28,1.7,32.33,10,0,0,0,0,0,0,0.164869363393417,180.246549603489,21.3200052554491
9.7,"random_instances_SVM","SVM",13,9,1784,1626,158,1000,910,90,0.83988811188811,0.34965034965035,1.26591473043086,231,90,141,8,1.6,35.92,10.1,0,0,0,0,0,0,0.142415747966708,166.109619315929,17.9265014212682
9.7,"random_instances_SVM","SVM",13,10,1684,1534,150,1100,1002,98,0.83954685314685,0.356643356643357,1.26591473043086,257,98,159,26,1.6,39.51,10.2,0,0,0,0,0,0,0.157249558784134,155.439809725071,20.9797112086241
9.7,"random_instances_SVM","SVM",13,11,1584,1438,146,1200,1098,102,0.844274125874126,0.384615384615385,1.26591473043086,273,102,171,16,1.7,43.1,10.8,0,0,0,0,0,0,0.169581634668971,147.524730024238,23.7694150354342
9.7,"random_instances_SVM","SVM",13,12,1484,1355,129,1300,1181,119,0.829577622377622,0.342657342657343,1.26591473043086,314,119,195,41,1.6,46.7,9.9,0,0,0,0,0,0,0.122400927656381,132.86507360301,14.1542041823965
9.7,"random_instances_SVM","SVM",13,13,1384,1267,117,1400,1269,131,0.815317482517482,0.335664335664336,1.26591473043086,342,131,211,28,1.6,50.29,9.7,0,0,0,0,0,0,0.161359790300462,131.845182868085,22.0347311634209
9.7,"random_instances_SVM","SVM",13,14,1284,1179,105,1500,1357,143,0.820039160839159,0.356643356643357,1.26591473043086,356,143,213,14,1.5,53.88,9.5,0,0,0,0,0,0,0.166683501558615,120.170750741421,25.8395847965407
9.7,"random_instances_SVM","SVM",13,15,1184,1086,98,1600,1450,150,0.808352447552441,0.342657342657343,1.2748928490864,397,150,247,41,1.6,57.47,9.7,0,0,0,0,0,0,0.16706513848965,117.169153426824,24.7109729257283
9.7,"random_instances_SVM","SVM",13,16,1084,995,89,1700,1541,159,0.803239160839154,0.321678321678322,1.2748928490864,416,159,257,19,1.6,61.06,9.7,0,0,0,0,0,0,0.161199906132416,107.662638740425,24.3941919085327
9.7,"random_instances_SVM","SVM",13,17,984,899,85,1800,1637,163,0.818372027972021,0.328671328671329,1.2748928490864,440,163,277,24,1.7,64.66,10,0,0,0,0,0,0,0.160965086131109,94.8950414504025,25.2441031398059
9.7,"random_instances_SVM","SVM",13,18,884,808,76,1900,1728,172,0.792313286713278,0.258741258741259,1.2748928490864,460,172,288,20,1.7,68.25,10,0,0,0,0,0,0,0.153475493792183,86.3342499078534,22.3061449496282
9.7,"random_instances_SVM","SVM",13,19,784,717,67,2000,1819,181,0.820749650349646,0.307692307692308,1.2748928490864,507,181,326,47,1.8,71.84,10,0,0,0,0,0,0,0.156849831513964,74.5318383214733,20.2528165900978
9.7,"random_instances_SVM","SVM",13,20,684,627,57,2100,1909,191,0.791362237762229,0.293706293706294,1.2748928490864,531,191,340,24,1.8,75.43,10,0,0,0,0,0,0,0.151957232348295,63.3446394050554,19.0778186034761
9.7,"random_instances_SVM","SVM",13,21,584,536,48,2200,2000,200,0.815524475524473,0.27972027972028,1.2748928490864,551,200,351,20,1.8,79.02,10,0,0,0,0,0,0,0.151881829764836,55.0137668459817,18.8974223685122
9.7,"random_instances_SVM","SVM",13,22,484,443,41,2300,2093,207,0.769588811188808,0.223776223776224,1.26591473043086,588,207,381,37,1.8,82.61,10.1,0,0,0,0,0,0,0.152023447876024,47.7834536213284,18.980336045932
9.7,"random_instances_SVM","SVM",13,23,384,356,28,2400,2180,220,0.7931972027972,0.216783216783217,1.2748928490864,622,220,402,34,1.8,86.21,9.9,0,0,0,0,0,0,0.150336392162207,38.3537451255502,18.89981728879
9.7,"random_instances_SVM","SVM",13,24,284,261,23,2500,2275,225,0.813739860139862,0.300699300699301,1.26591473043086,628,225,403,6,1.8,89.8,10.1,0,0,0,0,0,0,0.132967346004825,27.1227050351743,17.6420435849456
9.7,"random_instances_SVM","SVM",13,25,184,167,17,2600,2369,231,0.795714685314681,0.300699300699301,1.2748928490864,653,231,422,25,1.8,93.39,10.3,0,0,0,0,0,0,0.0917159699283202,16.9216848070528,13.3515980551344
9.7,"random_instances_SVM","SVM",13,26,84,77,7,2700,2459,241,0.822058741258741,0.335664335664336,1.28387096774194,663,241,422,10,1.8,96.98,10.2,0,0,0,0,0,0,0.000327074112731848,7.45949235043548,7.45949235043548
9.7,"random_instances_SVM","SVM",13,27,0,0,0,2784,2536,248,0.772710489510488,0.216783216783217,1.26591473043086,664,248,416,1,1.7,100,10.2,0,0,0,0,0,0,0,0,0
9.7,"random_instances_SVM","SVM",14,0,2684,2420,264,100,89,11,0.807550022952494,0.198275862068966,1.27280311457175,30,11,19,0,1.7,3.59,8.1,0,0,0,0,0,0,0.192683186007687,280.969613510639,21.2861307131373
9.7,"random_instances_SVM","SVM",14,1,2584,2334,250,200,175,25,0.85289471552398,0.362068965517241,1.27280311457175,60,25,35,30,1.4,7.18,7,0,0,0,0,0,0,0.21133625007582,294.630786800758,23.3171219489971
9.7,"random_instances_SVM","SVM",14,2,2484,2244,240,300,265,35,0.807313747198445,0.336206896551724,1.23959955506118,83,35,48,23,1.4,10.78,7.6,0,0,0,0,0,0,0.238950798937564,305.366388260032,29.1892378169075
9.7,"random_instances_SVM","SVM",14,3,2384,2157,227,400,352,48,0.793319471822426,0.310344827586207,1.25066740823137,119,48,71,36,1.5,14.37,7.3,0,0,0,0,0,0,0.257743707753999,296.923963404443,30.6473853863073
9.7,"random_instances_SVM","SVM",14,4,2284,2060,224,500,449,51,0.797842464828659,0.232758620689655,1.26173526140156,129,51,78,10,1.5,17.96,8.8,0,0,0,0,0,0,0.213150100198454,239.258479088557,24.8215465804611
9.7,"random_instances_SVM","SVM",14,5,2184,1966,218,600,543,57,0.790355898792963,0.267241379310345,1.27280311457175,142,57,85,13,1.5,21.55,9.5,0,0,0,0,0,0,0.211231524403838,234.196904409001,24.8265855073421
9.7,"random_instances_SVM","SVM",14,6,2084,1871,213,700,638,62,0.801845651175971,0.275862068965517,1.27280311457175,168,62,106,26,1.7,25.14,10.3,0,0,0,0,0,0,0.226608182396989,215.545189268682,28.460929282043
9.7,"random_instances_SVM","SVM",14,7,1984,1777,207,800,732,68,0.803047282153749,0.275862068965517,1.27280311457175,180,68,112,12,1.6,28.74,10.8,0,0,0,0,0,0,0.217058679706062,192.739053563467,29.8121613410642
9.7,"random_instances_SVM","SVM",14,8,1884,1689,195,900,820,80,0.823272486701044,0.318965517241379,1.27280311457175,215,80,135,35,1.7,32.33,10.2,0,0,0,0,0,0,0.252521830838937,188.146936993169,33.5343102156634
9.7,"random_instances_SVM","SVM",14,9,1784,1597,187,1000,912,88,0.808144087705553,0.28448275862069,1.27280311457175,250,88,162,35,1.8,35.92,10.4,0,0,0,0,0,0,0.175327658972636,167.236872691803,21.9179076592915
9.7,"random_instances_SVM","SVM",14,10,1684,1511,173,1100,998,102,0.807543272216664,0.28448275862069,1.27280311457175,273,102,171,23,1.7,39.51,9.8,0,0,0,0,0,0,0.165731122029878,166.575491078156,18.6852830287182
9.7,"random_instances_SVM","SVM",14,11,1584,1426,158,1200,1083,117,0.797504928037153,0.21551724137931,1.27280311457175,320,117,203,47,1.7,43.1,9.3,0,0,0,0,0,0,0.199055000991807,163.308258970993,27.6801955691974
9.7,"random_instances_SVM","SVM",14,12,1484,1334,150,1300,1175,125,0.838400885696534,0.25,1.27280311457175,335,125,210,15,1.7,46.7,9.4,0,0,0,0,0,0,0.189662067591705,151.361394354556,23.5571983851785
9.7,"random_instances_SVM","SVM",14,13,1384,1241,143,1400,1268,132,0.79992169146437,0.232758620689655,1.27280311457175,364,132,232,29,1.8,50.29,9.6,0,0,0,0,0,0,0.191309103282255,137.431011409554,23.8564892780398
9.7,"random_instances_SVM","SVM",14,14,1284,1155,129,1500,1354,146,0.813726946237136,0.267241379310345,1.27280311457175,397,146,251,33,1.7,53.88,9.3,0,0,0,0,0,0,0.203766297802315,132.422772748546,25.9125440910041
9.7,"random_instances_SVM","SVM",14,15,1184,1061,123,1600,1448,152,0.765850727729319,0.21551724137931,1.27280311457175,415,152,263,18,1.7,57.47,9.5,0,0,0,0,0,0,0.182631307489083,119.789764556086,22.1647675653092
9.7,"random_instances_SVM","SVM",14,16,1084,966,118,1700,1543,157,0.807198984689322,0.258620689655172,1.27280311457175,431,157,274,16,1.7,61.06,9.8,0,0,0,0,0,0,0.173944107107198,103.868988836362,20.8701012990979
9.7,"random_instances_SVM","SVM",14,17,984,876,108,1800,1633,167,0.779682985445407,0.189655172413793,1.27280311457175,460,167,293,29,1.8,64.66,9.8,0,0,0,0,0,0,0.165030136732768,95.3394756261399,21.9078064823711
9.7,"random_instances_SVM","SVM",14,18,884,794,90,1900,1715,185,0.79591175438122,0.258620689655172,1.27280311457175,505,185,320,45,1.7,68.25,9.3,0,0,0,0,0,0,0.191795262419196,86.4586343797308,24.3420674850957
9.7,"random_instances_SVM","SVM",14,19,784,702,82,2000,1807,193,0.753976183403985,0.129310344827586,1.27280311457175,527,193,334,22,1.7,71.84,9.4,0,0,0,0,0,0,0.163871176594127,76.4408732969105,21.5402079083398
9.7,"random_instances_SVM","SVM",14,20,684,611,73,2100,1898,202,0.771062295790234,0.137931034482759,1.27280311457175,548,202,346,21,1.7,75.43,9.4,0,0,0,0,0,0,0.175323091515951,71.4380544718192,22.7981769543933
9.7,"random_instances_SVM","SVM",14,21,584,519,65,2200,1990,210,0.754705262873649,0.137931034482759,1.27280311457175,566,210,356,18,1.7,79.02,9.5,0,0,0,0,0,0,0.176504624825985,59.7254230083533,23.7976402153986
9.7,"random_instances_SVM","SVM",14,22,484,429,55,2300,2080,220,0.718595576917879,0.103448275862069,1.27280311457175,591,220,371,25,1.7,82.61,9.5,0,0,0,0,0,0,0.159364149214444,53.1041914828085,20.7765315849804
9.7,"random_instances_SVM","SVM",14,23,384,334,50,2400,2175,225,0.832244214619382,0.293103448275862,1.27280311457175,600,225,375,9,1.7,86.21,9.7,0,0,0,0,0,0,0.141965852712906,38.6097349489762,17.4046300924074
9.7,"random_instances_SVM","SVM",14,24,284,246,38,2500,2263,237,0.759829071368773,0.172413793103448,1.26173526140156,675,237,438,75,1.8,89.8,9.5,0,0,0,0,0,0,0.129895923819299,28.809268942933,15.8912295693695
9.7,"random_instances_SVM","SVM",14,25,184,157,27,2600,2352,248,0.799044095806441,0.21551724137931,1.25066740823137,700,248,452,25,1.8,93.39,9.5,0,0,0,0,0,0,0.0833710670779852,18.1958560599315,15.2613827752415
9.7,"random_instances_SVM","SVM",14,26,84,69,15,2700,2440,260,0.832784273485804,0.25,1.27280311457175,743,260,483,43,1.9,96.98,9.4,0,0,0,0,0,0,1.0000000994736e-07,8.40587926391483,8.40587926391483
9.7,"random_instances_SVM","SVM",14,27,0,0,0,2784,2509,275,0.792185348202947,0.189655172413793,1.26173526140156,745,275,470,2,1.7,100,9.1,0,0,0,0,0,0,0,0,0
9.7,"random_instances_SVM","SVM",15,0,2684,2432,252,100,88,12,0.827126170840029,0.291338582677165,1.2737617475235,34,12,22,0,1.8,3.59,7.3,0,0,0,0,0,0,0.161743916048587,342.932497219046,17.3584365477819
9.7,"random_instances_SVM","SVM",15,1,2584,2346,238,200,174,26,0.784304213158196,0.173228346456693,1.24343408686817,65,26,39,31,1.5,7.18,6.7,0,0,0,0,0,0,0.179707992629899,341.00979070542,24.9073917767099
9.7,"random_instances_SVM","SVM",15,2,2484,2254,230,300,266,34,0.768064833128093,0.251968503937008,1.22321564643129,93,34,59,28,1.7,10.78,7.8,0,0,0,0,0,0,0.237434628180326,300.257180821783,29.1988832490278
9.7,"random_instances_SVM","SVM",15,3,2384,2162,222,400,358,42,0.799716386162635,0.259842519685039,1.2737617475235,106,42,64,13,1.5,14.37,8.5,0,0,0,0,0,0,0.140877605014155,246.960064674611,15.258555532123
9.7,"random_instances_SVM","SVM",15,4,2284,2072,212,500,448,52,0.791910786033264,0.228346456692913,1.28387096774194,136,52,84,30,1.6,17.96,8.6,0,0,0,0,0,0,0.178617211784476,244.200171073809,22.5607999949424
9.7,"random_instances_SVM","SVM",15,5,2184,1977,207,600,543,57,0.793490564864229,0.236220472440945,1.25354330708661,152,57,95,16,1.7,21.55,9.5,0,0,0,0,0,0,0.136595435782867,220.174852070465,15.2914217357718
9.7,"random_instances_SVM","SVM",15,6,2084,1884,200,700,636,64,0.790884551753304,0.220472440944882,1.26365252730505,170,64,106,18,1.7,25.14,9.9,0,0,0,0,0,0,0.17572627202846,203.445282992874,21.3352121959581
9.7,"random_instances_SVM","SVM",15,7,1984,1794,190,800,726,74,0.806147454317023,0.267716535433071,1.26365252730505,191,74,117,21,1.6,28.74,9.8,0,0,0,0,0,0,0.156481320780207,184.484587727212,17.9316638778531
9.7,"random_instances_SVM","SVM",15,8,1884,1704,180,900,816,84,0.790007587914071,0.259842519685039,1.2737617475235,215,84,131,24,1.6,32.33,9.7,0,0,0,0,0,0,0.191799352978902,170.554630880448,24.8259016289875
9.7,"random_instances_SVM","SVM",15,9,1784,1608,176,1000,912,88,0.822635618414999,0.244094488188976,1.25354330708661,237,88,149,22,1.7,35.92,10.4,0,0,0,0,0,0,0.154716793160291,156.552566012597,18.8016967264814
9.7,"random_instances_SVM","SVM",15,10,1684,1517,167,1100,1003,97,0.813872199624338,0.259842519685039,1.25354330708661,258,97,161,21,1.7,39.51,10.3,0,0,0,0,0,0,0.146617176137242,160.292499148906,16.1388406601285
9.7,"random_instances_SVM","SVM",15,11,1584,1424,160,1200,1096,104,0.793179584779405,0.181102362204724,1.2737617475235,303,104,199,45,1.9,43.1,10.5,0,0,0,0,0,0,0.173291140486141,157.533220444738,22.3230205825437
9.7,"random_instances_SVM","SVM",15,12,1484,1336,148,1300,1184,116,0.807273202224134,0.21259842519685,1.28387096774194,323,116,207,20,1.8,46.7,10.2,0,0,0,0,0,0,0.14742245983,141.680433586067,16.7646235151251
9.7,"random_instances_SVM","SVM",15,13,1384,1243,141,1400,1277,123,0.790455399236233,0.244094488188976,1.26365252730505,361,123,238,38,1.9,50.29,10.4,0,0,0,0,0,0,0.142922179767876,135.325970879507,15.4867581894947
9.7,"random_instances_SVM","SVM",15,14,1284,1155,129,1500,1365,135,0.788427809083111,0.188976377952756,1.2737617475235,385,135,250,24,1.9,53.88,10.1,0,0,0,0,0,0,0.173316119934129,126.248918515654,20.1920891186159
9.7,"random_instances_SVM","SVM",15,15,1184,1064,120,1600,1456,144,0.781517831598071,0.21259842519685,1.2737617475235,427,144,283,42,2,57.47,10.1,0,0,0,0,0,0,0.146785393465902,111.927715536576,16.9678702881446
9.7,"random_instances_SVM","SVM",15,16,1084,970,114,1700,1550,150,0.725889714022721,0.15748031496063,1.2737617475235,456,150,306,29,2,61.06,10.3,0,0,0,0,0,0,0.15012140450048,102.364352509927,17.2505252111962
9.7,"random_instances_SVM","SVM",15,17,984,880,104,1800,1640,160,0.803398390367082,0.291338582677165,1.2737617475235,473,160,313,17,2,64.66,10.2,0,0,0,0,0,0,0.195725997828377,99.0723157480382,22.6706190928132
9.7,"random_instances_SVM","SVM",15,18,884,794,90,1900,1726,174,0.738422211441579,0.149606299212598,1.2737617475235,491,174,317,18,1.8,68.25,9.9,0,0,0,0,0,0,0.172341202933939,91.9649364853056,20.494647253841
9.7,"random_instances_SVM","SVM",15,19,784,704,80,2000,1816,184,0.775307559303906,0.220472440944882,1.27258885456997,527,184,343,36,1.9,71.84,9.9,0,0,0,0,0,0,0.175617734753203,78.5853397669082,21.6482189626964
9.7,"random_instances_SVM","SVM",15,20,684,612,72,2100,1908,192,0.770185717306667,0.21259842519685,1.2737617475235,544,192,352,17,1.8,75.43,9.9,0,0,0,0,0,0,0.143942224640475,67.8098959385512,16.2276621374129
9.7,"random_instances_SVM","SVM",15,21,584,521,63,2200,1999,201,0.764099837046442,0.196850393700787,1.27258885456997,566,201,365,22,1.8,79.02,9.9,0,0,0,0,0,0,0.148377461640108,56.9299382333542,16.7305283965485
9.7,"random_instances_SVM","SVM",15,22,484,432,52,2300,2088,212,0.805432200121908,0.21259842519685,1.27258885456997,598,212,386,32,1.8,82.61,9.8,0,0,0,0,0,0,0.164686050615555,46.2181241298643,19.3047077263918
9.7,"random_instances_SVM","SVM",15,23,384,344,40,2400,2176,224,0.803218021917882,0.220472440944882,1.2737617475235,622,224,398,24,1.8,86.21,9.7,0,0,0,0,0,0,0.152653785724385,39.2676178283799,18.0282830823196
9.7,"random_instances_SVM","SVM",15,24,284,258,26,2500,2262,238,0.796581706907501,0.188976377952756,1.2737617475235,660,238,422,38,1.8,89.8,9.5,0,0,0,0,0,0,0.127870621992481,28.5877545839193,18.6701726852978
9.7,"random_instances_SVM","SVM",15,25,184,169,15,2600,2351,249,0.792607381423296,0.236220472440945,1.28387096774194,713,249,464,53,1.9,93.39,9.4,0,0,0,0,0,0,0.0890006550074106,18.890929425694,15.9827005339807
9.7,"random_instances_SVM","SVM",15,26,84,76,8,2700,2444,256,0.839185978529943,0.299212598425197,1.28387096774194,718,256,462,5,1.8,96.98,9.5,0,0,0,0,0,0,2.59190525719906e-07,8.86228731865165,8.86228731865165
9.7,"random_instances_SVM","SVM",15,27,0,0,0,2784,2520,264,0.730653928922398,0.125984251968504,1.2737617475235,756,264,492,38,1.9,100,9.5,0,0,0,0,0,0,0,0,0
9.7,"random_instances_SVM","SVM",16,0,2684,2427,257,100,93,7,0.863193641079226,0.291338582677165,1.28387096774194,19,7,12,0,1.7,3.59,13.3,0,0,0,0,0,0,0.136914011540247,212.745548522229,14.4964889186559
9.7,"random_instances_SVM","SVM",16,1,2584,2341,243,200,179,21,0.852035675635334,0.338582677165354,1.28387096774194,55,21,34,36,1.6,7.18,8.5,0,0,0,0,0,0,0.163893732067084,315.881454167124,17.3401502466705
9.7,"random_instances_SVM","SVM",16,2,2484,2253,231,300,267,33,0.800095781866131,0.149606299212598,1.28387096774194,86,33,53,31,1.6,10.78,8.1,0,0,0,0,0,0,0.252403257771564,283.549906245492,31.272225457076
9.7,"random_instances_SVM","SVM",16,3,2384,2159,225,400,361,39,0.830416340137581,0.322834645669291,1.28387096774194,110,39,71,24,1.8,14.37,9.3,0,0,0,0,0,0,0.176286289016065,245.427921057172,20.8830701164804
9.7,"random_instances_SVM","SVM",16,4,2284,2071,213,500,449,51,0.840062942369176,0.299212598425197,1.28387096774194,141,51,90,31,1.8,17.96,8.8,0,0,0,0,0,0,0.2294803952034,228.595459650406,29.6290831002582
9.7,"random_instances_SVM","SVM",16,5,2184,1978,206,600,542,58,0.816795412421792,0.307086614173228,1.28387096774194,169,58,111,28,1.9,21.55,9.3,0,0,0,0,0,0,0.212492057143039,226.21630681003,28.7593842847444
9.7,"random_instances_SVM","SVM",16,6,2084,1885,199,700,635,65,0.843042131581898,0.354330708661417,1.28387096774194,186,65,121,17,1.9,25.14,9.8,0,0,0,0,0,0,0.214903070051232,220.125899492931,28.982181564712
9.7,"random_instances_SVM","SVM",16,7,1984,1794,190,800,726,74,0.819463621549682,0.259842519685039,1.2737617475235,206,74,132,20,1.8,28.74,9.8,0,0,0,0,0,0,0.174792724869309,188.060667818531,23.3893736246591
9.7,"random_instances_SVM","SVM",16,8,1884,1705,179,900,815,85,0.794970830068044,0.173228346456693,1.28387096774194,237,85,152,31,1.8,32.33,9.6,0,0,0,0,0,0,0.209023827647721,188.784426441331,29.1208895988541
9.7,"random_instances_SVM","SVM",16,9,1784,1616,168,1000,904,96,0.806533069622223,0.236220472440945,1.28387096774194,251,96,155,14,1.6,35.92,9.4,0,0,0,0,0,0,0.221378671927378,182.565081508434,34.4567838681761
9.7,"random_instances_SVM","SVM",16,10,1684,1522,162,1100,998,102,0.817093953303231,0.21259842519685,1.28387096774194,266,102,164,15,1.6,39.51,9.8,0,0,0,0,0,0,0.212825242120933,168.22629625356,35.558554875703
9.7,"random_instances_SVM","SVM",16,11,1584,1430,154,1200,1090,110,0.831672699680315,0.267716535433071,1.28387096774194,298,110,188,32,1.7,43.1,9.9,0,0,0,0,0,0,0.199039280457858,145.468268757225,29.2132037197128
9.7,"random_instances_SVM","SVM",16,12,1484,1342,142,1300,1178,122,0.831274645171728,0.251968503937008,1.28387096774194,326,122,204,28,1.7,46.7,9.7,0,0,0,0,0,0,0.185417274170964,136.279918117476,25.4710160952367
9.7,"random_instances_SVM","SVM",16,13,1384,1254,130,1400,1266,134,0.821771093779157,0.228346456692913,1.28387096774194,357,134,223,31,1.7,50.29,9.4,0,0,0,0,0,0,0.201513692158936,141.107557583782,24.778962432126
9.7,"random_instances_SVM","SVM",16,14,1284,1163,121,1500,1357,143,0.810619347936964,0.244094488188976,1.2737617475235,407,143,264,50,1.8,53.88,9.5,0,0,0,0,0,0,0.171543733671227,131.98334851765,23.11843784699
9.7,"random_instances_SVM","SVM",16,15,1184,1071,113,1600,1449,151,0.819053127837697,0.228346456692913,1.28387096774194,426,151,275,19,1.8,57.47,9.6,0,0,0,0,0,0,0.164603918298554,117.510219633593,21.1725482854046
9.7,"random_instances_SVM","SVM",16,16,1084,981,103,1700,1539,161,0.782090034954164,0.133858267716535,1.2737617475235,447,161,286,21,1.8,61.06,9.6,0,0,0,0,0,0,0.164705464951401,109.321966593761,21.0445162899163
9.7,"random_instances_SVM","SVM",16,17,984,886,98,1800,1634,166,0.83546043711361,0.291338582677165,1.28387096774194,477,166,311,30,1.9,64.66,9.8,0,0,0,0,0,0,0.161890800168194,97.4666961585466,18.7744051671686
9.7,"random_instances_SVM","SVM",16,18,884,798,86,1900,1722,178,0.782892363573044,0.173228346456693,1.2737617475235,504,178,326,27,1.8,68.25,9.7,0,0,0,0,0,0,0.163198852560703,93.3374662672161,20.6514257651662
9.7,"random_instances_SVM","SVM",16,19,784,709,75,2000,1811,189,0.741606647510298,0.118110236220472,1.2737617475235,535,189,346,31,1.8,71.84,9.6,0,0,0,0,0,0,0.149650302474792,83.7458789395319,18.2608147791774
9.7,"random_instances_SVM","SVM",16,20,684,619,65,2100,1901,199,0.789080867261267,0.21259842519685,1.2737617475235,553,199,354,18,1.8,75.43,9.6,0,0,0,0,0,0,0.158436188729557,71.6979914499209,19.7161548444745
9.7,"random_instances_SVM","SVM",16,21,584,526,58,2200,1994,206,0.790530034456596,0.181102362204724,1.2737617475235,572,206,366,19,1.8,79.02,9.7,0,0,0,0,0,0,0.141174248832947,58.0883420350761,17.3089491352973
9.7,"random_instances_SVM","SVM",16,22,484,432,52,2300,2088,212,0.817647497854245,0.173228346456693,1.28387096774194,591,212,379,19,1.8,82.61,9.8,0,0,0,0,0,0,0.128165492999756,45.2181847486163,15.7606235845957
9.7,"random_instances_SVM","SVM",16,23,384,353,31,2400,2167,233,0.816957122065905,0.244094488188976,1.28387096774194,632,233,399,41,1.7,86.21,9.3,0,0,0,0,0,0,0.133379870862537,38.891175969986,16.9649681260441
9.7,"random_instances_SVM","SVM",16,24,284,264,20,2500,2256,244,0.786058140836663,0.165354330708661,1.28387096774194,664,244,420,32,1.7,89.8,9.2,0,0,0,0,0,0,0.120732096155535,28.5011968489212,14.9737849075282
9.7,"random_instances_SVM","SVM",16,25,184,171,13,2600,2349,251,0.792607381423298,0.181102362204724,1.28387096774194,686,251,435,22,1.7,93.39,9.4,0,0,0,0,0,0,0.0807504671020538,17.8620177412496,14.4881546535797
9.7,"random_instances_SVM","SVM",16,26,84,78,6,2700,2442,258,0.79966040974736,0.173228346456693,1.26365252730505,691,258,433,5,1.7,96.98,9.5,0,0,0,0,0,0,2.65606961577843e-06,8.47359930724975,8.47359930724975
9.7,"random_instances_SVM","SVM",16,27,0,0,0,2784,2520,264,0.798889179136968,0.21259842519685,1.28387096774194,737,264,473,46,1.8,100,9.5,0,0,0,0,0,0,0,0,0
9.7,"random_instances_SVM","SVM",17,0,2684,2431,253,100,92,8,0.636701382544614,0.215384615384615,1.0863523573201,28,8,20,0,2.5,3.59,11.5,0,0,0,0,0,0,0.135437630161132,215.42530165862,17.1118446789687
9.7,"random_instances_SVM","SVM",17,1,2584,2345,239,200,178,22,0.766002801632259,0.246153846153846,1.24436724565757,59,22,37,31,1.7,7.18,8.1,0,0,0,0,0,0,0.1875895908807,255.317703018601,22.4403307834965
9.7,"random_instances_SVM","SVM",17,2,2484,2260,224,300,263,37,0.802308301358185,0.292307692307692,1.24436724565757,89,37,52,30,1.4,10.78,7.1,0,0,0,0,0,0,0.261436865684548,271.622965222214,32.3617566146211
9.7,"random_instances_SVM","SVM",17,3,2384,2167,217,400,356,44,0.803502040319145,0.323076923076923,1.24436724565757,108,44,64,19,1.5,14.37,8.1,0,0,0,0,0,0,0.208962622212499,246.893376660027,26.5269562876465
9.7,"random_instances_SVM","SVM",17,4,2284,2073,211,500,450,50,0.803654302941717,0.253846153846154,1.24436724565757,122,50,72,14,1.4,17.96,9,0,0,0,0,0,0,0.22287524843335,218.849178869627,30.310658488347
9.7,"random_instances_SVM","SVM",17,5,2184,1978,206,600,545,55,0.800261891710826,0.207692307692308,1.24436724565757,138,55,83,16,1.5,21.55,9.9,0,0,0,0,0,0,0.225005379977606,216.026613663255,31.1027245878781
9.7,"random_instances_SVM","SVM",17,6,2084,1886,198,700,637,63,0.811023813874173,0.261538461538462,1.26411910669975,160,63,97,22,1.5,25.14,10.1,0,0,0,0,0,0,0.21883408414198,177.582621821028,29.978387339519
9.7,"random_instances_SVM","SVM",17,7,1984,1805,179,800,718,82,0.79969547475486,0.284615384615385,1.25424317617866,192,82,110,32,1.3,28.74,8.8,0,0,0,0,0,0,0.238902500071641,211.129201660191,33.3331607071636
9.7,"random_instances_SVM","SVM",17,8,1884,1716,168,900,807,93,0.803441135270117,0.284615384615385,1.25424317617866,223,93,130,31,1.4,32.33,8.7,0,0,0,0,0,0,0.236783426450008,186.525402122599,33.2684522559665
9.7,"random_instances_SVM","SVM",17,9,1784,1630,154,1000,893,107,0.799451854558746,0.269230769230769,1.25424317617866,250,107,143,27,1.3,35.92,8.3,0,0,0,0,0,0,0.238164495253381,197.369000539076,32.4330962548267
9.7,"random_instances_SVM","SVM",17,10,1684,1538,146,1100,985,115,0.799116876789089,0.261538461538462,1.24436724565757,286,115,171,36,1.5,39.51,8.6,0,0,0,0,0,0,0.223673592586256,170.057810260716,31.5797545229586
9.7,"random_instances_SVM","SVM",17,11,1584,1446,138,1200,1077,123,0.795553931420918,0.253846153846154,1.26411910669975,310,123,187,24,1.5,43.1,8.8,0,0,0,0,0,0,0.222494009778321,168.285484090577,30.9006596216111
9.7,"random_instances_SVM","SVM",17,12,1484,1357,127,1300,1166,134,0.79325781107254,0.230769230769231,1.27399503722084,345,134,211,35,1.6,46.7,8.7,0,0,0,0,0,0,0.225351837186539,154.15367990271,30.367776055104
9.7,"random_instances_SVM","SVM",17,13,1384,1265,119,1400,1258,142,0.816560082830869,0.276923076923077,1.26411910669975,371,142,229,26,1.6,50.29,8.9,0,0,0,0,0,0,0.210886452979691,148.407881800582,30.4261361370502
9.7,"random_instances_SVM","SVM",17,14,1284,1170,114,1500,1353,147,0.812522078080277,0.253846153846154,1.22461538461538,391,147,244,20,1.7,53.88,9.2,0,0,0,0,0,0,0.17366809827825,128.224299349735,24.2816163016375
9.7,"random_instances_SVM","SVM",17,15,1184,1076,108,1600,1447,153,0.811121261952619,0.246153846153846,1.22461538461538,397,153,244,6,1.6,57.47,9.5,0,0,0,0,0,0,0.167181340462247,112.630048021702,24.0882458542155
9.7,"random_instances_SVM","SVM",17,16,1084,983,101,1700,1540,160,0.803940556672151,0.246153846153846,1.22461538461538,433,160,273,36,1.7,61.06,9.6,0,0,0,0,0,0,0.168939383762143,104.410696150464,24.6250364834037
9.7,"random_instances_SVM","SVM",17,17,984,894,90,1800,1629,171,0.805030757049763,0.253846153846154,1.22461538461538,455,171,284,22,1.7,64.66,9.5,0,0,0,0,0,0,0.142806975568973,94.0215822210495,15.9725173947196
9.7,"random_instances_SVM","SVM",17,18,884,802,82,1900,1721,179,0.806876180035328,0.192307692307692,1.25424317617866,484,179,305,29,1.7,68.25,9.6,0,0,0,0,0,0,0.185379025217084,85.866079305454,23.2103946661669
9.7,"random_instances_SVM","SVM",17,19,784,713,71,2000,1810,190,0.80730860588343,0.2,1.26411910669975,506,190,316,22,1.7,71.84,9.5,0,0,0,0,0,0,0.173650805347858,70.4200254243606,22.3953875096335
9.7,"random_instances_SVM","SVM",17,20,684,623,61,2100,1900,200,0.813965527742252,0.269230769230769,1.26411910669975,530,200,330,24,1.6,75.43,9.5,0,0,0,0,0,0,0.188538715645095,59.0406390036241,22.7475385780583
9.7,"random_instances_SVM","SVM",17,21,584,528,56,2200,1995,205,0.798355563676231,0.2,1.26411910669975,549,205,344,19,1.7,79.02,9.7,0,0,0,0,0,0,0.173471570634435,55.5363922404875,20.8081198227092
9.7,"random_instances_SVM","SVM",17,22,484,435,49,2300,2088,212,0.8147085693404,0.230769230769231,1.26411910669975,569,212,357,20,1.7,82.61,9.8,0,0,0,0,0,0,0.168096024138616,45.3567525706647,19.2183684602746
9.7,"random_instances_SVM","SVM",17,23,384,345,39,2400,2178,222,0.788421950179672,0.192307692307692,1.26411910669975,580,222,358,11,1.6,86.21,9.8,0,0,0,0,0,0,0.155163403196332,34.9100651699975,20.5037168973963
9.7,"random_instances_SVM","SVM",17,24,284,256,28,2500,2267,233,0.808709422011087,0.253846153846154,1.26411910669975,618,233,385,38,1.7,89.8,9.7,0,0,0,0,0,0,0.131088234936743,26.2781989345523,17.8126610696934
9.7,"random_instances_SVM","SVM",17,25,184,168,16,2600,2355,245,0.789280711370975,0.223076923076923,1.26411910669975,651,245,406,33,1.7,93.39,9.6,0,0,0,0,0,0,0.0876260913210268,18.3271165485368,15.9369215897621
9.7,"random_instances_SVM","SVM",17,26,84,76,8,2700,2447,253,0.823783421645657,0.284615384615385,1.26411910669975,665,253,412,14,1.6,96.98,9.7,0,0,0,0,0,0,0.00275606579800198,8.82755587893909,8.82755587893909
9.7,"random_instances_SVM","SVM",17,27,0,0,0,2784,2523,261,0.779943967354896,0.153846153846154,1.26411910669975,701,261,440,36,1.7,100,9.7,0,0,0,0,0,0,0,0,0
9.7,"random_instances_SVM","SVM",18,0,2684,2431,253,100,92,8,0.773378403069616,0.238461538461538,1.28387096774194,25,8,17,0,2.1,3.59,11.5,0,0,0,0,0,0,0.121809788316647,197.373894645677,14.6894910163861
9.7,"random_instances_SVM","SVM",18,1,2584,2345,239,200,178,22,0.810524392472137,0.207692307692308,1.28387096774194,53,22,31,28,1.4,7.18,8.1,0,0,0,0,0,0,0.224931377633581,270.903968251726,25.7006795804245
9.7,"random_instances_SVM","SVM",18,2,2484,2250,234,300,273,27,0.840355685486328,0.284615384615385,1.28387096774194,74,27,47,21,1.7,10.78,10.1,0,0,0,0,0,0,0.201528748566798,210.724697146489,28.6873302099248
9.7,"random_instances_SVM","SVM",18,3,2384,2157,227,400,366,34,0.837980388574214,0.269230769230769,1.28387096774194,93,34,59,19,1.7,14.37,10.8,0,0,0,0,0,0,0.179288636679608,199.339875225367,24.2016381765023
9.7,"random_instances_SVM","SVM",18,4,2284,2068,216,500,455,45,0.816292100615143,0.246153846153846,1.28387096774194,119,45,74,26,1.6,17.96,10.1,0,0,0,0,0,0,0.146084285250387,208.28626129672,18.1197113940983
9.7,"random_instances_SVM","SVM",18,5,2184,1974,210,600,549,51,0.809921432486755,0.176923076923077,1.28387096774194,140,51,89,21,1.7,21.55,10.8,0,0,0,0,0,0,0.185079900164236,197.162552962397,25.8176696224319
9.7,"random_instances_SVM","SVM",18,6,2084,1881,203,700,642,58,0.816480906267131,0.207692307692308,1.28387096774194,161,58,103,21,1.8,25.14,11.1,0,0,0,0,0,0,0.194731309647148,190.709912730417,30.2218718714735
9.7,"random_instances_SVM","SVM",18,7,1984,1785,199,800,738,62,0.807357329922652,0.176923076923077,1.28387096774194,175,62,113,14,1.8,28.74,11.9,0,0,0,0,0,0,0.171450007531079,159.292889257671,27.3219631392157
9.7,"random_instances_SVM","SVM",18,8,1884,1698,186,900,825,75,0.790864242645717,0.230769230769231,1.28387096774194,202,75,127,27,1.7,32.33,11,0,0,0,0,0,0,0.15938514904026,167.266036245171,21.6805076020932
9.7,"random_instances_SVM","SVM",18,9,1784,1612,172,1000,911,89,0.807125890736344,0.192307692307692,1.27399503722084,220,89,131,18,1.5,35.92,10.2,0,0,0,0,0,0,0.178889063839531,155.155086980611,28.3756206925133
9.7,"random_instances_SVM","SVM",18,10,1684,1521,163,1100,1002,98,0.804774955843841,0.2,1.28387096774194,245,98,147,25,1.5,39.51,10.2,0,0,0,0,0,0,0.179618085996494,150.969154801468,26.7181149473662
9.7,"random_instances_SVM","SVM",18,11,1584,1432,152,1200,1091,109,0.813179852609783,0.223076923076923,1.27399503722084,264,109,155,19,1.4,43.1,10,0,0,0,0,0,0,0.157384343121137,140.066314553971,22.9961665897785
9.7,"random_instances_SVM","SVM",18,12,1484,1351,133,1300,1172,128,0.802417930446436,0.184615384615385,1.28387096774194,304,128,176,40,1.4,46.7,9.2,0,0,0,0,0,0,0.186037801188729,146.506230850302,29.1939541905659
9.7,"random_instances_SVM","SVM",18,13,1384,1259,125,1400,1264,136,0.805451001888058,0.169230769230769,1.28387096774194,324,136,188,20,1.4,50.29,9.3,0,0,0,0,0,0,0.176698928023967,131.183379900744,26.5494756263792
9.7,"random_instances_SVM","SVM",18,14,1284,1171,113,1500,1352,148,0.788616846336563,0.138461538461538,1.26411910669975,357,148,209,33,1.4,53.88,9.1,0,0,0,0,0,0,0.153017716979566,130.717996379491,19.1196734598488
9.7,"random_instances_SVM","SVM",18,15,1184,1079,105,1600,1444,156,0.791065229307512,0.176923076923077,1.26411910669975,381,156,225,24,1.4,57.47,9.3,0,0,0,0,0,0,0.146870889437269,114.622454007613,18.2647540393682
9.7,"random_instances_SVM","SVM",18,16,1084,985,99,1700,1538,162,0.810110238138744,0.207692307692308,1.26411910669975,414,162,252,33,1.6,61.06,9.5,0,0,0,0,0,0,0.153772654640326,105.565338582997,18.3648216753933
9.7,"random_instances_SVM","SVM",18,17,984,894,90,1800,1629,171,0.818320238747794,0.223076923076923,1.25424317617866,445,171,274,31,1.6,64.66,9.5,0,0,0,0,0,0,0.138874446033669,96.8967044416565,16.0654140782437
9.7,"random_instances_SVM","SVM",18,18,884,803,81,1900,1720,180,0.80756440708935,0.2,1.25424317617866,464,180,284,19,1.6,68.25,9.6,0,0,0,0,0,0,0.160103002028348,86.1985104585436,19.5203200080563
9.7,"random_instances_SVM","SVM",18,19,784,708,76,2000,1815,185,0.792392959376334,0.146153846153846,1.25424317617866,476,185,291,12,1.6,71.84,9.8,0,0,0,0,0,0,0.150737153658045,82.1665007209985,18.6879551482427
9.7,"random_instances_SVM","SVM",18,20,684,615,69,2100,1908,192,0.815719593154274,0.176923076923077,1.26411910669975,496,192,304,20,1.6,75.43,9.9,0,0,0,0,0,0,0.164553336589797,63.6776530633033,18.7748839047016
9.7,"random_instances_SVM","SVM",18,21,584,524,60,2200,1999,201,0.802201717522384,0.2,1.27282192945176,547,201,346,51,1.7,79.02,9.9,0,0,0,0,0,0,0.14251068037101,54.6177501469138,16.618959552613
9.7,"random_instances_SVM","SVM",18,22,484,436,48,2300,2087,213,0.826560691881359,0.269230769230769,1.26411910669975,570,213,357,23,1.7,82.61,9.8,0,0,0,0,0,0,0.151227745902782,45.0995034433506,18.4402896527082
9.7,"random_instances_SVM","SVM",18,23,384,345,39,2400,2178,222,0.795480845362083,0.192307692307692,1.27399503722084,606,222,384,36,1.7,86.21,9.8,0,0,0,0,0,0,0.127275934807099,37.095754600789,14.4060412439503
9.7,"random_instances_SVM","SVM",18,24,284,252,32,2500,2271,229,0.847980997624705,0.292307692307692,1.28387096774194,620,229,391,14,1.7,89.8,9.9,0,0,0,0,0,0,0.115875486741212,26.71241359033,15.4916816235212
9.7,"random_instances_SVM","SVM",18,25,184,168,16,2600,2355,245,0.821889274620869,0.269230769230769,1.26411910669975,650,245,405,30,1.7,93.39,9.6,0,0,0,0,0,0,0.0833548270366375,17.6692282273979,14.5223334209045
9.7,"random_instances_SVM","SVM",18,26,84,74,10,2700,2449,251,0.809458554114138,0.176923076923077,1.26411910669975,678,251,427,28,1.7,96.98,9.8,0,0,0,0,0,0,1.86251420288257e-05,7.64046085578041,7.64046085578041
9.7,"random_instances_SVM","SVM",18,27,0,0,0,2784,2523,261,0.81415433339424,0.276923076923077,1.27399503722084,719,261,458,41,1.8,100,9.7,0,0,0,0,0,0,0,0,0
9.7,"random_instances_SVM","SVM",19,0,2684,2402,282,100,95,5,0.539699826937997,0.0961538461538462,1.03697270471464,29,5,24,0,4.8,3.59,19,0,0,0,0,0,0,0.0664652664963044,149.2360632263,7.84466165408695
9.7,"random_instances_SVM","SVM",19,1,2584,2316,268,200,181,19,0.744300889180646,0.240384615384615,1.19635394531803,49,19,30,20,1.6,7.18,9.5,0,0,0,0,0,0,0.389905462878063,274.250699203432,44.4454722094972
9.7,"random_instances_SVM","SVM",19,2,2484,2230,254,300,267,33,0.765381631556965,0.230769230769231,1.22214640198511,74,33,41,25,1.2,10.78,8.1,0,0,0,0,0,0,0.281334864492865,275.28446936774,29.6717446747733
9.7,"random_instances_SVM","SVM",19,3,2384,2142,242,400,355,45,0.786365399534525,0.25,1.24683622828784,122,45,77,48,1.7,14.37,7.9,0,0,0,0,0,0,0.154651396141421,257.643932523912,16.7370342283046
9.7,"random_instances_SVM","SVM",19,4,2284,2053,231,500,444,56,0.777630244077103,0.230769230769231,1.24683622828784,146,56,90,24,1.6,17.96,7.9,0,0,0,0,0,0,0.298517870587282,254.029580264004,35.8050471562308
9.7,"random_instances_SVM","SVM",19,5,2184,1967,217,600,530,70,0.797278749179447,0.201923076923077,1.24683622828784,173,70,103,27,1.5,21.55,7.6,0,0,0,0,0,0,0.278969688969363,264.981441888566,32.195318405144
9.7,"random_instances_SVM","SVM",19,6,2084,1877,207,700,620,80,0.79392940263771,0.211538461538462,1.24683622828784,193,80,113,20,1.4,25.14,7.8,0,0,0,0,0,0,0.146536615719333,234.967850304769,15.4194186444234
9.7,"random_instances_SVM","SVM",19,7,1984,1791,193,800,706,94,0.790915736707052,0.230769230769231,1.25918114143921,217,94,123,24,1.3,28.74,7.5,0,0,0,0,0,0,0.255295074681079,227.710580229603,30.0798397337271
9.7,"random_instances_SVM","SVM",19,8,1884,1706,178,900,791,109,0.785492629945697,0.230769230769231,1.24683622828784,248,109,139,31,1.3,32.33,7.3,0,0,0,0,0,0,0.289799041456843,218.318717709111,32.7566038256882
9.7,"random_instances_SVM","SVM",19,9,1784,1617,167,1000,880,120,0.800889180640931,0.259615384615385,1.2277021786646,274,120,154,26,1.3,35.92,7.3,0,0,0,0,0,0,0.3913637645593,216.907484360064,45.3067326905975
9.7,"random_instances_SVM","SVM",19,10,1684,1525,159,1100,972,128,0.821209046965451,0.240384615384615,1.25918114143921,316,128,188,42,1.5,39.51,7.6,0,0,0,0,0,0,0.300339977521401,199.273958182081,38.1879809912244
9.7,"random_instances_SVM","SVM",19,11,1584,1429,155,1200,1068,132,0.806371963955365,0.240384615384615,1.25918114143921,335,132,203,19,1.5,43.1,8.1,0,0,0,0,0,0,0.116140542602922,169.229058794245,11.8473569038168
9.7,"random_instances_SVM","SVM",19,12,1484,1336,148,1300,1161,139,0.772102703347856,0.182692307692308,1.24683622828784,359,139,220,24,1.6,46.7,8.4,0,0,0,0,0,0,0.138466035159552,159.605623691818,14.981908887812
9.7,"random_instances_SVM","SVM",19,13,1384,1245,139,1400,1252,148,0.785529927791371,0.240384615384615,1.25918114143921,387,148,239,28,1.6,50.29,8.5,0,0,0,0,0,0,0.145182786553866,144.129814091414,16.003581158443
9.7,"random_instances_SVM","SVM",19,14,1284,1158,126,1500,1339,161,0.781912036760765,0.221153846153846,1.23449131513648,422,161,261,35,1.6,53.88,8.3,0,0,0,0,0,0,0.181725495868747,141.298766914855,22.3556943257194
9.7,"random_instances_SVM","SVM",19,15,1184,1066,118,1600,1431,169,0.783396491018684,0.221153846153846,1.25918114143921,478,169,309,56,1.8,57.47,8.5,0,0,0,0,0,0,0.165489040266041,126.441682144472,19.9021283329671
9.7,"random_instances_SVM","SVM",19,16,1084,975,109,1700,1522,178,0.821313480933345,0.259615384615385,1.25918114143921,493,178,315,15,1.8,61.06,8.6,0,0,0,0,0,0,0.19701202768288,117.303847295706,25.3707037716001
9.7,"random_instances_SVM","SVM",19,17,984,888,96,1800,1609,191,0.747381691233519,0.201923076923077,1.24683622828784,541,191,350,48,1.8,64.66,8.4,0,0,0,0,0,0,0.15877470192267,107.377685077284,19.0298511889967
9.7,"random_instances_SVM","SVM",19,18,884,796,88,1900,1701,199,0.741600525153666,0.163461538461538,1.25918114143921,558,199,359,17,1.8,68.25,8.5,0,0,0,0,0,0,0.163184839328428,95.3708476395896,18.9081996757579
9.7,"random_instances_SVM","SVM",19,19,784,708,76,2000,1789,211,0.80617801515785,0.192307692307692,1.25918114143921,586,211,375,28,1.8,71.84,8.5,0,0,0,0,0,0,0.160649370574428,81.5895339545826,18.4870148991918
9.7,"random_instances_SVM","SVM",19,20,684,621,63,2100,1876,224,0.765724771737189,0.192307692307692,1.24683622828784,629,224,405,43,1.8,75.43,8.4,0,0,0,0,0,0,0.168631227347158,72.4322296344947,20.0685763299223
9.7,"random_instances_SVM","SVM",19,21,584,534,50,2200,1963,237,0.783821686459393,0.192307692307692,1.25918114143921,633,237,396,4,1.7,79.02,8.3,0,0,0,0,0,0,0.140525693802258,64.5050403636606,16.1799083076641
9.7,"random_instances_SVM","SVM",19,22,484,441,43,2300,2056,244,0.772706928447817,0.211538461538462,1.25918114143921,671,244,427,38,1.8,82.61,8.4,0,0,0,0,0,0,0.140195976139064,51.018684719591,16.3361846488445
9.7,"random_instances_SVM","SVM",19,23,384,348,36,2400,2149,251,0.724920928567169,0.153846153846154,1.25918114143921,680,251,429,9,1.7,86.21,8.6,0,0,0,0,0,0,0.130631076136037,39.8361717331402,14.3373449130136
9.7,"random_instances_SVM","SVM",19,24,284,261,23,2500,2236,264,0.715618845855466,0.134615384615385,1.25918114143921,725,264,461,45,1.7,89.8,8.5,0,0,0,0,0,0,0.134018727066426,31.2332065629241,16.7809604076635
9.7,"random_instances_SVM","SVM",19,25,184,172,12,2600,2325,275,0.762800620636157,0.153846153846154,1.27152605459057,739,275,464,14,1.7,93.39,8.5,0,0,0,0,0,0,0.1063980472065,18.9532791506899,14.186822962398
9.7,"random_instances_SVM","SVM",19,26,84,81,3,2700,2416,284,0.74450975711643,0.173076923076923,1.27152605459057,781,284,497,42,1.8,96.98,8.5,0,0,0,0,0,0,0.00629835511429972,8.78131844860273,8.78131844860273
9.7,"random_instances_SVM","SVM",19,27,0,0,0,2784,2497,287,0.759704899445009,0.153846153846154,1.27152605459057,796,287,509,15,1.8,100,8.7,0,0,0,0,0,0,0,0,0
9.7,"random_instances_SVM","SVM",20,0,2684,2422,262,100,87,13,0.765702211541051,0.224137931034483,1.23959955506118,35,13,22,0,1.7,3.59,6.7,0,0,0,0,0,0,0.174472292659374,339.95836062059,23.2259032970569
9.7,"random_instances_SVM","SVM",20,1,2584,2336,248,200,173,27,0.731536737504381,0.163793103448276,1.23959955506118,68,27,41,33,1.5,7.18,6.4,0,0,0,0,0,0,0.190561226363413,327.907816726793,29.2432435855974
9.7,"random_instances_SVM","SVM",20,2,2484,2250,234,300,259,41,0.768854805173763,0.258620689655172,1.22853170189099,100,41,59,32,1.4,10.78,6.3,0,0,0,0,0,0,0.271045572289447,326.963463548217,43.3194941269815
9.7,"random_instances_SVM","SVM",20,3,2384,2158,226,400,351,49,0.789390543569248,0.258620689655172,1.27280311457175,121,49,72,21,1.5,14.37,7.2,0,0,0,0,0,0,0.208303226809718,293.213482811582,30.180558203989
9.7,"random_instances_SVM","SVM",20,4,2284,2070,214,500,439,61,0.780506575216693,0.327586206896552,1.22853170189099,161,61,100,40,1.6,17.96,7.2,0,0,0,0,0,0,0.230921115669862,272.32607283603,31.7661412437577
9.7,"random_instances_SVM","SVM",20,5,2184,1977,207,600,532,68,0.74691491372559,0.318965517241379,1.22853170189099,191,68,123,30,1.8,21.55,7.8,0,0,0,0,0,0,0.1533626696634,249.59206109264,19.9335491410985
9.7,"random_instances_SVM","SVM",20,6,2084,1889,195,700,620,80,0.742952231793266,0.301724137931034,1.2174638487208,214,80,134,23,1.7,25.14,7.8,0,0,0,0,0,0,0.151196155835484,244.578327901794,19.9306698604698
9.7,"random_instances_SVM","SVM",20,7,1984,1803,181,800,706,94,0.74617233278427,0.301724137931034,1.19532814238042,249,94,155,35,1.6,28.74,7.5,0,0,0,0,0,0,0.158484596528832,237.404232496772,20.8877989374734
9.7,"random_instances_SVM","SVM",20,8,1884,1712,172,900,797,103,0.783922447546779,0.310344827586207,1.23959955506118,286,103,183,37,1.8,32.33,7.7,0,0,0,0,0,0,0.165715182290973,219.813774222467,20.56230789949
9.7,"random_instances_SVM","SVM",20,9,1784,1617,167,1000,892,108,0.779061917749032,0.310344827586207,1.22853170189099,285,108,177,-1,1.6,35.92,8.3,0,0,0,0,0,0,0.176370568653714,192.713005295517,24.9101316741569
9.7,"random_instances_SVM","SVM",20,10,1684,1534,150,1100,975,125,0.776645154321817,0.28448275862069,1.22853170189099,342,125,217,57,1.7,39.51,7.8,0,0,0,0,0,0,0.13184393514731,192.915543280364,14.3667828522166
9.7,"random_instances_SVM","SVM",20,11,1584,1440,144,1200,1069,131,0.77019820160397,0.267241379310345,1.2174638487208,345,131,214,3,1.6,43.1,8.2,0,0,0,0,0,0,0.158775482354564,171.958197634775,21.3614051831704
9.7,"random_instances_SVM","SVM",20,12,1484,1352,132,1300,1157,143,0.776611400642666,0.301724137931034,1.23959955506118,381,143,238,36,1.7,46.7,8.1,0,0,0,0,0,0,0.161810061071163,165.994726229537,21.5773151394788
9.7,"random_instances_SVM","SVM",20,13,1384,1263,121,1400,1246,154,0.771629357599979,0.275862068965517,1.23959955506118,422,154,268,41,1.7,50.29,8.1,0,0,0,0,0,0,0.166380828568621,147.434250639148,22.3997557713364
9.7,"random_instances_SVM","SVM",20,14,1284,1173,111,1500,1336,164,0.777225717603217,0.232758620689655,1.25066740823137,454,164,290,32,1.8,53.88,8.1,0,0,0,0,0,0,0.160066691875717,138.791507268851,19.8725851447762
9.7,"random_instances_SVM","SVM",20,15,1184,1085,99,1600,1424,176,0.792414873221175,0.21551724137931,1.27280311457175,470,176,294,16,1.7,57.47,8.1,0,0,0,0,0,0,0.172492062489029,122.024173025366,23.1675047448958
9.7,"random_instances_SVM","SVM",20,16,1084,990,94,1700,1519,181,0.788202414063125,0.258620689655172,1.26173526140156,500,181,319,30,1.8,61.06,8.4,0,0,0,0,0,0,0.164751390572893,112.202439157084,21.0063391876838
9.7,"random_instances_SVM","SVM",20,17,984,899,85,1800,1610,190,0.771595603920818,0.224137931034483,1.26173526140156,507,190,317,7,1.7,64.66,8.5,0,0,0,0,0,0,0.173016831393805,100.396186783145,23.283467061502
9.7,"random_instances_SVM","SVM",20,18,884,807,77,1900,1702,198,0.795135419760752,0.21551724137931,1.26173526140156,533,198,335,26,1.7,68.25,8.6,0,0,0,0,0,0,0.169308293987413,89.4665683236689,22.2829417388728
9.7,"random_instances_SVM","SVM",20,19,784,715,69,2000,1794,206,0.755555855588254,0.181034482758621,1.26173526140156,569,206,363,36,1.8,71.84,8.7,0,0,0,0,0,0,0.159656782162192,76.7215076419195,20.8978677186866
9.7,"random_instances_SVM","SVM",20,20,684,622,62,2100,1887,213,0.795986012475363,0.21551724137931,1.25066740823137,592,213,379,23,1.8,75.43,8.9,0,0,0,0,0,0,0.17286938711391,66.5333913084857,21.8699622221945
9.7,"random_instances_SVM","SVM",20,21,584,530,54,2200,1979,221,0.78764885372505,0.189655172413793,1.27280311457175,612,221,391,20,1.8,79.02,9,0,0,0,0,0,0,0.149034837187548,57.3722615875778,19.1223692947842
9.7,"random_instances_SVM","SVM",20,22,484,435,49,2300,2074,226,0.791793805524798,0.163793103448276,1.27280311457175,626,226,400,14,1.8,82.61,9.2,0,0,0,0,0,0,0.143753937795372,46.3692139743617,17.5403205187556
9.7,"random_instances_SVM","SVM",20,23,384,344,40,2400,2165,235,0.758593686711843,0.129310344827586,1.26173526140156,650,235,415,24,1.8,86.21,9.2,0,0,0,0,0,0,0.142929506425813,37.9504359861616,16.7616670421983
9.7,"random_instances_SVM","SVM",20,24,284,258,26,2500,2251,249,0.766309777765771,0.172413793103448,1.27280311457175,682,249,433,32,1.7,89.8,9,0,0,0,0,0,0,0.127335182886959,28.240436053367,17.0660704755723
9.7,"random_instances_SVM","SVM",20,25,184,164,20,2600,2345,255,0.765958739502599,0.155172413793103,1.27280311457175,682,255,427,0,1.7,93.39,9.2,0,0,0,0,0,0,0.0903345126289702,18.362700574694,14.368442041708
9.7,"random_instances_SVM","SVM",20,26,84,77,7,2700,2432,268,0.714578889098907,0.0775862068965517,1.27280311457175,714,268,446,32,1.7,96.98,9.1,0,0,0,0,0,0,3.52590599504064e-09,8.89985265651661,8.89985265651661
9.7,"random_instances_SVM","SVM",20,27,0,0,0,2784,2509,275,0.786778008802954,0.172413793103448,1.27280311457175,723,275,448,9,1.6,100,9.1,0,0,0,0,0,0,0,0,0
9.7,"random_instances_SVM","SVM",21,0,2684,2427,257,100,88,12,0.748416762327329,0.163934426229508,1.27334743521946,31,12,19,0,1.6,3.59,7.3,0,0,0,0,0,0,0.235434060533499,337.705542630389,27.4013953029033
9.7,"random_instances_SVM","SVM",21,1,2584,2341,243,200,174,26,0.825192503643701,0.270491803278689,1.27334743521946,58,26,32,27,1.2,7.18,6.7,0,0,0,0,0,0,0.229190046930979,308.182101421062,24.7242939611839
9.7,"random_instances_SVM","SVM",21,2,2484,2249,235,300,266,34,0.819936541512421,0.30327868852459,1.27334743521946,88,34,54,30,1.6,10.78,7.8,0,0,0,0,0,0,0.173713897781803,278.650242724997,19.4986256313592
9.7,"random_instances_SVM","SVM",21,3,2384,2158,226,400,357,43,0.832737872592893,0.295081967213115,1.27334743521946,111,43,68,23,1.6,14.37,8.3,0,0,0,0,0,0,0.221395082730955,255.774028171634,27.247695568522
9.7,"random_instances_SVM","SVM",21,4,2284,2069,215,500,446,54,0.819820458913212,0.237704918032787,1.26282390269699,143,54,89,32,1.6,17.96,8.3,0,0,0,0,0,0,0.184102114616486,252.070768589053,21.3869128291276
9.7,"random_instances_SVM","SVM",21,5,2184,1984,200,600,531,69,0.823077220724613,0.204918032786885,1.26282390269699,180,69,111,37,1.6,21.55,7.7,0,0,0,0,0,0,0.295703497629977,254.841514471419,39.5572455330381
9.7,"random_instances_SVM","SVM",21,6,2084,1892,192,700,623,77,0.822400072229178,0.204918032786885,1.26282390269699,191,77,114,11,1.5,25.14,8.1,0,0,0,0,0,0,0.288945801666246,227.000572072324,42.1307312168001
9.7,"random_instances_SVM","SVM",21,7,1984,1808,176,800,707,93,0.816054223471908,0.221311475409836,1.26282390269699,228,93,135,37,1.5,28.74,7.6,0,0,0,0,0,0,0.330998668915628,229.480412312058,49.3260444533419
9.7,"random_instances_SVM","SVM",21,8,1884,1724,160,900,791,109,0.827101417497514,0.270491803278689,1.26282390269699,255,109,146,27,1.3,32.33,7.3,0,0,0,0,0,0,0.239581021178469,218.656256064282,34.4623985793185
9.7,"random_instances_SVM","SVM",21,9,1784,1636,148,1000,879,121,0.829861603745599,0.262295081967213,1.26282390269699,272,121,151,17,1.2,35.92,7.3,0,0,0,0,0,0,0.28817134557224,213.218836274096,43.4780090943803
9.7,"random_instances_SVM","SVM",21,10,1684,1549,135,1100,966,134,0.835685080806392,0.278688524590164,1.27334743521946,308,134,174,36,1.3,39.51,7.2,0,0,0,0,0,0,0.225394883634837,196.681509772911,32.8295897537807
9.7,"random_instances_SVM","SVM",21,11,1584,1455,129,1200,1060,140,0.824496008048394,0.254098360655738,1.26282390269699,328,140,188,20,1.3,43.1,7.6,0,0,0,0,0,0,0.27924904995289,198.853932977995,42.3210891423174
9.7,"random_instances_SVM","SVM",21,12,1484,1360,124,1300,1155,145,0.826959538765137,0.262295081967213,1.26282390269699,347,145,202,19,1.4,46.7,8,0,0,0,0,0,0,0.209116946268713,170.715342935409,30.3659380502048
9.7,"random_instances_SVM","SVM",21,13,1384,1264,120,1400,1251,149,0.840180057009457,0.278688524590164,1.27334743521946,359,149,210,12,1.4,50.29,8.4,0,0,0,0,0,0,0.177700684231312,155.15510029002,24.5196641509583
9.7,"random_instances_SVM","SVM",21,14,1284,1173,111,1500,1342,158,0.834356579948663,0.262295081967213,1.26282390269699,395,158,237,36,1.5,53.88,8.5,0,0,0,0,0,0,0.158520093225731,144.896188580357,20.5906433717094
9.7,"random_instances_SVM","SVM",21,15,1184,1081,103,1600,1434,166,0.833892249551797,0.286885245901639,1.28387096774194,419,166,253,24,1.5,57.47,8.6,0,0,0,0,0,0,0.179038145115865,128.496207508701,23.4433190390505
9.7,"random_instances_SVM","SVM",21,16,1084,988,96,1700,1527,173,0.828223549289966,0.278688524590164,1.26282390269699,436,173,263,17,1.5,61.06,8.8,0,0,0,0,0,0,0.17311687056713,123.256337024869,21.2009901090597
9.7,"random_instances_SVM","SVM",21,17,984,896,88,1800,1619,181,0.808876449420234,0.237704918032787,1.25230037017451,466,181,285,30,1.6,64.66,8.9,0,0,0,0,0,0,0.161083567198586,104.641549507431,20.6481787003107
9.7,"random_instances_SVM","SVM",21,18,884,804,80,1900,1711,189,0.825895448272299,0.30327868852459,1.27334743521946,491,189,302,25,1.6,68.25,9.1,0,0,0,0,0,0,0.17067402730271,93.2744253489656,22.879444704661
9.7,"random_instances_SVM","SVM",21,19,784,716,68,2000,1799,201,0.807870400227006,0.229508196721311,1.28387096774194,532,201,331,41,1.6,71.84,9,0,0,0,0,0,0,0.159048387512764,82.783305115187,21.28875693728
9.7,"random_instances_SVM","SVM",21,20,684,622,62,2100,1893,207,0.82123924623699,0.278688524590164,1.28268876611418,546,207,339,14,1.6,75.43,9.1,0,0,0,0,0,0,0.154389395777243,68.9306774746507,22.1541196208977
9.7,"random_instances_SVM","SVM",21,21,584,530,54,2200,1985,215,0.799899395080682,0.204918032786885,1.26282390269699,561,215,346,15,1.6,79.02,9.2,0,0,0,0,0,0,0.147911032829086,59.0645900346496,18.5903830352758
9.7,"random_instances_SVM","SVM",21,22,484,436,48,2300,2079,221,0.804226696418202,0.204918032786885,1.27334743521946,579,221,358,18,1.6,82.61,9.4,0,0,0,0,0,0,0.143571216131729,48.1341028256301,18.4284628518142
9.7,"random_instances_SVM","SVM",21,23,384,343,41,2400,2172,228,0.802640234228887,0.213114754098361,1.27334743521946,604,228,376,25,1.6,86.21,9.5,0,0,0,0,0,0,0.14085164473241,39.9346623094056,19.0169482881306
9.7,"random_instances_SVM","SVM",21,24,284,256,28,2500,2259,241,0.785582541177077,0.229508196721311,1.26282390269699,655,241,414,51,1.7,89.8,9.4,0,0,0,0,0,0,0.129194922928742,28.9166608502405,16.7457845954127
9.7,"random_instances_SVM","SVM",21,25,184,169,15,2600,2346,254,0.798280687724908,0.245901639344262,1.27334743521946,668,254,414,13,1.6,93.39,9.2,0,0,0,0,0,0,0.0998444252372204,19.2121274759989,15.0823246452262
9.7,"random_instances_SVM","SVM",21,26,84,76,8,2700,2439,261,0.802175903832019,0.237704918032787,1.28387096774194,680,261,419,12,1.6,96.98,9.3,0,0,0,0,0,0,2.04740474901825e-06,9.64220509342183,9.64220509342183
9.7,"random_instances_SVM","SVM",21,27,0,0,0,2784,2515,269,0.785840502508674,0.163934426229508,1.28387096774194,746,269,477,66,1.8,100,9.3,0,0,0,0,0,0,0,0,0
9.7,"random_instances_SVM","SVM",22,0,2684,2424,260,100,93,7,0.604743384427669,0.193548387096774,1.10785639958377,24,7,17,0,2.4,3.59,13.3,0,0,0,0,0,0,0.0892993244461188,198.282328035358,9.20064411196073
9.7,"random_instances_SVM","SVM",22,1,2584,2338,246,200,179,21,0.784291669844178,0.185483870967742,1.27351716961498,65,21,44,41,2.1,7.18,8.5,0,0,0,0,0,0,0.19926915510423,304.702503990219,25.0325599514497
9.7,"random_instances_SVM","SVM",22,2,2484,2253,231,300,264,36,0.836212155875851,0.346774193548387,1.28387096774194,90,36,54,25,1.5,10.78,7.3,0,0,0,0,0,0,0.216383506735284,286.846666738074,25.0675389370171
9.7,"random_instances_SVM","SVM",22,3,2384,2165,219,400,352,48,0.805943211571217,0.306451612903226,1.28387096774194,117,48,69,27,1.4,14.37,7.3,0,0,0,0,0,0,0.209777905613188,294.699519063493,25.1048202273358
9.7,"random_instances_SVM","SVM",22,4,2284,2072,212,500,445,55,0.809457535778746,0.282258064516129,1.27351716961498,136,55,81,19,1.5,17.96,8.1,0,0,0,0,0,0,0.189551978566117,254.688427304474,22.9324783733143
9.7,"random_instances_SVM","SVM",22,5,2184,1977,207,600,540,60,0.808434378098073,0.282258064516129,1.27351716961498,162,60,102,26,1.7,21.55,9,0,0,0,0,0,0,0.162448584739657,210.370542846666,19.4389210750721
9.7,"random_instances_SVM","SVM",22,6,2084,1886,198,700,631,69,0.796112000813444,0.241935483870968,1.28387096774194,177,69,108,15,1.6,25.14,9.1,0,0,0,0,0,0,0.153970449335711,200.49648605144,19.5222301800899
9.7,"random_instances_SVM","SVM",22,7,1984,1797,187,800,720,80,0.805733496021762,0.282258064516129,1.28387096774194,201,80,121,24,1.5,28.74,9,0,0,0,0,0,0,0.26072853793276,213.064928063575,36.8999033240316
9.7,"random_instances_SVM","SVM",22,8,1884,1705,179,900,812,88,0.791987595007499,0.274193548387097,1.27351716961498,239,88,151,38,1.7,32.33,9.2,0,0,0,0,0,0,0.193563246911625,203.479054422738,25.5505458057304
9.7,"random_instances_SVM","SVM",22,9,1784,1615,169,1000,902,98,0.789985764762705,0.225806451612903,1.27351716961498,271,98,173,32,1.8,35.92,9.2,0,0,0,0,0,0,0.192718785082704,182.493367358906,26.5327853208274
9.7,"random_instances_SVM","SVM",22,10,1684,1522,162,1100,995,105,0.816060398078243,0.298387096774194,1.27351716961498,293,105,188,22,1.8,39.51,9.5,0,0,0,0,0,0,0.194969518708459,179.286384900454,25.8760604465312
9.7,"random_instances_SVM","SVM",22,11,1584,1427,157,1200,1090,110,0.812889244769823,0.241935483870968,1.27351716961498,309,110,199,16,1.8,43.1,9.9,0,0,0,0,0,0,0.192189052456308,150.322315033343,24.5880378560292
9.7,"random_instances_SVM","SVM",22,12,1484,1340,144,1300,1177,123,0.824194819390428,0.298387096774194,1.27351716961498,343,123,220,34,1.8,46.7,9.6,0,0,0,0,0,0,0.220061054828087,150.182200398838,26.9118945949581
9.7,"random_instances_SVM","SVM",22,13,1384,1247,137,1400,1270,130,0.789648948880252,0.137096774193548,1.27351716961498,361,130,231,18,1.8,50.29,9.8,0,0,0,0,0,0,0.208045493811339,128.975528969316,27.040011041286
9.7,"random_instances_SVM","SVM",22,14,1284,1155,129,1500,1362,138,0.778756450341902,0.185483870967742,1.26316337148803,412,138,274,51,2,53.88,9.9,0,0,0,0,0,0,0.182445763114285,122.075205208977,21.2188084209206
9.7,"random_instances_SVM","SVM",22,15,1184,1068,116,1600,1449,151,0.759316454409115,0.185483870967742,1.26316337148803,441,151,290,29,1.9,57.47,9.6,0,0,0,0,0,0,0.188116727960502,124.4441946133,22.5655383111619
9.7,"random_instances_SVM","SVM",22,16,1084,978,106,1700,1539,161,0.734150588474546,0.120967741935484,1.27351716961498,468,161,307,27,1.9,61.06,9.6,0,0,0,0,0,0,0.177239501035697,106.914165728502,22.2390579069871
9.7,"random_instances_SVM","SVM",22,17,984,887,97,1800,1630,170,0.720074226594475,0.104838709677419,1.26316337148803,515,170,345,47,2,64.66,9.6,0,0,0,0,0,0,0.160881678616752,97.3346911830304,19.5518967321691
9.7,"random_instances_SVM","SVM",22,18,884,800,84,1900,1717,183,0.753482549124284,0.112903225806452,1.26316337148803,541,183,358,26,2,68.25,9.4,0,0,0,0,0,0,0.173405093151378,93.4359763622801,20.844812478891
9.7,"random_instances_SVM","SVM",22,19,784,713,71,2000,1804,196,0.708336510841662,0.0725806451612903,1.26316337148803,570,196,374,29,1.9,71.84,9.2,0,0,0,0,0,0,0.166386324791193,77.1940383570636,20.2250810713626
9.7,"random_instances_SVM","SVM",22,20,684,624,60,2100,1893,207,0.810448918376173,0.201612903225806,1.26316337148803,595,207,388,25,1.9,75.43,9.1,0,0,0,0,0,0,0.165736476792987,67.615515914254,18.6673422508522
9.7,"random_instances_SVM","SVM",22,21,584,536,48,2200,1981,219,0.807659066066758,0.185483870967742,1.27351716961498,607,219,388,12,1.8,79.02,9,0,0,0,0,0,0,0.174664631754921,61.1350586141419,21.4245385511179
9.7,"random_instances_SVM","SVM",22,22,484,447,37,2300,2070,230,0.833943414931753,0.258064516129032,1.27351716961498,624,230,394,17,1.7,82.61,9,0,0,0,0,0,0,0.161399702288325,49.6845304857024,19.3570377378995
9.7,"random_instances_SVM","SVM",22,23,384,356,28,2400,2161,239,0.813556521518089,0.217741935483871,1.27351716961498,668,239,429,44,1.8,86.21,9,0,0,0,0,0,0,0.148467790924667,38.8579959454972,17.7339425297426
9.7,"random_instances_SVM","SVM",22,24,284,264,20,2500,2253,247,0.789598108747051,0.169354838709677,1.27351716961498,675,247,428,7,1.7,89.8,9.1,0,0,0,0,0,0,0.137562624903417,30.2593589527455,16.9838253270491
9.7,"random_instances_SVM","SVM",22,25,184,168,16,2600,2349,251,0.788072904751016,0.169354838709677,1.27351716961498,690,251,439,15,1.7,93.39,9.4,0,0,0,0,0,0,0.099468760834662,19.0766167984708,15.7634658416779
9.7,"random_instances_SVM","SVM",22,26,84,73,11,2700,2444,256,0.78309692671395,0.161290322580645,1.27351716961498,715,256,459,25,1.8,96.98,9.5,0,0,0,0,0,0,3.11740826197848e-05,8.28859931889974,8.28859931889974
9.7,"random_instances_SVM","SVM",22,27,0,0,0,2784,2517,267,0.704301075268819,0.137096774193548,1.27351716961498,730,267,463,15,1.7,100,9.4,0,0,0,0,0,0,0,0,0
9.7,"random_instances_SVM","SVM",23,0,2684,2445,239,100,86,14,0.578093423407817,0.123188405797101,1.1164095371669,33,14,19,0,1.4,3.59,6.1,0,0,0,0,0,0,0.180977851696623,294.994491374387,36.1257215369034
9.7,"random_instances_SVM","SVM",23,1,2584,2358,226,200,173,27,0.780570471736247,0.260869565217391,1.23735390369331,60,27,33,27,1.2,7.18,6.4,0,0,0,0,0,0,0.229766712713229,318.729474942888,34.8499963003117
9.7,"random_instances_SVM","SVM",23,2,2484,2266,218,300,265,35,0.794780299093487,0.202898550724638,1.25596072931276,93,35,58,33,1.7,10.78,7.6,0,0,0,0,0,0,0.127601789819425,279.059292439402,13.2638330298802
9.7,"random_instances_SVM","SVM",23,3,2384,2175,209,400,356,44,0.812633523875517,0.268115942028986,1.26526414212249,105,44,61,12,1.4,14.37,8.1,0,0,0,0,0,0,0.258860258552182,222.916905629067,35.1819627688108
9.7,"random_instances_SVM","SVM",23,4,2284,2080,204,500,451,49,0.798123448236047,0.253623188405797,1.25596072931276,120,49,71,15,1.4,17.96,9.2,0,0,0,0,0,0,0.147854173797941,232.463851959748,17.3729289146347
9.7,"random_instances_SVM","SVM",23,5,2184,1987,197,600,544,56,0.800952710895552,0.22463768115942,1.25596072931276,144,56,88,24,1.6,21.55,9.7,0,0,0,0,0,0,0.18733764287756,211.005760252057,24.1533270760177
9.7,"random_instances_SVM","SVM",23,6,2084,1900,184,700,631,69,0.798002194122064,0.27536231884058,1.24665731650304,172,69,103,28,1.5,25.14,9.1,0,0,0,0,0,0,0.250949775730528,209.771538650206,36.4632512767967
9.7,"random_instances_SVM","SVM",23,7,1984,1809,175,800,722,78,0.776297707719845,0.297101449275362,1.24665731650304,191,78,113,19,1.4,28.74,9.3,0,0,0,0,0,0,0.234114489998277,196.126574456619,34.7701202615333
9.7,"random_instances_SVM","SVM",23,8,1884,1716,168,900,815,85,0.785865234713321,0.260869565217391,1.26526414212249,211,85,126,20,1.5,32.33,9.6,0,0,0,0,0,0,0.181275879103391,168.580202195013,26.3731996073163
9.7,"random_instances_SVM","SVM",23,9,1784,1621,163,1000,910,90,0.790495987066231,0.239130434782609,1.27456755493221,230,90,140,19,1.6,35.92,10.1,0,0,0,0,0,0,0.199024942652199,167.817772439107,29.2987347110589
9.7,"random_instances_SVM","SVM",23,10,1684,1529,155,1100,1002,98,0.773254806859521,0.166666666666667,1.25596072931276,267,98,169,37,1.7,39.51,10.2,0,0,0,0,0,0,0.176866462444986,166.724917682022,23.5718938106899
9.7,"random_instances_SVM","SVM",23,11,1584,1434,150,1200,1097,103,0.779831399041519,0.202898550724638,1.26526414212249,286,103,183,19,1.8,43.1,10.7,0,0,0,0,0,0,0.151146962201367,150.650553225017,20.891084449779
9.7,"random_instances_SVM","SVM",23,12,1484,1346,138,1300,1185,115,0.787447312200479,0.195652173913043,1.26526414212249,320,115,205,34,1.8,46.7,10.3,0,0,0,0,0,0,0.162652299701657,141.74551636808,20.7475545541232
9.7,"random_instances_SVM","SVM",23,13,1384,1255,129,1400,1276,124,0.812414111669268,0.289855072463768,1.26526414212249,344,124,220,24,1.8,50.29,10.3,0,0,0,0,0,0,0.151367143988298,132.944494419629,19.5822788478033
9.7,"random_instances_SVM","SVM",23,14,1284,1167,117,1500,1364,136,0.802621398464119,0.231884057971014,1.25596072931276,381,136,245,37,1.8,53.88,10,0,0,0,0,0,0,0.16828146409466,123.5132313658,24.0938911951538
9.7,"random_instances_SVM","SVM",23,15,1184,1073,111,1600,1458,142,0.819585426410307,0.246376811594203,1.25596072931276,392,142,250,11,1.8,57.47,10.3,0,0,0,0,0,0,0.175304601185971,112.08171098129,26.1549915203152
9.7,"random_instances_SVM","SVM",23,16,1084,988,96,1700,1543,157,0.815324210404763,0.260869565217391,1.26526414212249,429,157,272,37,1.7,61.06,9.8,0,0,0,0,0,0,0.166337792157172,109.607088879972,24.4793583482741
9.7,"random_instances_SVM","SVM",23,17,984,897,87,1800,1634,166,0.795629077891335,0.246376811594203,1.25596072931276,471,166,305,42,1.8,64.66,9.8,0,0,0,0,0,0,0.164502841033788,96.890042547145,20.1723728063937
9.7,"random_instances_SVM","SVM",23,18,884,803,81,1900,1728,172,0.790767365321327,0.260869565217391,1.27456755493221,481,172,309,10,1.8,68.25,10,0,0,0,0,0,0,0.132608552694126,85.3117935455872,15.6337671965509
9.7,"random_instances_SVM","SVM",23,19,784,710,74,2000,1821,179,0.794739881055495,0.195652173913043,1.27456755493221,490,179,311,9,1.7,71.84,10.2,0,0,0,0,0,0,0.143081157483608,73.1554957506486,18.5332044576465
9.7,"random_instances_SVM","SVM",23,20,684,620,64,2100,1911,189,0.778578439863738,0.210144927536232,1.26526414212249,548,189,359,58,1.9,75.43,10.1,0,0,0,0,0,0,0.139156147262671,67.2962348404408,16.3173678107694
9.7,"random_instances_SVM","SVM",23,21,584,522,62,2200,2009,191,0.838864830532945,0.311594202898551,1.27456755493221,539,191,348,-9,1.8,79.02,10.5,0,0,0,0,0,0,0.131845036952427,53.2893344946439,15.2077794451313
9.7,"random_instances_SVM","SVM",23,22,484,432,52,2300,2099,201,0.814342629482072,0.297101449275362,1.25596072931276,552,201,351,13,1.7,82.61,10.4,0,0,0,0,0,0,0.137537227274658,48.3996763381786,17.9073907140382
9.7,"random_instances_SVM","SVM",23,23,384,341,43,2400,2190,210,0.795675269934761,0.22463768115942,1.27456755493221,579,210,369,27,1.8,86.21,10.4,0,0,0,0,0,0,0.132213749783917,37.9222177117194,16.6978567338307
9.7,"random_instances_SVM","SVM",23,24,284,257,27,2500,2274,226,0.789393152029564,0.253623188405797,1.21874707807387,592,226,366,13,1.6,89.8,10.1,0,0,0,0,0,0,0.114205884646842,26.2251494203958,16.3420620701322
9.7,"random_instances_SVM","SVM",23,25,184,164,20,2600,2367,233,0.792649691090712,0.253623188405797,1.24665731650304,611,233,378,19,1.6,93.39,10.2,0,0,0,0,0,0,0.0786603728146129,18.7763473652827,15.3033155243554
9.7,"random_instances_SVM","SVM",23,26,84,76,8,2700,2455,245,0.779842947052372,0.239130434782609,1.25596072931276,645,245,400,34,1.6,96.98,10,0,0,0,0,0,0,0.00438832981336203,8.09417851964286,8.09417851964286
9.7,"random_instances_SVM","SVM",23,27,0,0,0,2784,2531,253,0.775142906634333,0.217391304347826,1.25596072931276,672,253,419,27,1.7,100,10,0,0,0,0,0,0,0,0,0
9.7,"random_instances_SVM","SVM",24,0,2684,2448,236,100,86,14,0.835474588176653,0.340425531914894,1.27476549988561,38,14,24,0,1.7,3.59,6.1,0,0,0,0,0,0,0.316951063565,329.056064919568,36.5525314066679
9.7,"random_instances_SVM","SVM",24,1,2584,2361,223,200,173,27,0.835044071329844,0.361702127659574,1.27476549988561,59,27,32,21,1.2,7.18,6.4,0,0,0,0,0,0,0.400699751859345,270.047072362791,47.5775803121995
9.7,"random_instances_SVM","SVM",24,2,2484,2268,216,300,266,34,0.839524845353819,0.354609929078014,1.27476549988561,80,34,46,21,1.4,10.78,7.8,0,0,0,0,0,0,0.295295029212656,223.102749945757,36.1802342542587
9.7,"random_instances_SVM","SVM",24,3,2384,2180,204,400,354,46,0.826374255092563,0.375886524822695,1.27359168266656,114,46,68,34,1.5,14.37,7.7,0,0,0,0,0,0,0.328398428109727,282.196918619794,41.6061132247205
9.7,"random_instances_SVM","SVM",24,4,2284,2088,196,500,446,54,0.832528946593256,0.361702127659574,1.27476549988561,136,54,82,22,1.5,17.96,8.3,0,0,0,0,0,0,0.214479542567914,252.95411310358,24.4355759053074
9.7,"random_instances_SVM","SVM",24,5,2184,1997,187,600,537,63,0.81765912129246,0.326241134751773,1.25655456417296,160,63,97,24,1.5,21.55,8.5,0,0,0,0,0,0,0.184299974427501,231.246494083736,22.1403479028778
9.7,"random_instances_SVM","SVM",24,6,2084,1908,176,700,626,74,0.78874085151701,0.26241134751773,1.26566003202928,201,74,127,41,1.7,25.14,8.5,0,0,0,0,0,0,0.159797479979221,235.740166401814,19.628553620489
9.7,"random_instances_SVM","SVM",24,7,1984,1817,167,800,717,83,0.733821630072736,0.269503546099291,1.26566003202928,230,83,147,29,1.8,28.74,8.6,0,0,0,0,0,0,0.15512573396113,227.385342606077,21.0128015529362
9.7,"random_instances_SVM","SVM",24,8,1884,1726,158,900,808,92,0.803678653162039,0.276595744680851,1.27476549988561,252,92,160,22,1.7,32.33,8.8,0,0,0,0,0,0,0.188152450222365,202.731456306182,26.8032731572112
9.7,"random_instances_SVM","SVM",24,9,1784,1631,153,1000,903,97,0.802709990256729,0.24113475177305,1.27476549988561,259,97,162,7,1.7,35.92,9.3,0,0,0,0,0,0,0.166353447507822,190.207449883507,23.1541481836672
9.7,"random_instances_SVM","SVM",24,10,1684,1537,147,1100,997,103,0.811535585616211,0.25531914893617,1.27476549988561,293,103,190,34,1.8,39.51,9.7,0,0,0,0,0,0,0.151999654772302,158.945494024374,18.2306689259493
9.7,"random_instances_SVM","SVM",24,11,1584,1445,139,1200,1089,111,0.787845829651286,0.212765957446809,1.27476549988561,313,111,202,20,1.8,43.1,9.8,0,0,0,0,0,0,0.14939586211263,151.167035797322,17.6899058239762
9.7,"random_instances_SVM","SVM",24,12,1484,1351,133,1300,1183,117,0.808182085967421,0.26241134751773,1.27476549988561,330,117,213,17,1.8,46.7,10.1,0,0,0,0,0,0,0.151723835252417,134.283664901898,18.7435436394721
9.7,"random_instances_SVM","SVM",24,13,1384,1266,118,1400,1268,132,0.811020098339115,0.269503546099291,1.27476549988561,367,132,235,37,1.8,50.29,9.6,0,0,0,0,0,0,0.161132007116068,130.383810702946,18.9372513793201
9.7,"random_instances_SVM","SVM",24,14,1284,1173,111,1500,1361,139,0.822904629189046,0.276595744680851,1.27476549988561,384,139,245,17,1.8,53.88,9.8,0,0,0,0,0,0,0.15252758848434,117.319859627998,17.175749305029
9.7,"random_instances_SVM","SVM",24,15,1184,1077,107,1600,1457,143,0.821579090476517,0.276595744680851,1.27476549988561,409,143,266,25,1.9,57.47,10.2,0,0,0,0,0,0,0.150919116028124,104.924069991094,16.7979177415441
9.7,"random_instances_SVM","SVM",24,16,1084,983,101,1700,1551,149,0.83004781002878,0.312056737588652,1.27476549988561,425,149,276,16,1.9,61.06,10.4,0,0,0,0,0,0,0.14653940346432,96.2262475051126,15.7718489222573
9.7,"random_instances_SVM","SVM",24,17,984,891,93,1800,1643,157,0.837649831192083,0.326241134751773,1.27476549988561,451,157,294,26,1.9,64.66,10.5,0,0,0,0,0,0,0.176016380560859,89.4584425534531,19.8529844145116
9.7,"random_instances_SVM","SVM",24,18,884,797,87,1900,1737,163,0.812158702105005,0.212765957446809,1.27476549988561,466,163,303,15,1.9,68.25,10.7,0,0,0,0,0,0,0.158854193946507,78.2798656161988,20.2116060811104
9.7,"random_instances_SVM","SVM",24,19,784,707,77,2000,1827,173,0.760638297872346,0.198581560283688,1.27476549988561,503,173,330,37,1.9,71.84,10.6,0,0,0,0,0,0,0.161580833526755,73.7962043814518,19.8457349555608
9.7,"random_instances_SVM","SVM",24,20,684,620,64,2100,1914,186,0.815942718600597,0.276595744680851,1.27476549988561,522,186,336,19,1.8,75.43,10.3,0,0,0,0,0,0,0.160982244901691,64.465741340832,18.9904295705151
9.7,"random_instances_SVM","SVM",24,21,584,527,57,2200,2007,193,0.787137742732199,0.24113475177305,1.27476549988561,526,193,333,4,1.7,79.02,10.4,0,0,0,0,0,0,0.145956696806438,53.8932867894154,17.0341684833271
9.7,"random_instances_SVM","SVM",24,22,484,440,44,2300,2094,206,0.774035302381441,0.219858156028369,1.27476549988561,551,206,345,25,1.7,82.61,10.2,0,0,0,0,0,0,0.153358283645227,47.5120275199131,18.1777077282072
9.7,"random_instances_SVM","SVM",24,23,384,349,35,2400,2185,215,0.780283461355452,0.219858156028369,1.27476549988561,588,215,373,37,1.7,86.21,10.2,0,0,0,0,0,0,0.145186963322519,37.9844062670793,17.8611305071553
9.7,"random_instances_SVM","SVM",24,24,284,256,28,2500,2278,222,0.820848344776023,0.297872340425532,1.27476549988561,588,222,366,0,1.6,89.8,10.3,0,0,0,0,0,0,0.139722801550796,29.0827188199765,18.1789852671804
9.7,"random_instances_SVM","SVM",24,25,184,164,20,2600,2370,230,0.801441098497726,0.24822695035461,1.28387096774194,629,230,399,41,1.7,93.39,10.3,0,0,0,0,0,0,0.091928972268795,17.3765466688592,13.6253995313512
9.7,"random_instances_SVM","SVM",24,26,84,77,7,2700,2457,243,0.796648766229353,0.219858156028369,1.26566003202928,644,243,401,15,1.7,96.98,10.1,0,0,0,0,0,0,2.05827345028216e-06,8.04463797629142,8.04463797629142
9.7,"random_instances_SVM","SVM",24,27,0,0,0,2784,2534,250,0.759363741417988,0.219858156028369,1.27476549988561,675,250,425,31,1.7,100,10.1,0,0,0,0,0,0,0,0,0
9.7,"random_instances_SVM","SVM",25,0,2684,2430,254,100,88,12,0.813943217665624,0.336,1.20170322580645,29,12,17,0,1.4,3.59,7.3,0,0,0,0,0,0,0.32114626399617,316.509080911727,35.3364925230176
9.7,"random_instances_SVM","SVM",25,1,2584,2344,240,200,174,26,0.803400630914824,0.328,1.22224516129032,60,26,34,31,1.3,7.18,6.7,0,0,0,0,0,0,0.413456128913717,301.485471979136,45.087576925309
9.7,"random_instances_SVM","SVM",25,2,2484,2250,234,300,268,32,0.814940063091489,0.288,1.28387096774194,83,32,51,23,1.6,10.78,8.4,0,0,0,0,0,0,0.184724997800648,248.206542232626,20.7232922886759
9.7,"random_instances_SVM","SVM",25,3,2384,2158,226,400,360,40,0.822296529968456,0.264,1.28387096774194,105,40,65,22,1.6,14.37,9,0,0,0,0,0,0,0.23116408883326,214.93265293008,27.6449195671728
9.7,"random_instances_SVM","SVM",25,4,2284,2069,215,500,449,51,0.825558359621451,0.224,1.28387096774194,141,51,90,36,1.8,17.96,8.8,0,0,0,0,0,0,0.200681795752427,203.4765456259,24.5157968387448
9.7,"random_instances_SVM","SVM",25,5,2184,1983,201,600,535,65,0.767495268138812,0.208,1.2736,181,65,116,40,1.8,21.55,8.2,0,0,0,0,0,0,0.168385705905642,239.07014739907,19.1771367811499
9.7,"random_instances_SVM","SVM",25,6,2084,1887,197,700,631,69,0.825690851735019,0.248,1.28387096774194,193,69,124,12,1.8,25.14,9.1,0,0,0,0,0,0,0.189399459289943,196.372014790836,22.4629550895439
9.7,"random_instances_SVM","SVM",25,7,1984,1799,185,800,719,81,0.815861198738177,0.24,1.2736,202,81,121,9,1.5,28.74,8.9,0,0,0,0,0,0,0.242983799151929,186.566101271541,32.8957564565711
9.7,"random_instances_SVM","SVM",25,8,1884,1708,176,900,810,90,0.817665615141959,0.304,1.2736,224,90,134,22,1.5,32.33,9,0,0,0,0,0,0,0.25719964803507,178.140673535577,36.492887833173
9.7,"random_instances_SVM","SVM",25,9,1784,1618,166,1000,900,100,0.816220820189279,0.288,1.2736,255,100,155,31,1.6,35.92,9,0,0,0,0,0,0,0.223634501312532,164.872990735174,29.1771163994983
9.7,"random_instances_SVM","SVM",25,10,1684,1526,158,1100,992,108,0.829268138801262,0.28,1.28387096774194,277,108,169,22,1.6,39.51,9.2,0,0,0,0,0,0,0.168642588141315,157.61012773151,19.6563355772783
9.7,"random_instances_SVM","SVM",25,11,1584,1435,149,1200,1083,117,0.836744479495269,0.28,1.28387096774194,300,117,183,23,1.6,43.1,9.3,0,0,0,0,0,0,0.194672514003974,148.941856027268,23.9930744656774
9.7,"random_instances_SVM","SVM",25,12,1484,1346,138,1300,1172,128,0.794813880126184,0.24,1.28387096774194,353,128,225,53,1.8,46.7,9.2,0,0,0,0,0,0,0.200935127478774,151.122947240798,24.4809122416977
9.7,"random_instances_SVM","SVM",25,13,1384,1254,130,1400,1264,136,0.811785488958988,0.224,1.28387096774194,373,136,237,20,1.7,50.29,9.3,0,0,0,0,0,0,0.205029030717427,138.962918141674,25.9421824723601
9.7,"random_instances_SVM","SVM",25,14,1284,1163,121,1500,1355,145,0.819507886435332,0.232,1.28387096774194,404,145,259,31,1.8,53.88,9.3,0,0,0,0,0,0,0.204306860348168,126.858924668802,28.9314966912258
9.7,"random_instances_SVM","SVM",25,15,1184,1080,104,1600,1438,162,0.838750788643531,0.264,1.28387096774194,418,162,256,14,1.6,57.47,8.9,0,0,0,0,0,0,0.233682265510182,118.046585183206,35.9219993010502
9.7,"random_instances_SVM","SVM",25,16,1084,989,95,1700,1529,171,0.816044164037854,0.216,1.28387096774194,435,171,264,17,1.5,61.06,8.9,0,0,0,0,0,0,0.199847773597178,106.063592089449,27.3226005167318
9.7,"random_instances_SVM","SVM",25,17,984,897,87,1800,1621,179,0.779085173501582,0.208,1.2736,496,179,317,61,1.8,64.66,9.1,0,0,0,0,0,0,0.190781667508154,107.435428194809,28.0126421720899
9.7,"random_instances_SVM","SVM",25,18,884,799,85,1900,1719,181,0.800826498422712,0.216,1.28387096774194,500,181,319,4,1.8,68.25,9.5,0,0,0,0,0,0,0.175783567322277,86.6440772199034,25.7351786677734
9.7,"random_instances_SVM","SVM",25,19,784,710,74,2000,1808,192,0.750044164037856,0.176,1.27125666973321,527,192,335,27,1.7,71.84,9.4,0,0,0,0,0,0,0.169708373874347,79.4915515716107,23.9558991661488
9.7,"random_instances_SVM","SVM",25,20,684,622,62,2100,1896,204,0.801255520504731,0.216,1.28387096774194,557,204,353,30,1.7,75.43,9.3,0,0,0,0,0,0,0.180941285298016,66.9411272036754,22.7835197093025
9.7,"random_instances_SVM","SVM",25,21,584,533,51,2200,1985,215,0.759236593059935,0.168,1.2736,599,215,384,42,1.8,79.02,9.2,0,0,0,0,0,0,0.159109274899861,59.1747828436945,20.9040348511706
9.7,"random_instances_SVM","SVM",25,22,484,445,39,2300,2073,227,0.760536277602521,0.16,1.28387096774194,633,227,406,34,1.8,82.61,9.1,0,0,0,0,0,0,0.154595605416205,48.1494834380871,20.4324863922393
9.7,"random_instances_SVM","SVM",25,23,384,356,28,2400,2162,238,0.767627760252369,0.192,1.2736,664,238,426,31,1.8,86.21,9.1,0,0,0,0,0,0,0.147042992117386,38.5733229568179,20.1018271768076
9.7,"random_instances_SVM","SVM",25,24,284,267,17,2500,2251,249,0.809564668769716,0.24,1.28387096774194,659,249,410,-5,1.6,89.8,9,0,0,0,0,0,0,0.118754688114416,27.7895922334943,17.213960518311
9.7,"random_instances_SVM","SVM",25,25,184,176,8,2600,2342,258,0.744712933753943,0.16,1.28387096774194,685,258,427,26,1.7,93.39,9.1,0,0,0,0,0,0,0.0983202216053919,18.5481604442425,15.0549638793591
9.7,"random_instances_SVM","SVM",25,26,84,82,2,2700,2436,264,0.764056782334382,0.168,1.28387096774194,727,264,463,42,1.8,96.98,9.2,0,0,0,0,0,0,2.87524283857124e-10,8.98112942608751,8.98112942608751
9.7,"random_instances_SVM","SVM",25,27,0,0,0,2784,2518,266,0.751520504731866,0.184,1.2736,738,266,472,11,1.8,100,9.5,0,0,0,0,0,0,0,0,0
9.7,"random_instances_SVM","SVM",26,0,2684,2422,262,100,90,10,0.831068691212756,0.361344537815126,1.24071564109515,28,10,18,0,1.8,3.59,9,0,0,0,0,0,0,0.226464990463438,241.189537199361,24.6187433604977
9.7,"random_instances_SVM","SVM",26,1,2584,2336,248,200,176,24,0.784269751856789,0.260504201680672,1.26229330441854,62,24,38,34,1.6,7.18,7.3,0,0,0,0,0,0,0.203332889793037,318.883127073099,30.1735221185125
9.7,"random_instances_SVM","SVM",26,2,2484,2245,239,300,267,33,0.782244766038288,0.277310924369748,1.26229330441854,89,33,56,27,1.7,10.78,8.1,0,0,0,0,0,0,0.139357115210858,257.571358321489,16.7221498969658
9.7,"random_instances_SVM","SVM",26,3,2384,2159,225,400,353,47,0.782502011793731,0.252100840336134,1.22992680943345,127,47,80,38,1.7,14.37,7.5,0,0,0,0,0,0,0.163518401818901,301.222230800967,47.0873791603998
9.7,"random_instances_SVM","SVM",26,4,2284,2072,212,500,440,60,0.779388678548343,0.252100840336134,1.25150447275684,152,60,92,25,1.5,17.96,7.3,0,0,0,0,0,0,0.215053566644098,291.844018413089,56.3701292395983
9.7,"random_instances_SVM","SVM",26,5,2184,1983,201,600,529,71,0.789164017255257,0.277310924369748,1.22992680943345,187,71,116,35,1.6,21.55,7.5,0,0,0,0,0,0,0.218393435540927,261.213878403234,30.2322289729786
9.7,"random_instances_SVM","SVM",26,6,2084,1892,192,700,620,80,0.790826220598132,0.310924369747899,1.22992680943345,205,80,125,18,1.6,25.14,7.8,0,0,0,0,0,0,0.203584280687454,242.775650083793,26.5529171204636
9.7,"random_instances_SVM","SVM",26,7,1984,1805,179,800,707,93,0.779955938419327,0.310924369747899,1.20834914611006,249,93,156,44,1.7,28.74,7.6,0,0,0,0,0,0,0.211949440175599,236.08803939382,28.3117741403201
9.7,"random_instances_SVM","SVM",26,8,1884,1711,173,900,801,99,0.804394285186605,0.327731092436975,1.24071564109515,260,99,161,11,1.6,32.33,8.1,0,0,0,0,0,0,0.160105700473098,216.26657350764,18.6138471215975
9.7,"random_instances_SVM","SVM",26,9,1784,1622,162,1000,890,110,0.783887181246133,0.277310924369748,1.22992680943345,303,110,193,43,1.8,35.92,8.1,0,0,0,0,0,0,0.189467276758847,191.539815396171,25.3060970657099
9.7,"random_instances_SVM","SVM",26,10,1684,1530,154,1100,982,118,0.805977335989345,0.26890756302521,1.24071564109515,342,118,224,39,1.9,39.51,8.3,0,0,0,0,0,0,0.172521513912636,192.616906851254,20.6156748021241
9.7,"random_instances_SVM","SVM",26,11,1584,1440,144,1200,1072,128,0.814591770774252,0.294117647058824,1.25150447275684,352,128,224,10,1.8,43.1,8.4,0,0,0,0,0,0,0.18496647051435,170.396896193861,23.9196149713351
9.7,"random_instances_SVM","SVM",26,12,1484,1350,134,1300,1162,138,0.812764666306089,0.243697478991597,1.25150447275684,386,138,248,34,1.8,46.7,8.4,0,0,0,0,0,0,0.180523319661903,161.994690637724,23.7851955990037
9.7,"random_instances_SVM","SVM",26,13,1384,1258,126,1400,1254,146,0.805443056343423,0.252100840336134,1.25150447275684,398,146,252,12,1.7,50.29,8.6,0,0,0,0,0,0,0.2164490135934,144.725845428439,28.9915495626965
9.7,"random_instances_SVM","SVM",26,14,1284,1172,112,1500,1340,160,0.820877801670125,0.277310924369748,1.25150447275684,422,160,262,24,1.6,53.88,8.4,0,0,0,0,0,0,0.222302259803858,138.87703080485,32.9338953564843
9.7,"random_instances_SVM","SVM",26,15,1184,1078,106,1600,1434,166,0.81319340923183,0.243697478991597,1.25150447275684,446,166,280,24,1.7,57.47,8.6,0,0,0,0,0,0,0.192490257400946,130.792608384456,25.5446762599739
9.7,"random_instances_SVM","SVM",26,16,1084,984,100,1700,1528,172,0.786947746131424,0.159663865546218,1.25150447275684,457,172,285,11,1.7,61.06,8.9,0,0,0,0,0,0,0.19641183194127,113.294202761455,28.0382749216199
9.7,"random_instances_SVM","SVM",26,17,984,894,90,1800,1618,182,0.814242180388644,0.243697478991597,1.25150447275684,498,182,316,41,1.7,64.66,8.9,0,0,0,0,0,0,0.190404256105793,105.510648599279,24.3899570359275
9.7,"random_instances_SVM","SVM",26,18,884,805,79,1900,1707,193,0.829696713850381,0.260504201680672,1.25150447275684,531,193,338,33,1.8,68.25,8.8,0,0,0,0,0,0,0.197090135451074,95.5916235148169,25.1372074968321
9.7,"random_instances_SVM","SVM",26,19,784,713,71,2000,1799,201,0.816517815917583,0.319327731092437,1.25150447275684,543,201,342,12,1.7,71.84,9,0,0,0,0,0,0,0.187831668805966,86.335908942775,23.1393352251602
9.7,"random_instances_SVM","SVM",26,20,684,621,63,2100,1891,209,0.835619962270629,0.302521008403361,1.25150447275684,564,209,355,21,1.7,75.43,9,0,0,0,0,0,0,0.193375584025,71.2886212261664,23.571816194421
9.7,"random_instances_SVM","SVM",26,21,584,529,55,2200,1983,217,0.756935741329502,0.176470588235294,1.25150447275684,584,217,367,20,1.7,79.02,9.1,0,0,0,0,0,0,0.128723690785466,58.3596968916814,14.01505177169
9.7,"random_instances_SVM","SVM",26,22,484,438,46,2300,2074,226,0.755319710301706,0.159663865546218,1.26229330441854,614,226,388,30,1.7,82.61,9.2,0,0,0,0,0,0,0.149359532632271,50.8884807069486,18.711692519443
9.7,"random_instances_SVM","SVM",26,23,384,347,37,2400,2165,235,0.752555967441926,0.168067226890756,1.26229330441854,632,235,397,18,1.7,86.21,9.2,0,0,0,0,0,0,0.132893301372433,39.6402755499284,15.4059414797321
9.7,"random_instances_SVM","SVM",26,24,284,256,28,2500,2256,244,0.692578130153163,0.0840336134453782,1.26229330441854,665,244,421,33,1.7,89.8,9.2,0,0,0,0,0,0,0.130042931967417,30.1451133360003,15.2006410815547
9.7,"random_instances_SVM","SVM",26,25,184,168,16,2600,2344,256,0.77403268999908,0.201680672268908,1.26229330441854,703,256,447,38,1.7,93.39,9.2,0,0,0,0,0,0,0.100354793706725,18.8119624928212,14.4193345251605
9.7,"random_instances_SVM","SVM",26,26,84,76,8,2700,2436,264,0.749706475996995,0.151260504201681,1.26229330441854,732,264,468,29,1.8,96.98,9.2,0,0,0,0,0,0,2.33450006867975e-06,9.35698672150293,9.35698672150293
9.7,"random_instances_SVM","SVM",26,27,0,0,0,2784,2512,272,0.823509623629676,0.302521008403361,1.26229330441854,732,272,460,0,1.7,100,9.2,0,0,0,0,0,0,0,0,0
9.7,"random_instances_SVM","SVM",27,0,2684,2437,247,100,90,10,0.811328583452874,0.328358208955224,1.2263842079923,28,10,18,0,1.8,3.59,9,0,0,0,0,0,0,0.162386059357641,310.308061663603,17.4113007074869
9.7,"random_instances_SVM","SVM",27,1,2584,2351,233,200,176,24,0.835850532879693,0.305970149253731,1.26470871449206,57,24,33,29,1.4,7.18,7.3,0,0,0,0,0,0,0.488329074341329,265.828403647996,64.6963070337477
9.7,"random_instances_SVM","SVM",27,2,2484,2259,225,300,268,32,0.800836958970048,0.23134328358209,1.24554646124218,82,32,50,25,1.6,10.78,8.4,0,0,0,0,0,0,0.32931947146713,258.353263431357,45.3927142969082
9.7,"random_instances_SVM","SVM",27,3,2384,2170,214,400,357,43,0.791883513330884,0.238805970149254,1.25397185343998,103,43,60,21,1.4,14.37,8.3,0,0,0,0,0,0,0.246920309466983,233.119290492276,37.0613561236276
9.7,"random_instances_SVM","SVM",27,4,2284,2078,206,500,449,51,0.770790606143235,0.246268656716418,1.26470871449206,124,51,73,21,1.4,17.96,8.8,0,0,0,0,0,0,0.253592243886561,231.574308940951,40.2708941897364
9.7,"random_instances_SVM","SVM",27,5,2184,1985,199,600,542,58,0.826093914857803,0.305970149253731,1.274289841117,142,58,84,18,1.4,21.55,9.3,0,0,0,0,0,0,0.150011878076312,202.52752654773,20.2566758119804
9.7,"random_instances_SVM","SVM",27,6,2084,1889,195,700,638,62,0.800534657925628,0.223880597014925,1.26470871449206,158,62,96,16,1.5,25.14,10.3,0,0,0,0,0,0,0.186282043045511,189.3002653791,29.2434135543009
9.7,"random_instances_SVM","SVM",27,7,1984,1797,187,800,730,70,0.796912972864038,0.223880597014925,1.24554646124218,182,70,112,24,1.6,28.74,10.4,0,0,0,0,0,0,0.204182644984048,190.967691610771,33.9348706978577
9.7,"random_instances_SVM","SVM",27,8,1884,1702,182,900,825,75,0.804351949545367,0.238805970149254,1.26470871449206,199,75,124,17,1.7,32.33,11,0,0,0,0,0,0,0.156115410627096,158.661870058463,26.3027459742728
9.7,"random_instances_SVM","SVM",27,9,1784,1609,175,1000,918,82,0.814078930209954,0.223880597014925,1.28387096774194,215,82,133,16,1.6,35.92,11.2,0,0,0,0,0,0,0.138471695416193,146.759470476419,23.6330792721868
9.7,"random_instances_SVM","SVM",27,10,1684,1517,167,1100,1010,90,0.820978506988494,0.216417910447761,1.274289841117,225,90,135,10,1.5,39.51,11.2,0,0,0,0,0,0,0.147759392578373,132.000343476677,25.8371208554761
9.7,"random_instances_SVM","SVM",27,11,1584,1419,165,1200,1108,92,0.826141334629479,0.186567164179104,1.274289841117,241,92,149,16,1.6,43.1,12,0,0,0,0,0,0,0.145922119485926,121.295442113032,27.37228528855
9.7,"random_instances_SVM","SVM",27,12,1484,1327,157,1300,1200,100,0.817078230768324,0.23134328358209,1.26470871449206,275,100,175,34,1.8,46.7,12,0,0,0,0,0,0,0.129543885138146,125.037180171537,22.5228762579333
9.7,"random_instances_SVM","SVM",27,13,1384,1234,150,1400,1293,107,0.827688404680337,0.23134328358209,1.26470871449206,281,107,174,6,1.6,50.29,12.1,0,0,0,0,0,0,0.137046624638654,111.126966701439,25.8036627923422
9.7,"random_instances_SVM","SVM",27,14,1284,1146,138,1500,1381,119,0.80454755610352,0.208955223880597,1.274289841117,310,119,191,29,1.6,53.88,11.6,0,0,0,0,0,0,0.136128370700915,112.213205937729,22.7337851285841
9.7,"random_instances_SVM","SVM",27,15,1184,1057,127,1600,1470,130,0.813598805021759,0.216417910447761,1.274289841117,329,130,199,19,1.5,57.47,11.3,0,0,0,0,0,0,0.138239568460595,98.6238345588014,22.1848884290043
9.7,"random_instances_SVM","SVM",27,16,1084,966,118,1700,1561,139,0.813094969947724,0.186567164179104,1.28387096774194,355,139,216,26,1.6,61.06,11.2,0,0,0,0,0,0,0.12858900487159,89.4224004285938,20.8230067248737
9.7,"random_instances_SVM","SVM",27,17,984,877,107,1800,1650,150,0.799165412018545,0.223880597014925,1.28387096774194,372,150,222,17,1.5,64.66,11,0,0,0,0,0,0,0.133731140666631,85.9262670662817,21.4472903497613
9.7,"random_instances_SVM","SVM",27,18,884,786,98,1900,1741,159,0.807238628146009,0.216417910447761,1.28387096774194,398,159,239,26,1.5,68.25,10.9,0,0,0,0,0,0,0.13901650474461,79.6685328635656,21.3540043856056
9.7,"random_instances_SVM","SVM",27,19,784,699,85,2000,1828,172,0.792633338470479,0.201492537313433,1.28387096774194,441,172,269,43,1.6,71.84,10.6,0,0,0,0,0,0,0.137298730639243,72.3628201283432,20.6232434236734
9.7,"random_instances_SVM","SVM",27,20,684,612,72,2100,1915,185,0.778057686152244,0.141791044776119,1.28387096774194,477,185,292,36,1.6,75.43,10.4,0,0,0,0,0,0,0.137047296797048,64.1441134903854,18.9014851712129
9.7,"random_instances_SVM","SVM",27,21,584,525,59,2200,2002,198,0.710810522447334,0.126865671641791,1.274289841117,522,198,324,45,1.6,79.02,10.1,0,0,0,0,0,0,0.112320996526248,52.3895705209128,13.4945373945629
9.7,"random_instances_SVM","SVM",27,22,484,437,47,2300,2090,210,0.730329685962566,0.156716417910448,1.274289841117,544,210,334,22,1.6,82.61,10,0,0,0,0,0,0,0.122778546075159,44.2703423240429,15.3337433951768
9.7,"random_instances_SVM","SVM",27,23,384,346,38,2400,2181,219,0.776427631500959,0.208955223880597,1.274289841117,563,219,344,19,1.6,86.21,10,0,0,0,0,0,0,0.123742665054985,35.3783533132337,14.8797430688034
9.7,"random_instances_SVM","SVM",27,24,284,262,22,2500,2265,235,0.754009934442167,0.171641791044776,1.274289841117,605,235,370,42,1.6,89.8,9.6,0,0,0,0,0,0,0.112312398083524,27.0666932888219,13.1094754432156
9.7,"random_instances_SVM","SVM",27,25,184,173,11,2600,2354,246,0.750334902137447,0.171641791044776,1.26470871449206,638,246,392,33,1.6,93.39,9.6,0,0,0,0,0,0,0.098697366364226,18.2671640707258,13.4853235982721
9.7,"random_instances_SVM","SVM",27,26,84,80,4,2700,2447,253,0.7334356810072,0.141791044776119,1.27311646188945,659,253,406,21,1.6,96.98,9.7,0,0,0,0,0,0,5.07978072958097e-06,8.31872128940894,8.31872128940894
9.7,"random_instances_SVM","SVM",27,27,0,0,0,2784,2527,257,0.800718409540858,0.17910447761194,1.27311646188945,659,257,402,0,1.6,100,9.8,0,0,0,0,0,0,0,0,0
9.7,"random_instances_SVM","SVM",28,0,2684,2438,246,100,90,10,0.807831360772542,0.274074074074074,1.26485065710872,25,10,15,0,1.5,3.59,9,0,0,0,0,0,0,0.140317912229411,268.599981941457,14.8527207654497
9.7,"random_instances_SVM","SVM",28,1,2584,2352,232,200,176,24,0.800135429547202,0.362962962962963,1.21729988052569,59,24,35,34,1.5,7.18,7.3,0,0,0,0,0,0,0.210179842167632,307.025931922372,25.2951841589595
9.7,"random_instances_SVM","SVM",28,2,2484,2268,216,300,260,40,0.786239180356834,0.333333333333333,1.22681003584229,93,40,53,34,1.3,10.78,6.5,0,0,0,0,0,0,0.243975518228789,322.256766296441,39.0013815972122
9.7,"random_instances_SVM","SVM",28,3,2384,2175,209,400,353,47,0.808797032326445,0.288888888888889,1.28387096774194,118,47,71,25,1.5,14.37,7.5,0,0,0,0,0,0,0.170569634530358,258.643200200836,21.4029173152901
9.7,"random_instances_SVM","SVM",28,4,2284,2081,203,500,447,53,0.805405405405403,0.318518518518519,1.26485065710872,131,53,78,13,1.5,17.96,8.4,0,0,0,0,0,0,0.146902042115063,225.819139403025,18.0811963464255
9.7,"random_instances_SVM","SVM",28,5,2184,1990,194,600,538,62,0.808814697049988,0.303703703703704,1.28387096774194,148,62,86,17,1.4,21.55,8.7,0,0,0,0,0,0,0.169989258998255,219.773472772847,24.49995011917
9.7,"random_instances_SVM","SVM",28,6,2084,1896,188,700,632,68,0.802944120591179,0.296296296296296,1.28387096774194,160,68,92,12,1.4,25.14,9.3,0,0,0,0,0,0,0.239110306771233,194.961584315106,41.6738945156268
9.7,"random_instances_SVM","SVM",28,7,1984,1804,180,800,724,76,0.78108696932227,0.296296296296296,1.25534050179211,184,76,108,24,1.4,28.74,9.5,0,0,0,0,0,0,0.137482144210422,194.272658612002,19.960736693536
9.7,"random_instances_SVM","SVM",28,8,1884,1714,170,900,814,86,0.804263086616024,0.244444444444444,1.28387096774194,212,86,126,28,1.5,32.33,9.5,0,0,0,0,0,0,0.172554340441525,192.728222859613,29.8340875301666
9.7,"random_instances_SVM","SVM",28,9,1784,1627,157,1000,901,99,0.805334746511221,0.244444444444444,1.27436081242533,240,99,141,28,1.4,35.92,9.1,0,0,0,0,0,0,0.168197927578692,181.62886622717,27.5469979505975
9.7,"random_instances_SVM","SVM",28,10,1684,1538,146,1100,990,110,0.810216098451392,0.251851851851852,1.28387096774194,269,110,159,29,1.4,39.51,9,0,0,0,0,0,0,0.214515495178643,173.404939698374,31.552787164708
9.7,"random_instances_SVM","SVM",28,11,1584,1446,138,1200,1082,118,0.816263322145671,0.288888888888889,1.28387096774194,294,118,176,25,1.5,43.1,9.2,0,0,0,0,0,0,0.122036087726749,151.875173719703,13.4023836703318
9.7,"random_instances_SVM","SVM",28,12,1484,1354,130,1300,1174,126,0.809521285991873,0.22962962962963,1.28387096774194,306,126,180,12,1.4,46.7,9.3,0,0,0,0,0,0,0.200006015560342,144.516467297162,28.7809205538484
9.7,"random_instances_SVM","SVM",28,13,1384,1261,123,1400,1267,133,0.815226991697581,0.259259259259259,1.28387096774194,318,133,185,12,1.4,50.29,9.5,0,0,0,0,0,0,0.190921957398689,137.663330185903,29.0577548268393
9.7,"random_instances_SVM","SVM",28,14,1284,1166,118,1500,1362,138,0.827009362303481,0.274074074074074,1.28387096774194,338,138,200,20,1.4,53.88,9.9,0,0,0,0,0,0,0.191719538662132,124.930654170352,26.371090121452
9.7,"random_instances_SVM","SVM",28,15,1184,1071,113,1600,1457,143,0.821951363127835,0.251851851851852,1.28387096774194,361,143,218,23,1.5,57.47,10.2,0,0,0,0,0,0,0.186472132146634,111.03379391764,27.3813822052211
9.7,"random_instances_SVM","SVM",28,16,1084,976,108,1700,1552,148,0.82126832715068,0.251851851851852,1.27436081242533,392,148,244,31,1.6,61.06,10.5,0,0,0,0,0,0,0.160129666696272,97.2153641065102,22.36902573918
9.7,"random_instances_SVM","SVM",28,17,984,884,100,1800,1644,156,0.811440852617324,0.237037037037037,1.28387096774194,409,156,253,17,1.6,64.66,10.5,0,0,0,0,0,0,0.132861297828869,91.4626310675579,15.8309434138772
9.7,"random_instances_SVM","SVM",28,18,884,795,89,1900,1733,167,0.813066007183657,0.259259259259259,1.27436081242533,439,167,272,30,1.6,68.25,10.4,0,0,0,0,0,0,0.145268144113552,82.5122132268129,18.6970622320607
9.7,"random_instances_SVM","SVM",28,19,784,708,76,2000,1820,180,0.808885355944179,0.244444444444444,1.28387096774194,483,180,303,44,1.7,71.84,10.1,0,0,0,0,0,0,0.145281535221275,77.0948046330827,17.7880641708828
9.7,"random_instances_SVM","SVM",28,20,684,620,64,2100,1908,192,0.81168815874698,0.207407407407407,1.28387096774194,502,192,310,19,1.6,75.43,9.9,0,0,0,0,0,0,0.15679260659431,65.4326929485121,19.6551970312506
9.7,"random_instances_SVM","SVM",28,21,584,531,53,2200,1997,203,0.821321321321322,0.244444444444444,1.27436081242533,523,203,320,21,1.6,79.02,9.8,0,0,0,0,0,0,0.142698288799121,58.1801865943572,17.2137364230447
9.7,"random_instances_SVM","SVM",28,22,484,440,44,2300,2088,212,0.820455749867511,0.237037037037037,1.28387096774194,540,212,328,17,1.5,82.61,9.8,0,0,0,0,0,0,0.140882462089475,48.307250590613,16.8514548553776
9.7,"random_instances_SVM","SVM",28,23,384,348,36,2400,2180,220,0.820390979214505,0.259259259259259,1.28387096774194,563,220,343,23,1.6,86.21,9.9,0,0,0,0,0,0,0.14532897584123,38.5621236790076,18.391785221136
9.7,"random_instances_SVM","SVM",28,24,284,255,29,2500,2273,227,0.798922451863625,0.207407407407407,1.28387096774194,577,227,350,14,1.5,89.8,10,0,0,0,0,0,0,0.129575828965536,29.1756258515544,17.084731639493
9.7,"random_instances_SVM","SVM",28,25,184,166,18,2600,2362,238,0.78356003061885,0.192592592592593,1.27436081242533,643,238,405,66,1.7,93.39,9.9,0,0,0,0,0,0,0.0970682732371523,18.3779522032517,12.6010532159687
9.7,"random_instances_SVM","SVM",28,26,84,72,12,2700,2456,244,0.773420479302828,0.17037037037037,1.28387096774194,648,244,404,5,1.7,96.98,10.1,0,0,0,0,0,0,1.46074912442071e-06,8.78411451911674,8.78411451911674
9.7,"random_instances_SVM","SVM",28,27,0,0,0,2784,2528,256,0.826714950244357,0.274074074074074,1.28387096774194,702,256,446,54,1.7,100,9.9,0,0,0,0,0,0,0,0,0
9.7,"random_instances_SVM","SVM",29,0,2684,2427,257,100,90,10,0.817000940542466,0.314516129032258,1.27351716961498,32,10,22,0,2.2,3.59,9,0,0,0,0,0,0,0.142093667269999,272.12437717291,14.9902647398781
9.7,"random_instances_SVM","SVM",29,1,2584,2341,243,200,176,24,0.832831287017977,0.298387096774194,1.27351716961498,58,24,34,26,1.4,7.18,7.3,0,0,0,0,0,0,0.224350314526058,286.800839726063,27.142888120688
9.7,"random_instances_SVM","SVM",29,2,2484,2252,232,300,265,35,0.834343780980713,0.201612903225806,1.27351716961498,85,35,50,27,1.4,10.78,7.6,0,0,0,0,0,0,0.191750633646646,283.095570486276,20.7970560702399
9.7,"random_instances_SVM","SVM",29,3,2384,2161,223,400,356,44,0.837915300338093,0.193548387096774,1.27351716961498,125,44,81,40,1.8,14.37,8.1,0,0,0,0,0,0,0.173748656374494,277.394751813439,19.2728467741082
9.7,"random_instances_SVM","SVM",29,4,2284,2072,212,500,445,55,0.858028928035798,0.298387096774194,1.27351716961498,146,55,91,21,1.7,17.96,8.1,0,0,0,0,0,0,0.151497320148482,264.01470601238,16.654282248222
9.7,"random_instances_SVM","SVM",29,5,2184,1979,205,600,538,62,0.848725183659989,0.282258064516129,1.27234450187132,167,62,105,21,1.7,21.55,8.7,0,0,0,0,0,0,0.20894210271886,238.026538645912,37.5650087941102
9.7,"random_instances_SVM","SVM",29,6,2084,1881,203,700,636,64,0.848286687511128,0.282258064516129,1.27351716961498,186,64,122,19,1.9,25.14,9.9,0,0,0,0,0,0,0.174644065703544,197.585598398629,25.3148775611384
9.7,"random_instances_SVM","SVM",29,7,1984,1793,191,800,724,76,0.860780650245308,0.306451612903226,1.27351716961498,202,76,126,16,1.7,28.74,9.5,0,0,0,0,0,0,0.195985779463757,201.157172625433,25.728310046966
9.7,"random_instances_SVM","SVM",29,8,1884,1706,178,900,811,89,0.859280866315876,0.298387096774194,1.27351716961498,236,89,147,34,1.7,32.33,9.1,0,0,0,0,0,0,0.193351420021598,194.191286069443,23.9178355408399
9.7,"random_instances_SVM","SVM",29,9,1784,1617,167,1000,900,100,0.84264978774245,0.25,1.27351716961498,277,100,177,41,1.8,35.92,9,0,0,0,0,0,0,0.178398983601673,187.028200113027,22.1979955137143
9.7,"random_instances_SVM","SVM",29,10,1684,1531,153,1100,986,114,0.864263199369588,0.306451612903226,1.27351716961498,312,114,198,35,1.7,39.51,8.6,0,0,0,0,0,0,0.111783906898859,175.341072538158,11.3614693147384
9.7,"random_instances_SVM","SVM",29,11,1584,1435,149,1200,1082,118,0.846894938864744,0.290322580645161,1.27351716961498,340,118,222,28,1.9,43.1,9.2,0,0,0,0,0,0,0.154121149094764,165.383201022589,17.5494155791458
9.7,"random_instances_SVM","SVM",29,12,1484,1347,137,1300,1170,130,0.836256640992404,0.274193548387097,1.27351716961498,350,130,220,10,1.7,46.7,9,0,0,0,0,0,0,0.111261103030067,151.76140489222,11.3878209577001
9.7,"random_instances_SVM","SVM",29,13,1384,1262,122,1400,1255,145,0.84538244490201,0.290322580645161,1.27351716961498,394,145,249,44,1.7,50.29,8.7,0,0,0,0,0,0,0.135122446383552,144.940717486479,14.949722347636
9.7,"random_instances_SVM","SVM",29,14,1284,1174,110,1500,1343,157,0.844689748087144,0.290322580645161,1.28387096774194,408,157,251,14,1.6,53.88,8.6,0,0,0,0,0,0,0.172537969146783,132.736481936911,22.6388462248644
9.7,"random_instances_SVM","SVM",29,15,1184,1081,103,1600,1436,164,0.847489132921533,0.274193548387097,1.28268876611418,433,164,269,25,1.6,57.47,8.8,0,0,0,0,0,0,0.156105753576637,124.224976790285,19.4344245895149
9.7,"random_instances_SVM","SVM",29,16,1084,993,91,1700,1524,176,0.825764508503017,0.225806451612903,1.28387096774194,461,176,285,28,1.6,61.06,8.7,0,0,0,0,0,0,0.169888096609235,116.913090489469,22.0796360955835
9.7,"random_instances_SVM","SVM",29,17,984,904,80,1800,1613,187,0.813677266834444,0.193548387096774,1.26316337148803,490,187,303,29,1.6,64.66,8.6,0,0,0,0,0,0,0.162925825351355,105.034621878207,21.0515133669157
9.7,"random_instances_SVM","SVM",29,18,884,813,71,1900,1704,196,0.804602303058039,0.185483870967742,1.26316337148803,528,196,332,38,1.7,68.25,8.7,0,0,0,0,0,0,0.169843392918719,91.7642354834345,22.4018501380817
9.7,"random_instances_SVM","SVM",29,19,784,718,66,2000,1799,201,0.825580213020164,0.201612903225806,1.26316337148803,543,201,342,15,1.7,71.84,9,0,0,0,0,0,0,0.167813264308621,83.8894710255407,21.4642345806467
9.7,"random_instances_SVM","SVM",29,20,684,629,55,2100,1888,212,0.808993619563287,0.185483870967742,1.27351716961498,573,212,361,30,1.7,75.43,8.9,0,0,0,0,0,0,0.148943454970622,71.6706676991634,17.1645287092124
9.7,"random_instances_SVM","SVM",29,21,584,537,47,2200,1980,220,0.834451816263764,0.241935483870968,1.26316337148803,593,220,373,20,1.7,79.02,9,0,0,0,0,0,0,0.146020716432847,60.9715732136751,15.71981510353
9.7,"random_instances_SVM","SVM",29,22,484,442,42,2300,2075,225,0.840025165865941,0.266129032258065,1.26316337148803,612,225,387,19,1.7,82.61,9.2,0,0,0,0,0,0,0.156300826443497,48.0383885429231,18.2303984821033
9.7,"random_instances_SVM","SVM",29,23,384,354,30,2400,2163,237,0.791015277460031,0.185483870967742,1.27351716961498,653,237,416,41,1.8,86.21,9.1,0,0,0,0,0,0,0.137531939451206,40.2394543404251,15.4954454167495
9.7,"random_instances_SVM","SVM",29,24,284,261,23,2500,2256,244,0.850968504537487,0.298387096774194,1.26316337148803,660,244,416,7,1.7,89.8,9.2,0,0,0,0,0,0,0.133130565997245,28.6947702919506,17.2269818156587
9.7,"random_instances_SVM","SVM",29,25,184,168,16,2600,2349,251,0.852125117567813,0.282258064516129,1.26316337148803,676,251,425,16,1.7,93.39,9.4,0,0,0,0,0,0,0.101421894743787,18.4552034149124,14.8789609444785
9.7,"random_instances_SVM","SVM",29,26,84,76,8,2700,2441,259,0.804716693357741,0.217741935483871,1.28387096774194,711,259,452,35,1.7,96.98,9.4,0,0,0,0,0,0,5.00040595152701e-05,8.07218766848128,8.07218766848128
9.7,"random_instances_SVM","SVM",29,27,0,0,0,2784,2517,267,0.835322453544834,0.282258064516129,1.26316337148803,725,267,458,14,1.7,100,9.4,0,0,0,0,0,0,0,0,0
9.7,"random_instances_SVM","SVM",30,0,2684,2426,258,100,90,10,0.241501824467063,0,0.469708890637293,31,10,21,0,2.1,3.59,9,0,0,0,0,0,0,0.103110124657613,270.453518887238,10.3559915365574
9.7,"random_instances_SVM","SVM",30,1,2584,2340,244,200,176,24,0.766173740477559,0.113821138211382,1.24211906635195,60,24,36,29,1.5,7.18,7.3,0,0,0,0,0,0,0.306269057675536,329.663399387946,55.8073663418543
9.7,"random_instances_SVM","SVM",30,2,2484,2252,232,300,264,36,0.779860444273731,0.113821138211382,1.25255704169945,100,36,64,40,1.8,10.78,7.3,0,0,0,0,0,0,0.157036367315829,315.12105152193,31.6971268335468
9.7,"random_instances_SVM","SVM",30,3,2384,2159,225,400,357,43,0.814282056206387,0.211382113821138,1.25255704169945,130,43,87,30,2,14.37,8.3,0,0,0,0,0,0,0.116453179551999,257.071436375504,12.0695687480813
9.7,"random_instances_SVM","SVM",30,4,2284,2069,215,500,447,53,0.781947378528898,0.121951219512195,1.26299501704694,156,53,103,26,1.9,17.96,8.4,0,0,0,0,0,0,0.188356869714407,255.117518461628,25.1489160414641
9.7,"random_instances_SVM","SVM",30,5,2184,1978,206,600,538,62,0.811855835093794,0.211382113821138,1.26299501704694,188,62,126,32,2,21.55,8.7,0,0,0,0,0,0,0.193207665323339,260.611411065087,26.0692727171159
9.7,"random_instances_SVM","SVM",30,6,2084,1889,195,700,627,73,0.815383138083353,0.235772357723577,1.26299501704694,212,73,139,24,1.9,25.14,8.6,0,0,0,0,0,0,0.202141191922893,240.77046290523,28.5123350393878
9.7,"random_instances_SVM","SVM",30,7,1984,1799,185,800,717,83,0.816368990461561,0.219512195121951,1.26299501704694,232,83,149,20,1.8,28.74,8.6,0,0,0,0,0,0,0.16904769370734,210.762005336671,19.5712030873784
9.7,"random_instances_SVM","SVM",30,8,1884,1706,178,900,810,90,0.808315728826581,0.227642276422764,1.25255704169945,256,90,166,24,1.8,32.33,9,0,0,0,0,0,0,0.172777291370409,194.793456175897,20.3773969869826
9.7,"random_instances_SVM","SVM",30,9,1784,1615,169,1000,901,99,0.818238268996863,0.276422764227642,1.26299501704694,291,99,192,35,1.9,35.92,9.1,0,0,0,0,0,0,0.205705305576293,180.195819720278,27.92142575823
9.7,"random_instances_SVM","SVM",30,10,1684,1521,163,1100,995,105,0.813616285769158,0.268292682926829,1.26299501704694,300,105,195,9,1.9,39.51,9.5,0,0,0,0,0,0,0.183516124986685,172.785243490099,22.9485014821557
9.7,"random_instances_SVM","SVM",30,11,1584,1428,156,1200,1088,112,0.801478778567317,0.252032520325203,1.26299501704694,335,112,223,35,2,43.1,9.7,0,0,0,0,0,0,0.15793049643023,154.483468906127,17.5668621934811
9.7,"random_instances_SVM","SVM",30,12,1484,1341,143,1300,1175,125,0.786018820818137,0.211382113821138,1.26299501704694,359,125,234,24,1.9,46.7,9.4,0,0,0,0,0,0,0.172124395187442,141.112275469621,19.5769936825731
9.7,"random_instances_SVM","SVM",30,13,1384,1255,129,1400,1261,139,0.804308302925558,0.195121951219512,1.26299501704694,389,139,250,30,1.8,50.29,9.1,0,0,0,0,0,0,0.176664226170254,136.574086910449,19.964091935133
9.7,"random_instances_SVM","SVM",30,14,1284,1169,115,1500,1347,153,0.752006913769929,0.130081300813008,1.26299501704694,444,153,291,55,1.9,53.88,8.8,0,0,0,0,0,0,0.18758695134936,137.064112327694,22.0704627921463
9.7,"random_instances_SVM","SVM",30,15,1184,1076,108,1600,1440,160,0.788797132065814,0.203252032520325,1.26299501704694,458,160,298,14,1.9,57.47,9,0,0,0,0,0,0,0.188270996311737,118.924686841024,21.5838550352258
9.7,"random_instances_SVM","SVM",30,16,1084,982,102,1700,1534,166,0.789654951667634,0.211382113821138,1.26299501704694,483,166,317,25,1.9,61.06,9.2,0,0,0,0,0,0,0.168402545843878,111.635783473843,18.5990594346715
9.7,"random_instances_SVM","SVM",30,17,984,889,95,1800,1627,173,0.801645221176626,0.268292682926829,1.26299501704694,485,173,312,2,1.8,64.66,9.4,0,0,0,0,0,0,0.186514984955698,97.8001602682139,22.8786380589135
9.7,"random_instances_SVM","SVM",30,18,884,795,89,1900,1721,179,0.821227834325596,0.300813008130081,1.26299501704694,512,179,333,27,1.9,68.25,9.6,0,0,0,0,0,0,0.188750085134953,81.1926428007807,22.922045836614
9.7,"random_instances_SVM","SVM",30,19,784,707,77,2000,1809,191,0.775993854426736,0.203252032520325,1.26299501704694,541,191,350,29,1.8,71.84,9.5,0,0,0,0,0,0,0.176905163982628,78.7714960538756,21.2337174922836
9.7,"random_instances_SVM","SVM",30,20,684,613,71,2100,1903,197,0.784572050444919,0.219512195121951,1.26299501704694,542,197,345,1,1.8,75.43,9.7,0,0,0,0,0,0,0.17238461320376,68.5784794450847,20.5919691913114
9.7,"random_instances_SVM","SVM",30,21,584,522,62,2200,1994,206,0.797042442865381,0.24390243902439,1.26299501704694,566,206,360,24,1.7,79.02,9.7,0,0,0,0,0,0,0.138155038655406,57.1393834642108,15.2141212347793
9.7,"random_instances_SVM","SVM",30,22,484,433,51,2300,2083,217,0.794436975865829,0.195121951219512,1.26299501704694,615,217,398,49,1.8,82.61,9.6,0,0,0,0,0,0,0.1542924558927,50.3267078740651,18.1515922894674
9.7,"random_instances_SVM","SVM",30,23,384,343,41,2400,2173,227,0.823212342359651,0.268292682926829,1.27343299239444,612,227,385,-3,1.7,86.21,9.6,0,0,0,0,0,0,0.133850770824264,36.1197764523556,15.3125898684811
9.7,"random_instances_SVM","SVM",30,24,284,252,32,2500,2264,236,0.763081748927735,0.211382113821138,1.27343299239444,643,236,407,31,1.7,89.8,9.6,0,0,0,0,0,0,0.131616774954174,27.7525515315662,17.2170301768739
9.7,"random_instances_SVM","SVM",30,25,184,162,22,2600,2354,246,0.728173612444792,0.138211382113821,1.26299501704694,661,246,415,18,1.7,93.39,9.6,0,0,0,0,0,0,0.0883874561967368,17.1186376845901,15.2271919686719
9.7,"random_instances_SVM","SVM",30,26,84,73,11,2700,2443,257,0.756590487164724,0.170731707317073,1.27343299239444,684,257,427,23,1.7,96.98,9.5,0,0,0,0,0,0,7.42057911712195e-05,7.86933616009782,7.86933616009782
9.7,"random_instances_SVM","SVM",30,27,0,0,0,2784,2516,268,0.780410985212225,0.211382113821138,1.26299501704694,730,268,462,46,1.7,100,9.4,0,0,0,0,0,0,0,0,0
9.7,"random_instances_SVM","SVM",31,0,2684,2415,269,100,94,6,0.543657008613942,0.120689655172414,0.896496106785317,24,6,18,0,3,3.59,15.7,0,0,0,0,0,0,0.165014375208597,199.218822142307,20.017441568775
9.7,"random_instances_SVM","SVM",31,1,2584,2329,255,200,180,20,0.756824993924333,0.241379310344828,1.26173526140156,60,20,40,36,2,7.18,9,0,0,0,0,0,0,0.236255160309293,269.293880021221,29.926870298358
9.7,"random_instances_SVM","SVM",31,2,2484,2237,247,300,272,28,0.746314098236704,0.181034482758621,1.27280311457175,91,28,63,31,2.2,10.78,9.7,0,0,0,0,0,0,0.152872582639775,242.925375831945,17.3597995269838
9.7,"random_instances_SVM","SVM",31,3,2384,2143,241,400,366,34,0.737436880619985,0.155172413793103,1.26173526140156,111,34,77,20,2.3,14.37,10.8,0,0,0,0,0,0,0.141030917863657,217.546687958554,16.1851906900514
9.7,"random_instances_SVM","SVM",31,4,2284,2053,231,500,456,44,0.771001539167766,0.232758620689655,1.27280311457175,141,44,97,30,2.2,17.96,10.4,0,0,0,0,0,0,0.164445444615608,222.714049561249,19.5604686035146
9.7,"random_instances_SVM","SVM",31,5,2184,1960,224,600,549,51,0.793596251991459,0.232758620689655,1.27280311457175,166,51,115,25,2.3,21.55,10.8,0,0,0,0,0,0,0.151155663915205,191.593571563307,17.2304186466282
9.7,"random_instances_SVM","SVM",31,6,2084,1868,216,700,641,59,0.796998622849884,0.181034482758621,1.25066740823137,173,59,114,7,1.9,25.14,10.9,0,0,0,0,0,0,0.166209766044667,180.570277231262,23.5610983436583
9.7,"random_instances_SVM","SVM",31,7,1984,1780,204,800,729,71,0.798227256770988,0.224137931034483,1.28387096774194,220,71,149,47,2.1,28.74,10.3,0,0,0,0,0,0,0.15171431867006,188.900068825025,20.3275193439263
9.7,"random_instances_SVM","SVM",31,8,1884,1690,194,900,819,81,0.781174898063887,0.181034482758621,1.28387096774194,237,81,156,17,1.9,32.33,10.1,0,0,0,0,0,0,0.163703555246336,184.399131366483,19.6759182724812
9.7,"random_instances_SVM","SVM",31,9,1784,1606,178,1000,903,97,0.805322280128531,0.232758620689655,1.28387096774194,273,97,176,36,1.8,35.92,9.3,0,0,0,0,0,0,0.142115917993895,184.32320148764,15.5216273547487
9.7,"random_instances_SVM","SVM",31,10,1684,1517,167,1100,992,108,0.811485701941513,0.241379310344828,1.28387096774194,291,108,183,18,1.7,39.51,9.2,0,0,0,0,0,0,0.152079254623996,174.659482170149,19.5601238075006
9.7,"random_instances_SVM","SVM",31,11,1584,1428,156,1200,1081,119,0.80810358329058,0.21551724137931,1.28387096774194,322,119,203,31,1.7,43.1,9.1,0,0,0,0,0,0,0.140468347350293,162.21935351518,15.9855178174457
9.7,"random_instances_SVM","SVM",31,12,1484,1338,146,1300,1171,129,0.810243566548752,0.21551724137931,1.28387096774194,358,129,229,36,1.8,46.7,9.1,0,0,0,0,0,0,0.15454838683896,158.060542794487,18.0275174482742
9.7,"random_instances_SVM","SVM",31,13,1384,1252,132,1400,1257,143,0.790065617152267,0.232758620689655,1.28387096774194,384,143,241,26,1.7,50.29,8.8,0,0,0,0,0,0,0.15184773049634,145.034498412413,17.839862859229
9.7,"random_instances_SVM","SVM",31,14,1284,1156,128,1500,1353,147,0.821989846893307,0.25,1.28387096774194,407,147,260,23,1.8,53.88,9.2,0,0,0,0,0,0,0.171410094055357,132.161286469032,22.5890805717772
9.7,"random_instances_SVM","SVM",31,15,1184,1064,120,1600,1445,155,0.805423541165985,0.241379310344828,1.28387096774194,418,155,263,11,1.7,57.47,9.3,0,0,0,0,0,0,0.187361108694841,121.748750989109,24.5469764296918
9.7,"random_instances_SVM","SVM",31,16,1084,975,109,1700,1534,166,0.790679934112811,0.198275862068966,1.27280311457175,447,166,281,29,1.7,61.06,9.2,0,0,0,0,0,0,0.16089075197325,111.769310138491,19.4328757735874
9.7,"random_instances_SVM","SVM",31,17,984,886,98,1800,1623,177,0.816305727324271,0.241379310344828,1.27280311457175,490,177,313,43,1.8,64.66,9.2,0,0,0,0,0,0,0.164463237868467,97.8092847124765,21.0443887530873
9.7,"random_instances_SVM","SVM",31,18,884,792,92,1900,1717,183,0.792178597467119,0.232758620689655,1.27280311457175,500,183,317,10,1.7,68.25,9.4,0,0,0,0,0,0,0.138926335621732,89.6538616485338,15.8338803383084
9.7,"random_instances_SVM","SVM",31,19,784,702,82,2000,1807,193,0.803040531417921,0.189655172413793,1.27280311457175,530,193,337,30,1.7,71.84,9.4,0,0,0,0,0,0,0.170689825359189,78.4406043433773,20.8642637983407
9.7,"random_instances_SVM","SVM",31,20,684,609,75,2100,1900,200,0.763960521696862,0.146551724137931,1.27280311457175,556,200,356,26,1.8,75.43,9.5,0,0,0,0,0,0,0.153816097043593,69.060282086618,18.4179216553622
9.7,"random_instances_SVM","SVM",31,21,584,517,67,2200,1992,208,0.812039262279589,0.258620689655172,1.27280311457175,569,208,361,13,1.7,79.02,9.6,0,0,0,0,0,0,0.148370414579881,58.5893622864241,16.5142527131043
9.7,"random_instances_SVM","SVM",31,22,484,428,56,2300,2081,219,0.768537520589744,0.163793103448276,1.27280311457175,589,219,370,20,1.7,82.61,9.5,0,0,0,0,0,0,0.136430970484673,47.2019364742502,15.3165852003517
9.7,"random_instances_SVM","SVM",31,23,384,340,44,2400,2169,231,0.798416277374234,0.224137931034483,1.28387096774194,612,231,381,23,1.6,86.21,9.4,0,0,0,0,0,0,0.145712708608094,38.1802546032703,16.7337848807162
9.7,"random_instances_SVM","SVM",31,24,284,256,28,2500,2253,247,0.785967920503336,0.224137931034483,1.28387096774194,645,247,398,33,1.6,89.8,9.1,0,0,0,0,0,0,0.135731858471811,29.3489845193832,17.5394733584182
9.7,"random_instances_SVM","SVM",31,25,184,169,15,2600,2340,260,0.811222423244132,0.25,1.28387096774194,707,260,447,62,1.7,93.39,9,0,0,0,0,0,0,0.0895376225280375,18.5251395972934,15.3181338380802
9.7,"random_instances_SVM","SVM",31,26,84,78,6,2700,2431,269,0.82541246995922,0.267241379310345,1.28387096774194,718,269,449,11,1.7,96.98,9,0,0,0,0,0,0,2.40269429239098e-07,7.79723724254808,7.79723724254808
9.7,"random_instances_SVM","SVM",31,27,0,0,0,2784,2509,275,0.811094159263353,0.21551724137931,1.28387096774194,750,275,475,32,1.7,100,9.1,0,0,0,0,0,0,0,0,0
9.7,"random_instances_SVM","SVM",32,0,2684,2442,242,100,95,5,0.66098434302998,0.243055555555556,1.15905017921147,23,5,18,0,3.6,3.59,19,0,0,0,0,0,0,0.057320014186431,147.551207981347,5.78019368799974
9.7,"random_instances_SVM","SVM",32,1,2584,2355,229,200,182,18,0.750722800462589,0.159722222222222,1.27495519713262,58,18,40,35,2.2,7.18,10.1,0,0,0,0,0,0,0.110975054209177,244.088259793109,11.5947391733154
9.7,"random_instances_SVM","SVM",32,2,2484,2267,217,300,270,30,0.795575349168222,0.291666666666667,1.27495519713262,82,30,52,24,1.7,10.78,9,0,0,0,0,0,0,0.136022907057553,257.339284554602,14.3947951107112
9.7,"random_instances_SVM","SVM",32,3,2384,2177,207,400,360,40,0.792595187260921,0.284722222222222,1.28387096774194,110,40,70,28,1.8,14.37,9,0,0,0,0,0,0,0.160020476731819,247.669065103941,17.8587768826625
9.7,"random_instances_SVM","SVM",32,4,2284,2087,197,500,450,50,0.809764478249267,0.284722222222222,1.28387096774194,139,50,89,29,1.8,17.96,9,0,0,0,0,0,0,0.180376199246762,254.422404042753,20.2724973281196
9.7,"random_instances_SVM","SVM",32,5,2184,1995,189,600,542,58,0.782848501023032,0.25,1.26487364436259,169,58,111,30,1.9,21.55,9.3,0,0,0,0,0,0,0.207773738920261,218.775040645022,30.076848079704
9.7,"random_instances_SVM","SVM",32,6,2084,1902,182,700,635,65,0.772662574504043,0.208333333333333,1.23929211469534,181,65,116,12,1.8,25.14,9.8,0,0,0,0,0,0,0.160782767287356,198.904843228796,23.8804534922899
9.7,"random_instances_SVM","SVM",32,7,1984,1810,174,800,727,73,0.769560092518458,0.215277777777778,1.2660394265233,217,73,144,36,2,28.74,10,0,0,0,0,0,0,0.163258241214687,183.00972635198,25.6416385230409
9.7,"random_instances_SVM","SVM",32,8,1884,1722,162,900,815,85,0.785294902588729,0.236111111111111,1.27495519713262,229,85,144,12,1.7,32.33,9.6,0,0,0,0,0,0,0.153060235894742,193.255562931444,19.9042612481641
9.7,"random_instances_SVM","SVM",32,9,1784,1634,150,1000,903,97,0.776521216973568,0.222222222222222,1.24820788530466,256,97,159,27,1.6,35.92,9.3,0,0,0,0,0,0,0.185483911456734,171.832232935239,28.8410596050886
9.7,"random_instances_SVM","SVM",32,10,1684,1543,141,1100,994,106,0.782653900898491,0.263888888888889,1.23929211469534,277,106,171,21,1.6,39.51,9.4,0,0,0,0,0,0,0.162453016096819,165.081471033293,23.0773788777884
9.7,"random_instances_SVM","SVM",32,11,1584,1451,133,1200,1086,114,0.792311627079437,0.305555555555556,1.23929211469534,300,114,186,23,1.6,43.1,9.5,0,0,0,0,0,0,0.142045658326465,155.057238043316,17.4256328022489
9.7,"random_instances_SVM","SVM",32,12,1484,1361,123,1300,1176,124,0.780418779468016,0.263888888888889,1.27495519713262,334,124,210,34,1.7,46.7,9.5,0,0,0,0,0,0,0.141532426766224,146.736290007198,17.3727850983514
9.7,"random_instances_SVM","SVM",32,13,1384,1269,115,1400,1268,132,0.796998710079173,0.284722222222222,1.25712365591398,362,132,230,28,1.7,50.29,9.6,0,0,0,0,0,0,0.184949214473964,137.913386966872,24.8333775022777
9.7,"random_instances_SVM","SVM",32,14,1284,1179,105,1500,1358,142,0.76345520861133,0.25,1.23037634408602,382,142,240,20,1.7,53.88,9.6,0,0,0,0,0,0,0.147697630006133,129.906626728423,17.9957825484479
9.7,"random_instances_SVM","SVM",32,15,1184,1092,92,1600,1445,155,0.789103505026237,0.291666666666667,1.27495519713262,417,155,262,35,1.7,57.47,9.3,0,0,0,0,0,0,0.139959687480524,118.940652847025,16.4328135411884
9.7,"random_instances_SVM","SVM",32,16,1084,999,85,1700,1538,162,0.783532381460714,0.277777777777778,1.27495519713262,440,162,278,23,1.7,61.06,9.5,0,0,0,0,0,0,0.127459499749221,109.571154068209,14.1345750676201
9.7,"random_instances_SVM","SVM",32,17,984,913,71,1800,1624,176,0.801702473089574,0.319444444444444,1.27495519713262,469,176,293,29,1.7,64.66,9.2,0,0,0,0,0,0,0.157265792780021,99.2884297351472,18.5796853867543
9.7,"random_instances_SVM","SVM",32,18,884,816,68,1900,1721,179,0.777827817809793,0.236111111111111,1.27495519713262,488,179,309,19,1.7,68.25,9.6,0,0,0,0,0,0,0.152417362842734,88.1899086861987,18.9136917575918
9.7,"random_instances_SVM","SVM",32,19,784,725,59,2000,1812,188,0.783621341517657,0.277777777777778,1.2660394265233,492,188,304,4,1.6,71.84,9.6,0,0,0,0,0,0,0.146446955953096,75.6193300906872,17.2959506640676
9.7,"random_instances_SVM","SVM",32,20,684,637,47,2100,1900,200,0.804126634641035,0.305555555555556,1.27495519713262,539,200,339,47,1.7,75.43,9.5,0,0,0,0,0,0,0.148057391421284,64.4869928756345,17.4221093726361
9.7,"random_instances_SVM","SVM",32,21,584,541,43,2200,1996,204,0.773201894849209,0.236111111111111,1.2660394265233,568,204,364,29,1.8,79.02,9.8,0,0,0,0,0,0,0.143274666689865,55.2149593502427,17.8955557717064
9.7,"random_instances_SVM","SVM",32,22,484,444,40,2300,2093,207,0.788697624766476,0.284722222222222,1.27495519713262,566,207,359,-2,1.7,82.61,10.1,0,0,0,0,0,0,0.137045587601562,43.2498407421764,17.7403249410779
9.7,"random_instances_SVM","SVM",32,23,384,351,33,2400,2186,214,0.796398229694866,0.291666666666667,1.2660394265233,581,214,367,15,1.7,86.21,10.2,0,0,0,0,0,0,0.131058428876549,35.2659790960603,16.8048073000047
9.7,"random_instances_SVM","SVM",32,24,284,259,25,2500,2278,222,0.762220887821366,0.215277777777778,1.24820788530466,624,222,402,43,1.8,89.8,10.3,0,0,0,0,0,0,0.12021244846156,26.1951826612657,16.0678327275601
9.7,"random_instances_SVM","SVM",32,25,184,165,19,2600,2372,228,0.734815630281997,0.236111111111111,1.25712365591398,648,228,420,24,1.8,93.39,10.4,0,0,0,0,0,0,0.0910368222165831,16.5323594501751,13.1855785563917
9.7,"random_instances_SVM","SVM",32,26,84,77,7,2700,2460,240,0.733325549328348,0.1875,1.25712365591398,670,240,430,22,1.8,96.98,10.2,0,0,0,0,0,0,2.60991765676366e-05,6.42140944783917,6.42140944783917
9.7,"random_instances_SVM","SVM",32,27,0,0,0,2784,2537,247,0.761826127568715,0.236111111111111,1.25712365591398,667,247,420,-3,1.7,100,10.3,0,0,0,0,0,0,0,0,0
9.7,"random_instances_SVM","SVM",33,0,2684,2435,249,100,90,10,0.80047701439453,0.242424242424242,1.24496578690127,24,10,14,0,1.4,3.59,9,0,0,0,0,0,0,0.254338670694675,194.491031219239,36.5558894136463
9.7,"random_instances_SVM","SVM",33,1,2584,2349,235,200,176,24,0.789344675942607,0.25,1.27414467253177,59,24,35,35,1.5,7.18,7.3,0,0,0,0,0,0,0.220057862084814,290.612048303057,28.7347051471566
9.7,"random_instances_SVM","SVM",33,2,2484,2261,223,300,264,36,0.798680700742557,0.21969696969697,1.28268876611418,96,36,60,37,1.7,10.78,7.3,0,0,0,0,0,0,0.234102859365662,299.077754742331,34.4034953303928
9.7,"random_instances_SVM","SVM",33,3,2384,2173,211,400,352,48,0.800585153677928,0.21969696969697,1.27414467253177,128,48,80,32,1.7,14.37,7.3,0,0,0,0,0,0,0.206153862851869,279.019618802251,26.5393459981462
9.7,"random_instances_SVM","SVM",33,4,2284,2080,204,500,445,55,0.79376036334799,0.166666666666667,1.27414467253177,151,55,96,23,1.7,17.96,8.1,0,0,0,0,0,0,0.201363522245093,249.163641963953,26.8588472133665
9.7,"random_instances_SVM","SVM",33,5,2184,1984,200,600,541,59,0.795106096652485,0.196969696969697,1.27297142697695,167,59,108,16,1.8,21.55,9.2,0,0,0,0,0,0,0.16140229371441,221.018720464898,19.994314651857
9.7,"random_instances_SVM","SVM",33,6,2084,1890,194,700,635,65,0.786292745055629,0.174242424242424,1.27414467253177,194,65,129,27,2,25.14,9.8,0,0,0,0,0,0,0.156623874767339,197.038569915004,20.1037988830093
9.7,"random_instances_SVM","SVM",33,7,1984,1800,184,800,725,75,0.794090788936146,0.189393939393939,1.27414467253177,221,75,146,27,1.9,28.74,9.7,0,0,0,0,0,0,0.160548804374318,204.950053329974,19.9220269305621
9.7,"random_instances_SVM","SVM",33,8,1884,1709,175,900,816,84,0.799305505491072,0.227272727272727,1.2644183773216,247,84,163,26,1.9,32.33,9.7,0,0,0,0,0,0,0.141599091136974,188.814531108472,17.4779647839896
9.7,"random_instances_SVM","SVM",33,9,1784,1621,163,1000,904,96,0.799347559656828,0.25,1.27414467253177,269,96,173,22,1.8,35.92,9.4,0,0,0,0,0,0,0.165064040227707,179.533344453685,21.9894330449512
9.7,"random_instances_SVM","SVM",33,10,1684,1532,152,1100,993,107,0.802129142335324,0.189393939393939,1.27414467253177,306,107,199,37,1.9,39.51,9.3,0,0,0,0,0,0,0.160354234185171,183.813147027332,19.3564999301578
9.7,"random_instances_SVM","SVM",33,11,1584,1439,145,1200,1086,114,0.81147117487323,0.234848484848485,1.27414467253177,311,114,197,5,1.7,43.1,9.5,0,0,0,0,0,0,0.16280537488019,158.121789737225,21.0964819055537
9.7,"random_instances_SVM","SVM",33,12,1484,1350,134,1300,1175,125,0.79249873837502,0.174242424242424,1.2644183773216,346,125,221,35,1.8,46.7,9.4,0,0,0,0,0,0,0.157972564668595,154.704346347997,18.27527370074
9.7,"random_instances_SVM","SVM",33,13,1384,1256,128,1400,1269,131,0.810377766563322,0.242424242424242,1.27414467253177,352,131,221,6,1.7,50.29,9.7,0,0,0,0,0,0,0.149441041430755,139.653189611322,17.0887271759009
9.7,"random_instances_SVM","SVM",33,14,1284,1166,118,1500,1359,141,0.809885132050072,0.234848484848485,1.27414467253177,396,141,255,44,1.8,53.88,9.6,0,0,0,0,0,0,0.146130573080651,122.917886108166,17.3061774871832
9.7,"random_instances_SVM","SVM",33,15,1184,1070,114,1600,1455,145,0.800056472736875,0.234848484848485,1.27414467253177,411,145,266,15,1.8,57.47,10,0,0,0,0,0,0,0.134708519110602,113.37778090867,14.4825000781785
9.7,"random_instances_SVM","SVM",33,16,1084,978,106,1700,1547,153,0.770528440631531,0.204545454545455,1.27414467253177,446,153,293,35,1.9,61.06,10.1,0,0,0,0,0,0,0.14497692450824,102.130438050452,16.3685867713627
9.7,"random_instances_SVM","SVM",33,17,984,888,96,1800,1637,163,0.788701847980199,0.189393939393939,1.28387096774194,468,163,305,22,1.9,64.66,10,0,0,0,0,0,0,0.137339384838075,92.8276177764877,15.5800436612195
9.7,"random_instances_SVM","SVM",33,18,884,796,88,1900,1729,171,0.791357268161389,0.25,1.27414467253177,484,171,313,16,1.8,68.25,10.1,0,0,0,0,0,0,0.169736339362924,84.1315690734592,20.7315856976245
9.7,"random_instances_SVM","SVM",33,19,784,707,77,2000,1818,182,0.781444500516666,0.174242424242424,1.28387096774194,532,182,350,48,1.9,71.84,10,0,0,0,0,0,0,0.149948467479899,77.8893608706997,17.2506757849537
9.7,"random_instances_SVM","SVM",33,20,684,617,67,2100,1908,192,0.773322038785949,0.159090909090909,1.27414467253177,543,192,351,11,1.8,75.43,9.9,0,0,0,0,0,0,0.141297795364564,63.1256710420386,17.4900159904404
9.7,"random_instances_SVM","SVM",33,21,584,527,57,2200,1998,202,0.737071347896087,0.136363636363636,1.27414467253177,573,202,371,30,1.8,79.02,9.9,0,0,0,0,0,0,0.138273179560806,55.5485364812267,18.6814547564855
9.7,"random_instances_SVM","SVM",33,22,484,436,48,2300,2089,211,0.711177997260476,0.128787878787879,1.28387096774194,618,211,407,45,1.9,82.61,9.9,0,0,0,0,0,0,0.124661315001,47.6903189467984,14.9246610173302
9.7,"random_instances_SVM","SVM",33,23,384,352,32,2400,2173,227,0.781624732655658,0.196969696969697,1.28387096774194,652,227,425,34,1.9,86.21,9.6,0,0,0,0,0,0,0.116616034459726,36.4367329237956,13.8268510209542
9.7,"random_instances_SVM","SVM",33,24,284,261,23,2500,2264,236,0.691094129238462,0.143939393939394,1.27414467253177,663,236,427,11,1.8,89.8,9.6,0,0,0,0,0,0,0.11815826541126,28.1371936166509,14.8769381149768
9.7,"random_instances_SVM","SVM",33,25,184,168,16,2600,2357,243,0.720441929204817,0.121212121212121,1.27414467253177,691,243,448,28,1.8,93.39,9.7,0,0,0,0,0,0,0.10235960696863,18.5700525308126,13.7247619741548
9.7,"random_instances_SVM","SVM",33,26,84,75,9,2700,2450,250,0.792414630043485,0.212121212121212,1.27414467253177,709,250,459,18,1.8,96.98,9.8,0,0,0,0,0,0,1.16621665769796e-05,8.40267034869916,8.40267034869916
9.7,"random_instances_SVM","SVM",33,27,0,0,0,2784,2525,259,0.769927666834874,0.204545454545455,1.27414467253177,730,259,471,21,1.8,100,9.7,0,0,0,0,0,0,0,0,0
9.7,"random_instances_SVM","SVM",34,0,2684,2419,265,100,93,7,0.560822131050223,0.151260504201681,1.02493900786121,25,7,18,0,2.6,3.59,13.3,0,0,0,0,0,0,0.0981832472085971,197.67858377182,11.5211136319976
9.7,"random_instances_SVM","SVM",34,1,2584,2333,251,200,179,21,0.79417701146393,0.168067226890756,1.27308213608024,56,21,35,31,1.7,7.18,8.5,0,0,0,0,0,0,0.244768120576807,276.318595193508,32.9447435884651
9.7,"random_instances_SVM","SVM",34,2,2484,2239,245,300,273,27,0.78599791564978,0.201680672268908,1.27308213608024,73,27,46,17,1.7,10.78,10.1,0,0,0,0,0,0,0.201584418005951,198.782569091646,27.1148319180722
9.7,"random_instances_SVM","SVM",34,3,2384,2144,240,400,368,32,0.78987639011649,0.201680672268908,1.27308213608024,88,32,56,15,1.8,14.37,11.5,0,0,0,0,0,0,0.187837196705276,185.487792017155,26.4303299818183
9.7,"random_instances_SVM","SVM",34,4,2284,2053,231,500,459,41,0.801953748532384,0.19327731092437,1.26229330441854,109,41,68,21,1.7,17.96,11.2,0,0,0,0,0,0,0.176452065046367,186.810284664713,24.9453133891111
9.7,"random_instances_SVM","SVM",34,5,2184,1958,226,600,554,46,0.809196205954914,0.218487394957983,1.26229330441854,125,46,79,16,1.7,21.55,12,0,0,0,0,0,0,0.165037562878355,171.338194832293,24.8409968124655
9.7,"random_instances_SVM","SVM",34,6,2084,1865,219,700,647,53,0.804381093096582,0.184873949579832,1.26229330441854,139,53,86,14,1.6,25.14,12.2,0,0,0,0,0,0,0.1539889686462,183.102992880971,19.9306717675704
9.7,"random_instances_SVM","SVM",34,7,1984,1774,210,800,738,62,0.808424468688578,0.226890756302521,1.26229330441854,164,62,102,25,1.6,28.74,11.9,0,0,0,0,0,0,0.172999811064513,167.171872016732,26.4684495073112
9.7,"random_instances_SVM","SVM",34,8,1884,1690,194,900,822,78,0.818311940160683,0.218487394957983,1.26229330441854,206,78,128,42,1.6,32.33,10.5,0,0,0,0,0,0,0.185154011100562,168.077027020124,22.9182765419158
9.7,"random_instances_SVM","SVM",34,9,1784,1600,184,1000,912,88,0.813318734087045,0.218487394957983,1.26229330441854,232,88,144,26,1.6,35.92,10.4,0,0,0,0,0,0,0.174122187724401,164.010400634571,23.1131340276547
9.7,"random_instances_SVM","SVM",34,10,1684,1508,176,1100,1004,96,0.811643338654147,0.226890756302521,1.26229330441854,254,96,158,22,1.6,39.51,10.5,0,0,0,0,0,0,0.1529397995933,155.419062596426,17.9362410767691
9.7,"random_instances_SVM","SVM",34,11,1584,1421,163,1200,1091,109,0.819954355368524,0.226890756302521,1.27308213608024,289,109,180,35,1.7,43.1,10,0,0,0,0,0,0,0.151755152292148,149.433768364053,19.2398964719606
9.7,"random_instances_SVM","SVM",34,12,1484,1335,149,1300,1177,123,0.815620753796028,0.218487394957983,1.27308213608024,322,123,199,33,1.6,46.7,9.6,0,0,0,0,0,0,0.179990297878358,140.743006171669,29.7219090019953
9.7,"random_instances_SVM","SVM",34,13,1384,1244,140,1400,1268,132,0.800344313549599,0.210084033613445,1.27308213608024,352,132,220,30,1.7,50.29,9.6,0,0,0,0,0,0,0.124686167756577,134.619030722391,15.038530994278
9.7,"random_instances_SVM","SVM",34,14,1284,1157,127,1500,1355,145,0.809545796340518,0.218487394957983,1.27308213608024,372,145,227,20,1.6,53.88,9.3,0,0,0,0,0,0,0.167845353911425,132.446771280423,24.7313769866861
9.7,"random_instances_SVM","SVM",34,15,1184,1072,112,1600,1440,160,0.810620951677378,0.201680672268908,1.26229330441854,407,160,247,35,1.5,57.47,9,0,0,0,0,0,0,0.12196772738828,119.598249668195,14.1863633135209
9.7,"random_instances_SVM","SVM",34,16,1084,984,100,1700,1528,172,0.812804242576157,0.226890756302521,1.26229330441854,458,172,286,51,1.7,61.06,8.9,0,0,0,0,0,0,0.153691938373417,121.419279513472,24.7506358850784
9.7,"random_instances_SVM","SVM",34,17,984,894,90,1800,1618,182,0.812012717174787,0.201680672268908,1.27308213608024,481,182,299,23,1.6,64.66,8.9,0,0,0,0,0,0,0.165380864845162,110.510519000082,25.4319539838225
9.7,"random_instances_SVM","SVM",34,18,884,801,83,1900,1711,189,0.802164821972749,0.201680672268908,1.27190986891994,500,189,311,19,1.6,68.25,9.1,0,0,0,0,0,0,0.155479341127692,94.9227078168698,20.2616043826689
9.7,"random_instances_SVM","SVM",34,19,784,710,74,2000,1802,198,0.797151827764077,0.243697478991597,1.26229330441854,541,198,343,41,1.7,71.84,9.1,0,0,0,0,0,0,0.151666245457038,80.0322364416652,21.6984290512578
9.7,"random_instances_SVM","SVM",34,20,684,620,64,2100,1892,208,0.761698085827741,0.210084033613445,1.25150447275684,557,208,349,16,1.7,75.43,9.1,0,0,0,0,0,0,0.154180749888452,70.9546179369253,21.827869920501
9.7,"random_instances_SVM","SVM",34,21,584,531,53,2200,1981,219,0.828060894687551,0.210084033613445,1.27308213608024,579,219,360,22,1.6,79.02,9,0,0,0,0,0,0,0.177737382294038,63.0114591482856,22.4754640655487
9.7,"random_instances_SVM","SVM",34,22,484,437,47,2300,2075,225,0.803866601585692,0.226890756302521,1.27308213608024,608,225,383,29,1.7,82.61,9.2,0,0,0,0,0,0,0.139424351078893,49.8337408407852,17.2453056100551
9.7,"random_instances_SVM","SVM",34,23,384,346,38,2400,2166,234,0.80712504782133,0.19327731092437,1.27308213608024,636,234,402,28,1.7,86.21,9.3,0,0,0,0,0,0,0.141948777481658,39.2860387229731,17.883285595858
9.7,"random_instances_SVM","SVM",34,24,284,259,25,2500,2253,247,0.757601941875654,0.19327731092437,1.27308213608024,678,247,431,42,1.7,89.8,9.1,0,0,0,0,0,0,0.127462362236632,29.3205835548385,17.1480828468842
9.7,"random_instances_SVM","SVM",34,25,184,169,15,2600,2343,257,0.795054285450447,0.218487394957983,1.27308213608024,690,257,433,12,1.7,93.39,9.1,0,0,0,0,0,0,0.103701947919457,19.4997380070486,15.8296201480207
9.7,"random_instances_SVM","SVM",34,26,84,77,7,2700,2435,265,0.814802844214612,0.235294117647059,1.27308213608024,712,265,447,22,1.7,96.98,9.2,0,0,0,0,0,0,8.96878379815722e-07,9.11349373501467,9.11349373501467
9.7,"random_instances_SVM","SVM",34,27,0,0,0,2784,2512,272,0.809756869780883,0.277310924369748,1.27308213608024,713,272,441,1,1.6,100,9.2,0,0,0,0,0,0,0,0,0
9.7,"random_instances_SVM","SVM",35,0,2684,2441,243,100,92,8,0.736797400524457,0.135714285714286,1.27470046082949,26,8,18,0,2.2,3.59,11.5,0,0,0,0,0,0,0.137982529761683,221.928344076295,15.1554750128756
9.7,"random_instances_SVM","SVM",35,1,2584,2354,230,200,179,21,0.748175806635508,0.328571428571429,1.21967741935484,60,21,39,34,1.9,7.18,8.5,0,0,0,0,0,0,0.217239895578482,288.346252036337,25.9768480711076
9.7,"random_instances_SVM","SVM",35,2,2484,2266,218,300,267,33,0.734921901721579,0.235714285714286,1.20133640552995,91,33,58,31,1.8,10.78,8.1,0,0,0,0,0,0,0.257524291167703,251.035544055732,34.4922519201221
9.7,"random_instances_SVM","SVM",35,3,2384,2179,205,400,354,46,0.750507353779503,0.25,1.17382488479263,126,46,80,35,1.7,14.37,7.7,0,0,0,0,0,0,0.173418816498456,288.409001540503,19.4990468320417
9.7,"random_instances_SVM","SVM",35,4,2284,2089,195,500,444,56,0.761213088587396,0.257142857142857,1.17382488479263,145,56,89,19,1.6,17.96,7.9,0,0,0,0,0,0,0.189068869829282,252.091050383563,22.064592517118
9.7,"random_instances_SVM","SVM",35,5,2184,1998,186,600,535,65,0.777847451829895,0.264285714285714,1.25635944700461,168,65,103,23,1.6,21.55,8.2,0,0,0,0,0,0,0.185929026535808,256.771903046801,21.0803842130423
9.7,"random_instances_SVM","SVM",35,6,2084,1910,174,700,623,77,0.793752137726603,0.235714285714286,1.28387096774194,203,77,126,35,1.6,25.14,8.1,0,0,0,0,0,0,0.166575789687285,232.901405956263,19.290183736446
9.7,"random_instances_SVM","SVM",35,7,1984,1816,168,800,717,83,0.812170790103754,0.228571428571429,1.28387096774194,219,83,136,16,1.6,28.74,8.6,0,0,0,0,0,0,0.180756048590878,217.329972011813,23.035746074906
9.7,"random_instances_SVM","SVM",35,8,1884,1724,160,900,809,91,0.819729791357889,0.235714285714286,1.28387096774194,247,91,156,28,1.7,32.33,8.9,0,0,0,0,0,0,0.210743154786982,197.34811002848,28.0551117174649
9.7,"random_instances_SVM","SVM",35,9,1784,1639,145,1000,894,106,0.832915289020638,0.3,1.28387096774194,250,106,144,3,1.4,35.92,8.4,0,0,0,0,0,0,0.262702185342921,193.222989615933,33.7918105736585
9.7,"random_instances_SVM","SVM",35,10,1684,1545,139,1100,988,112,0.831740964542245,0.3,1.28387096774194,271,112,159,21,1.4,39.51,8.8,0,0,0,0,0,0,0.21825511814897,166.152803212119,27.3762690715476
9.7,"random_instances_SVM","SVM",35,11,1584,1451,133,1200,1082,118,0.82337247748262,0.307142857142857,1.27470046082949,305,118,187,34,1.6,43.1,9.2,0,0,0,0,0,0,0.211997934241386,155.670196362106,28.7487872952702
9.7,"random_instances_SVM","SVM",35,12,1484,1363,121,1300,1170,130,0.824045148785772,0.285714285714286,1.28387096774194,329,130,199,24,1.5,46.7,9,0,0,0,0,0,0,0.18342860842245,153.385718326312,23.6558206711297
9.7,"random_instances_SVM","SVM",35,13,1384,1274,110,1400,1259,141,0.829871166343634,0.278571428571429,1.27470046082949,372,141,231,43,1.6,50.29,8.9,0,0,0,0,0,0,0.216154709187512,149.830775880765,30.3939542428253
9.7,"random_instances_SVM","SVM",35,14,1284,1184,100,1500,1349,151,0.823634705278759,0.321428571428571,1.27470046082949,391,151,240,19,1.6,53.88,8.9,0,0,0,0,0,0,0.211635612689919,138.82191797939,29.295394064445
9.7,"random_instances_SVM","SVM",35,15,1184,1092,92,1600,1441,159,0.809177972865126,0.257142857142857,1.28387096774194,416,159,257,25,1.6,57.47,9.1,0,0,0,0,0,0,0.127357264855727,115.114791309667,14.1977373082155
9.7,"random_instances_SVM","SVM",35,16,1084,999,85,1700,1534,166,0.812284802189035,0.235714285714286,1.28387096774194,447,166,281,31,1.7,61.06,9.2,0,0,0,0,0,0,0.195162245152041,111.612291622016,27.1116517949808
9.7,"random_instances_SVM","SVM",35,17,984,907,77,1800,1626,174,0.80026792840041,0.278571428571429,1.27470046082949,477,174,303,30,1.7,64.66,9.3,0,0,0,0,0,0,0.174828841995781,99.950722234204,22.6521074987039
9.7,"random_instances_SVM","SVM",35,18,884,816,68,1900,1717,183,0.813903773800033,0.271428571428571,1.26552995391705,478,183,295,1,1.6,68.25,9.4,0,0,0,0,0,0,0.18957837091882,88.3666047264092,28.1288603937321
9.7,"random_instances_SVM","SVM",35,19,784,723,61,2000,1810,190,0.807000342036256,0.235714285714286,1.28387096774194,513,190,323,35,1.7,71.84,9.5,0,0,0,0,0,0,0.15022576414891,75.0474264092908,19.2796580931798
9.7,"random_instances_SVM","SVM",35,20,684,632,52,2100,1901,199,0.780395621935926,0.242857142857143,1.27470046082949,524,199,325,11,1.6,75.43,9.6,0,0,0,0,0,0,0.154442018341792,68.1034663482293,19.6879316040208
9.7,"random_instances_SVM","SVM",35,21,584,540,44,2200,1993,207,0.790673811424014,0.25,1.27470046082949,558,207,351,34,1.7,79.02,9.6,0,0,0,0,0,0,0.14813739933726,53.2528713352653,18.0018857104188
9.7,"random_instances_SVM","SVM",35,22,484,445,39,2300,2088,212,0.831216508949954,0.314285714285714,1.28387096774194,590,212,378,32,1.8,82.61,9.8,0,0,0,0,0,0,0.142109870153499,43.9340264394203,17.2192199303664
9.7,"random_instances_SVM","SVM",35,23,384,351,33,2400,2182,218,0.774581005586593,0.185714285714286,1.27470046082949,603,218,385,13,1.8,86.21,10,0,0,0,0,0,0,0.131354254405074,34.5415393029978,15.0772299579329
9.7,"random_instances_SVM","SVM",35,24,284,256,28,2500,2277,223,0.799424238969331,0.235714285714286,1.27470046082949,623,223,400,20,1.8,89.8,10.2,0,0,0,0,0,0,0.118508252338626,24.329781363719,16.2072785805233
9.7,"random_instances_SVM","SVM",35,25,184,162,22,2600,2371,229,0.808898643256188,0.242857142857143,1.27470046082949,631,229,402,8,1.8,93.39,10.4,0,0,0,0,0,0,0.0707202171777118,16.6009733697367,14.3460009338562
9.7,"random_instances_SVM","SVM",35,26,84,73,11,2700,2460,240,0.782339527989964,0.2,1.27470046082949,658,240,418,27,1.7,96.98,10.2,0,0,0,0,0,0,3.81082188964597e-05,8.02801177567906,8.02801177567906
9.7,"random_instances_SVM","SVM",35,27,0,0,0,2784,2533,251,0.741848135902406,0.164285714285714,1.24718894009217,692,251,441,34,1.8,100,10.1,0,0,0,0,0,0,0,0,0
9.7,"random_instances_SVM","SVM",36,0,2684,2439,245,100,91,9,0.693267934353062,0.313868613138686,1.09644454909348,24,9,15,0,1.7,3.59,10.1,0,0,0,0,0,0,0.130595800046316,241.561598015512,13.7280291621433
9.7,"random_instances_SVM","SVM",36,1,2584,2353,231,200,177,23,0.754538797712585,0.277372262773723,1.23701436307982,57,23,34,33,1.5,7.18,7.7,0,0,0,0,0,0,0.230587447104317,315.68111732967,29.0904271190568
9.7,"random_instances_SVM","SVM",36,2,2484,2262,222,300,268,32,0.786467292761168,0.27007299270073,1.24638568401224,93,32,61,36,1.9,10.78,8.4,0,0,0,0,0,0,0.155082701567983,288.404165166655,18.7550799034178
9.7,"random_instances_SVM","SVM",36,3,2384,2175,209,400,355,45,0.707453856525175,0.218978102189781,1.19952907935013,129,45,84,36,1.9,14.37,7.9,0,0,0,0,0,0,0.147571540788982,289.68076690814,35.2018017181582
9.7,"random_instances_SVM","SVM",36,4,2284,2078,206,500,452,48,0.698201915477241,0.18978102189781,1.17141511655286,143,48,95,14,2,17.96,9.4,0,0,0,0,0,0,0.108513845687656,234.246538995318,29.9529747165214
9.7,"random_instances_SVM","SVM",36,5,2184,1989,195,600,541,59,0.735622297642845,0.175182481751825,1.19952907935013,164,59,105,21,1.8,21.55,9.2,0,0,0,0,0,0,0.112647923677492,230.481067894528,34.6081803545176
9.7,"random_instances_SVM","SVM",36,6,2084,1896,188,700,634,66,0.769544144311693,0.211678832116788,1.26512832587709,188,66,122,24,1.8,25.14,9.6,0,0,0,0,0,0,0.125055313813842,212.649510256413,29.1383319472106
9.7,"random_instances_SVM","SVM",36,7,1984,1804,180,800,726,74,0.788873262355298,0.27007299270073,1.24638568401224,224,74,150,36,2,28.74,9.8,0,0,0,0,0,0,0.0973662412716944,184.662370382795,13.064307948708
9.7,"random_instances_SVM","SVM",36,8,1884,1710,174,900,820,80,0.742235808266307,0.204379562043796,1.2276430421474,248,80,168,24,2.1,32.33,10.2,0,0,0,0,0,0,0.107320202534822,184.856061966684,27.307916313761
9.7,"random_instances_SVM","SVM",36,9,1784,1622,162,1000,908,92,0.778889069691761,0.277372262773723,1.25575700494467,258,92,166,10,1.8,35.92,9.9,0,0,0,0,0,0,0.108716733637251,178.526823761367,25.1994033546777
9.7,"random_instances_SVM","SVM",36,10,1684,1531,153,1100,999,101,0.780190850341724,0.313868613138686,1.26512832587709,290,101,189,32,1.9,39.51,9.9,0,0,0,0,0,0,0.102365752293357,159.308386289839,10.7720839171612
9.7,"random_instances_SVM","SVM",36,11,1584,1435,149,1200,1095,105,0.816140917755365,0.277372262773723,1.26512832587709,312,105,207,22,2,43.1,10.4,0,0,0,0,0,0,0.114259567290761,142.76670321699,12.4501249603644
9.7,"random_instances_SVM","SVM",36,12,1484,1349,135,1300,1181,119,0.800124366544244,0.284671532846715,1.26512832587709,345,119,226,33,1.9,46.7,9.9,0,0,0,0,0,0,0.132521098431729,145.605958511992,19.4316754774087
9.7,"random_instances_SVM","SVM",36,13,1384,1262,122,1400,1268,132,0.780835929145941,0.218978102189781,1.26512832587709,353,132,221,8,1.7,50.29,9.6,0,0,0,0,0,0,0.0947657969798653,130.08249308728,9.58492972160794
9.7,"random_instances_SVM","SVM",36,14,1284,1169,115,1500,1361,139,0.784537867869265,0.226277372262774,1.27449964680951,397,139,258,44,1.9,53.88,9.8,0,0,0,0,0,0,0.155484573146489,125.841456814365,26.1963264409104
9.7,"random_instances_SVM","SVM",36,15,1184,1083,101,1600,1447,153,0.806081175321964,0.284671532846715,1.25575700494467,400,153,247,3,1.6,57.47,9.5,0,0,0,0,0,0,0.131391403681874,116.110415864933,16.5860405130033
9.7,"random_instances_SVM","SVM",36,16,1084,991,93,1700,1539,161,0.794568552698876,0.277372262773723,1.27449964680951,425,161,264,25,1.6,61.06,9.6,0,0,0,0,0,0,0.117603522164998,103.071457417605,13.1035086396372
9.7,"random_instances_SVM","SVM",36,17,984,896,88,1800,1634,166,0.772211632339959,0.233576642335766,1.27449964680951,454,166,288,29,1.7,64.66,9.8,0,0,0,0,0,0,0.122884138017108,93.7705396978475,14.6754402581051
9.7,"random_instances_SVM","SVM",36,18,884,806,78,1900,1724,176,0.808510390999124,0.299270072992701,1.27449964680951,495,176,319,41,1.8,68.25,9.8,0,0,0,0,0,0,0.11168724935496,81.2522476901306,12.0985355401576
9.7,"random_instances_SVM","SVM",36,19,784,715,69,2000,1815,185,0.818488772141898,0.284671532846715,1.27449964680951,490,185,305,-5,1.6,71.84,9.8,0,0,0,0,0,0,0.141881791497278,73.7852059281206,17.6954676725877
9.7,"random_instances_SVM","SVM",36,20,684,627,57,2100,1903,197,0.803384629689902,0.291970802919708,1.27332607439072,529,197,332,39,1.7,75.43,9.7,0,0,0,0,0,0,0.156599387739459,66.7670127047494,20.8790674294078
9.7,"random_instances_SVM","SVM",36,21,584,532,52,2200,1998,202,0.723935329397002,0.175182481751825,1.24638568401224,566,202,364,37,1.8,79.02,9.9,0,0,0,0,0,0,0.132026533188424,59.6489148017424,16.6269898449562
9.7,"random_instances_SVM","SVM",36,22,484,443,41,2300,2087,213,0.760902412943423,0.197080291970803,1.27449964680951,595,213,382,29,1.8,82.61,9.8,0,0,0,0,0,0,0.135399826385953,50.0558480338426,19.1514082062886
9.7,"random_instances_SVM","SVM",36,23,384,351,33,2400,2179,221,0.772223255381476,0.211678832116788,1.27449964680951,601,221,380,6,1.7,86.21,9.9,0,0,0,0,0,0,0.128905576706359,37.9605121311404,17.0670994524945
9.7,"random_instances_SVM","SVM",36,24,284,265,19,2500,2265,235,0.791854572504538,0.248175182481752,1.27449964680951,638,235,403,37,1.7,89.8,9.6,0,0,0,0,0,0,0.120794833602056,27.4464195476289,15.3526901356895
9.7,"random_instances_SVM","SVM",36,25,184,172,12,2600,2358,242,0.757688641963834,0.197080291970803,1.27449964680951,665,242,423,27,1.7,93.39,9.7,0,0,0,0,0,0,0.0946235187186389,19.2195800824123,15.4622346196155
9.7,"random_instances_SVM","SVM",36,26,84,79,5,2700,2451,249,0.762669115254085,0.160583941605839,1.27215466125881,684,249,435,19,1.7,96.98,9.8,0,0,0,0,0,0,7.7269712408496e-08,8.41910615796686,8.41910615796686
9.7,"random_instances_SVM","SVM",36,27,0,0,0,2784,2530,254,0.820900553256781,0.299270072992701,1.27449964680951,714,254,460,30,1.8,100,10,0,0,0,0,0,0,0,0,0
9.7,"random_instances_SVM","SVM",37,0,2684,2439,245,100,90,10,0.803266413964159,0.286764705882353,1.27443074003795,30,10,20,0,2,3.59,9,0,0,0,0,0,0,0.153870694419222,260.736389695063,16.8521763068293
9.7,"random_instances_SVM","SVM",37,1,2584,2353,231,200,176,24,0.807150545182275,0.301470588235294,1.27443074003795,66,24,42,36,1.8,7.18,7.3,0,0,0,0,0,0,0.194810362994495,312.536418846978,23.1975032446623
9.7,"random_instances_SVM","SVM",37,2,2484,2263,221,300,266,34,0.806910711778747,0.272058823529412,1.27443074003795,84,34,50,18,1.5,10.78,7.8,0,0,0,0,0,0,0.421241600147432,310.384799403733,54.6476915905144
9.7,"random_instances_SVM","SVM",37,3,2384,2174,210,400,355,45,0.802108194112971,0.264705882352941,1.25555028462998,119,45,74,35,1.6,14.37,7.9,0,0,0,0,0,0,0.215234604281483,253.006491272414,28.2862121647551
9.7,"random_instances_SVM","SVM",37,4,2284,2082,202,500,447,53,0.792479760400587,0.338235294117647,1.23666982922201,131,53,78,12,1.5,17.96,8.4,0,0,0,0,0,0,0.271319851558123,235.761781794559,39.4867055466963
9.7,"random_instances_SVM","SVM",37,5,2184,1990,194,600,539,61,0.801400393092799,0.257352941176471,1.27443074003795,158,61,97,27,1.6,21.55,8.8,0,0,0,0,0,0,0.256265868888671,213.070120564044,35.1833505550719
9.7,"random_instances_SVM","SVM",37,6,2084,1898,186,700,631,69,0.801529084187377,0.235294117647059,1.27443074003795,170,69,101,12,1.5,25.14,9.1,0,0,0,0,0,0,0.267789306998092,192.326585865445,36.6139333743495
9.7,"random_instances_SVM","SVM",37,7,1984,1807,177,800,722,78,0.810654452711874,0.220588235294118,1.27443074003795,182,78,104,12,1.3,28.74,9.3,0,0,0,0,0,0,0.298447529928234,184.443705014904,43.1492360048273
9.7,"random_instances_SVM","SVM",37,8,1884,1715,169,900,814,86,0.799832701577052,0.220588235294118,1.27443074003795,220,86,134,38,1.6,32.33,9.5,0,0,0,0,0,0,0.177729545938692,184.416140056722,22.8840664737842
9.7,"random_instances_SVM","SVM",37,9,1784,1625,159,1000,904,96,0.821078431372549,0.25,1.27443074003795,242,96,146,22,1.5,35.92,9.4,0,0,0,0,0,0,0.232517843380508,169.267533169662,33.4613431856652
9.7,"random_instances_SVM","SVM",37,10,1684,1534,150,1100,995,105,0.810648603116664,0.242647058823529,1.28387096774194,270,105,165,28,1.6,39.51,9.5,0,0,0,0,0,0,0.205617701698784,168.398271245193,27.560407865711
9.7,"random_instances_SVM","SVM",37,11,1584,1442,142,1200,1087,113,0.805705695165896,0.198529411764706,1.27443074003795,289,113,176,19,1.6,43.1,9.6,0,0,0,0,0,0,0.202742367433123,152.048588350362,28.4230438749259
9.7,"random_instances_SVM","SVM",37,12,1484,1352,132,1300,1177,123,0.821452805465859,0.220588235294118,1.28387096774194,322,123,199,33,1.6,46.7,9.6,0,0,0,0,0,0,0.180198202289536,147.435640076365,22.8512376089176
9.7,"random_instances_SVM","SVM",37,13,1384,1265,119,1400,1264,136,0.826492231737564,0.294117647058824,1.28268876611418,356,136,220,34,1.6,50.29,9.3,0,0,0,0,0,0,0.21333628830662,141.101471012048,27.8844551586724
9.7,"random_instances_SVM","SVM",37,14,1284,1173,111,1500,1356,144,0.814345547288128,0.235294117647059,1.28387096774194,379,144,235,23,1.6,53.88,9.4,0,0,0,0,0,0,0.191960620374893,127.426432549734,24.7042420150911
9.7,"random_instances_SVM","SVM",37,15,1184,1081,103,1600,1448,152,0.817814357246478,0.220588235294118,1.28387096774194,392,152,240,13,1.6,57.47,9.5,0,0,0,0,0,0,0.191639355243469,114.109654401696,24.1483335738809
9.7,"random_instances_SVM","SVM",37,16,1084,985,99,1700,1544,156,0.798446347512752,0.235294117647059,1.28387096774194,403,156,247,11,1.6,61.06,9.9,0,0,0,0,0,0,0.200136293871821,108.949403035341,25.0926342878634
9.7,"random_instances_SVM","SVM",37,17,984,894,90,1800,1635,165,0.798083672609857,0.220588235294118,1.28387096774194,438,165,273,35,1.7,64.66,9.9,0,0,0,0,0,0,0.158692762095732,95.4285280828035,18.9334965981663
9.7,"random_instances_SVM","SVM",37,18,884,802,82,1900,1727,173,0.829653937947492,0.264705882352941,1.28387096774194,461,173,288,23,1.7,68.25,10,0,0,0,0,0,0,0.182603777256954,86.447994008719,22.1834791247255
9.7,"random_instances_SVM","SVM",37,19,784,712,72,2000,1817,183,0.809151106743415,0.227941176470588,1.28387096774194,466,183,283,5,1.5,71.84,9.9,0,0,0,0,0,0,0.18403743734562,79.2291411072693,23.2258790254818
9.7,"random_instances_SVM","SVM",37,20,684,614,70,2100,1915,185,0.808548598436986,0.191176470588235,1.28387096774194,496,185,311,30,1.7,75.43,10.4,0,0,0,0,0,0,0.171043854943332,63.7662883731483,21.7703505513907
9.7,"random_instances_SVM","SVM",37,21,584,526,58,2200,2003,197,0.790210117459871,0.191176470588235,1.27443074003795,546,197,349,50,1.8,79.02,10.2,0,0,0,0,0,0,0.144854586636635,55.7270888078729,17.7983323083707
9.7,"random_instances_SVM","SVM",37,22,484,438,46,2300,2091,209,0.770005615611398,0.154411764705882,1.27443074003795,578,209,369,32,1.8,82.61,10,0,0,0,0,0,0,0.134451510728827,45.8919268031381,17.1048997314962
9.7,"random_instances_SVM","SVM",37,23,384,350,34,2400,2179,221,0.761769385558517,0.161764705882353,1.27443074003795,618,221,397,40,1.8,86.21,9.9,0,0,0,0,0,0,0.129940424642157,38.2910259790853,16.2295591425124
9.7,"random_instances_SVM","SVM",37,24,284,260,24,2500,2269,231,0.791251345406899,0.198529411764706,1.28387096774194,627,231,396,9,1.7,89.8,9.8,0,0,0,0,0,0,0.128690970435153,28.6578879760697,16.3320983880217
9.7,"random_instances_SVM","SVM",37,25,184,168,16,2600,2361,239,0.755516168281155,0.220588235294118,1.27443074003795,654,239,415,27,1.7,93.39,9.9,0,0,0,0,0,0,0.0924221870228074,18.1720763860212,14.1724450857347
9.7,"random_instances_SVM","SVM",37,26,84,78,6,2700,2451,249,0.742214188778137,0.161764705882353,1.28387096774194,678,249,429,24,1.7,96.98,9.8,0,0,0,0,0,0,1.17215361031114e-05,7.94762801683753,7.94762801683753
9.7,"random_instances_SVM","SVM",37,27,0,0,0,2784,2529,255,0.814731620571859,0.272058823529412,1.27443074003795,705,255,450,27,1.8,100,9.9,0,0,0,0,0,0,0,0,0
9.7,"random_instances_SVM","SVM",38,0,2684,2422,262,100,91,9,0.794619010212096,0.183333333333333,1.26247311827957,28,9,19,0,2.1,3.59,10.1,0,0,0,0,0,0,0.136276218808001,241.070226121318,16.2414332089668
9.7,"random_instances_SVM","SVM",38,1,2584,2336,248,200,177,23,0.777710133542805,0.283333333333333,1.25177419354839,57,23,34,29,1.5,7.18,7.7,0,0,0,0,0,0,0.38356568708858,293.538846765922,51.8246582011725
9.7,"random_instances_SVM","SVM",38,2,2484,2249,235,300,264,36,0.806880073317612,0.325,1.26247311827957,91,36,55,34,1.5,10.78,7.3,0,0,0,0,0,0,0.257666141994304,291.264243372015,32.2391668309582
9.7,"random_instances_SVM","SVM",38,3,2384,2159,225,400,354,46,0.79867766431002,0.225,1.25177419354839,119,46,73,28,1.6,14.37,7.7,0,0,0,0,0,0,0.227676768430158,281.780398392069,28.1544537287416
9.7,"random_instances_SVM","SVM",38,4,2284,2063,221,500,450,50,0.774636684996074,0.233333333333333,1.26131062001228,136,50,86,17,1.7,17.96,9,0,0,0,0,0,0,0.28087481339896,252.184169692919,38.5829460254668
9.7,"random_instances_SVM","SVM",38,5,2184,1969,215,600,544,56,0.768113380466092,0.216666666666667,1.26247311827957,146,56,90,10,1.6,21.55,9.7,0,0,0,0,0,0,0.146833535425427,221.193076956651,16.9743076444192
9.7,"random_instances_SVM","SVM",38,6,2084,1878,206,700,635,65,0.772342236187471,0.191666666666667,1.27317204301075,185,65,120,39,1.8,25.14,9.8,0,0,0,0,0,0,0.136072452200895,209.92411370466,15.8413974391163
9.7,"random_instances_SVM","SVM",38,7,1984,1789,195,800,724,76,0.784956794972492,0.158333333333333,1.27317204301075,202,76,126,17,1.7,28.74,9.5,0,0,0,0,0,0,0.15738434432978,206.305525310674,19.2829102318571
9.7,"random_instances_SVM","SVM",38,8,1884,1702,182,900,811,89,0.802134066509545,0.225,1.27317204301075,232,89,143,30,1.6,32.33,9.1,0,0,0,0,0,0,0.186652389526748,198.423096038861,24.84798732853
9.7,"random_instances_SVM","SVM",38,9,1784,1611,173,1000,902,98,0.809459282534681,0.216666666666667,1.27317204301075,247,98,149,15,1.5,35.92,9.2,0,0,0,0,0,0,0.190474281399035,181.476914145656,26.1190013519072
9.7,"random_instances_SVM","SVM",38,10,1684,1524,160,1100,989,111,0.794422623723478,0.225,1.27317204301075,287,111,176,40,1.6,39.51,8.9,0,0,0,0,0,0,0.160513733179335,171.374911005819,19.3459767998695
9.7,"random_instances_SVM","SVM",38,11,1584,1435,149,1200,1078,122,0.776269965959668,0.2,1.26247311827957,336,122,214,49,1.8,43.1,8.8,0,0,0,0,0,0,0.136900417937506,165.798364705478,15.3287893128527
9.7,"random_instances_SVM","SVM",38,12,1484,1345,139,1300,1168,132,0.785244828489125,0.225,1.27317204301075,339,132,207,3,1.6,46.7,8.8,0,0,0,0,0,0,0.165513483621713,150.490632209059,20.830865442375
9.7,"random_instances_SVM","SVM",38,13,1384,1260,124,1400,1253,147,0.806971720345632,0.241666666666667,1.26247311827957,369,147,222,30,1.5,50.29,8.5,0,0,0,0,0,0,0.198698586160773,154.003444010961,26.7286916967667
9.7,"random_instances_SVM","SVM",38,14,1284,1170,114,1500,1343,157,0.79726368159204,0.25,1.23037634408602,394,157,237,25,1.5,53.88,8.6,0,0,0,0,0,0,0.149203751799975,142.533935787831,18.099254912706
9.7,"random_instances_SVM","SVM",38,15,1184,1077,107,1600,1436,164,0.792295103430214,0.241666666666667,1.26247311827957,429,164,265,35,1.6,57.47,8.8,0,0,0,0,0,0,0.198021594080741,126.635164811016,27.4767658041647
9.7,"random_instances_SVM","SVM",38,16,1084,987,97,1700,1526,174,0.809275988478659,0.258333333333333,1.27317204301075,462,174,288,33,1.7,61.06,8.8,0,0,0,0,0,0,0.169313374465827,120.565921127277,21.1478322319549
9.7,"random_instances_SVM","SVM",38,17,984,893,91,1800,1620,180,0.801911495155798,0.216666666666667,1.27317204301075,473,180,293,11,1.6,64.66,9,0,0,0,0,0,0,0.18090738073821,109.097712534355,24.3729744185818
9.7,"random_instances_SVM","SVM",38,18,884,803,81,1900,1710,190,0.801001571091904,0.183333333333333,1.27317204301075,509,190,319,36,1.7,68.25,9,0,0,0,0,0,0,0.182268274365246,97.9037889069666,24.5616479278229
9.7,"random_instances_SVM","SVM",38,19,784,714,70,2000,1799,201,0.803325477873788,0.225,1.26247311827957,526,201,325,17,1.6,71.84,9,0,0,0,0,0,0,0.171177769372207,82.8727272560539,23.4505237489739
9.7,"random_instances_SVM","SVM",38,20,684,621,63,2100,1892,208,0.756722964126736,0.1,1.26247311827957,555,208,347,29,1.7,75.43,9.1,0,0,0,0,0,0,0.164480282310669,74.1259761028567,21.2190191413024
9.7,"random_instances_SVM","SVM",38,21,584,526,58,2200,1987,213,0.748448546739983,0.1,1.26247311827957,574,213,361,19,1.7,79.02,9.3,0,0,0,0,0,0,0.163554721041388,59.7438739929613,21.6737694557344
9.7,"random_instances_SVM","SVM",38,22,484,435,49,2300,2078,222,0.777952343545432,0.141666666666667,1.26247311827957,594,222,372,20,1.7,82.61,9.4,0,0,0,0,0,0,0.166204573738436,51.1590388861767,20.9894323930838
9.7,"random_instances_SVM","SVM",38,23,384,347,37,2400,2166,234,0.799541764859904,0.225,1.27317204301075,637,234,403,43,1.7,86.21,9.3,0,0,0,0,0,0,0.158484079199033,42.4293698473863,20.7519324310692
9.7,"random_instances_SVM","SVM",38,24,284,257,27,2500,2256,244,0.77928777166797,0.15,1.27317204301075,628,244,384,-9,1.6,89.8,9.2,0,0,0,0,0,0,0.140751924738083,29.6899202684188,18.1588570785239
9.7,"random_instances_SVM","SVM",38,25,184,163,21,2600,2350,250,0.779261586802822,0.166666666666667,1.27317204301075,656,250,406,28,1.6,93.39,9.4,0,0,0,0,0,0,0.0967620538469438,19.4286725378858,16.6141951747519
9.7,"random_instances_SVM","SVM",38,26,84,74,10,2700,2439,261,0.805452998167056,0.208333333333333,1.27317204301075,682,261,421,26,1.6,96.98,9.3,0,0,0,0,0,0,1.04920988793062e-05,8.88563459797807,8.88563459797807
9.7,"random_instances_SVM","SVM",38,27,0,0,0,2784,2513,271,0.82249934537837,0.241666666666667,1.28387096774194,706,271,435,24,1.6,100,9.3,0,0,0,0,0,0,0,0,0
9.7,"random_instances_SVM","SVM",39,0,2684,2423,261,100,91,9,0.794512448671969,0.371900826446281,1.18837643295121,21,9,12,0,1.3,3.59,10.1,0,0,0,0,0,0,0.274954271881792,239.951204332016,30.5045505041809
9.7,"random_instances_SVM","SVM",39,1,2584,2337,247,200,177,23,0.82318467695826,0.363636363636364,1.26264996001066,51,23,28,30,1.2,7.18,7.7,0,0,0,0,0,0,0.216493110961126,295.449694231714,22.6463159878711
9.7,"random_instances_SVM","SVM",39,2,2484,2251,233,300,263,37,0.836906803887937,0.347107438016529,1.25203945614503,77,37,40,26,1.1,10.78,7.1,0,0,0,0,0,0,0.274158433443788,280.021744421774,28.9085551691067
9.7,"random_instances_SVM","SVM",39,3,2384,2167,217,400,347,53,0.823665471178339,0.347107438016529,1.22020794454812,121,53,68,44,1.3,14.37,6.5,0,0,0,0,0,0,0.245548906739846,281.41812969539,25.975180749531
9.7,"random_instances_SVM","SVM",39,4,2284,2077,207,500,437,63,0.825926503456519,0.330578512396694,1.23081844841376,142,63,79,21,1.3,17.96,6.9,0,0,0,0,0,0,0.159680369360675,275.475877027224,16.5262999223396
9.7,"random_instances_SVM","SVM",39,5,2184,1984,200,600,530,70,0.820117989500492,0.355371900826446,1.22020794454812,155,70,85,13,1.2,21.55,7.6,0,0,0,0,0,0,0.335942898181292,242.881685432633,38.5580715775287
9.7,"random_instances_SVM","SVM",39,6,2084,1895,189,700,619,81,0.813036020583192,0.338842975206612,1.23081844841376,181,81,100,26,1.2,25.14,7.6,0,0,0,0,0,0,0.447586464901562,240.267604966723,53.1243305563748
9.7,"random_instances_SVM","SVM",39,7,1984,1806,178,800,708,92,0.808546442122774,0.330578512396694,1.22742464754497,204,92,112,23,1.2,28.74,7.7,0,0,0,0,0,0,0.5,244.511574178912,59.3405874415687
9.7,"random_instances_SVM","SVM",39,8,1884,1713,171,900,801,99,0.809261136233695,0.338842975206612,1.22020794454812,218,99,119,14,1.2,32.33,8.1,0,0,0,0,0,0,0.447923631455997,214.659116304726,58.8700422141536
9.7,"random_instances_SVM","SVM",39,9,1784,1622,162,1000,892,108,0.809293622329647,0.338842975206612,1.25203945614503,238,108,130,20,1.2,35.92,8.3,0,0,0,0,0,0,0.206750796401858,171.936987720417,26.5482156047673
9.7,"random_instances_SVM","SVM",39,10,1684,1533,151,1100,981,119,0.805151645095905,0.330578512396694,1.22742464754497,262,119,143,24,1.2,39.51,8.2,0,0,0,0,0,0,0.315548611973877,180.456668840305,47.4868855840034
9.7,"random_instances_SVM","SVM",39,11,1584,1441,143,1200,1073,127,0.816252144082334,0.330578512396694,1.25203945614503,284,127,157,22,1.2,43.1,8.4,0,0,0,0,0,0,0.295330072263246,171.609286079007,43.9163934967081
9.7,"random_instances_SVM","SVM",39,12,1484,1347,137,1300,1167,133,0.805824107282081,0.305785123966942,1.25203945614503,301,133,168,17,1.3,46.7,8.8,0,0,0,0,0,0,0.264724326544399,171.569670465668,40.7074212862574
9.7,"random_instances_SVM","SVM",39,13,1384,1256,128,1400,1258,142,0.818162326524249,0.31404958677686,1.28387096774194,324,142,182,23,1.3,50.29,8.9,0,0,0,0,0,0,0.273791594542948,152.465733670311,44.7073724802674
9.7,"random_instances_SVM","SVM",39,14,1284,1166,118,1500,1348,152,0.824964915016375,0.264462809917355,1.24142895227939,351,152,199,27,1.3,53.88,8.9,0,0,0,0,0,0,0.208512665283336,138.869534712429,31.2886308432155
9.7,"random_instances_SVM","SVM",39,15,1184,1073,111,1600,1441,159,0.823269140807735,0.272727272727273,1.24142895227939,384,159,225,33,1.4,57.47,9.1,0,0,0,0,0,0,0.168676440913997,125.187889895921,21.7593526538465
9.7,"random_instances_SVM","SVM",39,16,1084,984,100,1700,1530,170,0.821332969489061,0.305785123966942,1.24142895227939,412,170,242,28,1.4,61.06,9,0,0,0,0,0,0,0.175422279004669,115.846585770127,24.0214940211015
9.7,"random_instances_SVM","SVM",39,17,984,893,91,1800,1621,179,0.813308903789176,0.231404958677686,1.2732604638763,454,179,275,42,1.5,64.66,9.1,0,0,0,0,0,0,0.177504630405412,100.563369110648,27.3287311869215
9.7,"random_instances_SVM","SVM",39,18,884,805,79,1900,1709,191,0.82280783824523,0.231404958677686,1.2732604638763,488,191,297,34,1.6,68.25,8.9,0,0,0,0,0,0,0.161927644912864,90.7920189460076,22.4331097571553
9.7,"random_instances_SVM","SVM",39,19,784,715,69,2000,1799,201,0.801237070533813,0.231404958677686,1.28387096774194,528,201,327,40,1.6,71.84,9,0,0,0,0,0,0,0.189425722904184,80.5780024622974,27.318146921531
9.7,"random_instances_SVM","SVM",39,20,684,623,61,2100,1891,209,0.824997401112325,0.28099173553719,1.2732604638763,549,209,340,21,1.6,75.43,9,0,0,0,0,0,0,0.203795867953482,73.1129495112068,30.8534949057265
9.7,"random_instances_SVM","SVM",39,21,584,527,57,2200,1987,213,0.828161546857943,0.28099173553719,1.2732604638763,547,213,334,-2,1.6,79.02,9.3,0,0,0,0,0,0,0.17927203263815,63.0668938539241,25.9827449160658
9.7,"random_instances_SVM","SVM",39,22,484,437,47,2300,2077,223,0.821618847133424,0.256198347107438,1.2732604638763,582,223,359,35,1.6,82.61,9.3,0,0,0,0,0,0,0.133999104164716,47.7174224468358,14.9604799941054
9.7,"random_instances_SVM","SVM",39,23,384,346,38,2400,2168,232,0.80887780030147,0.190082644628099,1.2732604638763,610,232,378,28,1.6,86.21,9.3,0,0,0,0,0,0,0.165060919123372,40.9099866540966,21.1795406406482
9.7,"random_instances_SVM","SVM",39,24,284,252,32,2500,2262,238,0.80965746660429,0.198347107438017,1.2732604638763,647,238,409,37,1.7,89.8,9.5,0,0,0,0,0,0,0.139594815502544,28.7032540481669,15.8248907950798
9.7,"random_instances_SVM","SVM",39,25,184,165,19,2600,2349,251,0.806850667914142,0.223140495867769,1.26264996001066,686,251,435,39,1.7,93.39,9.4,0,0,0,0,0,0,0.0956393552762503,18.566506247875,15.1051502178014
9.7,"random_instances_SVM","SVM",39,26,84,75,9,2700,2439,261,0.779705286137536,0.148760330578512,1.28387096774194,691,261,430,5,1.6,96.98,9.3,0,0,0,0,0,0,0.000542032878808866,8.18040988514028,8.18040988514028
9.7,"random_instances_SVM","SVM",39,27,0,0,0,2784,2514,270,0.758511357139146,0.140495867768595,1.28387096774194,726,270,456,35,1.7,100,9.3,0,0,0,0,0,0,0,0,0
9.7,"random_instances_SVM","SVM",40,0,2684,2425,259,100,91,9,0.782299468663982,0.195121951219512,1.27343299239444,30,9,21,0,2.3,3.59,10.1,0,0,0,0,0,0,0.101268160697945,243.000099294373,10.6367515153145
9.7,"random_instances_SVM","SVM",40,1,2584,2339,245,200,177,23,0.79804750016004,0.195121951219512,1.28387096774194,63,23,40,33,1.7,7.18,7.7,0,0,0,0,0,0,0.203019331290733,316.940393844993,35.8888708136146
9.7,"random_instances_SVM","SVM",40,2,2484,2254,230,300,262,38,0.788982779591588,0.178861788617886,1.27343299239444,94,38,56,31,1.5,10.78,6.9,0,0,0,0,0,0,0.212998321688735,348.30678071131,39.6010098696479
9.7,"random_instances_SVM","SVM",40,3,2384,2161,223,400,355,45,0.767089174828767,0.170731707317073,1.27343299239444,132,45,87,38,1.9,14.37,7.9,0,0,0,0,0,0,0.181346219000688,277.13439482649,21.1508258587305
9.7,"random_instances_SVM","SVM",40,4,2284,2071,213,500,445,55,0.791575443313497,0.203252032520325,1.27343299239444,149,55,94,17,1.7,17.96,8.1,0,0,0,0,0,0,0.200074208728216,272.385401286889,23.6132680695529
9.7,"random_instances_SVM","SVM",40,5,2184,1977,207,600,539,61,0.794565008642222,0.235772357723577,1.27343299239444,172,61,111,23,1.8,21.55,8.8,0,0,0,0,0,0,0.198300117243489,229.831350949858,24.7473100400238
9.7,"random_instances_SVM","SVM",40,6,2084,1883,201,700,633,67,0.79792586902248,0.252032520325203,1.27343299239444,198,67,131,26,2,25.14,9.4,0,0,0,0,0,0,0.207398433056379,215.693396471956,30.0222397139725
9.7,"random_instances_SVM","SVM",40,7,1984,1792,192,800,724,76,0.803348057102628,0.284552845528455,1.27343299239444,217,76,141,19,1.9,28.74,9.5,0,0,0,0,0,0,0.193166436985834,201.746615497474,25.6742058475552
9.7,"random_instances_SVM","SVM",40,8,1884,1706,178,900,810,90,0.778957813200185,0.195121951219512,1.27343299239444,254,90,164,37,1.8,32.33,9,0,0,0,0,0,0,0.188203416608473,210.990394037042,24.5747689517781
9.7,"random_instances_SVM","SVM",40,9,1784,1615,169,1000,901,99,0.807502720696509,0.24390243902439,1.27343299239444,292,99,193,38,1.9,35.92,9.1,0,0,0,0,0,0,0.182471397592015,176.754689687705,22.2874178613677
9.7,"random_instances_SVM","SVM",40,10,1684,1523,161,1100,993,107,0.78717751744447,0.203252032520325,1.26299501704694,309,107,202,17,1.9,39.51,9.3,0,0,0,0,0,0,0.162850468188834,176.478323361896,20.600401204003
9.7,"random_instances_SVM","SVM",40,11,1584,1427,157,1200,1089,111,0.825235260226615,0.284552845528455,1.26299501704694,314,111,203,5,1.8,43.1,9.8,0,0,0,0,0,0,0.175944717775564,145.405645632211,21.7505092134676
9.7,"random_instances_SVM","SVM",40,12,1484,1338,146,1300,1178,122,0.790980090903283,0.186991869918699,1.27343299239444,351,122,229,37,1.9,46.7,9.7,0,0,0,0,0,0,0.17670875352159,150.405787184535,20.9194735896768
9.7,"random_instances_SVM","SVM",40,13,1384,1254,130,1400,1262,138,0.791709877728711,0.211382113821138,1.27343299239444,400,138,262,49,1.9,50.29,9.1,0,0,0,0,0,0,0.145826835071786,137.931241644532,16.5892576116662
9.7,"random_instances_SVM","SVM",40,14,1284,1172,112,1500,1344,156,0.81716919531401,0.260162601626016,1.27343299239444,432,156,276,32,1.8,53.88,8.6,0,0,0,0,0,0,0.200406146233279,134.111412283287,24.8115252162541
9.7,"random_instances_SVM","SVM",40,15,1184,1082,102,1600,1434,166,0.785858779847653,0.260162601626016,1.27343299239444,441,166,275,9,1.7,57.47,8.6,0,0,0,0,0,0,0.165591820787177,130.254274276181,19.6726504095978
9.7,"random_instances_SVM","SVM",40,16,1084,992,92,1700,1524,176,0.816887523205952,0.276422764227642,1.27343299239444,467,176,291,26,1.7,61.06,8.7,0,0,0,0,0,0,0.153008032221771,114.156905641049,17.5510320482498
9.7,"random_instances_SVM","SVM",40,17,984,902,82,1800,1614,186,0.806862556814549,0.260162601626016,1.26299501704694,497,186,311,30,1.7,64.66,8.7,0,0,0,0,0,0,0.164676632637713,105.474162322716,19.4978895068197
9.7,"random_instances_SVM","SVM",40,18,884,813,71,1900,1703,197,0.813539466103336,0.284552845528455,1.27343299239444,503,197,306,6,1.6,68.25,8.6,0,0,0,0,0,0,0.180372192547647,94.7113659757569,24.3966562152655
9.7,"random_instances_SVM","SVM",40,19,784,720,64,2000,1796,204,0.802522245694907,0.24390243902439,1.27343299239444,535,204,331,32,1.6,71.84,8.8,0,0,0,0,0,0,0.155687818862436,85.8193256859558,18.9947342544373
9.7,"random_instances_SVM","SVM",40,20,684,626,58,2100,1890,210,0.791332181038352,0.219512195121951,1.26299501704694,550,210,340,15,1.6,75.43,9,0,0,0,0,0,0,0.141080202797703,72.4424137012854,16.4604463527187
9.7,"random_instances_SVM","SVM",40,21,584,531,53,2200,1985,215,0.777222969080095,0.146341463414634,1.27343299239444,577,215,362,27,1.7,79.02,9.2,0,0,0,0,0,0,0.151019238533653,58.8416126480098,20.7387180501057
9.7,"random_instances_SVM","SVM",40,22,484,442,42,2300,2074,226,0.767850969848283,0.138211382113821,1.27343299239444,635,226,409,58,1.8,82.61,9.2,0,0,0,0,0,0,0.132642300923631,49.8176006092883,16.7940509177902
9.7,"random_instances_SVM","SVM",40,23,384,351,33,2400,2165,235,0.738576275526536,0.130081300813008,1.27343299239444,642,235,407,7,1.7,86.21,9.2,0,0,0,0,0,0,0.125963462629513,40.7903412248264,15.5030892637941
9.7,"random_instances_SVM","SVM",40,24,284,255,29,2500,2261,239,0.776710837974524,0.16260162601626,1.28387096774194,661,239,422,19,1.8,89.8,9.5,0,0,0,0,0,0,0.114613793270182,28.3937026685303,13.5132824637263
9.7,"random_instances_SVM","SVM",40,25,184,163,21,2600,2353,247,0.787427181358437,0.170731707317073,1.27343299239444,668,247,421,7,1.7,93.39,9.5,0,0,0,0,0,0,0.0901956235041715,17.0113668145523,12.1638799086254
9.7,"random_instances_SVM","SVM",40,26,84,75,9,2700,2441,259,0.776045067537293,0.195121951219512,1.26299501704694,706,259,447,38,1.7,96.98,9.4,0,0,0,0,0,0,2.29627367325152e-06,7.26629472471573,7.26629472471573
9.7,"random_instances_SVM","SVM",40,27,0,0,0,2784,2516,268,0.816170539658156,0.235772357723577,1.27343299239444,729,268,461,23,1.7,100,9.4,0,0,0,0,0,0,0,0,0
9.7,"random_instances_SVM","SVM",41,0,2684,2434,250,100,90,10,0.762802288866574,0.229007633587786,1.25331421421844,25,10,15,0,1.5,3.59,9,0,0,0,0,0,0,0.275599388802569,254.117600872716,38.7418938212861
9.7,"random_instances_SVM","SVM",41,1,2584,2348,236,200,176,24,0.83073638112289,0.396946564885496,1.25446934252647,55,24,31,30,1.3,7.18,7.3,0,0,0,0,0,0,0.236144250660722,283.228597023844,25.3747819238922
9.7,"random_instances_SVM","SVM",41,2,2484,2256,228,300,268,32,0.799070904053903,0.343511450381679,1.24466880078798,72,32,40,17,1.2,10.78,8.4,0,0,0,0,0,0,0.20898310404052,228.447283888032,25.0115343230535
9.7,"random_instances_SVM","SVM",41,3,2384,2163,221,400,361,39,0.80827718029058,0.32824427480916,1.26426988426496,95,39,56,23,1.4,14.37,9.3,0,0,0,0,0,0,0.268190552776509,196.765269652392,34.4476603343653
9.7,"random_instances_SVM","SVM",41,4,2284,2069,215,500,455,45,0.774930136339989,0.244274809160305,1.26426988426496,120,45,75,25,1.7,17.96,10.1,0,0,0,0,0,0,0.206376643756955,237.993467835729,25.202110108783
9.7,"random_instances_SVM","SVM",41,5,2184,1982,202,600,542,58,0.767701818269794,0.320610687022901,1.21526717557252,147,58,89,27,1.5,21.55,9.3,0,0,0,0,0,0,0.139147984555057,216.628510761889,15.7535291576796
9.7,"random_instances_SVM","SVM",41,6,2084,1895,189,700,629,71,0.800425835641955,0.267175572519084,1.27407042600345,170,71,99,23,1.4,25.14,8.9,0,0,0,0,0,0,0.208678386981913,192.902780923865,27.6210610785008
9.7,"random_instances_SVM","SVM",41,7,1984,1798,186,800,726,74,0.814622373307846,0.251908396946565,1.27407042600345,191,74,117,21,1.6,28.74,9.8,0,0,0,0,0,0,0.181362821701893,171.032497575499,24.2060904690876
9.7,"random_instances_SVM","SVM",41,8,1884,1706,178,900,818,82,0.813297685728456,0.267175572519084,1.27407042600345,213,82,131,22,1.6,32.33,10,0,0,0,0,0,0,0.175897099573444,167.678743798809,22.1326690545099
9.7,"random_instances_SVM","SVM",41,9,1784,1619,165,1000,905,95,0.798859195993272,0.259541984732824,1.26426988426496,253,95,158,40,1.7,35.92,9.5,0,0,0,0,0,0,0.194101242385999,168.221234044394,26.7090649842245
9.7,"random_instances_SVM","SVM",41,10,1684,1526,158,1100,998,102,0.807642056108686,0.274809160305344,1.26426988426496,264,102,162,11,1.6,39.51,9.8,0,0,0,0,0,0,0.173388662535362,154.886753607573,22.5027630016377
9.7,"random_instances_SVM","SVM",41,11,1584,1431,153,1200,1093,107,0.803093357205935,0.236641221374046,1.26426988426496,285,107,178,21,1.7,43.1,10.2,0,0,0,0,0,0,0.178489571671711,143.332982782478,24.0236347368186
9.7,"random_instances_SVM","SVM",41,12,1484,1341,143,1300,1183,117,0.804877753716987,0.244274809160305,1.25446934252647,321,117,204,36,1.7,46.7,10.1,0,0,0,0,0,0,0.162422400537084,137.982473271194,20.0043731816671
9.7,"random_instances_SVM","SVM",41,13,1384,1254,130,1400,1270,130,0.77472447708109,0.206106870229008,1.25446934252647,362,130,232,41,1.8,50.29,9.8,0,0,0,0,0,0,0.164929043880687,134.856166262837,20.7608872415719
9.7,"random_instances_SVM","SVM",41,14,1284,1161,123,1500,1363,137,0.791401023457252,0.198473282442748,1.24466880078798,372,137,235,10,1.7,53.88,9.9,0,0,0,0,0,0,0.160850381600989,117.266937418673,21.0072708764929
9.7,"random_instances_SVM","SVM",41,15,1184,1076,108,1600,1448,152,0.769286604323679,0.190839694656489,1.25446934252647,417,152,265,45,1.7,57.47,9.5,0,0,0,0,0,0,0.160816902958678,115.402372079236,19.1981824057442
9.7,"random_instances_SVM","SVM",41,16,1084,985,99,1700,1539,161,0.778752979034848,0.183206106870229,1.27407042600345,447,161,286,30,1.8,61.06,9.6,0,0,0,0,0,0,0.170422289118417,107.70228368652,21.4651584120647
9.7,"random_instances_SVM","SVM",41,17,984,896,88,1800,1628,172,0.800649641306051,0.229007633587786,1.27407042600345,481,172,309,34,1.8,64.66,9.5,0,0,0,0,0,0,0.175147911829512,94.6142526948936,22.246571111114
9.7,"random_instances_SVM","SVM",41,18,884,810,74,1900,1714,186,0.760122669699128,0.122137404580153,1.26426988426496,494,186,308,13,1.7,68.25,9.2,0,0,0,0,0,0,0.165120455305944,90.5339527481631,19.7290066887133
9.7,"random_instances_SVM","SVM",41,19,784,716,68,2000,1808,192,0.79320961517523,0.229007633587786,1.26426988426496,524,192,332,30,1.7,71.84,9.4,0,0,0,0,0,0,0.176826543021887,76.8739552522041,21.5069624122652
9.7,"random_instances_SVM","SVM",41,20,684,626,58,2100,1898,202,0.8049926809499,0.229007633587786,1.25446934252647,524,202,322,0,1.6,75.43,9.4,0,0,0,0,0,0,0.186774303588794,65.1972686393656,21.9713152633182
9.7,"random_instances_SVM","SVM",41,21,584,533,51,2200,1991,209,0.811791534097094,0.244274809160305,1.25446934252647,564,209,355,40,1.7,79.02,9.5,0,0,0,0,0,0,0.169672501180529,54.8606622097315,18.9790175608805
9.7,"random_instances_SVM","SVM",41,22,484,443,41,2300,2081,219,0.769849142884791,0.16793893129771,1.26426988426496,603,219,384,39,1.8,82.61,9.5,0,0,0,0,0,0,0.168206792295917,46.1634233366386,20.1774698550402
9.7,"random_instances_SVM","SVM",41,23,384,356,28,2400,2168,232,0.802905844352231,0.213740458015267,1.27407042600345,608,232,376,5,1.6,86.21,9.3,0,0,0,0,0,0,0.14991451474017,36.0252191027626,17.7403663683784
9.7,"random_instances_SVM","SVM",41,24,284,266,18,2500,2258,242,0.80511970578628,0.221374045801527,1.26426988426496,628,242,386,20,1.6,89.8,9.3,0,0,0,0,0,0,0.135461536531299,26.1438735078856,17.8034591519874
9.7,"random_instances_SVM","SVM",41,25,184,169,15,2600,2355,245,0.789429114092498,0.16030534351145,1.26426988426496,644,245,399,16,1.6,93.39,9.6,0,0,0,0,0,0,0.0880280397487176,17.6640011956165,15.300275592086
9.7,"random_instances_SVM","SVM",41,26,84,75,9,2700,2449,251,0.807496884867106,0.221374045801527,1.27407042600345,662,251,411,18,1.6,96.98,9.8,0,0,0,0,0,0,7.82634153043661e-07,7.32850952825998,7.32850952825998
9.7,"random_instances_SVM","SVM",41,27,0,0,0,2784,2524,260,0.80591209881322,0.213740458015267,1.27407042600345,679,260,419,17,1.6,100,9.7,0,0,0,0,0,0,0,0,0
9.7,"random_instances_SVM","SVM",42,0,2684,2432,252,100,91,9,0.805310920275293,0.253846153846154,1.26411910669975,24,9,15,0,1.7,3.59,10.1,0,0,0,0,0,0,0.333956263968903,234.246726062803,42.0935745459345
9.7,"random_instances_SVM","SVM",42,1,2584,2346,238,200,177,23,0.817400572507462,0.230769230769231,1.28387096774194,59,23,36,35,1.6,7.18,7.7,0,0,0,0,0,0,0.193737546931801,260.200838980061,20.7755083186325
9.7,"random_instances_SVM","SVM",42,2,2484,2263,221,300,260,40,0.790139472562277,0.153846153846154,1.27399503722084,98,40,58,39,1.4,10.78,6.5,0,0,0,0,0,0,0.20059762200319,327.951218743869,23.0912282285364
9.7,"random_instances_SVM","SVM",42,3,2384,2173,211,400,350,50,0.76133747487667,0.153846153846154,1.26411910669975,123,50,73,25,1.5,14.37,7,0,0,0,0,0,0,0.227320512469619,306.887296200056,30.9337022820834
9.7,"random_instances_SVM","SVM",42,4,2284,2086,198,500,437,63,0.780644375418725,0.223076923076923,1.26411910669975,156,63,93,33,1.5,17.96,6.9,0,0,0,0,0,0,0.178002495940906,286.246740090857,22.0249817917737
9.7,"random_instances_SVM","SVM",42,5,2184,1998,186,600,525,75,0.7727023570254,0.169230769230769,1.26411910669975,187,75,112,31,1.5,21.55,7,0,0,0,0,0,0,0.218088223890916,265.064657545272,30.8656329269216
9.7,"random_instances_SVM","SVM",42,6,2084,1903,181,700,620,80,0.797234910774105,0.192307692307692,1.27399503722084,207,80,127,20,1.6,25.14,7.8,0,0,0,0,0,0,0.197239714565895,224.575971995503,25.5341563326865
9.7,"random_instances_SVM","SVM",42,7,1984,1810,174,800,713,87,0.790328278214266,0.130769230769231,1.26411910669975,228,87,141,21,1.6,28.74,8.2,0,0,0,0,0,0,0.23395991331026,216.932243908955,34.9991060038739
9.7,"random_instances_SVM","SVM",42,8,1884,1718,166,900,805,95,0.780674827943238,0.138461538461538,1.26411910669975,252,95,157,24,1.7,32.33,8.5,0,0,0,0,0,0,0.203532490365362,196.312768746862,29.8375957478109
9.7,"random_instances_SVM","SVM",42,9,1784,1625,159,1000,898,102,0.768840976916989,0.138461538461538,1.26411910669975,271,102,169,19,1.7,35.92,8.8,0,0,0,0,0,0,0.216200217504595,186.977638562118,36.4686111397434
9.7,"random_instances_SVM","SVM",42,10,1684,1537,147,1100,986,114,0.778878128996896,0.138461538461538,1.26411910669975,312,114,198,41,1.7,39.51,8.6,0,0,0,0,0,0,0.169575042888109,180.231740824012,21.8412024018486
9.7,"random_instances_SVM","SVM",42,11,1584,1443,141,1200,1080,120,0.777489493879045,0.146153846153846,1.27399503722084,320,120,200,8,1.7,43.1,9,0,0,0,0,0,0,0.208740757879917,166.667567356236,34.176839700775
9.7,"random_instances_SVM","SVM",42,12,1484,1349,135,1300,1174,126,0.791290577988917,0.184615384615385,1.26411910669975,344,126,218,24,1.7,46.7,9.3,0,0,0,0,0,0,0.180936307361024,140.500716383019,26.2575835993827
9.7,"random_instances_SVM","SVM",42,13,1384,1258,126,1400,1265,135,0.777288507217251,0.153846153846154,1.25424317617866,380,135,245,36,1.8,50.29,9.4,0,0,0,0,0,0,0.186165680287952,143.964520344167,29.759682041234
9.7,"random_instances_SVM","SVM",42,14,1284,1164,120,1500,1359,141,0.798148486509534,0.215384615384615,1.26411910669975,396,141,255,16,1.8,53.88,9.6,0,0,0,0,0,0,0.179999735261674,125.764673278295,25.6008889790352
9.7,"random_instances_SVM","SVM",42,15,1184,1072,112,1600,1451,149,0.777184968633902,0.153846153846154,1.27399503722084,424,149,275,28,1.8,57.47,9.7,0,0,0,0,0,0,0.178508422991858,117.363181312888,28.7098060470362
9.7,"random_instances_SVM","SVM",42,16,1084,980,104,1700,1543,157,0.785455874291981,0.2,1.27399503722084,444,157,287,20,1.8,61.06,9.8,0,0,0,0,0,0,0.168573582885192,111.247109118659,22.5511264011017
9.7,"random_instances_SVM","SVM",42,17,984,890,94,1800,1633,167,0.799360496985202,0.169230769230769,1.28387096774194,471,167,304,27,1.8,64.66,9.8,0,0,0,0,0,0,0.158334997147297,93.9337591472874,19.3024201399518
9.7,"random_instances_SVM","SVM",42,18,884,799,85,1900,1724,176,0.807747122236435,0.253846153846154,1.28387096774194,479,176,303,8,1.7,68.25,9.8,0,0,0,0,0,0,0.19481718674486,87.9511994397184,25.134473967985
9.7,"random_instances_SVM","SVM",42,19,784,712,72,2000,1811,189,0.789621779645535,0.223076923076923,1.26411910669975,529,189,340,50,1.8,71.84,9.6,0,0,0,0,0,0,0.180566746114737,74.7949498829096,20.8352434306262
9.7,"random_instances_SVM","SVM",42,20,684,618,66,2100,1905,195,0.770832572020222,0.146153846153846,1.27399503722084,548,195,353,19,1.8,75.43,9.8,0,0,0,0,0,0,0.163659678299472,65.395329416202,19.435818597577
9.7,"random_instances_SVM","SVM",42,21,584,527,57,2200,1996,204,0.801394725622757,0.276923076923077,1.25424317617866,567,204,363,19,1.8,79.02,9.8,0,0,0,0,0,0,0.183807783710063,57.3365490723864,22.1334382895988
9.7,"random_instances_SVM","SVM",42,22,484,437,47,2300,2086,214,0.799969547475488,0.207692307692308,1.26411910669975,592,214,378,25,1.8,82.61,9.7,0,0,0,0,0,0,0.1561993230276,44.9265425740422,19.1635088769347
9.7,"random_instances_SVM","SVM",42,23,384,347,37,2400,2176,224,0.802003776113042,0.223076923076923,1.26411910669975,597,224,373,5,1.7,86.21,9.7,0,0,0,0,0,0,0.143002685708524,35.6938655556954,17.5070632100877
9.7,"random_instances_SVM","SVM",42,24,284,257,27,2500,2266,234,0.761818624763995,0.176923076923077,1.27399503722084,647,234,413,50,1.8,89.8,9.7,0,0,0,0,0,0,0.12631063854068,27.431010244638,14.6124148874162
9.7,"random_instances_SVM","SVM",42,25,184,167,17,2600,2356,244,0.809281929471955,0.261538461538462,1.26411910669975,676,244,432,29,1.8,93.39,9.7,0,0,0,0,0,0,0.0773029207471522,18.1763500036705,15.9541038308875
9.7,"random_instances_SVM","SVM",42,26,84,77,7,2700,2446,254,0.826719045008833,0.246153846153846,1.26411910669975,691,254,437,15,1.7,96.98,9.6,0,0,0,0,0,0,1.0000000994736e-07,8.22251298479717,8.22251298479717
9.7,"random_instances_SVM","SVM",42,27,0,0,0,2784,2523,261,0.818100980571291,0.276923076923077,1.27399503722084,722,261,461,31,1.8,100,9.7,0,0,0,0,0,0,0,0,0
9.7,"random_instances_SVM","SVM",43,0,2684,2427,257,100,94,6,0.693502964426876,0.3125,1.07323588709677,17,6,11,0,1.8,3.59,15.7,0,0,0,0,0,0,0.155994664695032,158.932127789945,18.3103245129903
9.7,"random_instances_SVM","SVM",43,1,2584,2341,243,200,180,20,0.774827075098817,0.1484375,1.27384072580645,61,20,41,44,2,7.18,9,0,0,0,0,0,0,0.214502639708883,264.363509437811,28.5103954156785
9.7,"random_instances_SVM","SVM",43,2,2484,2253,231,300,268,32,0.803754940711463,0.2109375,1.27384072580645,85,32,53,24,1.7,10.78,8.4,0,0,0,0,0,0,0.219634708544854,278.777465835031,29.021924615931
9.7,"random_instances_SVM","SVM",43,3,2384,2164,220,400,357,43,0.810128458498027,0.2109375,1.27384072580645,121,43,78,36,1.8,14.37,8.3,0,0,0,0,0,0,0.217788402615724,241.736485216018,34.1430943912284
9.7,"random_instances_SVM","SVM",43,4,2284,2076,208,500,445,55,0.825914031620556,0.2734375,1.27384072580645,144,55,89,23,1.6,17.96,8.1,0,0,0,0,0,0,0.236021808531346,259.3848857054,37.112475525659
9.7,"random_instances_SVM","SVM",43,5,2184,1985,199,600,536,64,0.82987895256917,0.2578125,1.27384072580645,170,64,106,26,1.7,21.55,8.4,0,0,0,0,0,0,0.232068396160525,236.855768835542,34.8602882172571
9.7,"random_instances_SVM","SVM",43,6,2084,1892,192,700,629,71,0.831299407114625,0.265625,1.27384072580645,187,71,116,17,1.6,25.14,8.9,0,0,0,0,0,0,0.210101228653442,206.981616594689,28.3933454788663
9.7,"random_instances_SVM","SVM",43,7,1984,1799,185,800,722,78,0.837228260869566,0.3125,1.27384072580645,207,78,129,20,1.7,28.74,9.3,0,0,0,0,0,0,0.218190736230819,186.93374588311,30.7614852874503
9.7,"random_instances_SVM","SVM",43,8,1884,1705,179,900,816,84,0.833874752964429,0.3359375,1.27384072580645,226,84,142,19,1.7,32.33,9.7,0,0,0,0,0,0,0.207334004578711,176.524394039852,27.4541867048549
9.7,"random_instances_SVM","SVM",43,9,1784,1614,170,1000,907,93,0.818737648221343,0.2578125,1.27384072580645,255,93,162,29,1.7,35.92,9.8,0,0,0,0,0,0,0.197735852251005,167.095343302888,27.227277885987
9.7,"random_instances_SVM","SVM",43,10,1684,1528,156,1100,993,107,0.817527173913043,0.28125,1.27384072580645,302,107,195,47,1.8,39.51,9.3,0,0,0,0,0,0,0.198016522208554,168.435109137879,25.7778960067368
9.7,"random_instances_SVM","SVM",43,11,1584,1433,151,1200,1088,112,0.799135375494075,0.265625,1.27384072580645,321,112,209,19,1.9,43.1,9.7,0,0,0,0,0,0,0.189522406404188,152.155171362597,24.3942876393022
9.7,"random_instances_SVM","SVM",43,12,1484,1345,139,1300,1176,124,0.808541254940712,0.25,1.27384072580645,344,124,220,23,1.8,46.7,9.5,0,0,0,0,0,0,0.192389663781753,147.598104144921,25.3922894334626
9.7,"random_instances_SVM","SVM",43,13,1384,1254,130,1400,1267,133,0.798005187747037,0.234375,1.27384072580645,372,133,239,28,1.8,50.29,9.5,0,0,0,0,0,0,0.19342097357185,142.8637266162,25.3981819626821
9.7,"random_instances_SVM","SVM",43,14,1284,1164,120,1500,1357,143,0.789223073122531,0.1875,1.27384072580645,396,143,253,24,1.8,53.88,9.5,0,0,0,0,0,0,0.188711417223861,132.960864950128,22.7236955248301
9.7,"random_instances_SVM","SVM",43,15,1184,1070,114,1600,1451,149,0.799277420948617,0.21875,1.27384072580645,425,149,276,29,1.9,57.47,9.7,0,0,0,0,0,0,0.1739594379587,124.687362786619,20.1818072737973
9.7,"random_instances_SVM","SVM",43,16,1084,983,101,1700,1538,162,0.793218873517794,0.2109375,1.25378024193548,483,162,321,58,2,61.06,9.5,0,0,0,0,0,0,0.188597484439583,112.948980770196,24.0535345952997
9.7,"random_instances_SVM","SVM",43,17,984,890,94,1800,1631,169,0.766279644268779,0.15625,1.25378024193548,492,169,323,9,1.9,64.66,9.7,0,0,0,0,0,0,0.171251187522005,100.397789037494,22.2680304774296
9.7,"random_instances_SVM","SVM",43,18,884,805,79,1900,1716,184,0.809449110671939,0.1640625,1.27384072580645,522,184,338,30,1.8,68.25,9.3,0,0,0,0,0,0,0.183433540513257,93.1381798606085,24.8555751933913
9.7,"random_instances_SVM","SVM",43,19,784,712,72,2000,1809,191,0.723326333992094,0.09375,1.27384072580645,534,191,343,12,1.8,71.84,9.5,0,0,0,0,0,0,0.190311393824757,84.1908908224867,26.8722965278511
9.7,"random_instances_SVM","SVM",43,20,684,621,63,2100,1900,200,0.81426630434783,0.234375,1.27384072580645,559,200,359,25,1.8,75.43,9.5,0,0,0,0,0,0,0.175042227296134,71.0042965483403,25.0166723013538
9.7,"random_instances_SVM","SVM",43,21,584,533,51,2200,1988,212,0.789809782608697,0.1953125,1.27384072580645,573,212,361,14,1.7,79.02,9.4,0,0,0,0,0,0,0.164424158892615,58.6865233069053,21.6457245661333
9.7,"random_instances_SVM","SVM",43,22,484,442,42,2300,2079,221,0.777550642292493,0.1796875,1.27384072580645,601,221,380,28,1.7,82.61,9.4,0,0,0,0,0,0,0.151362424185537,50.1020327823134,17.9985699086871
9.7,"random_instances_SVM","SVM",43,23,384,352,32,2400,2169,231,0.815711462450598,0.25,1.27384072580645,632,231,401,31,1.7,86.21,9.4,0,0,0,0,0,0,0.168442598423374,40.0443364252844,21.4438995646435
9.7,"random_instances_SVM","SVM",43,24,284,261,23,2500,2260,240,0.814352766798422,0.1953125,1.27384072580645,630,240,390,-2,1.6,89.8,9.4,0,0,0,0,0,0,0.134008326242948,27.7748710597195,17.4649169307814
9.7,"random_instances_SVM","SVM",43,25,184,170,14,2600,2351,249,0.822980484189725,0.2578125,1.27384072580645,666,249,417,36,1.7,93.39,9.4,0,0,0,0,0,0,0.0754409928733522,18.5112210744247,16.4210568468706
9.7,"random_instances_SVM","SVM",43,26,84,79,5,2700,2442,258,0.811511857707516,0.28125,1.27384072580645,687,258,429,21,1.7,96.98,9.5,0,0,0,0,0,0,2.59769986611244e-07,8.77763182662107,8.77763182662107
9.7,"random_instances_SVM","SVM",43,27,0,0,0,2784,2521,263,0.836894762845849,0.3125,1.27384072580645,713,263,450,26,1.7,100,9.6,0,0,0,0,0,0,0,0,0
9.7,"random_instances_SVM","SVM",44,0,2684,2423,261,100,85,15,0.776097162686262,0.339130434782609,1.21688639551192,40,15,25,0,1.7,3.59,5.7,0,0,0,0,0,0,0.382452316419856,395.370687774786,39.6791289312108
9.7,"random_instances_SVM","SVM",44,1,2584,2337,247,200,171,29,0.808777301490104,0.365217391304348,1.21019407802973,70,29,41,30,1.4,7.18,5.9,0,0,0,0,0,0,0.5,371.137023033599,53.4101586169909
9.7,"random_instances_SVM","SVM",44,2,2484,2251,233,300,257,43,0.791290739606725,0.304347826086957,1.21688639551192,106,43,63,36,1.5,10.78,6,0,0,0,0,0,0,0.186890255651312,348.77887372805,19.9715820154394
9.7,"random_instances_SVM","SVM",44,3,2384,2153,231,400,355,45,0.767728107777099,0.295652173913043,1.21688639551192,114,45,69,8,1.5,14.37,7.9,0,0,0,0,0,0,0.294709282786596,302.510369620513,38.4587204174166
9.7,"random_instances_SVM","SVM",44,4,2284,2067,217,500,441,59,0.782390964142345,0.356521739130435,1.18339410939691,146,59,87,32,1.5,17.96,7.5,0,0,0,0,0,0,0.149653929464115,270.738842200813,16.0483857213101
9.7,"random_instances_SVM","SVM",44,5,2184,1978,206,600,530,70,0.76798666394503,0.347826086956522,1.09408134642356,176,70,106,30,1.5,21.55,7.6,0,0,0,0,0,0,0.297978148202781,245.691122888723,36.0873473004281
9.7,"random_instances_SVM","SVM",44,6,2084,1883,201,700,625,75,0.777049738041774,0.321739130434783,1.19455820476858,196,75,121,20,1.6,25.14,8.3,0,0,0,0,0,0,0.237807769147606,233.120571269604,32.0115098864557
9.7,"random_instances_SVM","SVM",44,7,1984,1792,192,800,716,84,0.788562291624141,0.295652173913043,1.22805049088359,223,84,139,27,1.7,28.74,8.5,0,0,0,0,0,0,0.182347097221063,217.894494423565,22.6948450883142
9.7,"random_instances_SVM","SVM",44,8,1884,1698,186,900,810,90,0.754085867864191,0.234782608695652,1.22805049088359,254,90,164,31,1.8,32.33,9,0,0,0,0,0,0,0.149093793168132,190.600947061354,17.3931171660955
9.7,"random_instances_SVM","SVM",44,9,1784,1608,176,1000,900,100,0.769136558481328,0.156521739130435,1.2615427769986,286,100,186,32,1.9,35.92,9,0,0,0,0,0,0,0.144924996143975,202.462426237177,24.7921568650703
9.7,"random_instances_SVM","SVM",44,10,1684,1522,162,1100,986,114,0.764536980336125,0.191304347826087,1.27270687237027,315,114,201,29,1.8,39.51,8.6,0,0,0,0,0,0,0.17754975587682,196.250487985822,34.8154380664902
9.7,"random_instances_SVM","SVM",44,11,1584,1429,155,1200,1079,121,0.786834047764852,0.226086956521739,1.27270687237027,343,121,222,28,1.8,43.1,8.9,0,0,0,0,0,0,0.174563013500098,179.12966717896,32.7784227750518
9.7,"random_instances_SVM","SVM",44,12,1484,1342,142,1300,1166,134,0.798598353405463,0.208695652173913,1.27270687237027,383,134,249,40,1.9,46.7,8.7,0,0,0,0,0,0,0.177682709716729,174.931150514443,32.4774810540548
9.7,"random_instances_SVM","SVM",44,13,1384,1255,129,1400,1253,147,0.801993604136902,0.165217391304348,1.27270687237027,419,147,272,36,1.9,50.29,8.5,0,0,0,0,0,0,0.165790703585017,159.103836301548,26.4879998920041
9.7,"random_instances_SVM","SVM",44,14,1284,1163,121,1500,1345,155,0.804844526093765,0.2,1.28387096774194,424,155,269,5,1.7,53.88,8.7,0,0,0,0,0,0,0.191806120143114,145.141349382557,31.2939213505384
9.7,"random_instances_SVM","SVM",44,15,1184,1072,112,1600,1436,164,0.820180989317548,0.234782608695652,1.28387096774194,453,164,289,29,1.8,57.47,8.8,0,0,0,0,0,0,0.180658739568327,131.821741051121,28.678963082392
9.7,"random_instances_SVM","SVM",44,16,1084,983,101,1700,1525,175,0.820725318092133,0.243478260869565,1.28387096774194,467,175,292,14,1.7,61.06,8.7,0,0,0,0,0,0,0.185331620838173,119.657542987404,30.2648838963551
9.7,"random_instances_SVM","SVM",44,17,984,889,95,1800,1619,181,0.784891474450575,0.182608695652174,1.26038113539915,488,181,307,21,1.7,64.66,8.9,0,0,0,0,0,0,0.163471234293333,105.347545008755,23.3084295956341
9.7,"random_instances_SVM","SVM",44,18,884,807,77,1900,1701,199,0.833115601823506,0.243478260869565,1.27270687237027,532,199,333,44,1.7,68.25,8.5,0,0,0,0,0,0,0.161004333629384,98.2771101029128,21.0153364093199
9.7,"random_instances_SVM","SVM",44,19,784,712,72,2000,1796,204,0.81554739062394,0.226086956521739,1.28387096774194,560,204,356,28,1.7,71.84,8.8,0,0,0,0,0,0,0.155224835006624,85.751088923743,20.9535826893925
9.7,"random_instances_SVM","SVM",44,20,684,622,62,2100,1886,214,0.804136898686807,0.208695652173913,1.28387096774194,581,214,367,21,1.7,75.43,8.8,0,0,0,0,0,0,0.146488048444787,72.8455819349478,16.961135445114
9.7,"random_instances_SVM","SVM",44,21,584,532,52,2200,1976,224,0.80193236714976,0.139130434782609,1.28387096774194,608,224,384,27,1.7,79.02,8.8,0,0,0,0,0,0,0.151260226820551,61.7623521438487,18.0595862621462
9.7,"random_instances_SVM","SVM",44,22,484,441,43,2300,2067,233,0.848771858202357,0.252173913043478,1.28387096774194,629,233,396,21,1.7,82.61,8.9,0,0,0,0,0,0,0.153543762077281,49.4973509417175,18.527298346531
9.7,"random_instances_SVM","SVM",44,23,384,347,37,2400,2161,239,0.751847315778731,0.156521739130435,1.28387096774194,645,239,406,16,1.7,86.21,9,0,0,0,0,0,0,0.133087971919442,39.3419568713184,16.9767308787173
9.7,"random_instances_SVM","SVM",44,24,284,256,28,2500,2252,248,0.856419677485205,0.252173913043478,1.28387096774194,665,248,417,20,1.7,89.8,9.1,0,0,0,0,0,0,0.136080465018474,29.1798321730844,16.5852892753064
9.7,"random_instances_SVM","SVM",44,25,184,164,20,2600,2344,256,0.828243859291016,0.173913043478261,1.28387096774194,716,256,460,51,1.8,93.39,9.2,0,0,0,0,0,0,0.101569553444711,19.4327547124978,15.9665058835396
9.7,"random_instances_SVM","SVM",44,26,84,73,11,2700,2435,265,0.823133972919644,0.191304347826087,1.28387096774194,714,265,449,-2,1.7,96.98,9.2,0,0,0,0,0,0,0.000122279491794808,9.71206014328712,9.71206014328712
9.7,"random_instances_SVM","SVM",44,27,0,0,0,2784,2508,276,0.824903041437033,0.165217391304348,1.28387096774194,756,276,480,42,1.7,100,9.1,0,0,0,0,0,0,0,0,0
9.7,"random_instances_SVM","SVM",45,0,2684,2430,254,100,92,8,0.688291139240504,0.170542635658915,1.18434608652163,28,8,20,0,2.5,3.59,11.5,0,0,0,0,0,0,0.105727759475022,209.413794092438,12.0371304990085
9.7,"random_instances_SVM","SVM",45,1,2584,2344,240,200,178,22,0.74335811009714,0.13953488372093,1.23410852713178,66,22,44,38,2,7.18,8.1,0,0,0,0,0,0,0.131301034835181,284.746104561179,14.1129378571297
9.7,"random_instances_SVM","SVM",45,2,2484,2260,224,300,262,38,0.78005102541458,0.193798449612403,1.25401350337584,110,38,72,44,1.9,10.78,6.9,0,0,0,0,0,0,0.157525084379778,315.839515192397,17.6369326964435
9.7,"random_instances_SVM","SVM",45,3,2384,2165,219,400,357,43,0.785288489843975,0.232558139534884,1.26396599149787,123,43,80,13,1.9,14.37,8.3,0,0,0,0,0,0,0.160873752317614,259.842828137603,20.9317929403913
9.7,"random_instances_SVM","SVM",45,4,2284,2078,206,500,444,56,0.80360121675988,0.248062015503876,1.2739184796199,160,56,104,37,1.9,17.96,7.9,0,0,0,0,0,0,0.121430696652007,253.393195399135,12.7931364156186
9.7,"random_instances_SVM","SVM",45,5,2184,1987,197,600,535,65,0.803889461289366,0.294573643410853,1.2739184796199,190,65,125,30,1.9,21.55,8.2,0,0,0,0,0,0,0.179381806398893,247.869638957656,24.3048762996119
9.7,"random_instances_SVM","SVM",45,6,2084,1891,193,700,631,69,0.788183200863511,0.294573643410853,1.24406101525381,195,69,126,5,1.8,25.14,9.1,0,0,0,0,0,0,0.164597073383779,211.972295895264,24.3723012726008
9.7,"random_instances_SVM","SVM",45,7,1984,1798,186,800,724,76,0.808335786478262,0.271317829457364,1.24406101525381,203,76,127,8,1.7,28.74,9.5,0,0,0,0,0,0,0.183864571242741,198.353712033058,25.1707235143189
9.7,"random_instances_SVM","SVM",45,8,1884,1709,175,900,813,87,0.820895888529086,0.263565891472868,1.26396599149787,233,87,146,30,1.7,32.33,9.3,0,0,0,0,0,0,0.165106640283616,186.114590556842,21.957732487344
9.7,"random_instances_SVM","SVM",45,9,1784,1620,164,1000,902,98,0.809501030320865,0.271317829457364,1.26396599149787,264,98,166,31,1.7,35.92,9.2,0,0,0,0,0,0,0.177967629370087,182.910962075732,24.4357279813646
9.7,"random_instances_SVM","SVM",45,10,1684,1533,151,1100,989,111,0.820742566970851,0.263565891472868,1.28387096774194,288,111,177,24,1.6,39.51,8.9,0,0,0,0,0,0,0.202472529282906,177.244769256083,29.7479206591565
9.7,"random_instances_SVM","SVM",45,11,1584,1442,142,1200,1080,120,0.81552963399077,0.248062015503876,1.2739184796199,306,120,186,18,1.6,43.1,9,0,0,0,0,0,0,0.195709095767619,167.665137953648,29.4430810711969
9.7,"random_instances_SVM","SVM",45,12,1484,1354,130,1300,1168,132,0.824416151506229,0.286821705426357,1.28387096774194,340,132,208,34,1.6,46.7,8.8,0,0,0,0,0,0,0.208474330047691,154.72251596544,31.0674878197365
9.7,"random_instances_SVM","SVM",45,13,1384,1265,119,1400,1257,143,0.83838681189284,0.286821705426357,1.28387096774194,380,143,237,40,1.7,50.29,8.8,0,0,0,0,0,0,0.199521105923151,146.844482432249,28.7334921190414
9.7,"random_instances_SVM","SVM",45,14,1284,1179,105,1500,1343,157,0.832787508586002,0.248062015503876,1.28387096774194,406,157,249,26,1.6,53.88,8.6,0,0,0,0,0,0,0.159500957033637,143.16196219592,21.4589528896441
9.7,"random_instances_SVM","SVM",45,15,1184,1085,99,1600,1437,163,0.836369100186434,0.286821705426357,1.28387096774194,434,163,271,28,1.7,57.47,8.8,0,0,0,0,0,0,0.171852978330129,133.209793549055,22.4776624682588
9.7,"random_instances_SVM","SVM",45,16,1084,993,91,1700,1529,171,0.821453979001073,0.271317829457364,1.28387096774194,463,171,292,29,1.7,61.06,8.9,0,0,0,0,0,0,0.140891505371982,114.616735419172,17.3661740718365
9.7,"random_instances_SVM","SVM",45,17,984,905,79,1800,1617,183,0.843716269257181,0.317829457364341,1.28387096774194,487,183,304,24,1.7,64.66,8.8,0,0,0,0,0,0,0.182340702271135,110.193265064906,24.6364048542717
9.7,"random_instances_SVM","SVM",45,18,884,812,72,1900,1710,190,0.815529633990772,0.255813953488372,1.28387096774194,497,190,307,10,1.6,68.25,9,0,0,0,0,0,0,0.166966705209845,98.0279615775644,22.5123204941085
9.7,"random_instances_SVM","SVM",45,19,784,719,65,2000,1803,197,0.83833774899421,0.302325581395349,1.28387096774194,520,197,323,23,1.6,71.84,9.2,0,0,0,0,0,0,0.170853062694477,80.4117373590525,23.8553636633013
9.7,"random_instances_SVM","SVM",45,20,684,624,60,2100,1898,202,0.821061475811985,0.271317829457364,1.25401350337584,522,202,320,2,1.6,75.43,9.4,0,0,0,0,0,0,0.159898748154665,70.9238490485894,21.2262346321013
9.7,"random_instances_SVM","SVM",45,21,584,535,49,2200,1987,213,0.791200569129619,0.248062015503876,1.25401350337584,556,213,343,34,1.6,79.02,9.3,0,0,0,0,0,0,0.152316985591335,60.6418829924139,19.2342981373038
9.7,"random_instances_SVM","SVM",45,22,484,446,38,2300,2076,224,0.799492198999114,0.255813953488372,1.25401350337584,602,224,378,46,1.7,82.61,9.3,0,0,0,0,0,0,0.148682534172713,47.6005008900807,19.5606359177408
9.7,"random_instances_SVM","SVM",45,23,384,355,29,2400,2167,233,0.817719065842406,0.310077519379845,1.25401350337584,646,233,413,44,1.8,86.21,9.3,0,0,0,0,0,0,0.142840808909382,39.8763158968954,17.1925321853137
9.7,"random_instances_SVM","SVM",45,24,284,263,21,2500,2259,241,0.775199931311938,0.217054263565891,1.28387096774194,667,241,426,21,1.8,89.8,9.4,0,0,0,0,0,0,0.12335787507426,27.6402758581579,14.8302238891606
9.7,"random_instances_SVM","SVM",45,25,184,172,12,2600,2350,250,0.774678638013932,0.162790697674419,1.28387096774194,679,250,429,12,1.7,93.39,9.4,0,0,0,0,0,0,0.0960218333530381,17.7240730732106,13.8135750081404
9.7,"random_instances_SVM","SVM",45,26,84,77,7,2700,2445,255,0.800087086645074,0.209302325581395,1.28387096774194,706,255,451,27,1.8,96.98,9.6,0,0,0,0,0,0,0.00199627671825757,8.55831148792065,8.55831148792065
9.7,"random_instances_SVM","SVM",45,27,0,0,0,2784,2522,262,0.804987243646349,0.201550387596899,1.28387096774194,706,262,444,0,1.7,100,9.6,0,0,0,0,0,0,0,0,0
9.7,"random_instances_SVM","SVM",46,0,2684,2441,243,100,90,10,0.737109532882962,0.152173913043478,1.23735390369331,31,10,21,0,2.1,3.59,9,0,0,0,0,0,0,0.111225731593695,275.388039189252,12.931796511949
9.7,"random_instances_SVM","SVM",46,1,2584,2354,230,200,177,23,0.74486402217218,0.144927536231884,1.22805049088359,72,23,49,41,2.1,7.18,7.7,0,0,0,0,0,0,0.129297343756385,284.207058277477,29.1767284873174
9.7,"random_instances_SVM","SVM",46,2,2484,2266,218,300,265,35,0.766822564813209,0.13768115942029,1.22805049088359,94,35,59,22,1.7,10.78,7.6,0,0,0,0,0,0,0.163554973210786,278.841688886082,38.8205454911661
9.7,"random_instances_SVM","SVM",46,3,2384,2176,208,400,355,45,0.796385472602342,0.260869565217391,1.24665731650304,122,45,77,28,1.7,14.37,7.9,0,0,0,0,0,0,0.140421795660286,251.156291192563,34.9646147886775
9.7,"random_instances_SVM","SVM",46,4,2284,2091,193,500,440,60,0.803937871701599,0.27536231884058,1.28387096774194,152,60,92,30,1.5,17.96,7.3,0,0,0,0,0,0,0.175820025638547,249.14431930041,26.266480708867
9.7,"random_instances_SVM","SVM",46,5,2184,1999,185,600,532,68,0.798723944800507,0.246376811594203,1.27456755493221,175,68,107,23,1.6,21.55,7.8,0,0,0,0,0,0,0.19513260816517,270.844993519809,26.6922106744176
9.7,"random_instances_SVM","SVM",46,6,2084,1907,177,700,624,76,0.802788844621513,0.246376811594203,1.27456755493221,194,76,118,19,1.6,25.14,8.2,0,0,0,0,0,0,0.180785795156352,234.429494312466,26.6164393752465
9.7,"random_instances_SVM","SVM",46,7,1984,1815,169,800,716,84,0.80208441595935,0.217391304347826,1.27456755493221,221,84,137,27,1.6,28.74,8.5,0,0,0,0,0,0,0.114295328472898,210.084308009754,12.1468602922835
9.7,"random_instances_SVM","SVM",46,8,1884,1726,158,900,805,95,0.805739361395,0.282608695652174,1.22805049088359,260,95,165,39,1.7,32.33,8.5,0,0,0,0,0,0,0.1449089840308,214.651623541415,20.4538256211891
9.7,"random_instances_SVM","SVM",46,9,1784,1635,149,1000,896,104,0.810520237889021,0.282608695652174,1.28387096774194,289,104,185,29,1.8,35.92,8.6,0,0,0,0,0,0,0.150750921943506,189.291944571276,22.8513224766884
9.7,"random_instances_SVM","SVM",46,10,1684,1543,141,1100,988,112,0.816836999826777,0.289855072463768,1.28387096774194,302,112,190,13,1.7,39.51,8.8,0,0,0,0,0,0,0.159985577505609,176.041177607661,24.5841328982142
9.7,"random_instances_SVM","SVM",46,11,1584,1452,132,1200,1079,121,0.799607367630923,0.231884057971014,1.27456755493221,331,121,210,29,1.7,43.1,8.9,0,0,0,0,0,0,0.155603010151316,172.31511855569,20.3916887962048
9.7,"random_instances_SVM","SVM",46,12,1484,1359,125,1300,1172,128,0.807292568855018,0.27536231884058,1.24665731650304,349,128,221,18,1.7,46.7,9.2,0,0,0,0,0,0,0.151207341411221,161.892749867034,20.1713944148442
9.7,"random_instances_SVM","SVM",46,13,1384,1266,118,1400,1265,135,0.791460245972632,0.282608695652174,1.24665731650304,377,135,242,28,1.8,50.29,9.4,0,0,0,0,0,0,0.152998370757778,146.873076522323,21.3514071031294
9.7,"random_instances_SVM","SVM",46,14,1284,1176,108,1500,1355,145,0.793463825856001,0.27536231884058,1.24665731650304,400,145,255,23,1.8,53.88,9.3,0,0,0,0,0,0,0.109366242400712,128.639520601769,12.5279516177139
9.7,"random_instances_SVM","SVM",46,15,1184,1089,95,1600,1442,158,0.801761071655409,0.340579710144928,1.24665731650304,425,158,267,25,1.7,57.47,9.1,0,0,0,0,0,0,0.139203767544757,120.986044374814,19.3832777456867
9.7,"random_instances_SVM","SVM",46,16,1084,1002,82,1700,1529,171,0.816559847566259,0.297101449275362,1.24665731650304,438,171,267,13,1.6,61.06,8.9,0,0,0,0,0,0,0.137324278229636,110.573249632313,18.1785674429305
9.7,"random_instances_SVM","SVM",46,17,984,912,72,1800,1619,181,0.822235694901555,0.304347826086957,1.24665731650304,459,181,278,21,1.5,64.66,8.9,0,0,0,0,0,0,0.147950258952823,102.629588101091,21.1073785048652
9.7,"random_instances_SVM","SVM",46,18,884,820,64,1900,1711,189,0.800687106645882,0.246376811594203,1.24665731650304,491,189,302,32,1.6,68.25,9.1,0,0,0,0,0,0,0.13492297231345,93.0896970298426,17.8677596254508
9.7,"random_instances_SVM","SVM",46,19,784,726,58,2000,1805,195,0.809902419308277,0.260869565217391,1.26526414212249,505,195,310,14,1.6,71.84,9.3,0,0,0,0,0,0,0.138744641444115,78.2178769963695,16.8240582984761
9.7,"random_instances_SVM","SVM",46,20,684,631,53,2100,1900,200,0.808649460130496,0.311594202898551,1.27456755493221,538,200,338,33,1.7,75.43,9.5,0,0,0,0,0,0,0.142188180516633,67.3585194706584,17.356534243164
9.7,"random_instances_SVM","SVM",46,21,584,538,46,2200,1993,207,0.808077833593164,0.289855072463768,1.28387096774194,556,207,349,18,1.7,79.02,9.6,0,0,0,0,0,0,0.152305410609004,59.2670451318318,18.1058245278934
9.7,"random_instances_SVM","SVM",46,22,484,444,40,2300,2087,213,0.805837519487271,0.231884057971014,1.28387096774194,578,213,365,22,1.7,82.61,9.8,0,0,0,0,0,0,0.140613747733555,48.6510934944907,16.9001243920305
9.7,"random_instances_SVM","SVM",46,23,384,350,34,2400,2181,219,0.840106241699869,0.333333333333333,1.28387096774194,596,219,377,18,1.7,86.21,10,0,0,0,0,0,0,0.146528960697117,36.7766643509517,17.8613083564908
9.7,"random_instances_SVM","SVM",46,24,284,260,24,2500,2271,229,0.812096541370749,0.246376811594203,1.28387096774194,627,229,398,31,1.7,89.8,9.9,0,0,0,0,0,0,0.123763499291931,27.7112080178781,14.8424595921464
9.7,"random_instances_SVM","SVM",46,25,184,167,17,2600,2364,236,0.811230440556616,0.239130434782609,1.28387096774194,644,236,408,17,1.7,93.39,10,0,0,0,0,0,0,0.102576212636686,17.4618526856688,13.2080718135811
9.7,"random_instances_SVM","SVM",46,26,84,78,6,2700,2453,247,0.813436110629947,0.253623188405797,1.28387096774194,674,247,427,30,1.7,96.98,9.9,0,0,0,0,0,0,0.000409279703912464,8.3429796194128,8.3429796194128
9.7,"random_instances_SVM","SVM",46,27,0,0,0,2784,2531,253,0.83126623939027,0.268115942028986,1.28387096774194,693,253,440,19,1.7,100,10,0,0,0,0,0,0,0,0,0
9.7,"random_instances_SVM","SVM",47,0,2684,2418,266,100,90,10,0.739572701911955,0.217391304347826,1.21688639551192,27,10,17,0,1.7,3.59,9,0,0,0,0,0,0,0.189042816077575,287.325670790385,21.2535804457923
9.7,"random_instances_SVM","SVM",47,1,2584,2332,252,200,176,24,0.781567666870792,0.217391304347826,1.2615427769986,59,24,35,32,1.5,7.18,7.3,0,0,0,0,0,0,0.226264708009254,285.584721170581,36.8730007323312
9.7,"random_instances_SVM","SVM",47,2,2484,2245,239,300,263,37,0.820133360549775,0.269565217391304,1.27270687237027,92,37,55,33,1.5,10.78,7.1,0,0,0,0,0,0,0.182519383517953,276.682435170937,21.3188133709362
9.7,"random_instances_SVM","SVM",47,3,2384,2158,226,400,350,50,0.835714771722122,0.28695652173913,1.28387096774194,117,50,67,25,1.3,14.37,7,0,0,0,0,0,0,0.296281508418544,275.501932276298,38.0096881267347
9.7,"random_instances_SVM","SVM",47,4,2284,2068,216,500,440,60,0.790263319044708,0.295652173913043,1.24922732004164,143,60,83,26,1.4,17.96,7.3,0,0,0,0,0,0,0.375801787622768,286.021868765358,48.774858081067
9.7,"random_instances_SVM","SVM",47,5,2184,1974,210,600,534,66,0.78888208477921,0.304347826086957,1.21688639551192,165,66,99,22,1.5,21.55,8.1,0,0,0,0,0,0,0.135643533929439,239.214472974446,15.0823035999168
9.7,"random_instances_SVM","SVM",47,6,2084,1882,202,700,626,74,0.807675035721581,0.217391304347826,1.2615427769986,203,74,129,38,1.7,25.14,8.5,0,0,0,0,0,0,0.152648286353342,220.884144810536,19.0209970047954
9.7,"random_instances_SVM","SVM",47,7,1984,1789,195,800,719,81,0.798135673947068,0.173913043478261,1.2615427769986,230,81,149,27,1.8,28.74,8.9,0,0,0,0,0,0,0.142529908837275,207.490527316742,15.8618226815392
9.7,"random_instances_SVM","SVM",47,8,1884,1705,179,900,803,97,0.793631353337429,0.2,1.23921458625526,259,97,162,29,1.7,32.33,8.3,0,0,0,0,0,0,0.175757707478243,211.816602519341,24.989794248269
9.7,"random_instances_SVM","SVM",47,9,1784,1611,173,1000,897,103,0.803163911002255,0.208695652173913,1.25037868162693,290,103,187,31,1.8,35.92,8.7,0,0,0,0,0,0,0.130793364772805,188.24804703288,16.2777787340688
9.7,"random_instances_SVM","SVM",47,10,1684,1518,166,1100,990,110,0.813669456351646,0.226086956521739,1.25037868162693,300,110,190,10,1.7,39.51,9,0,0,0,0,0,0,0.126093044646602,174.170825419115,13.9252237778527
9.7,"random_instances_SVM","SVM",47,11,1584,1423,161,1200,1085,115,0.811866367285846,0.269565217391304,1.27270687237027,326,115,211,26,1.8,43.1,9.4,0,0,0,0,0,0,0.135760445699467,159.486276381302,15.9937414354037
9.7,"random_instances_SVM","SVM",47,12,1484,1340,144,1300,1168,132,0.801626182214063,0.234782608695652,1.27270687237027,386,132,254,60,1.9,46.7,8.8,0,0,0,0,0,0,0.128149303014482,153.927630040038,14.4252622302506
9.7,"random_instances_SVM","SVM",47,13,1384,1253,131,1400,1255,145,0.812703272776762,0.28695652173913,1.27270687237027,396,145,251,10,1.7,50.29,8.7,0,0,0,0,0,0,0.166120574543869,146.328866569407,22.7907583067387
9.7,"random_instances_SVM","SVM",47,14,1284,1164,120,1500,1344,156,0.791134245084035,0.191304347826087,1.27270687237027,434,156,278,38,1.8,53.88,8.6,0,0,0,0,0,0,0.140280265141972,138.454909564307,16.3925653729543
9.7,"random_instances_SVM","SVM",47,15,1184,1073,111,1600,1435,165,0.819493774239646,0.269565217391304,1.27270687237027,441,165,276,7,1.7,57.47,8.7,0,0,0,0,0,0,0.165992430233422,122.376927385994,22.2526952245005
9.7,"random_instances_SVM","SVM",47,16,1084,981,103,1700,1527,173,0.808266993263934,0.208695652173913,1.27270687237027,474,173,301,33,1.7,61.06,8.8,0,0,0,0,0,0,0.13397701009679,108.149470257201,15.9089960781791
9.7,"random_instances_SVM","SVM",47,17,984,890,94,1800,1618,182,0.834197455262984,0.28695652173913,1.27270687237027,495,182,313,21,1.7,64.66,8.9,0,0,0,0,0,0,0.137940489454609,96.5380479193616,15.9881529150432
9.7,"random_instances_SVM","SVM",47,18,884,802,82,1900,1706,194,0.82211335646731,0.28695652173913,1.27270687237027,535,194,341,40,1.8,68.25,8.8,0,0,0,0,0,0,0.159438976130655,88.3479407486298,20.3926753890215
9.7,"random_instances_SVM","SVM",47,19,784,711,73,2000,1797,203,0.820630060556584,0.278260869565217,1.27270687237027,561,203,358,26,1.8,71.84,8.9,0,0,0,0,0,0,0.136596210838736,79.6731867756003,16.5288280946667
9.7,"random_instances_SVM","SVM",47,20,684,620,64,2100,1888,212,0.799503299993201,0.243478260869565,1.27270687237027,587,212,375,26,1.8,75.43,8.9,0,0,0,0,0,0,0.133763672483209,72.3999733384399,16.6542928564824
9.7,"random_instances_SVM","SVM",47,21,584,528,56,2200,1980,220,0.77174933659931,0.156521739130435,1.27270687237027,595,220,375,8,1.7,79.02,9,0,0,0,0,0,0,0.127764244881265,59.2677307001946,13.9089161175612
9.7,"random_instances_SVM","SVM",47,22,484,438,46,2300,2070,230,0.839912907396075,0.278260869565217,1.27270687237027,626,230,396,31,1.7,82.61,9,0,0,0,0,0,0,0.143943387185991,47.8499401622821,16.586347835483
9.7,"random_instances_SVM","SVM",47,23,384,347,37,2400,2161,239,0.825801183915089,0.234782608695652,1.28387096774194,652,239,413,26,1.7,86.21,9,0,0,0,0,0,0,0.125532544859487,38.9422536017827,13.7363607233357
9.7,"random_instances_SVM","SVM",47,24,284,255,29,2500,2253,247,0.749010002041236,0.173913043478261,1.28387096774194,669,247,422,17,1.7,89.8,9.1,0,0,0,0,0,0,0.119893482853397,28.4315691161828,13.3913742324943
9.7,"random_instances_SVM","SVM",47,25,184,168,16,2600,2340,260,0.799217527386542,0.2,1.28387096774194,691,260,431,22,1.7,93.39,9,0,0,0,0,0,0,0.102003897771039,18.1827330140773,13.4137728084401
9.7,"random_instances_SVM","SVM",47,26,84,76,8,2700,2432,268,0.795495679390357,0.182608695652174,1.27270687237027,717,268,449,26,1.7,96.98,9.1,0,0,0,0,0,0,0.000115924196841094,8.45239952190966,8.45239952190966
9.7,"random_instances_SVM","SVM",47,27,0,0,0,2784,2508,276,0.786425801183916,0.191304347826087,1.28387096774194,771,276,495,54,1.8,100,9.1,0,0,0,0,0,0,0,0,0
9.7,"random_instances_SVM","SVM",48,0,2684,2433,251,100,90,10,0.727035751263784,0.161538461538462,1.18511166253102,31,10,21,0,2.1,3.59,9,0,0,0,0,0,0,0.218589558783406,281.898055738114,31.1060903501541
9.7,"random_instances_SVM","SVM",48,1,2584,2347,237,200,176,24,0.805103843108596,0.261538461538462,1.25424317617866,59,24,35,28,1.5,7.18,7.3,0,0,0,0,0,0,0.139634527346365,295.401582033977,14.2643225068005
9.7,"random_instances_SVM","SVM",48,2,2484,2259,225,300,264,36,0.81229672939887,0.253846153846154,1.26411910669975,86,36,50,27,1.4,10.78,7.3,0,0,0,0,0,0,0.212354053227822,299.492620810127,23.1813259000657
9.7,"random_instances_SVM","SVM",48,3,2384,2167,217,400,356,44,0.802405749436632,0.292307692307692,1.22461538461538,112,44,68,26,1.5,14.37,8.1,0,0,0,0,0,0,0.28454698757277,263.620210617073,35.1534687154728
9.7,"random_instances_SVM","SVM",48,4,2284,2073,211,500,450,50,0.80803337596687,0.284615384615385,1.26411910669975,143,50,93,31,1.9,17.96,9,0,0,0,0,0,0,0.183196123580116,264.969549106257,21.7341460241747
9.7,"random_instances_SVM","SVM",48,5,2184,1982,202,600,541,59,0.778062001339913,0.330769230769231,1.27399503722084,178,59,119,35,2,21.55,9.2,0,0,0,0,0,0,0.18864529608971,242.351200110826,24.6557545455358
9.7,"random_instances_SVM","SVM",48,6,2084,1892,192,700,631,69,0.790596260429994,0.292307692307692,1.25424317617866,191,69,122,13,1.8,25.14,9.1,0,0,0,0,0,0,0.149381493588678,212.017233759358,18.0499603096813
9.7,"random_instances_SVM","SVM",48,7,1984,1797,187,800,726,74,0.775035020403195,0.292307692307692,1.27399503722084,206,74,132,15,1.8,28.74,9.8,0,0,0,0,0,0,0.208838948027449,219.677153317519,29.1140403960962
9.7,"random_instances_SVM","SVM",48,8,1884,1707,177,900,816,84,0.802174310250323,0.3,1.27399503722084,218,84,134,12,1.6,32.33,9.7,0,0,0,0,0,0,0.17861645649016,200.137227002694,23.7481078865838
9.7,"random_instances_SVM","SVM",48,9,1784,1616,168,1000,907,93,0.785358426213535,0.246153846153846,1.27399503722084,259,93,166,41,1.8,35.92,9.8,0,0,0,0,0,0,0.192512193732319,187.475110544573,26.860356623524
9.7,"random_instances_SVM","SVM",48,10,1684,1524,160,1100,999,101,0.789268530361169,0.238461538461538,1.27399503722084,283,101,182,24,1.8,39.51,9.9,0,0,0,0,0,0,0.194064101435683,169.858340878655,25.4412809706813
9.7,"random_instances_SVM","SVM",48,11,1584,1435,149,1200,1088,112,0.788689932395398,0.223076923076923,1.27399503722084,295,112,183,12,1.6,43.1,9.7,0,0,0,0,0,0,0.165263123991277,151.621479691541,21.9167071854255
9.7,"random_instances_SVM","SVM",48,12,1484,1341,143,1300,1182,118,0.785029538948782,0.2,1.23449131513648,314,118,196,19,1.7,46.7,10,0,0,0,0,0,0,0.176490104847214,146.007370799903,24.0094307906456
9.7,"random_instances_SVM","SVM",48,13,1384,1254,130,1400,1269,131,0.776533284609296,0.2,1.26411910669975,343,131,212,29,1.6,50.29,9.7,0,0,0,0,0,0,0.162028088683333,145.205399081021,19.7698031092353
9.7,"random_instances_SVM","SVM",48,14,1284,1162,122,1500,1361,139,0.800298434740243,0.223076923076923,1.28387096774194,378,139,239,35,1.7,53.88,9.8,0,0,0,0,0,0,0.168568530863731,130.984855108125,22.3670400237706
9.7,"random_instances_SVM","SVM",48,15,1184,1074,110,1600,1449,151,0.772477008343995,0.153846153846154,1.27399503722084,427,151,276,49,1.8,57.47,9.6,0,0,0,0,0,0,0.170315851530204,118.712138609454,22.2310378048073
9.7,"random_instances_SVM","SVM",48,16,1084,983,101,1700,1540,160,0.793952128631465,0.2,1.28387096774194,437,160,277,10,1.7,61.06,9.6,0,0,0,0,0,0,0.174910406865167,109.640986303641,23.8916045948876
9.7,"random_instances_SVM","SVM",48,17,984,896,88,1800,1627,173,0.771100554235949,0.176923076923077,1.27399503722084,471,173,298,34,1.7,64.66,9.4,0,0,0,0,0,0,0.174608576561731,105.08847069057,23.0326015963877
9.7,"random_instances_SVM","SVM",48,18,884,801,83,1900,1722,178,0.763986844509412,0.138461538461538,1.28387096774194,481,178,303,10,1.7,68.25,9.7,0,0,0,0,0,0,0.183585510363578,92.4769841706295,24.1508768994661
9.7,"random_instances_SVM","SVM",48,19,784,711,73,2000,1812,188,0.783135391923992,0.184615384615385,1.27399503722084,523,188,335,42,1.8,71.84,9.6,0,0,0,0,0,0,0.165330844964156,78.1353469485479,21.7321966281988
9.7,"random_instances_SVM","SVM",48,20,684,618,66,2100,1905,195,0.796613679274013,0.184615384615385,1.27399503722084,529,195,334,6,1.7,75.43,9.8,0,0,0,0,0,0,0.162608974425361,69.782942761615,21.1392129909297
9.7,"random_instances_SVM","SVM",48,21,584,526,58,2200,1997,203,0.811431877702663,0.230769230769231,1.28387096774194,547,203,344,18,1.7,79.02,9.8,0,0,0,0,0,0,0.185964482481857,61.6126046449278,25.322233104257
9.7,"random_instances_SVM","SVM",48,22,484,437,47,2300,2086,214,0.795109324563008,0.192307692307692,1.27399503722084,566,214,352,19,1.6,82.61,9.7,0,0,0,0,0,0,0.152829308911348,52.0488958682638,20.1149574315792
9.7,"random_instances_SVM","SVM",48,23,384,348,36,2400,2175,225,0.800450697362813,0.207692307692308,1.27399503722084,589,225,364,23,1.6,86.21,9.7,0,0,0,0,0,0,0.155981978518764,41.8687000489588,20.8770804636979
9.7,"random_instances_SVM","SVM",48,24,284,260,24,2500,2263,237,0.795206772641454,0.192307692307692,1.27399503722084,625,237,388,36,1.6,89.8,9.5,0,0,0,0,0,0,0.135628567682944,29.0321446445423,17.3121381354799
9.7,"random_instances_SVM","SVM",48,25,184,168,16,2600,2355,245,0.79283147572934,0.176923076923077,1.26411910669975,647,245,402,22,1.6,93.39,9.6,0,0,0,0,0,0,0.0924499269523703,18.5420585478857,15.0115839882609
9.7,"random_instances_SVM","SVM",48,26,84,76,8,2700,2447,253,0.785650770448873,0.184615384615385,1.26411910669975,667,253,414,20,1.6,96.98,9.7,0,0,0,0,0,0,7.52289171500205e-05,8.64232738310196,8.64232738310196
9.7,"random_instances_SVM","SVM",48,27,0,0,0,2784,2523,261,0.808782508069921,0.238461538461538,1.27399503722084,676,261,415,9,1.6,100,9.7,0,0,0,0,0,0,0,0,0
9.7,"random_instances_SVM","SVM",49,0,2684,2429,255,100,91,9,0.816957122065906,0.409448818897638,1.22321564643129,36,9,27,0,3,3.59,10.1,0,0,0,0,0,0,0.116513086902038,247.608142451059,11.9244095099573
9.7,"random_instances_SVM","SVM",49,1,2584,2343,241,200,177,23,0.745842196265753,0.259842519685039,1.19288798577597,63,23,40,27,1.7,7.18,7.7,0,0,0,0,0,0,0.155648308059829,315.698022377373,32.3419211826699
9.7,"random_instances_SVM","SVM",49,2,2484,2255,229,300,265,35,0.808728589021156,0.204724409448819,1.28387096774194,90,35,55,27,1.6,10.78,7.6,0,0,0,0,0,0,0.235012155792371,288.193175164511,40.9657613167773
9.7,"random_instances_SVM","SVM",49,3,2384,2160,224,400,360,40,0.826553967483923,0.236220472440945,1.28387096774194,108,40,68,18,1.7,14.37,9,0,0,0,0,0,0,0.152435845229358,240.043352136064,23.0243970962533
9.7,"random_instances_SVM","SVM",49,4,2284,2064,220,500,456,44,0.8175231058203,0.196850393700787,1.28387096774194,128,44,84,20,1.9,17.96,10.4,0,0,0,0,0,0,0.118616309560215,203.541552998766,19.9712289564687
9.7,"random_instances_SVM","SVM",49,5,2184,1972,212,600,548,52,0.811011182843856,0.236220472440945,1.28387096774194,139,52,87,11,1.7,21.55,10.5,0,0,0,0,0,0,0.108320055059113,186.410098995411,11.9248747628166
9.7,"random_instances_SVM","SVM",49,6,2084,1881,203,700,639,61,0.82020997375328,0.251968503937008,1.28387096774194,156,61,95,17,1.6,25.14,10.5,0,0,0,0,0,0,0.184142824746595,179.504644953409,27.0716345428278
9.7,"random_instances_SVM","SVM",49,7,1984,1794,190,800,726,74,0.823046112126981,0.275590551181102,1.28387096774194,191,74,117,35,1.6,28.74,9.8,0,0,0,0,0,0,0.197411538688718,190.857291824589,27.9630846523026
9.7,"random_instances_SVM","SVM",49,8,1884,1704,180,900,816,84,0.814599893022855,0.267716535433071,1.28268876611418,210,84,126,19,1.5,32.33,9.7,0,0,0,0,0,0,0.214027804044768,174.788566173371,31.4658592320224
9.7,"random_instances_SVM","SVM",49,9,1784,1621,163,1000,899,101,0.793048973143761,0.244094488188976,1.28268876611418,254,101,153,44,1.5,35.92,8.9,0,0,0,0,0,0,0.231375846975314,186.099604957089,33.9188372327728
9.7,"random_instances_SVM","SVM",49,10,1684,1529,155,1100,991,109,0.824719184983393,0.275590551181102,1.28387096774194,275,109,166,21,1.5,39.51,9.1,0,0,0,0,0,0,0.214454483331219,173.245279915687,29.5903018290065
9.7,"random_instances_SVM","SVM",49,11,1584,1437,147,1200,1083,117,0.803205582714485,0.259842519685039,1.28268876611418,300,117,183,25,1.6,43.1,9.3,0,0,0,0,0,0,0.228611937674508,167.615951867621,33.0416524135772
9.7,"random_instances_SVM","SVM",49,12,1484,1343,141,1300,1177,123,0.804785361545445,0.283464566929134,1.28268876611418,316,123,193,16,1.6,46.7,9.6,0,0,0,0,0,0,0.210888259159435,148.04369646833,30.3703387625359
9.7,"random_instances_SVM","SVM",49,13,1384,1249,135,1400,1271,129,0.810314587453816,0.291338582677165,1.28387096774194,338,129,209,22,1.6,50.29,9.9,0,0,0,0,0,0,0.175094274913488,131.617355973577,22.806357058376
9.7,"random_instances_SVM","SVM",49,14,1284,1158,126,1500,1362,138,0.82680275155179,0.299212598425197,1.28387096774194,353,138,215,15,1.6,53.88,9.9,0,0,0,0,0,0,0.170531104561112,120.923813229617,23.668878850583
9.7,"random_instances_SVM","SVM",49,15,1184,1066,118,1600,1454,146,0.81596198579443,0.244094488188976,1.28387096774194,389,146,243,36,1.7,57.47,10,0,0,0,0,0,0,0.162240515120835,105.838902312014,21.8359242471737
9.7,"random_instances_SVM","SVM",49,16,1084,976,108,1700,1544,156,0.804294013011407,0.188976377952756,1.28387096774194,430,156,274,41,1.8,61.06,9.9,0,0,0,0,0,0,0.145275575809972,99.5961302460834,18.039452263248
9.7,"random_instances_SVM","SVM",49,17,984,888,96,1800,1632,168,0.845194113768957,0.275590551181102,1.28387096774194,455,168,287,25,1.7,64.66,9.7,0,0,0,0,0,0,0.183810501884591,95.6024044270092,23.861187417766
9.7,"random_instances_SVM","SVM",49,18,884,799,85,1900,1721,179,0.829589133111917,0.244094488188976,1.28387096774194,483,179,304,28,1.7,68.25,9.6,0,0,0,0,0,0,0.156608354108009,85.7867255110355,19.7398152509065
9.7,"random_instances_SVM","SVM",49,19,784,709,75,2000,1811,189,0.837108631563235,0.220472440944882,1.28387096774194,498,189,309,15,1.6,71.84,9.6,0,0,0,0,0,0,0.16912763806097,76.187038707785,22.851907771363
9.7,"random_instances_SVM","SVM",49,20,684,618,66,2100,1902,198,0.80878456543643,0.188976377952756,1.28387096774194,530,198,332,32,1.7,75.43,9.6,0,0,0,0,0,0,0.14477392161884,66.9387354249454,18.0944177296794
9.7,"random_instances_SVM","SVM",49,21,584,529,55,2200,1991,209,0.786997300692864,0.173228346456693,1.28387096774194,563,209,354,33,1.7,79.02,9.5,0,0,0,0,0,0,0.132357887470561,55.268840304261,18.2414477345086
9.7,"random_instances_SVM","SVM",49,22,484,443,41,2300,2077,223,0.797402694331455,0.173228346456693,1.28387096774194,618,223,395,55,1.8,82.61,9.3,0,0,0,0,0,0,0.132953004072274,46.9995375439813,16.9967972850924
9.7,"random_instances_SVM","SVM",49,23,384,355,29,2400,2165,235,0.819544476371733,0.204724409448819,1.28387096774194,640,235,405,22,1.7,86.21,9.2,0,0,0,0,0,0,0.13044676515958,38.3985030593229,17.2834533588963
9.7,"random_instances_SVM","SVM",49,24,284,263,21,2500,2257,243,0.762112674304337,0.165354330708661,1.28387096774194,649,243,406,9,1.7,89.8,9.3,0,0,0,0,0,0,0.121274168632011,29.3242820004278,15.6950212862612
9.7,"random_instances_SVM","SVM",49,25,184,170,14,2600,2350,250,0.769775223594682,0.173228346456693,1.28387096774194,679,250,429,30,1.7,93.39,9.4,0,0,0,0,0,0,0.0933372684366861,18.9027823361222,14.2701482871801
9.7,"random_instances_SVM","SVM",49,26,84,75,9,2700,2445,255,0.809027129902602,0.21259842519685,1.28387096774194,707,255,452,28,1.8,96.98,9.6,0,0,0,0,0,0,0.00311947478296517,9.07809840804257,9.07809840804257
9.7,"random_instances_SVM","SVM",49,27,0,0,0,2784,2520,264,0.815439539251907,0.244094488188976,1.28268876611418,697,264,433,-10,1.6,100,9.5,0,0,0,0,0,0,0,0,0
9.7,"random_instances_SVM","SVM",50,0,2684,2444,240,100,95,5,0.74104975228219,0.273972602739726,1.13437914273089,17,5,12,0,2.4,3.59,19,0,0,0,0,0,0,0.110065147574643,152.015886393198,16.386038047989
9.7,"random_instances_SVM","SVM",50,1,2584,2357,227,200,182,18,0.819303314255575,0.328767123287671,1.26628369421122,45,18,27,28,1.5,7.18,10.1,0,0,0,0,0,0,0.400269788691806,237.452086466381,69.0564646123113
9.7,"random_instances_SVM","SVM",50,2,2484,2272,212,300,267,33,0.825109028792373,0.356164383561644,1.26628369421122,88,33,55,43,1.7,10.78,8.1,0,0,0,0,0,0,0.177403145381005,260.077460647132,19.6900738123111
9.7,"random_instances_SVM","SVM",50,3,2384,2185,199,400,354,46,0.771034043347867,0.315068493150685,1.24869642068051,137,46,91,49,2,14.37,7.7,0,0,0,0,0,0,0.140569512731817,281.289664582215,18.6948934462066
9.7,"random_instances_SVM","SVM",50,4,2284,2094,190,500,445,55,0.758768990783351,0.267123287671233,1.26628369421122,161,55,106,24,1.9,17.96,8.1,0,0,0,0,0,0,0.131201061983046,267.764026050905,15.6285421970486
9.7,"random_instances_SVM","SVM",50,5,2184,2002,182,600,537,63,0.774060484889754,0.308219178082192,1.26628369421122,186,63,123,25,2,21.55,8.5,0,0,0,0,0,0,0.138152796610919,244.318860959371,15.5931197886887
9.7,"random_instances_SVM","SVM",50,6,2084,1910,174,700,629,71,0.793564829563555,0.267123287671233,1.25749005744587,203,71,132,17,1.9,25.14,8.9,0,0,0,0,0,0,0.132969130156541,217.530314746016,14.522854805462
9.7,"random_instances_SVM","SVM",50,7,1984,1815,169,800,724,76,0.761108853028086,0.267123287671233,1.26628369421122,233,76,157,30,2.1,28.74,9.5,0,0,0,0,0,0,0.15155542404472,200.44835523283,18.7924400235209
9.7,"random_instances_SVM","SVM",50,8,1884,1725,159,900,814,86,0.739555755731557,0.232876712328767,1.26628369421122,253,86,167,20,1.9,32.33,9.5,0,0,0,0,0,0,0.120777289495947,183.041895921331,12.964984522346
9.7,"random_instances_SVM","SVM",50,9,1784,1634,150,1000,905,95,0.760295943140245,0.205479452054795,1.25749005744587,276,95,181,23,1.9,35.92,9.5,0,0,0,0,0,0,0.155825571880797,173.449670136622,18.9903522878505
9.7,"random_instances_SVM","SVM",50,10,1684,1541,143,1100,998,102,0.775010710637034,0.280821917808219,1.25749005744587,308,102,206,32,2,39.51,9.8,0,0,0,0,0,0,0.132645632461198,161.245889430048,15.5454678245357
9.7,"random_instances_SVM","SVM",50,11,1584,1447,137,1200,1092,108,0.787764607661121,0.287671232876712,1.26628369421122,327,108,219,19,2,43.1,10.1,0,0,0,0,0,0,0.146155234152552,145.487698762073,18.6765557265203
9.7,"random_instances_SVM","SVM",50,12,1484,1356,128,1300,1183,117,0.785161098966283,0.287671232876712,1.27507733097658,345,117,228,18,1.9,46.7,10.1,0,0,0,0,0,0,0.170690607701841,139.840528644932,26.0810629395585
9.7,"random_instances_SVM","SVM",50,13,1384,1267,117,1400,1272,128,0.756467576979263,0.26027397260274,1.26628369421122,367,128,239,22,1.9,50.29,9.9,0,0,0,0,0,0,0.146128676036303,126.30134183959,19.4610994337134
9.7,"random_instances_SVM","SVM",50,14,1284,1176,108,1500,1363,137,0.795344443101803,0.308219178082192,1.25749005744587,382,137,245,15,1.8,53.88,9.9,0,0,0,0,0,0,0.145428801928146,120.581927586642,19.0332260339006
9.7,"random_instances_SVM","SVM",50,15,1184,1085,99,1600,1454,146,0.76687611912426,0.26027397260274,1.25749005744587,426,146,280,44,1.9,57.47,10,0,0,0,0,0,0,0.113132086094347,112.262100759638,12.3654257033945
9.7,"random_instances_SVM","SVM",50,16,1084,992,92,1700,1547,153,0.804780788962003,0.321917808219178,1.25749005744587,428,153,275,2,1.8,61.06,10.1,0,0,0,0,0,0,0.140331161637095,104.785525600979,17.6463302137293
9.7,"random_instances_SVM","SVM",50,17,984,900,84,1800,1639,161,0.816897540398328,0.315068493150685,1.25749005744587,445,161,284,17,1.8,64.66,10.2,0,0,0,0,0,0,0.13788574442187,91.5873413776722,16.756003297766
9.7,"random_instances_SVM","SVM",50,18,884,807,77,1900,1732,168,0.787577858092301,0.287671232876712,1.25749005744587,499,168,331,54,2,68.25,10.3,0,0,0,0,0,0,0.148688738546417,85.2123135040859,19.1486029029874
9.7,"random_instances_SVM","SVM",50,19,784,717,67,2000,1822,178,0.737193922949324,0.191780821917808,1.25749005744587,503,178,325,4,1.8,71.84,10.2,0,0,0,0,0,0,0.149671820017635,76.2527634284773,18.5856416084292
9.7,"random_instances_SVM","SVM",50,20,684,627,57,2100,1912,188,0.79813470136547,0.301369863013699,1.25749005744587,531,188,343,28,1.8,75.43,10.2,0,0,0,0,0,0,0.176559701967151,68.7909650615288,21.5545140072294
9.7,"random_instances_SVM","SVM",50,21,584,534,50,2200,2005,195,0.738830727993754,0.171232876712329,1.26628369421122,563,195,368,32,1.9,79.02,10.3,0,0,0,0,0,0,0.1454205042995,54.4411609566036,17.8332221836485
9.7,"random_instances_SVM","SVM",50,22,484,444,40,2300,2095,205,0.798656501631302,0.321917808219178,1.26628369421122,593,205,388,30,1.9,82.61,10.2,0,0,0,0,0,0,0.158922326009001,47.6496484848349,19.1392027027097
9.7,"random_instances_SVM","SVM",50,23,384,349,35,2400,2190,210,0.748706484604139,0.212328767123288,1.26628369421122,592,210,382,-1,1.8,86.21,10.4,0,0,0,0,0,0,0.138542019264494,36.0071235434071,16.8961120103068
9.7,"random_instances_SVM","SVM",50,24,284,257,27,2500,2282,218,0.758790961320865,0.26027397260274,1.25749005744587,609,218,391,17,1.8,89.8,10.5,0,0,0,0,0,0,0.127587893275659,27.2051740192763,16.325510271574
9.7,"random_instances_SVM","SVM",50,25,184,168,16,2600,2371,229,0.806170425459456,0.301369863013699,1.26628369421122,643,229,414,34,1.8,93.39,10.4,0,0,0,0,0,0,0.0706210900157383,17.1937332958848,15.6168393437185
9.7,"random_instances_SVM","SVM",50,26,84,75,9,2700,2464,236,0.796893365996191,0.301369863013699,1.26628369421122,685,236,449,42,1.9,96.98,10.4,0,0,0,0,0,0,2.97052352026788e-07,7.92239931318612,7.92239931318612
9.7,"random_instances_SVM","SVM",50,27,0,0,0,2784,2539,245,0.727395063220215,0.171232876712329,1.26628369421122,689,245,444,4,1.8,100,10.4,0,0,0,0,0,0,0,0,0
9.7,"random_instances_SVM","SVM",51,0,2684,2433,251,100,91,9,0.778190440473737,0.297709923664122,1.2348682590495,31,9,22,0,2.4,3.59,10.1,0,0,0,0,0,0,0.106481288983141,257.439326638764,10.9947105225871
9.7,"random_instances_SVM","SVM",51,1,2584,2347,237,200,177,23,0.817791945415609,0.351145038167939,1.27407042600345,60,23,37,29,1.6,7.18,7.7,0,0,0,0,0,0,0.296022913004801,309.946260435151,37.7049115142151
9.7,"random_instances_SVM","SVM",51,2,2484,2261,223,300,263,37,0.825231971546432,0.381679389312977,1.27407042600345,88,37,51,28,1.4,10.78,7.1,0,0,0,0,0,0,0.15355512285607,291.150976867126,16.7169881216744
9.7,"random_instances_SVM","SVM",51,3,2384,2169,215,400,355,45,0.831643701382753,0.358778625954198,1.28387096774194,111,45,66,23,1.5,14.37,7.9,0,0,0,0,0,0,0.211596295361088,265.511255269015,25.7512880884792
9.7,"random_instances_SVM","SVM",51,4,2284,2075,209,500,449,51,0.806910151099066,0.351145038167939,1.28387096774194,131,51,80,20,1.6,17.96,8.8,0,0,0,0,0,0,0.263743006108132,239.679725660347,37.4137761782418
9.7,"random_instances_SVM","SVM",51,5,2184,1980,204,600,544,56,0.801036764616928,0.259541984732824,1.28387096774194,152,56,96,21,1.7,21.55,9.7,0,0,0,0,0,0,0.200464074858031,196.241759716772,25.8002985488053
9.7,"random_instances_SVM","SVM",51,6,2084,1886,198,700,638,62,0.813836029082639,0.244274809160305,1.28387096774194,175,62,113,23,1.8,25.14,10.3,0,0,0,0,0,0,0.189880410557385,184.351066136169,24.9659956595279
9.7,"random_instances_SVM","SVM",51,7,1984,1798,186,800,726,74,0.794691571599666,0.274809160305344,1.26426988426496,213,74,139,38,1.9,28.74,9.8,0,0,0,0,0,0,0.229698319929806,180.658009835919,30.9128227017752
9.7,"random_instances_SVM","SVM",51,8,1884,1710,174,900,814,86,0.770538706282283,0.290076335877863,1.26426988426496,235,86,149,22,1.7,32.33,9.5,0,0,0,0,0,0,0.182818826770609,182.697530476832,22.3996177459441
9.7,"random_instances_SVM","SVM",51,9,1784,1623,161,1000,901,99,0.7040321312348,0.175572519083969,1.26426988426496,283,99,184,48,1.9,35.92,9.1,0,0,0,0,0,0,0.178289812960061,181.223042911254,23.1054668874599
9.7,"random_instances_SVM","SVM",51,10,1684,1538,146,1100,986,114,0.7491501433566,0.213740458015267,1.26426988426496,312,114,198,29,1.7,39.51,8.6,0,0,0,0,0,0,0.220528642423407,165.567794324774,28.2593173431244
9.7,"random_instances_SVM","SVM",51,11,1584,1443,141,1200,1081,119,0.748031115036107,0.190839694656489,1.26426988426496,347,119,228,35,1.9,43.1,9.1,0,0,0,0,0,0,0.181747871653454,166.728900504619,24.1219063641798
9.7,"random_instances_SVM","SVM",51,12,1484,1353,131,1300,1171,129,0.686786997495794,0.152671755725191,1.25446934252647,394,129,265,47,2.1,46.7,9.1,0,0,0,0,0,0,0.16586591761016,154.594784237068,21.6959001184721
9.7,"random_instances_SVM","SVM",51,13,1384,1261,123,1400,1263,137,0.737584834444292,0.229007633587786,1.26426988426496,404,137,267,10,1.9,50.29,9.2,0,0,0,0,0,0,0.199198192433238,143.725002780984,27.3863536704262
9.7,"random_instances_SVM","SVM",51,14,1284,1174,110,1500,1350,150,0.745381739877325,0.213740458015267,1.27407042600345,419,150,269,15,1.8,53.88,9,0,0,0,0,0,0,0.142078861489221,132.484315760614,16.8087982235676
9.7,"random_instances_SVM","SVM",51,15,1184,1082,102,1600,1442,158,0.748418238346981,0.236641221374046,1.27407042600345,462,158,304,43,1.9,57.47,9.1,0,0,0,0,0,0,0.166476949238959,120.420488848884,21.9161044386151
9.7,"random_instances_SVM","SVM",51,16,1084,987,97,1700,1537,163,0.775946335031029,0.183206106870229,1.27407042600345,476,163,313,14,1.9,61.06,9.4,0,0,0,0,0,0,0.158670032507885,109.723509498553,19.2957145909447
9.7,"random_instances_SVM","SVM",51,17,984,898,86,1800,1626,174,0.803728481387835,0.251908396946565,1.27407042600345,508,174,334,32,1.9,64.66,9.3,0,0,0,0,0,0,0.151912088535117,98.301322165195,17.5708716673198
9.7,"random_instances_SVM","SVM",51,18,884,806,78,1900,1718,182,0.788406866599724,0.213740458015267,1.27407042600345,502,182,320,-6,1.8,68.25,9.4,0,0,0,0,0,0,0.161477626881355,85.6277848184871,19.6158949281983
9.7,"random_instances_SVM","SVM",51,19,784,714,70,2000,1810,190,0.777888000387121,0.183206106870229,1.28387096774194,559,190,369,57,1.9,71.84,9.5,0,0,0,0,0,0,0.155682858247441,78.1069528185106,18.929268293765
9.7,"random_instances_SVM","SVM",51,20,684,621,63,2100,1903,197,0.79873217115689,0.282442748091603,1.26426988426496,584,197,387,25,2,75.43,9.7,0,0,0,0,0,0,0.139530015066296,64.5586164379888,16.1701316423394
9.7,"random_instances_SVM","SVM",51,21,584,526,58,2200,1998,202,0.76187077339979,0.198473282442748,1.28387096774194,581,202,379,-3,1.9,79.02,9.9,0,0,0,0,0,0,0.126600524978791,54.356393387147,15.8667360479697
9.7,"random_instances_SVM","SVM",51,22,484,433,51,2300,2091,209,0.776539117600803,0.221374045801527,1.28387096774194,584,209,375,3,1.8,82.61,10,0,0,0,0,0,0,0.129991286925344,45.7905021805158,16.0341868083037
9.7,"random_instances_SVM","SVM",51,23,384,345,39,2400,2179,221,0.791050192956773,0.206106870229008,1.28387096774194,605,221,384,21,1.7,86.21,9.9,0,0,0,0,0,0,0.12140127306989,36.7547408109196,14.5643552814458
9.7,"random_instances_SVM","SVM",51,24,284,252,32,2500,2272,228,0.807690446522539,0.236641221374046,1.28387096774194,632,228,404,27,1.8,89.8,10,0,0,0,0,0,0,0.123882490334119,28.2527931304737,16.0010823574498
9.7,"random_instances_SVM","SVM",51,25,184,159,25,2600,2365,235,0.816848332345362,0.259541984732824,1.28387096774194,654,235,419,22,1.8,93.39,10.1,0,0,0,0,0,0,0.0977142413995395,17.6410998301004,12.4988121306895
9.7,"random_instances_SVM","SVM",51,26,84,71,13,2700,2453,247,0.810630164164478,0.282442748091603,1.28387096774194,685,247,438,31,1.8,96.98,9.9,0,0,0,0,0,0,5.44445279008966e-08,8.69405793427547,8.69405793427547
9.7,"random_instances_SVM","SVM",51,27,0,0,0,2784,2524,260,0.823054402922778,0.236641221374046,1.28387096774194,725,260,465,40,1.8,100,9.7,0,0,0,0,0,0,0,0,0
9.7,"random_instances_SVM","SVM",52,0,2684,2434,250,100,91,9,0.768083291279157,0.234848484848485,1.2352394916911,24,9,15,0,1.7,3.59,10.1,0,0,0,0,0,0,0.101463488778387,262.590362951463,10.2203890817432
9.7,"random_instances_SVM","SVM",52,1,2584,2348,236,200,177,23,0.817268642010906,0.333333333333333,1.2644183773216,56,23,33,32,1.4,7.18,7.7,0,0,0,0,0,0,0.142710510865592,301.84727186644,14.5807809583887
9.7,"random_instances_SVM","SVM",52,2,2484,2264,220,300,261,39,0.825306995410083,0.287878787878788,1.27414467253177,95,39,56,39,1.4,10.78,6.7,0,0,0,0,0,0,0.222531505196951,278.398473926697,26.0226706157092
9.7,"random_instances_SVM","SVM",52,3,2384,2170,214,400,355,45,0.786989642659742,0.21969696969697,1.2644183773216,119,45,74,24,1.6,14.37,7.9,0,0,0,0,0,0,0.137736613158433,264.74485419152,14.8813292139311
9.7,"random_instances_SVM","SVM",52,4,2284,2075,209,500,450,50,0.805463436906733,0.25,1.2644183773216,137,50,87,18,1.7,17.96,9,0,0,0,0,0,0,0.178670340025863,236.865128081917,21.8855125932217
9.7,"random_instances_SVM","SVM",52,5,2184,1978,206,600,547,53,0.802189219714993,0.25,1.2644183773216,138,53,85,1,1.6,21.55,10.3,0,0,0,0,0,0,0.144741683784264,190.368156786572,17.195008497415
9.7,"random_instances_SVM","SVM",52,6,2084,1883,201,700,642,58,0.803546968495421,0.257575757575758,1.25469208211144,157,58,99,19,1.7,25.14,11.1,0,0,0,0,0,0,0.172567345364677,184.860551992475,23.00751620869
9.7,"random_instances_SVM","SVM",52,7,1984,1796,188,800,729,71,0.805619638093853,0.257575757575758,1.25469208211144,194,71,123,37,1.7,28.74,10.3,0,0,0,0,0,0,0.185103877260269,193.959936816002,23.8870259256362
9.7,"random_instances_SVM","SVM",52,8,1884,1711,173,900,814,86,0.800422944752834,0.265151515151515,1.24496578690127,220,86,134,26,1.6,32.33,9.5,0,0,0,0,0,0,0.196237515305274,187.129284066496,27.0385127247558
9.7,"random_instances_SVM","SVM",52,9,1784,1621,163,1000,904,96,0.804754523826679,0.257575757575758,1.2644183773216,250,96,154,30,1.6,35.92,9.4,0,0,0,0,0,0,0.203923119660148,188.675297158519,27.5579510883538
9.7,"random_instances_SVM","SVM",52,10,1684,1530,154,1100,995,105,0.789554946771435,0.234848484848485,1.2352394916911,275,105,170,25,1.6,39.51,9.5,0,0,0,0,0,0,0.183682424363056,169.424681583121,23.5741583964486
9.7,"random_instances_SVM","SVM",52,11,1584,1435,149,1200,1090,110,0.782922404056422,0.25,1.22438473129081,284,110,174,9,1.6,43.1,9.9,0,0,0,0,0,0,0.197845303319458,153.877915708418,27.9625792287654
9.7,"random_instances_SVM","SVM",52,12,1484,1346,138,1300,1179,121,0.8043039434792,0.25,1.2644183773216,312,121,191,28,1.6,46.7,9.7,0,0,0,0,0,0,0.184510727962457,140.830068781895,25.888029637896
9.7,"random_instances_SVM","SVM",52,13,1384,1257,127,1400,1268,132,0.795040011534849,0.25,1.2644183773216,335,132,203,23,1.5,50.29,9.6,0,0,0,0,0,0,0.21006595003648,139.497236552677,29.4665833576346
9.7,"random_instances_SVM","SVM",52,14,1284,1173,111,1500,1352,148,0.820542859202647,0.28030303030303,1.27297142697695,371,148,223,36,1.5,53.88,9.1,0,0,0,0,0,0,0.195031932972187,124.293062603226,27.8499421912645
9.7,"random_instances_SVM","SVM",52,15,1184,1086,98,1600,1439,161,0.814258765289692,0.25,1.2644183773216,404,161,243,33,1.5,57.47,8.9,0,0,0,0,0,0,0.19488876861197,122.217987262415,27.162525710242
9.7,"random_instances_SVM","SVM",52,16,1084,996,88,1700,1529,171,0.813207411145553,0.287878787878788,1.25469208211144,426,171,255,22,1.5,61.06,8.9,0,0,0,0,0,0,0.205403990150026,108.460077961462,31.0225023032879
9.7,"random_instances_SVM","SVM",52,17,984,904,80,1800,1621,179,0.819641698507676,0.272727272727273,1.24496578690127,449,179,270,23,1.5,64.66,9.1,0,0,0,0,0,0,0.213612504217615,103.446161071925,29.141456294584
9.7,"random_instances_SVM","SVM",52,18,884,813,71,1900,1712,188,0.807349866628209,0.242424242424242,1.25469208211144,469,188,281,20,1.5,68.25,9.1,0,0,0,0,0,0,0.205551880549566,88.2288554609319,31.0300511620181
9.7,"random_instances_SVM","SVM",52,19,784,719,65,2000,1806,194,0.813862254583898,0.265151515151515,1.25353674870249,503,194,309,34,1.6,71.84,9.3,0,0,0,0,0,0,0.199847837964315,82.2057937004989,28.4862572477654
9.7,"random_instances_SVM","SVM",52,20,684,625,59,2100,1900,200,0.812480474851604,0.25,1.26325408783972,531,200,331,28,1.7,75.43,9.5,0,0,0,0,0,0,0.189731439172326,69.7201624632573,25.8220227536829
9.7,"random_instances_SVM","SVM",52,21,584,533,51,2200,1992,208,0.812210126643112,0.287878787878788,1.2644183773216,572,208,364,41,1.8,79.02,9.6,0,0,0,0,0,0,0.178278405253024,62.7361138372859,21.5946208051572
9.7,"random_instances_SVM","SVM",52,22,484,440,44,2300,2085,215,0.810864393338619,0.25,1.2644183773216,575,215,360,3,1.7,82.61,9.7,0,0,0,0,0,0,0.161136988597175,47.9293643755769,19.6812061331994
9.7,"random_instances_SVM","SVM",52,23,384,352,32,2400,2173,227,0.805463436906734,0.234848484848485,1.27414467253177,598,227,371,23,1.6,86.21,9.6,0,0,0,0,0,0,0.147309810872322,35.9643851630402,19.4391883109027
9.7,"random_instances_SVM","SVM",52,24,284,263,21,2500,2262,238,0.814090548626629,0.287878787878788,1.27414467253177,632,238,394,34,1.7,89.8,9.5,0,0,0,0,0,0,0.12688101342462,29.2579458262477,18.9752049332608
9.7,"random_instances_SVM","SVM",52,25,184,173,11,2600,2352,248,0.786022396847141,0.25,1.2644183773216,669,248,421,37,1.7,93.39,9.5,0,0,0,0,0,0,0.0791130019312629,17.8645072033526,15.4786168988914
9.7,"random_instances_SVM","SVM",52,26,84,80,4,2700,2445,255,0.840843005791459,0.318181818181818,1.2644183773216,688,255,433,19,1.7,96.98,9.6,0,0,0,0,0,0,2.00513684972833e-05,7.59129829375642,7.59129829375642
9.7,"random_instances_SVM","SVM",52,27,0,0,0,2784,2525,259,0.791195059236297,0.212121212121212,1.2644183773216,688,259,429,0,1.7,100,9.7,0,0,0,0,0,0,0,0,0
9.7,"random_instances_SVM","SVM",53,0,2684,2423,261,100,83,17,0.802316095132735,0.327433628318584,1.21570082786183,42,17,25,0,1.5,3.59,4.9,0,0,0,0,0,0,0.235855484723852,441.858175829896,24.3194199804165
9.7,"random_instances_SVM","SVM",53,1,2584,2337,247,200,169,31,0.822255254424769,0.380530973451327,1.20433913788182,77,31,46,35,1.5,7.18,5.5,0,0,0,0,0,0,0.189118456531712,394.501281144968,19.9192255607021
9.7,"random_instances_SVM","SVM",53,2,2484,2249,235,300,257,43,0.794545077433622,0.336283185840708,1.23842420782187,111,43,68,34,1.6,10.78,6,0,0,0,0,0,0,0.319350856514176,355.456199577292,44.4513174378031
9.7,"random_instances_SVM","SVM",53,3,2384,2153,231,400,353,47,0.743667035398228,0.283185840707965,1.24978589780188,131,47,84,20,1.8,14.37,7.5,0,0,0,0,0,0,0.164490090601907,292.158880669935,20.1379279645532
9.7,"random_instances_SVM","SVM",53,4,2284,2061,223,500,445,55,0.760218473451324,0.256637168141593,1.23842420782187,159,55,104,28,1.9,17.96,8.1,0,0,0,0,0,0,0.171545877487838,262.085104651235,21.924162580021
9.7,"random_instances_SVM","SVM",53,5,2184,1966,218,600,540,60,0.724363938053093,0.20353982300885,1.23842420782187,177,60,117,18,2,21.55,9,0,0,0,0,0,0,0.12175579016183,229.452477214713,14.0304740563277
9.7,"random_instances_SVM","SVM",53,6,2084,1874,210,700,632,68,0.756395188053092,0.221238938053097,1.24978589780188,203,68,135,26,2,25.14,9.3,0,0,0,0,0,0,0.121136520166768,209.059323083306,14.259064175931
9.7,"random_instances_SVM","SVM",53,7,1984,1786,198,800,720,80,0.739546460176987,0.132743362831858,1.24978589780188,235,80,155,32,1.9,28.74,9,0,0,0,0,0,0,0.15686170270768,201.25455290259,20.984804219405
9.7,"random_instances_SVM","SVM",53,8,1884,1694,190,900,812,88,0.741095132743359,0.141592920353982,1.2611475877819,252,88,164,17,1.9,32.33,9.2,0,0,0,0,0,0,0.166545701954318,200.626886997634,27.075345307572
9.7,"random_instances_SVM","SVM",53,9,1784,1602,182,1000,904,96,0.706478152654863,0.123893805309735,1.24978589780188,277,96,181,25,1.9,35.92,9.4,0,0,0,0,0,0,0.13733695595983,180.22355471282,22.0146720107673
9.7,"random_instances_SVM","SVM",53,10,1684,1513,171,1100,993,107,0.773140210176989,0.15929203539823,1.27250927776192,317,107,210,40,2,39.51,9.3,0,0,0,0,0,0,0.135052996817306,175.167355222718,19.8696542328227
9.7,"random_instances_SVM","SVM",53,11,1584,1422,162,1200,1084,116,0.74689574115044,0.194690265486726,1.28387096774194,358,116,242,41,2.1,43.1,9.3,0,0,0,0,0,0,0.128015786031919,161.881510694144,19.588728527412
9.7,"random_instances_SVM","SVM",53,12,1484,1329,155,1300,1177,123,0.768431969026548,0.176991150442478,1.28387096774194,389,123,266,31,2.2,46.7,9.6,0,0,0,0,0,0,0.118242937601407,148.611282176846,16.2299662973279
9.7,"random_instances_SVM","SVM",53,13,1384,1235,149,1400,1271,129,0.813606194690264,0.221238938053097,1.28387096774194,405,129,276,16,2.1,50.29,9.9,0,0,0,0,0,0,0.158722992428276,145.149720765931,25.1679870595724
9.7,"random_instances_SVM","SVM",53,14,1284,1145,139,1500,1361,139,0.781415929203539,0.194690265486726,1.28387096774194,440,139,301,35,2.2,53.88,9.8,0,0,0,0,0,0,0.147045162056447,129.401231667519,21.0709805112894
9.7,"random_instances_SVM","SVM",53,15,1184,1054,130,1600,1452,148,0.798935287610618,0.194690265486726,1.28387096774194,466,148,318,26,2.1,57.47,9.8,0,0,0,0,0,0,0.145060662779028,120.845511151041,20.3973360525328
9.7,"random_instances_SVM","SVM",53,16,1084,961,123,1700,1545,155,0.725082964601769,0.141592920353982,1.28387096774194,500,155,345,34,2.2,61.06,10,0,0,0,0,0,0,0.146344381594728,106.77526834015,20.4197788768348
9.7,"random_instances_SVM","SVM",53,17,984,869,115,1800,1637,163,0.809215984513274,0.20353982300885,1.28387096774194,508,163,345,8,2.1,64.66,10,0,0,0,0,0,0,0.137193863342541,99.422216057167,18.4447485009984
9.7,"random_instances_SVM","SVM",53,18,884,778,106,1900,1728,172,0.757473727876105,0.106194690265487,1.28387096774194,538,172,366,30,2.1,68.25,10,0,0,0,0,0,0,0.162767694047416,92.9600190750136,25.1883588505145
9.7,"random_instances_SVM","SVM",53,19,784,687,97,2000,1819,181,0.769780143805309,0.132743362831858,1.28387096774194,550,181,369,12,2,71.84,10,0,0,0,0,0,0,0.159277278999774,84.909653580384,24.1907380492222
9.7,"random_instances_SVM","SVM",53,20,684,599,85,2100,1907,193,0.781671736725662,0.115044247787611,1.28387096774194,578,193,385,28,2,75.43,9.9,0,0,0,0,0,0,0.163074429108655,73.3206059773472,23.580400420497
9.7,"random_instances_SVM","SVM",53,21,584,508,76,2200,1998,202,0.839311393805309,0.185840707964602,1.28387096774194,580,202,378,2,1.9,79.02,9.9,0,0,0,0,0,0,0.150821498363784,58.8956035663404,19.1085418512434
9.7,"random_instances_SVM","SVM",53,22,484,419,65,2300,2087,213,0.829708241150441,0.185840707964602,1.28387096774194,610,213,397,30,1.9,82.61,9.8,0,0,0,0,0,0,0.158381230221075,51.7003681174085,20.3565962739761
9.7,"random_instances_SVM","SVM",53,23,384,334,50,2400,2172,228,0.782508296460176,0.176991150442478,1.28387096774194,666,228,438,56,1.9,86.21,9.5,0,0,0,0,0,0,0.14159759074627,41.2715561488939,17.2961120404922
9.7,"random_instances_SVM","SVM",53,24,284,248,36,2500,2258,242,0.815438329646017,0.238938053097345,1.28387096774194,681,242,439,15,1.8,89.8,9.3,0,0,0,0,0,0,0.140221760679849,31.7865570674466,18.0523011039478
9.7,"random_instances_SVM","SVM",53,25,184,158,26,2600,2348,252,0.821453263274335,0.185840707964602,1.28387096774194,713,252,461,32,1.8,93.39,9.3,0,0,0,0,0,0,0.117624347027035,20.0681778633823,14.6719547828696
9.7,"random_instances_SVM","SVM",53,26,84,72,12,2700,2434,266,0.815728705752211,0.238938053097345,1.28387096774194,748,266,482,35,1.8,96.98,9.2,0,0,0,0,0,0,0.00118942233176416,9.14887290953757,9.14887290953757
9.7,"random_instances_SVM","SVM",53,27,0,0,0,2784,2506,278,0.808759679203538,0.185840707964602,1.28387096774194,755,278,477,7,1.7,100,9,0,0,0,0,0,0,0,0,0
9.7,"random_instances_SVM","SVM",54,0,2684,2421,263,100,92,8,0.199620319455355,0.00833333333333333,0.588440860215054,26,8,18,0,2.2,3.59,11.5,0,0,0,0,0,0,0.0861441520016099,216.310347292137,8.68634787055599
9.7,"random_instances_SVM","SVM",54,1,2584,2335,249,200,178,22,0.809262896046088,0.241666666666667,1.28387096774194,55,22,33,29,1.5,7.18,8.1,0,0,0,0,0,0,0.164418366665297,287.071910880133,16.8161714498724
9.7,"random_instances_SVM","SVM",54,2,2484,2244,240,300,269,31,0.764552238805968,0.125,1.27317204301075,83,31,52,28,1.7,10.78,8.7,0,0,0,0,0,0,0.127958665214333,249.130195593829,14.0843724712453
9.7,"random_instances_SVM","SVM",54,3,2384,2150,234,400,363,37,0.77275464781356,0.141666666666667,1.26247311827957,104,37,67,21,1.8,14.37,9.8,0,0,0,0,0,0,0.2220883365074,266.689012198124,31.4260752991408
9.7,"random_instances_SVM","SVM",54,4,2284,2058,226,500,455,45,0.755217334380724,0.108333333333333,1.26247311827957,126,45,81,22,1.8,17.96,10.1,0,0,0,0,0,0,0.201039242187131,233.198084444567,27.8383069205244
9.7,"random_instances_SVM","SVM",54,5,2184,1970,214,600,543,57,0.763400104739455,0.275,1.26247311827957,161,57,104,35,1.8,21.55,9.5,0,0,0,0,0,0,0.187421339883079,232.09749547817,24.7299959056488
9.7,"random_instances_SVM","SVM",54,6,2084,1876,208,700,637,63,0.763858339879541,0.208333333333333,1.27317204301075,187,63,124,26,2,25.14,10.1,0,0,0,0,0,0,0.16005527167609,207.273749184243,21.2590856548446
9.7,"random_instances_SVM","SVM",54,7,1984,1783,201,800,730,70,0.813832155014391,0.233333333333333,1.27317204301075,225,70,155,38,2.2,28.74,10.4,0,0,0,0,0,0,0.151248279408334,196.804160789474,19.8671148424685
9.7,"random_instances_SVM","SVM",54,8,1884,1695,189,900,818,82,0.764506415291963,0.166666666666667,1.28387096774194,250,82,168,25,2,32.33,10,0,0,0,0,0,0,0.162538218144142,202.211500299901,22.5591412339786
9.7,"random_instances_SVM","SVM",54,9,1784,1603,181,1000,910,90,0.758713013877981,0.141666666666667,1.28387096774194,280,90,190,30,2.1,35.92,10.1,0,0,0,0,0,0,0.174853229620417,187.952771583359,25.0031797992197
9.7,"random_instances_SVM","SVM",54,10,1684,1512,172,1100,1001,99,0.812961508248234,0.208333333333333,1.28387096774194,302,99,203,22,2.1,39.51,10.1,0,0,0,0,0,0,0.172944895807616,165.998301878178,23.9576566461636
9.7,"random_instances_SVM","SVM",54,11,1584,1419,165,1200,1094,106,0.788805970149256,0.166666666666667,1.28387096774194,322,106,216,20,2,43.1,10.3,0,0,0,0,0,0,0.161495918821158,150.622080230006,20.7647911226399
9.7,"random_instances_SVM","SVM",54,12,1484,1329,155,1300,1184,116,0.795240900759363,0.166666666666667,1.28387096774194,359,116,243,37,2.1,46.7,10.2,0,0,0,0,0,0,0.155250283006377,141.652034093719,19.938307740377
9.7,"random_instances_SVM","SVM",54,13,1384,1244,140,1400,1269,131,0.820077245352184,0.2,1.28387096774194,384,131,253,25,1.9,50.29,9.7,0,0,0,0,0,0,0.138391667523942,140.917095694204,16.1300952358648
9.7,"random_instances_SVM","SVM",54,14,1284,1155,129,1500,1358,142,0.793499607227026,0.15,1.28387096774194,412,142,270,28,1.9,53.88,9.6,0,0,0,0,0,0,0.162777773949909,137.638980765366,21.0800255337627
9.7,"random_instances_SVM","SVM",54,15,1184,1066,118,1600,1447,153,0.77754647813564,0.175,1.28387096774194,441,153,288,29,1.9,57.47,9.5,0,0,0,0,0,0,0.125206015687634,120.506015798791,13.7365072908731
9.7,"random_instances_SVM","SVM",54,16,1084,976,108,1700,1537,163,0.829556166535744,0.25,1.28387096774194,481,163,318,40,2,61.06,9.4,0,0,0,0,0,0,0.137410808332937,108.40964724169,15.8069116824406
9.7,"random_instances_SVM","SVM",54,17,984,885,99,1800,1628,172,0.746242471851272,0.158333333333333,1.28387096774194,506,172,334,25,1.9,64.66,9.5,0,0,0,0,0,0,0.133665347661583,97.6854620322124,15.8438203252502
9.7,"random_instances_SVM","SVM",54,18,884,794,90,1900,1719,181,0.821177009688402,0.283333333333333,1.28387096774194,525,181,344,19,1.9,68.25,9.5,0,0,0,0,0,0,0.143552879235874,90.5709434959742,17.2059683575582
9.7,"random_instances_SVM","SVM",54,19,784,700,84,2000,1813,187,0.683490442524224,0.108333333333333,1.26247311827957,567,187,380,42,2,71.84,9.7,0,0,0,0,0,0,0.139882548367653,81.6029431627856,17.9199341332816
9.7,"random_instances_SVM","SVM",54,20,684,612,72,2100,1901,199,0.805721393034829,0.216666666666667,1.28387096774194,598,199,399,31,2,75.43,9.6,0,0,0,0,0,0,0.138566901885849,71.74489550404,16.92679093002
9.7,"random_instances_SVM","SVM",54,21,584,521,63,2200,1992,208,0.764139827179892,0.2,1.28387096774194,601,208,393,3,1.9,79.02,9.6,0,0,0,0,0,0,0.126722624649363,58.8298018481557,15.8073334943786
9.7,"random_instances_SVM","SVM",54,22,484,430,54,2300,2083,217,0.786429693637079,0.208333333333333,1.28387096774194,617,217,400,16,1.8,82.61,9.6,0,0,0,0,0,0,0.113110188700468,46.3258850054813,12.1286663507422
9.7,"random_instances_SVM","SVM",54,23,384,342,42,2400,2171,229,0.747414244566641,0.141666666666667,1.28387096774194,648,229,419,31,1.8,86.21,9.5,0,0,0,0,0,0,0.116025513803793,36.3221455980208,13.5346984868702
9.7,"random_instances_SVM","SVM",54,24,284,254,30,2500,2259,241,0.752206074888716,0.158333333333333,1.28387096774194,695,241,454,47,1.9,89.8,9.4,0,0,0,0,0,0,0.122275238867669,29.7652952839343,14.3707713843811
9.7,"random_instances_SVM","SVM",54,25,184,164,20,2600,2349,251,0.729647813563761,0.141666666666667,1.28387096774194,734,251,483,39,1.9,93.39,9.4,0,0,0,0,0,0,0.111572951250368,18.997615193678,13.5272946206819
9.7,"random_instances_SVM","SVM",54,26,84,77,7,2700,2436,264,0.750909924063892,0.15,1.28387096774194,760,264,496,26,1.9,96.98,9.2,0,0,0,0,0,0,0.0036243867234044,8.51007786276268,8.51007786276268
9.7,"random_instances_SVM","SVM",54,27,0,0,0,2784,2513,271,0.790907305577377,0.175,1.28387096774194,774,271,503,14,1.9,100,9.3,0,0,0,0,0,0,0,0,0
9.7,"random_instances_SVM","SVM",55,0,2684,2420,264,100,91,9,0.381994017946162,0.0254237288135593,0.826899945325314,33,9,24,0,2.7,3.59,10.1,0,0,0,0,0,0,0.0998685057353668,244.754137602156,10.0712576361394
9.7,"random_instances_SVM","SVM",55,1,2584,2334,250,200,177,23,0.757301429046197,0.245762711864407,1.24034991798797,60,23,37,27,1.6,7.18,7.7,0,0,0,0,0,0,0.174021621815746,298.13320703784,23.0072300301137
9.7,"random_instances_SVM","SVM",55,2,2484,2247,237,300,264,36,0.729451645064805,0.186440677966102,1.21858939311099,89,36,53,29,1.5,10.78,7.3,0,0,0,0,0,0,0.176901259042396,276.522966057812,38.7797295574464
9.7,"random_instances_SVM","SVM",55,3,2384,2154,230,400,357,43,0.743914921900965,0.211864406779661,1.22946965554948,105,43,62,16,1.4,14.37,8.3,0,0,0,0,0,0,0.225799365021142,252.159765811373,45.5872925136591
9.7,"random_instances_SVM","SVM",55,4,2284,2063,221,500,448,52,0.758325024925228,0.203389830508475,1.26211044286495,136,52,84,31,1.6,17.96,8.6,0,0,0,0,0,0,0.148495915295952,233.159249060322,21.8259657534254
9.7,"random_instances_SVM","SVM",55,5,2184,1974,210,600,537,63,0.755108009305418,0.245762711864407,1.26094827855292,157,63,94,21,1.5,21.55,8.5,0,0,0,0,0,0,0.269893519111643,225.26745509073,44.2897330059702
9.7,"random_instances_SVM","SVM",55,6,2084,1878,206,700,633,67,0.769086075108011,0.279661016949153,1.27299070530344,166,67,99,9,1.5,25.14,9.4,0,0,0,0,0,0,0.148991403250093,206.591053936785,20.5031785257336
9.7,"random_instances_SVM","SVM",55,7,1984,1785,199,800,726,74,0.793147224991695,0.245762711864407,1.27299070530344,194,74,120,28,1.6,28.74,9.8,0,0,0,0,0,0,0.161313275291254,195.218657200748,21.3566459634303
9.7,"random_instances_SVM","SVM",55,8,1884,1694,190,900,817,83,0.798557660352277,0.271186440677966,1.27299070530344,234,83,151,40,1.8,32.33,9.8,0,0,0,0,0,0,0.14320405189294,179.669822341626,18.765430185898
9.7,"random_instances_SVM","SVM",55,9,1784,1605,179,1000,906,94,0.792309737454306,0.279661016949153,1.27299070530344,254,94,160,20,1.7,35.92,9.6,0,0,0,0,0,0,0.150735551895054,165.073823048081,20.9044031254716
9.7,"random_instances_SVM","SVM",55,10,1684,1518,166,1100,993,107,0.788388168826852,0.305084745762712,1.27299070530344,272,107,165,18,1.5,39.51,9.3,0,0,0,0,0,0,0.167356801811803,165.15752776592,23.1430382676997
9.7,"random_instances_SVM","SVM",55,11,1584,1431,153,1200,1080,120,0.78656696576936,0.288135593220339,1.27299070530344,311,120,191,39,1.6,43.1,9,0,0,0,0,0,0,0.201014741650625,159.74330523083,31.1607959372325
9.7,"random_instances_SVM","SVM",55,12,1484,1345,139,1300,1166,134,0.790661349285478,0.305084745762712,1.26211044286495,342,134,208,31,1.6,46.7,8.7,0,0,0,0,0,0,0.142525627739094,156.989444242932,18.5525740893438
9.7,"random_instances_SVM","SVM",55,13,1384,1253,131,1400,1258,142,0.784380192755074,0.23728813559322,1.25123018042646,383,142,241,41,1.7,50.29,8.9,0,0,0,0,0,0,0.162561220703571,151.483591747521,24.0966207196962
9.7,"random_instances_SVM","SVM",55,14,1284,1164,120,1500,1347,153,0.774057826520447,0.169491525423729,1.21858939311099,408,153,255,25,1.7,53.88,8.8,0,0,0,0,0,0,0.143089138228783,134.507262434589,21.8744869828711
9.7,"random_instances_SVM","SVM",55,15,1184,1071,113,1600,1440,160,0.783848454636099,0.144067796610169,1.21858939311099,435,160,275,27,1.7,57.47,9,0,0,0,0,0,0,0.148352774923701,124.594391165616,23.3631339270966
9.7,"random_instances_SVM","SVM",55,16,1084,982,102,1700,1529,171,0.781595214356937,0.169491525423729,1.22946965554948,455,171,284,20,1.7,61.06,8.9,0,0,0,0,0,0,0.152633418075905,112.471684879836,24.9164126421559
9.7,"random_instances_SVM","SVM",55,17,984,892,92,1800,1619,181,0.770674642738458,0.101694915254237,1.24034991798797,480,181,299,25,1.7,64.66,8.9,0,0,0,0,0,0,0.146256210415801,104.826925319778,23.1262307956346
9.7,"random_instances_SVM","SVM",55,18,884,797,87,1900,1714,186,0.794642738451321,0.169491525423729,1.22946965554948,501,186,315,21,1.7,68.25,9.2,0,0,0,0,0,0,0.149034552023981,93.4405206175012,24.7767882680199
9.7,"random_instances_SVM","SVM",55,19,784,709,75,2000,1802,198,0.788664007976079,0.186440677966102,1.23920779099167,520,198,322,19,1.6,71.84,9.1,0,0,0,0,0,0,0.151450635650772,85.3963379899033,25.1368107707908
9.7,"random_instances_SVM","SVM",55,20,684,622,62,2100,1889,211,0.766739780658031,0.194915254237288,1.25123018042646,569,211,358,49,1.7,75.43,9,0,0,0,0,0,0,0.156475468630638,76.9462041889271,21.7883522741815
9.7,"random_instances_SVM","SVM",55,21,584,530,54,2200,1981,219,0.795340644732474,0.203389830508475,1.27299070530344,588,219,369,19,1.7,79.02,9,0,0,0,0,0,0,0.121404980933958,60.0690323414391,13.4467310072206
9.7,"random_instances_SVM","SVM",55,22,484,439,45,2300,2072,228,0.785995347291462,0.203389830508475,1.27299070530344,604,228,376,16,1.6,82.61,9.1,0,0,0,0,0,0,0.15242878172191,51.4307625640909,20.5901959784264
9.7,"random_instances_SVM","SVM",55,23,384,351,33,2400,2160,240,0.796623462944503,0.203389830508475,1.27299070530344,641,240,401,37,1.7,86.21,9,0,0,0,0,0,0,0.125761710409545,40.0699757905778,14.6665959206549
9.7,"random_instances_SVM","SVM",55,24,284,261,23,2500,2250,250,0.784426719840481,0.194915254237288,1.27299070530344,652,250,402,11,1.6,89.8,9,0,0,0,0,0,0,0.134349447034221,29.4347440270573,17.5526646128832
9.7,"random_instances_SVM","SVM",55,25,184,171,13,2600,2340,260,0.782313060817548,0.203389830508475,1.27299070530344,691,260,431,39,1.7,93.39,9,0,0,0,0,0,0,0.0943216562093814,18.7470153875619,15.0262322295785
9.7,"random_instances_SVM","SVM",55,26,84,78,6,2700,2433,267,0.796969092721838,0.245762711864407,1.27299070530344,708,267,441,17,1.7,96.98,9.1,0,0,0,0,0,0,5.39913859516747e-06,8.00211346736346,8.00211346736346
9.7,"random_instances_SVM","SVM",55,27,0,0,0,2784,2511,273,0.709690927218348,0.0932203389830508,1.27299070530344,718,273,445,10,1.6,100,9.2,0,0,0,0,0,0,0,0,0
9.7,"random_instances_SVM","SVM",56,0,2684,2428,256,100,88,12,0.704525958645411,0.276422764227642,1.15861526357199,37,12,25,0,2.1,3.59,7.3,0,0,0,0,0,0,0.197792706980171,294.137606099077,23.3239294884207
9.7,"random_instances_SVM","SVM",56,1,2584,2342,242,200,174,26,0.771448690864869,0.308943089430894,1.18992918961448,68,26,42,31,1.6,7.18,6.7,0,0,0,0,0,0,0.158964974021797,316.585263359139,16.9252733817951
9.7,"random_instances_SVM","SVM",56,2,2484,2251,233,300,265,35,0.79903335253825,0.365853658536585,1.21080514030947,89,35,54,21,1.5,10.78,7.6,0,0,0,0,0,0,0.190644183749119,250.411587509869,21.9130779512652
9.7,"random_instances_SVM","SVM",56,3,2384,2162,222,400,354,46,0.830030087702462,0.390243902439024,1.25255704169945,128,46,82,39,1.8,14.37,7.7,0,0,0,0,0,0,0.197905893175516,272.396295626886,21.6627245424392
9.7,"random_instances_SVM","SVM",56,4,2284,2071,213,500,445,55,0.828762563216186,0.317073170731707,1.26299501704694,150,55,95,22,1.7,17.96,8.1,0,0,0,0,0,0,0.173072564533388,255.414899164271,20.0292542297026
9.7,"random_instances_SVM","SVM",56,5,2184,1979,205,600,537,63,0.821938416234562,0.284552845528455,1.26299501704694,172,63,109,22,1.7,21.55,8.5,0,0,0,0,0,0,0.209925297212849,235.337159408175,25.5401125214556
9.7,"random_instances_SVM","SVM",56,6,2084,1889,195,700,627,73,0.836290890467959,0.276422764227642,1.28387096774194,205,73,132,33,1.8,25.14,8.6,0,0,0,0,0,0,0.183180319023231,220.028789212804,21.8716387957163
9.7,"random_instances_SVM","SVM",56,7,1984,1799,185,800,717,83,0.840023045899752,0.276422764227642,1.28387096774194,225,83,142,20,1.7,28.74,8.6,0,0,0,0,0,0,0.205107943096336,212.1280506505,27.8138031017923
9.7,"random_instances_SVM","SVM",56,8,1884,1712,172,900,804,96,0.84585493886435,0.300813008130081,1.28387096774194,265,96,169,40,1.8,32.33,8.4,0,0,0,0,0,0,0.23467619542214,209.761509062415,33.2241809397291
9.7,"random_instances_SVM","SVM",56,9,1784,1621,163,1000,895,105,0.820382818001409,0.219512195121951,1.28387096774194,294,105,189,29,1.8,35.92,8.5,0,0,0,0,0,0,0.175409684700983,192.634929146305,21.9564909606454
9.7,"random_instances_SVM","SVM",56,10,1684,1533,151,1100,983,117,0.824435055374176,0.235772357723577,1.28387096774194,325,117,208,31,1.8,39.51,8.4,0,0,0,0,0,0,0.193610907466387,184.655738821563,24.9337400432291
9.7,"random_instances_SVM","SVM",56,11,1584,1440,144,1200,1076,124,0.837603226425966,0.284552845528455,1.28387096774194,353,124,229,28,1.8,43.1,8.7,0,0,0,0,0,0,0.194271081182081,170.102259109723,24.7503105205417
9.7,"random_instances_SVM","SVM",56,12,1484,1345,139,1300,1171,129,0.831092759746494,0.24390243902439,1.28387096774194,368,129,239,15,1.9,46.7,9.1,0,0,0,0,0,0,0.170932578720945,151.139662786368,21.370659396729
9.7,"random_instances_SVM","SVM",56,13,1384,1256,128,1400,1260,140,0.809250368094229,0.170731707317073,1.28387096774194,403,140,263,35,1.9,50.29,9,0,0,0,0,0,0,0.179727856434448,142.600906566486,25.3932219078233
9.7,"random_instances_SVM","SVM",56,14,1284,1168,116,1500,1348,152,0.804890852058125,0.170731707317073,1.28387096774194,431,152,279,28,1.8,53.88,8.9,0,0,0,0,0,0,0.160734942726508,136.195487441256,21.1756475907976
9.7,"random_instances_SVM","SVM",56,15,1184,1082,102,1600,1434,166,0.829927661481337,0.24390243902439,1.28387096774194,464,166,298,33,1.8,57.47,8.6,0,0,0,0,0,0,0.19377887082297,127.995486621407,25.764303074637
9.7,"random_instances_SVM","SVM",56,16,1084,988,96,1700,1528,172,0.800281672108071,0.170731707317073,1.27343299239444,463,172,291,-1,1.7,61.06,8.9,0,0,0,0,0,0,0.167219155447333,109.14046371985,20.324573769575
9.7,"random_instances_SVM","SVM",56,17,984,903,81,1800,1613,187,0.769521797580177,0.121951219512195,1.28387096774194,504,187,317,41,1.7,64.66,8.6,0,0,0,0,0,0,0.163003578557441,104.386659634492,19.194741175009
9.7,"random_instances_SVM","SVM",56,18,884,812,72,1900,1704,196,0.809666474617506,0.235772357723577,1.27343299239444,523,196,327,19,1.7,68.25,8.7,0,0,0,0,0,0,0.166180923324596,91.1145067844875,20.1601851338478
9.7,"random_instances_SVM","SVM",56,19,784,720,64,2000,1796,204,0.785724345432435,0.178861788617886,1.27343299239444,569,204,365,46,1.8,71.84,8.8,0,0,0,0,0,0,0.164709613446294,82.9789060476078,20.0366990103798
9.7,"random_instances_SVM","SVM",56,20,684,625,59,2100,1891,209,0.776416362588822,0.146341463414634,1.27343299239444,570,209,361,1,1.7,75.43,9,0,0,0,0,0,0,0.156399430110834,70.1929439689116,19.2447927340224
9.7,"random_instances_SVM","SVM",56,21,584,533,51,2200,1983,217,0.807624351834067,0.195121951219512,1.28387096774194,607,217,390,37,1.8,79.02,9.1,0,0,0,0,0,0,0.147352713035835,56.9895627029471,18.041595473206
9.7,"random_instances_SVM","SVM",56,22,484,438,46,2300,2078,222,0.767722937071887,0.146341463414634,1.28387096774194,627,222,405,20,1.8,82.61,9.4,0,0,0,0,0,0,0.124618169063408,47.0108132114777,14.3907901568608
9.7,"random_instances_SVM","SVM",56,23,384,347,37,2400,2169,231,0.758895077139748,0.186991869918699,1.27343299239444,643,231,412,16,1.8,86.21,9.4,0,0,0,0,0,0,0.133082826086938,37.7347141181989,16.5751761168701
9.7,"random_instances_SVM","SVM",56,24,284,255,29,2500,2261,239,0.738621086998268,0.138211382113821,1.28387096774194,650,239,411,7,1.7,89.8,9.5,0,0,0,0,0,0,0.119880208548681,27.7469172584797,15.8315402466882
9.7,"random_instances_SVM","SVM",56,25,184,164,20,2600,2352,248,0.810671531912166,0.16260162601626,1.28387096774194,698,248,450,48,1.8,93.39,9.5,0,0,0,0,0,0,0.0872953018029137,17.0568573310199,13.0273754197115
9.7,"random_instances_SVM","SVM",56,26,84,76,8,2700,2440,260,0.762800076819665,0.146341463414634,1.28387096774194,728,260,468,30,1.8,96.98,9.4,0,0,0,0,0,0,3.40105206645634e-09,8.22230038086481,8.22230038086481
9.7,"random_instances_SVM","SVM",56,27,0,0,0,2784,2516,268,0.809845720504444,0.203252032520325,1.28387096774194,761,268,493,33,1.8,100,9.4,0,0,0,0,0,0,0,0,0
9.7,"random_instances_SVM","SVM",57,0,2684,2427,257,100,87,13,0.832501689276997,0.347107438016529,1.25203945614503,29,13,16,0,1.2,3.59,6.7,0,0,0,0,0,0,0.390895398796882,375.440420310307,42.1692469753851
9.7,"random_instances_SVM","SVM",57,1,2584,2341,243,200,173,27,0.851554784552218,0.322314049586777,1.28268876611418,64,27,37,35,1.4,7.18,6.4,0,0,0,0,0,0,0.423514993748085,337.134423917907,47.6446138414537
9.7,"random_instances_SVM","SVM",57,2,2484,2252,232,300,262,38,0.802419564426423,0.198347107438017,1.2732604638763,93,38,55,29,1.4,10.78,6.9,0,0,0,0,0,0,0.257414637192715,289.811410455513,32.0974180836413
9.7,"random_instances_SVM","SVM",57,3,2384,2169,215,400,345,55,0.835185040802532,0.272727272727273,1.2732604638763,127,55,72,34,1.3,14.37,6.3,0,0,0,0,0,0,0.275966379793848,296.977367630015,32.9463927388226
9.7,"random_instances_SVM","SVM",57,4,2284,2072,212,500,442,58,0.843384531420554,0.289256198347107,1.2732604638763,141,58,83,14,1.4,17.96,7.6,0,0,0,0,0,0,0.281501173792604,266.539505177613,35.908644403238
9.7,"random_instances_SVM","SVM",57,5,2184,1978,206,600,536,64,0.823100213108797,0.247933884297521,1.26264996001066,154,64,90,13,1.4,21.55,8.4,0,0,0,0,0,0,0.220496610036017,239.276384991764,27.090912747333
9.7,"random_instances_SVM","SVM",57,6,2084,1886,198,700,628,72,0.824224232028695,0.247933884297521,1.2732604638763,190,72,118,36,1.6,25.14,8.7,0,0,0,0,0,0,0.217940895574004,210.283415057314,27.869776295513
9.7,"random_instances_SVM","SVM",57,7,1984,1793,191,800,721,79,0.822041166380788,0.223140495867769,1.2732604638763,209,79,130,19,1.6,28.74,9.1,0,0,0,0,0,0,0.209613525013944,194.919716444982,30.0463326285837
9.7,"random_instances_SVM","SVM",57,8,1884,1702,182,900,812,88,0.826680180882578,0.289256198347107,1.2732604638763,238,88,150,29,1.7,32.33,9.2,0,0,0,0,0,0,0.164399841728781,191.417407034299,19.102542241849
9.7,"random_instances_SVM","SVM",57,9,1784,1614,170,1000,900,100,0.836036176516451,0.289256198347107,1.2732604638763,263,100,163,25,1.6,35.92,9,0,0,0,0,0,0,0.188662636690136,183.656531736601,22.3148518772897
9.7,"random_instances_SVM","SVM",57,10,1684,1528,156,1100,986,114,0.835126565829824,0.289256198347107,1.2732604638763,292,114,178,29,1.6,39.51,8.6,0,0,0,0,0,0,0.213827733523943,173.091476334935,29.0184061221599
9.7,"random_instances_SVM","SVM",57,11,1584,1432,152,1200,1082,118,0.831221737096521,0.289256198347107,1.2732604638763,308,118,190,16,1.6,43.1,9.2,0,0,0,0,0,0,0.157545199972241,161.339568503214,18.8912080943011
9.7,"random_instances_SVM","SVM",57,12,1484,1340,144,1300,1174,126,0.793778262903477,0.256198347107438,1.26264996001066,342,126,216,34,1.7,46.7,9.3,0,0,0,0,0,0,0.171423672432177,158.754802106087,28.4804187905548
9.7,"random_instances_SVM","SVM",57,13,1384,1251,133,1400,1263,137,0.791972035968603,0.231404958677686,1.2732604638763,375,137,238,33,1.7,50.29,9.2,0,0,0,0,0,0,0.145169214927694,140.062228648887,22.4186948726725
9.7,"random_instances_SVM","SVM",57,14,1284,1160,124,1500,1354,146,0.814413431051511,0.28099173553719,1.2732604638763,385,146,239,10,1.6,53.88,9.3,0,0,0,0,0,0,0.156200723424735,124.28555201394,20.4567331724657
9.7,"random_instances_SVM","SVM",57,15,1184,1069,115,1600,1445,155,0.815790841519828,0.264462809917355,1.2732604638763,411,155,256,26,1.7,57.47,9.3,0,0,0,0,0,0,0.155431573445876,109.155729530301,19.2307915332404
9.7,"random_instances_SVM","SVM",57,16,1084,973,111,1700,1541,159,0.816421071781278,0.247933884297521,1.2732604638763,446,159,287,35,1.8,61.06,9.7,0,0,0,0,0,0,0.159153996136102,105.139403309443,20.9360538305663
9.7,"random_instances_SVM","SVM",57,17,984,884,100,1800,1630,170,0.794837309631475,0.223140495867769,1.2732604638763,466,170,296,20,1.7,64.66,9.6,0,0,0,0,0,0,0.157054659023995,96.9496702922336,20.9742684129147
9.7,"random_instances_SVM","SVM",57,18,884,795,89,1900,1719,181,0.832547169811319,0.297520661157025,1.2732604638763,500,181,319,34,1.8,68.25,9.5,0,0,0,0,0,0,0.175327957591256,83.3649435116996,22.8810492463635
9.7,"random_instances_SVM","SVM",57,19,784,708,76,2000,1806,194,0.796689017100684,0.206611570247934,1.2732604638763,514,194,320,14,1.6,71.84,9.3,0,0,0,0,0,0,0.156583266345166,77.3283370489429,20.1750995696149
9.7,"random_instances_SVM","SVM",57,20,684,619,65,2100,1895,205,0.839960496907326,0.239669421487603,1.2732604638763,565,205,360,51,1.8,75.43,9.2,0,0,0,0,0,0,0.165172689177639,61.4549546008926,21.9720881466888
9.7,"random_instances_SVM","SVM",57,21,584,530,54,2200,1984,216,0.81679791049431,0.223140495867769,1.2732604638763,587,216,371,22,1.7,79.02,9.2,0,0,0,0,0,0,0.149284972519004,57.7491722263884,17.5223739536193
9.7,"random_instances_SVM","SVM",57,22,484,434,50,2300,2080,220,0.845151775040283,0.305785123966942,1.2732604638763,613,220,393,26,1.8,82.61,9.5,0,0,0,0,0,0,0.156229705243646,47.953512462572,20.0687436756741
9.7,"random_instances_SVM","SVM",57,23,384,347,37,2400,2167,233,0.786462394095332,0.15702479338843,1.28387096774194,624,233,391,11,1.7,86.21,9.3,0,0,0,0,0,0,0.13842844571274,39.4128217670998,17.2230727976092
9.7,"random_instances_SVM","SVM",57,24,284,257,27,2500,2257,243,0.852136285669734,0.305785123966942,1.2732604638763,664,243,421,40,1.7,89.8,9.3,0,0,0,0,0,0,0.135386808950802,28.7441480757606,18.120098144249
9.7,"random_instances_SVM","SVM",57,25,184,168,16,2600,2346,254,0.811937990540053,0.231404958677686,1.2732604638763,678,254,424,14,1.7,93.39,9.2,0,0,0,0,0,0,0.108384320538078,19.4140865931464,15.1395529610897
9.7,"random_instances_SVM","SVM",57,26,84,78,6,2700,2436,264,0.826264358854413,0.239669421487603,1.28387096774194,709,264,445,31,1.7,96.98,9.2,0,0,0,0,0,0,3.22632280582765e-05,8.21957980429743,8.21957980429743
9.7,"random_instances_SVM","SVM",57,27,0,0,0,2784,2514,270,0.836172618119446,0.247933884297521,1.27208803250993,725,270,455,16,1.7,100,9.3,0,0,0,0,0,0,0,0,0
9.7,"random_instances_SVM","SVM",58,0,2684,2431,253,100,93,7,0.821530104886216,0.297709923664122,1.24466880078798,19,7,12,0,1.7,3.59,13.3,0,0,0,0,0,0,0.163107538100949,208.449810174953,17.9130090682015
9.7,"random_instances_SVM","SVM",58,1,2584,2345,239,200,179,21,0.81312831927994,0.33587786259542,1.2348682590495,45,21,24,26,1.1,7.18,8.5,0,0,0,0,0,0,0.263217647391662,231.224146822591,28.0204579559982
9.7,"random_instances_SVM","SVM",58,2,2484,2254,230,300,270,30,0.827343003351034,0.32824427480916,1.27407042600345,73,30,43,28,1.4,10.78,9,0,0,0,0,0,0,0.224061178235715,235.741117398865,26.2018389555324
9.7,"random_instances_SVM","SVM",58,3,2384,2161,223,400,363,37,0.833839416411606,0.312977099236641,1.27407042600345,93,37,56,20,1.5,14.37,9.8,0,0,0,0,0,0,0.143357945185581,242.613468279079,15.4043283023056
9.7,"random_instances_SVM","SVM",58,4,2284,2070,214,500,454,46,0.832006629486695,0.366412213740458,1.26426988426496,111,46,65,18,1.4,17.96,9.9,0,0,0,0,0,0,0.253331704604626,211.618695394749,32.6019442515566
9.7,"random_instances_SVM","SVM",58,5,2184,1978,206,600,546,54,0.784614267913522,0.366412213740458,1.25446934252647,148,54,94,37,1.7,21.55,10.1,0,0,0,0,0,0,0.147781947266303,201.246213771161,19.8043412494151
9.7,"random_instances_SVM","SVM",58,6,2084,1886,198,700,638,62,0.779164297552648,0.312977099236641,1.2348682590495,178,62,116,30,1.9,25.14,10.3,0,0,0,0,0,0,0.182561425262565,206.473572417733,24.386791284517
9.7,"random_instances_SVM","SVM",58,7,1984,1794,190,800,730,70,0.776260872721112,0.343511450381679,1.24466880078798,209,70,139,31,2,28.74,10.4,0,0,0,0,0,0,0.159281870711429,195.870715931072,19.6214243763193
9.7,"random_instances_SVM","SVM",58,8,1884,1703,181,900,821,79,0.78696725178742,0.267175572519084,1.28387096774194,232,79,153,23,1.9,32.33,10.4,0,0,0,0,0,0,0.164753075391805,180.965354044678,21.2257482736549
9.7,"random_instances_SVM","SVM",58,9,1784,1615,169,1000,909,91,0.775764870979058,0.305343511450382,1.26426988426496,250,91,159,18,1.7,35.92,10,0,0,0,0,0,0,0.166249610312673,180.435852076885,23.392638932315
9.7,"random_instances_SVM","SVM",58,10,1684,1523,161,1100,1001,99,0.800244371589979,0.274809160305344,1.22506771731101,278,99,179,28,1.8,39.51,10.1,0,0,0,0,0,0,0.177048498016134,164.765763954712,24.9224331503482
9.7,"random_instances_SVM","SVM",58,11,1584,1432,152,1200,1092,108,0.804163995112565,0.282442748091603,1.24466880078798,313,108,205,35,1.9,43.1,10.1,0,0,0,0,0,0,0.136919558348404,154.559190724511,18.0965716801651
9.7,"random_instances_SVM","SVM",58,12,1484,1342,142,1300,1182,118,0.774464378606596,0.236641221374046,1.26426988426496,362,118,244,49,2.1,46.7,10,0,0,0,0,0,0,0.147467412901459,150.311268591673,18.036396365822
9.7,"random_instances_SVM","SVM",58,13,1384,1253,131,1400,1271,129,0.814942959799664,0.320610687022901,1.28387096774194,379,129,250,17,1.9,50.29,9.9,0,0,0,0,0,0,0.161157806916321,137.75194822304,21.0616541044225
9.7,"random_instances_SVM","SVM",58,14,1284,1161,123,1500,1363,137,0.755198945088977,0.229007633587786,1.28387096774194,392,137,255,13,1.9,53.88,9.9,0,0,0,0,0,0,0.15863702425339,133.80932712552,19.6223511432439
9.7,"random_instances_SVM","SVM",58,15,1184,1071,113,1600,1453,147,0.80728517680647,0.282442748091603,1.28387096774194,426,147,279,34,1.9,57.47,9.9,0,0,0,0,0,0,0.173233122024197,120.240642813256,22.0830195694876
9.7,"random_instances_SVM","SVM",58,16,1084,981,103,1700,1543,157,0.767139279708687,0.267175572519084,1.28387096774194,453,157,296,27,1.9,61.06,9.8,0,0,0,0,0,0,0.175585565229721,114.288239968747,24.347655180917
9.7,"random_instances_SVM","SVM",58,17,984,894,90,1800,1630,170,0.799657637821947,0.290076335877863,1.28387096774194,467,170,297,14,1.7,64.66,9.6,0,0,0,0,0,0,0.145265323922309,96.4646582224186,18.9518450739888
9.7,"random_instances_SVM","SVM",58,18,884,803,81,1900,1721,179,0.795459769419679,0.282442748091603,1.28387096774194,523,179,344,56,1.9,68.25,9.6,0,0,0,0,0,0,0.171490517116811,89.9850392675435,22.9384163620846
9.7,"random_instances_SVM","SVM",58,19,784,710,74,2000,1814,186,0.756668803909945,0.175572519083969,1.25446934252647,531,186,345,8,1.9,71.84,9.8,0,0,0,0,0,0,0.156384487978847,82.5001299050591,19.4555032301363
9.7,"random_instances_SVM","SVM",58,20,684,619,65,2100,1905,195,0.778535222172487,0.16030534351145,1.27407042600345,563,195,368,32,1.9,75.43,9.8,0,0,0,0,0,0,0.16051549969698,66.4601587870895,19.6901431082724
9.7,"random_instances_SVM","SVM",58,21,584,530,54,2200,1994,206,0.775244674030073,0.206106870229008,1.27407042600345,589,206,383,26,1.9,79.02,9.7,0,0,0,0,0,0,0.14977773825358,59.9442296745523,17.9034610753598
9.7,"random_instances_SVM","SVM",58,22,484,441,43,2300,2083,217,0.803196186835385,0.236641221374046,1.28387096774194,619,217,402,30,1.9,82.61,9.6,0,0,0,0,0,0,0.153620323898747,50.3199586147482,17.9163984554597
9.7,"random_instances_SVM","SVM",58,23,384,350,34,2400,2174,226,0.804877753716989,0.213740458015267,1.28387096774194,654,226,428,35,1.9,86.21,9.6,0,0,0,0,0,0,0.153194359788614,38.7746221019559,19.402645375883
9.7,"random_instances_SVM","SVM",58,24,284,255,29,2500,2269,231,0.785273587302354,0.259541984732824,1.26426988426496,661,231,430,7,1.9,89.8,9.8,0,0,0,0,0,0,0.12889616351185,27.2262597780719,16.9691419269457
9.7,"random_instances_SVM","SVM",58,25,184,165,19,2600,2359,241,0.837238842985203,0.312977099236641,1.28387096774194,693,241,452,32,1.9,93.39,9.8,0,0,0,0,0,0,0.0904788103714346,17.7997422720581,14.9587635719721
9.7,"random_instances_SVM","SVM",58,26,84,75,9,2700,2449,251,0.797092945887416,0.221374045801527,1.28268876611418,716,251,465,23,1.9,96.98,9.8,0,0,0,0,0,0,2.26055944625191e-05,8.20640325097595,8.20640325097595
9.7,"random_instances_SVM","SVM",58,27,0,0,0,2784,2524,260,0.780712790796141,0.206106870229008,1.2728972488156,738,260,478,22,1.8,100,9.7,0,0,0,0,0,0,0,0,0
9.7,"random_instances_SVM","SVM",59,0,2684,2426,258,100,92,8,0.297779179810724,0,0.708696774193548,38,8,30,0,3.8,3.59,11.5,0,0,0,0,0,0,0.125352943111851,225.886476013563,13.3841682326891
9.7,"random_instances_SVM","SVM",59,1,2584,2340,244,200,178,22,0.723842271293376,0.184,1.26332903225806,83,22,61,45,2.8,7.18,8.1,0,0,0,0,0,0,0.127696985546631,285.650198668352,13.5172629310009
9.7,"random_instances_SVM","SVM",59,2,2484,2253,231,300,265,35,0.721173501577286,0.264,1.25305806451613,103,35,68,20,1.9,10.78,7.6,0,0,0,0,0,0,0.187497338961631,290.481800325629,24.3607516080069
9.7,"random_instances_SVM","SVM",59,3,2384,2157,227,400,361,39,0.75408201892745,0.288,1.26332903225806,117,39,78,14,2,14.37,9.3,0,0,0,0,0,0,0.147528852732823,247.426689921339,16.9457979089014
9.7,"random_instances_SVM","SVM",59,4,2284,2066,218,500,452,48,0.767413249211361,0.2,1.2736,146,48,98,29,2,17.96,9.4,0,0,0,0,0,0,0.12386259428841,245.458631093226,13.3561224558612
9.7,"random_instances_SVM","SVM",59,5,2184,1979,205,600,539,61,0.760649842271297,0.304,1.22224516129032,166,61,105,20,1.7,21.55,8.8,0,0,0,0,0,0,0.204491109826107,242.95742507265,27.8478294473469
9.7,"random_instances_SVM","SVM",59,6,2084,1890,194,700,628,72,0.785564668769718,0.24,1.26332903225806,193,72,121,27,1.7,25.14,8.7,0,0,0,0,0,0,0.175998169792367,232.569023111841,24.7638804365137
9.7,"random_instances_SVM","SVM",59,7,1984,1801,183,800,717,83,0.76413249211357,0.256,1.24278709677419,212,83,129,19,1.6,28.74,8.6,0,0,0,0,0,0,0.173281938860027,219.278554536191,23.3942683547074
9.7,"random_instances_SVM","SVM",59,8,1884,1709,175,900,809,91,0.784208201892746,0.288,1.24278709677419,231,91,140,19,1.5,32.33,8.9,0,0,0,0,0,0,0.156200682129449,197.032808272506,19.4574569985832
9.7,"random_instances_SVM","SVM",59,9,1784,1620,164,1000,898,102,0.788605678233448,0.264,1.25305806451613,273,102,171,42,1.7,35.92,8.8,0,0,0,0,0,0,0.154769129779119,191.59687507807,19.1731040991793
9.7,"random_instances_SVM","SVM",59,10,1684,1529,155,1100,989,111,0.801627760252375,0.28,1.2736,285,111,174,12,1.6,39.51,8.9,0,0,0,0,0,0,0.168727347149635,175.152672381745,22.7730657525842
9.7,"random_instances_SVM","SVM",59,11,1584,1441,143,1200,1077,123,0.803987381703484,0.304,1.2736,315,123,192,30,1.6,43.1,8.8,0,0,0,0,0,0,0.159162202152926,168.072409764352,20.6364953395682
9.7,"random_instances_SVM","SVM",59,12,1484,1353,131,1300,1165,135,0.82485173501578,0.304,1.2736,359,135,224,44,1.7,46.7,8.6,0,0,0,0,0,0,0.185020212266635,166.145615816175,25.9583322834253
9.7,"random_instances_SVM","SVM",59,13,1384,1264,120,1400,1254,146,0.797369085173512,0.248,1.2736,392,146,246,33,1.7,50.29,8.6,0,0,0,0,0,0,0.174367537201167,148.275322533033,25.3119013038458
9.7,"random_instances_SVM","SVM",59,14,1284,1174,110,1500,1344,156,0.819394321766574,0.248,1.2736,406,156,250,14,1.6,53.88,8.6,0,0,0,0,0,0,0.180098631834018,140.013832601453,25.3564490819905
9.7,"random_instances_SVM","SVM",59,15,1184,1087,97,1600,1431,169,0.81917981072556,0.264,1.2736,436,169,267,30,1.6,57.47,8.5,0,0,0,0,0,0,0.175060546177176,129.621435576966,24.217976129641
9.7,"random_instances_SVM","SVM",59,16,1084,995,89,1700,1523,177,0.827394321766567,0.28,1.28387096774194,459,177,282,23,1.6,61.06,8.6,0,0,0,0,0,0,0.177358214340413,114.755875737962,24.2451943398757
9.7,"random_instances_SVM","SVM",59,17,984,904,80,1800,1614,186,0.821545741324925,0.24,1.28387096774194,487,186,301,28,1.6,64.66,8.7,0,0,0,0,0,0,0.177808141843727,108.3425097986,23.5499296643014
9.7,"random_instances_SVM","SVM",59,18,884,815,69,1900,1703,197,0.808050473186127,0.216,1.2736,515,197,318,28,1.6,68.25,8.6,0,0,0,0,0,0,0.183382088380559,94.1295900140116,27.2083800577409
9.7,"random_instances_SVM","SVM",59,19,784,723,61,2000,1795,205,0.840094637223985,0.264,1.2736,545,205,340,30,1.7,71.84,8.8,0,0,0,0,0,0,0.182946485068586,83.3229161948589,23.7689254507461
9.7,"random_instances_SVM","SVM",59,20,684,634,50,2100,1884,216,0.802933753943225,0.24,1.2736,575,216,359,30,1.7,75.43,8.7,0,0,0,0,0,0,0.167073361749781,70.4587264368909,23.4191172289236
9.7,"random_instances_SVM","SVM",59,21,584,539,45,2200,1979,221,0.8337665615142,0.224,1.2736,585,221,364,10,1.6,79.02,9,0,0,0,0,0,0,0.1700208306561,60.8645816842937,22.0323102187266
9.7,"random_instances_SVM","SVM",59,22,484,444,40,2300,2074,226,0.834712933753949,0.256,1.2736,603,226,377,18,1.7,82.61,9.2,0,0,0,0,0,0,0.16446101959059,49.4379058837362,21.0411731327362
9.7,"random_instances_SVM","SVM",59,23,384,351,33,2400,2167,233,0.788264984227132,0.208,1.2736,638,233,405,35,1.7,86.21,9.3,0,0,0,0,0,0,0.132639302099008,38.4433572421986,15.4129499508807
9.7,"random_instances_SVM","SVM",59,24,284,262,22,2500,2256,244,0.795198738170351,0.224,1.2736,652,244,408,14,1.7,89.8,9.2,0,0,0,0,0,0,0.133591213253085,29.1108500734919,17.3854182550195
9.7,"random_instances_SVM","SVM",59,25,184,173,11,2600,2345,255,0.823558359621459,0.28,1.2736,697,255,442,45,1.7,93.39,9.2,0,0,0,0,0,0,0.0846377016337909,18.6386543554999,15.7010602784708
9.7,"random_instances_SVM","SVM",59,26,84,78,6,2700,2440,260,0.844397476340704,0.256,1.2736,701,260,441,4,1.7,96.98,9.4,0,0,0,0,0,0,1.23303919043288e-05,7.57278970812411,7.57278970812411
9.7,"random_instances_SVM","SVM",59,27,0,0,0,2784,2518,266,0.818138801261838,0.232,1.2736,732,266,466,31,1.8,100,9.5,0,0,0,0,0,0,0,0,0
9.7,"random_instances_SVM","SVM",60,0,2684,2437,247,100,91,9,0.818141671082847,0.288888888888889,1.28387096774194,29,9,20,0,2.2,3.59,10.1,0,0,0,0,0,0,0.152747984904713,254.340124493772,16.9268705776358
9.7,"random_instances_SVM","SVM",60,1,2584,2351,233,200,177,23,0.832244008714598,0.296296296296296,1.28387096774194,56,23,33,27,1.4,7.18,7.7,0,0,0,0,0,0,0.272280828037274,290.663140339763,30.9982608109245
9.7,"random_instances_SVM","SVM",60,2,2484,2262,222,300,266,34,0.808726373432253,0.244444444444444,1.28387096774194,87,34,53,31,1.6,10.78,7.8,0,0,0,0,0,0,0.202483459097783,277.486031800758,22.5847866362841
9.7,"random_instances_SVM","SVM",60,3,2384,2170,214,400,358,42,0.771418477300836,0.214814814814815,1.27436081242533,116,42,74,29,1.8,14.37,8.5,0,0,0,0,0,0,0.205948185808232,254.069305782578,26.59016071553
9.7,"random_instances_SVM","SVM",60,4,2284,2076,208,500,452,48,0.803350409232761,0.266666666666667,1.28387096774194,144,48,96,28,2,17.96,9.4,0,0,0,0,0,0,0.180111372943931,224.724283580899,21.2467996925007
9.7,"random_instances_SVM","SVM",60,5,2184,1983,201,600,545,55,0.804180651239482,0.22962962962963,1.26485065710872,167,55,112,23,2,21.55,9.9,0,0,0,0,0,0,0.167255157389995,228.324326085812,19.9768635525986
9.7,"random_instances_SVM","SVM",60,6,2084,1890,194,700,638,62,0.799599599599607,0.222222222222222,1.24583034647551,193,62,131,26,2.1,25.14,10.3,0,0,0,0,0,0,0.162580536456947,196.902186005917,19.3463065049979
9.7,"random_instances_SVM","SVM",60,7,1984,1796,188,800,732,68,0.816139669080849,0.214814814814815,1.27436081242533,209,68,141,16,2.1,28.74,10.8,0,0,0,0,0,0,0.160706660144872,184.946217779052,19.3221412195104
9.7,"random_instances_SVM","SVM",60,8,1884,1710,174,900,818,82,0.80681269504799,0.251851851851852,1.27436081242533,243,82,161,34,2,32.33,10,0,0,0,0,0,0,0.185421663628403,174.406147929222,22.7806084651537
9.7,"random_instances_SVM","SVM",60,9,1784,1621,163,1000,907,93,0.814331979037865,0.222222222222222,1.27436081242533,274,93,181,31,1.9,35.92,9.8,0,0,0,0,0,0,0.196637632385348,170.742679533912,24.9355047331952
9.7,"random_instances_SVM","SVM",60,10,1684,1529,155,1100,999,101,0.835300005888242,0.296296296296296,1.28387096774194,297,101,196,23,1.9,39.51,9.9,0,0,0,0,0,0,0.184692541138082,159.762494820122,23.3048873183445
9.7,"random_instances_SVM","SVM",60,11,1584,1434,150,1200,1094,106,0.838980156627214,0.274074074074074,1.27436081242533,307,106,201,10,1.9,43.1,10.3,0,0,0,0,0,0,0.171103720512753,150.303039801,20.8250154312372
9.7,"random_instances_SVM","SVM",60,12,1484,1347,137,1300,1181,119,0.831437319672617,0.303703703703704,1.26485065710872,351,119,232,44,1.9,46.7,9.9,0,0,0,0,0,0,0.171577001380606,139.093152252474,20.7558024851744
9.7,"random_instances_SVM","SVM",60,13,1384,1255,129,1400,1273,127,0.815533180239071,0.222222222222222,1.27436081242533,350,127,223,-1,1.8,50.29,10,0,0,0,0,0,0,0.158646986223981,120.876679514254,18.6933859293672
9.7,"random_instances_SVM","SVM",60,14,1284,1161,123,1500,1367,133,0.818801154095277,0.274074074074074,1.27436081242533,374,133,241,24,1.8,53.88,10.3,0,0,0,0,0,0,0.16961994339237,121.932647808882,19.4360115926261
9.7,"random_instances_SVM","SVM",60,15,1184,1070,114,1600,1458,142,0.80362126832716,0.185185185185185,1.27436081242533,410,142,268,36,1.9,57.47,10.3,0,0,0,0,0,0,0.175553129049593,110.060731000421,21.0242597690766
9.7,"random_instances_SVM","SVM",60,16,1084,982,102,1700,1546,154,0.835765176941659,0.303703703703704,1.27436081242533,443,154,289,33,1.9,61.06,10,0,0,0,0,0,0,0.15547617470678,104.767683209685,17.0859250385801
9.7,"random_instances_SVM","SVM",60,17,984,895,89,1800,1633,167,0.828134016369314,0.259259259259259,1.27436081242533,468,167,301,25,1.8,64.66,9.8,0,0,0,0,0,0,0.159586886854559,98.7704408565536,17.7267005171244
9.7,"random_instances_SVM","SVM",60,18,884,804,80,1900,1724,176,0.778619796266858,0.148148148148148,1.27436081242533,497,176,321,29,1.8,68.25,9.8,0,0,0,0,0,0,0.158837575432455,82.9813117346687,18.221281748666
9.7,"random_instances_SVM","SVM",60,19,784,710,74,2000,1818,182,0.816775599128541,0.251851851851852,1.27436081242533,536,182,354,39,1.9,71.84,10,0,0,0,0,0,0,0.146047074208801,75.2605142932711,16.341090320065
9.7,"random_instances_SVM","SVM",60,20,684,622,62,2100,1906,194,0.818135782841671,0.311111111111111,1.27436081242533,554,194,360,18,1.9,75.43,9.8,0,0,0,0,0,0,0.164529451120785,62.4014330722338,18.5783854205715
9.7,"random_instances_SVM","SVM",60,21,584,532,52,2200,1996,204,0.8317435082141,0.281481481481481,1.27436081242533,598,204,394,44,1.9,79.02,9.8,0,0,0,0,0,0,0.157619194246018,55.0642474648911,17.1373868860394
9.7,"random_instances_SVM","SVM",60,22,484,439,45,2300,2089,211,0.786539480657133,0.251851851851852,1.27436081242533,586,211,375,-12,1.8,82.61,9.9,0,0,0,0,0,0,0.13684428438752,45.305747898551,15.0382475903974
9.7,"random_instances_SVM","SVM",60,23,384,347,37,2400,2181,219,0.81431431431432,0.274074074074074,1.27436081242533,611,219,392,25,1.8,86.21,10,0,0,0,0,0,0,0.132803814108313,35.8373228678544,15.855191604047
9.7,"random_instances_SVM","SVM",60,24,284,257,27,2500,2271,229,0.744226579520703,0.17037037037037,1.27436081242533,630,229,401,19,1.8,89.8,9.9,0,0,0,0,0,0,0.127653155687101,26.9667650322468,15.1605906292265
9.7,"random_instances_SVM","SVM",60,25,184,162,22,2600,2366,234,0.798121651062837,0.17037037037037,1.27436081242533,658,234,424,28,1.8,93.39,10.1,0,0,0,0,0,0,0.0906656321302693,17.0906918020277,14.002095987273
9.7,"random_instances_SVM","SVM",60,26,84,74,10,2700,2454,246,0.822175116292765,0.222222222222222,1.28387096774194,710,246,464,52,1.9,96.98,10,0,0,0,0,0,0,1.81621043994549e-07,8.59285660230127,8.59285660230127
9.7,"random_instances_SVM","SVM",60,27,0,0,0,2784,2528,256,0.799252193369849,0.214814814814815,1.27436081242533,705,256,449,-5,1.8,100,9.9,0,0,0,0,0,0,0,0,0
9.7,"random_instances_SVM","SVM",61,0,2684,2420,264,100,91,9,0.787411100033237,0.254237288135593,1.27299070530344,31,9,22,0,2.4,3.59,10.1,0,0,0,0,0,0,0.0921401997378673,246.140572584944,9.22668708265654
9.7,"random_instances_SVM","SVM",61,1,2584,2334,250,200,177,23,0.839621136590237,0.372881355932203,1.25123018042646,55,23,32,24,1.4,7.18,7.7,0,0,0,0,0,0,0.302517223621327,256.473681528052,36.5069107195662
9.7,"random_instances_SVM","SVM",61,2,2484,2244,240,300,267,33,0.823070787637095,0.330508474576271,1.25123018042646,83,33,50,28,1.5,10.78,8.1,0,0,0,0,0,0,0.290232063180251,280.229377821995,36.9721675909571
9.7,"random_instances_SVM","SVM",61,3,2384,2151,233,400,360,40,0.762818212030578,0.220338983050847,1.22946965554948,103,40,63,20,1.6,14.37,9,0,0,0,0,0,0,0.232548719754821,241.663829394307,29.8316635562224
9.7,"random_instances_SVM","SVM",61,4,2284,2059,225,500,452,48,0.759641076769695,0.26271186440678,1.24034991798797,123,48,75,20,1.6,17.96,9.4,0,0,0,0,0,0,0.193628685163107,209.275240069367,24.3413744910849
9.7,"random_instances_SVM","SVM",61,5,2184,1973,211,600,538,62,0.77399135925557,0.322033898305085,1.22946965554948,160,62,98,37,1.6,21.55,8.7,0,0,0,0,0,0,0.171189348511039,215.577373506692,20.8704692682141
9.7,"random_instances_SVM","SVM",61,6,2084,1879,205,700,632,68,0.739175805915589,0.26271186440678,1.24034991798797,205,68,137,45,2,25.14,9.3,0,0,0,0,0,0,0.183310574293686,199.369956985243,25.8349914710009
9.7,"random_instances_SVM","SVM",61,7,1984,1787,197,800,724,76,0.750242605516787,0.203389830508475,1.27299070530344,217,76,141,12,1.9,28.74,9.5,0,0,0,0,0,0,0.199383476997479,190.497674409444,30.8424263428005
9.7,"random_instances_SVM","SVM",61,8,1884,1698,186,900,813,87,0.764599534729148,0.279661016949153,1.22946965554948,248,87,161,31,1.9,32.33,9.3,0,0,0,0,0,0,0.185550183637765,189.051040240538,26.7522701663126
9.7,"random_instances_SVM","SVM",61,9,1784,1605,179,1000,906,94,0.777500830840813,0.26271186440678,1.24034991798797,272,94,178,24,1.9,35.92,9.6,0,0,0,0,0,0,0.167095102800702,171.498523784684,22.704454218971
9.7,"random_instances_SVM","SVM",61,10,1684,1513,171,1100,998,102,0.772130275839154,0.169491525423729,1.26211044286495,293,102,191,21,1.9,39.51,9.8,0,0,0,0,0,0,0.150312230866071,156.485625429377,20.6478764374024
9.7,"random_instances_SVM","SVM",61,11,1584,1423,161,1200,1088,112,0.809903622465942,0.211864406779661,1.26211044286495,312,112,200,19,1.8,43.1,9.7,0,0,0,0,0,0,0.172335555498358,148.52432391243,24.5387237275191
9.7,"random_instances_SVM","SVM",61,12,1484,1339,145,1300,1172,128,0.77299435028249,0.186440677966102,1.26211044286495,368,128,240,56,1.9,46.7,9.2,0,0,0,0,0,0,0.158059502410277,144.113556226482,21.0058623283129
9.7,"random_instances_SVM","SVM",61,13,1384,1248,136,1400,1263,137,0.764978398138922,0.169491525423729,1.26211044286495,377,137,240,9,1.8,50.29,9.2,0,0,0,0,0,0,0.176818625847333,137.677341206123,23.629126089365
9.7,"random_instances_SVM","SVM",61,14,1284,1158,126,1500,1353,147,0.767088733798606,0.161016949152542,1.27181852233355,410,147,263,33,1.8,53.88,9.2,0,0,0,0,0,0,0.16873292620494,130.546289358306,22.0711229370014
9.7,"random_instances_SVM","SVM",61,15,1184,1071,113,1600,1440,160,0.774636091724828,0.135593220338983,1.27299070530344,440,160,280,30,1.8,57.47,9,0,0,0,0,0,0,0.177602783868685,122.723796775828,24.4082787832933
9.7,"random_instances_SVM","SVM",61,16,1084,976,108,1700,1535,165,0.765270854104355,0.169491525423729,1.27299070530344,450,165,285,10,1.7,61.06,9.3,0,0,0,0,0,0,0.172973793367943,106.075550215969,23.4111696400024
9.7,"random_instances_SVM","SVM",61,17,984,883,101,1800,1628,172,0.802558989697577,0.203389830508475,1.27299070530344,486,172,314,36,1.8,64.66,9.5,0,0,0,0,0,0,0.16619991460639,93.7933372689232,23.152151833108
9.7,"random_instances_SVM","SVM",61,18,884,796,88,1900,1715,185,0.83284812229977,0.220338983050847,1.27299070530344,507,185,322,21,1.7,68.25,9.3,0,0,0,0,0,0,0.148156213465588,84.5048663987432,18.6969464019011
9.7,"random_instances_SVM","SVM",61,19,784,714,70,2000,1797,203,0.77824526420738,0.211864406779661,1.27299070530344,574,203,371,67,1.8,71.84,8.9,0,0,0,0,0,0,0.148887616183388,77.4739890435932,19.4919088485028
9.7,"random_instances_SVM","SVM",61,20,684,626,58,2100,1885,215,0.779521435692924,0.194915254237288,1.27299070530344,602,215,387,28,1.8,75.43,8.8,0,0,0,0,0,0,0.147486931009722,71.8229598742564,19.1383149036816
9.7,"random_instances_SVM","SVM",61,21,584,530,54,2200,1981,219,0.815181123296779,0.245762711864407,1.27299070530344,606,219,387,4,1.8,79.02,9,0,0,0,0,0,0,0.158888542123879,61.9012446523764,20.9662225681976
9.7,"random_instances_SVM","SVM",61,22,484,444,40,2300,2067,233,0.792509139248922,0.245762711864407,1.27299070530344,623,233,390,17,1.7,82.61,8.9,0,0,0,0,0,0,0.148096773429717,53.0561020364741,18.9406546367808
9.7,"random_instances_SVM","SVM",61,23,384,358,26,2400,2153,247,0.853492854769028,0.305084745762712,1.27299070530344,652,247,405,29,1.6,86.21,8.7,0,0,0,0,0,0,0.153601682789954,40.9243487385115,22.1674358432135
9.7,"random_instances_SVM","SVM",61,24,284,263,21,2500,2248,252,0.848368228647393,0.288135593220339,1.27299070530344,673,252,421,21,1.7,89.8,8.9,0,0,0,0,0,0,0.139154324737602,31.2314097454081,19.9052691613152
9.7,"random_instances_SVM","SVM",61,25,184,168,16,2600,2343,257,0.833147224991693,0.245762711864407,1.27299070530344,706,257,449,33,1.7,93.39,9.1,0,0,0,0,0,0,0.11241757890569,18.3207134471249,13.5187465988289
9.7,"random_instances_SVM","SVM",61,26,84,78,6,2700,2433,267,0.8499235626454,0.254237288135593,1.27299070530344,749,267,482,43,1.8,96.98,9.1,0,0,0,0,0,0,7.70972305258193e-05,9.38239252720624,9.38239252720624
9.7,"random_instances_SVM","SVM",61,27,0,0,0,2784,2511,273,0.811950814223997,0.254237288135593,1.27299070530344,764,273,491,15,1.8,100,9.2,0,0,0,0,0,0,0,0,0
9.7,"random_instances_SVM","SVM",62,0,2684,2437,247,100,88,12,0.809722923124976,0.265151515151515,1.27414467253177,31,12,19,0,1.6,3.59,7.3,0,0,0,0,0,0,0.159328260749906,310.770574882515,17.8558029650458
9.7,"random_instances_SVM","SVM",62,1,2584,2351,233,200,174,26,0.83645735707591,0.234848484848485,1.27414467253177,60,26,34,29,1.3,7.18,6.7,0,0,0,0,0,0,0.236713746862273,321.241790862048,26.4553837153123
9.7,"random_instances_SVM","SVM",62,2,2484,2265,219,300,260,40,0.831338764328459,0.310606060606061,1.28387096774194,90,40,50,30,1.2,10.78,6.5,0,0,0,0,0,0,0.193691852693681,302.540207201455,21.0136395584082
9.7,"random_instances_SVM","SVM",62,3,2384,2172,212,400,353,47,0.845529041405333,0.348484848484849,1.28268876611418,104,47,57,14,1.2,14.37,7.5,0,0,0,0,0,0,0.40203782178024,226.765093338828,46.8999509667961
9.7,"random_instances_SVM","SVM",62,4,2284,2084,200,500,441,59,0.833531588686231,0.318181818181818,1.28387096774194,130,59,71,26,1.2,17.96,7.5,0,0,0,0,0,0,0.328646452874417,249.817086548335,38.715406248731
9.7,"random_instances_SVM","SVM",62,5,2184,1994,190,600,531,69,0.796427799005118,0.325757575757576,1.28387096774194,165,69,96,35,1.4,21.55,7.7,0,0,0,0,0,0,0.213746445991742,245.838931063568,24.6755265951444
9.7,"random_instances_SVM","SVM",62,6,2084,1901,183,700,624,76,0.796235551390193,0.310606060606061,1.28387096774194,191,76,115,26,1.5,25.14,8.2,0,0,0,0,0,0,0.282700288923333,225.449395753727,36.3590709223116
9.7,"random_instances_SVM","SVM",62,7,1984,1807,177,800,718,82,0.790029558070797,0.265151515151515,1.28387096774194,209,82,127,18,1.5,28.74,8.8,0,0,0,0,0,0,0.259017815491964,191.542697254044,34.3585273592493
9.7,"random_instances_SVM","SVM",62,8,1884,1712,172,900,813,87,0.781606709441761,0.234848484848485,1.28387096774194,232,87,145,23,1.7,32.33,9.3,0,0,0,0,0,0,0.206345835037669,189.379338433094,28.2045875920344
9.7,"random_instances_SVM","SVM",62,9,1784,1622,162,1000,903,97,0.795454545454538,0.234848484848485,1.27414467253177,241,97,144,9,1.5,35.92,9.3,0,0,0,0,0,0,0.248905179864195,167.969211097387,33.9914389114665
9.7,"random_instances_SVM","SVM",62,10,1684,1532,152,1100,993,107,0.816385504529829,0.234848484848485,1.27414467253177,268,107,161,27,1.5,39.51,9.3,0,0,0,0,0,0,0.184787331957858,155.002240073195,23.4826568500931
9.7,"random_instances_SVM","SVM",62,11,1584,1442,142,1200,1083,117,0.813237449835382,0.21969696969697,1.27414467253177,303,117,186,35,1.6,43.1,9.3,0,0,0,0,0,0,0.204109084876315,151.626893295905,26.6127758054867
9.7,"random_instances_SVM","SVM",62,12,1484,1350,134,1300,1175,125,0.819269218753756,0.25,1.28387096774194,333,125,208,30,1.7,46.7,9.4,0,0,0,0,0,0,0.207590266140425,150.637191131256,28.9184174619944
9.7,"random_instances_SVM","SVM",62,13,1384,1255,129,1400,1270,130,0.81306322543436,0.196969696969697,1.28387096774194,342,130,212,9,1.6,50.29,9.8,0,0,0,0,0,0,0.201298747810136,132.376802813645,28.8155628871536
9.7,"random_instances_SVM","SVM",62,14,1284,1164,120,1500,1361,139,0.809482613606328,0.227272727272727,1.28387096774194,360,139,221,18,1.6,53.88,9.8,0,0,0,0,0,0,0.197451613673735,112.33845007219,26.7895141833442
9.7,"random_instances_SVM","SVM",62,15,1184,1072,112,1600,1453,147,0.812594621872971,0.204545454545455,1.28387096774194,395,147,248,35,1.7,57.47,9.9,0,0,0,0,0,0,0.183260048124588,107.265083931534,22.3367590394149
9.7,"random_instances_SVM","SVM",62,16,1084,979,105,1700,1546,154,0.797923725758775,0.212121212121212,1.28387096774194,427,154,273,32,1.8,61.06,10,0,0,0,0,0,0,0.182780026259803,104.704617433161,22.8673713294737
9.7,"random_instances_SVM","SVM",62,17,984,891,93,1800,1634,166,0.796367721625455,0.234848484848485,1.28387096774194,454,166,288,27,1.7,64.66,9.8,0,0,0,0,0,0,0.16311044521111,94.5806828385195,19.776317685453
9.7,"random_instances_SVM","SVM",62,18,884,800,84,1900,1725,175,0.809434551702592,0.204545454545455,1.28387096774194,472,175,297,18,1.7,68.25,9.9,0,0,0,0,0,0,0.153544952477307,87.3943706567291,17.6747178333943
9.7,"random_instances_SVM","SVM",62,19,784,707,77,2000,1818,182,0.792450676471295,0.21969696969697,1.28387096774194,506,182,324,34,1.8,71.84,10,0,0,0,0,0,0,0.155056927230146,73.3468156820981,19.084170188122
9.7,"random_instances_SVM","SVM",62,20,684,617,67,2100,1908,192,0.747500781005937,0.159090909090909,1.27414467253177,554,192,362,48,1.9,75.43,9.9,0,0,0,0,0,0,0.154397719752935,71.0587989699199,19.4375115645596
9.7,"random_instances_SVM","SVM",62,21,584,531,53,2200,1994,206,0.733352558094828,0.113636363636364,1.27414467253177,562,206,356,8,1.7,79.02,9.7,0,0,0,0,0,0,0.1429249229,58.5848476346481,17.3989490936128
9.7,"random_instances_SVM","SVM",62,22,484,439,45,2300,2086,214,0.783715425467999,0.196969696969697,1.27414467253177,596,214,382,34,1.8,82.61,9.7,0,0,0,0,0,0,0.132454473920122,45.6989444351826,15.3898237203252
9.7,"random_instances_SVM","SVM",62,23,384,347,37,2400,2178,222,0.775779203614256,0.166666666666667,1.28387096774194,610,222,388,14,1.7,86.21,9.8,0,0,0,0,0,0,0.139286678841862,39.5312728899442,17.91717927438
9.7,"random_instances_SVM","SVM",62,24,284,255,29,2500,2270,230,0.782333645735708,0.189393939393939,1.28387096774194,622,230,392,12,1.7,89.8,9.9,0,0,0,0,0,0,0.123818023207294,28.3678889440981,15.9514876504329
9.7,"random_instances_SVM","SVM",62,25,184,166,18,2600,2359,241,0.769170691851104,0.189393939393939,1.28387096774194,650,241,409,28,1.7,93.39,9.8,0,0,0,0,0,0,0.0953037428821597,18.0280933260834,13.9263839376532
9.7,"random_instances_SVM","SVM",62,26,84,80,4,2700,2445,255,0.759840674789129,0.143939393939394,1.28387096774194,690,255,435,40,1.7,96.98,9.6,0,0,0,0,0,0,9.55729454784535e-07,8.35030932366088,8.35030932366088
9.7,"random_instances_SVM","SVM",62,27,0,0,0,2784,2525,259,0.815832792636913,0.287878787878788,1.27414467253177,705,259,446,15,1.7,100,9.7,0,0,0,0,0,0,0,0,0
9.7,"random_instances_SVM","SVM",63,0,2684,2440,244,100,90,10,0.784125249895392,0.197080291970803,1.27449964680951,29,10,19,0,1.9,3.59,9,0,0,0,0,0,0,0.148661039876177,261.450411279427,16.9584806385719
9.7,"random_instances_SVM","SVM",63,1,2584,2354,230,200,176,24,0.775535822213963,0.262773722627737,1.23701436307982,62,24,38,33,1.6,7.18,7.3,0,0,0,0,0,0,0.168605638047736,299.814511468738,18.8362429654833
9.7,"random_instances_SVM","SVM",63,2,2484,2265,219,300,265,35,0.800740387744668,0.343065693430657,1.27449964680951,88,35,53,26,1.5,10.78,7.6,0,0,0,0,0,0,0.15969432277149,245.423590704248,16.5156611494372
9.7,"random_instances_SVM","SVM",63,3,2384,2173,211,400,357,43,0.813409502998747,0.357664233576642,1.27449964680951,102,43,59,14,1.4,14.37,8.3,0,0,0,0,0,0,0.258544577707579,222.378659880666,28.5584188697074
9.7,"random_instances_SVM","SVM",63,4,2284,2084,200,500,446,54,0.830739457901345,0.335766423357664,1.28387096774194,140,54,86,38,1.6,17.96,8.3,0,0,0,0,0,0,0.178780915844428,243.217478357371,21.219883564591
9.7,"random_instances_SVM","SVM",63,5,2184,1995,189,600,535,65,0.793813055000233,0.233576642335766,1.28387096774194,179,65,114,39,1.8,21.55,8.2,0,0,0,0,0,0,0.167954062017222,264.03584533565,19.4587185012372
9.7,"random_instances_SVM","SVM",63,6,2084,1897,187,700,633,67,0.776215770142735,0.18978102189781,1.26512832587709,193,67,126,14,1.9,25.14,9.4,0,0,0,0,0,0,0.135185216366658,204.108456233645,14.9575811763675
9.7,"random_instances_SVM","SVM",63,7,1984,1806,178,800,724,76,0.807388767492681,0.262773722627737,1.28387096774194,218,76,142,25,1.9,28.74,9.5,0,0,0,0,0,0,0.17583694784135,196.449441934262,20.3435109908171
9.7,"random_instances_SVM","SVM",63,8,1884,1717,167,900,813,87,0.813188665209913,0.262773722627737,1.28387096774194,247,87,160,29,1.8,32.33,9.3,0,0,0,0,0,0,0.195551718656757,180.466715264153,22.5687251537094
9.7,"random_instances_SVM","SVM",63,9,1784,1626,158,1000,904,96,0.796050490492354,0.262773722627737,1.28387096774194,262,96,166,15,1.7,35.92,9.4,0,0,0,0,0,0,0.182063169207891,170.736046850991,22.0907613006714
9.7,"random_instances_SVM","SVM",63,10,1684,1535,149,1100,995,105,0.815548142637966,0.284671532846715,1.27449964680951,278,105,173,16,1.6,39.51,9.5,0,0,0,0,0,0,0.19538766222984,144.943194750601,23.3679176221566
9.7,"random_instances_SVM","SVM",63,11,1584,1438,146,1200,1092,108,0.819052489655496,0.284671532846715,1.27449964680951,294,108,186,16,1.7,43.1,10.1,0,0,0,0,0,0,0.188791012663382,141.212108654121,22.563379727181
9.7,"random_instances_SVM","SVM",63,12,1484,1350,134,1300,1180,120,0.795823841182761,0.248175182481752,1.27449964680951,327,120,207,33,1.7,46.7,9.8,0,0,0,0,0,0,0.169463526057521,149.750897904547,18.807101839228
9.7,"random_instances_SVM","SVM",63,13,1384,1263,121,1400,1267,133,0.822859035752479,0.306569343065693,1.28387096774194,374,133,241,47,1.8,50.29,9.5,0,0,0,0,0,0,0.197899341448325,139.402344047807,24.8442444490324
9.7,"random_instances_SVM","SVM",63,14,1284,1173,111,1500,1357,143,0.783445301966627,0.218978102189781,1.25575700494467,412,143,269,38,1.9,53.88,9.5,0,0,0,0,0,0,0.160736955280205,127.883718160603,19.6505775415139
9.7,"random_instances_SVM","SVM",63,15,1184,1083,101,1600,1447,153,0.801769026918971,0.284671532846715,1.26512832587709,410,153,257,-2,1.7,57.47,9.5,0,0,0,0,0,0,0.147178944522708,112.676427726254,17.7699167059086
9.7,"random_instances_SVM","SVM",63,16,1084,989,95,1700,1541,159,0.802472220930781,0.27007299270073,1.26512832587709,439,159,280,29,1.8,61.06,9.7,0,0,0,0,0,0,0.167610544707888,102.227846326513,22.5607987068868
9.7,"random_instances_SVM","SVM",63,17,984,892,92,1800,1638,162,0.785415407503839,0.233576642335766,1.26512832587709,451,162,289,12,1.8,64.66,10.1,0,0,0,0,0,0,0.150558547556522,90.0480085451005,19.0125140548989
9.7,"random_instances_SVM","SVM",63,18,884,799,85,1900,1731,169,0.802989446278307,0.277372262773723,1.27449964680951,472,169,303,21,1.8,68.25,10.2,0,0,0,0,0,0,0.160616709763339,79.8240700063334,20.8502917529965
9.7,"random_instances_SVM","SVM",63,19,784,705,79,2000,1825,175,0.819366311776472,0.306569343065693,1.26512832587709,481,175,306,9,1.7,71.84,10.4,0,0,0,0,0,0,0.15710011898799,70.2718059137082,20.3365338433603
9.7,"random_instances_SVM","SVM",63,20,684,612,72,2100,1918,182,0.808841647682371,0.240875912408759,1.27449964680951,518,182,336,37,1.8,75.43,10.5,0,0,0,0,0,0,0.14883850109264,66.0034465457797,18.7986812910099
9.7,"random_instances_SVM","SVM",63,21,584,523,61,2200,2007,193,0.794917243944397,0.226277372262774,1.27449964680951,543,193,350,25,1.8,79.02,10.4,0,0,0,0,0,0,0.133322492743685,52.0095600333857,16.5650301732372
9.7,"random_instances_SVM","SVM",63,22,484,433,51,2300,2097,203,0.782550327769774,0.204379562043796,1.27449964680951,546,203,343,3,1.7,82.61,10.3,0,0,0,0,0,0,0.129785664163553,42.757651719011,16.6881985606405
9.7,"random_instances_SVM","SVM",63,23,384,339,45,2400,2191,209,0.776488911618396,0.175182481751825,1.27449964680951,576,209,367,30,1.8,86.21,10.5,0,0,0,0,0,0,0.123710224743056,33.8406285828247,15.9142766086954
9.7,"random_instances_SVM","SVM",63,24,284,250,34,2500,2280,220,0.775593937421545,0.167883211678832,1.26512832587709,610,220,390,34,1.8,89.8,10.4,0,0,0,0,0,0,0.11945369887046,27.9884254757952,16.5994022035263
9.7,"random_instances_SVM","SVM",63,25,184,159,25,2600,2371,229,0.74911083732391,0.182481751824818,1.27449964680951,646,229,417,36,1.8,93.39,10.4,0,0,0,0,0,0,0.0982679622780829,18.2908748121195,14.6669304079737
9.7,"random_instances_SVM","SVM",63,26,84,74,10,2700,2456,244,0.789140592310196,0.226277372262774,1.27449964680951,674,244,430,28,1.8,96.98,10.1,0,0,0,0,0,0,1.25530114885122e-06,7.53498626814546,7.53498626814546
9.7,"random_instances_SVM","SVM",63,27,0,0,0,2784,2530,254,0.824579245897066,0.328467153284672,1.27449964680951,702,254,448,28,1.8,100,10,0,0,0,0,0,0,0,0,0
9.7,"random_instances_SVM","SVM",64,0,2684,2432,252,100,87,13,0.702390348404555,0.0873015873015873,1.26349206349206,41,13,28,0,2.2,3.59,6.7,0,0,0,0,0,0,0.136793573205549,352.852810366913,13.8177979763039
9.7,"random_instances_SVM","SVM",64,1,2584,2346,238,200,173,27,0.72878691071272,0.182539682539683,1.24311315924219,72,27,45,31,1.7,7.18,6.4,0,0,0,0,0,0,0.185476548156448,358.03826434407,20.3621715291252
9.7,"random_instances_SVM","SVM",64,2,2484,2262,222,300,257,43,0.780540208716999,0.198412698412698,1.26349206349206,107,43,64,35,1.5,10.78,6,0,0,0,0,0,0,0.320226659598513,353.009196545704,40.1266460580945
9.7,"random_instances_SVM","SVM",64,3,2384,2172,212,400,347,53,0.79428972325578,0.206349206349206,1.26232862696951,132,53,79,25,1.5,14.37,6.5,0,0,0,0,0,0,0.375824105062854,310.78776381726,53.8400994425529
9.7,"random_instances_SVM","SVM",64,4,2284,2077,207,500,442,58,0.788426604527628,0.238095238095238,1.24311315924219,154,58,96,22,1.7,17.96,7.6,0,0,0,0,0,0,0.192256769917379,248.591376189667,26.1719684323772
9.7,"random_instances_SVM","SVM",64,5,2184,1986,198,600,533,67,0.756636724671452,0.238095238095238,1.24311315924219,189,67,122,35,1.8,21.55,8,0,0,0,0,0,0,0.182541245392773,267.139806937491,22.6904797499626
9.7,"random_instances_SVM","SVM",64,6,2084,1895,189,700,624,76,0.778780020295407,0.214285714285714,1.26349206349206,209,76,133,20,1.8,25.14,8.2,0,0,0,0,0,0,0.172432277827941,229.610295278813,21.9000931831694
9.7,"random_instances_SVM","SVM",64,7,1984,1805,179,800,714,86,0.810262963380556,0.214285714285714,1.25330261136713,237,86,151,28,1.8,28.74,8.3,0,0,0,0,0,0,0.188464068748227,217.691617375993,24.9152007347473
9.7,"random_instances_SVM","SVM",64,8,1884,1713,171,900,806,94,0.806986883151057,0.23015873015873,1.24311315924219,260,94,166,23,1.8,32.33,8.6,0,0,0,0,0,0,0.174783556108031,201.553384126129,22.0079990677675
9.7,"random_instances_SVM","SVM",64,9,1784,1621,163,1000,898,102,0.809561393618213,0.182539682539683,1.25330261136713,285,102,183,25,1.8,35.92,8.8,0,0,0,0,0,0,0.186091316211099,185.785979709242,23.1805998848762
9.7,"random_instances_SVM","SVM",64,10,1684,1528,156,1100,991,109,0.810394507711001,0.214285714285714,1.25330261136713,303,109,194,18,1.8,39.51,9.1,0,0,0,0,0,0,0.143303506259589,180.698948493512,16.2615408152961
9.7,"random_instances_SVM","SVM",64,11,1584,1437,147,1200,1082,118,0.785131732250908,0.158730158730159,1.26349206349206,343,118,225,40,1.9,43.1,9.2,0,0,0,0,0,0,0.189701572894953,170.461744043465,24.3246409050067
9.7,"random_instances_SVM","SVM",64,12,1484,1350,134,1300,1169,131,0.805690231893859,0.222222222222222,1.26349206349206,372,131,241,29,1.8,46.7,8.9,0,0,0,0,0,0,0.18893516748781,156.027115281292,22.9685679524746
9.7,"random_instances_SVM","SVM",64,13,1384,1261,123,1400,1258,142,0.778372859272618,0.119047619047619,1.26349206349206,399,142,257,27,1.8,50.29,8.9,0,0,0,0,0,0,0.159366693615044,150.960823952663,19.3888058989862
9.7,"random_instances_SVM","SVM",64,14,1284,1170,114,1500,1349,151,0.805752872051211,0.182539682539683,1.25330261136713,417,151,266,18,1.8,53.88,8.9,0,0,0,0,0,0,0.175377943520893,135.59370048238,22.8241588515797
9.7,"random_instances_SVM","SVM",64,15,1184,1080,104,1600,1439,161,0.824688991618741,0.214285714285714,1.273681515617,435,161,274,18,1.7,57.47,8.9,0,0,0,0,0,0,0.176947541459648,121.807134832413,23.7157526015586
9.7,"random_instances_SVM","SVM",64,16,1084,991,93,1700,1528,172,0.810983325190102,0.246031746031746,1.25330261136713,460,172,288,25,1.7,61.06,8.9,0,0,0,0,0,0,0.187287000701314,112.408165812301,26.976404815785
9.7,"random_instances_SVM","SVM",64,17,984,898,86,1800,1621,179,0.788633317046888,0.126984126984127,1.25330261136713,478,179,299,18,1.7,64.66,9.1,0,0,0,0,0,0,0.169097921117797,102.828799213524,23.4695736673644
9.7,"random_instances_SVM","SVM",64,18,884,802,82,1900,1717,183,0.790406033499949,0.134920634920635,1.26349206349206,490,183,307,12,1.7,68.25,9.4,0,0,0,0,0,0,0.161607846690264,92.2068628347099,21.0669533245815
9.7,"random_instances_SVM","SVM",64,19,784,713,71,2000,1806,194,0.808227158266619,0.19047619047619,1.273681515617,524,194,330,34,1.7,71.84,9.3,0,0,0,0,0,0,0.164383597241968,81.60930470785,22.9633577295324
9.7,"random_instances_SVM","SVM",64,20,684,621,63,2100,1898,202,0.831090815700119,0.23015873015873,1.26349206349206,537,202,335,13,1.7,75.43,9.4,0,0,0,0,0,0,0.150674091761859,70.2913013257545,21.1134841827922
9.7,"random_instances_SVM","SVM",64,21,584,528,56,2200,1991,209,0.797578331516759,0.206349206349206,1.25330261136713,575,209,366,38,1.8,79.02,9.5,0,0,0,0,0,0,0.124670335415237,58.1802241588342,14.682471718783
9.7,"random_instances_SVM","SVM",64,22,484,436,48,2300,2083,217,0.763771438593848,0.150793650793651,1.25330261136713,602,217,385,27,1.8,82.61,9.6,0,0,0,0,0,0,0.12850525214986,49.1995293848898,15.69037508983
9.7,"random_instances_SVM","SVM",64,23,384,350,34,2400,2169,231,0.812768569674642,0.238095238095238,1.26349206349206,645,231,414,43,1.8,86.21,9.4,0,0,0,0,0,0,0.120289628770313,38.3042569282071,14.099133456101
9.7,"random_instances_SVM","SVM",64,24,284,259,25,2500,2260,240,0.806780170631779,0.206349206349206,1.26349206349206,659,240,419,14,1.7,89.8,9.4,0,0,0,0,0,0,0.120861897724173,28.7560739126543,14.8993616594346
9.7,"random_instances_SVM","SVM",64,25,184,164,20,2600,2355,245,0.780101727615532,0.198412698412698,1.25330261136713,665,245,420,6,1.7,93.39,9.6,0,0,0,0,0,0,0.103156366251148,17.9699732272426,13.4297234391014
9.7,"random_instances_SVM","SVM",64,26,84,76,8,2700,2443,257,0.716146126959068,0.126984126984127,1.26349206349206,713,257,456,48,1.8,96.98,9.5,0,0,0,0,0,0,0.00269207782105427,8.16366196499779,8.16366196499779
9.7,"random_instances_SVM","SVM",64,27,0,0,0,2784,2519,265,0.829029954523245,0.246031746031746,1.26349206349206,713,265,448,0,1.7,100,9.5,0,0,0,0,0,0,0,0,0
9.7,"random_instances_SVM","SVM",65,0,2684,2426,258,100,89,11,0.736524744940737,0.237704918032787,1.23125330512956,33,11,22,0,2,3.59,8.1,0,0,0,0,0,0,0.284674171325104,295.796788473807,44.7831666242257
9.7,"random_instances_SVM","SVM",65,1,2584,2340,244,200,175,25,0.809708374714625,0.344262295081967,1.25230037017451,63,25,38,30,1.5,7.18,7,0,0,0,0,0,0,0.255436957975505,359.620783197387,31.4735277285696
9.7,"random_instances_SVM","SVM",65,2,2484,2255,229,300,260,40,0.783312481459035,0.360655737704918,1.21020624008461,107,40,67,44,1.7,10.78,6.5,0,0,0,0,0,0,0.31355251967108,360.322451648526,40.7525920595871
9.7,"random_instances_SVM","SVM",65,3,2384,2161,223,400,354,46,0.789980781880799,0.360655737704918,1.25230037017451,127,46,81,20,1.8,14.37,7.7,0,0,0,0,0,0,0.149718013202183,282.971820587451,16.4917293367248
9.7,"random_instances_SVM","SVM",65,4,2284,2071,213,500,444,56,0.803040074292868,0.377049180327869,1.23125330512956,166,56,110,39,2,17.96,7.9,0,0,0,0,0,0,0.162625383948576,261.026381738164,18.2916389758102
9.7,"random_instances_SVM","SVM",65,5,2184,1981,203,600,534,66,0.81249435709587,0.311475409836066,1.27334743521946,184,66,118,18,1.8,21.55,8.1,0,0,0,0,0,0,0.139643606091524,240.57300234415,16.1142547531621
9.7,"random_instances_SVM","SVM",65,6,2084,1889,195,700,626,74,0.802253292231496,0.270491803278689,1.27334743521946,214,74,140,30,1.9,25.14,8.5,0,0,0,0,0,0,0.145493598245207,229.1209892425,16.7593431769745
9.7,"random_instances_SVM","SVM",65,7,1984,1799,185,800,716,84,0.791541447936954,0.262295081967213,1.28387096774194,251,84,167,37,2,28.74,8.5,0,0,0,0,0,0,0.165029099059669,220.342850337548,21.3443031017044
9.7,"random_instances_SVM","SVM",65,8,1884,1710,174,900,805,95,0.773993628355109,0.172131147540984,1.28387096774194,283,95,188,32,2,32.33,8.5,0,0,0,0,0,0,0.155204013269932,200.802124127908,20.9629916598981
9.7,"random_instances_SVM","SVM",65,9,1784,1623,161,1000,892,108,0.815228747210796,0.245901639344262,1.28387096774194,321,108,213,38,2,35.92,8.3,0,0,0,0,0,0,0.128887308690075,194.465799894871,14.2763351817914
9.7,"random_instances_SVM","SVM",65,10,1684,1530,154,1100,985,115,0.818227547690604,0.245901639344262,1.28387096774194,330,115,215,9,1.9,39.51,8.6,0,0,0,0,0,0,0.13177811211651,177.694607340529,14.8320350610886
9.7,"random_instances_SVM","SVM",65,11,1584,1435,149,1200,1080,120,0.810301685777297,0.188524590163934,1.27334743521946,348,120,228,18,1.9,43.1,9,0,0,0,0,0,0,0.152961032876605,165.277508410357,19.8155218581133
9.7,"random_instances_SVM","SVM",65,12,1484,1345,139,1300,1170,130,0.84255975029343,0.262295081967213,1.28387096774194,379,130,249,31,1.9,46.7,9,0,0,0,0,0,0,0.153686388636644,155.544588492751,19.2667943950318
9.7,"random_instances_SVM","SVM",65,13,1384,1250,134,1400,1265,135,0.821529452735033,0.213114754098361,1.28387096774194,385,135,250,6,1.9,50.29,9.4,0,0,0,0,0,0,0.159880326851984,134.435475562022,21.5309037027524
9.7,"random_instances_SVM","SVM",65,14,1284,1159,125,1500,1356,144,0.79141246727115,0.172131147540984,1.27334743521946,419,144,275,34,1.9,53.88,9.4,0,0,0,0,0,0,0.160543664629181,124.820526161277,21.97588445976
9.7,"random_instances_SVM","SVM",65,15,1184,1070,114,1600,1445,155,0.839967238910878,0.278688524590164,1.27334743521946,426,155,271,7,1.7,57.47,9.3,0,0,0,0,0,0,0.155843247178256,113.262886098356,22.0577869104344
9.7,"random_instances_SVM","SVM",65,16,1084,977,107,1700,1538,162,0.819743070513723,0.213114754098361,1.27334743521946,469,162,307,43,1.9,61.06,9.5,0,0,0,0,0,0,0.153240304971556,104.824804520247,19.9475590551192
9.7,"random_instances_SVM","SVM",65,17,984,885,99,1800,1630,170,0.806993331699576,0.213114754098361,1.27334743521946,487,170,317,18,1.9,64.66,9.6,0,0,0,0,0,0,0.119548737915244,96.6143768582258,13.7413283124896
9.7,"random_instances_SVM","SVM",65,18,884,793,91,1900,1722,178,0.820987733938679,0.229508196721311,1.27334743521946,496,178,318,9,1.8,68.25,9.7,0,0,0,0,0,0,0.149992494553065,85.3100464411913,20.7597604965694
9.7,"random_instances_SVM","SVM",65,19,784,700,84,2000,1815,185,0.783634933123524,0.139344262295082,1.28387096774194,509,185,324,13,1.8,71.84,9.8,0,0,0,0,0,0,0.14441689730526,77.9927471579552,19.4064517882298
9.7,"random_instances_SVM","SVM",65,20,684,613,71,2100,1902,198,0.839490010447431,0.319672131147541,1.27334743521946,528,198,330,19,1.7,75.43,9.6,0,0,0,0,0,0,0.153432812619133,69.1115766106533,20.7348653638596
9.7,"random_instances_SVM","SVM",65,21,584,520,64,2200,1995,205,0.82374792018676,0.286885245901639,1.27334743521946,572,205,367,44,1.8,79.02,9.7,0,0,0,0,0,0,0.143865045812033,57.766191716631,19.5404238485991
9.7,"random_instances_SVM","SVM",65,22,484,431,53,2300,2084,216,0.831422269801756,0.262295081967213,1.28387096774194,595,216,379,23,1.8,82.61,9.6,0,0,0,0,0,0,0.142193802943849,47.4496772134659,19.2704888584926
9.7,"random_instances_SVM","SVM",65,23,384,336,48,2400,2179,221,0.793424565657606,0.155737704918033,1.27334743521946,612,221,391,17,1.8,86.21,9.9,0,0,0,0,0,0,0.128423383686752,37.9092630474817,19.0627633729772
9.7,"random_instances_SVM","SVM",65,24,284,242,42,2500,2273,227,0.843649636919424,0.295081967213115,1.28387096774194,627,227,400,15,1.8,89.8,10,0,0,0,0,0,0,0.116545183973101,27.9323571840392,17.4275671106166
9.7,"random_instances_SVM","SVM",65,25,184,160,24,2600,2355,245,0.815099766544995,0.262295081967213,1.28387096774194,693,245,448,66,1.8,93.39,9.6,0,0,0,0,0,0,0.100119283322968,18.9845993191671,14.9358107132373
9.7,"random_instances_SVM","SVM",65,26,84,72,12,2700,2443,257,0.840444467374343,0.295081967213115,1.28387096774194,699,257,442,6,1.7,96.98,9.5,0,0,0,0,0,0,0.00307583365679302,8.88247865667349,8.88247865667349
9.7,"random_instances_SVM","SVM",65,27,0,0,0,2784,2515,269,0.814403270949686,0.213114754098361,1.28387096774194,740,269,471,41,1.8,100,9.3,0,0,0,0,0,0,0,0,0
9.7,"random_instances_SVM","SVM",66,0,2684,2426,258,100,94,6,0.177855730119043,0,0.485242570485141,18,6,12,0,2,3.59,15.7,0,0,0,0,0,0,0.0623247039385188,167.212402614507,6.2326156229163
9.7,"random_instances_SVM","SVM",66,1,2584,2340,244,200,180,20,0.754151584132558,0.21259842519685,1.2737617475235,64,20,44,46,2.2,7.18,9,0,0,0,0,0,0,0.137049632604921,261.664778953283,17.7815717666253
9.7,"random_instances_SVM","SVM",66,2,2484,2252,232,300,268,32,0.753865482454504,0.220472440944882,1.2737617475235,95,32,63,31,2,10.78,8.4,0,0,0,0,0,0,0.162855780863078,267.39765332348,20.4250812123723
9.7,"random_instances_SVM","SVM",66,3,2384,2163,221,400,357,43,0.806103917105157,0.236220472440945,1.2737617475235,129,43,86,34,2,14.37,8.3,0,0,0,0,0,0,0.198588786462652,246.498342576368,27.966180613088
9.7,"random_instances_SVM","SVM",66,4,2284,2074,210,500,446,54,0.780802577402956,0.196850393700787,1.2737617475235,157,54,103,28,1.9,17.96,8.3,0,0,0,0,0,0,0.173318714259398,264.439202895029,24.754204497603
9.7,"random_instances_SVM","SVM",66,5,2184,1987,197,600,533,67,0.8003570051374,0.220472440944882,1.26365252730505,185,67,118,28,1.8,21.55,8,0,0,0,0,0,0,0.204946170794122,245.863897967835,31.1842138797225
9.7,"random_instances_SVM","SVM",66,6,2084,1896,188,700,624,76,0.787028398701351,0.196850393700787,1.26365252730505,212,76,136,27,1.8,25.14,8.2,0,0,0,0,0,0,0.209252159367429,236.085625896195,35.4913964271296
9.7,"random_instances_SVM","SVM",66,7,1984,1803,181,800,717,83,0.795909989924249,0.21259842519685,1.26365252730505,229,83,146,17,1.8,28.74,8.6,0,0,0,0,0,0,0.171054412596465,225.310112047912,25.2435909327874
9.7,"random_instances_SVM","SVM",66,8,1884,1719,165,900,801,99,0.790890771355003,0.228346456692913,1.26365252730505,259,99,160,30,1.6,32.33,8.1,0,0,0,0,0,0,0.201104920503199,220.521966490834,31.9497117477686
9.7,"random_instances_SVM","SVM",66,9,1784,1629,155,1000,891,109,0.802745332188932,0.236220472440945,1.2737617475235,293,109,184,34,1.7,35.92,8.2,0,0,0,0,0,0,0.175848624918554,204.87029506896,24.634895759533
9.7,"random_instances_SVM","SVM",66,10,1684,1538,146,1100,982,118,0.794050329016932,0.21259842519685,1.28387096774194,322,118,204,29,1.7,39.51,8.3,0,0,0,0,0,0,0.201031426971029,192.89717131816,30.7072954681222
9.7,"random_instances_SVM","SVM",66,11,1584,1443,141,1200,1077,123,0.789068428057872,0.15748031496063,1.26365252730505,334,123,211,12,1.7,43.1,8.8,0,0,0,0,0,0,0.1589213376448,160.828409640477,23.0150725463973
9.7,"random_instances_SVM","SVM",66,12,1484,1353,131,1300,1167,133,0.805861352638985,0.188976377952756,1.2737617475235,372,133,239,38,1.8,46.7,8.8,0,0,0,0,0,0,0.172232951748129,151.007165735066,24.6743365295861
9.7,"random_instances_SVM","SVM",66,13,1384,1260,124,1400,1260,140,0.779446704233065,0.149606299212598,1.26365252730505,393,140,253,21,1.8,50.29,9,0,0,0,0,0,0,0.187443349783458,150.303518051441,28.5890556098675
9.7,"random_instances_SVM","SVM",66,14,1284,1167,117,1500,1353,147,0.784895075319384,0.181102362204724,1.2737617475235,408,147,261,15,1.8,53.88,9.2,0,0,0,0,0,0,0.177736912175142,134.190086832023,27.1207128875093
9.7,"random_instances_SVM","SVM",66,15,1184,1074,110,1600,1446,154,0.817218345337174,0.236220472440945,1.2737617475235,429,154,275,21,1.8,57.47,9.4,0,0,0,0,0,0,0.165998865751826,120.802677221019,25.6183016089335
9.7,"random_instances_SVM","SVM",66,16,1084,984,100,1700,1536,164,0.829831697578101,0.259842519685039,1.2737617475235,464,164,300,35,1.8,61.06,9.4,0,0,0,0,0,0,0.180461948247114,112.24061293331,26.3156795274718
9.7,"random_instances_SVM","SVM",66,17,984,896,88,1800,1624,176,0.799654190145671,0.173228346456693,1.2737617475235,484,176,308,20,1.8,64.66,9.2,0,0,0,0,0,0,0.161663081886471,103.526309886051,22.3331318644635
9.7,"random_instances_SVM","SVM",66,18,884,804,80,1900,1716,184,0.787824507718531,0.204724409448819,1.2737617475235,525,184,341,41,1.9,68.25,9.3,0,0,0,0,0,0,0.167441385486344,85.9016783737206,23.0145558268923
9.7,"random_instances_SVM","SVM",66,19,784,713,71,2000,1807,193,0.831815750519343,0.228346456692913,1.2737617475235,534,193,341,9,1.8,71.84,9.4,0,0,0,0,0,0,0.165399065526073,75.485895845209,20.330077853149
9.7,"random_instances_SVM","SVM",66,20,684,619,65,2100,1901,199,0.740431142789624,0.118110236220472,1.2737617475235,549,199,350,15,1.8,75.43,9.6,0,0,0,0,0,0,0.161134155417945,69.0563380004045,21.4607831808501
9.7,"random_instances_SVM","SVM",66,21,584,528,56,2200,1992,208,0.835790076003541,0.307086614173228,1.2737617475235,595,208,387,46,1.9,79.02,9.6,0,0,0,0,0,0,0.155640209646516,56.5064445662394,18.1196870767168
9.7,"random_instances_SVM","SVM",66,22,484,438,46,2300,2082,218,0.814643430234733,0.204724409448819,1.2737617475235,596,218,378,1,1.7,82.61,9.6,0,0,0,0,0,0,0.15414244811981,48.8175613765331,17.2799536995635
9.7,"random_instances_SVM","SVM",66,23,384,344,40,2400,2176,224,0.832294659849985,0.251968503937008,1.28387096774194,615,224,391,19,1.7,86.21,9.7,0,0,0,0,0,0,0.138527982941882,35.0537626008945,15.7265814100038
9.7,"random_instances_SVM","SVM",66,24,284,253,31,2500,2267,233,0.789659290219058,0.220472440944882,1.28387096774194,649,233,416,34,1.8,89.8,9.7,0,0,0,0,0,0,0.135045133860151,27.757575737622,16.9656187246441
9.7,"random_instances_SVM","SVM",66,25,184,163,21,2600,2357,243,0.841779552437471,0.267716535433071,1.28387096774194,666,243,423,17,1.7,93.39,9.7,0,0,0,0,0,0,0.0954199034097727,17.7783883254477,14.7414142716249
9.7,"random_instances_SVM","SVM",66,26,84,73,11,2700,2447,253,0.827592640967275,0.251968503937008,1.28387096774194,693,253,440,27,1.7,96.98,9.7,0,0,0,0,0,0,9.84762517431279e-06,8.51923826897332,8.51923826897332
9.7,"random_instances_SVM","SVM",66,27,0,0,0,2784,2520,264,0.773724670672089,0.181102362204724,1.2737617475235,738,264,474,45,1.8,100,9.5,0,0,0,0,0,0,0,0,0
9.7,"random_instances_SVM","SVM",67,0,2684,2436,248,100,88,12,0.71672856607106,0.213740458015267,1.2348682590495,38,12,26,0,2.2,3.59,7.3,0,0,0,0,0,0,0.202705450024683,337.766827033392,28.9195432961104
9.7,"random_instances_SVM","SVM",67,1,2584,2350,234,200,174,26,0.773097349415075,0.282442748091603,1.22506771731101,68,26,42,30,1.6,7.18,6.7,0,0,0,0,0,0,0.270310643284376,351.150869026088,63.9624090228598
9.7,"random_instances_SVM","SVM",67,2,2484,2260,224,300,264,36,0.793439469641057,0.229007633587786,1.2348682590495,101,36,65,33,1.8,10.78,7.3,0,0,0,0,0,0,0.139770690190466,299.821111687826,18.8100011586606
9.7,"random_instances_SVM","SVM",67,3,2384,2171,213,400,353,47,0.776484678385206,0.206106870229008,1.26426988426496,127,47,80,26,1.7,14.37,7.5,0,0,0,0,0,0,0.173248299890629,299.761052678776,33.3923536885061
9.7,"random_instances_SVM","SVM",67,4,2284,2081,203,500,443,57,0.770320949419917,0.175572519083969,1.26426988426496,166,57,109,39,1.9,17.96,7.8,0,0,0,0,0,0,0.158042798406772,272.941844894056,22.6532062301615
9.7,"random_instances_SVM","SVM",67,5,2184,1986,198,600,538,62,0.788491549823977,0.198473282442748,1.27407042600345,174,62,112,8,1.8,21.55,8.7,0,0,0,0,0,0,0.127547526259534,229.22354549863,16.9412662295621
9.7,"random_instances_SVM","SVM",67,6,2084,1897,187,700,627,73,0.786386566821113,0.229007633587786,1.28387096774194,204,73,131,30,1.8,25.14,8.6,0,0,0,0,0,0,0.214881151738668,230.70882148162,33.889767086545
9.7,"random_instances_SVM","SVM",67,7,1984,1806,178,800,718,82,0.747819406975478,0.16030534351145,1.27407042600345,248,82,166,44,2,28.74,8.8,0,0,0,0,0,0,0.153409012446361,225.115543124597,21.6714184129696
9.7,"random_instances_SVM","SVM",67,8,1884,1714,170,900,810,90,0.775462430892443,0.122137404580153,1.28387096774194,266,90,176,18,2,32.33,9,0,0,0,0,0,0,0.179948851660039,191.142964476856,30.2524061394084
9.7,"random_instances_SVM","SVM",67,9,1784,1624,160,1000,900,100,0.758997592576907,0.145038167938931,1.28387096774194,310,100,210,44,2.1,35.92,9,0,0,0,0,0,0,0.135171881758888,179.191061937271,19.3767675563115
9.7,"random_instances_SVM","SVM",67,10,1684,1535,149,1100,989,111,0.760775940286228,0.152671755725191,1.28387096774194,326,111,215,16,1.9,39.51,8.9,0,0,0,0,0,0,0.144307576348585,167.655612161278,18.912487639676
9.7,"random_instances_SVM","SVM",67,11,1584,1440,144,1200,1084,116,0.748127895863824,0.137404580152672,1.26426988426496,341,116,225,15,1.9,43.1,9.3,0,0,0,0,0,0,0.158989391404659,160.620703083652,24.8153791047746
9.7,"random_instances_SVM","SVM",67,12,1484,1350,134,1300,1174,126,0.727398652326971,0.083969465648855,1.28387096774194,361,126,235,20,1.9,46.7,9.3,0,0,0,0,0,0,0.169543161478895,147.871715149192,26.7037133197343
9.7,"random_instances_SVM","SVM",67,13,1384,1255,129,1400,1269,131,0.743240464064067,0.122137404580153,1.28387096774194,381,131,250,20,1.9,50.29,9.7,0,0,0,0,0,0,0.14496856050563,130.393915839065,20.6534536317418
9.7,"random_instances_SVM","SVM",67,14,1284,1163,121,1500,1361,139,0.711550791788144,0.129770992366412,1.27407042600345,405,139,266,24,1.9,53.88,9.8,0,0,0,0,0,0,0.156188635552873,127.084307467331,23.6081048829227
9.7,"random_instances_SVM","SVM",67,15,1184,1069,115,1600,1455,145,0.759971449655818,0.16793893129771,1.26426988426496,412,145,267,7,1.8,57.47,10,0,0,0,0,0,0,0.163318512367233,117.938733689995,22.4622307532425
9.7,"random_instances_SVM","SVM",67,16,1084,973,111,1700,1551,149,0.760697305863706,0.145038167938931,1.28387096774194,441,149,292,29,2,61.06,10.4,0,0,0,0,0,0,0.14996633079576,100.779067030848,22.653692902306
9.7,"random_instances_SVM","SVM",67,17,984,880,104,1800,1644,156,0.769528556392976,0.16793893129771,1.28387096774194,451,156,295,10,1.9,64.66,10.5,0,0,0,0,0,0,0.141384554141146,89.6802986127284,18.719914751249
9.7,"random_instances_SVM","SVM",67,18,884,790,94,1900,1734,166,0.753487134198714,0.16030534351145,1.28387096774194,480,166,314,29,1.9,68.25,10.4,0,0,0,0,0,0,0.149296213176673,82.895657591239,19.3719100034667
9.7,"random_instances_SVM","SVM",67,19,784,699,85,2000,1825,175,0.776835508885689,0.183206106870229,1.28387096774194,495,175,320,15,1.8,71.84,10.4,0,0,0,0,0,0,0.141607435017051,73.2367067586237,18.031708161638
9.7,"random_instances_SVM","SVM",67,20,684,610,74,2100,1914,186,0.7620038470379,0.16793893129771,1.28387096774194,541,186,355,46,1.9,75.43,10.3,0,0,0,0,0,0,0.136182240109074,64.6777947788753,17.5957690763453
9.7,"random_instances_SVM","SVM",67,21,584,518,66,2200,2006,194,0.83079686914022,0.282442748091603,1.28387096774194,550,194,356,9,1.8,79.02,10.3,0,0,0,0,0,0,0.163321994801818,58.0290092740849,22.9826899417888
9.7,"random_instances_SVM","SVM",67,22,484,431,53,2300,2093,207,0.810853969828577,0.290076335877863,1.28387096774194,568,207,361,18,1.7,82.61,10.1,0,0,0,0,0,0,0.152538970974931,48.6124494673567,19.354445254738
9.7,"random_instances_SVM","SVM",67,23,384,343,41,2400,2181,219,0.782327820858685,0.221374045801527,1.27407042600345,607,219,388,39,1.8,86.21,10,0,0,0,0,0,0,0.123733688570263,37.1962761045263,14.2876979530526
9.7,"random_instances_SVM","SVM",67,24,284,251,33,2500,2273,227,0.807025078331981,0.312977099236641,1.27407042600345,629,227,402,22,1.8,89.8,10,0,0,0,0,0,0,0.121229412978979,26.5640193732371,16.2929312702429
9.7,"random_instances_SVM","SVM",67,25,184,161,23,2600,2363,237,0.825238020348165,0.290076335877863,1.27407042600345,659,237,422,30,1.8,93.39,10,0,0,0,0,0,0,0.0859660567067136,17.0015059626168,13.3519462254954
9.7,"random_instances_SVM","SVM",67,26,84,76,8,2700,2448,252,0.828099103567579,0.32824427480916,1.27407042600345,698,252,446,39,1.8,96.98,9.7,0,0,0,0,0,0,0.00359256178555029,8.62898642159726,8.62898642159726
9.7,"random_instances_SVM","SVM",67,27,0,0,0,2784,2524,260,0.771911784275533,0.183206106870229,1.27407042600345,717,260,457,19,1.8,100,9.7,0,0,0,0,0,0,0,0,0
9.7,"random_instances_SVM","SVM",68,0,2684,2419,265,100,91,9,0.786807062669132,0.239316239316239,1.28387096774194,30,9,21,0,2.3,3.59,10.1,0,0,0,0,0,0,0.115505013093837,252.477713992681,11.9586933277076
9.7,"random_instances_SVM","SVM",68,1,2584,2333,251,200,177,23,0.814337003992172,0.299145299145299,1.26192445547284,59,23,36,29,1.6,7.18,7.7,0,0,0,0,0,0,0.160837241209322,279.681987577177,17.0500723833844
9.7,"random_instances_SVM","SVM",68,2,2484,2242,242,300,268,32,0.782794791415481,0.145299145299145,1.28387096774194,89,32,57,30,1.8,10.78,8.4,0,0,0,0,0,0,0.168770333595002,250.026259038013,19.7056281140105
9.7,"random_instances_SVM","SVM",68,3,2384,2151,233,400,359,41,0.788099831203279,0.145299145299145,1.28387096774194,126,41,85,37,2.1,14.37,8.8,0,0,0,0,0,0,0.184572877101191,234.690739394088,24.5316960344826
9.7,"random_instances_SVM","SVM",68,4,2284,2057,227,500,453,47,0.809527637113843,0.188034188034188,1.28387096774194,132,47,85,6,1.8,17.96,9.6,0,0,0,0,0,0,0.172295838335661,207.121563330995,24.4211955107207
9.7,"random_instances_SVM","SVM",68,5,2184,1967,217,600,543,57,0.79108726522519,0.128205128205128,1.27289771160739,154,57,97,22,1.7,21.55,9.5,0,0,0,0,0,0,0.203630399440116,201.59020539803,31.0642554432783
9.7,"random_instances_SVM","SVM",68,6,2084,1871,213,700,639,61,0.801616965410071,0.153846153846154,1.28387096774194,164,61,103,10,1.7,25.14,10.5,0,0,0,0,0,0,0.172026432958592,181.996638121983,24.4397731511838
9.7,"random_instances_SVM","SVM",68,7,1984,1781,203,800,729,71,0.781461833185972,0.179487179487179,1.28387096774194,204,71,133,40,1.9,28.74,10.3,0,0,0,0,0,0,0.169009664166291,180.62218641616,23.5705004318694
9.7,"random_instances_SVM","SVM",68,8,1884,1697,187,900,813,87,0.791803981459153,0.179487179487179,1.28387096774194,245,87,158,41,1.8,32.33,9.3,0,0,0,0,0,0,0.178358494473766,180.256701306459,21.2785405327913
9.7,"random_instances_SVM","SVM",68,9,1784,1607,177,1000,903,97,0.793230715644509,0.162393162393162,1.28387096774194,271,97,174,26,1.8,35.92,9.3,0,0,0,0,0,0,0.186219924459862,172.317730623795,23.4516068106941
9.7,"random_instances_SVM","SVM",68,10,1684,1517,167,1100,993,107,0.78809313292072,0.239316239316239,1.26192445547284,292,107,185,21,1.7,39.51,9.3,0,0,0,0,0,0,0.160634571851405,172.608612375249,19.7847759584102
9.7,"random_instances_SVM","SVM",68,11,1584,1421,163,1200,1089,111,0.795240200412619,0.230769230769231,1.26192445547284,311,111,200,19,1.8,43.1,9.8,0,0,0,0,0,0,0.133572728340911,153.689244871625,15.3164839780438
9.7,"random_instances_SVM","SVM",68,12,1484,1337,147,1300,1173,127,0.770289097875297,0.247863247863248,1.27289771160739,344,127,217,33,1.7,46.7,9.2,0,0,0,0,0,0,0.176953377119628,150.481036396847,23.9092186514264
9.7,"random_instances_SVM","SVM",68,13,1384,1250,134,1400,1260,140,0.778521287141969,0.290598290598291,1.26192445547284,356,140,216,12,1.5,50.29,9,0,0,0,0,0,0,0.1230510764938,140.037532856951,14.2293769873192
9.7,"random_instances_SVM","SVM",68,14,1284,1163,121,1500,1347,153,0.773497575221712,0.264957264957265,1.26192445547284,385,153,232,29,1.5,53.88,8.8,0,0,0,0,0,0,0.162614804010643,130.309644071498,23.2033218070911
9.7,"random_instances_SVM","SVM",68,15,1184,1074,110,1600,1436,164,0.778795916726958,0.256410256410256,1.26192445547284,422,164,258,37,1.6,57.47,8.8,0,0,0,0,0,0,0.171312743891891,126.234986486236,25.6474265722441
9.7,"random_instances_SVM","SVM",68,16,1084,981,103,1700,1529,171,0.775058275058276,0.213675213675214,1.26192445547284,464,171,293,42,1.7,61.06,8.9,0,0,0,0,0,0,0.167580551742171,112.892102447159,24.2312064143387
9.7,"random_instances_SVM","SVM",68,17,984,893,91,1800,1617,183,0.806747849851295,0.230769230769231,1.26192445547284,479,183,296,15,1.6,64.66,8.8,0,0,0,0,0,0,0.135570853893316,104.893239809384,15.3806423953269
9.7,"random_instances_SVM","SVM",68,18,884,804,80,1900,1706,194,0.807203333065405,0.256410256410256,1.26192445547284,514,194,320,35,1.6,68.25,8.8,0,0,0,0,0,0,0.165508392213214,95.1078929476472,21.4111949692668
9.7,"random_instances_SVM","SVM",68,19,784,712,72,2000,1798,202,0.792011628218524,0.230769230769231,1.26192445547284,535,202,333,21,1.6,71.84,8.9,0,0,0,0,0,0,0.170847736420407,86.0418515006121,22.328800128756
9.7,"random_instances_SVM","SVM",68,20,684,623,61,2100,1887,213,0.814611633577152,0.256410256410256,1.26192445547284,581,213,368,46,1.7,75.43,8.9,0,0,0,0,0,0,0.178116906734074,76.110685428112,23.3001046363417
9.7,"random_instances_SVM","SVM",68,21,584,531,53,2200,1979,221,0.768286311389765,0.205128205128205,1.26192445547284,603,221,382,22,1.7,79.02,9,0,0,0,0,0,0,0.152180137712255,63.4977452432748,19.9838282652766
9.7,"random_instances_SVM","SVM",68,22,484,439,45,2300,2071,229,0.766303619751893,0.196581196581197,1.26192445547284,613,229,384,10,1.7,82.61,9,0,0,0,0,0,0,0.151672458434423,53.1931569834781,19.0836919464763
9.7,"random_instances_SVM","SVM",68,23,384,351,33,2400,2159,241,0.791964740240604,0.222222222222222,1.26192445547284,652,241,411,39,1.7,86.21,9,0,0,0,0,0,0,0.145231856579792,42.2594397539656,17.5235534532467
9.7,"random_instances_SVM","SVM",68,24,284,259,25,2500,2251,249,0.803284837767591,0.256410256410256,1.26192445547284,659,249,410,7,1.6,89.8,9,0,0,0,0,0,0,0.120458903381604,29.0561731846786,14.1935040072505
9.7,"random_instances_SVM","SVM",68,25,184,166,18,2600,2344,256,0.771534978431528,0.205128205128205,1.26192445547284,696,256,440,37,1.7,93.39,9.2,0,0,0,0,0,0,0.103977246581305,20.0622117099043,15.2574774045406
9.7,"random_instances_SVM","SVM",68,26,84,75,9,2700,2435,265,0.787456796077482,0.196581196581197,1.27289771160739,716,265,451,20,1.7,96.98,9.2,0,0,0,0,0,0,3.36201351431892e-06,9.41125772893936,9.41125772893936
9.7,"random_instances_SVM","SVM",68,27,0,0,0,2784,2510,274,0.783317257455182,0.179487179487179,1.27289771160739,739,274,465,23,1.7,100,9.2,0,0,0,0,0,0,0,0,0
9.7,"random_instances_SVM","SVM",69,0,2684,2422,262,100,89,11,0.30977733466268,0.00847457627118644,0.761618370694368,34,11,23,0,2.1,3.59,8.1,0,0,0,0,0,0,0.117674086450739,298.946632966351,11.8844061056355
9.7,"random_instances_SVM","SVM",69,1,2584,2336,248,200,175,25,0.730136257892988,0.161016949152542,1.21858939311099,63,25,38,29,1.5,7.18,7,0,0,0,0,0,0,0.136870270283166,319.787112261721,13.9649388985579
9.7,"random_instances_SVM","SVM",69,2,2484,2246,238,300,265,35,0.769112662013962,0.23728813559322,1.26211044286495,86,35,51,23,1.5,10.78,7.6,0,0,0,0,0,0,0.21289134946438,267.241287497951,27.7524375673058
9.7,"random_instances_SVM","SVM",69,3,2384,2153,231,400,358,42,0.779375207710211,0.177966101694915,1.24034991798797,109,42,67,23,1.6,14.37,8.5,0,0,0,0,0,0,0.21446121835799,229.804967233928,27.9789980449899
9.7,"random_instances_SVM","SVM",69,4,2284,2061,223,500,450,50,0.775692921236294,0.186440677966102,1.25123018042646,135,50,85,26,1.7,17.96,9,0,0,0,0,0,0,0.198762638442421,241.794676734562,25.4004379328896
9.7,"random_instances_SVM","SVM",69,5,2184,1967,217,600,544,56,0.788467929544707,0.194915254237288,1.24034991798797,147,56,91,12,1.6,21.55,9.7,0,0,0,0,0,0,0.173433048819605,226.947375403767,21.1841644266515
9.7,"random_instances_SVM","SVM",69,6,2084,1872,212,700,639,61,0.792821535393824,0.228813559322034,1.26211044286495,165,61,104,18,1.7,25.14,10.5,0,0,0,0,0,0,0.197840594658234,187.951929946585,24.68257808797
9.7,"random_instances_SVM","SVM",69,7,1984,1781,203,800,730,70,0.79811232967764,0.211864406779661,1.25123018042646,196,70,126,31,1.8,28.74,10.4,0,0,0,0,0,0,0.155232650034349,187.619769326197,17.1991271799644
9.7,"random_instances_SVM","SVM",69,8,1884,1694,190,900,817,83,0.784273845131277,0.203389830508475,1.26211044286495,234,83,151,38,1.8,32.33,9.8,0,0,0,0,0,0,0.17569027999853,177.203640743143,19.9573476871825
9.7,"random_instances_SVM","SVM",69,9,1784,1603,181,1000,908,92,0.770402126952481,0.211864406779661,1.26211044286495,259,92,167,25,1.8,35.92,9.9,0,0,0,0,0,0,0.186654164184264,172.002586539907,21.5756469646621
9.7,"random_instances_SVM","SVM",69,10,1684,1518,166,1100,993,107,0.796477234961786,0.23728813559322,1.26211044286495,300,107,193,41,1.8,39.51,9.3,0,0,0,0,0,0,0.178418837353249,173.033677700506,22.5958416515234
9.7,"random_instances_SVM","SVM",69,11,1584,1423,161,1200,1088,112,0.773752077102032,0.186440677966102,1.25123018042646,319,112,207,19,1.8,43.1,9.7,0,0,0,0,0,0,0.188424947576691,163.930309320203,24.0411842071295
9.7,"random_instances_SVM","SVM",69,12,1484,1338,146,1300,1173,127,0.812469258890002,0.245762711864407,1.26211044286495,353,127,226,34,1.8,46.7,9.2,0,0,0,0,0,0,0.17914798353938,147.825698496553,21.2603987912158
9.7,"random_instances_SVM","SVM",69,13,1384,1245,139,1400,1266,134,0.76564307078764,0.194915254237288,1.26211044286495,366,134,232,13,1.7,50.29,9.4,0,0,0,0,0,0,0.171561574617399,142.676887448124,20.6469022870289
9.7,"random_instances_SVM","SVM",69,14,1284,1152,132,1500,1359,141,0.802545696244603,0.186440677966102,1.26211044286495,394,141,253,28,1.8,53.88,9.6,0,0,0,0,0,0,0.173295027033544,128.769526681353,21.2203171596275
9.7,"random_instances_SVM","SVM",69,15,1184,1061,123,1600,1450,150,0.814775672981061,0.220338983050847,1.26211044286495,415,150,265,21,1.8,57.47,9.7,0,0,0,0,0,0,0.168860177380263,116.176574652112,20.7608541282992
9.7,"random_instances_SVM","SVM",69,16,1084,967,117,1700,1544,156,0.829006314390168,0.288135593220339,1.26211044286495,439,156,283,24,1.8,61.06,9.9,0,0,0,0,0,0,0.177880931411563,100.214254124739,22.0605298028338
9.7,"random_instances_SVM","SVM",69,17,984,876,108,1800,1635,165,0.820511797939519,0.228813559322034,1.26211044286495,459,165,294,20,1.8,64.66,9.9,0,0,0,0,0,0,0.178517625516818,93.1629694917446,22.0326501848658
9.7,"random_instances_SVM","SVM",69,18,884,791,93,1900,1720,180,0.820910601528751,0.26271186440678,1.26211044286495,498,180,318,39,1.8,68.25,9.6,0,0,0,0,0,0,0.188691091961054,89.9763593556689,24.306320965608
9.7,"random_instances_SVM","SVM",69,19,784,697,87,2000,1814,186,0.832156862745101,0.296610169491525,1.26211044286495,518,186,332,20,1.8,71.84,9.8,0,0,0,0,0,0,0.171344731399208,79.3847101292331,21.7259564833358
9.7,"random_instances_SVM","SVM",69,20,684,609,75,2100,1902,198,0.806945829179133,0.254237288135593,1.26211044286495,535,198,337,17,1.7,75.43,9.6,0,0,0,0,0,0,0.171162596310709,72.7050259710994,21.3082652780033
9.7,"random_instances_SVM","SVM",69,21,584,518,66,2200,1993,207,0.762273180458628,0.203389830508475,1.27299070530344,584,207,377,49,1.8,79.02,9.6,0,0,0,0,0,0,0.136409493878451,58.7575153513036,17.3788116739734
9.7,"random_instances_SVM","SVM",69,22,484,426,58,2300,2085,215,0.762399468261884,0.152542372881356,1.27299070530344,602,215,387,18,1.8,82.61,9.7,0,0,0,0,0,0,0.126813567397257,48.2731208220267,15.3274652977949
9.7,"random_instances_SVM","SVM",69,23,384,338,46,2400,2173,227,0.739395147889668,0.127118644067797,1.26211044286495,653,227,426,51,1.9,86.21,9.6,0,0,0,0,0,0,0.125658585821985,37.8163279381545,15.8126970904597
9.7,"random_instances_SVM","SVM",69,24,284,249,35,2500,2262,238,0.746832834828849,0.144067796610169,1.27299070530344,652,238,414,-1,1.7,89.8,9.5,0,0,0,0,0,0,0.116727661484202,27.4857010622377,13.2680025245738
9.7,"random_instances_SVM","SVM",69,25,184,164,20,2600,2347,253,0.770847457627122,0.203389830508475,1.27299070530344,698,253,445,46,1.8,93.39,9.3,0,0,0,0,0,0,0.0990820574589653,18.1220112496528,13.7016889597192
9.7,"random_instances_SVM","SVM",69,26,84,78,6,2700,2433,267,0.780917248255237,0.186440677966102,1.27299070530344,733,267,466,35,1.7,96.98,9.1,0,0,0,0,0,0,0.00492266334402465,8.41339696546862,8.41339696546862
9.7,"random_instances_SVM","SVM",69,27,0,0,0,2784,2511,273,0.818963110667998,0.254237288135593,1.28387096774194,746,273,473,13,1.7,100,9.2,0,0,0,0,0,0,0,0,0
9.7,"random_instances_SVM","SVM",70,0,2684,2451,233,100,89,11,0.756597984298055,0.312925170068027,1.1615975422427,30,11,19,0,1.7,3.59,8.1,0,0,0,0,0,0,0.210631559955811,276.928108231933,39.908437797539
9.7,"random_instances_SVM","SVM",70,1,2584,2364,220,200,176,24,0.813274587523617,0.292517006802721,1.26640333552776,64,24,40,34,1.7,7.18,7.3,0,0,0,0,0,0,0.163353828918973,290.307298820424,20.0973828086866
9.7,"random_instances_SVM","SVM",70,2,2484,2278,206,300,262,38,0.762139526757731,0.156462585034014,1.25766951942067,98,38,60,34,1.6,10.78,6.9,0,0,0,0,0,0,0.198739754441063,284.878256581,27.7566560827396
9.7,"random_instances_SVM","SVM",70,3,2384,2183,201,400,357,43,0.783333879298101,0.170068027210884,1.25766951942067,123,43,80,25,1.9,14.37,8.3,0,0,0,0,0,0,0.163787357090126,239.683177224225,22.6539487600227
9.7,"random_instances_SVM","SVM",70,4,2284,2088,196,500,452,48,0.779987115231322,0.210884353741497,1.26640333552776,142,48,94,19,2,17.96,9.4,0,0,0,0,0,0,0.165843738295798,212.620366307118,20.9065743985631
9.7,"random_instances_SVM","SVM",70,5,2184,1993,191,600,547,53,0.769586486279902,0.17687074829932,1.26640333552776,155,53,102,13,1.9,21.55,10.3,0,0,0,0,0,0,0.161620179872693,197.692445641825,21.3054237104329
9.7,"random_instances_SVM","SVM",70,6,2084,1901,183,700,639,61,0.804086000371263,0.244897959183673,1.26640333552776,176,61,115,21,1.9,25.14,10.5,0,0,0,0,0,0,0.161322259339443,186.067193749999,22.0443168717806
9.7,"random_instances_SVM","SVM",70,7,1984,1812,172,800,728,72,0.805259824636117,0.26530612244898,1.26640333552776,209,72,137,33,1.9,28.74,10.1,0,0,0,0,0,0,0.158316906202024,182.564167454861,20.3964055156859
9.7,"random_instances_SVM","SVM",70,8,1884,1722,162,900,818,82,0.802590056889535,0.231292517006803,1.26640333552776,238,82,156,29,1.9,32.33,10,0,0,0,0,0,0,0.156669395020494,173.509273134998,20.3789458569093
9.7,"random_instances_SVM","SVM",70,9,1784,1632,152,1000,908,92,0.81579694478113,0.292517006802721,1.26640333552776,277,92,185,39,2,35.92,9.9,0,0,0,0,0,0,0.151457540314664,170.982177836264,18.3180773209828
9.7,"random_instances_SVM","SVM",70,10,1684,1548,136,1100,992,108,0.804642884441094,0.251700680272109,1.26640333552776,314,108,206,37,1.9,39.51,9.2,0,0,0,0,0,0,0.166193695441052,165.981434353351,21.7253232935615
9.7,"random_instances_SVM","SVM",70,11,1584,1455,129,1200,1085,115,0.785588713816181,0.204081632653061,1.26640333552776,314,115,199,0,1.7,43.1,9.4,0,0,0,0,0,0,0.192260159946605,152.363323423723,28.5800262322003
9.7,"random_instances_SVM","SVM",70,12,1484,1362,122,1300,1178,122,0.763155021238028,0.156462585034014,1.26640333552776,345,122,223,31,1.8,46.7,9.7,0,0,0,0,0,0,0.182589566334892,148.121495191179,27.2225956967922
9.7,"random_instances_SVM","SVM",70,13,1384,1273,111,1400,1267,133,0.776924252847196,0.224489795918367,1.27513715163485,364,133,231,19,1.7,50.29,9.5,0,0,0,0,0,0,0.167881553630517,140.541136876463,20.8795653363051
9.7,"random_instances_SVM","SVM",70,14,1284,1177,107,1500,1363,137,0.808415501031864,0.285714285714286,1.27513715163485,382,137,245,18,1.8,53.88,9.9,0,0,0,0,0,0,0.171777028073198,117.545820722274,21.3093619065299
9.7,"random_instances_SVM","SVM",70,15,1184,1082,102,1600,1458,142,0.728169598497499,0.170068027210884,1.27513715163485,419,142,277,37,2,57.47,10.3,0,0,0,0,0,0,0.160624483760291,110.569296109628,20.9432833171586
9.7,"random_instances_SVM","SVM",70,16,1084,986,98,1700,1554,146,0.81250477719178,0.27891156462585,1.26640333552776,454,146,308,35,2.1,61.06,10.6,0,0,0,0,0,0,0.144677136485087,97.5197585729778,16.6797538071974
9.7,"random_instances_SVM","SVM",70,17,984,892,92,1800,1648,152,0.734442733754814,0.142857142857143,1.27513715163485,466,152,314,12,2.1,64.66,10.8,0,0,0,0,0,0,0.132618837286842,88.2573698726745,16.6369669271424
9.7,"random_instances_SVM","SVM",70,18,884,801,83,1900,1739,161,0.76040335877529,0.183673469387755,1.25766951942067,473,161,312,7,1.9,68.25,10.8,0,0,0,0,0,0,0.125326406144164,76.618263954776,15.2478854379031
9.7,"random_instances_SVM","SVM",70,19,784,709,75,2000,1831,169,0.804118758257716,0.224489795918367,1.25766951942067,493,169,324,20,1.9,71.84,10.8,0,0,0,0,0,0,0.140422312757437,71.3425545701042,17.1196117370295
9.7,"random_instances_SVM","SVM",70,20,684,619,65,2100,1921,179,0.770809447374452,0.197278911564626,1.25766951942067,534,179,355,41,2,75.43,10.7,0,0,0,0,0,0,0.13288469776173,61.8405558801944,17.6317740027949
9.7,"random_instances_SVM","SVM",70,21,584,527,57,2200,2013,187,0.800837509963857,0.272108843537415,1.26640333552776,528,187,341,-6,1.8,79.02,10.8,0,0,0,0,0,0,0.138164971662543,51.9047699824375,19.3656711854521
9.7,"random_instances_SVM","SVM",70,22,484,435,49,2300,2105,195,0.771060591170652,0.210884353741497,1.27513715163485,570,195,375,42,1.9,82.61,10.8,0,0,0,0,0,0,0.135935587325947,43.2782392379958,17.5191665997335
9.7,"random_instances_SVM","SVM",70,23,384,344,40,2400,2196,204,0.792757231303431,0.244897959183673,1.27513715163485,587,204,383,17,1.9,86.21,10.8,0,0,0,0,0,0,0.12378821966504,35.4014148085572,14.9450464112399
9.7,"random_instances_SVM","SVM",70,24,284,252,32,2500,2288,212,0.761571723392399,0.197278911564626,1.27513715163485,619,212,407,32,1.9,89.8,10.8,0,0,0,0,0,0,0.120165741052954,25.5254803254894,15.8132012559582
9.7,"random_instances_SVM","SVM",70,25,184,162,22,2600,2378,222,0.754468721678074,0.19047619047619,1.26640333552776,622,222,400,3,1.8,93.39,10.7,0,0,0,0,0,0,0.097734782716738,16.5331780188327,12.479087424555
9.7,"random_instances_SVM","SVM",70,26,84,72,12,2700,2468,232,0.816932551511779,0.27891156462585,1.26640333552776,651,232,419,29,1.8,96.98,10.6,0,0,0,0,0,0,0.000130002891548948,7.42433682929917,7.42433682929917
9.7,"random_instances_SVM","SVM",70,27,0,0,0,2784,2540,244,0.75390637796049,0.163265306122449,1.27513715163485,691,244,447,40,1.8,100,10.4,0,0,0,0,0,0,0,0,0
9.7,"random_instances_SVM","SVM",71,0,2684,2429,255,100,92,8,0.832466650197633,0.2890625,1.28387096774194,25,8,17,0,2.1,3.59,11.5,0,0,0,0,0,0,0.164010624339156,225.173331902042,19.5649737162104
9.7,"random_instances_SVM","SVM",71,1,2584,2343,241,200,178,22,0.798598073122531,0.234375,1.27384072580645,63,22,41,38,1.9,7.18,8.1,0,0,0,0,0,0,0.250124756912922,287.773464315932,28.5213388696099
9.7,"random_instances_SVM","SVM",71,2,2484,2256,228,300,265,35,0.824777667984188,0.3359375,1.28387096774194,89,35,54,26,1.5,10.78,7.6,0,0,0,0,0,0,0.148484043924469,291.898325675564,15.3350394125782
9.7,"random_instances_SVM","SVM",71,3,2384,2165,219,400,356,44,0.804718379446638,0.328125,1.28387096774194,110,44,66,21,1.5,14.37,8.1,0,0,0,0,0,0,0.177448760614034,272.544269196446,19.3916667709985
9.7,"random_instances_SVM","SVM",71,4,2284,2070,214,500,451,49,0.789426877470355,0.265625,1.28387096774194,132,49,83,22,1.7,17.96,9.2,0,0,0,0,0,0,0.170131176145197,236.451079994886,19.1785000284784
9.7,"random_instances_SVM","SVM",71,5,2184,1980,204,600,541,59,0.817693922924902,0.3046875,1.28387096774194,157,59,98,25,1.7,21.55,9.2,0,0,0,0,0,0,0.209074689011533,228.503946451487,24.2030869459979
9.7,"random_instances_SVM","SVM",71,6,2084,1884,200,700,637,63,0.814433053359682,0.2421875,1.28387096774194,166,63,103,9,1.6,25.14,10.1,0,0,0,0,0,0,0.132168785291516,207.458809325933,13.8744689975523
9.7,"random_instances_SVM","SVM",71,7,1984,1794,190,800,727,73,0.817150444664033,0.2578125,1.27384072580645,203,73,130,37,1.8,28.74,10,0,0,0,0,0,0,0.164743424949142,189.040450068056,17.9998207569997
9.7,"random_instances_SVM","SVM",71,8,1884,1703,181,900,818,82,0.811715662055337,0.2109375,1.27384072580645,227,82,145,24,1.8,32.33,10,0,0,0,0,0,0,0.181800720300607,168.355399192949,20.7512457835383
9.7,"random_instances_SVM","SVM",71,9,1784,1615,169,1000,906,94,0.774431818181821,0.21875,1.27384072580645,259,94,165,32,1.8,35.92,9.6,0,0,0,0,0,0,0.153819313444554,179.491798107813,19.7558960346
9.7,"random_instances_SVM","SVM",71,10,1684,1521,163,1100,1000,100,0.807522233201582,0.2421875,1.27384072580645,265,100,165,6,1.6,39.51,10,0,0,0,0,0,0,0.232891198766927,155.651387755415,32.0097428538537
9.7,"random_instances_SVM","SVM",71,11,1584,1431,153,1200,1090,110,0.804798666007908,0.28125,1.27384072580645,298,110,188,33,1.7,43.1,9.9,0,0,0,0,0,0,0.156099014106622,150.080188721625,19.0417436004363
9.7,"random_instances_SVM","SVM",71,12,1484,1341,143,1300,1180,120,0.803415266798422,0.2578125,1.25378024193548,320,120,200,22,1.7,46.7,9.8,0,0,0,0,0,0,0.198995998461925,142.465535091014,26.9581362557605
9.7,"random_instances_SVM","SVM",71,13,1384,1250,134,1400,1271,129,0.793033596837944,0.2109375,1.27384072580645,362,129,233,42,1.8,50.29,9.9,0,0,0,0,0,0,0.160037300212115,129.237582178366,20.6705067610457
9.7,"random_instances_SVM","SVM",71,14,1284,1163,121,1500,1358,142,0.790909090909092,0.2734375,1.28387096774194,376,142,234,14,1.6,53.88,9.6,0,0,0,0,0,0,0.180747026857679,128.962502743645,28.2253807782787
9.7,"random_instances_SVM","SVM",71,15,1184,1069,115,1600,1452,148,0.784770256916996,0.234375,1.28387096774194,405,148,257,29,1.7,57.47,9.8,0,0,0,0,0,0,0.160411766156528,111.914584660093,20.2425358907073
9.7,"random_instances_SVM","SVM",71,16,1084,973,111,1700,1548,152,0.794188488142296,0.2109375,1.27384072580645,422,152,270,17,1.8,61.06,10.2,0,0,0,0,0,0,0.170056441294715,102.826133082119,20.9936657349693
9.7,"random_instances_SVM","SVM",71,17,984,887,97,1800,1634,166,0.770361907114621,0.2109375,1.26381048387097,461,166,295,39,1.8,64.66,9.8,0,0,0,0,0,0,0.154061012700688,91.2470345924815,20.1355722039266
9.7,"random_instances_SVM","SVM",71,18,884,795,89,1900,1726,174,0.81444540513834,0.25,1.28387096774194,483,174,309,22,1.8,68.25,9.9,0,0,0,0,0,0,0.152176951904405,83.8819772246404,17.9268548535434
9.7,"random_instances_SVM","SVM",71,19,784,704,80,2000,1817,183,0.811394515810276,0.234375,1.27384072580645,501,183,318,18,1.7,71.84,9.9,0,0,0,0,0,0,0.161590824659855,77.6273089224701,19.6232017017029
9.7,"random_instances_SVM","SVM",71,20,684,615,69,2100,1906,194,0.786876235177864,0.2265625,1.27384072580645,531,194,337,30,1.7,75.43,9.8,0,0,0,0,0,0,0.138505012839216,68.5341948243974,16.4858075865502
9.7,"random_instances_SVM","SVM",71,21,584,524,60,2200,1997,203,0.807701333992097,0.2578125,1.26381048387097,545,203,342,14,1.7,79.02,9.8,0,0,0,0,0,0,0.178793240100162,63.7433651398851,23.7466028091634
9.7,"random_instances_SVM","SVM",71,22,484,434,50,2300,2087,213,0.805088932806322,0.21875,1.27384072580645,571,213,358,26,1.7,82.61,9.8,0,0,0,0,0,0,0.163380211840501,47.8960692746411,20.4900466384923
9.7,"random_instances_SVM","SVM",71,23,384,344,40,2400,2177,223,0.808541254940713,0.1875,1.28387096774194,599,223,376,28,1.7,86.21,9.8,0,0,0,0,0,0,0.152960124892256,38.5734099539128,18.5486258633088
9.7,"random_instances_SVM","SVM",71,24,284,252,32,2500,2269,231,0.748060770750987,0.1484375,1.27384072580645,628,231,397,29,1.7,89.8,9.8,0,0,0,0,0,0,0.134198409564868,30.0796487764133,16.1426954776597
9.7,"random_instances_SVM","SVM",71,25,184,169,15,2600,2352,248,0.795127223320157,0.234375,1.28387096774194,656,248,408,28,1.6,93.39,9.5,0,0,0,0,0,0,0.0994082465363949,18.6537348901201,15.2651280050774
9.7,"random_instances_SVM","SVM",71,26,84,78,6,2700,2443,257,0.822819911067195,0.296875,1.27384072580645,684,257,427,28,1.7,96.98,9.5,0,0,0,0,0,0,1.10561411894255e-06,8.46460055976141,8.46460055976141
9.7,"random_instances_SVM","SVM",71,27,0,0,0,2784,2521,263,0.763938982213439,0.15625,1.27384072580645,706,263,443,22,1.7,100,9.6,0,0,0,0,0,0,0,0,0
9.7,"random_instances_SVM","SVM",72,0,2684,2435,249,100,92,8,0.765082451128004,0.402985074626866,1.16889744824266,23,8,15,0,1.9,3.59,11.5,0,0,0,0,0,0,0.183956310791592,237.801719544191,20.7890209908655
9.7,"random_instances_SVM","SVM",72,1,2584,2349,235,200,178,22,0.824932130451793,0.41044776119403,1.25512758786712,51,22,29,28,1.3,7.18,8.1,0,0,0,0,0,0,0.348904237895637,273.615372434754,39.7004696047864
9.7,"random_instances_SVM","SVM",72,2,2484,2255,229,300,272,28,0.826994890519604,0.328358208955224,1.274289841117,76,28,48,25,1.7,10.78,9.7,0,0,0,0,0,0,0.124514782944272,245.604242016724,13.5890395484096
9.7,"random_instances_SVM","SVM",72,3,2384,2169,215,400,358,42,0.81004232214622,0.253731343283582,1.25512758786712,113,42,71,37,1.7,14.37,8.5,0,0,0,0,0,0,0.161605517302924,277.507835016668,19.0636841961067
9.7,"random_instances_SVM","SVM",72,4,2284,2077,207,500,450,50,0.791264092563395,0.253731343283582,1.274289841117,149,50,99,36,2,17.96,9,0,0,0,0,0,0,0.144744654090098,245.99863549966,17.1068569018094
9.7,"random_instances_SVM","SVM",72,5,2184,1984,200,600,543,57,0.803130890424766,0.253731343283582,1.26470871449206,161,57,104,12,1.8,21.55,9.5,0,0,0,0,0,0,0.211292577113634,208.505224774204,30.9106870386067
9.7,"random_instances_SVM","SVM",72,6,2084,1894,190,700,633,67,0.803563595841289,0.238805970149254,1.274289841117,196,67,129,35,1.9,25.14,9.4,0,0,0,0,0,0,0.177687871054141,211.353025354058,27.3183566093257
9.7,"random_instances_SVM","SVM",72,7,1984,1802,182,800,725,75,0.808222588408241,0.23134328358209,1.27311646188945,211,75,136,15,1.8,28.74,9.7,0,0,0,0,0,0,0.171421840434585,199.203233737991,26.5124561557592
9.7,"random_instances_SVM","SVM",72,8,1884,1713,171,900,814,86,0.808756060839571,0.246268656716418,1.274289841117,233,86,147,22,1.7,32.33,9.5,0,0,0,0,0,0,0.181744344626551,188.659805708659,28.6785223524587
9.7,"random_instances_SVM","SVM",72,9,1784,1619,165,1000,908,92,0.7903334795443,0.261194029850746,1.274289841117,249,92,157,16,1.7,35.92,9.9,0,0,0,0,0,0,0.160361478445489,185.336987305662,21.08771039771
9.7,"random_instances_SVM","SVM",72,10,1684,1526,158,1100,1001,99,0.778680070655465,0.216417910447761,1.274289841117,278,99,179,29,1.8,39.51,10.1,0,0,0,0,0,0,0.177654464240832,158.27114686152,26.2902432531663
9.7,"random_instances_SVM","SVM",72,11,1584,1434,150,1200,1093,107,0.758022832620068,0.26865671641791,1.23596533461724,316,107,209,38,2,43.1,10.2,0,0,0,0,0,0,0.153328481725341,157.275372186749,22.3803815753627
9.7,"random_instances_SVM","SVM",72,12,1484,1346,138,1300,1181,119,0.813349851220468,0.328358208955224,1.26470871449206,347,119,228,31,1.9,46.7,9.9,0,0,0,0,0,0,0.132709205238404,140.107558882245,17.906444114194
9.7,"random_instances_SVM","SVM",72,13,1384,1258,126,1400,1269,131,0.818447476675405,0.373134328358209,1.24554646124218,364,131,233,17,1.8,50.29,9.7,0,0,0,0,0,0,0.126305598402199,132.623646779906,16.9359344624171
9.7,"random_instances_SVM","SVM",72,14,1284,1166,118,1500,1361,139,0.811524190011025,0.32089552238806,1.24554646124218,391,139,252,27,1.8,53.88,9.8,0,0,0,0,0,0,0.143788422466028,122.451029731324,22.129153791059
9.7,"random_instances_SVM","SVM",72,15,1184,1075,109,1600,1452,148,0.8372731260299,0.350746268656716,1.26470871449206,429,148,281,38,1.9,57.47,9.8,0,0,0,0,0,0,0.147734967498241,113.563660062943,21.117133726697
9.7,"random_instances_SVM","SVM",72,16,1084,987,97,1700,1540,160,0.786735504368548,0.283582089552239,1.274289841117,457,160,297,28,1.9,61.06,9.6,0,0,0,0,0,0,0.142666483723254,104.515777227139,19.414716969278
9.7,"random_instances_SVM","SVM",72,17,984,898,86,1800,1629,171,0.774750157077997,0.26865671641791,1.25512758786712,490,171,319,33,1.9,64.66,9.5,0,0,0,0,0,0,0.144693846899219,96.788244519382,19.5659629904536
9.7,"random_instances_SVM","SVM",72,18,884,808,76,1900,1719,181,0.824943985394714,0.335820895522388,1.26470871449206,506,181,325,16,1.8,68.25,9.5,0,0,0,0,0,0,0.158421002960936,86.952952515693,21.3536321290301
9.7,"random_instances_SVM","SVM",72,19,784,717,67,2000,1810,190,0.761733429753541,0.246268656716418,1.25512758786712,533,190,343,27,1.8,71.84,9.5,0,0,0,0,0,0,0.145969314071039,77.3136589733289,18.80310662597
9.7,"random_instances_SVM","SVM",72,20,684,624,60,2100,1903,197,0.811844273469828,0.26865671641791,1.274289841117,557,197,360,24,1.8,75.43,9.7,0,0,0,0,0,0,0.162107209345735,66.9223938546397,21.9200286357697
9.7,"random_instances_SVM","SVM",72,21,584,531,53,2200,1996,204,0.816639597880338,0.276119402985075,1.274289841117,603,204,399,46,2,79.02,9.8,0,0,0,0,0,0,0.151231512445527,60.0816396860042,17.5544941985996
9.7,"random_instances_SVM","SVM",72,22,484,440,44,2300,2087,213,0.748758194729295,0.17910447761194,1.274289841117,606,213,393,3,1.8,82.61,9.8,0,0,0,0,0,0,0.13353540990512,49.2705106952905,15.1382277910107
9.7,"random_instances_SVM","SVM",72,23,384,347,37,2400,2180,220,0.739997391912559,0.149253731343284,1.274289841117,642,220,422,36,1.9,86.21,9.9,0,0,0,0,0,0,0.132660284327909,40.6957999738793,15.2994546663837
9.7,"random_instances_SVM","SVM",72,24,284,253,31,2500,2274,226,0.834617618816167,0.335820895522388,1.274289841117,636,226,410,-6,1.8,89.8,10.1,0,0,0,0,0,0,0.121247286362886,27.3924659885689,14.6358035711349
9.7,"random_instances_SVM","SVM",72,25,184,163,21,2600,2364,236,0.722054935805487,0.164179104477612,1.26470871449206,667,236,431,31,1.8,93.39,10,0,0,0,0,0,0,0.110852350886028,18.8644921374562,13.3431053017173
9.7,"random_instances_SVM","SVM",72,26,84,74,10,2700,2453,247,0.795466669827987,0.253731343283582,1.274289841117,706,247,459,39,1.9,96.98,9.9,0,0,0,0,0,0,1.0000000994736e-07,8.4739822358554,8.4739822358554
9.7,"random_instances_SVM","SVM",72,27,0,0,0,2784,2527,257,0.764003651322422,0.17910447761194,1.274289841117,724,257,467,18,1.8,100,9.8,0,0,0,0,0,0,0,0,0
9.7,"random_instances_SVM","SVM",73,0,2684,2422,262,100,94,6,0.777895141156136,0.268292682926829,1.16905323891949,17,6,11,0,1.8,3.59,15.7,0,0,0,0,0,0,0.100766834096552,132.63394313404,23.6452244156541
9.7,"random_instances_SVM","SVM",73,1,2584,2336,248,200,180,20,0.763286601369953,0.292682926829268,1.1481772882245,51,20,31,34,1.6,7.18,9,0,0,0,0,0,0,0.218671788533594,234.930550081019,46.1067565697136
9.7,"random_instances_SVM","SVM",73,2,2484,2246,238,300,270,30,0.80912553613725,0.235772357723577,1.28268876611418,80,30,50,29,1.7,10.78,9,0,0,0,0,0,0,0.293080868101953,214.130009486318,41.0793742769123
9.7,"random_instances_SVM","SVM",73,3,2384,2158,226,400,358,42,0.761455732667566,0.195121951219512,1.27343299239444,115,42,73,35,1.7,14.37,8.5,0,0,0,0,0,0,0.240215458574804,258.825550214478,34.5591560482484
9.7,"random_instances_SVM","SVM",73,4,2284,2067,217,500,449,51,0.767671723961332,0.252032520325203,1.22124311565696,138,51,87,23,1.7,17.96,8.8,0,0,0,0,0,0,0.257863946794252,228.532046404755,39.5967754631365
9.7,"random_instances_SVM","SVM",73,5,2184,1979,205,600,537,63,0.761161257281866,0.268292682926829,1.20036716496197,159,63,96,21,1.5,21.55,8.5,0,0,0,0,0,0,0.317629791628771,231.269967301857,49.0473699816915
9.7,"random_instances_SVM","SVM",73,6,2084,1885,199,700,631,69,0.763273798092313,0.276422764227642,1.18992918961448,175,69,106,16,1.5,25.14,9.1,0,0,0,0,0,0,0.272892296951393,217.078227110296,42.2193253758713
9.7,"random_instances_SVM","SVM",73,7,1984,1795,189,800,721,79,0.761026822866651,0.252032520325203,1.15861526357199,204,79,125,29,1.6,28.74,9.1,0,0,0,0,0,0,0.299915556134724,205.734186661457,48.6571223095606
9.7,"random_instances_SVM","SVM",73,8,1884,1706,178,900,810,90,0.714422892260416,0.252032520325203,1.1481772882245,233,90,143,29,1.6,32.33,9,0,0,0,0,0,0,0.243360063795734,194.840285118866,42.4565004376976
9.7,"random_instances_SVM","SVM",73,9,1784,1612,172,1000,904,96,0.732917226810062,0.260162601626016,1.1481772882245,260,96,164,27,1.7,35.92,9.4,0,0,0,0,0,0,0.191539724002151,183.247656621397,33.7133514391065
9.7,"random_instances_SVM","SVM",73,10,1684,1524,160,1100,992,108,0.774009346392675,0.292682926829268,1.16905323891949,282,108,174,22,1.6,39.51,9.2,0,0,0,0,0,0,0.218353229859638,180.498888598772,35.218830023386
9.7,"random_instances_SVM","SVM",73,11,1584,1430,154,1200,1086,114,0.767204404327504,0.235772357723577,1.17949121426698,317,114,203,35,1.8,43.1,9.5,0,0,0,0,0,0,0.213942441042747,154.399235978531,35.3696270157005
9.7,"random_instances_SVM","SVM",73,12,1484,1341,143,1300,1175,125,0.778925805006087,0.24390243902439,1.24211906635195,337,125,212,20,1.7,46.7,9.4,0,0,0,0,0,0,0.189382836705355,152.649002825427,26.3108006868719
9.7,"random_instances_SVM","SVM",73,13,1384,1251,133,1400,1265,135,0.777421419883497,0.284552845528455,1.22124311565696,370,135,235,33,1.7,50.29,9.4,0,0,0,0,0,0,0.200151813511991,136.716571052019,29.5311523444898
9.7,"random_instances_SVM","SVM",73,14,1284,1158,126,1500,1358,142,0.760431470456443,0.211382113821138,1.26299501704694,400,142,258,30,1.8,53.88,9.6,0,0,0,0,0,0,0.194063068118938,131.232289602636,27.6965067012668
9.7,"random_instances_SVM","SVM",73,15,1184,1071,113,1600,1445,155,0.731937776070679,0.203252032520325,1.25255704169945,437,155,282,37,1.8,57.47,9.3,0,0,0,0,0,0,0.198839872632426,120.077006875291,29.3548852210067
9.7,"random_instances_SVM","SVM",73,16,1084,980,104,1700,1536,164,0.770507649958395,0.276422764227642,1.25255704169945,447,164,283,10,1.7,61.06,9.4,0,0,0,0,0,0,0.197605959765237,106.918120282627,26.4888145075985
9.7,"random_instances_SVM","SVM",73,17,984,891,93,1800,1625,175,0.805300556942578,0.300813008130081,1.26299501704694,486,175,311,39,1.8,64.66,9.3,0,0,0,0,0,0,0.201603110011046,101.068784671184,26.3784029467686
9.7,"random_instances_SVM","SVM",73,18,884,800,84,1900,1716,184,0.816439408488579,0.32520325203252,1.26299501704694,505,184,321,19,1.7,68.25,9.3,0,0,0,0,0,0,0.20321311020969,84.8479176942739,28.2246075894427
9.7,"random_instances_SVM","SVM",73,19,784,710,74,2000,1806,194,0.778119198514821,0.252032520325203,1.25255704169945,539,194,345,34,1.8,71.84,9.3,0,0,0,0,0,0,0.19222748063628,76.6555421262306,25.9166476462234
9.7,"random_instances_SVM","SVM",73,20,684,619,65,2100,1897,203,0.809820113949183,0.292682926829268,1.27343299239444,557,203,354,18,1.7,75.43,9.3,0,0,0,0,0,0,0.185547246460143,65.946242115676,25.3334467496695
9.7,"random_instances_SVM","SVM",73,21,584,523,61,2200,1993,207,0.746322258498185,0.178861788617886,1.26299501704694,589,207,382,32,1.8,79.02,9.6,0,0,0,0,0,0,0.158341093555842,58.4115135502452,22.6654136177444
9.7,"random_instances_SVM","SVM",73,22,484,441,43,2300,2075,225,0.744561807822803,0.186991869918699,1.25255704169945,605,225,380,16,1.7,82.61,9.2,0,0,0,0,0,0,0.146881108250094,51.5773271403855,19.2937206520126
9.7,"random_instances_SVM","SVM",73,23,384,351,33,2400,2165,235,0.743031816144938,0.178861788617886,1.26299501704694,651,235,416,46,1.8,86.21,9.2,0,0,0,0,0,0,0.134116249393992,40.1531734651949,16.3612103218289
9.7,"random_instances_SVM","SVM",73,24,284,256,28,2500,2260,240,0.793918443121445,0.252032520325203,1.27343299239444,663,240,423,12,1.8,89.8,9.4,0,0,0,0,0,0,0.127807863340814,28.1113372268962,17.4698751589539
9.7,"random_instances_SVM","SVM",73,25,184,168,16,2600,2348,252,0.76414442097177,0.219512195121951,1.27343299239444,711,252,459,48,1.8,93.39,9.3,0,0,0,0,0,0,0.0926009832891347,17.8916294662604,14.7591421891556
9.7,"random_instances_SVM","SVM",73,26,84,77,7,2700,2439,261,0.785103386466937,0.235772357723577,1.28387096774194,737,261,476,26,1.8,96.98,9.3,0,0,0,0,0,0,0.000257121482602573,8.59927612115336,8.59927612115336
9.7,"random_instances_SVM","SVM",73,27,0,0,0,2784,2516,268,0.786153255233344,0.219512195121951,1.27343299239444,755,268,487,18,1.8,100,9.4,0,0,0,0,0,0,0,0,0
9.7,"random_instances_SVM","SVM",74,0,2684,2436,248,100,90,10,0.760651629072687,0.330827067669173,1.22595197671598,32,10,22,0,2.2,3.59,9,0,0,0,0,0,0,0.116712668439825,276.505814757635,12.2512360675907
9.7,"random_instances_SVM","SVM",74,1,2584,2350,234,200,176,24,0.818632891753194,0.360902255639098,1.27304448967723,66,24,42,34,1.8,7.18,7.3,0,0,0,0,0,0,0.265269673281686,315.248270806424,33.0395619994872
9.7,"random_instances_SVM","SVM",74,2,2484,2257,227,300,269,31,0.780827067669179,0.398496240601504,1.19699248120301,89,31,58,23,1.9,10.78,8.7,0,0,0,0,0,0,0.197905446689444,269.182907495276,27.3108862832668
9.7,"random_instances_SVM","SVM",74,3,2384,2165,219,400,361,39,0.737826709631226,0.293233082706767,1.19699248120301,110,39,71,21,1.8,14.37,9.3,0,0,0,0,0,0,0.140957598992452,237.574665366442,17.3709292246925
9.7,"random_instances_SVM","SVM",74,4,2284,2069,215,500,457,43,0.72867287265784,0.300751879699248,1.14872665534805,123,43,80,13,1.9,17.96,10.6,0,0,0,0,0,0,0.213668348755706,222.15587873218,36.9925107240495
9.7,"random_instances_SVM","SVM",74,5,2184,1979,205,600,547,53,0.773952738990333,0.360902255639098,1.21629881154499,141,53,88,18,1.7,21.55,10.3,0,0,0,0,0,0,0.20945724480363,219.098143075386,30.4197929698758
9.7,"random_instances_SVM","SVM",74,6,2084,1890,194,700,636,64,0.798842343955132,0.285714285714286,1.26456463739995,172,64,108,31,1.7,25.14,9.9,0,0,0,0,0,0,0.164255472426551,206.92093858243,24.1513036592477
9.7,"random_instances_SVM","SVM",74,7,1984,1799,185,800,727,73,0.796163026614155,0.218045112781955,1.26456463739995,195,73,122,23,1.7,28.74,10,0,0,0,0,0,0,0.179610239752874,196.502593084793,31.379596897342
9.7,"random_instances_SVM","SVM",74,8,1884,1713,171,900,813,87,0.783619763694958,0.210526315789474,1.25491147222896,230,87,143,35,1.6,32.33,9.3,0,0,0,0,0,0,0.189037383775466,198.711821589982,31.9687009892664
9.7,"random_instances_SVM","SVM",74,9,1784,1618,166,1000,908,92,0.796735887337396,0.270676691729323,1.24525830705797,253,92,161,23,1.8,35.92,9.9,0,0,0,0,0,0,0.190940630228642,180.900636104039,33.0047771513665
9.7,"random_instances_SVM","SVM",74,10,1684,1524,160,1100,1002,98,0.79133548156105,0.255639097744361,1.26456463739995,271,98,173,18,1.8,39.51,10.2,0,0,0,0,0,0,0.191509686992536,168.593240489915,30.0815536285027
9.7,"random_instances_SVM","SVM",74,11,1584,1428,156,1200,1098,102,0.796473326172586,0.24812030075188,1.27421780257094,304,102,202,33,2,43.1,10.8,0,0,0,0,0,0,0.148785177036277,147.241627108537,20.3673611768093
9.7,"random_instances_SVM","SVM",74,12,1484,1338,146,1300,1188,112,0.770855710705337,0.255639097744361,1.26456463739995,338,112,226,34,2,46.7,10.6,0,0,0,0,0,0,0.146594958330723,137.004563925688,20.0668741480152
9.7,"random_instances_SVM","SVM",74,13,1384,1249,135,1400,1277,123,0.792815371762748,0.24812030075188,1.26456463739995,357,123,234,19,1.9,50.29,10.4,0,0,0,0,0,0,0.140726705584239,126.54631559584,18.6778037733914
9.7,"random_instances_SVM","SVM",74,14,1284,1160,124,1500,1366,134,0.74767872061106,0.24812030075188,1.25491147222896,405,134,271,48,2,53.88,10.2,0,0,0,0,0,0,0.147005427266861,122.533181328025,20.4097152675372
9.7,"random_instances_SVM","SVM",74,15,1184,1071,113,1600,1455,145,0.746861200620608,0.195488721804511,1.25491147222896,414,145,269,9,1.9,57.47,10,0,0,0,0,0,0,0.167806042570549,115.642138235703,25.9739579354359
9.7,"random_instances_SVM","SVM",74,16,1084,977,107,1700,1549,151,0.753825038787452,0.195488721804511,1.26456463739995,444,151,293,30,1.9,61.06,10.3,0,0,0,0,0,0,0.153747908931988,105.749374119628,23.1405696651602
9.7,"random_instances_SVM","SVM",74,17,984,888,96,1800,1638,162,0.777789712376181,0.233082706766917,1.25491147222896,482,162,320,38,2,64.66,10.1,0,0,0,0,0,0,0.168650505282388,95.9108391111561,24.6130643261919
9.7,"random_instances_SVM","SVM",74,18,884,802,82,1900,1724,176,0.760842582647098,0.203007518796992,1.27421780257094,512,176,336,30,1.9,68.25,9.8,0,0,0,0,0,0,0.149282909271689,90.9676724977304,19.3035006102994
9.7,"random_instances_SVM","SVM",74,19,784,707,77,2000,1819,181,0.800620599116838,0.263157894736842,1.28387096774194,537,181,356,25,2,71.84,10,0,0,0,0,0,0,0.140681719183271,77.0086529823144,17.3442196115759
9.7,"random_instances_SVM","SVM",74,20,684,620,64,2100,1906,194,0.831179138321994,0.330827067669173,1.28387096774194,538,194,344,1,1.8,75.43,9.8,0,0,0,0,0,0,0.165191710818036,65.8578623085687,21.8315014806115
9.7,"random_instances_SVM","SVM",74,21,584,525,59,2200,2001,199,0.738095238095238,0.150375939849624,1.27421780257094,552,199,353,14,1.8,79.02,10.1,0,0,0,0,0,0,0.124725249777993,55.8556372331318,16.5934163980528
9.7,"random_instances_SVM","SVM",74,22,484,437,47,2300,2089,211,0.76830170664757,0.142857142857143,1.28387096774194,570,211,359,18,1.7,82.61,9.9,0,0,0,0,0,0,0.130955801463828,48.9015403387285,18.0726363292469
9.7,"random_instances_SVM","SVM",74,23,384,348,36,2400,2178,222,0.770348490273301,0.180451127819549,1.27421780257094,614,222,392,44,1.8,86.21,9.8,0,0,0,0,0,0,0.136729605882347,41.2659208259864,18.79281309274
9.7,"random_instances_SVM","SVM",74,24,284,252,32,2500,2274,226,0.777037832676929,0.203007518796992,1.28387096774194,625,226,399,11,1.8,89.8,10.1,0,0,0,0,0,0,0.116088744926553,28.3311787133288,14.233430159081
9.7,"random_instances_SVM","SVM",74,25,184,168,16,2600,2358,242,0.702261606396943,0.12781954887218,1.26456463739995,667,242,425,42,1.8,93.39,9.7,0,0,0,0,0,0,0.10774204575139,19.193845974532,14.5503712494129
9.7,"random_instances_SVM","SVM",74,26,84,79,5,2700,2447,253,0.767096312209094,0.203007518796992,1.27421780257094,685,253,432,18,1.7,96.98,9.7,0,0,0,0,0,0,1.65217660862145e-06,9.63912406447769,9.63912406447769
9.7,"random_instances_SVM","SVM",74,27,0,0,0,2784,2526,258,0.792284282133912,0.24812030075188,1.27421780257094,729,258,471,44,1.8,100,9.8,0,0,0,0,0,0,0,0,0
9.7,"random_instances_SVM","SVM",75,0,2684,2447,237,100,84,16,0.798775910849364,0.326086956521739,1.20014025245442,36,16,20,0,1.2,3.59,5.2,0,0,0,0,0,0,0.38505500568569,426.791505983714,40.9887309005556
9.7,"random_instances_SVM","SVM",75,1,2584,2360,224,200,171,29,0.778457185749762,0.297101449275362,1.22805049088359,64,29,35,28,1.2,7.18,5.9,0,0,0,0,0,0,0.301170961936189,328.734550202443,32.0268293897015
9.7,"random_instances_SVM","SVM",75,2,2484,2271,213,300,260,40,0.772140423812005,0.355072463768116,1.20014025245442,86,40,46,22,1.1,10.78,6.5,0,0,0,0,0,0,0.302905954367627,273.024957258008,32.725572196421
9.7,"random_instances_SVM","SVM",75,3,2384,2180,204,400,351,49,0.817939834863446,0.355072463768116,1.27456755493221,113,49,64,27,1.3,14.37,7.2,0,0,0,0,0,0,0.2173645279939,249.92763375444,24.300229713399
9.7,"random_instances_SVM","SVM",75,4,2284,2087,197,500,444,56,0.825128471620765,0.326086956521739,1.28387096774194,123,56,67,10,1.2,17.96,7.9,0,0,0,0,0,0,0.281282367696672,224.557507764404,32.1670426414087
9.7,"random_instances_SVM","SVM",75,5,2184,1993,191,600,538,62,0.837912119637397,0.289855072463768,1.27456755493221,152,62,90,29,1.5,21.55,8.7,0,0,0,0,0,0,0.171812156163651,198.462273008335,19.5257886009769
9.7,"random_instances_SVM","SVM",75,6,2084,1903,181,700,628,72,0.835920087764885,0.289855072463768,1.28387096774194,176,72,104,24,1.4,25.14,8.7,0,0,0,0,0,0,0.212955380474314,212.818998620815,27.7699236366583
9.7,"random_instances_SVM","SVM",75,7,1984,1809,175,800,722,78,0.828211790519086,0.260869565217391,1.28387096774194,204,78,126,28,1.6,28.74,9.3,0,0,0,0,0,0,0.239630685769129,198.359955889763,35.1163888823126
9.7,"random_instances_SVM","SVM",75,8,1884,1718,166,900,813,87,0.822039378717017,0.304347826086957,1.28387096774194,225,87,138,21,1.6,32.33,9.3,0,0,0,0,0,0,0.164432290479012,168.65879347847,20.3689029767475
9.7,"random_instances_SVM","SVM",75,9,1784,1625,159,1000,906,94,0.825174663664185,0.297101449275362,1.28387096774194,238,94,144,13,1.5,35.92,9.6,0,0,0,0,0,0,0.17941823194293,163.400984112391,23.7738768678494
9.7,"random_instances_SVM","SVM",75,10,1684,1536,148,1100,995,105,0.834378428315724,0.304347826086957,1.28387096774194,270,105,165,32,1.6,39.51,9.5,0,0,0,0,0,0,0.212049536015297,157.105085979594,29.2463579404487
9.7,"random_instances_SVM","SVM",75,11,1584,1440,144,1200,1091,109,0.832709740747158,0.268115942028986,1.28387096774194,298,109,189,28,1.7,43.1,10,0,0,0,0,0,0,0.139752014734395,147.716882001522,17.6910388566664
9.7,"random_instances_SVM","SVM",75,12,1484,1351,133,1300,1180,120,0.824389398926037,0.268115942028986,1.28387096774194,319,120,199,21,1.7,46.7,9.8,0,0,0,0,0,0,0.159369303828597,143.155090935038,20.6195449778576
9.7,"random_instances_SVM","SVM",75,13,1384,1259,125,1400,1272,128,0.804122639875282,0.282608695652174,1.27456755493221,355,128,227,36,1.8,50.29,9.9,0,0,0,0,0,0,0.136401818436359,130.492779925588,16.1313791335339
9.7,"random_instances_SVM","SVM",75,14,1284,1171,113,1500,1360,140,0.794058548415039,0.231884057971014,1.27456755493221,372,140,232,17,1.7,53.88,9.7,0,0,0,0,0,0,0.145252877106528,123.387813214903,18.6130176732574
9.7,"random_instances_SVM","SVM",75,15,1184,1076,108,1600,1455,145,0.82279577342803,0.253623188405797,1.27456755493221,402,145,257,30,1.8,57.47,10,0,0,0,0,0,0,0.140571881861438,111.068666768267,17.3838963158095
9.7,"random_instances_SVM","SVM",75,16,1084,986,98,1700,1545,155,0.783365090363189,0.22463768115942,1.27456755493221,434,155,279,32,1.8,61.06,10,0,0,0,0,0,0,0.160413093386309,102.828066936198,20.8581234822707
9.7,"random_instances_SVM","SVM",75,17,984,894,90,1800,1637,163,0.801501241411167,0.253623188405797,1.27456755493221,452,163,289,18,1.8,64.66,10,0,0,0,0,0,0,0.137711070288539,91.6981513207953,17.2647887671272
9.7,"random_instances_SVM","SVM",75,18,884,802,82,1900,1729,171,0.794428084762399,0.253623188405797,1.27456755493221,459,171,288,7,1.7,68.25,10.1,0,0,0,0,0,0,0.153871248322076,83.5426202873122,20.3745084451649
9.7,"random_instances_SVM","SVM",75,19,784,715,69,2000,1816,184,0.809579075004331,0.289855072463768,1.27456755493221,506,184,322,47,1.8,71.84,9.9,0,0,0,0,0,0,0.141649420747188,74.8588334080627,18.6895122222307
9.7,"random_instances_SVM","SVM",75,20,684,624,60,2100,1907,193,0.802350020209021,0.239130434782609,1.26526414212249,519,193,326,13,1.7,75.43,9.9,0,0,0,0,0,0,0.142709812135356,67.596656239928,18.593220952563
9.7,"random_instances_SVM","SVM",75,21,584,533,51,2200,1998,202,0.797540273687861,0.246376811594203,1.27456755493221,555,202,353,36,1.7,79.02,9.9,0,0,0,0,0,0,0.149914298039054,55.9894442437738,19.4562531585235
9.7,"random_instances_SVM","SVM",75,22,484,445,39,2300,2086,214,0.794035452393328,0.260869565217391,1.26526414212249,582,214,368,27,1.7,82.61,9.7,0,0,0,0,0,0,0.123999736612653,45.4077567270922,13.7998390389194
9.7,"random_instances_SVM","SVM",75,23,384,357,27,2400,2174,226,0.7944280847624,0.239130434782609,1.27456755493221,616,226,390,34,1.7,86.21,9.6,0,0,0,0,0,0,0.131225451069042,36.3567002669453,15.5163474913148
9.7,"random_instances_SVM","SVM",75,24,284,263,21,2500,2268,232,0.793492695883136,0.260869565217391,1.26526414212249,626,232,394,10,1.7,89.8,9.8,0,0,0,0,0,0,0.122051212839605,26.9108965498727,15.0463363062784
9.7,"random_instances_SVM","SVM",75,25,184,169,15,2600,2362,238,0.827449621802644,0.311594202898551,1.27456755493221,650,238,412,24,1.7,93.39,9.9,0,0,0,0,0,0,0.0949600347187537,18.181816354292,13.9899059571502
9.7,"random_instances_SVM","SVM",75,26,84,78,6,2700,2453,247,0.825469137940989,0.260869565217391,1.28387096774194,673,247,426,23,1.7,96.98,9.9,0,0,0,0,0,0,0.000758471780691753,7.80702375604502,7.80702375604502
9.7,"random_instances_SVM","SVM",75,27,0,0,0,2784,2531,253,0.807558173104684,0.202898550724638,1.28387096774194,688,253,435,15,1.7,100,10,0,0,0,0,0,0,0,0,0
9.7,"random_instances_SVM","SVM",76,0,2684,2429,255,100,89,11,0.828050473186118,0.336,1.24278709677419,26,11,15,0,1.4,3.59,8.1,0,0,0,0,0,0,0.266906762598003,267.228984115867,30.2130044306382
9.7,"random_instances_SVM","SVM",76,1,2584,2343,241,200,175,25,0.787107255520515,0.352,1.22911764705882,57,25,32,31,1.3,7.18,7,0,0,0,0,0,0,0.403497172313878,315.56683087233,51.0166556444555
9.7,"random_instances_SVM","SVM",76,2,2484,2252,232,300,266,34,0.777160883280756,0.312,1.2405004599816,80,34,46,23,1.4,10.78,7.8,0,0,0,0,0,0,0.385111531225646,263.536205603581,52.0521336229986
9.7,"random_instances_SVM","SVM",76,3,2384,2161,223,400,357,43,0.791476340694009,0.344,1.25305806451613,98,43,55,18,1.3,14.37,8.3,0,0,0,0,0,0,0.314220783613853,242.079937899831,44.6036975540777
9.7,"random_instances_SVM","SVM",76,4,2284,2068,216,500,450,50,0.785602523659308,0.344,1.25190423572744,122,50,72,24,1.4,17.96,9,0,0,0,0,0,0,0.354054713799662,225.549917833906,50.3490620528607
9.7,"random_instances_SVM","SVM",76,5,2184,1980,204,600,538,62,0.797028391167206,0.32,1.25305806451613,148,62,86,26,1.4,21.55,8.7,0,0,0,0,0,0,0.389417868772191,214.221842283987,54.4664050730711
9.7,"random_instances_SVM","SVM",76,6,2084,1888,196,700,630,70,0.808763406940073,0.272,1.26332903225806,169,70,99,21,1.4,25.14,9,0,0,0,0,0,0,0.249227355877409,199.09509445712,35.3200719520519
9.7,"random_instances_SVM","SVM",76,7,1984,1795,189,800,723,77,0.800170347003167,0.352,1.25305806451613,180,77,103,11,1.3,28.74,9.4,0,0,0,0,0,0,0.339401072892955,191.216960098945,48.5420325800645
9.7,"random_instances_SVM","SVM",76,8,1884,1708,176,900,810,90,0.808703470031555,0.368,1.25190423572744,202,90,112,22,1.2,32.33,9,0,0,0,0,0,0,0.489599835590174,207.312247884626,70.6422923058699
9.7,"random_instances_SVM","SVM",76,9,1784,1618,166,1000,900,100,0.814287066246059,0.344,1.26216574585635,227,100,127,25,1.3,35.92,9,0,0,0,0,0,0,0.356283726539095,185.141866527309,54.3314069277693
9.7,"random_instances_SVM","SVM",76,10,1684,1524,160,1100,994,106,0.813728706624617,0.328,1.26332903225806,255,106,149,28,1.4,39.51,9.4,0,0,0,0,0,0,0.244717155574011,160.641068976337,35.1786639073052
9.7,"random_instances_SVM","SVM",76,11,1584,1436,148,1200,1082,118,0.810580441640393,0.312,1.25305806451613,279,118,161,24,1.4,43.1,9.2,0,0,0,0,0,0,0.202299528440534,160.490989761063,28.1342483780041
9.7,"random_instances_SVM","SVM",76,12,1484,1341,143,1300,1177,123,0.805211356466875,0.288,1.24278709677419,310,123,187,31,1.5,46.7,9.6,0,0,0,0,0,0,0.187307108202596,146.204386369513,24.908994057858
9.7,"random_instances_SVM","SVM",76,13,1384,1250,134,1400,1268,132,0.81185488958991,0.28,1.25305806451613,334,132,202,24,1.5,50.29,9.6,0,0,0,0,0,0,0.208214775528961,133.864284002716,28.6160012216032
9.7,"random_instances_SVM","SVM",76,14,1284,1162,122,1500,1356,144,0.815413249211364,0.32,1.25305806451613,358,144,214,24,1.5,53.88,9.4,0,0,0,0,0,0,0.162598924343042,116.429604599901,23.3275622831576
9.7,"random_instances_SVM","SVM",76,15,1184,1071,113,1600,1447,153,0.824328075709783,0.336,1.25305806451613,388,153,235,30,1.5,57.47,9.5,0,0,0,0,0,0,0.165291765377269,116.960495268564,21.9715329046416
9.7,"random_instances_SVM","SVM",76,16,1084,978,106,1700,1540,160,0.808681388012618,0.264,1.25305806451613,407,160,247,19,1.5,61.06,9.6,0,0,0,0,0,0,0.168988041567306,105.3886298004,24.2307492404125
9.7,"random_instances_SVM","SVM",76,17,984,890,94,1800,1628,172,0.788624605678236,0.232,1.24278709677419,437,172,265,30,1.5,64.66,9.5,0,0,0,0,0,0,0.156472127772948,94.7405985891471,22.9218014345876
9.7,"random_instances_SVM","SVM",76,18,884,799,85,1900,1719,181,0.812340694006317,0.296,1.24278709677419,467,181,286,30,1.6,68.25,9.5,0,0,0,0,0,0,0.153489965736369,86.9524849705205,20.0541166450339
9.7,"random_instances_SVM","SVM",76,19,784,710,74,2000,1808,192,0.790813880126182,0.208,1.24278709677419,523,192,331,56,1.7,71.84,9.4,0,0,0,0,0,0,0.153487459235085,80.6501514788675,19.1002479534998
9.7,"random_instances_SVM","SVM",76,20,684,621,63,2100,1897,203,0.804788643533127,0.24,1.26332903225806,572,203,369,49,1.8,75.43,9.3,0,0,0,0,0,0,0.154897506877726,69.126142365882,18.7341594748221
9.7,"random_instances_SVM","SVM",76,21,584,530,54,2200,1988,212,0.768006309148264,0.176,1.26332903225806,576,212,364,4,1.7,79.02,9.4,0,0,0,0,0,0,0.140896196745249,59.3833325478853,16.7194865966929
9.7,"random_instances_SVM","SVM",76,22,484,444,40,2300,2074,226,0.81398107255522,0.264,1.25305806451613,608,226,382,32,1.7,82.61,9.2,0,0,0,0,0,0,0.169303815690548,49.2760358666021,20.5690128226542
9.7,"random_instances_SVM","SVM",76,23,384,357,27,2400,2161,239,0.802334384858057,0.208,1.25305806451613,628,239,389,20,1.6,86.21,9,0,0,0,0,0,0,0.158268779941766,38.4266205031726,20.767422519788
9.7,"random_instances_SVM","SVM",76,24,284,263,21,2500,2255,245,0.775514195583606,0.168,1.26332903225806,658,245,413,30,1.7,89.8,9.2,0,0,0,0,0,0,0.135105633366528,29.2041642609574,16.2949133621011
9.7,"random_instances_SVM","SVM",76,25,184,169,15,2600,2349,251,0.771955835962152,0.168,1.25305806451613,694,251,443,36,1.8,93.39,9.4,0,0,0,0,0,0,0.0984862049496364,18.690189994903,15.8075245282824
9.7,"random_instances_SVM","SVM",76,26,84,74,10,2700,2444,256,0.829741324921141,0.312,1.25305806451613,708,256,452,14,1.8,96.98,9.5,0,0,0,0,0,0,1.38977446084904e-06,9.26819296099701,9.26819296099701
9.7,"random_instances_SVM","SVM",76,27,0,0,0,2784,2518,266,0.757179810725559,0.176,1.25305806451613,723,266,457,15,1.7,100,9.5,0,0,0,0,0,0,0,0,0
9.7,"random_instances_SVM","SVM",77,0,2684,2424,260,100,92,8,0.799334229562776,0.276422764227642,1.25255704169945,23,8,15,0,1.9,3.59,11.5,0,0,0,0,0,0,0.148833112605967,189.436924653875,18.1917845060971
9.7,"random_instances_SVM","SVM",77,1,2584,2338,246,200,178,22,0.737417578900198,0.227642276422764,1.20036716496197,63,22,41,40,1.9,7.18,8.1,0,0,0,0,0,0,0.170491531427854,280.836574064534,19.7947490619918
9.7,"random_instances_SVM","SVM",77,2,2484,2248,236,300,268,32,0.7795531656104,0.178861788617886,1.25255704169945,94,32,62,31,1.9,10.78,8.4,0,0,0,0,0,0,0.147774041904258,267.47141115962,15.9428855301776
9.7,"random_instances_SVM","SVM",77,3,2384,2160,224,400,356,44,0.776403559311183,0.186991869918699,1.24211906635195,119,44,75,25,1.7,14.37,8.1,0,0,0,0,0,0,0.218735459246969,245.335976115102,29.4925562330932
9.7,"random_instances_SVM","SVM",77,4,2284,2069,215,500,447,53,0.765706420843738,0.154471544715447,1.25255704169945,155,53,102,36,1.9,17.96,8.4,0,0,0,0,0,0,0.24090487284115,235.369168052412,34.5323239556422
9.7,"random_instances_SVM","SVM",77,5,2184,1978,206,600,538,62,0.778035977210175,0.170731707317073,1.25255704169945,170,62,108,15,1.7,21.55,8.7,0,0,0,0,0,0,0.179625637871518,226.841684161851,20.7122124106905
9.7,"random_instances_SVM","SVM",77,6,2084,1886,198,700,630,70,0.762319953908215,0.170731707317073,1.25255704169945,183,70,113,13,1.6,25.14,9,0,0,0,0,0,0,0.186574046746328,203.755210108909,22.4423703723274
9.7,"random_instances_SVM","SVM",77,7,1984,1796,188,800,720,80,0.754868446322269,0.170731707317073,1.25255704169945,211,80,131,28,1.6,28.74,9,0,0,0,0,0,0,0.20703382428979,190.748862165363,26.3967544332006
9.7,"random_instances_SVM","SVM",77,8,1884,1707,177,900,809,91,0.767934191152944,0.203252032520325,1.26299501704694,248,91,157,37,1.7,32.33,8.9,0,0,0,0,0,0,0.198637720931017,189.702594283688,23.3376503080406
9.7,"random_instances_SVM","SVM",77,9,1784,1620,164,1000,896,104,0.770994174508684,0.16260162601626,1.26299501704694,274,104,170,26,1.6,35.92,8.6,0,0,0,0,0,0,0.193826938737519,176.449726626108,23.2049148196156
9.7,"random_instances_SVM","SVM",77,10,1684,1533,151,1100,983,117,0.785064976634034,0.203252032520325,1.25255704169945,311,117,194,37,1.7,39.51,8.4,0,0,0,0,0,0,0.202370272275127,169.178545391702,24.3853048691665
9.7,"random_instances_SVM","SVM",77,11,1584,1439,145,1200,1077,123,0.789808590999299,0.203252032520325,1.25255704169945,328,123,205,17,1.7,43.1,8.8,0,0,0,0,0,0,0.201966999065486,164.657436496407,26.4869308656707
9.7,"random_instances_SVM","SVM",77,12,1484,1349,135,1300,1167,133,0.775718583957499,0.16260162601626,1.25255704169945,363,133,230,35,1.7,46.7,8.8,0,0,0,0,0,0,0.191332278999395,155.998435498796,24.8952682290898
9.7,"random_instances_SVM","SVM",77,13,1384,1256,128,1400,1260,140,0.785781960181808,0.178861788617886,1.25255704169945,384,140,244,21,1.7,50.29,9,0,0,0,0,0,0,0.165737105450349,145.887815211743,19.5247184611177
9.7,"random_instances_SVM","SVM",77,14,1284,1167,117,1500,1349,151,0.776685231419242,0.16260162601626,1.26299501704694,411,151,260,27,1.7,53.88,8.9,0,0,0,0,0,0,0.188235235802066,139.813930081398,24.6759574910119
9.7,"random_instances_SVM","SVM",77,15,1184,1077,107,1600,1439,161,0.789066000896231,0.178861788617886,1.26299501704694,432,161,271,21,1.7,57.47,8.9,0,0,0,0,0,0,0.185735731470919,126.733403124978,24.5241883397978
9.7,"random_instances_SVM","SVM",77,16,1084,983,101,1700,1533,167,0.793207861212473,0.16260162601626,1.25255704169945,449,167,282,17,1.7,61.06,9.2,0,0,0,0,0,0,0.180043761795476,116.819009885665,21.5832409458228
9.7,"random_instances_SVM","SVM",77,17,984,897,87,1800,1619,181,0.765860060175409,0.16260162601626,1.25255704169945,484,181,303,35,1.7,64.66,8.9,0,0,0,0,0,0,0.170130736778051,112.190132124153,20.4056893016496
9.7,"random_instances_SVM","SVM",77,18,884,804,80,1900,1712,188,0.752320594072083,0.138211382113821,1.26299501704694,498,188,310,14,1.6,68.25,9.1,0,0,0,0,0,0,0.182900243667794,91.3473018842097,22.3387745633876
9.7,"random_instances_SVM","SVM",77,19,784,717,67,2000,1799,201,0.774098969336154,0.16260162601626,1.25255704169945,552,201,351,54,1.7,71.84,9,0,0,0,0,0,0,0.184691624014235,82.8231187932626,22.6213034298707
9.7,"random_instances_SVM","SVM",77,20,684,624,60,2100,1892,208,0.769515395941366,0.186991869918699,1.25255704169945,545,208,337,-7,1.6,75.43,9.1,0,0,0,0,0,0,0.163437986700247,68.0499294778718,19.9853401859564
9.7,"random_instances_SVM","SVM",77,21,584,530,54,2200,1986,214,0.779911657384295,0.178861788617886,1.26299501704694,565,214,351,20,1.6,79.02,9.3,0,0,0,0,0,0,0.160853775055521,57.4860969255769,19.0274979825849
9.7,"random_instances_SVM","SVM",77,22,484,439,45,2300,2077,223,0.746130209333595,0.16260162601626,1.25255704169945,615,223,392,50,1.8,82.61,9.3,0,0,0,0,0,0,0.157967447784218,50.7783567469364,19.0254831459674
9.7,"random_instances_SVM","SVM",77,23,384,350,34,2400,2166,234,0.781992190000643,0.227642276422764,1.26299501704694,619,234,385,4,1.6,86.21,9.3,0,0,0,0,0,0,0.159875435253851,39.5727918097809,19.6298336341409
9.7,"random_instances_SVM","SVM",77,24,284,255,29,2500,2261,239,0.757480314960636,0.195121951219512,1.25255704169945,628,239,389,9,1.6,89.8,9.5,0,0,0,0,0,0,0.141951985042581,29.8847552020457,16.5429377568914
9.7,"random_instances_SVM","SVM",77,25,184,160,24,2600,2356,244,0.789686959861729,0.260162601626016,1.26299501704694,641,244,397,13,1.6,93.39,9.7,0,0,0,0,0,0,0.0973719003423194,19.1967325136514,15.9501024099
9.7,"random_instances_SVM","SVM",77,26,84,67,17,2700,2449,251,0.807970040330326,0.268292682926829,1.26299501704694,657,251,406,16,1.6,96.98,9.8,0,0,0,0,0,0,9.8525025934595e-12,8.25639369670315,8.25639369670315
9.7,"random_instances_SVM","SVM",77,27,0,0,0,2784,2516,268,0.781928173612447,0.195121951219512,1.26299501704694,725,268,457,68,1.7,100,9.4,0,0,0,0,0,0,0,0,0
9.7,"random_instances_SVM","SVM",78,0,2684,2428,256,100,90,10,0.80617665615142,0.256,1.26332903225806,27,10,17,0,1.7,3.59,9,0,0,0,0,0,0,0.15119121312521,247.609384627756,15.8808772611779
9.7,"random_instances_SVM","SVM",78,1,2584,2342,242,200,176,24,0.836271293375399,0.344,1.2736,56,24,32,29,1.3,7.18,7.3,0,0,0,0,0,0,0.19915261436369,310.517896216732,21.36969748774
9.7,"random_instances_SVM","SVM",78,2,2484,2251,233,300,267,33,0.822996845425869,0.312,1.26332903225806,83,33,50,27,1.5,10.78,8.1,0,0,0,0,0,0,0.23149474118998,244.959766904223,27.547597827708
9.7,"random_instances_SVM","SVM",78,3,2384,2163,221,400,355,45,0.833009463722406,0.28,1.26332903225806,109,45,64,26,1.4,14.37,7.9,0,0,0,0,0,0,0.364689792678651,232.374354196698,45.1481645488738
9.7,"random_instances_SVM","SVM",78,4,2284,2072,212,500,446,54,0.818599369085176,0.312,1.26332903225806,132,54,78,23,1.4,17.96,8.3,0,0,0,0,0,0,0.271294094446546,240.662130738851,37.0193798410422
9.7,"random_instances_SVM","SVM",78,5,2184,1979,205,600,539,61,0.776946372239762,0.272,1.2736,156,61,95,24,1.6,21.55,8.8,0,0,0,0,0,0,0.143303110217899,218.983369212878,17.0712770527696
9.7,"random_instances_SVM","SVM",78,6,2084,1884,200,700,634,66,0.808391167192436,0.256,1.26332903225806,172,66,106,16,1.6,25.14,9.6,0,0,0,0,0,0,0.159702114082597,203.053033910599,19.0171339011494
9.7,"random_instances_SVM","SVM",78,7,1984,1791,193,800,727,73,0.815009463722406,0.264,1.26332903225806,201,73,128,29,1.8,28.74,10,0,0,0,0,0,0,0.211823809506921,178.650981180523,27.5147360416456
9.7,"random_instances_SVM","SVM",78,8,1884,1699,185,900,819,81,0.770637223974764,0.224,1.28387096774194,238,81,157,37,1.9,32.33,10.1,0,0,0,0,0,0,0.14205852227211,189.244440016316,16.6351708681488
9.7,"random_instances_SVM","SVM",78,9,1784,1606,178,1000,912,88,0.805324921135653,0.264,1.28387096774194,259,88,171,21,1.9,35.92,10.4,0,0,0,0,0,0,0.177423083680191,164.140605760765,23.6284284884278
9.7,"random_instances_SVM","SVM",78,10,1684,1512,172,1100,1006,94,0.801899053627763,0.248,1.28387096774194,269,94,175,10,1.9,39.51,10.7,0,0,0,0,0,0,0.179283079841291,156.572603044706,23.6411120701026
9.7,"random_instances_SVM","SVM",78,11,1584,1417,167,1200,1101,99,0.81135015772871,0.24,1.28387096774194,285,99,186,16,1.9,43.1,11.1,0,0,0,0,0,0,0.151520374147805,141.099135499823,19.4444978794105
9.7,"random_instances_SVM","SVM",78,12,1484,1334,150,1300,1184,116,0.795772870662466,0.232,1.2736,322,116,206,37,1.8,46.7,10.2,0,0,0,0,0,0,0.156680107866393,144.266411407818,19.5336335156168
9.7,"random_instances_SVM","SVM",78,13,1384,1246,138,1400,1272,128,0.734782334384866,0.16,1.2736,351,128,223,29,1.7,50.29,9.9,0,0,0,0,0,0,0.155131658372449,139.276765253191,19.3545623148953
9.7,"random_instances_SVM","SVM",78,14,1284,1153,131,1500,1365,135,0.786252365930606,0.216,1.2736,376,135,241,25,1.8,53.88,10.1,0,0,0,0,0,0,0.160810348583611,121.460593519079,20.304188125649
9.7,"random_instances_SVM","SVM",78,15,1184,1059,125,1600,1459,141,0.788328075709779,0.208,1.28387096774194,397,141,256,21,1.8,57.47,10.3,0,0,0,0,0,0,0.160205574108653,108.229783201059,21.5868996171685
9.7,"random_instances_SVM","SVM",78,16,1084,964,120,1700,1554,146,0.732927444794955,0.136,1.2736,417,146,271,20,1.9,61.06,10.6,0,0,0,0,0,0,0.155295481969347,104.918932545671,19.8926322797535
9.7,"random_instances_SVM","SVM",78,17,984,875,109,1800,1643,157,0.754037854889604,0.144,1.2736,457,157,300,40,1.9,64.66,10.5,0,0,0,0,0,0,0.157718428162407,95.507802315542,20.4648603321977
9.7,"random_instances_SVM","SVM",78,18,884,784,100,1900,1734,166,0.790883280757101,0.224,1.28387096774194,463,166,297,6,1.8,68.25,10.4,0,0,0,0,0,0,0.155909742132181,79.7518895652832,21.5095827037118
9.7,"random_instances_SVM","SVM",78,19,784,691,93,2000,1827,173,0.768107255520505,0.208,1.24278709677419,481,173,308,18,1.8,71.84,10.6,0,0,0,0,0,0,0.158026152097393,72.6334587208269,21.3560589704893
9.7,"random_instances_SVM","SVM",78,20,684,602,82,2100,1916,184,0.76352050473186,0.2,1.26332903225806,526,184,342,45,1.9,75.43,10.4,0,0,0,0,0,0,0.140639523093541,66.0215324545933,17.9285621333685
9.7,"random_instances_SVM","SVM",78,21,584,511,73,2200,2007,193,0.75733753943218,0.184,1.25305806451613,555,193,362,29,1.9,79.02,10.4,0,0,0,0,0,0,0.140900099532289,58.014746996769,19.1858914501389
9.7,"random_instances_SVM","SVM",78,22,484,422,62,2300,2096,204,0.694656151419565,0.128,1.25190423572744,568,204,364,13,1.8,82.61,10.3,0,0,0,0,0,0,0.131588569889468,48.7956563618446,19.4729713366784
9.7,"random_instances_SVM","SVM",78,23,384,337,47,2400,2181,219,0.72237223974764,0.128,1.25305806451613,598,219,379,30,1.7,86.21,10,0,0,0,0,0,0,0.12881788414022,39.1400368609533,18.9167003212478
9.7,"random_instances_SVM","SVM",78,24,284,253,31,2500,2265,235,0.736618296529976,0.16,1.2736,654,235,419,56,1.8,89.8,9.6,0,0,0,0,0,0,0.122118408767283,28.2018902312738,16.62294802984
9.7,"random_instances_SVM","SVM",78,25,184,165,19,2600,2353,247,0.748542586750798,0.152,1.2736,674,247,427,20,1.7,93.39,9.5,0,0,0,0,0,0,0.0940358059886537,17.9115462581402,14.1246313970837
9.7,"random_instances_SVM","SVM",78,26,84,75,9,2700,2443,257,0.676321766561519,0.096,1.26332903225806,702,257,445,28,1.7,96.98,9.5,0,0,0,0,0,0,9.21219452069118e-07,8.540938517266,8.540938517266
9.7,"random_instances_SVM","SVM",78,27,0,0,0,2784,2518,266,0.78620820189275,0.184,1.26332903225806,724,266,458,22,1.7,100,9.5,0,0,0,0,0,0,0,0,0
9.7,"random_instances_SVM","SVM",79,0,2684,2418,266,100,94,6,0.735333693917131,0.176470588235294,1.24071564109515,22,6,16,0,2.7,3.59,15.7,0,0,0,0,0,0,0.0768711902233321,175.662636585931,7.88273962682642
9.7,"random_instances_SVM","SVM",79,1,2584,2332,252,200,180,20,0.799269158212737,0.319327731092437,1.24071564109515,49,20,29,27,1.4,7.18,9,0,0,0,0,0,0,0.180337792192136,248.321312171554,19.4825443382252
9.7,"random_instances_SVM","SVM",79,2,2484,2241,243,300,271,29,0.745775233170195,0.235294117647059,1.24071564109515,91,29,62,42,2.1,10.78,9.3,0,0,0,0,0,0,0.157109567031607,262.130864144708,18.691230490758
9.7,"random_instances_SVM","SVM",79,3,2384,2151,233,400,361,39,0.708923129691439,0.159663865546218,1.27308213608024,117,39,78,26,2,14.37,9.3,0,0,0,0,0,0,0.137205740143301,245.257257435017,15.5682367622943
9.7,"random_instances_SVM","SVM",79,4,2284,2055,229,500,457,43,0.665468385156263,0.0840336134453782,1.25150447275684,149,43,106,32,2.5,17.96,10.6,0,0,0,0,0,0,0.117629078432913,213.226216138729,13.4912393003875
9.7,"random_instances_SVM","SVM",79,5,2184,1965,219,600,547,53,0.702116011239664,0.0672268907563025,1.25150447275684,169,53,116,20,2.2,21.55,10.3,0,0,0,0,0,0,0.167919688254541,202.245145327809,21.7249385765422
9.7,"random_instances_SVM","SVM",79,6,2084,1874,210,700,638,62,0.679689458200867,0.0672268907563025,1.20834914611006,191,62,129,22,2.1,25.14,10.3,0,0,0,0,0,0,0.141490387970743,194.249372756606,19.3393125501858
9.7,"random_instances_SVM","SVM",79,7,1984,1784,200,800,728,72,0.731323298550195,0.117647058823529,1.21913797777175,218,72,146,27,2,28.74,10.1,0,0,0,0,0,0,0.150310231366776,194.044945174716,20.4464598048171
9.7,"random_instances_SVM","SVM",79,8,1884,1693,191,900,819,81,0.737272931150487,0.117647058823529,1.22992680943345,255,81,174,37,2.1,32.33,10.1,0,0,0,0,0,0,0.14273538898808,179.430380721135,19.6201308574686
9.7,"random_instances_SVM","SVM",79,9,1784,1601,183,1000,911,89,0.7309209398045,0.134453781512605,1.22992680943345,276,89,187,21,2.1,35.92,10.2,0,0,0,0,0,0,0.153476957192369,172.603214264709,21.9608327597381
9.7,"random_instances_SVM","SVM",79,10,1684,1512,172,1100,1000,100,0.742510190889547,0.126050420168067,1.22992680943345,302,100,202,26,2,39.51,10,0,0,0,0,0,0,0.148519560837098,169.697451349324,19.5751956651363
9.7,"random_instances_SVM","SVM",79,11,1584,1423,161,1200,1089,111,0.737411448095727,0.109243697478992,1.24071564109515,329,111,218,27,2,43.1,9.8,0,0,0,0,0,0,0.158270662359748,155.681892713507,21.9414161703565
9.7,"random_instances_SVM","SVM",79,12,1484,1331,153,1300,1181,119,0.77041805733283,0.134453781512605,1.24071564109515,339,119,220,10,1.8,46.7,9.9,0,0,0,0,0,0,0.17249134903378,141.349367861193,24.1213937135484
9.7,"random_instances_SVM","SVM",79,13,1384,1240,144,1400,1272,128,0.746170995870878,0.134453781512605,1.26229330441854,371,128,243,32,1.9,50.29,9.9,0,0,0,0,0,0,0.16046502672992,144.723451650494,21.955541160375
9.7,"random_instances_SVM","SVM",79,14,1284,1151,133,1500,1361,139,0.772522195691464,0.159663865546218,1.28387096774194,396,139,257,25,1.8,53.88,9.8,0,0,0,0,0,0,0.157895487435092,130.071709220174,21.0632383371899
9.7,"random_instances_SVM","SVM",79,15,1184,1060,124,1600,1452,148,0.780965133306073,0.168067226890756,1.27308213608024,438,148,290,42,2,57.47,9.8,0,0,0,0,0,0,0.172464647292645,121.585602040626,23.1537483421264
9.7,"random_instances_SVM","SVM",79,16,1084,969,115,1700,1543,157,0.781407068321836,0.201680672268908,1.27308213608024,455,157,298,17,1.9,61.06,9.8,0,0,0,0,0,0,0.177557780339893,113.057013029715,23.9412102982452
9.7,"random_instances_SVM","SVM",79,17,984,878,106,1800,1634,166,0.797329920979384,0.210084033613445,1.27308213608024,475,166,309,20,1.9,64.66,9.8,0,0,0,0,0,0,0.154946269617044,99.157167135087,20.1455331859704
9.7,"random_instances_SVM","SVM",79,18,884,787,97,1900,1725,175,0.726138807171222,0.100840336134454,1.27308213608024,500,175,325,25,1.9,68.25,9.9,0,0,0,0,0,0,0.159007554835145,88.7520497657872,21.3560143371026
9.7,"random_instances_SVM","SVM",79,19,784,694,90,2000,1818,182,0.788431856258989,0.201680672268908,1.27308213608024,506,182,324,6,1.8,71.84,10,0,0,0,0,0,0,0.169808936639332,79.1208019870264,22.8897327455396
9.7,"random_instances_SVM","SVM",79,20,684,605,79,2100,1907,193,0.77151300080472,0.19327731092437,1.27308213608024,540,193,347,34,1.8,75.43,9.9,0,0,0,0,0,0,0.173566072715871,73.4256086438245,23.5636856268695
9.7,"random_instances_SVM","SVM",79,21,584,518,66,2200,1994,206,0.766414258010899,0.142857142857143,1.27308213608024,565,206,359,25,1.7,79.02,9.7,0,0,0,0,0,0,0.168768757274806,62.9287971425192,23.79500531042
9.7,"random_instances_SVM","SVM",79,22,484,427,57,2300,2085,215,0.773076263472424,0.176470588235294,1.28387096774194,589,215,374,24,1.7,82.61,9.7,0,0,0,0,0,0,0.16221611554213,53.923098508888,21.8296491201958
9.7,"random_instances_SVM","SVM",79,23,384,342,42,2400,2170,230,0.744858382913606,0.159663865546218,1.27308213608024,620,230,390,31,1.7,86.21,9.4,0,0,0,0,0,0,0.143645651184033,41.3911705789049,19.0271239641678
9.7,"random_instances_SVM","SVM",79,24,284,251,33,2500,2261,239,0.798312731686084,0.252100840336134,1.28387096774194,662,239,423,42,1.8,89.8,9.5,0,0,0,0,0,0,0.141288434123927,31.5497319654739,20.1509158190249
9.7,"random_instances_SVM","SVM",79,25,184,163,21,2600,2349,251,0.773188396237618,0.159663865546218,1.27190986891994,653,251,402,-9,1.6,93.39,9.4,0,0,0,0,0,0,0.0969497845828148,19.9527413593021,16.9932811756523
9.7,"random_instances_SVM","SVM",79,26,84,75,9,2700,2437,263,0.788702294104457,0.176470588235294,1.27308213608024,683,263,420,30,1.6,96.98,9.3,0,0,0,0,0,0,5.49549944864131e-05,10.7054688439478,10.7054688439478
9.7,"random_instances_SVM","SVM",79,27,0,0,0,2784,2512,272,0.724760233763837,0.126050420168067,1.27308213608024,748,272,476,65,1.8,100,9.2,0,0,0,0,0,0,0,0,0
9.7,"random_instances_SVM","SVM",80,0,2684,2447,237,100,88,12,0.628747706060501,0.0985915492957746,1.10304407087687,33,12,21,0,1.8,3.59,7.3,0,0,0,0,0,0,0.296795177911918,325.744583928941,80.1635641707819
9.7,"random_instances_SVM","SVM",80,1,2584,2360,224,200,175,25,0.735749428626112,0.316901408450704,1.11208541572013,59,25,34,26,1.4,7.18,7,0,0,0,0,0,0,0.179837597355436,288.368375306694,68.2201848481641
9.7,"random_instances_SVM","SVM",80,2,2484,2273,211,300,262,38,0.76939575100483,0.28169014084507,1.22962289868242,92,38,54,33,1.4,10.78,6.9,0,0,0,0,0,0,0.16863487388213,298.588745259307,34.0423815800594
9.7,"random_instances_SVM","SVM",80,3,2384,2178,206,400,357,43,0.802096351088137,0.316901408450704,1.27482962289868,113,43,70,21,1.6,14.37,8.3,0,0,0,0,0,0,0.109083209863854,255.174806564503,11.128975667439
9.7,"random_instances_SVM","SVM",80,4,2284,2082,202,500,453,47,0.807393521802274,0.309859154929577,1.27482962289868,119,47,72,6,1.5,17.96,9.6,0,0,0,0,0,0,0.154357273116588,218.835288128924,30.0711665774732
9.7,"random_instances_SVM","SVM",80,5,2184,1989,195,600,546,54,0.820357798268424,0.330985915492958,1.27482962289868,145,54,91,26,1.7,21.55,10.1,0,0,0,0,0,0,0.102920832227952,188.378128268209,10.7527060061654
9.7,"random_instances_SVM","SVM",80,6,2084,1896,188,700,639,61,0.822947275982027,0.338028169014085,1.27482962289868,160,61,99,15,1.6,25.14,10.5,0,0,0,0,0,0,0.178190847512825,179.343678505904,23.0107901974151
9.7,"random_instances_SVM","SVM",80,7,1984,1813,171,800,722,78,0.825992726945199,0.338028169014085,1.27482962289868,189,78,111,29,1.4,28.74,9.3,0,0,0,0,0,0,0.20386547081818,187.912569034509,23.9527174558249
9.7,"random_instances_SVM","SVM",80,8,1884,1724,160,900,811,89,0.836694025061635,0.345070422535211,1.27482962289868,226,89,137,37,1.5,32.33,9.1,0,0,0,0,0,0,0.268460274980986,188.498832756378,35.7663284598627
9.7,"random_instances_SVM","SVM",80,9,1784,1631,153,1000,904,96,0.826504993188545,0.345070422535211,1.26578827805543,246,96,150,20,1.6,35.92,9.4,0,0,0,0,0,0,0.231408709794124,173.335592704793,32.3022423130823
9.7,"random_instances_SVM","SVM",80,10,1684,1547,137,1100,988,112,0.822198579164835,0.366197183098592,1.27482962289868,284,112,172,38,1.5,39.51,8.8,0,0,0,0,0,0,0.234162967433057,172.449524889412,32.0016857790434
9.7,"random_instances_SVM","SVM",80,11,1584,1452,132,1200,1083,117,0.824213868341939,0.316901408450704,1.26578827805543,304,117,187,20,1.6,43.1,9.3,0,0,0,0,0,0,0.199516988415005,145.064617274277,25.9400420686426
9.7,"random_instances_SVM","SVM",80,12,1484,1362,122,1300,1173,127,0.826989112934998,0.309859154929577,1.27482962289868,339,127,212,35,1.7,46.7,9.2,0,0,0,0,0,0,0.207208556734031,140.446739318514,28.3539081333465
9.7,"random_instances_SVM","SVM",80,13,1384,1279,105,1400,1256,144,0.829803762623696,0.288732394366197,1.26578827805543,371,144,227,32,1.6,50.29,8.7,0,0,0,0,0,0,0.195610397857916,143.229699049433,23.4733889672831
9.7,"random_instances_SVM","SVM",80,14,1284,1190,94,1500,1345,155,0.81976109253442,0.288732394366197,1.27482962289868,417,155,262,46,1.7,53.88,8.7,0,0,0,0,0,0,0.199698615126888,145.688792118872,24.5793689532836
9.7,"random_instances_SVM","SVM",80,15,1184,1096,88,1600,1439,161,0.816254039022299,0.288732394366197,1.27482962289868,434,161,273,17,1.7,57.47,8.9,0,0,0,0,0,0,0.186463124935419,133.31492710244,22.3623714403564
9.7,"random_instances_SVM","SVM",80,16,1084,1003,81,1700,1532,168,0.815460307810087,0.246478873239437,1.27482962289868,453,168,285,19,1.7,61.06,9.1,0,0,0,0,0,0,0.178002485896915,114.386233440112,20.240434399479
9.7,"random_instances_SVM","SVM",80,17,984,914,70,1800,1621,179,0.808992242825455,0.21830985915493,1.27482962289868,472,179,293,19,1.6,64.66,9.1,0,0,0,0,0,0,0.178409922610637,100.14990551161,20.8301372140024
9.7,"random_instances_SVM","SVM",80,18,884,822,62,1900,1713,187,0.79666407718895,0.225352112676056,1.27482962289868,501,187,314,29,1.7,68.25,9.2,0,0,0,0,0,0,0.177140720840835,92.535572036733,21.35923866356
9.7,"random_instances_SVM","SVM",80,19,784,726,58,2000,1809,191,0.765376431249366,0.161971830985915,1.27482962289868,497,191,306,-4,1.6,71.84,9.5,0,0,0,0,0,0,0.16309998309459,80.8682362668711,20.2460925779832
9.7,"random_instances_SVM","SVM",80,20,684,634,50,2100,1901,199,0.819333265781738,0.253521126760563,1.27482962289868,524,199,325,27,1.6,75.43,9.6,0,0,0,0,0,0,0.168388944160495,71.3593496473259,19.6676101431662
9.7,"random_instances_SVM","SVM",80,21,584,539,45,2200,1996,204,0.821235968971296,0.274647887323944,1.27482962289868,552,204,348,28,1.7,79.02,9.8,0,0,0,0,0,0,0.170867809418715,57.25714696862,21.5379557757909
9.7,"random_instances_SVM","SVM",80,22,484,445,39,2300,2090,210,0.782247441483427,0.21830985915493,1.27482962289868,573,210,363,21,1.7,82.61,10,0,0,0,0,0,0,0.143436820019196,48.6285786009144,19.1208214997769
9.7,"random_instances_SVM","SVM",80,23,384,352,32,2400,2183,217,0.794147780367252,0.23943661971831,1.27482962289868,599,217,382,26,1.8,86.21,10.1,0,0,0,0,0,0,0.132198931422885,37.2603188233378,15.5591506156008
9.7,"random_instances_SVM","SVM",80,24,284,263,21,2500,2272,228,0.801589714144174,0.225352112676056,1.27482962289868,622,228,394,23,1.7,89.8,10,0,0,0,0,0,0,0.123756420593983,27.154702455165,16.6562324539816
9.7,"random_instances_SVM","SVM",80,25,184,168,16,2600,2367,233,0.80227648866822,0.232394366197183,1.28387096774194,641,233,408,19,1.8,93.39,10.2,0,0,0,0,0,0,0.0976155980709667,17.9387977808241,13.6777186289974
9.7,"random_instances_SVM","SVM",80,26,84,78,6,2700,2457,243,0.754517512750363,0.190140845070423,1.28387096774194,663,243,420,22,1.7,96.98,10.1,0,0,0,0,0,0,1.30482479825996e-07,8.11251177655401,8.11251177655401
9.7,"random_instances_SVM","SVM",80,27,0,0,0,2784,2535,249,0.773454475855931,0.211267605633803,1.27482962289868,726,249,477,63,1.9,100,10.2,0,0,0,0,0,0,0,0,0
9.7,"random_instances_SVM","SVM",81,0,2684,2421,263,100,91,9,0.741778029893278,0.210084033613445,1.22992680943345,27,9,18,0,2,3.59,10.1,0,0,0,0,0,0,0.176936451814861,254.362498496935,19.6488516224982
9.7,"random_instances_SVM","SVM",81,1,2584,2335,249,200,177,23,0.815086474150103,0.260504201680672,1.27308213608024,56,23,33,29,1.4,7.18,7.7,0,0,0,0,0,0,0.182831321761011,307.56373489662,18.9546928684595
9.7,"random_instances_SVM","SVM",81,2,2484,2247,237,300,265,35,0.786927957996389,0.210084033613445,1.26229330441854,90,35,55,34,1.6,10.78,7.6,0,0,0,0,0,0,0.198948997968721,261.093147854029,22.4812993152245
9.7,"random_instances_SVM","SVM",81,3,2384,2161,223,400,351,49,0.784691898737519,0.218487394957983,1.27308213608024,124,49,75,34,1.5,14.37,7.2,0,0,0,0,0,0,0.186960538915113,316.12486910942,20.8251314764724
9.7,"random_instances_SVM","SVM",81,4,2284,2073,211,500,439,61,0.797527802329724,0.336134453781513,1.25150447275684,146,61,85,22,1.4,17.96,7.2,0,0,0,0,0,0,0.189316409861122,265.274868807995,20.2892677782853
9.7,"random_instances_SVM","SVM",81,5,2184,1984,200,600,528,72,0.792864398506657,0.294117647058824,1.27308213608024,179,72,107,33,1.5,21.55,7.3,0,0,0,0,0,0,0.202200273992977,258.916073218717,24.3837375460827
9.7,"random_instances_SVM","SVM",81,6,2084,1890,194,700,622,78,0.800390485864676,0.327731092436975,1.26229330441854,202,78,124,23,1.6,25.14,8,0,0,0,0,0,0,0.172212199714055,242.232837074775,20.595665391134
9.7,"random_instances_SVM","SVM",81,7,1984,1799,185,800,713,87,0.797000118728812,0.310924369747899,1.26229330441854,240,87,153,38,1.8,28.74,8.2,0,0,0,0,0,0,0.183433056119258,234.792753354346,20.8204888732939
9.7,"random_instances_SVM","SVM",81,8,1884,1711,173,900,801,99,0.79586559898685,0.260504201680672,1.27308213608024,272,99,173,32,1.7,32.33,8.1,0,0,0,0,0,0,0.165074177485669,224.124234780315,17.7503068983313
9.7,"random_instances_SVM","SVM",81,9,1784,1619,165,1000,893,107,0.808094666438006,0.243697478991597,1.27308213608024,295,107,188,23,1.8,35.92,8.3,0,0,0,0,0,0,0.197866143448508,214.044785039891,23.0130999444877
9.7,"random_instances_SVM","SVM",81,10,1684,1529,155,1100,983,117,0.801689906731925,0.226890756302521,1.27308213608024,341,117,224,46,1.9,39.51,8.4,0,0,0,0,0,0,0.177920739048411,199.419025978827,19.6261031348965
9.7,"random_instances_SVM","SVM",81,11,1584,1436,148,1200,1076,124,0.805812434864056,0.294117647058824,1.28387096774194,345,124,221,4,1.8,43.1,8.7,0,0,0,0,0,0,0.162721280581939,170.173743015676,17.9033558385719
9.7,"random_instances_SVM","SVM",81,12,1484,1346,138,1300,1166,134,0.79446723744443,0.252100840336134,1.28387096774194,377,134,243,32,1.8,46.7,8.7,0,0,0,0,0,0,0.161292579747239,160.837170068398,18.1741377604344
9.7,"random_instances_SVM","SVM",81,13,1384,1254,130,1400,1258,142,0.788557181114207,0.19327731092437,1.28387096774194,402,142,260,25,1.8,50.29,8.9,0,0,0,0,0,0,0.163280521761061,152.945655380858,18.1576695295896
9.7,"random_instances_SVM","SVM",81,14,1284,1162,122,1500,1350,150,0.79678904528845,0.201680672268908,1.27308213608024,447,150,297,45,2,53.88,9,0,0,0,0,0,0,0.179453036101902,139.667355766649,20.4125420320937
9.7,"random_instances_SVM","SVM",81,15,1184,1069,115,1600,1443,157,0.779540387583608,0.159663865546218,1.28387096774194,462,157,305,15,1.9,57.47,9.2,0,0,0,0,0,0,0.151435081107093,127.635650433086,16.2346819795516
9.7,"random_instances_SVM","SVM",81,16,1084,975,109,1700,1537,163,0.804282152421412,0.210084033613445,1.28387096774194,465,163,302,3,1.9,61.06,9.4,0,0,0,0,0,0,0.179253400582685,111.916918330482,19.4397648213027
9.7,"random_instances_SVM","SVM",81,17,984,889,95,1800,1623,177,0.784698494782533,0.151260504201681,1.25150447275684,496,177,319,31,1.8,64.66,9.2,0,0,0,0,0,0,0.165647703568213,103.497397719447,18.6409564017424
9.7,"random_instances_SVM","SVM",81,18,884,799,85,1900,1713,187,0.79665712438822,0.19327731092437,1.27308213608024,537,187,350,41,1.9,68.25,9.2,0,0,0,0,0,0,0.161858405180518,90.7317825549649,18.5773622524168
9.7,"random_instances_SVM","SVM",81,19,784,710,74,2000,1802,198,0.824611163146581,0.285714285714286,1.26229330441854,557,198,359,20,1.8,71.84,9.1,0,0,0,0,0,0,0.161205613714943,84.2010421862132,17.6095846041315
9.7,"random_instances_SVM","SVM",81,20,684,617,67,2100,1895,205,0.798332519821118,0.176470588235294,1.26229330441854,579,205,374,22,1.8,75.43,9.2,0,0,0,0,0,0,0.16438112311794,71.4733329073151,19.0757113035663
9.7,"random_instances_SVM","SVM",81,21,584,523,61,2200,1989,211,0.789249765840405,0.168067226890756,1.27308213608024,588,211,377,9,1.8,79.02,9.4,0,0,0,0,0,0,0.159244822807099,61.0768690585268,18.0541226835748
9.7,"random_instances_SVM","SVM",81,22,484,429,55,2300,2083,217,0.809295146630085,0.235294117647059,1.27308213608024,599,217,382,11,1.8,82.61,9.6,0,0,0,0,0,0,0.165963192705647,50.4527025953185,19.3137499284008
9.7,"random_instances_SVM","SVM",81,23,384,343,41,2400,2169,231,0.770602746593148,0.176470588235294,1.27308213608024,635,231,404,36,1.7,86.21,9.4,0,0,0,0,0,0,0.149747388938501,40.8958502598892,17.2855842361289
9.7,"random_instances_SVM","SVM",81,24,284,252,32,2500,2260,240,0.723190375051121,0.134453781512605,1.27308213608024,664,240,424,29,1.8,89.8,9.4,0,0,0,0,0,0,0.140688404049383,32.7871829762929,17.3127586248741
9.7,"random_instances_SVM","SVM",81,25,184,164,20,2600,2348,252,0.792752265741465,0.159663865546218,1.28387096774194,698,252,446,34,1.8,93.39,9.3,0,0,0,0,0,0,0.0876320156925568,18.6403116073346,15.2861398956199
9.7,"random_instances_SVM","SVM",81,26,84,75,9,2700,2437,263,0.738447027162516,0.134453781512605,1.28387096774194,717,263,454,19,1.7,96.98,9.3,0,0,0,0,0,0,7.87342015172018e-05,9.54268189963715,9.54268189963715
9.7,"random_instances_SVM","SVM",81,27,0,0,0,2784,2512,272,0.813160429006772,0.226890756302521,1.27308213608024,742,272,470,25,1.7,100,9.2,0,0,0,0,0,0,0,0,0
9.7,"random_instances_SVM","SVM",82,0,2684,2444,240,100,95,5,0.763053245597657,0.328767123287671,1.21352187361909,13,5,8,0,1.6,3.59,19,0,0,0,0,0,0,0.245282543459732,214.833384539519,35.657194959074
9.7,"random_instances_SVM","SVM",82,1,2584,2357,227,200,182,18,0.798618053190673,0.410958904109589,1.16955368979231,39,18,21,26,1.2,7.18,10.1,0,0,0,0,0,0,0.299784653076821,190.8245515606,32.8422077627857
9.7,"random_instances_SVM","SVM",82,2,2484,2262,222,300,277,23,0.790708659687355,0.410958904109589,1.1519664162616,54,23,31,15,1.3,10.78,12,0,0,0,0,0,0,0.121246620848561,193.954858683087,12.4837841816441
9.7,"random_instances_SVM","SVM",82,3,2384,2173,211,400,366,34,0.850276279509184,0.383561643835616,1.25749005744587,80,34,46,26,1.4,14.37,10.8,0,0,0,0,0,0,0.199855261231751,180.2708941396,22.9465357775259
9.7,"random_instances_SVM","SVM",82,4,2284,2078,206,500,461,39,0.850506970153018,0.376712328767123,1.27507733097658,102,39,63,22,1.6,17.96,11.8,0,0,0,0,0,0,0.189452134826316,186.644027459954,24.2772417071272
9.7,"random_instances_SVM","SVM",82,5,2184,1984,200,600,555,45,0.845025321044472,0.363013698630137,1.26628369421122,130,45,85,28,1.9,21.55,12.3,0,0,0,0,0,0,0.147422092123453,171.964614812272,16.3011503817795
9.7,"random_instances_SVM","SVM",82,6,2084,1892,192,700,647,53,0.838022212213419,0.315068493150685,1.26628369421122,145,53,92,15,1.7,25.14,12.2,0,0,0,0,0,0,0.160904098936314,159.667347902889,19.9756290701613
9.7,"random_instances_SVM","SVM",82,7,1984,1800,184,800,739,61,0.834907888521484,0.315068493150685,1.26628369421122,172,61,111,27,1.8,28.74,12.1,0,0,0,0,0,0,0.153148229389904,143.297833589566,19.1684831648111
9.7,"random_instances_SVM","SVM",82,8,1884,1711,173,900,828,72,0.823384341597909,0.294520547945205,1.26628369421122,205,72,133,33,1.8,32.33,11.5,0,0,0,0,0,0,0.139919950760905,155.388879781323,16.5557751408453
9.7,"random_instances_SVM","SVM",82,9,1784,1621,163,1000,918,82,0.822961408750863,0.321917808219178,1.26628369421122,226,82,144,21,1.8,35.92,11.2,0,0,0,0,0,0,0.176345802581529,148.083847135249,26.4151759889864
9.7,"random_instances_SVM","SVM",82,10,1684,1529,155,1100,1010,90,0.821544309081519,0.308219178082192,1.27507733097658,253,90,163,27,1.8,39.51,11.2,0,0,0,0,0,0,0.1579702766646,166.940725785174,19.5353469699941
9.7,"random_instances_SVM","SVM",82,11,1584,1439,145,1200,1100,100,0.819380211136857,0.294520547945205,1.26628369421122,283,100,183,30,1.8,43.1,11,0,0,0,0,0,0,0.149596866006032,148.205815869044,18.2840148600799
9.7,"random_instances_SVM","SVM",82,12,1484,1345,139,1300,1194,106,0.820934626665636,0.356164383561644,1.26628369421122,306,106,200,23,1.9,46.7,11.3,0,0,0,0,0,0,0.153991907772924,142.962355438643,18.8135696805409
9.7,"random_instances_SVM","SVM",82,13,1384,1253,131,1400,1286,114,0.810504113983138,0.308219178082192,1.27507733097658,318,114,204,12,1.8,50.29,11.3,0,0,0,0,0,0,0.151372084655014,123.852625233105,17.7539341203344
9.7,"random_instances_SVM","SVM",82,14,1284,1164,120,1500,1375,125,0.805450890356029,0.273972602739726,1.26628369421122,368,125,243,50,1.9,53.88,11,0,0,0,0,0,0,0.140090859833886,116.964199938555,16.5028240068616
9.7,"random_instances_SVM","SVM",82,15,1184,1075,109,1600,1464,136,0.82003383462777,0.315068493150685,1.25749005744587,384,136,248,16,1.8,57.47,10.8,0,0,0,0,0,0,0.154014591686978,108.731378638392,18.647007246244
9.7,"random_instances_SVM","SVM",82,16,1084,988,96,1700,1551,149,0.804594039393174,0.294520547945205,1.26628369421122,425,149,276,41,1.9,61.06,10.4,0,0,0,0,0,0,0.147349903661853,99.6818099953284,17.4413432341146
9.7,"random_instances_SVM","SVM",82,17,984,899,85,1800,1640,160,0.812014588436905,0.308219178082192,1.27507733097658,447,160,287,22,1.8,64.66,10.2,0,0,0,0,0,0,0.152049220647375,95.0986882046188,17.8638250907888
9.7,"random_instances_SVM","SVM",82,18,884,810,74,1900,1729,171,0.831595829991981,0.321917808219178,1.28268876611418,469,171,298,22,1.7,68.25,10.1,0,0,0,0,0,0,0.160516693575043,83.1932266228166,19.5211203446884
9.7,"random_instances_SVM","SVM",82,19,784,722,62,2000,1817,183,0.836385407168986,0.356164383561644,1.28268876611418,511,183,328,42,1.8,71.84,9.9,0,0,0,0,0,0,0.1658538185987,77.7682322155225,20.0813600460477
9.7,"random_instances_SVM","SVM",82,20,684,627,57,2100,1912,188,0.807543584053782,0.273972602739726,1.27390322662025,540,188,352,29,1.9,75.43,10.2,0,0,0,0,0,0,0.169608658361283,64.2061281334118,21.2685037959131
9.7,"random_instances_SVM","SVM",82,21,584,536,48,2200,2003,197,0.812316683327651,0.315068493150685,1.27507733097658,546,197,349,6,1.8,79.02,10.2,0,0,0,0,0,0,0.133585680085524,52.6054400716857,16.2064035908197
9.7,"random_instances_SVM","SVM",82,22,484,448,36,2300,2091,209,0.780448418670559,0.23972602739726,1.27390322662025,584,209,375,38,1.8,82.61,10,0,0,0,0,0,0,0.133924289772774,44.782128845966,16.2487358356858
9.7,"random_instances_SVM","SVM",82,23,384,350,34,2400,2189,211,0.792718963869447,0.232876712328767,1.27390322662025,590,211,379,6,1.8,86.21,10.4,0,0,0,0,0,0,0.125410230903976,32.5666621624406,15.4591823404052
9.7,"random_instances_SVM","SVM",82,24,284,256,28,2500,2283,217,0.717541277147343,0.150684931506849,1.27390322662025,595,217,378,5,1.7,89.8,10.5,0,0,0,0,0,0,0.122042898628611,26.0713676277921,14.7399447285541
9.7,"random_instances_SVM","SVM",82,25,184,170,14,2600,2369,231,0.69866309279256,0.157534246575342,1.27507733097658,646,231,415,51,1.8,93.39,10.3,0,0,0,0,0,0,0.0955419509107708,16.8614144181501,13.7128725371964
9.7,"random_instances_SVM","SVM",82,26,84,76,8,2700,2463,237,0.805016972240223,0.26027397260274,1.27390322662025,671,237,434,25,1.8,96.98,10.4,0,0,0,0,0,0,1.01625976889619e-11,7.6199919539635,7.6199919539635
9.7,"random_instances_SVM","SVM",82,27,0,0,0,2784,2539,245,0.785408267513262,0.23972602739726,1.27390322662025,672,245,427,1,1.7,100,10.4,0,0,0,0,0,0,0,0,0
9.7,"random_instances_SVM","SVM",83,0,2684,2440,244,100,86,14,0.698818474758323,0.157894736842105,1.22595197671598,44,14,30,0,2.1,3.59,6.1,0,0,0,0,0,0,0.1873124449128,377.657739718033,25.1587842167094
9.7,"random_instances_SVM","SVM",83,1,2584,2354,230,200,172,28,0.727222818952147,0.150375939849624,1.19589027818164,73,28,45,29,1.6,7.18,6.1,0,0,0,0,0,0,0.352757700146189,374.865031481007,66.9711667393106
9.7,"random_instances_SVM","SVM",83,2,2484,2266,218,300,260,40,0.7685702351116,0.218045112781955,1.25491147222896,99,40,59,26,1.5,10.78,6.5,0,0,0,0,0,0,0.166764867741142,327.206012432217,23.1527726032549
9.7,"random_instances_SVM","SVM",83,3,2384,2172,212,400,354,46,0.78302303377492,0.285714285714286,1.24525830705797,122,46,76,23,1.7,14.37,7.7,0,0,0,0,0,0,0.188997102526537,286.946090976201,33.3827193975432
9.7,"random_instances_SVM","SVM",83,4,2284,2081,203,500,445,55,0.761343835779934,0.24812030075188,1.19699248120301,161,55,106,39,1.9,17.96,8.1,0,0,0,0,0,0,0.129248346745019,256.634260165085,17.3728805264889
9.7,"random_instances_SVM","SVM",83,5,2184,1991,193,600,535,65,0.777175080558547,0.263157894736842,1.206645646374,177,65,112,16,1.7,21.55,8.2,0,0,0,0,0,0,0.136268048748509,247.451886211903,18.8105521600947
9.7,"random_instances_SVM","SVM",83,6,2084,1898,186,700,628,72,0.803228308867412,0.300751879699248,1.25491147222896,194,72,122,17,1.7,25.14,8.7,0,0,0,0,0,0,0.198515500306777,234.583720585711,29.9198223222084
9.7,"random_instances_SVM","SVM",83,7,1984,1807,177,800,719,81,0.792713927676333,0.285714285714286,1.26456463739995,231,81,150,37,1.9,28.74,8.9,0,0,0,0,0,0,0.143937894071102,207.976896064898,17.1622454845652
9.7,"random_instances_SVM","SVM",83,8,1884,1720,164,900,806,94,0.783046902971713,0.240601503759398,1.26456463739995,265,94,171,34,1.8,32.33,8.6,0,0,0,0,0,0,0.157792494922406,206.735174107712,19.5400657684597
9.7,"random_instances_SVM","SVM",83,9,1784,1632,152,1000,894,106,0.807035445757249,0.285714285714286,1.28387096774194,285,106,179,20,1.7,35.92,8.4,0,0,0,0,0,0,0.165580065396614,190.061711278129,20.8106074737607
9.7,"random_instances_SVM","SVM",83,10,1684,1542,142,1100,984,116,0.81494211719776,0.345864661654135,1.27421780257094,310,116,194,25,1.7,39.51,8.5,0,0,0,0,0,0,0.147169751696481,182.182662240646,17.2132856151508
9.7,"random_instances_SVM","SVM",83,11,1584,1444,140,1200,1082,118,0.795059076262084,0.300751879699248,1.26456463739995,329,118,211,19,1.8,43.1,9.2,0,0,0,0,0,0,0.153977166978005,148.941387335557,21.4594369120295
9.7,"random_instances_SVM","SVM",83,12,1484,1354,130,1300,1172,128,0.80278672872658,0.270676691729323,1.27421780257094,353,128,225,24,1.8,46.7,9.2,0,0,0,0,0,0,0.131023634149033,146.125665502583,15.5068405810005
9.7,"random_instances_SVM","SVM",83,13,1384,1263,121,1400,1263,137,0.809291084854993,0.270676691729323,1.27421780257094,380,137,243,27,1.8,50.29,9.2,0,0,0,0,0,0,0.125818912755182,140.335800642839,14.3574068656211
9.7,"random_instances_SVM","SVM",83,14,1284,1171,113,1500,1355,145,0.81585511397542,0.285714285714286,1.27421780257094,401,145,256,21,1.8,53.88,9.3,0,0,0,0,0,0,0.148959131844261,123.879708023018,18.5915706353072
9.7,"random_instances_SVM","SVM",83,15,1184,1079,105,1600,1447,153,0.768522496717985,0.210526315789474,1.26456463739995,434,153,281,33,1.8,57.47,9.5,0,0,0,0,0,0,0.13791832008885,122.819903636121,16.4271726512541
9.7,"random_instances_SVM","SVM",83,16,1084,984,100,1700,1542,158,0.803383458646618,0.270676691729323,1.28387096774194,445,158,287,11,1.8,61.06,9.8,0,0,0,0,0,0,0.127881002472622,105.353634632231,14.773314786965
9.7,"random_instances_SVM","SVM",83,17,984,894,90,1800,1632,168,0.812632772407209,0.285714285714286,1.28387096774194,473,168,305,28,1.8,64.66,9.7,0,0,0,0,0,0,0.150800798373309,95.0287706118711,20.5523051186104
9.7,"random_instances_SVM","SVM",83,18,884,803,81,1900,1723,177,0.801420217209689,0.300751879699248,1.28387096774194,485,177,308,12,1.7,68.25,9.7,0,0,0,0,0,0,0.156680005624156,81.9153825022836,22.9823837342803
9.7,"random_instances_SVM","SVM",83,19,784,717,67,2000,1809,191,0.821422604129371,0.323308270676692,1.27421780257094,510,191,319,25,1.7,71.84,9.5,0,0,0,0,0,0,0.15834869903005,80.2964072991003,20.8252572357582
9.7,"random_instances_SVM","SVM",83,20,684,626,58,2100,1900,200,0.815079365079365,0.278195488721804,1.28387096774194,542,200,342,32,1.7,75.43,9.5,0,0,0,0,0,0,0.158943561759511,69.2415912685148,22.4880796750719
9.7,"random_instances_SVM","SVM",83,21,584,531,53,2200,1995,205,0.8375104427736,0.345864661654135,1.26456463739995,574,205,369,32,1.8,79.02,9.7,0,0,0,0,0,0,0.16095367457859,59.9982314100601,19.8660744989532
9.7,"random_instances_SVM","SVM",83,22,484,439,45,2300,2087,213,0.825241675617614,0.285714285714286,1.27421780257094,598,213,385,24,1.8,82.61,9.8,0,0,0,0,0,0,0.160636536021644,51.5703489582888,21.6447978814386
9.7,"random_instances_SVM","SVM",83,23,384,345,39,2400,2181,219,0.822789115646258,0.263157894736842,1.27421780257094,602,219,383,4,1.7,86.21,10,0,0,0,0,0,0,0.139616219233433,39.8676305059057,18.6824959792571
9.7,"random_instances_SVM","SVM",83,24,284,254,30,2500,2272,228,0.828756414846642,0.330827067669173,1.28387096774194,625,228,397,23,1.7,89.8,10,0,0,0,0,0,0,0.121159281416019,29.5175213828232,16.5262270320992
9.7,"random_instances_SVM","SVM",83,25,184,158,26,2600,2368,232,0.812435851533605,0.278195488721804,1.27421780257094,661,232,429,36,1.8,93.39,10.2,0,0,0,0,0,0,0.0798943847125445,18.3908146579162,15.5742865459982
9.7,"random_instances_SVM","SVM",83,26,84,67,17,2700,2459,241,0.803759398496243,0.285714285714286,1.27421780257094,681,241,440,20,1.8,96.98,10.2,0,0,0,0,0,0,1.67505926055939e-06,8.44020886079524,8.44020886079524
9.7,"random_instances_SVM","SVM",83,27,0,0,0,2784,2526,258,0.731865377730045,0.157894736842105,1.27421780257094,727,258,469,46,1.8,100,9.8,0,0,0,0,0,0,0,0,0
9.7,"random_instances_SVM","SVM",84,0,2684,2427,257,100,91,9,0.695293375394325,0.272,1.15034838709677,32,9,23,0,2.6,3.59,10.1,0,0,0,0,0,0,0.0922055348330751,245.980510832636,9.22759395485429
9.7,"random_instances_SVM","SVM",84,1,2584,2341,243,200,177,23,0.777943217665615,0.216,1.28387096774194,63,23,40,31,1.7,7.18,7.7,0,0,0,0,0,0,0.257218318834631,293.423184129472,49.4582037643128
9.7,"random_instances_SVM","SVM",84,2,2484,2255,229,300,263,37,0.760630914826501,0.152,1.25305806451613,101,37,64,38,1.7,10.78,7.1,0,0,0,0,0,0,0.126088282016391,296.405640181959,23.18141097753
9.7,"random_instances_SVM","SVM",84,3,2384,2167,217,400,351,49,0.781022082018929,0.184,1.2736,129,49,80,28,1.6,14.37,7.2,0,0,0,0,0,0,0.139088895119758,290.20796548627,23.4021996768666
9.7,"random_instances_SVM","SVM",84,4,2284,2080,204,500,438,62,0.804580441640379,0.216,1.28387096774194,162,62,100,33,1.6,17.96,7.1,0,0,0,0,0,0,0.141342296285017,282.864304229799,18.768652449823
9.7,"random_instances_SVM","SVM",84,5,2184,1989,195,600,529,71,0.792902208201894,0.232,1.28387096774194,187,71,116,25,1.6,21.55,7.5,0,0,0,0,0,0,0.158328453781458,267.817125705726,19.6002615229581
9.7,"random_instances_SVM","SVM",84,6,2084,1896,188,700,622,78,0.809514195583597,0.24,1.26332903225806,192,78,114,5,1.5,25.14,8,0,0,0,0,0,0,0.14195926300907,234.046326328492,17.929093223036
9.7,"random_instances_SVM","SVM",84,7,1984,1806,178,800,712,88,0.834485804416404,0.312,1.28387096774194,228,88,140,36,1.6,28.74,8.1,0,0,0,0,0,0,0.183929653510015,225.188148583244,21.4663252711692
9.7,"random_instances_SVM","SVM",84,8,1884,1721,163,900,797,103,0.826214511041011,0.296,1.28387096774194,273,103,170,45,1.7,32.33,7.7,0,0,0,0,0,0,0.183982761384173,231.824966355855,21.1753757549947
9.7,"random_instances_SVM","SVM",84,9,1784,1633,151,1000,885,115,0.817766561514198,0.312,1.28387096774194,296,115,181,23,1.6,35.92,7.7,0,0,0,0,0,0,0.193915072385442,205.522857550388,24.2644875103666
9.7,"random_instances_SVM","SVM",84,10,1684,1541,143,1100,977,123,0.819369085173503,0.352,1.28387096774194,309,123,186,13,1.5,39.51,7.9,0,0,0,0,0,0,0.138783456393719,193.928337255705,14.9399538030353
9.7,"random_instances_SVM","SVM",84,11,1584,1446,138,1200,1072,128,0.796574132492114,0.28,1.28387096774194,355,128,227,46,1.8,43.1,8.4,0,0,0,0,0,0,0.173983307676384,165.984264625867,20.415572550955
9.7,"random_instances_SVM","SVM",84,12,1484,1358,126,1300,1160,140,0.797217665615145,0.28,1.28387096774194,364,140,224,9,1.6,46.7,8.3,0,0,0,0,0,0,0.19289521010466,157.132067133009,23.1631451682516
9.7,"random_instances_SVM","SVM",84,13,1384,1265,119,1400,1253,147,0.79904731861199,0.304,1.28387096774194,411,147,264,47,1.8,50.29,8.5,0,0,0,0,0,0,0.18996696613624,146.867058306665,24.0253397281419
9.7,"random_instances_SVM","SVM",84,14,1284,1173,111,1500,1345,155,0.815047318611988,0.288,1.28387096774194,441,155,286,30,1.8,53.88,8.7,0,0,0,0,0,0,0.164809108802462,140.666982359293,18.8858361223288
9.7,"random_instances_SVM","SVM",84,15,1184,1088,96,1600,1430,170,0.820403785488957,0.28,1.28387096774194,472,170,302,31,1.8,57.47,8.4,0,0,0,0,0,0,0.215043229476864,132.439197686317,26.6023822702908
9.7,"random_instances_SVM","SVM",84,16,1084,992,92,1700,1526,174,0.792977917981072,0.24,1.28387096774194,486,174,312,14,1.8,61.06,8.8,0,0,0,0,0,0,0.193599850844221,108.441749843705,24.7769914994973
9.7,"random_instances_SVM","SVM",84,17,984,904,80,1800,1614,186,0.814372239747637,0.24,1.28387096774194,497,186,311,11,1.7,64.66,8.7,0,0,0,0,0,0,0.185169901961305,99.0037782481374,21.6090638973758
9.7,"random_instances_SVM","SVM",84,18,884,812,72,1900,1706,194,0.814056782334392,0.296,1.2736,540,194,346,43,1.8,68.25,8.8,0,0,0,0,0,0,0.180957685969994,91.1182587175193,21.4160814954648
9.7,"random_instances_SVM","SVM",84,19,784,718,66,2000,1800,200,0.823179810725556,0.264,1.2736,567,200,367,27,1.8,71.84,9,0,0,0,0,0,0,0.156316928263385,75.8108399035302,17.1752346075655
9.7,"random_instances_SVM","SVM",84,20,684,624,60,2100,1894,206,0.76661198738171,0.144,1.2736,584,206,378,17,1.8,75.43,9.2,0,0,0,0,0,0,0.117382198107564,67.7299304632088,12.2130629747882
9.7,"random_instances_SVM","SVM",84,21,584,528,56,2200,1990,210,0.772624605678243,0.152,1.2736,582,210,372,-2,1.8,79.02,9.5,0,0,0,0,0,0,0.123570432993205,56.7895612419141,13.6923547858505
9.7,"random_instances_SVM","SVM",84,22,484,435,49,2300,2083,217,0.803388012618301,0.176,1.2736,604,217,387,22,1.8,82.61,9.6,0,0,0,0,0,0,0.140626418482004,45.2435060110564,17.4260747929049
9.7,"random_instances_SVM","SVM",84,23,384,349,35,2400,2169,231,0.799141955835965,0.168,1.2736,643,231,412,39,1.8,86.21,9.4,0,0,0,0,0,0,0.132843526662731,37.1917439778673,17.0511326731097
9.7,"random_instances_SVM","SVM",84,24,284,259,25,2500,2259,241,0.708170347003154,0.128,1.2736,673,241,432,30,1.8,89.8,9.4,0,0,0,0,0,0,0.119366972572865,29.0807794770192,14.8957447327968
9.7,"random_instances_SVM","SVM",84,25,184,166,18,2600,2352,248,0.774839116719245,0.16,1.2736,689,248,441,16,1.8,93.39,9.5,0,0,0,0,0,0,0.0942114954899827,18.9020230172325,14.8619032981017
9.7,"random_instances_SVM","SVM",84,26,84,73,11,2700,2445,255,0.838454258675084,0.296,1.28387096774194,705,255,450,16,1.8,96.98,9.6,0,0,0,0,0,0,9.64072290826134e-08,8.13042269303678,8.13042269303678
9.7,"random_instances_SVM","SVM",84,27,0,0,0,2784,2518,266,0.804706624605677,0.224,1.28387096774194,732,266,466,27,1.8,100,9.5,0,0,0,0,0,0,0,0,0
9.7,"random_instances_SVM","SVM",85,0,2684,2448,236,100,95,5,0.798047733976935,0.24,1.26675268817204,20,5,15,0,3,3.59,19,0,0,0,0,0,0,0.0889799910533154,141.366193397645,10.5577811974073
9.7,"random_instances_SVM","SVM",85,1,2584,2361,223,200,182,18,0.813462054170014,0.353333333333333,1.26675268817204,47,18,29,27,1.6,7.18,10.1,0,0,0,0,0,0,0.27523257036014,235.567576524145,35.4703130237004
9.7,"random_instances_SVM","SVM",85,2,2484,2268,216,300,275,25,0.804934298739607,0.313333333333333,1.24963440860215,67,25,42,20,1.7,10.78,11,0,0,0,0,0,0,0.180360997754532,194.769142600819,22.3065065252208
9.7,"random_instances_SVM","SVM",85,3,2384,2177,207,400,366,34,0.808307857334401,0.286666666666667,1.27531182795699,88,34,54,21,1.6,14.37,10.8,0,0,0,0,0,0,0.206273530915764,186.07086542391,33.8300630797361
9.7,"random_instances_SVM","SVM",85,4,2284,2084,200,500,459,41,0.779436846339496,0.213333333333333,1.26675268817204,127,41,86,39,2.1,17.96,11.2,0,0,0,0,0,0,0.126571192222918,196.668440176493,16.6805676644357
9.7,"random_instances_SVM","SVM",85,5,2184,1989,195,600,554,46,0.78427996781979,0.2,1.26675268817204,138,46,92,11,2,21.55,12,0,0,0,0,0,0,0.127141140973089,172.504196592028,16.3994787882494
9.7,"random_instances_SVM","SVM",85,6,2084,1898,186,700,645,55,0.804081523196564,0.3,1.26675268817204,169,55,114,31,2.1,25.14,11.7,0,0,0,0,0,0,0.130655355080762,162.40695937237,15.4987736852305
9.7,"random_instances_SVM","SVM",85,7,1984,1803,181,800,740,60,0.795226602306247,0.24,1.2581935483871,185,60,125,16,2.1,28.74,12.3,0,0,0,0,0,0,0.142565484234395,156.173629969194,17.7096269795132
9.7,"random_instances_SVM","SVM",85,8,1884,1709,175,900,834,66,0.807363904532043,0.286666666666667,1.26675268817204,206,66,140,21,2.1,32.33,12.6,0,0,0,0,0,0,0.12501325308039,143.824752526934,14.6389247145936
9.7,"random_instances_SVM","SVM",85,9,1784,1617,167,1000,926,74,0.758144274604451,0.153333333333333,1.2581935483871,218,74,144,12,1.9,35.92,12.5,0,0,0,0,0,0,0.152645529956128,145.493856013454,20.16731776384
9.7,"random_instances_SVM","SVM",85,10,1684,1528,156,1100,1015,85,0.803920622150706,0.26,1.2581935483871,233,85,148,15,1.7,39.51,11.9,0,0,0,0,0,0,0.156094785797731,136.709896627834,20.3380038130055
9.7,"random_instances_SVM","SVM",85,11,1584,1438,146,1200,1105,95,0.783529096272454,0.233333333333333,1.2581935483871,272,95,177,39,1.9,43.1,11.6,0,0,0,0,0,0,0.162919804970259,142.023070712855,21.0147246183932
9.7,"random_instances_SVM","SVM",85,12,1484,1347,137,1300,1196,104,0.769123089300082,0.213333333333333,1.24963440860215,311,104,207,39,2,46.7,11.5,0,0,0,0,0,0,0.142243671306965,135.188466493363,16.6466090697469
9.7,"random_instances_SVM","SVM",85,13,1384,1258,126,1400,1285,115,0.806285867524803,0.286666666666667,1.2581935483871,334,115,219,23,1.9,50.29,11.2,0,0,0,0,0,0,0.148140981290058,120.739140795403,17.7321628893463
9.7,"random_instances_SVM","SVM",85,14,1284,1169,115,1500,1374,126,0.77525341914722,0.206666666666667,1.24963440860215,357,126,231,23,1.8,53.88,10.9,0,0,0,0,0,0,0.156159913720966,126.837035414872,19.7375968546938
9.7,"random_instances_SVM","SVM",85,15,1184,1080,104,1600,1463,137,0.744564226334137,0.186666666666667,1.2581935483871,387,137,250,30,1.8,57.47,10.7,0,0,0,0,0,0,0.14016780408332,111.331126043608,17.385666676411
9.7,"random_instances_SVM","SVM",85,16,1084,985,99,1700,1558,142,0.764607133279698,0.286666666666667,1.2581935483871,406,142,264,19,1.9,61.06,11,0,0,0,0,0,0,0.166553036804912,98.2777003372704,21.7374838932859
9.7,"random_instances_SVM","SVM",85,17,984,896,88,1800,1647,153,0.760482703137569,0.24,1.2581935483871,434,153,281,28,1.8,64.66,10.8,0,0,0,0,0,0,0.16609560408101,88.3163526173392,22.0633383825201
9.7,"random_instances_SVM","SVM",85,18,884,805,79,1900,1738,162,0.740257441673373,0.186666666666667,1.26675268817204,455,162,293,21,1.8,68.25,10.7,0,0,0,0,0,0,0.153922035697181,80.0732960759125,20.3046322951755
9.7,"random_instances_SVM","SVM",85,19,784,715,69,2000,1828,172,0.711252346473582,0.146666666666667,1.2581935483871,485,172,313,30,1.8,71.84,10.6,0,0,0,0,0,0,0.138025534381308,70.6155314680575,17.0479407090356
9.7,"random_instances_SVM","SVM",85,20,684,621,63,2100,1922,178,0.794320193081255,0.273333333333333,1.2581935483871,493,178,315,8,1.8,75.43,10.8,0,0,0,0,0,0,0.138649218992515,59.1119751498488,16.4152462818885
9.7,"random_instances_SVM","SVM",85,21,584,527,57,2200,2016,184,0.726859747921691,0.16,1.2581935483871,527,184,343,34,1.9,79.02,11,0,0,0,0,0,0,0.134035760800771,51.8225822721956,16.3234122502934
9.7,"random_instances_SVM","SVM",85,22,484,435,49,2300,2108,192,0.795768302493965,0.266666666666667,1.2581935483871,524,192,332,-3,1.7,82.61,11,0,0,0,0,0,0,0.13244780309312,40.148452611221,14.7521793173783
9.7,"random_instances_SVM","SVM",85,23,384,340,44,2400,2203,197,0.769938321265751,0.206666666666667,1.2581935483871,548,197,351,24,1.8,86.21,11.2,0,0,0,0,0,0,0.125222838928535,32.7045520775742,13.961124857529
9.7,"random_instances_SVM","SVM",85,24,284,250,34,2500,2293,207,0.752791633145611,0.173333333333333,1.26675268817204,570,207,363,22,1.8,89.8,11.1,0,0,0,0,0,0,0.120618511635014,24.3192952415639,14.6158980215428
9.7,"random_instances_SVM","SVM",85,25,184,162,22,2600,2381,219,0.802815768302491,0.306666666666667,1.26675268817204,599,219,380,29,1.7,93.39,10.9,0,0,0,0,0,0,0.0923747594230183,16.8507070138243,12.9636618055535
9.7,"random_instances_SVM","SVM",85,26,84,76,8,2700,2467,233,0.794588361491013,0.32,1.2581935483871,637,233,404,38,1.7,96.98,10.6,0,0,0,0,0,0,2.60792728345089e-05,8.14635200221826,8.14635200221826
9.7,"random_instances_SVM","SVM",85,27,0,0,0,2784,2543,241,0.749852507374633,0.173333333333333,1.24963440860215,654,241,413,17,1.7,100,10.6,0,0,0,0,0,0,0,0,0
9.7,"random_instances_SVM","SVM",86,0,2684,2439,245,100,91,9,0.739457901343624,0.328467153284672,1.19952907935013,23,9,14,0,1.6,3.59,10.1,0,0,0,0,0,0,0.213160326387336,233.116954659509,27.2201570336294
9.7,"random_instances_SVM","SVM",86,1,2584,2353,231,200,177,23,0.790087870193876,0.357664233576642,1.20890040028255,54,23,31,31,1.3,7.18,7.7,0,0,0,0,0,0,0.167116250238786,271.149326494618,18.1998925096975
9.7,"random_instances_SVM","SVM",86,2,2484,2261,223,300,269,31,0.772769538332794,0.364963503649635,1.18078643748528,80,31,49,26,1.6,10.78,8.7,0,0,0,0,0,0,0.253686184045086,256.351096605742,33.6498086637291
9.7,"random_instances_SVM","SVM",86,3,2384,2169,215,400,361,39,0.76017016132782,0.343065693430657,1.2276430421474,116,39,77,36,2,14.37,9.3,0,0,0,0,0,0,0.190445783646588,240.515166499284,23.7079678228873
9.7,"random_instances_SVM","SVM",86,4,2284,2077,207,500,453,47,0.760234088056166,0.277372262773723,1.23701436307982,126,47,79,10,1.7,17.96,9.6,0,0,0,0,0,0,0.252673960457939,231.960783366622,33.8361398654963
9.7,"random_instances_SVM","SVM",86,5,2184,1990,194,600,540,60,0.77604723604073,0.284671532846715,1.26512832587709,166,60,106,40,1.8,21.55,9,0,0,0,0,0,0,0.134903615588463,226.677659278098,15.0959489251764
9.7,"random_instances_SVM","SVM",86,6,2084,1896,188,700,634,66,0.740178529917711,0.321167883211679,1.20890040028255,181,66,115,15,1.7,25.14,9.6,0,0,0,0,0,0,0.273829602704759,214.37511792389,40.8630563820461
9.7,"random_instances_SVM","SVM",86,7,1984,1809,175,800,721,79,0.763261890371476,0.335766423357664,1.2276430421474,224,79,145,43,1.8,28.74,9.1,0,0,0,0,0,0,0.15273498925917,203.287080196615,20.3149272102482
9.7,"random_instances_SVM","SVM",86,8,1884,1720,164,900,810,90,0.771124877958069,0.364963503649635,1.26512832587709,262,90,172,38,1.9,32.33,9,0,0,0,0,0,0,0.232425802489259,192.335837201034,35.2014720549522
9.7,"random_instances_SVM","SVM",86,9,1784,1629,155,1000,901,99,0.774890743409739,0.35036496350365,1.25575700494467,269,99,170,7,1.7,35.92,9.1,0,0,0,0,0,0,0.210585045607451,174.586716194566,31.9437157515955
9.7,"random_instances_SVM","SVM",86,10,1684,1540,144,1100,990,110,0.780452368775862,0.306569343065693,1.27449964680951,317,110,207,48,1.9,39.51,9,0,0,0,0,0,0,0.143087404342766,172.573498253012,16.6180837079916
9.7,"random_instances_SVM","SVM",86,11,1584,1447,137,1200,1083,117,0.819813798874892,0.35036496350365,1.28387096774194,337,117,220,20,1.9,43.1,9.3,0,0,0,0,0,0,0.134244520962749,156.882815450912,15.361786063739
9.7,"random_instances_SVM","SVM",86,12,1484,1358,126,1300,1172,128,0.801455204797993,0.328467153284672,1.27449964680951,358,128,230,21,1.8,46.7,9.2,0,0,0,0,0,0,0.181588409206829,147.835110361268,23.022647263321
9.7,"random_instances_SVM","SVM",86,13,1384,1266,118,1400,1264,136,0.777773257706075,0.248175182481752,1.27449964680951,376,136,240,18,1.8,50.29,9.3,0,0,0,0,0,0,0.152789016364463,139.930014382951,17.435508582022
9.7,"random_instances_SVM","SVM",86,14,1284,1171,113,1500,1359,141,0.808196568878145,0.277372262773723,1.28387096774194,413,141,272,37,1.9,53.88,9.6,0,0,0,0,0,0,0.138690897457828,125.129979992153,15.30180154896
9.7,"random_instances_SVM","SVM",86,15,1184,1082,102,1600,1448,152,0.812398298386721,0.277372262773723,1.28387096774194,440,152,288,27,1.9,57.47,9.5,0,0,0,0,0,0,0.133756560217159,115.595932457159,14.6294163548036
9.7,"random_instances_SVM","SVM",86,16,1084,991,93,1700,1539,161,0.803006880840579,0.248175182481752,1.28387096774194,458,161,297,18,1.8,61.06,9.6,0,0,0,0,0,0,0.126966422635595,104.742858052976,13.6564336226178
9.7,"random_instances_SVM","SVM",86,17,984,901,83,1800,1629,171,0.807423636617229,0.226277372262774,1.28387096774194,470,171,299,12,1.7,64.66,9.5,0,0,0,0,0,0,0.155756167500551,98.9368635345693,19.683910595975
9.7,"random_instances_SVM","SVM",86,18,884,807,77,1900,1723,177,0.727125854293553,0.116788321167883,1.28387096774194,501,177,324,31,1.8,68.25,9.7,0,0,0,0,0,0,0.155245686912463,89.3609570747998,21.6513722962213
9.7,"random_instances_SVM","SVM",86,19,784,716,68,2000,1814,186,0.766243200520711,0.182481751824818,1.28387096774194,522,186,336,21,1.8,71.84,9.8,0,0,0,0,0,0,0.15215217727012,78.5121111388431,20.139288884533
9.7,"random_instances_SVM","SVM",86,20,684,629,55,2100,1901,199,0.787048444837046,0.218978102189781,1.28387096774194,543,199,344,21,1.7,75.43,9.6,0,0,0,0,0,0,0.130626835426359,65.8410561730882,14.7720366662871
9.7,"random_instances_SVM","SVM",86,21,584,538,46,2200,1992,208,0.770375191780183,0.197080291970803,1.28387096774194,586,208,378,43,1.8,79.02,9.6,0,0,0,0,0,0,0.132832509042606,58.530429328332,15.4831345197911
9.7,"random_instances_SVM","SVM",86,22,484,444,40,2300,2086,214,0.789471848993443,0.197080291970803,1.28387096774194,611,214,397,25,1.9,82.61,9.7,0,0,0,0,0,0,0.143457507021133,46.8566273231874,18.8296709808318
9.7,"random_instances_SVM","SVM",86,23,384,355,29,2400,2175,225,0.814647356920359,0.218978102189781,1.28387096774194,635,225,410,24,1.8,86.21,9.7,0,0,0,0,0,0,0.134590628441504,36.9547485371183,18.1367328098334
9.7,"random_instances_SVM","SVM",86,24,284,262,22,2500,2268,232,0.766806918034312,0.182481751824818,1.28387096774194,659,232,427,24,1.8,89.8,9.8,0,0,0,0,0,0,0.120495594920715,25.3659737906538,14.4566395353298
9.7,"random_instances_SVM","SVM",86,25,184,170,14,2600,2360,240,0.75624738481566,0.138686131386861,1.27449964680951,669,240,429,10,1.8,93.39,9.8,0,0,0,0,0,0,0.0908508296657999,17.1718497695661,13.8003903372355
9.7,"random_instances_SVM","SVM",86,26,84,73,11,2700,2457,243,0.71618857222558,0.131386861313869,1.27449964680951,685,243,442,16,1.8,96.98,10.1,0,0,0,0,0,0,3.7689959940697e-07,9.00867479728251,9.00867479728251
9.7,"random_instances_SVM","SVM",86,27,0,0,0,2784,2530,254,0.801060021386399,0.262773722627737,1.27449964680951,705,254,451,20,1.8,100,10,0,0,0,0,0,0,0,0,0
9.7,"random_instances_SVM","SVM",87,0,2684,2439,245,100,95,5,0.838964040513903,0.24822695035461,1.28387096774194,22,5,17,0,3.4,3.59,19,0,0,0,0,0,0,0.0934053779978661,139.012605601764,10.7074727457377
9.7,"random_instances_SVM","SVM",87,1,2584,2353,231,200,181,19,0.779564045045657,0.226950354609929,1.26566003202928,55,19,36,33,1.9,7.18,9.5,0,0,0,0,0,0,0.151136734980954,260.522457008071,33.8923653606025
9.7,"random_instances_SVM","SVM",87,2,2484,2266,218,300,268,32,0.818520154986067,0.276595744680851,1.27476549988561,82,32,50,27,1.6,10.78,8.4,0,0,0,0,0,0,0.182811389824282,289.677066857221,41.3955474267779
9.7,"random_instances_SVM","SVM",87,3,2384,2179,205,400,355,45,0.816786758208146,0.312056737588652,1.27476549988561,110,45,65,28,1.4,14.37,7.9,0,0,0,0,0,0,0.171522255785454,276.248377561499,36.8505231342327
9.7,"random_instances_SVM","SVM",87,4,2284,2088,196,500,446,54,0.808119774318537,0.319148936170213,1.28387096774194,137,54,83,27,1.5,17.96,8.3,0,0,0,0,0,0,0.136642084793847,241.428278041574,21.3324977063399
9.7,"random_instances_SVM","SVM",87,5,2184,1995,189,600,539,61,0.811722520562844,0.340425531914894,1.28387096774194,157,61,96,20,1.6,21.55,8.8,0,0,0,0,0,0,0.161337383881359,229.812412976019,26.9629055255914
9.7,"random_instances_SVM","SVM",87,6,2084,1908,176,700,626,74,0.809218725216959,0.375886524822695,1.27476549988561,184,74,110,27,1.5,25.14,8.5,0,0,0,0,0,0,0.171047360820118,236.145253341058,27.442312682627
9.7,"random_instances_SVM","SVM",87,7,1984,1818,166,800,716,84,0.793986359413594,0.347517730496454,1.24744909631663,217,84,133,33,1.6,28.74,8.5,0,0,0,0,0,0,0.194343263220596,221.539674298638,25.9336704320716
9.7,"random_instances_SVM","SVM",87,8,1884,1725,159,900,809,91,0.7828155801781,0.269503546099291,1.27476549988561,257,91,166,40,1.8,32.33,8.9,0,0,0,0,0,0,0.144387702777892,203.380885878673,17.701967299715
9.7,"random_instances_SVM","SVM",87,9,1784,1634,150,1000,900,100,0.801441098497726,0.226950354609929,1.28387096774194,284,100,184,27,1.8,35.92,9,0,0,0,0,0,0,0.134273372782281,182.548798083174,16.9932012560215
9.7,"random_instances_SVM","SVM",87,10,1684,1538,146,1100,996,104,0.796048308521967,0.26241134751773,1.28387096774194,300,104,196,16,1.9,39.51,9.6,0,0,0,0,0,0,0.164421549425341,174.31411358777,22.9344601820342
9.7,"random_instances_SVM","SVM",87,11,1584,1444,140,1200,1090,110,0.784090136632455,0.24113475177305,1.28387096774194,333,110,223,33,2,43.1,9.9,0,0,0,0,0,0,0.165739721279643,154.226304742202,25.2876471685253
9.7,"random_instances_SVM","SVM",87,12,1484,1356,128,1300,1178,122,0.792553191489364,0.234042553191489,1.28387096774194,363,122,241,30,2,46.7,9.7,0,0,0,0,0,0,0.181978877653867,142.320698093137,28.4382067850202
9.7,"random_instances_SVM","SVM",87,13,1384,1268,116,1400,1266,134,0.786922484308795,0.234042553191489,1.27476549988561,400,134,266,37,2,50.29,9.4,0,0,0,0,0,0,0.162629241550107,131.847426116441,23.6232267000073
9.7,"random_instances_SVM","SVM",87,14,1284,1177,107,1500,1357,143,0.80869190854916,0.290780141843972,1.28387096774194,407,143,264,7,1.8,53.88,9.5,0,0,0,0,0,0,0.163522021406988,122.653546714879,22.783628545135
9.7,"random_instances_SVM","SVM",87,15,1184,1087,97,1600,1447,153,0.790955747399906,0.234042553191489,1.28387096774194,431,153,278,24,1.8,57.47,9.5,0,0,0,0,0,0,0.160682041956057,114.098736687744,21.2945731824586
9.7,"random_instances_SVM","SVM",87,16,1084,993,91,1700,1541,159,0.704353884848075,0.113475177304965,1.28387096774194,453,159,294,22,1.8,61.06,9.7,0,0,0,0,0,0,0.161559150526535,110.361214070234,20.9342989145953
9.7,"random_instances_SVM","SVM",87,17,984,900,84,1800,1634,166,0.809320689733309,0.26241134751773,1.27476549988561,476,166,310,23,1.9,64.66,9.8,0,0,0,0,0,0,0.155106926526786,90.5822888073166,20.0974669413377
9.7,"random_instances_SVM","SVM",87,18,884,809,75,1900,1725,175,0.793102666938572,0.26241134751773,1.28387096774194,508,175,333,32,1.9,68.25,9.9,0,0,0,0,0,0,0.163341545753993,85.0085886090078,21.5690033280474
9.7,"random_instances_SVM","SVM",87,19,784,722,62,2000,1812,188,0.771191625314391,0.205673758865248,1.28387096774194,533,188,345,25,1.8,71.84,9.6,0,0,0,0,0,0,0.17074052566236,76.2605285528679,22.2240780351214
9.7,"random_instances_SVM","SVM",87,20,684,630,54,2100,1904,196,0.778278159200602,0.170212765957447,1.28387096774194,549,196,353,16,1.8,75.43,9.7,0,0,0,0,0,0,0.143940461093679,65.565838066691,16.9146946287413
9.7,"random_instances_SVM","SVM",87,21,584,535,49,2200,1999,201,0.802177508893575,0.234042553191489,1.28387096774194,553,201,352,4,1.8,79.02,9.9,0,0,0,0,0,0,0.155361853269076,54.2730634358022,19.2753407384665
9.7,"random_instances_SVM","SVM",87,22,484,443,41,2300,2091,209,0.815013708562755,0.319148936170213,1.27476549988561,585,209,376,32,1.8,82.61,10,0,0,0,0,0,0,0.147245155547585,47.1850298375476,17.9869020503972
9.7,"random_instances_SVM","SVM",87,23,384,352,32,2400,2182,218,0.816650805519682,0.269503546099291,1.28387096774194,614,218,396,29,1.8,86.21,10,0,0,0,0,0,0,0.133250710646137,36.7908431383134,17.4690228446689
9.7,"random_instances_SVM","SVM",87,24,284,256,28,2500,2278,222,0.790825459406796,0.163120567375887,1.27476549988561,620,222,398,6,1.8,89.8,10.3,0,0,0,0,0,0,0.123376663661283,25.5702813958843,15.3852110192462
9.7,"random_instances_SVM","SVM",87,25,184,167,17,2600,2367,233,0.809462307117129,0.24113475177305,1.27476549988561,653,233,420,33,1.8,93.39,10.2,0,0,0,0,0,0,0.0763054127238721,17.6115418174153,15.3260636974513
9.7,"random_instances_SVM","SVM",87,26,84,78,6,2700,2456,244,0.815087349602343,0.290780141843972,1.26566003202928,652,244,408,-1,1.7,96.98,10.1,0,0,0,0,0,0,0.00023153271964644,7.93296515437191,7.93296515437191
9.7,"random_instances_SVM","SVM",87,27,0,0,0,2784,2534,250,0.742137402850479,0.141843971631206,1.26566003202928,698,250,448,46,1.8,100,10.1,0,0,0,0,0,0,0,0,0
9.7,"random_instances_SVM","SVM",88,0,2684,2437,247,100,91,9,0.296543602425955,0,0.884444444444444,30,9,21,0,2.3,3.59,10.1,0,0,0,0,0,0,0.10722181476408,231.407978443099,11.0637891066331
9.7,"random_instances_SVM","SVM",88,1,2584,2351,233,200,177,23,0.693982217511631,0.125925925925926,1.2363201911589,70,23,47,40,2,7.18,7.7,0,0,0,0,0,0,0.131011751519571,302.485160902673,15.8161285466738
9.7,"random_instances_SVM","SVM",88,2,2484,2258,226,300,270,30,0.678684566919867,0.140740740740741,1.15072879330944,91,30,61,21,2,10.78,9,0,0,0,0,0,0,0.130477332405739,261.282380389536,18.3326699775975
9.7,"random_instances_SVM","SVM",88,3,2384,2169,215,400,359,41,0.725814049343462,0.244444444444444,1.2363201911589,117,41,76,26,1.9,14.37,8.8,0,0,0,0,0,0,0.14218861271015,256.455909952235,17.1198347954509
9.7,"random_instances_SVM","SVM",88,4,2284,2079,205,500,449,51,0.744738856503568,0.259259259259259,1.25534050179211,152,51,101,35,2,17.96,8.8,0,0,0,0,0,0,0.131644510604209,243.004162171727,15.0476912174585
9.7,"random_instances_SVM","SVM",88,5,2184,1993,191,600,535,65,0.762603780250848,0.192592592592593,1.25534050179211,182,65,117,30,1.8,21.55,8.2,0,0,0,0,0,0,0.155384265466222,246.667575950257,19.3285711224257
9.7,"random_instances_SVM","SVM",88,6,2084,1902,182,700,626,74,0.78516163222046,0.22962962962963,1.27436081242533,203,74,129,21,1.7,25.14,8.5,0,0,0,0,0,0,0.167064421714076,239.787873918465,21.7189207035467
9.7,"random_instances_SVM","SVM",88,7,1984,1810,174,800,718,82,0.774827768945416,0.207407407407407,1.26485065710872,233,82,151,30,1.8,28.74,8.8,0,0,0,0,0,0,0.136540654618897,208.689767544425,17.0417042505054
9.7,"random_instances_SVM","SVM",88,8,1884,1717,167,900,811,89,0.783118412530178,0.185185185185185,1.26485065710872,256,89,167,23,1.9,32.33,9.1,0,0,0,0,0,0,0.153664384939253,200.445564675008,24.8287062079336
9.7,"random_instances_SVM","SVM",88,9,1784,1623,161,1000,905,95,0.799729140905614,0.274074074074074,1.26485065710872,279,95,184,23,1.9,35.92,9.5,0,0,0,0,0,0,0.117191730697878,176.961937040998,14.8690197085789
9.7,"random_instances_SVM","SVM",88,10,1684,1533,151,1100,995,105,0.784537478655124,0.214814814814815,1.26485065710872,297,105,192,18,1.8,39.51,9.5,0,0,0,0,0,0,0.170657620078342,186.013400738729,30.8854895660214
9.7,"random_instances_SVM","SVM",88,11,1584,1442,142,1200,1086,114,0.795047989165633,0.237037037037037,1.26485065710872,320,114,206,23,1.8,43.1,9.5,0,0,0,0,0,0,0.152564970834756,159.725720994157,27.6307280487978
9.7,"random_instances_SVM","SVM",88,12,1484,1352,132,1300,1176,124,0.809656715539075,0.296296296296296,1.26485065710872,352,124,228,32,1.8,46.7,9.5,0,0,0,0,0,0,0.127251584806961,149.250238025362,20.2050852178539
9.7,"random_instances_SVM","SVM",88,13,1384,1259,125,1400,1269,131,0.780309721486187,0.2,1.26485065710872,380,131,249,28,1.9,50.29,9.7,0,0,0,0,0,0,0.152130383143202,141.453517338137,17.8339559785479
9.7,"random_instances_SVM","SVM",88,14,1284,1168,116,1500,1360,140,0.805387740681856,0.259259259259259,1.26485065710872,396,140,256,16,1.8,53.88,9.7,0,0,0,0,0,0,0.132422618363837,128.47009858867,15.0472143318063
9.7,"random_instances_SVM","SVM",88,15,1184,1077,107,1600,1451,149,0.787440381558032,0.214814814814815,1.25534050179211,444,149,295,48,2,57.47,9.7,0,0,0,0,0,0,0.15337619646612,124.234559201721,18.3054090575401
9.7,"random_instances_SVM","SVM",88,16,1084,986,98,1700,1542,158,0.762680327386208,0.192592592592593,1.26485065710872,451,158,293,7,1.9,61.06,9.8,0,0,0,0,0,0,0.167529198479691,115.498362316631,20.9114854478325
9.7,"random_instances_SVM","SVM",88,17,984,895,89,1800,1633,167,0.812630277336168,0.318518518518519,1.27436081242533,470,167,303,19,1.8,64.66,9.8,0,0,0,0,0,0,0.155595717330029,102.597333416136,17.1964756896329
9.7,"random_instances_SVM","SVM",88,18,884,810,74,1900,1718,182,0.777218394865462,0.237037037037037,1.27436081242533,504,182,322,34,1.8,68.25,9.4,0,0,0,0,0,0,0.15030718486544,87.6444269020121,18.0566835159146
9.7,"random_instances_SVM","SVM",88,19,784,725,59,2000,1803,197,0.815062120944482,0.259259259259259,1.26485065710872,536,197,339,32,1.7,71.84,9.2,0,0,0,0,0,0,0.159870514569407,82.3715167794572,18.629472708324
9.7,"random_instances_SVM","SVM",88,20,684,632,52,2100,1896,204,0.783183183183191,0.214814814814815,1.27436081242533,570,204,366,34,1.8,75.43,9.3,0,0,0,0,0,0,0.156097794573504,69.7684878352974,18.1080885289997
9.7,"random_instances_SVM","SVM",88,21,584,538,46,2200,1990,210,0.809085556144392,0.274074074074074,1.27436081242533,599,210,389,29,1.9,79.02,9.5,0,0,0,0,0,0,0.161066520392663,60.9681466923245,19.3896890729026
9.7,"random_instances_SVM","SVM",88,22,484,448,36,2300,2080,220,0.79898133427546,0.207407407407407,1.27436081242533,613,220,393,14,1.8,82.61,9.5,0,0,0,0,0,0,0.149761406119834,49.0676103793225,17.7773843327448
9.7,"random_instances_SVM","SVM",88,23,384,355,29,2400,2173,227,0.822952364128844,0.318518518518519,1.27436081242533,624,227,397,11,1.7,86.21,9.6,0,0,0,0,0,0,0.137613947802985,35.7163000504686,20.2141228673452
9.7,"random_instances_SVM","SVM",88,24,284,264,20,2500,2264,236,0.822493081316622,0.311111111111111,1.27436081242533,654,236,418,30,1.8,89.8,9.6,0,0,0,0,0,0,0.124217043046652,27.5668075155949,16.7908817512616
9.7,"random_instances_SVM","SVM",88,25,184,170,14,2600,2358,242,0.802084437378558,0.244444444444444,1.27436081242533,679,242,437,25,1.8,93.39,9.7,0,0,0,0,0,0,0.0757428849475481,16.9566863290567,14.7315377278939
9.7,"random_instances_SVM","SVM",88,26,84,77,7,2700,2451,249,0.773067184831902,0.140740740740741,1.27318736784667,677,249,428,-2,1.7,96.98,9.8,0,0,0,0,0,0,0.000277092218026925,7.4567106309854,7.4567106309854
9.7,"random_instances_SVM","SVM",88,27,0,0,0,2784,2528,256,0.750927397986228,0.2,1.26485065710872,700,256,444,23,1.7,100,9.9,0,0,0,0,0,0,0,0,0
9.7,"random_instances_SVM","SVM",89,0,2684,2437,247,100,89,11,0.69630624179497,0.195488721804511,1.21629881154499,33,11,22,0,2,3.59,8.1,0,0,0,0,0,0,0.129434996114944,292.172427764419,15.586278279601
9.7,"random_instances_SVM","SVM",89,1,2584,2351,233,200,175,25,0.770014321518092,0.338345864661654,1.206645646374,66,25,41,33,1.6,7.18,7,0,0,0,0,0,0,0.142884854583958,326.482276017678,15.6345488797885
9.7,"random_instances_SVM","SVM",89,2,2484,2259,225,300,267,33,0.778863826232254,0.308270676691729,1.24525830705797,82,33,49,16,1.5,10.78,8.1,0,0,0,0,0,0,0.206551248815737,297.40263663697,28.5161310667383
9.7,"random_instances_SVM","SVM",89,3,2384,2174,210,400,352,48,0.788948561880895,0.278195488721804,1.26456463739995,118,48,70,36,1.5,14.37,7.3,0,0,0,0,0,0,0.242358721035763,317.631362346421,44.7274894062169
9.7,"random_instances_SVM","SVM",89,4,2284,2085,199,500,441,59,0.78947965150973,0.285714285714286,1.25491147222896,144,59,85,26,1.4,17.96,7.5,0,0,0,0,0,0,0.234774636854977,292.580807978773,44.7968857896559
9.7,"random_instances_SVM","SVM",89,5,2184,1994,190,600,532,68,0.781012053944394,0.315789473684211,1.24525830705797,166,68,98,22,1.4,21.55,7.8,0,0,0,0,0,0,0.156464064750511,257.336913705477,35.47328926279
9.7,"random_instances_SVM","SVM",89,6,2084,1903,181,700,623,77,0.754767872061107,0.323308270676692,1.22595197671598,204,77,127,38,1.6,25.14,8.1,0,0,0,0,0,0,0.127780541435217,233.361041129367,22.8728891948434
9.7,"random_instances_SVM","SVM",89,7,1984,1814,170,800,712,88,0.799039264828738,0.338345864661654,1.27421780257094,230,88,142,26,1.6,28.74,8.1,0,0,0,0,0,0,0.137159940027975,219.742423645833,15.661282195134
9.7,"random_instances_SVM","SVM",89,8,1884,1720,164,900,806,94,0.785242869077459,0.270676691729323,1.27421780257094,255,94,161,25,1.7,32.33,8.6,0,0,0,0,0,0,0.144277275147904,205.86544215628,18.773862965726
9.7,"random_instances_SVM","SVM",89,9,1784,1626,158,1000,900,100,0.810305525719067,0.255639097744361,1.27304448967723,277,100,177,22,1.8,35.92,9,0,0,0,0,0,0,0.185550135454076,192.074607839691,27.2283920831541
9.7,"random_instances_SVM","SVM",89,10,1684,1533,151,1100,993,107,0.815586585511402,0.293233082706767,1.27421780257094,303,107,196,26,1.8,39.51,9.3,0,0,0,0,0,0,0.123500284597953,171.442464359377,13.6907932826534
9.7,"random_instances_SVM","SVM",89,11,1584,1438,146,1200,1088,112,0.810794844253495,0.255639097744361,1.27421780257094,324,112,212,21,1.9,43.1,9.7,0,0,0,0,0,0,0.135197326678972,155.522553172152,16.3400844524942
9.7,"random_instances_SVM","SVM",89,12,1484,1349,135,1300,1177,123,0.803407327843423,0.263157894736842,1.27421780257094,348,123,225,24,1.8,46.7,9.6,0,0,0,0,0,0,0.148234514776282,150.238813501418,19.5550184255859
9.7,"random_instances_SVM","SVM",89,13,1384,1254,130,1400,1272,128,0.816965031626692,0.293233082706767,1.27421780257094,373,128,245,25,1.9,50.29,9.9,0,0,0,0,0,0,0.129391932154118,132.017321450883,15.0944261481626
9.7,"random_instances_SVM","SVM",89,14,1284,1163,121,1500,1363,137,0.809887814775041,0.233082706766917,1.27421780257094,395,137,258,22,1.9,53.88,9.9,0,0,0,0,0,0,0.167064522059072,123.187982281422,21.2224987766516
9.7,"random_instances_SVM","SVM",89,15,1184,1074,110,1600,1452,148,0.784395512591007,0.18796992481203,1.27421780257094,424,148,276,29,1.9,57.47,9.8,0,0,0,0,0,0,0.170114997398083,122.68616255812,23.3083442257877
9.7,"random_instances_SVM","SVM",89,16,1084,982,102,1700,1544,156,0.797696622508662,0.203007518796992,1.27421780257094,452,156,296,28,1.9,61.06,9.9,0,0,0,0,0,0,0.151972249430249,105.42666451144,18.6539505208763
9.7,"random_instances_SVM","SVM",89,17,984,891,93,1800,1635,165,0.821595655806192,0.24812030075188,1.27421780257094,485,165,320,33,1.9,64.66,9.9,0,0,0,0,0,0,0.165061268754325,100.393163454036,20.0215234865869
9.7,"random_instances_SVM","SVM",89,18,884,799,85,1900,1727,173,0.795804988662138,0.218045112781955,1.27421780257094,505,173,332,20,1.9,68.25,10,0,0,0,0,0,0,0.153326768663148,85.0256359077862,18.2845564609692
9.7,"random_instances_SVM","SVM",89,19,784,709,75,2000,1817,183,0.827944862155398,0.285714285714286,1.27421780257094,531,183,348,26,1.9,71.84,9.9,0,0,0,0,0,0,0.141988953914023,75.5044599526309,16.3340762365372
9.7,"random_instances_SVM","SVM",89,20,684,617,67,2100,1909,191,0.817716911325942,0.270676691729323,1.27421780257094,549,191,358,18,1.9,75.43,10,0,0,0,0,0,0,0.159200150870826,68.2871745947865,19.3651167560912
9.7,"random_instances_SVM","SVM",89,21,584,524,60,2200,2002,198,0.781972789115653,0.203007518796992,1.27421780257094,573,198,375,24,1.9,79.02,10.1,0,0,0,0,0,0,0.12933854134952,55.3245481535569,15.13459971927
9.7,"random_instances_SVM","SVM",89,22,484,433,51,2300,2093,207,0.715884950471419,0.135338345864662,1.27421780257094,605,207,398,32,1.9,82.61,10.1,0,0,0,0,0,0,0.136041857237321,49.2792363968156,17.3064933946007
9.7,"random_instances_SVM","SVM",89,23,384,345,39,2400,2181,219,0.800286430361623,0.225563909774436,1.27421780257094,632,219,413,27,1.9,86.21,10,0,0,0,0,0,0,0.138498831287367,38.492233789766,17.0104874111355
9.7,"random_instances_SVM","SVM",89,24,284,255,29,2500,2271,229,0.76590285236902,0.172932330827068,1.26456463739995,622,229,393,-10,1.7,89.8,9.9,0,0,0,0,0,0,0.122443242379761,28.1732841116114,15.2516310953418
9.7,"random_instances_SVM","SVM",89,25,184,169,15,2600,2357,243,0.765043561284163,0.150375939849624,1.26456463739995,686,243,443,64,1.8,93.39,9.7,0,0,0,0,0,0,0.104655070169942,18.3600757649827,14.2098984952828
9.7,"random_instances_SVM","SVM",89,26,84,77,7,2700,2449,251,0.761093209213513,0.165413533834586,1.26456463739995,714,251,463,28,1.8,96.98,9.8,0,0,0,0,0,0,2.24839008797806e-07,8.43848782506025,8.43848782506025
9.7,"random_instances_SVM","SVM",89,27,0,0,0,2784,2526,258,0.780128893662731,0.218045112781955,1.27421780257094,704,258,446,-10,1.7,100,9.8,0,0,0,0,0,0,0,0,0
9.7,"random_instances_SVM","SVM",90,0,2684,2418,266,100,93,7,0.824858757062151,0.279661016949153,1.26211044286495,23,7,16,0,2.3,3.59,13.3,0,0,0,0,0,0,0.0978941574623581,203.531775235108,11.4816408242051
9.7,"random_instances_SVM","SVM",90,1,2584,2332,252,200,179,21,0.83232967763377,0.220338983050847,1.27299070530344,53,21,32,30,1.5,7.18,8.5,0,0,0,0,0,0,0.185708993187417,259.50308647201,22.1830111957292
9.7,"random_instances_SVM","SVM",90,2,2484,2240,244,300,271,29,0.798384845463613,0.161016949152542,1.27299070530344,75,29,46,22,1.6,10.78,9.3,0,0,0,0,0,0,0.117006505403262,244.112542813477,13.0447254160419
9.7,"random_instances_SVM","SVM",90,3,2384,2152,232,400,359,41,0.829225656364245,0.194915254237288,1.27299070530344,104,41,63,29,1.5,14.37,8.8,0,0,0,0,0,0,0.221627479065672,239.313698669742,27.9032443527285
9.7,"random_instances_SVM","SVM",90,4,2284,2061,223,500,450,50,0.820378863409778,0.211864406779661,1.25123018042646,127,50,77,23,1.5,17.96,9,0,0,0,0,0,0,0.212440895274105,205.427057002416,31.4749379202821
9.7,"random_instances_SVM","SVM",90,5,2184,1970,214,600,541,59,0.810893984712535,0.203389830508475,1.25123018042646,164,59,105,37,1.8,21.55,9.2,0,0,0,0,0,0,0.1824530912019,214.475349334141,25.8614160973762
9.7,"random_instances_SVM","SVM",90,6,2084,1879,205,700,632,68,0.809584579594556,0.194915254237288,1.24034991798797,178,68,110,14,1.6,25.14,9.3,0,0,0,0,0,0,0.172239175660025,203.087549002772,32.3723779337499
9.7,"random_instances_SVM","SVM",90,7,1984,1786,198,800,725,75,0.804705882352949,0.186440677966102,1.24034991798797,202,75,127,24,1.7,28.74,9.7,0,0,0,0,0,0,0.149825379156795,176.747270304912,27.8988507426211
9.7,"random_instances_SVM","SVM",90,8,1884,1702,182,900,809,91,0.767018943170497,0.127118644067797,1.22946965554948,239,91,148,37,1.6,32.33,8.9,0,0,0,0,0,0,0.164865163784986,203.145156140775,33.5075376585148
9.7,"random_instances_SVM","SVM",90,9,1784,1610,174,1000,901,99,0.776862745098048,0.144067796610169,1.22946965554948,248,99,149,9,1.5,35.92,9.1,0,0,0,0,0,0,0.153433030816092,183.571339602828,27.4607164924508
9.7,"random_instances_SVM","SVM",90,10,1684,1521,163,1100,990,110,0.791445663010975,0.161016949152542,1.22946965554948,283,110,173,35,1.6,39.51,9,0,0,0,0,0,0,0.15508541383973,170.462810591002,27.05055089667
9.7,"random_instances_SVM","SVM",90,11,1584,1426,158,1200,1085,115,0.778484546360926,0.144067796610169,1.22946965554948,293,115,178,10,1.5,43.1,9.4,0,0,0,0,0,0,0.140665607657445,155.358092666174,23.2915527382524
9.7,"random_instances_SVM","SVM",90,12,1484,1334,150,1300,1177,123,0.757653705550025,0.127118644067797,1.21858939311099,328,123,205,35,1.7,46.7,9.6,0,0,0,0,0,0,0.136154028286492,146.625607108368,19.9137419041572
9.7,"random_instances_SVM","SVM",90,13,1384,1244,140,1400,1267,133,0.774396809571295,0.135593220338983,1.21858939311099,351,133,218,23,1.6,50.29,9.5,0,0,0,0,0,0,0.126837244249184,139.484289210844,17.6596394358973
9.7,"random_instances_SVM","SVM",90,14,1284,1148,136,1500,1363,137,0.754084413426395,0.0932203389830508,1.22946965554948,368,137,231,17,1.7,53.88,9.9,0,0,0,0,0,0,0.115298251850838,128.183216334718,15.1413014216475
9.7,"random_instances_SVM","SVM",90,15,1184,1059,125,1600,1452,148,0.769245596543708,0.135593220338983,1.24034991798797,384,148,236,16,1.6,57.47,9.8,0,0,0,0,0,0,0.131026467190646,107.562317448004,19.0371182539711
9.7,"random_instances_SVM","SVM",90,16,1084,965,119,1700,1546,154,0.79142572283151,0.144067796610169,1.27299070530344,415,154,261,31,1.7,61.06,10,0,0,0,0,0,0,0.124727229408716,103.073903876635,15.366336494432
9.7,"random_instances_SVM","SVM",90,17,984,877,107,1800,1634,166,0.783217015619813,0.211864406779661,1.26211044286495,447,166,281,32,1.7,64.66,9.8,0,0,0,0,0,0,0.128013308243516,94.6596349102545,16.1755883591726
9.7,"random_instances_SVM","SVM",90,18,884,789,95,1900,1722,178,0.738750415420411,0.11864406779661,1.25123018042646,474,178,296,27,1.7,68.25,9.7,0,0,0,0,0,0,0.143347934778433,86.9522573271401,20.4228394500783
9.7,"random_instances_SVM","SVM",90,19,784,705,79,2000,1806,194,0.717986041874381,0.0847457627118644,1.25123018042646,524,194,330,50,1.7,71.84,9.3,0,0,0,0,0,0,0.129811380620634,77.1480281691932,15.508487043103
9.7,"random_instances_SVM","SVM",90,20,684,618,66,2100,1893,207,0.710475240943839,0.0932203389830508,1.26211044286495,557,207,350,33,1.7,75.43,9.1,0,0,0,0,0,0,0.15270708734193,72.1553777038774,19.2823237127217
9.7,"random_instances_SVM","SVM",90,21,584,525,59,2200,1986,214,0.73851113326687,0.110169491525424,1.27299070530344,567,214,353,10,1.6,79.02,9.3,0,0,0,0,0,0,0.13328137012239,60.3551782613978,15.9008338941759
9.7,"random_instances_SVM","SVM",90,22,484,436,48,2300,2075,225,0.749371884346965,0.144067796610169,1.24034991798797,596,225,371,29,1.6,82.61,9.2,0,0,0,0,0,0,0.143186527078923,53.3951362445079,18.3113210394937
9.7,"random_instances_SVM","SVM",90,23,384,347,37,2400,2164,236,0.727843137254906,0.127118644067797,1.27181852233355,637,236,401,41,1.7,86.21,9.2,0,0,0,0,0,0,0.142545961933371,43.2172877290139,18.1905243940338
9.7,"random_instances_SVM","SVM",90,24,284,255,29,2500,2256,244,0.754815553339984,0.152542372881356,1.26211044286495,650,244,406,13,1.7,89.8,9.2,0,0,0,0,0,0,0.1259961541672,30.2147979991404,15.6347838381309
9.7,"random_instances_SVM","SVM",90,25,184,166,18,2600,2345,255,0.789990029910274,0.228813559322034,1.26211044286495,699,255,444,49,1.7,93.39,9.2,0,0,0,0,0,0,0.0974460583337353,18.3890644929165,14.5057732749351
9.7,"random_instances_SVM","SVM",90,26,84,76,8,2700,2435,265,0.739494848786975,0.11864406779661,1.27299070530344,703,265,438,4,1.7,96.98,9.2,0,0,0,0,0,0,5.29050372307524e-07,8.37898472231469,8.37898472231469
9.7,"random_instances_SVM","SVM",90,27,0,0,0,2784,2511,273,0.809132602193424,0.228813559322034,1.28387096774194,732,273,459,29,1.7,100,9.2,0,0,0,0,0,0,0,0,0
9.7,"random_instances_SVM","SVM",91,0,2684,2431,253,100,94,6,0.86156970177587,0.371212121212121,1.27414467253177,20,6,14,0,2.3,3.59,15.7,0,0,0,0,0,0,0.0766689241228643,157.99534934362,8.01789491374241
9.7,"random_instances_SVM","SVM",91,1,2584,2345,239,200,180,20,0.796794271021065,0.333333333333333,1.2352394916911,58,20,38,38,1.9,7.18,9,0,0,0,0,0,0,0.151704731028942,279.943778475955,16.3475729385803
9.7,"random_instances_SVM","SVM",91,2,2484,2257,227,300,268,32,0.780459231490155,0.303030303030303,1.2352394916911,87,32,55,29,1.7,10.78,8.4,0,0,0,0,0,0,0.218507650231379,255.701181146574,30.0922666596455
9.7,"random_instances_SVM","SVM",91,3,2384,2163,221,400,362,38,0.786076466488843,0.303030303030303,1.20606060606061,101,38,63,14,1.7,14.37,9.5,0,0,0,0,0,0,0.125623770186894,230.058047509364,14.2536542561864
9.7,"random_instances_SVM","SVM",91,4,2284,2078,206,500,447,53,0.822609521063128,0.287878787878788,1.2644183773216,144,53,91,43,1.7,17.96,8.4,0,0,0,0,0,0,0.187926666085692,253.981489804741,27.3776958359376
9.7,"random_instances_SVM","SVM",91,5,2184,1988,196,600,537,63,0.831927522649164,0.325757575757576,1.27414467253177,166,63,103,22,1.6,21.55,8.5,0,0,0,0,0,0,0.208323436979054,236.755757089729,31.7465760323066
9.7,"random_instances_SVM","SVM",91,6,2084,1897,187,700,628,72,0.769471078749425,0.287878787878788,1.2352394916911,200,72,128,34,1.8,25.14,8.7,0,0,0,0,0,0,0.200396803429726,225.736316398369,31.2977161402385
9.7,"random_instances_SVM","SVM",91,7,1984,1806,178,800,719,81,0.808064787446229,0.333333333333333,1.2644183773216,218,81,137,18,1.7,28.74,8.9,0,0,0,0,0,0,0.142843939808498,203.678921580847,17.1390941864281
9.7,"random_instances_SVM","SVM",91,8,1884,1717,167,900,808,92,0.802321389950256,0.333333333333333,1.2644183773216,246,92,154,28,1.7,32.33,8.8,0,0,0,0,0,0,0.165046567331994,196.477673352889,21.0784571647547
9.7,"random_instances_SVM","SVM",91,9,1784,1627,157,1000,898,102,0.81010741835483,0.310606060606061,1.22551319648094,261,102,159,15,1.6,35.92,8.8,0,0,0,0,0,0,0.175290238610931,188.208106379793,21.4418427347331
9.7,"random_instances_SVM","SVM",91,10,1684,1536,148,1100,989,111,0.816595775358656,0.318181818181818,1.22551319648094,290,111,179,29,1.6,39.51,8.9,0,0,0,0,0,0,0.166037558514549,176.242724458812,19.9185756796187
9.7,"random_instances_SVM","SVM",91,11,1584,1442,142,1200,1083,117,0.813670006968975,0.310606060606061,1.22551319648094,299,117,182,9,1.6,43.1,9.3,0,0,0,0,0,0,0.169498935862581,165.733518070979,20.3938777729058
9.7,"random_instances_SVM","SVM",91,12,1484,1353,131,1300,1172,128,0.803991541104928,0.265151515151515,1.27414467253177,348,128,220,49,1.7,46.7,9.2,0,0,0,0,0,0,0.168458739645945,157.063576403327,20.9726758290187
9.7,"random_instances_SVM","SVM",91,13,1384,1259,125,1400,1266,134,0.827373657270547,0.287878787878788,1.27414467253177,369,134,235,21,1.8,50.29,9.4,0,0,0,0,0,0,0.167379927356009,132.735840000173,20.1254841497688
9.7,"random_instances_SVM","SVM",91,14,1284,1164,120,1500,1361,139,0.799029149544601,0.28030303030303,1.27414467253177,390,139,251,21,1.8,53.88,9.8,0,0,0,0,0,0,0.178918930702825,124.825698664287,23.7604831238445
9.7,"random_instances_SVM","SVM",91,15,1184,1073,111,1600,1452,148,0.760237185494908,0.189393939393939,1.27414467253177,437,148,289,47,2,57.47,9.8,0,0,0,0,0,0,0.164081034220652,120.116585798743,20.3361029014869
9.7,"random_instances_SVM","SVM",91,16,1084,979,105,1700,1546,154,0.809626799317508,0.234848484848485,1.27414467253177,449,154,295,12,1.9,61.06,10,0,0,0,0,0,0,0.178384371801635,95.4465245679288,23.1176817407876
9.7,"random_instances_SVM","SVM",91,17,984,888,96,1800,1637,163,0.7833729844039,0.242424242424242,1.27414467253177,464,163,301,15,1.8,64.66,10,0,0,0,0,0,0,0.159680969718871,92.0362448093359,19.7335922509246
9.7,"random_instances_SVM","SVM",91,18,884,802,82,1900,1723,177,0.79750919183908,0.28030303030303,1.2644183773216,498,177,321,34,1.8,68.25,9.7,0,0,0,0,0,0,0.155633292472078,85.704940517139,18.8995257411455
9.7,"random_instances_SVM","SVM",91,19,784,707,77,2000,1818,182,0.77741330834113,0.21969696969697,1.27414467253177,507,182,325,9,1.8,71.84,10,0,0,0,0,0,0,0.156143433711531,76.3652696922604,19.8656601879366
9.7,"random_instances_SVM","SVM",91,20,684,617,67,2100,1908,192,0.782207483238399,0.25,1.27414467253177,540,192,348,33,1.8,75.43,9.9,0,0,0,0,0,0,0.152432859344985,66.7024995318906,18.9852117169266
9.7,"random_instances_SVM","SVM",91,21,584,524,60,2200,2001,199,0.778987335688357,0.204545454545455,1.27414467253177,561,199,362,21,1.8,79.02,10.1,0,0,0,0,0,0,0.141792389379272,53.320297188781,16.483254293818
9.7,"random_instances_SVM","SVM",91,22,484,433,51,2300,2092,208,0.818163794967907,0.348484848484849,1.27414467253177,579,208,371,18,1.8,82.61,10.1,0,0,0,0,0,0,0.158557106576553,45.9366668487996,18.7789058394602
9.7,"random_instances_SVM","SVM",91,23,384,345,39,2400,2180,220,0.797383029341781,0.28030303030303,1.27414467253177,635,220,415,56,1.9,86.21,9.9,0,0,0,0,0,0,0.133340825084051,35.7507172458745,15.422546366281
9.7,"random_instances_SVM","SVM",91,24,284,257,27,2500,2268,232,0.76175714320044,0.234848484848485,1.27414467253177,673,232,441,38,1.9,89.8,9.8,0,0,0,0,0,0,0.116633861081083,26.4712846397232,12.6117875192204
9.7,"random_instances_SVM","SVM",91,25,184,166,18,2600,2359,241,0.79911926561411,0.257575757575758,1.28387096774194,678,241,437,5,1.8,93.39,9.8,0,0,0,0,0,0,0.0951555317230005,17.9303784070442,14.4998837366528
9.7,"random_instances_SVM","SVM",91,26,84,73,11,2700,2452,248,0.810479898108754,0.25,1.27414467253177,674,248,426,-4,1.7,96.98,9.9,0,0,0,0,0,0,0.000352716229475883,7.70281178737198,7.70281178737198
9.7,"random_instances_SVM","SVM",91,27,0,0,0,2784,2525,259,0.762808497344577,0.181818181818182,1.27414467253177,712,259,453,38,1.7,100,9.7,0,0,0,0,0,0,0,0,0
9.7,"random_instances_SVM","SVM",92,0,2684,2429,255,100,88,12,0.767342840438245,0.193548387096774,1.27351716961498,31,12,19,0,1.6,3.59,7.3,0,0,0,0,0,0,0.389886460611818,315.974945358259,49.9160449786512
9.7,"random_instances_SVM","SVM",92,1,2584,2343,241,200,174,26,0.793779709702837,0.217741935483871,1.25280957336108,62,26,36,31,1.4,7.18,6.7,0,0,0,0,0,0,0.451028503638222,353.574116493619,60.2544682459416
9.7,"random_instances_SVM","SVM",92,2,2484,2264,220,300,253,47,0.826762246117085,0.330645161290323,1.27234450187132,103,47,56,41,1.2,10.78,5.4,0,0,0,0,0,0,0.423469238586907,359.065279859231,49.6695121001199
9.7,"random_instances_SVM","SVM",92,3,2384,2171,213,400,346,54,0.821382724522742,0.306451612903226,1.26200023762847,117,54,63,14,1.2,14.37,6.4,0,0,0,0,0,0,0.34122309912479,298.073825525448,42.6376493752769
9.7,"random_instances_SVM","SVM",92,4,2284,2075,209,500,442,58,0.773704212105037,0.282258064516129,1.24245577523413,137,58,79,20,1.4,17.96,7.6,0,0,0,0,0,0,0.307423227243847,258.934509870228,44.0356556295815
9.7,"random_instances_SVM","SVM",92,5,2184,1982,202,600,535,65,0.769065049950434,0.274193548387097,1.23210197710718,155,65,90,18,1.4,21.55,8.2,0,0,0,0,0,0,0.320047578304058,256.660943337997,47.0494597690836
9.7,"random_instances_SVM","SVM",92,6,2084,1889,195,700,628,72,0.781768728234076,0.290322580645161,1.25280957336108,176,72,104,21,1.4,25.14,8.7,0,0,0,0,0,0,0.239270974268757,237.721814450479,32.9322532042915
9.7,"random_instances_SVM","SVM",92,7,1984,1800,184,800,717,83,0.779792318055878,0.225806451612903,1.24245577523413,211,83,128,35,1.5,28.74,8.6,0,0,0,0,0,0,0.207295823286355,225.80034577099,29.9348612066469
9.7,"random_instances_SVM","SVM",92,8,1884,1709,175,900,808,92,0.772369658608511,0.169354838709677,1.25280957336108,250,92,158,39,1.7,32.33,8.8,0,0,0,0,0,0,0.187238246834032,222.272546821362,26.8296765796183
9.7,"random_instances_SVM","SVM",92,9,1784,1619,165,1000,898,102,0.78145733241821,0.17741935483871,1.23210197710718,268,102,166,18,1.6,35.92,8.8,0,0,0,0,0,0,0.165975039198364,206.0012811029,23.0000408974838
9.7,"random_instances_SVM","SVM",92,10,1684,1533,151,1100,984,116,0.790557716261219,0.25,1.23210197710718,298,116,182,30,1.6,39.51,8.5,0,0,0,0,0,0,0.186866931492974,194.683206179306,29.8790946349182
9.7,"random_instances_SVM","SVM",92,11,1584,1439,145,1200,1078,122,0.79806934594169,0.209677419354839,1.26316337148803,315,122,193,17,1.6,43.1,8.8,0,0,0,0,0,0,0.154934461849688,172.95170258591,22.2000726733464
9.7,"random_instances_SVM","SVM",92,12,1484,1349,135,1300,1168,132,0.782918986247748,0.17741935483871,1.26316337148803,348,132,216,33,1.6,46.7,8.8,0,0,0,0,0,0,0.146234662762265,166.124279200313,19.877080821189
9.7,"random_instances_SVM","SVM",92,13,1384,1260,124,1400,1257,143,0.768893464500878,0.193548387096774,1.22174817898023,373,143,230,25,1.6,50.29,8.8,0,0,0,0,0,0,0.135957403216448,146.93084295587,19.7779383167496
9.7,"random_instances_SVM","SVM",92,14,1284,1169,115,1500,1348,152,0.778953455858057,0.217741935483871,1.24245577523413,406,152,254,33,1.7,53.88,8.9,0,0,0,0,0,0,0.134277497482758,136.796714859207,15.9842274441398
9.7,"random_instances_SVM","SVM",92,15,1184,1080,104,1600,1437,163,0.792775617072119,0.201612903225806,1.27351716961498,427,163,264,21,1.6,57.47,8.8,0,0,0,0,0,0,0.129425116419184,128.89315253677,14.2377203214288
9.7,"random_instances_SVM","SVM",92,16,1084,986,98,1700,1531,169,0.797865985408884,0.209677419354839,1.26316337148803,440,169,271,13,1.6,61.06,9.1,0,0,0,0,0,0,0.153706775159675,117.582992720337,19.9188646419787
9.7,"random_instances_SVM","SVM",92,17,984,899,85,1800,1618,182,0.801551895065965,0.233870967741935,1.24245577523413,472,182,290,32,1.6,64.66,8.9,0,0,0,0,0,0,0.134613589280324,106.731944400545,15.5394754678441
9.7,"random_instances_SVM","SVM",92,18,884,811,73,1900,1706,194,0.76634192531585,0.209677419354839,1.27234450187132,506,194,312,34,1.6,68.25,8.8,0,0,0,0,0,0,0.155328053013621,100.768661943013,20.796384527726
9.7,"random_instances_SVM","SVM",92,19,784,721,63,2000,1796,204,0.796499656829102,0.217741935483871,1.26316337148803,519,204,315,13,1.5,71.84,8.8,0,0,0,0,0,0,0.159904978613007,87.3598036392082,22.4249241616763
9.7,"random_instances_SVM","SVM",92,20,684,629,55,2100,1888,212,0.805066219273497,0.258064516129032,1.26316337148803,546,212,334,27,1.6,75.43,8.9,0,0,0,0,0,0,0.152418344953866,76.4559673853256,18.0075477038083
9.7,"random_instances_SVM","SVM",92,21,584,537,47,2200,1980,220,0.75967233534152,0.201612903225806,1.26316337148803,569,220,349,23,1.6,79.02,9,0,0,0,0,0,0,0.13871288835,58.8512786828748,16.9893759743462
9.7,"random_instances_SVM","SVM",92,22,484,449,35,2300,2068,232,0.803776150893519,0.25,1.26316337148803,597,232,365,28,1.6,82.61,8.9,0,0,0,0,0,0,0.142458196927541,51.4947441337278,17.0159792460489
9.7,"random_instances_SVM","SVM",92,23,384,361,23,2400,2156,244,0.741465212638857,0.185483870967742,1.25280957336108,642,244,398,45,1.6,86.21,8.8,0,0,0,0,0,0,0.139242540396535,43.7476446257109,16.6528468017121
9.7,"random_instances_SVM","SVM",92,24,284,263,21,2500,2254,246,0.757670505096725,0.17741935483871,1.26316337148803,662,246,416,20,1.7,89.8,9.2,0,0,0,0,0,0,0.12525734557057,30.5102937296387,15.1013075908211
9.7,"random_instances_SVM","SVM",92,25,184,170,14,2600,2347,253,0.727331655608942,0.185483870967742,1.24245577523413,679,253,426,17,1.7,93.39,9.3,0,0,0,0,0,0,0.103827712458993,17.6127366606508,12.8360916581321
9.7,"random_instances_SVM","SVM",92,26,84,76,8,2700,2441,259,0.812390375962789,0.225806451612903,1.26200023762847,686,259,427,7,1.6,96.98,9.4,0,0,0,0,0,0,4.83407540286798e-07,7.7879486843879,7.7879486843879
9.7,"random_instances_SVM","SVM",92,27,0,0,0,2784,2517,267,0.798361676707598,0.266129032258065,1.27351716961498,730,267,463,44,1.7,100,9.4,0,0,0,0,0,0,0,0,0
9.7,"random_instances_SVM","SVM",93,0,2684,2429,255,100,88,12,0.782181804316327,0.233870967741935,1.28387096774194,34,12,22,0,1.8,3.59,7.3,0,0,0,0,0,0,0.121333132909158,320.06511618321,12.1943916960147
9.7,"random_instances_SVM","SVM",93,1,2584,2343,241,200,174,26,0.865133836650658,0.403225806451613,1.26316337148803,62,26,36,28,1.4,7.18,6.7,0,0,0,0,0,0,0.1340718006092,334.633253867194,13.4842556295321
9.7,"random_instances_SVM","SVM",93,2,2484,2262,222,300,255,45,0.846818678664938,0.387096774193548,1.27351716961498,104,45,59,42,1.3,10.78,5.7,0,0,0,0,0,0,0.360342121315593,324.281601485235,41.6180299711885
9.7,"random_instances_SVM","SVM",93,3,2384,2174,210,400,343,57,0.815367701263381,0.314516129032258,1.26316337148803,151,57,94,47,1.6,14.37,6,0,0,0,0,0,0,0.248802362543864,345.495362524621,30.1060254160731
9.7,"random_instances_SVM","SVM",93,4,2284,2081,203,500,436,64,0.807398510384098,0.314516129032258,1.26316337148803,165,64,101,14,1.6,17.96,6.8,0,0,0,0,0,0,0.16853745353364,292.606242045204,18.6034706922267
9.7,"random_instances_SVM","SVM",93,5,2184,1989,195,600,528,72,0.812819339586671,0.266129032258065,1.26316337148803,185,72,113,20,1.6,21.55,7.3,0,0,0,0,0,0,0.150850295094977,253.506417742173,16.8554790782628
9.7,"random_instances_SVM","SVM",93,6,2084,1901,183,700,616,84,0.827937924197365,0.32258064516129,1.28387096774194,207,84,123,22,1.5,25.14,7.3,0,0,0,0,0,0,0.19951587648229,242.65502631584,23.6407218647823
9.7,"random_instances_SVM","SVM",93,7,1984,1805,179,800,712,88,0.801812450748623,0.201612903225806,1.28387096774194,240,88,152,33,1.7,28.74,8.1,0,0,0,0,0,0,0.173162164447114,213.49890807741,23.2725437214098
9.7,"random_instances_SVM","SVM",93,8,1884,1715,169,900,802,98,0.756062685884237,0.17741935483871,1.27351716961498,268,98,170,28,1.7,32.33,8.2,0,0,0,0,0,0,0.134980785239783,211.886961227698,15.267487721336
9.7,"random_instances_SVM","SVM",93,9,1784,1619,165,1000,898,102,0.725857291746101,0.129032258064516,1.27351716961498,293,102,191,25,1.9,35.92,8.8,0,0,0,0,0,0,0.132776989178394,190.15418330838,16.119924852019
9.7,"random_instances_SVM","SVM",93,10,1684,1528,156,1100,989,111,0.800903683367649,0.209677419354839,1.27351716961498,305,111,194,12,1.7,39.51,8.9,0,0,0,0,0,0,0.147667160816559,175.404916989457,19.2086582478431
9.7,"random_instances_SVM","SVM",93,11,1584,1436,148,1200,1081,119,0.763294694832101,0.161290322580645,1.28387096774194,324,119,205,19,1.7,43.1,9.1,0,0,0,0,0,0,0.131472682721863,164.497081407981,15.8634085107773
9.7,"random_instances_SVM","SVM",93,12,1484,1352,132,1300,1165,135,0.779652507689574,0.153225806451613,1.27351716961498,364,135,229,40,1.7,46.7,8.6,0,0,0,0,0,0,0.169658698748225,164.919503767172,29.6799468124027
9.7,"random_instances_SVM","SVM",93,13,1384,1259,125,1400,1258,142,0.806737588652491,0.145161290322581,1.28387096774194,405,142,263,41,1.9,50.29,8.9,0,0,0,0,0,0,0.143614752942605,147.699252008693,24.7508475542781
9.7,"random_instances_SVM","SVM",93,14,1284,1165,119,1500,1352,148,0.787577213452307,0.129032258064516,1.27351716961498,398,148,250,-7,1.7,53.88,9.1,0,0,0,0,0,0,0.151425789192638,128.463949167835,21.1898760731579
9.7,"random_instances_SVM","SVM",93,15,1184,1071,113,1600,1446,154,0.754791682554216,0.137096774193548,1.27351716961498,424,154,270,26,1.8,57.47,9.4,0,0,0,0,0,0,0.135423855587899,117.315353633331,18.0080718760839
9.7,"random_instances_SVM","SVM",93,16,1084,984,100,1700,1533,167,0.708558936424416,0.0806451612903226,1.28387096774194,476,167,309,52,1.9,61.06,9.2,0,0,0,0,0,0,0.146863284154206,108.576068240875,20.3431104781037
9.7,"random_instances_SVM","SVM",93,17,984,892,92,1800,1625,175,0.801513764966066,0.129032258064516,1.28387096774194,496,175,321,20,1.8,64.66,9.3,0,0,0,0,0,0,0.139470790078524,100.25372952792,17.9138745174218
9.7,"random_instances_SVM","SVM",93,18,884,805,79,1900,1712,188,0.788651211266176,0.129032258064516,1.27351716961498,528,188,340,32,1.8,68.25,9.1,0,0,0,0,0,0,0.164823385034817,94.6248582683392,23.8302314148802
9.7,"random_instances_SVM","SVM",93,19,784,711,73,2000,1806,194,0.776481354381152,0.104838709677419,1.28387096774194,546,194,352,18,1.8,71.84,9.3,0,0,0,0,0,0,0.149263956923463,78.1590634440574,20.8562850959863
9.7,"random_instances_SVM","SVM",93,20,684,618,66,2100,1899,201,0.704949286967136,0.0806451612903226,1.28387096774194,578,201,377,32,1.9,75.43,9.4,0,0,0,0,0,0,0.137103201406534,67.0970636795192,17.5765620499221
9.7,"random_instances_SVM","SVM",93,21,584,524,60,2200,1993,207,0.763873001347269,0.104838709677419,1.27351716961498,585,207,378,7,1.8,79.02,9.6,0,0,0,0,0,0,0.126767265901965,57.1036183310519,15.8993476382115
9.7,"random_instances_SVM","SVM",93,22,484,430,54,2300,2087,213,0.731843717430543,0.0806451612903226,1.27351716961498,602,213,389,17,1.8,82.61,9.8,0,0,0,0,0,0,0.128969340509875,46.7234845724669,17.0692286769543
9.7,"random_instances_SVM","SVM",93,23,384,341,43,2400,2176,224,0.782143674216429,0.153225806451613,1.27351716961498,620,224,396,18,1.8,86.21,9.7,0,0,0,0,0,0,0.127723572649221,36.5140259990853,16.6099693611997
9.7,"random_instances_SVM","SVM",93,24,284,251,33,2500,2266,234,0.77021530796411,0.120967741935484,1.28387096774194,650,234,416,30,1.8,89.8,9.7,0,0,0,0,0,0,0.118519652064236,26.9985717925433,14.9469789951921
9.7,"random_instances_SVM","SVM",93,25,184,166,18,2600,2351,249,0.727681181524697,0.0887096774193548,1.28387096774194,692,249,443,42,1.8,93.39,9.4,0,0,0,0,0,0,0.0976979871448463,19.157239863476,14.9494337007001
9.7,"random_instances_SVM","SVM",93,26,84,74,10,2700,2443,257,0.796016675563694,0.169354838709677,1.28387096774194,720,257,463,28,1.8,96.98,9.5,0,0,0,0,0,0,0.0096290661767105,8.85860997223685,8.85860997223685
9.7,"random_instances_SVM","SVM",93,27,0,0,0,2784,2517,267,0.827277002465747,0.201612903225806,1.26316337148803,721,267,454,1,1.7,100,9.4,0,0,0,0,0,0,0,0,0
9.7,"random_instances_SVM","SVM",94,0,2684,2446,238,100,88,12,0.260326739627943,0,0.600960878517502,35,12,23,0,1.9,3.59,7.3,0,0,0,0,0,0,0.128698506851522,316.090406405842,13.3020200204671
9.7,"random_instances_SVM","SVM",94,1,2584,2359,225,200,175,25,0.745235991208395,0.234042553191489,1.22923816060398,71,25,46,36,1.8,7.18,7,0,0,0,0,0,0,0.196948374278835,337.16149072286,22.5673498207454
9.7,"random_instances_SVM","SVM",94,2,2484,2270,214,300,264,36,0.821188226497182,0.404255319148936,1.25655456417296,89,36,53,18,1.5,10.78,7.3,0,0,0,0,0,0,0.195236879591689,289.585115419215,23.5366906547054
9.7,"random_instances_SVM","SVM",94,3,2384,2177,207,400,357,43,0.813065053361434,0.375886524822695,1.24630043232371,114,43,71,25,1.7,14.37,8.3,0,0,0,0,0,0,0.25343726609991,267.304127364641,34.6108281200474
9.7,"random_instances_SVM","SVM",94,4,2284,2090,194,500,444,56,0.803712641334151,0.382978723404255,1.23834362846031,158,56,102,44,1.8,17.96,7.9,0,0,0,0,0,0,0.184093829706069,260.267916317533,22.2515816040951
9.7,"random_instances_SVM","SVM",94,5,2184,2000,184,600,534,66,0.826960551061567,0.418439716312057,1.25655456417296,172,66,106,14,1.6,21.55,8.1,0,0,0,0,0,0,0.137130832082726,238.137308397244,14.9342263987001
9.7,"random_instances_SVM","SVM",94,6,2084,1904,180,700,630,70,0.824558720232029,0.375886524822695,1.25655456417296,180,70,110,8,1.6,25.14,9,0,0,0,0,0,0,0.168460090920273,209.878296393937,22.0773555063069
9.7,"random_instances_SVM","SVM",94,7,1984,1816,168,800,718,82,0.814254639385499,0.283687943262411,1.26566003202928,222,82,140,42,1.7,28.74,8.8,0,0,0,0,0,0,0.221172770109181,196.602238838972,28.6782847614277
9.7,"random_instances_SVM","SVM",94,8,1884,1725,159,900,809,91,0.821375161443821,0.326241134751773,1.26566003202928,248,91,157,26,1.7,32.33,8.9,0,0,0,0,0,0,0.226999673798265,198.179779226119,27.9627770108242
9.7,"random_instances_SVM","SVM",94,9,1784,1638,146,1000,896,104,0.819777717354365,0.319148936170213,1.26566003202928,284,104,180,36,1.7,35.92,8.6,0,0,0,0,0,0,0.207937195028145,197.905149820984,26.5790021613455
9.7,"random_instances_SVM","SVM",94,10,1684,1547,137,1100,987,113,0.789165703668461,0.234042553191489,1.23834362846031,306,113,193,22,1.7,39.51,8.7,0,0,0,0,0,0,0.205906836031739,180.535197749017,28.750790178828
9.7,"random_instances_SVM","SVM",94,11,1584,1455,129,1200,1079,121,0.813065053361434,0.26241134751773,1.25655456417296,336,121,215,30,1.8,43.1,8.9,0,0,0,0,0,0,0.167332358765252,159.772155059009,19.8508998002443
9.7,"random_instances_SVM","SVM",94,12,1484,1362,122,1300,1172,128,0.827889561099403,0.326241134751773,1.26566003202928,342,128,214,6,1.7,46.7,9.2,0,0,0,0,0,0,0.177357091194913,148.974523951988,19.8296545833642
9.7,"random_instances_SVM","SVM",94,13,1384,1268,116,1400,1266,134,0.79764575261143,0.234042553191489,1.25655456417296,378,134,244,36,1.8,50.29,9.4,0,0,0,0,0,0,0.18199042797049,135.344456857418,20.9909544713605
9.7,"random_instances_SVM","SVM",94,14,1284,1173,111,1500,1361,139,0.808623932204931,0.290780141843972,1.26566003202928,393,139,254,15,1.8,53.88,9.8,0,0,0,0,0,0,0.183706148349022,124.793532279268,22.9148812127454
9.7,"random_instances_SVM","SVM",94,15,1184,1081,103,1600,1453,147,0.816560170394041,0.269503546099291,1.26566003202928,419,147,272,26,1.9,57.47,9.9,0,0,0,0,0,0,0.19337074312742,114.534220622655,25.0782903459075
9.7,"random_instances_SVM","SVM",94,16,1084,985,99,1700,1549,151,0.786288038429299,0.25531914893617,1.25655456417296,401,151,250,-18,1.7,61.06,10.3,0,0,0,0,0,0,0.164339968197541,101.547999814703,21.7252194878258
9.7,"random_instances_SVM","SVM",94,17,984,897,87,1800,1637,163,0.802545714091499,0.25531914893617,1.26566003202928,439,163,276,38,1.7,64.66,10,0,0,0,0,0,0,0.175228211140109,96.1874346820039,22.6695067119967
9.7,"random_instances_SVM","SVM",94,18,884,806,78,1900,1728,172,0.808844855323687,0.26241134751773,1.26566003202928,460,172,288,21,1.7,68.25,10,0,0,0,0,0,0,0.17126125195233,84.777334497815,22.1166933265155
9.7,"random_instances_SVM","SVM",94,19,784,713,71,2000,1821,179,0.814798450139357,0.283687943262411,1.26566003202928,486,179,307,26,1.7,71.84,10.2,0,0,0,0,0,0,0.169369729438038,74.590761602508,22.1936422337473
9.7,"random_instances_SVM","SVM",94,20,684,627,57,2100,1907,193,0.804913556748923,0.26241134751773,1.26566003202928,528,193,335,42,1.7,75.43,9.9,0,0,0,0,0,0,0.170273871719712,70.0641829346174,21.0965766263775
9.7,"random_instances_SVM","SVM",94,21,584,536,48,2200,1998,202,0.775961298801356,0.177304964539007,1.26566003202928,551,202,349,23,1.7,79.02,9.9,0,0,0,0,0,0,0.142248265722469,57.4330562030656,17.2248770884698
9.7,"random_instances_SVM","SVM",94,22,484,444,40,2300,2090,210,0.76552692996171,0.24113475177305,1.26566003202928,576,210,366,25,1.7,82.61,10,0,0,0,0,0,0,0.139176772252972,48.1788568833846,17.7044430393358
9.7,"random_instances_SVM","SVM",94,23,384,350,34,2400,2184,216,0.772273582126755,0.219858156028369,1.27476549988561,577,216,361,1,1.7,86.21,10.1,0,0,0,0,0,0,0.110800772682307,36.59459252024,12.0108037616946
9.7,"random_instances_SVM","SVM",94,24,284,257,27,2500,2277,223,0.739780889583762,0.191489361702128,1.26566003202928,604,223,381,27,1.7,89.8,10.2,0,0,0,0,0,0,0.123048314584549,29.1983561879999,15.5234809376613
9.7,"random_instances_SVM","SVM",94,25,184,164,20,2600,2370,230,0.720016767498246,0.163120567375887,1.27476549988561,630,230,400,26,1.7,93.39,10.3,0,0,0,0,0,0,0.0972145259788062,16.9764216851898,12.9089815806867
9.7,"random_instances_SVM","SVM",94,26,84,73,11,2700,2461,239,0.710069562458933,0.156028368794326,1.27476549988561,669,239,430,39,1.8,96.98,10.3,0,0,0,0,0,0,1.38750943411252e-06,7.9768899153161,7.9768899153161
9.7,"random_instances_SVM","SVM",94,27,0,0,0,2784,2534,250,0.747348922574948,0.212765957446809,1.27476549988561,686,250,436,17,1.7,100,10.1,0,0,0,0,0,0,0,0,0
9.7,"random_instances_SVM","SVM",95,0,2684,2432,252,100,90,10,0.796802938867625,0.201550387596899,1.2528587948092,26,10,16,0,1.6,3.59,9,0,0,0,0,0,0,0.360838188384106,333.848696285554,45.720362701881
9.7,"random_instances_SVM","SVM",95,1,2584,2346,238,200,176,24,0.7381329113924,0.356589147286822,1.16016400794413,59,24,35,33,1.5,7.18,7.3,0,0,0,0,0,0,0.485069697690937,323.074391689102,60.2369640672069
9.7,"random_instances_SVM","SVM",95,2,2484,2256,228,300,266,34,0.805189628103227,0.364341085271318,1.28387096774194,83,34,49,24,1.4,10.78,7.8,0,0,0,0,0,0,0.320716937731603,253.539133434707,39.4982772316614
9.7,"random_instances_SVM","SVM",95,3,2384,2159,225,400,363,37,0.801319791973305,0.310077519379845,1.28387096774194,97,37,60,14,1.6,14.37,9.8,0,0,0,0,0,0,0.280848640297078,224.555592281319,36.8922574435129
9.7,"random_instances_SVM","SVM",95,4,2284,2072,212,500,450,50,0.81040869394563,0.294573643410853,1.2739184796199,123,50,73,26,1.5,17.96,9,0,0,0,0,0,0,0.219841440776091,231.704419338947,29.3920785100199
9.7,"random_instances_SVM","SVM",95,5,2184,1981,203,600,541,59,0.773501128446661,0.294573643410853,1.23410852713178,153,59,94,30,1.6,21.55,9.2,0,0,0,0,0,0,0.183640021587088,227.806983814701,24.4551781008646
9.7,"random_instances_SVM","SVM",95,6,2084,1886,198,700,636,64,0.773145422431548,0.224806201550388,1.24406101525381,183,64,119,30,1.9,25.14,9.9,0,0,0,0,0,0,0.146539262616389,194.871795262341,20.6766862299213
9.7,"random_instances_SVM","SVM",95,7,1984,1797,187,800,725,75,0.737378569325872,0.217054263565891,1.26396599149787,224,75,149,41,2,28.74,9.7,0,0,0,0,0,0,0.164275361848949,198.949544931965,22.5758167939676
9.7,"random_instances_SVM","SVM",95,8,1884,1711,173,900,811,89,0.755390785987627,0.193798449612403,1.2739184796199,259,89,170,35,1.9,32.33,9.1,0,0,0,0,0,0,0.180000630186112,187.893647217009,24.7915529177875
9.7,"random_instances_SVM","SVM",95,9,1784,1621,163,1000,901,99,0.776040133451078,0.186046511627907,1.2739184796199,293,99,194,34,2,35.92,9.1,0,0,0,0,0,0,0.120517398002632,178.067393592584,13.0044902613416
9.7,"random_instances_SVM","SVM",95,10,1684,1529,155,1100,993,107,0.752588067903045,0.131782945736434,1.28387096774194,312,107,205,19,1.9,39.51,9.3,0,0,0,0,0,0,0.166084540441489,168.787045534675,22.0981827852256
9.7,"random_instances_SVM","SVM",95,11,1584,1434,150,1200,1088,112,0.783227848101261,0.193798449612403,1.28387096774194,318,112,206,6,1.8,43.1,9.7,0,0,0,0,0,0,0.116086800995919,147.939991242153,12.857298250318
9.7,"random_instances_SVM","SVM",95,12,1484,1350,134,1300,1172,128,0.818927239721316,0.255813953488372,1.28387096774194,380,128,252,62,2,46.7,9.2,0,0,0,0,0,0,0.172047023243998,149.514590735506,21.2046753536808
9.7,"random_instances_SVM","SVM",95,13,1384,1256,128,1400,1266,134,0.788416249632021,0.217054263565891,1.28387096774194,380,134,246,0,1.8,50.29,9.4,0,0,0,0,0,0,0.173301558633169,137.033745634489,21.8123667954214
9.7,"random_instances_SVM","SVM",95,14,1284,1169,115,1500,1353,147,0.770974389166904,0.13953488372093,1.2739184796199,411,147,264,31,1.8,53.88,9.2,0,0,0,0,0,0,0.168003668970141,128.578350878133,22.1974743473277
9.7,"random_instances_SVM","SVM",95,15,1184,1083,101,1600,1439,161,0.797474487292706,0.201550387596899,1.28387096774194,424,161,263,13,1.6,57.47,8.9,0,0,0,0,0,0,0.184156158092466,123.241936590247,26.2302288543965
9.7,"random_instances_SVM","SVM",95,16,1084,987,97,1700,1535,165,0.777009125699141,0.186046511627907,1.28387096774194,423,165,258,-1,1.6,61.06,9.3,0,0,0,0,0,0,0.140382075780832,104.595641653524,16.6374726964258
9.7,"random_instances_SVM","SVM",95,17,984,894,90,1800,1628,172,0.814977676381117,0.209302325581395,1.28387096774194,461,172,289,38,1.7,64.66,9.5,0,0,0,0,0,0,0.163512939570592,98.8330406987806,20.6351893404716
9.7,"random_instances_SVM","SVM",95,18,884,803,81,1900,1719,181,0.797781130409181,0.224806201550388,1.28387096774194,482,181,301,21,1.7,68.25,9.5,0,0,0,0,0,0,0.189299464176111,91.4463800482283,27.7845662260418
9.7,"random_instances_SVM","SVM",95,19,784,705,79,2000,1817,183,0.773979491708364,0.155038759689922,1.28387096774194,497,183,314,15,1.7,71.84,9.9,0,0,0,0,0,0,0.155470171573851,76.0544059902464,20.936835737582
9.7,"random_instances_SVM","SVM",95,20,684,616,68,2100,1906,194,0.80772863310764,0.224806201550388,1.28387096774194,527,194,333,30,1.7,75.43,9.8,0,0,0,0,0,0,0.168107393663288,70.4377475388165,22.403172820089
9.7,"random_instances_SVM","SVM",95,21,584,527,57,2200,1995,205,0.791556275144732,0.162790697674419,1.28387096774194,570,205,365,43,1.8,79.02,9.7,0,0,0,0,0,0,0.16238234435911,57.556979074681,21.2124741751373
9.7,"random_instances_SVM","SVM",95,22,484,436,48,2300,2086,214,0.76634407810813,0.178294573643411,1.28387096774194,576,214,362,6,1.7,82.61,9.7,0,0,0,0,0,0,0.158567015318651,50.9321924266435,20.3053978588463
9.7,"random_instances_SVM","SVM",95,23,384,349,35,2400,2173,227,0.79605779609459,0.201550387596899,1.28387096774194,601,227,374,25,1.6,86.21,9.6,0,0,0,0,0,0,0.148179020929146,38.2331716323786,20.4035095120437
9.7,"random_instances_SVM","SVM",95,24,284,264,20,2500,2258,242,0.803239377882441,0.294573643410853,1.28387096774194,635,242,393,34,1.6,89.8,9.3,0,0,0,0,0,0,0.123403963297283,28.2685910454035,18.9307709346881
9.7,"random_instances_SVM","SVM",95,25,184,172,12,2600,2350,250,0.794408056127951,0.201550387596899,1.28387096774194,680,250,430,45,1.7,93.39,9.4,0,0,0,0,0,0,0.0901854098797561,19.8084603142388,16.9789380469588
9.7,"random_instances_SVM","SVM",95,26,84,80,4,2700,2442,258,0.77618118928466,0.162790697674419,1.28387096774194,697,258,439,17,1.7,96.98,9.5,0,0,0,0,0,0,1.0000000994736e-07,9.41553714153649,9.41553714153649
9.7,"random_instances_SVM","SVM",95,27,0,0,0,2784,2522,262,0.806722843685601,0.255813953488372,1.28387096774194,707,262,445,10,1.7,100,9.6,0,0,0,0,0,0,0,0,0
9.7,"random_instances_SVM","SVM",96,0,2684,2417,267,100,87,13,0.586449944484265,0,1.05157367312063,42,13,29,0,2.2,3.59,6.7,0,0,0,0,0,0,0.283322643444898,379.647163594453,40.3289123658754
9.7,"random_instances_SVM","SVM",96,1,2584,2331,253,200,173,27,0.765821984230718,0.189189189189189,1.28387096774194,70,27,43,28,1.6,7.18,6.4,0,0,0,0,0,0,0.24990307892664,360.080392365863,28.6646102547499
9.7,"random_instances_SVM","SVM",96,2,2484,2240,244,300,264,36,0.776246995825785,0.225225225225225,1.2711330114645,86,36,50,16,1.4,10.78,7.3,0,0,0,0,0,0,0.341267241018264,289.59263288635,44.6939831666095
9.7,"random_instances_SVM","SVM",96,3,2384,2152,232,400,352,48,0.749367542269264,0.243243243243243,1.25957725681483,114,48,66,28,1.4,14.37,7.3,0,0,0,0,0,0,0.341935924164528,274.141843363726,46.9999504342825
9.7,"random_instances_SVM","SVM",96,4,2284,2061,223,500,443,57,0.753004174221028,0.234234234234234,1.26073815751235,136,57,79,22,1.4,17.96,7.8,0,0,0,0,0,0,0.17161475811245,269.4320806669,20.9801781239487
9.7,"random_instances_SVM","SVM",96,5,2184,1967,217,600,537,63,0.762350494019773,0.234234234234234,1.26073815751235,153,63,90,17,1.4,21.55,8.5,0,0,0,0,0,0,0.221626863474833,233.618584512917,35.1398133414086
9.7,"random_instances_SVM","SVM",96,6,2084,1874,210,700,630,70,0.746665542297375,0.216216216216216,1.24917175239756,173,70,103,20,1.5,25.14,9,0,0,0,0,0,0,0.15400066775566,215.136852980494,21.1478743191956
9.7,"random_instances_SVM","SVM",96,7,1984,1791,193,800,713,87,0.76132450703434,0.207207207207207,1.22603894216797,210,87,123,37,1.4,28.74,8.2,0,0,0,0,0,0,0.169611613371168,216.96589503607,25.1212621727317
9.7,"random_instances_SVM","SVM",96,8,1884,1694,190,900,810,90,0.772399544630435,0.18018018018018,1.23760534728277,233,90,143,23,1.6,32.33,9,0,0,0,0,0,0,0.112315501844861,186.870732466907,12.40927364308
9.7,"random_instances_SVM","SVM",96,9,1784,1602,182,1000,902,98,0.771401666877491,0.198198198198198,1.23760534728277,252,98,154,19,1.6,35.92,9.2,0,0,0,0,0,0,0.148910340972159,180.342335478892,21.5220945493163
9.7,"random_instances_SVM","SVM",96,10,1684,1512,172,1100,992,108,0.781380444406963,0.198198198198198,1.23760534728277,272,108,164,20,1.5,39.51,9.2,0,0,0,0,0,0,0.158039950428568,161.872278938723,23.0400031985435
9.7,"random_instances_SVM","SVM",96,11,1584,1421,163,1200,1083,117,0.786130904695653,0.225225225225225,1.23760534728277,294,117,177,22,1.5,43.1,9.3,0,0,0,0,0,0,0.152653033875947,147.837167899609,22.5100496459079
9.7,"random_instances_SVM","SVM",96,12,1484,1332,152,1300,1172,128,0.786053604306338,0.252252252252252,1.23760534728277,326,128,198,32,1.5,46.7,9.2,0,0,0,0,0,0,0.135532119367788,148.148994841866,17.7828367900582
9.7,"random_instances_SVM","SVM",96,13,1384,1245,139,1400,1259,141,0.763587300248769,0.216216216216216,1.22603894216797,363,141,222,37,1.6,50.29,8.9,0,0,0,0,0,0,0.179261469902479,146.551079031432,30.8661326999326
9.7,"random_instances_SVM","SVM",96,14,1284,1154,130,1500,1350,150,0.776194291014887,0.189189189189189,1.22603894216797,389,150,239,26,1.6,53.88,9,0,0,0,0,0,0,0.16845614760655,139.21022571629,26.840356972116
9.7,"random_instances_SVM","SVM",96,15,1184,1063,121,1600,1441,159,0.776679175275122,0.189189189189189,1.22603894216797,406,159,247,17,1.6,57.47,9.1,0,0,0,0,0,0,0.171226404241993,133.779833697372,28.2592902753333
9.7,"random_instances_SVM","SVM",96,16,1084,973,111,1700,1531,169,0.737368413655466,0.18018018018018,1.22603894216797,436,169,267,30,1.6,61.06,9.1,0,0,0,0,0,0,0.173487403551328,121.478504533743,28.1169741289838
9.7,"random_instances_SVM","SVM",96,17,984,881,103,1800,1623,177,0.771970878835161,0.243243243243243,1.22603894216797,461,177,284,25,1.6,64.66,9.2,0,0,0,0,0,0,0.126241334754787,99.9635617573818,14.4184086455033
9.7,"random_instances_SVM","SVM",96,18,884,789,95,1900,1715,185,0.7732217396804,0.189189189189189,1.22603894216797,482,185,297,21,1.6,68.25,9.3,0,0,0,0,0,0,0.138508384333209,91.7492616237342,17.2228507102384
9.7,"random_instances_SVM","SVM",96,19,784,698,86,2000,1806,194,0.779321443128003,0.198198198198198,1.22603894216797,531,194,337,49,1.7,71.84,9.3,0,0,0,0,0,0,0.149624012612198,80.2985258627564,18.3136914792222
9.7,"random_instances_SVM","SVM",96,20,684,609,75,2100,1895,205,0.796109682225137,0.252252252252252,1.23760534728277,549,205,344,18,1.7,75.43,9.2,0,0,0,0,0,0,0.148172926488848,68.9299686485795,16.8536394866662
9.7,"random_instances_SVM","SVM",96,21,584,519,65,2200,1985,215,0.750045677502787,0.189189189189189,1.20290613193839,576,215,361,27,1.7,79.02,9.2,0,0,0,0,0,0,0.142466116032305,58.5927927384358,18.0777374794879
9.7,"random_instances_SVM","SVM",96,22,484,428,56,2300,2076,224,0.735014265435486,0.162162162162162,1.22603894216797,611,224,387,35,1.7,82.61,9.3,0,0,0,0,0,0,0.124769581779531,48.604876757869,14.0510906128344
9.7,"random_instances_SVM","SVM",96,23,384,337,47,2400,2167,233,0.761486135121083,0.171171171171171,1.23760534728277,637,233,404,26,1.7,86.21,9.3,0,0,0,0,0,0,0.130848191880212,38.7655460093624,16.4331183674737
9.7,"random_instances_SVM","SVM",96,24,284,249,35,2500,2255,245,0.7220207727228,0.162162162162162,1.23760534728277,667,245,422,30,1.7,89.8,9.2,0,0,0,0,0,0,0.129513106104147,30.3692245084967,16.2209863269744
9.7,"random_instances_SVM","SVM",96,25,184,155,29,2600,2349,251,0.781823164818494,0.18018018018018,1.23760534728277,672,251,421,5,1.7,93.39,9.4,0,0,0,0,0,0,0.0981879553259545,18.6771194781324,14.1376055165823
9.7,"random_instances_SVM","SVM",96,26,84,73,11,2700,2431,269,0.796784303804583,0.18018018018018,1.28387096774194,732,269,463,60,1.7,96.98,9,0,0,0,0,0,0,0.00860273685476044,8.63767153018298,8.63767153018298
9.7,"random_instances_SVM","SVM",96,27,0,0,0,2784,2504,280,0.770080532951047,0.144144144144144,1.27230456262714,743,280,463,11,1.7,100,8.9,0,0,0,0,0,0,0,0,0
9.7,"random_instances_SVM","SVM",97,0,2684,2427,257,100,93,7,0.358392108569368,0.0236220472440945,0.839065278130556,30,7,23,0,3.3,3.59,13.3,0,0,0,0,0,0,0.0864886972139012,183.30506632351,9.24332181100024
9.7,"random_instances_SVM","SVM",97,1,2584,2341,243,200,179,21,0.694474505852649,0.275590551181102,1.11201422402845,59,21,38,29,1.8,7.18,8.5,0,0,0,0,0,0,0.123733591765444,274.758358377062,13.001863013843
9.7,"random_instances_SVM","SVM",97,2,2484,2257,227,300,263,37,0.769619733552266,0.283464566929134,1.19288798577597,93,37,56,34,1.5,10.78,7.1,0,0,0,0,0,0,0.184108955406257,288.202921168026,21.2560892631843
9.7,"random_instances_SVM","SVM",97,3,2384,2167,217,400,353,47,0.735579853466185,0.322834645669291,1.19288798577597,121,47,74,28,1.6,14.37,7.5,0,0,0,0,0,0,0.20363991301683,261.189584065105,25.0745500970066
9.7,"random_instances_SVM","SVM",97,4,2284,2076,208,500,444,56,0.754866838327672,0.346456692913386,1.14821804299256,139,56,83,18,1.5,17.96,7.9,0,0,0,0,0,0,0.400456997362746,271.951916098008,54.5729942913289
9.7,"random_instances_SVM","SVM",97,5,2184,1989,195,600,531,69,0.729459765396622,0.346456692913386,1.14234188468377,168,69,99,29,1.4,21.55,7.7,0,0,0,0,0,0,0.203045153425327,243.169021950416,25.7614041401264
9.7,"random_instances_SVM","SVM",97,6,2084,1895,189,700,625,75,0.75262778171686,0.338582677165354,1.17266954533909,190,75,115,22,1.5,25.14,8.3,0,0,0,0,0,0,0.200168204086441,238.476031113808,25.6555554243351
9.7,"random_instances_SVM","SVM",97,7,1984,1805,179,800,715,85,0.767610802204223,0.322834645669291,1.20299720599441,218,85,133,28,1.6,28.74,8.4,0,0,0,0,0,0,0.170749276365718,217.261271663028,21.8390685591379
9.7,"random_instances_SVM","SVM",97,8,1884,1714,170,900,806,94,0.78810438979488,0.291338582677165,1.25354330708661,245,94,151,27,1.6,32.33,8.6,0,0,0,0,0,0,0.19913473079943,199.572498788181,29.5261188106833
9.7,"random_instances_SVM","SVM",97,9,1784,1622,162,1000,898,102,0.794013011406756,0.31496062992126,1.25354330708661,265,102,163,20,1.6,35.92,8.8,0,0,0,0,0,0,0.201269901981333,187.113993272557,30.3204557775661
9.7,"random_instances_SVM","SVM",97,10,1684,1529,155,1100,991,109,0.803311315943331,0.322834645669291,1.25354330708661,281,109,172,16,1.6,39.51,9.1,0,0,0,0,0,0,0.218193294255536,179.942584847773,39.4518074680463
9.7,"random_instances_SVM","SVM",97,11,1584,1436,148,1200,1084,116,0.803634735231554,0.307086614173228,1.26365252730505,292,116,176,11,1.5,43.1,9.3,0,0,0,0,0,0,0.160109530361967,176.9070904411,27.0202311612312
9.7,"random_instances_SVM","SVM",97,12,1484,1344,140,1300,1176,124,0.812553644064638,0.283464566929134,1.28387096774194,314,124,190,22,1.5,46.7,9.5,0,0,0,0,0,0,0.192455783054769,158.165774503908,36.0396685454231
9.7,"random_instances_SVM","SVM",97,13,1384,1255,129,1400,1265,135,0.821839509397819,0.291338582677165,1.28387096774194,349,135,214,35,1.6,50.29,9.4,0,0,0,0,0,0,0.172331775386978,143.183377602725,25.2924819437483
9.7,"random_instances_SVM","SVM",97,14,1284,1164,120,1500,1356,144,0.792271522931676,0.244094488188976,1.28387096774194,396,144,252,47,1.8,53.88,9.4,0,0,0,0,0,0,0.15693448802831,135.622706023494,20.9940982512461
9.7,"random_instances_SVM","SVM",97,15,1184,1072,112,1600,1448,152,0.817062855294752,0.299212598425197,1.28387096774194,414,152,262,18,1.7,57.47,9.5,0,0,0,0,0,0,0.175377302964539,123.775575423311,24.2081094197702
9.7,"random_instances_SVM","SVM",97,16,1084,980,104,1700,1540,160,0.789553556990211,0.267716535433071,1.28387096774194,440,160,280,26,1.8,61.06,9.6,0,0,0,0,0,0,0.156252517521323,109.989133048493,19.7928501300803
9.7,"random_instances_SVM","SVM",97,17,984,893,91,1800,1627,173,0.804804020350539,0.267716535433071,1.2737617475235,479,173,306,39,1.8,64.66,9.4,0,0,0,0,0,0,0.150696320391084,96.828777235084,20.0308020096597
9.7,"random_instances_SVM","SVM",97,18,884,802,82,1900,1718,182,0.801899466358176,0.259842519685039,1.2737617475235,490,182,308,11,1.7,68.25,9.4,0,0,0,0,0,0,0.167108165562381,94.2963035094653,21.3198831795027
9.7,"random_instances_SVM","SVM",97,19,784,716,68,2000,1804,196,0.796531950093916,0.204724409448819,1.28387096774194,536,196,340,46,1.7,71.84,9.2,0,0,0,0,0,0,0.165264016423666,83.700269325594,21.8549021534005
9.7,"random_instances_SVM","SVM",97,20,684,623,61,2100,1897,203,0.829893893595056,0.267716535433071,1.28387096774194,559,203,356,23,1.8,75.43,9.3,0,0,0,0,0,0,0.173127130377745,75.8572194142623,22.6556825145105
9.7,"random_instances_SVM","SVM",97,21,584,527,57,2200,1993,207,0.847370974362805,0.299212598425197,1.28387096774194,581,207,374,22,1.8,79.02,9.6,0,0,0,0,0,0,0.153063281876188,59.7224173860719,20.0549412263557
9.7,"random_instances_SVM","SVM",97,22,484,439,45,2300,2081,219,0.812752671318929,0.236220472440945,1.28387096774194,603,219,384,22,1.8,82.61,9.5,0,0,0,0,0,0,0.166302623740407,51.7951334032219,20.4382097295611
9.7,"random_instances_SVM","SVM",97,23,384,349,35,2400,2171,229,0.820632906668661,0.267716535433071,1.28387096774194,629,229,400,26,1.7,86.21,9.5,0,0,0,0,0,0,0.147758861357122,40.9319332113669,20.1891955379676
9.7,"random_instances_SVM","SVM",97,24,284,260,24,2500,2260,240,0.765514796432435,0.141732283464567,1.28387096774194,661,240,421,32,1.8,89.8,9.4,0,0,0,0,0,0,0.137362506665287,32.047555808051,17.6418947480104
9.7,"random_instances_SVM","SVM",97,25,184,163,21,2600,2357,243,0.781909666504957,0.165354330708661,1.28387096774194,678,243,435,17,1.8,93.39,9.7,0,0,0,0,0,0,0.107783661789446,19.4889236065275,15.1090205599046
9.7,"random_instances_SVM","SVM",97,26,84,77,7,2700,2443,257,0.821236208033237,0.307086614173228,1.28387096774194,715,257,458,37,1.8,96.98,9.5,0,0,0,0,0,0,0.000103052406539047,9.49832242186959,9.49832242186959
9.7,"random_instances_SVM","SVM",97,27,0,0,0,2784,2520,264,0.763823064770932,0.149606299212598,1.28387096774194,731,264,467,16,1.8,100,9.5,0,0,0,0,0,0,0,0,0
9.7,"random_instances_SVM","SVM",98,0,2684,2425,259,100,91,9,0.761833429357924,0.16260162601626,1.27343299239444,26,9,17,0,1.9,3.59,10.1,0,0,0,0,0,0,0.261088956334049,266.914342631572,33.0053885701966
9.7,"random_instances_SVM","SVM",98,1,2584,2339,245,200,177,23,0.771787977722306,0.203252032520325,1.25255704169945,61,23,38,35,1.7,7.18,7.7,0,0,0,0,0,0,0.14633014709375,301.266000077595,15.2214778392652
9.7,"random_instances_SVM","SVM",98,2,2484,2250,234,300,266,34,0.753549708725439,0.105691056910569,1.26299501704694,90,34,56,29,1.6,10.78,7.8,0,0,0,0,0,0,0.216596978583625,268.807445900169,42.6844017334967
9.7,"random_instances_SVM","SVM",98,3,2384,2160,224,400,356,44,0.803021573522833,0.178861788617886,1.27343299239444,123,44,79,33,1.8,14.37,8.1,0,0,0,0,0,0,0.191474563039607,235.13488330202,25.3480367200829
9.7,"random_instances_SVM","SVM",98,4,2284,2072,212,500,444,56,0.808968695986186,0.219512195121951,1.27343299239444,144,56,88,21,1.6,17.96,7.9,0,0,0,0,0,0,0.19768642774413,234.261351254724,26.1700187933566
9.7,"random_instances_SVM","SVM",98,5,2184,1979,205,600,537,63,0.785417066769099,0.211382113821138,1.25255704169945,173,63,110,29,1.7,21.55,8.5,0,0,0,0,0,0,0.170500455035923,247.700043079051,22.8339538090935
9.7,"random_instances_SVM","SVM",98,6,2084,1884,200,700,632,68,0.792369246527111,0.235772357723577,1.24211906635195,198,68,130,25,1.9,25.14,9.3,0,0,0,0,0,0,0.148044692860729,212.599201563022,18.5227731581552
9.7,"random_instances_SVM","SVM",98,7,1984,1791,193,800,725,75,0.773612444785869,0.16260162601626,1.24211906635195,216,75,141,18,1.9,28.74,9.7,0,0,0,0,0,0,0.165958508315924,203.826330943472,25.8863977838561
9.7,"random_instances_SVM","SVM",98,8,1884,1698,186,900,818,82,0.801382753985029,0.211382113821138,1.26299501704694,241,82,159,25,1.9,32.33,10,0,0,0,0,0,0,0.131175517002837,185.203553860933,16.6196483004737
9.7,"random_instances_SVM","SVM",98,9,1784,1612,172,1000,904,96,0.818667178797779,0.276422764227642,1.27343299239444,253,96,157,12,1.6,35.92,9.4,0,0,0,0,0,0,0.161036064014384,184.774499332292,20.4271630607656
9.7,"random_instances_SVM","SVM",98,10,1684,1519,165,1100,997,103,0.829863645093149,0.284552845528455,1.28387096774194,284,103,181,31,1.8,39.51,9.7,0,0,0,0,0,0,0.167510428675989,172.13409884886,22.0196606185305
9.7,"random_instances_SVM","SVM",98,11,1584,1424,160,1200,1092,108,0.826035465079063,0.317073170731707,1.28387096774194,290,108,182,6,1.7,43.1,10.1,0,0,0,0,0,0,0.138555997414552,151.562880263485,16.4478504338886
9.7,"random_instances_SVM","SVM",98,12,1484,1334,150,1300,1182,118,0.807842007553934,0.333333333333333,1.28387096774194,317,118,199,27,1.7,46.7,10,0,0,0,0,0,0,0.153706320975991,140.203860102313,19.5314501920008
9.7,"random_instances_SVM","SVM",98,13,1384,1248,136,1400,1268,132,0.785500288073747,0.317073170731707,1.28387096774194,353,132,221,36,1.7,50.29,9.6,0,0,0,0,0,0,0.178988311479413,139.401925430818,25.1912591686023
9.7,"random_instances_SVM","SVM",98,14,1284,1155,129,1500,1361,139,0.802118942449266,0.300813008130081,1.28387096774194,378,139,239,25,1.7,53.88,9.8,0,0,0,0,0,0,0.167218512759965,126.372692101209,21.4947963855652
9.7,"random_instances_SVM","SVM",98,15,1184,1063,121,1600,1453,147,0.806504065040654,0.268292682926829,1.27343299239444,394,147,247,16,1.7,57.47,9.9,0,0,0,0,0,0,0.176512394171972,120.086868198452,22.6562053843102
9.7,"random_instances_SVM","SVM",98,16,1084,972,112,1700,1544,156,0.821432686767819,0.284552845528455,1.27343299239444,416,156,260,22,1.7,61.06,9.9,0,0,0,0,0,0,0.166634748790533,103.363850152704,20.4935043183818
9.7,"random_instances_SVM","SVM",98,17,984,877,107,1800,1639,161,0.810261827027725,0.292682926829268,1.27343299239444,435,161,274,19,1.7,64.66,10.2,0,0,0,0,0,0,0.148514170724518,90.7255527849289,17.3867896983719
9.7,"random_instances_SVM","SVM",98,18,884,785,99,1900,1731,169,0.821835990013452,0.24390243902439,1.27343299239444,470,169,301,35,1.8,68.25,10.2,0,0,0,0,0,0,0.146095517708712,80.9546245642804,17.0456461105565
9.7,"random_instances_SVM","SVM",98,19,784,692,92,2000,1824,176,0.830727866333789,0.32520325203252,1.27343299239444,492,176,316,22,1.8,71.84,10.4,0,0,0,0,0,0,0.168292591078611,70.246136119971,19.511227662727
9.7,"random_instances_SVM","SVM",98,20,684,609,75,2100,1907,193,0.760047372127265,0.170731707317073,1.27343299239444,559,193,366,67,1.9,75.43,9.9,0,0,0,0,0,0,0.143472633058895,67.7790443526056,18.4700668373911
9.7,"random_instances_SVM","SVM",98,21,584,518,66,2200,1998,202,0.758799052557456,0.138211382113821,1.27343299239444,565,202,363,6,1.8,79.02,9.9,0,0,0,0,0,0,0.138606660621124,59.1056560318904,18.9453963731242
9.7,"random_instances_SVM","SVM",98,22,484,429,55,2300,2087,213,0.749126176301135,0.138211382113821,1.27343299239444,606,213,393,41,1.8,82.61,9.8,0,0,0,0,0,0,0.131509573060752,47.6559049516155,16.533650959917
9.7,"random_instances_SVM","SVM",98,23,384,339,45,2400,2177,223,0.789981435247428,0.195121951219512,1.27343299239444,632,223,409,26,1.8,86.21,9.8,0,0,0,0,0,0,0.125693179300926,38.0674827605589,16.4601967545787
9.7,"random_instances_SVM","SVM",98,24,284,254,30,2500,2262,238,0.79972472953076,0.211382113821138,1.27343299239444,662,238,424,30,1.8,89.8,9.5,0,0,0,0,0,0,0.123104965748549,27.9817698631644,15.2443778819609
9.7,"random_instances_SVM","SVM",98,25,184,163,21,2600,2353,247,0.802618270277193,0.203252032520325,1.28387096774194,689,247,442,27,1.8,93.39,9.5,0,0,0,0,0,0,0.0986516865908019,17.6203613966761,12.6563891154294
9.7,"random_instances_SVM","SVM",98,26,84,79,5,2700,2437,263,0.73698866909929,0.16260162601626,1.27343299239444,726,263,463,37,1.8,96.98,9.3,0,0,0,0,0,0,2.03311922429137e-06,8.31107097933165,8.31107097933165
9.7,"random_instances_SVM","SVM",98,27,0,0,0,2784,2516,268,0.772568977658284,0.203252032520325,1.27343299239444,768,268,500,42,1.9,100,9.4,0,0,0,0,0,0,0,0,0
9.7,"random_instances_SVM","SVM",99,0,2684,2414,270,100,88,12,0.767962788304902,0.247706422018349,1.20142053862089,34,12,22,0,1.8,3.59,7.3,0,0,0,0,0,0,0.181262453422215,327.208543495195,19.6643653784944
9.7,"random_instances_SVM","SVM",99,1,2584,2328,256,200,174,26,0.801423304467122,0.311926605504587,1.26031370227878,71,26,45,37,1.7,7.18,6.7,0,0,0,0,0,0,0.178868195399921,324.585555057739,19.2195870998337
9.7,"random_instances_SVM","SVM",99,2,2484,2243,241,300,259,41,0.780873988967966,0.192660550458716,1.27209233501036,107,41,66,36,1.6,10.78,6.3,0,0,0,0,0,0,0.246657398177214,343.552653562984,30.76615472679
9.7,"random_instances_SVM","SVM",99,3,2384,2153,231,400,349,51,0.785296807568097,0.18348623853211,1.27209233501036,138,51,87,31,1.7,14.37,6.8,0,0,0,0,0,0,0.187309224856126,293.718900146134,20.6774676561478
9.7,"random_instances_SVM","SVM",99,4,2284,2062,222,500,440,60,0.798936808711313,0.247706422018349,1.27209233501036,162,60,102,24,1.7,17.96,7.3,0,0,0,0,0,0,0.147210921825199,265.855265958998,15.3484871839469
9.7,"random_instances_SVM","SVM",99,5,2184,1974,210,600,528,72,0.823208722741438,0.302752293577982,1.27209233501036,173,72,101,11,1.4,21.55,7.3,0,0,0,0,0,0,0.213064580207201,248.31111550994,24.3720510907692
9.7,"random_instances_SVM","SVM",99,6,2084,1884,200,700,618,82,0.825152190688507,0.321100917431193,1.27209233501036,205,82,123,32,1.5,25.14,7.5,0,0,0,0,0,0,0.142213760163167,226.873243590571,15.0252122547867
9.7,"random_instances_SVM","SVM",99,7,1984,1789,195,800,713,87,0.825981022607111,0.302752293577982,1.27209233501036,224,87,137,19,1.6,28.74,8.2,0,0,0,0,0,0,0.187772079109546,216.638715841003,21.7047894441585
9.7,"random_instances_SVM","SVM",99,8,1884,1699,185,900,803,97,0.825223641715973,0.256880733944954,1.26031370227878,251,97,154,27,1.6,32.33,8.3,0,0,0,0,0,0,0.200158417070433,196.572849975183,24.8286227928567
9.7,"random_instances_SVM","SVM",99,9,1784,1612,172,1000,890,110,0.837084512275291,0.26605504587156,1.26031370227878,279,110,169,28,1.5,35.92,8.1,0,0,0,0,0,0,0.178224309673583,190.703226198091,20.9893847116944
9.7,"random_instances_SVM","SVM",99,10,1684,1519,165,1100,983,117,0.828388922232707,0.284403669724771,1.26031370227878,298,117,181,19,1.5,39.51,8.4,0,0,0,0,0,0,0.175541389643021,185.270892460005,20.3721639276801
9.7,"random_instances_SVM","SVM",99,11,1584,1427,157,1200,1075,125,0.816492326159654,0.220183486238532,1.26031370227878,314,125,189,16,1.5,43.1,8.6,0,0,0,0,0,0,0.224956446870243,170.303551311488,31.6198809869286
9.7,"random_instances_SVM","SVM",99,12,1484,1333,151,1300,1169,131,0.80708222584241,0.18348623853211,1.27209233501036,349,131,218,35,1.7,46.7,8.9,0,0,0,0,0,0,0.148872227820527,156.809325159029,21.5385540655626
9.7,"random_instances_SVM","SVM",99,13,1384,1240,144,1400,1262,138,0.816663808625571,0.220183486238532,1.27209233501036,370,138,232,21,1.7,50.29,9.1,0,0,0,0,0,0,0.143221100392871,133.720354595549,16.7946299201389
9.7,"random_instances_SVM","SVM",99,14,1284,1143,141,1500,1359,141,0.801980622481355,0.174311926605505,1.26031370227878,388,141,247,18,1.8,53.88,9.6,0,0,0,0,0,0,0.154661100335748,126.583718912087,20.0546435372461
9.7,"random_instances_SVM","SVM",99,15,1184,1053,131,1600,1449,151,0.800251507616683,0.192660550458716,1.27209233501036,413,151,262,25,1.7,57.47,9.6,0,0,0,0,0,0,0.138909345852956,109.901327634892,16.0151124537006
9.7,"random_instances_SVM","SVM",99,16,1084,963,121,1700,1539,161,0.79167738432079,0.155963302752294,1.27209233501036,431,161,270,18,1.7,61.06,9.6,0,0,0,0,0,0,0.176974087371597,106.890663245775,23.0975375934727
9.7,"random_instances_SVM","SVM",99,17,984,874,110,1800,1628,172,0.802523650290095,0.238532110091743,1.26031370227878,448,172,276,17,1.6,64.66,9.5,0,0,0,0,0,0,0.150796408476349,94.6342889406594,16.9614507550439
9.7,"random_instances_SVM","SVM",99,18,884,781,103,1900,1721,179,0.789155163051248,0.146788990825688,1.26031370227878,476,179,297,28,1.7,68.25,9.6,0,0,0,0,0,0,0.168478396982703,89.2654884014236,22.2194196347642
9.7,"random_instances_SVM","SVM",99,19,784,691,93,2000,1811,189,0.791062905484585,0.174311926605505,1.26031370227878,494,189,305,18,1.6,71.84,9.6,0,0,0,0,0,0,0.145328780294624,74.8950370225668,16.9345895278437
9.7,"random_instances_SVM","SVM",99,20,684,603,81,2100,1899,201,0.807260853411075,0.192660550458716,1.26031370227878,513,201,312,19,1.6,75.43,9.4,0,0,0,0,0,0,0.156818422189008,70.4497695905287,20.0731799401346
9.7,"random_instances_SVM","SVM",99,21,584,510,74,2200,1992,208,0.760953442510506,0.146788990825688,1.26031370227878,548,208,340,35,1.6,79.02,9.6,0,0,0,0,0,0,0.12270398734749,57.6423908699445,13.6799179596836
9.7,"random_instances_SVM","SVM",99,22,484,424,60,2300,2078,222,0.757052216410875,0.119266055045872,1.26031370227878,599,222,377,51,1.7,82.61,9.4,0,0,0,0,0,0,0.13749441477769,49.588617156336,16.3140138525844
9.7,"random_instances_SVM","SVM",99,23,384,336,48,2400,2166,234,0.766126496899029,0.146788990825688,1.26031370227878,637,234,403,38,1.7,86.21,9.3,0,0,0,0,0,0,0.132794685925158,37.8541818928521,15.7765665979005
9.7,"random_instances_SVM","SVM",99,24,284,246,38,2500,2256,244,0.758402640829978,0.174311926605505,1.26031370227878,653,244,409,16,1.7,89.8,9.2,0,0,0,0,0,0,0.11575388406896,27.5492391982348,12.4480273649852
9.7,"random_instances_SVM","SVM",99,25,184,158,26,2600,2344,256,0.74518420074881,0.165137614678899,1.27209233501036,692,256,436,39,1.7,93.39,9.2,0,0,0,0,0,0,0.103038510533091,17.3258053232159,13.0781931496793
9.7,"random_instances_SVM","SVM",99,26,84,75,9,2700,2427,273,0.788933664866104,0.229357798165138,1.27209233501036,733,273,460,41,1.7,96.98,8.9,0,0,0,0,0,0,2.16483986491425e-06,8.21310594190603,8.21310594190603
9.7,"random_instances_SVM","SVM",99,27,0,0,0,2784,2502,282,0.774050415844982,0.119266055045872,1.27209233501036,754,282,472,21,1.7,100,8.9,0,0,0,0,0,0,0,0,0
9.7,"random_instances_SVM","SVM",100,0,2684,2444,240,100,91,9,0.705976064219049,0.316901408450704,1.21154020899591,27,9,18,0,2,3.59,10.1,0,0,0,0,0,0,0.157552225466152,249.602709762908,22.4595881814727
9.7,"random_instances_SVM","SVM",100,1,2584,2357,227,200,178,22,0.81001677531214,0.330985915492958,1.27482962289868,59,22,37,32,1.7,7.18,8.1,0,0,0,0,0,0,0.118100728980643,286.311247757148,12.1944772844766
9.7,"random_instances_SVM","SVM",100,2,2484,2270,214,300,265,35,0.749800159872097,0.21830985915493,1.27482962289868,104,35,69,45,2,10.78,7.6,0,0,0,0,0,0,0.161412331970798,296.568779001753,18.124233127373
9.7,"random_instances_SVM","SVM",100,3,2384,2175,209,400,360,40,0.786807173979121,0.28169014084507,1.26578827805543,118,40,78,14,2,14.37,9,0,0,0,0,0,0,0.181865146602075,245.574330177216,22.1161476230461
9.7,"random_instances_SVM","SVM",100,4,2284,2082,202,500,453,47,0.803531822429373,0.28169014084507,1.26578827805543,143,47,96,25,2,17.96,9.6,0,0,0,0,0,0,0.162971273255247,212.874067743324,20.4182162356814
9.7,"random_instances_SVM","SVM",100,5,2184,1988,196,600,547,53,0.802299005865726,0.246478873239437,1.27482962289868,163,53,110,20,2.1,21.55,10.3,0,0,0,0,0,0,0.162965067402006,198.731127902393,20.8169901216677
9.7,"random_instances_SVM","SVM",100,6,2084,1893,191,700,642,58,0.825424167708091,0.288732394366197,1.25674693321218,173,58,115,10,2,25.14,11.1,0,0,0,0,0,0,0.144511979913888,175.417048397084,18.4507082953299
9.7,"random_instances_SVM","SVM",100,7,1984,1802,182,800,733,67,0.817515002082837,0.26056338028169,1.27482962289868,211,67,144,38,2.1,28.74,10.9,0,0,0,0,0,0,0.159204593627677,174.762939457009,20.3475259135374
9.7,"random_instances_SVM","SVM",100,8,1884,1715,169,900,820,80,0.795549475912223,0.23943661971831,1.27482962289868,237,80,157,26,2,32.33,10.2,0,0,0,0,0,0,0.15193000543206,180.903492207917,19.4838080989835
9.7,"random_instances_SVM","SVM",100,9,1784,1623,161,1000,912,88,0.799765821145891,0.253521126760563,1.27482962289868,270,88,182,33,2.1,35.92,10.4,0,0,0,0,0,0,0.09383572079194,155.068581438421,9.71047160011723
9.7,"random_instances_SVM","SVM",100,10,1684,1537,147,1100,998,102,0.762995237612726,0.246478873239437,1.25674693321218,303,102,201,33,2,39.51,9.8,0,0,0,0,0,0,0.140326276281903,164.650272252571,18.5101012891133
9.7,"random_instances_SVM","SVM",100,11,1584,1441,143,1200,1094,106,0.801921842807439,0.267605633802817,1.26578827805543,305,106,199,2,1.9,43.1,10.3,0,0,0,0,0,0,0.112656867911182,139.988728400982,13.1681029686205
9.7,"random_instances_SVM","SVM",100,12,1484,1356,128,1300,1179,121,0.789751297553499,0.274647887323944,1.27482962289868,358,121,237,53,2,46.7,9.7,0,0,0,0,0,0,0.12658189088399,138.572945551007,13.4982853295823
9.7,"random_instances_SVM","SVM",100,13,1384,1264,120,1400,1271,129,0.771197126805594,0.21830985915493,1.27482962289868,398,129,269,40,2.1,50.29,9.9,0,0,0,0,0,0,0.176237609297167,128.237762899924,22.7782720452522
9.7,"random_instances_SVM","SVM",100,14,1284,1175,109,1500,1360,140,0.799225408405662,0.26056338028169,1.27482962289868,406,140,266,8,1.9,53.88,9.7,0,0,0,0,0,0,0.152856835065375,120.83558706999,17.4965573486504
9.7,"random_instances_SVM","SVM",100,15,1184,1080,104,1600,1455,145,0.800660879746897,0.253521126760563,1.27482962289868,439,145,294,33,2,57.47,10,0,0,0,0,0,0,0.149333206696868,112.800568400089,16.8240423611335
9.7,"random_instances_SVM","SVM",100,16,1084,993,91,1700,1542,158,0.801128111595224,0.309859154929577,1.26578827805543,461,158,303,22,1.9,61.06,9.8,0,0,0,0,0,0,0.174470699660688,101.278506372293,22.7470599276739
9.7,"random_instances_SVM","SVM",100,17,984,903,81,1800,1632,168,0.699800722802039,0.183098591549296,1.25674693321218,508,168,340,47,2,64.66,9.7,0,0,0,0,0,0,0.120417077760099,92.6079974127423,13.1936039139785
9.7,"random_instances_SVM","SVM",100,18,884,808,76,1900,1727,173,0.764684027425943,0.26056338028169,1.27482962289868,512,173,339,4,2,68.25,10,0,0,0,0,0,0,0.167211843883727,85.2246582549334,20.9655523336415
9.7,"random_instances_SVM","SVM",100,19,784,719,65,2000,1816,184,0.741035340741499,0.176056338028169,1.23866424352567,552,184,368,40,2,71.84,9.9,0,0,0,0,0,0,0.155070787191778,73.9589477305609,18.3891306263083
9.7,"random_instances_SVM","SVM",100,20,684,628,56,2100,1907,193,0.717673748325282,0.183098591549296,1.26578827805543,565,193,372,13,1.9,75.43,9.9,0,0,0,0,0,0,0.160008377185554,66.1443865658458,20.132525703151
9.7,"random_instances_SVM","SVM",100,21,584,534,50,2200,2001,199,0.715680976345679,0.119718309859155,1.26578827805543,589,199,390,24,2,79.02,10.1,0,0,0,0,0,0,0.143325755615959,54.9635605252592,17.115541034706
9.7,"random_instances_SVM","SVM",100,22,484,441,43,2300,2094,206,0.758469280913291,0.232394366197183,1.26578827805543,616,206,410,27,2,82.61,10.2,0,0,0,0,0,0,0.146226550565751,46.2754285268204,18.0729282866151
9.7,"random_instances_SVM","SVM",100,23,384,350,34,2400,2185,215,0.768196710237442,0.225352112676056,1.27482962289868,665,215,450,49,2.1,86.21,10.2,0,0,0,0,0,0,0.13612489763119,36.3048301227322,16.2432040233716
9.7,"random_instances_SVM","SVM",100,24,284,254,30,2500,2281,219,0.820414091262196,0.330985915492958,1.27482962289868,661,219,442,-4,2,89.8,10.4,0,0,0,0,0,0,0.123547315303762,28.2531935425361,16.1734283140428
9.7,"random_instances_SVM","SVM",100,25,184,165,19,2600,2370,230,0.745589443937802,0.21830985915493,1.26578827805543,665,230,435,4,1.9,93.39,10.3,0,0,0,0,0,0,0.0781883984763241,16.9816599033337,14.9297235487946
9.7,"random_instances_SVM","SVM",100,26,84,77,7,2700,2458,242,0.818562051767032,0.309859154929577,1.27482962289868,707,242,465,42,1.9,96.98,10.2,0,0,0,0,0,0,1.0000000994736e-07,9.39360419383498,9.39360419383498
9.7,"random_instances_SVM","SVM",100,27,0,0,0,2784,2535,249,0.800728431339432,0.316901408450704,1.27482962289868,721,249,472,14,1.9,100,10.2,0,0,0,0,0,0,0,0,0
9.7,"random_policy_SVM","SVM",1,0,2684,2444,240,100,92,8,0.8167944055944,0.286713286713287,1.25693661177532,19,8,11,0,1.4,3.59,11.5,0,0,0,0,0,0,0.274861358709326,209.038902484711,33.7440753435211
9.7,"random_policy_SVM","SVM",1,1,2584,2361,223,200,175,25,0.83282797202797,0.335664335664336,1.2500240364585,69,25,44,50,1.8,7.18,7,0,0,0,0,0,0,0.482314452565512,275.904369363639,55.8707699618598
9.7,"random_policy_SVM","SVM",1,2,2484,2297,187,300,239,61,0.732984615384611,0.20979020979021,1.23898037446425,157,61,96,88,1.6,10.78,3.9,0,0,0,0,0,0,0.241183683681359,381.727038258442,28.3310614319237
9.7,"random_policy_SVM","SVM",1,3,2384,2214,170,400,322,78,0.773516083916083,0.188811188811189,1.24795849311978,192,78,114,35,1.5,14.37,4.1,0,0,0,0,0,0,0.201937728932344,426.164868634803,23.6063684940963
9.7,"random_policy_SVM","SVM",1,4,2284,2133,151,500,403,97,0.795608391608389,0.272727272727273,1.24795849311978,240,97,143,48,1.5,17.96,4.2,0,0,0,0,0,0,0.209588433233995,261.682099857773,21.6212869352539
9.7,"random_policy_SVM","SVM",1,5,2184,2064,120,600,472,128,0.787351048951041,0.230769230769231,1.25693661177532,312,128,184,72,1.4,21.55,3.7,0,0,0,0,0,0,0.220005619828652,200.089214181072,22.9247909463392
9.7,"random_policy_SVM","SVM",1,6,2084,1987,97,700,549,151,0.791306293706295,0.244755244755245,1.26591473043086,364,151,213,52,1.4,25.14,3.6,0,0,0,0,0,0,0.212922554414213,142.078524709834,22.0405956499913
9.7,"random_policy_SVM","SVM",1,7,1984,1922,62,800,614,186,0.793532867132864,0.27972027972028,1.25693661177532,452,186,266,88,1.4,28.74,3.3,0,0,0,0,0,0,0.225033237414516,122.686408532375,23.4839533223712
9.7,"random_policy_SVM","SVM",1,8,1884,1835,49,900,701,199,0.7976,0.27972027972028,1.25693661177532,478,199,279,26,1.4,32.33,3.5,0,0,0,0,0,0,0.206028775990124,128.203604516546,21.8101960048884
9.7,"random_policy_SVM","SVM",1,9,1784,1745,39,1000,791,209,0.803485314685311,0.307692307692308,1.25693661177532,511,209,302,33,1.4,35.92,3.8,0,0,0,0,0,0,0.170027877130602,70.3683439522297,19.3569664816385
9.7,"random_policy_SVM","SVM",1,10,1684,1651,33,1100,885,215,0.789745454545448,0.216783216783217,1.24795849311978,531,215,316,20,1.5,39.51,4.1,0,0,0,0,0,0,0.140544526242862,56.4109898470161,16.0354810502492
9.7,"random_policy_SVM","SVM",1,11,1584,1551,33,1200,985,215,0.788609790209786,0.223776223776224,1.24795849311978,522,215,307,-9,1.4,43.1,4.6,0,0,0,0,0,0,0.0858333895986673,29.9789776142858,10.6683956380735
9.7,"random_policy_SVM","SVM",1,12,1484,1459,25,1300,1077,223,0.785426573426569,0.223776223776224,1.23898037446425,560,223,337,38,1.5,46.7,4.8,0,0,0,0,0,0,0.133483424374393,43.5293175951,17.67513291038
9.7,"random_policy_SVM","SVM",1,13,1384,1365,19,1400,1171,229,0.773074125874121,0.237762237762238,1.22102413715317,588,229,359,28,1.6,50.29,5.1,0,0,0,0,0,0,0.133277190116004,66.7281235425445,14.9904746029221
9.7,"random_policy_SVM","SVM",1,14,1284,1268,16,1500,1268,232,0.759809790209788,0.216783216783217,1.23000225580871,604,232,372,16,1.6,53.88,5.5,0,0,0,0,0,0,0.153555180022105,101.621682659162,15.8662539276611
9.7,"random_policy_SVM","SVM",1,15,1184,1170,14,1600,1366,234,0.736173426573425,0.181818181818182,1.23000225580871,635,234,401,31,1.7,57.47,5.8,0,0,0,0,0,0,0.130709837891672,53.9624339108415,14.4800889743461
9.7,"random_policy_SVM","SVM",1,16,1084,1070,14,1700,1466,234,0.769096503496502,0.230769230769231,1.23898037446425,610,234,376,-25,1.6,61.06,6.3,0,0,0,0,0,0,0.0930607472363726,30.0407076486365,10.6965889300487
9.7,"random_policy_SVM","SVM",1,17,984,970,14,1800,1566,234,0.75118881118881,0.195804195804196,1.23670074176054,625,234,391,15,1.7,64.66,6.7,0,0,0,0,0,0,0.0519183021577094,12.3342483244784,6.87470447416786
9.7,"random_policy_SVM","SVM",1,18,884,870,14,1900,1666,234,0.72886713286713,0.160839160839161,1.23898037446425,627,234,393,2,1.7,68.25,7.1,0,0,0,0,0,0,0.0437756863434857,9.10241724729186,6.34062486678837
9.7,"random_policy_SVM","SVM",1,19,784,771,13,2000,1765,235,0.747759440559438,0.188811188811189,1.23898037446425,612,235,377,-15,1.6,71.84,7.5,0,0,0,0,0,0,0.012916865585128,4.12420779803008,3.79665165904758
9.7,"random_policy_SVM","SVM",1,20,684,671,13,2100,1865,235,0.738551048951048,0.181818181818182,1.23898037446425,610,235,375,-2,1.6,75.43,7.9,0,0,0,0,0,0,5.3185301691743e-07,0.282069705751918,0.282050249145295
9.7,"random_policy_SVM","SVM",1,21,584,578,6,2200,1958,242,0.756531468531469,0.202797202797203,1.27371891460289,658,242,416,48,1.7,79.02,8.1,0,0,0,0,0,0,0.106362790600517,33.4801479490009,16.0994148322651
9.7,"random_policy_SVM","SVM",1,22,484,479,5,2300,2057,243,0.737974825174825,0.195804195804196,1.25693661177532,665,243,422,7,1.7,82.61,8.5,0,0,0,0,0,0,0.0776597553250219,24.4540914950613,9.57328224070591
9.7,"random_policy_SVM","SVM",1,23,384,380,4,2400,2156,244,0.770981818181817,0.195804195804196,1.27371891460289,677,244,433,12,1.8,86.21,8.8,0,0,0,0,0,0,0.0294163135460497,7.77045745740954,5.04243567243129
9.7,"random_policy_SVM","SVM",1,24,284,283,1,2500,2253,247,0.789767832167827,0.251748251748252,1.27371891460289,678,247,431,1,1.7,89.8,9.1,0,0,0,0,0,0,0.0102487570099855,3.19305579702899,2.64962692730975
9.7,"random_policy_SVM","SVM",1,25,184,183,1,2600,2353,247,0.771793006993007,0.223776223776224,1.28268876611418,694,247,447,16,1.8,93.39,9.5,0,0,0,0,0,0,0.00260597649063959,0.791719044121842,0.783730332433162
9.7,"random_policy_SVM","SVM",1,26,84,83,1,2700,2453,247,0.799362237762238,0.237762237762238,1.28268876611418,685,247,438,-9,1.8,96.98,9.9,0,0,0,0,0,0,4.34052613383072e-08,0.202080364884863,0.202080364884863
9.7,"random_policy_SVM","SVM",1,27,0,0,0,2784,2536,248,0.76430769230769,0.202797202797203,1.27371891460289,708,248,460,23,1.9,100,10.2,0,0,0,0,0,0,0,0,0
9.7,"random_policy_SVM","SVM",2,0,2684,2438,246,100,89,11,0.750903939397533,0.246268656716418,1.23596533461724,32,11,21,0,1.9,3.59,8.1,0,0,0,0,0,0,0.125532650621015,301.852585932197,14.578560630903
9.7,"random_policy_SVM","SVM",2,1,2584,2347,237,200,180,20,0.745343971168782,0.365671641791045,1.23596533461724,57,20,37,25,1.8,7.18,9,0,0,0,0,0,0,0.197051471910914,278.631022248065,22.4337460070785
9.7,"random_policy_SVM","SVM",2,2,2484,2289,195,300,238,62,0.73818358564604,0.156716417910448,1.14973519499278,157,62,95,100,1.5,10.78,3.8,0,0,0,0,0,0,0.312702826468038,461.327917981915,34.1194453463197
9.7,"random_policy_SVM","SVM",2,3,2384,2196,188,400,331,69,0.79759463208185,0.343283582089552,1.23596533461724,192,69,123,35,1.8,14.37,4.8,0,0,0,0,0,0,0.220120538606682,396.819281508885,22.7499356474017
9.7,"random_policy_SVM","SVM",2,4,2284,2117,167,500,410,90,0.750275627422856,0.186567164179104,1.23596533461724,249,90,159,57,1.8,17.96,4.6,0,0,0,0,0,0,0.241570422361254,302.640854123205,25.4225892558916
9.7,"random_policy_SVM","SVM",2,5,2184,2031,153,600,496,104,0.753968442141953,0.208955223880597,1.24554646124218,284,104,180,35,1.7,21.55,4.8,0,0,0,0,0,0,0.212219667645904,234.834940603946,22.5227174421361
9.7,"random_policy_SVM","SVM",2,6,2084,1953,131,700,574,126,0.777583488435505,0.246268656716418,1.25512758786712,335,126,209,51,1.7,25.14,4.6,0,0,0,0,0,0,0.217410876169977,207.438762381407,23.0095276068612
9.7,"random_policy_SVM","SVM",2,7,1984,1881,103,800,646,154,0.786510260453097,0.253731343283582,1.25512758786712,406,154,252,71,1.6,28.74,4.2,0,0,0,0,0,0,0.219439831927329,171.140507763792,22.8965865648564
9.7,"random_policy_SVM","SVM",2,8,1884,1802,82,900,725,175,0.766445769563623,0.194029850746269,1.25512758786712,462,175,287,56,1.6,32.33,4.1,0,0,0,0,0,0,0.216304812140869,169.706226085963,22.5742452501061
9.7,"random_policy_SVM","SVM",2,9,1784,1722,62,1000,805,195,0.783908100482498,0.261194029850746,1.25512758786712,513,195,318,51,1.6,35.92,4.1,0,0,0,0,0,0,0.205546544322707,121.800943878139,22.6311479715518
9.7,"random_policy_SVM","SVM",2,10,1684,1641,43,1100,886,214,0.767589771555252,0.201492537313433,1.19764082811748,561,214,347,48,1.6,39.51,4.1,0,0,0,0,0,0,0.19680758009121,84.9647435140152,21.3784940263832
9.7,"random_policy_SVM","SVM",2,11,1584,1549,35,1200,978,222,0.777061870947094,0.238805970149254,1.19764082811748,577,222,355,16,1.6,43.1,4.4,0,0,0,0,0,0,0.136929786396793,41.996619197433,15.8776589150465
9.7,"random_policy_SVM","SVM",2,12,1484,1455,29,1300,1072,228,0.7904935212737,0.328358208955224,1.19764082811748,586,228,358,9,1.6,46.7,4.7,0,0,0,0,0,0,0.103356257665308,29.0030006105789,13.0987011438067
9.7,"random_policy_SVM","SVM",2,13,1384,1358,26,1400,1169,231,0.744407430678222,0.17910447761194,1.21680308136736,593,231,362,7,1.6,50.29,5.1,0,0,0,0,0,0,0.111958560036727,43.5619509886463,22.2641052485018
9.7,"random_policy_SVM","SVM",2,14,1284,1262,22,1500,1265,235,0.788721207307388,0.208955223880597,1.24554646124218,602,235,367,9,1.6,53.88,5.4,0,0,0,0,0,0,0.111784967253865,54.7233166997319,29.8766826047618
9.7,"random_policy_SVM","SVM",2,15,1184,1171,13,1600,1356,244,0.794921342453737,0.283582089552239,1.19764082811748,641,244,397,39,1.6,57.47,5.6,0,0,0,0,0,0,0.113476983140215,43.0343873001019,17.1361793197119
9.7,"random_policy_SVM","SVM",2,16,1084,1071,13,1700,1456,244,0.804808364847723,0.305970149253731,1.20722195474242,643,244,399,2,1.6,61.06,6,0,0,0,0,0,0,0.0862274598299924,34.6809519714173,10.3191050453895
9.7,"random_policy_SVM","SVM",2,17,984,972,12,1800,1555,245,0.808376702666178,0.313432835820896,1.20722195474242,650,245,405,7,1.7,64.66,6.3,0,0,0,0,0,0,0.0586253705986841,22.2273543005141,7.62521187355041
9.7,"random_policy_SVM","SVM",2,18,884,873,11,1900,1654,246,0.782195061230781,0.246268656716418,1.19764082811748,657,246,411,7,1.7,68.25,6.7,0,0,0,0,0,0,0.027719993016483,9.20617399441189,4.32418343708151
9.7,"random_policy_SVM","SVM",2,19,784,774,10,2000,1753,247,0.816343224307375,0.335820895522388,1.20722195474242,664,247,417,7,1.7,71.84,7.1,0,0,0,0,0,0,0.013073435519476,4.3762225855305,2.09741362931215
9.7,"random_policy_SVM","SVM",2,20,684,675,9,2100,1852,248,0.823616231787843,0.276119402985075,1.23596533461724,660,248,412,-4,1.7,75.43,7.5,0,0,0,0,0,0,0.0122295274761615,3.95294533966333,1.76190569640045
9.7,"random_policy_SVM","SVM",2,21,584,576,8,2200,1951,249,0.784945407987862,0.238805970149254,1.24554646124218,664,249,415,4,1.7,79.02,7.8,0,0,0,0,0,0,0.0127988388083391,3.50277635753203,1.94769130012256
9.7,"random_policy_SVM","SVM",2,22,484,480,4,2300,2047,253,0.808127748864894,0.238805970149254,1.26470871449206,707,253,454,43,1.8,82.61,8.1,0,0,0,0,0,0,0.00173174496710034,2.97180310904611,2.85671062160809
9.7,"random_policy_SVM","SVM",2,23,384,383,1,2400,2144,256,0.765035031356328,0.201492537313433,1.26470871449206,692,256,436,-15,1.7,86.21,8.4,0,0,0,0,0,0,0.000401827606985988,1.7584618074423,1.74115431546754
9.7,"random_policy_SVM","SVM",2,24,284,284,0,2500,2243,257,0.817676905385706,0.253731343283582,1.26470871449206,706,257,449,14,1.7,89.8,8.7,0,0,0,0,0,0,0.000761260898147401,0.318153562821925,0.270807640660698
9.7,"random_policy_SVM","SVM",2,25,184,184,0,2600,2343,257,0.755308050691741,0.156716417910448,1.26470871449206,686,257,429,-20,1.7,93.39,9.1,0,0,0,0,0,0,1.82084261515053e-05,0.0294244996194702,0.0288514398052109
9.7,"random_policy_SVM","SVM",2,26,84,84,0,2700,2443,257,0.827178642134841,0.343283582089552,1.26470871449206,690,257,433,4,1.7,96.98,9.5,0,0,0,0,0,0,1.0000000994736e-07,0.00559250852258872,0.00559250852258872
9.7,"random_policy_SVM","SVM",2,27,0,0,0,2784,2527,257,0.774791649378214,0.216417910447761,1.26470871449206,699,257,442,9,1.7,100,9.8,0,0,0,0,0,0,0,0,0
9.7,"random_policy_SVM","SVM",3,0,2684,2447,237,100,85,15,0.690435211639306,0.172661870503597,1.05295892318403,41,15,26,0,1.7,3.59,5.7,0,0,0,0,0,0,0.397026325721534,414.697482464903,42.1728417550085
9.7,"random_policy_SVM","SVM",3,1,2584,2352,232,200,180,20,0.667624751873152,0.115107913669065,1.0899048503133,56,20,36,15,1.8,7.18,9,0,0,0,0,0,0,0.153901844692096,255.142048932306,18.5542936730342
9.7,"random_policy_SVM","SVM",3,2,2484,2262,222,300,270,30,0.7675811503907,0.251798561151079,1.24692504061267,84,30,54,28,1.8,10.78,9,0,0,0,0,0,0,0.138001322018763,236.839028384546,15.0583754751543
9.7,"random_policy_SVM","SVM",3,3,2384,2177,207,400,355,45,0.777517698759662,0.215827338129496,1.2653980041773,129,45,84,45,1.9,14.37,7.9,0,0,0,0,0,0,0.144070247308591,187.195136751859,16.0034181547975
9.7,"random_policy_SVM","SVM",3,4,2284,2103,181,500,429,71,0.746136105469695,0.237410071942446,1.23768855883036,190,71,119,61,1.7,17.96,6,0,0,0,0,0,0,0.169263492846533,188.094236668909,19.6268204576185
9.7,"random_policy_SVM","SVM",3,5,2184,2025,159,600,507,93,0.742074283157212,0.244604316546763,1.20074263170109,225,93,132,35,1.4,21.55,5.5,0,0,0,0,0,0,0.167507417563777,198.684152346941,17.9700648452017
9.7,"random_policy_SVM","SVM",3,6,2084,1943,141,700,589,111,0.780632909939991,0.266187050359712,1.24692504061267,272,111,161,47,1.5,25.14,5.3,0,0,0,0,0,0,0.178265931869893,135.615665190356,19.7017463135533
9.7,"random_policy_SVM","SVM",3,7,1984,1864,120,800,668,132,0.79264626576251,0.323741007194245,1.24692504061267,320,132,188,48,1.4,28.74,5.1,0,0,0,0,0,0,0.176807512771692,110.465811386096,18.2549454469324
9.7,"random_policy_SVM","SVM",3,8,1884,1795,89,900,737,163,0.796880199189935,0.330935251798561,1.24692504061267,388,163,225,68,1.4,32.33,4.5,0,0,0,0,0,0,0.167085131838128,70.00059146952,19.2022587885112
9.7,"random_policy_SVM","SVM",3,9,1784,1717,67,1000,815,185,0.785033217445189,0.280575539568345,1.24692504061267,441,185,256,53,1.4,35.92,4.4,0,0,0,0,0,0,0.168659739400538,108.800340722397,18.2093799787425
9.7,"random_policy_SVM","SVM",3,10,1684,1628,56,1100,904,196,0.7858077174624,0.294964028776978,1.24692504061267,473,196,277,32,1.4,39.51,4.6,0,0,0,0,0,0,0.130535112329222,60.8747824082784,15.5157284825388
9.7,"random_policy_SVM","SVM",3,11,1584,1532,52,1200,1000,200,0.774127109795421,0.273381294964029,1.24692504061267,495,200,295,22,1.5,43.1,5,0,0,0,0,0,0,0.114647078150558,58.1283747665442,12.7482113542843
9.7,"random_policy_SVM","SVM",3,12,1484,1434,50,1300,1098,202,0.774396750542153,0.244604316546763,1.24692504061267,499,202,297,4,1.5,46.7,5.4,0,0,0,0,0,0,0.0613016293677462,23.1781237861532,7.52474282978738
9.7,"random_policy_SVM","SVM",3,13,1384,1344,40,1400,1188,212,0.778079928401778,0.20863309352518,1.22845207704804,532,212,320,33,1.5,50.29,5.6,0,0,0,0,0,0,0.140347003983193,65.8808301512469,15.5360127994913
9.7,"random_policy_SVM","SVM",3,14,1284,1251,33,1500,1281,219,0.80445308824711,0.273381294964029,1.22845207704804,561,219,342,29,1.6,53.88,5.8,0,0,0,0,0,0,0.123742892097341,50.1469794667974,13.8179624912178
9.7,"random_policy_SVM","SVM",3,15,1184,1164,20,1600,1368,232,0.816156644062747,0.287769784172662,1.21921559526572,585,232,353,24,1.5,57.47,5.9,0,0,0,0,0,0,0.10063807983627,31.9004865005028,12.336606068631
9.7,"random_policy_SVM","SVM",3,16,1084,1071,13,1700,1461,239,0.79312243984717,0.223021582733813,1.21921559526572,616,239,377,31,1.6,61.06,6.1,0,0,0,0,0,0,0.0767291589870759,22.5254771128836,9.54768533212667
9.7,"random_policy_SVM","SVM",3,17,984,971,13,1800,1561,239,0.797494062166541,0.251798561151079,1.22845207704804,618,239,379,2,1.6,64.66,6.5,0,0,0,0,0,0,0.0385374966666902,9.29418285596348,5.52636144509092
9.7,"random_policy_SVM","SVM",3,18,884,871,13,1900,1661,239,0.826437414661582,0.302158273381295,1.21921559526572,620,239,381,2,1.6,68.25,6.9,0,0,0,0,0,0,0.00788289532128391,1.90201962643929,1.47486741108633
9.7,"random_policy_SVM","SVM",3,19,784,772,12,2000,1760,240,0.801641940036496,0.266187050359712,1.23768855883036,620,240,380,0,1.6,71.84,7.3,0,0,0,0,0,0,0.005734759610684,2.14847940263001,1.87583331842263
9.7,"random_policy_SVM","SVM",3,20,684,675,9,2100,1857,243,0.815181347744779,0.309352517985612,1.24692504061267,640,243,397,20,1.6,75.43,7.6,0,0,0,0,0,0,0.00586648894625525,2.06139278959281,1.01009684247677
9.7,"random_policy_SVM","SVM",3,21,584,579,5,2200,1953,247,0.819782451550726,0.266187050359712,1.25616152239499,637,247,390,-3,1.6,79.02,7.9,0,0,0,0,0,0,0.0969522119655335,33.5553096812741,18.6274376981884
9.7,"random_policy_SVM","SVM",3,22,484,479,5,2300,2053,247,0.823867222011867,0.309352517985612,1.25616152239499,659,247,412,22,1.7,82.61,8.3,0,0,0,0,0,0,0.0372694709405394,10.5783546676156,5.39302506105077
9.7,"random_policy_SVM","SVM",3,23,384,380,4,2400,2152,248,0.766548483701079,0.18705035971223,1.25616152239499,659,248,411,0,1.7,86.21,8.7,0,0,0,0,0,0,0.0541574657238067,14.8747485732124,8.10516224049951
9.7,"random_policy_SVM","SVM",3,24,284,281,3,2500,2251,249,0.832432618498503,0.294964028776978,1.27463448595962,662,249,413,3,1.7,89.8,9,0,0,0,0,0,0,0.0305144821288573,7.06658711384775,4.74759252092514
9.7,"random_policy_SVM","SVM",3,25,184,184,0,2600,2348,252,0.829426411024289,0.280575539568345,1.27463448595962,686,252,434,24,1.7,93.39,9.3,0,0,0,0,0,0,0.0100046991700638,2.94238473009423,2.65697961590863
9.7,"random_policy_SVM","SVM",3,26,84,84,0,2700,2448,252,0.831985129599669,0.316546762589928,1.27463448595962,680,252,428,-6,1.7,96.98,9.7,0,0,0,0,0,0,3.67358984398661e-05,0.376823123052979,0.376823123052979
9.7,"random_policy_SVM","SVM",3,27,0,0,0,2784,2532,252,0.830436129565247,0.302158273381295,1.27463448595962,669,252,417,-11,1.7,100,10,0,0,0,0,0,0,0,0,0
9.7,"random_policy_SVM","SVM",4,0,2684,2435,249,100,92,8,0.719227531919439,0.26865671641791,1.21680308136736,29,8,21,0,2.6,3.59,11.5,0,0,0,0,0,0,0.109879871932389,230.430067283199,11.9707329096446
9.7,"random_policy_SVM","SVM",4,1,2584,2362,222,200,165,35,0.770600927056541,0.134328358208955,1.25512758786712,99,35,64,70,1.8,7.18,4.7,0,0,0,0,0,0,0.236545406634601,361.74199337567,25.4800439721671
9.7,"random_policy_SVM","SVM",4,2,2484,2276,208,300,251,49,0.739872915011917,0.194029850746269,1.24554646124218,132,49,83,33,1.7,10.78,5.1,0,0,0,0,0,0,0.182595211553084,364.587997298032,19.4952171363949
9.7,"random_policy_SVM","SVM",4,3,2384,2196,188,400,331,69,0.80801512690717,0.291044776119403,1.26470871449206,183,69,114,51,1.7,14.37,4.8,0,0,0,0,0,0,0.211543728128438,236.745334722823,22.6486667505172
9.7,"random_policy_SVM","SVM",4,4,2284,2132,152,500,395,105,0.788970161108679,0.171641791044776,1.26470871449206,266,105,161,83,1.5,17.96,3.8,0,0,0,0,0,0,0.221686639161783,369.879356523661,22.4878575568041
9.7,"random_policy_SVM","SVM",4,5,2184,2058,126,600,469,131,0.795033964411464,0.216417910447761,1.26470871449206,326,131,195,60,1.5,21.55,3.6,0,0,0,0,0,0,0.229319168310168,244.354074699122,23.5752547315004
9.7,"random_policy_SVM","SVM",4,6,2084,1987,97,700,540,160,0.780576861522413,0.223880597014925,1.25512758786712,386,160,226,60,1.4,25.14,3.4,0,0,0,0,0,0,0.235097506506599,135.124196388865,25.2126020415898
9.7,"random_policy_SVM","SVM",4,7,1984,1908,76,800,619,181,0.795929012601806,0.238805970149254,1.25512758786712,435,181,254,49,1.4,28.74,3.4,0,0,0,0,0,0,0.201511426025407,124.837105694941,21.9756304883347
9.7,"random_policy_SVM","SVM",4,8,1884,1826,58,900,701,199,0.791157398077132,0.23134328358209,1.25512758786712,506,199,307,71,1.5,32.33,3.5,0,0,0,0,0,0,0.220725377010609,213.024707572892,22.8403741877977
9.7,"random_policy_SVM","SVM",4,9,1784,1737,47,1000,790,210,0.788792336964899,0.23134328358209,1.26470871449206,522,210,312,16,1.5,35.92,3.8,0,0,0,0,0,0,0.177386357246567,93.3829957818786,19.5734995648725
9.7,"random_policy_SVM","SVM",4,10,1684,1651,33,1100,876,224,0.761822341825425,0.149253731343284,1.26470871449206,566,224,342,44,1.5,39.51,3.9,0,0,0,0,0,0,0.138092505180285,48.3057927308101,21.6595214999874
9.7,"random_policy_SVM","SVM",4,11,1584,1557,27,1200,970,230,0.777950991665976,0.17910447761194,1.26470871449206,565,230,335,-1,1.5,43.1,4.2,0,0,0,0,0,0,0.103132645525133,34.6441260235613,14.0986103426146
9.7,"random_policy_SVM","SVM",4,12,1484,1459,25,1300,1068,232,0.770547579813404,0.17910447761194,1.26470871449206,579,232,347,14,1.5,46.7,4.6,0,0,0,0,0,0,0.149110000487544,109.075526384823,15.9576487407262
9.7,"random_policy_SVM","SVM",4,13,1384,1362,22,1400,1165,235,0.740264128128224,0.141791044776119,1.26470871449206,615,235,380,36,1.6,50.29,5,0,0,0,0,0,0,0.153140016378008,51.6440309114482,20.132081002542
9.7,"random_policy_SVM","SVM",4,14,1284,1266,18,1500,1261,239,0.792532571455673,0.223880597014925,1.26470871449206,625,239,386,10,1.6,53.88,5.3,0,0,0,0,0,0,0.152910145371482,78.4393360296436,26.3946161530586
9.7,"random_policy_SVM","SVM",4,15,1184,1171,13,1600,1356,244,0.770268988654824,0.17910447761194,1.26470871449206,653,244,409,28,1.7,57.47,5.6,0,0,0,0,0,0,0.142413305208211,105.449711545087,14.8622434873655
9.7,"random_policy_SVM","SVM",4,16,1084,1075,9,1700,1452,248,0.775740044811689,0.186567164179104,1.26470871449206,676,248,428,23,1.7,61.06,5.9,0,0,0,0,0,0,0.0926993549462884,38.7651374379767,11.2119233188195
9.7,"random_policy_SVM","SVM",4,17,984,976,8,1800,1551,249,0.743945087904403,0.111940298507463,1.28387096774194,676,249,427,0,1.7,64.66,6.2,0,0,0,0,0,0,0.204237510181369,64.3910074695188,33.120852845369
9.7,"random_policy_SVM","SVM",4,18,884,878,6,1900,1649,251,0.783570234609324,0.186567164179104,1.274289841117,674,251,423,-2,1.7,68.25,6.6,0,0,0,0,0,0,0.103941175607027,54.4055248392364,11.7916248650528
9.7,"random_policy_SVM","SVM",4,19,784,783,1,2000,1744,256,0.801933541190003,0.23134328358209,1.274289841117,704,256,448,30,1.8,71.84,6.8,0,0,0,0,0,0,0.0226607897020475,8.31968183418078,5.31807468066213
9.7,"random_policy_SVM","SVM",4,20,684,683,1,2100,1844,256,0.791999099024341,0.223880597014925,1.274289841117,716,256,460,12,1.8,75.43,7.2,0,0,0,0,0,0,0.0657636177459549,27.0861530375248,7.81780885743656
9.7,"random_policy_SVM","SVM",4,21,584,583,1,2200,1944,256,0.800339051367469,0.223880597014925,1.274289841117,696,256,440,-20,1.7,79.02,7.6,0,0,0,0,0,0,0.00757989282334842,2.21657471042384,1.39349835318996
9.7,"random_policy_SVM","SVM",4,22,484,483,1,2300,2044,256,0.730880940808274,0.17910447761194,1.274289841117,696,256,440,0,1.7,82.61,8,0,0,0,0,0,0,0.00873818188289272,2.47366189057459,1.61528169955015
9.7,"random_policy_SVM","SVM",4,23,384,384,0,2400,2143,257,0.801269664386569,0.291044776119403,1.274289841117,703,257,446,7,1.7,86.21,8.3,0,0,0,0,0,0,0.00249060649941447,1.91595255175003,1.75627063653808
9.7,"random_policy_SVM","SVM",4,24,284,284,0,2500,2243,257,0.780274560477995,0.216417910447761,1.274289841117,696,257,439,-7,1.7,89.8,8.7,0,0,0,0,0,0,0.00341259106301379,1.15491028772087,0.915912843937204
9.7,"random_policy_SVM","SVM",4,25,184,184,0,2600,2343,257,0.758188801820922,0.186567164179104,1.274289841117,712,257,455,16,1.8,93.39,9.1,0,0,0,0,0,0,1.79825276479515e-05,0.0286196462108272,0.0280887373257006
9.7,"random_policy_SVM","SVM",4,26,84,84,0,2700,2443,257,0.750512726281226,0.186567164179104,1.274289841117,702,257,445,-10,1.7,96.98,9.5,0,0,0,0,0,0,1.0000000994736e-07,0.00193341927246411,0.00193341927246411
9.7,"random_policy_SVM","SVM",4,27,0,0,0,2784,2527,257,0.774157409932073,0.186567164179104,1.274289841117,714,257,457,12,1.8,100,9.8,0,0,0,0,0,0,0,0,0
9.7,"random_policy_SVM","SVM",5,0,2684,2432,252,100,89,11,0.74890686758893,0.34375,1.07323588709677,25,11,14,0,1.3,3.59,8.1,0,0,0,0,0,0,0.181600994689075,287.759373159024,18.9537319833917
9.7,"random_policy_SVM","SVM",5,1,2584,2368,216,200,153,47,0.697609930830041,0.1328125,1.16350806451613,112,47,65,87,1.4,7.18,3.3,0,0,0,0,0,0,0.304572098973038,572.40669253549,37.8177461347397
9.7,"random_policy_SVM","SVM",5,2,2484,2282,202,300,239,61,0.734331768774703,0.09375,1.27384072580645,166,61,105,54,1.7,10.78,3.9,0,0,0,0,0,0,0.252708020226085,456.236395862983,27.257226784156
9.7,"random_policy_SVM","SVM",5,3,2384,2191,193,400,330,70,0.814216897233202,0.234375,1.28387096774194,163,70,93,-3,1.3,14.37,4.7,0,0,0,0,0,0,0.228189269725251,247.239300150217,28.894281816126
9.7,"random_policy_SVM","SVM",5,4,2284,2107,177,500,414,86,0.832262845849803,0.2734375,1.28387096774194,208,86,122,45,1.4,17.96,4.8,0,0,0,0,0,0,0.206049981888794,151.72677330621,22.2088276922928
9.7,"random_policy_SVM","SVM",5,5,2184,2041,143,600,480,120,0.833318922924903,0.296875,1.28387096774194,291,120,171,83,1.4,21.55,4,0,0,0,0,0,0,0.221147701794123,170.133770009062,23.5747954491928
9.7,"random_policy_SVM","SVM",5,6,2084,1975,109,700,546,154,0.815526185770754,0.2421875,1.27384072580645,365,154,211,74,1.4,25.14,3.5,0,0,0,0,0,0,0.234218300854706,209.119203033097,31.8630234732338
9.7,"random_policy_SVM","SVM",5,7,1984,1894,90,800,627,173,0.831138833992093,0.2890625,1.28387096774194,413,173,240,48,1.4,28.74,3.6,0,0,0,0,0,0,0.222632686580992,109.598543952072,23.835906417443
9.7,"random_policy_SVM","SVM",5,8,1884,1816,68,900,705,195,0.830589179841894,0.3203125,1.28387096774194,471,195,276,58,1.4,32.33,3.6,0,0,0,0,0,0,0.204347215765109,110.62525878013,22.1283819353034
9.7,"random_policy_SVM","SVM",5,9,1784,1728,56,1000,793,207,0.832052865612648,0.296875,1.28387096774194,502,207,295,31,1.4,35.92,3.8,0,0,0,0,0,0,0.16138457575839,84.4296046006158,18.5952768142176
9.7,"random_policy_SVM","SVM",5,10,1684,1646,38,1100,875,225,0.833559782608697,0.296875,1.28387096774194,540,225,315,38,1.4,39.51,3.9,0,0,0,0,0,0,0.184144120885432,88.1526866568884,20.2266891436265
9.7,"random_policy_SVM","SVM",5,11,1584,1555,29,1200,966,234,0.83412178853755,0.2734375,1.28387096774194,572,234,338,32,1.4,43.1,4.1,0,0,0,0,0,0,0.144797023154686,52.6677905511392,16.4947709737231
9.7,"random_policy_SVM","SVM",5,12,1484,1463,21,1300,1058,242,0.823659832015812,0.2578125,1.28387096774194,595,242,353,23,1.5,46.7,4.4,0,0,0,0,0,0,0.111238830620587,34.6884234271015,14.0554028807421
9.7,"random_policy_SVM","SVM",5,13,1384,1366,18,1400,1155,245,0.815748517786563,0.2578125,1.28387096774194,612,245,367,17,1.5,50.29,4.7,0,0,0,0,0,0,0.112362837022378,39.7686526243231,13.2941786531114
9.7,"random_policy_SVM","SVM",5,14,1284,1267,17,1500,1254,246,0.819948122529644,0.25,1.27266776012891,611,246,365,-1,1.5,53.88,5.1,0,0,0,0,0,0,0.0564806496961882,15.1843513583265,7.92641854746284
9.7,"random_policy_SVM","SVM",5,15,1184,1168,16,1600,1353,247,0.801587203557318,0.265625,1.25378024193548,629,247,382,18,1.5,57.47,5.5,0,0,0,0,0,0,0.123331290670938,42.7937038781837,15.1206626589797
9.7,"random_policy_SVM","SVM",5,16,1084,1070,14,1700,1451,249,0.799549160079057,0.2578125,1.26381048387097,638,249,389,9,1.6,61.06,5.8,0,0,0,0,0,0,0.0983368530262181,27.8727614467787,12.8929428338916
9.7,"random_policy_SVM","SVM",5,17,984,970,14,1800,1551,249,0.796844120553365,0.25,1.27384072580645,646,249,397,8,1.6,64.66,6.2,0,0,0,0,0,0,0.0613796678058136,16.9547964973397,9.17762316215588
9.7,"random_policy_SVM","SVM",5,18,884,870,14,1900,1651,249,0.79810400197629,0.234375,1.27266776012891,645,249,396,-1,1.6,68.25,6.6,0,0,0,0,0,0,0.0189422463063514,4.82789505799506,3.50031304011562
9.7,"random_policy_SVM","SVM",5,19,784,770,14,2000,1751,249,0.775067934782614,0.21875,1.2714969526219,642,249,393,-3,1.6,71.84,7,0,0,0,0,0,0,0.000343313441530913,0.384052582752707,0.371427957224573
9.7,"random_policy_SVM","SVM",5,20,684,672,12,2100,1849,251,0.803223814229253,0.2734375,1.27266776012891,647,251,396,5,1.6,75.43,7.4,0,0,0,0,0,0,0.000876920878744675,0.516038939593657,0.472664956899397
9.7,"random_policy_SVM","SVM",5,21,584,578,6,2200,1943,257,0.793157114624507,0.21875,1.28387096774194,698,257,441,51,1.7,79.02,7.6,0,0,0,0,0,0,0.107253160039204,33.9079392237436,12.6374203552707
9.7,"random_policy_SVM","SVM",5,22,484,481,3,2300,2040,260,0.800759634387353,0.2578125,1.28268876611418,704,260,444,6,1.7,82.61,7.8,0,0,0,0,0,0,0.0538886916395102,13.5122421961837,7.71481215184678
9.7,"random_policy_SVM","SVM",5,23,384,382,2,2400,2139,261,0.811147480237154,0.2421875,1.28268876611418,705,261,444,1,1.7,86.21,8.2,0,0,0,0,0,0,0.022661086198082,6.2899973528036,5.21893093614119
9.7,"random_policy_SVM","SVM",5,24,284,282,2,2500,2239,261,0.805681818181819,0.28125,1.28268876611418,705,261,444,0,1.7,89.8,8.6,0,0,0,0,0,0,0.00579655154973562,2.38309078108844,2.14919583427231
9.7,"random_policy_SVM","SVM",5,25,184,183,1,2600,2338,262,0.814556571146247,0.2421875,1.28268876611418,737,262,475,32,1.8,93.39,8.9,0,0,0,0,0,0,0.0294632908574075,7.95107182860372,7.03198281286033
9.7,"random_policy_SVM","SVM",5,26,84,84,0,2700,2437,263,0.788519021739132,0.2109375,1.28150873965041,719,263,456,-18,1.7,96.98,9.3,0,0,0,0,0,0,3.15262061148552e-07,0.883699137068406,0.883699137068406
9.7,"random_policy_SVM","SVM",5,27,0,0,0,2784,2521,263,0.761166007905139,0.1953125,1.28268876611418,729,263,466,10,1.8,100,9.6,0,0,0,0,0,0,0,0,0
9.7,"random_policy_SVM","SVM",6,0,2684,2422,262,100,93,7,0.68016019398692,0.0901639344262295,1.26282390269699,26,7,19,0,2.7,3.59,13.3,0,0,0,0,0,0,0.102415930980949,216.141262833793,11.3377992104366
9.7,"random_policy_SVM","SVM",6,1,2584,2331,253,200,184,16,0.653164540635358,0.245901639344262,1.11549444738234,56,16,40,30,2.5,7.18,11.5,0,0,0,0,0,0,0.102834190738345,208.493920121215,10.9426518236656
9.7,"random_policy_SVM","SVM",6,2,2484,2257,227,300,258,42,0.640511537320558,0.147540983606557,1.15758857747224,119,42,77,63,1.8,10.78,6.1,0,0,0,0,0,0,0.189875442009007,306.693053969336,22.187757107379
9.7,"random_policy_SVM","SVM",6,3,2384,2172,212,400,343,57,0.721201841843909,0.19672131147541,1.21020624008461,151,57,94,32,1.6,14.37,6,0,0,0,0,0,0,0.159889891064442,291.378001401828,18.1069860475987
9.7,"random_policy_SVM","SVM",6,4,2284,2096,188,500,419,81,0.716074860378433,0.172131147540984,1.16811210999471,205,81,124,54,1.5,17.96,5.2,0,0,0,0,0,0,0.174892113132582,269.957219834253,18.3761947704523
9.7,"random_policy_SVM","SVM",6,5,2184,2012,172,600,503,97,0.747578387999637,0.180327868852459,1.23125330512956,236,97,139,31,1.4,21.55,5.2,0,0,0,0,0,0,0.166595678690047,177.893448113596,17.9735821855879
9.7,"random_policy_SVM","SVM",6,6,2084,1936,148,700,579,121,0.735222040216171,0.221311475409836,1.16811210999471,289,121,168,53,1.4,25.14,4.8,0,0,0,0,0,0,0.165303508769854,181.470711125048,17.545621968111
9.7,"random_policy_SVM","SVM",6,7,1984,1863,121,800,652,148,0.748191046162183,0.245901639344262,1.16811210999471,341,148,193,52,1.3,28.74,4.4,0,0,0,0,0,0,0.172753523697788,123.952046283961,18.3093947356609
9.7,"random_policy_SVM","SVM",6,8,1884,1790,94,900,725,175,0.750570739446158,0.254098360655738,1.1565226579718,409,175,234,68,1.3,32.33,4.1,0,0,0,0,0,0,0.190456964673968,163.239885950882,20.0852029524103
9.7,"random_policy_SVM","SVM",6,9,1784,1718,66,1000,797,203,0.761176174691412,0.278688524590164,1.1565226579718,476,203,273,67,1.3,35.92,3.9,0,0,0,0,0,0,0.155088979400546,89.5458768748672,17.9727864267016
9.7,"random_policy_SVM","SVM",6,10,1684,1632,52,1100,883,217,0.748397415227454,0.229508196721311,1.14706504494976,522,217,305,46,1.4,39.51,4.1,0,0,0,0,0,0,0.156805293349858,108.754356220415,17.547644470779
9.7,"random_policy_SVM","SVM",6,11,1584,1540,44,1200,975,225,0.759451058286359,0.262295081967213,1.14706504494976,542,225,317,20,1.4,43.1,4.3,0,0,0,0,0,0,0.142450342262974,97.6140273415069,16.0748017117433
9.7,"random_policy_SVM","SVM",6,12,1484,1442,42,1300,1073,227,0.746359520707851,0.254098360655738,1.15758857747224,564,227,337,22,1.5,46.7,4.7,0,0,0,0,0,0,0.11987712718336,72.7004229634464,13.8590074983706
9.7,"random_policy_SVM","SVM",6,13,1384,1342,42,1400,1173,227,0.753169699861988,0.262295081967213,1.14706504494976,550,227,323,-14,1.4,50.29,5.2,0,0,0,0,0,0,0.114957485918167,88.5331643184219,12.4764659677969
9.7,"random_policy_SVM","SVM",6,14,1284,1246,38,1500,1269,231,0.77665063007055,0.270491803278689,1.21020624008461,578,231,347,28,1.5,53.88,5.5,0,0,0,0,0,0,0.120076598859579,78.3520330394801,13.9930326171834
9.7,"random_policy_SVM","SVM",6,15,1184,1156,28,1600,1359,241,0.7715043015052,0.278688524590164,1.22072977260709,615,241,374,37,1.6,57.47,5.6,0,0,0,0,0,0,0.130944042997942,68.5679538518164,14.8577506811963
9.7,"random_policy_SVM","SVM",6,16,1084,1059,25,1700,1456,244,0.78270627232978,0.262295081967213,1.21020624008461,619,244,375,4,1.5,61.06,6,0,0,0,0,0,0,0.10238678810813,55.0047377774735,12.0792946003979
9.7,"random_policy_SVM","SVM",6,17,984,961,23,1800,1554,246,0.789929189614478,0.229508196721311,1.21020624008461,635,246,389,16,1.6,64.66,6.3,0,0,0,0,0,0,0.0934470665076581,45.5761274508705,11.7669717523944
9.7,"random_policy_SVM","SVM",6,18,884,872,12,1900,1643,257,0.767570391198357,0.19672131147541,1.21020624008461,665,257,408,30,1.6,68.25,6.4,0,0,0,0,0,0,0.0725973452338612,33.7964345974142,9.43585080361073
9.7,"random_policy_SVM","SVM",6,19,784,774,10,2000,1741,259,0.787278636932323,0.245901639344262,1.21020624008461,666,259,407,1,1.6,71.84,6.7,0,0,0,0,0,0,0.0360253303426804,13.7298298626316,4.96073464060294
9.7,"random_policy_SVM","SVM",6,20,684,674,10,2100,1841,259,0.796565244869794,0.237704918032787,1.22072977260709,668,259,409,2,1.6,75.43,7.1,0,0,0,0,0,0,0.0210238107230196,7.65824471302326,2.95129827467457
9.7,"random_policy_SVM","SVM",6,21,584,575,9,2200,1940,260,0.784918290748216,0.245901639344262,1.22072977260709,672,260,412,4,1.6,79.02,7.5,0,0,0,0,0,0,0.0127029986718779,4.14307754943464,1.85200184507712
9.7,"random_policy_SVM","SVM",6,22,484,477,7,2300,2038,262,0.794095265119755,0.270491803278689,1.22072977260709,683,262,421,11,1.6,82.61,7.8,0,0,0,0,0,0,0.00981367122923202,3.00778900861389,1.52737884168916
9.7,"random_policy_SVM","SVM",6,23,384,380,4,2400,2135,265,0.817460112729098,0.286885245901639,1.27334743521946,696,265,431,13,1.6,86.21,8.1,0,0,0,0,0,0,0.0250172080035448,7.57302743409718,4.52961401537414
9.7,"random_policy_SVM","SVM",6,24,284,284,0,2500,2231,269,0.795604338909597,0.270491803278689,1.26282390269699,722,269,453,26,1.7,89.8,8.3,0,0,0,0,0,0,0.00254994082498631,1.30163858661632,1.07214442947401
9.7,"random_policy_SVM","SVM",6,25,184,184,0,2600,2331,269,0.780887644942021,0.19672131147541,1.26282390269699,726,269,457,4,1.7,93.39,8.7,0,0,0,0,0,0,0.000237484050560921,0.143069561664439,0.133346500310782
9.7,"random_policy_SVM","SVM",6,26,84,84,0,2700,2431,269,0.844184906682493,0.336065573770492,1.26282390269699,717,269,448,-9,1.7,96.98,9,0,0,0,0,0,0,1.0000000994736e-07,0.00998894645087024,0.00998894645087024
9.7,"random_policy_SVM","SVM",6,27,0,0,0,2784,2515,269,0.829997033444688,0.270491803278689,1.26282390269699,699,269,430,-18,1.6,100,9.3,0,0,0,0,0,0,0,0,0
9.7,"random_policy_SVM","SVM",7,0,2684,2441,243,100,90,10,0.816525203533693,0.347826086956522,1.21906201519551,23,10,13,0,1.3,3.59,9,0,0,0,0,0,0,0.482200116001966,311.201412339137,50.9779478307274
9.7,"random_policy_SVM","SVM",7,1,2584,2376,208,200,155,45,0.833673999653562,0.384057971014493,1.27456755493221,101,45,56,78,1.2,7.18,3.4,0,0,0,0,0,0,0.335763236530133,453.11252098817,41.6067618853608
9.7,"random_policy_SVM","SVM",7,2,2484,2302,182,300,229,71,0.752098850972926,0.210144927536232,1.20944366526414,172,71,101,71,1.4,10.78,3.2,0,0,0,0,0,0,0.254831859690409,508.26846961356,27.5960851943634
9.7,"random_policy_SVM","SVM",7,3,2384,2210,174,400,321,79,0.823702292280154,0.297101449275362,1.28387096774194,214,79,135,42,1.7,14.37,4.1,0,0,0,0,0,0,0.213528537415647,363.758953290852,22.8983373501549
9.7,"random_policy_SVM","SVM",7,4,2284,2125,159,500,406,94,0.850649575610604,0.347826086956522,1.28387096774194,236,94,142,22,1.5,17.96,4.3,0,0,0,0,0,0,0.212267783439217,238.895978147804,22.2246454619548
9.7,"random_policy_SVM","SVM",7,5,2184,2053,131,600,478,122,0.851024885963394,0.384057971014493,1.28387096774194,313,122,191,77,1.6,21.55,3.9,0,0,0,0,0,0,0.223633542236654,184.756797826905,22.9198402984183
9.7,"random_policy_SVM","SVM",7,6,2084,1979,105,700,552,148,0.847219816386629,0.369565217391304,1.28387096774194,372,148,224,59,1.5,25.14,3.7,0,0,0,0,0,0,0.223389668951294,173.848745661608,23.2285013837078
9.7,"random_policy_SVM","SVM",7,7,1984,1902,82,800,629,171,0.842929730353949,0.376811594202899,1.28387096774194,442,171,271,70,1.6,28.74,3.7,0,0,0,0,0,0,0.208294045704432,178.638205158441,21.9915023114576
9.7,"random_policy_SVM","SVM",7,8,1884,1814,70,900,717,183,0.846526935735321,0.376811594202899,1.28387096774194,463,183,280,21,1.5,32.33,3.9,0,0,0,0,0,0,0.174096471965558,101.387134186521,19.0533736775377
9.7,"random_policy_SVM","SVM",7,9,1784,1724,60,1000,807,193,0.846596223800452,0.36231884057971,1.28387096774194,499,193,306,36,1.6,35.92,4.2,0,0,0,0,0,0,0.160780779289601,83.776059557693,19.3711145572836
9.7,"random_policy_SVM","SVM",7,10,1684,1641,43,1100,890,210,0.84825913736359,0.311594202898551,1.28387096774194,547,210,337,48,1.6,39.51,4.2,0,0,0,0,0,0,0.145755849938663,86.3086271337183,16.6874082757737
9.7,"random_policy_SVM","SVM",7,11,1584,1545,39,1200,986,214,0.844009469368905,0.297101449275362,1.28387096774194,546,214,332,-1,1.6,43.1,4.6,0,0,0,0,0,0,0.115645209722649,59.0706437470853,13.444020740441
9.7,"random_policy_SVM","SVM",7,12,1484,1456,28,1300,1075,225,0.844633061955081,0.297101449275362,1.26526414212249,583,225,358,37,1.6,46.7,4.8,0,0,0,0,0,0,0.157447308135023,141.081891046474,16.5924672037641
9.7,"random_policy_SVM","SVM",7,13,1384,1360,24,1400,1171,229,0.842196431664647,0.318840579710145,1.26526414212249,605,229,376,22,1.6,50.29,5.1,0,0,0,0,0,0,0.135367766513141,86.0678086319452,14.6987155799134
9.7,"random_policy_SVM","SVM",7,14,1284,1262,22,1500,1269,231,0.828396558692765,0.304347826086957,1.24665731650304,620,231,389,15,1.7,53.88,5.5,0,0,0,0,0,0,0.109534427689617,52.1727644032609,12.9027702580925
9.7,"random_policy_SVM","SVM",7,15,1184,1164,20,1600,1367,233,0.835660257520641,0.326086956521739,1.24665731650304,613,233,380,-7,1.6,57.47,5.9,0,0,0,0,0,0,0.112856028581866,68.2990321250344,12.7961719874516
9.7,"random_policy_SVM","SVM",7,16,1084,1065,19,1700,1466,234,0.819752872567701,0.253623188405797,1.24665731650304,650,234,416,37,1.8,61.06,6.3,0,0,0,0,0,0,0.092542862665454,53.3803997783093,13.5638827550453
9.7,"random_policy_SVM","SVM",7,17,984,968,16,1800,1563,237,0.818996477856691,0.268115942028986,1.24665731650304,648,237,411,-2,1.7,64.66,6.6,0,0,0,0,0,0,0.0675769784484698,31.3225723549375,7.90622351714266
9.7,"random_policy_SVM","SVM",7,18,884,869,15,1900,1662,238,0.83202263410128,0.297101449275362,1.24665731650304,642,238,404,-6,1.7,68.25,7,0,0,0,0,0,0,0.0364576349732348,14.8316028846416,5.07153126245897
9.7,"random_policy_SVM","SVM",7,19,784,771,13,2000,1760,240,0.829649517870553,0.282608695652174,1.25596072931276,661,240,421,19,1.8,71.84,7.3,0,0,0,0,0,0,0.0426410165554507,16.2562086500588,5.56264135919549
9.7,"random_policy_SVM","SVM",7,20,684,674,10,2100,1857,243,0.770113747906931,0.159420289855072,1.24665731650304,672,243,429,11,1.8,75.43,7.6,0,0,0,0,0,0,0.0839954704290665,30.6791086245545,18.0577756071263
9.7,"random_policy_SVM","SVM",7,21,584,574,10,2200,1957,243,0.844517581846537,0.355072463768116,1.24665731650304,672,243,429,0,1.8,79.02,8.1,0,0,0,0,0,0,0.0335455427537339,10.7778534889853,5.10908381653393
9.7,"random_policy_SVM","SVM",7,22,484,476,8,2300,2055,245,0.82321150181882,0.268115942028986,1.25596072931276,672,245,427,0,1.7,82.61,8.4,0,0,0,0,0,0,0.0454914436921401,14.6116132408178,5.8981295436086
9.7,"random_policy_SVM","SVM",7,23,384,380,4,2400,2151,249,0.831110341243724,0.260869565217391,1.27456755493221,687,249,438,15,1.8,86.21,8.6,0,0,0,0,0,0,0.0478867952640742,12.5422061958335,6.68086192045902
9.7,"random_policy_SVM","SVM",7,24,284,283,1,2500,2248,252,0.85210462497835,0.347826086956522,1.27456755493221,678,252,426,-9,1.7,89.8,8.9,0,0,0,0,0,0,0.00809322486400943,2.56404366596313,1.93330057150825
9.7,"random_policy_SVM","SVM",7,25,184,184,0,2600,2347,253,0.833119695132516,0.253623188405797,1.27456755493221,703,253,450,25,1.8,93.39,9.3,0,0,0,0,0,0,0.000132530382366085,0.106032578166724,0.10262128605277
9.7,"random_policy_SVM","SVM",7,26,84,84,0,2700,2447,253,0.853028465846762,0.347826086956522,1.27456755493221,703,253,450,0,1.8,96.98,9.7,0,0,0,0,0,0,3.65568975692948e-06,0.0381255226437708,0.0381255226437708
9.7,"random_policy_SVM","SVM",7,27,0,0,0,2784,2531,253,0.842207979675505,0.355072463768116,1.27456755493221,720,253,467,17,1.8,100,10,0,0,0,0,0,0,0,0,0
9.7,"random_policy_SVM","SVM",8,0,2684,2452,232,100,89,11,0.726598285032022,0.297297297297297,1.17109851787271,30,11,19,0,1.7,3.59,8.1,0,0,0,0,0,0,0.269087920593453,241.128425181546,33.9629128268824
9.7,"random_policy_SVM","SVM",8,1,2584,2393,191,200,148,52,0.651964615217621,0.216216216216216,1.14507410636443,114,52,62,84,1.2,7.18,2.8,0,0,0,0,0,0,0.271989098224406,587.734250841371,28.1812990066372
9.7,"random_policy_SVM","SVM",8,2,2484,2310,174,300,231,69,0.548138499945727,0.182432432432432,1.08435047951177,164,69,95,50,1.4,10.78,3.3,0,0,0,0,0,0,0.226622377030795,521.759205083567,23.0517041818362
9.7,"random_policy_SVM","SVM",8,3,2384,2215,169,400,326,74,0.519211983067402,0.121621621621622,1.06700087183958,176,74,102,12,1.4,14.37,4.4,0,0,0,0,0,0,0.18499518303134,365.527858654442,19.5420389570438
9.7,"random_policy_SVM","SVM",8,4,2284,2116,168,500,425,75,0.632106805600779,0.182432432432432,1.14507410636443,179,75,104,3,1.4,17.96,5.7,0,0,0,0,0,0,0.150043764012115,237.49963862551,16.0544042671818
9.7,"random_policy_SVM","SVM",8,5,2184,2024,160,600,517,83,0.694882231629221,0.236486486486486,1.16242371403662,201,83,118,22,1.4,21.55,6.2,0,0,0,0,0,0,0.145278079744378,200.713510081855,15.6329843106941
9.7,"random_policy_SVM","SVM",8,6,2084,1942,142,700,599,101,0.745636600455884,0.25,1.19712292938099,240,101,139,39,1.4,25.14,5.9,0,0,0,0,0,0,0.151160705945663,156.156507153281,15.6801811291869
9.7,"random_policy_SVM","SVM",8,7,1984,1857,127,800,684,116,0.774856181482691,0.297297297297297,1.21447253705318,276,116,160,36,1.4,28.74,5.9,0,0,0,0,0,0,0.153194490648632,163.93548568455,15.8495393447733
9.7,"random_policy_SVM","SVM",8,8,1884,1783,101,900,758,142,0.783116248778904,0.283783783783784,1.22314734088928,344,142,202,68,1.4,32.33,5.3,0,0,0,0,0,0,0.157359454415821,124.062928911155,17.1128067268338
9.7,"random_policy_SVM","SVM",8,9,1784,1704,80,1000,837,163,0.786128296971668,0.277027027027027,1.21447253705318,396,163,233,52,1.4,35.92,5.1,0,0,0,0,0,0,0.157633124658082,138.238148535932,19.5925177577515
9.7,"random_policy_SVM","SVM",8,10,1684,1620,64,1100,921,179,0.799755779876258,0.317567567567568,1.21447253705318,436,179,257,40,1.4,39.51,5.1,0,0,0,0,0,0,0.131548353233507,74.350511125158,14.8554098652701
9.7,"random_policy_SVM","SVM",8,11,1584,1538,46,1200,1003,197,0.792472593075001,0.256756756756757,1.21447253705318,487,197,290,51,1.5,43.1,5.1,0,0,0,0,0,0,0.163040216960166,104.227578447567,17.2836230845198
9.7,"random_policy_SVM","SVM",8,12,1484,1450,34,1300,1091,209,0.78909692825355,0.236486486486486,1.21447253705318,515,209,306,28,1.5,46.7,5.2,0,0,0,0,0,0,0.146650034887665,87.3138130290188,15.8137277240544
9.7,"random_policy_SVM","SVM",8,13,1384,1355,29,1400,1186,214,0.788505372842716,0.22972972972973,1.21447253705318,539,214,325,24,1.5,50.29,5.5,0,0,0,0,0,0,0.112647838355332,58.6356232394274,12.723033043759
9.7,"random_policy_SVM","SVM",8,14,1284,1260,24,1500,1281,219,0.784885487897538,0.243243243243243,1.21447253705318,570,219,351,31,1.6,53.88,5.8,0,0,0,0,0,0,0.143225821892742,97.7338930809093,14.991757026547
9.7,"random_policy_SVM","SVM",8,15,1184,1161,23,1600,1380,220,0.797704330836861,0.27027027027027,1.22314734088928,586,220,366,16,1.7,57.47,6.3,0,0,0,0,0,0,0.117235310047156,52.7589532610301,12.7262184866173
9.7,"random_policy_SVM","SVM",8,16,1084,1063,21,1700,1478,222,0.750287637034628,0.175675675675676,1.22314734088928,587,222,365,1,1.6,61.06,6.7,0,0,0,0,0,0,0.112722017315071,46.3590964220344,12.3681565608324
9.7,"random_policy_SVM","SVM",8,17,984,965,19,1800,1576,224,0.752822099207642,0.22972972972973,1.22314734088928,598,224,374,11,1.7,64.66,7,0,0,0,0,0,0,0.096706889523744,39.3528586909914,10.9874539559275
9.7,"random_policy_SVM","SVM",8,18,884,865,19,1900,1676,224,0.781770324541412,0.222972972972973,1.22314734088928,609,224,385,11,1.7,68.25,7.5,0,0,0,0,0,0,0.0517570720196076,15.6050475891181,6.65166410630135
9.7,"random_policy_SVM","SVM",8,19,784,765,19,2000,1776,224,0.753907521979813,0.182432432432432,1.22314734088928,603,224,379,-6,1.7,71.84,7.9,0,0,0,0,0,0,0.0443959015724026,13.6297049081862,5.5281037191254
9.7,"random_policy_SVM","SVM",8,20,684,667,17,2100,1874,226,0.763736025181811,0.222972972972973,1.22314734088928,611,226,385,8,1.7,75.43,8.3,0,0,0,0,0,0,0.021167836334044,5.92208360029741,3.09069132409377
9.7,"random_policy_SVM","SVM",8,21,584,567,17,2200,1974,226,0.77984369912081,0.256756756756757,1.22314734088928,614,226,388,3,1.7,79.02,8.7,0,0,0,0,0,0,0.0068502681475429,1.6701853941628,1.15193422076741
9.7,"random_policy_SVM","SVM",8,22,484,468,16,2300,2073,227,0.72955606208618,0.175675675675676,1.22314734088928,614,227,387,0,1.7,82.61,9.1,0,0,0,0,0,0,0.00758582082172559,2.06670688455611,1.38450816720887
9.7,"random_policy_SVM","SVM",8,23,384,369,15,2400,2172,228,0.748632367307066,0.209459459459459,1.21447253705318,604,228,376,-10,1.6,86.21,9.5,0,0,0,0,0,0,0.00516354039492735,1.3343887781962,1.16987843029718
9.7,"random_policy_SVM","SVM",8,24,284,271,13,2500,2270,230,0.755421686746989,0.216216216216216,1.22314734088928,630,230,400,26,1.7,89.8,9.9,0,0,0,0,0,0,0.00636827286502849,2.10499414135001,1.8164256203757
9.7,"random_policy_SVM","SVM",8,25,184,171,13,2600,2370,230,0.77134483881472,0.236486486486486,1.21447253705318,611,230,381,-19,1.7,93.39,10.3,0,0,0,0,0,0,1.45510366042464e-06,0.19355066390135,0.193522479195248
9.7,"random_policy_SVM","SVM",8,26,84,76,8,2700,2465,235,0.729756865299034,0.175675675675676,1.21447253705318,657,235,422,46,1.8,96.98,10.5,0,0,0,0,0,0,1.67877084937366e-07,0.88413052593185,0.88413052593185
9.7,"random_policy_SVM","SVM",8,27,0,0,0,2784,2541,243,0.774465429284698,0.243243243243243,1.26652136006975,685,243,442,28,1.8,100,10.5,0,0,0,0,0,0,0,0,0
9.7,"random_policy_SVM","SVM",9,0,2684,2439,245,100,95,5,0.380956427163347,0.0354609929078014,0.965179592770533,25,5,20,0,4,3.59,19,0,0,0,0,0,0,0.102036450108841,94.3547580401493,14.0076778099553
9.7,"random_policy_SVM","SVM",9,1,2584,2343,241,200,191,9,0.323578727936012,0.0141843971631206,0.855913978494624,38,9,29,13,3.2,7.18,21.2,0,0,0,0,0,0,0.0505852088538494,120.515122377104,5.12750985949138
9.7,"random_policy_SVM","SVM",9,2,2484,2243,241,300,291,9,0.691630979085947,0.120567375886525,1.22923816060398,37,9,28,-1,3.1,10.78,32.3,0,0,0,0,0,0,0.0459577802498089,92.0792630445013,5.06782181781248
9.7,"random_policy_SVM","SVM",9,3,2384,2154,230,400,380,20,0.682958330500988,0.24113475177305,1.21102722489133,64,20,44,27,2.2,14.37,19,0,0,0,0,0,0,0.0616141927755826,125.640384047242,6.59717514833529
9.7,"random_policy_SVM","SVM",9,4,2284,2077,207,500,457,43,0.740273718079446,0.290780141843972,1.24744909631663,111,43,68,47,1.6,17.96,10.6,0,0,0,0,0,0,0.124676432085727,183.448270161525,16.5041168362754
9.7,"random_policy_SVM","SVM",9,5,2184,2001,183,600,533,67,0.765515600571005,0.290780141843972,1.25655456417296,162,67,95,51,1.4,21.55,8,0,0,0,0,0,0,0.13896180750737,198.696323971485,14.7460691645113
9.7,"random_policy_SVM","SVM",9,6,2084,1924,160,700,610,90,0.745779801962254,0.25531914893617,1.25655456417296,226,90,136,64,1.5,25.14,6.8,0,0,0,0,0,0,0.145719113185394,213.565713839118,14.9810906676384
9.7,"random_policy_SVM","SVM",9,7,1984,1829,155,800,705,95,0.762751229238895,0.26241134751773,1.25655456417296,235,95,140,9,1.5,28.74,7.4,0,0,0,0,0,0,0.133012118153652,157.589803434768,14.0138740105674
9.7,"random_policy_SVM","SVM",9,8,1884,1753,131,900,781,119,0.789114721410288,0.269503546099291,1.25655456417296,294,119,175,59,1.5,32.33,6.6,0,0,0,0,0,0,0.145171405227689,173.012307238764,15.0750926029668
9.7,"random_policy_SVM","SVM",9,9,1784,1676,108,1000,858,142,0.793941041850775,0.269503546099291,1.25655456417296,344,142,202,50,1.4,35.92,6,0,0,0,0,0,0,0.149373321278155,197.398931452308,15.1488960562177
9.7,"random_policy_SVM","SVM",9,10,1684,1590,94,1100,944,156,0.802936578070837,0.276595744680851,1.25655456417296,378,156,222,34,1.4,39.51,6.1,0,0,0,0,0,0,0.155740518206164,100.656392322716,16.6332049528931
9.7,"random_policy_SVM","SVM",9,11,1584,1514,70,1200,1020,180,0.804075181836725,0.26241134751773,1.25655456417296,443,180,263,65,1.5,43.1,5.7,0,0,0,0,0,0,0.151222703162299,102.092794206813,16.4832752586437
9.7,"random_policy_SVM","SVM",9,12,1484,1434,50,1300,1100,200,0.811478938662683,0.283687943262411,1.25655456417296,487,200,287,44,1.4,46.7,5.5,0,0,0,0,0,0,0.14566915899821,97.3186769496382,15.5968910353586
9.7,"random_policy_SVM","SVM",9,13,1384,1349,35,1400,1185,215,0.816973693154786,0.297872340425532,1.25655456417296,517,215,302,30,1.4,50.29,5.5,0,0,0,0,0,0,0.156394923356262,110.674682770681,16.359561610595
9.7,"random_policy_SVM","SVM",9,14,1284,1254,30,1500,1280,220,0.802466408356562,0.276595744680851,1.25655456417296,549,220,329,32,1.5,53.88,5.8,0,0,0,0,0,0,0.132971578584607,64.0876779942276,14.379153781103
9.7,"random_policy_SVM","SVM",9,15,1184,1161,23,1600,1373,227,0.787001790043736,0.26241134751773,1.25655456417296,583,227,356,34,1.6,57.47,6,0,0,0,0,0,0,0.136269191080982,52.9311058292019,15.0221904248608
9.7,"random_policy_SVM","SVM",9,16,1084,1067,17,1700,1467,233,0.809847506401108,0.326241134751773,1.24744909631663,603,233,370,20,1.6,61.06,6.3,0,0,0,0,0,0,0.129352257341591,58.1248478777166,14.1060750102614
9.7,"random_policy_SVM","SVM",9,17,984,970,14,1800,1564,236,0.805321414814316,0.290780141843972,1.25655456417296,616,236,380,13,1.6,64.66,6.6,0,0,0,0,0,0,0.0818533131716891,29.696488986373,10.3921111710311
9.7,"random_policy_SVM","SVM",9,18,884,871,13,1900,1663,237,0.810442299413143,0.269503546099291,1.25655456417296,646,237,409,30,1.7,68.25,7,0,0,0,0,0,0,0.0797338531968927,43.4942258244954,10.5443611564063
9.7,"random_policy_SVM","SVM",9,19,784,774,10,2000,1760,240,0.817738427027399,0.326241134751773,1.25655456417296,640,240,400,-6,1.7,71.84,7.3,0,0,0,0,0,0,0.0385481667920743,11.6046385804939,7.20355564152612
9.7,"random_policy_SVM","SVM",9,20,684,676,8,2100,1858,242,0.807270070015636,0.26241134751773,1.25655456417296,648,242,406,8,1.7,75.43,7.7,0,0,0,0,0,0,0.0353257092195191,10.9820489510159,5.20313739604613
9.7,"random_policy_SVM","SVM",9,21,584,581,3,2200,1953,247,0.817251263227066,0.312056737588652,1.26566003202928,660,247,413,12,1.7,79.02,7.9,0,0,0,0,0,0,0.0293023006348009,9.16804811981167,5.43214374090925
9.7,"random_policy_SVM","SVM",9,22,484,484,0,2300,2050,250,0.78339904379943,0.212765957446809,1.26566003202928,675,250,425,15,1.7,82.61,8.2,0,0,0,0,0,0,0.00318602591323969,1.32541351726466,1.01228187808799
9.7,"random_policy_SVM","SVM",9,23,384,384,0,2400,2150,250,0.817302245485242,0.290780141843972,1.26566003202928,668,250,418,-7,1.7,86.21,8.6,0,0,0,0,0,0,0.00398833654710688,1.11243487052902,0.723039689591035
9.7,"random_policy_SVM","SVM",9,24,284,284,0,2500,2250,250,0.779093875331389,0.24113475177305,1.26566003202928,657,250,407,-11,1.6,89.8,9,0,0,0,0,0,0,0.00048500722109927,0.140150213163809,0.114198915258702
9.7,"random_policy_SVM","SVM",9,25,184,184,0,2600,2350,250,0.800058912831673,0.24822695035461,1.25655456417296,664,250,414,7,1.7,93.39,9.4,0,0,0,0,0,0,0.000128022779569288,0.0608199045652704,0.0552122360201677
9.7,"random_policy_SVM","SVM",9,26,84,84,0,2700,2450,250,0.757001563455922,0.234042553191489,1.26566003202928,657,250,407,-7,1.6,96.98,9.8,0,0,0,0,0,0,1.0000000994736e-07,0.000292436483001501,0.000292436483001501
9.7,"random_policy_SVM","SVM",9,27,0,0,0,2784,2534,250,0.800795323227521,0.26241134751773,1.25655456417296,668,250,418,11,1.7,100,10.1,0,0,0,0,0,0,0,0,0
9.7,"random_policy_SVM","SVM",10,0,2684,2445,239,100,89,11,0.729595767339634,0.163120567375887,1.25655456417296,28,11,17,0,1.5,3.59,8.1,0,0,0,0,0,0,0.127218838944274,294.964904199328,13.0446125902909
9.7,"random_policy_SVM","SVM",10,1,2584,2363,221,200,171,29,0.678687150205063,0.198581560283688,1.24744909631663,74,29,45,46,1.6,7.18,5.9,0,0,0,0,0,0,0.203857354542324,331.633101807011,26.5980425485568
9.7,"random_policy_SVM","SVM",10,2,2484,2279,205,300,255,45,0.728678086692499,0.184397163120567,1.26566003202928,121,45,76,47,1.7,10.78,5.7,0,0,0,0,0,0,0.157470408452134,336.167317137491,16.1886625739015
9.7,"random_policy_SVM","SVM",10,3,2384,2208,176,400,326,74,0.733640359821454,0.113475177304965,1.25539751577133,193,74,119,72,1.6,14.37,4.4,0,0,0,0,0,0,0.283938711747752,321.607986885312,45.286985829043
9.7,"random_policy_SVM","SVM",10,4,2284,2111,173,500,423,77,0.780668660639431,0.26241134751773,1.23834362846031,194,77,117,1,1.5,17.96,5.5,0,0,0,0,0,0,0.180970741121432,270.712569729195,18.6212797909829
9.7,"random_policy_SVM","SVM",10,5,2184,2031,153,600,503,97,0.784345047923322,0.276595744680851,1.22923816060398,258,97,161,64,1.7,21.55,5.2,0,0,0,0,0,0,0.172137099434082,179.549355124957,17.976482676974
9.7,"random_policy_SVM","SVM",10,6,2084,1958,126,700,576,124,0.816050347812295,0.326241134751773,1.22923816060398,318,124,194,60,1.6,25.14,4.6,0,0,0,0,0,0,0.195418281349845,196.950644031495,20.3451187864276
9.7,"random_policy_SVM","SVM",10,7,1984,1891,93,800,643,157,0.816792422903498,0.368794326241135,1.22013269274766,380,157,223,62,1.4,28.74,4.1,0,0,0,0,0,0,0.20432612877598,217.202520846221,20.9498064392647
9.7,"random_policy_SVM","SVM",10,8,1884,1814,70,900,720,180,0.823278499082321,0.340425531914894,1.22013269274766,449,180,269,69,1.5,32.33,4,0,0,0,0,0,0,0.203505854947415,161.564957039023,21.1653309747768
9.7,"random_policy_SVM","SVM",10,9,1784,1740,44,1000,794,206,0.804941880225683,0.326241134751773,1.21102722489133,520,206,314,71,1.5,35.92,3.9,0,0,0,0,0,0,0.214440723013498,189.500864548196,23.1369461934183
9.7,"random_policy_SVM","SVM",10,10,1684,1652,32,1100,882,218,0.806426030408085,0.319148936170213,1.22923816060398,572,218,354,52,1.6,39.51,4,0,0,0,0,0,0,0.200688708622803,145.681862759883,20.7568204464817
9.7,"random_policy_SVM","SVM",10,11,1584,1558,26,1200,976,224,0.818151949788142,0.354609929078014,1.22923816060398,581,224,357,9,1.6,43.1,4.4,0,0,0,0,0,0,0.178586740338931,123.299275665727,18.6548584349725
9.7,"random_policy_SVM","SVM",10,12,1484,1463,21,1300,1071,229,0.799673713547686,0.297872340425532,1.22923816060398,593,229,364,12,1.6,46.7,4.7,0,0,0,0,0,0,0.161075733403144,104.440971245181,16.8823126099355
9.7,"random_policy_SVM","SVM",10,13,1384,1364,20,1400,1170,230,0.798115922325699,0.304964539007092,1.22013269274766,603,230,373,10,1.6,50.29,5.1,0,0,0,0,0,0,0.146766816853359,92.075432098777,15.3774656056373
9.7,"random_policy_SVM","SVM",10,14,1284,1264,20,1500,1270,230,0.803474724129338,0.340425531914894,1.22013269274766,608,230,378,5,1.6,53.88,5.5,0,0,0,0,0,0,0.124623127468504,72.6128360650569,13.3325402971836
9.7,"random_policy_SVM","SVM",10,15,1184,1166,18,1600,1368,232,0.788978768721819,0.24822695035461,1.21102722489133,624,232,392,16,1.7,57.47,5.9,0,0,0,0,0,0,0.0954424446420966,40.484613559302,11.5530036642347
9.7,"random_policy_SVM","SVM",10,16,1084,1068,16,1700,1466,234,0.807502322525098,0.368794326241135,1.21102722489133,622,234,388,-2,1.7,61.06,6.3,0,0,0,0,0,0,0.0822823112472182,30.5739862947554,10.7980187960941
9.7,"random_policy_SVM","SVM",10,17,984,968,16,1800,1566,234,0.806709265175721,0.354609929078014,1.21102722489133,628,234,394,6,1.7,64.66,6.7,0,0,0,0,0,0,0.0361550002250419,10.6498422155921,5.26828042508986
9.7,"random_policy_SVM","SVM",10,18,884,869,15,1900,1665,235,0.814084698524915,0.347517730496454,1.22013269274766,627,235,392,-1,1.7,68.25,7.1,0,0,0,0,0,0,0.0270934580558002,8.81969395307672,3.72756937344056
9.7,"random_policy_SVM","SVM",10,19,784,770,14,2000,1764,236,0.792740126436002,0.269503546099291,1.22013269274766,620,236,384,-7,1.6,71.84,7.5,0,0,0,0,0,0,0.0210089393014032,7.25098737729505,4.18201071187995
9.7,"random_policy_SVM","SVM",10,20,684,673,11,2100,1861,239,0.80132780459067,0.297872340425532,1.23834362846031,639,239,400,19,1.7,75.43,7.8,0,0,0,0,0,0,0.014052487061072,5.14759151909134,3.37751017272713
9.7,"random_policy_SVM","SVM",10,21,584,574,10,2200,1960,240,0.802098203158634,0.290780141843972,1.23834362846031,633,240,393,-6,1.6,79.02,8.2,0,0,0,0,0,0,0.00402486155986401,1.37586242498066,0.966719568825199
9.7,"random_policy_SVM","SVM",10,22,484,477,7,2300,2057,243,0.820400833843155,0.354609929078014,1.24744909631663,643,243,400,10,1.6,82.61,8.5,0,0,0,0,0,0,0.00209756617781122,0.810387741626192,0.597245702316369
9.7,"random_policy_SVM","SVM",10,23,384,380,4,2400,2154,246,0.819630435275189,0.312056737588652,1.26566003202928,671,246,425,28,1.7,86.21,8.8,0,0,0,0,0,0,0.000531417079645982,1.26799106800802,1.23827145596041
9.7,"random_policy_SVM","SVM",10,24,284,284,0,2500,2250,250,0.812283325402765,0.304964539007092,1.26566003202928,686,250,436,15,1.7,89.8,9,0,0,0,0,0,0,0.00265710730952207,0.891623864044508,0.744877506117241
9.7,"random_policy_SVM","SVM",10,25,184,184,0,2600,2350,250,0.819992975777765,0.326241134751773,1.26566003202928,671,250,421,-15,1.7,93.39,9.4,0,0,0,0,0,0,2.26604920290306e-06,0.00594872839172211,0.00589546663693723
9.7,"random_policy_SVM","SVM",10,26,84,84,0,2700,2450,250,0.78331973806449,0.234042553191489,1.26566003202928,672,250,422,1,1.7,96.98,9.8,0,0,0,0,0,0,6.39684197356006e-07,0.00676681064990949,0.00676681064990949
9.7,"random_policy_SVM","SVM",10,27,0,0,0,2784,2534,250,0.836182675095737,0.404255319148936,1.26566003202928,675,250,425,3,1.7,100,10.1,0,0,0,0,0,0,0,0,0
9.7,"random_policy_SVM","SVM",11,0,2684,2444,240,100,88,12,0.753995846385101,0.402877697841727,1.13608725922488,33,12,21,0,1.8,3.59,7.3,0,0,0,0,0,0,0.176985676770523,327.884472399507,18.997685921107
9.7,"random_policy_SVM","SVM",11,1,2584,2378,206,200,154,46,0.641022110541237,0.122302158273381,1.09914133209561,109,46,63,76,1.4,7.18,3.3,0,0,0,0,0,0,0.256034117215693,560.352132638186,27.4565040213574
9.7,"random_policy_SVM","SVM",11,2,2484,2291,193,300,241,59,0.731156701433119,0.215827338129496,1.14532374100719,151,59,92,42,1.6,10.78,4.1,0,0,0,0,0,0,0.200961766646034,471.751054950363,20.4844193255649
9.7,"random_policy_SVM","SVM",11,3,2384,2198,186,400,334,66,0.765756772572378,0.273381294964029,1.20997911348341,166,66,100,15,1.5,14.37,5.1,0,0,0,0,0,0,0.18309403755966,305.693402608545,19.8819961322946
9.7,"random_policy_SVM","SVM",11,4,2284,2116,168,500,416,84,0.794109210239465,0.323741007194245,1.20997911348341,215,84,131,49,1.6,17.96,5,0,0,0,0,0,0,0.18362070875381,283.008568813152,19.1102351004207
9.7,"random_policy_SVM","SVM",11,5,2184,2034,150,600,498,102,0.803672851192736,0.323741007194245,1.20997911348341,255,102,153,40,1.5,21.55,4.9,0,0,0,0,0,0,0.182220690444504,245.438868822731,18.6628759771716
9.7,"random_policy_SVM","SVM",11,6,2084,1964,120,700,568,132,0.806552843849326,0.366906474820144,1.20997911348341,316,132,184,61,1.4,25.14,4.3,0,0,0,0,0,0,0.192119218168695,210.458729549391,19.9302061435223
9.7,"random_policy_SVM","SVM",11,7,1984,1895,89,800,637,163,0.805015317889235,0.37410071942446,1.19150614991877,392,163,229,76,1.4,28.74,3.9,0,0,0,0,0,0,0.20557176836332,206.71679814689,21.3333159498156
9.7,"random_policy_SVM","SVM",11,8,1884,1819,65,900,713,187,0.803546636375115,0.316546762589928,1.19150614991877,449,187,262,57,1.4,32.33,3.8,0,0,0,0,0,0,0.201291587415141,210.27245777921,20.9646569248185
9.7,"random_policy_SVM","SVM",11,9,1784,1736,48,1000,796,204,0.796616295480371,0.352517985611511,1.20074263170109,512,204,308,63,1.5,35.92,3.9,0,0,0,0,0,0,0.194607434574067,175.205940753241,20.8116074958793
9.7,"random_policy_SVM","SVM",11,10,1684,1643,41,1100,889,211,0.791315273140348,0.280575539568345,1.19150614991877,524,211,313,12,1.5,39.51,4.2,0,0,0,0,0,0,0.16836278880965,138.150887871505,18.4758281602324
9.7,"random_policy_SVM","SVM",11,11,1584,1547,37,1200,985,215,0.7979702362512,0.287769784172662,1.19150614991877,536,215,321,12,1.5,43.1,4.6,0,0,0,0,0,0,0.139734691088905,118.679215977336,15.3252351305393
9.7,"random_policy_SVM","SVM",11,12,1484,1450,34,1300,1082,218,0.799295491836209,0.287769784172662,1.18226966813646,546,218,328,10,1.5,46.7,5,0,0,0,0,0,0,0.128658520529355,103.880994286405,14.5937894471343
9.7,"random_policy_SVM","SVM",11,13,1384,1364,20,1400,1168,232,0.794378850986207,0.287769784172662,1.19150614991877,580,232,348,34,1.5,50.29,5,0,0,0,0,0,0,0.156706351300538,93.6572618639064,17.0383048286206
9.7,"random_policy_SVM","SVM",11,14,1284,1268,16,1500,1264,236,0.79693183252442,0.316546762589928,1.19150614991877,605,236,369,25,1.6,53.88,5.4,0,0,0,0,0,0,0.140005436326454,66.7791848431973,15.1576256302798
9.7,"random_policy_SVM","SVM",11,15,1184,1169,15,1600,1363,237,0.793151125032998,0.273381294964029,1.19150614991877,614,237,377,9,1.6,57.47,5.8,0,0,0,0,0,0,0.10878819660285,45.4136688325849,12.3813753420901
9.7,"random_policy_SVM","SVM",11,16,1084,1070,14,1700,1462,238,0.786903491560826,0.280575539568345,1.19150614991877,625,238,387,11,1.6,61.06,6.1,0,0,0,0,0,0,0.111810747478517,60.4844591321553,12.3705589787548
9.7,"random_policy_SVM","SVM",11,17,984,971,13,1800,1561,239,0.801263295583642,0.359712230215827,1.19150614991877,640,239,401,15,1.7,64.66,6.5,0,0,0,0,0,0,0.0510753420635755,15.0385023559511,6.63143848796702
9.7,"random_policy_SVM","SVM",11,18,884,871,13,1900,1661,239,0.770667676385219,0.244604316546763,1.19150614991877,624,239,385,-16,1.6,68.25,6.9,0,0,0,0,0,0,0.0497712423384953,17.5252727312328,6.09592437153228
9.7,"random_policy_SVM","SVM",11,19,784,773,11,2000,1759,241,0.802754925246423,0.338129496402878,1.19150614991877,637,241,396,13,1.6,71.84,7.3,0,0,0,0,0,0,0.0491541548992437,17.5209928561036,6.31626751018897
9.7,"random_policy_SVM","SVM",11,20,684,673,11,2100,1859,241,0.784786524847121,0.251798561151079,1.19150614991877,625,241,384,-12,1.6,75.43,7.7,0,0,0,0,0,0,0.0279902938509221,9.22648977537525,3.62920455243677
9.7,"random_policy_SVM","SVM",11,21,584,574,10,2200,1958,242,0.802330384496248,0.287769784172662,1.19150614991877,641,242,399,16,1.6,79.02,8.1,0,0,0,0,0,0,0.0116764644820958,3.42411201855677,1.71149751941227
9.7,"random_policy_SVM","SVM",11,22,484,475,9,2300,2057,243,0.781137769210466,0.244604316546763,1.18226966813646,649,243,406,8,1.7,82.61,8.5,0,0,0,0,0,0,0.0493327523508218,13.3859598808168,8.35087282401595
9.7,"random_policy_SVM","SVM",11,23,384,375,9,2400,2157,243,0.806151251247805,0.316546762589928,1.19150614991877,657,243,414,8,1.7,86.21,8.9,0,0,0,0,0,0,0.0101307204227177,3.0600346315845,2.20374764597354
9.7,"random_policy_SVM","SVM",11,24,284,275,9,2500,2257,243,0.793937099124534,0.323741007194245,1.19150614991877,634,243,391,-23,1.6,89.8,9.3,0,0,0,0,0,0,0.0114333928780505,2.82523273856099,1.8434445051066
9.7,"random_policy_SVM","SVM",11,25,184,177,7,2600,2355,245,0.732344268126179,0.158273381294964,1.18226966813646,645,245,400,11,1.6,93.39,9.6,0,0,0,0,0,0,0.00280664598119847,0.791398204263799,0.695451729009861
9.7,"random_policy_SVM","SVM",11,26,84,79,5,2700,2453,247,0.770007917111296,0.20863309352518,1.19150614991877,663,247,416,18,1.7,96.98,9.9,0,0,0,0,0,0,0.0015304915896052,1.03601053846125,1.03601053846125
9.7,"random_policy_SVM","SVM",11,27,0,0,0,2784,2532,252,0.810092595779839,0.287769784172662,1.23768855883036,701,252,449,38,1.8,100,10,0,0,0,0,0,0,0,0,0
9.7,"random_policy_SVM","SVM",12,0,2684,2440,244,100,85,15,0.774727849470121,0.356060606060606,1.19633431085044,40,15,25,0,1.7,3.59,5.7,0,0,0,0,0,0,0.249820912546197,383.905119266374,28.1817993338521
9.7,"random_policy_SVM","SVM",12,1,2584,2366,218,200,159,41,0.727446951673752,0.181818181818182,1.16715542521994,102,41,61,62,1.5,7.18,3.9,0,0,0,0,0,0,0.251944049075614,433.869486425093,38.9196655577233
9.7,"random_policy_SVM","SVM",12,2,2484,2274,210,300,251,49,0.729603729603734,0.227272727272727,1.17688172043011,135,49,86,33,1.8,10.78,5.1,0,0,0,0,0,0,0.187395537831966,341.990564680308,20.3805285295619
9.7,"random_policy_SVM","SVM",12,3,2384,2193,191,400,332,68,0.759690481339965,0.303030303030303,1.19633431085044,186,68,118,51,1.7,14.37,4.9,0,0,0,0,0,0,0.19240539021046,298.336328395288,20.5069387692447
9.7,"random_policy_SVM","SVM",12,4,2284,2120,164,500,405,95,0.76297671400764,0.265151515151515,1.21578690127077,241,95,146,55,1.5,17.96,4.3,0,0,0,0,0,0,0.209429782715137,291.33161074572,21.7582799519064
9.7,"random_policy_SVM","SVM",12,5,2184,2051,133,600,474,126,0.755340879052217,0.287878787878788,1.19633431085044,305,126,179,64,1.4,21.55,3.8,0,0,0,0,0,0,0.224033171255828,207.477225620806,22.8413007058021
9.7,"random_policy_SVM","SVM",12,6,2084,1984,100,700,541,159,0.759546295628769,0.340909090909091,1.18660801564027,390,159,231,85,1.5,25.14,3.4,0,0,0,0,0,0,0.23623213982181,197.058009103326,24.1882130943065
9.7,"random_policy_SVM","SVM",12,7,1984,1908,76,800,617,183,0.759516256938935,0.295454545454545,1.17688172043011,452,183,269,62,1.5,28.74,3.4,0,0,0,0,0,0,0.225972015681512,185.928510321304,23.5747406150745
9.7,"random_policy_SVM","SVM",12,8,1884,1823,61,900,702,198,0.756193977843464,0.310606060606061,1.17688172043011,497,198,299,45,1.5,32.33,3.5,0,0,0,0,0,0,0.205960247003576,128.278545907629,21.9609986771179
9.7,"random_policy_SVM","SVM",12,9,1784,1730,54,1000,795,205,0.756163939153631,0.303030303030303,1.17688172043011,509,205,304,12,1.5,35.92,3.9,0,0,0,0,0,0,0.165992325479515,107.594935042494,18.2656662214102
9.7,"random_policy_SVM","SVM",12,10,1684,1633,51,1100,892,208,0.754698051089805,0.325757575757576,1.20606060606061,517,208,309,8,1.5,39.51,4.3,0,0,0,0,0,0,0.126417520587477,76.3806774141759,14.4498419553258
9.7,"random_policy_SVM","SVM",12,11,1584,1539,45,1200,986,214,0.774391416143992,0.287878787878788,1.21578690127077,535,214,321,18,1.5,43.1,4.6,0,0,0,0,0,0,0.153745163544654,128.512713719902,17.1629670208531
9.7,"random_policy_SVM","SVM",12,12,1484,1446,38,1300,1079,221,0.77941388508399,0.303030303030303,1.22551319648094,533,221,312,-2,1.4,46.7,4.9,0,0,0,0,0,0,0.0808655896744627,38.5714232433806,9.8859387621693
9.7,"random_policy_SVM","SVM",12,13,1384,1347,37,1400,1178,222,0.778729002955808,0.310606060606061,1.22551319648094,557,222,335,24,1.5,50.29,5.3,0,0,0,0,0,0,0.097710580571046,44.2747747625759,10.9844693886341
9.7,"random_policy_SVM","SVM",12,14,1284,1254,30,1500,1271,229,0.795352413909119,0.295454545454545,1.21578690127077,575,229,346,18,1.5,53.88,5.6,0,0,0,0,0,0,0.135426994754933,47.0919709988251,15.8626682752609
9.7,"random_policy_SVM","SVM",12,15,1184,1164,20,1600,1361,239,0.800440967966747,0.295454545454545,1.21578690127077,616,239,377,41,1.6,57.47,5.7,0,0,0,0,0,0,0.128173155372551,36.3106127041898,14.7174118454282
9.7,"random_policy_SVM","SVM",12,16,1084,1067,17,1700,1458,242,0.809464590392429,0.287878787878788,1.21578690127077,641,242,399,25,1.6,61.06,6,0,0,0,0,0,0,0.111541979683063,30.6192637705186,12.7121446928226
9.7,"random_policy_SVM","SVM",12,17,984,968,16,1800,1557,243,0.773550332828684,0.21969696969697,1.21578690127077,638,243,395,-3,1.6,64.66,6.4,0,0,0,0,0,0,0.0559623307695472,12.746735178255,7.54738817410355
9.7,"random_policy_SVM","SVM",12,18,884,868,16,1900,1657,243,0.793126546992532,0.204545454545455,1.21578690127077,626,243,383,-12,1.6,68.25,6.8,0,0,0,0,0,0,0.00726986579622315,1.99915927573549,1.74819982350194
9.7,"random_policy_SVM","SVM",12,19,784,769,15,2000,1756,244,0.798061903732013,0.295454545454545,1.21578690127077,632,244,388,6,1.6,71.84,7.2,0,0,0,0,0,0,0.00708476833304063,2.84729423271543,1.83284800892127
9.7,"random_policy_SVM","SVM",12,20,684,672,12,2100,1853,247,0.773616417946316,0.21969696969697,1.21578690127077,647,247,400,15,1.6,75.43,7.5,0,0,0,0,0,0,0.00282889917206435,1.15680400798494,0.823787689524821
9.7,"random_policy_SVM","SVM",12,21,584,573,11,2200,1952,248,0.793195635979142,0.212121212121212,1.21578690127077,640,248,392,-7,1.6,79.02,7.9,0,0,0,0,0,0,0.00103279020994665,0.346297673794152,0.25104850582395
9.7,"random_policy_SVM","SVM",12,22,484,474,10,2300,2051,249,0.779467954725689,0.234848484848485,1.20606060606061,664,249,415,24,1.7,82.61,8.2,0,0,0,0,0,0,0.00913570076570542,3.4426446910222,2.75686109309101
9.7,"random_policy_SVM","SVM",12,23,384,375,9,2400,2150,250,0.782279576094012,0.21969696969697,1.20606060606061,661,250,411,-3,1.6,86.21,8.6,0,0,0,0,0,0,0.000272118434527318,0.462628606923341,0.450099220027196
9.7,"random_policy_SVM","SVM",12,24,284,278,6,2500,2247,253,0.773267969144257,0.227272727272727,1.19633431085044,657,253,404,-4,1.6,89.8,8.9,0,0,0,0,0,0,0.00452669845168791,1.54569356183427,1.25599285329016
9.7,"random_policy_SVM","SVM",12,25,184,178,6,2600,2347,253,0.790480138418283,0.287878787878788,1.19633431085044,658,253,405,1,1.6,93.39,9.3,0,0,0,0,0,0,0.000370355699915457,0.119476166724114,0.108459908866348
9.7,"random_policy_SVM","SVM",12,26,84,81,3,2700,2444,256,0.750012015475933,0.151515151515152,1.20495005301635,683,256,427,25,1.7,96.98,9.5,0,0,0,0,0,0,4.31890656221942e-06,0.059454774394563,0.059454774394563
9.7,"random_policy_SVM","SVM",12,27,0,0,0,2784,2525,259,0.764785043135552,0.189393939393939,1.2352394916911,695,259,436,12,1.7,100,9.7,0,0,0,0,0,0,0,0,0
9.7,"random_policy_SVM","SVM",13,0,2684,2445,239,100,91,9,0.8194965034965,0.370629370629371,1.24795849311978,22,9,13,0,1.4,3.59,10.1,0,0,0,0,0,0,0.104841394030106,227.475756392162,10.797660394731
9.7,"random_policy_SVM","SVM",13,1,2584,2376,208,200,160,40,0.741018181818177,0.153846153846154,1.22102413715317,105,40,65,83,1.6,7.18,4,0,0,0,0,0,0,0.25127873814481,493.733489789315,31.1328349667695
9.7,"random_policy_SVM","SVM",13,2,2484,2283,201,300,253,47,0.810360839160838,0.300699300699301,1.25693661177532,115,47,68,10,1.4,10.78,5.4,0,0,0,0,0,0,0.194199530383756,243.999814517723,21.6532091745936
9.7,"random_policy_SVM","SVM",13,3,2384,2209,175,400,327,73,0.766875524475514,0.27972027972028,1.24795849311978,173,73,100,58,1.4,14.37,4.5,0,0,0,0,0,0,0.200194382765948,211.51304785078,20.6780392978193
9.7,"random_policy_SVM","SVM",13,4,2284,2140,144,500,396,104,0.802724475524474,0.300699300699301,1.25693661177532,246,104,142,73,1.4,17.96,3.8,0,0,0,0,0,0,0.23105724165812,186.262242730542,23.5074111523116
9.7,"random_policy_SVM","SVM",13,5,2184,2067,117,600,469,131,0.806825174825172,0.300699300699301,1.24795849311978,310,131,179,64,1.4,21.55,3.6,0,0,0,0,0,0,0.221499271709939,120.881116934949,23.5758786114922
9.7,"random_policy_SVM","SVM",13,6,2084,1988,96,700,548,152,0.812788811188809,0.293706293706294,1.25693661177532,358,152,206,48,1.4,25.14,3.6,0,0,0,0,0,0,0.199466727625122,90.6096140332957,21.6240737146983
9.7,"random_policy_SVM","SVM",13,7,1984,1911,73,800,625,175,0.811071328671326,0.244755244755245,1.25693661177532,416,175,241,58,1.4,28.74,3.6,0,0,0,0,0,0,0.195275895537349,108.19168723533,21.1108332515323
9.7,"random_policy_SVM","SVM",13,8,1884,1827,57,900,709,191,0.818411188811187,0.300699300699301,1.25693661177532,458,191,267,42,1.4,32.33,3.7,0,0,0,0,0,0,0.175924833256861,89.5478877050722,19.6768986492697
9.7,"random_policy_SVM","SVM",13,9,1784,1739,45,1000,797,203,0.809085314685317,0.335664335664336,1.21204601849763,502,203,299,44,1.5,35.92,3.9,0,0,0,0,0,0,0.192645010346156,149.459043377054,20.3150327250375
9.7,"random_policy_SVM","SVM",13,10,1684,1647,37,1100,889,211,0.809751048951052,0.293706293706294,1.21204601849763,521,211,310,19,1.5,39.51,4.2,0,0,0,0,0,0,0.169301898109975,91.6225088263876,18.1724133673494
9.7,"random_policy_SVM","SVM",13,11,1584,1560,24,1200,976,224,0.787899300699304,0.244755244755245,1.21204601849763,571,224,347,50,1.5,43.1,4.4,0,0,0,0,0,0,0.178245770775122,84.9938950575016,18.9741582025874
9.7,"random_policy_SVM","SVM",13,12,1484,1463,21,1300,1073,227,0.786019580419582,0.237762237762238,1.21204601849763,589,227,362,18,1.6,46.7,4.7,0,0,0,0,0,0,0.152011799463643,67.0177266754449,16.128221725763
9.7,"random_policy_SVM","SVM",13,13,1384,1363,21,1400,1173,227,0.799211188811191,0.265734265734266,1.21204601849763,594,227,367,5,1.6,50.29,5.2,0,0,0,0,0,0,0.121207701087823,49.7644650264038,13.4437788533117
9.7,"random_policy_SVM","SVM",13,14,1284,1264,20,1500,1272,228,0.77532867132867,0.202797202797203,1.21204601849763,598,228,370,4,1.6,53.88,5.6,0,0,0,0,0,0,0.127551265282787,61.5738651384833,13.67097151751
9.7,"random_policy_SVM","SVM",13,15,1184,1167,17,1600,1369,231,0.711356643356643,0.125874125874126,1.21204601849763,620,231,389,22,1.7,57.47,5.9,0,0,0,0,0,0,0.147750280600772,54.3435048645226,16.0643126648579
9.7,"random_policy_SVM","SVM",13,16,1084,1068,16,1700,1468,232,0.730724475524477,0.13986013986014,1.21204601849763,636,232,404,16,1.7,61.06,6.3,0,0,0,0,0,0,0.101860616909595,27.8102275489126,11.6900049092909
9.7,"random_policy_SVM","SVM",13,17,984,968,16,1800,1568,232,0.770987412587414,0.244755244755245,1.21204601849763,627,232,395,-9,1.7,64.66,6.8,0,0,0,0,0,0,0.0786207150959937,19.0714296129565,9.26582188849499
9.7,"random_policy_SVM","SVM",13,18,884,868,16,1900,1668,232,0.751395804195805,0.188811188811189,1.21204601849763,625,232,393,-2,1.7,68.25,7.2,0,0,0,0,0,0,0.0320361621057873,7.22826807970875,5.58834305369692
9.7,"random_policy_SVM","SVM",13,19,784,769,15,2000,1767,233,0.739977622377621,0.181818181818182,1.19408978118656,627,233,394,2,1.7,71.84,7.6,0,0,0,0,0,0,0.0209413341915204,13.0679459667118,11.6864105385894
9.7,"random_policy_SVM","SVM",13,20,684,671,13,2100,1865,235,0.756486713286709,0.195804195804196,1.19408978118656,640,235,405,13,1.7,75.43,7.9,0,0,0,0,0,0,0.0177148516419724,5.84032659463293,3.34511164636298
9.7,"random_policy_SVM","SVM",13,21,584,571,13,2200,1965,235,0.770601398601395,0.258741258741259,1.20306789984209,628,235,393,-12,1.7,79.02,8.4,0,0,0,0,0,0,0.00391660461683402,0.879502608318204,0.663249960547099
9.7,"random_policy_SVM","SVM",13,22,484,475,9,2300,2061,239,0.788195804195798,0.272727272727273,1.21204601849763,639,239,400,11,1.7,82.61,8.6,0,0,0,0,0,0,0.0186124999196967,5.40285070056848,3.8149810693058
9.7,"random_policy_SVM","SVM",13,23,384,375,9,2400,2161,239,0.754461538461535,0.20979020979021,1.21204601849763,636,239,397,-3,1.7,86.21,9,0,0,0,0,0,0,0.0101646230148748,2.68036305241121,1.82772381242621
9.7,"random_policy_SVM","SVM",13,24,284,275,9,2500,2261,239,0.774892307692303,0.244755244755245,1.21204601849763,636,239,397,0,1.7,89.8,9.5,0,0,0,0,0,0,0.00880162676499127,2.15302293617025,1.34740037606408
9.7,"random_policy_SVM","SVM",13,25,184,177,7,2600,2359,241,0.770998601398601,0.230769230769231,1.23000225580871,646,241,405,10,1.7,93.39,9.8,0,0,0,0,0,0,0.0140492730721699,3.49270884084524,2.8481207656549
9.7,"random_policy_SVM","SVM",13,26,84,82,2,2700,2454,246,0.755725874125871,0.146853146853147,1.26591473043086,686,246,440,40,1.8,96.98,10,0,0,0,0,0,0,4.86115716204357e-11,1.17958362598421,1.17958362598421
9.7,"random_policy_SVM","SVM",13,27,0,0,0,2784,2536,248,0.772710489510488,0.216783216783217,1.26591473043086,664,248,416,-22,1.7,100,10.2,0,0,0,0,0,0,0,0,0
9.7,"random_policy_SVM","SVM",14,0,2684,2420,264,100,89,11,0.807550022952494,0.198275862068966,1.27280311457175,30,11,19,0,1.7,3.59,8.1,0,0,0,0,0,0,0.192683186007687,280.969613510639,21.2861307131373
9.7,"random_policy_SVM","SVM",14,1,2584,2337,247,200,172,28,0.778609618448409,0.318965517241379,1.20639599555061,79,28,51,49,1.8,7.18,6.1,0,0,0,0,0,0,0.226477962763205,316.929687878637,28.5205255563126
9.7,"random_policy_SVM","SVM",14,2,2484,2271,213,300,238,62,0.696689439148864,0.189655172413793,1.17319243604004,148,62,86,69,1.4,10.78,3.8,0,0,0,0,0,0,0.225157320192044,457.53669824558,24.2798729534683
9.7,"random_policy_SVM","SVM",14,3,2384,2182,202,400,327,73,0.804059892528283,0.258620689655172,1.23959955506118,173,73,100,25,1.4,14.37,4.5,0,0,0,0,0,0,0.194338839724825,259.395535349582,20.97502235633
9.7,"random_policy_SVM","SVM",14,4,2284,2113,171,500,396,104,0.791111981205962,0.267241379310345,1.20639599555061,243,104,139,70,1.3,17.96,3.8,0,0,0,0,0,0,0.209698669663281,217.876228182099,22.0649929915321
9.7,"random_policy_SVM","SVM",14,5,2184,2044,140,600,465,135,0.791922069505583,0.293103448275862,1.20639599555061,322,135,187,79,1.4,21.55,3.4,0,0,0,0,0,0,0.228529677695839,312.098128325418,23.4028335726294
9.7,"random_policy_SVM","SVM",14,6,2084,1968,116,700,541,159,0.803479329246893,0.310344827586207,1.20639599555061,373,159,214,51,1.3,25.14,3.4,0,0,0,0,0,0,0.225258310913456,159.801193113414,23.98739261367
9.7,"random_policy_SVM","SVM",14,7,1984,1895,89,800,614,186,0.807799800178215,0.25,1.2174638487208,443,186,257,70,1.4,28.74,3.3,0,0,0,0,0,0,0.232012362085832,173.811089459973,24.7013952015
9.7,"random_policy_SVM","SVM",14,8,1884,1814,70,900,695,205,0.811607215186457,0.258620689655172,1.2174638487208,495,205,290,52,1.4,32.33,3.4,0,0,0,0,0,0,0.214423975052929,135.494488436571,22.9848883348908
9.7,"random_policy_SVM","SVM",14,9,1784,1721,63,1000,788,212,0.81042583641617,0.241379310344828,1.2174638487208,525,212,313,30,1.5,35.92,3.7,0,0,0,0,0,0,0.170683362449417,89.7462574314913,18.7859411425265
9.7,"random_policy_SVM","SVM",14,10,1684,1639,45,1100,870,230,0.80253422623066,0.241379310344828,1.2174638487208,582,230,352,57,1.5,39.51,3.8,0,0,0,0,0,0,0.185703147677475,117.032215561155,19.9903133339411
9.7,"random_policy_SVM","SVM",14,11,1584,1549,35,1200,960,240,0.811674722544756,0.206896551724138,1.22853170189099,605,240,365,23,1.5,43.1,4,0,0,0,0,0,0,0.171544058917832,93.0103441470806,22.9379034892639
9.7,"random_policy_SVM","SVM",14,12,1484,1458,26,1300,1051,249,0.806253881673096,0.206896551724138,1.22853170189099,632,249,383,27,1.5,46.7,4.2,0,0,0,0,0,0,0.148002297259906,67.5622802684546,16.3703110528507
9.7,"random_policy_SVM","SVM",14,13,1384,1360,24,1400,1149,251,0.796721842680851,0.206896551724138,1.22853170189099,640,251,389,8,1.5,50.29,4.6,0,0,0,0,0,0,0.11410775424544,37.4154138766717,13.9850433349959
9.7,"random_policy_SVM","SVM",14,14,1284,1261,23,1500,1248,252,0.791246995922549,0.224137931034483,1.2174638487208,641,252,389,1,1.5,53.88,5,0,0,0,0,0,0,0.0753749354445342,22.6372443780267,9.78740048113538
9.7,"random_policy_SVM","SVM",14,15,1184,1164,20,1600,1345,255,0.773074015067638,0.129310344827586,1.2174638487208,659,255,404,18,1.6,57.47,5.3,0,0,0,0,0,0,0.0743651501645567,24.0610227576655,10.8266668765128
9.7,"random_policy_SVM","SVM",14,16,1084,1066,18,1700,1443,257,0.758843463937567,0.146551724137931,1.22853170189099,678,257,421,19,1.6,61.06,5.6,0,0,0,0,0,0,0.155428990335974,41.4462093148145,21.5948769322591
9.7,"random_policy_SVM","SVM",14,17,984,966,18,1800,1543,257,0.73472308481624,0.120689655172414,1.2174638487208,678,257,421,0,1.6,64.66,6,0,0,0,0,0,0,0.0787181772746642,19.7661310988852,12.1355353704206
9.7,"random_policy_SVM","SVM",14,18,884,866,18,1900,1643,257,0.763589231226199,0.163793103448276,1.2174638487208,670,257,413,-8,1.6,68.25,6.4,0,0,0,0,0,0,0.0151002588670395,4.16474393409216,3.48332941077565
9.7,"random_policy_SVM","SVM",14,19,784,767,17,2000,1742,258,0.713438014743603,0.112068965517241,1.2174638487208,672,258,414,2,1.6,71.84,6.8,0,0,0,0,0,0,0.00595167180590445,1.94618915086626,1.76379584505838
9.7,"random_policy_SVM","SVM",14,20,684,670,14,2100,1839,261,0.743107498717357,0.137931034482759,1.25066740823137,677,261,416,5,1.6,75.43,7,0,0,0,0,0,0,0.00733794607644255,2.54021134116678,1.97415146319389
9.7,"random_policy_SVM","SVM",14,21,584,576,8,2200,1933,267,0.768098722760774,0.146551724137931,1.27280311457175,709,267,442,32,1.7,79.02,7.2,0,0,0,0,0,0,0.101317387912994,31.6574235256327,16.1553443940843
9.7,"random_policy_SVM","SVM",14,22,484,482,2,2300,2027,273,0.791672292279856,0.224137931034483,1.28268876611418,744,273,471,35,1.7,82.61,7.4,0,0,0,0,0,0,0.0942882396470022,25.6014141716443,12.4379932398693
9.7,"random_policy_SVM","SVM",14,23,384,382,2,2400,2127,273,0.787500337536794,0.146551724137931,1.28387096774194,744,273,471,0,1.7,86.21,7.8,0,0,0,0,0,0,0.0498949203687722,12.8025937981623,6.7437901872716
9.7,"random_policy_SVM","SVM",14,24,284,283,1,2500,2226,274,0.741237544892388,0.120689655172414,1.27280311457175,741,274,467,-3,1.7,89.8,8.1,0,0,0,0,0,0,0.0461864580099462,10.7816185441162,7.10787893433585
9.7,"random_policy_SVM","SVM",14,25,184,184,0,2600,2325,275,0.720519536629487,0.103448275862069,1.27280311457175,755,275,480,14,1.7,93.39,8.5,0,0,0,0,0,0,0.0269593490683327,6.37314490062826,5.5146330888434
9.7,"random_policy_SVM","SVM",14,26,84,84,0,2700,2425,275,0.776483136661891,0.198275862068966,1.27280311457175,755,275,480,0,1.7,96.98,8.8,0,0,0,0,0,0,4.4321584825106e-08,0.887304514665655,0.887304514665655
9.7,"random_policy_SVM","SVM",14,27,0,0,0,2784,2509,275,0.792185348202947,0.189655172413793,1.26173526140156,745,275,470,-10,1.7,100,9.1,0,0,0,0,0,0,0,0,0
9.7,"random_policy_SVM","SVM",15,0,2684,2432,252,100,88,12,0.827126170840029,0.291338582677165,1.2737617475235,34,12,22,0,1.8,3.59,7.3,0,0,0,0,0,0,0.161743916048587,342.932497219046,17.3584365477819
9.7,"random_policy_SVM","SVM",15,1,2584,2352,232,200,168,32,0.81381000360738,0.330708661417323,1.24343408686817,77,32,45,43,1.4,7.18,5.2,0,0,0,0,0,0,0.247908764008777,356.705686447537,26.9008004292391
9.7,"random_policy_SVM","SVM",15,2,2484,2286,198,300,234,66,0.796345362043017,0.21259842519685,1.24343408686817,152,66,86,75,1.3,10.78,3.5,0,0,0,0,0,0,0.246436189564506,439.388093300708,25.5803567740652
9.7,"random_policy_SVM","SVM",15,3,2384,2203,181,400,317,83,0.828171063925065,0.291338582677165,1.26365252730505,200,83,117,48,1.4,14.37,3.8,0,0,0,0,0,0,0.226889683928212,241.734809285061,23.9853825904736
9.7,"random_policy_SVM","SVM",15,4,2284,2133,151,500,387,113,0.819115323854659,0.322834645669291,1.24343408686817,271,113,158,71,1.4,17.96,3.4,0,0,0,0,0,0,0.221000271907703,178.197226445847,23.5962913839513
9.7,"random_policy_SVM","SVM",15,5,2184,2051,133,600,469,131,0.819239715888598,0.330708661417323,1.24343408686817,303,131,172,32,1.3,21.55,3.6,0,0,0,0,0,0,0.202544425548425,163.448589261074,21.3108296033217
9.7,"random_policy_SVM","SVM",15,6,2084,1972,112,700,548,152,0.831243547163245,0.338582677165354,1.25354330708661,364,152,212,61,1.4,25.14,3.6,0,0,0,0,0,0,0.204333047396668,151.25397921563,22.8391181632293
9.7,"random_policy_SVM","SVM",15,7,1984,1896,88,800,624,176,0.821547188118076,0.362204724409449,1.24343408686817,439,176,263,75,1.5,28.74,3.5,0,0,0,0,0,0,0.166224397072451,151.171476235641,20.3652923618929
9.7,"random_policy_SVM","SVM",15,8,1884,1822,62,900,698,202,0.822473908770882,0.338582677165354,1.2737617475235,493,202,291,54,1.4,32.33,3.5,0,0,0,0,0,0,0.157830359810581,119.088996899519,21.2995984085806
9.7,"random_policy_SVM","SVM",15,9,1784,1734,50,1000,786,214,0.834888233757517,0.31496062992126,1.25354330708661,516,214,302,23,1.4,35.92,3.7,0,0,0,0,0,0,0.155939276205938,128.027119185478,16.7546212225306
9.7,"random_policy_SVM","SVM",15,10,1684,1638,46,1100,882,218,0.851712256347099,0.354330708661417,1.26365252730505,545,218,327,29,1.5,39.51,4,0,0,0,0,0,0,0.176083936703502,73.6158340707015,19.435198766109
9.7,"random_policy_SVM","SVM",15,11,1584,1549,35,1200,971,229,0.810488736301332,0.228346456692913,1.2737617475235,582,229,353,37,1.5,43.1,4.2,0,0,0,0,0,0,0.19775246800917,171.297029916843,20.1930319421047
9.7,"random_policy_SVM","SVM",15,12,1484,1458,26,1300,1062,238,0.812634498886693,0.196850393700787,1.28387096774194,615,238,377,33,1.6,46.7,4.5,0,0,0,0,0,0,0.175058875068234,102.918247283875,18.7022856735336
9.7,"random_policy_SVM","SVM",15,13,1384,1361,23,1400,1159,241,0.827499346941827,0.291338582677165,1.2737617475235,620,241,379,5,1.6,50.29,4.8,0,0,0,0,0,0,0.155341951685043,112.116065229821,16.5816095068784
9.7,"random_policy_SVM","SVM",15,14,1284,1262,22,1500,1258,242,0.760458260253017,0.15748031496063,1.25354330708661,642,242,400,22,1.7,53.88,5.2,0,0,0,0,0,0,0.151862835367054,55.4901863239366,20.0435325451173
9.7,"random_policy_SVM","SVM",15,15,1184,1164,20,1600,1356,244,0.792999216330191,0.21259842519685,1.26365252730505,641,244,397,-1,1.6,57.47,5.6,0,0,0,0,0,0,0.0960961201062842,25.9423116329392,13.0195918227168
9.7,"random_policy_SVM","SVM",15,16,1084,1067,17,1700,1453,247,0.811913025089879,0.291338582677165,1.25354330708661,664,247,417,23,1.7,61.06,5.9,0,0,0,0,0,0,0.100268094972142,27.9985272095667,12.2828302739706
9.7,"random_policy_SVM","SVM",15,17,984,967,17,1800,1553,247,0.785274471022881,0.251968503937008,1.25354330708661,652,247,405,-12,1.6,64.66,6.3,0,0,0,0,0,0,0.074931880335384,20.8961269661189,9.89413174693996
9.7,"random_policy_SVM","SVM",15,18,884,867,17,1900,1653,247,0.810756179174293,0.307086614173228,1.25354330708661,675,247,428,23,1.7,68.25,6.7,0,0,0,0,0,0,0.0197864576223653,5.71440146107101,4.45420133144875
9.7,"random_policy_SVM","SVM",15,19,784,771,13,2000,1749,251,0.816708337998036,0.267716535433071,1.28387096774194,689,251,438,14,1.7,71.84,7,0,0,0,0,0,0,0.0768163150409616,28.2069068774554,18.1787252044489
9.7,"random_policy_SVM","SVM",15,20,684,673,11,2100,1847,253,0.846873406227069,0.307086614173228,1.28387096774194,703,253,450,14,1.8,75.43,7.3,0,0,0,0,0,0,0.0708720706448071,21.611364262684,10.347714307692
9.7,"random_policy_SVM","SVM",15,21,584,573,11,2200,1947,253,0.816527969548834,0.244094488188976,1.28387096774194,702,253,449,-1,1.8,79.02,7.7,0,0,0,0,0,0,0.0235437601666261,6.87334283975362,4.14843961375062
9.7,"random_policy_SVM","SVM",15,22,484,476,8,2300,2044,256,0.743205085146347,0.149606299212598,1.28387096774194,738,256,482,36,1.9,82.61,8,0,0,0,0,0,0,0.0834110753934609,25.4516997422344,12.6258615710195
9.7,"random_policy_SVM","SVM",15,23,384,380,4,2400,2140,260,0.708543244890598,0.110236220472441,1.28387096774194,731,260,471,-7,1.8,86.21,8.2,0,0,0,0,0,0,0.0537545997304639,11.9254381999315,8.85877622001894
9.7,"random_policy_SVM","SVM",15,24,284,283,1,2500,2237,263,0.831125374731001,0.283464566929134,1.28387096774194,745,263,482,14,1.8,89.8,8.5,0,0,0,0,0,0,0.00142775063357711,1.54473928436413,1.49361486252533
9.7,"random_policy_SVM","SVM",15,25,184,184,0,2600,2336,264,0.833644313418181,0.291338582677165,1.2737617475235,740,264,476,-5,1.8,93.39,8.8,0,0,0,0,0,0,0.00025658348607451,0.917129590250719,0.911276918882826
9.7,"random_policy_SVM","SVM",15,26,84,84,0,2700,2436,264,0.811825950666124,0.259842519685039,1.2737617475235,757,264,493,17,1.9,96.98,9.2,0,0,0,0,0,0,1.0000000994736e-07,0.0260267392725268,0.0260267392725268
9.7,"random_policy_SVM","SVM",15,27,0,0,0,2784,2520,264,0.730653928922398,0.125984251968504,1.2737617475235,756,264,492,-1,1.9,100,9.5,0,0,0,0,0,0,0,0,0
9.7,"random_policy_SVM","SVM",16,0,2684,2427,257,100,93,7,0.863193641079226,0.291338582677165,1.28387096774194,19,7,12,0,1.7,3.59,13.3,0,0,0,0,0,0,0.136914011540247,212.745548522229,14.4964889186559
9.7,"random_policy_SVM","SVM",16,1,2584,2354,230,200,166,34,0.752167531191309,0.118110236220472,1.24228911993736,90,34,56,71,1.6,7.18,4.9,0,0,0,0,0,0,0.264639937047363,363.92751937727,36.27156457005
9.7,"random_policy_SVM","SVM",16,2,2484,2258,226,300,262,38,0.820153997338013,0.259842519685039,1.2737617475235,104,38,66,14,1.7,10.78,6.9,0,0,0,0,0,0,0.173053803073958,228.482111125813,20.7747040624921
9.7,"random_policy_SVM","SVM",16,3,2384,2171,213,400,349,51,0.853515940839153,0.346456692913386,1.28387096774194,133,51,82,29,1.6,14.37,6.8,0,0,0,0,0,0,0.15543794043765,164.867688737695,15.86439424532
9.7,"random_policy_SVM","SVM",16,4,2284,2100,184,500,420,80,0.848515381075001,0.322834645669291,1.28387096774194,205,80,125,72,1.6,17.96,5.2,0,0,0,0,0,0,0.187700095409715,168.182649461048,19.0238500974956
9.7,"random_policy_SVM","SVM",16,5,2184,2039,145,600,481,119,0.847644636837462,0.322834645669291,1.28387096774194,286,119,167,81,1.4,21.55,4,0,0,0,0,0,0,0.234925368276369,184.508038078128,25.0955779748391
9.7,"random_policy_SVM","SVM",16,6,2084,1965,119,700,555,145,0.845026184523148,0.31496062992126,1.28387096774194,340,145,195,54,1.3,25.14,3.8,0,0,0,0,0,0,0.226445105388014,123.018022494552,23.3522259410816
9.7,"random_policy_SVM","SVM",16,7,1984,1886,98,800,634,166,0.846717916184651,0.354330708661417,1.2737617475235,393,166,227,53,1.4,28.74,3.8,0,0,0,0,0,0,0.204518857385674,98.1976621847123,22.019320456766
9.7,"random_policy_SVM","SVM",16,8,1884,1798,86,900,722,178,0.848185742185076,0.362204724409449,1.2737617475235,419,178,241,26,1.4,32.33,4.1,0,0,0,0,0,0,0.162993850302837,74.1745355449171,18.3464242022066
9.7,"random_policy_SVM","SVM",16,9,1784,1713,71,1000,807,193,0.830833053451268,0.322834645669291,1.2737617475235,467,193,274,48,1.4,35.92,4.2,0,0,0,0,0,0,0.14677115723302,73.0580596875776,16.8514380318168
9.7,"random_policy_SVM","SVM",16,10,1684,1623,61,1100,897,203,0.818779465363051,0.275590551181102,1.25354330708661,496,203,293,29,1.4,39.51,4.4,0,0,0,0,0,0,0.168479793950985,96.35164922257,18.7964710604028
9.7,"random_policy_SVM","SVM",16,11,1584,1528,56,1200,992,208,0.753050714632244,0.078740157480315,1.25354330708661,516,208,308,20,1.5,43.1,4.8,0,0,0,0,0,0,0.364236901483197,130.406191034848,69.4628905605518
9.7,"random_policy_SVM","SVM",16,12,1484,1428,56,1300,1092,208,0.826367379433034,0.259842519685039,1.2737617475235,519,208,311,3,1.5,46.7,5.2,0,0,0,0,0,0,0.139006892490342,57.4247836582989,15.8626068167504
9.7,"random_policy_SVM","SVM",16,13,1384,1335,49,1400,1185,215,0.836119714893471,0.291338582677165,1.2737617475235,547,215,332,28,1.5,50.29,5.5,0,0,0,0,0,0,0.12517273920133,42.9163777590138,14.7834072012648
9.7,"random_policy_SVM","SVM",16,14,1284,1250,34,1500,1270,230,0.83880036322475,0.31496062992126,1.2737617475235,576,230,346,29,1.5,53.88,5.5,0,0,0,0,0,0,0.0915556542646953,27.1937605576238,15.2303968729051
9.7,"random_policy_SVM","SVM",16,15,1184,1161,23,1600,1359,241,0.836866067097075,0.299212598425197,1.2737617475235,608,241,367,32,1.5,57.47,5.6,0,0,0,0,0,0,0.054913031175948,13.5704785830449,7.44390318155644
9.7,"random_policy_SVM","SVM",16,16,1084,1063,21,1700,1457,243,0.807422472664857,0.244094488188976,1.25354330708661,626,243,383,18,1.6,61.06,6,0,0,0,0,0,0,0.0274444343605723,9.46858412795084,5.83332883305473
9.7,"random_policy_SVM","SVM",16,17,984,966,18,1800,1554,246,0.810700202759016,0.259842519685039,1.23332486664973,639,246,393,13,1.6,64.66,6.3,0,0,0,0,0,0,0.0581712331635193,18.7399992474475,8.76580158853063
9.7,"random_policy_SVM","SVM",16,18,884,868,16,1900,1652,248,0.806330932567079,0.236220472440945,1.23332486664973,657,248,409,18,1.6,68.25,6.7,0,0,0,0,0,0,0.0203048988986705,6.7008373480344,5.16846980868301
9.7,"random_policy_SVM","SVM",16,19,784,768,16,2000,1752,248,0.800487616773024,0.21259842519685,1.23332486664973,648,248,400,-9,1.6,71.84,7.1,0,0,0,0,0,0,0.010393686097848,3.5761757041715,2.43942057560347
9.7,"random_policy_SVM","SVM",16,20,684,669,15,2100,1851,249,0.814910873107688,0.251968503937008,1.23332486664973,657,249,408,9,1.6,75.43,7.4,0,0,0,0,0,0,0.0206414332359202,7.08946840368535,5.21828947923959
9.7,"random_policy_SVM","SVM",16,21,584,570,14,2200,1950,250,0.785330447438145,0.173228346456693,1.20299720599441,662,250,412,5,1.6,79.02,7.8,0,0,0,0,0,0,0.0170316901856969,8.86829421051581,7.44252701586641
9.7,"random_policy_SVM","SVM",16,22,484,471,13,2300,2049,251,0.792912141906425,0.204724409448819,1.21310642621285,689,251,438,27,1.7,82.61,8.2,0,0,0,0,0,0,0.0124184332178469,3.87598553312905,2.65743057473096
9.7,"random_policy_SVM","SVM",16,23,384,372,12,2400,2148,252,0.811919244691568,0.267716535433071,1.21310642621285,686,252,434,-3,1.7,86.21,8.5,0,0,0,0,0,0,0.00440874807124262,1.2727241912615,0.906808137541914
9.7,"random_policy_SVM","SVM",16,24,284,274,10,2500,2246,254,0.778712791232851,0.181102362204724,1.21310642621285,680,254,426,-6,1.7,89.8,8.8,0,0,0,0,0,0,0.00229147947264269,0.746946917659026,0.60568154433372
9.7,"random_policy_SVM","SVM",16,25,184,178,6,2600,2342,258,0.806694779266337,0.236220472440945,1.23332486664973,723,258,465,43,1.8,93.39,9.1,0,0,0,0,0,0,0.00594533832832806,2.17324758105188,2.03529407766688
9.7,"random_policy_SVM","SVM",16,26,84,83,1,2700,2437,263,0.764774663830532,0.165354330708661,1.2737617475235,734,263,471,11,1.8,96.98,9.3,0,0,0,0,0,0,1.85450048847706e-07,1.31469151818605,1.31469151818605
9.7,"random_policy_SVM","SVM",16,27,0,0,0,2784,2520,264,0.798889179136968,0.21259842519685,1.28387096774194,737,264,473,3,1.8,100,9.5,0,0,0,0,0,0,0,0,0
9.7,"random_policy_SVM","SVM",17,0,2684,2431,253,100,92,8,0.636701382544614,0.215384615384615,1.0863523573201,28,8,20,0,2.5,3.59,11.5,0,0,0,0,0,0,0.135437630161132,215.42530165862,17.1118446789687
9.7,"random_policy_SVM","SVM",17,1,2584,2354,230,200,169,31,0.794542907607043,0.3,1.24436724565757,89,31,58,61,1.9,7.18,5.5,0,0,0,0,0,0,0.209300728878559,317.912962942118,21.90830914056
9.7,"random_policy_SVM","SVM",17,2,2484,2280,204,300,243,57,0.791765637371341,0.215384615384615,1.24436724565757,138,57,81,49,1.4,10.78,4.3,0,0,0,0,0,0,0.236540486001186,226.953650569506,25.7017843345393
9.7,"random_policy_SVM","SVM",17,3,2384,2200,184,400,323,77,0.799604117181318,0.238461538461538,1.25424317617866,189,77,112,51,1.5,14.37,4.2,0,0,0,0,0,0,0.241882598638675,185.125404275079,28.8541829254851
9.7,"random_policy_SVM","SVM",17,4,2284,2131,153,500,392,108,0.823162190145566,0.284615384615385,1.26411910669975,258,108,150,69,1.4,17.96,3.6,0,0,0,0,0,0,0.246694164702329,113.698750419712,26.3991107845117
9.7,"random_policy_SVM","SVM",17,5,2184,2058,126,600,465,135,0.821036603934469,0.261538461538462,1.25424317617866,308,135,173,50,1.3,21.55,3.4,0,0,0,0,0,0,0.208457469821013,79.403048008726,23.491120125392
9.7,"random_policy_SVM","SVM",17,6,2084,1985,99,700,538,162,0.818442048845852,0.276923076923077,1.25424317617866,377,162,215,69,1.3,25.14,3.3,0,0,0,0,0,0,0.161380714213629,61.08312120505,20.3537325446013
9.7,"random_policy_SVM","SVM",17,7,1984,1907,77,800,616,184,0.796479688166153,0.3,1.22461538461538,438,184,254,61,1.4,28.74,3.3,0,0,0,0,0,0,0.167581355776121,69.6511452952127,20.1282190057819
9.7,"random_policy_SVM","SVM",17,8,1884,1822,62,900,701,199,0.752061635909623,0.253846153846154,1.19498759305211,497,199,298,59,1.5,32.33,3.5,0,0,0,0,0,0,0.193389121582825,95.4132560126784,23.4885723425108
9.7,"random_policy_SVM","SVM",17,9,1784,1730,54,1000,793,207,0.791162677385958,0.246153846153846,1.25424317617866,509,207,302,12,1.5,35.92,3.8,0,0,0,0,0,0,0.112232921752925,39.1803274280194,15.6789089002698
9.7,"random_policy_SVM","SVM",17,10,1684,1638,46,1100,885,215,0.779261830805778,0.307692307692308,1.22461538461538,533,215,318,24,1.5,39.51,4.1,0,0,0,0,0,0,0.180724537096448,200.157775879829,19.2090664581463
9.7,"random_policy_SVM","SVM",17,11,1584,1542,42,1200,981,219,0.795901090200381,0.323076923076923,1.23449131513648,542,219,323,9,1.5,43.1,4.5,0,0,0,0,0,0,0.0900809763709699,40.0098904945459,11.923440514944
9.7,"random_policy_SVM","SVM",17,12,1484,1447,37,1300,1076,224,0.809866617942629,0.276923076923077,1.27399503722084,551,224,327,9,1.5,46.7,4.8,0,0,0,0,0,0,0.0841944845783011,30.2494447449893,12.6482210343039
9.7,"random_policy_SVM","SVM",17,13,1384,1359,25,1400,1164,236,0.792667032096964,0.3,1.24436724565757,586,236,350,35,1.5,50.29,4.9,0,0,0,0,0,0,0.165728557211381,88.5176135873151,21.3702533152959
9.7,"random_policy_SVM","SVM",17,14,1284,1268,16,1500,1255,245,0.793988671660883,0.207692307692308,1.27399503722084,610,245,365,24,1.5,53.88,5.1,0,0,0,0,0,0,0.125190320009486,48.6007042725819,16.3207468503335
9.7,"random_policy_SVM","SVM",17,15,1184,1175,9,1600,1348,252,0.809093123819967,0.230769230769231,1.28387096774194,645,252,393,35,1.6,57.47,5.3,0,0,0,0,0,0,0.09239146148359,36.080533410069,12.8481081524645
9.7,"random_policy_SVM","SVM",17,16,1084,1078,6,1700,1445,255,0.794086119739329,0.253846153846154,1.27399503722084,658,255,403,13,1.6,61.06,5.7,0,0,0,0,0,0,0.0754211461604759,28.7508809590567,10.0026163939282
9.7,"random_policy_SVM","SVM",17,17,984,979,5,1800,1544,256,0.797015652597603,0.223076923076923,1.28387096774194,663,256,407,5,1.6,64.66,6,0,0,0,0,0,0,0.0242740732632329,8.07018567511683,3.89144569844454
9.7,"random_policy_SVM","SVM",17,18,884,880,4,1900,1643,257,0.778019367805594,0.2,1.25424317617866,675,257,418,12,1.6,68.25,6.4,0,0,0,0,0,0,0.0964156455019619,43.3679015764643,11.8430345964767
9.7,"random_policy_SVM","SVM",17,19,784,780,4,2000,1743,257,0.787240392228518,0.215384615384615,1.24436724565757,671,257,414,-4,1.6,71.84,6.8,0,0,0,0,0,0,0.0286481535229834,9.87270813880843,4.96923274586429
9.7,"random_policy_SVM","SVM",17,20,684,681,3,2100,1842,258,0.753998416468728,0.130769230769231,1.25424317617866,681,258,423,10,1.6,75.43,7.1,0,0,0,0,0,0,0.0270026591521978,9.79778190916105,5.24493535619375
9.7,"random_policy_SVM","SVM",17,21,584,581,3,2200,1942,258,0.808764236555213,0.269230769230769,1.25424317617866,683,258,425,2,1.6,79.02,7.5,0,0,0,0,0,0,0.00919730662650717,2.82673475586272,1.64137956446625
9.7,"random_policy_SVM","SVM",17,22,484,481,3,2300,2042,258,0.791254034959501,0.246153846153846,1.25424317617866,675,258,417,-8,1.6,82.61,7.9,0,0,0,0,0,0,0.00356214317476634,1.01423983567415,0.629766616945766
9.7,"random_policy_SVM","SVM",17,23,384,382,2,2400,2141,259,0.819471344174434,0.276923076923077,1.26411910669975,680,259,421,5,1.6,86.21,8.3,0,0,0,0,0,0,0.00225374249651697,0.796411458115842,0.610120589517652
9.7,"random_policy_SVM","SVM",17,24,284,283,1,2500,2240,260,0.809805712893601,0.223076923076923,1.26411910669975,688,260,428,8,1.6,89.8,8.6,0,0,0,0,0,0,0.000780091111536613,0.247054672759605,0.200630017180414
9.7,"random_policy_SVM","SVM",17,25,184,183,1,2600,2340,260,0.810043242584813,0.261538461538462,1.26411910669975,699,260,439,11,1.7,93.39,9,0,0,0,0,0,0,0.000154792398625726,0.0668260858153482,0.0622284960250042
9.7,"random_policy_SVM","SVM",17,26,84,84,0,2700,2439,261,0.773816919422623,0.2,1.25424317617866,693,261,432,-6,1.7,96.98,9.3,0,0,0,0,0,0,2.79364564512542e-05,1.57483540214701,1.57483540214701
9.7,"random_policy_SVM","SVM",17,27,0,0,0,2784,2523,261,0.779943967354896,0.153846153846154,1.26411910669975,701,261,440,8,1.7,100,9.7,0,0,0,0,0,0,0,0,0
9.7,"random_policy_SVM","SVM",18,0,2684,2431,253,100,92,8,0.773378403069616,0.238461538461538,1.28387096774194,25,8,17,0,2.1,3.59,11.5,0,0,0,0,0,0,0.121809788316647,197.373894645677,14.6894910163861
9.7,"random_policy_SVM","SVM",18,1,2584,2349,235,200,174,26,0.76496132529387,0.246153846153846,1.26411910669975,70,26,44,45,1.7,7.18,6.7,0,0,0,0,0,0,0.191534316208813,293.122316414703,24.626029814628
9.7,"random_policy_SVM","SVM",18,2,2484,2272,212,300,251,49,0.748705767708145,0.215384615384615,1.23449131513648,123,49,74,53,1.5,10.78,5.1,0,0,0,0,0,0,0.187528833051465,254.431139730911,20.9859219499851
9.7,"random_policy_SVM","SVM",18,3,2384,2192,192,400,331,69,0.735416286010113,0.223076923076923,1.22461538461538,170,69,101,47,1.5,14.37,4.8,0,0,0,0,0,0,0.179165961043588,270.078059708902,20.3925170011711
9.7,"random_policy_SVM","SVM",18,4,2284,2105,179,500,418,82,0.756879225287779,0.238461538461538,1.22461538461538,195,82,113,25,1.4,17.96,5.1,0,0,0,0,0,0,0.15990068633089,168.444518530123,17.6454035242708
9.7,"random_policy_SVM","SVM",18,5,2184,2028,156,600,495,105,0.754625738473723,0.238461538461538,1.22461538461538,244,105,139,49,1.3,21.55,4.7,0,0,0,0,0,0,0.169821402261249,171.092447368381,17.8543054820468
9.7,"random_policy_SVM","SVM",18,6,2084,1948,136,700,575,125,0.774718314148247,0.223076923076923,1.23449131513648,296,125,171,52,1.4,25.14,4.6,0,0,0,0,0,0,0.160423373373458,111.173029827327,18.3163053643476
9.7,"random_policy_SVM","SVM",18,7,1984,1872,112,800,651,149,0.77982215725684,0.215384615384615,1.22461538461538,356,149,207,60,1.4,28.74,4.4,0,0,0,0,0,0,0.163533496194259,130.533072549444,17.5959357671673
9.7,"random_policy_SVM","SVM",18,8,1884,1797,87,900,726,174,0.790517083866256,0.207692307692308,1.22461538461538,415,174,241,59,1.4,32.33,4.2,0,0,0,0,0,0,0.181858365581627,154.173088837188,19.0784088742816
9.7,"random_policy_SVM","SVM",18,9,1784,1722,62,1000,801,199,0.794250563371707,0.207692307692308,1.22461538461538,471,199,272,56,1.4,35.92,4,0,0,0,0,0,0,0.175529611789753,146.689159614085,19.3421328431891
9.7,"random_policy_SVM","SVM",18,10,1684,1634,50,1100,889,211,0.799524940617581,0.215384615384615,1.22461538461538,497,211,286,26,1.4,39.51,4.2,0,0,0,0,0,0,0.139992051215071,91.2274633783857,15.6063950823548
9.7,"random_policy_SVM","SVM",18,11,1584,1546,38,1200,977,223,0.801327730068826,0.215384615384615,1.22461538461538,541,223,318,44,1.4,43.1,4.4,0,0,0,0,0,0,0.134540304745407,56.820137527243,15.7169730024687
9.7,"random_policy_SVM","SVM",18,12,1484,1451,33,1300,1072,228,0.800341068274563,0.207692307692308,1.22461538461538,570,228,342,29,1.5,46.7,4.7,0,0,0,0,0,0,0.137440963465886,89.2667748091419,15.1013272003999
9.7,"random_policy_SVM","SVM",18,13,1384,1361,23,1400,1162,238,0.798197210548758,0.2,1.22461538461538,591,238,353,21,1.5,50.29,4.9,0,0,0,0,0,0,0.113120233366163,62.6652473560146,13.063721864097
9.7,"random_policy_SVM","SVM",18,14,1284,1265,19,1500,1258,242,0.789469517022965,0.161538461538462,1.22461538461538,609,242,367,18,1.5,53.88,5.2,0,0,0,0,0,0,0.115308372008801,80.0956738388943,12.5321248361698
9.7,"random_policy_SVM","SVM",18,15,1184,1166,18,1600,1357,243,0.798544369328221,0.184615384615385,1.22461538461538,616,243,373,7,1.5,57.47,5.6,0,0,0,0,0,0,0.101301466173712,46.488334854311,12.4053113792043
9.7,"random_policy_SVM","SVM",18,16,1084,1067,17,1700,1456,244,0.804616602716369,0.238461538461538,1.22461538461538,597,244,353,-19,1.4,61.06,6,0,0,0,0,0,0,0.0850917913770433,31.5593011419021,10.8540253440527
9.7,"random_policy_SVM","SVM",18,17,984,968,16,1800,1555,245,0.802740727206289,0.284615384615385,1.22461538461538,617,245,372,20,1.5,64.66,6.3,0,0,0,0,0,0,0.0660877314963057,23.0237161917977,8.14355857208718
9.7,"random_policy_SVM","SVM",18,18,884,868,16,1900,1655,245,0.788050429380599,0.207692307692308,1.22461538461538,618,245,373,1,1.5,68.25,6.8,0,0,0,0,0,0,0.0804680630397379,34.1144582157057,8.9503150658865
9.7,"random_policy_SVM","SVM",18,19,784,768,16,2000,1755,245,0.798812351543947,0.192307692307692,1.22461538461538,613,245,368,-5,1.5,71.84,7.2,0,0,0,0,0,0,0.022144887085935,6.15021923534106,3.23063337307987
9.7,"random_policy_SVM","SVM",18,20,684,668,16,2100,1855,245,0.805603264510632,0.269230769230769,1.22461538461538,626,245,381,13,1.6,75.43,7.6,0,0,0,0,0,0,0.00564927952362618,1.84492616590836,1.3277256034883
9.7,"random_policy_SVM","SVM",18,21,584,568,16,2200,1955,245,0.808404896765946,0.253846153846154,1.22461538461538,619,245,374,-7,1.5,79.02,8,0,0,0,0,0,0,0.00655845845639032,1.81494573005425,1.18866917132623
9.7,"random_policy_SVM","SVM",18,22,484,470,14,2300,2053,247,0.785187892076257,0.176923076923077,1.2048635235732,624,247,377,5,1.5,82.61,8.3,0,0,0,0,0,0,0.00885478328922662,3.70767499340969,2.96220438661119
9.7,"random_policy_SVM","SVM",18,23,384,372,12,2400,2151,249,0.783902795541754,0.207692307692308,1.2048635235732,648,249,399,24,1.6,86.21,8.6,0,0,0,0,0,0,0.00556497723409121,2.57754397317049,2.19274465610356
9.7,"random_policy_SVM","SVM",18,24,284,272,12,2500,2251,249,0.804604421706564,0.253846153846154,1.19498759305211,639,249,390,-9,1.6,89.8,9,0,0,0,0,0,0,0.000805369464833998,0.293822288896284,0.259430447672598
9.7,"random_policy_SVM","SVM",18,25,184,174,10,2600,2349,251,0.775053291917903,0.169230769230769,1.2048635235732,651,251,400,12,1.6,93.39,9.4,0,0,0,0,0,0,0.0012183805556049,0.349730882399533,0.316880854641947
9.7,"random_policy_SVM","SVM",18,26,84,79,5,2700,2444,256,0.824496010719292,0.3,1.23449131513648,669,256,413,18,1.6,96.98,9.5,0,0,0,0,0,0,1.43340016593518e-06,0.304324531095577,0.304324531095577
9.7,"random_policy_SVM","SVM",18,27,0,0,0,2784,2523,261,0.81415433339424,0.276923076923077,1.27399503722084,719,261,458,50,1.8,100,9.7,0,0,0,0,0,0,0,0,0
9.7,"random_policy_SVM","SVM",19,0,2684,2402,282,100,95,5,0.539699826937997,0.0961538461538462,1.03697270471464,29,5,24,0,4.8,3.59,19,0,0,0,0,0,0,0.0664652664963044,149.2360632263,7.84466165408695
9.7,"random_policy_SVM","SVM",19,1,2584,2312,272,200,185,15,0.743622068389334,0.144230769230769,1.24683622828784,61,15,46,32,3.1,7.18,12.3,0,0,0,0,0,0,0.0910142859335164,194.98675679335,9.77990941127826
9.7,"random_policy_SVM","SVM",19,2,2484,2225,259,300,272,28,0.704302679477236,0.144230769230769,1.25918114143921,100,28,72,39,2.6,10.78,9.7,0,0,0,0,0,0,0.104478644048607,231.93738934243,10.7050205709759
9.7,"random_policy_SVM","SVM",19,3,2384,2142,242,400,355,45,0.743390821746141,0.105769230769231,1.27152605459057,150,45,105,50,2.3,14.37,7.9,0,0,0,0,0,0,0.131608527198023,229.615263122285,13.7668995525467
9.7,"random_policy_SVM","SVM",19,4,2284,2065,219,500,432,68,0.763934475144719,0.173076923076923,1.27152605459057,199,68,131,49,1.9,17.96,6.4,0,0,0,0,0,0,0.186625547944788,202.238771753579,21.0958617946179
9.7,"random_policy_SVM","SVM",19,5,2184,2000,184,600,497,103,0.758936563824079,0.221153846153846,1.27152605459057,266,103,163,67,1.6,21.55,4.8,0,0,0,0,0,0,0.190784635083158,180.537548421944,20.5963906061408
9.7,"random_policy_SVM","SVM",19,6,2084,1929,155,700,568,132,0.76808199558394,0.211538461538462,1.27152605459057,329,132,197,63,1.5,25.14,4.3,0,0,0,0,0,0,0.191638096131299,160.332304055315,20.5069041074391
9.7,"random_policy_SVM","SVM",19,7,1984,1862,122,800,635,165,0.778294145730146,0.182692307692308,1.27152605459057,402,165,237,73,1.4,28.74,3.8,0,0,0,0,0,0,0.206116139921142,212.280574807749,21.2934408682946
9.7,"random_policy_SVM","SVM",19,8,1884,1787,97,900,710,190,0.790647192218182,0.201923076923077,1.27152605459057,465,190,275,63,1.4,32.33,3.7,0,0,0,0,0,0,0.194548085323473,130.667100473884,20.929382553716
9.7,"random_policy_SVM","SVM",19,9,1784,1716,68,1000,781,219,0.797256370472045,0.211538461538462,1.27152605459057,533,219,314,68,1.4,35.92,3.6,0,0,0,0,0,0,0.187820895753862,142.98246283566,20.1756019056962
9.7,"random_policy_SVM","SVM",19,10,1684,1632,52,1100,865,235,0.794600763859883,0.230769230769231,1.25918114143921,570,235,335,37,1.4,39.51,3.7,0,0,0,0,0,0,0.19888229289983,196.644278166455,20.739402386964
9.7,"random_policy_SVM","SVM",19,11,1584,1540,44,1200,957,243,0.784328937160595,0.153846153846154,1.25918114143921,603,243,360,33,1.5,43.1,3.9,0,0,0,0,0,0,0.175663072633748,121.933865732026,19.3301511300215
9.7,"random_policy_SVM","SVM",19,12,1484,1447,37,1300,1050,250,0.816181297368269,0.230769230769231,1.25918114143921,635,250,385,32,1.5,46.7,4.2,0,0,0,0,0,0,0.146130557503741,94.6947770668339,17.7081837612011
9.7,"random_policy_SVM","SVM",19,13,1384,1350,34,1400,1147,253,0.800963776332281,0.182692307692308,1.25918114143921,640,253,387,5,1.5,50.29,4.5,0,0,0,0,0,0,0.127934953392235,61.8630617245527,17.042606261619
9.7,"random_policy_SVM","SVM",19,14,1284,1257,27,1500,1240,260,0.809340872471212,0.201923076923077,1.25918114143921,668,260,408,28,1.6,53.88,4.8,0,0,0,0,0,0,0.1288732249729,47.4605724942344,15.490440693957
9.7,"random_policy_SVM","SVM",19,15,1184,1168,16,1600,1329,271,0.79239273139584,0.173076923076923,1.25918114143921,704,271,433,36,1.6,57.47,4.9,0,0,0,0,0,0,0.134120258198407,52.8294545923083,15.2057026873574
9.7,"random_policy_SVM","SVM",19,16,1084,1074,10,1700,1423,277,0.778316524437553,0.173076923076923,1.25918114143921,721,277,444,17,1.6,61.06,5.1,0,0,0,0,0,0,0.135797695291413,66.6822833183247,15.0337289992604
9.7,"random_policy_SVM","SVM",19,17,984,976,8,1800,1521,279,0.799069045771918,0.182692307692308,1.25918114143921,736,279,457,15,1.6,64.66,5.5,0,0,0,0,0,0,0.104332226267947,41.228233542448,11.9234895490768
9.7,"random_policy_SVM","SVM",19,18,884,878,6,1900,1619,281,0.804380258996244,0.201923076923077,1.25918114143921,756,281,475,20,1.7,68.25,5.8,0,0,0,0,0,0,0.0686050879700288,21.0146465358822,9.19236511036858
9.7,"random_policy_SVM","SVM",19,19,784,780,4,2000,1717,283,0.766582622187746,0.115384615384615,1.27152605459057,756,283,473,0,1.7,71.84,6.1,0,0,0,0,0,0,0.0684489968406306,21.9819864109986,8.81831864732881
9.7,"random_policy_SVM","SVM",19,20,684,682,2,2100,1815,285,0.777525810109211,0.201923076923077,1.27152605459057,764,285,479,8,1.7,75.43,6.4,0,0,0,0,0,0,0.051908225110481,15.1206251190326,11.3899931978417
9.7,"random_policy_SVM","SVM",19,21,584,583,1,2200,1914,286,0.804014740108613,0.192307692307692,1.27152605459057,766,286,480,2,1.7,79.02,6.7,0,0,0,0,0,0,0.0155570320044243,5.45099823772531,4.08499088234773
9.7,"random_policy_SVM","SVM",19,22,484,483,1,2300,2014,286,0.768380378349348,0.173076923076923,1.27152605459057,789,286,503,23,1.8,82.61,7,0,0,0,0,0,0,0.00274008831527901,0.823029771811318,0.672727734072727
9.7,"random_policy_SVM","SVM",19,23,384,383,1,2400,2114,286,0.806670346720777,0.192307692307692,1.25918114143921,781,286,495,-8,1.7,86.21,7.4,0,0,0,0,0,0,0.000241100318679719,0.127485007438876,0.117942908194179
9.7,"random_policy_SVM","SVM",19,24,284,284,0,2500,2213,287,0.770401921585012,0.153846153846154,1.27152605459057,785,287,498,4,1.7,89.8,7.7,0,0,0,0,0,0,0.00644251386443428,3.90850467868272,3.66625462570877
9.7,"random_policy_SVM","SVM",19,25,184,184,0,2600,2313,287,0.804126633645644,0.182692307692308,1.27152605459057,815,287,528,30,1.8,93.39,8.1,0,0,0,0,0,0,0.00320525306058104,1.60184761857372,1.50283018882535
9.7,"random_policy_SVM","SVM",19,26,84,84,0,2700,2413,287,0.788424240615864,0.201923076923077,1.25918114143921,784,287,497,-31,1.7,96.98,8.4,0,0,0,0,0,0,1.0000000994736e-07,0.0231049740044347,0.0231049740044347
9.7,"random_policy_SVM","SVM",19,27,0,0,0,2784,2497,287,0.759704899445009,0.153846153846154,1.27152605459057,796,287,509,12,1.8,100,8.7,0,0,0,0,0,0,0,0,0
9.7,"random_policy_SVM","SVM",20,0,2684,2422,262,100,87,13,0.765702211541051,0.224137931034483,1.23959955506118,35,13,22,0,1.7,3.59,6.7,0,0,0,0,0,0,0.174472292659374,339.95836062059,23.2259032970569
9.7,"random_policy_SVM","SVM",20,1,2584,2343,241,200,166,34,0.790598925282851,0.206896551724138,1.27280311457175,96,34,62,61,1.8,7.18,4.9,0,0,0,0,0,0,0.186286517790768,401.139801611516,19.4367770126289
9.7,"random_policy_SVM","SVM",20,2,2484,2254,230,300,255,45,0.800164717954254,0.206896551724138,1.28387096774194,116,45,71,20,1.6,10.78,5.7,0,0,0,0,0,0,0.179324022258042,282.14080645775,20.5626371723711
9.7,"random_policy_SVM","SVM",20,3,2384,2176,208,400,333,67,0.820153646747493,0.25,1.25066740823137,166,67,99,50,1.5,14.37,5,0,0,0,0,0,0,0.194896083847451,264.5695200694,20.1767927582852
9.7,"random_policy_SVM","SVM",20,4,2284,2109,175,500,400,100,0.804903734507067,0.21551724137931,1.25066740823137,239,100,139,73,1.4,17.96,4,0,0,0,0,0,0,0.216668635812294,202.741027258798,23.2844418940567
9.7,"random_policy_SVM","SVM",20,5,2184,2040,144,600,469,131,0.812916857937522,0.241379310344828,1.25066740823137,309,131,178,70,1.4,21.55,3.6,0,0,0,0,0,0,0.216653128141685,245.494843609903,22.4627742515901
9.7,"random_policy_SVM","SVM",20,6,2084,1969,115,700,540,160,0.816920044284835,0.241379310344828,1.25066740823137,383,160,223,74,1.4,25.14,3.4,0,0,0,0,0,0,0.227652005447748,222.348479262247,23.4174206918195
9.7,"random_policy_SVM","SVM",20,7,1984,1891,93,800,618,182,0.819728350390206,0.224137931034483,1.25066740823137,432,182,250,49,1.4,28.74,3.4,0,0,0,0,0,0,0.219767786054563,164.303499294767,23.0013299313403
9.7,"random_policy_SVM","SVM",20,8,1884,1819,65,900,690,210,0.819991629087577,0.258620689655172,1.25066740823137,492,210,282,60,1.3,32.33,3.3,0,0,0,0,0,0,0.196295837703453,118.290109549209,22.0952255213796
9.7,"random_policy_SVM","SVM",20,9,1784,1741,43,1000,768,232,0.813254394729024,0.232758620689655,1.23959955506118,558,232,326,66,1.4,35.92,3.3,0,0,0,0,0,0,0.217081633721131,193.306933099119,23.1627781551435
9.7,"random_policy_SVM","SVM",20,10,1684,1646,38,1100,863,237,0.815313369157236,0.25,1.22853170189099,567,237,330,9,1.4,39.51,3.6,0,0,0,0,0,0,0.148110804672702,81.1124140021178,17.3473707013166
9.7,"random_policy_SVM","SVM",20,11,1584,1550,34,1200,959,241,0.8140982367078,0.241379310344828,1.25066740823137,590,241,349,23,1.4,43.1,4,0,0,0,0,0,0,0.121161021754819,80.6569746078763,14.0783821205666
9.7,"random_policy_SVM","SVM",20,12,1484,1459,25,1300,1050,250,0.806267383144759,0.206896551724138,1.23959955506118,614,250,364,24,1.5,46.7,4.2,0,0,0,0,0,0,0.166108962738097,88.8808384440444,18.7237966186722
9.7,"random_policy_SVM","SVM",20,13,1384,1364,20,1400,1145,255,0.803101288040398,0.206896551724138,1.25066740823137,638,255,383,24,1.5,50.29,4.5,0,0,0,0,0,0,0.130603986729457,62.3846167698783,14.7120125482212
9.7,"random_policy_SVM","SVM",20,14,1284,1264,20,1500,1245,255,0.818756244430641,0.224137931034483,1.26057344256049,628,255,373,-10,1.5,53.88,4.9,0,0,0,0,0,0,0.0543137690205768,16.0141129481207,7.16827244103054
9.7,"random_policy_SVM","SVM",20,15,1184,1166,18,1600,1343,257,0.812025760807929,0.21551724137931,1.25066740823137,639,257,382,11,1.5,57.47,5.2,0,0,0,0,0,0,0.0379598888518668,11.3020010353517,6.19337247777436
9.7,"random_policy_SVM","SVM",20,16,1084,1068,16,1700,1441,259,0.806834444954498,0.206896551724138,1.23959955506118,652,259,393,13,1.5,61.06,5.6,0,0,0,0,0,0,0.115160360090134,37.7959267194219,15.4820375432406
9.7,"random_policy_SVM","SVM",20,17,984,969,15,1800,1540,260,0.797538681716305,0.206896551724138,1.23959955506118,672,260,412,20,1.6,64.66,5.9,0,0,0,0,0,0,0.063173735661733,24.8454448070592,8.74655215049555
9.7,"random_policy_SVM","SVM",20,18,884,871,13,1900,1638,262,0.798362271487585,0.189655172413793,1.22853170189099,682,262,420,10,1.6,68.25,6.3,0,0,0,0,0,0,0.0214046667080217,7.11420575604698,3.46504757312264
9.7,"random_policy_SVM","SVM",20,19,784,774,10,2000,1735,265,0.806314638295573,0.224137931034483,1.25066740823137,692,265,427,10,1.6,71.84,6.5,0,0,0,0,0,0,0.0780107077111309,37.8183146766441,9.8363513309049
9.7,"random_policy_SVM","SVM",20,20,684,675,9,2100,1834,266,0.791098479734291,0.189655172413793,1.22853170189099,696,266,430,4,1.6,75.43,6.9,0,0,0,0,0,0,0.0248480526388546,13.728733777615,10.0332174977714
9.7,"random_policy_SVM","SVM",20,21,584,575,9,2200,1934,266,0.803148543191203,0.21551724137931,1.22853170189099,694,266,428,-2,1.6,79.02,7.3,0,0,0,0,0,0,0.0219303946598239,6.49985016815119,3.23237497918971
9.7,"random_policy_SVM","SVM",20,22,484,475,9,2300,2034,266,0.794095806442903,0.172413793103448,1.22853170189099,707,266,441,13,1.7,82.61,7.6,0,0,0,0,0,0,0.0129431371531073,3.47974365699103,1.86641009797533
9.7,"random_policy_SVM","SVM",20,23,384,381,3,2400,2128,272,0.789289282531789,0.189655172413793,1.27280311457175,720,272,448,13,1.6,86.21,7.8,0,0,0,0,0,0,0.0404351265863411,10.4884881404536,8.1458417038238
9.7,"random_policy_SVM","SVM",20,24,284,283,1,2500,2226,274,0.803310560851129,0.21551724137931,1.27280311457175,726,274,452,6,1.6,89.8,8.1,0,0,0,0,0,0,0.00332486452614871,1.89418763704342,1.76830241008533
9.7,"random_policy_SVM","SVM",20,25,184,184,0,2600,2325,275,0.765648205654414,0.163793103448276,1.27280311457175,725,275,450,-1,1.6,93.39,8.5,0,0,0,0,0,0,0.000744496290765767,0.638953342614719,0.618643354537449
9.7,"random_policy_SVM","SVM",20,26,84,84,0,2700,2425,275,0.780682094348277,0.189655172413793,1.27280311457175,752,275,477,27,1.7,96.98,8.8,0,0,0,0,0,0,1.99425854077388e-07,0.0113126783125634,0.0113126783125634
9.7,"random_policy_SVM","SVM",20,27,0,0,0,2784,2509,275,0.786778008802954,0.172413793103448,1.27280311457175,723,275,448,-29,1.6,100,9.1,0,0,0,0,0,0,0,0,0
9.7,"random_policy_SVM","SVM",21,0,2684,2427,257,100,88,12,0.748416762327329,0.163934426229508,1.27334743521946,31,12,19,0,1.6,3.59,7.3,0,0,0,0,0,0,0.235434060533499,337.705542630389,27.4013953029033
9.7,"random_policy_SVM","SVM",21,1,2584,2356,228,200,159,41,0.759973429982845,0.139344262295082,1.25230037017451,97,41,56,66,1.4,7.18,3.9,0,0,0,0,0,0,0.23336312973485,471.365640771743,26.0631429177196
9.7,"random_policy_SVM","SVM",21,2,2484,2271,213,300,244,56,0.779223794353228,0.180327868852459,1.22072977260709,141,56,85,44,1.5,10.78,4.4,0,0,0,0,0,0,0.213479822201932,351.455184217133,25.0041452708793
9.7,"random_policy_SVM","SVM",21,3,2384,2186,198,400,329,71,0.799783312481461,0.286885245901639,1.24177683765204,175,71,104,34,1.5,14.37,4.6,0,0,0,0,0,0,0.206437828727319,271.253251689888,21.5489531615075
9.7,"random_policy_SVM","SVM",21,4,2284,2115,169,500,400,100,0.809766416014242,0.311475409836066,1.24177683765204,240,100,140,65,1.4,17.96,4,0,0,0,0,0,0,0.211883790919991,264.818871633454,21.5826859469038
9.7,"random_policy_SVM","SVM",21,5,2184,2052,132,600,463,137,0.806154957371896,0.295081967213115,1.24177683765204,321,137,184,81,1.3,21.55,3.4,0,0,0,0,0,0,0.239162667308,216.784093182008,24.6062985821145
9.7,"random_policy_SVM","SVM",21,6,2084,1972,112,700,543,157,0.805826056674112,0.319672131147541,1.24177683765204,367,157,210,46,1.3,25.14,3.5,0,0,0,0,0,0,0.22332166880617,187.734253548205,23.2575213530483
9.7,"random_policy_SVM","SVM",21,7,1984,1897,87,800,618,182,0.802601540029157,0.295081967213115,1.24177683765204,436,182,254,69,1.4,28.74,3.4,0,0,0,0,0,0,0.222938436775087,202.889882248339,23.1504522004011
9.7,"random_policy_SVM","SVM",21,8,1884,1811,73,900,704,196,0.786253240639232,0.295081967213115,1.22072977260709,480,196,284,44,1.4,32.33,3.6,0,0,0,0,0,0,0.205749726738375,175.748517095413,22.0492770783548
9.7,"random_policy_SVM","SVM",21,9,1784,1716,68,1000,799,201,0.786498303904251,0.30327868852459,1.22072977260709,488,201,287,8,1.4,35.92,4,0,0,0,0,0,0,0.174156315326153,141.369030345266,18.7852966557963
9.7,"random_policy_SVM","SVM",21,10,1684,1620,64,1100,895,205,0.794140408352795,0.286885245901639,1.24177683765204,497,205,292,9,1.4,39.51,4.4,0,0,0,0,0,0,0.145078360918412,112.690288560679,15.8068873083909
9.7,"random_policy_SVM","SVM",21,11,1584,1525,59,1200,990,210,0.797777663128305,0.286885245901639,1.24177683765204,512,210,302,15,1.4,43.1,4.7,0,0,0,0,0,0,0.130250621488428,83.8021827951727,15.4927590931794
9.7,"random_policy_SVM","SVM",21,12,1484,1433,51,1300,1082,218,0.800898995240624,0.286885245901639,1.24177683765204,542,218,324,30,1.5,46.7,5,0,0,0,0,0,0,0.0958541252668001,43.7970130874124,11.4334755207955
9.7,"random_policy_SVM","SVM",21,13,1384,1337,47,1400,1178,222,0.808553997755745,0.295081967213115,1.23125330512956,561,222,339,19,1.5,50.29,5.3,0,0,0,0,0,0,0.0906838370545344,40.2750314122132,11.2408516128219
9.7,"random_policy_SVM","SVM",21,14,1284,1245,39,1500,1270,230,0.818085668958233,0.336065573770492,1.22072977260709,595,230,365,34,1.6,53.88,5.5,0,0,0,0,0,0,0.102133872923462,47.2147323631146,11.7710488777404
9.7,"random_policy_SVM","SVM",21,15,1184,1150,34,1600,1365,235,0.785750216042623,0.204918032786885,1.22072977260709,610,235,375,15,1.6,57.47,5.8,0,0,0,0,0,0,0.128985644179201,81.7217454299646,13.6975457945746
9.7,"random_policy_SVM","SVM",21,16,1084,1052,32,1700,1463,237,0.804213798351633,0.221311475409836,1.22072977260709,614,237,377,4,1.6,61.06,6.2,0,0,0,0,0,0,0.0978579187538926,43.5290659337598,12.1154022053016
9.7,"random_policy_SVM","SVM",21,17,984,964,20,1800,1551,249,0.768002476428788,0.172131147540984,1.22072977260709,653,249,404,39,1.6,64.66,6.2,0,0,0,0,0,0,0.108982201366682,50.035917552074,13.3561788791524
9.7,"random_policy_SVM","SVM",21,18,884,867,17,1900,1648,252,0.779094813687433,0.19672131147541,1.22072977260709,675,252,423,22,1.7,68.25,6.5,0,0,0,0,0,0,0.0825464809020028,36.7606494092176,9.60610410949434
9.7,"random_policy_SVM","SVM",21,19,784,767,17,2000,1748,252,0.792734519095591,0.229508196721311,1.22072977260709,674,252,422,-1,1.7,71.84,6.9,0,0,0,0,0,0,0.0422125498075067,14.0574840954919,5.39636758544191
9.7,"random_policy_SVM","SVM",21,20,684,667,17,2100,1848,252,0.79012266061318,0.245901639344262,1.22072977260709,675,252,423,1,1.7,75.43,7.3,0,0,0,0,0,0,0.0154280356752269,4.6669293767052,2.57658297718585
9.7,"random_policy_SVM","SVM",21,21,584,570,14,2200,1945,255,0.743070513729994,0.172131147540984,1.22072977260709,672,255,417,-3,1.6,79.02,7.6,0,0,0,0,0,0,0.0397617893388048,12.6697804836722,5.58786958644066
9.7,"random_policy_SVM","SVM",21,22,484,471,13,2300,2044,256,0.753085862429221,0.155737704918033,1.22072977260709,686,256,430,14,1.7,82.61,8,0,0,0,0,0,0,0.0256984585010108,7.73420415720102,3.60153362550938
9.7,"random_policy_SVM","SVM",21,23,384,372,12,2400,2143,257,0.766970631102396,0.172131147540984,1.22072977260709,705,257,448,19,1.7,86.21,8.3,0,0,0,0,0,0,0.00535297808412661,1.40823005589367,1.05016007242885
9.7,"random_policy_SVM","SVM",21,24,284,275,9,2500,2240,260,0.794804658781655,0.229508196721311,1.23125330512956,693,260,433,-12,1.7,89.8,8.6,0,0,0,0,0,0,0.0309550681258781,7.65478062009467,4.27743849459953
9.7,"random_policy_SVM","SVM",21,25,184,178,6,2600,2337,263,0.774380570352507,0.163934426229508,1.23125330512956,708,263,445,15,1.7,93.39,8.9,0,0,0,0,0,0,0.00695981244079698,1.78057293420459,1.50986423245973
9.7,"random_policy_SVM","SVM",21,26,84,82,2,2700,2433,267,0.730939882111667,0.163934426229508,1.27334743521946,722,267,455,14,1.7,96.98,9.1,0,0,0,0,0,0,2.56428465851091e-08,0.686456836584583,0.686456836584583
9.7,"random_policy_SVM","SVM",21,27,0,0,0,2784,2515,269,0.785840502508674,0.163934426229508,1.28387096774194,746,269,477,24,1.8,100,9.3,0,0,0,0,0,0,0,0,0
9.7,"random_policy_SVM","SVM",22,0,2684,2424,260,100,93,7,0.604743384427669,0.193548387096774,1.10785639958377,24,7,17,0,2.4,3.59,13.3,0,0,0,0,0,0,0.0892993244461188,198.282328035358,9.20064411196073
9.7,"random_policy_SVM","SVM",22,1,2584,2346,238,200,171,29,0.666514146267065,0.129032258064516,1.20104058272633,90,29,61,66,2.1,7.18,5.9,0,0,0,0,0,0,0.190265952799241,319.01157637905,22.0829219977915
9.7,"random_policy_SVM","SVM",22,2,2484,2255,229,300,262,38,0.688159332977455,0.266129032258065,1.20104058272633,113,38,75,23,2,10.78,6.9,0,0,0,0,0,0,0.159989506913168,216.565015153898,18.3239219003758
9.7,"random_policy_SVM","SVM",22,3,2384,2177,207,400,340,60,0.74281883118534,0.225806451612903,1.24245577523413,158,60,98,45,1.6,14.37,5.7,0,0,0,0,0,0,0.163176944071123,256.862049054938,18.1456624033209
9.7,"random_policy_SVM","SVM",22,4,2284,2101,183,500,416,84,0.78862579119958,0.258064516129032,1.25280957336108,223,84,139,65,1.7,17.96,5,0,0,0,0,0,0,0.16998977394358,289.080613471559,17.7806853427615
9.7,"random_policy_SVM","SVM",22,5,2184,2031,153,600,486,114,0.806756653702442,0.241935483870968,1.25280957336108,283,114,169,60,1.5,21.55,4.3,0,0,0,0,0,0,0.194281309915712,271.470043691645,20.1128273561597
9.7,"random_policy_SVM","SVM",22,6,2084,1947,137,700,570,130,0.810245557843371,0.266129032258065,1.25280957336108,327,130,197,44,1.5,25.14,4.4,0,0,0,0,0,0,0.174438544861321,149.706192134344,18.734041188808
9.7,"random_policy_SVM","SVM",22,7,1984,1872,112,800,645,155,0.806890109052094,0.25,1.25280957336108,376,155,221,49,1.4,28.74,4.2,0,0,0,0,0,0,0.174613120878774,156.80351782683,18.1641592178091
9.7,"random_policy_SVM","SVM",22,8,1884,1795,89,900,722,178,0.828147639746824,0.290322580645161,1.24245577523413,435,178,257,59,1.4,32.33,4.1,0,0,0,0,0,0,0.173420430384558,117.832952710017,18.5439535553547
9.7,"random_policy_SVM","SVM",22,9,1784,1715,69,1000,802,198,0.830009659625316,0.274193548387097,1.24245577523413,482,198,284,47,1.4,35.92,4.1,0,0,0,0,0,0,0.172962057354922,111.882414925873,18.4338399396271
9.7,"random_policy_SVM","SVM",22,10,1684,1632,52,1100,885,215,0.835862629960097,0.225806451612903,1.24245577523413,528,215,313,46,1.5,39.51,4.1,0,0,0,0,0,0,0.176159421850584,119.461260876295,18.6509422873207
9.7,"random_policy_SVM","SVM",22,11,1584,1549,35,1200,968,232,0.844168636721833,0.274193548387097,1.24245577523413,583,232,351,55,1.5,43.1,4.2,0,0,0,0,0,0,0.157582379112035,86.4349523744337,17.5856121900567
9.7,"random_policy_SVM","SVM",22,12,1484,1460,24,1300,1057,243,0.840450951981496,0.314516129032258,1.24245577523413,605,243,362,22,1.5,46.7,4.3,0,0,0,0,0,0,0.126225072865826,47.5974191505341,15.1628293564667
9.7,"random_policy_SVM","SVM",22,13,1384,1363,21,1400,1154,246,0.84414321665523,0.32258064516129,1.24245577523413,632,246,386,27,1.6,50.29,4.7,0,0,0,0,0,0,0.134886066391721,79.7778220325829,14.8988980843616
9.7,"random_policy_SVM","SVM",22,14,1284,1266,18,1500,1251,249,0.828459035562675,0.282258064516129,1.23210197710718,657,249,408,25,1.6,53.88,5,0,0,0,0,0,0,0.130528493860237,64.5444019720924,14.7410904243715
9.7,"random_policy_SVM","SVM",22,15,1184,1169,15,1600,1348,252,0.757263784031114,0.145161290322581,1.23210197710718,650,252,398,-7,1.6,57.47,5.3,0,0,0,0,0,0,0.140018787590611,76.5167937702576,27.3075997955388
9.7,"random_policy_SVM","SVM",22,16,1084,1069,15,1700,1448,252,0.818545209588451,0.25,1.23210197710718,645,252,393,-5,1.6,61.06,5.7,0,0,0,0,0,0,0.0959064956078343,40.4843676422435,11.414049372904
9.7,"random_policy_SVM","SVM",22,17,984,969,15,1800,1548,252,0.825834413686164,0.290322580645161,1.23210197710718,674,252,422,29,1.7,64.66,6.1,0,0,0,0,0,0,0.0625801181843464,21.74333683364,7.93605724258293
9.7,"random_policy_SVM","SVM",22,18,884,869,15,1900,1648,252,0.821932433462978,0.274193548387097,1.23210197710718,665,252,413,-9,1.6,68.25,6.5,0,0,0,0,0,0,0.0421227287682367,13.1176232008276,5.62392020785531
9.7,"random_policy_SVM","SVM",22,19,784,770,14,2000,1747,253,0.801240499250112,0.233870967741935,1.23210197710718,659,253,406,-6,1.6,71.84,6.9,0,0,0,0,0,0,0.0143016254943191,4.81496404008014,2.88021886900599
9.7,"random_policy_SVM","SVM",22,20,684,670,14,2100,1847,253,0.824862096138695,0.314516129032258,1.23210197710718,661,253,408,2,1.6,75.43,7.3,0,0,0,0,0,0,0.0162426909619533,4.95868014480982,2.44203994257802
9.7,"random_policy_SVM","SVM",22,21,584,571,13,2200,1946,254,0.824449020056434,0.314516129032258,1.22174817898023,661,254,407,0,1.6,79.02,7.7,0,0,0,0,0,0,0.00908097542907316,3.58816998674323,2.68801044441067
9.7,"random_policy_SVM","SVM",22,22,484,471,13,2300,2046,254,0.822866620910548,0.258064516129032,1.22174817898023,677,254,423,16,1.7,82.61,8.1,0,0,0,0,0,0,0.00253030021321459,0.806601444950324,0.624539428367557
9.7,"random_policy_SVM","SVM",22,23,384,373,11,2400,2144,256,0.770819034545879,0.169354838709677,1.22174817898023,684,256,428,7,1.7,86.21,8.4,0,0,0,0,0,0,0.0263103766884698,8.45114893585769,6.68935167899193
9.7,"random_policy_SVM","SVM",22,24,284,273,11,2500,2244,256,0.801761610615426,0.233870967741935,1.22174817898023,694,256,438,10,1.7,89.8,8.8,0,0,0,0,0,0,0.00357755165963674,1.56201327391473,1.37375091805428
9.7,"random_policy_SVM","SVM",22,25,184,176,8,2600,2341,259,0.777396476778774,0.201612903225806,1.25280957336108,707,259,448,13,1.7,93.39,9,0,0,0,0,0,0,0.0124240158713567,3.08906935062,2.6990032014644
9.7,"random_policy_SVM","SVM",22,26,84,82,2,2700,2435,265,0.842351101959893,0.290322580645161,1.26316337148803,738,265,473,31,1.8,96.98,9.2,0,0,0,0,0,0,1.29611620754144e-05,1.19654402262296,1.19654402262296
9.7,"random_policy_SVM","SVM",22,27,0,0,0,2784,2517,267,0.704301075268819,0.137096774193548,1.27351716961498,730,267,463,-8,1.7,100,9.4,0,0,0,0,0,0,0,0,0
9.7,"random_policy_SVM","SVM",23,0,2684,2445,239,100,86,14,0.578093423407817,0.123188405797101,1.1164095371669,33,14,19,0,1.4,3.59,6.1,0,0,0,0,0,0,0.180977851696623,294.994491374387,36.1257215369034
9.7,"random_policy_SVM","SVM",23,1,2584,2362,222,200,169,31,0.736659160459616,0.13768115942029,1.26526414212249,86,31,55,53,1.8,7.18,5.5,0,0,0,0,0,0,0.220620295415746,267.979600225087,27.8933048034998
9.7,"random_policy_SVM","SVM",23,2,2484,2278,206,300,253,47,0.682833881863855,0.231884057971014,1.13501636278635,118,47,71,32,1.5,10.78,5.4,0,0,0,0,0,0,0.171893099587391,296.970280044703,18.4125951673715
9.7,"random_policy_SVM","SVM",23,3,2384,2204,180,400,327,73,0.787649402390439,0.333333333333333,1.22805049088359,178,73,105,60,1.4,14.37,4.5,0,0,0,0,0,0,0.211059423337769,257.031320950451,22.6480294689642
9.7,"random_policy_SVM","SVM",23,4,2284,2134,150,500,397,103,0.793469599861424,0.304347826086957,1.25596072931276,243,103,140,65,1.4,17.96,3.9,0,0,0,0,0,0,0.231741178904431,226.35765017164,24.0674493996594
9.7,"random_policy_SVM","SVM",23,5,2184,2055,129,600,476,124,0.796570240776025,0.289855072463768,1.25596072931276,295,124,171,52,1.4,21.55,3.8,0,0,0,0,0,0,0.218720881210663,160.308474277758,22.5863727986877
9.7,"random_policy_SVM","SVM",23,6,2084,1981,103,700,550,150,0.797800103932097,0.27536231884058,1.24665731650304,349,150,199,54,1.3,25.14,3.7,0,0,0,0,0,0,0.215572807757799,120.527727744552,22.4936565315142
9.7,"random_policy_SVM","SVM",23,7,1984,1896,88,800,635,165,0.796414342629482,0.297101449275362,1.22805049088359,391,165,226,42,1.4,28.74,3.8,0,0,0,0,0,0,0.209884314100721,156.990243602987,21.5533595686739
9.7,"random_policy_SVM","SVM",23,8,1884,1814,70,900,717,183,0.794231768577863,0.27536231884058,1.22805049088359,428,183,245,37,1.3,32.33,3.9,0,0,0,0,0,0,0.194240820757155,132.322498946593,20.1114943350598
9.7,"random_policy_SVM","SVM",23,9,1784,1733,51,1000,798,202,0.787297188059359,0.253623188405797,1.22805049088359,473,202,271,45,1.3,35.92,4,0,0,0,0,0,0,0.177113963895878,106.942260577153,18.905053045867
9.7,"random_policy_SVM","SVM",23,10,1684,1651,33,1100,880,220,0.789098677752763,0.268115942028986,1.20944366526414,525,220,305,52,1.4,39.51,4,0,0,0,0,0,0,0.166536581167561,88.9633870869179,18.4335169992481
9.7,"random_policy_SVM","SVM",23,11,1584,1562,22,1200,969,231,0.788036260754092,0.282608695652174,1.20014025245442,542,231,311,17,1.3,43.1,4.2,0,0,0,0,0,0,0.16609546842933,99.9228974625083,17.9471367223314
9.7,"random_policy_SVM","SVM",23,12,1484,1470,14,1300,1061,239,0.782406605462217,0.268115942028986,1.19083683964469,578,239,339,36,1.4,46.7,4.4,0,0,0,0,0,0,0.180500750963239,129.096236257698,18.803510682868
9.7,"random_policy_SVM","SVM",23,13,1384,1370,14,1400,1161,239,0.767965817887877,0.239130434782609,1.20014025245442,583,239,344,5,1.4,50.29,4.9,0,0,0,0,0,0,0.149033420183779,71.1580375977521,15.97524714721
9.7,"random_policy_SVM","SVM",23,14,1284,1270,14,1500,1261,239,0.765194295282646,0.231884057971014,1.20014025245442,595,239,356,12,1.5,53.88,5.3,0,0,0,0,0,0,0.110430053292069,38.5251138324026,12.4182440667234
9.7,"random_policy_SVM","SVM",23,15,1184,1171,13,1600,1360,240,0.789826202436639,0.289855072463768,1.20014025245442,593,240,353,-2,1.5,57.47,5.7,0,0,0,0,0,0,0.119985056100378,56.4856911806456,12.7861594134254
9.7,"random_policy_SVM","SVM",23,16,1084,1071,13,1700,1460,240,0.784612275535548,0.27536231884058,1.20014025245442,591,240,351,-2,1.5,61.06,6.1,0,0,0,0,0,0,0.0761496710918594,23.5932871363576,8.71066951315559
9.7,"random_policy_SVM","SVM",23,17,984,972,12,1800,1559,241,0.777048328425437,0.246376811594203,1.20944366526414,613,241,372,22,1.5,64.66,6.5,0,0,0,0,0,0,0.0975636366966925,22.6184691159292,12.5638330056532
9.7,"random_policy_SVM","SVM",23,18,884,872,12,1900,1659,241,0.747133206305219,0.22463768115942,1.20944366526414,604,241,363,-9,1.5,68.25,6.9,0,0,0,0,0,0,0.0373994001878941,7.67156408074465,6.48154743003239
9.7,"random_policy_SVM","SVM",23,19,784,773,11,2000,1758,242,0.79102719556557,0.27536231884058,1.20944366526414,622,242,380,18,1.6,71.84,7.3,0,0,0,0,0,0,0.00256533711046685,2.67616706727008,2.49383091719484
9.7,"random_policy_SVM","SVM",23,20,684,677,7,2100,1854,246,0.76278076101392,0.210144927536232,1.20944366526414,626,246,380,4,1.5,75.43,7.5,0,0,0,0,0,0,0.0024173431435513,1.02892835105298,0.690734577130254
9.7,"random_policy_SVM","SVM",23,21,584,580,4,2200,1951,249,0.736347364166523,0.181159420289855,1.22805049088359,650,249,401,24,1.6,79.02,7.8,0,0,0,0,0,0,0.107544001700639,36.1191535064661,13.0085357839316
9.7,"random_policy_SVM","SVM",23,22,484,480,4,2300,2051,249,0.737502165252036,0.166666666666667,1.22805049088359,651,249,402,1,1.6,82.61,8.2,0,0,0,0,0,0,0.0562717403777284,14.4358170005302,7.42960153954026
9.7,"random_policy_SVM","SVM",23,23,384,381,3,2400,2150,250,0.788463537155726,0.246376811594203,1.23735390369331,646,250,396,-5,1.6,86.21,8.6,0,0,0,0,0,0,0.0646275840193384,17.5515777912518,8.92712311855533
9.7,"random_policy_SVM","SVM",23,24,284,281,3,2500,2250,250,0.786517697326637,0.217391304347826,1.24665731650304,648,250,398,2,1.6,89.8,9,0,0,0,0,0,0,0.0294633605661381,7.41554904851161,4.91999534656417
9.7,"random_policy_SVM","SVM",23,25,184,184,0,2600,2347,253,0.819631618453724,0.297101449275362,1.25596072931276,669,253,416,21,1.6,93.39,9.3,0,0,0,0,0,0,0.00677325013086742,2.23690568078235,1.98056052150103
9.7,"random_policy_SVM","SVM",23,26,84,84,0,2700,2447,253,0.784121485074198,0.173913043478261,1.26526414212249,667,253,414,-2,1.6,96.98,9.7,0,0,0,0,0,0,0.000241705974248053,0.309216581435863,0.309216581435863
9.7,"random_policy_SVM","SVM",23,27,0,0,0,2784,2531,253,0.775142906634333,0.217391304347826,1.25596072931276,672,253,419,5,1.7,100,10,0,0,0,0,0,0,0,0,0
9.7,"random_policy_SVM","SVM",24,0,2684,2448,236,100,86,14,0.835474588176653,0.340425531914894,1.27476549988561,38,14,24,0,1.7,3.59,6.1,0,0,0,0,0,0,0.316951063565,329.056064919568,36.5525314066679
9.7,"random_policy_SVM","SVM",24,1,2584,2367,217,200,167,33,0.838884734778962,0.354609929078014,1.25655456417296,84,33,51,46,1.5,7.18,5.1,0,0,0,0,0,0,0.208513596221177,322.409749396493,22.16582863375
9.7,"random_policy_SVM","SVM",24,2,2484,2290,194,300,244,56,0.723234314458568,0.170212765957447,1.21102722489133,148,56,92,64,1.6,10.78,4.4,0,0,0,0,0,0,0.239838652970194,355.471081631385,27.9016934427421
9.7,"random_policy_SVM","SVM",24,3,2384,2199,185,400,335,65,0.85043504860309,0.382978723404255,1.27476549988561,165,65,100,17,1.5,14.37,5.2,0,0,0,0,0,0,0.216696826328837,217.30344010306,22.7369061511725
9.7,"random_policy_SVM","SVM",24,4,2284,2126,158,500,408,92,0.847138195907829,0.354609929078014,1.27476549988561,228,92,136,63,1.5,17.96,4.4,0,0,0,0,0,0,0.202063821484216,272.482482874788,20.4500317622321
9.7,"random_policy_SVM","SVM",24,5,2184,2043,141,600,491,109,0.845546416513724,0.361702127659574,1.26566003202928,264,109,155,36,1.4,21.55,4.5,0,0,0,0,0,0,0.205837489225848,145.379168022404,21.3568368030375
9.7,"random_policy_SVM","SVM",24,6,2084,1972,112,700,562,138,0.835066730111256,0.340425531914894,1.26566003202928,335,138,197,71,1.4,25.14,4.1,0,0,0,0,0,0,0.201396806867022,188.613042223449,20.797292684319
9.7,"random_policy_SVM","SVM",24,7,1984,1899,85,800,635,165,0.828858224004717,0.283687943262411,1.26566003202928,405,165,240,70,1.5,28.74,3.8,0,0,0,0,0,0,0.18653445234558,133.637487093879,20.7248103724929
9.7,"random_policy_SVM","SVM",24,8,1884,1824,60,900,710,190,0.829702263612266,0.354609929078014,1.26566003202928,462,190,272,57,1.4,32.33,3.7,0,0,0,0,0,0,0.204799165531917,247.419973304547,21.329343433535
9.7,"random_policy_SVM","SVM",24,9,1784,1735,49,1000,799,201,0.81683774046632,0.283687943262411,1.28387096774194,490,201,289,28,1.4,35.92,4,0,0,0,0,0,0,0.189867695304712,120.75584267821,26.7920025995341
9.7,"random_policy_SVM","SVM",24,10,1684,1642,42,1100,892,208,0.796427843110599,0.304964539007092,1.23834362846031,518,208,310,28,1.5,39.51,4.3,0,0,0,0,0,0,0.1674773356181,129.545974040255,18.6109777898295
9.7,"random_policy_SVM","SVM",24,11,1584,1547,37,1200,987,213,0.793125325719983,0.297872340425532,1.25655456417296,528,213,315,10,1.5,43.1,4.6,0,0,0,0,0,0,0.173564115656198,124.931822603267,19.1296183726875
9.7,"random_policy_SVM","SVM",24,12,1484,1450,34,1300,1084,216,0.79436589400222,0.24822695035461,1.26566003202928,533,216,317,5,1.5,46.7,5,0,0,0,0,0,0,0.119818210839008,45.9231826115197,14.3372091898895
9.7,"random_policy_SVM","SVM",24,13,1384,1356,28,1400,1178,222,0.788978768721818,0.25531914893617,1.22923816060398,549,222,327,16,1.5,50.29,5.3,0,0,0,0,0,0,0.100782444873554,38.6598777783645,13.1874501409809
9.7,"random_policy_SVM","SVM",24,14,1284,1263,21,1500,1271,229,0.794881381279314,0.297872340425532,1.22923816060398,579,229,350,30,1.5,53.88,5.6,0,0,0,0,0,0,0.12109376731234,50.1683680715334,14.3818245718873
9.7,"random_policy_SVM","SVM",24,15,1184,1171,13,1600,1363,237,0.755987582987787,0.191489361702128,1.201921757035,595,237,358,16,1.5,57.47,5.8,0,0,0,0,0,0,0.126167588232419,51.4410941145903,14.9368505495284
9.7,"random_policy_SVM","SVM",24,16,1084,1073,11,1700,1461,239,0.767787143407431,0.191489361702128,1.19281628917868,611,239,372,16,1.6,61.06,6.1,0,0,0,0,0,0,0.129023612871862,75.8040857852958,13.9532566113907
9.7,"random_policy_SVM","SVM",24,17,984,973,11,1800,1561,239,0.741531280447739,0.163120567375887,1.19281628917868,612,239,373,1,1.6,64.66,6.5,0,0,0,0,0,0,0.0927254955755952,40.5020242876224,10.6775369117245
9.7,"random_policy_SVM","SVM",24,18,884,874,10,1900,1660,240,0.714454036661912,0.148936170212766,1.17460535346603,619,240,379,7,1.6,68.25,6.9,0,0,0,0,0,0,0.115039440195145,39.9852692468626,14.0931986481334
9.7,"random_policy_SVM","SVM",24,19,784,774,10,2000,1760,240,0.740018806788577,0.191489361702128,1.17460535346603,608,240,368,-11,1.5,71.84,7.3,0,0,0,0,0,0,0.0871715476819113,34.0357278300556,10.1186904352879
9.7,"random_policy_SVM","SVM",24,20,684,674,10,2100,1860,240,0.735113180613152,0.163120567375887,1.17460535346603,616,240,376,8,1.6,75.43,7.8,0,0,0,0,0,0,0.057651978424527,18.9377702937394,7.22971886157481
9.7,"random_policy_SVM","SVM",24,21,584,576,8,2200,1958,242,0.721251671085133,0.156028368794326,1.17460535346603,635,242,393,19,1.6,79.02,8.1,0,0,0,0,0,0,0.0574887162540888,19.4383626980443,7.3961177048596
9.7,"random_policy_SVM","SVM",24,22,484,476,8,2300,2058,242,0.719846826637667,0.184397163120567,1.17460535346603,634,242,392,-1,1.6,82.61,8.5,0,0,0,0,0,0,0.011928051211854,3.17409605453849,2.0224691256996
9.7,"random_policy_SVM","SVM",24,23,384,378,6,2400,2156,244,0.724197312668523,0.148936170212766,1.201921757035,639,244,395,5,1.6,86.21,8.8,0,0,0,0,0,0,0.0255857176116726,7.11928268096456,3.97612964246489
9.7,"random_policy_SVM","SVM",24,24,284,281,3,2500,2253,247,0.772885369224842,0.198581560283688,1.23834362846031,657,247,410,18,1.7,89.8,9.1,0,0,0,0,0,0,0.0424845569933078,13.4935687414871,9.91884186716387
9.7,"random_policy_SVM","SVM",24,25,184,181,3,2600,2353,247,0.714255772324562,0.156028368794326,1.22923816060398,664,247,417,7,1.7,93.39,9.5,0,0,0,0,0,0,0.011644981390553,2.63619980020194,2.15684338411193
9.7,"random_policy_SVM","SVM",24,26,84,83,1,2700,2451,249,0.751263227063647,0.191489361702128,1.26566003202928,668,249,419,4,1.7,96.98,9.8,0,0,0,0,0,0,6.38178469500503e-06,1.19409542197609,1.19409542197609
9.7,"random_policy_SVM","SVM",24,27,0,0,0,2784,2534,250,0.759363741417988,0.219858156028369,1.27476549988561,675,250,425,7,1.7,100,10.1,0,0,0,0,0,0,0,0,0
9.7,"random_policy_SVM","SVM",25,0,2684,2430,254,100,88,12,0.813943217665624,0.336,1.20170322580645,29,12,17,0,1.4,3.59,7.3,0,0,0,0,0,0,0.32114626399617,316.509080911727,35.3364925230176
9.7,"random_policy_SVM","SVM",25,1,2584,2374,210,200,144,56,0.787690851735021,0.304,1.19143225806452,120,56,64,91,1.1,7.18,2.6,0,0,0,0,0,0,0.345606585030556,580.993656369882,36.6877682036828
9.7,"random_policy_SVM","SVM",25,2,2484,2312,172,300,206,94,0.832750788643534,0.336,1.26332903225806,198,94,104,78,1.1,10.78,2.2,0,0,0,0,0,0,0.331896480057276,507.921697580009,35.8340036526811
9.7,"random_policy_SVM","SVM",25,3,2384,2236,148,400,282,118,0.784170347003153,0.216,1.24278709677419,260,118,142,62,1.2,14.37,2.4,0,0,0,0,0,0,0.299215621581536,554.766679489455,31.0155963823997
9.7,"random_policy_SVM","SVM",25,4,2284,2147,137,500,371,129,0.782839116719256,0.256,1.25305806451613,291,129,162,31,1.3,17.96,2.9,0,0,0,0,0,0,0.28912125971702,311.544774081621,32.7143533258559
9.7,"random_policy_SVM","SVM",25,5,2184,2063,121,600,455,145,0.817186119873833,0.28,1.25305806451613,329,145,184,38,1.3,21.55,3.1,0,0,0,0,0,0,0.256401970762283,194.86984546425,26.1004409945729
9.7,"random_policy_SVM","SVM",25,6,2084,1990,94,700,528,172,0.815331230283925,0.28,1.26332903225806,394,172,222,65,1.3,25.14,3.1,0,0,0,0,0,0,0.23510061100202,123.415524880655,25.3953628880749
9.7,"random_policy_SVM","SVM",25,7,1984,1910,74,800,608,192,0.804302839116728,0.288,1.25190423572744,446,192,254,52,1.3,28.74,3.2,0,0,0,0,0,0,0.172692110625494,70.2183706551918,20.1150920820224
9.7,"random_policy_SVM","SVM",25,8,1884,1821,63,900,697,203,0.786662460567829,0.288,1.23251612903226,473,203,270,27,1.3,32.33,3.4,0,0,0,0,0,0,0.198461899264796,101.516438320822,20.5494900047964
9.7,"random_policy_SVM","SVM",25,9,1784,1723,61,1000,795,205,0.829785488958996,0.24,1.2736,482,205,277,9,1.4,35.92,3.9,0,0,0,0,0,0,0.122210083492254,28.5580835073867,16.8193569627758
9.7,"random_policy_SVM","SVM",25,10,1684,1633,51,1100,885,215,0.825652996845434,0.264,1.2736,522,215,307,40,1.4,39.51,4.1,0,0,0,0,0,0,0.109073568122947,29.864202997562,16.4041247102591
9.7,"random_policy_SVM","SVM",25,11,1584,1547,37,1200,971,229,0.821946372239753,0.264,1.26332903225806,557,229,328,35,1.4,43.1,4.2,0,0,0,0,0,0,0.0825793576888514,21.742589995316,12.6314751475096
9.7,"random_policy_SVM","SVM",25,12,1484,1450,34,1300,1068,232,0.810782334384861,0.24,1.25305806451613,567,232,335,10,1.4,46.7,4.6,0,0,0,0,0,0,0.0785358979572614,25.1987151465386,12.2938462826047
9.7,"random_policy_SVM","SVM",25,13,1384,1352,32,1400,1166,234,0.805709779179821,0.24,1.2736,574,234,340,7,1.5,50.29,5,0,0,0,0,0,0,0.0472106365046206,16.5696818288154,11.8505539285036
9.7,"random_policy_SVM","SVM",25,14,1284,1258,26,1500,1260,240,0.805621451104108,0.232,1.2736,585,240,345,11,1.4,53.88,5.2,0,0,0,0,0,0,0.0878999707958829,27.6124572586185,16.7327220427118
9.7,"random_policy_SVM","SVM",25,15,1184,1160,24,1600,1358,242,0.793406940063099,0.24,1.26332903225806,612,242,370,27,1.5,57.47,5.6,0,0,0,0,0,0,0.0486506875348019,12.5207738221008,8.02387936546833
9.7,"random_policy_SVM","SVM",25,16,1084,1061,23,1700,1457,243,0.786227129337548,0.2,1.2736,614,243,371,2,1.5,61.06,6,0,0,0,0,0,0,0.0206152349670496,5.76200341945219,3.57366290300272
9.7,"random_policy_SVM","SVM",25,17,984,966,18,1800,1552,248,0.783324921135658,0.192,1.2736,659,248,411,45,1.7,64.66,6.3,0,0,0,0,0,0,0.0957499899496153,32.3556682294942,18.6353499683023
9.7,"random_policy_SVM","SVM",25,18,884,867,17,1900,1651,249,0.808056782334392,0.224,1.2736,655,249,406,-4,1.6,68.25,6.6,0,0,0,0,0,0,0.0730130029572517,23.763640783236,10.2543254749815
9.7,"random_policy_SVM","SVM",25,19,784,775,9,2000,1743,257,0.759211356466876,0.192,1.28387096774194,686,257,429,31,1.7,71.84,6.8,0,0,0,0,0,0,0.110316382121278,35.5993710325942,17.0806600287999
9.7,"random_policy_SVM","SVM",25,20,684,679,5,2100,1839,261,0.704378548895897,0.12,1.28387096774194,720,261,459,34,1.8,75.43,7,0,0,0,0,0,0,0.164954297002886,57.7696184600813,21.6241735771174
9.7,"random_policy_SVM","SVM",25,21,584,580,4,2200,1938,262,0.75152050473186,0.168,1.28387096774194,720,262,458,0,1.7,79.02,7.4,0,0,0,0,0,0,0.0982250130357484,29.803869286669,12.5530674909729
9.7,"random_policy_SVM","SVM",25,22,484,482,2,2300,2036,264,0.811810725552052,0.216,1.28387096774194,731,264,467,11,1.8,82.61,7.7,0,0,0,0,0,0,0.0327146298237034,8.50693349765405,5.37340892074797
9.7,"random_policy_SVM","SVM",25,23,384,382,2,2400,2136,264,0.73548264984227,0.144,1.28387096774194,723,264,459,-8,1.7,86.21,8.1,0,0,0,0,0,0,0.0200178737734084,5.70334859705158,4.06890474117795
9.7,"random_policy_SVM","SVM",25,24,284,283,1,2500,2235,265,0.768548895899055,0.192,1.28387096774194,738,265,473,15,1.8,89.8,8.4,0,0,0,0,0,0,0.0102464486736692,5.13149645127812,4.64241453031616
9.7,"random_policy_SVM","SVM",25,25,184,184,0,2600,2334,266,0.780309148264984,0.232,1.2736,727,266,461,-11,1.7,93.39,8.8,0,0,0,0,0,0,0.00164818275590338,1.13698651501091,1.09390098190971
9.7,"random_policy_SVM","SVM",25,26,84,84,0,2700,2434,266,0.798927444794956,0.264,1.28387096774194,735,266,469,8,1.8,96.98,9.2,0,0,0,0,0,0,1.0000000994736e-07,0.0684322781709841,0.0684322781709841
9.7,"random_policy_SVM","SVM",25,27,0,0,0,2784,2518,266,0.751520504731866,0.184,1.2736,738,266,472,3,1.8,100,9.5,0,0,0,0,0,0,0,0,0
9.7,"random_policy_SVM","SVM",26,0,2684,2422,262,100,90,10,0.831068691212756,0.361344537815126,1.24071564109515,28,10,18,0,1.8,3.59,9,0,0,0,0,0,0,0.226464990463438,241.189537199361,24.6187433604977
9.7,"random_policy_SVM","SVM",26,1,2584,2359,225,200,153,47,0.791927760115041,0.159663865546218,1.25150447275684,107,47,60,79,1.3,7.18,3.3,0,0,0,0,0,0,0.296245621061726,468.18370522734,35.1402693431048
9.7,"random_policy_SVM","SVM",26,2,2484,2275,209,300,237,63,0.804262364286379,0.361344537815126,1.17598265112497,153,63,90,46,1.4,10.78,3.8,0,0,0,0,0,0,0.252310497471581,337.715881838245,26.0548952914597
9.7,"random_policy_SVM","SVM",26,3,2384,2207,177,400,305,95,0.785015104943081,0.34453781512605,1.13282732447818,230,95,135,77,1.4,14.37,3.2,0,0,0,0,0,0,0.266285549419065,300.591284311166,27.5128563139422
9.7,"random_policy_SVM","SVM",26,4,2284,2129,155,500,383,117,0.769745260741661,0.285714285714286,1.14361615613988,284,117,167,54,1.4,17.96,3.3,0,0,0,0,0,0,0.254763232955949,278.731979037716,27.0373564866158
9.7,"random_policy_SVM","SVM",26,5,2184,2046,138,600,466,134,0.799955146893925,0.252100840336134,1.22992680943345,330,134,196,46,1.5,21.55,3.5,0,0,0,0,0,0,0.230479065644932,233.30375885592,23.9734517406318
9.7,"random_policy_SVM","SVM",26,6,2084,1983,101,700,529,171,0.789718085036221,0.252100840336134,1.21913797777175,410,171,239,80,1.4,25.14,3.1,0,0,0,0,0,0,0.251562793531066,226.09488052113,38.3576547247737
9.7,"random_policy_SVM","SVM",26,7,1984,1899,85,800,613,187,0.790087463556854,0.302521008403361,1.22992680943345,444,187,257,34,1.4,28.74,3.3,0,0,0,0,0,0,0.229247051099865,239.640554667898,25.146603095637
9.7,"random_policy_SVM","SVM",26,8,1884,1809,75,900,703,197,0.800331121459576,0.336134453781513,1.22992680943345,473,197,276,29,1.4,32.33,3.6,0,0,0,0,0,0,0.196162006977523,137.316926711562,21.3324697369803
9.7,"random_policy_SVM","SVM",26,9,1784,1718,66,1000,794,206,0.784612746197383,0.302521008403361,1.20834914611006,507,206,301,34,1.5,35.92,3.9,0,0,0,0,0,0,0.177071632036792,145.833285727601,19.128304897303
9.7,"random_policy_SVM","SVM",26,10,1684,1631,53,1100,881,219,0.779626136168755,0.210084033613445,1.20834914611006,550,219,331,43,1.5,39.51,4,0,0,0,0,0,0,0.171773015019255,145.104293730463,18.5036516258912
9.7,"random_policy_SVM","SVM",26,11,1584,1542,42,1200,970,230,0.795766658311678,0.336134453781513,1.19756031444836,580,230,350,30,1.5,43.1,4.2,0,0,0,0,0,0,0.158755045528769,99.4246564238667,17.7255619188568
9.7,"random_policy_SVM","SVM",26,12,1484,1455,29,1300,1057,243,0.792165217735451,0.285714285714286,1.17598265112497,628,243,385,48,1.6,46.7,4.3,0,0,0,0,0,0,0.170689710851661,139.83910178962,17.9884532854981
9.7,"random_policy_SVM","SVM",26,13,1384,1361,23,1400,1151,249,0.77893355144256,0.277310924369748,1.16519381946327,646,249,397,18,1.6,50.29,4.6,0,0,0,0,0,0,0.170392322114267,188.779283635986,17.3761979758311
9.7,"random_policy_SVM","SVM",26,14,1284,1267,17,1500,1245,255,0.781037689801201,0.294117647058824,1.17598265112497,648,255,393,2,1.5,53.88,4.9,0,0,0,0,0,0,0.0947379054920784,42.8899418224846,11.5898655851206
9.7,"random_policy_SVM","SVM",26,15,1184,1168,16,1600,1344,256,0.787178607706823,0.310924369747899,1.17598265112497,662,256,406,14,1.6,57.47,5.2,0,0,0,0,0,0,0.114566499585195,76.707972364371,12.4798396925364
9.7,"random_policy_SVM","SVM",26,16,1084,1069,15,1700,1443,257,0.791360500244057,0.319327731092437,1.18677148278666,662,257,405,0,1.6,61.06,5.6,0,0,0,0,0,0,0.111062192752152,81.6184029396153,11.8384083759773
9.7,"random_policy_SVM","SVM",26,17,984,971,13,1800,1541,259,0.753169399627986,0.218487394957983,1.16519381946327,665,259,406,3,1.6,64.66,5.9,0,0,0,0,0,0,0.0997096049676745,40.9102338331159,17.5090779476498
9.7,"random_policy_SVM","SVM",26,18,884,871,13,1900,1641,259,0.750590346028525,0.176470588235294,1.16519381946327,676,259,417,11,1.6,68.25,6.3,0,0,0,0,0,0,0.0681894549021935,30.8413797762469,8.16989979856875
9.7,"random_policy_SVM","SVM",26,19,784,773,11,2000,1739,261,0.787943748928144,0.310924369747899,1.19756031444836,699,261,438,23,1.7,71.84,6.7,0,0,0,0,0,0,0.0137782538805789,5.24073831562116,3.02183093990787
9.7,"random_policy_SVM","SVM",26,20,684,675,9,2100,1837,263,0.806755669300689,0.327731092436975,1.22992680943345,694,263,431,-5,1.6,75.43,7,0,0,0,0,0,0,0.00741754246170918,2.82142892678873,1.70406527988184
9.7,"random_policy_SVM","SVM",26,21,584,578,6,2200,1934,266,0.798292943551053,0.235294117647059,1.25150447275684,710,266,444,16,1.7,79.02,7.3,0,0,0,0,0,0,0.0599200821357111,21.1800826000043,7.61909602684637
9.7,"random_policy_SVM","SVM",26,22,484,483,1,2300,2029,271,0.83389839452265,0.352941176470588,1.26229330441854,749,271,478,39,1.8,82.61,7.5,0,0,0,0,0,0,0.00842331858124677,4.2397359468084,3.52477482837262
9.7,"random_policy_SVM","SVM",26,23,384,384,0,2400,2128,272,0.780364893210036,0.176470588235294,1.26229330441854,725,272,453,-24,1.7,86.21,7.8,0,0,0,0,0,0,0.0319949082591629,8.84898598076332,4.58452530204154
9.7,"random_policy_SVM","SVM",26,24,284,284,0,2500,2228,272,0.821563790351311,0.294117647058824,1.26229330441854,744,272,472,19,1.7,89.8,8.2,0,0,0,0,0,0,0.000274316728461349,0.220427405656627,0.209913053189151
9.7,"random_policy_SVM","SVM",26,25,184,184,0,2600,2328,272,0.784118042821529,0.168067226890756,1.26229330441854,745,272,473,1,1.7,93.39,8.6,0,0,0,0,0,0,0.00613261052253114,1.77771567856908,1.39912960426478
9.7,"random_policy_SVM","SVM",26,26,84,84,0,2700,2428,272,0.817929369550025,0.252100840336134,1.26229330441854,753,272,481,8,1.8,96.98,8.9,0,0,0,0,0,0,1.45904837131812e-05,0.0620843494826674,0.0620843494826674
9.7,"random_policy_SVM","SVM",26,27,0,0,0,2784,2512,272,0.823509623629676,0.302521008403361,1.26229330441854,732,272,460,-21,1.7,100,9.2,0,0,0,0,0,0,0,0,0
9.7,"random_policy_SVM","SVM",27,0,2684,2437,247,100,90,10,0.811328583452874,0.328358208955224,1.2263842079923,28,10,18,0,1.8,3.59,9,0,0,0,0,0,0,0.162386059357641,310.308061663603,17.4113007074869
9.7,"random_policy_SVM","SVM",27,1,2584,2376,208,200,151,49,0.775994926084431,0.246268656716418,1.21680308136736,105,49,56,77,1.1,7.18,3.1,0,0,0,0,0,0,0.294316040860626,424.199658542894,32.2711406084616
9.7,"random_policy_SVM","SVM",27,2,2484,2305,179,300,222,78,0.719221604447983,0.216417910447761,1.11141068849302,173,78,95,68,1.2,10.78,2.8,0,0,0,0,0,0,0.287156968485757,411.722157893543,49.0085118977422
9.7,"random_policy_SVM","SVM",27,3,2384,2220,164,400,307,93,0.783985157611468,0.223880597014925,1.274289841117,211,93,118,38,1.3,14.37,3.3,0,0,0,0,0,0,0.239978734880694,268.505102677034,29.98092397646
9.7,"random_policy_SVM","SVM",27,4,2284,2129,155,500,398,102,0.765201000557189,0.238805970149254,1.17739341964212,231,102,129,20,1.3,17.96,3.9,0,0,0,0,0,0,0.182222559964966,155.893557961959,19.4826104152989
9.7,"random_policy_SVM","SVM",27,5,2184,2058,126,600,469,131,0.773890673716413,0.261194029850746,1.15931632161772,290,131,159,59,1.2,21.55,3.6,0,0,0,0,0,0,0.196862004769544,141.412525501195,20.5933054531811
9.7,"random_policy_SVM","SVM",27,6,2084,1982,102,700,545,155,0.768585586760408,0.276119402985075,1.14973519499278,342,155,187,52,1.2,25.14,3.5,0,0,0,0,0,0,0.194766367127932,121.119556553521,20.8260562908716
9.7,"random_policy_SVM","SVM",27,7,1984,1901,83,800,626,174,0.768514457102898,0.283582089552239,1.14973519499278,396,174,222,54,1.3,28.74,3.6,0,0,0,0,0,0,0.184025324571532,131.634278351864,20.7047871982084
9.7,"random_policy_SVM","SVM",27,8,1884,1816,68,900,711,189,0.776658802887868,0.276119402985075,1.19764082811748,427,189,238,31,1.3,32.33,3.8,0,0,0,0,0,0,0.154568164367509,91.6235419767328,17.6567862493853
9.7,"random_policy_SVM","SVM",27,9,1784,1724,60,1000,803,197,0.777790949936577,0.238805970149254,1.21680308136736,455,197,258,28,1.3,35.92,4.1,0,0,0,0,0,0,0.166104781868688,111.471091867149,18.7220743473817
9.7,"random_policy_SVM","SVM",27,10,1684,1634,50,1100,893,207,0.793018624115325,0.253731343283582,1.24554646124218,480,207,273,25,1.3,39.51,4.3,0,0,0,0,0,0,0.126086591349873,80.9442510739713,15.0596458400634
9.7,"random_policy_SVM","SVM",27,11,1584,1540,44,1200,987,213,0.807712825862748,0.194029850746269,1.26470871449206,504,213,291,24,1.4,43.1,4.6,0,0,0,0,0,0,0.10522405064682,64.1930340679221,14.3184378316256
9.7,"random_policy_SVM","SVM",27,12,1484,1453,31,1300,1074,226,0.82675186418978,0.216417910447761,1.26470871449206,549,226,323,45,1.4,46.7,4.8,0,0,0,0,0,0,0.128766240893606,51.0425803842338,17.1218862645545
9.7,"random_policy_SVM","SVM",27,13,1384,1363,21,1400,1164,236,0.810498737448584,0.194029850746269,1.26470871449206,571,236,335,22,1.4,50.29,4.9,0,0,0,0,0,0,0.102549099131219,39.8768091460865,12.8314179463601
9.7,"random_policy_SVM","SVM",27,14,1284,1266,18,1500,1261,239,0.809858570530989,0.208955223880597,1.26470871449206,574,239,335,3,1.4,53.88,5.3,0,0,0,0,0,0,0.0758671708082573,32.4440396206728,9.73060969158433
9.7,"random_policy_SVM","SVM",27,15,1184,1166,18,1600,1361,239,0.816645525351802,0.223880597014925,1.26470871449206,575,239,336,1,1.4,57.47,5.7,0,0,0,0,0,0,0.0230516907198126,8.43630286534832,3.6591540303804
9.7,"random_policy_SVM","SVM",27,16,1084,1067,17,1700,1460,240,0.791495263950313,0.164179104477612,1.25512758786712,580,240,340,5,1.4,61.06,6.1,0,0,0,0,0,0,0.102896831889165,36.1737731907182,12.8346889750753
9.7,"random_policy_SVM","SVM",27,17,984,968,16,1800,1559,241,0.789130202838082,0.164179104477612,1.25512758786712,591,241,350,11,1.5,64.66,6.5,0,0,0,0,0,0,0.0704982503357568,21.0478559966077,10.0145886640487
9.7,"random_policy_SVM","SVM",27,18,884,869,15,1900,1658,242,0.801880193946875,0.201492537313433,1.25512758786712,588,242,346,-3,1.4,68.25,6.9,0,0,0,0,0,0,0.0402565364511942,12.0021588923097,6.28747294813228
9.7,"random_policy_SVM","SVM",27,19,784,769,15,2000,1758,242,0.801660877502884,0.216417910447761,1.25512758786712,594,242,352,6,1.5,71.84,7.3,0,0,0,0,0,0,0.0264300604891442,8.54522708458724,3.71123236505295
9.7,"random_policy_SVM","SVM",27,20,684,671,13,2100,1856,244,0.796438775147307,0.164179104477612,1.26470871449206,602,244,358,8,1.5,75.43,7.6,0,0,0,0,0,0,0.0143599988473917,4.56186464351843,2.12347456188875
9.7,"random_policy_SVM","SVM",27,21,584,571,13,2200,1956,244,0.800030822851597,0.194029850746269,1.26470871449206,604,244,360,2,1.5,79.02,8,0,0,0,0,0,0,0.00346693267504382,1.02202788078386,0.639013949969313
9.7,"random_policy_SVM","SVM",27,22,484,473,11,2300,2054,246,0.786937038398168,0.186567164179104,1.24554646124218,612,246,366,8,1.5,82.61,8.3,0,0,0,0,0,0,0.0533836323838917,14.61522573432,8.75574132493347
9.7,"random_policy_SVM","SVM",27,23,384,374,10,2400,2153,247,0.784008867497312,0.17910447761194,1.24554646124218,633,247,386,21,1.6,86.21,8.7,0,0,0,0,0,0,0.00189946263029777,1.14050372530149,0.998477085550775
9.7,"random_policy_SVM","SVM",27,24,284,274,10,2500,2253,247,0.774839069149891,0.164179104477612,1.24439954921525,613,247,366,-20,1.5,89.8,9.1,0,0,0,0,0,0,0.000919825966908366,0.295711927395872,0.238701841786254
9.7,"random_policy_SVM","SVM",27,25,184,178,6,2600,2349,251,0.802502578450093,0.208955223880597,1.25397185343998,647,251,396,34,1.6,93.39,9.4,0,0,0,0,0,0,0.000427000480650145,0.177694792583195,0.162348835631946
9.7,"random_policy_SVM","SVM",27,26,84,83,1,2700,2444,256,0.801832774175196,0.216417910447761,1.274289841117,658,256,402,11,1.6,96.98,9.5,0,0,0,0,0,0,3.99276955245335e-06,2.33013603237558,2.33013603237558
9.7,"random_policy_SVM","SVM",27,27,0,0,0,2784,2527,257,0.800718409540858,0.17910447761194,1.27311646188945,659,257,402,1,1.6,100,9.8,0,0,0,0,0,0,0,0,0
9.7,"random_policy_SVM","SVM",28,0,2684,2438,246,100,90,10,0.807831360772542,0.274074074074074,1.26485065710872,25,10,15,0,1.5,3.59,9,0,0,0,0,0,0,0.140317912229411,268.599981941457,14.8527207654497
9.7,"random_policy_SVM","SVM",28,1,2584,2358,226,200,170,30,0.82054996172643,0.303703703703704,1.28387096774194,77,30,47,52,1.6,7.18,5.7,0,0,0,0,0,0,0.188345280143364,350.885064833195,20.8802828944912
9.7,"random_policy_SVM","SVM",28,2,2484,2281,203,300,247,53,0.784926102573165,0.22962962962963,1.2363201911589,129,53,76,52,1.4,10.78,4.7,0,0,0,0,0,0,0.211099001381517,277.224386792149,26.1658300963164
9.7,"random_policy_SVM","SVM",28,3,2384,2195,189,400,333,67,0.806524171230061,0.303703703703704,1.25534050179211,165,67,98,36,1.5,14.37,5,0,0,0,0,0,0,0.182534145628505,172.944973344671,18.9859485857073
9.7,"random_policy_SVM","SVM",28,4,2284,2130,154,500,398,102,0.804775363598903,0.281481481481481,1.25534050179211,242,102,140,77,1.4,17.96,3.9,0,0,0,0,0,0,0.217095877561499,188.822067970068,22.2692413302044
9.7,"random_policy_SVM","SVM",28,5,2184,2061,123,600,467,133,0.803373962197502,0.288888888888889,1.24583034647551,313,133,180,71,1.4,21.55,3.5,0,0,0,0,0,0,0.231674019482201,167.671809372981,23.9607597379508
9.7,"random_policy_SVM","SVM",28,6,2084,1995,89,700,533,167,0.799364069952318,0.281481481481481,1.2363201911589,389,167,222,76,1.3,25.14,3.2,0,0,0,0,0,0,0.239829619787779,241.036273508127,24.6997060293585
9.7,"random_policy_SVM","SVM",28,7,1984,1910,74,800,618,182,0.789554260142507,0.251851851851852,1.22681003584229,428,182,246,39,1.4,28.74,3.4,0,0,0,0,0,0,0.20642004510668,142.898130821156,22.4830678700616
9.7,"random_policy_SVM","SVM",28,8,1884,1826,58,900,702,198,0.792757463345711,0.259259259259259,1.22681003584229,469,198,271,41,1.4,32.33,3.5,0,0,0,0,0,0,0.182788435196142,111.17554249247,20.1665873011991
9.7,"random_policy_SVM","SVM",28,9,1784,1740,44,1000,788,212,0.810581169404709,0.259259259259259,1.2363201911589,509,212,297,40,1.4,35.92,3.7,0,0,0,0,0,0,0.173713040983826,135.279160188227,19.2174256643079
9.7,"random_policy_SVM","SVM",28,10,1684,1646,38,1100,882,218,0.821739386445275,0.288888888888889,1.25534050179211,520,218,302,11,1.4,39.51,4,0,0,0,0,0,0,0.089059902576742,48.286631938596,11.5763801947309
9.7,"random_policy_SVM","SVM",28,11,1584,1550,34,1200,978,222,0.808508508508519,0.222222222222222,1.2363201911589,549,222,327,29,1.5,43.1,4.4,0,0,0,0,0,0,0.180481690511893,93.5062343856263,22.4353668984428
9.7,"random_policy_SVM","SVM",28,12,1484,1453,31,1300,1075,225,0.824618736383454,0.281481481481481,1.2363201911589,547,225,322,-2,1.4,46.7,4.8,0,0,0,0,0,0,0.0799437839540897,31.915308375034,11.3268242628849
9.7,"random_policy_SVM","SVM",28,13,1384,1366,18,1400,1162,238,0.805958900076551,0.244444444444444,1.21729988052569,604,238,366,57,1.5,50.29,4.9,0,0,0,0,0,0,0.148967543745197,73.7703439435909,16.7891396819195
9.7,"random_policy_SVM","SVM",28,14,1284,1268,16,1500,1260,240,0.807313195548494,0.244444444444444,1.22681003584229,614,240,374,10,1.6,53.88,5.2,0,0,0,0,0,0,0.128203422919312,70.5118746410363,14.1174667180276
9.7,"random_policy_SVM","SVM",28,15,1184,1169,15,1600,1359,241,0.80780191956663,0.303703703703704,1.21729988052569,602,241,361,-12,1.5,57.47,5.6,0,0,0,0,0,0,0.0997205613232376,39.5423741374054,12.5334466087075
9.7,"random_policy_SVM","SVM",28,16,1084,1070,14,1700,1458,242,0.813307425072136,0.266666666666667,1.21729988052569,614,242,372,12,1.5,61.06,6,0,0,0,0,0,0,0.0821740596183136,29.8609407357545,9.76463030895533
9.7,"random_policy_SVM","SVM",28,17,984,970,14,1800,1558,242,0.818035682741571,0.274074074074074,1.21729988052569,617,242,375,3,1.5,64.66,6.4,0,0,0,0,0,0,0.02638219146501,7.43412840733789,3.95520809306466
9.7,"random_policy_SVM","SVM",28,18,884,870,14,1900,1658,242,0.814408526173239,0.281481481481481,1.21729988052569,611,242,369,-6,1.5,68.25,6.9,0,0,0,0,0,0,0.0182951785205592,5.59785678762953,3.09950008536291
9.7,"random_policy_SVM","SVM",28,19,784,772,12,2000,1756,244,0.812936465877648,0.274074074074074,1.21729988052569,631,244,387,20,1.6,71.84,7.2,0,0,0,0,0,0,0.0104089678825681,3.42990082646571,1.86627258601791
9.7,"random_policy_SVM","SVM",28,20,684,673,11,2100,1855,245,0.808785255844085,0.259259259259259,1.21729988052569,617,245,372,-14,1.5,75.43,7.6,0,0,0,0,0,0,0.0162770963251213,5.54522636063926,2.36051233254151
9.7,"random_policy_SVM","SVM",28,21,584,574,10,2200,1954,246,0.793658364246606,0.222222222222222,1.21729988052569,640,246,394,23,1.6,79.02,7.9,0,0,0,0,0,0,0.00936632929261599,3.17159382330302,1.84159785251554
9.7,"random_policy_SVM","SVM",28,22,484,476,8,2300,2052,248,0.751298357180719,0.155555555555556,1.19827956989247,646,248,398,6,1.6,82.61,8.3,0,0,0,0,0,0,0.148044977554143,56.3500259172959,50.29945704109
9.7,"random_policy_SVM","SVM",28,23,384,376,8,2400,2152,248,0.789554260142501,0.237037037037037,1.19827956989247,650,248,402,4,1.6,86.21,8.7,0,0,0,0,0,0,0.00388578488081396,2.60193443002009,2.30634003502575
9.7,"random_policy_SVM","SVM",28,24,284,276,8,2500,2252,248,0.808549726196794,0.259259259259259,1.19827956989247,654,248,406,4,1.6,89.8,9.1,0,0,0,0,0,0,0.00103183620060963,0.426990992502561,0.356393254793198
9.7,"random_policy_SVM","SVM",28,25,184,178,6,2600,2350,250,0.814950244362015,0.296296296296296,1.19827956989247,681,250,431,27,1.7,93.39,9.4,0,0,0,0,0,0,0.000649845924838564,0.238334060897857,0.21170093843729
9.7,"random_policy_SVM","SVM",28,26,84,82,2,2700,2446,254,0.814096449390563,0.288888888888889,1.28387096774194,681,254,427,0,1.7,96.98,9.6,0,0,0,0,0,0,8.64180649219929e-07,0.512003297145909,0.512003297145909
9.7,"random_policy_SVM","SVM",28,27,0,0,0,2784,2528,256,0.826714950244357,0.274074074074074,1.28387096774194,702,256,446,21,1.7,100,9.9,0,0,0,0,0,0,0,0,0
9.7,"random_policy_SVM","SVM",29,0,2684,2427,257,100,90,10,0.817000940542466,0.314516129032258,1.27351716961498,32,10,22,0,2.2,3.59,9,0,0,0,0,0,0,0.142093667269999,272.12437717291,14.9902647398781
9.7,"random_policy_SVM","SVM",29,1,2584,2346,238,200,171,29,0.81100180482473,0.338709677419355,1.25280957336108,80,29,51,48,1.8,7.18,5.9,0,0,0,0,0,0,0.193189830006765,326.464704390046,21.0692711414507
9.7,"random_policy_SVM","SVM",29,2,2484,2269,215,300,248,52,0.842611657642548,0.330645161290323,1.27351716961498,139,52,87,59,1.7,10.78,4.8,0,0,0,0,0,0,0.190631562996195,330.782258461629,20.0930824470231
9.7,"random_policy_SVM","SVM",29,3,2384,2180,204,400,337,63,0.867008566562445,0.379032258064516,1.27351716961498,179,63,116,40,1.8,14.37,5.3,0,0,0,0,0,0,0.177896901916202,224.356406107878,19.3798424885759
9.7,"random_policy_SVM","SVM",29,4,2284,2108,176,500,409,91,0.829329672843753,0.298387096774194,1.23210197710718,241,91,150,62,1.6,17.96,4.5,0,0,0,0,0,0,0.190240541316507,300.042616012661,22.7479816791618
9.7,"random_policy_SVM","SVM",29,5,2184,2031,153,600,486,114,0.840406466864942,0.266129032258065,1.26316337148803,281,114,167,40,1.5,21.55,4.3,0,0,0,0,0,0,0.209656319015412,257.759761311273,22.8480565816133
9.7,"random_policy_SVM","SVM",29,6,2084,1943,141,700,574,126,0.872365845598519,0.346774193548387,1.28387096774194,308,126,182,27,1.4,25.14,4.6,0,0,0,0,0,0,0.207160891456704,185.085478854315,21.1565588306351
9.7,"random_policy_SVM","SVM",29,7,1984,1870,114,800,647,153,0.869626833422307,0.362903225806452,1.27351716961498,377,153,224,69,1.5,28.74,4.2,0,0,0,0,0,0,0.208230552058536,187.569709662616,21.1876042377813
9.7,"random_policy_SVM","SVM",29,8,1884,1802,82,900,715,185,0.863799283154125,0.387096774193548,1.27351716961498,451,185,266,74,1.4,32.33,3.9,0,0,0,0,0,0,0.221162192840937,141.922785437073,22.7030506707474
9.7,"random_policy_SVM","SVM",29,9,1784,1722,62,1000,795,205,0.857742952286539,0.346774193548387,1.27351716961498,519,205,314,68,1.5,35.92,3.9,0,0,0,0,0,0,0.217599600712993,142.184623526645,22.2584171472953
9.7,"random_policy_SVM","SVM",29,10,1684,1634,50,1100,883,217,0.840196751315493,0.306451612903226,1.26316337148803,550,217,333,31,1.5,39.51,4.1,0,0,0,0,0,0,0.202992919660222,121.459585910422,21.0566494592301
9.7,"random_policy_SVM","SVM",29,11,1584,1545,39,1200,972,228,0.836739622257813,0.282258064516129,1.24245577523413,590,228,362,40,1.6,43.1,4.3,0,0,0,0,0,0,0.190270696418102,121.775990102018,19.7045985449328
9.7,"random_policy_SVM","SVM",29,12,1484,1455,29,1300,1062,238,0.827130837082795,0.258064516129032,1.23210197710718,608,238,370,18,1.6,46.7,4.5,0,0,0,0,0,0,0.175892018078458,95.1386752599373,18.6212201966819
9.7,"random_policy_SVM","SVM",29,13,1384,1360,24,1400,1157,243,0.815069015480822,0.209677419354839,1.23210197710718,644,243,401,36,1.7,50.29,4.8,0,0,0,0,0,0,0.163192356382414,95.5638650057299,17.1289957181824
9.7,"random_policy_SVM","SVM",29,14,1284,1262,22,1500,1255,245,0.838499961869904,0.274193548387097,1.23210197710718,647,245,402,3,1.6,53.88,5.1,0,0,0,0,0,0,0.154240978746674,96.0372201349409,15.8943381768664
9.7,"random_policy_SVM","SVM",29,15,1184,1163,21,1600,1354,246,0.845242634535712,0.362903225806452,1.23210197710718,663,246,417,16,1.7,57.47,5.5,0,0,0,0,0,0,0.131620079974229,57.7556717201157,14.214676744864
9.7,"random_policy_SVM","SVM",29,16,1084,1064,20,1700,1453,247,0.801386664633068,0.241935483870968,1.23210197710718,678,247,431,15,1.7,61.06,5.9,0,0,0,0,0,0,0.144205219336085,71.5911911135916,14.8792439636832
9.7,"random_policy_SVM","SVM",29,17,984,964,20,1800,1553,247,0.834413686163866,0.32258064516129,1.23210197710718,676,247,429,-2,1.7,64.66,6.3,0,0,0,0,0,0,0.102494991922877,29.5966501020751,11.6303647239149
9.7,"random_policy_SVM","SVM",29,18,884,865,19,1900,1652,248,0.814280993416208,0.241935483870968,1.25280957336108,671,248,423,-5,1.7,68.25,6.7,0,0,0,0,0,0,0.0451354256721421,10.7825077319935,7.03028058779227
9.7,"random_policy_SVM","SVM",29,19,784,766,18,2000,1751,249,0.840031520882595,0.306451612903226,1.23210197710718,659,249,410,-12,1.6,71.84,7,0,0,0,0,0,0,0.043732442884757,9.64751748698551,6.58058138372179
9.7,"random_policy_SVM","SVM",29,20,684,672,12,2100,1845,255,0.799607259971028,0.161290322580645,1.26316337148803,662,255,407,3,1.6,75.43,7.2,0,0,0,0,0,0,0.00437798648222578,2.15709877833222,1.8494855673396
9.7,"random_policy_SVM","SVM",29,21,584,579,5,2200,1938,262,0.851089249853836,0.258064516129032,1.27351716961498,687,262,425,25,1.6,79.02,7.4,0,0,0,0,0,0,0.0366071374443793,13.7916770552923,10.2391322745592
9.7,"random_policy_SVM","SVM",29,22,484,481,3,2300,2036,264,0.817642797224132,0.258064516129032,1.28387096774194,709,264,445,22,1.7,82.61,7.7,0,0,0,0,0,0,0.0303321348258693,8.678186817418,5.30922507447363
9.7,"random_policy_SVM","SVM",29,23,384,382,2,2400,2135,265,0.791205927959533,0.120967741935484,1.28387096774194,705,265,440,-4,1.7,86.21,8.1,0,0,0,0,0,0,0.048872519536703,12.0274986915482,6.86281478485783
9.7,"random_policy_SVM","SVM",29,24,284,282,2,2500,2235,265,0.803286814611456,0.161290322580645,1.28387096774194,737,265,472,32,1.8,89.8,8.4,0,0,0,0,0,0,0.0163328745942304,4.81888442380918,4.11054329038607
9.7,"random_policy_SVM","SVM",29,25,184,183,1,2600,2334,266,0.818576984671704,0.225806451612903,1.27351716961498,714,266,448,-23,1.7,93.39,8.8,0,0,0,0,0,0,0.0107783595883186,5.05462983906467,4.76525264026059
9.7,"random_policy_SVM","SVM",29,26,84,84,0,2700,2433,267,0.786859096570837,0.104838709677419,1.28387096774194,723,267,456,9,1.7,96.98,9.1,0,0,0,0,0,0,7.20347587900874e-06,2.53178645429749,2.53178645429749
9.7,"random_policy_SVM","SVM",29,27,0,0,0,2784,2517,267,0.835322453544834,0.282258064516129,1.26316337148803,725,267,458,2,1.7,100,9.4,0,0,0,0,0,0,0,0,0
9.7,"random_policy_SVM","SVM",30,0,2684,2426,258,100,90,10,0.241501824467063,0,0.469708890637293,31,10,21,0,2.1,3.59,9,0,0,0,0,0,0,0.103110124657613,270.453518887238,10.3559915365574
9.7,"random_policy_SVM","SVM",30,1,2584,2337,247,200,179,21,0.782510722745031,0.235772357723577,1.25255704169945,53,21,32,22,1.5,7.18,8.5,0,0,0,0,0,0,0.28125566015007,329.13444618536,34.4289626465311
9.7,"random_policy_SVM","SVM",30,2,2484,2262,222,300,254,46,0.733935087382372,0.121951219512195,1.22124311565696,129,46,83,76,1.8,10.78,5.5,0,0,0,0,0,0,0.184909988701271,361.041309571998,20.119489415121
9.7,"random_policy_SVM","SVM",30,3,2384,2166,218,400,350,50,0.813027334997766,0.260162601626016,1.25255704169945,130,50,80,1,1.6,14.37,7,0,0,0,0,0,0,0.19492441377854,196.186928282998,23.5713601280607
9.7,"random_policy_SVM","SVM",30,4,2284,2088,196,500,428,72,0.82710453876193,0.308943089430894,1.26299501704694,182,72,110,52,1.5,17.96,5.9,0,0,0,0,0,0,0.200665402272155,172.29723801636,21.2456688733642
9.7,"random_policy_SVM","SVM",30,5,2184,2020,164,600,496,104,0.826931694513803,0.300813008130081,1.25255704169945,257,104,153,75,1.5,21.55,4.8,0,0,0,0,0,0,0.202324681830609,238.88830547083,20.5054296849997
9.7,"random_policy_SVM","SVM",30,6,2084,1953,131,700,563,137,0.826950899430261,0.300813008130081,1.25255704169945,339,137,202,82,1.5,25.14,4.1,0,0,0,0,0,0,0.225226488306868,140.262258476996,23.6046384017575
9.7,"random_policy_SVM","SVM",30,7,1984,1884,100,800,632,168,0.828512899302225,0.317073170731707,1.25255704169945,404,168,236,65,1.4,28.74,3.8,0,0,0,0,0,0,0.203802449953711,131.523110591091,22.1364217023698
9.7,"random_policy_SVM","SVM",30,8,1884,1806,78,900,710,190,0.830081300813013,0.268292682926829,1.25255704169945,464,190,274,60,1.4,32.33,3.7,0,0,0,0,0,0,0.199688361127836,107.985101439783,21.856500311898
9.7,"random_policy_SVM","SVM",30,9,1784,1725,59,1000,791,209,0.81802701491582,0.227642276422764,1.25255704169945,505,209,296,41,1.4,35.92,3.8,0,0,0,0,0,0,0.193546866023937,92.7081756385573,21.2825200150291
9.7,"random_policy_SVM","SVM",30,10,1684,1642,42,1100,874,226,0.821720760514691,0.24390243902439,1.24211906635195,562,226,336,57,1.5,39.51,3.9,0,0,0,0,0,0,0.16911468503155,78.8047295199814,19.9292050158018
9.7,"random_policy_SVM","SVM",30,11,1584,1555,29,1200,961,239,0.821573522821838,0.235772357723577,1.24211906635195,583,239,344,21,1.4,43.1,4,0,0,0,0,0,0,0.144045687188036,57.1959267297052,17.6276618217464
9.7,"random_policy_SVM","SVM",30,12,1484,1462,22,1300,1054,246,0.802535048972542,0.227642276422764,1.24211906635195,624,246,378,41,1.5,46.7,4.3,0,0,0,0,0,0,0.140113951701649,63.5792194883373,16.5879981435668
9.7,"random_policy_SVM","SVM",30,13,1384,1364,20,1400,1152,248,0.804724409448824,0.211382113821138,1.25255704169945,633,248,385,9,1.6,50.29,4.6,0,0,0,0,0,0,0.0832339791895548,32.8426213111166,10.8281278413742
9.7,"random_policy_SVM","SVM",30,14,1284,1270,14,1500,1246,254,0.81014659752897,0.195121951219512,1.26299501704694,665,254,411,32,1.6,53.88,4.9,0,0,0,0,0,0,0.154365004563722,90.7415676334258,18.3281456009277
9.7,"random_policy_SVM","SVM",30,15,1184,1174,10,1600,1342,258,0.813712310351461,0.219512195121951,1.26299501704694,677,258,419,12,1.6,57.47,5.2,0,0,0,0,0,0,0.0930326951951028,36.3282585346299,12.3278379242374
9.7,"random_policy_SVM","SVM",30,16,1084,1075,9,1700,1441,259,0.822476153895408,0.284552845528455,1.26299501704694,671,259,412,-6,1.6,61.06,5.6,0,0,0,0,0,0,0.132238723350444,93.0385377807683,14.1148473771085
9.7,"random_policy_SVM","SVM",30,17,984,977,7,1800,1539,261,0.791850713782738,0.195121951219512,1.26299501704694,686,261,425,15,1.6,64.66,5.9,0,0,0,0,0,0,0.0644528811971488,25.0355261632213,9.61546925415144
9.7,"random_policy_SVM","SVM",30,18,884,878,6,1900,1638,262,0.810761154855657,0.284552845528455,1.27343299239444,714,262,452,28,1.7,68.25,6.3,0,0,0,0,0,0,0.0594862334719221,20.4495590613229,9.23784804882224
9.7,"random_policy_SVM","SVM",30,19,784,778,6,2000,1738,262,0.783387747263309,0.178861788617886,1.26299501704694,722,262,460,8,1.8,71.84,6.6,0,0,0,0,0,0,0.0494218852955125,16.7120754458575,6.31630563170601
9.7,"random_policy_SVM","SVM",30,20,684,681,3,2100,1835,265,0.797330516612262,0.227642276422764,1.26299501704694,722,265,457,0,1.7,75.43,6.9,0,0,0,0,0,0,0.0325462414088761,10.6913091229192,5.75527438411671
9.7,"random_policy_SVM","SVM",30,21,584,583,1,2200,1933,267,0.772114461302101,0.211382113821138,1.26299501704694,725,267,458,3,1.7,79.02,7.2,0,0,0,0,0,0,0.0120906708362772,3.44209444494742,2.31513211432387
9.7,"random_policy_SVM","SVM",30,22,484,484,0,2300,2032,268,0.79657512323156,0.235772357723577,1.27343299239444,719,268,451,-6,1.7,82.61,7.6,0,0,0,0,0,0,0.00610077606066701,1.69560366294129,1.23291040879961
9.7,"random_policy_SVM","SVM",30,23,384,384,0,2400,2132,268,0.817476473977346,0.292682926829268,1.26299501704694,725,268,457,6,1.7,86.21,8,0,0,0,0,0,0,0.00188764104245157,0.606121850296125,0.477868516530977
9.7,"random_policy_SVM","SVM",30,24,284,284,0,2500,2232,268,0.799846360668344,0.219512195121951,1.27343299239444,728,268,460,3,1.7,89.8,8.3,0,0,0,0,0,0,0.000294623413411186,0.166955165632576,0.152112703237885
9.7,"random_policy_SVM","SVM",30,25,184,184,0,2600,2332,268,0.79282376288331,0.24390243902439,1.26299501704694,707,268,439,-21,1.6,93.39,8.7,0,0,0,0,0,0,1.36606297649665e-05,0.0279738839027894,0.0275652870556791
9.7,"random_policy_SVM","SVM",30,26,84,84,0,2700,2432,268,0.807483515780047,0.252032520325203,1.26299501704694,716,268,448,9,1.7,96.98,9.1,0,0,0,0,0,0,2.70863591537261e-07,0.00109635198285908,0.00109635198285908
9.7,"random_policy_SVM","SVM",30,27,0,0,0,2784,2516,268,0.780410985212225,0.211382113821138,1.26299501704694,730,268,462,14,1.7,100,9.4,0,0,0,0,0,0,0,0,0
9.7,"random_policy_SVM","SVM",31,0,2684,2415,269,100,94,6,0.543657008613942,0.120689655172414,0.896496106785317,24,6,18,0,3,3.59,15.7,0,0,0,0,0,0,0.165014375208597,199.218822142307,20.017441568775
9.7,"random_policy_SVM","SVM",31,1,2584,2321,263,200,188,12,0.841094429292791,0.310344827586207,1.27280311457175,38,12,26,14,2.2,7.18,15.7,0,0,0,0,0,0,0.108291448020845,109.739518788281,11.4842079757999
9.7,"random_policy_SVM","SVM",31,2,2484,2256,228,300,253,47,0.804208408716546,0.224137931034483,1.28387096774194,122,47,75,84,1.6,10.78,5.4,0,0,0,0,0,0,0.218793867343949,234.545525796723,26.6311473853182
9.7,"random_policy_SVM","SVM",31,3,2384,2174,210,400,335,65,0.814557286744255,0.206896551724138,1.25066740823137,169,65,104,47,1.6,14.37,5.2,0,0,0,0,0,0,0.193652401082386,226.599761279887,24.2859368028546
9.7,"random_policy_SVM","SVM",31,4,2284,2092,192,500,417,83,0.765405179164521,0.224137931034483,1.23959955506118,215,83,132,46,1.6,17.96,5,0,0,0,0,0,0,0.203014674320258,191.319052818221,21.6317030370513
9.7,"random_policy_SVM","SVM",31,5,2184,2012,172,600,497,103,0.794325331461129,0.241379310344828,1.25066740823137,255,103,152,40,1.5,21.55,4.8,0,0,0,0,0,0,0.204818329138238,127.442211808725,20.7381401955371
9.7,"random_policy_SVM","SVM",31,6,2084,1947,137,700,562,138,0.807036967029409,0.275862068965517,1.25066740823137,338,138,200,83,1.4,25.14,4.1,0,0,0,0,0,0,0.225808023470851,127.378301276679,22.9048141544194
9.7,"random_policy_SVM","SVM",31,7,1984,1871,113,800,638,162,0.804971241865364,0.293103448275862,1.25066740823137,402,162,240,64,1.5,28.74,3.9,0,0,0,0,0,0,0.215042979753894,109.436249365014,22.285942306722
9.7,"random_policy_SVM","SVM",31,8,1884,1804,80,900,705,195,0.803958631490827,0.353448275862069,1.25066740823137,469,195,274,67,1.4,32.33,3.6,0,0,0,0,0,0,0.201349335712151,100.645060398622,22.1110603912484
9.7,"random_policy_SVM","SVM",31,9,1784,1710,74,1000,799,201,0.797288904490591,0.21551724137931,1.25066740823137,472,201,271,3,1.3,35.92,4,0,0,0,0,0,0,0.145780523146821,59.8138180955176,17.7785755770552
9.7,"random_policy_SVM","SVM",31,10,1684,1613,71,1100,896,204,0.806557664785454,0.310344827586207,1.23959955506118,483,204,279,11,1.4,39.51,4.4,0,0,0,0,0,0,0.0869506500450541,33.647466688296,11.2086921812988
9.7,"random_policy_SVM","SVM",31,11,1584,1520,64,1200,989,211,0.809649501795694,0.232758620689655,1.25066740823137,505,211,294,22,1.4,43.1,4.7,0,0,0,0,0,0,0.0451908873346472,14.924816112763,8.85018426949088
9.7,"random_policy_SVM","SVM",31,12,1484,1432,52,1300,1077,223,0.798213755299321,0.241379310344828,1.23959955506118,550,223,327,45,1.5,46.7,4.8,0,0,0,0,0,0,0.105175574839508,50.9236720522837,14.9578358806458
9.7,"random_policy_SVM","SVM",31,13,1384,1352,32,1400,1157,243,0.812167526260352,0.232758620689655,1.23959955506118,605,243,362,55,1.5,50.29,4.8,0,0,0,0,0,0,0.134897223771014,39.3768358833174,16.7485674691774
9.7,"random_policy_SVM","SVM",31,14,1284,1263,21,1500,1246,254,0.791415764318302,0.198275862068966,1.23959955506118,644,254,390,39,1.5,53.88,4.9,0,0,0,0,0,0,0.0651636533826157,17.3689013334132,10.7968744549145
9.7,"random_policy_SVM","SVM",31,15,1184,1164,20,1600,1345,255,0.794858639591711,0.241379310344828,1.23959955506118,636,255,381,-8,1.5,57.47,5.3,0,0,0,0,0,0,0.134610333149208,54.9117058355962,16.1057673112992
9.7,"random_policy_SVM","SVM",31,16,1084,1065,19,1700,1444,256,0.795371695514804,0.232758620689655,1.23959955506118,655,256,399,19,1.6,61.06,5.6,0,0,0,0,0,0,0.128906138025749,42.0349706182187,14.6602273858038
9.7,"random_policy_SVM","SVM",31,17,984,966,18,1800,1543,257,0.788560203062125,0.241379310344828,1.23959955506118,686,257,429,31,1.7,64.66,6,0,0,0,0,0,0,0.118121783605009,32.0727615297732,13.4663830901815
9.7,"random_policy_SVM","SVM",31,18,884,866,18,1900,1643,257,0.775727054248902,0.155172413793103,1.23959955506118,677,257,420,-9,1.6,68.25,6.4,0,0,0,0,0,0,0.0412558198955219,8.38506334939344,6.49690864186839
9.7,"random_policy_SVM","SVM",31,19,784,767,17,2000,1742,258,0.798267761185959,0.258620689655172,1.23959955506118,671,258,413,-6,1.6,71.84,6.8,0,0,0,0,0,0,0.0147315960289127,4.82966574770595,4.27000578679234
9.7,"random_policy_SVM","SVM",31,20,684,670,14,2100,1839,261,0.795675478627164,0.232758620689655,1.25066740823137,664,261,403,-7,1.5,75.43,7,0,0,0,0,0,0,0.000406483658506569,0.684468674977954,0.667153569586757
9.7,"random_policy_SVM","SVM",31,21,584,579,5,2200,1930,270,0.810351578322034,0.224137931034483,1.28387096774194,713,270,443,49,1.6,79.02,7.1,0,0,0,0,0,0,0.119457608595589,35.314893175619,15.3065481901842
9.7,"random_policy_SVM","SVM",31,22,484,482,2,2300,2027,273,0.802459968136526,0.206896551724138,1.28387096774194,710,273,437,-3,1.6,82.61,7.4,0,0,0,0,0,0,0.0921303177076092,27.6667827954972,11.2228969863297
9.7,"random_policy_SVM","SVM",31,23,384,382,2,2400,2127,273,0.826924634785192,0.267241379310345,1.28387096774194,729,273,456,19,1.7,86.21,7.8,0,0,0,0,0,0,0.0400365565968713,9.31006621602923,5.52686576051686
9.7,"random_policy_SVM","SVM",31,24,284,282,2,2500,2227,273,0.805349283071855,0.21551724137931,1.28387096774194,711,273,438,-18,1.6,89.8,8.2,0,0,0,0,0,0,0.00476016178452737,1.49353297789698,1.3057186126629
9.7,"random_policy_SVM","SVM",31,25,184,183,1,2600,2326,274,0.806564415521292,0.198275862068966,1.28387096774194,719,274,445,8,1.6,93.39,8.5,0,0,0,0,0,0,0.000189802633960637,0.742619624792031,0.739650506147507
9.7,"random_policy_SVM","SVM",31,26,84,84,0,2700,2425,275,0.786832014689592,0.146551724137931,1.27280311457175,738,275,463,19,1.7,96.98,8.8,0,0,0,0,0,0,1.0000000994736e-07,9.51533157010769,9.51533157010769
9.7,"random_policy_SVM","SVM",31,27,0,0,0,2784,2509,275,0.811094159263353,0.21551724137931,1.28387096774194,750,275,475,12,1.7,100,9.1,0,0,0,0,0,0,0,0,0
9.7,"random_policy_SVM","SVM",32,0,2684,2442,242,100,95,5,0.66098434302998,0.243055555555556,1.15905017921147,23,5,18,0,3.6,3.59,19,0,0,0,0,0,0,0.057320014186431,147.551207981347,5.78019368799974
9.7,"random_policy_SVM","SVM",32,1,2584,2370,214,200,167,33,0.757594964860777,0.270833333333333,1.23037634408602,92,33,59,69,1.8,7.18,5.1,0,0,0,0,0,0,0.172652887594905,407.521129773192,17.7052239522868
9.7,"random_policy_SVM","SVM",32,2,2484,2289,195,300,248,52,0.741654434658838,0.243055555555556,1.2214605734767,141,52,89,49,1.7,10.78,4.8,0,0,0,0,0,0,0.200753175913187,288.887160306847,23.7435860678359
9.7,"random_policy_SVM","SVM",32,3,2384,2216,168,400,321,79,0.778645138332888,0.291666666666667,1.24820788530466,197,79,118,56,1.5,14.37,4.1,0,0,0,0,0,0,0.203450131696963,316.432552440202,20.9502268045986
9.7,"random_policy_SVM","SVM",32,4,2284,2144,140,500,393,107,0.784866782314735,0.326388888888889,1.23929211469534,262,107,155,65,1.4,17.96,3.7,0,0,0,0,0,0,0.209763130468842,264.238855111455,22.0997892627896
9.7,"random_policy_SVM","SVM",32,5,2184,2064,120,600,473,127,0.788831064851878,0.340277777777778,1.23037634408602,301,127,174,39,1.4,21.55,3.7,0,0,0,0,0,0,0.193016909141106,197.899248005977,20.5782850529722
9.7,"random_policy_SVM","SVM",32,6,2084,1989,95,700,548,152,0.80712347655902,0.347222222222222,1.23929211469534,358,152,206,57,1.4,25.14,3.6,0,0,0,0,0,0,0.183357049083427,140.789097497299,20.4378757222125
9.7,"random_policy_SVM","SVM",32,7,1984,1915,69,800,622,178,0.798683391157366,0.284722222222222,1.23037634408602,423,178,245,65,1.4,28.74,3.5,0,0,0,0,0,0,0.22182661744133,221.342542816896,23.4415189226606
9.7,"random_policy_SVM","SVM",32,8,1884,1827,57,900,710,190,0.805605595587577,0.333333333333333,1.2214605734767,469,190,279,46,1.5,32.33,3.7,0,0,0,0,0,0,0.205327038603179,234.166531554467,21.2257834941178
9.7,"random_policy_SVM","SVM",32,9,1784,1738,46,1000,799,201,0.788325104528064,0.284722222222222,1.2214605734767,508,201,307,39,1.5,35.92,4,0,0,0,0,0,0,0.192452146007467,214.883238977132,19.8553589427725
9.7,"random_policy_SVM","SVM",32,10,1684,1644,40,1100,893,207,0.795124988879992,0.3125,1.23037634408602,520,207,313,12,1.5,39.51,4.3,0,0,0,0,0,0,0.147033691327732,113.768043240922,16.1427214904741
9.7,"random_policy_SVM","SVM",32,11,1584,1555,29,1200,982,218,0.797821590605814,0.263888888888889,1.2214605734767,552,218,334,32,1.5,43.1,4.5,0,0,0,0,0,0,0.190210385565455,141.542185566081,21.3284906759322
9.7,"random_policy_SVM","SVM",32,12,1484,1464,20,1300,1073,227,0.793584867894309,0.298611111111111,1.23037634408602,580,227,353,28,1.6,46.7,4.7,0,0,0,0,0,0,0.157956284144348,139.884143722592,16.8866569900334
9.7,"random_policy_SVM","SVM",32,13,1384,1368,16,1400,1169,231,0.788002624321675,0.263888888888889,1.2214605734767,596,231,365,16,1.6,50.29,5.1,0,0,0,0,0,0,0.141129992791986,119.829912591056,14.8646785870934
9.7,"random_policy_SVM","SVM",32,14,1284,1271,13,1500,1266,234,0.79157214660617,0.305555555555556,1.21254480286738,617,234,383,21,1.6,53.88,5.4,0,0,0,0,0,0,0.128312947188464,91.4637558619859,14.2420334682284
9.7,"random_policy_SVM","SVM",32,15,1184,1171,13,1600,1366,234,0.764923049550749,0.243055555555556,1.21254480286738,622,234,388,5,1.7,57.47,5.8,0,0,0,0,0,0,0.102679704693897,65.9248004029064,11.3660057529881
9.7,"random_policy_SVM","SVM",32,16,1084,1072,12,1700,1465,235,0.758729205586689,0.243055555555556,1.21254480286738,614,235,379,-8,1.6,61.06,6.2,0,0,0,0,0,0,0.0782546152455313,39.0551257848362,8.89054932038337
9.7,"random_policy_SVM","SVM",32,17,984,973,11,1800,1564,236,0.762093007739526,0.25,1.21254480286738,626,236,390,12,1.7,64.66,6.6,0,0,0,0,0,0,0.0902447980175778,44.3527288839661,11.2113211221038
9.7,"random_policy_SVM","SVM",32,18,884,874,10,1900,1663,237,0.747297838270619,0.229166666666667,1.21254480286738,629,237,392,3,1.7,68.25,7,0,0,0,0,0,0,0.0537344625840891,21.4148105069628,7.67187850327648
9.7,"random_policy_SVM","SVM",32,19,784,774,10,2000,1763,237,0.788914464905262,0.326388888888889,1.20362903225806,628,237,391,-1,1.6,71.84,7.4,0,0,0,0,0,0,0.040337707680028,15.4981303121848,5.03672115474694
9.7,"random_policy_SVM","SVM",32,20,684,675,9,2100,1862,238,0.735388310648524,0.201388888888889,1.2214605734767,641,238,403,13,1.7,75.43,7.8,0,0,0,0,0,0,0.0381868244373433,14.262935538477,5.04014942412974
9.7,"random_policy_SVM","SVM",32,21,584,575,9,2200,1962,238,0.764194689084602,0.236111111111111,1.21254480286738,645,238,407,4,1.7,79.02,8.2,0,0,0,0,0,0,0.037080849606172,13.7824181471136,4.50007744257226
9.7,"random_policy_SVM","SVM",32,22,484,475,9,2300,2062,238,0.753475002224001,0.215277777777778,1.21254480286738,640,238,402,-5,1.7,82.61,8.7,0,0,0,0,0,0,0.0163437511275346,4.62715779582373,2.14747289767297
9.7,"random_policy_SVM","SVM",32,23,384,376,8,2400,2161,239,0.72354550306912,0.1875,1.21254480286738,640,239,401,0,1.7,86.21,9,0,0,0,0,0,0,0.00907536840845043,2.2315071894141,1.3480045177124
9.7,"random_policy_SVM","SVM",32,24,284,281,3,2500,2256,244,0.732352548705624,0.215277777777778,1.24820788530466,656,244,412,16,1.7,89.8,9.2,0,0,0,0,0,0,0.0107270043895009,4.87514067014967,4.44141638579763
9.7,"random_policy_SVM","SVM",32,25,184,184,0,2600,2353,247,0.793501467840937,0.263888888888889,1.27495519713262,677,247,430,21,1.7,93.39,9.5,0,0,0,0,0,0,0.00857967817722576,2.06133032433238,1.67808819678373
9.7,"random_policy_SVM","SVM",32,26,84,84,0,2700,2453,247,0.760369406636418,0.256944444444444,1.26487364436259,676,247,429,-1,1.7,96.98,9.9,0,0,0,0,0,0,8.65669461742744e-10,0.0183779721780697,0.0183779721780697
9.7,"random_policy_SVM","SVM",32,27,0,0,0,2784,2537,247,0.761826127568715,0.236111111111111,1.25712365591398,667,247,420,-9,1.7,100,10.3,0,0,0,0,0,0,0,0,0
9.7,"random_policy_SVM","SVM",33,0,2684,2435,249,100,90,10,0.80047701439453,0.242424242424242,1.24496578690127,24,10,14,0,1.4,3.59,9,0,0,0,0,0,0,0.254338670694675,194.491031219239,36.5558894136463
9.7,"random_policy_SVM","SVM",33,1,2584,2376,208,200,149,51,0.68573522697234,0.189393939393939,1.13797653958944,112,51,61,88,1.2,7.18,2.9,0,0,0,0,0,0,0.299054024548248,509.021368469914,39.4548352137235
9.7,"random_policy_SVM","SVM",33,2,2484,2290,194,300,235,65,0.695804195804195,0.166666666666667,1.13797653958944,157,65,92,45,1.4,10.78,3.6,0,0,0,0,0,0,0.231292578774753,442.7182573155,23.6441019790905
9.7,"random_policy_SVM","SVM",33,3,2384,2202,182,400,323,77,0.796229543652215,0.227272727272727,1.2644183773216,181,77,104,24,1.4,14.37,4.2,0,0,0,0,0,0,0.254565099920568,205.10544681299,27.1140280626278
9.7,"random_policy_SVM","SVM",33,4,2284,2133,151,500,392,108,0.802171196501092,0.272727272727273,1.24496578690127,245,108,137,64,1.3,17.96,3.6,0,0,0,0,0,0,0.255635487672283,161.238901074991,27.9994246229547
9.7,"random_policy_SVM","SVM",33,5,2184,2064,120,600,461,139,0.810215557638238,0.257575757575758,1.25469208211144,309,139,170,64,1.2,21.55,3.3,0,0,0,0,0,0,0.247741459637543,145.528003747033,25.5617039277515
9.7,"random_policy_SVM","SVM",33,6,2084,1988,96,700,537,163,0.810389782039264,0.265151515151515,1.25469208211144,364,163,201,55,1.2,25.14,3.3,0,0,0,0,0,0,0.231877182676529,99.12792655193,24.3844264184837
9.7,"random_policy_SVM","SVM",33,7,1984,1911,73,800,614,186,0.805030879773141,0.265151515151515,1.2644183773216,421,186,235,57,1.3,28.74,3.3,0,0,0,0,0,0,0.208213252755747,77.9412660825312,23.2755580057698
9.7,"random_policy_SVM","SVM",33,8,1884,1819,65,900,706,194,0.796499891860707,0.265151515151515,1.25469208211144,446,194,252,25,1.3,32.33,3.6,0,0,0,0,0,0,0.150374703799324,54.6204085518026,17.391879819436
9.7,"random_policy_SVM","SVM",33,9,1784,1730,54,1000,795,205,0.791357268161387,0.227272727272727,1.2644183773216,490,205,285,44,1.4,35.92,3.9,0,0,0,0,0,0,0.179011263746793,74.6225722288452,19.8211763323867
9.7,"random_policy_SVM","SVM",33,10,1684,1634,50,1100,891,209,0.798007834090304,0.227272727272727,1.2644183773216,511,209,302,21,1.4,39.51,4.3,0,0,0,0,0,0,0.127088474505287,55.9339126336461,15.9534190491994
9.7,"random_policy_SVM","SVM",33,11,1584,1540,44,1200,985,215,0.787698555739787,0.204545454545455,1.2644183773216,523,215,308,12,1.4,43.1,4.6,0,0,0,0,0,0,0.144799921159247,77.4007035411404,16.5983369782021
9.7,"random_policy_SVM","SVM",33,12,1484,1452,32,1300,1073,227,0.801978948886156,0.212121212121212,1.26325408783972,546,227,319,23,1.4,46.7,4.7,0,0,0,0,0,0,0.137828965041524,44.0820428774266,16.95555063647
9.7,"random_policy_SVM","SVM",33,13,1384,1363,21,1400,1162,238,0.808713623146605,0.303030303030303,1.2644183773216,580,238,342,34,1.4,50.29,4.9,0,0,0,0,0,0,0.116790345322449,31.5008999157009,14.0379519595559
9.7,"random_policy_SVM","SVM",33,14,1284,1264,20,1500,1261,239,0.80192487924446,0.257575757575758,1.2644183773216,587,239,348,7,1.5,53.88,5.3,0,0,0,0,0,0,0.0670910427147729,19.3285497052155,9.82253514099854
9.7,"random_policy_SVM","SVM",33,15,1184,1165,19,1600,1360,240,0.768101314493067,0.25,1.25469208211144,614,240,374,27,1.6,57.47,5.7,0,0,0,0,0,0,0.142571900569441,51.3790656668443,16.156408075255
9.7,"random_policy_SVM","SVM",33,16,1084,1067,17,1700,1458,242,0.787968903948284,0.257575757575758,1.2644183773216,623,242,381,9,1.6,61.06,6,0,0,0,0,0,0,0.113839916957195,36.8491528482987,12.6426523539385
9.7,"random_policy_SVM","SVM",33,17,984,967,17,1800,1558,242,0.766764592795521,0.234848484848485,1.2644183773216,612,242,370,-11,1.5,64.66,6.4,0,0,0,0,0,0,0.0654955028567168,15.1354672042052,8.43765901633138
9.7,"random_policy_SVM","SVM",33,18,884,867,17,1900,1658,242,0.770570494797302,0.21969696969697,1.2644183773216,614,242,372,2,1.5,68.25,6.9,0,0,0,0,0,0,0.0206144372290099,4.9531232209391,4.000132829503
9.7,"random_policy_SVM","SVM",33,19,784,767,17,2000,1758,242,0.771633864417371,0.227272727272727,1.2644183773216,627,242,385,13,1.6,71.84,7.3,0,0,0,0,0,0,0.00200122861657408,1.27784729445247,1.22474230403315
9.7,"random_policy_SVM","SVM",33,20,684,669,15,2100,1856,244,0.737524932112553,0.166666666666667,1.2644183773216,622,244,378,-5,1.5,75.43,7.6,0,0,0,0,0,0,6.99863312007172e-05,0.240983809239197,0.23771317974518
9.7,"random_policy_SVM","SVM",33,21,584,576,8,2200,1949,251,0.769320885300271,0.181818181818182,1.28387096774194,682,251,431,60,1.7,79.02,7.8,0,0,0,0,0,0,0.0993385756619827,27.5700852545419,13.6617477045495
9.7,"random_policy_SVM","SVM",33,22,484,481,3,2300,2044,256,0.804736500612786,0.234848484848485,1.27414467253177,679,256,423,-3,1.7,82.61,8,0,0,0,0,0,0,0.0520576696193072,13.5549855681969,8.15004038377452
9.7,"random_policy_SVM","SVM",33,23,384,381,3,2400,2144,256,0.807746377334009,0.242424242424242,1.28387096774194,668,256,412,-11,1.6,86.21,8.4,0,0,0,0,0,0,0.0329496469660425,7.47017397007856,5.07234484239722
9.7,"random_policy_SVM","SVM",33,24,284,282,2,2500,2243,257,0.789693124744673,0.265151515151515,1.28387096774194,681,257,424,13,1.6,89.8,8.7,0,0,0,0,0,0,0.00317381199055655,1.7733850556632,1.67779820958771
9.7,"random_policy_SVM","SVM",33,25,184,183,1,2600,2342,258,0.68424530795665,0.0984848484848485,1.25469208211144,699,258,441,18,1.7,93.39,9.1,0,0,0,0,0,0,0.0432491264247167,10.8574529347754,9.03548172796788
9.7,"random_policy_SVM","SVM",33,26,84,83,1,2700,2442,258,0.798572561459155,0.272727272727273,1.2644183773216,711,258,453,12,1.8,96.98,9.5,0,0,0,0,0,0,0.000472623597951967,1.66867163428695,1.66867163428695
9.7,"random_policy_SVM","SVM",33,27,0,0,0,2784,2525,259,0.769927666834874,0.204545454545455,1.27414467253177,730,259,471,19,1.8,100,9.7,0,0,0,0,0,0,0,0,0
9.7,"random_policy_SVM","SVM",34,0,2684,2419,265,100,93,7,0.560822131050223,0.151260504201681,1.02493900786121,25,7,18,0,2.6,3.59,13.3,0,0,0,0,0,0,0.0981832472085971,197.67858377182,11.5211136319976
9.7,"random_policy_SVM","SVM",34,1,2584,2343,241,200,169,31,0.808741078849127,0.260504201680672,1.26229330441854,75,31,44,50,1.4,7.18,5.5,0,0,0,0,0,0,0.205373661931812,301.580904280694,22.7564319156947
9.7,"random_policy_SVM","SVM",34,2,2484,2268,216,300,244,56,0.80501431341768,0.235294117647059,1.26229330441854,134,56,78,59,1.4,10.78,4.4,0,0,0,0,0,0,0.200366862947743,358.123468085474,20.532840058237
9.7,"random_policy_SVM","SVM",34,3,2384,2200,184,400,312,88,0.752028283841012,0.226890756302521,1.25150447275684,196,88,108,62,1.2,14.37,3.5,0,0,0,0,0,0,0.234090600955662,386.209415461835,26.1818668099372
9.7,"random_policy_SVM","SVM",34,4,2284,2113,171,500,399,101,0.803675316280364,0.26890756302521,1.26229330441854,242,101,141,46,1.4,17.96,4,0,0,0,0,0,0,0.227961065381686,175.674326580539,23.5295053938767
9.7,"random_policy_SVM","SVM",34,5,2184,2034,150,600,478,122,0.802765062068789,0.260504201680672,1.26229330441854,298,122,176,56,1.4,21.55,3.9,0,0,0,0,0,0,0.216268248785723,187.518269579494,21.9770588464741
9.7,"random_policy_SVM","SVM",34,6,2084,1963,121,700,549,151,0.800443254224773,0.226890756302521,1.26229330441854,365,151,214,67,1.4,25.14,3.6,0,0,0,0,0,0,0.227530968547926,166.945560037592,23.2665316030825
9.7,"random_policy_SVM","SVM",34,7,1984,1902,82,800,610,190,0.806326926374952,0.252100840336134,1.26229330441854,441,190,251,76,1.3,28.74,3.2,0,0,0,0,0,0,0.235620145474323,150.619764824986,25.1725114752447
9.7,"random_policy_SVM","SVM",34,8,1884,1821,63,900,691,209,0.800403677954704,0.252100840336134,1.25150447275684,490,209,281,49,1.3,32.33,3.3,0,0,0,0,0,0,0.198693172810929,117.245219578065,21.8677204375095
9.7,"random_policy_SVM","SVM",34,9,1784,1729,55,1000,783,217,0.79865572602668,0.210084033613445,1.25150447275684,505,217,288,15,1.3,35.92,3.6,0,0,0,0,0,0,0.153008624865767,92.0518500787557,18.3424958800566
9.7,"random_policy_SVM","SVM",34,10,1684,1642,42,1100,870,230,0.811979736949731,0.210084033613445,1.26229330441854,541,230,311,36,1.4,39.51,3.8,0,0,0,0,0,0,0.162530553674615,97.5640888493582,19.3889752939413
9.7,"random_policy_SVM","SVM",34,11,1584,1553,31,1200,959,241,0.813041700196567,0.201680672268908,1.26229330441854,579,241,338,38,1.4,43.1,4,0,0,0,0,0,0,0.146698445080066,69.0330443698894,17.7375759466888
9.7,"random_policy_SVM","SVM",34,12,1484,1460,24,1300,1052,248,0.805199002678001,0.184873949579832,1.25150447275684,605,248,357,26,1.4,46.7,4.2,0,0,0,0,0,0,0.146581548490445,61.8730824282094,17.7793550992259
9.7,"random_policy_SVM","SVM",34,13,1384,1361,23,1400,1151,249,0.810924369747905,0.201680672268908,1.26229330441854,609,249,360,4,1.4,50.29,4.6,0,0,0,0,0,0,0.12535614976989,58.2192393406518,14.3189515716028
9.7,"random_policy_SVM","SVM",34,14,1284,1264,20,1500,1248,252,0.809558988430543,0.210084033613445,1.26229330441854,642,252,390,33,1.5,53.88,5,0,0,0,0,0,0,0.125876250254336,54.2097507012896,14.5704064149106
9.7,"random_policy_SVM","SVM",34,15,1184,1167,17,1600,1345,255,0.802145033837718,0.19327731092437,1.26229330441854,663,255,408,21,1.6,57.47,5.3,0,0,0,0,0,0,0.0940438760458735,33.194144873686,12.8230580394413
9.7,"random_policy_SVM","SVM",34,16,1084,1067,17,1700,1445,255,0.800812632745413,0.210084033613445,1.26229330441854,660,255,405,-3,1.6,61.06,5.7,0,0,0,0,0,0,0.0594984599258007,18.151273460272,7.78720917346597
9.7,"random_policy_SVM","SVM",34,17,984,967,17,1800,1545,255,0.793847209213361,0.19327731092437,1.26229330441854,654,255,399,-6,1.6,64.66,6.1,0,0,0,0,0,0,0.0227384448929695,6.83343115529736,3.61702079068265
9.7,"random_policy_SVM","SVM",34,18,884,868,16,1900,1644,256,0.787910768703092,0.159663865546218,1.26229330441854,655,256,399,1,1.6,68.25,6.4,0,0,0,0,0,0,0.0151305995476107,4.88906801863324,2.4178382380903
9.7,"random_policy_SVM","SVM",34,19,784,771,13,2000,1741,259,0.797283748664306,0.218487394957983,1.26229330441854,671,259,412,16,1.6,71.84,6.7,0,0,0,0,0,0,0.0690193058510128,23.9187839632208,9.84154649286164
9.7,"random_policy_SVM","SVM",34,20,684,671,13,2100,1841,259,0.808200203158192,0.235294117647059,1.26229330441854,664,259,405,-7,1.6,75.43,7.1,0,0,0,0,0,0,0.0420584427220457,13.2993051149782,5.76711167563043
9.7,"random_policy_SVM","SVM",34,21,584,573,11,2200,1939,261,0.817527010804326,0.277310924369748,1.27308213608024,667,261,406,3,1.6,79.02,7.4,0,0,0,0,0,0,0.0155512327697452,4.50705743364283,3.53015945261618
9.7,"random_policy_SVM","SVM",34,22,484,481,3,2300,2031,269,0.814967745339897,0.210084033613445,1.27308213608024,710,269,441,43,1.6,82.61,7.6,0,0,0,0,0,0,0.00729596489941603,4.11717472364265,3.75445630901578
9.7,"random_policy_SVM","SVM",34,23,384,384,0,2400,2128,272,0.814301544793745,0.260504201680672,1.27308213608024,745,272,473,35,1.7,86.21,7.8,0,0,0,0,0,0,0.0411858761845568,12.2204976178429,9.57975843707655
9.7,"random_policy_SVM","SVM",34,24,284,284,0,2500,2228,272,0.824083479545668,0.235294117647059,1.28387096774194,739,272,467,-6,1.7,89.8,8.2,0,0,0,0,0,0,0.0118868898476713,3.68709342993036,2.96014232047125
9.7,"random_policy_SVM","SVM",34,25,184,184,0,2600,2328,272,0.792178409825472,0.235294117647059,1.27308213608024,745,272,473,6,1.7,93.39,8.6,0,0,0,0,0,0,0.00147362733695475,0.657890579187406,0.613570897072012
9.7,"random_policy_SVM","SVM",34,26,84,84,0,2700,2428,272,0.773920557233885,0.210084033613445,1.27308213608024,734,272,462,-11,1.7,96.98,8.9,0,0,0,0,0,0,1.79798842590237e-06,0.0195702541188278,0.0195702541188278
9.7,"random_policy_SVM","SVM",34,27,0,0,0,2784,2512,272,0.809756869780883,0.277310924369748,1.27308213608024,713,272,441,-21,1.6,100,9.2,0,0,0,0,0,0,0,0,0
9.7,"random_policy_SVM","SVM",35,0,2684,2441,243,100,92,8,0.736797400524457,0.135714285714286,1.27470046082949,26,8,18,0,2.2,3.59,11.5,0,0,0,0,0,0,0.137982529761683,221.928344076295,15.1554750128756
9.7,"random_policy_SVM","SVM",35,1,2584,2356,228,200,177,23,0.668806293467111,0.1,1.16465437788018,75,23,52,49,2.3,7.18,7.7,0,0,0,0,0,0,0.148779523192323,288.714599571824,16.0472364071712
9.7,"random_policy_SVM","SVM",35,2,2484,2261,223,300,272,28,0.780994185383653,0.221428571428571,1.26552995391705,94,28,66,19,2.4,10.78,9.7,0,0,0,0,0,0,0.117125564368331,192.102989652336,12.3738605146938
9.7,"random_policy_SVM","SVM",35,3,2384,2180,204,400,353,47,0.804497776764333,0.257142857142857,1.27470046082949,148,47,101,54,2.1,14.37,7.5,0,0,0,0,0,0,0.152288994734914,177.873526227192,15.7463006313016
9.7,"random_policy_SVM","SVM",35,4,2284,2118,166,500,415,85,0.79875156766617,0.235714285714286,1.27470046082949,227,85,142,79,1.7,17.96,4.9,0,0,0,0,0,0,0.199995920723897,193.8830038749,21.1721665016778
9.7,"random_policy_SVM","SVM",35,5,2184,2035,149,600,498,102,0.822312165089498,0.321428571428571,1.27470046082949,272,102,170,45,1.7,21.55,4.9,0,0,0,0,0,0,0.210650915577999,127.313085691821,21.670356428913
9.7,"random_policy_SVM","SVM",35,6,2084,1966,118,700,567,133,0.821975829437918,0.307142857142857,1.27470046082949,348,133,215,76,1.6,25.14,4.3,0,0,0,0,0,0,0.221051853550315,125.672138627922,22.7881237151592
9.7,"random_policy_SVM","SVM",35,7,1984,1892,92,800,641,159,0.816583057804123,0.292857142857143,1.27470046082949,401,159,242,53,1.5,28.74,4,0,0,0,0,0,0,0.211801796358577,93.6115554775726,22.516734361609
9.7,"random_policy_SVM","SVM",35,8,1884,1813,71,900,720,180,0.811355603693989,0.264285714285714,1.27470046082949,455,180,275,54,1.5,32.33,4,0,0,0,0,0,0,0.164373958908096,73.9436035346452,19.2900111471768
9.7,"random_policy_SVM","SVM",35,9,1784,1720,64,1000,813,187,0.787036825903546,0.171428571428571,1.27470046082949,477,187,290,22,1.6,35.92,4.3,0,0,0,0,0,0,0.101304281436052,40.7481696420234,13.2199988240199
9.7,"random_policy_SVM","SVM",35,10,1684,1628,56,1100,905,195,0.808505301561962,0.257142857142857,1.27470046082949,525,195,330,48,1.7,39.51,4.6,0,0,0,0,0,0,0.14319712663046,58.3314093960793,19.3824929182883
9.7,"random_policy_SVM","SVM",35,11,1584,1541,43,1200,992,208,0.81658305780412,0.214285714285714,1.27470046082949,538,208,330,13,1.6,43.1,4.8,0,0,0,0,0,0,0.0746684772704244,25.033273174413,12.3751706149597
9.7,"random_policy_SVM","SVM",35,12,1484,1451,33,1300,1082,218,0.823571998631855,0.257142857142857,1.26552995391705,541,218,323,3,1.5,46.7,5,0,0,0,0,0,0,0.0943257821181409,32.3841828421377,11.8474638174093
9.7,"random_policy_SVM","SVM",35,13,1384,1357,27,1400,1176,224,0.831073993843349,0.257142857142857,1.27470046082949,570,224,346,29,1.5,50.29,5.2,0,0,0,0,0,0,0.0626400754093492,23.3112662943248,10.2339878346574
9.7,"random_policy_SVM","SVM",35,14,1284,1262,22,1500,1271,229,0.839140348876977,0.292857142857143,1.27470046082949,592,229,363,22,1.6,53.88,5.6,0,0,0,0,0,0,0.0641552237971942,22.1540329278354,10.134423939102
9.7,"random_policy_SVM","SVM",35,15,1184,1172,12,1600,1361,239,0.836763196898868,0.285714285714286,1.27470046082949,620,239,381,28,1.6,57.47,5.7,0,0,0,0,0,0,0.0305486072160233,10.0825627317178,6.97005567788917
9.7,"random_policy_SVM","SVM",35,16,1084,1076,8,1700,1457,243,0.802285942309885,0.178571428571429,1.28387096774194,648,243,405,28,1.7,61.06,6,0,0,0,0,0,0,0.0613984659988367,20.380254519714,9.80826009418112
9.7,"random_policy_SVM","SVM",35,17,984,978,6,1800,1555,245,0.830549538251056,0.264285714285714,1.28387096774194,650,245,405,2,1.7,64.66,6.3,0,0,0,0,0,0,0.0929641268181131,30.6335273372526,12.9611905297309
9.7,"random_policy_SVM","SVM",35,18,884,879,5,1900,1654,246,0.836540873332574,0.292857142857143,1.28387096774194,668,246,422,18,1.7,68.25,6.7,0,0,0,0,0,0,0.0560324001396116,16.2648060626539,8.69545750610864
9.7,"random_policy_SVM","SVM",35,19,784,779,5,2000,1754,246,0.808163265306126,0.221428571428571,1.28387096774194,661,246,415,-7,1.7,71.84,7.1,0,0,0,0,0,0,0.0173240216733664,5.52709233175603,3.22783857519308
9.7,"random_policy_SVM","SVM",35,20,684,680,4,2100,1853,247,0.816417740280474,0.228571428571429,1.28387096774194,668,247,421,7,1.7,75.43,7.5,0,0,0,0,0,0,0.0123658544081525,4.29567074670391,2.92117428411176
9.7,"random_policy_SVM","SVM",35,21,584,582,2,2200,1951,249,0.746288906624105,0.157142857142857,1.28387096774194,679,249,430,11,1.7,79.02,7.8,0,0,0,0,0,0,0.0108290285410135,3.68399728660355,2.73008779005713
9.7,"random_policy_SVM","SVM",35,22,484,482,2,2300,2051,249,0.806521491278076,0.228571428571429,1.28387096774194,690,249,441,11,1.8,82.61,8.2,0,0,0,0,0,0,0.00274293088120422,0.991146727792998,0.778288235883026
9.7,"random_policy_SVM","SVM",35,23,384,382,2,2400,2151,249,0.805461178884964,0.264285714285714,1.28387096774194,676,249,427,-14,1.7,86.21,8.6,0,0,0,0,0,0,0.00108729188112573,0.537297268162251,0.479303202351112
9.7,"random_policy_SVM","SVM",35,24,284,283,1,2500,2250,250,0.820938319461865,0.3,1.27470046082949,702,250,452,26,1.8,89.8,9,0,0,0,0,0,0,0.0283254899251358,11.4140226169465,10.0229575984911
9.7,"random_policy_SVM","SVM",35,25,184,184,0,2600,2349,251,0.793296089385484,0.192857142857143,1.26552995391705,710,251,459,8,1.8,93.39,9.4,0,0,0,0,0,0,0.00335297418512452,2.97873589958071,2.88482550358912
9.7,"random_policy_SVM","SVM",35,26,84,84,0,2700,2449,251,0.768213430623653,0.164285714285714,1.25635944700461,702,251,451,-8,1.8,96.98,9.8,0,0,0,0,0,0,5.43576502864001e-06,0.145700398855654,0.145700398855654
9.7,"random_policy_SVM","SVM",35,27,0,0,0,2784,2533,251,0.741848135902406,0.164285714285714,1.24718894009217,692,251,441,-10,1.8,100,10.1,0,0,0,0,0,0,0,0,0
9.7,"random_policy_SVM","SVM",36,0,2684,2439,245,100,91,9,0.693267934353062,0.313868613138686,1.09644454909348,24,9,15,0,1.7,3.59,10.1,0,0,0,0,0,0,0.130595800046316,241.561598015512,13.7280291621433
9.7,"random_policy_SVM","SVM",36,1,2584,2371,213,200,159,41,0.739481147426657,0.153284671532847,1.28387096774194,105,41,64,81,1.6,7.18,3.9,0,0,0,0,0,0,0.264117388228074,491.067304172092,31.9644047795842
9.7,"random_policy_SVM","SVM",36,2,2484,2283,201,300,247,53,0.695516992886704,0.175182481751825,1.21827172121498,134,53,81,29,1.5,10.78,4.7,0,0,0,0,0,0,0.207518931591554,425.629732202415,22.1311368488064
9.7,"random_policy_SVM","SVM",36,3,2384,2188,196,400,342,58,0.765818959505324,0.277372262773723,1.23701436307982,150,58,92,16,1.6,14.37,5.9,0,0,0,0,0,0,0.182643042719949,276.197381369521,19.6173347307397
9.7,"random_policy_SVM","SVM",36,4,2284,2108,176,500,422,78,0.791842949463027,0.299270072992701,1.25575700494467,205,78,127,55,1.6,17.96,5.4,0,0,0,0,0,0,0.186090366453656,235.503600930321,19.1689135013405
9.7,"random_policy_SVM","SVM",36,5,2184,2039,145,600,491,109,0.796823422753275,0.313868613138686,1.25575700494467,279,109,170,74,1.6,21.55,4.5,0,0,0,0,0,0,0.205958031526673,238.969773708493,22.0423185094314
9.7,"random_policy_SVM","SVM",36,6,2084,1970,114,700,560,140,0.805104839834498,0.313868613138686,1.26512832587709,351,140,211,72,1.5,25.14,4,0,0,0,0,0,0,0.214759956137021,246.668869887337,22.5618681005597
9.7,"random_policy_SVM","SVM",36,7,1984,1888,96,800,642,158,0.813025942628672,0.328467153284672,1.25575700494467,386,158,228,35,1.4,28.74,4.1,0,0,0,0,0,0,0.184011269440424,158.036223688636,20.0748844372859
9.7,"random_policy_SVM","SVM",36,8,1884,1805,79,900,725,175,0.828554326096057,0.386861313868613,1.27449964680951,421,175,246,35,1.4,32.33,4.1,0,0,0,0,0,0,0.171031801510451,139.361503757722,19.1162657922108
9.7,"random_policy_SVM","SVM",36,9,1784,1714,70,1000,816,184,0.833145427495474,0.394160583941606,1.26512832587709,455,184,271,34,1.5,35.92,4.4,0,0,0,0,0,0,0.154698270685794,110.239614143744,17.209824351537
9.7,"random_policy_SVM","SVM",36,10,1684,1624,60,1100,906,194,0.816111860151567,0.328467153284672,1.26512832587709,483,194,289,28,1.5,39.51,4.7,0,0,0,0,0,0,0.151622592036007,109.711275636082,16.8395644511646
9.7,"random_policy_SVM","SVM",36,11,1584,1530,54,1200,1000,200,0.819930029290068,0.328467153284672,1.26512832587709,502,200,302,19,1.5,43.1,5,0,0,0,0,0,0,0.13041500428004,80.4643585267832,14.9708995629563
9.7,"random_policy_SVM","SVM",36,12,1484,1436,48,1300,1094,206,0.814257985029525,0.321167883211679,1.25575700494467,528,206,322,26,1.6,46.7,5.3,0,0,0,0,0,0,0.145962425524545,83.0648136400266,16.2698105678511
9.7,"random_policy_SVM","SVM",36,13,1384,1342,42,1400,1188,212,0.814914686875262,0.335766423357664,1.20890040028255,569,212,357,41,1.7,50.29,5.6,0,0,0,0,0,0,0.127483791918807,74.2892440690429,14.1820304495336
9.7,"random_policy_SVM","SVM",36,14,1284,1247,37,1500,1283,217,0.821063275838024,0.335766423357664,1.25575700494467,589,217,372,20,1.7,53.88,5.9,0,0,0,0,0,0,0.0960990387879505,40.9593051859168,11.6757096074848
9.7,"random_policy_SVM","SVM",36,15,1184,1151,33,1600,1379,221,0.797718396950121,0.233576642335766,1.26512832587709,593,221,372,4,1.7,57.47,6.2,0,0,0,0,0,0,0.0861288064795092,28.9694497284466,13.4259259497657
9.7,"random_policy_SVM","SVM",36,16,1084,1066,18,1700,1464,236,0.821905946348046,0.306569343065693,1.26512832587709,632,236,396,39,1.7,61.06,6.2,0,0,0,0,0,0,0.0539569377115941,16.6119545932929,8.74137148505321
9.7,"random_policy_SVM","SVM",36,17,984,971,13,1800,1559,241,0.799217769305879,0.291970802919708,1.25575700494467,644,241,403,12,1.7,64.66,6.5,0,0,0,0,0,0,0.0231749789618279,8.40096071631334,4.38296064885007
9.7,"random_policy_SVM","SVM",36,18,884,873,11,1900,1657,243,0.827206053280032,0.299270072992701,1.25575700494467,644,243,401,0,1.7,68.25,6.8,0,0,0,0,0,0,0.0072189118450508,2.37487799951267,1.46162679548474
9.7,"random_policy_SVM","SVM",36,19,784,776,8,2000,1754,246,0.834743595704129,0.306569343065693,1.27449964680951,654,246,408,10,1.7,71.84,7.1,0,0,0,0,0,0,0.0391154388784319,13.0762363524768,9.00329541470123
9.7,"random_policy_SVM","SVM",36,20,684,680,4,2100,1850,250,0.795783160537452,0.233576642335766,1.27449964680951,694,250,444,40,1.8,75.43,7.4,0,0,0,0,0,0,0.10626111429439,26.9299146451751,16.0240003447775
9.7,"random_policy_SVM","SVM",36,21,584,583,1,2200,1947,253,0.781010274768706,0.211678832116788,1.27449964680951,691,253,438,-3,1.7,79.02,7.7,0,0,0,0,0,0,0.089321932845854,30.731762839275,19.473224893878
9.7,"random_policy_SVM","SVM",36,22,484,483,1,2300,2047,253,0.826473801664424,0.313868613138686,1.27449964680951,692,253,439,1,1.7,82.61,8.1,0,0,0,0,0,0,0.026763621120193,6.88380578731834,4.69733890854493
9.7,"random_policy_SVM","SVM",36,23,384,383,1,2400,2147,253,0.805825468408576,0.233576642335766,1.27449964680951,687,253,434,-5,1.7,86.21,8.5,0,0,0,0,0,0,0.00389379208417852,1.28170752088946,1.00885864518352
9.7,"random_policy_SVM","SVM",36,24,284,284,0,2500,2246,254,0.810614161513789,0.27007299270073,1.27449964680951,707,254,453,20,1.8,89.8,8.8,0,0,0,0,0,0,0.00109877087089933,0.743103211493016,0.685541411395947
9.7,"random_policy_SVM","SVM",36,25,184,184,0,2600,2346,254,0.826026314566001,0.277372262773723,1.27449964680951,687,254,433,-20,1.7,93.39,9.2,0,0,0,0,0,0,0.000210467083146346,0.176554345049011,0.169524950699086
9.7,"random_policy_SVM","SVM",36,26,84,84,0,2700,2446,254,0.817378771676977,0.284671532846715,1.27449964680951,687,254,433,0,1.7,96.98,9.6,0,0,0,0,0,0,2.44654743812147e-07,0.00470341523264716,0.00470341523264716
9.7,"random_policy_SVM","SVM",36,27,0,0,0,2784,2530,254,0.820900553256781,0.299270072992701,1.27449964680951,714,254,460,27,1.8,100,10,0,0,0,0,0,0,0,0,0
9.7,"random_policy_SVM","SVM",37,0,2684,2439,245,100,90,10,0.803266413964159,0.286764705882353,1.27443074003795,30,10,20,0,2,3.59,9,0,0,0,0,0,0,0.153870694419222,260.736389695063,16.8521763068293
9.7,"random_policy_SVM","SVM",37,1,2584,2373,211,200,156,44,0.715101314989009,0.183823529411765,1.246110056926,110,44,66,80,1.5,7.18,3.5,0,0,0,0,0,0,0.2583587223632,483.84091913782,30.6175713465313
9.7,"random_policy_SVM","SVM",37,2,2484,2287,197,300,242,58,0.647123169076699,0.139705882352941,1.14226755218216,155,58,97,45,1.7,10.78,4.2,0,0,0,0,0,0,0.210821862846221,412.739554472684,21.9055068366238
9.7,"random_policy_SVM","SVM",37,3,2384,2203,181,400,326,74,0.773562169497873,0.316176470588235,1.18946869070209,178,74,104,23,1.4,14.37,4.4,0,0,0,0,0,0,0.201125361242961,351.404315350199,21.0845967850538
9.7,"random_policy_SVM","SVM",37,4,2284,2133,151,500,396,104,0.789449670082829,0.308823529411765,1.21778937381404,250,104,146,72,1.4,17.96,3.8,0,0,0,0,0,0,0.223209247585412,351.22974178928,22.689353178172
9.7,"random_policy_SVM","SVM",37,5,2184,2061,123,600,468,132,0.781102297721002,0.316176470588235,1.19890891840607,319,132,187,69,1.4,21.55,3.5,0,0,0,0,0,0,0.222858710877548,241.062947506618,23.2973247372572
9.7,"random_policy_SVM","SVM",37,6,2084,1983,101,700,546,154,0.794187842201327,0.330882352941176,1.19890891840607,372,154,218,53,1.4,25.14,3.5,0,0,0,0,0,0,0.211584628053148,245.466821217444,22.3818911891414
9.7,"random_policy_SVM","SVM",37,7,1984,1901,83,800,628,172,0.808045533249101,0.294117647058824,1.20834914611006,413,172,241,41,1.4,28.74,3.7,0,0,0,0,0,0,0.202103198080067,217.015263441577,21.3657301060642
9.7,"random_policy_SVM","SVM",37,8,1884,1829,55,900,700,200,0.802388974682954,0.242647058823529,1.21778937381404,490,200,290,77,1.4,32.33,3.5,0,0,0,0,0,0,0.205486164960021,162.547227815767,22.3738912447664
9.7,"random_policy_SVM","SVM",37,9,1784,1743,41,1000,786,214,0.786589218026112,0.191176470588235,1.22722960151803,527,214,313,37,1.5,35.92,3.7,0,0,0,0,0,0,0.209582809494298,174.550921911128,22.4758083772662
9.7,"random_policy_SVM","SVM",37,10,1684,1647,37,1100,882,218,0.797867237587161,0.242647058823529,1.25555028462998,542,218,324,15,1.5,39.51,4,0,0,0,0,0,0,0.174691457351895,101.692046347782,18.7230976321162
9.7,"random_policy_SVM","SVM",37,11,1584,1553,31,1200,976,224,0.79849314427442,0.220588235294118,1.21778937381404,571,224,347,29,1.5,43.1,4.4,0,0,0,0,0,0,0.156947771930677,74.0403312420211,17.465054272783
9.7,"random_policy_SVM","SVM",37,12,1484,1461,23,1300,1068,232,0.805951378164634,0.220588235294118,1.21666802079948,591,232,359,20,1.5,46.7,4.6,0,0,0,0,0,0,0.109710268986736,48.9022426109209,13.7001196613705
9.7,"random_policy_SVM","SVM",37,13,1384,1365,19,1400,1164,236,0.791982544807899,0.176470588235294,1.23666982922201,602,236,366,11,1.6,50.29,4.9,0,0,0,0,0,0,0.104661691871018,51.5611214437299,13.0580454988713
9.7,"random_policy_SVM","SVM",37,14,1284,1266,18,1500,1263,237,0.803629088867052,0.264705882352941,1.21778937381404,595,237,358,-7,1.5,53.88,5.3,0,0,0,0,0,0,0.0415382798048386,14.0741314054401,5.77834655456989
9.7,"random_policy_SVM","SVM",37,15,1184,1166,18,1600,1363,237,0.807226589919977,0.25,1.22722960151803,602,237,365,7,1.5,57.47,5.8,0,0,0,0,0,0,0.0270225026798194,8.90438775568562,3.75368333444109
9.7,"random_policy_SVM","SVM",37,16,1084,1071,13,1700,1458,242,0.801493986616121,0.257352941176471,1.22722960151803,608,242,366,6,1.5,61.06,6,0,0,0,0,0,0,0.04417451622238,19.3447535606524,5.5075470418427
9.7,"random_policy_SVM","SVM",37,17,984,973,11,1800,1556,244,0.804190650007016,0.286764705882353,1.22722960151803,630,244,386,22,1.6,64.66,6.4,0,0,0,0,0,0,0.0552517202855065,21.2735044419646,8.29033672518946
9.7,"random_policy_SVM","SVM",37,18,884,874,10,1900,1655,245,0.806787870279378,0.235294117647059,1.22722960151803,629,245,384,-1,1.6,68.25,6.8,0,0,0,0,0,0,0.0221952793130602,8.51420625587639,3.46560106197957
9.7,"random_policy_SVM","SVM",37,19,784,775,9,2000,1754,246,0.780581683747481,0.183823529411765,1.22722960151803,645,246,399,16,1.6,71.84,7.1,0,0,0,0,0,0,0.0857128397989716,24.4025059533344,12.6220896378362
9.7,"random_policy_SVM","SVM",37,20,684,675,9,2100,1854,246,0.784465814965605,0.25,1.21778937381404,643,246,397,-2,1.6,75.43,7.5,0,0,0,0,0,0,0.036218599699371,13.315475905906,5.91102498135587
9.7,"random_policy_SVM","SVM",37,21,584,575,9,2200,1954,246,0.813222425008184,0.264705882352941,1.22722960151803,651,246,405,8,1.6,79.02,7.9,0,0,0,0,0,0,0.00644703663013819,2.09145599115622,1.30290887953564
9.7,"random_policy_SVM","SVM",37,22,484,477,7,2300,2052,248,0.771772193364213,0.191176470588235,1.21778937381404,681,248,433,30,1.7,82.61,8.3,0,0,0,0,0,0,0.0499984254970586,14.5536273320507,10.5738544993037
9.7,"random_policy_SVM","SVM",37,23,384,377,7,2400,2152,248,0.789133791941594,0.220588235294118,1.21778937381404,665,248,417,-16,1.7,86.21,8.7,0,0,0,0,0,0,0.0102580016791436,4.24730919932465,3.22628697115384
9.7,"random_policy_SVM","SVM",37,24,284,279,5,2500,2250,250,0.75067855304413,0.169117647058824,1.22722960151803,654,250,404,-11,1.6,89.8,9,0,0,0,0,0,0,0.00997601017356788,3.5897364422134,2.78504740346382
9.7,"random_policy_SVM","SVM",37,25,184,182,2,2600,2347,253,0.818539707052273,0.257352941176471,1.27443074003795,682,253,429,28,1.7,93.39,9.3,0,0,0,0,0,0,0.00291160586486541,2.28764678138548,2.20458795809516
9.7,"random_policy_SVM","SVM",37,26,84,84,0,2700,2445,255,0.79283658570827,0.227941176470588,1.28387096774194,681,255,426,-1,1.7,96.98,9.6,0,0,0,0,0,0,9.60015353241032e-07,0.24255518665603,0.24255518665603
9.7,"random_policy_SVM","SVM",37,27,0,0,0,2784,2529,255,0.814731620571859,0.272058823529412,1.27443074003795,705,255,450,24,1.8,100,9.9,0,0,0,0,0,0,0,0,0
9.7,"random_policy_SVM","SVM",38,0,2684,2422,262,100,91,9,0.794619010212096,0.183333333333333,1.26247311827957,28,9,19,0,2.1,3.59,10.1,0,0,0,0,0,0,0.136276218808001,241.070226121318,16.2414332089668
9.7,"random_policy_SVM","SVM",38,1,2584,2345,239,200,168,32,0.797145849698876,0.158333333333333,1.26247311827957,79,32,47,51,1.5,7.18,5.2,0,0,0,0,0,0,0.179495205807226,344.177186366678,18.6452520505207
9.7,"random_policy_SVM","SVM",38,2,2484,2271,213,300,242,58,0.799731605132231,0.258333333333333,1.26247311827957,147,58,89,68,1.5,10.78,4.2,0,0,0,0,0,0,0.241635721038458,285.945256275939,25.6537647640686
9.7,"random_policy_SVM","SVM",38,3,2384,2201,183,400,312,88,0.794442262372339,0.233333333333333,1.26247311827957,211,88,123,64,1.4,14.37,3.5,0,0,0,0,0,0,0.226882081314227,234.784443804365,24.0083438379324
9.7,"random_policy_SVM","SVM",38,4,2284,2129,155,500,384,116,0.803953914637336,0.266666666666667,1.26247311827957,278,116,162,67,1.4,17.96,3.3,0,0,0,0,0,0,0.231234697209946,191.665808143071,24.2777467820069
9.7,"random_policy_SVM","SVM",38,5,2184,2060,124,600,453,147,0.803043990573448,0.266666666666667,1.26247311827957,350,147,203,72,1.4,21.55,3.1,0,0,0,0,0,0,0.246478956811352,195.008001655182,25.630075259028
9.7,"random_policy_SVM","SVM",38,6,2084,1982,102,700,531,169,0.803790259230164,0.241666666666667,1.26247311827957,411,169,242,61,1.4,25.14,3.1,0,0,0,0,0,0,0.237633454414044,142.44341625641,24.7187618465524
9.7,"random_policy_SVM","SVM",38,7,1984,1906,78,800,607,193,0.80907960199005,0.216666666666667,1.26247311827957,463,193,270,52,1.4,28.74,3.1,0,0,0,0,0,0,0.231818532691772,156.285141828232,24.9583476015387
9.7,"random_policy_SVM","SVM",38,8,1884,1823,61,900,690,210,0.804444880858866,0.208333333333333,1.26247311827957,506,210,296,43,1.4,32.33,3.3,0,0,0,0,0,0,0.211160416208781,203.610721284481,22.1581046735528
9.7,"random_policy_SVM","SVM",38,9,1784,1733,51,1000,780,220,0.804268133019114,0.225,1.26247311827957,530,220,310,24,1.4,35.92,3.5,0,0,0,0,0,0,0.172634347015023,145.615628876176,20.0104904557
9.7,"random_policy_SVM","SVM",38,10,1684,1641,43,1100,872,228,0.778633150039272,0.233333333333333,1.23037634408602,534,228,306,4,1.3,39.51,3.8,0,0,0,0,0,0,0.211773388569015,200.77728438697,23.7738675559084
9.7,"random_policy_SVM","SVM",38,11,1584,1548,36,1200,965,235,0.810185912542539,0.258333333333333,1.27317204301075,571,235,336,37,1.4,43.1,4.1,0,0,0,0,0,0,0.154450653251985,61.9318036410675,17.500246601367
9.7,"random_policy_SVM","SVM",38,12,1484,1460,24,1300,1053,247,0.756493846556682,0.075,1.27317204301075,599,247,352,28,1.4,46.7,4.3,0,0,0,0,0,0,0.253586653546878,174.820957899069,35.1042774456337
9.7,"random_policy_SVM","SVM",38,13,1384,1361,23,1400,1152,248,0.801819848127776,0.183333333333333,1.27317204301075,616,248,368,17,1.5,50.29,4.6,0,0,0,0,0,0,0.155818507811339,95.8934143988963,17.3593896695431
9.7,"random_policy_SVM","SVM",38,14,1284,1268,16,1500,1245,255,0.824044252422097,0.233333333333333,1.26247311827957,634,255,379,18,1.5,53.88,4.9,0,0,0,0,0,0,0.11397051742697,54.1956085399617,13.0258511858508
9.7,"random_policy_SVM","SVM",38,15,1184,1175,9,1600,1338,262,0.826865671641788,0.258333333333333,1.27317204301075,651,262,389,17,1.5,57.47,5.1,0,0,0,0,0,0,0.0936561464178085,41.1573668111948,10.9630157089161
9.7,"random_policy_SVM","SVM",38,16,1084,1078,6,1700,1435,265,0.83270489656977,0.275,1.27317204301075,670,265,405,19,1.5,61.06,5.4,0,0,0,0,0,0,0.0684978567899472,26.1581852938251,8.75589521199538
9.7,"random_policy_SVM","SVM",38,17,984,980,4,1800,1533,267,0.807731081434924,0.183333333333333,1.26247311827957,671,267,404,1,1.5,64.66,5.7,0,0,0,0,0,0,0.0573035547216881,17.5889197870039,8.06977463069581
9.7,"random_policy_SVM","SVM",38,18,884,880,4,1900,1633,267,0.812752029327037,0.208333333333333,1.27317204301075,677,267,410,6,1.5,68.25,6.1,0,0,0,0,0,0,0.0564204078583839,18.9169573953765,6.86898216823431
9.7,"random_policy_SVM","SVM",38,19,784,782,2,2000,1731,269,0.808280963603037,0.2,1.26247311827957,699,269,430,22,1.6,71.84,6.4,0,0,0,0,0,0,0.037716389450415,22.2248858166287,18.820572350403
9.7,"random_policy_SVM","SVM",38,20,684,683,1,2100,1830,270,0.798330714846811,0.183333333333333,1.27317204301075,701,270,431,2,1.6,75.43,6.8,0,0,0,0,0,0,0.0405584964704473,12.312041192663,7.58686646905415
9.7,"random_policy_SVM","SVM",38,21,584,583,1,2200,1930,270,0.81242471851269,0.233333333333333,1.27317204301075,695,270,425,-6,1.6,79.02,7.1,0,0,0,0,0,0,0.0341085685809569,9.98420685118129,4.7811147325473
9.7,"random_policy_SVM","SVM",38,22,484,483,1,2300,2030,270,0.7822401152134,0.158333333333333,1.27317204301075,703,270,433,8,1.6,82.61,7.5,0,0,0,0,0,0,0.00522642362233223,1.62461250711712,1.26108717936805
9.7,"random_policy_SVM","SVM",38,23,384,383,1,2400,2130,270,0.816254255040577,0.191666666666667,1.27317204301075,696,270,426,-7,1.6,86.21,7.9,0,0,0,0,0,0,0.00412483867540053,1.34195115249578,0.992285645174135
9.7,"random_policy_SVM","SVM",38,24,284,284,0,2500,2229,271,0.8009033778476,0.158333333333333,1.27317204301075,711,271,440,15,1.6,89.8,8.2,0,0,0,0,0,0,0.0110458090275767,8.63314650199071,8.11853058075765
9.7,"random_policy_SVM","SVM",38,25,184,184,0,2600,2329,271,0.807639434406914,0.191666666666667,1.28387096774194,693,271,422,-18,1.6,93.39,8.6,0,0,0,0,0,0,0.000211663103330939,0.305207085501735,0.299295537170421
9.7,"random_policy_SVM","SVM",38,26,84,84,0,2700,2429,271,0.832122283320238,0.291666666666667,1.27317204301075,718,271,447,25,1.6,96.98,9,0,0,0,0,0,0,1.82447978261357e-07,0.0280643741070728,0.0280643741070728
9.7,"random_policy_SVM","SVM",38,27,0,0,0,2784,2513,271,0.82249934537837,0.241666666666667,1.28387096774194,706,271,435,-12,1.6,100,9.3,0,0,0,0,0,0,0,0,0
9.7,"random_policy_SVM","SVM",39,0,2684,2423,261,100,91,9,0.794512448671969,0.371900826446281,1.18837643295121,21,9,12,0,1.3,3.59,10.1,0,0,0,0,0,0,0.274954271881792,239.951204332016,30.5045505041809
9.7,"random_policy_SVM","SVM",39,1,2584,2362,222,200,152,48,0.782590051457976,0.198347107438017,1.24142895227939,102,48,54,81,1.1,7.18,3.2,0,0,0,0,0,0,0.246774121263506,584.417726224232,25.035362351083
9.7,"random_policy_SVM","SVM",39,2,2484,2280,204,300,234,66,0.81075549664744,0.297520661157025,1.28387096774194,150,66,84,48,1.3,10.78,3.5,0,0,0,0,0,0,0.250042948284456,386.095883797622,26.37089922125
9.7,"random_policy_SVM","SVM",39,3,2384,2193,191,400,321,79,0.835626851707474,0.264462809917355,1.28387096774194,192,79,113,42,1.4,14.37,4.1,0,0,0,0,0,0,0.217450113314619,205.398557509028,22.1983960423277
9.7,"random_policy_SVM","SVM",39,4,2284,2125,159,500,389,111,0.82784318311764,0.297520661157025,1.26264996001066,257,111,146,65,1.3,17.96,3.5,0,0,0,0,0,0,0.24441904881143,171.321172338341,25.7404519688929
9.7,"random_policy_SVM","SVM",39,5,2184,2059,125,600,455,145,0.83146863142576,0.322314049586777,1.26264996001066,336,145,191,79,1.3,21.55,3.1,0,0,0,0,0,0,0.217511586949239,148.08917856126,23.8622310520047
9.7,"random_policy_SVM","SVM",39,6,2084,1986,98,700,528,172,0.789418628826858,0.28099173553719,1.26264996001066,411,172,239,75,1.4,25.14,3.1,0,0,0,0,0,0,0.246083190468175,206.118513335577,26.4422223398677
9.7,"random_policy_SVM","SVM",39,7,1984,1902,82,800,612,188,0.743515775248196,0.231404958677686,1.15654492135431,453,188,265,42,1.4,28.74,3.3,0,0,0,0,0,0,0.235829934132899,408.070435463506,24.5592511065261
9.7,"random_policy_SVM","SVM",39,8,1884,1816,68,900,698,202,0.77363038619471,0.214876033057851,1.25203945614503,483,202,281,30,1.4,32.33,3.5,0,0,0,0,0,0,0.228870428813378,115.210436647106,44.5339190791371
9.7,"random_policy_SVM","SVM",39,9,1784,1723,61,1000,791,209,0.776645095898951,0.247933884297521,1.23081844841376,500,209,291,17,1.4,35.92,3.8,0,0,0,0,0,0,0.19540103157212,48.1519965042183,23.3343495377607
9.7,"random_policy_SVM","SVM",39,10,1684,1628,56,1100,886,214,0.795733925879724,0.289256198347107,1.24142895227939,508,214,294,8,1.4,39.51,4.1,0,0,0,0,0,0,0.0585150459712242,17.2309515169808,13.2901237501573
9.7,"random_policy_SVM","SVM",39,11,1584,1531,53,1200,983,217,0.8009122095743,0.297520661157025,1.25203945614503,523,217,306,15,1.4,43.1,4.5,0,0,0,0,0,0,0.0124988720648525,4.11095888818184,3.15623786840476
9.7,"random_policy_SVM","SVM",39,12,1484,1439,45,1300,1075,225,0.803699516606889,0.214876033057851,1.26264996001066,555,225,330,32,1.5,46.7,4.8,0,0,0,0,0,0,0.0642603105121722,18.6430204790093,11.2937338781146
9.7,"random_policy_SVM","SVM",39,13,1384,1353,31,1400,1161,239,0.802393575549664,0.239669421487603,1.24142895227939,592,239,353,37,1.5,50.29,4.9,0,0,0,0,0,0,0.135603687706122,42.6308187949434,16.1151684049965
9.7,"random_policy_SVM","SVM",39,14,1284,1261,23,1500,1253,247,0.793349446436922,0.214876033057851,1.25203945614503,624,247,377,32,1.5,53.88,5.1,0,0,0,0,0,0,0.13920350236335,40.6905888196298,15.7768025723677
9.7,"random_policy_SVM","SVM",39,15,1184,1166,18,1600,1348,252,0.801237070533807,0.214876033057851,1.26264996001066,641,252,389,17,1.5,57.47,5.3,0,0,0,0,0,0,0.119742258944019,33.3215677906402,14.6757008347659
9.7,"random_policy_SVM","SVM",39,16,1084,1068,16,1700,1446,254,0.778867144862,0.190082644628099,1.23081844841376,660,254,406,19,1.6,61.06,5.7,0,0,0,0,0,0,0.14735951205312,49.5720408208369,15.9059344287957
9.7,"random_policy_SVM","SVM",39,17,984,969,15,1800,1545,255,0.760486511772962,0.165289256198347,1.22968509809293,676,255,421,16,1.7,64.66,6.1,0,0,0,0,0,0,0.129235086126451,36.482366722916,14.3519787459579
9.7,"random_policy_SVM","SVM",39,18,884,870,14,1900,1644,256,0.740773948749938,0.12396694214876,1.23081844841376,681,256,425,5,1.7,68.25,6.4,0,0,0,0,0,0,0.129178184257118,26.7179782124975,14.4379764521349
9.7,"random_policy_SVM","SVM",39,19,784,770,14,2000,1744,256,0.767412547429703,0.165289256198347,1.25203945614503,682,256,426,1,1.7,71.84,6.8,0,0,0,0,0,0,0.0904130838660776,14.0762577526956,11.2476065220557
9.7,"random_policy_SVM","SVM",39,20,684,671,13,2100,1843,257,0.765404906699936,0.165289256198347,1.25203945614503,662,257,405,-20,1.6,75.43,7.2,0,0,0,0,0,0,0.00555896413378414,2.58064864135566,2.24740020665944
9.7,"random_policy_SVM","SVM",39,21,584,576,8,2200,1938,262,0.775066271635741,0.12396694214876,1.26264996001066,690,262,428,28,1.6,79.02,7.4,0,0,0,0,0,0,0.0170203036122478,6.91414654361669,3.21099447778574
9.7,"random_policy_SVM","SVM",39,22,484,479,5,2300,2035,265,0.756042413846875,0.148760330578512,1.28387096774194,701,265,436,11,1.6,82.61,7.7,0,0,0,0,0,0,0.0284691780813801,10.0847110440262,5.02183140100532
9.7,"random_policy_SVM","SVM",39,23,384,380,4,2400,2134,266,0.752442954415514,0.148760330578512,1.28387096774194,715,266,449,14,1.7,86.21,8,0,0,0,0,0,0,0.0471712645689657,13.4729238076031,7.215643453876
9.7,"random_policy_SVM","SVM",39,24,284,282,2,2500,2232,268,0.783333983055258,0.190082644628099,1.26148729890568,724,268,456,9,1.7,89.8,8.3,0,0,0,0,0,0,0.0371509786526332,9.67053928635982,6.61962561897727
9.7,"random_policy_SVM","SVM",39,25,184,182,2,2600,2332,268,0.806837673475756,0.256198347107438,1.26264996001066,736,268,468,12,1.7,93.39,8.7,0,0,0,0,0,0,0.0208452834595318,4.94194980366826,3.82958136383627
9.7,"random_policy_SVM","SVM",39,26,84,84,0,2700,2430,270,0.79659805603202,0.148760330578512,1.28387096774194,753,270,483,17,1.8,96.98,9,0,0,0,0,0,0,3.34528089632766e-09,2.52440110430142,2.52440110430142
9.7,"random_policy_SVM","SVM",39,27,0,0,0,2784,2514,270,0.758511357139146,0.140495867768595,1.28387096774194,726,270,456,-27,1.7,100,9.3,0,0,0,0,0,0,0,0,0
9.7,"random_policy_SVM","SVM",40,0,2684,2425,259,100,91,9,0.782299468663982,0.195121951219512,1.27343299239444,30,9,21,0,2.3,3.59,10.1,0,0,0,0,0,0,0.101268160697945,243.000099294373,10.6367515153145
9.7,"random_policy_SVM","SVM",40,1,2584,2335,249,200,181,19,0.695243582357085,0.317073170731707,1.17949121426698,64,19,45,34,2.4,7.18,9.5,0,0,0,0,0,0,0.102440839807065,245.343961859194,10.4524894444261
9.7,"random_policy_SVM","SVM",40,2,2484,2267,217,300,249,51,0.731419243326297,0.219512195121951,1.27343299239444,140,51,89,76,1.7,10.78,4.9,0,0,0,0,0,0,0.188954291667828,375.76578983963,19.6630247186479
9.7,"random_policy_SVM","SVM",40,3,2384,2181,203,400,335,65,0.749094168107047,0.219512195121951,1.27343299239444,170,65,105,30,1.6,14.37,5.2,0,0,0,0,0,0,0.179705567828131,242.761120751705,19.3175709117438
9.7,"random_policy_SVM","SVM",40,4,2284,2100,184,500,416,84,0.727040522373737,0.24390243902439,1.21080514030947,205,84,121,35,1.4,17.96,5,0,0,0,0,0,0,0.178750171080566,251.111466012957,22.8481708466746
9.7,"random_policy_SVM","SVM",40,5,2184,2013,171,600,503,97,0.775564944625829,0.276422764227642,1.23168109100446,235,97,138,30,1.4,21.55,5.2,0,0,0,0,0,0,0.174784672141544,200.446829766449,18.2128467129785
9.7,"random_policy_SVM","SVM",40,6,2084,1938,146,700,578,122,0.767550092823765,0.260162601626016,1.23168109100446,293,122,171,58,1.4,25.14,4.7,0,0,0,0,0,0,0.182747349088808,194.450068535805,18.8266473751786
9.7,"random_policy_SVM","SVM",40,7,1984,1871,113,800,645,155,0.772524166186546,0.276422764227642,1.23168109100446,380,155,225,87,1.5,28.74,4.2,0,0,0,0,0,0,0.211242290222292,210.999861098349,21.4079893577448
9.7,"random_policy_SVM","SVM",40,8,1884,1793,91,900,723,177,0.769528199219001,0.235772357723577,1.23168109100446,441,177,264,61,1.5,32.33,4.1,0,0,0,0,0,0,0.209437317186268,183.02310592546,21.5383371658868
9.7,"random_policy_SVM","SVM",40,9,1784,1717,67,1000,799,201,0.778330452595866,0.268292682926829,1.23168109100446,487,201,286,46,1.4,35.92,4,0,0,0,0,0,0,0.178545523583337,147.851979120047,19.5013686965822
9.7,"random_policy_SVM","SVM",40,10,1684,1626,58,1100,890,210,0.782837206324823,0.260162601626016,1.23168109100446,510,210,300,23,1.4,39.51,4.2,0,0,0,0,0,0,0.17091886082509,117.594124236479,19.0045286340281
9.7,"random_policy_SVM","SVM",40,11,1584,1535,49,1200,981,219,0.798662057486722,0.260162601626016,1.23168109100446,533,219,314,23,1.4,43.1,4.5,0,0,0,0,0,0,0.142757972548104,70.4074577366877,16.3386640573729
9.7,"random_policy_SVM","SVM",40,12,1484,1447,37,1300,1069,231,0.823423596440694,0.260162601626016,1.24211906635195,562,231,331,29,1.4,46.7,4.6,0,0,0,0,0,0,0.159871699472425,78.5704743203165,17.984735534392
9.7,"random_policy_SVM","SVM",40,13,1384,1360,24,1400,1156,244,0.811894244926708,0.227642276422764,1.23168109100446,607,244,363,45,1.5,50.29,4.7,0,0,0,0,0,0,0.134985262880254,73.1166982207025,15.2356436196784
9.7,"random_policy_SVM","SVM",40,14,1284,1263,21,1500,1253,247,0.809493630369384,0.276422764227642,1.23168109100446,608,247,361,1,1.5,53.88,5.1,0,0,0,0,0,0,0.106163650635769,54.9459697760236,12.078114620687
9.7,"random_policy_SVM","SVM",40,15,1184,1168,16,1600,1348,252,0.80090903271239,0.252032520325203,1.23168109100446,635,252,383,27,1.5,57.47,5.3,0,0,0,0,0,0,0.0854403575660453,38.3149289254196,10.846325967829
9.7,"random_policy_SVM","SVM",40,16,1084,1069,15,1700,1447,253,0.786940656808151,0.227642276422764,1.21080514030947,626,253,373,-9,1.5,61.06,5.7,0,0,0,0,0,0,0.128071476918324,69.2786596460829,14.7887768042868
9.7,"random_policy_SVM","SVM",40,17,984,970,14,1800,1546,254,0.798341975545749,0.227642276422764,1.21080514030947,655,254,401,29,1.6,64.66,6.1,0,0,0,0,0,0,0.0864806073294556,39.6959494720855,10.1147088697947
9.7,"random_policy_SVM","SVM",40,18,884,870,14,1900,1646,254,0.799507073810907,0.252032520325203,1.21080514030947,653,254,399,-2,1.6,68.25,6.5,0,0,0,0,0,0,0.043040783399829,13.1883535707542,5.47008238578057
9.7,"random_policy_SVM","SVM",40,19,784,770,14,2000,1746,254,0.800454516356198,0.235772357723577,1.21080514030947,645,254,391,-8,1.5,71.84,6.9,0,0,0,0,0,0,0.0662296893411541,30.5867164549926,7.62297676899059
9.7,"random_policy_SVM","SVM",40,20,684,671,13,2100,1845,255,0.803328852186175,0.252032520325203,1.21080514030947,652,255,397,7,1.6,75.43,7.2,0,0,0,0,0,0,0.0278187948475343,8.75479788382779,3.54956849806169
9.7,"random_policy_SVM","SVM",40,21,584,573,11,2200,1943,257,0.79190832853211,0.211382113821138,1.22124311565696,669,257,412,17,1.6,79.02,7.6,0,0,0,0,0,0,0.0371546234381708,11.4354838536905,8.23220161268492
9.7,"random_policy_SVM","SVM",40,22,484,473,11,2300,2043,257,0.791895525254469,0.252032520325203,1.22124311565696,665,257,408,-4,1.6,82.61,7.9,0,0,0,0,0,0,0.00861958561640941,3.05242869962147,2.05128116384225
9.7,"random_policy_SVM","SVM",40,23,384,375,9,2400,2141,259,0.78015491965944,0.211382113821138,1.22124311565696,662,259,403,-3,1.6,86.21,8.3,0,0,0,0,0,0,0.00538687684011327,1.67667572637368,1.07130686759456
9.7,"random_policy_SVM","SVM",40,24,284,276,8,2500,2240,260,0.77569297740222,0.203252032520325,1.22124311565696,676,260,416,14,1.6,89.8,8.6,0,0,0,0,0,0,0.00522501642576711,1.36385240300078,0.883088234783589
9.7,"random_policy_SVM","SVM",40,25,184,178,6,2600,2338,262,0.786402919147311,0.219512195121951,1.24211906635195,674,262,412,-2,1.6,93.39,8.9,0,0,0,0,0,0,0.00942369538980718,2.47838881512827,2.02234907266334
9.7,"random_policy_SVM","SVM",40,26,84,83,1,2700,2433,267,0.799955188528268,0.186991869918699,1.27343299239444,717,267,450,43,1.7,96.98,9.1,0,0,0,0,0,0,0.000144121343087863,1.34684644742917,1.34684644742917
9.7,"random_policy_SVM","SVM",40,27,0,0,0,2784,2516,268,0.816170539658156,0.235772357723577,1.27343299239444,729,268,461,12,1.7,100,9.4,0,0,0,0,0,0,0,0,0
9.7,"random_policy_SVM","SVM",41,0,2684,2434,250,100,90,10,0.762802288866574,0.229007633587786,1.25331421421844,25,10,15,0,1.5,3.59,9,0,0,0,0,0,0,0.275599388802569,254.117600872716,38.7418938212861
9.7,"random_policy_SVM","SVM",41,1,2584,2364,220,200,160,40,0.794473814737297,0.33587786259542,1.25446934252647,102,40,62,77,1.6,7.18,4,0,0,0,0,0,0,0.338538557946204,358.850677554827,42.7369513176774
9.7,"random_policy_SVM","SVM",41,2,2484,2298,186,300,226,74,0.809499038240518,0.274809160305344,1.26426988426496,165,74,91,63,1.2,10.78,3.1,0,0,0,0,0,0,0.256001077195509,410.355630334753,28.9320064857682
9.7,"random_policy_SVM","SVM",41,3,2384,2225,159,400,299,101,0.76633478907828,0.145038167938931,1.26426988426496,233,101,132,68,1.3,14.37,3,0,0,0,0,0,0,0.286587625501309,318.160458985172,40.2010918930891
9.7,"random_policy_SVM","SVM",41,4,2284,2134,150,500,390,110,0.753777476681865,0.229007633587786,1.24466880078798,258,110,148,25,1.3,17.96,3.5,0,0,0,0,0,0,0.224796765107154,279.000236674205,25.1831735576877
9.7,"random_policy_SVM","SVM",41,5,2184,2056,128,600,468,132,0.789707358972182,0.290076335877863,1.25446934252647,313,132,181,55,1.4,21.55,3.5,0,0,0,0,0,0,0.218048542998426,277.922385751335,22.664486050052
9.7,"random_policy_SVM","SVM",41,6,2084,1979,105,700,545,155,0.806256880511968,0.259541984732824,1.26426988426496,365,155,210,52,1.4,25.14,3.5,0,0,0,0,0,0,0.222779969168353,333.870883729689,36.394110866084
9.7,"random_policy_SVM","SVM",41,7,1984,1893,91,800,631,169,0.808482839549482,0.259541984732824,1.26426988426496,407,169,238,42,1.4,28.74,3.7,0,0,0,0,0,0,0.191117622291216,144.038909320883,21.0094089561966
9.7,"random_policy_SVM","SVM",41,8,1884,1808,76,900,716,184,0.813388417754434,0.259541984732824,1.26426988426496,438,184,254,31,1.4,32.33,3.9,0,0,0,0,0,0,0.170462599046723,120.930804572869,18.8738512363489
9.7,"random_policy_SVM","SVM",41,9,1784,1731,53,1000,793,207,0.808077569833409,0.251908396946565,1.26426988426496,492,207,285,54,1.4,35.92,3.8,0,0,0,0,0,0,0.186061494227851,130.629028677043,19.9797218276096
9.7,"random_policy_SVM","SVM",41,10,1684,1645,39,1100,879,221,0.814507446074928,0.267175572519084,1.26426988426496,531,221,310,39,1.4,39.51,4,0,0,0,0,0,0,0.178973452008411,139.626083666647,18.8741808004535
9.7,"random_policy_SVM","SVM",41,11,1584,1559,25,1200,965,235,0.807545275280965,0.236641221374046,1.26426988426496,577,235,342,46,1.5,43.1,4.1,0,0,0,0,0,0,0.148067035353109,90.2341882988583,16.9534421423546
9.7,"random_policy_SVM","SVM",41,12,1484,1466,18,1300,1058,242,0.809644209482098,0.251908396946565,1.26426988426496,597,242,355,20,1.5,46.7,4.4,0,0,0,0,0,0,0.145870853672426,98.6423270813668,17.0114047567652
9.7,"random_policy_SVM","SVM",41,13,1384,1373,11,1400,1151,249,0.813182758495538,0.244274809160305,1.26426988426496,618,249,369,21,1.5,50.29,4.6,0,0,0,0,0,0,0.137731767789954,92.1812660376233,15.5398634506633
9.7,"random_policy_SVM","SVM",41,14,1284,1278,6,1500,1246,254,0.800873446970154,0.206106870229008,1.26426988426496,663,254,409,45,1.6,53.88,4.9,0,0,0,0,0,0,0.141175607720156,88.3140580849188,15.2344604945382
9.7,"random_policy_SVM","SVM",41,15,1184,1180,4,1600,1344,256,0.795459769419677,0.190839694656489,1.26426988426496,661,256,405,-2,1.6,57.47,5.2,0,0,0,0,0,0,0.0995495057120992,39.9449963397475,10.970542190363
9.7,"random_policy_SVM","SVM",41,16,1084,1082,2,1700,1442,258,0.796409431291657,0.229007633587786,1.26426988426496,654,258,396,-7,1.5,61.06,5.6,0,0,0,0,0,0,0.0341181087018243,9.98781452913692,5.05794714114284
9.7,"random_policy_SVM","SVM",41,17,984,982,2,1800,1542,258,0.810811628216449,0.206106870229008,1.26426988426496,682,258,424,28,1.6,64.66,6,0,0,0,0,0,0,0.0582946034957443,18.6416389570841,6.95372861705664
9.7,"random_policy_SVM","SVM",41,18,884,882,2,1900,1642,258,0.815003447816986,0.213740458015267,1.26426988426496,664,258,406,-18,1.6,68.25,6.4,0,0,0,0,0,0,0.0212841104267988,6.36947775330933,3.25196075553839
9.7,"random_policy_SVM","SVM",41,19,784,782,2,2000,1742,258,0.816503550646616,0.259541984732824,1.26426988426496,662,258,404,-2,1.6,71.84,6.8,0,0,0,0,0,0,0.0084396991827384,2.42861772804415,1.39761759439317
9.7,"random_policy_SVM","SVM",41,20,684,682,2,2100,1842,258,0.808882060463819,0.221374045801527,1.27407042600345,664,258,406,2,1.6,75.43,7.1,0,0,0,0,0,0,0.00117000791213642,0.439180954631347,0.350074504086565
9.7,"random_policy_SVM","SVM",41,21,584,583,1,2200,1941,259,0.787584229564119,0.175572519083969,1.25446934252647,683,259,424,19,1.6,79.02,7.5,0,0,0,0,0,0,0.105183390577941,26.4833594489891,17.1882214516136
9.7,"random_policy_SVM","SVM",41,22,484,483,1,2300,2041,259,0.821390982446374,0.267175572519084,1.26426988426496,681,259,422,-2,1.6,82.61,7.9,0,0,0,0,0,0,0.0148081465776857,6.57859844173462,5.8351036499018
9.7,"random_policy_SVM","SVM",41,23,384,384,0,2400,2140,260,0.799083001657369,0.198473282442748,1.26426988426496,677,260,417,-4,1.6,86.21,8.2,0,0,0,0,0,0,0.00190050922352233,0.701496530084765,0.548757255700722
9.7,"random_policy_SVM","SVM",41,24,284,284,0,2500,2240,260,0.784916708000142,0.175572519083969,1.26426988426496,685,260,425,8,1.6,89.8,8.6,0,0,0,0,0,0,0.00178714476304165,0.507744483390403,0.383854990902756
9.7,"random_policy_SVM","SVM",41,25,184,184,0,2600,2340,260,0.794250009073199,0.190839694656489,1.26426988426496,685,260,425,0,1.6,93.39,9,0,0,0,0,0,0,0.00334452034563953,0.811730411149942,0.644049170957781
9.7,"random_policy_SVM","SVM",41,26,84,84,0,2700,2440,260,0.765360931999366,0.190839694656489,1.27407042600345,682,260,422,-3,1.6,96.98,9.4,0,0,0,0,0,0,1.0000000994736e-07,0.00384882856147769,0.00384882856147769
9.7,"random_policy_SVM","SVM",41,27,0,0,0,2784,2524,260,0.80591209881322,0.213740458015267,1.27407042600345,679,260,419,-3,1.6,100,9.7,0,0,0,0,0,0,0,0,0
9.7,"random_policy_SVM","SVM",42,0,2684,2432,252,100,91,9,0.805310920275293,0.253846153846154,1.26411910669975,24,9,15,0,1.7,3.59,10.1,0,0,0,0,0,0,0.333956263968903,234.246726062803,42.0935745459345
9.7,"random_policy_SVM","SVM",42,1,2584,2358,226,200,165,35,0.782398440830747,0.261538461538462,1.25424317617866,89,35,54,65,1.5,7.18,4.7,0,0,0,0,0,0,0.194451825691499,420.07412754905,20.1432343460474
9.7,"random_policy_SVM","SVM",42,2,2484,2273,211,300,250,50,0.787526645958952,0.246153846153846,1.25424317617866,131,50,81,42,1.6,10.78,5,0,0,0,0,0,0,0.18689640744901,298.54007210116,20.9778955675662
9.7,"random_policy_SVM","SVM",42,3,2384,2197,187,400,326,74,0.807808027285464,0.253846153846154,1.26411910669975,184,74,110,53,1.5,14.37,4.4,0,0,0,0,0,0,0.197983905980059,218.986478667472,21.143800394334
9.7,"random_policy_SVM","SVM",42,4,2284,2128,156,500,395,105,0.795675741518975,0.230769230769231,1.26411910669975,250,105,145,66,1.4,17.96,3.8,0,0,0,0,0,0,0.204776240260154,183.848347940565,21.8586087410366
9.7,"random_policy_SVM","SVM",42,5,2184,2056,128,600,467,133,0.803404592240699,0.284615384615385,1.25424317617866,315,133,182,65,1.4,21.55,3.5,0,0,0,0,0,0,0.211290922723509,232.565808556715,21.9141307848576
9.7,"random_policy_SVM","SVM",42,6,2084,1980,104,700,543,157,0.798306839637009,0.230769230769231,1.25424317617866,374,157,217,59,1.4,25.14,3.5,0,0,0,0,0,0,0.20229009527763,204.683174681742,21.4142460578699
9.7,"random_policy_SVM","SVM",42,7,1984,1907,77,800,616,184,0.796461416651443,0.238461538461538,1.24436724565757,444,184,260,70,1.4,28.74,3.3,0,0,0,0,0,0,0.225604523308761,391.864027413342,22.8050173532399
9.7,"random_policy_SVM","SVM",42,8,1884,1827,57,900,696,204,0.784670199159514,0.230769230769231,1.25424317617866,503,204,299,59,1.5,32.33,3.4,0,0,0,0,0,0,0.183769276337043,139.002548703705,21.1784743411979
9.7,"random_policy_SVM","SVM",42,9,1784,1729,55,1000,794,206,0.792417321395946,0.215384615384615,1.26411910669975,503,206,297,0,1.4,35.92,3.9,0,0,0,0,0,0,0.130339871122911,64.5203296783396,15.5690624717209
9.7,"random_policy_SVM","SVM",42,10,1684,1632,52,1100,891,209,0.800243620196117,0.246153846153846,1.26411910669975,527,209,318,24,1.5,39.51,4.3,0,0,0,0,0,0,0.0919281216486656,50.7764976795295,11.8974584882378
9.7,"random_policy_SVM","SVM",42,11,1584,1535,49,1200,988,212,0.806851818015715,0.215384615384615,1.27399503722084,529,212,317,2,1.5,43.1,4.7,0,0,0,0,0,0,0.0650546248255567,42.1634274132351,14.1306308878968
9.7,"random_policy_SVM","SVM",42,12,1484,1446,38,1300,1077,223,0.816486996772034,0.230769230769231,1.28387096774194,568,223,345,39,1.5,46.7,4.8,0,0,0,0,0,0,0.0802045300154762,30.9495172357031,13.8301613987726
9.7,"random_policy_SVM","SVM",42,13,1384,1366,18,1400,1157,243,0.813910713198126,0.184615384615385,1.28387096774194,629,243,386,61,1.6,50.29,4.8,0,0,0,0,0,0,0.169604745111656,100.001115218129,17.9641810120649
9.7,"random_policy_SVM","SVM",42,14,1284,1269,15,1500,1254,246,0.818630854497839,0.223076923076923,1.28387096774194,658,246,412,29,1.7,53.88,5.1,0,0,0,0,0,0,0.0700747774915921,19.8974400240589,11.6359484475776
9.7,"random_policy_SVM","SVM",42,15,1184,1173,11,1600,1350,250,0.804634874231076,0.223076923076923,1.28387096774194,681,250,431,23,1.7,57.47,5.4,0,0,0,0,0,0,0.102785282296425,30.65552776297,14.6997303227037
9.7,"random_policy_SVM","SVM",42,16,1084,1075,9,1700,1448,252,0.805085571593887,0.238461538461538,1.28387096774194,676,252,424,-5,1.7,61.06,5.7,0,0,0,0,0,0,0.0634670255506678,18.7397917645362,9.27578237728744
9.7,"random_policy_SVM","SVM",42,17,984,975,9,1800,1548,252,0.799202143857728,0.284615384615385,1.28387096774194,689,252,437,13,1.7,64.66,6.1,0,0,0,0,0,0,0.0316398529202527,8.94917200901654,5.99777450283542
9.7,"random_policy_SVM","SVM",42,18,884,875,9,1900,1648,252,0.77899384859005,0.2,1.28387096774194,686,252,434,-3,1.7,68.25,6.5,0,0,0,0,0,0,0.0122145233777634,3.65510376043856,2.56107769855486
9.7,"random_policy_SVM","SVM",42,19,784,778,6,2000,1745,255,0.779048663134176,0.184615384615385,1.27399503722084,713,255,458,27,1.8,71.84,6.8,0,0,0,0,0,0,0.154127339255726,46.1839010801029,31.2749998516104
9.7,"random_policy_SVM","SVM",42,20,684,682,2,2100,1841,259,0.795109324563008,0.230769230769231,1.26411910669975,702,259,443,-11,1.7,75.43,7.1,0,0,0,0,0,0,0.109565677386195,48.6842591383847,12.6945601317301
9.7,"random_policy_SVM","SVM",42,21,584,583,1,2200,1940,260,0.791004324258483,0.176923076923077,1.27399503722084,715,260,455,13,1.8,79.02,7.5,0,0,0,0,0,0,0.0399002667330609,11.9622548833718,7.71144747087167
9.7,"random_policy_SVM","SVM",42,22,484,483,1,2300,2040,260,0.783293745051467,0.176923076923077,1.27399503722084,737,260,477,22,1.8,82.61,7.8,0,0,0,0,0,0,0.00375411724572221,1.53563066281596,1.21850739816715
9.7,"random_policy_SVM","SVM",42,23,384,384,0,2400,2139,261,0.780126682501981,0.184615384615385,1.26411910669975,729,261,468,-8,1.8,86.21,8.2,0,0,0,0,0,0,0.0023619233398571,7.43738704470284,7.32428323192572
9.7,"random_policy_SVM","SVM",42,24,284,284,0,2500,2239,261,0.795767099092516,0.215384615384615,1.26411910669975,720,261,459,-9,1.8,89.8,8.6,0,0,0,0,0,0,0.00712102270378028,1.86137722326236,1.42110464460932
9.7,"random_policy_SVM","SVM",42,25,184,184,0,2600,2339,261,0.830903221877095,0.284615384615385,1.26411910669975,725,261,464,5,1.8,93.39,9,0,0,0,0,0,0,1.82539397473211e-05,0.0282896505902522,0.0279428952626963
9.7,"random_policy_SVM","SVM",42,26,84,84,0,2700,2439,261,0.810366039344664,0.223076923076923,1.26411910669975,720,261,459,-5,1.8,96.98,9.3,0,0,0,0,0,0,1.0000000994736e-07,0.000422767199453326,0.000422767199453326
9.7,"random_policy_SVM","SVM",42,27,0,0,0,2784,2523,261,0.818100980571291,0.276923076923077,1.27399503722084,722,261,461,2,1.8,100,9.7,0,0,0,0,0,0,0,0,0
9.7,"random_policy_SVM","SVM",43,0,2684,2427,257,100,94,6,0.693502964426876,0.3125,1.07323588709677,17,6,11,0,1.8,3.59,15.7,0,0,0,0,0,0,0.155994664695032,158.932127789945,18.3103245129903
9.7,"random_policy_SVM","SVM",43,1,2584,2360,224,200,161,39,0.758393033596839,0.203125,1.16350806451613,88,39,49,71,1.3,7.18,4.1,0,0,0,0,0,0,0.23889899536353,132.118709710262,30.5863621978428
9.7,"random_policy_SVM","SVM",43,2,2484,2283,201,300,238,62,0.804767786561271,0.2421875,1.25378024193548,143,62,81,55,1.3,10.78,3.8,0,0,0,0,0,0,0.233181006819789,97.6580529450583,24.8967944313306
9.7,"random_policy_SVM","SVM",43,3,2384,2207,177,400,314,86,0.798875988142295,0.2578125,1.22368951612903,208,86,122,65,1.4,14.37,3.7,0,0,0,0,0,0,0.223945261525864,101.049941375172,23.7372198861048
9.7,"random_policy_SVM","SVM",43,4,2284,2135,149,500,386,114,0.807015810276689,0.265625,1.23371975806452,274,114,160,66,1.4,17.96,3.4,0,0,0,0,0,0,0.185918507550412,87.4301209471886,23.2204006208585
9.7,"random_policy_SVM","SVM",43,5,2184,2064,120,600,457,143,0.755027173913047,0.265625,1.13341733870968,351,143,208,77,1.5,21.55,3.2,0,0,0,0,0,0,0.225696706647471,210.809650839881,31.3980299074908
9.7,"random_policy_SVM","SVM",43,6,2084,1980,104,700,541,159,0.779039031620549,0.21875,1.21365927419355,359,159,200,8,1.3,25.14,3.4,0,0,0,0,0,0,0.241976419718348,162.474187837446,38.0930335224849
9.7,"random_policy_SVM","SVM",43,7,1984,1891,93,800,630,170,0.747702569169962,0.3125,1.15347782258065,396,170,226,37,1.3,28.74,3.7,0,0,0,0,0,0,0.192306291875279,222.765659426187,20.6479351297605
9.7,"random_policy_SVM","SVM",43,8,1884,1809,75,900,712,188,0.760381669960476,0.3125,1.15347782258065,442,188,254,46,1.4,32.33,3.8,0,0,0,0,0,0,0.211076929158591,209.034375916063,21.9905736756223
9.7,"random_policy_SVM","SVM",43,9,1784,1721,63,1000,800,200,0.83247282608696,0.28125,1.27384072580645,477,200,277,35,1.4,35.92,4,0,0,0,0,0,0,0.208691248781725,115.628457860885,25.8495557578622
9.7,"random_policy_SVM","SVM",43,10,1684,1631,53,1100,890,210,0.84598567193676,0.34375,1.27384072580645,508,210,298,31,1.4,39.51,4.2,0,0,0,0,0,0,0.164611132746953,75.606234163935,18.9989729139184
9.7,"random_policy_SVM","SVM",43,11,1584,1547,37,1200,974,226,0.844132905138337,0.3125,1.27384072580645,567,226,341,59,1.5,43.1,4.3,0,0,0,0,0,0,0.136975089515617,62.4872139254624,17.088042412898
9.7,"random_policy_SVM","SVM",43,12,1484,1456,28,1300,1065,235,0.838315217391306,0.28125,1.27384072580645,578,235,343,11,1.5,46.7,4.5,0,0,0,0,0,0,0.128698564411366,58.1009550141148,15.4726354682067
9.7,"random_policy_SVM","SVM",43,13,1384,1368,16,1400,1153,247,0.832855731225299,0.28125,1.26381048387097,616,247,369,38,1.5,50.29,4.7,0,0,0,0,0,0,0.154172664701257,78.4385213715508,17.4188056944588
9.7,"random_policy_SVM","SVM",43,14,1284,1270,14,1500,1251,249,0.821195652173917,0.234375,1.26381048387097,633,249,384,17,1.5,53.88,5,0,0,0,0,0,0,0.0880202107519391,32.0728810097455,11.4212839323722
9.7,"random_policy_SVM","SVM",43,15,1184,1171,13,1600,1350,250,0.834720849802376,0.2734375,1.26381048387097,635,250,385,2,1.5,57.47,5.4,0,0,0,0,0,0,0.0755087473996493,34.2632470126556,9.1782593769263
9.7,"random_policy_SVM","SVM",43,16,1084,1071,13,1700,1450,250,0.834788784584984,0.3046875,1.26264675414365,635,250,385,0,1.5,61.06,5.8,0,0,0,0,0,0,0.0268260425705246,9.11707218158843,4.01496553915323
9.7,"random_policy_SVM","SVM",43,17,984,971,13,1800,1550,250,0.824314476284589,0.2421875,1.26381048387097,635,250,385,0,1.5,64.66,6.2,0,0,0,0,0,0,0.0182538258004418,5.97038808319983,2.71292227407778
9.7,"random_policy_SVM","SVM",43,18,884,871,13,1900,1650,250,0.825543478260874,0.2578125,1.26381048387097,625,250,375,-10,1.5,68.25,6.6,0,0,0,0,0,0,0.00510530752881259,1.69429297983942,0.969748503135028
9.7,"random_policy_SVM","SVM",43,19,784,774,10,2000,1747,253,0.823659832015815,0.2421875,1.26381048387097,651,253,398,26,1.6,71.84,6.9,0,0,0,0,0,0,0.040208457685228,13.395433269651,6.50815553118981
9.7,"random_policy_SVM","SVM",43,20,684,676,8,2100,1845,255,0.832559288537549,0.2890625,1.27384072580645,663,255,408,12,1.6,75.43,7.2,0,0,0,0,0,0,0.0185759779621168,6.98123939765941,4.19150384622441
9.7,"random_policy_SVM","SVM",43,21,584,581,3,2200,1940,260,0.796553853754941,0.2265625,1.26381048387097,700,260,440,37,1.7,79.02,7.5,0,0,0,0,0,0,0.00821360941363829,6.4096427028298,5.89514640483193
9.7,"random_policy_SVM","SVM",43,22,484,483,1,2300,2038,262,0.802173913043481,0.2421875,1.27384072580645,692,262,430,-8,1.6,82.61,7.8,0,0,0,0,0,0,0.0065706319223049,2.97198103353563,2.26104688474986
9.7,"random_policy_SVM","SVM",43,23,384,384,0,2400,2137,263,0.795374258893284,0.1640625,1.27384072580645,691,263,428,-1,1.6,86.21,8.1,0,0,0,0,0,0,0.00992897005973367,3.08853933359468,2.46791863904116
9.7,"random_policy_SVM","SVM",43,24,284,284,0,2500,2237,263,0.791304347826092,0.171875,1.27384072580645,695,263,432,4,1.6,89.8,8.5,0,0,0,0,0,0,0.00146374354708859,0.521074282385523,0.449397345600664
9.7,"random_policy_SVM","SVM",43,25,184,184,0,2600,2337,263,0.797369071146248,0.171875,1.27384072580645,716,263,453,21,1.7,93.39,8.9,0,0,0,0,0,0,0.00041433179333568,0.20484259075381,0.19164628341456
9.7,"random_policy_SVM","SVM",43,26,84,84,0,2700,2437,263,0.770553359683797,0.140625,1.27384072580645,695,263,432,-21,1.6,96.98,9.3,0,0,0,0,0,0,1.0000000994736e-07,0.0145567989454193,0.0145567989454193
9.7,"random_policy_SVM","SVM",43,27,0,0,0,2784,2521,263,0.836894762845849,0.3125,1.27384072580645,713,263,450,18,1.7,100,9.6,0,0,0,0,0,0,0,0,0
9.7,"random_policy_SVM","SVM",44,0,2684,2423,261,100,85,15,0.776097162686262,0.339130434782609,1.21688639551192,40,15,25,0,1.7,3.59,5.7,0,0,0,0,0,0,0.382452316419856,395.370687774786,39.6791289312108
9.7,"random_policy_SVM","SVM",44,1,2584,2363,221,200,145,55,0.725202422263047,0,1.25037868162693,126,55,71,86,1.3,7.18,2.6,0,0,0,0,0,0,0.356962933710743,612.451232572601,42.2907264452774
9.7,"random_policy_SVM","SVM",44,2,2484,2263,221,300,245,55,0.798822889024976,0.173913043478261,1.28387096774194,136,55,81,10,1.5,10.78,4.5,0,0,0,0,0,0,0.275880232755557,393.56873611648,30.5438662028423
9.7,"random_policy_SVM","SVM",44,3,2384,2187,197,400,321,79,0.698346601347216,0.104347826086957,1.16106591865358,187,79,108,51,1.4,14.37,4.1,0,0,0,0,0,0,0.320427991611493,364.668102293576,41.2847169971989
9.7,"random_policy_SVM","SVM",44,4,2284,2095,189,500,413,87,0.810478328910666,0.234782608695652,1.27270687237027,220,87,133,33,1.5,17.96,4.7,0,0,0,0,0,0,0.23812179136294,243.787148308271,26.4445549465581
9.7,"random_policy_SVM","SVM",44,5,2184,2021,163,600,487,113,0.799387630128602,0.147826086956522,1.27153495075667,279,113,166,59,1.5,21.55,4.3,0,0,0,0,0,0,0.242935894605062,299.219229835481,37.8701750475927
9.7,"random_policy_SVM","SVM",44,6,2084,1932,152,700,576,124,0.802993808260192,0.234782608695652,1.27270687237027,304,124,180,25,1.5,25.14,4.6,0,0,0,0,0,0,0.209756513126937,189.53595911515,22.5997968911299
9.7,"random_policy_SVM","SVM",44,7,1984,1858,126,800,650,150,0.800591957542361,0.252173913043478,1.2615427769986,366,150,216,62,1.4,28.74,4.3,0,0,0,0,0,0,0.212011915915544,212.91598873664,21.7834493437661
9.7,"random_policy_SVM","SVM",44,8,1884,1778,106,900,730,170,0.811893583724578,0.252173913043478,1.25037868162693,423,170,253,57,1.5,32.33,4.3,0,0,0,0,0,0,0.195652125358762,136.709793994824,21.0669017844135
9.7,"random_policy_SVM","SVM",44,9,1784,1705,79,1000,803,197,0.813376879635308,0.226086956521739,1.2615427769986,492,197,295,69,1.5,35.92,4.1,0,0,0,0,0,0,0.202320590812605,187.309221031598,21.1959596197282
9.7,"random_policy_SVM","SVM",44,10,1684,1626,58,1100,882,218,0.811900387834259,0.260869565217391,1.2615427769986,533,218,315,41,1.4,39.51,4,0,0,0,0,0,0,0.19567698310627,149.977076549658,20.6934368729735
9.7,"random_policy_SVM","SVM",44,11,1584,1532,52,1200,976,224,0.816302646798677,0.260869565217391,1.2615427769986,562,224,338,29,1.5,43.1,4.4,0,0,0,0,0,0,0.153913818729424,98.87019825947,18.3124586683539
9.7,"random_policy_SVM","SVM",44,12,1484,1436,48,1300,1072,228,0.834673742940744,0.252173913043478,1.2615427769986,566,228,338,4,1.5,46.7,4.7,0,0,0,0,0,0,0.15173082752767,103.281720401753,18.2242816220269
9.7,"random_policy_SVM","SVM",44,13,1384,1343,41,1400,1165,235,0.849697217119147,0.269565217391304,1.2615427769986,582,235,347,16,1.5,50.29,5,0,0,0,0,0,0,0.130949488807091,83.7527039791049,15.0173949225647
9.7,"random_policy_SVM","SVM",44,14,1284,1254,30,1500,1254,246,0.855609988433015,0.28695652173913,1.27270687237027,613,246,367,31,1.5,53.88,5.1,0,0,0,0,0,0,0.147579838273436,108.656493418278,16.3303114889157
9.7,"random_policy_SVM","SVM",44,15,1184,1163,21,1600,1345,255,0.845961760903598,0.217391304347826,1.2615427769986,655,255,400,42,1.6,57.47,5.3,0,0,0,0,0,0,0.138442683368986,98.1249222709459,15.1815193303359
9.7,"random_policy_SVM","SVM",44,16,1084,1068,16,1700,1440,260,0.865802544737031,0.31304347826087,1.2615427769986,681,260,421,26,1.6,61.06,5.5,0,0,0,0,0,0,0.134495777936023,77.8843284592314,14.8579654016629
9.7,"random_policy_SVM","SVM",44,17,984,969,15,1800,1539,261,0.799891134245095,0.217391304347826,1.2615427769986,687,261,426,6,1.6,64.66,5.9,0,0,0,0,0,0,0.124190376644731,73.2220223016645,13.7083623611933
9.7,"random_policy_SVM","SVM",44,18,884,869,15,1900,1639,261,0.811532965911423,0.182608695652174,1.2615427769986,700,261,439,13,1.7,68.25,6.3,0,0,0,0,0,0,0.109536142197147,57.587663052716,11.9766899731197
9.7,"random_policy_SVM","SVM",44,19,784,769,15,2000,1739,261,0.809723072735943,0.173913043478261,1.2615427769986,686,261,425,-14,1.6,71.84,6.7,0,0,0,0,0,0,0.0609980297946931,23.2141924125189,7.21477050499549
9.7,"random_policy_SVM","SVM",44,20,684,669,15,2100,1839,261,0.826869429135208,0.208695652173913,1.2615427769986,698,261,437,12,1.7,75.43,7,0,0,0,0,0,0,0.0599356417087649,21.4652946487498,6.89791957901521
9.7,"random_policy_SVM","SVM",44,21,584,570,14,2200,1938,262,0.839293733414993,0.2,1.2615427769986,695,262,433,-3,1.7,79.02,7.4,0,0,0,0,0,0,0.021372478721391,6.47027905319903,3.03511635749927
9.7,"random_policy_SVM","SVM",44,22,484,475,9,2300,2033,267,0.83814383887869,0.208695652173913,1.28387096774194,717,267,450,22,1.7,82.61,7.6,0,0,0,0,0,0,0.082507359712844,22.5468749718711,10.1803355331936
9.7,"random_policy_SVM","SVM",44,23,384,381,3,2400,2127,273,0.831693542899917,0.226086956521739,1.28387096774194,750,273,477,33,1.7,86.21,7.8,0,0,0,0,0,0,0.0361379065319637,10.515764255509,8.23392726889794
9.7,"random_policy_SVM","SVM",44,24,284,283,1,2500,2225,275,0.803544941144456,0.173913043478261,1.28387096774194,774,275,499,24,1.8,89.8,8.1,0,0,0,0,0,0,0.00632180102314676,2.11432861690788,1.73940974159155
9.7,"random_policy_SVM","SVM",44,25,184,184,0,2600,2324,276,0.857127304892158,0.269565217391304,1.28387096774194,768,276,492,-6,1.8,93.39,8.4,0,0,0,0,0,0,0.00222745366179972,0.969968848777464,0.896937440966112
9.7,"random_policy_SVM","SVM",44,26,84,84,0,2700,2424,276,0.840831462203175,0.226086956521739,1.28387096774194,774,276,498,6,1.8,96.98,8.8,0,0,0,0,0,0,4.62069745366979e-07,0.00977812364694881,0.00977812364694881
9.7,"random_policy_SVM","SVM",44,27,0,0,0,2784,2508,276,0.824903041437033,0.165217391304348,1.28387096774194,756,276,480,-18,1.7,100,9.1,0,0,0,0,0,0,0,0,0
9.7,"random_policy_SVM","SVM",45,0,2684,2430,254,100,92,8,0.688291139240504,0.170542635658915,1.18434608652163,28,8,20,0,2.5,3.59,11.5,0,0,0,0,0,0,0.105727759475022,209.413794092438,12.0371304990085
9.7,"random_policy_SVM","SVM",45,1,2584,2333,251,200,189,11,0.748129476989495,0.155038759689922,1.26396599149787,44,11,33,16,3,7.18,17.2,0,0,0,0,0,0,0.0744159496787293,156.879974558231,8.09728639558078
9.7,"random_policy_SVM","SVM",45,2,2484,2245,239,300,277,23,0.779370277695996,0.248062015503876,1.26396599149787,78,23,55,34,2.4,10.78,12,0,0,0,0,0,0,0.0953446057797365,173.722217658682,10.4193151401265
9.7,"random_policy_SVM","SVM",45,3,2384,2171,213,400,351,49,0.75209743891669,0.155038759689922,1.23410852713178,139,49,90,61,1.8,14.37,7.2,0,0,0,0,0,0,0.138535290593311,265.363695528855,17.6303250262184
9.7,"random_policy_SVM","SVM",45,4,2284,2084,200,500,438,62,0.774868756746145,0.209302325581395,1.23410852713178,164,62,102,25,1.6,17.96,7.1,0,0,0,0,0,0,0.140710596640799,170.092034053457,14.8638127270416
9.7,"random_policy_SVM","SVM",45,5,2184,2013,171,600,509,91,0.790697674418597,0.255813953488372,1.23410852713178,231,91,140,67,1.5,21.55,5.6,0,0,0,0,0,0,0.171644202148331,194.103755736719,17.6125138957734
9.7,"random_policy_SVM","SVM",45,6,2084,1938,146,700,584,116,0.797229172799523,0.27906976744186,1.23410852713178,298,116,182,67,1.6,25.14,5,0,0,0,0,0,0,0.186114467982977,146.70401463931,19.3013294198079
9.7,"random_policy_SVM","SVM",45,7,1984,1866,118,800,656,144,0.801258463350008,0.302325581395349,1.23410852713178,362,144,218,64,1.5,28.74,4.6,0,0,0,0,0,0,0.18823224734443,139.947125430985,19.9683429646485
9.7,"random_policy_SVM","SVM",45,8,1884,1798,86,900,724,176,0.798247227946225,0.286821705426357,1.21420355088772,425,176,249,63,1.4,32.33,4.1,0,0,0,0,0,0,0.185686622985211,132.209389207229,20.1629697316051
9.7,"random_policy_SVM","SVM",45,9,1784,1714,70,1000,808,192,0.800136149543709,0.255813953488372,1.23410852713178,469,192,277,44,1.4,35.92,4.2,0,0,0,0,0,0,0.144568714976585,93.9170635471578,16.428181660013
9.7,"random_policy_SVM","SVM",45,10,1684,1627,57,1100,895,205,0.792979099205175,0.24031007751938,1.23410852713178,494,205,289,25,1.4,39.51,4.4,0,0,0,0,0,0,0.169258959163516,123.6901426084,18.4424957359153
9.7,"random_policy_SVM","SVM",45,11,1584,1533,51,1200,989,211,0.794138210185453,0.193798449612403,1.23410852713178,522,211,311,28,1.5,43.1,4.7,0,0,0,0,0,0,0.140954843291588,86.8127600967421,15.5205743836774
9.7,"random_policy_SVM","SVM",45,12,1484,1443,41,1300,1079,221,0.815744284172309,0.27906976744186,1.22415603900975,554,221,333,32,1.5,46.7,4.9,0,0,0,0,0,0,0.15163506255219,84.0116512078769,17.5050130276225
9.7,"random_policy_SVM","SVM",45,13,1384,1352,32,1400,1170,230,0.794389657540966,0.201550387596899,1.22415603900975,584,230,354,30,1.5,50.29,5.1,0,0,0,0,0,0,0.118318329804891,55.1638313023044,13.7718780672425
9.7,"random_policy_SVM","SVM",45,14,1284,1259,25,1500,1263,237,0.811255028947111,0.286821705426357,1.23410852713178,616,237,379,32,1.6,53.88,5.3,0,0,0,0,0,0,0.105894280168822,51.5342041151393,11.8492159105832
9.7,"random_policy_SVM","SVM",45,15,1184,1165,19,1600,1357,243,0.792617260327736,0.263565891472868,1.22415603900975,629,243,386,13,1.6,57.47,5.6,0,0,0,0,0,0,0.129541054665736,54.6366224036067,14.4351379295461
9.7,"random_policy_SVM","SVM",45,16,1084,1069,15,1700,1453,247,0.77983637523304,0.193798449612403,1.23410852713178,642,247,395,13,1.6,61.06,5.9,0,0,0,0,0,0,0.117105818203336,43.8809102586803,13.690979923826
9.7,"random_policy_SVM","SVM",45,17,984,969,15,1800,1553,247,0.783884064370515,0.209302325581395,1.22415603900975,651,247,404,9,1.6,64.66,6.3,0,0,0,0,0,0,0.0885085403865571,31.8145070074363,10.2970549761846
9.7,"random_policy_SVM","SVM",45,18,884,870,14,1900,1652,248,0.797241438524187,0.255813953488372,1.22415603900975,656,248,408,5,1.6,68.25,6.7,0,0,0,0,0,0,0.0435430888780932,11.7377454072043,6.29811965091866
9.7,"random_policy_SVM","SVM",45,19,784,772,12,2000,1750,250,0.771673535472472,0.193798449612403,1.23410852713178,651,250,401,-5,1.6,71.84,7,0,0,0,0,0,0,0.017557904460997,4.93512240132606,3.15184010121964
9.7,"random_policy_SVM","SVM",45,20,684,672,12,2100,1850,250,0.796891865371403,0.193798449612403,1.23410852713178,662,250,412,11,1.6,75.43,7.4,0,0,0,0,0,0,0.00607959446350131,1.76472143992889,1.15794157514714
9.7,"random_policy_SVM","SVM",45,21,584,575,9,2200,1947,253,0.817400157001267,0.317829457364341,1.23410852713178,669,253,416,7,1.6,79.02,7.7,0,0,0,0,0,0,0.0145180655059714,4.86957583196236,2.75495343859069
9.7,"random_policy_SVM","SVM",45,22,484,477,7,2300,2045,255,0.774488519281712,0.232558139534884,1.24406101525381,682,255,427,13,1.7,82.61,8,0,0,0,0,0,0,0.0173426435429374,6.27627649033735,4.26465335019463
9.7,"random_policy_SVM","SVM",45,23,384,377,7,2400,2145,255,0.796769208124806,0.248062015503876,1.24406101525381,673,255,418,-9,1.6,86.21,8.4,0,0,0,0,0,0,0.00603554040254733,1.82169854621669,1.20289385649326
9.7,"random_policy_SVM","SVM",45,24,284,279,5,2500,2243,257,0.798762388381894,0.271317829457364,1.26396599149787,690,257,433,17,1.7,89.8,8.7,0,0,0,0,0,0,0.00126589325762225,0.436309273896039,0.361493607090483
9.7,"random_policy_SVM","SVM",45,25,184,182,2,2600,2340,260,0.790194779707582,0.248062015503876,1.28387096774194,708,260,448,18,1.7,93.39,9,0,0,0,0,0,0,0.00576277132818138,4.1416242709747,3.93781748320929
9.7,"random_policy_SVM","SVM",45,26,84,84,0,2700,2438,262,0.796989991168675,0.24031007751938,1.28387096774194,719,262,457,11,1.7,96.98,9.3,0,0,0,0,0,0,7.71971021723579e-06,0.385614584700123,0.385614584700123
9.7,"random_policy_SVM","SVM",45,27,0,0,0,2784,2522,262,0.804987243646349,0.201550387596899,1.28387096774194,706,262,444,-13,1.7,100,9.6,0,0,0,0,0,0,0,0,0
9.7,"random_policy_SVM","SVM",46,0,2684,2441,243,100,90,10,0.737109532882962,0.152173913043478,1.23735390369331,31,10,21,0,2.1,3.59,9,0,0,0,0,0,0,0.111225731593695,275.388039189252,12.931796511949
9.7,"random_policy_SVM","SVM",46,1,2584,2361,223,200,170,30,0.615555170621861,0.246376811594203,1.1536231884058,73,30,43,42,1.4,7.18,5.7,0,0,0,0,0,0,0.197677231815169,358.806355109819,23.1052515782283
9.7,"random_policy_SVM","SVM",46,2,2484,2279,205,300,252,48,0.67604942548646,0.123188405797101,1.19083683964469,128,48,80,55,1.7,10.78,5.2,0,0,0,0,0,0,0.186342103481087,342.548970152294,20.0794929738686
9.7,"random_policy_SVM","SVM",46,3,2384,2190,194,400,341,59,0.755574802240314,0.202898550724638,1.24665731650304,161,59,102,33,1.7,14.37,5.8,0,0,0,0,0,0,0.157246296216477,283.089820195512,16.3842274313351
9.7,"random_policy_SVM","SVM",46,4,2284,2105,179,500,426,74,0.760661701022002,0.239130434782609,1.19083683964469,193,74,119,32,1.6,17.96,5.8,0,0,0,0,0,0,0.15415438015779,233.08820475657,15.9695374369783
9.7,"random_policy_SVM","SVM",46,5,2184,2027,157,600,504,96,0.771407125122701,0.289855072463768,1.20944366526414,244,96,148,51,1.5,21.55,5.2,0,0,0,0,0,0,0.161070517376598,231.419030444525,16.4845272378683
9.7,"random_policy_SVM","SVM",46,6,2084,1956,128,700,575,125,0.791569952075756,0.282608695652174,1.20944366526414,306,125,181,62,1.4,25.14,4.6,0,0,0,0,0,0,0.178150817991055,213.874553313096,18.3284702891544
9.7,"random_policy_SVM","SVM",46,7,1984,1889,95,800,642,158,0.798712396789655,0.289855072463768,1.21874707807387,387,158,229,81,1.4,28.74,4.1,0,0,0,0,0,0,0.191422720089132,190.664850009302,20.0025725940357
9.7,"random_policy_SVM","SVM",46,8,1884,1814,70,900,717,183,0.80327386107743,0.289855072463768,1.22805049088359,443,183,260,56,1.4,32.33,3.9,0,0,0,0,0,0,0.194255176856408,179.521667015957,20.2898678215514
9.7,"random_policy_SVM","SVM",46,9,1784,1729,55,1000,802,198,0.811253536578325,0.318840579710145,1.23735390369331,500,198,302,57,1.5,35.92,4.1,0,0,0,0,0,0,0.188657114697088,185.618123669449,19.4695485064457
9.7,"random_policy_SVM","SVM",46,10,1684,1641,43,1100,890,210,0.823119117731969,0.311594202898551,1.23735390369331,523,210,313,23,1.5,39.51,4.2,0,0,0,0,0,0,0.18600519634175,190.415491307286,19.0443276702517
9.7,"random_policy_SVM","SVM",46,11,1584,1556,28,1200,975,225,0.830203822391592,0.340579710144928,1.23735390369331,577,225,352,54,1.6,43.1,4.3,0,0,0,0,0,0,0.179784168653555,155.710694885425,18.6362039383395
9.7,"random_policy_SVM","SVM",46,12,1484,1464,20,1300,1067,233,0.812546913794098,0.304347826086957,1.23735390369331,587,233,354,10,1.5,46.7,4.6,0,0,0,0,0,0,0.161682731048794,133.297768952608,17.0464639549268
9.7,"random_policy_SVM","SVM",46,13,1384,1365,19,1400,1166,234,0.814810323921703,0.260869565217391,1.23735390369331,596,234,362,9,1.5,50.29,5,0,0,0,0,0,0,0.124921334937659,63.5498786048858,13.6000227895638
9.7,"random_policy_SVM","SVM",46,14,1284,1267,17,1500,1264,236,0.814123217275822,0.27536231884058,1.23735390369331,602,236,366,6,1.6,53.88,5.4,0,0,0,0,0,0,0.113018394500076,56.6087996122345,12.4259158671218
9.7,"random_policy_SVM","SVM",46,15,1184,1167,17,1600,1364,236,0.820382239159303,0.326086956521739,1.23735390369331,611,236,375,9,1.6,57.47,5.8,0,0,0,0,0,0,0.0917459210567015,38.7243307222626,10.1309783094264
9.7,"random_policy_SVM","SVM",46,16,1084,1067,17,1700,1464,236,0.816086379121195,0.289855072463768,1.23735390369331,612,236,376,1,1.6,61.06,6.2,0,0,0,0,0,0,0.0467060985499619,15.4695506285171,6.22908184753988
9.7,"random_policy_SVM","SVM",46,17,984,969,15,1800,1562,238,0.805918355563253,0.304347826086957,1.22805049088359,623,238,385,11,1.6,64.66,6.6,0,0,0,0,0,0,0.046576384417115,17.2120531634837,6.2713919712521
9.7,"random_policy_SVM","SVM",46,18,884,869,15,1900,1662,238,0.807402274958137,0.246376811594203,1.22805049088359,609,238,371,-14,1.6,68.25,7,0,0,0,0,0,0,0.0335684798394206,11.6749852852381,4.27480117073044
9.7,"random_policy_SVM","SVM",46,19,784,771,13,2000,1760,240,0.810987932328656,0.282608695652174,1.20944366526414,615,240,375,6,1.6,71.84,7.3,0,0,0,0,0,0,0.0254701385244917,8.08537012040729,3.88380114465186
9.7,"random_policy_SVM","SVM",46,20,684,671,13,2100,1860,240,0.807523529072117,0.297101449275362,1.20944366526414,632,240,392,17,1.6,75.43,7.8,0,0,0,0,0,0,0.0163586330577393,5.28403820090667,2.54915760511084
9.7,"random_policy_SVM","SVM",46,21,584,571,13,2200,1960,240,0.813401466597379,0.268115942028986,1.20944366526414,637,240,397,5,1.7,79.02,8.2,0,0,0,0,0,0,0.0163419738679781,5.29890287371578,2.27627408854905
9.7,"random_policy_SVM","SVM",46,22,484,471,13,2300,2060,240,0.812281309544431,0.297101449275362,1.20944366526414,626,240,386,-11,1.6,82.61,8.6,0,0,0,0,0,0,0.00344921789914624,1.00822608891514,0.530233319720512
9.7,"random_policy_SVM","SVM",46,23,384,373,11,2400,2158,242,0.805595011259312,0.27536231884058,1.20944366526414,645,242,403,19,1.7,86.21,8.9,0,0,0,0,0,0,0.0205524503540845,6.60454623001089,3.26351582181031
9.7,"random_policy_SVM","SVM",46,24,284,273,11,2500,2258,242,0.805797101449277,0.289855072463768,1.21874707807387,648,242,406,3,1.7,89.8,9.3,0,0,0,0,0,0,0.00141608124238037,0.403114491977916,0.283360624824254
9.7,"random_policy_SVM","SVM",46,25,184,175,9,2600,2356,244,0.773936139499967,0.202898550724638,1.25596072931276,666,244,422,18,1.7,93.39,9.7,0,0,0,0,0,0,0.0026205368978448,0.945317490868362,0.839734550582753
9.7,"random_policy_SVM","SVM",46,26,84,84,0,2700,2447,253,0.808337663837407,0.231884057971014,1.28387096774194,696,253,443,30,1.8,96.98,9.7,0,0,0,0,0,0,1.0000000994736e-07,0.620704975534117,0.620704975534117
9.7,"random_policy_SVM","SVM",46,27,0,0,0,2784,2531,253,0.83126623939027,0.268115942028986,1.28387096774194,693,253,440,-3,1.7,100,10,0,0,0,0,0,0,0,0,0
9.7,"random_policy_SVM","SVM",47,0,2684,2418,266,100,90,10,0.739572701911955,0.217391304347826,1.21688639551192,27,10,17,0,1.7,3.59,9,0,0,0,0,0,0,0.189042816077575,287.325670790385,21.2535804457923
9.7,"random_policy_SVM","SVM",47,1,2584,2349,235,200,159,41,0.801857521943266,0.278260869565217,1.25037868162693,98,41,57,71,1.4,7.18,3.9,0,0,0,0,0,0,0.26395909625239,361.650913244144,31.6980055872181
9.7,"random_policy_SVM","SVM",47,2,2484,2277,207,300,231,69,0.776328502415468,0.156521739130435,1.27270687237027,166,69,97,68,1.4,10.78,3.3,0,0,0,0,0,0,0.238550041315264,519.143970816692,26.6334390643851
9.7,"random_policy_SVM","SVM",47,3,2384,2191,193,400,317,83,0.798156086276113,0.173913043478261,1.28387096774194,201,83,118,35,1.4,14.37,3.8,0,0,0,0,0,0,0.210383380383801,338.711597378173,22.0701575102975
9.7,"random_policy_SVM","SVM",47,4,2284,2107,177,500,401,99,0.814377083758593,0.217391304347826,1.28387096774194,247,99,148,46,1.5,17.96,4.1,0,0,0,0,0,0,0.199913150403371,375.805002794975,21.1152952022045
9.7,"random_policy_SVM","SVM",47,5,2184,2030,154,600,478,122,0.824617268830378,0.234782608695652,1.28387096774194,300,122,178,53,1.5,21.55,3.9,0,0,0,0,0,0,0.195556529547834,247.226216794241,20.1420107312774
9.7,"random_policy_SVM","SVM",47,6,2084,1958,126,700,550,150,0.835558277199433,0.217391304347826,1.28387096774194,364,150,214,64,1.4,25.14,3.7,0,0,0,0,0,0,0.204846501034654,222.816727659771,21.3464943507416
9.7,"random_policy_SVM","SVM",47,7,1984,1888,96,800,620,180,0.833204055249374,0.217391304347826,1.28387096774194,432,180,252,68,1.4,28.74,3.4,0,0,0,0,0,0,0.217878792816181,286.582933307986,22.204488808644
9.7,"random_policy_SVM","SVM",47,8,1884,1811,73,900,697,203,0.839021569027695,0.243478260869565,1.28387096774194,487,203,284,55,1.4,32.33,3.4,0,0,0,0,0,0,0.215784582951535,286.153695140072,21.9625336197666
9.7,"random_policy_SVM","SVM",47,9,1784,1731,53,1000,777,223,0.846812274613871,0.243478260869565,1.28387096774194,529,223,306,42,1.4,35.92,3.5,0,0,0,0,0,0,0.18160870943439,140.385979800673,19.4058990321973
9.7,"random_policy_SVM","SVM",47,10,1684,1645,39,1100,863,237,0.845424236238692,0.234782608695652,1.28387096774194,567,237,330,38,1.4,39.51,3.6,0,0,0,0,0,0,0.194036952759713,208.694241110318,20.2999030650427
9.7,"random_policy_SVM","SVM",47,11,1584,1561,23,1200,947,253,0.848023406137311,0.260869565217391,1.28387096774194,618,253,365,51,1.4,43.1,3.7,0,0,0,0,0,0,0.173609903955949,137.212443322943,18.4858947411453
9.7,"random_policy_SVM","SVM",47,12,1484,1468,16,1300,1040,260,0.8386745594339,0.243478260869565,1.28387096774194,655,260,395,37,1.5,46.7,4,0,0,0,0,0,0,0.195182985355302,269.172133368109,19.6870588762338
9.7,"random_policy_SVM","SVM",47,13,1384,1371,13,1400,1137,263,0.839518269034499,0.252173913043478,1.28387096774194,662,263,399,7,1.5,50.29,4.3,0,0,0,0,0,0,0.174637598659214,197.41623534321,17.9075851227426
9.7,"random_policy_SVM","SVM",47,14,1284,1273,11,1500,1235,265,0.832271892222903,0.234782608695652,1.28387096774194,672,265,407,10,1.5,53.88,4.7,0,0,0,0,0,0,0.136423307314799,96.7243374243309,17.0559886216799
9.7,"random_policy_SVM","SVM",47,15,1184,1174,10,1600,1334,266,0.824950670204805,0.226086956521739,1.28387096774194,684,266,418,12,1.6,57.47,5,0,0,0,0,0,0,0.140802449715326,108.243427203438,15.332471436225
9.7,"random_policy_SVM","SVM",47,16,1084,1078,6,1700,1430,270,0.8303191127441,0.28695652173913,1.28387096774194,711,270,441,27,1.6,61.06,5.3,0,0,0,0,0,0,0.151643860382557,137.16725252267,15.4236466259402
9.7,"random_policy_SVM","SVM",47,17,984,979,5,1800,1529,271,0.816676872831192,0.252173913043478,1.28387096774194,716,271,445,5,1.6,64.66,5.6,0,0,0,0,0,0,0.135840255126966,98.6413210948643,13.9918947724701
9.7,"random_policy_SVM","SVM",47,18,884,880,4,1900,1628,272,0.810451112471937,0.234782608695652,1.28387096774194,715,272,443,-1,1.6,68.25,6,0,0,0,0,0,0,0.0741654422757383,28.5106649603329,9.25966457957658
9.7,"random_policy_SVM","SVM",47,19,784,781,3,2000,1727,273,0.810321834387973,0.226086956521739,1.28387096774194,730,273,457,15,1.7,71.84,6.3,0,0,0,0,0,0,0.0997186573183058,47.4545469646325,10.9059313207625
9.7,"random_policy_SVM","SVM",47,20,684,682,2,2100,1826,274,0.80677008913384,0.191304347826087,1.28387096774194,728,274,454,-2,1.7,75.43,6.7,0,0,0,0,0,0,0.0416037423270318,12.8517989459147,6.53393432021183
9.7,"random_policy_SVM","SVM",47,21,584,582,2,2200,1926,274,0.817234809825136,0.234782608695652,1.28387096774194,726,274,452,-2,1.6,79.02,7,0,0,0,0,0,0,0.0282515358369762,8.22391418264294,4.01943049912637
9.7,"random_policy_SVM","SVM",47,22,484,482,2,2300,2026,274,0.816812955024837,0.226086956521739,1.28387096774194,716,274,442,-10,1.6,82.61,7.4,0,0,0,0,0,0,0.0323186093985695,9.88930428147105,4.18089982194593
9.7,"random_policy_SVM","SVM",47,23,384,383,1,2400,2125,275,0.792950942369193,0.182608695652174,1.28387096774194,749,275,474,33,1.7,86.21,7.7,0,0,0,0,0,0,0.0897516454095072,21.4062956107047,12.5911716817584
9.7,"random_policy_SVM","SVM",47,24,284,284,0,2500,2224,276,0.787017758726272,0.182608695652174,1.28387096774194,743,276,467,-6,1.7,89.8,8.1,0,0,0,0,0,0,0.0415823051947291,14.4406001848548,11.4071102458811
9.7,"random_policy_SVM","SVM",47,25,184,184,0,2600,2324,276,0.819575423555829,0.191304347826087,1.28387096774194,766,276,490,23,1.8,93.39,8.4,0,0,0,0,0,0,0.0116741304384467,3.06188906285802,2.48033443136826
9.7,"random_policy_SVM","SVM",47,26,84,84,0,2700,2424,276,0.804579165816156,0.226086956521739,1.28387096774194,749,276,473,-17,1.7,96.98,8.8,0,0,0,0,0,0,5.41621280221061e-10,0.0107820324647879,0.0107820324647879
9.7,"random_policy_SVM","SVM",47,27,0,0,0,2784,2508,276,0.786425801183916,0.191304347826087,1.28387096774194,771,276,495,22,1.8,100,9.1,0,0,0,0,0,0,0,0,0
9.7,"random_policy_SVM","SVM",48,0,2684,2433,251,100,90,10,0.727035751263784,0.161538461538462,1.18511166253102,31,10,21,0,2.1,3.59,9,0,0,0,0,0,0,0.218589558783406,281.898055738114,31.1060903501541
9.7,"random_policy_SVM","SVM",48,1,2584,2343,241,200,180,20,0.80351422132895,0.230769230769231,1.27399503722084,66,20,46,35,2.3,7.18,9,0,0,0,0,0,0,0.123139752292412,227.935996009706,12.7810739166831
9.7,"random_policy_SVM","SVM",48,2,2484,2263,221,300,260,40,0.814154333394241,0.3,1.26411910669975,117,40,77,51,1.9,10.78,6.5,0,0,0,0,0,0,0.154115243298084,303.214517084369,15.7352253480592
9.7,"random_policy_SVM","SVM",48,3,2384,2203,181,400,320,80,0.784865095316405,0.192307692307692,1.24436724565757,197,80,117,80,1.5,14.37,4,0,0,0,0,0,0,0.223616407259143,331.882141459567,25.893024287974
9.7,"random_policy_SVM","SVM",48,4,2284,2125,159,500,398,102,0.747390218649132,0.230769230769231,1.15548387096774,245,102,143,48,1.4,17.96,3.9,0,0,0,0,0,0,0.222265085517255,239.286526238401,27.2540183066331
9.7,"random_policy_SVM","SVM",48,5,2184,2048,136,600,475,125,0.800950118764849,0.307692307692308,1.24436724565757,301,125,176,56,1.4,21.55,3.8,0,0,0,0,0,0,0.227905497337285,177.691244475975,25.0136417032153
9.7,"random_policy_SVM","SVM",48,6,2084,1977,107,700,546,154,0.789140629758211,0.276923076923077,1.19498759305211,356,154,202,55,1.3,25.14,3.5,0,0,0,0,0,0,0.210639516268515,182.154836974274,23.0792736218112
9.7,"random_policy_SVM","SVM",48,7,1984,1906,78,800,617,183,0.787027224556921,0.292307692307692,1.19498759305211,426,183,243,70,1.3,28.74,3.4,0,0,0,0,0,0,0.218005082811489,183.489656347167,22.658000236829
9.7,"random_policy_SVM","SVM",48,8,1884,1822,62,900,701,199,0.780151044521595,0.276923076923077,1.19498759305211,469,199,270,43,1.4,32.33,3.5,0,0,0,0,0,0,0.206303323919862,156.412607769085,22.2901378578051
9.7,"random_policy_SVM","SVM",48,9,1784,1726,58,1000,797,203,0.775698885437607,0.269230769230769,1.19498759305211,480,203,277,11,1.4,35.92,3.9,0,0,0,0,0,0,0.169185305213385,117.46994191401,18.1450633696211
9.7,"random_policy_SVM","SVM",48,10,1684,1633,51,1100,890,210,0.771618247152695,0.269230769230769,1.19498759305211,496,210,286,16,1.4,39.51,4.2,0,0,0,0,0,0,0.157343099910947,117.604409105447,16.709912521026
9.7,"random_policy_SVM","SVM",48,11,1584,1538,46,1200,985,215,0.743723734697611,0.153846153846154,1.2048635235732,514,215,299,18,1.4,43.1,4.6,0,0,0,0,0,0,0.21426077867321,134.181734020363,43.9142914874054
9.7,"random_policy_SVM","SVM",48,12,1484,1440,44,1300,1083,217,0.768950606005242,0.253846153846154,1.2048635235732,532,217,315,18,1.5,46.7,5,0,0,0,0,0,0,0.133275671785723,78.513238469701,15.001102069738
9.7,"random_policy_SVM","SVM",48,13,1384,1349,35,1400,1174,226,0.78094890066387,0.269230769230769,1.2048635235732,559,226,333,27,1.5,50.29,5.2,0,0,0,0,0,0,0.131997282188535,84.0710679956642,14.3655255793878
9.7,"random_policy_SVM","SVM",48,14,1284,1259,25,1500,1264,236,0.769943358304408,0.215384615384615,1.2048635235732,591,236,355,32,1.5,53.88,5.4,0,0,0,0,0,0,0.137684500381442,68.7139284642084,15.7632684311871
9.7,"random_policy_SVM","SVM",48,15,1184,1168,16,1600,1355,245,0.778713685364521,0.223076923076923,1.2048635235732,600,245,355,9,1.4,57.47,5.5,0,0,0,0,0,0,0.120345415315594,65.8797696496298,13.1727498376363
9.7,"random_policy_SVM","SVM",48,16,1084,1069,15,1700,1454,246,0.775144649491447,0.2,1.2048635235732,603,246,357,3,1.5,61.06,5.9,0,0,0,0,0,0,0.0800897699264572,33.0842104800162,9.61760311874972
9.7,"random_policy_SVM","SVM",48,17,984,970,14,1800,1553,247,0.78476764723796,0.246153846153846,1.2048635235732,606,247,359,3,1.5,64.66,6.3,0,0,0,0,0,0,0.060033190208954,22.061683716311,6.96446728095132
9.7,"random_policy_SVM","SVM",48,18,884,870,14,1900,1653,247,0.788160058468851,0.230769230769231,1.2048635235732,613,247,366,7,1.5,68.25,6.7,0,0,0,0,0,0,0.0267797860447405,9.01507957747829,3.84897625801814
9.7,"random_policy_SVM","SVM",48,19,784,770,14,2000,1753,247,0.794719532249228,0.276923076923077,1.2048635235732,616,247,369,3,1.5,71.84,7.1,0,0,0,0,0,0,0.015670307237104,4.79906769045832,2.32573229859542
9.7,"random_policy_SVM","SVM",48,20,684,671,13,2100,1852,248,0.798830623058656,0.3,1.2048635235732,609,248,361,-7,1.5,75.43,7.5,0,0,0,0,0,0,0.0122371982364357,3.96713356925617,2.14966295228364
9.7,"random_policy_SVM","SVM",48,21,584,572,12,2200,1951,249,0.790425726292714,0.238461538461538,1.2048635235732,620,249,371,11,1.5,79.02,7.8,0,0,0,0,0,0,0.00884163984341546,2.68746735267761,1.47724441319369
9.7,"random_policy_SVM","SVM",48,22,484,474,10,2300,2049,251,0.785035629453686,0.238461538461538,1.21473945409429,620,251,369,0,1.5,82.61,8.2,0,0,0,0,0,0,0.0114371849303244,8.89544270732245,8.06301923871619
9.7,"random_policy_SVM","SVM",48,23,384,375,9,2400,2148,252,0.782934405262201,0.246153846153846,1.21473945409429,621,252,369,1,1.5,86.21,8.5,0,0,0,0,0,0,0.00942379216351587,2.885322049782,1.79397546723554
9.7,"random_policy_SVM","SVM",48,24,284,279,5,2500,2244,256,0.796138619891593,0.261538461538462,1.22348774613968,657,256,401,36,1.6,89.8,8.8,0,0,0,0,0,0,0.0205222039614129,4.70033378785121,3.26577617854514
9.7,"random_policy_SVM","SVM",48,25,184,183,1,2600,2340,260,0.802606736098425,0.246153846153846,1.27399503722084,684,260,424,27,1.6,93.39,9,0,0,0,0,0,0,0.00919285020767373,4.17161694055045,3.88725431188594
9.7,"random_policy_SVM","SVM",48,26,84,84,0,2700,2439,261,0.780735732992268,0.192307692307692,1.27399503722084,685,261,424,1,1.6,96.98,9.3,0,0,0,0,0,0,1.3226736701078e-06,0.102964918395751,0.102964918395751
9.7,"random_policy_SVM","SVM",48,27,0,0,0,2784,2523,261,0.808782508069921,0.238461538461538,1.27399503722084,676,261,415,-9,1.6,100,9.7,0,0,0,0,0,0,0,0,0
9.7,"random_policy_SVM","SVM",49,0,2684,2429,255,100,91,9,0.816957122065906,0.409448818897638,1.22321564643129,36,9,27,0,3,3.59,10.1,0,0,0,0,0,0,0.116513086902038,247.608142451059,11.9244095099573
9.7,"random_policy_SVM","SVM",49,1,2584,2371,213,200,149,51,0.674951176126679,0.21259842519685,1.16256032512065,121,51,70,85,1.4,7.18,2.9,0,0,0,0,0,0,0.265799668449251,559.758421147653,29.1429778732183
9.7,"random_policy_SVM","SVM",49,2,2484,2289,195,300,231,69,0.771336343620554,0.15748031496063,1.28387096774194,163,69,94,42,1.4,10.78,3.3,0,0,0,0,0,0,0.269518648392684,440.273865861804,30.6457034363988
9.7,"random_policy_SVM","SVM",49,3,2384,2205,179,400,315,85,0.727537908472341,0.118110236220472,1.25354330708661,203,85,118,40,1.4,14.37,3.7,0,0,0,0,0,0,0.232657715821053,401.487379683077,25.9095948763579
9.7,"random_policy_SVM","SVM",49,4,2284,2120,164,500,400,100,0.826659700712762,0.188976377952756,1.26365252730505,230,100,130,27,1.3,17.96,4,0,0,0,0,0,0,0.216383034723035,272.68642398702,24.7168722713743
9.7,"random_policy_SVM","SVM",49,5,2184,2043,141,600,477,123,0.828264357950512,0.228346456692913,1.26365252730505,282,123,159,52,1.3,21.55,3.9,0,0,0,0,0,0,0.207918950406077,219.677822271489,22.0000336866266
9.7,"random_policy_SVM","SVM",49,6,2084,1967,117,700,553,147,0.832431491087309,0.251968503937008,1.26365252730505,346,147,199,64,1.4,25.14,3.8,0,0,0,0,0,0,0.203267608629703,199.580827505956,21.723059928043
9.7,"random_policy_SVM","SVM",49,7,1984,1881,103,800,639,161,0.833003694443406,0.244094488188976,1.26365252730505,377,161,216,31,1.3,28.74,4,0,0,0,0,0,0,0.189032947267293,168.531917962976,19.6776026157508
9.7,"random_policy_SVM","SVM",49,8,1884,1805,79,900,715,185,0.835914468037463,0.21259842519685,1.26365252730505,434,185,249,57,1.3,32.33,3.9,0,0,0,0,0,0,0.201986873889284,170.885193228686,20.8881750004855
9.7,"random_policy_SVM","SVM",49,9,1784,1717,67,1000,803,197,0.836387157766413,0.244094488188976,1.26365252730505,464,197,267,30,1.4,35.92,4.1,0,0,0,0,0,0,0.176142762178959,131.571741684329,18.7993136029811
9.7,"random_policy_SVM","SVM",49,10,1684,1627,57,1100,893,207,0.845791195531835,0.244094488188976,1.26365252730505,494,207,287,30,1.4,39.51,4.3,0,0,0,0,0,0,0.15151930349732,83.0269421626933,16.4938057178213
9.7,"random_policy_SVM","SVM",49,11,1584,1539,45,1200,981,219,0.837861203368534,0.283464566929134,1.26365252730505,524,219,305,30,1.4,43.1,4.5,0,0,0,0,0,0,0.173554354488468,109.931749852435,18.3171023348007
9.7,"random_policy_SVM","SVM",49,12,1484,1447,37,1300,1073,227,0.823064770932069,0.244094488188976,1.26365252730505,554,227,327,30,1.4,46.7,4.7,0,0,0,0,0,0,0.158828805264674,85.9994161164221,16.9408393225541
9.7,"random_policy_SVM","SVM",49,13,1384,1352,32,1400,1168,232,0.797763431229862,0.204724409448819,1.25354330708661,581,232,349,27,1.5,50.29,5,0,0,0,0,0,0,0.161728510630494,84.4380178251455,18.1808224528256
9.7,"random_policy_SVM","SVM",49,14,1284,1252,32,1500,1268,232,0.814711845853391,0.220472440944882,1.26365252730505,574,232,342,-7,1.5,53.88,5.5,0,0,0,0,0,0,0.137578479747601,62.4102444113916,14.4909504245273
9.7,"random_policy_SVM","SVM",49,15,1184,1155,29,1600,1365,235,0.811776193852544,0.259842519685039,1.26365252730505,595,235,360,21,1.5,57.47,5.8,0,0,0,0,0,0,0.107973913719354,34.8580377829785,12.173312132613
9.7,"random_policy_SVM","SVM",49,16,1084,1055,29,1700,1465,235,0.838557798758567,0.283464566929134,1.26365252730505,589,235,354,-6,1.5,61.06,6.2,0,0,0,0,0,0,0.0788925893939276,21.6351392215593,9.12381326664247
9.7,"random_policy_SVM","SVM",49,17,984,955,29,1800,1565,235,0.835416899901729,0.267716535433071,1.26365252730505,594,235,359,5,1.5,64.66,6.7,0,0,0,0,0,0,0.054701712977281,11.9931573780591,6.86560148335949
9.7,"random_policy_SVM","SVM",49,18,884,857,27,1900,1663,237,0.820919008346708,0.259842519685039,1.26365252730505,597,237,360,3,1.5,68.25,7,0,0,0,0,0,0,0.0288727743948429,7.41031007264052,5.08038968082211
9.7,"random_policy_SVM","SVM",49,19,784,759,25,2000,1761,239,0.790952967371971,0.204724409448819,1.25354330708661,631,239,392,34,1.6,71.84,7.4,0,0,0,0,0,0,0.00244299298047997,1.19166532732695,1.03100352523489
9.7,"random_policy_SVM","SVM",49,20,684,665,19,2100,1855,245,0.827486907738423,0.267716535433071,1.26365252730505,635,245,390,4,1.6,75.43,7.6,0,0,0,0,0,0,0.0299928701671736,9.35488609855293,5.61301273675728
9.7,"random_policy_SVM","SVM",49,21,584,565,19,2200,1955,245,0.82940876466271,0.267716535433071,1.26365252730505,629,245,384,-6,1.6,79.02,8,0,0,0,0,0,0,0.00815634810077986,2.5388049726134,1.72566063636021
9.7,"random_policy_SVM","SVM",49,22,484,468,16,2300,2052,248,0.838906096453579,0.236220472440945,1.26365252730505,645,248,397,16,1.6,82.61,8.3,0,0,0,0,0,0,0.0195533781979958,5.77686009610273,2.9666472067676
9.7,"random_policy_SVM","SVM",49,23,384,373,11,2400,2147,253,0.810588249928481,0.236220472440945,1.28387096774194,665,253,412,20,1.6,86.21,8.5,0,0,0,0,0,0,0.0257619112030139,7.24279306059251,5.16526050966666
9.7,"random_policy_SVM","SVM",49,24,284,282,2,2500,2238,262,0.747950641240934,0.110236220472441,1.28387096774194,702,262,440,37,1.7,89.8,8.5,0,0,0,0,0,0,0.0869173851408599,23.190734585492,15.9149668627884
9.7,"random_policy_SVM","SVM",49,25,184,183,1,2600,2337,263,0.843583236929508,0.267716535433071,1.28268876611418,699,263,436,-3,1.7,93.39,8.9,0,0,0,0,0,0,0.0145314809600068,4.79174172214608,4.29372377588728
9.7,"random_policy_SVM","SVM",49,26,84,84,0,2700,2436,264,0.799405406077796,0.236220472440945,1.28268876611418,707,264,443,8,1.7,96.98,9.2,0,0,0,0,0,0,1.49140733685458e-05,1.19280721183512,1.19280721183512
9.7,"random_policy_SVM","SVM",49,27,0,0,0,2784,2520,264,0.815439539251907,0.244094488188976,1.28268876611418,697,264,433,-10,1.6,100,9.5,0,0,0,0,0,0,0,0,0
9.7,"random_policy_SVM","SVM",50,0,2684,2444,240,100,95,5,0.74104975228219,0.273972602739726,1.13437914273089,17,5,12,0,2.4,3.59,19,0,0,0,0,0,0,0.110065147574643,152.015886393198,16.386038047989
9.7,"random_policy_SVM","SVM",50,1,2584,2363,221,200,176,24,0.728537531170698,0.123287671232877,1.24869642068051,78,24,54,61,2.2,7.18,7.3,0,0,0,0,0,0,0.139789610964572,288.229688945773,42.2225723935336
9.7,"random_policy_SVM","SVM",50,2,2484,2270,214,300,269,31,0.808757456251156,0.280821917808219,1.26628369421122,95,31,64,17,2.1,10.78,8.7,0,0,0,0,0,0,0.167387798699807,173.891541386713,19.4587430236389
9.7,"random_policy_SVM","SVM",50,3,2384,2192,192,400,347,53,0.811025914248986,0.301369863013699,1.27507733097658,149,53,96,54,1.8,14.37,6.5,0,0,0,0,0,0,0.171157662668481,178.978097859244,17.8529038537489
9.7,"random_policy_SVM","SVM",50,4,2284,2124,160,500,415,85,0.787089013632713,0.23972602739726,1.27507733097658,223,85,138,74,1.6,17.96,4.9,0,0,0,0,0,0,0.216687071262687,229.952751945467,29.0698965957632
9.7,"random_policy_SVM","SVM",50,5,2184,2041,143,600,498,102,0.776839757884664,0.23972602739726,1.26628369421122,269,102,167,46,1.6,21.55,4.9,0,0,0,0,0,0,0.198437110789626,227.386466799249,21.521400795554
9.7,"random_policy_SVM","SVM",50,6,2084,1955,129,700,584,116,0.778147004866458,0.26027397260274,1.26628369421122,311,116,195,42,1.7,25.14,5,0,0,0,0,0,0,0.184825073306605,201.911144907768,19.115581064037
9.7,"random_policy_SVM","SVM",50,7,1984,1875,109,800,664,136,0.786506794388708,0.267123287671233,1.26628369421122,368,136,232,57,1.7,28.74,4.9,0,0,0,0,0,0,0.170852265495107,312.223186243066,17.1198588896945
9.7,"random_policy_SVM","SVM",50,8,1884,1789,95,900,750,150,0.79710208610252,0.287671232876712,1.26628369421122,405,150,255,37,1.7,32.33,5,0,0,0,0,0,0,0.17130232238923,109.602059967763,18.2570116157779
9.7,"random_policy_SVM","SVM",50,9,1784,1717,67,1000,822,178,0.809839505223478,0.294520547945205,1.26628369421122,482,178,304,77,1.7,35.92,4.6,0,0,0,0,0,0,0.18584482556047,153.450095746503,19.0795848042286
9.7,"random_policy_SVM","SVM",50,10,1684,1642,42,1100,897,203,0.826537113730469,0.328767123287671,1.26628369421122,535,203,332,53,1.6,39.51,4.4,0,0,0,0,0,0,0.175942199828507,99.7275142576828,18.9799003810706
9.7,"random_policy_SVM","SVM",50,11,1584,1556,28,1200,983,217,0.795163186167332,0.205479452054795,1.26628369421122,589,217,372,54,1.7,43.1,4.5,0,0,0,0,0,0,0.177668355659922,161.151358162144,18.2266185584238
9.7,"random_policy_SVM","SVM",50,12,1484,1459,25,1300,1080,220,0.815551844975876,0.273972602739726,1.26628369421122,582,220,362,-7,1.6,46.7,4.9,0,0,0,0,0,0,0.136940253478699,63.2836431064457,14.8878425951426
9.7,"random_policy_SVM","SVM",50,13,1384,1364,20,1400,1175,225,0.827399457327716,0.321917808219178,1.26628369421122,605,225,380,23,1.7,50.29,5.2,0,0,0,0,0,0,0.0875354828960743,31.9104522890488,11.105133570129
9.7,"random_policy_SVM","SVM",50,14,1284,1268,16,1500,1271,229,0.812662719293415,0.294520547945205,1.26628369421122,624,229,395,19,1.7,53.88,5.6,0,0,0,0,0,0,0.115204841721926,65.7620680322937,13.737446457152
9.7,"random_policy_SVM","SVM",50,15,1184,1172,12,1600,1367,233,0.825273807823709,0.315068493150685,1.25749005744587,641,233,408,17,1.8,57.47,5.9,0,0,0,0,0,0,0.115778615899182,61.0147663842664,12.7930038350076
9.7,"random_policy_SVM","SVM",50,16,1084,1077,7,1700,1462,238,0.799139853456514,0.226027397260274,1.25749005744587,660,238,422,19,1.8,61.06,6.1,0,0,0,0,0,0,0.104938060392561,38.6258334671522,12.5089427974001
9.7,"random_policy_SVM","SVM",50,17,984,981,3,1800,1558,242,0.797178982983817,0.226027397260274,1.25749005744587,673,242,431,13,1.8,64.66,6.4,0,0,0,0,0,0,0.0736066462636578,27.0735598528377,10.1434317747277
9.7,"random_policy_SVM","SVM",50,18,884,883,1,1900,1656,244,0.77927299491382,0.226027397260274,1.25749005744587,680,244,436,7,1.8,68.25,6.8,0,0,0,0,0,0,0.0449038600535349,16.327236335261,7.84781104549202
9.7,"random_policy_SVM","SVM",50,19,784,784,0,2000,1755,245,0.784661269237946,0.253424657534247,1.25749005744587,682,245,437,2,1.8,71.84,7.2,0,0,0,0,0,0,0.05611770600774,17.7283184396383,8.34576008336775
9.7,"random_policy_SVM","SVM",50,20,684,684,0,2100,1855,245,0.806412101372057,0.294520547945205,1.25749005744587,711,245,466,29,1.9,75.43,7.6,0,0,0,0,0,0,0.0300676984792969,8.5928593235019,4.32677182474688
9.7,"random_policy_SVM","SVM",50,21,584,584,0,2200,1955,245,0.773280530808174,0.26027397260274,1.26628369421122,701,245,456,-10,1.9,79.02,8,0,0,0,0,0,0,0.0161499177123355,4.35624801569006,2.72193110585822
9.7,"random_policy_SVM","SVM",50,22,484,484,0,2300,2055,245,0.790296712109051,0.26027397260274,1.26628369421122,689,245,444,-12,1.8,82.61,8.4,0,0,0,0,0,0,0.00313258093591396,1.08314202573392,0.879146511903663
9.7,"random_policy_SVM","SVM",50,23,384,384,0,2400,2155,245,0.817704957651782,0.335616438356164,1.26628369421122,704,245,459,15,1.9,86.21,8.8,0,0,0,0,0,0,0.000133482782981298,0.0929427792148188,0.087754552154221
9.7,"random_policy_SVM","SVM",50,24,284,284,0,2500,2255,245,0.770638573672694,0.191780821917808,1.26628369421122,694,245,449,-10,1.8,89.8,9.2,0,0,0,0,0,0,3.08023957483315e-05,0.0314319202206214,0.030501516053629
9.7,"random_policy_SVM","SVM",50,25,184,184,0,2600,2355,245,0.734639847963872,0.136986301369863,1.26628369421122,694,245,449,0,1.8,93.39,9.6,0,0,0,0,0,0,6.18899185063924e-06,0.0143887728304641,0.0142066972419301
9.7,"random_policy_SVM","SVM",50,26,84,84,0,2700,2455,245,0.806379145565786,0.280821917808219,1.26628369421122,677,245,432,-17,1.8,96.98,10,0,0,0,0,0,0,1.0000000994736e-07,0.000152280857758231,0.000152280857758231
9.7,"random_policy_SVM","SVM",50,27,0,0,0,2784,2539,245,0.727395063220215,0.171232876712329,1.26628369421122,689,245,444,12,1.8,100,10.4,0,0,0,0,0,0,0,0,0
9.7,"random_policy_SVM","SVM",51,0,2684,2433,251,100,91,9,0.778190440473737,0.297709923664122,1.2348682590495,31,9,22,0,2.4,3.59,10.1,0,0,0,0,0,0,0.106481288983141,257.439326638764,10.9947105225871
9.7,"random_policy_SVM","SVM",51,1,2584,2367,217,200,157,43,0.705326574805529,0.198473282442748,1.27407042600345,112,43,69,81,1.6,7.18,3.7,0,0,0,0,0,0,0.238340952876004,505.380786115947,25.3367100175375
9.7,"random_policy_SVM","SVM",51,2,2484,2284,200,300,240,60,0.747589552509642,0.206106870229008,1.22506771731101,160,60,100,48,1.7,10.78,4,0,0,0,0,0,0,0.220308189546405,444.176793607305,22.6455093056715
9.7,"random_policy_SVM","SVM",51,3,2384,2189,195,400,335,65,0.74941024183109,0.198473282442748,1.25446934252647,174,65,109,14,1.7,14.37,5.2,0,0,0,0,0,0,0.185083047066894,323.308318659979,20.9069358872671
9.7,"random_policy_SVM","SVM",51,4,2284,2094,190,500,430,70,0.796978018654505,0.274809160305344,1.25446934252647,192,70,122,18,1.7,17.96,6.1,0,0,0,0,0,0,0.158053960421853,215.225297517568,16.3411798069914
9.7,"random_policy_SVM","SVM",51,5,2184,2018,166,600,506,94,0.804381751974929,0.312977099236641,1.24466880078798,251,94,157,59,1.7,21.55,5.4,0,0,0,0,0,0,0.177480024612132,186.063768152154,18.221257577791
9.7,"random_policy_SVM","SVM",51,6,2084,1947,137,700,577,123,0.82241927874088,0.305343511450382,1.24466880078798,317,123,194,66,1.6,25.14,4.7,0,0,0,0,0,0,0.203957699363168,175.517878031745,20.9211857164373
9.7,"random_policy_SVM","SVM",51,7,1984,1880,104,800,644,156,0.821173225584008,0.32824427480916,1.24466880078798,393,156,237,76,1.5,28.74,4.1,0,0,0,0,0,0,0.205933401907201,174.718249258958,21.6255519900187
9.7,"random_policy_SVM","SVM",51,8,1884,1807,77,900,717,183,0.813872321893026,0.305343511450382,1.2348682590495,469,183,286,76,1.6,32.33,3.9,0,0,0,0,0,0,0.205983457416864,193.153162794917,21.3626479242848
9.7,"random_policy_SVM","SVM",51,9,1784,1720,64,1000,804,196,0.796869140223314,0.259541984732824,1.2348682590495,502,196,306,33,1.6,35.92,4.1,0,0,0,0,0,0,0.19041949370122,154.483124128127,20.230612964018
9.7,"random_policy_SVM","SVM",51,10,1684,1625,59,1100,899,201,0.811144312311724,0.32824427480916,1.2348682590495,520,201,319,18,1.6,39.51,4.5,0,0,0,0,0,0,0.167754752193531,140.462050091975,17.6246950685023
9.7,"random_policy_SVM","SVM",51,11,1584,1535,49,1200,989,211,0.803540968534126,0.305343511450382,1.22506771731101,554,211,343,34,1.6,43.1,4.7,0,0,0,0,0,0,0.157242090877291,114.629583050435,16.8983956777185
9.7,"random_policy_SVM","SVM",51,12,1484,1438,46,1300,1086,214,0.792181318880722,0.267175572519084,1.22506771731101,562,214,348,8,1.6,46.7,5.1,0,0,0,0,0,0,0.139515823246737,72.0989841039494,15.2786544539416
9.7,"random_policy_SVM","SVM",51,13,1384,1344,40,1400,1180,220,0.778922345483352,0.213740458015267,1.22506771731101,575,220,355,13,1.6,50.29,5.4,0,0,0,0,0,0,0.157907832848842,86.7067192169987,18.4014977677058
9.7,"random_policy_SVM","SVM",51,14,1284,1247,37,1500,1277,223,0.789997701455334,0.267175572519084,1.22506771731101,594,223,371,19,1.7,53.88,5.7,0,0,0,0,0,0,0.113508458555523,45.0587453820026,12.7313174737696
9.7,"random_policy_SVM","SVM",51,15,1184,1151,33,1600,1373,227,0.801829157643862,0.236641221374046,1.22506771731101,599,227,372,5,1.6,57.47,6,0,0,0,0,0,0,0.099963074220349,38.8570444495177,12.0711924167915
9.7,"random_policy_SVM","SVM",51,16,1084,1053,31,1700,1471,229,0.807412201642846,0.297709923664122,1.22506771731101,601,229,372,2,1.6,61.06,6.4,0,0,0,0,0,0,0.0648551423335466,22.1406845705593,8.05022771109021
9.7,"random_policy_SVM","SVM",51,17,984,954,30,1800,1570,230,0.799500368976899,0.236641221374046,1.2348682590495,606,230,376,5,1.6,64.66,6.8,0,0,0,0,0,0,0.0276757403373136,9.19586294003392,4.8009797706928
9.7,"random_policy_SVM","SVM",51,18,884,855,29,1900,1669,231,0.833754733187348,0.297709923664122,1.2348682590495,611,231,380,5,1.6,68.25,7.2,0,0,0,0,0,0,0.0165672955228632,5.45531038257603,2.47518102333095
9.7,"random_policy_SVM","SVM",51,19,784,760,24,2000,1764,236,0.83726908699386,0.305343511450382,1.25446934252647,643,236,407,32,1.7,71.84,7.5,0,0,0,0,0,0,0.0715578046470521,27.9614601322738,10.5176752195213
9.7,"random_policy_SVM","SVM",51,20,684,666,18,2100,1858,242,0.824560554554142,0.274809160305344,1.25446934252647,654,242,412,11,1.7,75.43,7.7,0,0,0,0,0,0,0.0227215118253633,7.91389031189771,5.18345210806049
9.7,"random_policy_SVM","SVM",51,21,584,571,13,2200,1953,247,0.83057306347612,0.305343511450382,1.26426988426496,665,247,418,11,1.7,79.02,7.9,0,0,0,0,0,0,0.0607925411247582,20.5189956631033,8.33596743066368
9.7,"random_policy_SVM","SVM",51,22,484,472,12,2300,2052,248,0.768657528943515,0.190839694656489,1.26426988426496,655,248,407,-10,1.6,82.61,8.3,0,0,0,0,0,0,0.0419032686865291,15.6804843089911,11.5450761965441
9.7,"random_policy_SVM","SVM",51,23,384,375,9,2400,2149,251,0.789392821282101,0.244274809160305,1.28387096774194,690,251,439,35,1.7,86.21,8.6,0,0,0,0,0,0,0.034049270673859,8.31423227791647,6.06460796688727
9.7,"random_policy_SVM","SVM",51,24,284,281,3,2500,2243,257,0.760515841811736,0.206106870229008,1.28387096774194,725,257,468,35,1.8,89.8,8.7,0,0,0,0,0,0,0.00928712718066265,3.73911864299025,3.38390091349353
9.7,"random_policy_SVM","SVM",51,25,184,184,0,2600,2340,260,0.829853256069971,0.274809160305344,1.28387096774194,707,260,447,-18,1.7,93.39,9,0,0,0,0,0,0,8.27251120242348e-08,0.0861144982958068,0.0861135913101998
9.7,"random_policy_SVM","SVM",51,26,84,84,0,2700,2440,260,0.766637229164902,0.221374045801527,1.28387096774194,729,260,469,22,1.8,96.98,9.4,0,0,0,0,0,0,3.00000089999998e-14,5.21096272781147e-06,5.21096272781147e-06
9.7,"random_policy_SVM","SVM",51,27,0,0,0,2784,2524,260,0.823054402922778,0.236641221374046,1.28387096774194,725,260,465,-4,1.8,100,9.7,0,0,0,0,0,0,0,0,0
9.7,"random_policy_SVM","SVM",52,0,2684,2434,250,100,91,9,0.768083291279157,0.234848484848485,1.2352394916911,24,9,15,0,1.7,3.59,10.1,0,0,0,0,0,0,0.101463488778387,262.590362951463,10.2203890817432
9.7,"random_policy_SVM","SVM",52,1,2584,2357,227,200,168,32,0.753484488020573,0.257575757575758,1.15742913000977,87,32,55,63,1.7,7.18,5.2,0,0,0,0,0,0,0.20342156367183,370.686253565978,26.3583673087525
9.7,"random_policy_SVM","SVM",52,2,2484,2275,209,300,250,50,0.765740273472229,0.227272727272727,1.22551319648094,129,50,79,42,1.6,10.78,5,0,0,0,0,0,0,0.210426068675222,264.025813974914,25.497702617213
9.7,"random_policy_SVM","SVM",52,3,2384,2194,190,400,331,69,0.806604907120363,0.287878787878788,1.22551319648094,166,69,97,37,1.4,14.37,4.8,0,0,0,0,0,0,0.208274795793829,195.504444080286,21.3161869878426
9.7,"random_policy_SVM","SVM",52,4,2284,2131,153,500,394,106,0.788858049167318,0.265151515151515,1.21578690127077,257,106,151,91,1.4,17.96,3.7,0,0,0,0,0,0,0.234823986497745,202.465041014169,23.9959613421366
9.7,"random_policy_SVM","SVM",52,5,2184,2061,123,600,464,136,0.78753033907672,0.265151515151515,1.21578690127077,321,136,185,64,1.4,21.55,3.4,0,0,0,0,0,0,0.242260727889818,179.423317614976,24.7644095411658
9.7,"random_policy_SVM","SVM",52,6,2084,1987,97,700,538,162,0.801546391752568,0.295454545454545,1.21578690127077,379,162,217,58,1.3,25.14,3.3,0,0,0,0,0,0,0.243446048229165,138.189464709556,25.235122831536
9.7,"random_policy_SVM","SVM",52,7,1984,1916,68,800,609,191,0.80725975055871,0.303030303030303,1.21578690127077,436,191,245,57,1.3,28.74,3.2,0,0,0,0,0,0,0.241228985844317,129.773447818307,25.3568845963363
9.7,"random_policy_SVM","SVM",52,8,1884,1832,52,900,693,207,0.801095811405082,0.310606060606061,1.21578690127077,491,207,284,55,1.4,32.33,3.3,0,0,0,0,0,0,0.217213422968509,100.454872787436,23.3801604376046
9.7,"random_policy_SVM","SVM",52,9,1784,1738,46,1000,787,213,0.804303943479191,0.348484848484849,1.21578690127077,527,213,314,36,1.5,35.92,3.7,0,0,0,0,0,0,0.197423566094091,115.838469294509,20.9139670221253
9.7,"random_policy_SVM","SVM",52,10,1684,1642,42,1100,883,217,0.80179871674716,0.348484848484849,1.21578690127077,516,217,299,-11,1.4,39.51,4.1,0,0,0,0,0,0,0.098677578219117,25.8621949670621,12.9528837172805
9.7,"random_policy_SVM","SVM",52,11,1584,1544,40,1200,981,219,0.813333573642844,0.340909090909091,1.22551319648094,541,219,322,25,1.5,43.1,4.5,0,0,0,0,0,0,0.0571558633809073,16.2712345806426,9.93979324849176
9.7,"random_policy_SVM","SVM",52,12,1484,1454,30,1300,1071,229,0.811260904044395,0.257575757575758,1.25469208211144,542,229,313,1,1.4,46.7,4.7,0,0,0,0,0,0,0.153519891385122,65.899472950316,23.6694262615095
9.7,"random_policy_SVM","SVM",52,13,1384,1361,23,1400,1164,236,0.815598490856208,0.28030303030303,1.25469208211144,579,236,343,37,1.5,50.29,4.9,0,0,0,0,0,0,0.100103590276772,37.6647413682217,13.1186028356061
9.7,"random_policy_SVM","SVM",52,14,1284,1263,21,1500,1262,238,0.81317737245571,0.28030303030303,1.25469208211144,597,238,359,18,1.5,53.88,5.3,0,0,0,0,0,0,0.0510525774435161,17.4780360222623,7.54544945907046
9.7,"random_policy_SVM","SVM",52,15,1184,1164,20,1600,1361,239,0.809680868959209,0.265151515151515,1.22551319648094,605,239,366,8,1.5,57.47,5.7,0,0,0,0,0,0,0.12732692200672,42.0765077896161,14.9436997719654
9.7,"random_policy_SVM","SVM",52,16,1084,1066,18,1700,1459,241,0.802657823276372,0.25,1.22551319648094,602,241,361,-3,1.5,61.06,6.1,0,0,0,0,0,0,0.122563540955908,40.1072546263917,15.2233116142358
9.7,"random_policy_SVM","SVM",52,17,984,967,17,1800,1558,242,0.815610506332146,0.325757575757576,1.22551319648094,630,242,388,28,1.6,64.66,6.4,0,0,0,0,0,0,0.0597569869095645,16.40021328579,8.03534109530962
9.7,"random_policy_SVM","SVM",52,18,884,867,17,1900,1658,242,0.789122389637845,0.257575757575758,1.22551319648094,619,242,377,-11,1.6,68.25,6.9,0,0,0,0,0,0,0.0392779669913112,11.0556313740147,5.71934732815415
9.7,"random_policy_SVM","SVM",52,19,784,767,17,2000,1758,242,0.808070795184187,0.287878787878788,1.22551319648094,619,242,377,0,1.6,71.84,7.3,0,0,0,0,0,0,0.0149345676640946,4.32636014530575,2.5273535511435
9.7,"random_policy_SVM","SVM",52,20,684,668,16,2100,1857,243,0.804670415495148,0.21969696969697,1.22551319648094,622,243,379,3,1.6,75.43,7.6,0,0,0,0,0,0,0.00302658707038933,1.41724764150347,1.10256369883812
9.7,"random_policy_SVM","SVM",52,21,584,568,16,2200,1957,243,0.812168072477341,0.295454545454545,1.22551319648094,635,243,392,13,1.6,79.02,8.1,0,0,0,0,0,0,0.00160065490792182,0.518808431586757,0.355524453163127
9.7,"random_policy_SVM","SVM",52,22,484,471,13,2300,2054,246,0.802069064955659,0.287878787878788,1.21578690127077,647,246,401,12,1.6,82.61,8.3,0,0,0,0,0,0,0.0351882584189154,10.6850505295781,8.77746303901757
9.7,"random_policy_SVM","SVM",52,23,384,372,12,2400,2153,247,0.809452574916487,0.310606060606061,1.21578690127077,653,247,406,6,1.6,86.21,8.7,0,0,0,0,0,0,0.00746805348577643,4.84694972728464,4.5093801205653
9.7,"random_policy_SVM","SVM",52,24,284,272,12,2500,2253,247,0.762742412226943,0.159090909090909,1.21578690127077,641,247,394,-12,1.6,89.8,9.1,0,0,0,0,0,0,0.00106317791226949,0.483764366648301,0.430581306942874
9.7,"random_policy_SVM","SVM",52,25,184,175,9,2600,2350,250,0.816313411674233,0.303030303030303,1.21578690127077,668,250,418,27,1.7,93.39,9.4,0,0,0,0,0,0,0.000375696411866806,0.193795607150186,0.180727793094413
9.7,"random_policy_SVM","SVM",52,26,84,82,2,2700,2443,257,0.825024631725661,0.257575757575758,1.27414467253177,701,257,444,33,1.7,96.98,9.5,0,0,0,0,0,0,2.44949581111191e-07,4.26792060162825,4.26792060162825
9.7,"random_policy_SVM","SVM",52,27,0,0,0,2784,2525,259,0.791195059236297,0.212121212121212,1.2644183773216,688,259,429,-13,1.7,100,9.7,0,0,0,0,0,0,0,0,0
9.7,"random_policy_SVM","SVM",53,0,2684,2423,261,100,83,17,0.802316095132735,0.327433628318584,1.21570082786183,42,17,25,0,1.5,3.59,4.9,0,0,0,0,0,0,0.235855484723852,441.858175829896,24.3194199804165
9.7,"random_policy_SVM","SVM",53,1,2584,2351,233,200,155,45,0.674287887168137,0.0884955752212389,1.22706251784185,120,45,75,78,1.7,7.18,3.4,0,0,0,0,0,0,0.237969947156243,578.700679195205,24.4658448532406
9.7,"random_policy_SVM","SVM",53,2,2484,2261,223,300,245,55,0.753595132743357,0.168141592920354,1.21570082786183,150,55,95,30,1.7,10.78,4.5,0,0,0,0,0,0,0.203288806008994,435.988894421733,23.0774717547752
9.7,"random_policy_SVM","SVM",53,3,2384,2167,217,400,339,61,0.808683628318578,0.265486725663717,1.24978589780188,180,61,119,30,2,14.37,5.6,0,0,0,0,0,0,0.176166797805443,298.696515739983,18.4464242941377
9.7,"random_policy_SVM","SVM",53,4,2284,2089,195,500,417,83,0.820685840707958,0.327433628318584,1.24978589780188,222,83,139,42,1.7,17.96,5,0,0,0,0,0,0,0.18984473903298,316.972529674777,19.7480925579744
9.7,"random_policy_SVM","SVM",53,5,2184,2024,160,600,482,118,0.803539823008844,0.274336283185841,1.24978589780188,297,118,179,75,1.5,21.55,4.1,0,0,0,0,0,0,0.209655331756396,356.209181877188,21.3060520481819
9.7,"random_policy_SVM","SVM",53,6,2084,1958,126,700,548,152,0.798140210176986,0.247787610619469,1.24978589780188,383,152,231,86,1.5,25.14,3.6,0,0,0,0,0,0,0.225080963905311,338.825810688536,22.8860633945934
9.7,"random_policy_SVM","SVM",53,7,1984,1880,104,800,626,174,0.811656526548667,0.238938053097345,1.24978589780188,426,174,252,43,1.4,28.74,3.6,0,0,0,0,0,0,0.222086760881946,347.127299110128,22.4871860323468
9.7,"random_policy_SVM","SVM",53,8,1884,1801,83,900,705,195,0.809222898230082,0.265486725663717,1.24978589780188,482,195,287,56,1.5,32.33,3.6,0,0,0,0,0,0,0.217410711933786,329.850103743719,22.1708760034765
9.7,"random_policy_SVM","SVM",53,9,1784,1708,76,1000,798,202,0.796715984513269,0.176991150442478,1.24978589780188,501,202,299,19,1.5,35.92,4,0,0,0,0,0,0,0.211387435172753,238.04709786455,26.2694227910766
9.7,"random_policy_SVM","SVM",53,10,1684,1614,70,1100,892,208,0.809063882743358,0.20353982300885,1.24978589780188,535,208,327,34,1.6,39.51,4.3,0,0,0,0,0,0,0.171389442384959,149.106725978123,18.6669222739485
9.7,"random_policy_SVM","SVM",53,11,1584,1535,49,1200,971,229,0.799675055309732,0.20353982300885,1.2611475877819,575,229,346,40,1.5,43.1,4.2,0,0,0,0,0,0,0.188550121611073,186.248791725714,20.2022614677723
9.7,"random_policy_SVM","SVM",53,12,1484,1442,42,1300,1064,236,0.808621404867254,0.194690265486726,1.2611475877819,592,236,356,17,1.5,46.7,4.5,0,0,0,0,0,0,0.169005391919604,144.263828885781,20.5893979130124
9.7,"random_policy_SVM","SVM",53,13,1384,1350,34,1400,1156,244,0.822524889380529,0.212389380530973,1.27250927776192,614,244,370,22,1.5,50.29,4.7,0,0,0,0,0,0,0.168458289978476,137.232598026648,17.7427309849627
9.7,"random_policy_SVM","SVM",53,14,1284,1263,21,1500,1243,257,0.827067201327432,0.20353982300885,1.27250927776192,671,257,414,57,1.6,53.88,4.8,0,0,0,0,0,0,0.170058130995134,128.63301740213,18.4813132525176
9.7,"random_policy_SVM","SVM",53,15,1184,1169,15,1600,1337,263,0.826251382743362,0.212389380530973,1.27250927776192,681,263,418,10,1.6,57.47,5.1,0,0,0,0,0,0,0.155307544658729,105.587504109642,16.6618605847403
9.7,"random_policy_SVM","SVM",53,16,1084,1074,10,1700,1432,268,0.836995298672566,0.230088495575221,1.27250927776192,715,268,447,34,1.7,61.06,5.3,0,0,0,0,0,0,0.123847736597152,68.4525631317041,13.9644135696199
9.7,"random_policy_SVM","SVM",53,17,984,974,10,1800,1532,268,0.797407356194689,0.168141592920354,1.27250927776192,723,268,455,8,1.7,64.66,5.7,0,0,0,0,0,0,0.0946427514046942,42.8524147306045,11.1737735863145
9.7,"random_policy_SVM","SVM",53,18,884,875,9,1900,1631,269,0.837852599557521,0.274336283185841,1.27250927776192,718,269,449,-5,1.7,68.25,6.1,0,0,0,0,0,0,0.0853351814756337,40.6185174366987,9.49947360371589
9.7,"random_policy_SVM","SVM",53,19,784,780,4,2000,1726,274,0.812313329646016,0.221238938053097,1.27250927776192,728,274,454,10,1.7,71.84,6.3,0,0,0,0,0,0,0.0635788932239442,24.0712789850291,8.34403110447386
9.7,"random_policy_SVM","SVM",53,20,684,680,4,2100,1826,274,0.807376935840707,0.185840707964602,1.27250927776192,741,274,467,13,1.7,75.43,6.7,0,0,0,0,0,0,0.0230442146212262,6.87041035318666,3.64875360396887
9.7,"random_policy_SVM","SVM",53,21,584,581,3,2200,1925,275,0.791800331858406,0.141592920353982,1.27250927776192,713,275,438,-28,1.6,79.02,7,0,0,0,0,0,0,0.0289453708670319,10.7890825898551,6.95064126801126
9.7,"random_policy_SVM","SVM",53,22,484,482,2,2300,2024,276,0.791433904867256,0.132743362831858,1.27250927776192,740,276,464,27,1.7,82.61,7.3,0,0,0,0,0,0,0.0224136024324569,6.18592569791032,3.53102882021171
9.7,"random_policy_SVM","SVM",53,23,384,383,1,2400,2123,277,0.794738661504424,0.123893805309735,1.28387096774194,743,277,466,3,1.7,86.21,7.7,0,0,0,0,0,0,0.00411723280723112,1.95624574847704,1.73833795743165
9.7,"random_policy_SVM","SVM",53,24,284,284,0,2500,2222,278,0.80060149336283,0.194690265486726,1.28387096774194,761,278,483,18,1.7,89.8,8,0,0,0,0,0,0,0.00764553874114336,2.67654867047238,2.26108088336368
9.7,"random_policy_SVM","SVM",53,25,184,184,0,2600,2322,278,0.786359236725663,0.176991150442478,1.28387096774194,769,278,491,8,1.8,93.39,8.4,0,0,0,0,0,0,3.58102413232737e-05,0.0742920437181053,0.0735057014044226
9.7,"random_policy_SVM","SVM",53,26,84,84,0,2700,2422,278,0.81729120575221,0.194690265486726,1.28387096774194,734,278,456,-35,1.6,96.98,8.7,0,0,0,0,0,0,2.38178978980787e-07,0.038636414169215,0.038636414169215
9.7,"random_policy_SVM","SVM",53,27,0,0,0,2784,2506,278,0.808759679203538,0.185840707964602,1.28387096774194,755,278,477,21,1.7,100,9,0,0,0,0,0,0,0,0,0
9.7,"random_policy_SVM","SVM",54,0,2684,2421,263,100,92,8,0.199620319455355,0.00833333333333333,0.588440860215054,26,8,18,0,2.2,3.59,11.5,0,0,0,0,0,0,0.0861441520016099,216.310347292137,8.68634787055599
9.7,"random_policy_SVM","SVM",54,1,2584,2332,252,200,181,19,0.792426027755956,0.275,1.18758064516129,56,19,37,30,1.9,7.18,9.5,0,0,0,0,0,0,0.169505892349131,268.076999966968,18.3818526991658
9.7,"random_policy_SVM","SVM",54,2,2484,2264,220,300,249,51,0.8234354543074,0.225,1.27317204301075,123,51,72,67,1.4,10.78,4.9,0,0,0,0,0,0,0.293231339946339,339.122718852533,36.4706344778587
9.7,"random_policy_SVM","SVM",54,3,2384,2187,197,400,326,74,0.765992406389107,0.183333333333333,1.26247311827957,190,74,116,67,1.6,14.37,4.4,0,0,0,0,0,0,0.241788174624806,355.413539245942,27.8670581515518
9.7,"random_policy_SVM","SVM",54,4,2284,2107,177,500,406,94,0.829929300864103,0.3,1.26247311827957,239,94,145,49,1.5,17.96,4.3,0,0,0,0,0,0,0.204965167468256,368.251210547669,20.9479647141253
9.7,"random_policy_SVM","SVM",54,5,2184,2036,148,600,477,123,0.820181984812774,0.258333333333333,1.26247311827957,301,123,178,62,1.4,21.55,3.9,0,0,0,0,0,0,0.224843149719728,349.1589147317,22.783623307604
9.7,"random_policy_SVM","SVM",54,6,2084,1969,115,700,544,156,0.819370253993191,0.258333333333333,1.26247311827957,370,156,214,69,1.4,25.14,3.5,0,0,0,0,0,0,0.234234488181533,177.129454062951,24.4640144816024
9.7,"random_policy_SVM","SVM",54,7,1984,1892,92,800,621,179,0.824044252422099,0.283333333333333,1.26247311827957,440,179,261,70,1.5,28.74,3.5,0,0,0,0,0,0,0.222307665264201,145.086082826262,23.612298648621
9.7,"random_policy_SVM","SVM",54,8,1884,1809,75,900,704,196,0.828534956794968,0.283333333333333,1.26247311827957,479,196,283,39,1.4,32.33,3.6,0,0,0,0,0,0,0.208033453828949,141.831211541358,22.2648832970491
9.7,"random_policy_SVM","SVM",54,9,1784,1723,61,1000,790,210,0.833536266038222,0.283333333333333,1.27317204301075,533,210,323,54,1.5,35.92,3.8,0,0,0,0,0,0,0.185372176766991,104.537477353971,20.7321074203001
9.7,"random_policy_SVM","SVM",54,10,1684,1636,48,1100,877,223,0.832135375752811,0.291666666666667,1.27317204301075,564,223,341,31,1.5,39.51,3.9,0,0,0,0,0,0,0.197030478573432,201.650949566401,20.4895893545117
9.7,"random_policy_SVM","SVM",54,11,1584,1552,32,1200,961,239,0.825039277297719,0.275,1.27317204301075,627,239,388,63,1.6,43.1,4,0,0,0,0,0,0,0.175296682334453,115.153076025503,18.9001689954767
9.7,"random_policy_SVM","SVM",54,12,1484,1456,28,1300,1057,243,0.819317884262888,0.291666666666667,1.27317204301075,641,243,398,14,1.6,46.7,4.3,0,0,0,0,0,0,0.134963185120827,69.671334439086,15.6172417150493
9.7,"random_policy_SVM","SVM",54,13,1384,1358,26,1400,1155,245,0.821275202932703,0.275,1.27317204301075,643,245,398,2,1.6,50.29,4.7,0,0,0,0,0,0,0.129139160788219,71.7255786911019,14.8898409470429
9.7,"random_policy_SVM","SVM",54,14,1284,1258,26,1500,1255,245,0.817249279916207,0.25,1.26247311827957,643,245,398,0,1.6,53.88,5.1,0,0,0,0,0,0,0.0932675405590318,40.1863427478388,10.9500274473089
9.7,"random_policy_SVM","SVM",54,15,1184,1162,22,1600,1351,249,0.793028279654359,0.208333333333333,1.26247311827957,680,249,431,37,1.7,57.47,5.4,0,0,0,0,0,0,0.128579744375658,47.5037012947984,16.6205763841716
9.7,"random_policy_SVM","SVM",54,16,1084,1064,20,1700,1449,251,0.815344330976695,0.283333333333333,1.27317204301075,691,251,440,11,1.8,61.06,5.8,0,0,0,0,0,0,0.0576489954586215,19.2748892144135,8.4232252956537
9.7,"random_policy_SVM","SVM",54,17,984,968,16,1800,1545,255,0.82900628436763,0.225,1.27317204301075,705,255,450,14,1.8,64.66,6.1,0,0,0,0,0,0,0.0846500969960882,25.615951194728,14.090592539891
9.7,"random_policy_SVM","SVM",54,18,884,878,6,1900,1635,265,0.802199528672428,0.166666666666667,1.28387096774194,755,265,490,50,1.8,68.25,6.2,0,0,0,0,0,0,0.0450202669474971,15.573998885212,8.48637078240352
9.7,"random_policy_SVM","SVM",54,19,784,779,5,2000,1734,266,0.808889761717728,0.15,1.28387096774194,741,266,475,-14,1.8,71.84,6.5,0,0,0,0,0,0,0.0307927780466043,9.01113206265295,5.13826145408014
9.7,"random_policy_SVM","SVM",54,20,684,681,3,2100,1832,268,0.799365017020164,0.233333333333333,1.28387096774194,753,268,485,12,1.8,75.43,6.8,0,0,0,0,0,0,0.055583158152226,16.3428023100347,10.4147027997268
9.7,"random_policy_SVM","SVM",54,21,584,581,3,2200,1932,268,0.839133280963604,0.283333333333333,1.28387096774194,763,268,495,10,1.8,79.02,7.2,0,0,0,0,0,0,0.0100752204156262,3.18405848303257,2.13407658511363
9.7,"random_policy_SVM","SVM",54,22,484,481,3,2300,2032,268,0.799600680806495,0.175,1.28387096774194,767,268,499,4,1.9,82.61,7.6,0,0,0,0,0,0,0.0606636243043161,21.0536552007963,7.09845194941717
9.7,"random_policy_SVM","SVM",54,23,384,382,2,2400,2131,269,0.822080387536003,0.241666666666667,1.28387096774194,752,269,483,-15,1.8,86.21,7.9,0,0,0,0,0,0,0.00613769684105481,2.27387222342809,1.89988793545617
9.7,"random_policy_SVM","SVM",54,24,284,283,1,2500,2230,270,0.780655930871957,0.183333333333333,1.28387096774194,783,270,513,31,1.9,89.8,8.3,0,0,0,0,0,0,0.0201324679238838,7.30512895649168,6.47160081415428
9.7,"random_policy_SVM","SVM",54,25,184,184,0,2600,2329,271,0.826387797852843,0.241666666666667,1.28387096774194,795,271,524,12,1.9,93.39,8.6,0,0,0,0,0,0,0.000423403530465168,2.68297809854855,2.67586614566599
9.7,"random_policy_SVM","SVM",54,26,84,84,0,2700,2429,271,0.826086671903637,0.275,1.28387096774194,785,271,514,-10,1.9,96.98,9,0,0,0,0,0,0,0.000940825384517198,1.20464471656668,1.20464471656668
9.7,"random_policy_SVM","SVM",54,27,0,0,0,2784,2513,271,0.790907305577377,0.175,1.28387096774194,774,271,503,-11,1.9,100,9.3,0,0,0,0,0,0,0,0,0
9.7,"random_policy_SVM","SVM",55,0,2684,2420,264,100,91,9,0.381994017946162,0.0254237288135593,0.826899945325314,33,9,24,0,2.7,3.59,10.1,0,0,0,0,0,0,0.0998685057353668,244.754137602156,10.0712576361394
9.7,"random_policy_SVM","SVM",55,1,2584,2329,255,200,182,18,0.69893652376205,0.194915254237288,1.25123018042646,69,18,51,36,2.8,7.18,10.1,0,0,0,0,0,0,0.12606816430796,235.6181458146,13.3529042375322
9.7,"random_policy_SVM","SVM",55,2,2484,2244,240,300,267,33,0.756397474243939,0.186440677966102,1.26211044286495,97,33,64,28,1.9,10.78,8.1,0,0,0,0,0,0,0.130672721024299,239.05198251887,13.5974851484969
9.7,"random_policy_SVM","SVM",55,3,2384,2168,216,400,343,57,0.777720172814894,0.211864406779661,1.25123018042646,145,57,88,48,1.5,14.37,6,0,0,0,0,0,0,0.160638986226374,273.60634844895,16.7933902869974
9.7,"random_policy_SVM","SVM",55,4,2284,2090,194,500,421,79,0.778664007976077,0.271186440677966,1.24034991798797,195,79,116,50,1.5,17.96,5.3,0,0,0,0,0,0,0.16021757439112,288.212349887322,16.2867213280076
9.7,"random_policy_SVM","SVM",55,5,2184,2018,166,600,493,107,0.7827052176803,0.254237288135593,1.24034991798797,254,107,147,59,1.4,21.55,4.6,0,0,0,0,0,0,0.18899793334342,253.404894775111,19.5666127539359
9.7,"random_policy_SVM","SVM",55,6,2084,1959,125,700,552,148,0.768680624792294,0.23728813559322,1.22946965554948,346,148,198,92,1.3,25.14,3.7,0,0,0,0,0,0,0.210067647699215,255.133479176307,22.13512681516
9.7,"random_policy_SVM","SVM",55,7,1984,1893,91,800,618,182,0.770555001661687,0.23728813559322,1.22946965554948,424,182,242,78,1.3,28.74,3.4,0,0,0,0,0,0,0.213601313238702,215.725241538042,22.2529084165557
9.7,"random_policy_SVM","SVM",55,8,1884,1814,70,900,697,203,0.78386174808907,0.228813559322034,1.24034991798797,457,203,254,33,1.3,32.33,3.4,0,0,0,0,0,0,0.190071930901237,171.207954022993,20.8760681085866
9.7,"random_policy_SVM","SVM",55,9,1784,1738,46,1000,773,227,0.784546360917252,0.254237288135593,1.22946965554948,530,227,303,73,1.3,35.92,3.4,0,0,0,0,0,0,0.2019481098952,170.49662111562,22.2658927392589
9.7,"random_policy_SVM","SVM",55,10,1684,1642,42,1100,869,231,0.786812894649388,0.279661016949153,1.24034991798797,542,231,311,12,1.3,39.51,3.8,0,0,0,0,0,0,0.158541699297679,116.264844874576,17.3191551402418
9.7,"random_policy_SVM","SVM",55,11,1584,1548,36,1200,963,237,0.792562313060822,0.220338983050847,1.24034991798797,560,237,323,18,1.4,43.1,4.1,0,0,0,0,0,0,0.135334338281534,84.4016812028953,15.1368873101849
9.7,"random_policy_SVM","SVM",55,12,1484,1458,26,1300,1053,247,0.794489863742111,0.203389830508475,1.27299070530344,612,247,365,52,1.5,46.7,4.3,0,0,0,0,0,0,0.171280228674717,98.2662444257796,19.3740775832053
9.7,"random_policy_SVM","SVM",55,13,1384,1365,19,1400,1146,254,0.81623130608176,0.220338983050847,1.27299070530344,626,254,372,14,1.5,50.29,4.5,0,0,0,0,0,0,0.138813188995651,90.3714068529462,15.5231082438619
9.7,"random_policy_SVM","SVM",55,14,1284,1271,13,1500,1240,260,0.792030574941846,0.161016949152542,1.27299070530344,643,260,383,17,1.5,53.88,4.8,0,0,0,0,0,0,0.139895341024322,80.0303986258735,16.270094125284
9.7,"random_policy_SVM","SVM",55,15,1184,1174,10,1600,1337,263,0.805496842804924,0.203389830508475,1.27299070530344,664,263,401,21,1.5,57.47,5.1,0,0,0,0,0,0,0.113052753716685,54.189168929129,12.8120426457875
9.7,"random_policy_SVM","SVM",55,16,1084,1075,9,1700,1436,264,0.796869391824532,0.203389830508475,1.27299070530344,669,264,405,5,1.5,61.06,5.4,0,0,0,0,0,0,0.125549069699665,85.9116266347404,13.5648698087335
9.7,"random_policy_SVM","SVM",55,17,984,977,7,1800,1534,266,0.793612495845801,0.194915254237288,1.27299070530344,682,266,416,13,1.6,64.66,5.8,0,0,0,0,0,0,0.101425651589721,51.269103808397,13.0738018854384
9.7,"random_policy_SVM","SVM",55,18,884,878,6,1900,1633,267,0.783363243602529,0.169491525423729,1.28387096774194,693,267,426,11,1.6,68.25,6.1,0,0,0,0,0,0,0.0728025167158249,30.5397501215772,8.75784850330225
9.7,"random_policy_SVM","SVM",55,19,784,780,4,2000,1731,269,0.764945164506483,0.135593220338983,1.28387096774194,698,269,429,5,1.6,71.84,6.4,0,0,0,0,0,0,0.0459660130654358,17.9446952840102,6.07616429949773
9.7,"random_policy_SVM","SVM",55,20,684,681,3,2100,1830,270,0.776304420073117,0.203389830508475,1.28387096774194,689,270,419,-9,1.6,75.43,6.8,0,0,0,0,0,0,0.0343527294175201,11.23936059306,4.64313722433391
9.7,"random_policy_SVM","SVM",55,21,584,582,2,2200,1929,271,0.779873712196747,0.152542372881356,1.28387096774194,713,271,442,24,1.6,79.02,7.1,0,0,0,0,0,0,0.0241572982909664,7.46536015182224,3.2645225474505
9.7,"random_policy_SVM","SVM",55,22,484,482,2,2300,2029,271,0.77222997673646,0.161016949152542,1.28387096774194,712,271,441,-1,1.6,82.61,7.5,0,0,0,0,0,0,0.00875876401811474,2.25889734773799,1.37480688112409
9.7,"random_policy_SVM","SVM",55,23,384,383,1,2400,2128,272,0.735068128946498,0.127118644067797,1.27299070530344,706,272,434,-6,1.6,86.21,7.8,0,0,0,0,0,0,0.0834678630656131,22.5566155957679,12.9762853621257
9.7,"random_policy_SVM","SVM",55,24,284,283,1,2500,2228,272,0.782000664672653,0.169491525423729,1.27299070530344,718,272,446,12,1.6,89.8,8.2,0,0,0,0,0,0,0.0090428736346961,2.66534668508691,2.08288971387526
9.7,"random_policy_SVM","SVM",55,25,184,184,0,2600,2327,273,0.773678963110673,0.161016949152542,1.27299070530344,716,273,443,-2,1.6,93.39,8.5,0,0,0,0,0,0,4.96661950552189e-06,2.52063375919617,2.52054322059861
9.7,"random_policy_SVM","SVM",55,26,84,84,0,2700,2427,273,0.769504818876707,0.144067796610169,1.27299070530344,723,273,450,7,1.6,96.98,8.9,0,0,0,0,0,0,2.17050355042012e-09,0.136427699531503,0.136427699531503
9.7,"random_policy_SVM","SVM",55,27,0,0,0,2784,2511,273,0.709690927218348,0.0932203389830508,1.27299070530344,718,273,445,-5,1.6,100,9.2,0,0,0,0,0,0,0,0,0
9.7,"random_policy_SVM","SVM",56,0,2684,2428,256,100,88,12,0.704525958645411,0.276422764227642,1.15861526357199,37,12,25,0,2.1,3.59,7.3,0,0,0,0,0,0,0.197792706980171,294.137606099077,23.3239294884207
9.7,"random_policy_SVM","SVM",56,1,2584,2347,237,200,169,31,0.672805838294602,0.146341463414634,1.24211906635195,92,31,61,55,2,7.18,5.5,0,0,0,0,0,0,0.18934224520888,396.241963326536,20.3074069051303
9.7,"random_policy_SVM","SVM",56,2,2484,2250,234,300,266,34,0.762147109660073,0.252032520325203,1.25255704169945,108,34,74,16,2.2,10.78,7.8,0,0,0,0,0,0,0.128614878011803,290.275484502238,13.2190680091888
9.7,"random_policy_SVM","SVM",56,3,2384,2188,196,400,328,72,0.774310223417197,0.211382113821138,1.18992918961448,184,72,112,76,1.6,14.37,4.6,0,0,0,0,0,0,0.218353352710027,301.441151076985,24.2868580660066
9.7,"random_policy_SVM","SVM",56,4,2284,2109,175,500,407,93,0.769348953332062,0.211382113821138,1.23168109100446,244,93,151,60,1.6,17.96,4.4,0,0,0,0,0,0,0.206032044277732,293.171125777562,26.349743380619
9.7,"random_policy_SVM","SVM",56,5,2184,2029,155,600,487,113,0.790768836822236,0.300813008130081,1.24211906635195,291,113,178,47,1.6,21.55,4.3,0,0,0,0,0,0,0.204818087613056,251.888343249716,21.255904528195
9.7,"random_policy_SVM","SVM",56,6,2084,1951,133,700,565,135,0.792042762947319,0.260162601626016,1.22124311565696,344,135,209,53,1.5,25.14,4.2,0,0,0,0,0,0,0.196115925055833,248.2287067236,19.95276043964
9.7,"random_policy_SVM","SVM",56,7,1984,1880,104,800,636,164,0.791172140067863,0.211382113821138,1.22124311565696,417,164,253,73,1.5,28.74,3.9,0,0,0,0,0,0,0.207588408845771,263.340745390538,20.9649758167339
9.7,"random_policy_SVM","SVM",56,8,1884,1802,82,900,714,186,0.779034632866017,0.195121951219512,1.22124311565696,465,186,279,48,1.5,32.33,3.8,0,0,0,0,0,0,0.206623112901788,194.692926313941,25.0735761618089
9.7,"random_policy_SVM","SVM",56,9,1784,1713,71,1000,803,197,0.810581908968701,0.252032520325203,1.23168109100446,507,197,310,42,1.6,35.92,4.1,0,0,0,0,0,0,0.197647050463963,125.233839826557,20.5423213102791
9.7,"random_policy_SVM","SVM",56,10,1684,1635,49,1100,881,219,0.795333205300562,0.195121951219512,1.23168109100446,556,219,337,49,1.5,39.51,4,0,0,0,0,0,0,0.20013300334432,175.197570235375,20.468734918343
9.7,"random_policy_SVM","SVM",56,11,1584,1547,37,1200,969,231,0.780635042570903,0.186991869918699,1.24211906635195,605,231,374,49,1.6,43.1,4.2,0,0,0,0,0,0,0.182745734293285,124.138744675276,18.9636733501532
9.7,"random_policy_SVM","SVM",56,12,1484,1454,30,1300,1062,238,0.787696050188853,0.211382113821138,1.23168109100446,614,238,376,9,1.6,46.7,4.5,0,0,0,0,0,0,0.179512010745445,107.669194922244,18.4600544626792
9.7,"random_policy_SVM","SVM",56,13,1384,1357,27,1400,1159,241,0.800262467191606,0.284552845528455,1.23168109100446,631,241,390,17,1.6,50.29,4.8,0,0,0,0,0,0,0.158199941225001,72.0423386946371,16.712704745671
9.7,"random_policy_SVM","SVM",56,14,1284,1258,26,1500,1258,242,0.767966199347037,0.186991869918699,1.23168109100446,637,242,395,6,1.6,53.88,5.2,0,0,0,0,0,0,0.135054252431082,48.311181873186,14.9008061547814
9.7,"random_policy_SVM","SVM",56,15,1184,1161,23,1600,1355,245,0.790333525382503,0.276422764227642,1.23168109100446,655,245,410,18,1.7,57.47,5.5,0,0,0,0,0,0,0.118527651563858,35.0307498078497,13.0506315800566
9.7,"random_policy_SVM","SVM",56,16,1084,1063,21,1700,1453,247,0.812310351449976,0.284552845528455,1.25255704169945,664,247,417,9,1.7,61.06,5.9,0,0,0,0,0,0,0.063495353361795,14.9950133349574,8.37650069434763
9.7,"random_policy_SVM","SVM",56,17,984,963,21,1800,1553,247,0.748825299276618,0.105691056910569,1.25255704169945,652,247,405,-12,1.6,64.66,6.3,0,0,0,0,0,0,0.0264472698614301,7.10878870805471,5.53698264531897
9.7,"random_policy_SVM","SVM",56,18,884,864,20,1900,1652,248,0.791204148261962,0.211382113821138,1.25255704169945,658,248,410,6,1.7,68.25,6.7,0,0,0,0,0,0,0.0100008708550067,3.33480401565804,2.73484951418853
9.7,"random_policy_SVM","SVM",56,19,784,766,18,2000,1750,250,0.759535241021709,0.130081300813008,1.25255704169945,660,250,410,2,1.6,71.84,7,0,0,0,0,0,0,0.000937770603389926,0.794329086326111,0.75249214650591
9.7,"random_policy_SVM","SVM",56,20,684,672,12,2100,1844,256,0.803380065296731,0.227642276422764,1.25255704169945,687,256,431,27,1.7,75.43,7.2,0,0,0,0,0,0,0.036646015764045,11.2135077487373,8.27563193903534
9.7,"random_policy_SVM","SVM",56,21,584,572,12,2200,1944,256,0.782088214582944,0.154471544715447,1.25255704169945,679,256,423,-8,1.7,79.02,7.6,0,0,0,0,0,0,0.039926489306245,11.9815777800362,5.8533132803926
9.7,"random_policy_SVM","SVM",56,22,484,473,11,2300,2043,257,0.805703860188219,0.211382113821138,1.27343299239444,688,257,431,9,1.7,82.61,7.9,0,0,0,0,0,0,0.0115104475329457,2.88654071893335,1.95046547232383
9.7,"random_policy_SVM","SVM",56,23,384,375,9,2400,2141,259,0.793291082517127,0.186991869918699,1.28387096774194,697,259,438,9,1.7,86.21,8.3,0,0,0,0,0,0,0.00453654193518222,1.47577901480613,1.27659513403146
9.7,"random_policy_SVM","SVM",56,24,284,282,2,2500,2234,266,0.84331988989181,0.292682926829268,1.28387096774194,751,266,485,54,1.8,89.8,8.4,0,0,0,0,0,0,0.00413324261804844,2.47537142187269,2.19675996244016
9.7,"random_policy_SVM","SVM",56,25,184,184,0,2600,2332,268,0.802125344088086,0.219512195121951,1.28387096774194,751,268,483,0,1.8,93.39,8.7,0,0,0,0,0,0,0.00598456624666176,12.5360392686109,12.438524423977
9.7,"random_policy_SVM","SVM",56,26,84,84,0,2700,2432,268,0.766218551949299,0.130081300813008,1.28387096774194,751,268,483,0,1.8,96.98,9.1,0,0,0,0,0,0,1.0000000994736e-07,0.156839356467319,0.156839356467319
9.7,"random_policy_SVM","SVM",56,27,0,0,0,2784,2516,268,0.809845720504444,0.203252032520325,1.28387096774194,761,268,493,10,1.8,100,9.4,0,0,0,0,0,0,0,0,0
9.7,"random_policy_SVM","SVM",57,0,2684,2427,257,100,87,13,0.832501689276997,0.347107438016529,1.25203945614503,29,13,16,0,1.2,3.59,6.7,0,0,0,0,0,0,0.390895398796882,375.440420310307,42.1692469753851
9.7,"random_policy_SVM","SVM",57,1,2584,2368,216,200,146,54,0.773532927906853,0.132231404958678,1.2732604638763,125,54,71,96,1.3,7.18,2.7,0,0,0,0,0,0,0.333795244080332,579.07590921354,36.2315445365325
9.7,"random_policy_SVM","SVM",57,2,2484,2287,197,300,227,73,0.803712511045276,0.198347107438017,1.26264996001066,174,73,101,49,1.4,10.78,3.1,0,0,0,0,0,0,0.246316205622641,580.084396789051,25.1527586993029
9.7,"random_policy_SVM","SVM",57,3,2384,2209,175,400,305,95,0.843566453557885,0.272727272727273,1.26264996001066,221,95,126,47,1.3,14.37,3.2,0,0,0,0,0,0,0.265031617180933,341.518757135142,29.4773236454475
9.7,"random_policy_SVM","SVM",57,4,2284,2130,154,500,384,116,0.842409948542028,0.28099173553719,1.2732604638763,270,116,154,49,1.3,17.96,3.3,0,0,0,0,0,0,0.254508379182409,296.087414160105,26.5122327036383
9.7,"random_policy_SVM","SVM",57,5,2184,2059,125,600,455,145,0.843248089817558,0.297520661157025,1.2732604638763,345,145,200,75,1.4,21.55,3.1,0,0,0,0,0,0,0.258017286212412,249.750197747944,26.4700277086159
9.7,"random_policy_SVM","SVM",57,6,2084,1986,98,700,528,172,0.84574302198659,0.289256198347107,1.2732604638763,403,172,231,58,1.3,25.14,3.1,0,0,0,0,0,0,0.248633400242868,221.145102552457,25.361615111497
9.7,"random_policy_SVM","SVM",57,7,1984,1916,68,800,598,202,0.839655127605384,0.289256198347107,1.2732604638763,476,202,274,73,1.4,28.74,3,0,0,0,0,0,0,0.245398910942561,160.600818986583,25.8961786412803
9.7,"random_policy_SVM","SVM",57,8,1884,1825,59,900,689,211,0.833944071937212,0.297520661157025,1.2732604638763,503,211,292,27,1.4,32.33,3.3,0,0,0,0,0,0,0.199130950518009,107.913660207479,21.5173678535952
9.7,"random_policy_SVM","SVM",57,9,1784,1735,49,1000,779,221,0.826407297676592,0.239669421487603,1.26264996001066,539,221,318,36,1.4,35.92,3.5,0,0,0,0,0,0,0.207108713258183,134.29801619523,21.9355755139588
9.7,"random_policy_SVM","SVM",57,10,1684,1644,40,1100,870,230,0.825647123031341,0.256198347107438,1.24142895227939,567,230,337,28,1.5,39.51,3.8,0,0,0,0,0,0,0.165724267162512,78.0251660379699,18.3402465300247
9.7,"random_policy_SVM","SVM",57,11,1584,1553,31,1200,961,239,0.830435573574508,0.28099173553719,1.24142895227939,602,239,363,35,1.5,43.1,4,0,0,0,0,0,0,0.165209681175164,86.0289735759474,19.160444513033
9.7,"random_policy_SVM","SVM",57,12,1484,1454,30,1300,1060,240,0.839746088674049,0.31404958677686,1.24142895227939,584,240,344,-18,1.4,46.7,4.4,0,0,0,0,0,0,0.171507385183848,91.8303329372213,18.4908378819328
9.7,"random_policy_SVM","SVM",57,13,1384,1357,27,1400,1157,243,0.797065855813709,0.190082644628099,1.25203945614503,624,243,381,40,1.6,50.29,4.8,0,0,0,0,0,0,0.154417738384254,70.3414651447729,17.4537798863417
9.7,"random_policy_SVM","SVM",57,14,1284,1260,24,1500,1254,246,0.81279562347315,0.198347107438017,1.23081844841376,612,246,366,-12,1.5,53.88,5.1,0,0,0,0,0,0,0.135358915211793,78.8078030640338,18.1247920729509
9.7,"random_policy_SVM","SVM",57,15,1184,1161,23,1600,1353,247,0.828239513488236,0.264462809917355,1.24142895227939,621,247,374,9,1.5,57.47,5.5,0,0,0,0,0,0,0.0874550470802397,31.6083805453686,10.4318056474095
9.7,"random_policy_SVM","SVM",57,16,1084,1061,23,1700,1453,247,0.834061021882639,0.256198347107438,1.24142895227939,627,247,380,6,1.5,61.06,5.9,0,0,0,0,0,0,0.0664179694582551,25.7493894781817,8.10413649430359
9.7,"random_policy_SVM","SVM",57,17,984,961,23,1800,1553,247,0.809053225219614,0.231404958677686,1.24142895227939,629,247,382,2,1.5,64.66,6.3,0,0,0,0,0,0,0.0490768643256773,16.9099868804329,6.3966523611436
9.7,"random_policy_SVM","SVM",57,18,884,865,19,1900,1649,251,0.818389729195906,0.223140495867769,1.24142895227939,644,251,393,15,1.6,68.25,6.6,0,0,0,0,0,0,0.0323544958642874,10.7831142185528,4.88815122816388
9.7,"random_policy_SVM","SVM",57,19,784,770,14,2000,1744,256,0.825634128592961,0.223140495867769,1.24142895227939,669,256,413,25,1.6,71.84,6.8,0,0,0,0,0,0,0.0331787385571295,10.8783255016954,5.87020922421801
9.7,"random_policy_SVM","SVM",57,20,684,672,12,2100,1842,258,0.806779198503045,0.206611570247934,1.26264996001066,655,258,397,-14,1.5,75.43,7.1,0,0,0,0,0,0,0.032952188525971,9.61175676512453,5.3881614876179
9.7,"random_policy_SVM","SVM",57,21,584,577,7,2200,1937,263,0.80356957222309,0.198347107438017,1.28387096774194,684,263,421,29,1.6,79.02,7.4,0,0,0,0,0,0,0.0583785979335798,19.3984016118646,8.44410982686
9.7,"random_policy_SVM","SVM",57,22,484,482,2,2300,2032,268,0.797748063828684,0.181818181818182,1.27208803250993,705,268,437,21,1.6,82.61,7.6,0,0,0,0,0,0,0.00950735264165061,4.31891288711704,3.46019266670713
9.7,"random_policy_SVM","SVM",57,23,384,383,1,2400,2131,269,0.844450075367743,0.247933884297521,1.28268876611418,708,269,439,3,1.6,86.21,7.9,0,0,0,0,0,0,0.00323747342664418,1.19534302164848,0.937797651326573
9.7,"random_policy_SVM","SVM",57,24,284,283,1,2500,2231,269,0.841026040854512,0.305785123966942,1.27208803250993,701,269,432,-7,1.6,89.8,8.3,0,0,0,0,0,0,0.00204033891729505,0.680457561801614,0.571795358173357
9.7,"random_policy_SVM","SVM",57,25,184,183,1,2600,2331,269,0.843533967461927,0.297520661157025,1.27208803250993,724,269,455,23,1.7,93.39,8.7,0,0,0,0,0,0,0.000173385616170786,0.128545921456343,0.122356330129332
9.7,"random_policy_SVM","SVM",57,26,84,84,0,2700,2430,270,0.831013826082433,0.247933884297521,1.2732604638763,743,270,473,19,1.8,96.98,9,0,0,0,0,0,0,3.64480643785349e-05,0.537095423395734,0.537095423395734
9.7,"random_policy_SVM","SVM",57,27,0,0,0,2784,2514,270,0.836172618119446,0.247933884297521,1.27208803250993,725,270,455,-18,1.7,100,9.3,0,0,0,0,0,0,0,0,0
9.7,"random_policy_SVM","SVM",58,0,2684,2431,253,100,93,7,0.821530104886216,0.297709923664122,1.24466880078798,19,7,12,0,1.7,3.59,13.3,0,0,0,0,0,0,0.163107538100949,208.449810174953,17.9130090682015
9.7,"random_policy_SVM","SVM",58,1,2584,2365,219,200,159,41,0.640574152260436,0.16030534351145,1.21526717557252,104,41,63,85,1.5,7.18,3.9,0,0,0,0,0,0,0.253813044108003,502.39313631947,29.0006463375337
9.7,"random_policy_SVM","SVM",58,2,2484,2282,202,300,242,58,0.792858784674744,0.312977099236641,1.20546663383403,141,58,83,37,1.4,10.78,4.2,0,0,0,0,0,0,0.296781310200661,231.860332942954,32.5107620485119
9.7,"random_policy_SVM","SVM",58,3,2384,2208,176,400,316,84,0.822455571551272,0.267175572519084,1.25446934252647,202,84,118,61,1.4,14.37,3.8,0,0,0,0,0,0,0.243321205069736,248.351492504272,28.5972252371406
9.7,"random_policy_SVM","SVM",58,4,2284,2128,156,500,396,104,0.812535536710168,0.32824427480916,1.2348682590495,252,104,148,50,1.4,17.96,3.8,0,0,0,0,0,0,0.23513187387476,186.684265762235,24.6728316775934
9.7,"random_policy_SVM","SVM",58,5,2184,2066,118,600,458,142,0.809051426912321,0.282442748091603,1.2348682590495,341,142,199,89,1.4,21.55,3.2,0,0,0,0,0,0,0.25587823847251,140.57469127449,26.9615807272114
9.7,"random_policy_SVM","SVM",58,6,2084,1991,93,700,533,167,0.808712694015307,0.290076335877863,1.22506771731101,397,167,230,56,1.4,25.14,3.2,0,0,0,0,0,0,0.235475649376422,110.941012323226,25.7574547262675
9.7,"random_policy_SVM","SVM",58,7,1984,1905,79,800,619,181,0.799518515382096,0.274809160305344,1.25446934252647,437,181,256,40,1.4,28.74,3.4,0,0,0,0,0,0,0.231188628865822,151.818473575072,24.3483645915224
9.7,"random_policy_SVM","SVM",58,8,1884,1813,71,900,711,189,0.802984478774748,0.282442748091603,1.24466880078798,461,189,272,24,1.4,32.33,3.8,0,0,0,0,0,0,0.186479203943449,98.0489983262654,21.3917610393104
9.7,"random_policy_SVM","SVM",58,9,1784,1721,63,1000,803,197,0.804557167225166,0.290076335877863,1.24466880078798,469,197,272,8,1.4,35.92,4.1,0,0,0,0,0,0,0.121007143763659,52.5451514942463,15.5740852550973
9.7,"random_policy_SVM","SVM",58,10,1684,1625,59,1100,899,201,0.807890056979705,0.282442748091603,1.2348682590495,495,201,294,26,1.5,39.51,4.5,0,0,0,0,0,0,0.0998476821886761,52.8007019320722,13.3217441472024
9.7,"random_policy_SVM","SVM",58,11,1584,1533,51,1200,991,209,0.808966743688069,0.251908396946565,1.24466880078798,525,209,316,30,1.5,43.1,4.7,0,0,0,0,0,0,0.133723400900278,42.4397594381059,17.0561666040709
9.7,"random_policy_SVM","SVM",58,12,1484,1446,38,1300,1078,222,0.822207570680241,0.274809160305344,1.25446934252647,554,222,332,29,1.5,46.7,4.9,0,0,0,0,0,0,0.099433386841694,33.445397060895,14.7817822640592
9.7,"random_policy_SVM","SVM",58,13,1384,1358,26,1400,1166,234,0.809789380723674,0.221374045801527,1.25446934252647,605,234,371,51,1.6,50.29,5,0,0,0,0,0,0,0.0860558312277041,26.9305236750837,14.6890579815903
9.7,"random_policy_SVM","SVM",58,14,1284,1263,21,1500,1261,239,0.780706741994404,0.175572519083969,1.2348682590495,613,239,374,8,1.6,53.88,5.3,0,0,0,0,0,0,0.109964590815729,42.4946752822329,20.617448042512
9.7,"random_policy_SVM","SVM",58,15,1184,1163,21,1600,1361,239,0.807339616022059,0.259541984732824,1.24466880078798,620,239,381,7,1.6,57.47,5.7,0,0,0,0,0,0,0.0673504335924368,19.322430294626,8.76703317956198
9.7,"random_policy_SVM","SVM",58,16,1084,1065,19,1700,1459,241,0.785563929785498,0.229007633587786,1.2348682590495,637,241,396,17,1.6,61.06,6.1,0,0,0,0,0,0,0.128473005715454,34.5346570068455,16.4591777462495
9.7,"random_policy_SVM","SVM",58,17,984,966,18,1800,1558,242,0.791860732388902,0.244274809160305,1.2348682590495,649,242,407,12,1.7,64.66,6.4,0,0,0,0,0,0,0.0748520787695182,17.8276517312869,10.1342590445203
9.7,"random_policy_SVM","SVM",58,18,884,866,18,1900,1658,242,0.752852010016806,0.175572519083969,1.2348682590495,642,242,400,-7,1.7,68.25,6.9,0,0,0,0,0,0,0.0387868616010048,8.8369773704257,6.68394532972976
9.7,"random_policy_SVM","SVM",58,19,784,766,18,2000,1758,242,0.751618054463402,0.16793893129771,1.2348682590495,648,242,406,6,1.7,71.84,7.3,0,0,0,0,0,0,0.00349137568544073,1.80889249195904,1.71303070528455
9.7,"random_policy_SVM","SVM",58,20,684,668,16,2100,1856,244,0.777954537206175,0.244274809160305,1.2348682590495,646,244,402,-2,1.6,75.43,7.6,0,0,0,0,0,0,0.00584787521442305,1.95033691329613,1.54526104597411
9.7,"random_policy_SVM","SVM",58,21,584,574,10,2200,1950,250,0.794594790771947,0.190839694656489,1.28268876611418,699,250,449,53,1.8,79.02,7.8,0,0,0,0,0,0,0.129638742624658,42.6742222398116,16.6612053123326
9.7,"random_policy_SVM","SVM",58,22,484,475,9,2300,2049,251,0.753069766879179,0.16030534351145,1.28387096774194,685,251,434,-14,1.7,82.61,8.2,0,0,0,0,0,0,0.0808681949544732,20.5774549857599,9.93050442028277
9.7,"random_policy_SVM","SVM",58,23,384,382,2,2400,2142,258,0.792399075743094,0.190839694656489,1.28268876611418,712,258,454,27,1.8,86.21,8.3,0,0,0,0,0,0,0.0587828540837109,14.0843219464855,9.212248981227
9.7,"random_policy_SVM","SVM",58,24,284,282,2,2500,2242,258,0.781196694934732,0.198473282442748,1.28387096774194,734,258,476,22,1.8,89.8,8.7,0,0,0,0,0,0,0.0280742603594825,6.6069111119661,4.62301718737727
9.7,"random_policy_SVM","SVM",58,25,184,183,1,2600,2341,259,0.707098873713114,0.129770992366412,1.28268876611418,731,259,472,-3,1.8,93.39,9,0,0,0,0,0,0,0.0224588794936107,7.82753450167093,7.28674266660712
9.7,"random_policy_SVM","SVM",58,26,84,84,0,2700,2440,260,0.749017069718488,0.122137404580153,1.28268876611418,734,260,474,3,1.8,96.98,9.4,0,0,0,0,0,0,1.14003527161759e-09,2.79501257621552,2.79501257621552
9.7,"random_policy_SVM","SVM",58,27,0,0,0,2784,2524,260,0.780712790796141,0.206106870229008,1.2728972488156,738,260,478,4,1.8,100,9.7,0,0,0,0,0,0,0,0,0
9.7,"random_policy_SVM","SVM",59,0,2684,2426,258,100,92,8,0.297779179810724,0,0.708696774193548,38,8,30,0,3.8,3.59,11.5,0,0,0,0,0,0,0.125352943111851,225.886476013563,13.3841682326891
9.7,"random_policy_SVM","SVM",59,1,2584,2326,258,200,192,8,0.698182965299687,0.112,1.16061935483871,39,8,31,1,3.9,7.18,24,0,0,0,0,0,0,0.096985209920367,175.480908949459,10.5816531205844
9.7,"random_policy_SVM","SVM",59,2,2484,2235,249,300,283,17,0.693791798107258,0.32,1.08872258064516,51,17,34,12,2,10.78,16.6,0,0,0,0,0,0,0.0785896599830168,146.775076726959,8.416700741173
9.7,"random_policy_SVM","SVM",59,3,2384,2168,216,400,350,50,0.670687697160884,0.072,1.15034838709677,136,50,86,85,1.7,14.37,7,0,0,0,0,0,0,0.167953886638603,277.116077230236,20.5457585334462
9.7,"random_policy_SVM","SVM",59,4,2284,2076,208,500,442,58,0.744593059936909,0.16,1.23251612903226,149,58,91,13,1.6,17.96,7.6,0,0,0,0,0,0,0.125703038444993,256.987629486762,13.0756000824358
9.7,"random_policy_SVM","SVM",59,5,2184,1995,189,600,523,77,0.742353312302843,0.24,1.23251612903226,199,77,122,50,1.6,21.55,6.8,0,0,0,0,0,0,0.160930517164531,193.230796841929,17.2333063025185
9.7,"random_policy_SVM","SVM",59,6,2084,1921,163,700,597,103,0.772548895899062,0.208,1.25305806451613,260,103,157,61,1.5,25.14,5.8,0,0,0,0,0,0,0.169415949967531,171.888484491153,18.8811601097529
9.7,"random_policy_SVM","SVM",59,7,1984,1844,140,800,674,126,0.779129337539432,0.216,1.26332903225806,327,126,201,67,1.6,28.74,5.3,0,0,0,0,0,0,0.178164396025231,160.723059050882,19.2922428822788
9.7,"random_policy_SVM","SVM",59,8,1884,1761,123,900,757,143,0.789678233438486,0.224,1.26332903225806,367,143,224,40,1.6,32.33,5.3,0,0,0,0,0,0,0.170825416727307,161.161382734429,17.9886656324863
9.7,"random_policy_SVM","SVM",59,9,1784,1682,102,1000,836,164,0.782921135646689,0.232,1.26332903225806,417,164,253,50,1.5,35.92,5.1,0,0,0,0,0,0,0.157553770456773,128.681919770607,16.7055513993909
9.7,"random_policy_SVM","SVM",59,10,1684,1598,86,1100,920,180,0.795892744479503,0.256,1.25305806451613,449,180,269,32,1.5,39.51,5.1,0,0,0,0,0,0,0.15889161701752,139.078764925473,16.6349890474555
9.7,"random_policy_SVM","SVM",59,11,1584,1514,70,1200,1004,196,0.820668769716098,0.264,1.25305806451613,501,196,305,52,1.6,43.1,5.1,0,0,0,0,0,0,0.167650971501352,112.054096592781,18.3033514597013
9.7,"random_policy_SVM","SVM",59,12,1484,1424,60,1300,1094,206,0.804536277602532,0.2,1.25305806451613,530,206,324,29,1.6,46.7,5.3,0,0,0,0,0,0,0.147595139517375,87.0766142289516,15.950944163425
9.7,"random_policy_SVM","SVM",59,13,1384,1341,43,1400,1177,223,0.806574132492124,0.208,1.25305806451613,562,223,339,32,1.5,50.29,5.3,0,0,0,0,0,0,0.14807552780346,102.144247871924,18.0763439598962
9.7,"random_policy_SVM","SVM",59,14,1284,1253,31,1500,1265,235,0.826359621451115,0.24,1.25305806451613,600,235,365,38,1.6,53.88,5.4,0,0,0,0,0,0,0.143898834021452,100.639887804917,15.4637527877848
9.7,"random_policy_SVM","SVM",59,15,1184,1160,24,1600,1358,242,0.800529968454267,0.2,1.25305806451613,639,242,397,39,1.6,57.47,5.6,0,0,0,0,0,0,0.134914643523866,81.3860066994544,15.4249025108311
9.7,"random_policy_SVM","SVM",59,16,1084,1063,21,1700,1455,245,0.780542586750796,0.16,1.24278709677419,631,245,386,-8,1.6,61.06,5.9,0,0,0,0,0,0,0.127662426562697,80.1483011527641,13.9502040813855
9.7,"random_policy_SVM","SVM",59,17,984,965,19,1800,1553,247,0.797936908517356,0.208,1.24278709677419,659,247,412,28,1.7,64.66,6.3,0,0,0,0,0,0,0.105406912078315,52.9017543725321,11.6623102653441
9.7,"random_policy_SVM","SVM",59,18,884,865,19,1900,1653,247,0.788145110410104,0.224,1.25305806451613,662,247,415,3,1.7,68.25,6.7,0,0,0,0,0,0,0.0781275245537125,34.3260996796801,9.22037805027162
9.7,"random_policy_SVM","SVM",59,19,784,767,17,2000,1751,249,0.793337539432182,0.2,1.24278709677419,666,249,417,4,1.7,71.84,7,0,0,0,0,0,0,0.0795578126506182,36.1373183212784,9.23950657940507
9.7,"random_policy_SVM","SVM",59,20,684,668,16,2100,1850,250,0.78870031545742,0.192,1.24278709677419,671,250,421,5,1.7,75.43,7.4,0,0,0,0,0,0,0.0374180684986601,11.7032701678188,4.7309682003106
9.7,"random_policy_SVM","SVM",59,21,584,571,13,2200,1947,253,0.793242902208209,0.208,1.25305806451613,689,253,436,18,1.7,79.02,7.7,0,0,0,0,0,0,0.0532700145179673,19.3180785663809,7.09962358765528
9.7,"random_policy_SVM","SVM",59,22,484,472,12,2300,2046,254,0.838227129337545,0.256,1.26332903225806,687,254,433,-2,1.7,82.61,8.1,0,0,0,0,0,0,0.0080988643680324,2.20642000236595,1.4561054998765
9.7,"random_policy_SVM","SVM",59,23,384,376,8,2400,2142,258,0.809621451104109,0.232,1.26332903225806,682,258,424,-5,1.6,86.21,8.3,0,0,0,0,0,0,0.0219324563762599,5.97677819057437,3.3984312529659
9.7,"random_policy_SVM","SVM",59,24,284,282,2,2500,2236,264,0.761917981072563,0.168,1.2736,719,264,455,37,1.7,89.8,8.5,0,0,0,0,0,0,0.0125014848019048,3.1249155636518,2.59773174154939
9.7,"random_policy_SVM","SVM",59,25,184,184,0,2600,2334,266,0.745993690851738,0.176,1.2736,739,266,473,20,1.8,93.39,8.8,0,0,0,0,0,0,0.00389928108774833,1.34937428137411,1.28265364667032
9.7,"random_policy_SVM","SVM",59,26,84,84,0,2700,2434,266,0.759640378548901,0.168,1.2736,741,266,475,2,1.8,96.98,9.2,0,0,0,0,0,0,2.67573713573617e-08,0.287352449616478,0.287352449616478
9.7,"random_policy_SVM","SVM",59,27,0,0,0,2784,2518,266,0.818138801261838,0.232,1.2736,732,266,466,-9,1.8,100,9.5,0,0,0,0,0,0,0,0,0
9.7,"random_policy_SVM","SVM",60,0,2684,2437,247,100,91,9,0.818141671082847,0.288888888888889,1.28387096774194,29,9,20,0,2.2,3.59,10.1,0,0,0,0,0,0,0.152747984904713,254.340124493772,16.9268705776358
9.7,"random_policy_SVM","SVM",60,1,2584,2361,223,200,167,33,0.805122769828653,0.192592592592593,1.28387096774194,82,33,49,53,1.5,7.18,5.1,0,0,0,0,0,0,0.265761456632019,278.35852238013,31.4158374541497
9.7,"random_policy_SVM","SVM",60,2,2484,2274,210,300,254,46,0.822981805334745,0.259259259259259,1.28387096774194,122,46,76,40,1.7,10.78,5.5,0,0,0,0,0,0,0.19989563981997,201.845967199853,21.0543524127075
9.7,"random_policy_SVM","SVM",60,3,2384,2207,177,400,321,79,0.828404875463703,0.318518518518519,1.27436081242533,188,79,109,66,1.4,14.37,4.1,0,0,0,0,0,0,0.228253166326797,218.665146527523,24.2278484308442
9.7,"random_policy_SVM","SVM",60,4,2284,2139,145,500,389,111,0.831772949420015,0.259259259259259,1.27436081242533,275,111,164,87,1.5,17.96,3.5,0,0,0,0,0,0,0.245012758426618,189.633135048834,25.0613601714861
9.7,"random_policy_SVM","SVM",60,5,2184,2059,125,600,469,131,0.842448330683633,0.311111111111111,1.27436081242533,326,131,195,51,1.5,21.55,3.6,0,0,0,0,0,0,0.234420003013648,164.099958378964,23.9722577492235
9.7,"random_policy_SVM","SVM",60,6,2084,1982,102,700,546,154,0.842854619325218,0.281481481481481,1.27436081242533,373,154,219,47,1.4,25.14,3.5,0,0,0,0,0,0,0.223664824851752,136.379349324716,23.2987700386361
9.7,"random_policy_SVM","SVM",60,7,1984,1907,77,800,621,179,0.844550432785737,0.296296296296296,1.27436081242533,461,179,282,88,1.6,28.74,3.5,0,0,0,0,0,0,0.204573309686864,105.298043122077,22.0297043914396
9.7,"random_policy_SVM","SVM",60,8,1884,1825,59,900,703,197,0.851416122004367,0.325925925925926,1.26485065710872,496,197,299,35,1.5,32.33,3.6,0,0,0,0,0,0,0.196366327238787,110.493807341213,21.0107269614443
9.7,"random_policy_SVM","SVM",60,9,1784,1740,44,1000,788,212,0.82097391509157,0.244444444444444,1.25534050179211,552,212,340,56,1.6,35.92,3.7,0,0,0,0,0,0,0.195329816712222,164.977977086035,22.0004026389111
9.7,"random_policy_SVM","SVM",60,10,1684,1646,38,1100,882,218,0.82951186480599,0.266666666666667,1.25534050179211,561,218,343,9,1.6,39.51,4,0,0,0,0,0,0,0.14982721481869,61.3924060354983,26.8438427062373
9.7,"random_policy_SVM","SVM",60,11,1584,1554,30,1200,974,226,0.838108696932233,0.281481481481481,1.26485065710872,615,226,389,54,1.7,43.1,4.3,0,0,0,0,0,0,0.177704425051517,126.864465466047,18.9937348079543
9.7,"random_policy_SVM","SVM",60,12,1484,1465,19,1300,1063,237,0.833056585997772,0.274074074074074,1.25534050179211,628,237,391,13,1.6,46.7,4.5,0,0,0,0,0,0,0.10542792166759,39.9439392633072,13.7074568630251
9.7,"random_policy_SVM","SVM",60,13,1384,1368,16,1400,1160,240,0.81480303833246,0.22962962962963,1.25534050179211,642,240,402,14,1.7,50.29,4.8,0,0,0,0,0,0,0.134992864283193,94.5285048119379,15.0523448846771
9.7,"random_policy_SVM","SVM",60,14,1284,1271,13,1500,1257,243,0.813931578637466,0.274074074074074,1.26485065710872,651,243,408,9,1.7,53.88,5.2,0,0,0,0,0,0,0.109757072688346,70.6427319128817,15.9948840832616
9.7,"random_policy_SVM","SVM",60,15,1184,1175,9,1600,1353,247,0.836984042866404,0.288888888888889,1.26485065710872,692,247,445,41,1.8,57.47,5.5,0,0,0,0,0,0,0.120786519399723,78.4077508158411,14.8692027592705
9.7,"random_policy_SVM","SVM",60,16,1084,1076,8,1700,1452,248,0.82632632632633,0.251851851851852,1.26485065710872,703,248,455,11,1.8,61.06,5.9,0,0,0,0,0,0,0.0514551519381632,17.5932954276857,8.95688688652995
9.7,"random_policy_SVM","SVM",60,17,984,978,6,1800,1550,250,0.820832597303198,0.244444444444444,1.27436081242533,700,250,450,-3,1.8,64.66,6.2,0,0,0,0,0,0,0.124141402654035,58.2172977672547,14.8182098768923
9.7,"random_policy_SVM","SVM",60,18,884,881,3,1900,1647,253,0.819319319319331,0.274074074074074,1.27436081242533,704,253,451,4,1.8,68.25,6.5,0,0,0,0,0,0,0.075553554569903,31.3864842947989,10.5461236829133
9.7,"random_policy_SVM","SVM",60,19,784,781,3,2000,1747,253,0.810104221868938,0.244444444444444,1.27436081242533,696,253,443,-8,1.8,71.84,6.9,0,0,0,0,0,0,0.0576610399089015,18.9234460118817,7.18938062616991
9.7,"random_policy_SVM","SVM",60,20,684,683,1,2100,1845,255,0.7796090207855,0.2,1.27318736784667,727,255,472,31,1.9,75.43,7.2,0,0,0,0,0,0,0.0603392945868689,20.1380399066943,7.30461638379366
9.7,"random_policy_SVM","SVM",60,21,584,583,1,2200,1945,255,0.807466289819239,0.2,1.27436081242533,730,255,475,3,1.9,79.02,7.6,0,0,0,0,0,0,0.0372359121597639,11.2179818508873,5.15113170292057
9.7,"random_policy_SVM","SVM",60,22,484,484,0,2300,2044,256,0.781552140375679,0.207407407407407,1.27436081242533,728,256,472,-2,1.8,82.61,8,0,0,0,0,0,0,0.0312261928495802,8.36866501486404,4.12958849553605
9.7,"random_policy_SVM","SVM",60,23,384,384,0,2400,2144,256,0.826962256374028,0.244444444444444,1.27436081242533,719,256,463,-9,1.8,86.21,8.4,0,0,0,0,0,0,0.0033396335071765,0.949585294804598,0.739612604928882
9.7,"random_policy_SVM","SVM",60,24,284,284,0,2500,2244,256,0.819325207560509,0.274074074074074,1.27436081242533,722,256,466,3,1.8,89.8,8.8,0,0,0,0,0,0,0.00041127117567976,0.201105857545354,0.187349142667995
9.7,"random_policy_SVM","SVM",60,25,184,184,0,2600,2344,256,0.811535064476246,0.244444444444444,1.27436081242533,719,256,463,-3,1.8,93.39,9.2,0,0,0,0,0,0,0.000527570454071855,0.299396129842754,0.284419234130841
9.7,"random_policy_SVM","SVM",60,26,84,84,0,2700,2444,256,0.791803568274165,0.2,1.27436081242533,705,256,449,-14,1.8,96.98,9.5,0,0,0,0,0,0,1.0000000994736e-07,0.00382355752182599,0.00382355752182599
9.7,"random_policy_SVM","SVM",60,27,0,0,0,2784,2528,256,0.799252193369849,0.214814814814815,1.27436081242533,705,256,449,0,1.8,100,9.9,0,0,0,0,0,0,0,0,0
9.7,"random_policy_SVM","SVM",61,0,2684,2420,264,100,91,9,0.787411100033237,0.254237288135593,1.27299070530344,31,9,22,0,2.4,3.59,10.1,0,0,0,0,0,0,0.0921401997378673,246.140572584944,9.22668708265654
9.7,"random_policy_SVM","SVM",61,1,2584,2343,241,200,168,32,0.808142239946832,0.313559322033898,1.26211044286495,84,32,52,53,1.6,7.18,5.2,0,0,0,0,0,0,0.184018919137841,330.552037190667,19.3445970685058
9.7,"random_policy_SVM","SVM",61,2,2484,2276,208,300,235,65,0.803462944499837,0.152542372881356,1.28387096774194,164,65,99,80,1.5,10.78,3.6,0,0,0,0,0,0,0.237189654633054,355.908398864886,24.6928806679971
9.7,"random_policy_SVM","SVM",61,3,2384,2189,195,400,322,78,0.79603855101363,0.296610169491525,1.24034991798797,200,78,122,36,1.6,14.37,4.1,0,0,0,0,0,0,0.201771759026777,284.187416056214,21.6841894511517
9.7,"random_policy_SVM","SVM",61,4,2284,2115,169,500,396,104,0.824134263875047,0.338983050847458,1.26211044286495,257,104,153,57,1.5,17.96,3.8,0,0,0,0,0,0,0.196601673101267,186.342486013597,20.7755088571627
9.7,"random_policy_SVM","SVM",61,5,2184,2049,135,600,462,138,0.833885011631778,0.305084745762712,1.26211044286495,334,138,196,77,1.4,21.55,3.3,0,0,0,0,0,0,0.225998526278964,368.971590241823,23.2322587473554
9.7,"random_policy_SVM","SVM",61,6,2084,1978,106,700,533,167,0.832017281488873,0.296610169491525,1.26211044286495,406,167,239,72,1.4,25.14,3.2,0,0,0,0,0,0,0.22217049478445,215.523392473846,23.3097723957864
9.7,"random_policy_SVM","SVM",61,7,1984,1897,87,800,614,186,0.831272848122306,0.271186440677966,1.26211044286495,456,186,270,50,1.5,28.74,3.3,0,0,0,0,0,0,0.220623234855659,267.51705401681,22.791243719319
9.7,"random_policy_SVM","SVM",61,8,1884,1818,66,900,693,207,0.823243602525764,0.26271186440678,1.25123018042646,504,207,297,48,1.4,32.33,3.3,0,0,0,0,0,0,0.21580840706542,195.91318489168,22.8997996085044
9.7,"random_policy_SVM","SVM",61,9,1784,1727,57,1000,784,216,0.824539714190767,0.26271186440678,1.26211044286495,540,216,324,36,1.5,35.92,3.6,0,0,0,0,0,0,0.197130724608074,176.846223172261,21.7748447400621
9.7,"random_policy_SVM","SVM",61,10,1684,1647,37,1100,864,236,0.834204054503163,0.279661016949153,1.26211044286495,594,236,358,54,1.5,39.51,3.7,0,0,0,0,0,0,0.191610804680842,151.753451651472,20.5232542812155
9.7,"random_policy_SVM","SVM",61,11,1584,1556,28,1200,955,245,0.831385842472588,0.288135593220339,1.26211044286495,617,245,372,23,1.5,43.1,3.9,0,0,0,0,0,0,0.180859711532715,146.330379747904,19.0946486228742
9.7,"random_policy_SVM","SVM",61,12,1484,1456,28,1300,1055,245,0.833300099700903,0.26271186440678,1.26211044286495,621,245,376,4,1.5,46.7,4.3,0,0,0,0,0,0,0.143347704943193,101.329104810469,15.5933008735841
9.7,"random_policy_SVM","SVM",61,13,1384,1359,25,1400,1152,248,0.835945496842811,0.305084745762712,1.26211044286495,628,248,380,7,1.5,50.29,4.6,0,0,0,0,0,0,0.153304784756662,134.933574472889,16.2272958291151
9.7,"random_policy_SVM","SVM",61,14,1284,1260,24,1500,1251,249,0.833140578265211,0.305084745762712,1.26211044286495,636,249,387,8,1.6,53.88,5,0,0,0,0,0,0,0.112192078457317,62.6599812938042,12.7103030664521
9.7,"random_policy_SVM","SVM",61,15,1184,1165,19,1600,1346,254,0.826666666666672,0.279661016949153,1.26211044286495,659,254,405,23,1.6,57.47,5.3,0,0,0,0,0,0,0.138556338906689,110.505404017688,14.9995276291373
9.7,"random_policy_SVM","SVM",61,16,1084,1068,16,1700,1443,257,0.843914921900968,0.305084745762712,1.26211044286495,683,257,426,24,1.7,61.06,5.6,0,0,0,0,0,0,0.0574211555412963,23.4763953159756,9.02558564536529
9.7,"random_policy_SVM","SVM",61,17,984,968,16,1800,1543,257,0.847238285144571,0.313559322033898,1.26211044286495,665,257,408,-18,1.6,64.66,6,0,0,0,0,0,0,0.0756303283412951,42.071990557571,8.72281376364773
9.7,"random_policy_SVM","SVM",61,18,884,868,16,1900,1643,257,0.850608175473583,0.305084745762712,1.26211044286495,676,257,419,11,1.6,68.25,6.4,0,0,0,0,0,0,0.0580087464942423,26.1470265406828,6.54548520589063
9.7,"random_policy_SVM","SVM",61,19,784,770,14,2000,1741,259,0.835659687603858,0.245762711864407,1.27299070530344,690,259,431,14,1.7,71.84,6.7,0,0,0,0,0,0,0.0856691473406298,46.1187813722252,9.36763450519333
9.7,"random_policy_SVM","SVM",61,20,684,674,10,2100,1837,263,0.833200398803592,0.26271186440678,1.27299070530344,712,263,449,22,1.7,75.43,7,0,0,0,0,0,0,0.0526760075815638,16.1547813129865,7.88820284411554
9.7,"random_policy_SVM","SVM",61,21,584,580,4,2200,1931,269,0.830727816550351,0.26271186440678,1.27299070530344,724,269,455,12,1.7,79.02,7.2,0,0,0,0,0,0,0.0659737031531443,24.5829130454319,9.17989907486163
9.7,"random_policy_SVM","SVM",61,22,484,482,2,2300,2029,271,0.825888999667665,0.211864406779661,1.27299070530344,734,271,463,10,1.7,82.61,7.5,0,0,0,0,0,0,0.0284719486429544,8.08793165298235,4.35011696815944
9.7,"random_policy_SVM","SVM",61,23,384,382,2,2400,2129,271,0.826114988368231,0.254237288135593,1.27299070530344,725,271,454,-9,1.7,86.21,7.9,0,0,0,0,0,0,0.0194356241151242,5.22710813587507,2.98899095944787
9.7,"random_policy_SVM","SVM",61,24,284,282,2,2500,2229,271,0.829125955466935,0.23728813559322,1.27299070530344,750,271,479,25,1.8,89.8,8.2,0,0,0,0,0,0,0.0137607389585654,3.57844568403811,2.18638283750748
9.7,"random_policy_SVM","SVM",61,25,184,183,1,2600,2328,272,0.829577932868064,0.23728813559322,1.27299070530344,748,272,476,-2,1.8,93.39,8.6,0,0,0,0,0,0,0.000182888734936426,0.207291150358706,0.200431093141409
9.7,"random_policy_SVM","SVM",61,26,84,84,0,2700,2427,273,0.829750747756732,0.288135593220339,1.27299070530344,745,273,472,-3,1.7,96.98,8.9,0,0,0,0,0,0,4.56939117547445e-05,1.13250370366918,1.13250370366918
9.7,"random_policy_SVM","SVM",61,27,0,0,0,2784,2511,273,0.811950814223997,0.254237288135593,1.27299070530344,764,273,491,19,1.8,100,9.2,0,0,0,0,0,0,0,0,0
9.7,"random_policy_SVM","SVM",62,0,2684,2437,247,100,88,12,0.809722923124976,0.265151515151515,1.27414467253177,31,12,19,0,1.6,3.59,7.3,0,0,0,0,0,0,0.159328260749906,310.770574882515,17.8558029650458
9.7,"random_policy_SVM","SVM",62,1,2584,2368,216,200,157,43,0.780729579698654,0.234848484848485,1.25469208211144,104,43,61,73,1.4,7.18,3.7,0,0,0,0,0,0,0.220130096240689,505.100256526632,22.4584827719074
9.7,"random_policy_SVM","SVM",62,2,2484,2283,201,300,242,58,0.758663158147691,0.128787878787879,1.22551319648094,146,58,88,42,1.5,10.78,4.2,0,0,0,0,0,0,0.218398882653104,357.731285085329,28.2306498270457
9.7,"random_policy_SVM","SVM",62,3,2384,2191,193,400,334,66,0.805811885708786,0.272727272727273,1.25469208211144,170,66,104,24,1.6,14.37,5.1,0,0,0,0,0,0,0.178845569342121,240.920532757336,18.2312869416944
9.7,"random_policy_SVM","SVM",62,4,2284,2129,155,500,396,104,0.809086102900528,0.303030303030303,1.25469208211144,263,104,159,93,1.5,17.96,3.8,0,0,0,0,0,0,0.21973294089086,259.572312445269,22.276310646115
9.7,"random_policy_SVM","SVM",62,5,2184,2059,125,600,466,134,0.808515367793709,0.303030303030303,1.25469208211144,325,134,191,62,1.4,21.55,3.5,0,0,0,0,0,0,0.229982782749901,188.956798694433,23.4802599406682
9.7,"random_policy_SVM","SVM",62,6,2084,1995,89,700,530,170,0.80526518155383,0.272727272727273,1.24496578690127,397,170,227,72,1.3,25.14,3.1,0,0,0,0,0,0,0.255563118370184,218.240059645688,26.3462923131578
9.7,"random_policy_SVM","SVM",62,7,1984,1912,72,800,613,187,0.799683992982952,0.25,1.22551319648094,438,187,251,41,1.3,28.74,3.3,0,0,0,0,0,0,0.233246125189141,207.092134118931,24.062618544553
9.7,"random_policy_SVM","SVM",62,8,1884,1823,61,900,702,198,0.798530507293385,0.257575757575758,1.22551319648094,476,198,278,38,1.4,32.33,3.5,0,0,0,0,0,0,0.202844549615132,167.492484512494,21.5757009849231
9.7,"random_policy_SVM","SVM",62,9,1784,1730,54,1000,795,205,0.79854252276932,0.21969696969697,1.22551319648094,496,205,291,20,1.4,35.92,3.9,0,0,0,0,0,0,0.138805092032767,66.3455705029488,16.065957181504
9.7,"random_policy_SVM","SVM",62,10,1684,1637,47,1100,888,212,0.79990027154975,0.212121212121212,1.22551319648094,507,212,295,11,1.4,39.51,4.2,0,0,0,0,0,0,0.14090662564876,91.2992773507969,15.9129145252762
9.7,"random_policy_SVM","SVM",62,11,1584,1551,33,1200,974,226,0.799377598346663,0.212121212121212,1.22551319648094,557,226,331,50,1.5,43.1,4.3,0,0,0,0,0,0,0.114229187461019,47.4252885494775,15.1286485230541
9.7,"random_policy_SVM","SVM",62,12,1484,1461,23,1300,1064,236,0.807109557109551,0.242424242424242,1.22551319648094,584,236,348,27,1.5,46.7,4.5,0,0,0,0,0,0,0.0616915098966227,21.5489382819322,10.4562648523384
9.7,"random_policy_SVM","SVM",62,13,1384,1361,23,1400,1164,236,0.799744070362621,0.234848484848485,1.22551319648094,587,236,351,3,1.5,50.29,4.9,0,0,0,0,0,0,0.0367144757053842,12.9808609890641,5.01613549706475
9.7,"random_policy_SVM","SVM",62,14,1284,1262,22,1500,1263,237,0.805920024992178,0.242424242424242,1.2352394916911,588,237,351,1,1.5,53.88,5.3,0,0,0,0,0,0,0.0155577981547157,4.98182912828064,2.56442276199254
9.7,"random_policy_SVM","SVM",62,15,1184,1168,16,1600,1357,243,0.797407060293655,0.189393939393939,1.2644183773216,616,243,373,28,1.5,57.47,5.6,0,0,0,0,0,0,0.0722956597268916,27.7050471290657,11.9461632227593
9.7,"random_policy_SVM","SVM",62,16,1084,1069,15,1700,1456,244,0.797959772186573,0.257575757575758,1.2644183773216,626,244,382,10,1.6,61.06,6,0,0,0,0,0,0,0.042902151986926,14.3981498927443,6.4002494602149
9.7,"random_policy_SVM","SVM",62,17,984,970,14,1800,1555,245,0.793898541321216,0.234848484848485,1.2352394916911,636,245,391,10,1.6,64.66,6.3,0,0,0,0,0,0,0.0687406031000369,21.5189386131351,10.0938716445516
9.7,"random_policy_SVM","SVM",62,18,884,870,14,1900,1655,245,0.793201643717104,0.204545454545455,1.2352394916911,652,245,407,16,1.7,68.25,6.8,0,0,0,0,0,0,0.0396389868156488,13.851057595106,5.44970282752921
9.7,"random_policy_SVM","SVM",62,19,784,771,13,2000,1754,246,0.780609424939322,0.151515151515152,1.2644183773216,636,246,390,-16,1.6,71.84,7.1,0,0,0,0,0,0,0.0167847258490576,5.49978614192122,2.65221184017993
9.7,"random_policy_SVM","SVM",62,20,684,678,6,2100,1847,253,0.799539807271768,0.204545454545455,1.28387096774194,677,253,424,41,1.7,75.43,7.3,0,0,0,0,0,0,0.0379693287640247,13.323574619352,9.46612060504262
9.7,"random_policy_SVM","SVM",62,21,584,581,3,2200,1944,256,0.808299089226926,0.242424242424242,1.28387096774194,680,256,424,3,1.7,79.02,7.6,0,0,0,0,0,0,0.0222304043645447,7.56132305147981,4.91570661138255
9.7,"random_policy_SVM","SVM",62,22,484,482,2,2300,2043,257,0.80535529762334,0.227272727272727,1.28387096774194,686,257,429,6,1.7,82.61,7.9,0,0,0,0,0,0,0.00448654665905164,1.43971232001247,1.01316169413773
9.7,"random_policy_SVM","SVM",62,23,384,383,1,2400,2142,258,0.770143945401677,0.181818181818182,1.28387096774194,712,258,454,26,1.8,86.21,8.3,0,0,0,0,0,0,0.0925601027426592,21.3030618839519,13.5006958011533
9.7,"random_policy_SVM","SVM",62,24,284,284,0,2500,2241,259,0.797959772186579,0.212121212121212,1.28387096774194,705,259,446,-7,1.7,89.8,8.7,0,0,0,0,0,0,0.00690805146335597,4.38381841661877,4.02164867408478
9.7,"random_policy_SVM","SVM",62,25,184,184,0,2600,2341,259,0.774000913176172,0.174242424242424,1.28387096774194,713,259,454,8,1.8,93.39,9,0,0,0,0,0,0,0.00382742954141688,1.83617575298799,1.73373663904747
9.7,"random_policy_SVM","SVM",62,26,84,84,0,2700,2441,259,0.77553288635763,0.174242424242424,1.28387096774194,702,259,443,-11,1.7,96.98,9.4,0,0,0,0,0,0,0.000131131528627319,0.241357032572303,0.241357032572303
9.7,"random_policy_SVM","SVM",62,27,0,0,0,2784,2525,259,0.815832792636913,0.287878787878788,1.27414467253177,705,259,446,3,1.7,100,9.7,0,0,0,0,0,0,0,0,0
9.7,"random_policy_SVM","SVM",63,0,2684,2440,244,100,90,10,0.784125249895392,0.197080291970803,1.27449964680951,29,10,19,0,1.9,3.59,9,0,0,0,0,0,0,0.148661039876177,261.450411279427,16.9584806385719
9.7,"random_policy_SVM","SVM",63,1,2584,2354,230,200,176,24,0.779603886745086,0.204379562043796,1.27449964680951,69,24,45,40,1.9,7.18,7.3,0,0,0,0,0,0,0.212743854043464,247.580828622284,33.642924280684
9.7,"random_policy_SVM","SVM",63,2,2484,2261,223,300,269,31,0.731600725277793,0.233576642335766,1.19015775841771,98,31,67,29,2.2,10.78,8.7,0,0,0,0,0,0,0.121696887069532,226.184533811964,12.8111530221722
9.7,"random_policy_SVM","SVM",63,3,2384,2180,204,400,350,50,0.709400715979357,0.27007299270073,1.14330115375559,135,50,85,37,1.7,14.37,7,0,0,0,0,0,0,0.148856284559606,238.996806525899,17.1140476140092
9.7,"random_policy_SVM","SVM",63,4,2284,2103,181,500,427,73,0.715467943651498,0.277372262773723,1.17141511655286,180,73,107,45,1.5,17.96,5.8,0,0,0,0,0,0,0.156667121820691,233.939607371817,16.5624223765193
9.7,"random_policy_SVM","SVM",63,5,2184,2016,168,600,514,86,0.730688316518665,0.262773722627737,1.19015775841771,220,86,134,40,1.6,21.55,6,0,0,0,0,0,0,0.145280040395795,155.831825406862,15.3470938663452
9.7,"random_policy_SVM","SVM",63,6,2084,1941,143,700,589,111,0.75342879724766,0.277372262773723,1.20890040028255,291,111,180,71,1.6,25.14,5.3,0,0,0,0,0,0,0.156606964700511,189.50237481444,16.1521586524434
9.7,"random_policy_SVM","SVM",63,7,1984,1857,127,800,673,127,0.764220791296667,0.306569343065693,1.19952907935013,326,127,199,35,1.6,28.74,5.3,0,0,0,0,0,0,0.159177949865417,163.300014332216,16.4583226795004
9.7,"random_policy_SVM","SVM",63,8,1884,1781,103,900,749,151,0.779301687665634,0.306569343065693,1.19015775841771,383,151,232,57,1.5,32.33,5,0,0,0,0,0,0,0.165508171712066,151.226754269367,17.8331068049403
9.7,"random_policy_SVM","SVM",63,9,1784,1715,69,1000,815,185,0.782771165558612,0.321167883211679,1.19015775841771,466,185,281,83,1.5,35.92,4.4,0,0,0,0,0,0,0.173090724483296,164.689674646216,18.3893545950778
9.7,"random_policy_SVM","SVM",63,10,1684,1626,58,1100,904,196,0.791773211213921,0.321167883211679,1.19952907935013,490,196,294,24,1.5,39.51,4.6,0,0,0,0,0,0,0.148607059453844,122.055367663181,15.8625082247941
9.7,"random_policy_SVM","SVM",63,11,1584,1537,47,1200,993,207,0.801931749500221,0.335766423357664,1.19015775841771,532,207,325,42,1.6,43.1,4.8,0,0,0,0,0,0,0.146930977596529,98.5331520378772,16.3527415431882
9.7,"random_policy_SVM","SVM",63,12,1484,1446,38,1300,1084,216,0.80500023246084,0.306569343065693,1.19015775841771,555,216,339,23,1.6,46.7,5,0,0,0,0,0,0,0.142872535460511,105.350438820167,15.6008483515156
9.7,"random_policy_SVM","SVM",63,13,1384,1356,28,1400,1174,226,0.803431121855978,0.321167883211679,1.19015775841771,579,226,353,24,1.6,50.29,5.2,0,0,0,0,0,0,0.128301689469292,78.7464876201053,14.2503715682861
9.7,"random_policy_SVM","SVM",63,14,1284,1262,22,1500,1268,232,0.785659491375715,0.262773722627737,1.19015775841771,606,232,374,27,1.6,53.88,5.5,0,0,0,0,0,0,0.119691517240462,65.9821029609081,14.0860803889869
9.7,"random_policy_SVM","SVM",63,15,1184,1162,22,1600,1368,232,0.798700543958357,0.328467153284672,1.19015775841771,604,232,372,-2,1.6,57.47,5.9,0,0,0,0,0,0,0.0901921103835632,42.803090707348,10.214563909301
9.7,"random_policy_SVM","SVM",63,16,1084,1063,21,1700,1467,233,0.785903575247581,0.27007299270073,1.19015775841771,627,233,394,23,1.7,61.06,6.3,0,0,0,0,0,0,0.103495047429143,48.655174633686,13.6893363265009
9.7,"random_policy_SVM","SVM",63,17,984,963,21,1800,1567,233,0.794597610302676,0.284671532846715,1.19015775841771,615,233,382,-12,1.6,64.66,6.7,0,0,0,0,0,0,0.0824073808496881,35.9190030264957,9.36743438046396
9.7,"random_policy_SVM","SVM",63,18,884,863,21,1900,1667,233,0.7954112232089,0.291970802919708,1.19015775841771,604,233,371,-11,1.6,68.25,7.2,0,0,0,0,0,0,0.0458810751403516,14.7404894207072,5.9478651759697
9.7,"random_policy_SVM","SVM",63,19,784,763,21,2000,1767,233,0.787100748523885,0.299270072992701,1.19015775841771,611,233,378,7,1.6,71.84,7.6,0,0,0,0,0,0,0.0273754483261579,8.05044146590146,3.82554594221522
9.7,"random_policy_SVM","SVM",63,20,684,665,19,2100,1865,235,0.790947975266173,0.27007299270073,1.19952907935013,631,235,396,20,1.7,75.43,7.9,0,0,0,0,0,0,0.0187856382985667,5.57850682931843,3.00344611085274
9.7,"random_policy_SVM","SVM",63,21,584,565,19,2200,1965,235,0.798148449486267,0.277372262773723,1.19015775841771,622,235,387,-9,1.6,79.02,8.4,0,0,0,0,0,0,0.0250398684870028,7.954000713182,3.47307934221381
9.7,"random_policy_SVM","SVM",63,22,484,467,17,2300,2063,237,0.787554047143063,0.211678832116788,1.20890040028255,640,237,403,18,1.7,82.61,8.7,0,0,0,0,0,0,0.00380756952318011,1.66968161692945,1.26595988272584
9.7,"random_policy_SVM","SVM",63,23,384,373,11,2400,2157,243,0.753062671439864,0.218978102189781,1.19952907935013,635,243,392,-5,1.6,86.21,8.9,0,0,0,0,0,0,0.053948986411419,15.1388948833809,12.8626581276205
9.7,"random_policy_SVM","SVM",63,24,284,273,11,2500,2257,243,0.787269282625883,0.284671532846715,1.19952907935013,668,243,425,33,1.7,89.8,9.3,0,0,0,0,0,0,0.0143628332699444,4.18044388678455,3.32215385213926
9.7,"random_policy_SVM","SVM",63,25,184,173,11,2600,2357,243,0.789314937932962,0.313868613138686,1.19952907935013,654,243,411,-14,1.7,93.39,9.7,0,0,0,0,0,0,0.000837957163391288,0.445402545079255,0.422698969175179
9.7,"random_policy_SVM","SVM",63,26,84,78,6,2700,2452,248,0.795556511227861,0.306569343065693,1.20890040028255,663,248,415,9,1.7,96.98,9.9,0,0,0,0,0,0,9.67632899309113e-06,1.30713317911993,1.30713317911993
9.7,"random_policy_SVM","SVM",63,27,0,0,0,2784,2530,254,0.824579245897066,0.328467153284672,1.27449964680951,702,254,448,39,1.8,100,10,0,0,0,0,0,0,0,0,0
9.7,"random_policy_SVM","SVM",64,0,2684,2432,252,100,87,13,0.702390348404555,0.0873015873015873,1.26349206349206,41,13,28,0,2.2,3.59,6.7,0,0,0,0,0,0,0.136793573205549,352.852810366913,13.8177979763039
9.7,"random_policy_SVM","SVM",64,1,2584,2337,247,200,182,18,0.574911364177343,0.222222222222222,1.00875576036866,58,18,40,17,2.2,7.18,10.1,0,0,0,0,0,0,0.120832198068985,248.615331862613,14.3990169807679
9.7,"random_policy_SVM","SVM",64,2,2484,2261,223,300,258,42,0.710113879806061,0.214285714285714,1.23292370711726,113,42,71,55,1.7,10.78,6.1,0,0,0,0,0,0,0.177920073195632,293.591754388592,20.0759859077049
9.7,"random_policy_SVM","SVM",64,3,2384,2178,206,400,341,59,0.704513849738787,0.214285714285714,1.22273425499232,158,59,99,45,1.7,14.37,5.8,0,0,0,0,0,0,0.155345741957888,328.074139061739,15.7853367544095
9.7,"random_policy_SVM","SVM",64,4,2284,2088,196,500,431,69,0.745499304694248,0.238095238095238,1.24311315924219,192,69,123,34,1.8,17.96,6.2,0,0,0,0,0,0,0.144952302127449,211.152506935995,15.1290581147678
9.7,"random_policy_SVM","SVM",64,5,2184,2006,178,600,513,87,0.752966011450618,0.246031746031746,1.23292370711726,227,87,140,35,1.6,21.55,5.9,0,0,0,0,0,0,0.14455401423358,234.779356840782,14.7766185154382
9.7,"random_policy_SVM","SVM",64,6,2084,1922,162,700,597,103,0.747578957918339,0.23015873015873,1.23292370711726,261,103,158,34,1.5,25.14,5.8,0,0,0,0,0,0,0.150324094326638,269.324914512941,15.1991467572881
9.7,"random_policy_SVM","SVM",64,7,1984,1843,141,800,676,124,0.768832763307897,0.261904761904762,1.24311315924219,329,124,205,68,1.7,28.74,5.5,0,0,0,0,0,0,0.159505160939361,233.049267904418,16.3367837426698
9.7,"random_policy_SVM","SVM",64,8,1884,1762,122,900,757,143,0.77364979140827,0.246031746031746,1.25330261136713,370,143,227,41,1.6,32.33,5.3,0,0,0,0,0,0,0.156007871390881,186.904457370873,15.9952730295532
9.7,"random_policy_SVM","SVM",64,9,1784,1686,98,1000,833,167,0.785958582327954,0.285714285714286,1.23292370711726,423,167,256,53,1.5,35.92,5,0,0,0,0,0,0,0.164373381817861,219.060443531897,17.0098526588065
9.7,"random_policy_SVM","SVM",64,10,1684,1615,69,1100,904,196,0.7720900514902,0.174603174603175,1.22273425499232,500,196,304,77,1.6,39.51,4.6,0,0,0,0,0,0,0.162362858618868,146.762320501592,17.7774545933194
9.7,"random_policy_SVM","SVM",64,11,1584,1530,54,1200,989,211,0.785407348943252,0.285714285714286,1.22273425499232,537,211,326,37,1.5,43.1,4.7,0,0,0,0,0,0,0.165003630892661,167.582750465562,17.4774036683278
9.7,"random_policy_SVM","SVM",64,12,1484,1437,47,1300,1082,218,0.761666729306814,0.19047619047619,1.22273425499232,552,218,334,15,1.5,46.7,5,0,0,0,0,0,0,0.149582552650157,142.959584018779,15.7834397132512
9.7,"random_policy_SVM","SVM",64,13,1384,1342,42,1400,1177,223,0.75671189286027,0.126984126984127,1.24311315924219,565,223,342,13,1.5,50.29,5.3,0,0,0,0,0,0,0.138546674189953,124.605338572543,14.6528757569898
9.7,"random_policy_SVM","SVM",64,14,1284,1247,37,1500,1272,228,0.775171947231932,0.19047619047619,1.24311315924219,572,228,344,7,1.5,53.88,5.6,0,0,0,0,0,0,0.134541334541753,120.8553750881,14.1252123396159
9.7,"random_policy_SVM","SVM",64,15,1184,1155,29,1600,1364,236,0.799614136630713,0.23015873015873,1.23292370711726,599,236,363,27,1.5,57.47,5.8,0,0,0,0,0,0,0.128886736136716,71.7555857354076,15.2542958488293
9.7,"random_policy_SVM","SVM",64,16,1084,1068,16,1700,1451,249,0.808032973778822,0.253968253968254,1.24311315924219,649,249,400,50,1.6,61.06,5.8,0,0,0,0,0,0,0.0723373479964774,36.3103327377677,9.7557824675607
9.7,"random_policy_SVM","SVM",64,17,984,972,12,1800,1547,253,0.816671051477673,0.214285714285714,1.25330261136713,635,253,382,-14,1.5,64.66,6.1,0,0,0,0,0,0,0.0902669998732468,50.8603696861152,9.99567942150167
9.7,"random_policy_SVM","SVM",64,18,884,874,10,1900,1645,255,0.779112013129372,0.206349206349206,1.21254480286738,660,255,405,25,1.6,68.25,6.5,0,0,0,0,0,0,0.127360174774836,74.5477552745528,14.0499530609342
9.7,"random_policy_SVM","SVM",64,19,784,774,10,2000,1745,255,0.799989977574819,0.206349206349206,1.23292370711726,657,255,402,-3,1.6,71.84,6.8,0,0,0,0,0,0,0.0584123506978912,22.7035137981518,7.48863629568211
9.7,"random_policy_SVM","SVM",64,20,684,675,9,2100,1844,256,0.799044111198803,0.23015873015873,1.20235535074245,666,256,410,9,1.6,75.43,7.2,0,0,0,0,0,0,0.066002510804725,28.2487181750561,8.1618404796126
9.7,"random_policy_SVM","SVM",64,21,584,575,9,2200,1944,256,0.796356848448403,0.19047619047619,1.22273425499232,677,256,421,11,1.6,79.02,7.6,0,0,0,0,0,0,0.0349253239264974,11.3019881024317,4.39398531543315
9.7,"random_policy_SVM","SVM",64,22,484,475,9,2300,2044,256,0.806510817955171,0.277777777777778,1.22273425499232,679,256,423,2,1.7,82.61,8,0,0,0,0,0,0,0.0160536009974892,4.57672665793951,2.17921814049133
9.7,"random_policy_SVM","SVM",64,23,384,378,6,2400,2141,259,0.826655892559605,0.26984126984127,1.23292370711726,698,259,439,19,1.7,86.21,8.3,0,0,0,0,0,0,0.0126825657523671,3.76197918272196,2.34884355039896
9.7,"random_policy_SVM","SVM",64,24,284,280,4,2500,2239,261,0.799708096866736,0.23015873015873,1.25330261136713,693,261,432,-5,1.7,89.8,8.6,0,0,0,0,0,0,0.0130018896238297,3.17974340663069,2.22761934777965
9.7,"random_policy_SVM","SVM",64,25,184,184,0,2600,2335,265,0.75057315743977,0.150793650793651,1.273681515617,732,265,467,39,1.8,93.39,8.8,0,0,0,0,0,0,0.00638253124109055,2.01128728534572,1.67687419932648
9.7,"random_policy_SVM","SVM",64,26,84,84,0,2700,2435,265,0.829330627278527,0.246031746031746,1.26349206349206,720,265,455,-12,1.7,96.98,9.2,0,0,0,0,0,0,0.000156826070746558,0.160902759523609,0.160902759523609
9.7,"random_policy_SVM","SVM",64,27,0,0,0,2784,2519,265,0.829029954523245,0.246031746031746,1.26349206349206,713,265,448,-7,1.7,100,9.5,0,0,0,0,0,0,0,0,0
9.7,"random_policy_SVM","SVM",65,0,2684,2426,258,100,89,11,0.736524744940737,0.237704918032787,1.23125330512956,33,11,22,0,2,3.59,8.1,0,0,0,0,0,0,0.284674171325104,295.796788473807,44.7831666242257
9.7,"random_policy_SVM","SVM",65,1,2584,2348,236,200,167,33,0.756542544272619,0.245901639344262,1.23125330512956,84,33,51,51,1.5,7.18,5.1,0,0,0,0,0,0,0.262932680323196,319.618695812981,29.9357766829395
9.7,"random_policy_SVM","SVM",65,2,2484,2277,207,300,238,62,0.708761656627666,0.229508196721311,1.21020624008461,147,62,85,63,1.4,10.78,3.8,0,0,0,0,0,0,0.220719059051533,345.836375407447,23.8603681644739
9.7,"random_policy_SVM","SVM",65,3,2384,2195,189,400,320,80,0.76579690704363,0.254098360655738,1.27334743521946,192,80,112,45,1.4,14.37,4,0,0,0,0,0,0,0.20064225195593,224.779393375117,21.1666493667187
9.7,"random_policy_SVM","SVM",65,4,2284,2112,172,500,403,97,0.765777559943761,0.237704918032787,1.27334743521946,239,97,142,47,1.5,17.96,4.2,0,0,0,0,0,0,0.188194566104818,197.830703252796,19.645961004687
9.7,"random_policy_SVM","SVM",65,5,2184,2026,158,600,489,111,0.781332628239026,0.254098360655738,1.26282390269699,265,111,154,26,1.4,21.55,4.4,0,0,0,0,0,0,0.16817533595431,140.094093788846,17.6807877540132
9.7,"random_policy_SVM","SVM",65,6,2084,1944,140,700,571,129,0.810121112845181,0.311475409836066,1.26282390269699,304,129,175,39,1.4,25.14,4.4,0,0,0,0,0,0,0.17505300849993,175.815201995637,18.1876973900337
9.7,"random_policy_SVM","SVM",65,7,1984,1876,108,800,639,161,0.804316982884268,0.237704918032787,1.26282390269699,394,161,233,90,1.4,28.74,4,0,0,0,0,0,0,0.199674909606361,179.018640388395,20.8499226410299
9.7,"random_policy_SVM","SVM",65,8,1884,1797,87,900,718,182,0.819749519547024,0.262295081967213,1.26282390269699,441,182,259,47,1.4,32.33,3.9,0,0,0,0,0,0,0.189280815098172,186.631869083144,19.896181743563
9.7,"random_policy_SVM","SVM",65,9,1784,1718,66,1000,797,203,0.831338432368992,0.311475409836066,1.26282390269699,491,203,288,50,1.4,35.92,3.9,0,0,0,0,0,0,0.170653361618758,111.593680714082,18.3462974919127
9.7,"random_policy_SVM","SVM",65,10,1684,1629,55,1100,886,214,0.831028878771078,0.295081967213115,1.26282390269699,537,214,323,46,1.5,39.51,4.1,0,0,0,0,0,0,0.164477476152421,114.486808896932,17.8434432784029
9.7,"random_policy_SVM","SVM",65,11,1584,1540,44,1200,975,225,0.816828107466699,0.245901639344262,1.24177683765204,553,225,328,16,1.5,43.1,4.3,0,0,0,0,0,0,0.147330922778676,96.1735930781232,16.0119673651692
9.7,"random_policy_SVM","SVM",65,12,1484,1447,37,1300,1068,232,0.822961138125403,0.336065573770492,1.24177683765204,585,232,353,32,1.5,46.7,4.6,0,0,0,0,0,0,0.163277478219856,124.679359116195,17.3035080364445
9.7,"random_policy_SVM","SVM",65,13,1384,1355,29,1400,1160,240,0.803762366021341,0.19672131147541,1.24177683765204,622,240,382,37,1.6,50.29,4.8,0,0,0,0,0,0,0.149256813676949,81.7021188151508,16.1594071455883
9.7,"random_policy_SVM","SVM",65,14,1284,1258,26,1500,1257,243,0.81525454334396,0.278688524590164,1.24177683765204,653,243,410,31,1.7,53.88,5.2,0,0,0,0,0,0,0.133932655838371,68.1342259125763,14.3172830229453
9.7,"random_policy_SVM","SVM",65,15,1184,1159,25,1600,1356,244,0.798441913557164,0.204918032786885,1.25230037017451,634,244,390,-19,1.6,57.47,5.6,0,0,0,0,0,0,0.106151174016445,38.8317796516128,11.7148683864226
9.7,"random_policy_SVM","SVM",65,16,1084,1059,25,1700,1456,244,0.820471811275496,0.286885245901639,1.25230037017451,645,244,401,11,1.6,61.06,6,0,0,0,0,0,0,0.058414213656248,15.4113727030622,7.1800905942102
9.7,"random_policy_SVM","SVM",65,17,984,959,25,1800,1556,244,0.80945041338304,0.245901639344262,1.26282390269699,641,244,397,-4,1.6,64.66,6.4,0,0,0,0,0,0,0.0352242893001679,8.57340563606799,4.97452571139621
9.7,"random_policy_SVM","SVM",65,18,884,860,24,1900,1655,245,0.79156724407012,0.213114754098361,1.26282390269699,658,245,413,17,1.7,68.25,6.8,0,0,0,0,0,0,0.0130836389508626,3.66088844814674,2.9536812823047
9.7,"random_policy_SVM","SVM",65,19,784,763,21,2000,1752,248,0.824799112613019,0.295081967213115,1.26282390269699,658,248,410,0,1.7,71.84,7.1,0,0,0,0,0,0,0.0110892874344127,4.44726126384712,3.44412896733291
9.7,"random_policy_SVM","SVM",65,20,684,669,15,2100,1846,254,0.793540648256831,0.245901639344262,1.25230037017451,670,254,416,12,1.6,75.43,7.3,0,0,0,0,0,0,0.028184803890671,10.7710714883801,4.23652042518695
9.7,"random_policy_SVM","SVM",65,21,584,572,12,2200,1943,257,0.767667126697708,0.131147540983607,1.25230037017451,685,257,428,15,1.7,79.02,7.6,0,0,0,0,0,0,0.0443424921876407,14.7552699793503,5.78611790510306
9.7,"random_policy_SVM","SVM",65,22,484,472,12,2300,2043,257,0.818756368420372,0.204918032786885,1.25230037017451,683,257,426,-2,1.7,82.61,7.9,0,0,0,0,0,0,0.0112706847418957,3.09152037881163,1.78608104688102
9.7,"random_policy_SVM","SVM",65,23,384,374,10,2400,2141,259,0.801937289600288,0.245901639344262,1.24177683765204,692,259,433,9,1.7,86.21,8.3,0,0,0,0,0,0,0.0270460389659998,8.24611060901951,5.57077582643387
9.7,"random_policy_SVM","SVM",65,24,284,275,9,2500,2240,260,0.81958829371477,0.278688524590164,1.24177683765204,707,260,447,15,1.7,89.8,8.6,0,0,0,0,0,0,0.00866857653868747,3.48008434407458,2.81448716679304
9.7,"random_policy_SVM","SVM",65,25,184,176,8,2600,2339,261,0.790380621944768,0.188524590163934,1.26282390269699,704,261,443,-3,1.7,93.39,9,0,0,0,0,0,0,0.00899779740513606,2.50759306953945,2.11396989218021
9.7,"random_policy_SVM","SVM",65,26,84,83,1,2700,2432,268,0.820368626742851,0.237704918032787,1.28387096774194,733,268,465,29,1.7,96.98,9.1,0,0,0,0,0,0,9.77067549509259e-07,1.23669922437235,1.23669922437235
9.7,"random_policy_SVM","SVM",65,27,0,0,0,2784,2515,269,0.814403270949686,0.213114754098361,1.28387096774194,740,269,471,7,1.8,100,9.3,0,0,0,0,0,0,0,0,0
9.7,"random_policy_SVM","SVM",66,0,2684,2426,258,100,94,6,0.177855730119043,0,0.485242570485141,18,6,12,0,2,3.59,15.7,0,0,0,0,0,0,0.0623247039385188,167.212402614507,6.2326156229163
9.7,"random_policy_SVM","SVM",66,1,2584,2340,244,200,180,20,0.766957744026081,0.220472440944882,1.2737617475235,58,20,38,40,1.9,7.18,9,0,0,0,0,0,0,0.146342561100531,231.255512513941,16.8697820887939
9.7,"random_policy_SVM","SVM",66,2,2484,2250,234,300,270,30,0.766174074212293,0.267716535433071,1.25354330708661,85,30,55,27,1.8,10.78,9,0,0,0,0,0,0,0.131864684031929,217.63771977349,15.8396399972587
9.7,"random_policy_SVM","SVM",66,3,2384,2165,219,400,355,45,0.79058601087187,0.259842519685039,1.2737617475235,126,45,81,41,1.8,14.37,7.9,0,0,0,0,0,0,0.136549644566786,197.102755923526,14.3791015629514
9.7,"random_policy_SVM","SVM",66,4,2284,2083,201,500,437,63,0.81904068863431,0.330708661417323,1.2737617475235,184,63,121,58,1.9,17.96,6.9,0,0,0,0,0,0,0.142484065891608,166.485014782147,15.1279142820192
9.7,"random_policy_SVM","SVM",66,5,2184,2012,172,600,508,92,0.811608264606738,0.275590551181102,1.28387096774194,250,92,158,66,1.7,21.55,5.5,0,0,0,0,0,0,0.169569676824665,223.588869100029,17.807384381568
9.7,"random_policy_SVM","SVM",66,6,2084,1936,148,700,584,116,0.776231170155863,0.188976377952756,1.25354330708661,321,116,205,71,1.8,25.14,5,0,0,0,0,0,0,0.190476228402608,295.918111433153,24.2460969766486
9.7,"random_policy_SVM","SVM",66,7,1984,1847,137,800,673,127,0.824905773034295,0.244094488188976,1.26365252730505,338,127,211,17,1.7,28.74,5.3,0,0,0,0,0,0,0.169488305580186,192.068968684204,18.5256694088703
9.7,"random_policy_SVM","SVM",66,8,1884,1771,113,900,749,151,0.838159744249982,0.283464566929134,1.26365252730505,402,151,251,64,1.7,32.33,5,0,0,0,0,0,0,0.169345202590685,172.256846795697,18.0513817891049
9.7,"random_policy_SVM","SVM",66,9,1784,1702,82,1000,818,182,0.837295219614142,0.307086614173228,1.25354330708661,462,182,280,60,1.5,35.92,4.5,0,0,0,0,0,0,0.191440911367365,159.261735108528,20.0097892239778
9.7,"random_policy_SVM","SVM",66,10,1684,1631,53,1100,889,211,0.825757858466749,0.275590551181102,1.25354330708661,540,211,329,78,1.6,39.51,4.2,0,0,0,0,0,0,0.19177331437302,178.036689289748,20.1712384322779
9.7,"random_policy_SVM","SVM",66,11,1584,1548,36,1200,972,228,0.833619435011387,0.283464566929134,1.25354330708661,579,228,351,39,1.5,43.1,4.3,0,0,0,0,0,0,0.179210955417905,151.112603299728,18.7963431068017
9.7,"random_policy_SVM","SVM",66,12,1484,1457,27,1300,1063,237,0.821628042940136,0.236220472440945,1.25354330708661,618,237,381,39,1.6,46.7,4.5,0,0,0,0,0,0,0.168075795156568,120.030690498318,17.5058136182818
9.7,"random_policy_SVM","SVM",66,13,1384,1363,21,1400,1157,243,0.798478685424986,0.188976377952756,1.25354330708661,632,243,389,14,1.6,50.29,4.8,0,0,0,0,0,0,0.173619658506768,117.258526911392,18.1342038752143
9.7,"random_policy_SVM","SVM",66,14,1284,1266,18,1500,1254,246,0.796706098941424,0.181102362204724,1.25354330708661,636,246,390,4,1.6,53.88,5.1,0,0,0,0,0,0,0.153105268403749,83.5371153257931,16.176519909505
9.7,"random_policy_SVM","SVM",66,15,1184,1166,18,1600,1354,246,0.814985508328048,0.228346456692913,1.25354330708661,653,246,407,17,1.7,57.47,5.5,0,0,0,0,0,0,0.12564706910701,52.9454142042868,13.3045137336491
9.7,"random_policy_SVM","SVM",66,16,1084,1069,15,1700,1451,249,0.818978492617333,0.220472440944882,1.25354330708661,658,249,409,5,1.6,61.06,5.8,0,0,0,0,0,0,0.125244456727878,54.5728452486178,13.3723332071786
9.7,"random_policy_SVM","SVM",66,17,984,969,15,1800,1551,249,0.795014367279919,0.236220472440945,1.25354330708661,661,249,412,3,1.7,64.66,6.2,0,0,0,0,0,0,0.0871658471201564,25.7450845795573,9.83751827481641
9.7,"random_policy_SVM","SVM",66,18,884,870,14,1900,1650,250,0.805488176537172,0.204724409448819,1.25354330708661,678,250,428,17,1.7,68.25,6.6,0,0,0,0,0,0,0.0555362722029987,13.327663099875,7.30321898613559
9.7,"random_policy_SVM","SVM",66,19,784,770,14,2000,1750,250,0.804598773494545,0.196850393700787,1.26365252730505,675,250,425,-3,1.7,71.84,7,0,0,0,0,0,0,0.0162004931589665,4.07975727188734,3.39238865057525
9.7,"random_policy_SVM","SVM",66,20,684,672,12,2100,1848,252,0.79299299672849,0.173228346456693,1.26365252730505,675,252,423,0,1.7,75.43,7.3,0,0,0,0,0,0,0.00546452465130994,1.8673375749485,1.72531255251281
9.7,"random_policy_SVM","SVM",66,21,584,580,4,2200,1940,260,0.740978467738924,0.141732283464567,1.28387096774194,702,260,442,27,1.7,79.02,7.5,0,0,0,0,0,0,0.11854611668997,37.3861903939923,15.8222870039024
9.7,"random_policy_SVM","SVM",66,22,484,481,3,2300,2039,261,0.78601460362479,0.196850393700787,1.2737617475235,734,261,473,32,1.8,82.61,7.8,0,0,0,0,0,0,0.0582509549407958,15.4804386139084,7.68272227246204
9.7,"random_policy_SVM","SVM",66,23,384,383,1,2400,2137,263,0.715297732333221,0.078740157480315,1.2737617475235,731,263,468,-3,1.8,86.21,8.1,0,0,0,0,0,0,0.0386967971481989,8.97838443641518,5.63325488954302
9.7,"random_policy_SVM","SVM",66,24,284,283,1,2500,2237,263,0.776268487766048,0.149606299212598,1.2737617475235,734,263,471,3,1.8,89.8,8.5,0,0,0,0,0,0,0.0050285583235953,1.26896069624652,1.15003910400963
9.7,"random_policy_SVM","SVM",66,25,184,183,1,2600,2337,263,0.818288116829003,0.244094488188976,1.2737617475235,725,263,462,-9,1.8,93.39,8.9,0,0,0,0,0,0,1.93485454057547e-07,0.152474148342681,0.152471163353916
9.7,"random_policy_SVM","SVM",66,26,84,84,0,2700,2436,264,0.769793882399773,0.173228346456693,1.2737617475235,720,264,456,-5,1.7,96.98,9.2,0,0,0,0,0,0,7.19011057529281e-12,1.5167745751606,1.5167745751606
9.7,"random_policy_SVM","SVM",66,27,0,0,0,2784,2520,264,0.773724670672089,0.181102362204724,1.2737617475235,738,264,474,18,1.8,100,9.5,0,0,0,0,0,0,0,0,0
9.7,"random_policy_SVM","SVM",67,0,2684,2436,248,100,88,12,0.71672856607106,0.213740458015267,1.2348682590495,38,12,26,0,2.2,3.59,7.3,0,0,0,0,0,0,0.202705450024683,337.766827033392,28.9195432961104
9.7,"random_policy_SVM","SVM",67,1,2584,2344,240,200,180,20,0.780150252235032,0.213740458015267,1.27407042600345,60,20,40,22,2,7.18,9,0,0,0,0,0,0,0.19052638561011,238.420408753281,24.0824562046988
9.7,"random_policy_SVM","SVM",67,2,2484,2256,228,300,268,32,0.74256299827004,0.244274809160305,1.22506771731101,100,32,68,40,2.1,10.78,8.4,0,0,0,0,0,0,0.107707334100039,263.082991326836,10.8266720924921
9.7,"random_policy_SVM","SVM",67,3,2384,2181,203,400,343,57,0.692333748684379,0.137404580152672,1.21526717557252,153,57,96,53,1.7,14.37,6,0,0,0,0,0,0,0.16762467806875,290.807213960803,20.7818331366224
9.7,"random_policy_SVM","SVM",67,4,2284,2092,192,500,432,68,0.823689527104673,0.358778625954198,1.24466880078798,169,68,101,16,1.5,17.96,6.4,0,0,0,0,0,0,0.164857837439684,189.230848038311,19.673786471585
9.7,"random_policy_SVM","SVM",67,5,2184,2016,168,600,508,92,0.816908820362682,0.282442748091603,1.25446934252647,226,92,134,57,1.5,21.55,5.5,0,0,0,0,0,0,0.17111942477794,187.111017412119,17.8649272776804
9.7,"random_policy_SVM","SVM",67,6,2084,1958,126,700,566,134,0.80545843868329,0.282442748091603,1.25446934252647,324,134,190,98,1.4,25.14,4.2,0,0,0,0,0,0,0.204248986510883,226.209885528246,21.239540525653
9.7,"random_policy_SVM","SVM",67,7,1984,1877,107,800,647,153,0.822262009895833,0.32824427480916,1.25446934252647,368,153,215,44,1.4,28.74,4.2,0,0,0,0,0,0,0.191851433112385,152.380126726088,20.0930595008011
9.7,"random_policy_SVM","SVM",67,8,1884,1799,85,900,725,175,0.821741812946849,0.290076335877863,1.25446934252647,418,175,243,50,1.4,32.33,4.1,0,0,0,0,0,0,0.191379952064269,137.200699503989,20.3790638140415
9.7,"random_policy_SVM","SVM",67,9,1784,1727,57,1000,797,203,0.820574394212499,0.274809160305344,1.24466880078798,496,203,293,78,1.4,35.92,3.9,0,0,0,0,0,0,0.197099960313938,146.131141076629,20.4806194208918
9.7,"random_policy_SVM","SVM",67,10,1684,1646,38,1100,878,222,0.818548045632152,0.282442748091603,1.24352269691985,536,222,314,40,1.4,39.51,4,0,0,0,0,0,0,0.19276751677177,117.089531843782,20.7514183324201
9.7,"random_policy_SVM","SVM",67,11,1584,1555,29,1200,969,231,0.829871402475162,0.290076335877863,1.25446934252647,562,231,331,26,1.4,43.1,4.2,0,0,0,0,0,0,0.158620423125586,83.8439030655587,17.4879103413309
9.7,"random_policy_SVM","SVM",67,12,1484,1460,24,1300,1064,236,0.822370888327011,0.305343511450382,1.2348682590495,587,236,351,25,1.5,46.7,4.5,0,0,0,0,0,0,0.165325598013269,128.188478907963,17.5706797513739
9.7,"random_policy_SVM","SVM",67,13,1384,1364,20,1400,1160,240,0.809662355887286,0.274809160305344,1.22506771731101,594,240,354,7,1.5,50.29,4.8,0,0,0,0,0,0,0.153055073344439,112.081617154684,16.4571359540855
9.7,"random_policy_SVM","SVM",67,14,1284,1266,18,1500,1258,242,0.810938653052815,0.290076335877863,1.22506771731101,617,242,375,23,1.5,53.88,5.2,0,0,0,0,0,0,0.125762593462249,72.3362201925831,14.4077991843222
9.7,"random_policy_SVM","SVM",67,15,1184,1167,17,1600,1357,243,0.801127496642901,0.244274809160305,1.22506771731101,623,243,380,6,1.6,57.47,5.6,0,0,0,0,0,0,0.0921788248248238,43.1849592578879,10.4729354805634
9.7,"random_policy_SVM","SVM",67,16,1084,1069,15,1700,1455,245,0.805857659597616,0.274809160305344,1.22506771731101,634,245,389,11,1.6,61.06,5.9,0,0,0,0,0,0,0.0891099404942492,43.9441340073577,9.774741007391
9.7,"random_policy_SVM","SVM",67,17,984,969,15,1800,1555,245,0.811997193355978,0.267175572519084,1.22506771731101,638,245,393,4,1.6,64.66,6.3,0,0,0,0,0,0,0.0518069080916367,19.0182697172568,6.17767144359588
9.7,"random_policy_SVM","SVM",67,18,884,869,15,1900,1655,245,0.804889851320437,0.274809160305344,1.22506771731101,637,245,392,-1,1.6,68.25,6.8,0,0,0,0,0,0,0.0423036922237492,14.4054524567159,4.95594335784048
9.7,"random_policy_SVM","SVM",67,19,784,770,14,2000,1754,246,0.80963816068035,0.290076335877863,1.21526717557252,632,246,386,-5,1.6,71.84,7.1,0,0,0,0,0,0,0.0351169528851892,11.1771894375664,5.19060804471598
9.7,"random_policy_SVM","SVM",67,20,684,671,13,2100,1853,247,0.800673836512969,0.274809160305344,1.21526717557252,650,247,403,18,1.6,75.43,7.5,0,0,0,0,0,0,0.0240922041298849,7.01912991880818,3.4553697319745
9.7,"random_policy_SVM","SVM",67,21,584,571,13,2200,1953,247,0.788183060935611,0.236641221374046,1.22506771731101,651,247,404,1,1.6,79.02,7.9,0,0,0,0,0,0,0.00902742915012071,2.69114650246022,1.61798079212768
9.7,"random_policy_SVM","SVM",67,22,484,474,10,2300,2050,250,0.800329054814228,0.259541984732824,1.22506771731101,645,250,395,-6,1.6,82.61,8.2,0,0,0,0,0,0,0.00464535635519638,1.54054137175549,1.05968504675079
9.7,"random_policy_SVM","SVM",67,23,384,375,9,2400,2149,251,0.786368420415899,0.221374045801527,1.21526717557252,673,251,422,28,1.7,86.21,8.6,0,0,0,0,0,0,0.0603419435314705,14.3557474515981,9.1133648319206
9.7,"random_policy_SVM","SVM",67,24,284,275,9,2500,2249,251,0.788806087514046,0.259541984732824,1.21526717557252,660,251,409,-13,1.6,89.8,9,0,0,0,0,0,0,0.00429440572116124,2.03156852544255,1.73117666523436
9.7,"random_policy_SVM","SVM",67,25,184,177,7,2600,2347,253,0.799645540218466,0.274809160305344,1.21526717557252,675,253,422,15,1.7,93.39,9.3,0,0,0,0,0,0,0.00509848263223973,2.12251032807634,1.95153308015098
9.7,"random_policy_SVM","SVM",67,26,84,83,1,2700,2441,259,0.807636007306949,0.229007633587786,1.28387096774194,719,259,460,44,1.8,96.98,9.4,0,0,0,0,0,0,4.96702852962824e-06,1.43955031466109,1.43955031466109
9.7,"random_policy_SVM","SVM",67,27,0,0,0,2784,2524,260,0.771911784275533,0.183206106870229,1.27407042600345,717,260,457,-2,1.8,100,9.7,0,0,0,0,0,0,0,0,0
9.7,"random_policy_SVM","SVM",68,0,2684,2419,265,100,91,9,0.786807062669132,0.239316239316239,1.28387096774194,30,9,21,0,2.3,3.59,10.1,0,0,0,0,0,0,0.115505013093837,252.477713992681,11.9586933277076
9.7,"random_policy_SVM","SVM",68,1,2584,2339,245,200,171,29,0.748814403986813,0.256410256410256,1.2509511993383,78,29,49,48,1.7,7.18,5.9,0,0,0,0,0,0,0.164260805012254,350.117190045546,17.1825339557578
9.7,"random_policy_SVM","SVM",68,2,2484,2278,206,300,232,68,0.726227795193309,0.196581196581197,1.23997794320375,162,68,94,84,1.4,10.78,3.4,0,0,0,0,0,0,0.242700324388616,438.697674378151,25.779342306486
9.7,"random_policy_SVM","SVM",68,3,2384,2203,181,400,307,93,0.758513517134209,0.230769230769231,1.2509511993383,220,93,127,58,1.4,14.37,3.3,0,0,0,0,0,0,0.23705270200274,422.171349756841,24.3429184440319
9.7,"random_policy_SVM","SVM",68,4,2284,2127,157,500,383,117,0.765627093213289,0.205128205128205,1.23997794320375,270,117,153,50,1.3,17.96,3.3,0,0,0,0,0,0,0.237139805772746,440.488969470664,28.2253706304812
9.7,"random_policy_SVM","SVM",68,5,2184,2040,144,600,470,130,0.776994078718219,0.239316239316239,1.26192445547284,311,130,181,41,1.4,21.55,3.6,0,0,0,0,0,0,0.216768830031728,367.872662884173,22.0908110952553
9.7,"random_policy_SVM","SVM",68,6,2084,1965,119,700,545,155,0.78909787530478,0.230769230769231,1.26192445547284,368,155,213,57,1.4,25.14,3.5,0,0,0,0,0,0,0.223560959937928,316.840635942175,23.0951071475443
9.7,"random_policy_SVM","SVM",68,7,1984,1895,89,800,615,185,0.796198054818752,0.247863247863248,1.26192445547284,427,185,242,59,1.3,28.74,3.3,0,0,0,0,0,0,0.219291373547949,289.841502898796,22.8634589281975
9.7,"random_policy_SVM","SVM",68,8,1884,1819,65,900,691,209,0.805012994668177,0.264957264957265,1.26192445547284,485,209,276,58,1.3,32.33,3.3,0,0,0,0,0,0,0.211922460634643,250.027280239112,22.1608932447147
9.7,"random_policy_SVM","SVM",68,9,1784,1738,46,1000,772,228,0.804597701149436,0.273504273504274,1.26192445547284,549,228,321,64,1.4,35.92,3.4,0,0,0,0,0,0,0.201693629971524,184.316183014939,21.9424570817498
9.7,"random_policy_SVM","SVM",68,10,1684,1648,36,1100,862,238,0.804477132063346,0.282051282051282,1.26192445547284,575,238,337,26,1.4,39.51,3.6,0,0,0,0,0,0,0.174819603798014,124.817770936346,18.5984876943225
9.7,"random_policy_SVM","SVM",68,11,1584,1557,27,1200,953,247,0.802260000535865,0.239316239316239,1.26192445547284,605,247,358,30,1.4,43.1,3.9,0,0,0,0,0,0,0.179909733623645,139.896508208205,19.4129845080672
9.7,"random_policy_SVM","SVM",68,12,1484,1463,21,1300,1047,253,0.793498646946922,0.230769230769231,1.23997794320375,632,253,379,27,1.5,46.7,4.1,0,0,0,0,0,0,0.153994492838205,103.942706301021,16.9279641914016
9.7,"random_policy_SVM","SVM",68,13,1384,1364,20,1400,1146,254,0.790343755860999,0.239316239316239,1.2290046870692,645,254,391,13,1.5,50.29,4.5,0,0,0,0,0,0,0.141796085696198,78.3235954598269,15.9837195987878
9.7,"random_policy_SVM","SVM",68,14,1284,1265,19,1500,1245,255,0.788119926050963,0.230769230769231,1.2509511993383,649,255,394,4,1.5,53.88,4.9,0,0,0,0,0,0,0.122914917821296,68.3549292068876,13.1157957055678
9.7,"random_policy_SVM","SVM",68,15,1184,1169,15,1600,1341,259,0.795561717975511,0.222222222222222,1.23997794320375,662,259,403,13,1.6,57.47,5.2,0,0,0,0,0,0,0.108425682544279,54.4946305771121,12.5585888472062
9.7,"random_policy_SVM","SVM",68,16,1084,1070,14,1700,1440,260,0.790310264448198,0.205128205128205,1.2509511993383,667,260,407,5,1.6,61.06,5.5,0,0,0,0,0,0,0.075799202513307,33.3531760309114,9.28219629977451
9.7,"random_policy_SVM","SVM",68,17,984,971,13,1800,1539,261,0.786458751975992,0.222222222222222,1.2509511993383,665,261,404,-2,1.5,64.66,5.9,0,0,0,0,0,0,0.0917824214628555,47.6700747317205,10.3464949417127
9.7,"random_policy_SVM","SVM",68,18,884,872,12,1900,1638,262,0.788716073198832,0.196581196581197,1.27289771160739,683,262,421,18,1.6,68.25,6.3,0,0,0,0,0,0,0.0510839456092518,18.5956113744925,6.41201160789065
9.7,"random_policy_SVM","SVM",68,19,784,774,10,2000,1736,264,0.810338129303643,0.264957264957265,1.27289771160739,689,264,425,6,1.6,71.84,6.6,0,0,0,0,0,0,0.039814618147273,14.6743579066433,5.92393673645377
9.7,"random_policy_SVM","SVM",68,20,684,678,6,2100,1832,268,0.823419875144012,0.230769230769231,1.28387096774194,724,268,456,35,1.7,75.43,6.8,0,0,0,0,0,0,0.0189554677422863,6.88392344288659,3.79077568074713
9.7,"random_policy_SVM","SVM",68,21,584,582,2,2200,1928,272,0.813124614848752,0.264957264957265,1.28387096774194,721,272,449,-3,1.7,79.02,7.1,0,0,0,0,0,0,0.0202034913386975,6.31679174129233,3.60816708971361
9.7,"random_policy_SVM","SVM",68,22,484,483,1,2300,2027,273,0.769719743857673,0.170940170940171,1.27289771160739,741,273,468,20,1.7,82.61,7.4,0,0,0,0,0,0,0.06925187087568,21.0809839616329,10.271739707971
9.7,"random_policy_SVM","SVM",68,23,384,383,1,2400,2127,273,0.797644883851776,0.213675213675214,1.27289771160739,745,273,472,4,1.7,86.21,7.8,0,0,0,0,0,0,0.0298467831344144,8.16606260540121,4.87513236663164
9.7,"random_policy_SVM","SVM",68,24,284,284,0,2500,2226,274,0.801375827237893,0.256410256410256,1.27289771160739,746,274,472,1,1.7,89.8,8.1,0,0,0,0,0,0,0.00617966115471757,3.29420091049626,2.94893318501631
9.7,"random_policy_SVM","SVM",68,25,184,184,0,2600,2326,274,0.777925139994101,0.205128205128205,1.27289771160739,746,274,472,0,1.7,93.39,8.5,0,0,0,0,0,0,0.000579218969410748,0.328089146433565,0.314435547958597
9.7,"random_policy_SVM","SVM",68,26,84,84,0,2700,2426,274,0.812213648420543,0.230769230769231,1.28387096774194,743,274,469,-3,1.7,96.98,8.9,0,0,0,0,0,0,1.24081888032728e-05,0.0279441130483632,0.0279441130483632
9.7,"random_policy_SVM","SVM",68,27,0,0,0,2784,2510,274,0.783317257455182,0.179487179487179,1.27289771160739,739,274,465,-4,1.7,100,9.2,0,0,0,0,0,0,0,0,0
9.7,"random_policy_SVM","SVM",69,0,2684,2422,262,100,89,11,0.30977733466268,0.00847457627118644,0.761618370694368,34,11,23,0,2.1,3.59,8.1,0,0,0,0,0,0,0.117674086450739,298.946632966351,11.8844061056355
9.7,"random_policy_SVM","SVM",69,1,2584,2333,251,200,178,22,0.773406447324695,0.23728813559322,1.27299070530344,56,22,34,22,1.5,7.18,8.1,0,0,0,0,0,0,0.164475018883788,264.995018793442,17.7706069610486
9.7,"random_policy_SVM","SVM",69,2,2484,2269,215,300,242,58,0.772136922565639,0.254237288135593,1.26211044286495,130,58,72,74,1.2,10.78,4.2,0,0,0,0,0,0,0.22328859442616,355.03212406137,24.0987756322872
9.7,"random_policy_SVM","SVM",69,3,2384,2203,181,400,308,92,0.788321701561982,0.254237288135593,1.27299070530344,204,92,112,74,1.2,14.37,3.3,0,0,0,0,0,0,0.260046830982646,424.208532236126,29.7597593553827
9.7,"random_policy_SVM","SVM",69,4,2284,2118,166,500,393,107,0.764918577600533,0.279661016949153,1.19682886823401,242,107,135,38,1.3,17.96,3.7,0,0,0,0,0,0,0.21653947567115,255.675040241023,23.2313637836703
9.7,"random_policy_SVM","SVM",69,5,2184,2039,145,600,472,128,0.77598537720173,0.245762711864407,1.24034991798797,293,128,165,51,1.3,21.55,3.7,0,0,0,0,0,0,0.22398850796043,192.22588929105,23.216170891251
9.7,"random_policy_SVM","SVM",69,6,2084,1961,123,700,550,150,0.777806580259223,0.254237288135593,1.25123018042646,361,150,211,68,1.4,25.14,3.7,0,0,0,0,0,0,0.225672568775372,188.961417596668,23.4460315006849
9.7,"random_policy_SVM","SVM",69,7,1984,1883,101,800,628,172,0.782352941176471,0.26271186440678,1.24034991798797,409,172,237,48,1.4,28.74,3.7,0,0,0,0,0,0,0.187700202191526,146.028258089507,21.4871624874344
9.7,"random_policy_SVM","SVM",69,8,1884,1809,75,900,702,198,0.77843137254902,0.288135593220339,1.25123018042646,467,198,269,58,1.4,32.33,3.5,0,0,0,0,0,0,0.169129516759339,108.744779819742,20.2219023821235
9.7,"random_policy_SVM","SVM",69,9,1784,1723,61,1000,788,212,0.776204719175807,0.245762711864407,1.24034991798797,514,212,302,47,1.4,35.92,3.7,0,0,0,0,0,0,0.175436435372723,139.622480602347,19.252709766563
9.7,"random_policy_SVM","SVM",69,10,1684,1628,56,1100,883,217,0.792748421402466,0.203389830508475,1.24034991798797,519,217,302,5,1.4,39.51,4.1,0,0,0,0,0,0,0.177210318610149,111.637499624552,19.4924245248613
9.7,"random_policy_SVM","SVM",69,11,1584,1548,36,1200,963,237,0.816144898637427,0.288135593220339,1.24034991798797,577,237,340,58,1.4,43.1,4.1,0,0,0,0,0,0,0.138532781304228,65.1114924165645,17.4643361132325
9.7,"random_policy_SVM","SVM",69,12,1484,1456,28,1300,1055,245,0.812615486872719,0.245762711864407,1.26211044286495,608,245,363,31,1.5,46.7,4.3,0,0,0,0,0,0,0.146833459727547,77.0621000773748,17.5476498486428
9.7,"random_policy_SVM","SVM",69,13,1384,1366,18,1400,1145,255,0.796862745098044,0.220338983050847,1.25123018042646,639,255,384,31,1.5,50.29,4.5,0,0,0,0,0,0,0.150957919427901,81.6024663666368,16.6155909958769
9.7,"random_policy_SVM","SVM",69,14,1284,1269,15,1500,1242,258,0.794124293785319,0.211864406779661,1.22946965554948,657,258,399,18,1.5,53.88,4.8,0,0,0,0,0,0,0.144990803603787,87.9228586521763,16.0270136454973
9.7,"random_policy_SVM","SVM",69,15,1184,1169,15,1600,1342,258,0.780132934529752,0.228813559322034,1.22946965554948,646,258,388,-11,1.5,57.47,5.2,0,0,0,0,0,0,0.112855884599123,56.654621867482,12.654799797501
9.7,"random_policy_SVM","SVM",69,16,1084,1070,14,1700,1441,259,0.794562977733474,0.203389830508475,1.24034991798797,664,259,405,18,1.6,61.06,5.6,0,0,0,0,0,0,0.0511646956910655,18.3588879794712,7.44070367092131
9.7,"random_policy_SVM","SVM",69,17,984,973,11,1800,1538,262,0.784446660019948,0.177966101694915,1.25123018042646,682,262,420,18,1.6,64.66,5.9,0,0,0,0,0,0,0.0625225540291033,21.1473134771766,9.42703617928726
9.7,"random_policy_SVM","SVM",69,18,884,873,11,1900,1638,262,0.797062146892663,0.194915254237288,1.25123018042646,680,262,418,-2,1.6,68.25,6.3,0,0,0,0,0,0,0.0498551577148041,19.728408373699,6.61099302174913
9.7,"random_policy_SVM","SVM",69,19,784,773,11,2000,1738,262,0.792854769026262,0.211864406779661,1.25123018042646,683,262,421,3,1.6,71.84,6.6,0,0,0,0,0,0,0.0220186213241237,8.21921800228717,3.21013036522673
9.7,"random_policy_SVM","SVM",69,20,684,675,9,2100,1836,264,0.780897308075778,0.177966101694915,1.26211044286495,672,264,408,-11,1.5,75.43,7,0,0,0,0,0,0,0.0103280260315954,3.41488528074369,1.62561920648373
9.7,"random_policy_SVM","SVM",69,21,584,578,6,2200,1933,267,0.82576271186441,0.220338983050847,1.27299070530344,713,267,446,41,1.7,79.02,7.2,0,0,0,0,0,0,0.0806621896328899,22.8472544160636,9.38956385419197
9.7,"random_policy_SVM","SVM",69,22,484,481,3,2300,2030,270,0.78718511133267,0.152542372881356,1.27299070530344,709,270,439,-4,1.6,82.61,7.5,0,0,0,0,0,0,0.0260616054987915,8.08721006695704,5.77531519961442
9.7,"random_policy_SVM","SVM",69,23,384,383,1,2400,2128,272,0.801914257228317,0.228813559322034,1.27299070530344,733,272,461,24,1.7,86.21,7.8,0,0,0,0,0,0,0.00111120985767432,0.922448859547142,0.841665179851767
9.7,"random_policy_SVM","SVM",69,24,284,284,0,2500,2227,273,0.788288467929547,0.211864406779661,1.28387096774194,735,273,462,2,1.7,89.8,8.2,0,0,0,0,0,0,0.039280452332251,10.2913585328201,7.83445454973949
9.7,"random_policy_SVM","SVM",69,25,184,184,0,2600,2327,273,0.810342306414093,0.26271186440678,1.28387096774194,751,273,478,16,1.8,93.39,8.5,0,0,0,0,0,0,0.00920975513588243,2.4241071822892,2.08501309808158
9.7,"random_policy_SVM","SVM",69,26,84,84,0,2700,2427,273,0.754483217015622,0.177966101694915,1.27299070530344,767,273,494,16,1.8,96.98,8.9,0,0,0,0,0,0,0.000166599872959562,0.193102480524736,0.193102480524736
9.7,"random_policy_SVM","SVM",69,27,0,0,0,2784,2511,273,0.818963110667998,0.254237288135593,1.28387096774194,746,273,473,-21,1.7,100,9.2,0,0,0,0,0,0,0,0,0
9.7,"random_policy_SVM","SVM",70,0,2684,2451,233,100,89,11,0.756597984298055,0.312925170068027,1.1615975422427,30,11,19,0,1.7,3.59,8.1,0,0,0,0,0,0,0.210631559955811,276.928108231933,39.908437797539
9.7,"random_policy_SVM","SVM",70,1,2584,2375,209,200,165,35,0.829391467662502,0.251700680272109,1.26640333552776,91,35,56,61,1.6,7.18,4.7,0,0,0,0,0,0,0.23121031185527,231.706156863631,31.8480146143572
9.7,"random_policy_SVM","SVM",70,2,2484,2290,194,300,250,50,0.816670488420084,0.319727891156463,1.26640333552776,129,50,79,38,1.6,10.78,5,0,0,0,0,0,0,0.180086720910604,312.989234692037,18.3609638201688
9.7,"random_policy_SVM","SVM",70,3,2384,2210,174,400,330,70,0.817183695307975,0.340136054421769,1.26640333552776,177,70,107,48,1.5,14.37,4.7,0,0,0,0,0,0,0.18908324465953,237.736625451979,19.440185589254
9.7,"random_policy_SVM","SVM",70,4,2284,2137,147,500,403,97,0.824455946102349,0.353741496598639,1.26640333552776,240,97,143,63,1.5,17.96,4.2,0,0,0,0,0,0,0.200405548614394,259.398439896402,20.3061370969424
9.7,"random_policy_SVM","SVM",70,5,2184,2067,117,600,473,127,0.815644074644305,0.353741496598639,1.25766951942067,311,127,184,71,1.4,21.55,3.7,0,0,0,0,0,0,0.217230989197216,243.154631861571,22.0571701516871
9.7,"random_policy_SVM","SVM",70,6,2084,1988,96,700,552,148,0.80476845633919,0.285714285714286,1.25766951942067,363,148,215,52,1.5,25.14,3.7,0,0,0,0,0,0,0.199530776318524,263.008869112155,21.1462003607238
9.7,"random_policy_SVM","SVM",70,7,1984,1910,74,800,630,170,0.819160087791134,0.333333333333333,1.25766951942067,406,170,236,43,1.4,28.74,3.7,0,0,0,0,0,0,0.148442143547676,153.638160491245,17.6873200438335
9.7,"random_policy_SVM","SVM",70,8,1884,1826,58,900,714,186,0.839797556261677,0.333333333333333,1.26640333552776,457,186,271,51,1.5,32.33,3.8,0,0,0,0,0,0,0.161104133152867,147.372539487778,17.8988323377808
9.7,"random_policy_SVM","SVM",70,9,1784,1736,48,1000,804,196,0.83538616088491,0.319727891156463,1.26640333552776,489,196,293,32,1.5,35.92,4.1,0,0,0,0,0,0,0.171929905904269,164.894809724821,18.6180821682769
9.7,"random_policy_SVM","SVM",70,10,1684,1645,39,1100,895,205,0.827360478701912,0.299319727891156,1.26640333552776,501,205,296,12,1.4,39.51,4.4,0,0,0,0,0,0,0.116745622240265,87.6610381470858,13.8385781979069
9.7,"random_policy_SVM","SVM",70,11,1584,1553,31,1200,987,213,0.828010176783398,0.258503401360544,1.26640333552776,544,213,331,43,1.6,43.1,4.6,0,0,0,0,0,0,0.146335868054031,129.974130884173,15.9908250992236
9.7,"random_policy_SVM","SVM",70,12,1484,1459,25,1300,1081,219,0.819394852644104,0.272108843537415,1.26640333552776,561,219,342,17,1.6,46.7,4.9,0,0,0,0,0,0,0.142854648389279,97.0401791559599,15.8570031308769
9.7,"random_policy_SVM","SVM",70,13,1384,1370,14,1400,1170,230,0.812160819383925,0.27891156462585,1.27513715163485,609,230,379,48,1.6,50.29,5.1,0,0,0,0,0,0,0.154951126867516,116.323457044109,16.4182954506503
9.7,"random_policy_SVM","SVM",70,14,1284,1273,11,1500,1267,233,0.821414922309211,0.27891156462585,1.26640333552776,623,233,390,14,1.7,53.88,5.4,0,0,0,0,0,0,0.133900623854888,99.8421327997363,15.2889338557774
9.7,"random_policy_SVM","SVM",70,15,1184,1175,9,1600,1365,235,0.80763477140455,0.26530612244898,1.26640333552776,623,235,388,0,1.7,57.47,5.8,0,0,0,0,0,0,0.117595820424278,86.4436200597605,12.8630390611009
9.7,"random_policy_SVM","SVM",70,16,1084,1076,8,1700,1464,236,0.801034057282627,0.251700680272109,1.26640333552776,646,236,410,23,1.7,61.06,6.2,0,0,0,0,0,0,0.116775083287679,77.2094971979242,12.8999040926279
9.7,"random_policy_SVM","SVM",70,17,984,976,8,1800,1564,236,0.797294198578308,0.238095238095238,1.26640333552776,635,236,399,-11,1.7,64.66,6.6,0,0,0,0,0,0,0.108187702412674,77.8016981538086,11.3829449720409
9.7,"random_policy_SVM","SVM",70,18,884,877,7,1900,1663,237,0.803518197005927,0.210884353741497,1.26640333552776,657,237,420,22,1.8,68.25,7,0,0,0,0,0,0,0.0825634086754275,43.1609952294588,9.07065028686905
9.7,"random_policy_SVM","SVM",70,19,784,780,4,2000,1760,240,0.797021216191118,0.217687074829932,1.27513715163485,666,240,426,9,1.8,71.84,7.3,0,0,0,0,0,0,0.0749355025120921,35.8924936541952,8.61512368495504
9.7,"random_policy_SVM","SVM",70,20,684,681,3,2100,1859,241,0.794635350127196,0.224489795918367,1.27513715163485,670,241,429,4,1.8,75.43,7.7,0,0,0,0,0,0,0.0311518141335632,10.1644896615085,4.57333361368618
9.7,"random_policy_SVM","SVM",70,21,584,582,2,2200,1958,242,0.802437186752698,0.244897959183673,1.27513715163485,671,242,429,1,1.8,79.02,8.1,0,0,0,0,0,0,0.0414857209016121,13.2997786370657,5.20589538979141
9.7,"random_policy_SVM","SVM",70,22,484,482,2,2300,2058,242,0.74003341304418,0.163265306122449,1.27513715163485,676,242,434,5,1.8,82.61,8.5,0,0,0,0,0,0,0.0275891930337902,7.95727581374367,3.74004703179779
9.7,"random_policy_SVM","SVM",70,23,384,384,0,2400,2156,244,0.76322053701095,0.204081632653061,1.26640333552776,679,244,435,3,1.8,86.21,8.8,0,0,0,0,0,0,0.0699300294234675,18.83093996884,11.1672453373119
9.7,"random_policy_SVM","SVM",70,24,284,284,0,2500,2256,244,0.796764612747184,0.258503401360544,1.26640333552776,680,244,436,1,1.8,89.8,9.2,0,0,0,0,0,0,0.0140355551007186,3.68316480765067,2.82223169392691
9.7,"random_policy_SVM","SVM",70,25,184,184,0,2600,2356,244,0.767135104443056,0.204081632653061,1.26640333552776,691,244,447,11,1.8,93.39,9.7,0,0,0,0,0,0,0.00963796263991458,2.34561641954611,1.92520913581808
9.7,"random_policy_SVM","SVM",70,26,84,84,0,2700,2456,244,0.753578799095875,0.224489795918367,1.27513715163485,687,244,443,-4,1.8,96.98,10.1,0,0,0,0,0,0,4.6776115581409e-06,0.661914039903352,0.661914039903352
9.7,"random_policy_SVM","SVM",70,27,0,0,0,2784,2540,244,0.75390637796049,0.163265306122449,1.27513715163485,691,244,447,4,1.8,100,10.4,0,0,0,0,0,0,0,0,0
9.7,"random_policy_SVM","SVM",71,0,2684,2429,255,100,92,8,0.832466650197633,0.2890625,1.28387096774194,25,8,17,0,2.1,3.59,11.5,0,0,0,0,0,0,0.164010624339156,225.173331902042,19.5649737162104
9.7,"random_policy_SVM","SVM",71,1,2584,2351,233,200,170,30,0.829712203557311,0.296875,1.28387096774194,83,30,53,58,1.8,7.18,5.7,0,0,0,0,0,0,0.176328614982261,352.359737266024,17.8550809081682
9.7,"random_policy_SVM","SVM",71,2,2484,2288,196,300,233,67,0.823480731225296,0.3125,1.28387096774194,167,67,100,84,1.5,10.78,3.5,0,0,0,0,0,0,0.247069880911096,415.957737785085,25.2705749935933
9.7,"random_policy_SVM","SVM",71,3,2384,2213,171,400,308,92,0.825487895256918,0.28125,1.28387096774194,221,92,129,54,1.4,14.37,3.3,0,0,0,0,0,0,0.249226612157301,310.586545880256,25.5573430011602
9.7,"random_policy_SVM","SVM",71,4,2284,2151,133,500,370,130,0.829749258893281,0.2578125,1.28387096774194,302,130,172,81,1.3,17.96,2.8,0,0,0,0,0,0,0.275737184403022,287.002459594937,28.1212481805344
9.7,"random_policy_SVM","SVM",71,5,2184,2077,107,600,444,156,0.829545454545455,0.265625,1.28387096774194,367,156,211,65,1.4,21.55,2.8,0,0,0,0,0,0,0.260628927156837,281.750842941778,26.6562668681977
9.7,"random_policy_SVM","SVM",71,6,2084,1999,85,700,522,178,0.830854743083004,0.2734375,1.28387096774194,420,178,242,53,1.4,25.14,2.9,0,0,0,0,0,0,0.237024940773366,174.903729205283,25.0451056667821
9.7,"random_policy_SVM","SVM",71,7,1984,1912,72,800,609,191,0.828940217391305,0.2734375,1.28387096774194,458,191,267,38,1.4,28.74,3.2,0,0,0,0,0,0,0.229784955073269,231.295992889474,24.1007978546149
9.7,"random_policy_SVM","SVM",71,8,1884,1830,54,900,691,209,0.810542243083004,0.1796875,1.28387096774194,496,209,287,38,1.4,32.33,3.3,0,0,0,0,0,0,0.234907964123799,203.181050745254,27.5448288024408
9.7,"random_policy_SVM","SVM",71,9,1784,1740,44,1000,781,219,0.831793478260871,0.265625,1.28387096774194,526,219,307,30,1.4,35.92,3.6,0,0,0,0,0,0,0.188253260401705,132.596703791841,20.4508305858641
9.7,"random_policy_SVM","SVM",71,10,1684,1653,31,1100,868,232,0.824468873517786,0.265625,1.28387096774194,558,232,326,32,1.4,39.51,3.7,0,0,0,0,0,0,0.188791641177593,111.341345628058,20.6399701249412
9.7,"random_policy_SVM","SVM",71,11,1584,1556,28,1200,965,235,0.826692193675891,0.265625,1.28387096774194,577,235,342,19,1.5,43.1,4.1,0,0,0,0,0,0,0.122029558786322,50.1552988138131,14.5957788609567
9.7,"random_policy_SVM","SVM",71,12,1484,1460,24,1300,1061,239,0.825358201581027,0.234375,1.28387096774194,589,239,350,12,1.5,46.7,4.4,0,0,0,0,0,0,0.0911147808218422,35.6815328698055,12.2932871138523
9.7,"random_policy_SVM","SVM",71,13,1384,1369,15,1400,1152,248,0.824048913043479,0.2109375,1.28387096774194,624,248,376,35,1.5,50.29,4.6,0,0,0,0,0,0,0.107076775092432,41.2266447229933,15.2498702911231
9.7,"random_policy_SVM","SVM",71,14,1284,1275,9,1500,1246,254,0.824382411067194,0.2109375,1.28387096774194,637,254,383,13,1.5,53.88,4.9,0,0,0,0,0,0,0.0663350906202788,23.1744865577054,8.59099596840037
9.7,"random_policy_SVM","SVM",71,15,1184,1177,7,1600,1344,256,0.819762845849802,0.2109375,1.28387096774194,642,256,386,5,1.5,57.47,5.2,0,0,0,0,0,0,0.0698721040276141,22.3855146662079,9.43208984469216
9.7,"random_policy_SVM","SVM",71,16,1084,1078,6,1700,1443,257,0.811209239130434,0.25,1.28387096774194,648,257,391,6,1.5,61.06,5.6,0,0,0,0,0,0,0.0527717918846713,15.8332359688714,7.75012894479756
9.7,"random_policy_SVM","SVM",71,17,984,980,4,1800,1541,259,0.812042984189725,0.2421875,1.28387096774194,679,259,420,31,1.6,64.66,5.9,0,0,0,0,0,0,0.049712171123318,17.0461573395482,7.42195602614677
9.7,"random_policy_SVM","SVM",71,18,884,881,3,1900,1640,260,0.792514822134391,0.2109375,1.28387096774194,675,260,415,-4,1.6,68.25,6.3,0,0,0,0,0,0,0.0391864477524593,12.4004901981816,6.71430165003249
9.7,"random_policy_SVM","SVM",71,19,784,782,2,2000,1739,261,0.801482213438738,0.1796875,1.28387096774194,688,261,427,13,1.6,71.84,6.7,0,0,0,0,0,0,0.0449435594403502,16.2253690321719,7.94969737538502
9.7,"random_policy_SVM","SVM",71,20,684,682,2,2100,1839,261,0.816038784584983,0.234375,1.28387096774194,685,261,424,-3,1.6,75.43,7,0,0,0,0,0,0,0.025026506429562,8.32607977603166,3.84803613513032
9.7,"random_policy_SVM","SVM",71,21,584,582,2,2200,1939,261,0.793237401185771,0.21875,1.28387096774194,685,261,424,0,1.6,79.02,7.4,0,0,0,0,0,0,0.0123265269906148,3.51404807769892,1.93112773828958
9.7,"random_policy_SVM","SVM",71,22,484,482,2,2300,2039,261,0.778378211462452,0.15625,1.28387096774194,686,261,425,1,1.6,82.61,7.8,0,0,0,0,0,0,0.00940249181822975,2.4721680303268,1.41053819572277
9.7,"random_policy_SVM","SVM",71,23,384,382,2,2400,2139,261,0.770800395256919,0.1796875,1.28387096774194,692,261,431,6,1.7,86.21,8.2,0,0,0,0,0,0,0.00432099225984632,1.03673419889024,0.726216058072417
9.7,"random_policy_SVM","SVM",71,24,284,284,0,2500,2237,263,0.750271739130433,0.1640625,1.27384072580645,705,263,442,13,1.7,89.8,8.5,0,0,0,0,0,0,0.0127875412560827,5.5977955226389,4.94375848489184
9.7,"random_policy_SVM","SVM",71,25,184,184,0,2600,2337,263,0.78731472332016,0.203125,1.28387096774194,712,263,449,7,1.7,93.39,8.9,0,0,0,0,0,0,0.00362781671479493,1.16924561684335,1.13561410645464
9.7,"random_policy_SVM","SVM",71,26,84,84,0,2700,2437,263,0.746282114624503,0.1328125,1.27384072580645,709,263,446,-3,1.7,96.98,9.3,0,0,0,0,0,0,8.87491144968765e-13,0.0233816595846471,0.0233816595846471
9.7,"random_policy_SVM","SVM",71,27,0,0,0,2784,2521,263,0.763938982213439,0.15625,1.27384072580645,706,263,443,-3,1.7,100,9.6,0,0,0,0,0,0,0,0,0
9.7,"random_policy_SVM","SVM",72,0,2684,2435,249,100,92,8,0.765082451128004,0.402985074626866,1.16889744824266,23,8,15,0,1.9,3.59,11.5,0,0,0,0,0,0,0.183956310791592,237.801719544191,20.7890209908655
9.7,"random_policy_SVM","SVM",72,1,2584,2369,215,200,158,42,0.759300202719527,0.156716417910448,1.25397185343998,103,42,61,80,1.5,7.18,3.8,0,0,0,0,0,0,0.351826485592111,369.241379086242,43.5777222731011
9.7,"random_policy_SVM","SVM",72,2,2484,2282,202,300,245,55,0.833574383839346,0.291044776119403,1.28387096774194,143,55,88,40,1.6,10.78,4.5,0,0,0,0,0,0,0.200678638950953,394.925244276454,20.7911052348719
9.7,"random_policy_SVM","SVM",72,3,2384,2199,185,400,328,72,0.825323343568109,0.291044776119403,1.25512758786712,191,72,119,48,1.7,14.37,4.6,0,0,0,0,0,0,0.186884183119201,342.228032253618,19.0588478108937
9.7,"random_policy_SVM","SVM",72,4,2284,2123,161,500,404,96,0.817919931715534,0.23134328358209,1.26470871449206,252,96,156,61,1.6,17.96,4.2,0,0,0,0,0,0,0.204344006765785,304.478226136745,21.5844505529113
9.7,"random_policy_SVM","SVM",72,5,2184,2041,143,600,486,114,0.818447476675407,0.276119402985075,1.26470871449206,297,114,183,45,1.6,21.55,4.3,0,0,0,0,0,0,0.195508760570072,258.18787384002,20.1187137432304
9.7,"random_policy_SVM","SVM",72,6,2084,1962,122,700,565,135,0.826817066375832,0.253731343283582,1.26470871449206,346,135,211,49,1.6,25.14,4.2,0,0,0,0,0,0,0.192895658035291,221.410951970578,19.7482141487455
9.7,"random_policy_SVM","SVM",72,7,1984,1893,91,800,634,166,0.821197823432486,0.238805970149254,1.274289841117,423,166,257,77,1.5,28.74,3.8,0,0,0,0,0,0,0.211040154694955,236.015110120364,21.5985854543039
9.7,"random_policy_SVM","SVM",72,8,1884,1815,69,900,712,188,0.827060092705659,0.253731343283582,1.274289841117,481,188,293,58,1.6,32.33,3.8,0,0,0,0,0,0,0.20922050496104,236.656320176651,21.3186475932502
9.7,"random_policy_SVM","SVM",72,9,1784,1737,47,1000,790,210,0.826988963048149,0.261194029850746,1.274289841117,543,210,333,62,1.6,35.92,3.8,0,0,0,0,0,0,0.200552828173274,174.924277563362,20.6434413706766
9.7,"random_policy_SVM","SVM",72,10,1684,1654,30,1100,873,227,0.815869026590643,0.276119402985075,1.26470871449206,582,227,355,39,1.6,39.51,3.8,0,0,0,0,0,0,0.197337936174418,188.603391874074,20.7673503491612
9.7,"random_policy_SVM","SVM",72,11,1584,1564,20,1200,963,237,0.823782200988709,0.23134328358209,1.26470871449206,616,237,379,34,1.6,43.1,4.1,0,0,0,0,0,0,0.184543510320051,174.978800467776,19.1261707307988
9.7,"random_policy_SVM","SVM",72,12,1484,1468,16,1300,1059,241,0.795994214787861,0.23134328358209,1.26470871449206,638,241,397,22,1.6,46.7,4.4,0,0,0,0,0,0,0.142738716338669,82.875431707545,15.7086011246167
9.7,"random_policy_SVM","SVM",72,13,1384,1368,16,1400,1159,241,0.814031510438283,0.276119402985075,1.26470871449206,640,241,399,2,1.7,50.29,4.8,0,0,0,0,0,0,0.130937679306375,95.0499298032444,14.1292190132411
9.7,"random_policy_SVM","SVM",72,14,1284,1271,13,1500,1256,244,0.821553471720037,0.261194029850746,1.274289841117,648,244,404,8,1.7,53.88,5.1,0,0,0,0,0,0,0.129362828489217,87.6880823904476,14.7376725870898
9.7,"random_policy_SVM","SVM",72,15,1184,1174,10,1600,1353,247,0.814487925740641,0.253731343283582,1.26470871449206,670,247,423,22,1.7,57.47,5.5,0,0,0,0,0,0,0.134707055700623,77.1217143127739,15.253166523343
9.7,"random_policy_SVM","SVM",72,16,1084,1076,8,1700,1451,249,0.780019679205249,0.208955223880597,1.274289841117,697,249,448,27,1.8,61.06,5.8,0,0,0,0,0,0,0.117566903873019,68.4691408075298,13.7523093845161
9.7,"random_policy_SVM","SVM",72,17,984,977,7,1800,1550,250,0.801465270944724,0.201492537313433,1.28387096774194,691,250,441,-6,1.8,64.66,6.2,0,0,0,0,0,0,0.111219893432312,70.5127834190155,11.8554954484593
9.7,"random_policy_SVM","SVM",72,18,884,879,5,1900,1648,252,0.775858594240871,0.186567164179104,1.28387096774194,723,252,471,32,1.9,68.25,6.5,0,0,0,0,0,0,0.12541360631036,63.7770164864568,13.9537959828468
9.7,"random_policy_SVM","SVM",72,19,784,781,3,2000,1746,254,0.728154303937029,0.156716417910448,1.274289841117,723,254,469,0,1.8,71.84,6.9,0,0,0,0,0,0,0.109939759989299,55.348043962467,12.2043871133524
9.7,"random_policy_SVM","SVM",72,20,684,682,2,2100,1845,255,0.756612094412767,0.223880597014925,1.28387096774194,735,255,480,12,1.9,75.43,7.2,0,0,0,0,0,0,0.0996563488601821,46.316555207317,11.1831003526719
9.7,"random_policy_SVM","SVM",72,21,584,583,1,2200,1944,256,0.788904958922626,0.238805970149254,1.274289841117,731,256,475,-4,1.9,79.02,7.6,0,0,0,0,0,0,0.0681842172443832,24.9988529712509,7.89695025191135
9.7,"random_policy_SVM","SVM",72,22,484,483,1,2300,2044,256,0.796314298246656,0.223880597014925,1.28387096774194,746,256,490,15,1.9,82.61,8,0,0,0,0,0,0,0.0560953437290835,18.1758708984248,6.66799009378621
9.7,"random_policy_SVM","SVM",72,23,384,384,0,2400,2143,257,0.768135098929501,0.186567164179104,1.274289841117,734,257,477,-12,1.9,86.21,8.3,0,0,0,0,0,0,0.0197429706910813,10.9255301723883,9.43369352190438
9.7,"random_policy_SVM","SVM",72,24,284,284,0,2500,2243,257,0.780144156105889,0.216417910447761,1.28387096774194,736,257,479,2,1.9,89.8,8.7,0,0,0,0,0,0,0.00328680980497732,1.09332740721401,1.02719754605174
9.7,"random_policy_SVM","SVM",72,25,184,184,0,2600,2343,257,0.783179021493014,0.223880597014925,1.274289841117,739,257,482,3,1.9,93.39,9.1,0,0,0,0,0,0,9.66426759759207e-07,0.172563003780197,0.172553123017674
9.7,"random_policy_SVM","SVM",72,26,84,84,0,2700,2443,257,0.748005405853973,0.156716417910448,1.28387096774194,722,257,465,-17,1.8,96.98,9.5,0,0,0,0,0,0,8.59597945513135e-09,0.0270603324013694,0.0270603324013694
9.7,"random_policy_SVM","SVM",72,27,0,0,0,2784,2527,257,0.764003651322422,0.17910447761194,1.274289841117,724,257,467,2,1.8,100,9.8,0,0,0,0,0,0,0,0,0
9.7,"random_policy_SVM","SVM",73,0,2684,2422,262,100,94,6,0.777895141156136,0.268292682926829,1.16905323891949,17,6,11,0,1.8,3.59,15.7,0,0,0,0,0,0,0.100766834096552,132.63394313404,23.6452244156541
9.7,"random_policy_SVM","SVM",73,1,2584,2343,241,200,173,27,0.82353882593944,0.317073170731707,1.28387096774194,73,27,46,56,1.7,7.18,6.4,0,0,0,0,0,0,0.188499146202817,169.372654114814,19.9641712004502
9.7,"random_policy_SVM","SVM",73,2,2484,2272,212,300,244,56,0.814858203700145,0.268292682926829,1.24211906635195,144,56,88,71,1.6,10.78,4.4,0,0,0,0,0,0,0.216044771784189,126.677854196815,22.7191169910532
9.7,"random_policy_SVM","SVM",73,3,2384,2194,190,400,322,78,0.805479802829525,0.276422764227642,1.23168109100446,198,78,120,54,1.5,14.37,4.1,0,0,0,0,0,0,0.213663174553618,121.674413772971,22.4092446569543
9.7,"random_policy_SVM","SVM",73,4,2284,2117,167,500,399,101,0.810972408936697,0.32520325203252,1.25255704169945,251,101,150,53,1.5,17.96,4,0,0,0,0,0,0,0.211821309435128,147.461571673621,25.9328967700492
9.7,"random_policy_SVM","SVM",73,5,2184,2053,131,600,463,137,0.828717751744447,0.300813008130081,1.25255704169945,328,137,191,77,1.4,21.55,3.4,0,0,0,0,0,0,0.242850170044341,188.877691114401,34.9659797676408
9.7,"random_policy_SVM","SVM",73,6,2084,1980,104,700,536,164,0.774931182382691,0.170731707317073,1.23168109100446,399,164,235,71,1.4,25.14,3.3,0,0,0,0,0,0,0.270365486471545,292.174032807715,40.8790382553349
9.7,"random_policy_SVM","SVM",73,7,1984,1882,102,800,634,166,0.813084949747134,0.211382113821138,1.28387096774194,408,166,242,9,1.5,28.74,3.8,0,0,0,0,0,0,0.228791147617787,227.048629147093,27.0817226253093
9.7,"random_policy_SVM","SVM",73,8,1884,1800,84,900,716,184,0.830791882721993,0.276422764227642,1.26299501704694,440,184,256,32,1.4,32.33,3.9,0,0,0,0,0,0,0.207405537251087,179.696038664846,22.1758237971612
9.7,"random_policy_SVM","SVM",73,9,1784,1719,65,1000,797,203,0.832059407208253,0.341463414634146,1.24211906635195,484,203,281,44,1.4,35.92,3.9,0,0,0,0,0,0,0.176852928263891,131.385106007717,19.1533281077889
9.7,"random_policy_SVM","SVM",73,10,1684,1634,50,1100,882,218,0.830292554894061,0.333333333333333,1.24211906635195,534,218,316,50,1.4,39.51,4,0,0,0,0,0,0,0.174100371639839,87.2318435522784,19.4873165495019
9.7,"random_policy_SVM","SVM",73,11,1584,1542,42,1200,974,226,0.810306638499461,0.276422764227642,1.24211906635195,567,226,341,33,1.5,43.1,4.3,0,0,0,0,0,0,0.149185134025434,77.339062340611,18.0597973458527
9.7,"random_policy_SVM","SVM",73,12,1484,1446,38,1300,1070,230,0.810850777799126,0.260162601626016,1.24097531030559,583,230,353,16,1.5,46.7,4.7,0,0,0,0,0,0,0.171044677287665,76.2436073781536,18.214143359253
9.7,"random_policy_SVM","SVM",73,13,1384,1362,22,1400,1154,246,0.815440752832734,0.292682926829268,1.24211906635195,627,246,381,44,1.5,50.29,4.7,0,0,0,0,0,0,0.149679873545339,70.8969575642909,16.8528043811754
9.7,"random_policy_SVM","SVM",73,14,1284,1267,17,1500,1249,251,0.811452531848163,0.276422764227642,1.23168109100446,643,251,392,16,1.6,53.88,5,0,0,0,0,0,0,0.105102753597926,40.7386452006716,13.1085723272118
9.7,"random_policy_SVM","SVM",73,15,1184,1167,17,1600,1349,251,0.82077971960823,0.308943089430894,1.23168109100446,646,251,395,3,1.6,57.47,5.4,0,0,0,0,0,0,0.0687527674125701,26.9924813975978,8.50452436156986
9.7,"random_policy_SVM","SVM",73,16,1084,1068,16,1700,1448,252,0.797247295307607,0.227642276422764,1.23168109100446,657,252,405,11,1.6,61.06,5.7,0,0,0,0,0,0,0.0594142591438033,23.2864650502228,7.42823752139385
9.7,"random_policy_SVM","SVM",73,17,984,969,15,1800,1547,253,0.797426541194548,0.292682926829268,1.20036716496197,682,253,429,25,1.7,64.66,6.1,0,0,0,0,0,0,0.0997657413438854,34.8639389422963,13.2129953078769
9.7,"random_policy_SVM","SVM",73,18,884,870,14,1900,1646,254,0.785634722488966,0.252032520325203,1.21080514030947,677,254,423,-5,1.7,68.25,6.5,0,0,0,0,0,0,0.0691867815351774,23.8947461876194,9.05262272477155
9.7,"random_policy_SVM","SVM",73,19,784,770,14,2000,1746,254,0.790007041802709,0.276422764227642,1.20036716496197,682,254,428,5,1.7,71.84,6.9,0,0,0,0,0,0,0.0680229018739585,29.9201945804736,8.01309141289858
9.7,"random_policy_SVM","SVM",73,20,684,672,12,2100,1844,256,0.749516676269129,0.235772357723577,1.20036716496197,683,256,427,1,1.7,75.43,7.2,0,0,0,0,0,0,0.0868699008756487,32.4221338436688,15.2480534377971
9.7,"random_policy_SVM","SVM",73,21,584,572,12,2200,1944,256,0.73982459509635,0.138211382113821,1.20036716496197,687,256,431,4,1.7,79.02,7.6,0,0,0,0,0,0,0.0334539138262219,9.77863332168085,4.70413329848744
9.7,"random_policy_SVM","SVM",73,22,484,474,10,2300,2042,258,0.760828372063258,0.219512195121951,1.18992918961448,694,258,436,7,1.7,82.61,7.9,0,0,0,0,0,0,0.0398405340693416,10.7867596555805,5.65203377208152
9.7,"random_policy_SVM","SVM",73,23,384,374,10,2400,2142,258,0.777997567377259,0.24390243902439,1.20036716496197,691,258,433,-3,1.7,86.21,8.3,0,0,0,0,0,0,0.0129934747797798,3.31757333551613,2.19127122617919
9.7,"random_policy_SVM","SVM",73,24,284,275,9,2500,2241,259,0.752794315344737,0.235772357723577,1.20036716496197,696,259,437,5,1.7,89.8,8.7,0,0,0,0,0,0,0.00878279945302897,2.22245881830408,1.636239882518
9.7,"random_policy_SVM","SVM",73,25,184,176,8,2600,2340,260,0.730337366365796,0.195121951219512,1.20036716496197,695,260,435,-1,1.7,93.39,9,0,0,0,0,0,0,1.26667323081165e-05,0.486604741064656,0.486250101288802
9.7,"random_policy_SVM","SVM",73,26,84,80,4,2700,2436,264,0.752947954676403,0.211382113821138,1.24211906635195,723,264,459,28,1.7,96.98,9.2,0,0,0,0,0,0,4.96584899356679e-10,0.744988473701365,0.744988473701365
9.7,"random_policy_SVM","SVM",73,27,0,0,0,2784,2516,268,0.786153255233344,0.219512195121951,1.27343299239444,755,268,487,32,1.8,100,9.4,0,0,0,0,0,0,0,0,0
9.7,"random_policy_SVM","SVM",74,0,2684,2436,248,100,90,10,0.760651629072687,0.330827067669173,1.22595197671598,32,10,22,0,2.2,3.59,9,0,0,0,0,0,0,0.116712668439825,276.505814757635,12.2512360675907
9.7,"random_policy_SVM","SVM",74,1,2584,2364,220,200,162,38,0.703795202291443,0.278195488721804,1.18733931603202,99,38,61,67,1.6,7.18,4.3,0,0,0,0,0,0,0.222105668514329,452.32712154818,23.9825637208552
9.7,"random_policy_SVM","SVM",74,2,2484,2291,193,300,235,65,0.753067191788994,0.195488721804511,1.22595197671598,162,65,97,63,1.5,10.78,3.6,0,0,0,0,0,0,0.218010530598163,534.844231822283,21.9053108221378
9.7,"random_policy_SVM","SVM",74,3,2384,2203,181,400,323,77,0.77367227592792,0.240601503759398,1.24525830705797,197,77,120,35,1.6,14.37,4.2,0,0,0,0,0,0,0.204765467222737,356.277560714084,21.1132233071369
9.7,"random_policy_SVM","SVM",74,4,2284,2116,168,500,410,90,0.805412340374752,0.293233082706767,1.24525830705797,233,90,143,36,1.6,17.96,4.6,0,0,0,0,0,0,0.182967108277125,274.61576530627,18.7269024502819
9.7,"random_policy_SVM","SVM",74,5,2184,2049,135,600,477,123,0.8124119823368,0.323308270676692,1.24525830705797,311,123,188,78,1.5,21.55,3.9,0,0,0,0,0,0,0.211117221013389,290.792120316603,21.8230574244142
9.7,"random_policy_SVM","SVM",74,6,2084,1982,102,700,544,156,0.811182718701518,0.285714285714286,1.24525830705797,377,156,221,66,1.4,25.14,3.5,0,0,0,0,0,0,0.223186913399767,302.152910266369,23.3808296780897
9.7,"random_policy_SVM","SVM",74,7,1984,1910,74,800,616,184,0.819435493495654,0.308270676691729,1.25491147222896,445,184,261,68,1.4,28.74,3.3,0,0,0,0,0,0,0.221101227672305,285.830313991784,23.0471484249241
9.7,"random_policy_SVM","SVM",74,8,1884,1821,63,900,705,195,0.814285714285723,0.300751879699248,1.25491147222896,477,195,282,32,1.4,32.33,3.6,0,0,0,0,0,0,0.195255992736136,229.684998366268,20.452613678092
9.7,"random_policy_SVM","SVM",74,9,1784,1726,58,1000,800,200,0.817120181405902,0.293233082706767,1.25491147222896,486,200,286,9,1.4,35.92,4,0,0,0,0,0,0,0.162031312963165,158.546800233727,17.1298108667331
9.7,"random_policy_SVM","SVM",74,10,1684,1632,52,1100,894,206,0.82819548872181,0.293233082706767,1.25491147222896,519,206,313,33,1.5,39.51,4.3,0,0,0,0,0,0,0.146842640855401,100.442642640944,16.5033459377724
9.7,"random_policy_SVM","SVM",74,11,1584,1544,40,1200,982,218,0.827085571070537,0.300751879699248,1.24525830705797,549,218,331,30,1.5,43.1,4.5,0,0,0,0,0,0,0.148777518406828,103.862199807966,16.1857301695173
9.7,"random_policy_SVM","SVM",74,12,1484,1450,34,1300,1076,224,0.82093925289414,0.263157894736842,1.24525830705797,573,224,349,24,1.6,46.7,4.8,0,0,0,0,0,0,0.137455805912617,93.3257321043709,15.1550956634772
9.7,"random_policy_SVM","SVM",74,13,1384,1359,25,1400,1167,233,0.812602935911206,0.270676691729323,1.24525830705797,601,233,368,28,1.6,50.29,5,0,0,0,0,0,0,0.137672466157139,95.5389459132972,14.7823673122393
9.7,"random_policy_SVM","SVM",74,14,1284,1263,21,1500,1263,237,0.807471058598877,0.218045112781955,1.24525830705797,629,237,392,28,1.7,53.88,5.3,0,0,0,0,0,0,0.123987704265138,64.8468170723177,13.7268254439253
9.7,"random_policy_SVM","SVM",74,15,1184,1165,19,1600,1361,239,0.807632175677287,0.270676691729323,1.24525830705797,650,239,411,21,1.7,57.47,5.7,0,0,0,0,0,0,0.126827862076184,92.1837880750495,13.3504156776577
9.7,"random_policy_SVM","SVM",74,16,1084,1066,18,1700,1460,240,0.815884950471416,0.293233082706767,1.24525830705797,646,240,406,-4,1.7,61.06,6.1,0,0,0,0,0,0,0.0944836542029813,55.3503747547747,10.8251809097419
9.7,"random_policy_SVM","SVM",74,17,984,967,17,1800,1559,241,0.82533118510562,0.315789473684211,1.24525830705797,661,241,420,15,1.7,64.66,6.5,0,0,0,0,0,0,0.0770769649226835,39.640678918471,8.59884991849418
9.7,"random_policy_SVM","SVM",74,18,884,867,17,1900,1659,241,0.809738632295022,0.255639097744361,1.24525830705797,640,241,399,-21,1.7,68.25,6.9,0,0,0,0,0,0,0.0705669554471609,34.4173518271901,7.97052670733919
9.7,"random_policy_SVM","SVM",74,19,784,767,17,2000,1759,241,0.836179735051915,0.323308270676692,1.24525830705797,661,241,420,21,1.7,71.84,7.3,0,0,0,0,0,0,0.0278994691008456,9.69820681739326,3.53247766259614
9.7,"random_policy_SVM","SVM",74,20,684,669,15,2100,1857,243,0.830988184747585,0.338345864661654,1.24525830705797,664,243,421,3,1.7,75.43,7.6,0,0,0,0,0,0,0.0277468618913879,8.58375440224784,4.00216198828062
9.7,"random_policy_SVM","SVM",74,21,584,569,15,2200,1957,243,0.812960973863232,0.263157894736842,1.24525830705797,649,243,406,-15,1.7,79.02,8.1,0,0,0,0,0,0,0.0222702846922656,6.7596236814969,3.0868577567361
9.7,"random_policy_SVM","SVM",74,22,484,469,15,2300,2057,243,0.841305645065046,0.330827067669173,1.24525830705797,651,243,408,2,1.7,82.61,8.5,0,0,0,0,0,0,0.0161674552209519,4.74013858628011,2.26489486515048
9.7,"random_policy_SVM","SVM",74,23,384,372,12,2400,2154,246,0.761964434896771,0.180451127819549,1.23560514188698,686,246,440,35,1.8,86.21,8.8,0,0,0,0,0,0,0.0231584691593305,6.70694459827968,3.52593795427656
9.7,"random_policy_SVM","SVM",74,24,284,272,12,2500,2254,246,0.818880534670013,0.300751879699248,1.24525830705797,666,246,420,-20,1.7,89.8,9.2,0,0,0,0,0,0,0.00596142541162061,1.52660223266831,1.01399975817348
9.7,"random_policy_SVM","SVM",74,25,184,175,9,2600,2351,249,0.804654493376305,0.24812030075188,1.26456463739995,709,249,460,43,1.8,93.39,9.4,0,0,0,0,0,0,0.00371712366952654,3.14050738542814,3.03476217134404
9.7,"random_policy_SVM","SVM",74,26,84,84,0,2700,2442,258,0.806468552333221,0.263157894736842,1.27421780257094,742,258,484,33,1.9,96.98,9.5,0,0,0,0,0,0,1.44127096932111e-05,0.270509834410472,0.270509834410472
9.7,"random_policy_SVM","SVM",74,27,0,0,0,2784,2526,258,0.792284282133912,0.24812030075188,1.27421780257094,729,258,471,-13,1.8,100,9.8,0,0,0,0,0,0,0,0,0
9.7,"random_policy_SVM","SVM",75,0,2684,2447,237,100,84,16,0.798775910849364,0.326086956521739,1.20014025245442,36,16,20,0,1.2,3.59,5.2,0,0,0,0,0,0,0.38505500568569,426.791505983714,40.9887309005556
9.7,"random_policy_SVM","SVM",75,1,2584,2381,203,200,150,50,0.736578324383631,0.166666666666667,1.25134746676249,115,50,65,79,1.3,7.18,3,0,0,0,0,0,0,0.5852462432456,609.317170475687,67.0033151929154
9.7,"random_policy_SVM","SVM",75,2,2484,2297,187,300,234,66,0.757156879727471,0.173913043478261,1.25596072931276,153,66,87,38,1.3,10.78,3.5,0,0,0,0,0,0,0.238237998113502,518.105567290378,25.0482499896892
9.7,"random_policy_SVM","SVM",75,3,2384,2210,174,400,321,79,0.76030948669092,0.210144927536232,1.22805049088359,193,79,114,40,1.4,14.37,4.1,0,0,0,0,0,0,0.214989318635807,315.740258262827,22.9631205026716
9.7,"random_policy_SVM","SVM",75,4,2284,2129,155,500,402,98,0.789456666089266,0.311594202898551,1.22805049088359,240,98,142,47,1.4,17.96,4.1,0,0,0,0,0,0,0.205460059920465,278.190017070808,21.2826732470523
9.7,"random_policy_SVM","SVM",75,5,2184,2056,128,600,475,125,0.81231017957157,0.304347826086957,1.24665731650304,309,125,184,69,1.5,21.55,3.8,0,0,0,0,0,0,0.213553217499954,241.607816404854,21.7991301453246
9.7,"random_policy_SVM","SVM",75,6,2084,1988,96,700,543,157,0.812933772157747,0.297101449275362,1.23735390369331,386,157,229,77,1.5,25.14,3.5,0,0,0,0,0,0,0.225531574969097,234.228267898833,23.1403722919562
9.7,"random_policy_SVM","SVM",75,7,1984,1916,68,800,615,185,0.811455626768289,0.289855072463768,1.22805049088359,449,185,264,63,1.4,28.74,3.3,0,0,0,0,0,0,0.222309093272585,209.197102639818,23.0205058406192
9.7,"random_policy_SVM","SVM",75,8,1884,1839,45,900,692,208,0.798337086436863,0.260869565217391,1.21874707807387,506,208,298,57,1.4,32.33,3.3,0,0,0,0,0,0,0.221953753959641,246.115855248628,23.0242607490551
9.7,"random_policy_SVM","SVM",75,9,1784,1747,37,1000,784,216,0.80970032911831,0.289855072463768,1.22805049088359,537,216,321,31,1.5,35.92,3.6,0,0,0,0,0,0,0.192455618962185,138.343541997954,20.2741378524796
9.7,"random_policy_SVM","SVM",75,10,1684,1657,27,1100,874,226,0.807061608637915,0.27536231884058,1.21874707807387,578,226,352,41,1.6,39.51,3.9,0,0,0,0,0,0,0.177804207590766,132.664645891139,18.928172598726
9.7,"random_policy_SVM","SVM",75,11,1584,1560,24,1200,971,229,0.80356256134881,0.311594202898551,1.20944366526414,580,229,351,2,1.5,43.1,4.2,0,0,0,0,0,0,0.154667284245472,114.568658208587,16.4333403584635
9.7,"random_policy_SVM","SVM",75,12,1484,1461,23,1300,1070,230,0.80048501645592,0.282608695652174,1.21874707807387,583,230,353,3,1.5,46.7,4.7,0,0,0,0,0,0,0.153863867473518,86.4483678579996,16.5617818523892
9.7,"random_policy_SVM","SVM",75,13,1384,1361,23,1400,1170,230,0.800184768173684,0.260869565217391,1.21874707807387,577,230,347,-6,1.5,50.29,5.1,0,0,0,0,0,0,0.140994311055759,70.837993087321,15.1247998508617
9.7,"random_policy_SVM","SVM",75,14,1284,1263,21,1500,1268,232,0.778214677521798,0.260869565217391,1.21874707807387,601,232,369,24,1.6,53.88,5.5,0,0,0,0,0,0,0.145888524735453,65.2609563072689,16.1295085554539
9.7,"random_policy_SVM","SVM",75,15,1184,1165,19,1600,1366,234,0.791852878341709,0.304347826086957,1.21874707807387,620,234,386,19,1.6,57.47,5.8,0,0,0,0,0,0,0.116150669107863,41.3043148496679,13.7494527109529
9.7,"random_policy_SVM","SVM",75,16,1084,1065,19,1700,1466,234,0.780775448928923,0.217391304347826,1.21762484319535,620,234,386,0,1.6,61.06,6.3,0,0,0,0,0,0,0.0785108816558806,20.4770284119001,9.45976310347075
9.7,"random_policy_SVM","SVM",75,17,984,966,18,1800,1565,235,0.785010681910042,0.253623188405797,1.21874707807387,609,235,374,-11,1.6,64.66,6.7,0,0,0,0,0,0,0.0450998983801969,10.5080523483658,6.72867891004173
9.7,"random_policy_SVM","SVM",75,18,884,867,17,1900,1664,236,0.807783359316359,0.282608695652174,1.22805049088359,617,236,381,8,1.6,68.25,7.1,0,0,0,0,0,0,0.0112518229238775,3.35767588114907,2.63966054997836
9.7,"random_policy_SVM","SVM",75,19,784,769,15,2000,1762,238,0.815780356833537,0.333333333333333,1.22805049088359,630,238,392,13,1.6,71.84,7.4,0,0,0,0,0,0,0.000976300450841377,0.584755830136364,0.513510746828397
9.7,"random_policy_SVM","SVM",75,20,684,675,9,2100,1856,244,0.789468214100121,0.217391304347826,1.27456755493221,642,244,398,12,1.6,75.43,7.6,0,0,0,0,0,0,0.0283477510341686,9.17948116164469,5.0384718925132
9.7,"random_policy_SVM","SVM",75,21,584,581,3,2200,1950,250,0.809036318494141,0.239130434782609,1.28387096774194,672,250,422,30,1.7,79.02,7.8,0,0,0,0,0,0,0.102925387691958,34.3651454901614,12.375009930782
9.7,"random_policy_SVM","SVM",75,22,484,482,2,2300,2049,251,0.807569721115538,0.22463768115942,1.28387096774194,676,251,425,4,1.7,82.61,8.2,0,0,0,0,0,0,0.0659264766381609,18.1726358841679,9.27040468187635
9.7,"random_policy_SVM","SVM",75,23,384,382,2,2400,2149,251,0.821225243951731,0.27536231884058,1.28387096774194,670,251,419,-6,1.7,86.21,8.6,0,0,0,0,0,0,0.0347129979451645,8.44249824476839,4.90013766380101
9.7,"random_policy_SVM","SVM",75,24,284,283,1,2500,2248,252,0.816282695305736,0.318840579710145,1.27456755493221,688,252,436,18,1.7,89.8,8.9,0,0,0,0,0,0,0.0473640968705844,11.8749372174781,7.95521674624489
9.7,"random_policy_SVM","SVM",75,25,184,183,1,2600,2348,252,0.785172354062016,0.202898550724638,1.27456755493221,688,252,436,0,1.7,93.39,9.3,0,0,0,0,0,0,0.0264672426492027,6.07425742164406,4.65018340870516
9.7,"random_policy_SVM","SVM",75,26,84,84,0,2700,2447,253,0.78814596685721,0.217391304347826,1.27456755493221,689,253,436,1,1.7,96.98,9.7,0,0,0,0,0,0,7.78261746304155e-05,2.51467695164442,2.51467695164442
9.7,"random_policy_SVM","SVM",75,27,0,0,0,2784,2531,253,0.807558173104684,0.202898550724638,1.28387096774194,688,253,435,-1,1.7,100,10,0,0,0,0,0,0,0,0,0
9.7,"random_policy_SVM","SVM",76,0,2684,2429,255,100,89,11,0.828050473186118,0.336,1.24278709677419,26,11,15,0,1.4,3.59,8.1,0,0,0,0,0,0,0.266906762598003,267.228984115867,30.2130044306382
9.7,"random_policy_SVM","SVM",76,1,2584,2362,222,200,156,44,0.756902208201894,0.16,1.23251612903226,102,44,58,76,1.3,7.18,3.5,0,0,0,0,0,0,0.267749622995365,464.358463176196,30.0782734270434
9.7,"random_policy_SVM","SVM",76,2,2484,2277,207,300,241,59,0.813400630914835,0.288,1.26332903225806,139,59,80,37,1.4,10.78,4.1,0,0,0,0,0,0,0.220579446476515,338.462916697347,23.089894252018
9.7,"random_policy_SVM","SVM",76,3,2384,2199,185,400,319,81,0.792744479495277,0.264,1.19143225806452,193,81,112,54,1.4,14.37,3.9,0,0,0,0,0,0,0.209733369648258,251.827081929508,26.127888880752
9.7,"random_policy_SVM","SVM",76,4,2284,2125,159,500,393,107,0.82466246056783,0.312,1.23251612903226,251,107,144,58,1.3,17.96,3.7,0,0,0,0,0,0,0.233070629733708,205.646859846345,23.9056897770476
9.7,"random_policy_SVM","SVM",76,5,2184,2061,123,600,457,143,0.820914826498427,0.304,1.23251612903226,324,143,181,73,1.3,21.55,3.2,0,0,0,0,0,0,0.275440464694464,171.143320130698,28.3759433050368
9.7,"random_policy_SVM","SVM",76,6,2084,1987,97,700,531,169,0.816744479495273,0.312,1.23251612903226,399,169,230,75,1.4,25.14,3.1,0,0,0,0,0,0,0.255404288834622,147.357486650473,26.6539318583229
9.7,"random_policy_SVM","SVM",76,7,1984,1901,83,800,617,183,0.818511041009469,0.344,1.23251612903226,442,183,259,43,1.4,28.74,3.4,0,0,0,0,0,0,0.22038882347891,149.304281697136,23.3886675265788
9.7,"random_policy_SVM","SVM",76,8,1884,1815,69,900,703,197,0.812725552050483,0.288,1.23251612903226,475,197,278,33,1.4,32.33,3.6,0,0,0,0,0,0,0.188595157848804,108.956371523643,20.9902962108852
9.7,"random_policy_SVM","SVM",76,9,1784,1722,62,1000,796,204,0.808365930599375,0.264,1.23251612903226,494,204,290,19,1.4,35.92,3.9,0,0,0,0,0,0,0.167414393985632,78.9259390398224,18.5692851728093
9.7,"random_policy_SVM","SVM",76,10,1684,1638,46,1100,880,220,0.82056151419559,0.288,1.23251612903226,542,220,322,48,1.5,39.51,4,0,0,0,0,0,0,0.173065720153627,86.8233560321548,19.0391969553613
9.7,"random_policy_SVM","SVM",76,11,1584,1543,41,1200,975,225,0.817432176656158,0.256,1.23251612903226,568,225,343,26,1.5,43.1,4.3,0,0,0,0,0,0,0.167470491437326,83.5707707011368,18.1409040315577
9.7,"random_policy_SVM","SVM",76,12,1484,1450,34,1300,1068,232,0.794908517350168,0.296,1.22224516129032,586,232,354,18,1.5,46.7,4.6,0,0,0,0,0,0,0.161937157528727,95.1405642078162,17.4237730918797
9.7,"random_policy_SVM","SVM",76,13,1384,1357,27,1400,1161,239,0.796921135646702,0.256,1.21197419354839,620,239,381,34,1.6,50.29,4.9,0,0,0,0,0,0,0.147084471980764,80.2470601012152,16.0081128101065
9.7,"random_policy_SVM","SVM",76,14,1284,1258,26,1500,1260,240,0.787520504731873,0.248,1.21197419354839,620,240,380,0,1.6,53.88,5.2,0,0,0,0,0,0,0.111248176646486,46.2901190770121,12.4346537657195
9.7,"random_policy_SVM","SVM",76,15,1184,1159,25,1600,1359,241,0.744687697160889,0.144,1.21197419354839,628,241,387,8,1.6,57.47,5.6,0,0,0,0,0,0,0.147060815057059,65.4907814971955,16.1394241621344
9.7,"random_policy_SVM","SVM",76,16,1084,1060,24,1700,1458,242,0.790126182965307,0.24,1.21197419354839,636,242,394,8,1.6,61.06,6,0,0,0,0,0,0,0.102878924651624,32.3659083745701,11.8809931969727
9.7,"random_policy_SVM","SVM",76,17,984,961,23,1800,1557,243,0.789211356466885,0.264,1.21197419354839,635,243,392,-1,1.6,64.66,6.4,0,0,0,0,0,0,0.0830302713661238,22.4153687862459,9.91878788291045
9.7,"random_policy_SVM","SVM",76,18,884,862,22,1900,1656,244,0.731034700315461,0.136,1.21197419354839,647,244,403,12,1.7,68.25,6.8,0,0,0,0,0,0,0.0477057998999268,9.92289160769607,6.42785474785468
9.7,"random_policy_SVM","SVM",76,19,784,764,20,2000,1754,246,0.780132492113566,0.224,1.21197419354839,658,246,412,11,1.7,71.84,7.1,0,0,0,0,0,0,0.0146722559813514,4.40013629752095,3.51904758959047
9.7,"random_policy_SVM","SVM",76,20,684,673,11,2100,1845,255,0.786044164037863,0.192,1.22224516129032,671,255,416,13,1.6,75.43,7.2,0,0,0,0,0,0,0.0100482333597134,3.62891372155079,2.65702259602424
9.7,"random_policy_SVM","SVM",76,21,584,581,3,2200,1937,263,0.738069400630915,0.12,1.26216574585635,703,263,440,32,1.7,79.02,7.4,0,0,0,0,0,0,0.178809345819351,65.2576317612242,29.7899239499875
9.7,"random_policy_SVM","SVM",76,22,484,481,3,2300,2037,263,0.766403785488961,0.176,1.26332903225806,700,263,437,-3,1.7,82.61,7.7,0,0,0,0,0,0,0.0487581009505333,14.145702837944,6.88302931632664
9.7,"random_policy_SVM","SVM",76,23,384,383,1,2400,2135,265,0.781785488958998,0.208,1.24278709677419,707,265,442,7,1.7,86.21,8.1,0,0,0,0,0,0,0.0362124045895127,9.82247874871948,6.48884868143767
9.7,"random_policy_SVM","SVM",76,24,284,284,0,2500,2234,266,0.781545741324926,0.216,1.25305806451613,724,266,458,17,1.7,89.8,8.4,0,0,0,0,0,0,0.0196728062137679,4.54984998415607,3.60749611919355
9.7,"random_policy_SVM","SVM",76,25,184,184,0,2600,2334,266,0.775034700315462,0.184,1.24278709677419,705,266,439,-19,1.7,93.39,8.8,0,0,0,0,0,0,1.29494008216408e-06,0.498511833929982,0.49848906087676
9.7,"random_policy_SVM","SVM",76,26,84,84,0,2700,2434,266,0.79280757097792,0.208,1.24278709677419,709,266,443,4,1.7,96.98,9.2,0,0,0,0,0,0,3.85965234985522e-11,0.126378528293268,0.126378528293268
9.7,"random_policy_SVM","SVM",76,27,0,0,0,2784,2518,266,0.757179810725559,0.176,1.25305806451613,723,266,457,14,1.7,100,9.5,0,0,0,0,0,0,0,0,0
9.7,"random_policy_SVM","SVM",77,0,2684,2424,260,100,92,8,0.799334229562776,0.276422764227642,1.25255704169945,23,8,15,0,1.9,3.59,11.5,0,0,0,0,0,0,0.148833112605967,189.436924653875,18.1917845060971
9.7,"random_policy_SVM","SVM",77,1,2584,2346,238,200,170,30,0.604724409448821,0.146341463414634,1.10642538683451,79,30,49,56,1.6,7.18,5.7,0,0,0,0,0,0,0.300319918095865,340.723579920058,59.0342403282899
9.7,"random_policy_SVM","SVM",77,2,2484,2263,221,300,253,47,0.766064912617638,0.211382113821138,1.21080514030947,131,47,84,52,1.8,10.78,5.4,0,0,0,0,0,0,0.187845660068526,278.163324781716,19.99250510653
9.7,"random_policy_SVM","SVM",77,3,2384,2189,195,400,327,73,0.741469816272971,0.195121951219512,1.20036716496197,180,73,107,49,1.5,14.37,4.5,0,0,0,0,0,0,0.199726808908412,260.123437485153,21.795334628361
9.7,"random_policy_SVM","SVM",77,4,2284,2119,165,500,397,103,0.751513987580821,0.24390243902439,1.20036716496197,250,103,147,70,1.4,17.96,3.9,0,0,0,0,0,0,0.206758924282968,284.417147645333,21.3408187803505
9.7,"random_policy_SVM","SVM",77,5,2184,2050,134,600,466,134,0.766647461750212,0.227642276422764,1.24211906635195,316,134,182,66,1.4,21.55,3.5,0,0,0,0,0,0,0.205267758598175,149.292136413076,22.086008697094
9.7,"random_policy_SVM","SVM",77,6,2084,1977,107,700,539,161,0.772012035080988,0.227642276422764,1.24211906635195,364,161,203,48,1.3,25.14,3.3,0,0,0,0,0,0,0.21322302463215,203.130254907134,23.9829331695078
9.7,"random_policy_SVM","SVM",77,7,1984,1893,91,800,623,177,0.764822994686654,0.219512195121951,1.25255704169945,410,177,233,46,1.3,28.74,3.5,0,0,0,0,0,0,0.20669494579422,156.404741857695,27.5228698523022
9.7,"random_policy_SVM","SVM",77,8,1884,1813,71,900,703,197,0.785429870046744,0.24390243902439,1.25255704169945,463,197,266,53,1.4,32.33,3.6,0,0,0,0,0,0,0.187968351153127,129.084801571374,20.6362752029405
9.7,"random_policy_SVM","SVM",77,9,1784,1736,48,1000,780,220,0.783234107931634,0.211382113821138,1.25255704169945,529,220,309,66,1.4,35.92,3.5,0,0,0,0,0,0,0.196799137591549,138.0869992808,22.3322643034733
9.7,"random_policy_SVM","SVM",77,10,1684,1645,39,1100,871,229,0.79101850073619,0.235772357723577,1.24211906635195,553,229,324,24,1.4,39.51,3.8,0,0,0,0,0,0,0.156488018892758,87.1275488095885,17.6410096064981
9.7,"random_policy_SVM","SVM",77,11,1584,1553,31,1200,963,237,0.785692337238344,0.24390243902439,1.25255704169945,572,237,335,19,1.4,43.1,4.1,0,0,0,0,0,0,0.181582804789741,191.749284251122,18.81614448823
9.7,"random_policy_SVM","SVM",77,12,1484,1460,24,1300,1056,244,0.783336534152747,0.227642276422764,1.25255704169945,600,244,356,28,1.5,46.7,4.3,0,0,0,0,0,0,0.152405430083254,112.864241951228,16.6748881243044
9.7,"random_policy_SVM","SVM",77,13,1384,1362,22,1400,1154,246,0.784104730811097,0.227642276422764,1.25255704169945,616,246,370,16,1.5,50.29,4.7,0,0,0,0,0,0,0.123391364453999,71.5368488174612,13.6697842895238
9.7,"random_policy_SVM","SVM",77,14,1284,1267,17,1500,1249,251,0.774707125024018,0.211382113821138,1.25255704169945,639,251,388,23,1.5,53.88,5,0,0,0,0,0,0,0.13453520971865,66.720443397355,15.3028962277349
9.7,"random_policy_SVM","SVM",77,15,1184,1174,10,1600,1342,258,0.782632353882605,0.227642276422764,1.25255704169945,653,258,395,14,1.5,57.47,5.2,0,0,0,0,0,0,0.153218874394407,148.667124105897,15.7875935876487
9.7,"random_policy_SVM","SVM",77,16,1084,1078,6,1700,1438,262,0.764925420907764,0.203252032520325,1.25255704169945,672,262,410,19,1.6,61.06,5.5,0,0,0,0,0,0,0.0756926005852284,31.8215294584415,9.35481851030885
9.7,"random_policy_SVM","SVM",77,17,984,979,5,1800,1537,263,0.784149542282835,0.219512195121951,1.25255704169945,674,263,411,2,1.6,64.66,5.8,0,0,0,0,0,0,0.040411694539603,13.6702775786817,5.70968830281353
9.7,"random_policy_SVM","SVM",77,18,884,882,2,1900,1634,266,0.779687600025615,0.227642276422764,1.25255704169945,702,266,436,28,1.6,68.25,6.1,0,0,0,0,0,0,0.0281838543965035,8.34873132634961,4.30085059582948
9.7,"random_policy_SVM","SVM",77,19,784,784,0,2000,1732,268,0.754093848025098,0.178861788617886,1.25255704169945,700,268,432,-2,1.6,71.84,6.5,0,0,0,0,0,0,0.0467482764815466,17.6267024197445,6.03600331295037
9.7,"random_policy_SVM","SVM",77,20,684,684,0,2100,1832,268,0.765283912681654,0.195121951219512,1.25255704169945,698,268,430,-2,1.6,75.43,6.8,0,0,0,0,0,0,0.0167455990147279,5.13499197505995,2.46436299287038
9.7,"random_policy_SVM","SVM",77,21,584,584,0,2200,1932,268,0.773260354650798,0.203252032520325,1.25255704169945,697,268,429,-1,1.6,79.02,7.2,0,0,0,0,0,0,0.00793519752745799,2.18013967796485,1.35891520461746
9.7,"random_policy_SVM","SVM",77,22,484,484,0,2300,2032,268,0.774995198770888,0.186991869918699,1.25255704169945,703,268,435,6,1.6,82.61,7.6,0,0,0,0,0,0,1.02576783003505e-05,0.304865259746976,0.30427489362164
9.7,"random_policy_SVM","SVM",77,23,384,384,0,2400,2132,268,0.786927853530509,0.211382113821138,1.26299501704694,709,268,441,6,1.6,86.21,8,0,0,0,0,0,0,0.0135305348622237,4.06309854888478,1.85679738474349
9.7,"random_policy_SVM","SVM",77,24,284,284,0,2500,2232,268,0.756750528135205,0.186991869918699,1.25255704169945,709,268,441,0,1.6,89.8,8.3,0,0,0,0,0,0,3.33642163527707e-07,0.0218650483854986,0.0218489313368696
9.7,"random_policy_SVM","SVM",77,25,184,184,0,2600,2332,268,0.757173036297293,0.203252032520325,1.26299501704694,724,268,456,15,1.7,93.39,8.7,0,0,0,0,0,0,2.04900889735155e-11,6.33451373128025e-07,6.32994962612698e-07
9.7,"random_policy_SVM","SVM",77,26,84,84,0,2700,2432,268,0.772588182574742,0.186991869918699,1.26299501704694,711,268,443,-13,1.7,96.98,9.1,0,0,0,0,0,0,9.510855990641e-13,5.32530898998015e-06,5.32530898998015e-06
9.7,"random_policy_SVM","SVM",77,27,0,0,0,2784,2516,268,0.781928173612447,0.195121951219512,1.26299501704694,725,268,457,14,1.7,100,9.4,0,0,0,0,0,0,0,0,0
9.7,"random_policy_SVM","SVM",78,0,2684,2428,256,100,90,10,0.80617665615142,0.256,1.26332903225806,27,10,17,0,1.7,3.59,9,0,0,0,0,0,0,0.15119121312521,247.609384627756,15.8808772611779
9.7,"random_policy_SVM","SVM",78,1,2584,2363,221,200,155,45,0.786050473186125,0.192,1.25305806451613,107,45,62,80,1.4,7.18,3.4,0,0,0,0,0,0,0.251488521999094,555.751734473843,28.0166188855902
9.7,"random_policy_SVM","SVM",78,2,2484,2283,201,300,235,65,0.828201892744491,0.296,1.26332903225806,162,65,97,55,1.5,10.78,3.6,0,0,0,0,0,0,0.285918065499482,323.719537048408,30.9921480205073
9.7,"random_policy_SVM","SVM",78,3,2384,2213,171,400,305,95,0.80240378548897,0.208,1.2736,224,95,129,62,1.4,14.37,3.2,0,0,0,0,0,0,0.26905480684834,407.539213285043,32.7724619321156
9.7,"random_policy_SVM","SVM",78,4,2284,2131,153,500,387,113,0.828504731861203,0.232,1.26332903225806,270,113,157,46,1.4,17.96,3.4,0,0,0,0,0,0,0.241494436743818,302.031300514799,24.686879929101
9.7,"random_policy_SVM","SVM",78,5,2184,2061,123,600,457,143,0.822119873817045,0.272,1.26332903225806,353,143,210,83,1.5,21.55,3.2,0,0,0,0,0,0,0.246476442596161,285.964357627002,24.9395204627499
9.7,"random_policy_SVM","SVM",78,6,2084,1987,97,700,531,169,0.819192429022096,0.272,1.2736,418,169,249,65,1.5,25.14,3.1,0,0,0,0,0,0,0.245985448775736,272.157697692077,24.9106042352919
9.7,"random_policy_SVM","SVM",78,7,1984,1916,68,800,602,198,0.820845425867527,0.288,1.2736,477,198,279,59,1.4,28.74,3,0,0,0,0,0,0,0.240373932789696,189.353536914893,25.1353014845274
9.7,"random_policy_SVM","SVM",78,8,1884,1832,52,900,686,214,0.817835962145129,0.28,1.2736,511,214,297,34,1.4,32.33,3.2,0,0,0,0,0,0,0.19230465309853,109.567261404576,21.5438228543012
9.7,"random_policy_SVM","SVM",78,9,1784,1742,42,1000,776,224,0.823488958990541,0.272,1.26332903225806,552,224,328,41,1.5,35.92,3.5,0,0,0,0,0,0,0.203161695561546,147.974780206422,21.5046889430129
9.7,"random_policy_SVM","SVM",78,10,1684,1657,27,1100,861,239,0.811305993690856,0.2,1.26332903225806,601,239,362,49,1.5,39.51,3.6,0,0,0,0,0,0,0.176229691089449,82.1707391424944,19.738325437015
9.7,"random_policy_SVM","SVM",78,11,1584,1565,19,1200,953,247,0.801299684542584,0.16,1.26332903225806,624,247,377,23,1.5,43.1,3.9,0,0,0,0,0,0,0.178822023496681,126.280683725825,19.1090414522229
9.7,"random_policy_SVM","SVM",78,12,1484,1468,16,1300,1050,250,0.80763406940063,0.208,1.26332903225806,623,250,373,-1,1.5,46.7,4.2,0,0,0,0,0,0,0.157077851387544,115.798423853756,16.8704148495557
9.7,"random_policy_SVM","SVM",78,13,1384,1370,14,1400,1148,252,0.739091482649844,0.088,1.26332903225806,649,252,397,26,1.6,50.29,4.6,0,0,0,0,0,0,0.209397647812914,125.424478552124,23.5175659450434
9.7,"random_policy_SVM","SVM",78,14,1284,1270,14,1500,1248,252,0.784656151419557,0.168,1.26332903225806,653,252,401,4,1.6,53.88,5,0,0,0,0,0,0,0.149419666272987,83.9037775697513,16.2096525367431
9.7,"random_policy_SVM","SVM",78,15,1184,1172,12,1600,1346,254,0.764441640378546,0.16,1.26332903225806,648,254,394,-5,1.6,57.47,5.3,0,0,0,0,0,0,0.145969875116573,65.8455929089678,16.1387045454005
9.7,"random_policy_SVM","SVM",78,16,1084,1072,12,1700,1446,254,0.789324921135643,0.2,1.26332903225806,672,254,418,24,1.6,61.06,5.7,0,0,0,0,0,0,0.133664204957612,65.4369054622744,14.4150699737462
9.7,"random_policy_SVM","SVM",78,17,984,975,9,1800,1543,257,0.778460567823341,0.192,1.26332903225806,681,257,424,9,1.6,64.66,6,0,0,0,0,0,0,0.0894491214895562,29.6917208858118,10.3934457858944
9.7,"random_policy_SVM","SVM",78,18,884,877,7,1900,1641,259,0.769192429022082,0.152,1.26332903225806,691,259,432,10,1.7,68.25,6.3,0,0,0,0,0,0,0.0719385681936612,19.4385305528944,8.48793016976902
9.7,"random_policy_SVM","SVM",78,19,784,778,6,2000,1740,260,0.779369085173504,0.176,1.26332903225806,684,260,424,-7,1.6,71.84,6.7,0,0,0,0,0,0,0.0411529532381157,10.5998460350653,5.79766469337497
9.7,"random_policy_SVM","SVM",78,20,684,679,5,2100,1839,261,0.759381703470039,0.144,1.26332903225806,701,261,440,17,1.7,75.43,7,0,0,0,0,0,0,0.0839593070709231,36.8314869921273,10.5359818417919
9.7,"random_policy_SVM","SVM",78,21,584,583,1,2200,1935,265,0.755753943217675,0.144,1.26332903225806,699,265,434,-2,1.6,79.02,7.3,0,0,0,0,0,0,0.115034287486238,38.1543292170462,13.3635572469189
9.7,"random_policy_SVM","SVM",78,22,484,484,0,2300,2034,266,0.769791798107261,0.176,1.26332903225806,716,266,450,17,1.7,82.61,7.6,0,0,0,0,0,0,0.0478270222999511,13.0927380224373,6.76480115738952
9.7,"random_policy_SVM","SVM",78,23,384,384,0,2400,2134,266,0.78258675078865,0.184,1.26332903225806,711,266,445,-5,1.7,86.21,8,0,0,0,0,0,0,0.0259867636691316,6.59688816511887,3.9946929979884
9.7,"random_policy_SVM","SVM",78,24,284,284,0,2500,2234,266,0.764473186119881,0.184,1.26332903225806,728,266,462,17,1.7,89.8,8.4,0,0,0,0,0,0,0.00669964776714209,1.75765896236876,1.43666953698423
9.7,"random_policy_SVM","SVM",78,25,184,184,0,2600,2334,266,0.787160883280761,0.24,1.26332903225806,717,266,451,-11,1.7,93.39,8.8,0,0,0,0,0,0,0.00316888163070075,0.723007250631791,0.677917377613671
9.7,"random_policy_SVM","SVM",78,26,84,84,0,2700,2434,266,0.797034700315466,0.16,1.2736,718,266,452,1,1.7,96.98,9.2,0,0,0,0,0,0,1.41152848561943e-10,0.00270370998741593,0.00270370998741593
9.7,"random_policy_SVM","SVM",78,27,0,0,0,2784,2518,266,0.78620820189275,0.184,1.26332903225806,724,266,458,6,1.7,100,9.5,0,0,0,0,0,0,0,0,0
9.7,"random_policy_SVM","SVM",79,0,2684,2418,266,100,94,6,0.735333693917131,0.176470588235294,1.24071564109515,22,6,16,0,2.7,3.59,15.7,0,0,0,0,0,0,0.0768711902233321,175.662636585931,7.88273962682642
9.7,"random_policy_SVM","SVM",79,1,2584,2344,240,200,168,32,0.780364893210036,0.151260504201681,1.26229330441854,77,32,45,55,1.4,7.18,5.2,0,0,0,0,0,0,0.287739793771684,269.689299568773,33.4474690223313
9.7,"random_policy_SVM","SVM",79,2,2484,2260,224,300,252,48,0.654175956096726,0.142857142857143,1.18677148278666,124,48,76,47,1.6,10.78,5.2,0,0,0,0,0,0,0.201904690065905,335.240133752319,22.2805672328411
9.7,"random_policy_SVM","SVM",79,3,2384,2182,202,400,330,70,0.765774441644794,0.126050420168067,1.25150447275684,178,70,108,54,1.5,14.37,4.7,0,0,0,0,0,0,0.358319047293779,221.305804292925,76.1680908674903
9.7,"random_policy_SVM","SVM",79,4,2284,2099,185,500,413,87,0.784236771631735,0.184873949579832,1.25150447275684,213,87,126,35,1.4,17.96,4.7,0,0,0,0,0,0,0.196334862345747,219.634245353812,20.4089509760518
9.7,"random_policy_SVM","SVM",79,5,2184,2035,149,600,477,123,0.780575966650401,0.176470588235294,1.26229330441854,296,123,173,83,1.4,21.55,3.9,0,0,0,0,0,0,0.212062035715804,158.94182047974,22.5809911105841
9.7,"random_policy_SVM","SVM",79,6,2084,1962,122,700,550,150,0.777970528870892,0.168067226890756,1.26229330441854,346,150,196,50,1.3,25.14,3.7,0,0,0,0,0,0,0.217634708342723,188.369912977588,23.2073348549858
9.7,"random_policy_SVM","SVM",79,7,1984,1878,106,800,634,166,0.760042478529875,0.210084033613445,1.25150447275684,394,166,228,48,1.4,28.74,3.8,0,0,0,0,0,0,0.186223093212126,137.01764884114,20.0441837282315
9.7,"random_policy_SVM","SVM",79,8,1884,1792,92,900,720,180,0.79832592377611,0.184873949579832,1.26229330441854,420,180,240,26,1.3,32.33,4,0,0,0,0,0,0,0.186852314875962,128.407013604324,23.1459188492593
9.7,"random_policy_SVM","SVM",79,9,1784,1722,62,1000,790,210,0.784790839412695,0.151260504201681,1.24071564109515,525,210,315,105,1.5,35.92,3.8,0,0,0,0,0,0,0.21109938865331,200.049426898008,21.8503741167285
9.7,"random_policy_SVM","SVM",79,10,1684,1635,49,1100,877,223,0.799031700592331,0.176470588235294,1.25150447275684,541,223,318,16,1.4,39.51,3.9,0,0,0,0,0,0,0.196191077498353,145.203401581971,20.5430754670683
9.7,"random_policy_SVM","SVM",79,11,1584,1557,27,1200,955,245,0.777251559964651,0.159663865546218,1.25150447275684,606,245,361,65,1.5,43.1,3.9,0,0,0,0,0,0,0.205857400221244,133.055527837453,21.3184748683686
9.7,"random_policy_SVM","SVM",79,12,1484,1465,19,1300,1047,253,0.778201390446295,0.210084033613445,1.25150447275684,634,253,381,28,1.5,46.7,4.1,0,0,0,0,0,0,0.179067291861157,107.293692030248,19.4229978953142
9.7,"random_policy_SVM","SVM",79,13,1384,1368,16,1400,1144,256,0.786321121855342,0.184873949579832,1.25150447275684,643,256,387,9,1.5,50.29,4.5,0,0,0,0,0,0,0.150588129032949,94.9973199576538,16.6447644723714
9.7,"random_policy_SVM","SVM",79,14,1284,1270,14,1500,1242,258,0.770965529068774,0.176470588235294,1.26229330441854,664,258,406,21,1.6,53.88,4.8,0,0,0,0,0,0,0.138345840598139,72.2617095590693,15.4849851503127
9.7,"random_policy_SVM","SVM",79,15,1184,1172,12,1600,1340,260,0.751612733005295,0.184873949579832,1.24071564109515,684,260,424,20,1.6,57.47,5.2,0,0,0,0,0,0,0.147520581186796,85.3711676935497,16.0956143546783
9.7,"random_policy_SVM","SVM",79,16,1084,1073,11,1700,1439,261,0.777620938485291,0.19327731092437,1.24071564109515,680,261,419,-4,1.6,61.06,5.5,0,0,0,0,0,0,0.123858268667646,62.9567004409592,13.864327600212
9.7,"random_policy_SVM","SVM",79,17,984,974,10,1800,1538,262,0.753690487183889,0.184873949579832,1.24071564109515,674,262,412,-6,1.6,64.66,5.9,0,0,0,0,0,0,0.111712300184765,62.6649235828575,12.4017319215682
9.7,"random_policy_SVM","SVM",79,18,884,875,9,1900,1637,263,0.765372082899097,0.19327731092437,1.24071564109515,699,263,436,25,1.7,68.25,6.2,0,0,0,0,0,0,0.0670910854760404,27.2008708002111,8.12827435271728
9.7,"random_policy_SVM","SVM",79,19,784,777,7,2000,1735,265,0.771519596849735,0.176470588235294,1.26229330441854,718,265,453,19,1.7,71.84,6.5,0,0,0,0,0,0,0.0786193998715969,33.8745512791362,10.4285129537658
9.7,"random_policy_SVM","SVM",79,20,684,679,5,2100,1833,267,0.775681701251934,0.218487394957983,1.27308213608024,707,267,440,-11,1.6,75.43,6.9,0,0,0,0,0,0,0.0941015415902858,44.4253105907169,10.2589236567468
9.7,"random_policy_SVM","SVM",79,21,584,582,2,2200,1930,270,0.750814611558912,0.159663865546218,1.27308213608024,718,270,448,11,1.7,79.02,7.1,0,0,0,0,0,0,0.0533678529667899,17.3312981422603,7.9607518547217
9.7,"random_policy_SVM","SVM",79,22,484,483,1,2300,2029,271,0.751461023970031,0.142857142857143,1.27308213608024,722,271,451,4,1.7,82.61,7.5,0,0,0,0,0,0,0.0178014101093696,5.33475020973933,3.61149907669924
9.7,"random_policy_SVM","SVM",79,23,384,383,1,2400,2129,271,0.772034088360623,0.184873949579832,1.27308213608024,735,271,464,13,1.7,86.21,7.9,0,0,0,0,0,0,0.0144456157515213,4.09684292452007,2.47096065859815
9.7,"random_policy_SVM","SVM",79,24,284,283,1,2500,2229,271,0.738295318127253,0.126050420168067,1.27308213608024,737,271,466,2,1.7,89.8,8.2,0,0,0,0,0,0,0.0106834257314795,2.65029273032073,1.78077194511228
9.7,"random_policy_SVM","SVM",79,25,184,183,1,2600,2329,271,0.783550782950547,0.184873949579832,1.28387096774194,736,271,465,-1,1.7,93.39,8.6,0,0,0,0,0,0,0.0032139607161971,0.966261092131655,0.909848880264566
9.7,"random_policy_SVM","SVM",79,26,84,84,0,2700,2428,272,0.753631122778785,0.134453781512605,1.27308213608024,743,272,471,7,1.7,96.98,8.9,0,0,0,0,0,0,1.18567631935765e-09,2.70277183576497,2.70277183576497
9.7,"random_policy_SVM","SVM",79,27,0,0,0,2784,2512,272,0.724760233763837,0.126050420168067,1.27308213608024,748,272,476,5,1.8,100,9.2,0,0,0,0,0,0,0,0,0
9.7,"random_policy_SVM","SVM",80,0,2684,2447,237,100,88,12,0.628747706060501,0.0985915492957746,1.10304407087687,33,12,21,0,1.8,3.59,7.3,0,0,0,0,0,0,0.296795177911918,325.744583928941,80.1635641707819
9.7,"random_policy_SVM","SVM",80,1,2584,2363,221,200,172,28,0.777344321725725,0.204225352112676,1.24770558836892,78,28,50,45,1.8,7.18,6.1,0,0,0,0,0,0,0.14418108737121,345.086600705484,14.674556581571
9.7,"random_policy_SVM","SVM",80,2,2484,2281,203,300,254,46,0.800480742166827,0.274647887323944,1.26578827805543,126,46,80,48,1.7,10.78,5.5,0,0,0,0,0,0,0.213760956470207,205.724269277021,28.9258123855959
9.7,"random_policy_SVM","SVM",80,3,2384,2198,186,400,337,63,0.823825446684898,0.28169014084507,1.27482962289868,166,63,103,40,1.6,14.37,5.3,0,0,0,0,0,0,0.185364708272128,194.664032184724,19.2434572926682
9.7,"random_policy_SVM","SVM",80,4,2284,2121,163,500,414,86,0.812150279776181,0.295774647887324,1.24770558836892,220,86,134,54,1.6,17.96,4.8,0,0,0,0,0,0,0.187424803144216,213.772296373577,20.3382145870548
9.7,"random_policy_SVM","SVM",80,5,2184,2051,133,600,484,116,0.820166402089592,0.295774647887324,1.25674693321218,286,116,170,66,1.5,21.55,4.2,0,0,0,0,0,0,0.204715089676044,181.341734528107,20.9464397621249
9.7,"random_policy_SVM","SVM",80,6,2084,1979,105,700,556,144,0.824619177897113,0.316901408450704,1.25674693321218,350,144,206,64,1.4,25.14,3.9,0,0,0,0,0,0,0.208563239865345,141.032232696632,21.462261250249
9.7,"random_policy_SVM","SVM",80,7,1984,1905,79,800,630,170,0.820391574064698,0.330985915492958,1.25674693321218,411,170,241,61,1.4,28.74,3.7,0,0,0,0,0,0,0.214648733750266,207.975210397175,21.894829478729
9.7,"random_policy_SVM","SVM",80,8,1884,1828,56,900,707,193,0.814019207169483,0.316901408450704,1.25674693321218,493,193,300,82,1.6,32.33,3.7,0,0,0,0,0,0,0.206820130317749,135.847242260935,21.6776054677166
9.7,"random_policy_SVM","SVM",80,9,1784,1738,46,1000,797,203,0.81098501480506,0.288732394366197,1.25674693321218,512,203,309,19,1.5,35.92,3.9,0,0,0,0,0,0,0.182230571017348,132.150514633877,19.3464820817089
9.7,"random_policy_SVM","SVM",80,10,1684,1644,40,1100,891,209,0.819108093806644,0.309859154929577,1.24770558836892,544,209,335,32,1.6,39.51,4.3,0,0,0,0,0,0,0.152203485254288,107.876200053718,16.7068197315956
9.7,"random_policy_SVM","SVM",80,11,1584,1546,38,1200,989,211,0.820397203364069,0.309859154929577,1.24770558836892,542,211,331,-2,1.6,43.1,4.7,0,0,0,0,0,0,0.11517761362054,79.2506791687077,13.0299082881672
9.7,"random_policy_SVM","SVM",80,12,1484,1453,31,1300,1082,218,0.824624807196502,0.309859154929577,1.24770558836892,563,218,345,21,1.6,46.7,5,0,0,0,0,0,0,0.13313790533164,63.0023928842077,16.6019969823022
9.7,"random_policy_SVM","SVM",80,13,1384,1365,19,1400,1170,230,0.815572893797647,0.295774647887324,1.25674693321218,592,230,362,29,1.6,50.29,5.1,0,0,0,0,0,0,0.101568345910755,48.8721168093701,12.3794296843868
9.7,"random_policy_SVM","SVM",80,14,1284,1268,16,1500,1267,233,0.808722036455352,0.26056338028169,1.24770558836892,618,233,385,26,1.7,53.88,5.4,0,0,0,0,0,0,0.0982511118473038,49.3067585640351,11.9462617784948
9.7,"random_policy_SVM","SVM",80,15,1184,1169,15,1600,1366,234,0.788450929397335,0.197183098591549,1.23866424352567,617,234,383,-1,1.6,57.47,5.8,0,0,0,0,0,0,0.0517916910639786,16.4324979166958,7.49931902916659
9.7,"random_policy_SVM","SVM",80,16,1084,1070,14,1700,1465,235,0.797120050438526,0.267605633802817,1.22962289868242,624,235,389,7,1.7,61.06,6.2,0,0,0,0,0,0,0.0830155428710816,37.0203367861416,10.0822526063295
9.7,"random_policy_SVM","SVM",80,17,984,970,14,1800,1565,235,0.800396302676176,0.274647887323944,1.23866424352567,624,235,389,0,1.7,64.66,6.7,0,0,0,0,0,0,0.0323217516042367,11.1628235314567,4.68389958335129
9.7,"random_policy_SVM","SVM",80,18,884,871,13,1900,1664,236,0.799225408405675,0.253521126760563,1.22962289868242,633,236,397,9,1.7,68.25,7.1,0,0,0,0,0,0,0.00985528917137852,3.10293585283032,1.63195603140725
9.7,"random_policy_SVM","SVM",80,19,784,771,13,2000,1764,236,0.782247441483439,0.204225352112676,1.22962289868242,636,236,400,3,1.7,71.84,7.5,0,0,0,0,0,0,0.010699351115049,3.9023246737985,1.87787039431494
9.7,"random_policy_SVM","SVM",80,20,684,671,13,2100,1864,236,0.800379414778043,0.295774647887324,1.22962289868242,631,236,395,-5,1.7,75.43,7.9,0,0,0,0,0,0,0.005266531459756,1.71978028765403,0.867182789040145
9.7,"random_policy_SVM","SVM",80,21,584,573,11,2200,1962,238,0.799214149806916,0.288732394366197,1.22962289868242,650,238,412,19,1.7,79.02,8.2,0,0,0,0,0,0,0.0334880047373335,11.8813065783656,4.46988819173303
9.7,"random_policy_SVM","SVM",80,22,484,476,8,2300,2059,241,0.793838168901503,0.253521126760563,1.22962289868242,666,241,425,16,1.8,82.61,8.5,0,0,0,0,0,0,0.0372912768343746,13.3947981908161,8.39034659952696
9.7,"random_policy_SVM","SVM",80,23,384,376,8,2400,2159,241,0.771118316614318,0.211267605633803,1.22962289868242,653,241,412,-13,1.7,86.21,9,0,0,0,0,0,0,0.0110391363654136,3.13709234496745,1.99970593935213
9.7,"random_policy_SVM","SVM",80,24,284,277,7,2500,2258,242,0.761222008308844,0.161971830985915,1.22962289868242,660,242,418,7,1.7,89.8,9.3,0,0,0,0,0,0,0.0163979494944714,4.02331650461846,2.7192791525433
9.7,"random_policy_SVM","SVM",80,25,184,178,6,2600,2357,243,0.816974589342608,0.323943661971831,1.22962289868242,674,243,431,14,1.8,93.39,9.7,0,0,0,0,0,0,0.0039825081529866,1.149279083645,1.03099750169003
9.7,"random_policy_SVM","SVM",80,26,84,82,2,2700,2453,247,0.822812172796972,0.274647887323944,1.28387096774194,687,247,440,13,1.8,96.98,9.9,0,0,0,0,0,0,4.63275870231227e-05,0.643569466946442,0.643569466946442
9.7,"random_policy_SVM","SVM",80,27,0,0,0,2784,2535,249,0.773454475855931,0.211267605633803,1.27482962289868,726,249,477,39,1.9,100,10.2,0,0,0,0,0,0,0,0,0
9.7,"random_policy_SVM","SVM",81,0,2684,2421,263,100,91,9,0.741778029893278,0.210084033613445,1.22992680943345,27,9,18,0,2,3.59,10.1,0,0,0,0,0,0,0.176936451814861,254.362498496935,19.6488516224982
9.7,"random_policy_SVM","SVM",81,1,2584,2346,238,200,166,34,0.773208184372652,0.243697478991597,1.27308213608024,89,34,55,62,1.6,7.18,4.9,0,0,0,0,0,0,0.235608531661779,308.82503153254,26.1580885879089
9.7,"random_policy_SVM","SVM",81,2,2484,2269,215,300,243,57,0.781947944012774,0.252100840336134,1.26229330441854,138,57,81,49,1.4,10.78,4.3,0,0,0,0,0,0,0.216827798096007,305.867673645912,24.2732230203337
9.7,"random_policy_SVM","SVM",81,3,2384,2207,177,400,305,95,0.776532591058402,0.19327731092437,1.27308213608024,219,95,124,81,1.3,14.37,3.2,0,0,0,0,0,0,0.25173005918275,353.84090637569,26.116694477994
9.7,"random_policy_SVM","SVM",81,4,2284,2128,156,500,384,116,0.769145020645622,0.210084033613445,1.27308213608024,270,116,154,51,1.3,17.96,3.3,0,0,0,0,0,0,0.2378252279505,263.48804305691,24.7705203065015
9.7,"random_policy_SVM","SVM",81,5,2184,2050,134,600,462,138,0.751480812105062,0.210084033613445,1.27308213608024,325,138,187,55,1.4,21.55,3.3,0,0,0,0,0,0,0.217690291582044,254.286313867376,22.5334392232851
9.7,"random_policy_SVM","SVM",81,6,2084,1969,115,700,543,157,0.761440840072292,0.235294117647059,1.27308213608024,374,157,217,49,1.4,25.14,3.5,0,0,0,0,0,0,0.207911360645228,213.55810644525,21.853976344999
9.7,"random_policy_SVM","SVM",81,7,1984,1891,93,800,621,179,0.781097054206298,0.226890756302521,1.26229330441854,425,179,246,51,1.4,28.74,3.5,0,0,0,0,0,0,0.214261559427236,205.033303468346,22.539648681202
9.7,"random_policy_SVM","SVM",81,8,1884,1808,76,900,704,196,0.790225980502091,0.226890756302521,1.26229330441854,485,196,289,60,1.5,32.33,3.6,0,0,0,0,0,0,0.201272546808466,193.215057987602,21.842188838651
9.7,"random_policy_SVM","SVM",81,9,1784,1722,62,1000,790,210,0.763070063190108,0.226890756302521,1.19756031444836,515,210,305,30,1.5,35.92,3.8,0,0,0,0,0,0,0.159758786244539,110.656903068811,18.4354522874426
9.7,"random_policy_SVM","SVM",81,10,1684,1623,61,1100,889,211,0.754383071910081,0.226890756302521,1.15440498780157,515,211,304,0,1.4,39.51,4.2,0,0,0,0,0,0,0.177323972804534,157.159409682606,20.078588736922
9.7,"random_policy_SVM","SVM",81,11,1584,1524,60,1200,988,212,0.757799823225993,0.19327731092437,1.15440498780157,527,212,315,12,1.5,43.1,4.7,0,0,0,0,0,0,0.156926189379071,107.036965103675,17.3482148761679
9.7,"random_policy_SVM","SVM",81,12,1484,1428,56,1300,1084,216,0.745491603234701,0.151260504201681,1.22992680943345,548,216,332,21,1.5,46.7,5,0,0,0,0,0,0,0.101978249025297,37.3598475621742,13.5033838886519
9.7,"random_policy_SVM","SVM",81,13,1384,1340,44,1400,1172,228,0.77145363639962,0.19327731092437,1.24071564109515,587,228,359,39,1.6,50.29,5.1,0,0,0,0,0,0,0.146620980825389,77.0775629689757,17.3729737959408
9.7,"random_policy_SVM","SVM",81,14,1284,1256,28,1500,1256,244,0.807474638206935,0.252100840336134,1.21913797777175,640,244,396,53,1.6,53.88,5.1,0,0,0,0,0,0,0.0911403851950603,32.343391449729,12.8600070342539
9.7,"random_policy_SVM","SVM",81,15,1184,1161,23,1600,1351,249,0.790225980502098,0.201680672268908,1.24071564109515,652,249,403,12,1.6,57.47,5.4,0,0,0,0,0,0,0.0905385318534629,35.3380954455875,10.8934301106605
9.7,"random_policy_SVM","SVM",81,16,1084,1065,19,1700,1447,253,0.796043692202159,0.210084033613445,1.26229330441854,653,253,400,1,1.6,61.06,5.7,0,0,0,0,0,0,0.051138842032155,19.8566323540555,9.40469988206665
9.7,"random_policy_SVM","SVM",81,17,984,973,11,1800,1539,261,0.801881192037259,0.226890756302521,1.26229330441854,690,261,429,37,1.6,64.66,5.9,0,0,0,0,0,0,0.0185924127437672,6.06601133443829,3.3956184210979
9.7,"random_policy_SVM","SVM",81,18,884,875,9,1900,1637,263,0.800044193501579,0.184873949579832,1.27190986891994,711,263,448,21,1.7,68.25,6.2,0,0,0,0,0,0,0.0105398238038332,3.55177496911553,2.52442727963718
9.7,"random_policy_SVM","SVM",81,19,784,777,7,2000,1735,265,0.800733480205271,0.168067226890756,1.27308213608024,714,265,449,3,1.7,71.84,6.5,0,0,0,0,0,0,0.102882337426668,31.5901279688244,17.160154832829
9.7,"random_policy_SVM","SVM",81,20,684,681,3,2100,1831,269,0.790925161273303,0.168067226890756,1.27308213608024,732,269,463,18,1.7,75.43,6.8,0,0,0,0,0,0,0.0936431186403767,26.4701524874675,15.0007409730899
9.7,"random_policy_SVM","SVM",81,21,584,583,1,2200,1929,271,0.798253367280981,0.218487394957983,1.27308213608024,692,271,421,-40,1.6,79.02,7.1,0,0,0,0,0,0,0.0341928976552272,8.61873671941326,6.49091426171503
9.7,"random_policy_SVM","SVM",81,22,484,483,1,2300,2029,271,0.777838607970662,0.151260504201681,1.27308213608024,705,271,434,13,1.6,82.61,7.5,0,0,0,0,0,0,0.00220793815110302,1.0016958010036,0.876392045562158
9.7,"random_policy_SVM","SVM",81,23,384,383,1,2400,2129,271,0.788939751724869,0.184873949579832,1.27308213608024,710,271,439,5,1.6,86.21,7.9,0,0,0,0,0,0,0.000817023362871208,0.506941935002682,0.455032528556997
9.7,"random_policy_SVM","SVM",81,24,284,284,0,2500,2228,272,0.79996833898395,0.201680672268908,1.26229330441854,730,272,458,20,1.7,89.8,8.2,0,0,0,0,0,0,0.0076312684908844,6.58306915774803,6.35849616205496
9.7,"random_policy_SVM","SVM",81,25,184,184,0,2600,2328,272,0.771156814374104,0.184873949579832,1.27308213608024,744,272,472,14,1.7,93.39,8.6,0,0,0,0,0,0,0.000599777623327519,0.682149120924545,0.667411576277611
9.7,"random_policy_SVM","SVM",81,26,84,84,0,2700,2428,272,0.801663522551881,0.210084033613445,1.27308213608024,747,272,475,3,1.7,96.98,8.9,0,0,0,0,0,0,1.46033733798436e-05,0.0737298203536449,0.0737298203536449
9.7,"random_policy_SVM","SVM",81,27,0,0,0,2784,2512,272,0.813160429006772,0.226890756302521,1.27308213608024,742,272,470,-5,1.7,100,9.2,0,0,0,0,0,0,0,0,0
9.7,"random_policy_SVM","SVM",82,0,2684,2444,240,100,95,5,0.763053245597657,0.328767123287671,1.21352187361909,13,5,8,0,1.6,3.59,19,0,0,0,0,0,0,0.245282543459732,214.833384539519,35.657194959074
9.7,"random_policy_SVM","SVM",82,1,2584,2367,217,200,172,28,0.812245279080746,0.356164383561644,1.25749005744587,69,28,41,56,1.5,7.18,6.1,0,0,0,0,0,0,0.204337911583282,233.134451098642,27.2002982365051
9.7,"random_policy_SVM","SVM",82,2,2484,2291,193,300,248,52,0.715772648877854,0.191780821917808,1.1519664162616,134,52,82,65,1.6,10.78,4.8,0,0,0,0,0,0,0.196627079642105,271.750373849977,21.7946906027919
9.7,"random_policy_SVM","SVM",82,3,2384,2196,188,400,343,57,0.789857301358866,0.26027397260274,1.25749005744587,148,57,91,14,1.6,14.37,6,0,0,0,0,0,0,0.196366314180679,171.468553574753,31.2775802470096
9.7,"random_policy_SVM","SVM",82,4,2284,2105,179,500,434,66,0.822148498863026,0.342465753424658,1.25749005744587,170,66,104,22,1.6,17.96,6.6,0,0,0,0,0,0,0.163910444776586,99.133767924172,17.3322043179029
9.7,"random_policy_SVM","SVM",82,5,2184,2045,139,600,494,106,0.824098384066968,0.363013698630137,1.24869642068051,253,106,147,83,1.4,21.55,4.7,0,0,0,0,0,0,0.226101344493031,132.429071196774,23.5060473218849
9.7,"random_policy_SVM","SVM",82,6,2084,1966,118,700,573,127,0.81526073535389,0.26027397260274,1.25749005744587,307,127,180,54,1.4,25.14,4.5,0,0,0,0,0,0,0.219362350328062,97.7492974475836,23.1940857744625
9.7,"random_policy_SVM","SVM",82,7,1984,1881,103,800,658,142,0.820681965484284,0.328767123287671,1.24869642068051,348,142,206,41,1.5,28.74,4.6,0,0,0,0,0,0,0.189088772205377,74.7310552696384,20.4725965380778
9.7,"random_policy_SVM","SVM",82,8,1884,1804,80,900,735,165,0.817446803836055,0.273972602739726,1.25749005744587,402,165,237,54,1.4,32.33,4.5,0,0,0,0,0,0,0.179600388478529,75.7146087228074,20.113706127456
9.7,"random_policy_SVM","SVM",82,9,1784,1724,60,1000,815,185,0.845069262119491,0.335616438356164,1.26628369421122,456,185,271,54,1.5,35.92,4.4,0,0,0,0,0,0,0.148669706725819,44.1094754127613,18.1877136058821
9.7,"random_policy_SVM","SVM",82,10,1684,1641,43,1100,898,202,0.848233019520815,0.363013698630137,1.26628369421122,493,202,291,37,1.4,39.51,4.4,0,0,0,0,0,0,0.162511254827905,55.8379669063202,18.8396405450521
9.7,"random_policy_SVM","SVM",82,11,1584,1551,33,1200,988,212,0.827750985927865,0.328767123287671,1.26628369421122,539,212,327,46,1.5,43.1,4.7,0,0,0,0,0,0,0.177626657927325,100.9617180485,18.9280614379655
9.7,"random_policy_SVM","SVM",82,12,1484,1459,25,1300,1080,220,0.806351682393904,0.287671232876712,1.25749005744587,577,220,357,38,1.6,46.7,4.9,0,0,0,0,0,0,0.165537028990968,77.0642510914178,18.4123263092288
9.7,"random_policy_SVM","SVM",82,13,1384,1365,19,1400,1174,226,0.782134657424391,0.280821917808219,1.25749005744587,598,226,372,21,1.6,50.29,5.2,0,0,0,0,0,0,0.16456414591714,87.6631397472729,18.6204950049603
9.7,"random_policy_SVM","SVM",82,14,1284,1266,18,1500,1273,227,0.785616987619595,0.232876712328767,1.25749005744587,614,227,387,16,1.7,53.88,5.6,0,0,0,0,0,0,0.14542385048165,68.6811974613367,15.7563783231041
9.7,"random_policy_SVM","SVM",82,15,1184,1166,18,1600,1373,227,0.811300545967852,0.342465753424658,1.25749005744587,618,227,391,4,1.7,57.47,6,0,0,0,0,0,0,0.102454846004793,38.7417446784726,11.6372463392758
9.7,"random_policy_SVM","SVM",82,16,1084,1068,16,1700,1471,229,0.821170809943859,0.397260273972603,1.25749005744587,605,229,376,-13,1.6,61.06,6.4,0,0,0,0,0,0,0.0938584245540535,31.4984163857517,10.9274905547179
9.7,"random_policy_SVM","SVM",82,17,984,968,16,1800,1571,229,0.766541068427234,0.205479452054795,1.25749005744587,636,229,407,31,1.8,64.66,6.9,0,0,0,0,0,0,0.0820060980988155,21.3275144770641,10.1960832509279
9.7,"random_policy_SVM","SVM",82,18,884,868,16,1900,1671,229,0.794094868780963,0.301369863013699,1.25633214763238,637,229,408,1,1.8,68.25,7.3,0,0,0,0,0,0,0.0195767020112665,4.74618244376544,3.56358657877872
9.7,"random_policy_SVM","SVM",82,19,784,769,15,2000,1770,230,0.809779086245338,0.356164383561644,1.25749005744587,662,230,432,25,1.9,71.84,7.7,0,0,0,0,0,0,0.0106548473752778,4.10921021775055,3.6710125473473
9.7,"random_policy_SVM","SVM",82,20,684,672,12,2100,1867,233,0.768924871746978,0.253424657534247,1.26628369421122,655,233,422,-7,1.8,75.43,8,0,0,0,0,0,0,0.00595734360497058,2.23035517489875,1.57371460835054
9.7,"random_policy_SVM","SVM",82,21,584,577,7,2200,1962,238,0.829948039678784,0.342465753424658,1.27507733097658,692,238,454,37,1.9,79.02,8.2,0,0,0,0,0,0,0.043508608993736,11.8569338356312,6.02324308244265
9.7,"random_policy_SVM","SVM",82,22,484,480,4,2300,2059,241,0.840949786336521,0.363013698630137,1.27390322662025,674,241,433,-18,1.8,82.61,8.5,0,0,0,0,0,0,0.0399771516722529,10.7194824893944,7.64858251685632
9.7,"random_policy_SVM","SVM",82,23,384,382,2,2400,2157,243,0.81073480462699,0.308219178082192,1.27390322662025,701,243,458,27,1.9,86.21,8.9,0,0,0,0,0,0,0.0097321184885131,4.43410578714717,4.05599522118765
9.7,"random_policy_SVM","SVM",82,24,284,283,1,2500,2256,244,0.834155397611799,0.39041095890411,1.27390322662025,693,244,449,-8,1.8,89.8,9.2,0,0,0,0,0,0,0.00168467324095542,1.11628579492924,1.07554646708118
9.7,"random_policy_SVM","SVM",82,25,184,183,1,2600,2356,244,0.756549966494928,0.205479452054795,1.27390322662025,694,244,450,1,1.8,93.39,9.7,0,0,0,0,0,0,5.96219045593339e-05,0.18226960190228,0.180906440615874
9.7,"random_policy_SVM","SVM",82,26,84,84,0,2700,2455,245,0.776702442025243,0.212328767123288,1.27390322662025,697,245,452,3,1.8,96.98,10,0,0,0,0,0,0,3.35549027468895e-07,3.99327985321122,3.99327985321122
9.7,"random_policy_SVM","SVM",82,27,0,0,0,2784,2539,245,0.785408267513262,0.23972602739726,1.27390322662025,672,245,427,-25,1.7,100,10.4,0,0,0,0,0,0,0,0,0
9.7,"random_policy_SVM","SVM",83,0,2684,2440,244,100,86,14,0.698818474758323,0.157894736842105,1.22595197671598,44,14,30,0,2.1,3.59,6.1,0,0,0,0,0,0,0.1873124449128,377.657739718033,25.1587842167094
9.7,"random_policy_SVM","SVM",83,1,2584,2356,228,200,170,30,0.770509607351728,0.180451127819549,1.27421780257094,92,30,62,48,2.1,7.18,5.7,0,0,0,0,0,0,0.206419901836118,315.133960064627,24.6909889155187
9.7,"random_policy_SVM","SVM",83,2,2484,2266,218,300,260,40,0.755740541830776,0.105263157894737,1.26456463739995,141,40,101,49,2.5,10.78,6.5,0,0,0,0,0,0,0.170155243554817,304.26066826986,21.7403533940411
9.7,"random_policy_SVM","SVM",83,3,2384,2179,205,400,347,53,0.800393841747241,0.210526315789474,1.27421780257094,172,53,119,31,2.2,14.37,6.5,0,0,0,0,0,0,0.15220498223431,259.430225783708,16.3459254536053
9.7,"random_policy_SVM","SVM",83,4,2284,2097,187,500,429,71,0.815264351354592,0.330827067669173,1.27421780257094,195,71,124,23,1.7,17.96,6,0,0,0,0,0,0,0.15861053140184,223.107219566689,16.7480486506558
9.7,"random_policy_SVM","SVM",83,5,2184,2026,158,600,500,100,0.816392170903463,0.338345864661654,1.27421780257094,259,100,159,64,1.6,21.55,5,0,0,0,0,0,0,0.169410568479361,215.49042827143,17.4553212391491
9.7,"random_policy_SVM","SVM",83,6,2084,1955,129,700,571,129,0.824400286430372,0.353383458646617,1.26456463739995,317,129,188,58,1.5,25.14,4.4,0,0,0,0,0,0,0.184223894831084,188.080754907132,18.9674709541879
9.7,"random_policy_SVM","SVM",83,7,1984,1884,100,800,642,158,0.830654015992371,0.323308270676692,1.26456463739995,389,158,231,72,1.5,28.74,4.1,0,0,0,0,0,0,0.194703710183153,158.442545598319,20.5316860115145
9.7,"random_policy_SVM","SVM",83,8,1884,1815,69,900,711,189,0.832879818594113,0.285714285714286,1.26456463739995,449,189,260,60,1.4,32.33,3.8,0,0,0,0,0,0,0.205205720525118,261.960921990864,21.0397625682408
9.7,"random_policy_SVM","SVM",83,9,1784,1737,47,1000,789,211,0.830671917889971,0.278195488721804,1.26456463739995,512,211,301,63,1.4,35.92,3.7,0,0,0,0,0,0,0.196579894213247,116.092252818524,21.1034091685157
9.7,"random_policy_SVM","SVM",83,10,1684,1653,31,1100,873,227,0.822848788638272,0.255639097744361,1.26456463739995,557,227,330,45,1.5,39.51,3.8,0,0,0,0,0,0,0.189932839977125,154.371557438798,19.7739150226117
9.7,"random_policy_SVM","SVM",83,11,1584,1562,22,1200,964,236,0.819477264590056,0.270676691729323,1.26456463739995,590,236,354,33,1.5,43.1,4.1,0,0,0,0,0,0,0.168819528168882,99.7409762031825,18.1708797769251
9.7,"random_policy_SVM","SVM",83,12,1484,1464,20,1300,1062,238,0.82234753550544,0.270676691729323,1.26456463739995,599,238,361,9,1.5,46.7,4.5,0,0,0,0,0,0,0.114249233819779,56.8443675896708,13.4465212737242
9.7,"random_policy_SVM","SVM",83,13,1384,1366,18,1400,1160,240,0.82120181405897,0.278195488721804,1.27421780257094,610,240,370,11,1.5,50.29,4.8,0,0,0,0,0,0,0.140026253812537,117.497107638108,14.7903417605445
9.7,"random_policy_SVM","SVM",83,14,1284,1271,13,1500,1255,245,0.819113259338837,0.285714285714286,1.27421780257094,647,245,402,37,1.6,53.88,5.1,0,0,0,0,0,0,0.139934110965717,100.469570426926,14.9339753496823
9.7,"random_policy_SVM","SVM",83,15,1184,1174,10,1600,1352,248,0.813265306122465,0.24812030075188,1.27421780257094,666,248,418,19,1.7,57.47,5.5,0,0,0,0,0,0,0.110395775153724,56.1180117288129,12.6378875815576
9.7,"random_policy_SVM","SVM",83,16,1084,1078,6,1700,1448,252,0.785672514619897,0.18796992481203,1.27421780257094,694,252,442,28,1.8,61.06,5.7,0,0,0,0,0,0,0.0813974082876531,33.611584767126,9.92881071554349
9.7,"random_policy_SVM","SVM",83,17,984,981,3,1800,1545,255,0.79289891395156,0.218045112781955,1.27421780257094,695,255,440,1,1.7,64.66,6.1,0,0,0,0,0,0,0.089437884946595,36.0225614780889,12.494592838003
9.7,"random_policy_SVM","SVM",83,18,884,881,3,1900,1645,255,0.771273421649374,0.203007518796992,1.27421780257094,699,255,444,4,1.7,68.25,6.5,0,0,0,0,0,0,0.0600043433761847,21.2924465850123,8.03092277731451
9.7,"random_policy_SVM","SVM",83,19,784,782,2,2000,1744,256,0.788327962764067,0.210526315789474,1.27421780257094,695,256,439,-4,1.7,71.84,6.8,0,0,0,0,0,0,0.0600673233751402,21.8997267266638,7.0745736228962
9.7,"random_policy_SVM","SVM",83,20,684,683,1,2100,1843,257,0.805322830886755,0.263157894736842,1.27304448967723,707,257,450,12,1.8,75.43,7.2,0,0,0,0,0,0,0.0302012778819077,9.3648970072745,4.55171983012175
9.7,"random_policy_SVM","SVM",83,21,584,583,1,2200,1943,257,0.737456737080807,0.180451127819549,1.27421780257094,725,257,468,18,1.8,79.02,7.6,0,0,0,0,0,0,0.0183239228682915,4.60840284557337,2.69975844129016
9.7,"random_policy_SVM","SVM",83,22,484,483,1,2300,2043,257,0.791633846521079,0.210526315789474,1.27421780257094,722,257,465,-3,1.8,82.61,7.9,0,0,0,0,0,0,0.0163212319250215,3.97933175976051,2.42231628240217
9.7,"random_policy_SVM","SVM",83,23,384,383,1,2400,2143,257,0.814882444205767,0.285714285714286,1.27421780257094,716,257,459,-6,1.8,86.21,8.3,0,0,0,0,0,0,0.00337233201709302,0.816680252268257,0.765781022373371
9.7,"random_policy_SVM","SVM",83,24,284,284,0,2500,2242,258,0.777437641723362,0.203007518796992,1.27421780257094,723,258,465,7,1.8,89.8,8.7,0,0,0,0,0,0,0.0298526792372464,9.1036710484579,7.95143917719151
9.7,"random_policy_SVM","SVM",83,25,184,184,0,2600,2342,258,0.747428094044641,0.210526315789474,1.27421780257094,739,258,481,16,1.9,93.39,9.1,0,0,0,0,0,0,0.00335252415535624,1.57168677322264,1.53573172255457
9.7,"random_policy_SVM","SVM",83,26,84,84,0,2700,2442,258,0.712662608903213,0.165413533834586,1.26456463739995,726,258,468,-13,1.8,96.98,9.5,0,0,0,0,0,0,1.72857886129773e-08,0.112317543308811,0.112317543308811
9.7,"random_policy_SVM","SVM",83,27,0,0,0,2784,2526,258,0.731865377730045,0.157894736842105,1.27421780257094,727,258,469,1,1.8,100,9.8,0,0,0,0,0,0,0,0,0
9.7,"random_policy_SVM","SVM",84,0,2684,2427,257,100,91,9,0.695293375394325,0.272,1.15034838709677,32,9,23,0,2.6,3.59,10.1,0,0,0,0,0,0,0.0922055348330751,245.980510832636,9.22759395485429
9.7,"random_policy_SVM","SVM",84,1,2584,2359,225,200,159,41,0.720593059936912,0.136,1.24278709677419,103,41,62,71,1.5,7.18,3.9,0,0,0,0,0,0,0.210510616407101,521.686129198172,21.3216769119053
9.7,"random_policy_SVM","SVM",84,2,2484,2265,219,300,253,47,0.745072555205048,0.144,1.26332903225806,135,47,88,32,1.9,10.78,5.4,0,0,0,0,0,0,0.191828985645654,368.152531350112,19.8236992301762
9.7,"random_policy_SVM","SVM",84,3,2384,2169,215,400,349,51,0.744365930599378,0.2,1.26332903225806,161,51,110,26,2.2,14.37,6.8,0,0,0,0,0,0,0.151053321456057,248.114817804284,15.5195116292445
9.7,"random_policy_SVM","SVM",84,4,2284,2091,193,500,427,73,0.756618296529976,0.192,1.21197419354839,210,73,137,49,1.9,17.96,5.8,0,0,0,0,0,0,0.178181460553941,192.157362421022,18.681791168404
9.7,"random_policy_SVM","SVM",84,5,2184,2018,166,600,500,100,0.771324921135655,0.232,1.20170322580645,271,100,171,61,1.7,21.55,5,0,0,0,0,0,0,0.191497039852821,166.176387901858,22.5902948086485
9.7,"random_policy_SVM","SVM",84,6,2084,1952,132,700,566,134,0.769716088328076,0.256,1.19143225806452,340,134,206,69,1.5,25.14,4.2,0,0,0,0,0,0,0.19850249170698,260.893948953362,22.2005434931452
9.7,"random_policy_SVM","SVM",84,7,1984,1864,120,800,654,146,0.790315457413251,0.312,1.21197419354839,385,146,239,45,1.6,28.74,4.5,0,0,0,0,0,0,0.177751492201087,172.057057209097,18.9907477727658
9.7,"random_policy_SVM","SVM",84,8,1884,1784,100,900,734,166,0.797962145110416,0.328,1.22224516129032,427,166,261,42,1.6,32.33,4.4,0,0,0,0,0,0,0.158877474011629,137.796463952541,17.5064372993046
9.7,"random_policy_SVM","SVM",84,9,1784,1703,81,1000,815,185,0.816706624605684,0.352,1.23251612903226,474,185,289,47,1.6,35.92,4.4,0,0,0,0,0,0,0.137980090444205,86.6342845705367,16.3074080607651
9.7,"random_policy_SVM","SVM",84,10,1684,1618,66,1100,900,200,0.813526813880125,0.264,1.26332903225806,501,200,301,27,1.5,39.51,4.5,0,0,0,0,0,0,0.142619603373104,85.3296107200041,17.2563875462843
9.7,"random_policy_SVM","SVM",84,11,1584,1532,52,1200,986,214,0.826258675078871,0.248,1.26332903225806,550,214,336,49,1.6,43.1,4.6,0,0,0,0,0,0,0.139300538059738,101.023109177489,16.9359485377924
9.7,"random_policy_SVM","SVM",84,12,1484,1443,41,1300,1075,225,0.829886435331238,0.272,1.28387096774194,580,225,355,30,1.6,46.7,4.8,0,0,0,0,0,0,0.0822972857410303,36.7944385964345,11.2723381415586
9.7,"random_policy_SVM","SVM",84,13,1384,1350,34,1400,1168,232,0.804132492113575,0.2,1.2736,596,232,364,16,1.6,50.29,5,0,0,0,0,0,0,0.149211441487816,78.3760174316566,17.157394878855
9.7,"random_policy_SVM","SVM",84,14,1284,1251,33,1500,1267,233,0.822252365930611,0.24,1.2736,606,233,373,10,1.6,53.88,5.4,0,0,0,0,0,0,0.115556754590576,42.2822093349032,16.0046243751979
9.7,"random_policy_SVM","SVM",84,15,1184,1158,26,1600,1360,240,0.836668769716096,0.28,1.28387096774194,660,240,420,54,1.8,57.47,5.7,0,0,0,0,0,0,0.115678797807752,54.4323916607079,13.6583416784102
9.7,"random_policy_SVM","SVM",84,16,1084,1072,12,1700,1446,254,0.837867507886434,0.28,1.28387096774194,681,254,427,21,1.7,61.06,5.7,0,0,0,0,0,0,0.107117492762743,46.960243165366,14.081168830513
9.7,"random_policy_SVM","SVM",84,17,984,977,7,1800,1541,259,0.840517350157729,0.264,1.28387096774194,678,259,419,-3,1.6,64.66,5.9,0,0,0,0,0,0,0.078660991074761,30.3628532847021,13.5625327665752
9.7,"random_policy_SVM","SVM",84,18,884,880,4,1900,1638,262,0.816946372239747,0.224,1.28387096774194,711,262,449,33,1.7,68.25,6.3,0,0,0,0,0,0,0.0603323069071427,20.635157611048,8.82024647838788
9.7,"random_policy_SVM","SVM",84,19,784,781,3,2000,1737,263,0.813646687697163,0.192,1.28387096774194,709,263,446,-2,1.7,71.84,6.6,0,0,0,0,0,0,0.059379259959872,19.3177837608685,7.65766766274208
9.7,"random_policy_SVM","SVM",84,20,684,681,3,2100,1837,263,0.829053627760255,0.24,1.28387096774194,710,263,447,1,1.7,75.43,7,0,0,0,0,0,0,0.0238262299129724,6.90436152297489,3.59925453499048
9.7,"random_policy_SVM","SVM",84,21,584,582,2,2200,1936,264,0.815135646687702,0.216,1.2736,734,264,470,24,1.8,79.02,7.3,0,0,0,0,0,0,0.0522512197302836,18.4896015313342,11.6684958238024
9.7,"random_policy_SVM","SVM",84,22,484,482,2,2300,2036,264,0.785318611987384,0.192,1.28387096774194,745,264,481,11,1.8,82.61,7.7,0,0,0,0,0,0,0.00893188424268358,2.57827878988794,1.93528866166891
9.7,"random_policy_SVM","SVM",84,23,384,382,2,2400,2136,264,0.806813880126184,0.216,1.28387096774194,728,264,464,-17,1.8,86.21,8.1,0,0,0,0,0,0,0.00122451627600423,0.602416151218666,0.543247782404553
9.7,"random_policy_SVM","SVM",84,24,284,284,0,2500,2234,266,0.825438485804422,0.264,1.2736,734,266,468,6,1.8,89.8,8.4,0,0,0,0,0,0,0.00569498509150446,7.96077504542092,7.72536057831838
9.7,"random_policy_SVM","SVM",84,25,184,184,0,2600,2334,266,0.802889589905368,0.24,1.2736,747,266,481,13,1.8,93.39,8.8,0,0,0,0,0,0,0.000182212142769528,0.208027748374691,0.20513005706289
9.7,"random_policy_SVM","SVM",84,26,84,84,0,2700,2434,266,0.781034700315459,0.184,1.28387096774194,745,266,479,-2,1.8,96.98,9.2,0,0,0,0,0,0,1.0000000994736e-07,0.00608927671701898,0.00608927671701898
9.7,"random_policy_SVM","SVM",84,27,0,0,0,2784,2518,266,0.804706624605677,0.224,1.28387096774194,732,266,466,-13,1.8,100,9.5,0,0,0,0,0,0,0,0,0
9.7,"random_policy_SVM","SVM",85,0,2684,2448,236,100,95,5,0.798047733976935,0.24,1.26675268817204,20,5,15,0,3,3.59,19,0,0,0,0,0,0,0.0889799910533154,141.366193397645,10.5577811974073
9.7,"random_policy_SVM","SVM",85,1,2584,2364,220,200,179,21,0.804151246983097,0.3,1.23251612903226,60,21,39,40,1.9,7.18,8.5,0,0,0,0,0,0,0.121698314931265,234.12411634531,13.0126177821714
9.7,"random_policy_SVM","SVM",85,2,2484,2285,199,300,258,42,0.816057924376499,0.38,1.2410752688172,114,42,72,54,1.7,10.78,6.1,0,0,0,0,0,0,0.158934888212622,206.05434500718,16.8055601382652
9.7,"random_policy_SVM","SVM",85,3,2384,2213,171,400,330,70,0.818342719227668,0.353333333333333,1.23251612903226,175,70,105,61,1.5,14.37,4.7,0,0,0,0,0,0,0.197114921012856,257.428277584044,20.5322079933726
9.7,"random_policy_SVM","SVM",85,4,2284,2147,137,500,396,104,0.815510860820586,0.366666666666667,1.23251612903226,249,104,145,74,1.4,17.96,3.8,0,0,0,0,0,0,0.218285706015316,219.880343451575,22.5217719151361
9.7,"random_policy_SVM","SVM",85,5,2184,2076,108,600,467,133,0.812909627245899,0.353333333333333,1.23251612903226,315,133,182,66,1.4,21.55,3.5,0,0,0,0,0,0,0.22722752528035,215.297091477375,23.4123046909878
9.7,"random_policy_SVM","SVM",85,6,2084,1988,96,700,555,145,0.819147224456952,0.386666666666667,1.2410752688172,358,145,213,43,1.5,25.14,3.8,0,0,0,0,0,0,0.187812021204549,150.589150261389,20.5100372211835
9.7,"random_policy_SVM","SVM",85,7,1984,1905,79,800,638,162,0.808350764279959,0.34,1.24963440860215,384,162,222,26,1.4,28.74,3.9,0,0,0,0,0,0,0.177873515160931,156.787095808976,19.1201467522369
9.7,"random_policy_SVM","SVM",85,8,1884,1819,65,900,724,176,0.806462858675236,0.333333333333333,1.2410752688172,425,176,249,41,1.4,32.33,4.1,0,0,0,0,0,0,0.17834361185093,192.738914123628,18.8648886427674
9.7,"random_policy_SVM","SVM",85,9,1784,1732,52,1000,811,189,0.805068382944479,0.306666666666667,1.2410752688172,466,189,277,41,1.5,35.92,4.3,0,0,0,0,0,0,0.164420329012558,175.683655286621,17.7591459284168
9.7,"random_policy_SVM","SVM",85,10,1684,1638,46,1100,905,195,0.791987127916326,0.26,1.2410752688172,478,195,283,12,1.5,39.51,4.6,0,0,0,0,0,0,0.158788797428868,157.863223507821,18.7033365416676
9.7,"random_policy_SVM","SVM",85,11,1584,1550,34,1200,993,207,0.81014749262536,0.273333333333333,1.2410752688172,520,207,313,42,1.5,43.1,4.8,0,0,0,0,0,0,0.142215400190785,82.2770002254487,16.8527163086461
9.7,"random_policy_SVM","SVM",85,12,1484,1464,20,1300,1079,221,0.812512737999451,0.32,1.23251612903226,569,221,348,49,1.6,46.7,4.9,0,0,0,0,0,0,0.150162188251865,107.236794599104,16.2987513275571
9.7,"random_policy_SVM","SVM",85,13,1384,1369,15,1400,1174,226,0.799957093054424,0.293333333333333,1.23251612903226,575,226,349,6,1.5,50.29,5.2,0,0,0,0,0,0,0.132322278895443,100.674948198627,14.4516317954545
9.7,"random_policy_SVM","SVM",85,14,1284,1271,13,1500,1272,228,0.790791096808785,0.246666666666667,1.23251612903226,583,228,355,8,1.6,53.88,5.6,0,0,0,0,0,0,0.0896060995828034,47.6323558054271,10.2988206272148
9.7,"random_policy_SVM","SVM",85,15,1184,1172,12,1600,1371,229,0.790185036202725,0.273333333333333,1.23251612903226,594,229,365,11,1.6,57.47,6,0,0,0,0,0,0,0.0909344274862807,51.0486310813055,10.5434221157632
9.7,"random_policy_SVM","SVM",85,16,1084,1072,12,1700,1471,229,0.769305443818709,0.173333333333333,1.23251612903226,601,229,372,7,1.6,61.06,6.4,0,0,0,0,0,0,0.0789614154002771,41.8563375216325,8.92779527314568
9.7,"random_policy_SVM","SVM",85,17,984,974,10,1800,1569,231,0.790002681684085,0.28,1.21539784946237,600,231,369,-1,1.6,64.66,6.8,0,0,0,0,0,0,0.10057661586685,54.5432337397912,11.7329531091841
9.7,"random_policy_SVM","SVM",85,18,884,875,9,1900,1668,232,0.769648699383204,0.213333333333333,1.20683870967742,615,232,383,15,1.7,68.25,7.2,0,0,0,0,0,0,0.0877943956912138,47.6298499362994,9.97437095694203
9.7,"random_policy_SVM","SVM",85,19,784,775,9,2000,1768,232,0.780155537677655,0.273333333333333,1.21539784946237,622,232,390,7,1.7,71.84,7.6,0,0,0,0,0,0,0.065567979065359,30.1830675009074,7.4635233731917
9.7,"random_policy_SVM","SVM",85,20,684,676,8,2100,1867,233,0.756631804773386,0.186666666666667,1.22395698924731,628,233,395,6,1.7,75.43,8,0,0,0,0,0,0,0.0419078223370979,14.8207869154268,5.19528762170475
9.7,"random_policy_SVM","SVM",85,21,584,578,6,2200,1965,235,0.780836685438448,0.253333333333333,1.20683870967742,631,235,396,3,1.7,79.02,8.4,0,0,0,0,0,0,0.0324955032392865,10.9324776870246,4.6089674793472
9.7,"random_policy_SVM","SVM",85,22,484,480,4,2300,2063,237,0.788774470367388,0.22,1.24963440860215,642,237,405,11,1.7,82.61,8.7,0,0,0,0,0,0,0.0385687201168974,11.9936851220073,5.20025210465803
9.7,"random_policy_SVM","SVM",85,23,384,383,1,2400,2160,240,0.783850898364169,0.24,1.24963440860215,658,240,418,16,1.7,86.21,9,0,0,0,0,0,0,0.0258203353537751,7.45855071195861,4.08427396241613
9.7,"random_policy_SVM","SVM",85,24,284,284,0,2500,2259,241,0.769412711182622,0.193333333333333,1.2581935483871,655,241,414,-3,1.7,89.8,9.4,0,0,0,0,0,0,0.00756740526357864,1.96525884938305,1.29240915388917
9.7,"random_policy_SVM","SVM",85,25,184,184,0,2600,2359,241,0.797264682220431,0.266666666666667,1.24963440860215,654,241,413,-1,1.7,93.39,9.8,0,0,0,0,0,0,0.0011361113117529,0.339933819458424,0.288559001764462
9.7,"random_policy_SVM","SVM",85,26,84,84,0,2700,2459,241,0.773349423437914,0.22,1.2581935483871,658,241,417,4,1.7,96.98,10.2,0,0,0,0,0,0,4.8053610134279e-07,0.0398519989315722,0.0398519989315722
9.7,"random_policy_SVM","SVM",85,27,0,0,0,2784,2543,241,0.749852507374633,0.173333333333333,1.24963440860215,654,241,413,-4,1.7,100,10.6,0,0,0,0,0,0,0,0,0
9.7,"random_policy_SVM","SVM",86,0,2684,2439,245,100,91,9,0.739457901343624,0.328467153284672,1.19952907935013,23,9,14,0,1.6,3.59,10.1,0,0,0,0,0,0,0.213160326387336,233.116954659509,27.2201570336294
9.7,"random_policy_SVM","SVM",86,1,2584,2363,221,200,167,33,0.766336184852855,0.240875912408759,1.25575700494467,81,33,48,58,1.5,7.18,5.1,0,0,0,0,0,0,0.208470135644854,377.162357984091,22.65177135181
9.7,"random_policy_SVM","SVM",86,2,2484,2287,197,300,243,57,0.760373564554374,0.277372262773723,1.27449964680951,144,57,87,63,1.5,10.78,4.3,0,0,0,0,0,0,0.209922261441034,364.940532434321,23.3096045828607
9.7,"random_policy_SVM","SVM",86,3,2384,2209,175,400,321,79,0.8015540006509,0.277372262773723,1.25575700494467,194,79,115,50,1.5,14.37,4.1,0,0,0,0,0,0,0.208952663246661,323.168381002849,21.2772471663968
9.7,"random_policy_SVM","SVM",86,4,2284,2131,153,500,399,101,0.804111069784751,0.284671532846715,1.25575700494467,246,101,145,52,1.4,17.96,4,0,0,0,0,0,0,0.218270030379665,248.074009373651,22.1421439738281
9.7,"random_policy_SVM","SVM",86,5,2184,2050,134,600,480,120,0.816582593333034,0.277372262773723,1.25575700494467,297,120,177,51,1.5,21.55,4,0,0,0,0,0,0,0.213552192474713,174.891782392598,22.3788232448731
9.7,"random_policy_SVM","SVM",86,6,2084,1980,104,700,550,150,0.819040866613988,0.284671532846715,1.25575700494467,373,150,223,76,1.5,25.14,3.7,0,0,0,0,0,0,0.22076310037156,247.901874336678,23.1977379743844
9.7,"random_policy_SVM","SVM",86,7,1984,1901,83,800,629,171,0.82413757031941,0.299270072992701,1.25575700494467,421,171,250,48,1.5,28.74,3.7,0,0,0,0,0,0,0.209211447525333,198.870552373154,21.8598441236807
9.7,"random_policy_SVM","SVM",86,8,1884,1822,62,900,708,192,0.830937049607145,0.321167883211679,1.25575700494467,478,192,286,57,1.5,32.33,3.7,0,0,0,0,0,0,0.192302070066671,162.046614674989,20.2808062907431
9.7,"random_policy_SVM","SVM",86,9,1784,1728,56,1000,802,198,0.826066995211311,0.306569343065693,1.25575700494467,481,198,283,3,1.4,35.92,4.1,0,0,0,0,0,0,0.182561387624143,167.749221327171,19.0246841528737
9.7,"random_policy_SVM","SVM",86,10,1684,1632,52,1100,898,202,0.824172439443962,0.313868613138686,1.25575700494467,504,202,302,23,1.5,39.51,4.4,0,0,0,0,0,0,0.147560702159666,98.5351498639976,15.7059689802241
9.7,"random_policy_SVM","SVM",86,11,1584,1544,40,1200,986,214,0.808277930168776,0.262773722627737,1.25575700494467,537,214,323,33,1.5,43.1,4.6,0,0,0,0,0,0,0.175094098383701,131.36009281864,18.5970719848388
9.7,"random_policy_SVM","SVM",86,12,1484,1450,34,1300,1080,220,0.803192849504868,0.240875912408759,1.25575700494467,586,220,366,49,1.7,46.7,4.9,0,0,0,0,0,0,0.162192015143257,100.155899788899,16.8175283034465
9.7,"random_policy_SVM","SVM",86,13,1384,1356,28,1400,1174,226,0.801989864707807,0.233576642335766,1.25575700494467,603,226,377,17,1.7,50.29,5.2,0,0,0,0,0,0,0.152867073036149,94.5807561043887,15.7652470692256
9.7,"random_policy_SVM","SVM",86,14,1284,1260,24,1500,1270,230,0.799769863777964,0.211678832116788,1.25575700494467,625,230,395,22,1.7,53.88,5.5,0,0,0,0,0,0,0.137381340135711,66.2118213346454,14.3276924312941
9.7,"random_policy_SVM","SVM",86,15,1184,1161,23,1600,1369,231,0.809405365195975,0.27007299270073,1.25575700494467,628,231,397,3,1.7,57.47,5.9,0,0,0,0,0,0,0.132757955336093,73.089514013474,13.6682756834203
9.7,"random_policy_SVM","SVM",86,16,1084,1061,23,1700,1469,231,0.793377190943337,0.204379562043796,1.25575700494467,618,231,387,-10,1.7,61.06,6.4,0,0,0,0,0,0,0.0947658162307758,30.0620021539669,10.434812235609
9.7,"random_policy_SVM","SVM",86,17,984,961,23,1800,1569,231,0.804244734762203,0.277372262773723,1.25575700494467,628,231,397,10,1.7,64.66,6.8,0,0,0,0,0,0,0.0602508476418556,13.6870437564576,7.59933065953064
9.7,"random_policy_SVM","SVM",86,18,884,862,22,1900,1668,232,0.80938211911294,0.27007299270073,1.25575700494467,636,232,404,8,1.7,68.25,7.2,0,0,0,0,0,0,0.0329072706455763,6.72612759264308,5.28415514206621
9.7,"random_policy_SVM","SVM",86,19,784,763,21,2000,1767,233,0.815042540331965,0.343065693430657,1.25575700494467,625,233,392,-11,1.7,71.84,7.6,0,0,0,0,0,0,0.00141044962375673,2.00369821321601,1.95679504115083
9.7,"random_policy_SVM","SVM",86,20,684,667,17,2100,1863,237,0.7534811009345,0.138686131386861,1.25575700494467,631,237,394,6,1.7,75.43,7.9,0,0,0,0,0,0,8.67596996897912e-05,0.112662397299879,0.106867577486601
9.7,"random_policy_SVM","SVM",86,21,584,576,8,2200,1954,246,0.813339764749644,0.240875912408759,1.27449964680951,694,246,448,63,1.8,79.02,7.9,0,0,0,0,0,0,0.070306861620947,20.5507813319539,9.34014321788781
9.7,"random_policy_SVM","SVM",86,22,484,479,5,2300,2051,249,0.796050490492355,0.18978102189781,1.27449964680951,692,249,443,-2,1.8,82.61,8.2,0,0,0,0,0,0,0.0654386652403266,18.1025100563316,8.46129945217675
9.7,"random_policy_SVM","SVM",86,23,384,382,2,2400,2148,252,0.790041378027802,0.218978102189781,1.27449964680951,702,252,450,10,1.8,86.21,8.5,0,0,0,0,0,0,0.0509533489934396,12.9560336658609,7.24846693193671
9.7,"random_policy_SVM","SVM",86,24,284,283,1,2500,2247,253,0.814833325584638,0.248175182481752,1.27449964680951,716,253,463,14,1.8,89.8,8.9,0,0,0,0,0,0,0.0280530665576598,6.75146178183858,5.06154626878862
9.7,"random_policy_SVM","SVM",86,25,184,183,1,2600,2347,253,0.798863266539588,0.182481751824818,1.27449964680951,703,253,450,-13,1.8,93.39,9.3,0,0,0,0,0,0,0.0171920197907608,4.00329094715527,3.27265841671888
9.7,"random_policy_SVM","SVM",86,26,84,84,0,2700,2446,254,0.821557255102517,0.255474452554745,1.27449964680951,715,254,461,12,1.8,96.98,9.6,0,0,0,0,0,0,7.27794204435394e-05,1.6066485229574,1.6066485229574
9.7,"random_policy_SVM","SVM",86,27,0,0,0,2784,2530,254,0.801060021386399,0.262773722627737,1.27449964680951,705,254,451,-10,1.8,100,10,0,0,0,0,0,0,0,0,0
9.7,"random_policy_SVM","SVM",87,0,2684,2439,245,100,95,5,0.838964040513903,0.24822695035461,1.28387096774194,22,5,17,0,3.4,3.59,19,0,0,0,0,0,0,0.0934053779978661,139.012605601764,10.7074727457377
9.7,"random_policy_SVM","SVM",87,1,2584,2359,225,200,175,25,0.795232592391183,0.205673758865248,1.28387096774194,68,25,43,46,1.7,7.18,7,0,0,0,0,0,0,0.157351635555544,282.843009858917,16.4352503417813
9.7,"random_policy_SVM","SVM",87,2,2484,2291,193,300,243,57,0.833707203226612,0.297872340425532,1.28387096774194,143,57,86,75,1.5,10.78,4.3,0,0,0,0,0,0,0.223059566006643,260.617085047828,23.160473264231
9.7,"random_policy_SVM","SVM",87,3,2384,2214,170,400,320,80,0.822995264314688,0.297872340425532,1.28387096774194,202,80,122,59,1.5,14.37,4,0,0,0,0,0,0,0.218358277184914,204.549203127255,24.1103573417417
9.7,"random_policy_SVM","SVM",87,4,2284,2136,148,500,398,102,0.845574739990487,0.354609929078014,1.28387096774194,251,102,149,49,1.5,17.96,3.9,0,0,0,0,0,0,0.200478263927084,128.316257956965,21.6729068582801
9.7,"random_policy_SVM","SVM",87,5,2184,2054,130,600,480,120,0.83175854802529,0.283687943262411,1.28387096774194,295,120,175,44,1.5,21.55,4,0,0,0,0,0,0,0.196544144016467,163.721487596814,21.6584637212928
9.7,"random_policy_SVM","SVM",87,6,2084,1978,106,700,556,144,0.846311150386335,0.368794326241135,1.28387096774194,365,144,221,70,1.5,25.14,3.9,0,0,0,0,0,0,0.184671877623011,100.845642278929,21.0838407018473
9.7,"random_policy_SVM","SVM",87,7,1984,1909,75,800,625,175,0.799849319103622,0.198581560283688,1.28387096774194,449,175,274,84,1.6,28.74,3.6,0,0,0,0,0,0,0.229587642421976,271.536204328513,25.1096724486317
9.7,"random_policy_SVM","SVM",87,8,1884,1823,61,900,711,189,0.780742301679021,0.170212765957447,1.24744909631663,500,189,311,51,1.6,32.33,3.8,0,0,0,0,0,0,0.243416701522704,248.460608350417,36.8941835637925
9.7,"random_policy_SVM","SVM",87,9,1784,1734,50,1000,800,200,0.839122651983781,0.326241134751773,1.27476549988561,497,200,297,-3,1.5,35.92,4,0,0,0,0,0,0,0.197764554506679,135.108143798266,21.8036281055575
9.7,"random_policy_SVM","SVM",87,10,1684,1648,36,1100,886,214,0.81513266716517,0.24822695035461,1.23834362846031,544,214,330,47,1.5,39.51,4.1,0,0,0,0,0,0,0.18047254594553,103.671707722899,19.2246910818172
9.7,"random_policy_SVM","SVM",87,11,1584,1560,24,1200,974,226,0.82623547005643,0.290780141843972,1.23834362846031,591,226,365,47,1.6,43.1,4.3,0,0,0,0,0,0,0.164673468454346,85.9429031796533,17.8181987566855
9.7,"random_policy_SVM","SVM",87,12,1484,1462,22,1300,1072,228,0.817574150862177,0.297872340425532,1.23834362846031,588,228,360,-3,1.6,46.7,4.7,0,0,0,0,0,0,0.146025570453132,90.2552535143015,15.7672388227704
9.7,"random_policy_SVM","SVM",87,13,1384,1364,20,1400,1170,230,0.807054811592243,0.25531914893617,1.23834362846031,611,230,381,23,1.7,50.29,5.1,0,0,0,0,0,0,0.0999729150614417,41.5407721067941,11.6473715644363
9.7,"random_policy_SVM","SVM",87,14,1284,1266,18,1500,1268,232,0.798461468742221,0.24822695035461,1.22013269274766,604,232,372,-7,1.6,53.88,5.5,0,0,0,0,0,0,0.109490697611078,54.9278684479882,13.6422091858346
9.7,"random_policy_SVM","SVM",87,15,1184,1167,17,1600,1367,233,0.786678902408637,0.177304964539007,1.22013269274766,613,233,380,9,1.6,57.47,5.9,0,0,0,0,0,0,0.0827665558185163,35.4591449689199,11.1740244587042
9.7,"random_policy_SVM","SVM",87,16,1084,1069,15,1700,1465,235,0.804528357464941,0.269503546099291,1.22013269274766,630,235,395,17,1.7,61.06,6.2,0,0,0,0,0,0,0.0825482205601508,36.8215605630469,9.91101103055847
9.7,"random_policy_SVM","SVM",87,17,984,969,15,1800,1565,235,0.789324315138338,0.191489361702128,1.22013269274766,624,235,389,-6,1.7,64.66,6.7,0,0,0,0,0,0,0.057320590239806,23.0717758774992,6.89063162641362
9.7,"random_policy_SVM","SVM",87,18,884,869,15,1900,1665,235,0.782198128384661,0.24113475177305,1.22013269274766,623,235,388,-1,1.7,68.25,7.1,0,0,0,0,0,0,0.0333690110030186,10.8048151688891,4.424678038104
9.7,"random_policy_SVM","SVM",87,19,784,769,15,2000,1765,235,0.793493530917913,0.226950354609929,1.22013269274766,623,235,388,0,1.7,71.84,7.5,0,0,0,0,0,0,0.0203767563107793,6.2021606735158,2.92146164646048
9.7,"random_policy_SVM","SVM",87,20,684,669,15,2100,1865,235,0.786582602587637,0.212765957446809,1.22013269274766,632,235,397,9,1.7,75.43,7.9,0,0,0,0,0,0,0.0209187960188444,6.36166367060001,2.86517496903699
9.7,"random_policy_SVM","SVM",87,21,584,569,15,2200,1965,235,0.762745564543543,0.198581560283688,1.22923816060398,615,235,380,-17,1.6,79.02,8.4,0,0,0,0,0,0,1.58313757322906e-05,0.539066428199551,0.53829455144184
9.7,"random_policy_SVM","SVM",87,22,484,470,14,2300,2064,236,0.779071216549977,0.205673758865248,1.21102722489133,645,236,409,30,1.7,82.61,8.7,0,0,0,0,0,0,0.00772745040047234,3.00225412854276,2.1736273465871
9.7,"random_policy_SVM","SVM",87,23,384,374,10,2400,2160,240,0.745337955724747,0.156028368794326,1.21102722489133,655,240,415,10,1.7,86.21,9,0,0,0,0,0,0,0.0503254528156007,13.55635205895,8.5953701885072
9.7,"random_policy_SVM","SVM",87,24,284,275,9,2500,2259,241,0.792032039516926,0.269503546099291,1.21102722489133,664,241,423,9,1.8,89.8,9.4,0,0,0,0,0,0,0.0189268355585852,5.83491537362612,3.81154273118512
9.7,"random_policy_SVM","SVM",87,25,184,178,6,2600,2356,244,0.7340652119729,0.148936170212766,1.21102722489133,672,244,428,8,1.8,93.39,9.7,0,0,0,0,0,0,0.0101464416964259,2.24412189180356,1.86362118929219
9.7,"random_policy_SVM","SVM",87,26,84,84,0,2700,2450,250,0.773378197720531,0.156028368794326,1.26566003202928,695,250,445,23,1.8,96.98,9.8,0,0,0,0,0,0,3.04449515381453e-07,1.29632334005186,1.29632334005186
9.7,"random_policy_SVM","SVM",87,27,0,0,0,2784,2534,250,0.742137402850479,0.141843971631206,1.26566003202928,698,250,448,3,1.8,100,10.1,0,0,0,0,0,0,0,0,0
9.7,"random_policy_SVM","SVM",88,0,2684,2437,247,100,91,9,0.296543602425955,0,0.884444444444444,30,9,21,0,2.3,3.59,10.1,0,0,0,0,0,0,0.10722181476408,231.407978443099,11.0637891066331
9.7,"random_policy_SVM","SVM",88,1,2584,2337,247,200,191,9,0.691344285461933,0.0962962962962963,1.26485065710872,32,9,23,2,2.6,7.18,21.2,0,0,0,0,0,0,0.0655356070908854,143.84970122427,9.09794664772299
9.7,"random_policy_SVM","SVM",88,2,2484,2246,238,300,282,18,0.650962727433316,0.192592592592593,1.21729988052569,65,18,47,33,2.6,10.78,15.7,0,0,0,0,0,0,0.082443381124476,176.068673250002,8.7878804711754
9.7,"random_policy_SVM","SVM",88,3,2384,2163,221,400,365,35,0.699275746334573,0.2,1.2363201911589,104,35,69,39,2,14.37,10.4,0,0,0,0,0,0,0.126494967750454,231.481440977449,14.3239657927749
9.7,"random_policy_SVM","SVM",88,4,2284,2073,211,500,455,45,0.70174291938998,0.192592592592593,1.2363201911589,134,45,89,30,2,17.96,10.1,0,0,0,0,0,0,0.129495786409176,206.81819882591,13.5585447950423
9.7,"random_policy_SVM","SVM",88,5,2184,1986,198,600,542,58,0.752334687628811,0.266666666666667,1.24583034647551,168,58,110,34,1.9,21.55,9.3,0,0,0,0,0,0,0.115021954529721,207.343546687647,11.7394206481826
9.7,"random_policy_SVM","SVM",88,6,2084,1899,185,700,629,71,0.765736324559856,0.288888888888889,1.24583034647551,202,71,131,34,1.8,25.14,8.9,0,0,0,0,0,0,0.128097801638005,154.498374407247,13.3058049407989
9.7,"random_policy_SVM","SVM",88,7,1984,1827,157,800,701,99,0.775075075075081,0.325925925925926,1.22681003584229,274,99,175,72,1.8,28.74,7.1,0,0,0,0,0,0,0.156596178403199,182.806324929924,16.0800465678574
9.7,"random_policy_SVM","SVM",88,8,1884,1755,129,900,773,127,0.788806453512339,0.311111111111111,1.24583034647551,334,127,207,60,1.6,32.33,6.1,0,0,0,0,0,0,0.17397528186886,167.425069734912,18.116306897199
9.7,"random_policy_SVM","SVM",88,9,1784,1682,102,1000,846,154,0.793487605252317,0.340740740740741,1.2363201911589,395,154,241,61,1.6,35.92,5.5,0,0,0,0,0,0,0.174972450699232,169.60055569056,18.3667177043856
9.7,"random_policy_SVM","SVM",88,10,1684,1614,70,1100,914,186,0.803656597774252,0.333333333333333,1.24583034647551,453,186,267,58,1.4,39.51,4.9,0,0,0,0,0,0,0.18473417753018,169.302792007331,19.6637947402116
9.7,"random_policy_SVM","SVM",88,11,1584,1533,51,1200,995,205,0.797273744332575,0.288888888888889,1.24583034647551,507,205,302,54,1.5,43.1,4.9,0,0,0,0,0,0,0.168499182615288,117.603861641761,18.4109726838385
9.7,"random_policy_SVM","SVM",88,12,1484,1443,41,1300,1085,215,0.796455278808225,0.288888888888889,1.22681003584229,537,215,322,30,1.5,46.7,5,0,0,0,0,0,0,0.168689077645528,173.934760028235,17.6280738980962
9.7,"random_policy_SVM","SVM",88,13,1384,1344,40,1400,1184,216,0.80562915857034,0.303703703703704,1.2363201911589,554,216,338,17,1.6,50.29,5.5,0,0,0,0,0,0,0.136500032387134,102.568289303984,14.9578909180453
9.7,"random_policy_SVM","SVM",88,14,1284,1252,32,1500,1276,224,0.813566507684157,0.325925925925926,1.22681003584229,563,224,339,9,1.5,53.88,5.7,0,0,0,0,0,0,0.15069496394435,105.916207317788,16.4572004690363
9.7,"random_policy_SVM","SVM",88,15,1184,1167,17,1600,1361,239,0.801271860095392,0.266666666666667,1.22681003584229,632,239,393,69,1.6,57.47,5.7,0,0,0,0,0,0,0.128109113457158,86.0507631571452,15.0337661702878
9.7,"random_policy_SVM","SVM",88,16,1084,1073,11,1700,1455,245,0.740664193605373,0.17037037037037,1.21729988052569,646,245,401,14,1.6,61.06,5.9,0,0,0,0,0,0,0.138212041576844,87.0419306642294,15.2097890091766
9.7,"random_policy_SVM","SVM",88,17,984,974,10,1800,1554,246,0.762521344874291,0.222222222222222,1.21729988052569,661,246,415,15,1.7,64.66,6.3,0,0,0,0,0,0,0.115700331911175,68.9179368070345,12.7714427017454
9.7,"random_policy_SVM","SVM",88,18,884,875,9,1900,1653,247,0.747129482423603,0.185185185185185,1.21729988052569,668,247,421,7,1.7,68.25,6.7,0,0,0,0,0,0,0.0872199192884421,41.8871043246322,9.92151974311737
9.7,"random_policy_SVM","SVM",88,19,784,775,9,2000,1753,247,0.721945474886654,0.2,1.21729988052569,665,247,418,-3,1.7,71.84,7.1,0,0,0,0,0,0,0.0946382873418514,45.4178060867387,10.2506597385379
9.7,"random_policy_SVM","SVM",88,20,684,675,9,2100,1853,247,0.764128834717077,0.251851851851852,1.21729988052569,664,247,417,-1,1.7,75.43,7.5,0,0,0,0,0,0,0.0494106511104258,17.8095788444656,6.00147493702002
9.7,"random_policy_SVM","SVM",88,21,584,576,8,2200,1952,248,0.755066831537423,0.185185185185185,1.22681003584229,672,248,424,8,1.7,79.02,7.9,0,0,0,0,0,0,0.0340341541355886,10.4447343816841,4.47083182798649
9.7,"random_policy_SVM","SVM",88,22,484,476,8,2300,2052,248,0.717661779426487,0.177777777777778,1.22568037650911,660,248,412,-12,1.7,82.61,8.3,0,0,0,0,0,0,0.0204523749091894,5.71964806073458,3.06235012145143
9.7,"random_policy_SVM","SVM",88,23,384,376,8,2400,2152,248,0.790837896720254,0.274074074074074,1.22681003584229,660,248,412,0,1.7,86.21,8.7,0,0,0,0,0,0,0.014226068600579,3.70513309109372,1.96819335563859
9.7,"random_policy_SVM","SVM",88,24,284,277,7,2500,2251,249,0.797541659306369,0.303703703703704,1.22568037650911,673,249,424,13,1.7,89.8,9,0,0,0,0,0,0,0.00459489276783957,1.09210867386855,0.817152219757265
9.7,"random_policy_SVM","SVM",88,25,184,180,4,2600,2348,252,0.757139492433619,0.177777777777778,1.27436081242533,685,252,433,12,1.7,93.39,9.3,0,0,0,0,0,0,0.00943177625897119,4.63663774225422,4.24771026051741
9.7,"random_policy_SVM","SVM",88,26,84,84,0,2700,2444,256,0.780757227816064,0.207407407407407,1.27318736784667,707,256,451,22,1.8,96.98,9.5,0,0,0,0,0,0,1.88112832138431e-08,0.431976624092879,0.431976624092879
9.7,"random_policy_SVM","SVM",88,27,0,0,0,2784,2528,256,0.750927397986228,0.2,1.26485065710872,700,256,444,-7,1.7,100,9.9,0,0,0,0,0,0,0,0,0
9.7,"random_policy_SVM","SVM",89,0,2684,2437,247,100,89,11,0.69630624179497,0.195488721804511,1.21629881154499,33,11,22,0,2,3.59,8.1,0,0,0,0,0,0,0.129434996114944,292.172427764419,15.586278279601
9.7,"random_policy_SVM","SVM",89,1,2584,2346,238,200,180,20,0.734777419739827,0.233082706766917,1.24525830705797,66,20,46,33,2.3,7.18,9,0,0,0,0,0,0,0.139095373662576,273.375206553482,15.4929882597151
9.7,"random_policy_SVM","SVM",89,2,2484,2273,211,300,253,47,0.761612364243949,0.345864661654135,1.206645646374,121,47,74,55,1.6,10.78,5.4,0,0,0,0,0,0,0.189218665796191,365.507790196724,19.9896949295725
9.7,"random_policy_SVM","SVM",89,3,2384,2206,178,400,320,80,0.706146318176395,0.120300751879699,1.24525830705797,202,80,122,81,1.5,14.37,4,0,0,0,0,0,0,0.257304297886547,408.127250229866,27.8006446815525
9.7,"random_policy_SVM","SVM",89,4,2284,2115,169,500,411,89,0.727109440267344,0.218045112781955,1.25491147222896,235,89,146,33,1.6,17.96,4.6,0,0,0,0,0,0,0.192905327701238,338.723266695722,19.6873846870753
9.7,"random_policy_SVM","SVM",89,5,2184,2034,150,600,492,108,0.755227354099537,0.218045112781955,1.25491147222896,286,108,178,51,1.6,21.55,4.6,0,0,0,0,0,0,0.195736132749428,293.210037485024,20.6821153897204
9.7,"random_policy_SVM","SVM",89,6,2084,1944,140,700,582,118,0.759422365437401,0.240601503759398,1.26456463739995,305,118,187,19,1.6,25.14,4.9,0,0,0,0,0,0,0.171506070214415,289.748655628297,17.5825504077835
9.7,"random_policy_SVM","SVM",89,7,1984,1859,125,800,667,133,0.767191788996305,0.218045112781955,1.27421780257094,342,133,209,37,1.6,28.74,5,0,0,0,0,0,0,0.17250256793782,239.590240367997,18.3487158943287
9.7,"random_policy_SVM","SVM",89,8,1884,1778,106,900,748,152,0.787056928034373,0.233082706766917,1.27421780257094,383,152,231,41,1.5,32.33,4.9,0,0,0,0,0,0,0.161343222276897,143.907846277263,17.3505246070156
9.7,"random_policy_SVM","SVM",89,9,1784,1701,83,1000,825,175,0.815747702589816,0.270676691729323,1.27421780257094,438,175,263,55,1.5,35.92,4.7,0,0,0,0,0,0,0.171723439871872,166.421618999816,17.9402560173747
9.7,"random_policy_SVM","SVM",89,10,1684,1628,56,1100,898,202,0.824853801169596,0.255639097744361,1.27421780257094,496,202,294,58,1.5,39.51,4.4,0,0,0,0,0,0,0.173436448765477,190.676497309876,18.0958259221126
9.7,"random_policy_SVM","SVM",89,11,1584,1545,39,1200,981,219,0.821100369972563,0.285714285714286,1.27421780257094,555,219,336,59,1.5,43.1,4.5,0,0,0,0,0,0,0.153614868900349,100.888630206694,16.6787999814574
9.7,"random_policy_SVM","SVM",89,12,1484,1455,29,1300,1071,229,0.812996777658443,0.263157894736842,1.27421780257094,586,229,357,31,1.6,46.7,4.7,0,0,0,0,0,0,0.151354316660686,110.10731576635,16.2592089702194
9.7,"random_policy_SVM","SVM",89,13,1384,1360,24,1400,1166,234,0.7999283924096,0.255639097744361,1.24525830705797,614,234,380,28,1.6,50.29,5,0,0,0,0,0,0,0.152626769812446,133.186098416404,16.0695829980733
9.7,"random_policy_SVM","SVM",89,14,1284,1263,21,1500,1263,237,0.801473922902498,0.255639097744361,1.26456463739995,617,237,380,3,1.6,53.88,5.3,0,0,0,0,0,0,0.100901736850456,51.2112242962216,11.6777640755503
9.7,"random_policy_SVM","SVM",89,15,1184,1166,18,1600,1360,240,0.77200143215181,0.203007518796992,1.24525830705797,621,240,381,4,1.6,57.47,5.7,0,0,0,0,0,0,0.104693745504472,60.1072299491639,12.5687180145573
9.7,"random_policy_SVM","SVM",89,16,1084,1069,15,1700,1457,243,0.792934717746748,0.233082706766917,1.24525830705797,637,243,394,16,1.6,61.06,6,0,0,0,0,0,0,0.0766458057712089,41.8786821381399,10.0725761555686
9.7,"random_policy_SVM","SVM",89,17,984,970,14,1800,1556,244,0.787128535624787,0.218045112781955,1.26456463739995,660,244,416,23,1.7,64.66,6.4,0,0,0,0,0,0,0.0933380193228719,54.1802629118084,10.2812382067018
9.7,"random_policy_SVM","SVM",89,18,884,872,12,1900,1654,246,0.792833273660349,0.218045112781955,1.26456463739995,645,246,399,-15,1.6,68.25,6.7,0,0,0,0,0,0,0.0221824726697986,7.3366214971129,4.03558768446905
9.7,"random_policy_SVM","SVM",89,19,784,773,11,2000,1753,247,0.782587420933296,0.203007518796992,1.27421780257094,660,247,413,15,1.7,71.84,7.1,0,0,0,0,0,0,0.0194178207842545,6.34368219538282,3.54801137634739
9.7,"random_policy_SVM","SVM",89,20,684,677,7,2100,1849,251,0.807781358157306,0.24812030075188,1.25491147222896,681,251,430,21,1.7,75.43,7.4,0,0,0,0,0,0,0.0306155367664254,11.7240021674986,4.90342205395787
9.7,"random_policy_SVM","SVM",89,21,584,580,4,2200,1946,254,0.803180570473803,0.233082706766917,1.28387096774194,685,254,431,4,1.7,79.02,7.7,0,0,0,0,0,0,0.0741486385566962,21.5035165966141,15.0990271369834
9.7,"random_policy_SVM","SVM",89,22,484,482,2,2300,2044,256,0.809291084855,0.195488721804511,1.27421780257094,698,256,442,13,1.7,82.61,8,0,0,0,0,0,0,0.00816310577977587,2.84100604567509,2.43294910282791
9.7,"random_policy_SVM","SVM",89,23,384,383,1,2400,2143,257,0.802184031507345,0.263157894736842,1.27421780257094,702,257,445,4,1.7,86.21,8.3,0,0,0,0,0,0,0.0150509113289674,6.4053916892861,4.92906534240763
9.7,"random_policy_SVM","SVM",89,24,284,283,1,2500,2243,257,0.796843298723003,0.18796992481203,1.27421780257094,697,257,440,-5,1.7,89.8,8.7,0,0,0,0,0,0,0.000340112133647545,0.330594928489846,0.308106638658662
9.7,"random_policy_SVM","SVM",89,25,184,184,0,2600,2342,258,0.816511516887463,0.218045112781955,1.27421780257094,710,258,452,13,1.8,93.39,9.1,0,0,0,0,0,0,0.00379298136168583,3.02676055585555,2.89915842041486
9.7,"random_policy_SVM","SVM",89,26,84,84,0,2700,2442,258,0.83649600190954,0.300751879699248,1.27421780257094,701,258,443,-9,1.7,96.98,9.5,0,0,0,0,0,0,6.32797006101258e-07,0.0439090131463767,0.0439090131463767
9.7,"random_policy_SVM","SVM",89,27,0,0,0,2784,2526,258,0.780128893662731,0.218045112781955,1.27421780257094,704,258,446,3,1.7,100,9.8,0,0,0,0,0,0,0,0,0
9.7,"random_policy_SVM","SVM",90,0,2684,2418,266,100,93,7,0.824858757062151,0.279661016949153,1.26211044286495,23,7,16,0,2.3,3.59,13.3,0,0,0,0,0,0,0.0978941574623581,203.531775235108,11.4816408242051
9.7,"random_policy_SVM","SVM",90,1,2584,2343,241,200,168,32,0.818850116317719,0.194915254237288,1.26211044286495,83,32,51,60,1.6,7.18,5.2,0,0,0,0,0,0,0.190801505088378,336.966764516573,21.5527203251287
9.7,"random_policy_SVM","SVM",90,2,2484,2260,224,300,251,49,0.834190761050188,0.271186440677966,1.26211044286495,130,49,81,47,1.7,10.78,5.1,0,0,0,0,0,0,0.186024347700959,212.81888542445,19.513494148201
9.7,"random_policy_SVM","SVM",90,3,2384,2192,192,400,319,81,0.827424393486214,0.279661016949153,1.26211044286495,198,81,117,68,1.4,14.37,3.9,0,0,0,0,0,0,0.220433395313182,211.764443840555,23.2010243210492
9.7,"random_policy_SVM","SVM",90,4,2284,2129,155,500,382,118,0.81209039548023,0.23728813559322,1.24034991798797,274,118,156,76,1.3,17.96,3.2,0,0,0,0,0,0,0.211244831275686,204.29996468975,22.9256631231433
9.7,"random_policy_SVM","SVM",90,5,2184,2060,124,600,451,149,0.820511797939522,0.220338983050847,1.25123018042646,343,149,194,69,1.3,21.55,3,0,0,0,0,0,0,0.227701905512406,199.770682956527,23.9914411163481
9.7,"random_policy_SVM","SVM",90,6,2084,1992,92,700,519,181,0.82189431704886,0.288135593220339,1.25123018042646,422,181,241,79,1.3,25.14,2.9,0,0,0,0,0,0,0.250271056439515,215.881550013221,26.0315697393974
9.7,"random_policy_SVM","SVM",90,7,1984,1904,80,800,607,193,0.815240943835168,0.228813559322034,1.26211044286495,451,193,258,29,1.3,28.74,3.1,0,0,0,0,0,0,0.219462226185569,160.715822834769,24.2395950294295
9.7,"random_policy_SVM","SVM",90,8,1884,1826,58,900,685,215,0.815599867065477,0.23728813559322,1.25123018042646,514,215,299,63,1.4,32.33,3.2,0,0,0,0,0,0,0.22001991006975,203.267910395955,24.4887991530645
9.7,"random_policy_SVM","SVM",90,9,1784,1733,51,1000,778,222,0.818251910933871,0.211864406779661,1.26211044286495,537,222,315,23,1.4,35.92,3.5,0,0,0,0,0,0,0.192605192719122,149.233317813219,20.5293181934271
9.7,"random_policy_SVM","SVM",90,10,1684,1649,35,1100,862,238,0.818943170488542,0.211864406779661,1.24034991798797,579,238,341,42,1.4,39.51,3.6,0,0,0,0,0,0,0.192721996896421,134.274234816072,20.4398360107993
9.7,"random_policy_SVM","SVM",90,11,1584,1560,24,1200,951,249,0.8235360584912,0.220338983050847,1.25123018042646,606,249,357,27,1.4,43.1,3.8,0,0,0,0,0,0,0.168905896507171,113.932421983429,18.4353627655797
9.7,"random_policy_SVM","SVM",90,12,1484,1463,21,1300,1048,252,0.823742107012305,0.254237288135593,1.25123018042646,629,252,377,23,1.5,46.7,4.2,0,0,0,0,0,0,0.141435064112071,75.7535524048404,15.980098255454
9.7,"random_policy_SVM","SVM",90,13,1384,1365,19,1400,1146,254,0.818079096045206,0.228813559322034,1.24034991798797,628,254,374,-1,1.5,50.29,4.5,0,0,0,0,0,0,0.0917749948802987,41.3372047308089,10.5856657564233
9.7,"random_policy_SVM","SVM",90,14,1284,1267,17,1500,1244,256,0.8128880026587,0.23728813559322,1.21858939311099,655,256,399,27,1.6,53.88,4.9,0,0,0,0,0,0,0.132596900891718,60.8835170126402,15.0698540672333
9.7,"random_policy_SVM","SVM",90,15,1184,1169,15,1600,1342,258,0.811139913592566,0.220338983050847,1.21858939311099,651,258,393,-4,1.5,57.47,5.2,0,0,0,0,0,0,0.133286260011784,69.8584376674586,14.722652509599
9.7,"random_policy_SVM","SVM",90,16,1084,1070,14,1700,1441,259,0.794808906613502,0.161016949152542,1.21858939311099,656,259,397,5,1.5,61.06,5.6,0,0,0,0,0,0,0.105601260318847,50.5031866606786,12.5187717992406
9.7,"random_policy_SVM","SVM",90,17,984,970,14,1800,1541,259,0.80703888334996,0.228813559322034,1.21858939311099,666,259,407,10,1.6,64.66,5.9,0,0,0,0,0,0,0.0827042917449773,32.1495873597421,9.50639007898118
9.7,"random_policy_SVM","SVM",90,18,884,871,13,1900,1640,260,0.811246261216361,0.220338983050847,1.21858939311099,663,260,403,-3,1.6,68.25,6.3,0,0,0,0,0,0,0.0371996938704681,11.5701802172343,5.13326329900411
9.7,"random_policy_SVM","SVM",90,19,784,771,13,2000,1740,260,0.796311066799611,0.161016949152542,1.21858939311099,670,260,410,7,1.6,71.84,6.7,0,0,0,0,0,0,0.0264320594931374,9.0040213200517,3.76596114123769
9.7,"random_policy_SVM","SVM",90,20,684,672,12,2100,1839,261,0.79590561648389,0.194915254237288,1.21858939311099,668,261,407,-2,1.6,75.43,7,0,0,0,0,0,0,0.0104945209993071,3.49290710564942,2.06126452920762
9.7,"random_policy_SVM","SVM",90,21,584,574,10,2200,1937,263,0.80922565636425,0.245762711864407,1.21858939311099,685,263,422,17,1.6,79.02,7.4,0,0,0,0,0,0,0.0194694621123775,6.10710271104663,3.31916972482205
9.7,"random_policy_SVM","SVM",90,22,484,475,9,2300,2036,264,0.793878364905293,0.203389830508475,1.21858939311099,698,264,434,13,1.6,82.61,7.7,0,0,0,0,0,0,0.0233390227797746,7.15768172976196,3.25352221602929
9.7,"random_policy_SVM","SVM",90,23,384,376,8,2400,2135,265,0.793253572615496,0.177966101694915,1.21858939311099,702,265,437,4,1.6,86.21,8.1,0,0,0,0,0,0,0.00649406942806317,1.89337384366881,1.16801135772935
9.7,"random_policy_SVM","SVM",90,24,284,280,4,2500,2231,269,0.792037221668333,0.135593220338983,1.25123018042646,705,269,436,3,1.6,89.8,8.3,0,0,0,0,0,0,0.00614669472902726,3.38980659616729,2.97832383729043
9.7,"random_policy_SVM","SVM",90,25,184,184,0,2600,2327,273,0.820604852110341,0.23728813559322,1.26211044286495,725,273,452,20,1.7,93.39,8.5,0,0,0,0,0,0,0.000210768704785741,0.851385654465011,0.845115622188789
9.7,"random_policy_SVM","SVM",90,26,84,84,0,2700,2427,273,0.799641076769695,0.194915254237288,1.27299070530344,721,273,448,-4,1.6,96.98,8.9,0,0,0,0,0,0,1.22995998341808e-06,0.0424086170481,0.0424086170481
9.7,"random_policy_SVM","SVM",90,27,0,0,0,2784,2511,273,0.809132602193424,0.228813559322034,1.28387096774194,732,273,459,11,1.7,100,9.2,0,0,0,0,0,0,0,0,0
9.7,"random_policy_SVM","SVM",91,0,2684,2431,253,100,94,6,0.86156970177587,0.371212121212121,1.27414467253177,20,6,14,0,2.3,3.59,15.7,0,0,0,0,0,0,0.0766689241228643,157.99534934362,8.01789491374241
9.7,"random_policy_SVM","SVM",91,1,2584,2367,217,200,158,42,0.759059668853476,0.257575757575758,1.22551319648094,104,42,62,84,1.5,7.18,3.8,0,0,0,0,0,0,0.237213751861614,491.915347465429,25.8903896646142
9.7,"random_policy_SVM","SVM",91,2,2484,2288,196,300,237,63,0.745620359022423,0.242424242424242,1.18660801564027,152,63,89,48,1.4,10.78,3.8,0,0,0,0,0,0,0.227806554507822,431.001254558934,23.9221465001812
9.7,"random_policy_SVM","SVM",91,3,2384,2203,181,400,322,78,0.793027419316073,0.318181818181818,1.20606060606061,185,78,107,33,1.4,14.37,4.1,0,0,0,0,0,0,0.218054859942379,285.318671166181,22.6296181826385
9.7,"random_policy_SVM","SVM",91,4,2284,2121,163,500,404,96,0.795508615096238,0.340909090909091,1.19633431085044,239,96,143,54,1.5,17.96,4.2,0,0,0,0,0,0,0.207794288904259,237.080396685183,21.415736776179
9.7,"random_policy_SVM","SVM",91,5,2184,2054,130,600,471,129,0.792090212193301,0.356060606060606,1.18660801564027,329,129,200,90,1.6,21.55,3.7,0,0,0,0,0,0,0.23609493955444,213.167142651233,24.1984643366004
9.7,"random_policy_SVM","SVM",91,6,2084,1986,98,700,539,161,0.787278014082135,0.386363636363636,1.17688172043011,391,161,230,62,1.4,25.14,3.3,0,0,0,0,0,0,0.243888214534158,249.307787876695,25.1053756593578
9.7,"random_policy_SVM","SVM",91,7,1984,1897,87,800,628,172,0.792877225866912,0.340909090909091,1.18660801564027,416,172,244,25,1.4,28.74,3.7,0,0,0,0,0,0,0.194767973235653,168.27523955072,21.1963515341963
9.7,"random_policy_SVM","SVM",91,8,1884,1813,71,900,712,188,0.788221228942875,0.318181818181818,1.19633431085044,467,188,279,51,1.5,32.33,3.8,0,0,0,0,0,0,0.208610486314625,185.691730111208,21.8654838997933
9.7,"random_policy_SVM","SVM",91,9,1784,1728,56,1000,797,203,0.789440799750076,0.287878787878788,1.19633431085044,505,203,302,38,1.5,35.92,3.9,0,0,0,0,0,0,0.186124442450364,116.857426469016,19.8456348247384
9.7,"random_policy_SVM","SVM",91,10,1684,1640,44,1100,885,215,0.794649508567033,0.318181818181818,1.19633431085044,542,215,327,37,1.5,39.51,4.1,0,0,0,0,0,0,0.188232505603221,145.491828168039,19.4969343637303
9.7,"random_policy_SVM","SVM",91,11,1584,1547,37,1200,978,222,0.790924711027803,0.303030303030303,1.20606060606061,561,222,339,19,1.5,43.1,4.4,0,0,0,0,0,0,0.151666889322501,64.0294113862743,16.8868385177749
9.7,"random_policy_SVM","SVM",91,12,1484,1457,27,1300,1068,232,0.805265181553839,0.340909090909091,1.21578690127077,590,232,358,29,1.5,46.7,4.6,0,0,0,0,0,0,0.12310894164146,38.7291168005298,14.6675969592302
9.7,"random_policy_SVM","SVM",91,13,1384,1359,25,1400,1166,234,0.795478576406412,0.303030303030303,1.20606060606061,599,234,365,9,1.6,50.29,5,0,0,0,0,0,0,0.127979890538712,44.2626268113315,14.93352826026
9.7,"random_policy_SVM","SVM",91,14,1284,1260,24,1500,1265,235,0.788671809290366,0.310606060606061,1.20606060606061,620,235,385,21,1.6,53.88,5.4,0,0,0,0,0,0,0.0816689885767839,21.8281308790024,10.9899038713138
9.7,"random_policy_SVM","SVM",91,15,1184,1161,23,1600,1364,236,0.787127820632981,0.310606060606061,1.20606060606061,623,236,387,3,1.6,57.47,5.8,0,0,0,0,0,0,0.0608172556997385,15.6348610760426,9.2446754142307
9.7,"random_policy_SVM","SVM",91,16,1084,1061,23,1700,1464,236,0.794985941893164,0.348484848484849,1.20606060606061,628,236,392,5,1.7,61.06,6.2,0,0,0,0,0,0,0.044774560515207,12.2276305585242,6.32114854206058
9.7,"random_policy_SVM","SVM",91,17,984,963,21,1800,1562,238,0.772027371254185,0.265151515151515,1.17688172043011,627,238,389,-1,1.6,64.66,6.6,0,0,0,0,0,0,0.0371238908110309,9.45762576097483,7.32239268181076
9.7,"random_policy_SVM","SVM",91,18,884,863,21,1900,1662,238,0.735812726792118,0.143939393939394,1.17688172043011,633,238,395,6,1.7,68.25,7,0,0,0,0,0,0,0.00512004673088304,2.53199431582209,2.37567586816835
9.7,"random_policy_SVM","SVM",91,19,784,765,19,2000,1760,240,0.773922812582616,0.295454545454545,1.14770283479961,652,240,412,19,1.7,71.84,7.3,0,0,0,0,0,0,0.0353563854257644,12.2738632364634,6.00308643671224
9.7,"random_policy_SVM","SVM",91,20,684,666,18,2100,1859,241,0.768912359118552,0.295454545454545,1.15742913000977,633,241,392,-19,1.6,75.43,7.7,0,0,0,0,0,0,0.00832241350541843,2.8110655939198,2.02973991208383
9.7,"random_policy_SVM","SVM",91,21,584,566,18,2200,1959,241,0.762640280681524,0.265151515151515,1.15742913000977,646,241,405,13,1.7,79.02,8.1,0,0,0,0,0,0,0.00117763943598591,0.41115195460322,0.317852217076787
9.7,"random_policy_SVM","SVM",91,22,484,469,15,2300,2056,244,0.796998534111939,0.310606060606061,1.19633431085044,658,244,414,12,1.7,82.61,8.4,0,0,0,0,0,0,0.00186824781529336,0.976511676883836,0.83679326141943
9.7,"random_policy_SVM","SVM",91,23,384,374,10,2400,2151,249,0.793790402037819,0.25,1.21578690127077,668,249,419,10,1.7,86.21,8.6,0,0,0,0,0,0,0.0146614419973701,6.14496208654157,5.55279296912881
9.7,"random_policy_SVM","SVM",91,24,284,274,10,2500,2251,249,0.774902073871145,0.272727272727273,1.20606060606061,668,249,419,0,1.7,89.8,9,0,0,0,0,0,0,0.00206104322281846,0.827237493291936,0.702337655242601
9.7,"random_policy_SVM","SVM",91,25,184,178,6,2600,2347,253,0.796559969240375,0.257575757575758,1.2352394916911,679,253,426,11,1.7,93.39,9.3,0,0,0,0,0,0,0.0190251976007237,5.50492515499642,5.06768831461303
9.7,"random_policy_SVM","SVM",91,26,84,84,0,2700,2441,259,0.815694614663679,0.28030303030303,1.27414467253177,734,259,475,55,1.8,96.98,9.4,0,0,0,0,0,0,7.63940169325816e-06,0.237467136954321,0.237467136954321
9.7,"random_policy_SVM","SVM",91,27,0,0,0,2784,2525,259,0.762808497344577,0.181818181818182,1.27414467253177,712,259,453,-22,1.7,100,9.7,0,0,0,0,0,0,0,0,0
9.7,"random_policy_SVM","SVM",92,0,2684,2429,255,100,88,12,0.767342840438245,0.193548387096774,1.27351716961498,31,12,19,0,1.6,3.59,7.3,0,0,0,0,0,0,0.389886460611818,315.974945358259,49.9160449786512
9.7,"random_policy_SVM","SVM",92,1,2584,2354,230,200,163,37,0.796988993111162,0.25,1.26316337148803,89,37,52,58,1.4,7.18,4.4,0,0,0,0,0,0,0.209958448004162,372.212999789714,24.4419452549194
9.7,"random_policy_SVM","SVM",92,2,2484,2283,201,300,234,66,0.81325783573553,0.290322580645161,1.26316337148803,153,66,87,64,1.3,10.78,3.5,0,0,0,0,0,0,0.322532503278525,286.788395556425,37.212774260745
9.7,"random_policy_SVM","SVM",92,3,2384,2220,164,400,297,103,0.797770660159134,0.274193548387097,1.23210197710718,238,103,135,85,1.3,14.37,2.9,0,0,0,0,0,0,0.269994000987808,317.792309093815,27.871865124727
9.7,"random_policy_SVM","SVM",92,4,2284,2134,150,500,383,117,0.79671572739521,0.274193548387097,1.23210197710718,276,117,159,38,1.4,17.96,3.3,0,0,0,0,0,0,0.240071889130588,231.594043213198,24.5626495653194
9.7,"random_policy_SVM","SVM",92,5,2184,2066,118,600,451,149,0.806801138818985,0.298387096774194,1.24245577523413,350,149,201,74,1.3,21.55,3,0,0,0,0,0,0,0.250201410619905,219.411977448428,25.6871505989873
9.7,"random_policy_SVM","SVM",92,6,2084,1991,93,700,526,174,0.80915249497954,0.290322580645161,1.23210197710718,411,174,237,61,1.4,25.14,3,0,0,0,0,0,0,0.228853293692678,142.796249907925,24.2450713202264
9.7,"random_policy_SVM","SVM",92,7,1984,1919,65,800,598,202,0.793805129769446,0.225806451612903,1.22174817898023,479,202,277,68,1.4,28.74,3,0,0,0,0,0,0,0.24925015171372,236.124940370107,30.3157680440147
9.7,"random_policy_SVM","SVM",92,8,1884,1839,45,900,678,222,0.803019903912157,0.282258064516129,1.21027891641419,524,222,302,45,1.4,32.33,3.1,0,0,0,0,0,0,0.217746801674061,185.214456578469,23.1247446037758
9.7,"random_policy_SVM","SVM",92,9,1784,1749,35,1000,768,232,0.796575917028914,0.290322580645161,1.21139438085328,547,232,315,23,1.4,35.92,3.3,0,0,0,0,0,0,0.187892330908511,135.065199895597,20.4697403836969
9.7,"random_policy_SVM","SVM",92,10,1684,1658,26,1100,859,241,0.753399933907839,0.209677419354839,1.16997918834547,591,241,350,44,1.5,39.51,3.6,0,0,0,0,0,0,0.21980993750304,191.980691183817,22.7391970168387
9.7,"random_policy_SVM","SVM",92,11,1584,1560,24,1200,957,243,0.78432979994408,0.225806451612903,1.22174817898023,598,243,355,7,1.5,43.1,3.9,0,0,0,0,0,0,0.198255981484697,102.850372791871,20.7548442049034
9.7,"random_policy_SVM","SVM",92,12,1484,1462,22,1300,1055,245,0.791746104374799,0.266129032258065,1.21139438085328,586,245,341,-12,1.4,46.7,4.3,0,0,0,0,0,0,0.151960035430264,57.2537515941759,17.4775899027901
9.7,"random_policy_SVM","SVM",92,13,1384,1363,21,1400,1154,246,0.787926739368063,0.233870967741935,1.21139438085328,596,246,350,10,1.4,50.29,4.7,0,0,0,0,0,0,0.148827183344212,56.2211041667138,16.0944601386165
9.7,"random_policy_SVM","SVM",92,14,1284,1263,21,1500,1254,246,0.783278044688482,0.225806451612903,1.21139438085328,601,246,355,5,1.4,53.88,5.1,0,0,0,0,0,0,0.0770319477127071,20.6280560146896,9.80113567038326
9.7,"random_policy_SVM","SVM",92,15,1184,1164,20,1600,1353,247,0.7564503418999,0.201612903225806,1.21139438085328,616,247,369,15,1.5,57.47,5.5,0,0,0,0,0,0,0.113625719779738,34.0676958099419,13.7712110344852
9.7,"random_policy_SVM","SVM",92,16,1084,1066,18,1700,1451,249,0.783551310404441,0.241935483870968,1.21139438085328,617,249,368,1,1.5,61.06,5.8,0,0,0,0,0,0,0.0925169510725347,23.7956984643773,11.4731321770602
9.7,"random_policy_SVM","SVM",92,17,984,966,18,1800,1551,249,0.776773685147063,0.298387096774194,1.20104058272633,643,249,394,26,1.6,64.66,6.2,0,0,0,0,0,0,0.0695300032059774,15.532615477021,8.66744309047494
9.7,"random_policy_SVM","SVM",92,18,884,867,17,1900,1650,250,0.789960344696111,0.314516129032258,1.20104058272633,635,250,385,-8,1.5,68.25,6.6,0,0,0,0,0,0,0.0289884335127442,6.40605236281134,5.58263887345802
9.7,"random_policy_SVM","SVM",92,19,784,767,17,2000,1750,250,0.784933526525849,0.32258064516129,1.20104058272633,642,250,392,7,1.6,71.84,7,0,0,0,0,0,0,0.000302526463641784,1.31574842542453,1.30250764875011
9.7,"random_policy_SVM","SVM",92,20,684,669,15,2100,1848,252,0.777752357711182,0.290322580645161,1.22174817898023,658,252,406,16,1.6,75.43,7.3,0,0,0,0,0,0,3.19364540370697e-05,0.102097416854258,0.100755390214737
9.7,"random_policy_SVM","SVM",92,21,584,575,9,2200,1942,258,0.7520399603447,0.161290322580645,1.24245577523413,676,258,418,18,1.6,79.02,7.5,0,0,0,0,0,0,0.0230924440578395,8.71642274238101,3.48100589175306
9.7,"random_policy_SVM","SVM",92,22,484,477,7,2300,2040,260,0.794440631434454,0.225806451612903,1.27351716961498,675,260,415,-1,1.6,82.61,7.8,0,0,0,0,0,0,0.0835870504777437,29.1070099763303,11.1099313314729
9.7,"random_policy_SVM","SVM",92,23,384,380,4,2400,2137,263,0.801164239050305,0.233870967741935,1.26316337148803,693,263,430,18,1.6,86.21,8.1,0,0,0,0,0,0,0.0594475547948131,15.0598799906208,9.10262109716379
9.7,"random_policy_SVM","SVM",92,24,284,282,2,2500,2235,265,0.750629146648363,0.17741935483871,1.25280957336108,709,265,444,16,1.7,89.8,8.4,0,0,0,0,0,0,0.0568583379814675,13.6394920573644,10.1360431561578
9.7,"random_policy_SVM","SVM",92,25,184,183,1,2600,2334,266,0.805873306388062,0.274193548387097,1.26316337148803,714,266,448,5,1.7,93.39,8.8,0,0,0,0,0,0,0.0241506154561415,8.2200280226406,7.45161040587448
9.7,"random_policy_SVM","SVM",92,26,84,84,0,2700,2433,267,0.791517323775391,0.153225806451613,1.26316337148803,725,267,458,11,1.7,96.98,9.1,0,0,0,0,0,0,1.0000000994736e-07,0.969659583213996,0.969659583213996
9.7,"random_policy_SVM","SVM",92,27,0,0,0,2784,2517,267,0.798361676707598,0.266129032258065,1.27351716961498,730,267,463,5,1.7,100,9.4,0,0,0,0,0,0,0,0,0
9.7,"random_policy_SVM","SVM",93,0,2684,2429,255,100,88,12,0.782181804316327,0.233870967741935,1.28387096774194,34,12,22,0,1.8,3.59,7.3,0,0,0,0,0,0,0.121333132909158,320.06511618321,12.1943916960147
9.7,"random_policy_SVM","SVM",93,1,2584,2344,240,200,173,27,0.762621063067187,0.185483870967742,1.21139438085328,76,27,49,42,1.8,7.18,6.4,0,0,0,0,0,0,0.15332301889407,345.072549271682,16.4508407295976
9.7,"random_policy_SVM","SVM",93,2,2484,2252,232,300,265,35,0.739215536744711,0.153225806451613,1.20104058272633,99,35,64,23,1.8,10.78,7.6,0,0,0,0,0,0,0.136925535385436,267.832865967289,14.1093134538155
9.7,"random_policy_SVM","SVM",93,3,2384,2164,220,400,353,47,0.770780904445978,0.201612903225806,1.19068678459938,130,47,83,31,1.8,14.37,7.5,0,0,0,0,0,0,0.164478335105923,215.470637604284,17.5370620391352
9.7,"random_policy_SVM","SVM",93,4,2284,2085,199,500,432,68,0.76703779963904,0.145161290322581,1.20104058272633,202,68,134,72,2,17.96,6.4,0,0,0,0,0,0,0.173186617335658,183.325622552546,18.612956183965
9.7,"random_policy_SVM","SVM",93,5,2184,2000,184,600,517,83,0.766523043290379,0.145161290322581,1.21139438085328,258,83,175,56,2.1,21.55,6.2,0,0,0,0,0,0,0.154998158570148,190.643918700654,15.9514898989102
9.7,"random_policy_SVM","SVM",93,6,2084,1925,159,700,592,108,0.805358550039408,0.25,1.21139438085328,320,108,212,62,2,25.14,5.5,0,0,0,0,0,0,0.183088733677468,148.345847498357,19.0966515340297
9.7,"random_policy_SVM","SVM",93,7,1984,1854,130,800,663,137,0.817998678156544,0.298387096774194,1.22174817898023,394,137,257,74,1.9,28.74,4.8,0,0,0,0,0,0,0.205647272282929,132.669032209736,22.2709620678235
9.7,"random_policy_SVM","SVM",93,8,1884,1781,103,900,736,164,0.778603929942298,0.193548387096774,1.24245577523413,444,164,280,50,1.7,32.33,4.5,0,0,0,0,0,0,0.204334496346323,111.911087866938,22.7757187703758
9.7,"random_policy_SVM","SVM",93,9,1784,1699,85,1000,818,182,0.810283687943266,0.217741935483871,1.24245577523413,494,182,312,50,1.7,35.92,4.5,0,0,0,0,0,0,0.195607847587103,104.202399215069,20.7599370014499
9.7,"random_policy_SVM","SVM",93,10,1684,1627,57,1100,890,210,0.803102519128603,0.241935483870968,1.24245577523413,562,210,352,68,1.7,39.51,4.2,0,0,0,0,0,0,0.187198365703303,101.088197340211,20.8793736307937
9.7,"random_policy_SVM","SVM",93,11,1584,1537,47,1200,980,220,0.763701415897711,0.193548387096774,1.24245577523413,578,220,358,16,1.6,43.1,4.5,0,0,0,0,0,0,0.168576681013762,69.0665482200909,18.4269019647844
9.7,"random_policy_SVM","SVM",93,12,1484,1444,40,1300,1073,227,0.81004855232721,0.25,1.24245577523413,605,227,378,27,1.7,46.7,4.7,0,0,0,0,0,0,0.118462120917044,43.1515846276703,13.7228337127256
9.7,"random_policy_SVM","SVM",93,13,1384,1351,33,1400,1166,234,0.785746968657058,0.185483870967742,1.22174817898023,609,234,375,4,1.6,50.29,5,0,0,0,0,0,0,0.156068414296034,97.1061381686644,38.4929444676642
9.7,"random_policy_SVM","SVM",93,14,1284,1257,27,1500,1260,240,0.823209791809659,0.241935483870968,1.23210197710718,613,240,373,4,1.6,53.88,5.2,0,0,0,0,0,0,0.14347465331437,89.3605279092878,15.648618084113
9.7,"random_policy_SVM","SVM",93,15,1184,1160,24,1600,1357,243,0.817325046391625,0.225806451612903,1.22174817898023,614,243,371,1,1.5,57.47,5.6,0,0,0,0,0,0,0.104323498141343,46.5442787961585,11.9713127818475
9.7,"random_policy_SVM","SVM",93,16,1084,1061,23,1700,1456,244,0.808091207198966,0.217741935483871,1.22174817898023,614,244,370,0,1.5,61.06,6,0,0,0,0,0,0,0.0721592505986972,25.259395585223,9.26892355102926
9.7,"random_policy_SVM","SVM",93,17,984,961,23,1800,1556,244,0.794605861867361,0.193548387096774,1.22174817898023,619,244,375,5,1.5,64.66,6.4,0,0,0,0,0,0,0.0917293108156131,41.3255750192819,10.0374057688884
9.7,"random_policy_SVM","SVM",93,18,884,861,23,1900,1656,244,0.794230915885002,0.185483870967742,1.22174817898023,617,244,373,-2,1.5,68.25,6.8,0,0,0,0,0,0,0.0702683678893644,29.6901814574304,7.85560161092826
9.7,"random_policy_SVM","SVM",93,19,784,762,22,2000,1755,245,0.82240270469509,0.258064516129032,1.22174817898023,630,245,385,13,1.6,71.84,7.2,0,0,0,0,0,0,0.0301331852579118,8.99809425603243,3.98483204640867
9.7,"random_policy_SVM","SVM",93,20,684,666,18,2100,1851,249,0.781714710592543,0.201612903225806,1.22174817898023,662,249,413,32,1.7,75.43,7.4,0,0,0,0,0,0,0.00896962550658779,2.95209289168137,2.05949518866117
9.7,"random_policy_SVM","SVM",93,21,584,568,16,2200,1949,251,0.812031317522056,0.217741935483871,1.22174817898023,669,251,418,7,1.7,79.02,7.8,0,0,0,0,0,0,0.00762884939936123,2.52987897375885,1.76664895893443
9.7,"random_policy_SVM","SVM",93,22,484,469,15,2300,2048,252,0.810766669208677,0.241935483870968,1.20104058272633,662,252,410,-7,1.6,82.61,8.1,0,0,0,0,0,0,0.00349707781353408,1.14652323257525,0.815445941322464
9.7,"random_policy_SVM","SVM",93,23,384,370,14,2400,2147,253,0.783529067846159,0.169354838709677,1.22174817898023,672,253,419,10,1.7,86.21,8.5,0,0,0,0,0,0,0.00103284434015238,0.315364431176596,0.238334384187573
9.7,"random_policy_SVM","SVM",93,24,284,274,10,2500,2243,257,0.776252573781744,0.145161290322581,1.20104058272633,676,257,419,4,1.6,89.8,8.7,0,0,0,0,0,0,0.00195829254445516,0.55199102305557,0.432860931956932
9.7,"random_policy_SVM","SVM",93,25,184,178,6,2600,2339,261,0.788161874984111,0.185483870967742,1.22174817898023,694,261,433,18,1.7,93.39,9,0,0,0,0,0,0,0.00653058748578765,1.7528446359089,1.47411864305642
9.7,"random_policy_SVM","SVM",93,26,84,84,0,2700,2433,267,0.811516561173392,0.209677419354839,1.27351716961498,708,267,441,14,1.7,96.98,9.1,0,0,0,0,0,0,1.30968235785713e-06,1.10668650616916,1.10668650616916
9.7,"random_policy_SVM","SVM",93,27,0,0,0,2784,2517,267,0.827277002465747,0.201612903225806,1.26316337148803,721,267,454,13,1.7,100,9.4,0,0,0,0,0,0,0,0,0
9.7,"random_policy_SVM","SVM",94,0,2684,2446,238,100,88,12,0.260326739627943,0,0.600960878517502,35,12,23,0,1.9,3.59,7.3,0,0,0,0,0,0,0.128698506851522,316.090406405842,13.3020200204671
9.7,"random_policy_SVM","SVM",94,1,2584,2354,230,200,180,20,0.7679344254866,0.234042553191489,1.27476549988561,70,20,50,35,2.5,7.18,9,0,0,0,0,0,0,0.154396328073106,235.468153213208,16.6360990211055
9.7,"random_policy_SVM","SVM",94,2,2484,2281,203,300,253,47,0.696632905082365,0.205673758865248,1.19281628917868,124,47,77,54,1.6,10.78,5.4,0,0,0,0,0,0,0.214485164106037,310.618151227917,28.211894256648
9.7,"random_policy_SVM","SVM",94,3,2384,2203,181,400,331,69,0.761465343393836,0.170212765957447,1.25655456417296,182,69,113,58,1.6,14.37,4.8,0,0,0,0,0,0,0.196991967666453,358.970475671476,23.1164160114014
9.7,"random_policy_SVM","SVM",94,4,2284,2113,171,500,421,79,0.803231142229176,0.26241134751773,1.24744909631663,208,79,129,26,1.6,17.96,5.3,0,0,0,0,0,0,0.17806364704163,206.24735022395,18.8567629482075
9.7,"random_policy_SVM","SVM",94,5,2184,2043,141,600,491,109,0.808935490449327,0.340425531914894,1.24744909631663,261,109,152,53,1.4,21.55,4.5,0,0,0,0,0,0,0.190719589376832,233.990067683206,19.8070355554411
9.7,"random_policy_SVM","SVM",94,6,2084,1969,115,700,565,135,0.806301407110328,0.319148936170213,1.23834362846031,319,135,184,58,1.4,25.14,4.2,0,0,0,0,0,0,0.192070841251768,195.014991599955,19.9581755377983
9.7,"random_policy_SVM","SVM",94,7,1984,1897,87,800,637,163,0.821947295674442,0.347517730496454,1.24744909631663,388,163,225,69,1.4,28.74,3.9,0,0,0,0,0,0,0.197958367878571,148.699631321565,20.9968924527416
9.7,"random_policy_SVM","SVM",94,8,1884,1821,63,900,713,187,0.816503523440512,0.340425531914894,1.24744909631663,442,187,255,54,1.4,32.33,3.8,0,0,0,0,0,0,0.196093103912072,154.561435251429,20.9937939165327
9.7,"random_policy_SVM","SVM",94,9,1784,1742,42,1000,792,208,0.801152199034739,0.297872340425532,1.23834362846031,503,208,295,61,1.4,35.92,3.8,0,0,0,0,0,0,0.199828994048169,133.606198781608,21.7128361370434
9.7,"random_policy_SVM","SVM",94,10,1684,1649,35,1100,885,215,0.810702875399362,0.347517730496454,1.24744909631663,529,215,314,26,1.5,39.51,4.1,0,0,0,0,0,0,0.165652057425382,119.050624999456,18.3069546489824
9.7,"random_policy_SVM","SVM",94,11,1584,1557,27,1200,977,223,0.804222463915894,0.312056737588652,1.24744909631663,558,223,335,29,1.5,43.1,4.4,0,0,0,0,0,0,0.12593337373108,72.2042834676705,15.068066093408
9.7,"random_policy_SVM","SVM",94,12,1484,1462,22,1300,1072,228,0.811694197086085,0.361702127659574,1.24744909631663,577,228,349,19,1.5,46.7,4.7,0,0,0,0,0,0,0.11330352669241,75.4937109033668,13.0929333113933
9.7,"random_policy_SVM","SVM",94,13,1384,1366,18,1400,1168,232,0.797736387737072,0.269503546099291,1.23834362846031,591,232,359,14,1.5,50.29,5,0,0,0,0,0,0,0.119805563649718,65.177864597548,14.2110625301341
9.7,"random_policy_SVM","SVM",94,14,1284,1266,18,1500,1268,232,0.812187025581769,0.333333333333333,1.24744909631663,593,232,361,2,1.6,53.88,5.5,0,0,0,0,0,0,0.0633362263609814,28.0739590718789,7.75564469079628
9.7,"random_policy_SVM","SVM",94,15,1184,1170,14,1600,1364,236,0.788644551696015,0.219858156028369,1.25655456417296,628,236,392,35,1.7,57.47,5.8,0,0,0,0,0,0,0.0778784935407618,36.2458359134399,9.94998307577402
9.7,"random_policy_SVM","SVM",94,16,1084,1073,11,1700,1461,239,0.80450003398818,0.25531914893617,1.25655456417296,616,239,377,-12,1.6,61.06,6.1,0,0,0,0,0,0,0.0662374172186132,29.8848498636884,8.39708872258848
9.7,"random_policy_SVM","SVM",94,17,984,978,6,1800,1556,244,0.835315976706779,0.290780141843972,1.26566003202928,651,244,407,35,1.7,64.66,6.4,0,0,0,0,0,0,0.0900834804523689,39.8607523582473,11.40581999216
9.7,"random_policy_SVM","SVM",94,18,884,880,4,1900,1654,246,0.802200167674988,0.219858156028369,1.26566003202928,655,246,409,4,1.7,68.25,6.7,0,0,0,0,0,0,0.0814757184960568,32.0179350165469,10.6307160423311
9.7,"random_policy_SVM","SVM",94,19,784,782,2,2000,1752,248,0.827028527405798,0.326241134751773,1.27476549988561,670,248,422,15,1.7,71.84,7.1,0,0,0,0,0,0,0.0873852009256183,37.730513687482,11.2694365557996
9.7,"random_policy_SVM","SVM",94,20,684,682,2,2100,1852,248,0.756627693562643,0.184397163120567,1.27476549988561,656,248,408,-14,1.6,75.43,7.5,0,0,0,0,0,0,0.0491934877128768,15.7951699255761,7.20547593566036
9.7,"random_policy_SVM","SVM",94,21,584,583,1,2200,1951,249,0.778657693789232,0.219858156028369,1.26566003202928,663,249,414,7,1.7,79.02,7.8,0,0,0,0,0,0,0.0795781219085514,35.6549186536474,9.00812901418371
9.7,"random_policy_SVM","SVM",94,22,484,484,0,2300,2050,250,0.797827022862713,0.25531914893617,1.27476549988561,666,250,416,3,1.7,82.61,8.2,0,0,0,0,0,0,0.0116541345520156,3.28908346613849,2.05836732169542
9.7,"random_policy_SVM","SVM",94,23,384,384,0,2400,2150,250,0.793283937189862,0.212765957446809,1.26566003202928,703,250,453,37,1.8,86.21,8.6,0,0,0,0,0,0,0.00442276043826417,1.5023028046681,1.12242372351443
9.7,"random_policy_SVM","SVM",94,24,284,284,0,2500,2250,250,0.813065053361433,0.234042553191489,1.26566003202928,698,250,448,-5,1.8,89.8,9,0,0,0,0,0,0,0.00397584832424984,1.14341922187126,0.76271923772453
9.7,"random_policy_SVM","SVM",94,25,184,184,0,2600,2350,250,0.756163188543722,0.177304964539007,1.26566003202928,695,250,445,-3,1.8,93.39,9.4,0,0,0,0,0,0,0.00154331254265441,0.549294285885923,0.47661246711313
9.7,"random_policy_SVM","SVM",94,26,84,84,0,2700,2450,250,0.759505358801806,0.205673758865248,1.27476549988561,684,250,434,-11,1.7,96.98,9.8,0,0,0,0,0,0,1.3649647320172e-05,0.0381918147408385,0.0381918147408385
9.7,"random_policy_SVM","SVM",94,27,0,0,0,2784,2534,250,0.747348922574948,0.212765957446809,1.27476549988561,686,250,436,2,1.7,100,10.1,0,0,0,0,0,0,0,0,0
9.7,"random_policy_SVM","SVM",95,0,2684,2432,252,100,90,10,0.796802938867625,0.201550387596899,1.2528587948092,26,10,16,0,1.6,3.59,9,0,0,0,0,0,0,0.360838188384106,333.848696285554,45.720362701881
9.7,"random_policy_SVM","SVM",95,1,2584,2354,230,200,168,32,0.797020655480321,0.24031007751938,1.2739184796199,81,32,49,55,1.5,7.18,5.2,0,0,0,0,0,0,0.228363584453399,380.848075192321,26.3148796166276
9.7,"random_policy_SVM","SVM",95,2,2484,2288,196,300,234,66,0.785355951329589,0.170542635658915,1.26280211857753,153,66,87,72,1.3,10.78,3.5,0,0,0,0,0,0,0.420907566099809,408.615190763489,52.6779058259353
9.7,"random_policy_SVM","SVM",95,3,2384,2199,185,400,323,77,0.79329800804631,0.255813953488372,1.2739184796199,187,77,110,34,1.4,14.37,4.2,0,0,0,0,0,0,0.204145631741823,292.61999437836,22.018224578337
9.7,"random_policy_SVM","SVM",95,4,2284,2114,170,500,408,92,0.70280149151211,0.147286821705426,1.25401350337584,226,92,134,39,1.5,17.96,4.4,0,0,0,0,0,0,0.214116650276956,291.016475308173,31.0216444849393
9.7,"random_policy_SVM","SVM",95,5,2184,2020,164,600,502,98,0.777211510156015,0.232558139534884,1.2739184796199,240,98,142,14,1.4,21.55,5.1,0,0,0,0,0,0,0.179121873276867,180.989368040557,19.0173815622551
9.7,"random_policy_SVM","SVM",95,6,2084,1938,146,700,584,116,0.794457119026587,0.24031007751938,1.28387096774194,285,116,169,45,1.5,25.14,5,0,0,0,0,0,0,0.17379876515166,167.936421652113,18.1697009202093
9.7,"random_policy_SVM","SVM",95,7,1984,1858,126,800,664,136,0.808458443724851,0.255813953488372,1.2739184796199,330,136,194,45,1.4,28.74,4.9,0,0,0,0,0,0,0.171906046892956,114.286838818579,18.1816404529968
9.7,"random_policy_SVM","SVM",95,8,1884,1794,90,900,728,172,0.816492493376502,0.263565891472868,1.2739184796199,420,172,248,90,1.4,32.33,4.2,0,0,0,0,0,0,0.189925901359805,144.034488251007,20.1188576069135
9.7,"random_policy_SVM","SVM",95,9,1784,1730,54,1000,792,208,0.826691443430469,0.271317829457364,1.26396599149787,493,208,285,73,1.4,35.92,3.8,0,0,0,0,0,0,0.198467360081812,113.573861592897,22.0456517460568
9.7,"random_policy_SVM","SVM",95,10,1684,1649,35,1100,873,227,0.819626386026877,0.248062015503876,1.2739184796199,545,227,318,52,1.4,39.51,3.8,0,0,0,0,0,0,0.165335764437918,86.7103115680701,18.7430289387528
9.7,"random_policy_SVM","SVM",95,11,1584,1558,26,1200,964,236,0.818964036895293,0.224806201550388,1.2739184796199,570,236,334,25,1.4,43.1,4.1,0,0,0,0,0,0,0.162799692720749,91.4906321190704,17.6766593830305
9.7,"random_policy_SVM","SVM",95,12,1484,1464,20,1300,1058,242,0.820153812187213,0.232558139534884,1.26396599149787,592,242,350,22,1.4,46.7,4.4,0,0,0,0,0,0,0.139986777377179,68.0346732245682,16.294798460881
9.7,"random_policy_SVM","SVM",95,13,1384,1373,11,1400,1149,251,0.811058777352552,0.209302325581395,1.26396599149787,627,251,376,35,1.5,50.29,4.6,0,0,0,0,0,0,0.150965771709618,92.6509247531287,17.7601615624863
9.7,"random_policy_SVM","SVM",95,14,1284,1274,10,1500,1248,252,0.811635266411528,0.24031007751938,1.26396599149787,636,252,384,9,1.5,53.88,5,0,0,0,0,0,0,0.115472058047863,55.659847675126,13.3364097522317
9.7,"random_policy_SVM","SVM",95,15,1184,1178,6,1600,1344,256,0.801473113531536,0.186046511627907,1.26396599149787,649,256,393,13,1.5,57.47,5.2,0,0,0,0,0,0,0.128037896993202,59.4290848049543,15.9791276068558
9.7,"random_policy_SVM","SVM",95,16,1084,1078,6,1700,1444,256,0.825133696398774,0.271317829457364,1.2739184796199,674,256,418,25,1.6,61.06,5.6,0,0,0,0,0,0,0.098057930396911,45.2765203677562,11.2618772364426
9.7,"random_policy_SVM","SVM",95,17,984,980,4,1800,1542,258,0.812953831812375,0.232558139534884,1.2739184796199,687,258,429,13,1.7,64.66,6,0,0,0,0,0,0,0.0707982650803114,28.0946204511541,9.06674700683178
9.7,"random_policy_SVM","SVM",95,18,884,881,3,1900,1641,259,0.795082670984194,0.209302325581395,1.28387096774194,710,259,451,23,1.7,68.25,6.3,0,0,0,0,0,0,0.0605736336501945,21.823362735479,7.60722523817712
9.7,"random_policy_SVM","SVM",95,19,784,781,3,2000,1741,259,0.77787999214993,0.147286821705426,1.28387096774194,688,259,429,-22,1.7,71.84,6.7,0,0,0,0,0,0,0.0599661218973535,21.0814544254027,7.15602867442014
9.7,"random_policy_SVM","SVM",95,20,684,681,3,2100,1841,259,0.820405259542723,0.27906976744186,1.2739184796199,699,259,440,11,1.7,75.43,7.1,0,0,0,0,0,0,0.0324009481380199,9.99150995942757,4.49770590341576
9.7,"random_policy_SVM","SVM",95,21,584,582,2,2200,1940,260,0.831199097242657,0.263565891472868,1.2739184796199,698,260,438,-1,1.7,79.02,7.5,0,0,0,0,0,0,0.0295456955099704,8.87285424794741,4.32431894441148
9.7,"random_policy_SVM","SVM",95,22,484,482,2,2300,2040,260,0.816995388087518,0.255813953488372,1.2739184796199,700,260,440,2,1.7,82.61,7.8,0,0,0,0,0,0,0.0038268446957956,1.17385210805422,0.874424604104542
9.7,"random_policy_SVM","SVM",95,23,384,383,1,2400,2139,261,0.811954175252668,0.263565891472868,1.2739184796199,689,261,428,-11,1.6,86.21,8.2,0,0,0,0,0,0,0.00490429165359106,1.69957507214411,1.22481649144523
9.7,"random_policy_SVM","SVM",95,24,284,283,1,2500,2239,261,0.834799087430077,0.294573643410853,1.2739184796199,707,261,446,18,1.7,89.8,8.6,0,0,0,0,0,0,4.02290819728848e-05,0.0489631179781424,0.047551931981188
9.7,"random_policy_SVM","SVM",95,25,184,183,1,2600,2339,261,0.834486311451275,0.325581395348837,1.28387096774194,692,261,431,-15,1.7,93.39,9,0,0,0,0,0,0,2.28235592427172e-05,0.0386328041096696,0.0380336398505519
9.7,"random_policy_SVM","SVM",95,26,84,84,0,2700,2438,262,0.825593661073489,0.255813953488372,1.28387096774194,715,262,453,23,1.7,96.98,9.3,0,0,0,0,0,0,1.0000000994736e-07,0.280314671396746,0.280314671396746
9.7,"random_policy_SVM","SVM",95,27,0,0,0,2784,2522,262,0.806722843685601,0.255813953488372,1.28387096774194,707,262,445,-8,1.7,100,9.6,0,0,0,0,0,0,0,0,0
9.7,"random_policy_SVM","SVM",96,0,2684,2417,267,100,87,13,0.586449944484265,0,1.05157367312063,42,13,29,0,2.2,3.59,6.7,0,0,0,0,0,0,0.283322643444898,379.647163594453,40.3289123658754
9.7,"random_policy_SVM","SVM",96,1,2584,2327,257,200,177,23,0.760396902362583,0.171171171171171,1.27230456262714,74,23,51,32,2.2,7.18,7.7,0,0,0,0,0,0,0.141062773816487,305.393891369826,14.7086191505865
9.7,"random_policy_SVM","SVM",96,2,2484,2245,239,300,259,41,0.746208767269608,0.189189189189189,1.28387096774194,114,41,73,40,1.8,10.78,6.3,0,0,0,0,0,0,0.139612002235979,332.696139219485,14.306839645775
9.7,"random_policy_SVM","SVM",96,3,2384,2160,224,400,344,56,0.801576927941991,0.279279279279279,1.27230456262714,149,56,93,35,1.7,14.37,6.1,0,0,0,0,0,0,0.167879642593766,233.907687660296,17.6391245911914
9.7,"random_policy_SVM","SVM",96,4,2284,2091,193,500,413,87,0.789314275273721,0.252252252252252,1.24917175239756,217,87,130,68,1.5,17.96,4.7,0,0,0,0,0,0,0.198578800677729,253.621931998118,20.4557504929275
9.7,"random_policy_SVM","SVM",96,5,2184,2025,159,600,479,121,0.792371154305641,0.234234234234234,1.24917175239756,302,121,181,85,1.5,21.55,4,0,0,0,0,0,0,0.219604512545136,255.799715282327,22.5256835424824
9.7,"random_policy_SVM","SVM",96,6,2084,1944,140,700,560,140,0.798224901969062,0.243243243243243,1.24917175239756,341,140,201,39,1.4,25.14,4,0,0,0,0,0,0,0.213346571690531,198.657008105365,21.8964012796263
9.7,"random_policy_SVM","SVM",96,7,1984,1874,110,800,630,170,0.804219195794869,0.279279279279279,1.22603894216797,421,170,251,80,1.5,28.74,3.7,0,0,0,0,0,0,0.222305617341881,184.80656778312,22.9723610931209
9.7,"random_policy_SVM","SVM",96,8,1884,1816,68,900,688,212,0.802553723770581,0.279279279279279,1.22603894216797,509,212,297,88,1.4,32.33,3.2,0,0,0,0,0,0,0.226042878628071,197.349071057774,23.7960240242292
9.7,"random_policy_SVM","SVM",96,9,1784,1724,60,1000,780,220,0.810747565037749,0.261261261261261,1.23760534728277,537,220,317,28,1.4,35.92,3.5,0,0,0,0,0,0,0.214058189567613,215.654558966566,22.3590338588814
9.7,"random_policy_SVM","SVM",96,10,1684,1637,47,1100,867,233,0.803586738064127,0.207207207207207,1.23760534728277,567,233,334,30,1.4,39.51,3.7,0,0,0,0,0,0,0.184573857230224,132.149703074833,20.1778490922406
9.7,"random_policy_SVM","SVM",96,11,1584,1544,40,1200,960,240,0.79087433767622,0.18018018018018,1.23760534728277,577,240,337,10,1.4,43.1,4,0,0,0,0,0,0,0.190590747939093,171.896403055984,19.6934669805956
9.7,"random_policy_SVM","SVM",96,12,1484,1453,31,1300,1051,249,0.790944610757413,0.153153153153153,1.24917175239756,601,249,352,24,1.4,46.7,4.2,0,0,0,0,0,0,0.173191239649805,92.663859238604,19.0091314401802
9.7,"random_policy_SVM","SVM",96,13,1384,1362,22,1400,1142,258,0.801211507919788,0.216216216216216,1.24917175239756,650,258,392,49,1.5,50.29,4.4,0,0,0,0,0,0,0.173409891495092,87.2575316799114,18.7781027108401
9.7,"random_policy_SVM","SVM",96,14,1284,1267,17,1500,1237,263,0.80193532065608,0.225225225225225,1.24917175239756,670,263,407,20,1.5,53.88,4.7,0,0,0,0,0,0,0.15726263054356,76.7346956055743,16.6447092025498
9.7,"random_policy_SVM","SVM",96,15,1184,1168,16,1600,1336,264,0.806510098241777,0.243243243243243,1.24917175239756,662,264,398,-8,1.5,57.47,5.1,0,0,0,0,0,0,0.0919989505778587,27.0712352094547,11.2658619346122
9.7,"random_policy_SVM","SVM",96,16,1084,1068,16,1700,1436,264,0.786454160869148,0.171171171171171,1.23760534728277,663,264,399,1,1.5,61.06,5.4,0,0,0,0,0,0,0.0832930753950953,24.7072161080855,9.69315750531652
9.7,"random_policy_SVM","SVM",96,17,984,968,16,1800,1536,264,0.813396860198742,0.198198198198198,1.24917175239756,658,264,394,-5,1.5,64.66,5.8,0,0,0,0,0,0,0.0188399718897561,4.78421893629635,3.60934438095641
9.7,"random_policy_SVM","SVM",96,18,884,868,16,1900,1636,264,0.790565136118967,0.144144144144144,1.24917175239756,671,264,407,13,1.5,68.25,6.2,0,0,0,0,0,0,0.00674154506053102,2.13273987869003,1.71577098227857
9.7,"random_policy_SVM","SVM",96,19,784,768,16,2000,1736,264,0.804830571601251,0.225225225225225,1.27230456262714,664,264,400,-7,1.5,71.84,6.6,0,0,0,0,0,0,0.00107816139010768,0.840692004312481,0.806424503442563
9.7,"random_policy_SVM","SVM",96,20,684,669,15,2100,1835,265,0.789974842236938,0.171171171171171,1.27230456262714,673,265,408,9,1.5,75.43,6.9,0,0,0,0,0,0,0.00155957966378235,0.770382321414581,0.613380601128315
9.7,"random_policy_SVM","SVM",96,21,584,576,8,2200,1928,272,0.753214993464606,0.126126126126126,1.22603894216797,695,272,423,22,1.6,79.02,7.1,0,0,0,0,0,0,0.174619147414785,52.9264615069256,24.1603013586789
9.7,"random_policy_SVM","SVM",96,22,484,477,7,2300,2027,273,0.752969037680429,0.162162162162162,1.22603894216797,700,273,427,5,1.6,82.61,7.4,0,0,0,0,0,0,0.0741213378029908,19.9528776441095,10.8561343236926
9.7,"random_policy_SVM","SVM",96,23,384,379,5,2400,2125,275,0.791218675774063,0.162162162162162,1.22603894216797,702,275,427,2,1.6,86.21,7.7,0,0,0,0,0,0,0.0917337463557246,24.4120912913387,11.1528478559251
9.7,"random_policy_SVM","SVM",96,24,284,282,2,2500,2222,278,0.795034504082872,0.162162162162162,1.24917175239756,728,278,450,26,1.6,89.8,8,0,0,0,0,0,0,0.0553489838989402,13.5915297157568,10.40698936519
9.7,"random_policy_SVM","SVM",96,25,184,182,2,2600,2322,278,0.810592964259117,0.234234234234234,1.24917175239756,723,278,445,-5,1.6,93.39,8.4,0,0,0,0,0,0,0.00597352979005749,2.3402435675513,2.1993374037251
9.7,"random_policy_SVM","SVM",96,26,84,83,1,2700,2421,279,0.810304844626219,0.198198198198198,1.28387096774194,736,279,457,13,1.6,96.98,8.7,0,0,0,0,0,0,3.31337385596071e-06,0.259365585220441,0.259365585220441
9.7,"random_policy_SVM","SVM",96,27,0,0,0,2784,2504,280,0.770080532951047,0.144144144144144,1.27230456262714,743,280,463,7,1.7,100,8.9,0,0,0,0,0,0,0,0,0
9.7,"random_policy_SVM","SVM",97,0,2684,2427,257,100,93,7,0.358392108569368,0.0236220472440945,0.839065278130556,30,7,23,0,3.3,3.59,13.3,0,0,0,0,0,0,0.0864886972139012,183.30506632351,9.24332181100024
9.7,"random_policy_SVM","SVM",97,1,2584,2327,257,200,193,7,0.640382629896387,0.102362204724409,1.20299720599441,30,7,23,0,3.3,7.18,27.6,0,0,0,0,0,0,0.0618821436733577,123.612787845291,6.85795234938267
9.7,"random_policy_SVM","SVM",97,2,2484,2236,248,300,284,16,0.626034008782083,0.291338582677165,1.05135890271781,52,16,36,22,2.2,10.78,17.8,0,0,0,0,0,0,0.195508393136012,149.711312953534,27.7302969456365
9.7,"random_policy_SVM","SVM",97,3,2384,2168,216,400,352,48,0.649568981602418,0.165354330708661,1.19288798577597,122,48,74,70,1.5,14.37,7.3,0,0,0,0,0,0,0.185501111987721,224.820123722537,21.0627011881974
9.7,"random_policy_SVM","SVM",97,4,2284,2081,203,500,439,61,0.680996628975883,0.181102362204724,1.16256032512065,164,61,103,42,1.7,17.96,7.2,0,0,0,0,0,0,0.159357024875367,153.600847183326,18.0980177190223
9.7,"random_policy_SVM","SVM",97,5,2184,2006,178,600,514,86,0.749586396487172,0.251968503937008,1.24343408686817,212,86,126,48,1.5,21.55,6,0,0,0,0,0,0,0.171684687697942,176.479407574056,20.3737833307006
9.7,"random_policy_SVM","SVM",97,6,2084,1934,150,700,586,114,0.744318393850061,0.275590551181102,1.21310642621285,279,114,165,67,1.4,25.14,5.1,0,0,0,0,0,0,0.181127295559938,180.842135871761,20.9224702513625
9.7,"random_policy_SVM","SVM",97,7,1984,1863,121,800,657,143,0.75175703747932,0.259842519685039,1.22321564643129,346,143,203,67,1.4,28.74,4.6,0,0,0,0,0,0,0.186894437755851,182.397321708876,20.3319207801242
9.7,"random_policy_SVM","SVM",97,8,1884,1788,96,900,732,168,0.775553233570925,0.291338582677165,1.24343408686817,397,168,229,51,1.4,32.33,4.4,0,0,0,0,0,0,0.183360088950053,160.721568965717,19.9096115153636
9.7,"random_policy_SVM","SVM",97,9,1784,1708,76,1000,812,188,0.798155266136757,0.31496062992126,1.26365252730505,455,188,267,58,1.4,35.92,4.3,0,0,0,0,0,0,0.17038968540084,120.338314105978,19.3785704766433
9.7,"random_policy_SVM","SVM",97,10,1684,1626,58,1100,894,206,0.811098257267611,0.299212598425197,1.2737617475235,495,206,289,40,1.4,39.51,4.3,0,0,0,0,0,0,0.154965983242095,131.718026515648,17.2704556359376
9.7,"random_policy_SVM","SVM",97,11,1584,1533,51,1200,987,213,0.817348956972804,0.291338582677165,1.2737617475235,507,213,294,12,1.4,43.1,4.6,0,0,0,0,0,0,0.12325748091174,92.9194566416299,14.270517199149
9.7,"random_policy_SVM","SVM",97,12,1484,1440,44,1300,1080,220,0.823319774601637,0.31496062992126,1.28387096774194,532,220,312,25,1.4,46.7,4.9,0,0,0,0,0,0,0.109347510944845,75.0227120337683,12.4822294126634
9.7,"random_policy_SVM","SVM",97,13,1384,1350,34,1400,1170,230,0.810333246258912,0.267716535433071,1.28387096774194,575,230,345,43,1.5,50.29,5.1,0,0,0,0,0,0,0.134688831264023,89.018828178896,15.7562490709799
9.7,"random_policy_SVM","SVM",97,14,1284,1254,30,1500,1266,234,0.80891517707206,0.259842519685039,1.28387096774194,592,234,358,17,1.5,53.88,5.4,0,0,0,0,0,0,0.116581223338887,70.0121913355403,13.5793523332188
9.7,"random_policy_SVM","SVM",97,15,1184,1158,26,1600,1362,238,0.812410593225612,0.267716535433071,1.2737617475235,612,238,374,20,1.6,57.47,5.7,0,0,0,0,0,0,0.101374011210099,55.0579978457328,11.8056594652711
9.7,"random_policy_SVM","SVM",97,16,1084,1062,22,1700,1458,242,0.804368648231771,0.220472440944882,1.2737617475235,620,242,378,8,1.6,61.06,6,0,0,0,0,0,0,0.0899547637220481,47.4976438671562,10.3920024280248
9.7,"random_policy_SVM","SVM",97,17,984,963,21,1800,1557,243,0.796824271373662,0.204724409448819,1.28387096774194,634,243,391,14,1.6,64.66,6.4,0,0,0,0,0,0,0.0743553297470314,36.2116724261517,8.83525980201026
9.7,"random_policy_SVM","SVM",97,18,884,869,15,1900,1651,249,0.811713997835582,0.244094488188976,1.28387096774194,658,249,409,24,1.6,68.25,6.6,0,0,0,0,0,0,0.0594453104834856,24.203136482796,10.1238834308818
9.7,"random_policy_SVM","SVM",97,19,784,776,8,2000,1744,256,0.836611063427498,0.275590551181102,1.28387096774194,668,256,412,10,1.6,71.84,6.8,0,0,0,0,0,0,0.0571500957925145,23.9919806566101,7.18367643216139
9.7,"random_policy_SVM","SVM",97,20,684,680,4,2100,1840,260,0.828880098518492,0.275590551181102,1.28387096774194,690,260,430,22,1.7,75.43,7.1,0,0,0,0,0,0,0.0435194382534024,13.5806518662096,6.12593506771166
9.7,"random_policy_SVM","SVM",97,21,584,580,4,2200,1940,260,0.801302384595292,0.21259842519685,1.28387096774194,690,260,430,0,1.7,79.02,7.5,0,0,0,0,0,0,0.0135674227449625,3.86426574419242,2.26687975179707
9.7,"random_policy_SVM","SVM",97,22,484,481,3,2300,2039,261,0.820471197024546,0.267716535433071,1.28387096774194,687,261,426,-3,1.6,82.61,7.8,0,0,0,0,0,0,0.0435602812769303,14.4412269156191,6.6498327837156
9.7,"random_policy_SVM","SVM",97,23,384,381,3,2400,2139,261,0.78470226766678,0.133858267716535,1.28387096774194,693,261,432,6,1.7,86.21,8.2,0,0,0,0,0,0,0.0120334305480248,3.21843539768744,1.96654203159196
9.7,"random_policy_SVM","SVM",97,24,284,283,1,2500,2237,263,0.817591521438966,0.322834645669291,1.28387096774194,715,263,452,22,1.7,89.8,8.5,0,0,0,0,0,0,0.0131764662913073,4.42929274209488,3.46917829128821
9.7,"random_policy_SVM","SVM",97,25,184,183,1,2600,2337,263,0.825415780373425,0.283464566929134,1.28387096774194,707,263,444,-8,1.7,93.39,8.9,0,0,0,0,0,0,0.00231975357471754,0.764778418214788,0.678955004220726
9.7,"random_policy_SVM","SVM",97,26,84,84,0,2700,2436,264,0.794454603127219,0.204724409448819,1.28387096774194,715,264,451,8,1.7,96.98,9.2,0,0,0,0,0,0,1.22418188924691e-05,0.179583644998692,0.179583644998692
9.7,"random_policy_SVM","SVM",97,27,0,0,0,2784,2520,264,0.763823064770932,0.149606299212598,1.28387096774194,731,264,467,16,1.8,100,9.5,0,0,0,0,0,0,0,0,0
9.7,"random_policy_SVM","SVM",98,0,2684,2425,259,100,91,9,0.761833429357924,0.16260162601626,1.27343299239444,26,9,17,0,1.9,3.59,10.1,0,0,0,0,0,0,0.261088956334049,266.914342631572,33.0053885701966
9.7,"random_policy_SVM","SVM",98,1,2584,2347,237,200,169,31,0.639888611484541,0.292682926829268,1.05423551009704,82,31,51,56,1.6,7.18,5.5,0,0,0,0,0,0,0.182868130128201,357.995302865264,19.6835406589285
9.7,"random_policy_SVM","SVM",98,2,2484,2280,204,300,236,64,0.649126176301132,0.0813008130081301,1.16905323891949,159,64,95,77,1.5,10.78,3.7,0,0,0,0,0,0,0.264720008358066,454.661496795574,28.6790556769678
9.7,"random_policy_SVM","SVM",98,3,2384,2190,194,400,326,74,0.739094808270915,0.260162601626016,1.22124311565696,180,74,106,21,1.4,14.37,4.4,0,0,0,0,0,0,0.220387781754316,206.063708499062,25.758485179137
9.7,"random_policy_SVM","SVM",98,4,2284,2109,175,500,407,93,0.728839382882025,0.203252032520325,1.23168109100446,232,93,139,52,1.5,17.96,4.4,0,0,0,0,0,0,0.190731975805578,292.978865263143,19.7720601626225
9.7,"random_policy_SVM","SVM",98,5,2184,2024,160,600,492,108,0.73579156264004,0.211382113821138,1.23168109100446,270,108,162,38,1.5,21.55,4.6,0,0,0,0,0,0,0.17108734593252,188.783066628952,17.8220504152949
9.7,"random_policy_SVM","SVM",98,6,2084,1946,138,700,570,130,0.724492670123553,0.227642276422764,1.23168109100446,325,130,195,55,1.5,25.14,4.4,0,0,0,0,0,0,0.18478130519886,269.553530601134,18.8155193101064
9.7,"random_policy_SVM","SVM",98,7,1984,1860,124,800,656,144,0.740176685231427,0.227642276422764,1.23168109100446,364,144,220,39,1.5,28.74,4.6,0,0,0,0,0,0,0.173642666586876,223.735909002489,17.8074829041769
9.7,"random_policy_SVM","SVM",98,8,1884,1783,101,900,733,167,0.752800716983563,0.276422764227642,1.24211906635195,418,167,251,54,1.5,32.33,4.4,0,0,0,0,0,0,0.178302655492317,212.50006470255,18.4996786601187
9.7,"random_policy_SVM","SVM",98,9,1784,1701,83,1000,815,185,0.759426413161781,0.24390243902439,1.26299501704694,477,185,292,59,1.6,35.92,4.4,0,0,0,0,0,0,0.166854983123311,113.804340399024,18.4198245166303
9.7,"random_policy_SVM","SVM",98,10,1684,1616,68,1100,900,200,0.758018052621483,0.260162601626016,1.23168109100446,518,200,318,41,1.6,39.51,4.5,0,0,0,0,0,0,0.176827166929631,234.408088971794,17.9627421444984
9.7,"random_policy_SVM","SVM",98,11,1584,1529,55,1200,987,213,0.796159016708288,0.292682926829268,1.26299501704694,545,213,332,27,1.6,43.1,4.6,0,0,0,0,0,0,0.164326049717113,139.361019163578,21.1320668665898
9.7,"random_policy_SVM","SVM",98,12,1484,1442,42,1300,1074,226,0.805505409384809,0.260162601626016,1.26299501704694,590,226,364,45,1.6,46.7,4.8,0,0,0,0,0,0,0.132845288397494,67.8812324996889,15.5899102190835
9.7,"random_policy_SVM","SVM",98,13,1384,1364,20,1400,1152,248,0.804001024262221,0.260162601626016,1.25255704169945,631,248,383,41,1.5,50.29,4.6,0,0,0,0,0,0,0.153472585983537,121.768887330474,17.2163007018092
9.7,"random_policy_SVM","SVM",98,14,1284,1270,14,1500,1246,254,0.811446130209343,0.300813008130081,1.26299501704694,656,254,402,25,1.6,53.88,4.9,0,0,0,0,0,0,0.110260913249186,54.0334227000486,12.7517357989152
9.7,"random_policy_SVM","SVM",98,15,1184,1173,11,1600,1343,257,0.801888483451774,0.284552845528455,1.25255704169945,667,257,410,11,1.6,57.47,5.2,0,0,0,0,0,0,0.153675359635721,151.525114224314,15.8606773529862
9.7,"random_policy_SVM","SVM",98,16,1084,1073,11,1700,1443,257,0.811401318737607,0.300813008130081,1.26299501704694,666,257,409,-1,1.6,61.06,5.6,0,0,0,0,0,0,0.123709609681593,86.1059662841393,12.9973569950191
9.7,"random_policy_SVM","SVM",98,17,984,973,11,1800,1543,257,0.814653351257932,0.276422764227642,1.26299501704694,687,257,430,21,1.7,64.66,6,0,0,0,0,0,0,0.044889129820119,14.24019770328,5.63694230573532
9.7,"random_policy_SVM","SVM",98,18,884,874,10,1900,1642,258,0.80720184367199,0.276422764227642,1.26299501704694,695,258,437,8,1.7,68.25,6.4,0,0,0,0,0,0,0.0454511784833787,14.5681715863456,6.26630339104475
9.7,"random_policy_SVM","SVM",98,19,784,776,8,2000,1740,260,0.809243966455425,0.284552845528455,1.26299501704694,693,260,433,-2,1.7,71.84,6.7,0,0,0,0,0,0,0.0523843252336366,18.1272843963382,6.69990809176188
9.7,"random_policy_SVM","SVM",98,20,684,679,5,2100,1837,263,0.815421547916268,0.268292682926829,1.28387096774194,714,263,451,21,1.7,75.43,7,0,0,0,0,0,0,0.102337607467474,42.8207197304855,11.7799436385169
9.7,"random_policy_SVM","SVM",98,21,584,580,4,2200,1936,264,0.823462006273611,0.268292682926829,1.27343299239444,736,264,472,22,1.8,79.02,7.3,0,0,0,0,0,0,0.0774560299704598,27.4047995985574,9.62442629202839
9.7,"random_policy_SVM","SVM",98,22,484,483,1,2300,2033,267,0.801273926125092,0.252032520325203,1.27343299239444,748,267,481,12,1.8,82.61,7.6,0,0,0,0,0,0,0.0763410208445089,21.5006410584782,9.75988876526685
9.7,"random_policy_SVM","SVM",98,23,384,383,1,2400,2133,267,0.789315664810194,0.235772357723577,1.27343299239444,769,267,502,21,1.9,86.21,8,0,0,0,0,0,0,0.00631844696914632,2.21004857084446,1.77033616018412
9.7,"random_policy_SVM","SVM",98,24,284,283,1,2500,2233,267,0.83971576723642,0.300813008130081,1.27343299239444,751,267,484,-18,1.8,89.8,8.4,0,0,0,0,0,0,0.00407999357466468,1.14342487812461,0.824529822485149
9.7,"random_policy_SVM","SVM",98,25,184,184,0,2600,2332,268,0.809448818897641,0.252032520325203,1.28387096774194,762,268,494,11,1.8,93.39,8.7,0,0,0,0,0,0,0.00217417145308045,2.00303223986038,1.94639398593883
9.7,"random_policy_SVM","SVM",98,26,84,84,0,2700,2432,268,0.798047500160044,0.252032520325203,1.28387096774194,750,268,482,-12,1.8,96.98,9.1,0,0,0,0,0,0,7.3581146147826e-05,0.211026666931329,0.211026666931329
9.7,"random_policy_SVM","SVM",98,27,0,0,0,2784,2516,268,0.772568977658284,0.203252032520325,1.27343299239444,768,268,500,18,1.9,100,9.4,0,0,0,0,0,0,0,0,0
9.7,"random_policy_SVM","SVM",99,0,2684,2414,270,100,88,12,0.767962788304902,0.247706422018349,1.20142053862089,34,12,22,0,1.8,3.59,7.3,0,0,0,0,0,0,0.181262453422215,327.208543495195,19.6643653784944
9.7,"random_policy_SVM","SVM",99,1,2584,2348,236,200,154,46,0.785825545171344,0.238532110091743,1.23675643681563,106,46,60,72,1.3,7.18,3.3,0,0,0,0,0,0,0.264850533553472,455.65504304115,28.2160377056197
9.7,"random_policy_SVM","SVM",99,2,2484,2277,207,300,225,75,0.721155220212067,0.201834862385321,1.18964190588932,171,75,96,65,1.3,10.78,3,0,0,0,0,0,0,0.250822417928727,408.92843043911,27.2265628939901
9.7,"random_policy_SVM","SVM",99,3,2384,2196,188,400,306,94,0.749328360341821,0.238532110091743,1.16608464042616,214,94,120,43,1.3,14.37,3.3,0,0,0,0,0,0,0.208634220554223,260.765952929318,22.3986030046844
9.7,"random_policy_SVM","SVM",99,4,2284,2120,164,500,382,118,0.757802452199263,0.247706422018349,1.15430600769458,268,118,150,54,1.3,17.96,3.2,0,0,0,0,0,0,0.213227679400601,236.559603562068,22.3223541505774
9.7,"random_policy_SVM","SVM",99,5,2184,2047,137,600,455,145,0.767898482380178,0.256880733944954,1.16608464042616,335,145,190,67,1.3,21.55,3.1,0,0,0,0,0,0,0.234533323967526,352.209132261408,23.9675705944262
9.7,"random_policy_SVM","SVM",99,6,2084,1978,106,700,524,176,0.778566120780824,0.256880733944954,1.18964190588932,403,176,227,68,1.3,25.14,3,0,0,0,0,0,0,0.235792266621935,330.983787953543,26.1869635222158
9.7,"random_policy_SVM","SVM",99,7,1984,1892,92,800,610,190,0.796793277887341,0.238532110091743,1.26031370227878,441,190,251,38,1.3,28.74,3.2,0,0,0,0,0,0,0.20672855656047,234.089982336782,23.1279209146209
9.7,"random_policy_SVM","SVM",99,8,1884,1808,76,900,694,206,0.810340392694852,0.247706422018349,1.26031370227878,475,206,269,34,1.3,32.33,3.4,0,0,0,0,0,0,0.202153855431093,246.86126245726,21.2220554077656
9.7,"random_policy_SVM","SVM",99,9,1784,1724,60,1000,778,222,0.829675040727089,0.229357798165138,1.27209233501036,521,222,299,46,1.3,35.92,3.5,0,0,0,0,0,0,0.186970845272172,116.293880824484,20.6226951245078
9.7,"random_policy_SVM","SVM",99,10,1684,1643,41,1100,859,241,0.826967046786136,0.192660550458716,1.27209233501036,568,241,327,47,1.4,39.51,3.6,0,0,0,0,0,0,0.193060152842702,112.599639358734,21.131313461218
9.7,"random_policy_SVM","SVM",99,11,1584,1548,36,1200,954,246,0.823137271713971,0.192660550458716,1.27209233501036,593,246,347,25,1.4,43.1,3.9,0,0,0,0,0,0,0.150605574390848,66.6100796739725,16.8579727252148
9.7,"random_policy_SVM","SVM",99,12,1484,1457,27,1300,1045,255,0.824544856955046,0.165137614678899,1.27209233501036,611,255,356,18,1.4,46.7,4.1,0,0,0,0,0,0,0.160689078414454,71.8884580449103,17.8204949892976
9.7,"random_policy_SVM","SVM",99,13,1384,1362,22,1400,1140,260,0.820136328560408,0.238532110091743,1.27209233501036,639,260,379,28,1.5,50.29,4.4,0,0,0,0,0,0,0.158103154361992,81.0255515234702,17.1749162509539
9.7,"random_policy_SVM","SVM",99,14,1284,1264,20,1500,1238,262,0.770377833033243,0.174311926605505,1.26031370227878,657,262,395,18,1.5,53.88,4.7,0,0,0,0,0,0,0.169297584118464,67.3612659544718,20.1937028067172
9.7,"random_policy_SVM","SVM",99,15,1184,1164,20,1600,1338,262,0.813319900540174,0.211009174311927,1.27209233501036,655,262,393,-2,1.5,57.47,5.1,0,0,0,0,0,0,0.0901535672929208,29.2893608425142,10.8369246155956
9.7,"random_policy_SVM","SVM",99,16,1084,1064,20,1700,1438,262,0.788912229557864,0.165137614678899,1.27209233501036,660,262,398,5,1.5,61.06,5.5,0,0,0,0,0,0,0.0885419905626156,26.5341281646689,10.600668676682
9.7,"random_policy_SVM","SVM",99,17,984,965,19,1800,1537,263,0.809075709508706,0.229357798165138,1.27209233501036,668,263,405,8,1.5,64.66,5.8,0,0,0,0,0,0,0.0594986305784784,21.089895117538,7.53806567428316
9.7,"random_policy_SVM","SVM",99,18,884,867,17,1900,1635,265,0.810861985195351,0.211009174311927,1.27209233501036,658,265,393,-10,1.5,68.25,6.2,0,0,0,0,0,0,0.0569705308593467,22.1043948231986,7.43297977624731
9.7,"random_policy_SVM","SVM",99,19,784,768,16,2000,1734,266,0.824230472434197,0.220183486238532,1.26031370227878,660,266,394,2,1.5,71.84,6.5,0,0,0,0,0,0,0.0369508201184809,12.9513293809452,5.98274376629838
9.7,"random_policy_SVM","SVM",99,20,684,668,16,2100,1834,266,0.81681385578325,0.220183486238532,1.26031370227878,666,266,400,6,1.5,75.43,6.9,0,0,0,0,0,0,0.0158963772052646,5.07028620870105,2.31734944010874
9.7,"random_policy_SVM","SVM",99,21,584,568,16,2200,1934,266,0.800187201691964,0.211009174311927,1.26031370227878,655,266,389,-11,1.5,79.02,7.3,0,0,0,0,0,0,0.0132973424884684,4.55417895159742,1.94568630271784
9.7,"random_policy_SVM","SVM",99,22,484,472,12,2300,2030,270,0.786297121952618,0.155963302752294,1.2485350695472,717,270,447,62,1.7,82.61,7.5,0,0,0,0,0,0,0.0875100850131415,27.8348593573676,12.1991882693736
9.7,"random_policy_SVM","SVM",99,23,384,374,10,2400,2128,272,0.80915430563892,0.229357798165138,1.26031370227878,725,272,453,8,1.7,86.21,7.8,0,0,0,0,0,0,0.0469412222746394,10.7777352350509,7.42515185453694
9.7,"random_policy_SVM","SVM",99,24,284,279,5,2500,2223,277,0.806789276629802,0.284403669724771,1.27209233501036,734,277,457,9,1.6,89.8,8,0,0,0,0,0,0,0.0200430701779215,6.60870950392805,5.21415479960992
9.7,"random_policy_SVM","SVM",99,25,184,184,0,2600,2318,282,0.795242790591331,0.165137614678899,1.27209233501036,762,282,480,28,1.7,93.39,8.2,0,0,0,0,0,0,0.00183062462430285,0.925672233132947,0.867688343164758
9.7,"random_policy_SVM","SVM",99,26,84,84,0,2700,2418,282,0.814384520849413,0.275229357798165,1.27209233501036,758,282,476,-4,1.7,96.98,8.6,0,0,0,0,0,0,0.000114731195627572,0.589040926333408,0.589040926333408
9.7,"random_policy_SVM","SVM",99,27,0,0,0,2784,2502,282,0.774050415844982,0.119266055045872,1.27209233501036,754,282,472,-4,1.7,100,8.9,0,0,0,0,0,0,0,0,0
9.7,"random_policy_SVM","SVM",100,0,2684,2444,240,100,91,9,0.705976064219049,0.316901408450704,1.21154020899591,27,9,18,0,2,3.59,10.1,0,0,0,0,0,0,0.157552225466152,249.602709762908,22.4595881814727
9.7,"random_policy_SVM","SVM",100,1,2584,2370,214,200,165,35,0.727575685930131,0.253521126760563,1.23866424352567,88,35,53,61,1.5,7.18,4.7,0,0,0,0,0,0,0.220983654088439,364.485663935449,26.1579252635422
9.7,"random_policy_SVM","SVM",100,2,2484,2282,202,300,253,47,0.815285799529385,0.295774647887324,1.27482962289868,119,47,72,31,1.5,10.78,5.4,0,0,0,0,0,0,0.18774366835812,177.920013631207,20.8165115959334
9.7,"random_policy_SVM","SVM",100,3,2384,2211,173,400,324,76,0.824934418662251,0.28169014084507,1.28387096774194,185,76,109,66,1.4,14.37,4.3,0,0,0,0,0,0,0.246528132725125,140.435246440549,32.1784180357985
9.7,"random_policy_SVM","SVM",100,4,2284,2140,144,500,395,105,0.829139505297167,0.253521126760563,1.28387096774194,253,105,148,68,1.4,17.96,3.8,0,0,0,0,0,0,0.223720580396974,185.769412345936,23.8147926814018
9.7,"random_policy_SVM","SVM",100,5,2184,2062,122,600,473,127,0.828998772812734,0.288732394366197,1.28387096774194,313,127,186,60,1.5,21.55,3.7,0,0,0,0,0,0,0.222386556604955,157.824301503058,23.4978790005198
9.7,"random_policy_SVM","SVM",100,6,2084,1988,96,700,547,153,0.818460724378241,0.288732394366197,1.27482962289868,372,153,219,59,1.4,25.14,3.6,0,0,0,0,0,0,0.224744713357035,182.192502281903,23.4096342922229
9.7,"random_policy_SVM","SVM",100,7,1984,1901,83,800,634,166,0.815950056855921,0.288732394366197,1.27482962289868,407,166,241,35,1.5,28.74,3.8,0,0,0,0,0,0,0.199568489133025,125.250182024555,21.1742802511344
9.7,"random_policy_SVM","SVM",100,8,1884,1814,70,900,721,179,0.818590198263922,0.302816901408451,1.28387096774194,451,179,272,44,1.5,32.33,4,0,0,0,0,0,0,0.193993662150154,181.485921089693,20.2136615607919
9.7,"random_policy_SVM","SVM",100,9,1784,1725,59,1000,810,190,0.817695139662916,0.23943661971831,1.28387096774194,486,190,296,35,1.6,35.92,4.3,0,0,0,0,0,0,0.151860367535492,68.6337777157087,17.0023742655678
9.7,"random_policy_SVM","SVM",100,10,1684,1630,54,1100,905,195,0.814835455579197,0.288732394366197,1.28387096774194,505,195,310,19,1.6,39.51,4.6,0,0,0,0,0,0,0.120667134707644,65.6662380206555,14.6015388375333
9.7,"random_policy_SVM","SVM",100,11,1584,1534,50,1200,1001,199,0.81360826831492,0.274647887323944,1.27482962289868,522,199,323,17,1.6,43.1,5,0,0,0,0,0,0,0.0785966009215962,23.8123043581032,12.0645352254337
9.7,"random_policy_SVM","SVM",100,12,1484,1453,31,1300,1082,218,0.827332500197022,0.28169014084507,1.27482962289868,558,218,340,36,1.6,46.7,5,0,0,0,0,0,0,0.0595126187931781,23.3552221831882,9.86417832882115
9.7,"random_policy_SVM","SVM",100,13,1384,1361,23,1400,1174,226,0.818421319282598,0.274647887323944,1.27482962289868,602,226,376,44,1.7,50.29,5.2,0,0,0,0,0,0,0.153438198894518,85.414153589658,17.0956453799525
9.7,"random_policy_SVM","SVM",100,14,1284,1266,18,1500,1269,231,0.820262100179006,0.274647887323944,1.27482962289868,611,231,380,9,1.6,53.88,5.5,0,0,0,0,0,0,0.0321540040650913,11.3435735215597,6.5462842514195
9.7,"random_policy_SVM","SVM",100,15,1184,1174,10,1600,1361,239,0.775492282230554,0.204225352112676,1.25674693321218,649,239,410,38,1.7,57.47,5.7,0,0,0,0,0,0,0.145290124268595,53.3909798422748,21.509794420291
9.7,"random_policy_SVM","SVM",100,16,1084,1076,8,1700,1459,241,0.801758593125499,0.253521126760563,1.25674693321218,666,241,425,17,1.8,61.06,6.1,0,0,0,0,0,0,0.100367733315995,57.8421637697836,12.0335445406816
9.7,"random_policy_SVM","SVM",100,17,984,979,5,1800,1556,244,0.796686594386457,0.23943661971831,1.26578827805543,658,244,414,-8,1.7,64.66,6.4,0,0,0,0,0,0,0.0449052396247005,12.2463824673055,7.83957045380248
9.7,"random_policy_SVM","SVM",100,18,884,879,5,1900,1656,244,0.806419653009985,0.28169014084507,1.27482962289868,659,244,415,1,1.7,68.25,6.8,0,0,0,0,0,0,0.0101530730854338,3.18861961156356,2.14397092882704
9.7,"random_policy_SVM","SVM",100,19,784,780,4,2000,1755,245,0.787747266975146,0.23943661971831,1.26578827805543,695,245,450,36,1.8,71.84,7.2,0,0,0,0,0,0,0.0942713692279389,24.7333400675162,14.6091761724674
9.7,"random_policy_SVM","SVM",100,20,684,682,2,2100,1853,247,0.773336260569009,0.253521126760563,1.25674693321218,715,247,468,20,1.9,75.43,7.5,0,0,0,0,0,0,0.0513959703685864,18.2558432889472,11.6090433463849
9.7,"random_policy_SVM","SVM",100,21,584,583,1,2200,1952,248,0.783795498812213,0.253521126760563,1.27482962289868,720,248,472,5,1.9,79.02,7.9,0,0,0,0,0,0,0.0250942831185242,7.94838644369603,6.1670477170031
9.7,"random_policy_SVM","SVM",100,22,484,484,0,2300,2051,249,0.82251381992997,0.323943661971831,1.26578827805543,726,249,477,6,1.9,82.61,8.2,0,0,0,0,0,0,0.0208297889123461,7.94650278135743,6.17202306734306
9.7,"random_policy_SVM","SVM",100,23,384,384,0,2400,2151,249,0.725774310129359,0.176056338028169,1.26578827805543,743,249,494,17,2,86.21,8.6,0,0,0,0,0,0,0.0422607896264818,10.5512592456632,5.90991195881235
9.7,"random_policy_SVM","SVM",100,24,284,284,0,2500,2251,249,0.783468999448325,0.246478873239437,1.27482962289868,714,249,465,-29,1.9,89.8,9,0,0,0,0,0,0,0.00188549591064525,0.728988385577966,0.63770920587664
9.7,"random_policy_SVM","SVM",100,25,184,184,0,2600,2351,249,0.736239177671942,0.225352112676056,1.27482962289868,727,249,478,13,1.9,93.39,9.4,0,0,0,0,0,0,7.69796464821438e-05,0.17541017177142,0.174200413981828
9.7,"random_policy_SVM","SVM",100,26,84,84,0,2700,2451,249,0.698399027257063,0.176056338028169,1.27482962289868,739,249,490,12,2,96.98,9.8,0,0,0,0,0,0,5.75411375963692e-06,0.0206231347337158,0.0206231347337158
9.7,"random_policy_SVM","SVM",100,27,0,0,0,2784,2535,249,0.800728431339432,0.316901408450704,1.27482962289868,721,249,472,-18,1.9,100,10.2,0,0,0,0,0,0,0,0,0
9.7,"max_tuv_SVM","SVM",1,0,2684,2444,240,100,92,8,0.8167944055944,0.286713286713287,1.25693661177532,19,8,11,0,1.4,3.59,11.5,0,0,0,0,0,0,0.274861358709326,209.038902484711,33.7440753435211
9.7,"max_tuv_SVM","SVM",1,1,2584,2361,223,200,175,25,0.83282797202797,0.335664335664336,1.2500240364585,69,25,44,50,1.8,7.18,7,0,0,0,0,0,0,0.482314452565512,275.904369363639,55.8707699618598
9.7,"max_tuv_SVM","SVM",1,2,2484,2298,186,300,238,62,0.735681118881117,0.202797202797203,1.23898037446425,160,62,98,91,1.6,10.78,3.8,0,0,0,0,0,0,0.242163079197619,391.151097230832,27.5720605815085
9.7,"max_tuv_SVM","SVM",1,3,2384,2214,170,400,322,78,0.796335664335666,0.237762237762238,1.25693661177532,192,78,114,32,1.5,14.37,4.1,0,0,0,0,0,0,0.221152593095363,274.714262754558,25.5323817118556
9.7,"max_tuv_SVM","SVM",1,4,2284,2133,151,500,403,97,0.78857062937063,0.258741258741259,1.23898037446425,247,97,150,55,1.5,17.96,4.2,0,0,0,0,0,0,0.213709510280768,213.715811679687,22.0769863124289
9.7,"max_tuv_SVM","SVM",1,5,2184,2060,124,600,476,124,0.794618181818185,0.272727272727273,1.24795849311978,301,124,177,54,1.4,21.55,3.8,0,0,0,0,0,0,0.215895664603672,185.301059053958,22.0305144035064
9.7,"max_tuv_SVM","SVM",1,6,2084,1989,95,700,547,153,0.794461538461539,0.258741258741259,1.26591473043086,370,153,217,69,1.4,25.14,3.6,0,0,0,0,0,0,0.218507438845564,136.377225315287,23.0381934527487
9.7,"max_tuv_SVM","SVM",1,7,1984,1913,71,800,623,177,0.796475524475526,0.27972027972028,1.25693661177532,425,177,248,55,1.4,28.74,3.5,0,0,0,0,0,0,0.215609330681836,146.0007870119,22.4792200617695
9.7,"max_tuv_SVM","SVM",1,8,1884,1834,50,900,702,198,0.795099300699299,0.251748251748252,1.24795849311978,478,198,280,53,1.4,32.33,3.5,0,0,0,0,0,0,0.180694451882821,93.3157182975667,19.8693782554395
9.7,"max_tuv_SVM","SVM",1,9,1784,1743,41,1000,793,207,0.797594405594404,0.265734265734266,1.24795849311978,511,207,304,33,1.5,35.92,3.8,0,0,0,0,0,0,0.175274376963202,70.038144618013,19.8196980110679
9.7,"max_tuv_SVM","SVM",1,10,1684,1650,34,1100,886,214,0.789918881118878,0.237762237762238,1.24795849311978,530,214,316,19,1.5,39.51,4.1,0,0,0,0,0,0,0.126076488184321,41.2651030112086,14.8776983475316
9.7,"max_tuv_SVM","SVM",1,11,1584,1554,30,1200,982,218,0.78217622377622,0.237762237762238,1.23000225580871,542,218,324,12,1.5,43.1,4.5,0,0,0,0,0,0,0.124624629436473,55.4086254464282,15.5189908614619
9.7,"max_tuv_SVM","SVM",1,12,1484,1462,22,1300,1074,226,0.766276923076921,0.216783216783217,1.22102413715317,577,226,351,35,1.6,46.7,4.8,0,0,0,0,0,0,0.166761525309902,93.3820424725197,19.363102560376
9.7,"max_tuv_SVM","SVM",1,13,1384,1365,19,1400,1171,229,0.720861538461537,0.160839160839161,1.23000225580871,594,229,365,17,1.6,50.29,5.1,0,0,0,0,0,0,0.179650067306216,98.1487231466494,19.7100988734142
9.7,"max_tuv_SVM","SVM",1,14,1284,1266,18,1500,1270,230,0.752587412587412,0.181818181818182,1.23898037446425,604,230,374,10,1.6,53.88,5.5,0,0,0,0,0,0,0.136928762425041,54.4034474045306,15.0425295969388
9.7,"max_tuv_SVM","SVM",1,15,1184,1168,16,1600,1368,232,0.767474125874125,0.216783216783217,1.23898037446425,612,232,380,8,1.6,57.47,5.9,0,0,0,0,0,0,0.131512242213334,53.3609181869186,14.0824923761861
9.7,"max_tuv_SVM","SVM",1,16,1084,1070,14,1700,1466,234,0.777504895104892,0.265734265734266,1.23898037446425,621,234,387,9,1.7,61.06,6.3,0,0,0,0,0,0,0.0994418991120796,33.8845790449858,11.0822188480047
9.7,"max_tuv_SVM","SVM",1,17,984,970,14,1800,1566,234,0.762332867132865,0.230769230769231,1.23898037446425,625,234,391,4,1.7,64.66,6.7,0,0,0,0,0,0,0.0580895313118908,13.9673321941467,7.20725809287133
9.7,"max_tuv_SVM","SVM",1,18,884,870,14,1900,1666,234,0.733723076923074,0.153846153846154,1.23898037446425,613,234,379,-12,1.6,68.25,7.1,0,0,0,0,0,0,0.0394483144939213,8.08968730389173,5.4935149473935
9.7,"max_tuv_SVM","SVM",1,19,784,771,13,2000,1765,235,0.753594405594402,0.188811188811189,1.23898037446425,617,235,382,4,1.6,71.84,7.5,0,0,0,0,0,0,0.00737870095587608,3.19874539463735,3.04196242937141
9.7,"max_tuv_SVM","SVM",1,20,684,671,13,2100,1865,235,0.794718881118879,0.251748251748252,1.23898037446425,621,235,386,4,1.6,75.43,7.9,0,0,0,0,0,0,0.00324199829635997,1.00847350586451,0.953891991893827
9.7,"max_tuv_SVM","SVM",1,21,584,578,6,2200,1958,242,0.758752447552448,0.202797202797203,1.26591473043086,660,242,418,39,1.7,79.02,8.1,0,0,0,0,0,0,0.096982706077875,30.1439648500469,13.2747922456831
9.7,"max_tuv_SVM","SVM",1,22,484,479,5,2300,2057,243,0.766646153846153,0.223776223776224,1.25577921158032,666,243,423,6,1.7,82.61,8.5,0,0,0,0,0,0,0.0733344075829066,22.6916557987065,9.64346059991692
9.7,"max_tuv_SVM","SVM",1,23,384,381,3,2400,2155,245,0.761918881118883,0.237762237762238,1.28268876611418,675,245,430,9,1.8,86.21,8.8,0,0,0,0,0,0,0.033598135230563,8.95856376488693,5.65562527118263
9.7,"max_tuv_SVM","SVM",1,24,284,283,1,2500,2253,247,0.806685314685313,0.307692307692308,1.28268876611418,680,247,433,5,1.8,89.8,9.1,0,0,0,0,0,0,0.0124295589899641,2.88260367761843,2.20193356972481
9.7,"max_tuv_SVM","SVM",1,25,184,183,1,2600,2353,247,0.781952447552448,0.230769230769231,1.28268876611418,691,247,444,11,1.8,93.39,9.5,0,0,0,0,0,0,0.00399916830035567,0.994595617570469,0.93050372636326
9.7,"max_tuv_SVM","SVM",1,26,84,83,1,2700,2453,247,0.774025174825175,0.20979020979021,1.28268876611418,681,247,434,-10,1.8,96.98,9.9,0,0,0,0,0,0,6.85258441141137e-09,0.0732239265073938,0.0732239265073938
9.7,"max_tuv_SVM","SVM",1,27,0,0,0,2784,2536,248,0.76430769230769,0.202797202797203,1.27371891460289,708,248,460,27,1.9,100,10.2,0,0,0,0,0,0,0,0,0
9.7,"max_tuv_SVM","SVM",2,0,2684,2438,246,100,89,11,0.750903939397533,0.246268656716418,1.23596533461724,32,11,21,0,1.9,3.59,8.1,0,0,0,0,0,0,0.125532650621015,301.852585932197,14.578560630903
9.7,"max_tuv_SVM","SVM",2,1,2584,2338,246,200,189,11,0.765621851030788,0.283582089552239,1.2263842079923,33,11,22,1,2,7.18,17.2,0,0,0,0,0,0,0.157715417745117,244.945901275835,38.1430255804659
9.7,"max_tuv_SVM","SVM",2,2,2484,2258,226,300,269,31,0.752095361160839,0.276119402985075,1.2263842079923,89,31,58,56,1.9,10.78,8.7,0,0,0,0,0,0,0.238805891725298,293.478970753443,25.8649596957564
9.7,"max_tuv_SVM","SVM",2,3,2384,2183,201,400,344,56,0.735883726719856,0.156716417910448,1.24554646124218,171,56,115,82,2.1,14.37,6.1,0,0,0,0,0,0,0.226525058332516,331.737986015762,24.4286031943331
9.7,"max_tuv_SVM","SVM",2,4,2284,2092,192,500,435,65,0.803895534243004,0.343283582089552,1.24554646124218,186,65,121,15,1.9,17.96,6.7,0,0,0,0,0,0,0.224564953889056,241.378029531448,23.926511276463
9.7,"max_tuv_SVM","SVM",2,5,2184,2019,165,600,508,92,0.785502590305029,0.261194029850746,1.25512758786712,253,92,161,67,1.8,21.55,5.5,0,0,0,0,0,0,0.206851195745608,258.831752325173,21.167131130364
9.7,"max_tuv_SVM","SVM",2,6,2084,1935,149,700,592,108,0.813302431448794,0.343283582089552,1.25512758786712,294,108,186,41,1.7,25.14,5.5,0,0,0,0,0,0,0.210182193522491,174.411974637726,21.8694332593606
9.7,"max_tuv_SVM","SVM",2,7,1984,1865,119,800,662,138,0.807374959989568,0.335820895522388,1.26470871449206,369,138,231,75,1.7,28.74,4.8,0,0,0,0,0,0,0.215156140761598,146.8977478616,22.3222024576947
9.7,"max_tuv_SVM","SVM",2,8,1884,1793,91,900,734,166,0.79542517752777,0.276119402985075,1.25512758786712,423,166,257,54,1.5,32.33,4.4,0,0,0,0,0,0,0.223459485604224,165.125215071089,23.0529373693231
9.7,"max_tuv_SVM","SVM",2,9,1784,1708,76,1000,819,181,0.779450641945159,0.186567164179104,1.25512758786712,471,181,290,48,1.6,35.92,4.5,0,0,0,0,0,0,0.203200616923066,160.160675312112,20.8759642220074
9.7,"max_tuv_SVM","SVM",2,10,1684,1628,56,1100,899,201,0.783842898296445,0.23134328358209,1.24554646124218,535,201,334,64,1.7,39.51,4.5,0,0,0,0,0,0,0.198067636917159,143.79503414602,20.5651013828505
9.7,"max_tuv_SVM","SVM",2,11,1584,1542,42,1200,985,215,0.789177622609748,0.208955223880597,1.25512758786712,560,215,345,25,1.6,43.1,4.6,0,0,0,0,0,0,0.186755552523304,118.580508815261,19.8166485298239
9.7,"max_tuv_SVM","SVM",2,12,1484,1451,33,1300,1076,224,0.786053845150737,0.261194029850746,1.23596533461724,584,224,360,24,1.6,46.7,4.8,0,0,0,0,0,0,0.167230828769612,81.5725316242098,18.1230423606351
9.7,"max_tuv_SVM","SVM",2,13,1384,1359,25,1400,1168,232,0.802330681777766,0.261194029850746,1.24554646124218,614,232,382,30,1.6,50.29,5,0,0,0,0,0,0,0.148697880840555,79.3379082613592,21.0358529571668
9.7,"max_tuv_SVM","SVM",2,14,1284,1264,20,1500,1263,237,0.826668879589345,0.350746268656716,1.2263842079923,616,237,379,2,1.6,53.88,5.3,0,0,0,0,0,0,0.131195213256665,65.9409015619202,17.8521226125827
9.7,"max_tuv_SVM","SVM",2,15,1184,1170,14,1600,1357,243,0.814790226785059,0.335820895522388,1.20722195474242,631,243,388,15,1.6,57.47,5.6,0,0,0,0,0,0,0.0874951508057678,31.2363301357026,11.0963157885214
9.7,"max_tuv_SVM","SVM",2,16,1084,1072,12,1700,1455,245,0.797215273908458,0.283582089552239,1.19764082811748,633,245,388,2,1.6,61.06,5.9,0,0,0,0,0,0,0.116012312265397,55.9258108282258,14.4362585947859
9.7,"max_tuv_SVM","SVM",2,17,984,972,12,1800,1555,245,0.807973634606951,0.298507462686567,1.19764082811748,636,245,391,3,1.6,64.66,6.3,0,0,0,0,0,0,0.0665765415708047,23.2798818030243,8.10961966142211
9.7,"max_tuv_SVM","SVM",2,18,884,872,12,1900,1655,245,0.773754341872844,0.223880597014925,1.19764082811748,649,245,404,13,1.6,68.25,6.8,0,0,0,0,0,0,0.0349525101229737,9.90846417584517,4.93561775886903
9.7,"max_tuv_SVM","SVM",2,19,784,774,10,2000,1753,247,0.798400768200302,0.291044776119403,1.20722195474242,651,247,404,2,1.6,71.84,7.1,0,0,0,0,0,0,0.0177922191127974,5.8697064269488,2.7620976532819
9.7,"max_tuv_SVM","SVM",2,20,684,675,9,2100,1852,248,0.811387858167464,0.298507462686567,1.23596533461724,653,248,405,2,1.6,75.43,7.5,0,0,0,0,0,0,0.0173176913766854,5.44683179773386,2.3061200511192
9.7,"max_tuv_SVM","SVM",2,21,584,576,8,2200,1951,249,0.787559422901381,0.261194029850746,1.24554646124218,666,249,417,13,1.7,79.02,7.8,0,0,0,0,0,0,0.0604426024260906,19.7544003420551,6.57572036000652
9.7,"max_tuv_SVM","SVM",2,22,484,481,3,2300,2046,254,0.786160539637006,0.208955223880597,1.26470871449206,693,254,439,27,1.7,82.61,8.1,0,0,0,0,0,0,0.00782233894596583,3.30181222830192,2.75581172627231
9.7,"max_tuv_SVM","SVM",2,23,384,384,0,2400,2143,257,0.803937026543222,0.261194029850746,1.26470871449206,692,257,435,-1,1.7,86.21,8.3,0,0,0,0,0,0,0.000191383452099314,0.186436475625165,0.179824144967247
9.7,"max_tuv_SVM","SVM",2,24,284,284,0,2500,2243,257,0.818672720590853,0.26865671641791,1.274289841117,683,257,426,-9,1.7,89.8,8.7,0,0,0,0,0,0,0.000509102871153574,0.353363030783681,0.332552282158131
9.7,"max_tuv_SVM","SVM",2,25,184,184,0,2600,2343,257,0.788264792005032,0.208955223880597,1.26470871449206,707,257,450,24,1.8,93.39,9.1,0,0,0,0,0,0,6.44272238107015e-07,0.00275314711527591,0.00273131823022523
9.7,"max_tuv_SVM","SVM",2,26,84,84,0,2700,2443,257,0.811144831837637,0.26865671641791,1.26470871449206,702,257,445,-5,1.7,96.98,9.5,0,0,0,0,0,0,1.0000000994736e-07,0.00253636952055127,0.00253636952055127
9.7,"max_tuv_SVM","SVM",2,27,0,0,0,2784,2527,257,0.774791649378214,0.216417910447761,1.26470871449206,699,257,442,-3,1.7,100,9.8,0,0,0,0,0,0,0,0,0
9.7,"max_tuv_SVM","SVM",3,0,2684,2447,237,100,85,15,0.690435211639306,0.172661870503597,1.05295892318403,41,15,26,0,1.7,3.59,5.7,0,0,0,0,0,0,0.397026325721534,414.697482464903,42.1728417550085
9.7,"max_tuv_SVM","SVM",3,1,2584,2354,230,200,178,22,0.668915585235166,0.115107913669065,1.08890125468686,61,22,39,20,1.8,7.18,8.1,0,0,0,0,0,0,0.365216675685115,285.568347075676,53.0566830416245
9.7,"max_tuv_SVM","SVM",3,2,2484,2264,220,300,268,32,0.756818468670051,0.266187050359712,1.22845207704804,84,32,52,23,1.6,10.78,8.4,0,0,0,0,0,0,0.125496467152362,252.980744077688,13.4767170776881
9.7,"max_tuv_SVM","SVM",3,3,2384,2181,203,400,351,49,0.78199832478515,0.323741007194245,1.24692504061267,141,49,92,57,1.9,14.37,7.2,0,0,0,0,0,0,0.15763642087803,243.719857721636,18.0633211302881
9.7,"max_tuv_SVM","SVM",3,4,2284,2114,170,500,418,82,0.744346149874362,0.23021582733813,1.24692504061267,206,82,124,65,1.5,17.96,5.1,0,0,0,0,0,0,0.182816894072265,287.91973241068,19.3819454233999
9.7,"max_tuv_SVM","SVM",3,5,2184,2037,147,600,495,105,0.72542540130576,0.194244604316547,1.23768855883036,262,105,157,56,1.5,21.55,4.7,0,0,0,0,0,0,0.189688886120246,182.826753760721,23.9423236389604
9.7,"max_tuv_SVM","SVM",3,6,2084,1948,136,700,584,116,0.765137172558608,0.244604316546763,1.21921559526572,289,116,173,27,1.5,25.14,5,0,0,0,0,0,0,0.173785259953335,179.027896125236,18.7934186504124
9.7,"max_tuv_SVM","SVM",3,7,1984,1867,117,800,665,135,0.789708902734275,0.287769784172662,1.24692504061267,335,135,200,46,1.5,28.74,4.9,0,0,0,0,0,0,0.16965919362764,118.960125509865,17.7319787436414
9.7,"max_tuv_SVM","SVM",3,8,1884,1797,87,900,735,165,0.797494062166537,0.323741007194245,1.24692504061267,404,165,239,69,1.4,32.33,4.5,0,0,0,0,0,0,0.174830319370871,130.804696678418,18.7814627088678
9.7,"max_tuv_SVM","SVM",3,9,1784,1720,64,1000,812,188,0.792749532431477,0.302158273381295,1.24692504061267,450,188,262,46,1.4,35.92,4.3,0,0,0,0,0,0,0.136140007776482,74.8746497499885,15.5938661692749
9.7,"max_tuv_SVM","SVM",3,10,1684,1633,51,1100,899,201,0.793070806512686,0.294964028776978,1.23768855883036,493,201,292,43,1.5,39.51,4.5,0,0,0,0,0,0,0.143985276977626,95.0729452175859,15.5867523979749
9.7,"max_tuv_SVM","SVM",3,11,1584,1538,46,1200,994,206,0.789083565683341,0.280575539568345,1.23768855883036,507,206,301,14,1.5,43.1,4.8,0,0,0,0,0,0,0.121023124397494,69.3745453110149,13.6885718553343
9.7,"max_tuv_SVM","SVM",3,12,1484,1444,40,1300,1088,212,0.804573566027566,0.273381294964029,1.22845207704804,529,212,317,22,1.5,46.7,5.1,0,0,0,0,0,0,0.133809421019623,74.7310396598029,14.7801862721303
9.7,"max_tuv_SVM","SVM",3,13,1384,1354,30,1400,1178,222,0.813018484733751,0.287769784172662,1.22845207704804,554,222,332,25,1.5,50.29,5.3,0,0,0,0,0,0,0.131322690690685,53.9476169563693,14.381968397897
9.7,"max_tuv_SVM","SVM",3,14,1284,1263,21,1500,1269,231,0.811825181003527,0.302158273381295,1.20997911348341,588,231,357,34,1.5,53.88,5.5,0,0,0,0,0,0,0.127476473025886,63.3586503746667,13.7106415396911
9.7,"max_tuv_SVM","SVM",3,15,1184,1171,13,1600,1361,239,0.816672977407552,0.316546762589928,1.20997911348341,613,239,374,25,1.6,57.47,5.7,0,0,0,0,0,0,0.121295155389515,56.5993040572492,13.0588432184669
9.7,"max_tuv_SVM","SVM",3,16,1084,1071,13,1700,1461,239,0.818927633013214,0.273381294964029,1.21921559526572,616,239,377,3,1.6,61.06,6.1,0,0,0,0,0,0,0.081313108128056,27.5012006955202,9.23233351556483
9.7,"max_tuv_SVM","SVM",3,17,984,971,13,1800,1561,239,0.80444735120995,0.273381294964029,1.21921559526572,616,239,377,0,1.6,64.66,6.5,0,0,0,0,0,0,0.0444997743557,11.1674121400602,5.8005446779553
9.7,"max_tuv_SVM","SVM",3,18,884,872,12,1900,1660,240,0.805319380858959,0.287769784172662,1.23768855883036,615,240,375,-1,1.6,68.25,6.9,0,0,0,0,0,0,0.0225601010416102,5.67057263906206,3.73520359246127
9.7,"max_tuv_SVM","SVM",3,19,784,773,11,2000,1759,241,0.803896595642155,0.294964028776978,1.23768855883036,632,241,391,17,1.6,71.84,7.3,0,0,0,0,0,0,0.00372360450724547,1.58656431852817,1.42999492264629
9.7,"max_tuv_SVM","SVM",3,20,684,676,8,2100,1856,244,0.811779284706217,0.287769784172662,1.24692504061267,620,244,376,-12,1.5,75.43,7.6,0,0,0,0,0,0,0.0033925421498757,1.20397918585313,0.578954383568383
9.7,"max_tuv_SVM","SVM",3,21,584,579,5,2200,1953,247,0.814647803288469,0.323741007194245,1.24692504061267,646,247,399,26,1.6,79.02,7.9,0,0,0,0,0,0,0.0645111636620585,25.639518439841,14.2315869213212
9.7,"max_tuv_SVM","SVM",3,22,484,479,5,2300,2053,247,0.805480017899559,0.251798561151079,1.24692504061267,645,247,398,-1,1.6,82.61,8.3,0,0,0,0,0,0,0.0385656982945769,10.8566981225561,5.29654608547142
9.7,"max_tuv_SVM","SVM",3,23,384,380,4,2400,2152,248,0.814728121808775,0.280575539568345,1.2653980041773,664,248,416,19,1.7,86.21,8.7,0,0,0,0,0,0,0.0352816058900747,10.8606702512602,6.93909279044224
9.7,"max_tuv_SVM","SVM",3,24,284,281,3,2500,2251,249,0.815152662558954,0.273381294964029,1.27463448595962,654,249,405,-10,1.6,89.8,9,0,0,0,0,0,0,0.0282579433075921,6.20107420334697,4.13056124342638
9.7,"max_tuv_SVM","SVM",3,25,184,184,0,2600,2348,252,0.815491147751657,0.258992805755396,1.28387096774194,676,252,424,22,1.7,93.39,9.3,0,0,0,0,0,0,0.00458539759131094,1.68316466043991,1.56904786443227
9.7,"max_tuv_SVM","SVM",3,26,84,84,0,2700,2448,252,0.793633036154811,0.20863309352518,1.27463448595962,689,252,437,13,1.7,96.98,9.7,0,0,0,0,0,0,8.67685655306592e-06,0.185072820149363,0.185072820149363
9.7,"max_tuv_SVM","SVM",3,27,0,0,0,2784,2532,252,0.830436129565247,0.302158273381295,1.27463448595962,669,252,417,-20,1.7,100,10,0,0,0,0,0,0,0,0,0
9.7,"max_tuv_SVM","SVM",4,0,2684,2435,249,100,92,8,0.719227531919439,0.26865671641791,1.21680308136736,29,8,21,0,2.6,3.59,11.5,0,0,0,0,0,0,0.109879871932389,230.430067283199,11.9707329096446
9.7,"max_tuv_SVM","SVM",4,1,2584,2362,222,200,165,35,0.763452396476715,0.0970149253731343,1.25512758786712,96,35,61,67,1.7,7.18,4.7,0,0,0,0,0,0,0.230140247569738,371.29483771387,24.4651309970366
9.7,"max_tuv_SVM","SVM",4,2,2484,2277,207,300,250,50,0.718415468329522,0.186567164179104,1.23596533461724,138,50,88,42,1.8,10.78,5,0,0,0,0,0,0,0.187152864474089,339.512312315852,21.2579590635686
9.7,"max_tuv_SVM","SVM",4,3,2384,2190,194,400,337,63,0.796154256517257,0.149253731343284,1.274289841117,173,63,110,35,1.7,14.37,5.3,0,0,0,0,0,0,0.188220817664788,324.530004876988,23.4153809821048
9.7,"max_tuv_SVM","SVM",4,4,2284,2096,188,500,431,69,0.808637511410387,0.276119402985075,1.28387096774194,198,69,129,25,1.9,17.96,6.2,0,0,0,0,0,0,0.168864383562579,203.611050334238,17.5546730233214
9.7,"max_tuv_SVM","SVM",4,5,2184,2030,154,600,497,103,0.815975721076907,0.276119402985075,1.274289841117,267,103,164,69,1.6,21.55,4.8,0,0,0,0,0,0,0.18744350729453,175.063459804002,19.4986730722018
9.7,"max_tuv_SVM","SVM",4,6,2084,1964,120,700,563,137,0.821049636646004,0.305970149253731,1.274289841117,346,137,209,79,1.5,25.14,4.1,0,0,0,0,0,0,0.210820706199765,170.737842648635,22.151149499201
9.7,"max_tuv_SVM","SVM",4,7,1984,1896,88,800,631,169,0.834611691344711,0.276119402985075,1.274289841117,418,169,249,72,1.5,28.74,3.7,0,0,0,0,0,0,0.216558012538568,227.194244809144,22.8761739415093
9.7,"max_tuv_SVM","SVM",4,8,1884,1825,59,900,702,198,0.8267340817754,0.238805970149254,1.274289841117,489,198,291,71,1.5,32.33,3.5,0,0,0,0,0,0,0.197279161128435,153.359578366517,21.3196290865466
9.7,"max_tuv_SVM","SVM",4,9,1784,1737,47,1000,790,210,0.817931786658451,0.253731343283582,1.274289841117,524,210,314,35,1.5,35.92,3.8,0,0,0,0,0,0,0.187505613713716,139.481762296231,21.9611781274767
9.7,"max_tuv_SVM","SVM",4,10,1684,1641,43,1100,886,214,0.817090085711241,0.238805970149254,1.274289841117,529,214,315,5,1.5,39.51,4.1,0,0,0,0,0,0,0.152374987134572,75.1406083630707,17.0727190992227
9.7,"max_tuv_SVM","SVM",4,11,1584,1557,27,1200,970,230,0.806266522826696,0.171641791044776,1.274289841117,592,230,362,63,1.6,43.1,4.2,0,0,0,0,0,0,0.174436154903238,107.215678816966,19.0694709647874
9.7,"max_tuv_SVM","SVM",4,12,1484,1469,15,1300,1058,242,0.823444335115531,0.253731343283582,1.274289841117,633,242,391,41,1.6,46.7,4.4,0,0,0,0,0,0,0.132864280715105,65.9728179867401,16.525472704056
9.7,"max_tuv_SVM","SVM",4,13,1384,1373,11,1400,1154,246,0.798436333029059,0.223880597014925,1.274289841117,637,246,391,4,1.6,50.29,4.7,0,0,0,0,0,0,0.127690815223989,58.1485088431151,15.1155689226229
9.7,"max_tuv_SVM","SVM",4,14,1284,1277,7,1500,1250,250,0.793427619646015,0.201492537313433,1.274289841117,665,250,415,28,1.7,53.88,5,0,0,0,0,0,0,0.130325009886417,65.0149525644811,14.7302282063629
9.7,"max_tuv_SVM","SVM",4,15,1184,1178,6,1600,1349,251,0.798377058314467,0.223880597014925,1.274289841117,658,251,407,-7,1.6,57.47,5.4,0,0,0,0,0,0,0.0811992778607122,29.4609069736586,10.0802659347055
9.7,"max_tuv_SVM","SVM",4,16,1084,1081,3,1700,1446,254,0.788869394093871,0.208955223880597,1.274289841117,699,254,445,41,1.8,61.06,5.7,0,0,0,0,0,0,0.13552719636895,104.359768488688,14.1680074775954
9.7,"max_tuv_SVM","SVM",4,17,984,981,3,1800,1546,254,0.808661221296223,0.283582089552239,1.274289841117,687,254,433,-12,1.7,64.66,6.1,0,0,0,0,0,0,0.113435180773303,70.7274449774194,12.1422112990904
9.7,"max_tuv_SVM","SVM",4,18,884,882,2,1900,1645,255,0.786373928609537,0.208955223880597,1.274289841117,701,255,446,14,1.7,68.25,6.5,0,0,0,0,0,0,0.0945328140476677,50.0324845619158,11.0718187321561
9.7,"max_tuv_SVM","SVM",4,19,784,783,1,2000,1744,256,0.775585930553748,0.194029850746269,1.274289841117,699,256,443,-2,1.7,71.84,6.8,0,0,0,0,0,0,0.0821393774849888,38.102981872905,9.31936877880461
9.7,"max_tuv_SVM","SVM",4,20,684,683,1,2100,1844,256,0.811334510924333,0.26865671641791,1.274289841117,693,256,437,-6,1.7,75.43,7.2,0,0,0,0,0,0,0.021093723081434,6.71003202570717,3.05076330407525
9.7,"max_tuv_SVM","SVM",4,21,584,583,1,2200,1944,256,0.758248076535515,0.17910447761194,1.274289841117,709,256,453,16,1.8,79.02,7.6,0,0,0,0,0,0,0.00781995191071637,2.20642538822712,1.37968881441784
9.7,"max_tuv_SVM","SVM",4,22,484,484,0,2300,2043,257,0.780126373691514,0.223880597014925,1.274289841117,705,257,448,-4,1.7,82.61,7.9,0,0,0,0,0,0,0.00570784292480167,1.72845360675147,1.26389734581685
9.7,"max_tuv_SVM","SVM",4,23,384,384,0,2400,2143,257,0.767465294654611,0.201492537313433,1.274289841117,716,257,459,11,1.8,86.21,8.3,0,0,0,0,0,0,0.00129726315367057,0.412171925880154,0.335423816574897
9.7,"max_tuv_SVM","SVM",4,24,284,284,0,2500,2243,257,0.759374296112768,0.194029850746269,1.274289841117,721,257,464,5,1.8,89.8,8.7,0,0,0,0,0,0,8.55276866837986e-05,0.0558141602345188,0.0523579080080418
9.7,"max_tuv_SVM","SVM",4,25,184,184,0,2600,2343,257,0.811144831837638,0.305970149253731,1.26470871449206,709,257,452,-12,1.8,93.39,9.1,0,0,0,0,0,0,0.000260896692518634,0.181191142514264,0.17166392744898
9.7,"max_tuv_SVM","SVM",4,26,84,84,0,2700,2443,257,0.796195748817473,0.23134328358209,1.274289841117,700,257,443,-9,1.7,96.98,9.5,0,0,0,0,0,0,1.0000000994736e-07,0.00308197221058803,0.00308197221058803
9.7,"max_tuv_SVM","SVM",4,27,0,0,0,2784,2527,257,0.774157409932073,0.186567164179104,1.274289841117,714,257,457,14,1.8,100,9.8,0,0,0,0,0,0,0,0,0
9.7,"max_tuv_SVM","SVM",5,0,2684,2432,252,100,89,11,0.74890686758893,0.34375,1.07323588709677,25,11,14,0,1.3,3.59,8.1,0,0,0,0,0,0,0.181600994689075,287.759373159024,18.9537319833917
9.7,"max_tuv_SVM","SVM",5,1,2584,2370,214,200,151,49,0.686030138339924,0.109375,1.16350806451613,113,49,64,88,1.3,7.18,3.1,0,0,0,0,0,0,0.283767147501806,588.96197109521,33.0553443208188
9.7,"max_tuv_SVM","SVM",5,2,2484,2285,199,300,236,64,0.73998888339921,0.125,1.25378024193548,165,64,101,52,1.6,10.78,3.7,0,0,0,0,0,0,0.236815297010896,529.439705405822,24.3117219718405
9.7,"max_tuv_SVM","SVM",5,3,2384,2192,192,400,329,71,0.828489377470355,0.2421875,1.28387096774194,169,71,98,4,1.4,14.37,4.6,0,0,0,0,0,0,0.277724181340289,221.351536366057,47.0313679742062
9.7,"max_tuv_SVM","SVM",5,4,2284,2111,173,500,410,90,0.810109930830039,0.203125,1.27384072580645,222,90,132,53,1.5,17.96,4.6,0,0,0,0,0,0,0.218262761269429,234.865203039997,27.0011355451645
9.7,"max_tuv_SVM","SVM",5,5,2184,2031,153,600,490,110,0.807207262845854,0.2265625,1.25378024193548,274,110,164,52,1.5,21.55,4.5,0,0,0,0,0,0,0.205784259603467,252.932377440459,23.2097160621864
9.7,"max_tuv_SVM","SVM",5,6,2084,1961,123,700,560,140,0.826679841897237,0.28125,1.26381048387097,341,140,201,67,1.4,25.14,4,0,0,0,0,0,0,0.21804687727851,176.299179438576,22.4363645967953
9.7,"max_tuv_SVM","SVM",5,7,1984,1883,101,800,638,162,0.828372035573128,0.3046875,1.26381048387097,397,162,235,56,1.5,28.74,3.9,0,0,0,0,0,0,0.209899212545709,207.5868563508,21.3559284090365
9.7,"max_tuv_SVM","SVM",5,8,1884,1811,73,900,710,190,0.835004940711468,0.3125,1.26381048387097,455,190,265,58,1.4,32.33,3.7,0,0,0,0,0,0,0.196545669659958,100.662793567263,21.0848496749455
9.7,"max_tuv_SVM","SVM",5,9,1784,1727,57,1000,794,206,0.836085721343879,0.3046875,1.26381048387097,481,206,275,26,1.3,35.92,3.9,0,0,0,0,0,0,0.171777846473474,70.0890102675609,19.3081350067091
9.7,"max_tuv_SVM","SVM",5,10,1684,1644,40,1100,877,223,0.831145009881428,0.3125,1.26381048387097,531,223,308,50,1.4,39.51,3.9,0,0,0,0,0,0,0.176811837633513,78.928541125471,19.1319922424253
9.7,"max_tuv_SVM","SVM",5,11,1584,1557,27,1200,964,236,0.821976902173915,0.28125,1.26264675414365,572,236,336,41,1.4,43.1,4.1,0,0,0,0,0,0,0.157373922747195,50.2770749537032,18.0057078017078
9.7,"max_tuv_SVM","SVM",5,12,1484,1460,24,1300,1061,239,0.8141057312253,0.2734375,1.26381048387097,597,239,358,25,1.5,46.7,4.4,0,0,0,0,0,0,0.126297731633628,35.9939786489669,14.7911502459013
9.7,"max_tuv_SVM","SVM",5,13,1384,1363,21,1400,1158,242,0.810035820158105,0.2578125,1.26381048387097,612,242,370,15,1.5,50.29,4.8,0,0,0,0,0,0,0.106167330603356,32.2420643562234,13.0193212910681
9.7,"max_tuv_SVM","SVM",5,14,1284,1264,20,1500,1257,243,0.818712944664035,0.265625,1.26381048387097,609,243,366,-3,1.5,53.88,5.2,0,0,0,0,0,0,0.0368553338125881,10.0178440502414,5.72192771326333
9.7,"max_tuv_SVM","SVM",5,15,1184,1165,19,1600,1356,244,0.804770874505934,0.2734375,1.26264675414365,620,244,376,11,1.5,57.47,5.6,0,0,0,0,0,0,0.0174383761091097,4.9928136449811,3.42509386733206
9.7,"max_tuv_SVM","SVM",5,16,1084,1068,16,1700,1453,247,0.801179594861667,0.2578125,1.25378024193548,629,247,382,9,1.5,61.06,5.9,0,0,0,0,0,0,0.120453657479925,34.5940322230086,13.7335101278919
9.7,"max_tuv_SVM","SVM",5,17,984,969,15,1800,1552,248,0.79520750988143,0.25,1.25378024193548,637,248,389,8,1.6,64.66,6.3,0,0,0,0,0,0,0.0612221618458336,14.7628881175499,9.37522988773553
9.7,"max_tuv_SVM","SVM",5,18,884,869,15,1900,1652,248,0.800030879446646,0.2890625,1.26381048387097,627,248,379,-10,1.5,68.25,6.7,0,0,0,0,0,0,0.0565793889100431,13.6266594298616,7.76158359066364
9.7,"max_tuv_SVM","SVM",5,19,784,769,15,2000,1752,248,0.78423913043479,0.25,1.26148516559338,642,248,394,15,1.6,71.84,7.1,0,0,0,0,0,0,0.000478443966855315,0.696141804875317,0.678586922024617
9.7,"max_tuv_SVM","SVM",5,20,684,672,12,2100,1849,251,0.793107707509884,0.2421875,1.27266776012891,646,251,395,4,1.6,75.43,7.4,0,0,0,0,0,0,0.00129769748550787,0.600477598163176,0.530213557116512
9.7,"max_tuv_SVM","SVM",5,21,584,579,5,2200,1942,258,0.810369318181819,0.2734375,1.28268876611418,700,258,442,54,1.7,79.02,7.5,0,0,0,0,0,0,0.0758237543916175,23.3619806628977,11.7941865945014
9.7,"max_tuv_SVM","SVM",5,22,484,481,3,2300,2040,260,0.801120923913047,0.2265625,1.28150873965041,699,260,439,-1,1.7,82.61,7.8,0,0,0,0,0,0,0.0568049796770517,14.7226858476864,8.05193751432651
9.7,"max_tuv_SVM","SVM",5,23,384,382,2,2400,2139,261,0.810153162055337,0.28125,1.28268876611418,713,261,452,14,1.7,86.21,8.2,0,0,0,0,0,0,0.0322823953404667,9.16866572393525,7.54120714129125
9.7,"max_tuv_SVM","SVM",5,24,284,282,2,2500,2239,261,0.829187252964427,0.3046875,1.28268876611418,702,261,441,-11,1.7,89.8,8.6,0,0,0,0,0,0,0.0088378622895554,2.74347063203055,2.29092626080241
9.7,"max_tuv_SVM","SVM",5,25,184,183,1,2600,2338,262,0.748122529644268,0.1875,1.27266776012891,713,262,451,11,1.7,93.39,8.9,0,0,0,0,0,0,0.0229309149516153,8.02701561112833,7.28032749779819
9.7,"max_tuv_SVM","SVM",5,26,84,84,0,2700,2437,263,0.790476778656127,0.21875,1.28268876611418,725,263,462,12,1.8,96.98,9.3,0,0,0,0,0,0,1.44692299205808e-07,1.19457987494737,1.19457987494737
9.7,"max_tuv_SVM","SVM",5,27,0,0,0,2784,2521,263,0.761166007905139,0.1953125,1.28268876611418,729,263,466,4,1.8,100,9.6,0,0,0,0,0,0,0,0,0
9.7,"max_tuv_SVM","SVM",6,0,2684,2422,262,100,93,7,0.68016019398692,0.0901639344262295,1.26282390269699,26,7,19,0,2.7,3.59,13.3,0,0,0,0,0,0,0.102415930980949,216.141262833793,11.3377992104366
9.7,"max_tuv_SVM","SVM",6,1,2584,2332,252,200,183,17,0.711644374508259,0.286885245901639,1.18915917503966,57,17,40,31,2.4,7.18,10.8,0,0,0,0,0,0,0.0916008169564468,219.156147664558,9.27919806454636
9.7,"max_tuv_SVM","SVM",6,2,2484,2258,226,300,257,43,0.639157240329673,0.221311475409836,1.08392384981491,122,43,79,65,1.8,10.78,6,0,0,0,0,0,0,0.184578422284825,290.208186347635,21.4571764571284
9.7,"max_tuv_SVM","SVM",6,3,2384,2180,204,400,335,65,0.645103249022977,0.172131147540984,1.16811210999471,170,65,105,48,1.6,14.37,5.2,0,0,0,0,0,0,0.179605507277954,276.526362506676,18.8551961957307
9.7,"max_tuv_SVM","SVM",6,4,2284,2089,195,500,426,74,0.675865137815834,0.213114754098361,1.15758857747224,195,74,121,25,1.6,17.96,5.8,0,0,0,0,0,0,0.155699401507365,185.325419182607,16.229439609336
9.7,"max_tuv_SVM","SVM",6,5,2184,2005,179,600,510,90,0.683158994466727,0.245901639344262,1.14706504494976,227,90,137,32,1.5,21.55,5.7,0,0,0,0,0,0,0.148910242074268,217.731185079171,15.1905992791811
9.7,"max_tuv_SVM","SVM",6,6,2084,1915,169,700,600,100,0.693174343165957,0.254098360655738,1.21020624008461,252,100,152,25,1.5,25.14,6,0,0,0,0,0,0,0.138755582227898,182.751504913191,14.2734112515057
9.7,"max_tuv_SVM","SVM",6,7,1984,1829,155,800,686,114,0.714681869187812,0.254098360655738,1.22072977260709,284,114,170,32,1.5,28.74,6,0,0,0,0,0,0,0.132528683922797,132.06729698589,14.1189162850937
9.7,"max_tuv_SVM","SVM",6,8,1884,1750,134,900,765,135,0.740342572648362,0.262295081967213,1.25230037017451,340,135,205,56,1.5,32.33,5.7,0,0,0,0,0,0,0.145145896543256,130.129079224483,15.2406187750831
9.7,"max_tuv_SVM","SVM",6,9,1784,1679,105,1000,836,164,0.754652977518667,0.270491803278689,1.25230037017451,407,164,243,67,1.5,35.92,5.1,0,0,0,0,0,0,0.126632153622172,56.1846016104328,15.4233619362685
9.7,"max_tuv_SVM","SVM",6,10,1684,1604,80,1100,911,189,0.754104809689029,0.237704918032787,1.25230037017451,473,189,284,66,1.5,39.51,4.8,0,0,0,0,0,0,0.134929289188065,91.8301009619164,14.8921356897189
9.7,"max_tuv_SVM","SVM",6,11,1584,1519,65,1200,996,204,0.779984780281435,0.270491803278689,1.24177683765204,514,204,310,41,1.5,43.1,4.9,0,0,0,0,0,0,0.14851255274215,121.78533299686,17.8154088844935
9.7,"max_tuv_SVM","SVM",6,12,1484,1434,50,1300,1081,219,0.82376081825334,0.311475409836066,1.24177683765204,543,219,324,29,1.5,46.7,4.9,0,0,0,0,0,0,0.160982443626505,157.888392671066,18.2909133753171
9.7,"max_tuv_SVM","SVM",6,13,1384,1355,29,1400,1160,240,0.816241245437307,0.245901639344262,1.25230037017451,604,240,364,61,1.5,50.29,4.8,0,0,0,0,0,0,0.172655261971676,179.027334875797,17.9604934257611
9.7,"max_tuv_SVM","SVM",6,14,1284,1260,24,1500,1255,245,0.786962634301118,0.180327868852459,1.26282390269699,629,245,384,25,1.6,53.88,5.1,0,0,0,0,0,0,0.155312059098855,104.183326918636,17.7928732433994
9.7,"max_tuv_SVM","SVM",6,15,1184,1167,17,1600,1348,252,0.802736969728239,0.180327868852459,1.26282390269699,651,252,399,22,1.6,57.47,5.3,0,0,0,0,0,0,0.143432629231731,95.2481894942342,15.2219207130838
9.7,"max_tuv_SVM","SVM",6,16,1084,1073,11,1700,1442,258,0.797352026931161,0.213114754098361,1.25230037017451,652,258,394,1,1.5,61.06,5.6,0,0,0,0,0,0,0.129780590514726,82.6127777210565,14.0233423172145
9.7,"max_tuv_SVM","SVM",6,17,984,976,8,1800,1539,261,0.819201351717377,0.286885245901639,1.28387096774194,688,261,427,36,1.6,64.66,5.9,0,0,0,0,0,0,0.125562687991649,69.4822050074589,14.0178840306187
9.7,"max_tuv_SVM","SVM",6,18,884,879,5,1900,1636,264,0.804420167416903,0.221311475409836,1.27334743521946,697,264,433,9,1.6,68.25,6.2,0,0,0,0,0,0,0.106828727172284,50.3520700092151,12.1611426277935
9.7,"max_tuv_SVM","SVM",6,19,784,780,4,2000,1735,265,0.80903122621919,0.270491803278689,1.26282390269699,708,265,443,11,1.7,71.84,6.5,0,0,0,0,0,0,0.0862008035313489,35.8452583877454,10.287741932535
9.7,"max_tuv_SVM","SVM",6,20,684,682,2,2100,1833,267,0.819665682114254,0.278688524590164,1.27334743521946,729,267,462,21,1.7,75.43,6.9,0,0,0,0,0,0,0.054091987634236,17.7705807164368,6.74402601604157
9.7,"max_tuv_SVM","SVM",6,21,584,583,1,2200,1932,268,0.812146109298217,0.270491803278689,1.26282390269699,698,268,430,-31,1.6,79.02,7.2,0,0,0,0,0,0,0.0504541967848339,16.9365971365463,6.31075083123487
9.7,"max_tuv_SVM","SVM",6,22,484,484,0,2300,2031,269,0.814377474816527,0.254098360655738,1.26282390269699,725,269,456,27,1.7,82.61,7.6,0,0,0,0,0,0,0.00604825790860563,1.814071017923,1.27470090792488
9.7,"max_tuv_SVM","SVM",6,23,384,384,0,2400,2131,269,0.790387070978062,0.221311475409836,1.26282390269699,722,269,453,-3,1.7,86.21,7.9,0,0,0,0,0,0,0.00309263221367489,0.892958918810202,0.603222516252609
9.7,"max_tuv_SVM","SVM",6,24,284,284,0,2500,2231,269,0.836323535102089,0.270491803278689,1.26282390269699,739,269,470,17,1.7,89.8,8.3,0,0,0,0,0,0,0.00206052835783804,0.575148113109283,0.4021752355811
9.7,"max_tuv_SVM","SVM",6,25,184,184,0,2600,2331,269,0.825411770775564,0.278688524590164,1.26282390269699,725,269,456,-14,1.7,93.39,8.7,0,0,0,0,0,0,0.000641829388343702,0.177544112624587,0.147452061075471
9.7,"max_tuv_SVM","SVM",6,26,84,84,0,2700,2431,269,0.835601243373619,0.336065573770492,1.26282390269699,722,269,453,-3,1.7,96.98,9,0,0,0,0,0,0,1.67101623044313e-06,0.00703798733018088,0.00703798733018088
9.7,"max_tuv_SVM","SVM",6,27,0,0,0,2784,2515,269,0.829997033444688,0.270491803278689,1.26282390269699,699,269,430,-23,1.6,100,9.3,0,0,0,0,0,0,0,0,0
9.7,"max_tuv_SVM","SVM",7,0,2684,2441,243,100,90,10,0.816525203533693,0.347826086956522,1.21906201519551,23,10,13,0,1.3,3.59,9,0,0,0,0,0,0,0.482200116001966,311.201412339137,50.9779478307274
9.7,"max_tuv_SVM","SVM",7,1,2584,2375,209,200,156,44,0.855303423985221,0.326086956521739,1.28387096774194,106,44,62,83,1.4,7.18,3.5,0,0,0,0,0,0,0.349433205653011,313.351032832314,39.3189860506667
9.7,"max_tuv_SVM","SVM",7,2,2484,2301,183,300,230,70,0.811496044806281,0.210144927536232,1.27456755493221,178,70,108,72,1.5,10.78,3.3,0,0,0,0,0,0,0.293617323828299,409.26736959936,36.870562346824
9.7,"max_tuv_SVM","SVM",7,3,2384,2214,170,400,317,83,0.829025925284371,0.304347826086957,1.27456755493221,213,83,130,35,1.6,14.37,3.8,0,0,0,0,0,0,0.228913202428836,375.739414741271,26.928515222829
9.7,"max_tuv_SVM","SVM",7,4,2284,2124,160,500,407,93,0.8464807436919,0.369565217391304,1.28387096774194,233,93,140,20,1.5,17.96,4.4,0,0,0,0,0,0,0.201221019739163,250.665008114663,20.8461825115684
9.7,"max_tuv_SVM","SVM",7,5,2184,2054,130,600,477,123,0.853340262139848,0.376811594202899,1.28387096774194,306,123,183,73,1.5,21.55,3.9,0,0,0,0,0,0,0.222168328702465,226.673399046499,22.7870922935585
9.7,"max_tuv_SVM","SVM",7,6,2084,1985,99,700,546,154,0.854477741209077,0.384057971014493,1.28387096774194,369,154,215,63,1.4,25.14,3.5,0,0,0,0,0,0,0.211636162640029,179.503188399407,22.5771868495798
9.7,"max_tuv_SVM","SVM",7,7,1984,1903,81,800,628,172,0.841751833246725,0.384057971014493,1.27456755493221,428,172,256,59,1.5,28.74,3.7,0,0,0,0,0,0,0.199122399205363,191.400926885215,21.5550234437978
9.7,"max_tuv_SVM","SVM",7,8,1884,1812,72,900,719,181,0.840158207748717,0.369565217391304,1.27456755493221,469,181,288,41,1.6,32.33,4,0,0,0,0,0,0,0.172434489468349,135.524545844268,19.4915768510152
9.7,"max_tuv_SVM","SVM",7,9,1784,1717,67,1000,814,186,0.838044921762225,0.355072463768116,1.28387096774194,486,186,300,17,1.6,35.92,4.4,0,0,0,0,0,0,0.136938943307602,91.5655458685917,16.1422068609632
9.7,"max_tuv_SVM","SVM",7,10,1684,1625,59,1100,906,194,0.840279461862694,0.355072463768116,1.28387096774194,500,194,306,14,1.6,39.51,4.7,0,0,0,0,0,0,0.120270236274671,99.5333345190644,13.542899190257
9.7,"max_tuv_SVM","SVM",7,11,1584,1531,53,1200,1000,200,0.844482937813963,0.355072463768116,1.28387096774194,520,200,320,20,1.6,43.1,5,0,0,0,0,0,0,0.109586000989546,82.3545341080845,12.8445598944175
9.7,"max_tuv_SVM","SVM",7,12,1484,1448,36,1300,1083,217,0.86024019862579,0.340579710144928,1.28387096774194,562,217,345,42,1.6,46.7,5,0,0,0,0,0,0,0.150227965258336,117.720423947789,16.404802063403
9.7,"max_tuv_SVM","SVM",7,13,1384,1362,22,1400,1169,231,0.844430971765118,0.268115942028986,1.28387096774194,606,231,375,44,1.6,50.29,5.1,0,0,0,0,0,0,0.128855626623956,74.61589467824,14.5833038504308
9.7,"max_tuv_SVM","SVM",7,14,1284,1269,15,1500,1262,238,0.858993013453437,0.36231884057971,1.28387096774194,637,238,399,31,1.7,53.88,5.3,0,0,0,0,0,0,0.111586046751498,56.9648477209743,13.0320481352836
9.7,"max_tuv_SVM","SVM",7,15,1184,1170,14,1600,1361,239,0.85417171892142,0.326086956521739,1.28387096774194,635,239,396,-2,1.7,57.47,5.7,0,0,0,0,0,0,0.0821871031402874,40.1651780079471,10.4883519481438
9.7,"max_tuv_SVM","SVM",7,16,1084,1073,11,1700,1458,242,0.837606097349737,0.326086956521739,1.26526414212249,647,242,405,12,1.7,61.06,6,0,0,0,0,0,0,0.118568663184697,62.5645182171933,13.8513991052571
9.7,"max_tuv_SVM","SVM",7,17,984,973,11,1800,1558,242,0.848530515618691,0.36231884057971,1.26526414212249,674,242,432,27,1.8,64.66,6.4,0,0,0,0,0,0,0.0858299305944745,44.5639845611318,9.98318635403574
9.7,"max_tuv_SVM","SVM",7,18,884,875,9,1900,1656,244,0.851388648305333,0.355072463768116,1.26526414212249,645,244,401,-29,1.6,68.25,6.8,0,0,0,0,0,0,0.0943794901303644,59.5006994484948,10.3496986540356
9.7,"max_tuv_SVM","SVM",7,19,784,775,9,2000,1756,244,0.84217910964837,0.318840579710145,1.26526414212249,664,244,420,19,1.7,71.84,7.2,0,0,0,0,0,0,0.0425872628716011,17.6741852215839,5.4691022773379
9.7,"max_tuv_SVM","SVM",7,20,684,677,7,2100,1854,246,0.824972573474223,0.326086956521739,1.26526414212249,671,246,425,7,1.7,75.43,7.5,0,0,0,0,0,0,0.0838364427884951,38.2599556068555,10.4189005779062
9.7,"max_tuv_SVM","SVM",7,21,584,580,4,2200,1951,249,0.815913158958374,0.22463768115942,1.27456755493221,675,249,426,4,1.7,79.02,7.8,0,0,0,0,0,0,0.047223638462775,23.6945137843799,16.1198691458771
9.7,"max_tuv_SVM","SVM",7,22,484,483,1,2300,2048,252,0.848236041341883,0.318840579710145,1.27456755493221,709,252,457,34,1.8,82.61,8.1,0,0,0,0,0,0,0.0229640616627314,6.13848724918226,4.02462975634974
9.7,"max_tuv_SVM","SVM",7,23,384,383,1,2400,2148,252,0.828257982562507,0.282608695652174,1.27456755493221,699,252,447,-10,1.8,86.21,8.5,0,0,0,0,0,0,0.00730972690340406,1.84313404995544,1.34954014261547
9.7,"max_tuv_SVM","SVM",7,24,284,284,0,2500,2247,253,0.842075177550671,0.333333333333333,1.27456755493221,701,253,448,2,1.8,89.8,8.9,0,0,0,0,0,0,0.00108124165039201,0.478231596091884,0.420972238390692
9.7,"max_tuv_SVM","SVM",7,25,184,184,0,2600,2347,253,0.827692130030606,0.289855072463768,1.27456755493221,710,253,457,9,1.8,93.39,9.3,0,0,0,0,0,0,0.0022137133561383,0.618518221845315,0.522555257755767
9.7,"max_tuv_SVM","SVM",7,26,84,84,0,2700,2447,253,0.835169467059302,0.282608695652174,1.27456755493221,712,253,459,2,1.8,96.98,9.7,0,0,0,0,0,0,3.04058440985478e-06,0.0133621731758106,0.0133621731758106
9.7,"max_tuv_SVM","SVM",7,27,0,0,0,2784,2531,253,0.842207979675505,0.355072463768116,1.27456755493221,720,253,467,8,1.8,100,10,0,0,0,0,0,0,0,0,0
9.7,"max_tuv_SVM","SVM",8,0,2684,2452,232,100,89,11,0.726598285032022,0.297297297297297,1.17109851787271,30,11,19,0,1.7,3.59,8.1,0,0,0,0,0,0,0.269087920593453,241.128425181546,33.9629128268824
9.7,"max_tuv_SVM","SVM",8,1,2584,2392,192,200,149,51,0.666699229349833,0.189189189189189,1.1884481255449,111,51,60,81,1.2,7.18,2.9,0,0,0,0,0,0,0.282624049209733,546.252736986521,30.6516816136729
9.7,"max_tuv_SVM","SVM",8,2,2484,2308,176,300,233,67,0.585965483555842,0.155405405405405,1.06700087183958,157,67,90,46,1.3,10.78,3.5,0,0,0,0,0,0,0.223672051222007,507.899064418416,22.8527650494965
9.7,"max_tuv_SVM","SVM",8,3,2384,2223,161,400,318,82,0.626316075111254,0.189189189189189,1.10170008718396,190,82,108,33,1.3,14.37,3.9,0,0,0,0,0,0,0.207720132942671,311.53806442058,21.7254621823764
9.7,"max_tuv_SVM","SVM",8,4,2284,2132,152,500,409,91,0.664919136003473,0.243243243243243,1.12772449869224,215,91,124,25,1.4,17.96,4.5,0,0,0,0,0,0,0.16569108371015,190.833256153286,17.8563373513674
9.7,"max_tuv_SVM","SVM",8,5,2184,2049,135,600,492,108,0.72237056333442,0.283783783783784,1.1884481255449,249,108,141,34,1.3,21.55,4.6,0,0,0,0,0,0,0.165584146406334,198.543786560391,17.9880401486146
9.7,"max_tuv_SVM","SVM",8,6,2084,1966,118,700,575,125,0.752420492781942,0.256756756756757,1.19712292938099,288,125,163,39,1.3,25.14,4.6,0,0,0,0,0,0,0.168387173726998,218.616926538338,17.5545509851639
9.7,"max_tuv_SVM","SVM",8,7,1984,1893,91,800,648,152,0.779192445457512,0.27027027027027,1.20579773321709,360,152,208,72,1.4,28.74,4.3,0,0,0,0,0,0,0.188094014305847,173.454567798815,20.2129503182089
9.7,"max_tuv_SVM","SVM",8,8,1884,1804,80,900,737,163,0.778177575165532,0.277027027027027,1.20579773321709,392,163,229,32,1.4,32.33,4.5,0,0,0,0,0,0,0.175570347964512,154.483471105417,18.7324096122294
9.7,"max_tuv_SVM","SVM",8,9,1784,1715,69,1000,826,174,0.778204710734835,0.27027027027027,1.21447253705318,431,174,257,39,1.5,35.92,4.7,0,0,0,0,0,0,0.170175366923718,172.620168647653,17.908633335165
9.7,"max_tuv_SVM","SVM",8,10,1684,1632,52,1100,909,191,0.785770107456854,0.263513513513513,1.21447253705318,477,191,286,46,1.5,39.51,4.8,0,0,0,0,0,0,0.156484835252305,122.690882018207,17.0780862855855
9.7,"max_tuv_SVM","SVM",8,11,1584,1545,39,1200,996,204,0.791517421035492,0.27027027027027,1.21447253705318,515,204,311,38,1.5,43.1,4.9,0,0,0,0,0,0,0.15326051063527,115.868255644336,16.4720600617104
9.7,"max_tuv_SVM","SVM",8,12,1484,1456,28,1300,1085,215,0.802442201237378,0.304054054054054,1.21447253705318,564,215,349,49,1.6,46.7,5,0,0,0,0,0,0,0.152239685287237,117.590515548292,16.2647873591761
9.7,"max_tuv_SVM","SVM",8,13,1384,1358,26,1400,1183,217,0.801638988385975,0.263513513513513,1.21447253705318,549,217,332,-15,1.5,50.29,5.5,0,0,0,0,0,0,0.130026422695674,99.8850791641343,13.6762124657571
9.7,"max_tuv_SVM","SVM",8,14,1284,1263,21,1500,1278,222,0.785200260501466,0.236486486486486,1.22314734088928,590,222,368,41,1.7,53.88,5.8,0,0,0,0,0,0,0.153430844932831,82.8716244152268,16.1696575779407
9.7,"max_tuv_SVM","SVM",8,15,1184,1164,20,1600,1377,223,0.764555519374799,0.216216216216216,1.22314734088928,596,223,373,6,1.7,57.47,6.2,0,0,0,0,0,0,0.13522366072235,84.3096023619618,13.9958235400158
9.7,"max_tuv_SVM","SVM",8,16,1084,1065,19,1700,1476,224,0.785509605991536,0.243243243243243,1.22314734088928,612,224,388,16,1.7,61.06,6.6,0,0,0,0,0,0,0.118346080942691,63.0992511250088,12.485012278391
9.7,"max_tuv_SVM","SVM",8,17,984,965,19,1800,1576,224,0.764370997503531,0.216216216216216,1.22314734088928,594,224,370,-18,1.7,64.66,7,0,0,0,0,0,0,0.0950277435499743,38.6092727150196,10.3859402699287
9.7,"max_tuv_SVM","SVM",8,18,884,865,19,1900,1676,224,0.740225767936615,0.168918918918919,1.22314734088928,596,224,372,2,1.7,68.25,7.5,0,0,0,0,0,0,0.0557659911300825,16.2783846652711,6.68577200263808
9.7,"max_tuv_SVM","SVM",8,19,784,766,18,2000,1775,225,0.761890806469122,0.202702702702703,1.22314734088928,606,225,381,10,1.7,71.84,7.9,0,0,0,0,0,0,0.0307299961035342,8.28569025477181,4.41035901187798
9.7,"max_tuv_SVM","SVM",8,20,684,667,17,2100,1874,226,0.745191577119294,0.195945945945946,1.22314734088928,616,226,390,10,1.7,75.43,8.3,0,0,0,0,0,0,0.0222414542091488,6.43259444747459,3.31270602569192
9.7,"max_tuv_SVM","SVM",8,21,584,567,17,2200,1974,226,0.755766308477157,0.202702702702703,1.22314734088928,614,226,388,-2,1.7,79.02,8.7,0,0,0,0,0,0,7.76379959672972e-06,0.363837822229091,0.363517786727553
9.7,"max_tuv_SVM","SVM",8,22,484,468,16,2300,2073,227,0.767936611310104,0.236486486486486,1.22314734088928,598,227,371,-16,1.6,82.61,9.1,0,0,0,0,0,0,0.0101886432342833,2.88311148490024,1.76216204595277
9.7,"max_tuv_SVM","SVM",8,23,384,370,14,2400,2171,229,0.73979159882774,0.195945945945946,1.21447253705318,613,229,384,15,1.7,86.21,9.5,0,0,0,0,0,0,0.0119637105021787,3.69980748298864,2.8580111371272
9.7,"max_tuv_SVM","SVM",8,24,284,271,13,2500,2270,230,0.75676761098448,0.189189189189189,1.22314734088928,618,230,388,5,1.7,89.8,9.9,0,0,0,0,0,0,3.37541981404306e-06,0.171619656774892,0.171533302863701
9.7,"max_tuv_SVM","SVM",8,25,184,171,13,2600,2370,230,0.791501139693916,0.290540540540541,1.21447253705318,627,230,397,9,1.7,93.39,10.3,0,0,0,0,0,0,3.13901320990486e-06,0.241523555086236,0.241463727109784
9.7,"max_tuv_SVM","SVM",8,26,84,76,8,2700,2465,235,0.792803647020508,0.27027027027027,1.22314734088928,650,235,415,23,1.8,96.98,10.5,0,0,0,0,0,0,3.29775203895629e-08,0.621972819003683,0.621972819003683
9.7,"max_tuv_SVM","SVM",8,27,0,0,0,2784,2541,243,0.774465429284698,0.243243243243243,1.26652136006975,685,243,442,35,1.8,100,10.5,0,0,0,0,0,0,0,0,0
9.7,"max_tuv_SVM","SVM",9,0,2684,2439,245,100,95,5,0.380956427163347,0.0354609929078014,0.965179592770533,25,5,20,0,4,3.59,19,0,0,0,0,0,0,0.102036450108841,94.3547580401493,14.0076778099553
9.7,"max_tuv_SVM","SVM",9,1,2584,2345,239,200,189,11,0.353244737498017,0.0141843971631206,0.883230382063601,44,11,33,19,3,7.18,17.2,0,0,0,0,0,0,0.0600976503860434,148.086968091225,6.04949953850569
9.7,"max_tuv_SVM","SVM",9,2,2484,2246,238,300,288,12,0.643061881132034,0.134751773049645,1.18371082132235,54,12,42,10,3.5,10.78,24,0,0,0,0,0,0,0.0573117235113988,120.982148910909,6.12969464393344
9.7,"max_tuv_SVM","SVM",9,3,2384,2146,238,400,388,12,0.642795640450457,0.127659574468085,1.15639441775337,54,12,42,0,3.5,14.37,32.3,0,0,0,0,0,0,0.0518047249988481,96.1267759039506,5.86936652185136
9.7,"max_tuv_SVM","SVM",9,4,2284,2054,230,500,480,20,0.76390116239549,0.226950354609929,1.22923816060398,68,20,48,14,2.4,17.96,24,0,0,0,0,0,0,0.0785357493308216,106.357466537937,9.55944915183231
9.7,"max_tuv_SVM","SVM",9,5,2184,1974,210,600,560,40,0.755052908254594,0.198581560283688,1.25655456417296,115,40,75,47,1.9,21.55,14,0,0,0,0,0,0,0.0847847104301737,150.917545062117,8.96296020434315
9.7,"max_tuv_SVM","SVM",9,6,2084,1899,185,700,635,65,0.765158724763782,0.269503546099291,1.24744909631663,166,65,101,51,1.6,25.14,9.8,0,0,0,0,0,0,0.126111388191307,189.027002779665,13.3343902329538
9.7,"max_tuv_SVM","SVM",9,7,1984,1822,162,800,712,88,0.78296286225727,0.304964539007092,1.25655456417296,218,88,130,52,1.5,28.74,8.1,0,0,0,0,0,0,0.144695837269534,184.51729906541,15.295981497238
9.7,"max_tuv_SVM","SVM",9,8,1884,1744,140,900,790,110,0.808691908549163,0.290780141843972,1.25655456417296,271,110,161,53,1.5,32.33,7.2,0,0,0,0,0,0,0.15559417486164,156.541509743147,17.0318545423407
9.7,"max_tuv_SVM","SVM",9,9,1784,1682,102,1000,852,148,0.826127840844721,0.276595744680851,1.25655456417296,350,148,202,79,1.4,35.92,5.8,0,0,0,0,0,0,0.183277877104804,180.523907501962,19.7054999566189
9.7,"max_tuv_SVM","SVM",9,10,1684,1604,80,1100,930,170,0.828025513787871,0.290780141843972,1.25655456417296,396,170,226,46,1.3,39.51,5.5,0,0,0,0,0,0,0.17803629298419,194.622821979878,18.38804912908
9.7,"max_tuv_SVM","SVM",9,11,1584,1529,55,1200,1005,195,0.82274601771917,0.304964539007092,1.25655456417296,463,195,268,67,1.4,43.1,5.2,0,0,0,0,0,0,0.167368015681599,127.956709376614,18.4661197387973
9.7,"max_tuv_SVM","SVM",9,12,1484,1435,49,1300,1099,201,0.824003580087465,0.319148936170213,1.25655456417296,483,201,282,20,1.4,46.7,5.5,0,0,0,0,0,0,0.143625649235873,104.409623260108,15.8133704558207
9.7,"max_tuv_SVM","SVM",9,13,1384,1344,40,1400,1190,210,0.805723608184355,0.283687943262411,1.25655456417296,508,210,298,25,1.4,50.29,5.7,0,0,0,0,0,0,0.138968228603396,90.253825482865,16.2090656763382
9.7,"max_tuv_SVM","SVM",9,14,1284,1250,34,1500,1284,216,0.805004191874564,0.283687943262411,1.25655456417296,540,216,324,32,1.5,53.88,5.9,0,0,0,0,0,0,0.121043518162811,73.4343306329462,13.6716575492806
9.7,"max_tuv_SVM","SVM",9,15,1184,1156,28,1600,1378,222,0.797101941857569,0.283687943262411,1.25655456417296,560,222,338,20,1.5,57.47,6.2,0,0,0,0,0,0,0.134621341018617,64.5427309054809,15.0738057720687
9.7,"max_tuv_SVM","SVM",9,16,1084,1058,26,1700,1476,224,0.817568486166818,0.290780141843972,1.25655456417296,567,224,343,7,1.5,61.06,6.6,0,0,0,0,0,0,0.121069254564127,72.7901315503939,12.779146006548
9.7,"max_tuv_SVM","SVM",9,17,984,966,18,1800,1568,232,0.797147259420393,0.24822695035461,1.25655456417296,603,232,371,36,1.6,64.66,6.8,0,0,0,0,0,0,0.114968171091458,40.6021847117255,13.5438626975363
9.7,"max_tuv_SVM","SVM",9,18,884,875,9,1900,1659,241,0.801814968391004,0.269503546099291,1.25655456417296,632,241,391,29,1.6,68.25,6.9,0,0,0,0,0,0,0.0760576131456081,25.420965578612,10.0320802533516
9.7,"max_tuv_SVM","SVM",9,19,784,775,9,2000,1759,241,0.818474837423246,0.304964539007092,1.25655456417296,618,241,377,-14,1.6,71.84,7.3,0,0,0,0,0,0,0.0592638911160987,21.5039725058135,7.19519256472814
9.7,"max_tuv_SVM","SVM",9,20,684,678,6,2100,1856,244,0.799736025196565,0.297872340425532,1.25655456417296,648,244,404,30,1.7,75.43,7.6,0,0,0,0,0,0,0.0346386645199996,8.83721954939788,5.25317658136859
9.7,"max_tuv_SVM","SVM",9,21,584,581,3,2200,1953,247,0.821482790655521,0.326241134751773,1.26566003202928,650,247,403,2,1.6,79.02,7.9,0,0,0,0,0,0,0.0147391442290218,3.88221564133092,2.6713837836955
9.7,"max_tuv_SVM","SVM",9,22,484,483,1,2300,2051,249,0.801820633086356,0.26241134751773,1.26566003202928,659,249,410,9,1.6,82.61,8.2,0,0,0,0,0,0,0.00512564700309458,1.40222520496595,1.04392286182195
9.7,"max_tuv_SVM","SVM",9,23,384,384,0,2400,2150,250,0.805933201912405,0.269503546099291,1.26566003202928,657,250,407,-2,1.6,86.21,8.6,0,0,0,0,0,0,0.00154562358547548,0.594651929317951,0.467510680917298
9.7,"max_tuv_SVM","SVM",9,24,284,284,0,2500,2250,250,0.811994425939778,0.226950354609929,1.25655456417296,679,250,429,22,1.7,89.8,9,0,0,0,0,0,0,0.000534802640394952,0.149100728280214,0.118398489769582
9.7,"max_tuv_SVM","SVM",9,25,184,184,0,2600,2350,250,0.793266943103805,0.24113475177305,1.26566003202928,660,250,410,-19,1.6,93.39,9.4,0,0,0,0,0,0,0.000127218208509313,0.0778643497384428,0.0726661485502317
9.7,"max_tuv_SVM","SVM",9,26,84,84,0,2700,2450,250,0.783546325878599,0.24113475177305,1.25655456417296,666,250,416,6,1.7,96.98,9.8,0,0,0,0,0,0,1.0000000994736e-07,0.000462065151518524,0.000462065151518524
9.7,"max_tuv_SVM","SVM",9,27,0,0,0,2784,2534,250,0.800795323227521,0.26241134751773,1.25655456417296,668,250,418,2,1.7,100,10.1,0,0,0,0,0,0,0,0,0
9.7,"max_tuv_SVM","SVM",10,0,2684,2445,239,100,89,11,0.729595767339634,0.163120567375887,1.25655456417296,28,11,17,0,1.5,3.59,8.1,0,0,0,0,0,0,0.127218838944274,294.964904199328,13.0446125902909
9.7,"max_tuv_SVM","SVM",10,1,2584,2362,222,200,172,28,0.713519361928718,0.219858156028369,1.22923816060398,70,28,42,42,1.5,7.18,6.1,0,0,0,0,0,0,0.311780522835497,264.660236311861,47.2593238527751
9.7,"max_tuv_SVM","SVM",10,2,2484,2280,204,300,254,46,0.7640314503886,0.212765957446809,1.26566003202928,125,46,79,55,1.7,10.78,5.5,0,0,0,0,0,0,0.187377226354561,242.511702734359,21.3268389372929
9.7,"max_tuv_SVM","SVM",10,3,2384,2214,170,400,320,80,0.705248906713796,0.0780141843971631,1.20879902392557,193,80,113,68,1.4,14.37,4,0,0,0,0,0,0,0.417734525071786,324.803589301073,63.7907118744349
9.7,"max_tuv_SVM","SVM",10,4,2284,2117,167,500,417,83,0.808176421272066,0.25531914893617,1.24744909631663,206,83,123,13,1.5,17.96,5,0,0,0,0,0,0,0.207288937913359,211.106148320911,22.4800523082211
9.7,"max_tuv_SVM","SVM",10,5,2184,2040,144,600,494,106,0.81103709242517,0.290780141843972,1.24744909631663,264,106,158,58,1.5,21.55,4.7,0,0,0,0,0,0,0.1961345932765,199.228004677443,20.0192003436187
9.7,"max_tuv_SVM","SVM",10,6,2084,1961,123,700,573,127,0.81432828042508,0.340425531914894,1.23834362846031,316,127,189,52,1.5,25.14,4.5,0,0,0,0,0,0,0.196196018295372,190.972357018644,20.0916913412887
9.7,"max_tuv_SVM","SVM",10,7,1984,1890,94,800,644,156,0.819301882944736,0.333333333333333,1.23834362846031,389,156,233,73,1.5,28.74,4.1,0,0,0,0,0,0,0.205339679218079,163.70097422783,21.1671421326799
9.7,"max_tuv_SVM","SVM",10,8,1884,1813,71,900,721,179,0.815013708562755,0.290780141843972,1.23834362846031,448,179,269,59,1.5,32.33,4,0,0,0,0,0,0,0.208217070862355,160.202090953357,21.4726796260433
9.7,"max_tuv_SVM","SVM",10,9,1784,1728,56,1000,806,194,0.81453787415313,0.290780141843972,1.23834362846031,506,194,312,58,1.6,35.92,4.2,0,0,0,0,0,0,0.196896328436182,117.003189438614,20.3437749655992
9.7,"max_tuv_SVM","SVM",10,10,1684,1645,39,1100,889,211,0.803571023950333,0.26241134751773,1.23834362846031,547,211,336,41,1.6,39.51,4.2,0,0,0,0,0,0,0.188208759327772,111.771139742535,20.1118821066415
9.7,"max_tuv_SVM","SVM",10,11,1584,1555,29,1200,979,221,0.810770851743595,0.304964539007092,1.23834362846031,587,221,366,40,1.7,43.1,4.4,0,0,0,0,0,0,0.159070315668007,76.3935529258919,17.3158100112183
9.7,"max_tuv_SVM","SVM",10,12,1484,1463,21,1300,1071,229,0.815217637595451,0.319148936170213,1.22923816060398,590,229,361,3,1.6,46.7,4.7,0,0,0,0,0,0,0.144984266315419,69.9481903038568,15.7356083087961
9.7,"max_tuv_SVM","SVM",10,13,1384,1364,20,1400,1170,230,0.826903904108038,0.340425531914894,1.23834362846031,600,230,370,10,1.6,50.29,5.1,0,0,0,0,0,0,0.101036514927388,38.8577518553049,11.636194480495
9.7,"max_tuv_SVM","SVM",10,14,1284,1266,18,1500,1268,232,0.813438923254708,0.333333333333333,1.23834362846031,607,232,375,7,1.6,53.88,5.5,0,0,0,0,0,0,0.0724541361794458,27.0301194621288,8.91433289996121
9.7,"max_tuv_SVM","SVM",10,15,1184,1169,15,1600,1365,235,0.809858835791817,0.276595744680851,1.22013269274766,621,235,386,14,1.6,57.47,5.8,0,0,0,0,0,0,0.0671017013500911,25.7019059742355,8.94811787846553
9.7,"max_tuv_SVM","SVM",10,16,1084,1071,13,1700,1463,237,0.819171594951626,0.319148936170213,1.23834362846031,622,237,385,1,1.6,61.06,6.2,0,0,0,0,0,0,0.0589994745255805,21.3395353561183,6.8966822845053
9.7,"max_tuv_SVM","SVM",10,17,984,972,12,1800,1562,238,0.81394874583645,0.297872340425532,1.22923816060398,640,238,402,18,1.7,64.66,6.6,0,0,0,0,0,0,0.0732084733533961,38.4936099776569,8.40422564800055
9.7,"max_tuv_SVM","SVM",10,18,884,873,11,1900,1661,239,0.773604785534634,0.269503546099291,1.21102722489133,632,239,393,-8,1.6,68.25,6.9,0,0,0,0,0,0,0.114593109105068,45.6022215116209,13.8925383521621
9.7,"max_tuv_SVM","SVM",10,19,784,773,11,2000,1761,239,0.80647701266626,0.312056737588652,1.22013269274766,638,239,399,6,1.7,71.84,7.4,0,0,0,0,0,0,0.0357257878323995,12.668533671181,5.99034598398895
9.7,"max_tuv_SVM","SVM",10,20,684,674,10,2100,1860,240,0.80865225568169,0.326241134751773,1.22923816060398,634,240,394,-4,1.6,75.43,7.8,0,0,0,0,0,0,0.00901121051377742,2.61803311377777,1.47018609626804
9.7,"max_tuv_SVM","SVM",10,21,584,576,8,2200,1958,242,0.792349262456664,0.26241134751773,1.23834362846031,652,242,410,18,1.7,79.02,8.1,0,0,0,0,0,0,0.00999455124803048,3.06110627441645,1.63425756941874
9.7,"max_tuv_SVM","SVM",10,22,484,478,6,2300,2056,244,0.791760134139987,0.226950354609929,1.25655456417296,649,244,405,-3,1.7,82.61,8.4,0,0,0,0,0,0,0.00665597231297703,1.78870909795047,1.16884887273632
9.7,"max_tuv_SVM","SVM",10,23,384,384,0,2400,2150,250,0.814809779530058,0.312056737588652,1.26566003202928,693,250,443,44,1.8,86.21,8.6,0,0,0,0,0,0,0.00207209853297148,0.973532426852304,0.824549729954597
9.7,"max_tuv_SVM","SVM",10,24,284,284,0,2500,2250,250,0.801922597602701,0.276595744680851,1.26566003202928,693,250,443,0,1.8,89.8,9,0,0,0,0,0,0,2.71729809273159e-05,0.0177604736198633,0.016774960033735
9.7,"max_tuv_SVM","SVM",10,25,184,184,0,2600,2350,250,0.812589218951809,0.24113475177305,1.26566003202928,690,250,440,-3,1.8,93.39,9.4,0,0,0,0,0,0,4.22169706671802e-06,0.00601410612130515,0.00589679145917078
9.7,"max_tuv_SVM","SVM",10,26,84,84,0,2700,2450,250,0.829690934221558,0.347517730496454,1.26566003202928,677,250,427,-13,1.7,96.98,9.8,0,0,0,0,0,0,2.46553895248551e-07,0.00338267829948626,0.00338267829948626
9.7,"max_tuv_SVM","SVM",10,27,0,0,0,2784,2534,250,0.836182675095737,0.404255319148936,1.26566003202928,675,250,425,-2,1.7,100,10.1,0,0,0,0,0,0,0,0,0
9.7,"max_tuv_SVM","SVM",11,0,2684,2444,240,100,88,12,0.753995846385101,0.402877697841727,1.13608725922488,33,12,21,0,1.8,3.59,7.3,0,0,0,0,0,0,0.176985676770523,327.884472399507,18.997685921107
9.7,"max_tuv_SVM","SVM",11,1,2584,2379,205,200,153,47,0.639180521611422,0.151079136690647,1.08066836853098,111,47,64,78,1.4,7.18,3.3,0,0,0,0,0,0,0.282870319924219,569.369262626671,31.5053043418827
9.7,"max_tuv_SVM","SVM",11,2,2484,2293,191,300,239,61,0.710715638015911,0.20863309352518,1.15456022278951,152,61,91,41,1.5,10.78,3.9,0,0,0,0,0,0,0.210247630609496,474.239040657828,21.795590900704
9.7,"max_tuv_SVM","SVM",11,3,2384,2196,188,400,336,64,0.712086789898227,0.273381294964029,1.15456022278951,159,64,95,7,1.5,14.37,5.2,0,0,0,0,0,0,0.177194751071086,294.932205591871,18.8640535138696
9.7,"max_tuv_SVM","SVM",11,4,2284,2117,167,500,415,85,0.775062246853242,0.366906474820144,1.18226966813646,205,85,120,46,1.4,17.96,4.9,0,0,0,0,0,0,0.187693007291356,268.408171473698,19.9103933907445
9.7,"max_tuv_SVM","SVM",11,5,2184,2044,140,600,488,112,0.757564283501441,0.330935251798561,1.17303318635414,271,112,159,66,1.4,21.55,4.4,0,0,0,0,0,0,0.198982007352094,232.646602197386,20.4969222986595
9.7,"max_tuv_SVM","SVM",11,6,2084,1964,120,700,568,132,0.753318875999687,0.323741007194245,1.14532374100719,318,132,186,47,1.4,25.14,4.3,0,0,0,0,0,0,0.196469325927557,234.093397199257,20.3545584087919
9.7,"max_tuv_SVM","SVM",11,7,1984,1895,89,800,637,163,0.743118423921158,0.23021582733813,1.15456022278951,406,163,243,88,1.5,28.74,3.9,0,0,0,0,0,0,0.213143450526544,214.892736513956,22.0352937000473
9.7,"max_tuv_SVM","SVM",11,8,1884,1812,72,900,720,180,0.750938005576408,0.258992805755396,1.17303318635414,447,180,267,41,1.5,32.33,4,0,0,0,0,0,0,0.197852924622656,206.246417931103,20.519994426824
9.7,"max_tuv_SVM","SVM",11,9,1784,1721,63,1000,811,189,0.751368283363749,0.266187050359712,1.18226966813646,460,189,271,13,1.4,35.92,4.3,0,0,0,0,0,0,0.17041783428562,130.554358830365,18.385598692384
9.7,"max_tuv_SVM","SVM",11,10,1684,1630,54,1100,902,198,0.760461487269527,0.280575539568345,1.19150614991877,493,198,295,33,1.5,39.51,4.6,0,0,0,0,0,0,0.165366363179026,156.827570923612,17.7692094408655
9.7,"max_tuv_SVM","SVM",11,11,1584,1534,50,1200,998,202,0.767311509643977,0.294964028776978,1.19150614991877,505,202,303,12,1.5,43.1,4.9,0,0,0,0,0,0,0.135622171580732,114.367000532838,14.3470572506337
9.7,"max_tuv_SVM","SVM",11,12,1484,1441,43,1300,1091,209,0.748522712930151,0.18705035971223,1.19150614991877,538,209,329,33,1.6,46.7,5.2,0,0,0,0,0,0,0.160897576618937,104.864387953121,17.3369697211174
9.7,"max_tuv_SVM","SVM",11,13,1384,1346,38,1400,1186,214,0.772578109761006,0.258992805755396,1.19150614991877,554,214,340,16,1.6,50.29,5.5,0,0,0,0,0,0,0.137945842569572,60.5668575679798,14.9194569794828
9.7,"max_tuv_SVM","SVM",11,14,1284,1253,31,1500,1279,221,0.778785583973026,0.266187050359712,1.19150614991877,565,221,344,11,1.6,53.88,5.8,0,0,0,0,0,0,0.116710199543201,46.5327086220247,13.3977681769616
9.7,"max_tuv_SVM","SVM",11,15,1184,1165,19,1600,1367,233,0.773943524606167,0.287769784172662,1.19150614991877,611,233,378,46,1.6,57.47,5.9,0,0,0,0,0,0,0.12487110946511,56.7993438456862,13.5732856119316
9.7,"max_tuv_SVM","SVM",11,16,1084,1066,18,1700,1466,234,0.787643569355057,0.294964028776978,1.19150614991877,627,234,393,16,1.7,61.06,6.3,0,0,0,0,0,0,0.0845167874145568,27.2590709258543,9.95127933056247
9.7,"max_tuv_SVM","SVM",11,17,984,967,17,1800,1565,235,0.782181909974425,0.287769784172662,1.19150614991877,611,235,376,-16,1.6,64.66,6.7,0,0,0,0,0,0,0.0613156946464497,18.9139682871733,7.85753359500924
9.7,"max_tuv_SVM","SVM",11,18,884,867,17,1900,1665,235,0.781086135876001,0.309352517985612,1.19150614991877,619,235,384,8,1.6,68.25,7.1,0,0,0,0,0,0,0.0122886696042747,3.9704053337159,2.56013919075938
9.7,"max_tuv_SVM","SVM",11,19,784,769,15,2000,1763,237,0.771006161577928,0.251798561151079,1.19150614991877,628,237,391,9,1.6,71.84,7.4,0,0,0,0,0,0,0.0230695010178827,7.08099235050643,3.34389275622998
9.7,"max_tuv_SVM","SVM",11,20,684,670,14,2100,1862,238,0.788581574931458,0.302158273381295,1.19150614991877,624,238,386,-4,1.6,75.43,7.8,0,0,0,0,0,0,0.0123630532731259,3.91654487926007,2.69069344688776
9.7,"max_tuv_SVM","SVM",11,21,584,570,14,2200,1962,238,0.793529769485862,0.338129496402878,1.19150614991877,626,238,388,2,1.6,79.02,8.2,0,0,0,0,0,0,0.00841018480105858,2.24254508980489,1.32217551785691
9.7,"max_tuv_SVM","SVM",11,22,484,471,13,2300,2061,239,0.80605085309744,0.345323741007194,1.19150614991877,629,239,390,3,1.6,82.61,8.6,0,0,0,0,0,0,0.00220712932906572,0.707794651542519,0.519711631501806
9.7,"max_tuv_SVM","SVM",11,23,384,373,11,2400,2159,241,0.799668399251893,0.323741007194245,1.18226966813646,660,241,419,31,1.7,86.21,9,0,0,0,0,0,0,0.0212540467941864,6.66497541052693,5.44166672975191
9.7,"max_tuv_SVM","SVM",11,24,284,273,11,2500,2259,241,0.762784987321152,0.258992805755396,1.18226966813646,645,241,404,-15,1.7,89.8,9.4,0,0,0,0,0,0,0.0135924356324889,3.40606792255297,2.4884703700972
9.7,"max_tuv_SVM","SVM",11,25,184,175,9,2600,2357,243,0.796340917696468,0.338129496402878,1.19150614991877,669,243,426,24,1.8,93.39,9.7,0,0,0,0,0,0,0.00237117593464327,0.72886408282945,0.6704326587169
9.7,"max_tuv_SVM","SVM",11,26,84,79,5,2700,2453,247,0.801045288171384,0.316546762589928,1.20997911348341,658,247,411,-11,1.7,96.98,9.9,0,0,0,0,0,0,2.27151700424701e-05,0.414779919321561,0.414779919321561
9.7,"max_tuv_SVM","SVM",11,27,0,0,0,2784,2532,252,0.810092595779839,0.287769784172662,1.23768855883036,701,252,449,43,1.8,100,10,0,0,0,0,0,0,0,0,0
9.7,"max_tuv_SVM","SVM",12,0,2684,2440,244,100,85,15,0.774727849470121,0.356060606060606,1.19633431085044,40,15,25,0,1.7,3.59,5.7,0,0,0,0,0,0,0.249820912546197,383.905119266374,28.1817993338521
9.7,"max_tuv_SVM","SVM",12,1,2584,2365,219,200,160,40,0.723902386273517,0.166666666666667,1.14770283479961,101,40,61,61,1.5,7.18,4,0,0,0,0,0,0,0.206905287553472,478.419762131722,21.7595150104402
9.7,"max_tuv_SVM","SVM",12,2,2484,2276,208,300,249,51,0.730835315886867,0.181818181818182,1.16715542521994,132,51,81,31,1.6,10.78,4.9,0,0,0,0,0,0,0.18696625857371,396.827225028032,20.2350028350837
9.7,"max_tuv_SVM","SVM",12,3,2384,2193,191,400,332,68,0.767590656765912,0.272727272727273,1.21578690127077,176,68,108,44,1.6,14.37,4.9,0,0,0,0,0,0,0.190535171908394,248.508796443169,19.8457414700518
9.7,"max_tuv_SVM","SVM",12,4,2284,2120,164,500,405,95,0.766371085958716,0.28030303030303,1.20606060606061,239,95,144,63,1.5,17.96,4.3,0,0,0,0,0,0,0.207247944590548,279.248972616653,20.9197120418497
9.7,"max_tuv_SVM","SVM",12,5,2184,2057,127,600,468,132,0.759456179559273,0.272727272727273,1.19633431085044,323,132,191,84,1.4,21.55,3.5,0,0,0,0,0,0,0.230446575341308,225.893431584248,23.5615323696182
9.7,"max_tuv_SVM","SVM",12,6,2084,1984,100,700,541,159,0.762351909259126,0.303030303030303,1.19633431085044,379,159,220,56,1.4,25.14,3.4,0,0,0,0,0,0,0.227776774898673,261.620715493179,23.302895397441
9.7,"max_tuv_SVM","SVM",12,7,1984,1919,65,800,606,194,0.761144353927857,0.303030303030303,1.17688172043011,478,194,284,99,1.5,28.74,3.1,0,0,0,0,0,0,0.23912212851564,200.971486738696,24.8881731357583
9.7,"max_tuv_SVM","SVM",12,8,1884,1830,54,900,695,205,0.755851536779375,0.340909090909091,1.18660801564027,507,205,302,29,1.5,32.33,3.4,0,0,0,0,0,0,0.217036611551655,207.731586274362,22.9839351147721
9.7,"max_tuv_SVM","SVM",12,9,1784,1735,49,1000,790,210,0.751820344603854,0.25,1.19633431085044,528,210,318,21,1.5,35.92,3.8,0,0,0,0,0,0,0.179050039835418,142.756649838829,19.2361864560565
9.7,"max_tuv_SVM","SVM",12,10,1684,1636,48,1100,889,211,0.768053252589334,0.303030303030303,1.21578690127077,524,211,313,-4,1.5,39.51,4.2,0,0,0,0,0,0,0.14853796145131,93.0398680930053,16.5032998366345
9.7,"max_tuv_SVM","SVM",12,11,1584,1539,45,1200,986,214,0.7585550188643,0.242424242424242,1.22551319648094,519,214,305,-5,1.4,43.1,4.6,0,0,0,0,0,0,0.143039965971018,99.390884670706,16.027866391867
9.7,"max_tuv_SVM","SVM",12,12,1484,1446,38,1300,1079,221,0.768738134717518,0.25,1.22551319648094,541,221,320,22,1.4,46.7,4.9,0,0,0,0,0,0,0.0956375317727579,50.0716522108515,10.9206067474351
9.7,"max_tuv_SVM","SVM",12,13,1384,1348,36,1400,1177,223,0.787764640857429,0.287878787878788,1.21578690127077,548,223,325,7,1.5,50.29,5.3,0,0,0,0,0,0,0.147005914581829,74.3109108031181,15.3219595992794
9.7,"max_tuv_SVM","SVM",12,14,1284,1260,24,1500,1265,235,0.804147742292078,0.272727272727273,1.22551319648094,592,235,357,44,1.5,53.88,5.4,0,0,0,0,0,0,0.150615222903595,50.7908788865089,16.4132865181837
9.7,"max_tuv_SVM","SVM",12,15,1184,1168,16,1600,1357,243,0.798530507293398,0.242424242424242,1.22551319648094,624,243,381,32,1.6,57.47,5.6,0,0,0,0,0,0,0.131103683033827,34.6714397999977,14.4043086802862
9.7,"max_tuv_SVM","SVM",12,16,1084,1068,16,1700,1457,243,0.801594453656314,0.287878787878788,1.21578690127077,630,243,387,6,1.6,61.06,6,0,0,0,0,0,0,0.091090019118282,22.3051020410559,10.8601172453924
9.7,"max_tuv_SVM","SVM",12,17,984,968,16,1800,1557,243,0.794577415711441,0.272727272727273,1.21578690127077,624,243,381,-6,1.6,64.66,6.4,0,0,0,0,0,0,0.0285766029724315,6.80125291633823,5.08493189508722
9.7,"max_tuv_SVM","SVM",12,18,884,868,16,1900,1657,243,0.776992766683493,0.212121212121212,1.22551319648094,634,243,391,10,1.6,68.25,6.8,0,0,0,0,0,0,0.0131551581713618,3.21448921613208,2.84098620847705
9.7,"max_tuv_SVM","SVM",12,19,784,769,15,2000,1756,244,0.785325499243031,0.21969696969697,1.21578690127077,610,244,366,-24,1.5,71.84,7.2,0,0,0,0,0,0,0.0014208216126586,0.71556503233426,0.578588302687147
9.7,"max_tuv_SVM","SVM",12,20,684,671,13,2100,1854,246,0.775304592314904,0.234848484848485,1.21578690127077,638,246,392,28,1.6,75.43,7.5,0,0,0,0,0,0,0.000631943457139995,0.261379172145556,0.200996363206514
9.7,"max_tuv_SVM","SVM",12,21,584,573,11,2200,1952,248,0.776500132170238,0.21969696969697,1.20606060606061,662,248,414,24,1.7,79.02,7.9,0,0,0,0,0,0,0.00268551433953166,1.85876440949557,1.74616237160897
9.7,"max_tuv_SVM","SVM",12,22,484,473,11,2300,2052,248,0.785343522456926,0.21969696969697,1.20606060606061,642,248,394,-20,1.6,82.61,8.3,0,0,0,0,0,0,0.00180140802510237,0.560691938855676,0.391373009467378
9.7,"max_tuv_SVM","SVM",12,23,384,377,7,2400,2148,252,0.782874342152693,0.265151515151515,1.18660801564027,650,252,398,8,1.6,86.21,8.5,0,0,0,0,0,0,0.00247250782155987,1.51265007025477,1.37056541228127
9.7,"max_tuv_SVM","SVM",12,24,284,277,7,2500,2248,252,0.769765457909786,0.242424242424242,1.18660801564027,651,252,399,1,1.6,89.8,8.9,0,0,0,0,0,0,0.000582193881571022,0.202542782554493,0.173292974027061
9.7,"max_tuv_SVM","SVM",12,25,184,178,6,2600,2347,253,0.776548194073966,0.212121212121212,1.19633431085044,663,253,410,12,1.6,93.39,9.3,0,0,0,0,0,0,0.000356108012705171,0.10168918304558,0.0910772433408855
9.7,"max_tuv_SVM","SVM",12,26,84,82,2,2700,2443,257,0.78618460577223,0.227272727272727,1.22551319648094,677,257,420,14,1.6,96.98,9.5,0,0,0,0,0,0,2.95478533691955e-05,0.952886669376451,0.952886669376451
9.7,"max_tuv_SVM","SVM",12,27,0,0,0,2784,2525,259,0.764785043135552,0.189393939393939,1.2352394916911,695,259,436,18,1.7,100,9.7,0,0,0,0,0,0,0,0,0
9.7,"max_tuv_SVM","SVM",13,0,2684,2445,239,100,91,9,0.8194965034965,0.370629370629371,1.24795849311978,22,9,13,0,1.4,3.59,10.1,0,0,0,0,0,0,0.104841394030106,227.475756392162,10.797660394731
9.7,"max_tuv_SVM","SVM",13,1,2584,2378,206,200,158,42,0.661918881118877,0.111888111888112,1.20306789984209,103,42,61,81,1.5,7.18,3.8,0,0,0,0,0,0,0.273144245808971,546.395343885253,34.7496762341595
9.7,"max_tuv_SVM","SVM",13,2,2484,2285,199,300,251,49,0.810450349650347,0.293706293706294,1.28387096774194,108,49,59,5,1.2,10.78,5.1,0,0,0,0,0,0,0.197377897602697,188.193359897987,25.4775483304796
9.7,"max_tuv_SVM","SVM",13,3,2384,2207,177,400,329,71,0.816397202797198,0.300699300699301,1.26591473043086,172,71,101,64,1.4,14.37,4.6,0,0,0,0,0,0,0.202901487216178,195.323033616569,20.6534300126727
9.7,"max_tuv_SVM","SVM",13,4,2284,2137,147,500,399,101,0.800632167832168,0.314685314685315,1.25693661177532,238,101,137,66,1.4,17.96,4,0,0,0,0,0,0,0.218523086736346,183.811804381945,22.2749347834049
9.7,"max_tuv_SVM","SVM",13,5,2184,2069,115,600,467,133,0.793980419580421,0.300699300699301,1.25693661177532,309,133,176,71,1.3,21.55,3.5,0,0,0,0,0,0,0.22650236955423,145.036342962928,23.4991971648004
9.7,"max_tuv_SVM","SVM",13,6,2084,1989,95,700,547,153,0.797650349650345,0.307692307692308,1.25693661177532,355,153,202,46,1.3,25.14,3.6,0,0,0,0,0,0,0.200575045317189,118.759954346631,21.3369336539288
9.7,"max_tuv_SVM","SVM",13,7,1984,1904,80,800,632,168,0.814942657342657,0.258741258741259,1.25693661177532,400,168,232,45,1.4,28.74,3.8,0,0,0,0,0,0,0.203228507206819,127.406913495085,21.4118245603814
9.7,"max_tuv_SVM","SVM",13,8,1884,1827,57,900,709,191,0.824352447552443,0.27972027972028,1.25693661177532,458,191,267,58,1.4,32.33,3.7,0,0,0,0,0,0,0.209906703635301,119.68805904496,23.3708578644827
9.7,"max_tuv_SVM","SVM",13,9,1784,1737,47,1000,799,201,0.799787412587414,0.293706293706294,1.23000225580871,493,201,292,35,1.5,35.92,4,0,0,0,0,0,0,0.192267950726927,116.199482659483,23.6866651003453
9.7,"max_tuv_SVM","SVM",13,10,1684,1644,40,1100,892,208,0.812889510489509,0.307692307692308,1.25693661177532,516,208,308,23,1.5,39.51,4.3,0,0,0,0,0,0,0.178276761461863,126.194726060375,18.7764406019116
9.7,"max_tuv_SVM","SVM",13,11,1584,1549,35,1200,987,213,0.802360839160838,0.27972027972028,1.23000225580871,534,213,321,18,1.5,43.1,4.6,0,0,0,0,0,0,0.139348693547957,74.0744301871723,15.4987260831626
9.7,"max_tuv_SVM","SVM",13,12,1484,1454,30,1300,1082,218,0.806405594405596,0.258741258741259,1.22102413715317,553,218,335,19,1.5,46.7,5,0,0,0,0,0,0,0.126777330608762,45.2239617807053,14.9110804408334
9.7,"max_tuv_SVM","SVM",13,13,1384,1364,20,1400,1172,228,0.78953286713287,0.251748251748252,1.22102413715317,590,228,362,37,1.6,50.29,5.1,0,0,0,0,0,0,0.127400163234519,41.1075731081305,15.1080117823221
9.7,"max_tuv_SVM","SVM",13,14,1284,1265,19,1500,1271,229,0.776106293706294,0.202797202797203,1.21204601849763,613,229,384,23,1.7,53.88,5.6,0,0,0,0,0,0,0.133972039714006,65.9798841904963,14.2746356795634
9.7,"max_tuv_SVM","SVM",13,15,1184,1167,17,1600,1369,231,0.77107132867133,0.244755244755245,1.21204601849763,603,231,372,-10,1.6,57.47,5.9,0,0,0,0,0,0,0.13480028491304,71.3199963288927,14.0059944071295
9.7,"max_tuv_SVM","SVM",13,16,1084,1069,15,1700,1467,233,0.784167832167831,0.27972027972028,1.20306789984209,628,233,395,25,1.7,61.06,6.3,0,0,0,0,0,0,0.128986290200206,75.9803146967869,13.3485955771387
9.7,"max_tuv_SVM","SVM",13,17,984,969,15,1800,1567,233,0.760441958041959,0.202797202797203,1.21204601849763,627,233,394,-1,1.7,64.66,6.7,0,0,0,0,0,0,0.101265852457675,32.289602945068,11.1516345851318
9.7,"max_tuv_SVM","SVM",13,18,884,869,15,1900,1667,233,0.791686713286711,0.272727272727273,1.21204601849763,629,233,396,2,1.7,68.25,7.2,0,0,0,0,0,0,0.0545354043939376,10.9734508095221,7.0911106685876
9.7,"max_tuv_SVM","SVM",13,19,784,769,15,2000,1767,233,0.765023776223775,0.237762237762238,1.21204601849763,622,233,389,-7,1.7,71.84,7.6,0,0,0,0,0,0,0.00953708699385072,3.66535759644577,2.90794978248159
9.7,"max_tuv_SVM","SVM",13,20,684,672,12,2100,1864,236,0.749365034965029,0.181818181818182,1.21204601849763,627,236,391,5,1.7,75.43,7.9,0,0,0,0,0,0,0.0257810163154176,8.09098944030391,4.11826107045943
9.7,"max_tuv_SVM","SVM",13,21,584,572,12,2200,1964,236,0.754030769230763,0.223776223776224,1.21204601849763,635,236,399,8,1.7,79.02,8.3,0,0,0,0,0,0,0.0181986694951538,5.87507287651225,2.38144526169147
9.7,"max_tuv_SVM","SVM",13,22,484,475,9,2300,2061,239,0.761890909090907,0.20979020979021,1.21204601849763,629,239,390,-6,1.6,82.61,8.6,0,0,0,0,0,0,0.0212969009524985,6.60560221737528,4.74234755733846
9.7,"max_tuv_SVM","SVM",13,23,384,375,9,2400,2161,239,0.772648951048946,0.27972027972028,1.21204601849763,638,239,399,9,1.7,86.21,9,0,0,0,0,0,0,0.0172637533604055,4.62833489490558,2.60837469442579
9.7,"max_tuv_SVM","SVM",13,24,284,275,9,2500,2261,239,0.782103496503491,0.244755244755245,1.21204601849763,639,239,400,1,1.7,89.8,9.5,0,0,0,0,0,0,0.00889199197126872,2.20708014885792,1.38934278380818
9.7,"max_tuv_SVM","SVM",13,25,184,176,8,2600,2360,240,0.791479720279714,0.251748251748252,1.21204601849763,635,240,395,-4,1.6,93.39,9.8,0,0,0,0,0,0,0.00381493925237621,0.852233212972161,0.753216620368443
9.7,"max_tuv_SVM","SVM",13,26,84,81,3,2700,2455,245,0.81034405594405,0.293706293706294,1.2748928490864,680,245,435,45,1.8,96.98,10,0,0,0,0,0,0,4.85922350507964e-07,1.82813006800668,1.82813006800668
9.7,"max_tuv_SVM","SVM",13,27,0,0,0,2784,2536,248,0.772710489510488,0.216783216783217,1.26591473043086,664,248,416,-16,1.7,100,10.2,0,0,0,0,0,0,0,0,0
9.7,"max_tuv_SVM","SVM",14,0,2684,2420,264,100,89,11,0.807550022952494,0.198275862068966,1.27280311457175,30,11,19,0,1.7,3.59,8.1,0,0,0,0,0,0,0.192683186007687,280.969613510639,21.2861307131373
9.7,"max_tuv_SVM","SVM",14,1,2584,2336,248,200,173,27,0.723948910431232,0.267241379310345,1.16212458286986,80,27,53,50,2,7.18,6.4,0,0,0,0,0,0,0.163258926337443,335.914758138839,17.5944748759258
9.7,"max_tuv_SVM","SVM",14,2,2484,2273,211,300,236,64,0.727142008478926,0.25,1.16212458286986,150,64,86,70,1.3,10.78,3.7,0,0,0,0,0,0,0.223388438000182,467.896453071371,23.6638624933134
9.7,"max_tuv_SVM","SVM",14,3,2384,2191,193,400,318,82,0.748339318985767,0.172413793103448,1.20639599555061,189,82,107,39,1.3,14.37,3.9,0,0,0,0,0,0,0.237973683735137,312.723077457083,25.2072419594264
9.7,"max_tuv_SVM","SVM",14,4,2284,2099,185,500,410,90,0.750587314017226,0.25,1.20639599555061,219,90,129,30,1.4,17.96,4.6,0,0,0,0,0,0,0.184611977261908,222.841645978522,19.0974522413753
9.7,"max_tuv_SVM","SVM",14,5,2184,2024,160,600,485,115,0.764912375448926,0.267241379310345,1.20639599555061,289,115,174,70,1.5,21.55,4.2,0,0,0,0,0,0,0.187535158409759,187.999377954602,19.5596245036097
9.7,"max_tuv_SVM","SVM",14,6,2084,1946,138,700,563,137,0.768591526476387,0.301724137931034,1.20639599555061,334,137,197,45,1.4,25.14,4.1,0,0,0,0,0,0,0.186668132300953,146.948972401144,19.4586954795677
9.7,"max_tuv_SVM","SVM",14,7,1984,1872,112,800,637,163,0.775706802041423,0.301724137931034,1.20639599555061,395,163,232,61,1.4,28.74,3.9,0,0,0,0,0,0,0.193434600427275,163.864779999561,19.9961566248416
9.7,"max_tuv_SVM","SVM",14,8,1884,1804,80,900,705,195,0.777549752923076,0.258620689655172,1.20639599555061,474,195,279,79,1.4,32.33,3.6,0,0,0,0,0,0,0.202072448585736,152.584299903385,21.6944062871846
9.7,"max_tuv_SVM","SVM",14,9,1784,1721,63,1000,788,212,0.790173628925559,0.28448275862069,1.20639599555061,521,212,309,47,1.5,35.92,3.7,0,0,0,0,0,0,0.180154221285069,119.620769185893,19.5223100952196
9.7,"max_tuv_SVM","SVM",14,10,1684,1635,49,1100,874,226,0.764122539356793,0.198275862068966,1.18426028921023,561,226,335,40,1.5,39.51,3.9,0,0,0,0,0,0,0.18932459482183,128.571012544754,20.5952773035439
9.7,"max_tuv_SVM","SVM",14,11,1584,1539,45,1200,970,230,0.768598277212218,0.206896551724138,1.19532814238042,579,230,349,18,1.5,43.1,4.2,0,0,0,0,0,0,0.169421400664065,114.269601259648,17.9700652097569
9.7,"max_tuv_SVM","SVM",14,12,1484,1445,39,1300,1064,236,0.777185213188243,0.206896551724138,1.19532814238042,598,236,362,19,1.5,46.7,4.5,0,0,0,0,0,0,0.169710696453538,124.121699365468,20.1816150983206
9.7,"max_tuv_SVM","SVM",14,13,1384,1354,30,1400,1155,245,0.74960170658602,0.189655172413793,1.19532814238042,638,245,393,40,1.6,50.29,4.7,0,0,0,0,0,0,0.140192916755621,77.1511012704917,15.1570443737198
9.7,"max_tuv_SVM","SVM",14,14,1284,1262,22,1500,1247,253,0.772290929711341,0.181034482758621,1.19532814238042,661,253,408,23,1.6,53.88,4.9,0,0,0,0,0,0,0.12437586679394,56.5376023231019,13.9159821433351
9.7,"max_tuv_SVM","SVM",14,15,1184,1165,19,1600,1344,256,0.74206113466368,0.129310344827586,1.20639599555061,682,256,426,21,1.7,57.47,5.2,0,0,0,0,0,0,0.116108684540017,45.946999705039,13.7583496124225
9.7,"max_tuv_SVM","SVM",14,16,1084,1065,19,1700,1444,256,0.743296519320607,0.163793103448276,1.20639599555061,669,256,413,-13,1.6,61.06,5.6,0,0,0,0,0,0,0.101156800596504,35.7449489451558,11.4665815404956
9.7,"max_tuv_SVM","SVM",14,17,984,966,18,1800,1543,257,0.742452677341825,0.112068965517241,1.2174638487208,667,257,410,-2,1.6,64.66,6,0,0,0,0,0,0,0.0515987570825832,14.5239504981984,7.32690265487267
9.7,"max_tuv_SVM","SVM",14,18,884,868,16,1900,1641,259,0.756426700510347,0.146551724137931,1.2174638487208,667,259,408,0,1.6,68.25,6.3,0,0,0,0,0,0,0.0144977701847649,4.28977354015031,2.98560305150914
9.7,"max_tuv_SVM","SVM",14,19,784,770,14,2000,1739,261,0.78787837874328,0.224137931034483,1.23959955506118,678,261,417,11,1.6,71.84,6.7,0,0,0,0,0,0,0.00990258812981107,2.45100933828238,1.82625868423746
9.7,"max_tuv_SVM","SVM",14,20,684,675,9,2100,1834,266,0.732508843463934,0.137931034482759,1.26173526140156,711,266,445,33,1.7,75.43,6.9,0,0,0,0,0,0,0.0776678224349355,23.2964421340335,12.1830593926749
9.7,"max_tuv_SVM","SVM",14,21,584,581,3,2200,1928,272,0.755663867361542,0.120689655172414,1.28387096774194,735,272,463,24,1.7,79.02,7.1,0,0,0,0,0,0,0.127971989742328,45.1115911312448,14.4152258433909
9.7,"max_tuv_SVM","SVM",14,22,484,483,1,2300,2026,274,0.730213593281661,0.103448275862069,1.27280311457175,748,274,474,13,1.7,82.61,7.4,0,0,0,0,0,0,0.114664087738247,34.1578848975612,16.0906480017282
9.7,"max_tuv_SVM","SVM",14,23,384,383,1,2400,2126,274,0.794399589555255,0.224137931034483,1.27280311457175,748,274,474,0,1.7,86.21,7.8,0,0,0,0,0,0,0.0592306390281808,13.7819603805047,8.25078319558724
9.7,"max_tuv_SVM","SVM",14,24,284,283,1,2500,2226,274,0.801170577592949,0.241379310344828,1.27280311457175,745,274,471,-3,1.7,89.8,8.1,0,0,0,0,0,0,0.0188333429497705,4.3033384660549,3.5328893478953
9.7,"max_tuv_SVM","SVM",14,25,184,184,0,2600,2325,275,0.744194367186017,0.112068965517241,1.27280311457175,760,275,485,15,1.8,93.39,8.5,0,0,0,0,0,0,0.00446469824525962,2.49959057176541,2.42762084541947
9.7,"max_tuv_SVM","SVM",14,26,84,84,0,2700,2425,275,0.697215996543619,0.112068965517241,1.27280311457175,752,275,477,-8,1.7,96.98,8.8,0,0,0,0,0,0,3.48668196154532e-10,0.0168592693313206,0.0168592693313206
9.7,"max_tuv_SVM","SVM",14,27,0,0,0,2784,2509,275,0.792185348202947,0.189655172413793,1.26173526140156,745,275,470,-7,1.7,100,9.1,0,0,0,0,0,0,0,0,0
9.7,"max_tuv_SVM","SVM",15,0,2684,2432,252,100,88,12,0.827126170840029,0.291338582677165,1.2737617475235,34,12,22,0,1.8,3.59,7.3,0,0,0,0,0,0,0.161743916048587,342.932497219046,17.3584365477819
9.7,"max_tuv_SVM","SVM",15,1,2584,2353,231,200,167,33,0.816944682862521,0.338582677165354,1.24343408686817,79,33,46,45,1.4,7.18,5.1,0,0,0,0,0,0,0.291405110760001,301.007232797872,33.3028424602988
9.7,"max_tuv_SVM","SVM",15,2,2484,2287,197,300,233,67,0.775497257155649,0.220472440944882,1.23332486664973,159,67,92,80,1.4,10.78,3.5,0,0,0,0,0,0,0.240885760962878,473.923851635937,24.9030780951669
9.7,"max_tuv_SVM","SVM",15,3,2384,2202,182,400,318,82,0.809636650868881,0.299212598425197,1.22321564643129,196,82,114,37,1.4,14.37,3.9,0,0,0,0,0,0,0.231327520790886,233.770877030816,25.4152733875278
9.7,"max_tuv_SVM","SVM",15,4,2284,2132,152,500,388,112,0.775397743528504,0.322834645669291,1.22321564643129,263,112,151,67,1.3,17.96,3.5,0,0,0,0,0,0,0.209478818618595,240.163790374289,22.3366206066135
9.7,"max_tuv_SVM","SVM",15,5,2184,2053,131,600,467,133,0.804673408714907,0.31496062992126,1.23332486664973,310,133,177,47,1.3,21.55,3.5,0,0,0,0,0,0,0.216822263068227,290.932162587493,22.4148153637409
9.7,"max_tuv_SVM","SVM",15,6,2084,1973,111,700,547,153,0.831784652510857,0.354330708661417,1.25354330708661,353,153,200,43,1.3,25.14,3.6,0,0,0,0,0,0,0.211274866865761,183.527700451983,22.2732792725646
9.7,"max_tuv_SVM","SVM",15,7,1984,1902,82,800,618,182,0.810376783470788,0.322834645669291,1.25354330708661,435,182,253,82,1.4,28.74,3.4,0,0,0,0,0,0,0.211963956434283,227.410839177165,21.9963768261427
9.7,"max_tuv_SVM","SVM",15,8,1884,1804,80,900,716,184,0.845996442387832,0.267716535433071,1.28387096774194,434,184,250,-1,1.4,32.33,3.9,0,0,0,0,0,0,0.198260276415099,85.0001649074306,22.4591120408094
9.7,"max_tuv_SVM","SVM",15,9,1784,1718,66,1000,802,198,0.851202249007974,0.307086614173228,1.28387096774194,475,198,277,41,1.4,35.92,4.1,0,0,0,0,0,0,0.152625852683264,56.7975187522729,18.686660749812
9.7,"max_tuv_SVM","SVM",15,10,1684,1636,48,1100,884,216,0.835982883656131,0.220472440944882,1.28387096774194,528,216,312,53,1.4,39.51,4.1,0,0,0,0,0,0,0.185961955577354,98.8607553330906,20.3737259346931
9.7,"max_tuv_SVM","SVM",15,11,1584,1545,39,1200,975,225,0.811857048674604,0.251968503937008,1.2737617475235,549,225,324,21,1.4,43.1,4.3,0,0,0,0,0,0,0.205692558191268,147.284824881489,23.1975211741807
9.7,"max_tuv_SVM","SVM",15,12,1484,1446,38,1300,1074,226,0.822710253635361,0.275590551181102,1.28387096774194,568,226,342,19,1.5,46.7,4.8,0,0,0,0,0,0,0.187576573882103,141.30391889435,19.5430292525486
9.7,"max_tuv_SVM","SVM",15,13,1384,1354,30,1400,1166,234,0.823369531415209,0.236220472440945,1.28387096774194,580,234,346,12,1.5,50.29,5,0,0,0,0,0,0,0.164227263525483,53.0313940590522,20.8128573517726
9.7,"max_tuv_SVM","SVM",15,14,1284,1258,26,1500,1262,238,0.824843577017331,0.228346456692913,1.28387096774194,594,238,356,14,1.5,53.88,5.3,0,0,0,0,0,0,0.0698122186476415,22.5264508950849,10.9172851485002
9.7,"max_tuv_SVM","SVM",15,15,1184,1163,21,1600,1357,243,0.789758803846203,0.196850393700787,1.26365252730505,628,243,385,34,1.6,57.47,5.6,0,0,0,0,0,0,0.10754948890981,42.2320952438305,13.0742181586786
9.7,"max_tuv_SVM","SVM",15,16,1084,1067,17,1700,1453,247,0.827406052916371,0.322834645669291,1.26365252730505,668,247,421,40,1.7,61.06,5.9,0,0,0,0,0,0,0.126123021889361,50.5731841473279,14.0411408154429
9.7,"max_tuv_SVM","SVM",15,17,984,968,16,1800,1552,248,0.82419673844087,0.251968503937008,1.2737617475235,652,248,404,-16,1.6,64.66,6.3,0,0,0,0,0,0,0.0531430377927276,13.832552733762,7.34726766949495
9.7,"max_tuv_SVM","SVM",15,18,884,870,14,1900,1650,250,0.813405729497082,0.283464566929134,1.26365252730505,657,250,407,5,1.6,68.25,6.6,0,0,0,0,0,0,0.0399752181477504,11.6042945728867,5.70573745127018
9.7,"max_tuv_SVM","SVM",15,19,784,775,9,2000,1745,255,0.791239069050023,0.220472440944882,1.2737617475235,687,255,432,30,1.7,71.84,6.8,0,0,0,0,0,0,0.0909268310074332,25.0294617764479,13.6178176337045
9.7,"max_tuv_SVM","SVM",15,20,684,678,6,2100,1842,258,0.819476060753075,0.251968503937008,1.2737617475235,696,258,438,9,1.7,75.43,7.1,0,0,0,0,0,0,0.056289515928063,16.0109810230099,9.36108989274536
9.7,"max_tuv_SVM","SVM",15,21,584,580,4,2200,1940,260,0.842818225920814,0.299212598425197,1.28387096774194,712,260,452,16,1.7,79.02,7.5,0,0,0,0,0,0,0.0223091803243476,7.02092888654116,5.07837045522806
9.7,"max_tuv_SVM","SVM",15,22,484,481,3,2300,2039,261,0.838750606411165,0.236220472440945,1.28387096774194,728,261,467,16,1.8,82.61,7.8,0,0,0,0,0,0,0.0103977018798547,2.96575081998737,2.21653002164292
9.7,"max_tuv_SVM","SVM",15,23,384,382,2,2400,2138,262,0.744200221417824,0.15748031496063,1.26365252730505,706,262,444,-22,1.7,86.21,8.2,0,0,0,0,0,0,0.0527423274367051,19.5054068499127,15.8440282120014
9.7,"max_tuv_SVM","SVM",15,24,284,282,2,2500,2238,262,0.83583361321541,0.283464566929134,1.28387096774194,745,262,483,39,1.8,89.8,8.5,0,0,0,0,0,0,0.00595775399681673,1.84824869520474,1.54477603933179
9.7,"max_tuv_SVM","SVM",15,25,184,184,0,2600,2336,264,0.833414188155392,0.307086614173228,1.2737617475235,762,264,498,17,1.9,93.39,8.8,0,0,0,0,0,0,0.00320136383427435,2.10033975488549,2.00895933639078
9.7,"max_tuv_SVM","SVM",15,26,84,84,0,2700,2436,264,0.712834770061327,0.125984251968504,1.2737617475235,780,264,516,18,2,96.98,9.2,0,0,0,0,0,0,1.0000000994736e-07,0.133173066041938,0.133173066041938
9.7,"max_tuv_SVM","SVM",15,27,0,0,0,2784,2520,264,0.730653928922398,0.125984251968504,1.2737617475235,756,264,492,-24,1.9,100,9.5,0,0,0,0,0,0,0,0,0
9.7,"max_tuv_SVM","SVM",16,0,2684,2427,257,100,93,7,0.863193641079226,0.291338582677165,1.28387096774194,19,7,12,0,1.7,3.59,13.3,0,0,0,0,0,0,0.136914011540247,212.745548522229,14.4964889186559
9.7,"max_tuv_SVM","SVM",16,1,2584,2355,229,200,165,35,0.740978467738935,0.125984251968504,1.24343408686817,92,35,57,73,1.6,7.18,4.7,0,0,0,0,0,0,0.220155986799158,407.260252924582,26.2402332517175
9.7,"max_tuv_SVM","SVM",16,2,2484,2258,226,300,262,38,0.842569441852948,0.307086614173228,1.26365252730505,107,38,69,15,1.8,10.78,6.9,0,0,0,0,0,0,0.169169870519323,233.062609660168,19.5507950727142
9.7,"max_tuv_SVM","SVM",16,3,2384,2183,201,400,337,63,0.837214364792094,0.338582677165354,1.24343408686817,161,63,98,54,1.6,14.37,5.3,0,0,0,0,0,0,0.177592507543195,204.662084329632,18.4740727909917
9.7,"max_tuv_SVM","SVM",16,4,2284,2110,174,500,410,90,0.830248410891786,0.31496062992126,1.24343408686817,223,90,133,62,1.5,17.96,4.6,0,0,0,0,0,0,0.205564263366378,205.457867031867,21.1118341434206
9.7,"max_tuv_SVM","SVM",16,5,2184,2039,145,600,481,119,0.844671667226446,0.330708661417323,1.25354330708661,293,119,174,70,1.5,21.55,4,0,0,0,0,0,0,0.224408674612595,171.281587743032,23.1674944518798
9.7,"max_tuv_SVM","SVM",16,6,2084,1969,115,700,551,149,0.847619758430672,0.322834645669291,1.2737617475235,359,149,210,66,1.4,25.14,3.7,0,0,0,0,0,0,0.23242578359823,158.291608023238,23.6581611371093
9.7,"max_tuv_SVM","SVM",16,7,1984,1889,95,800,631,169,0.852197385279453,0.346456692913386,1.2737617475235,397,169,228,38,1.3,28.74,3.7,0,0,0,0,0,0,0.213038045310971,111.721386387717,22.5938995889278
9.7,"max_tuv_SVM","SVM",16,8,1884,1809,75,900,711,189,0.85233421651679,0.354330708661417,1.2737617475235,446,189,257,49,1.4,32.33,3.8,0,0,0,0,0,0,0.180641721630451,83.6472086900262,19.7292274913211
9.7,"max_tuv_SVM","SVM",16,9,1784,1720,64,1000,800,200,0.842880421937795,0.31496062992126,1.25354330708661,489,200,289,43,1.4,35.92,4,0,0,0,0,0,0,0.172335094968267,104.14918209699,18.5524083174317
9.7,"max_tuv_SVM","SVM",16,10,1684,1632,52,1100,888,212,0.811029841648956,0.220472440944882,1.24343408686817,523,212,311,34,1.5,39.51,4.2,0,0,0,0,0,0,0.173514039116684,85.1736833827078,19.2066420968689
9.7,"max_tuv_SVM","SVM",16,11,1584,1540,44,1200,980,220,0.822150489482669,0.228346456692913,1.24343408686817,540,220,320,17,1.5,43.1,4.5,0,0,0,0,0,0,0.174348619104805,109.192643564497,18.5657198528937
9.7,"max_tuv_SVM","SVM",16,12,1484,1445,39,1300,1075,225,0.819519597964963,0.267716535433071,1.24343408686817,556,225,331,16,1.5,46.7,4.8,0,0,0,0,0,0,0.15304319753586,54.6045363771699,16.5144310535346
9.7,"max_tuv_SVM","SVM",16,13,1384,1355,29,1400,1165,235,0.839478299809698,0.322834645669291,1.24343408686817,594,235,359,38,1.5,50.29,5,0,0,0,0,0,0,0.129537691921579,50.4843670457256,14.4777992694608
9.7,"max_tuv_SVM","SVM",16,14,1284,1259,25,1500,1261,239,0.827281660882455,0.291338582677165,1.25354330708661,615,239,376,21,1.6,53.88,5.3,0,0,0,0,0,0,0.118781580539708,51.5894649181048,13.3778771666424
9.7,"max_tuv_SVM","SVM",16,15,1184,1159,25,1600,1361,239,0.830969884688604,0.291338582677165,1.24343408686817,603,239,364,-12,1.5,57.47,5.7,0,0,0,0,0,0,0.0838749682263198,32.9739192930153,9.94196177183702
9.7,"max_tuv_SVM","SVM",16,16,1084,1062,22,1700,1458,242,0.828432287196335,0.291338582677165,1.24343408686817,623,242,381,20,1.6,61.06,6,0,0,0,0,0,0,0.0509000353534595,16.2010635636597,7.92944633253063
9.7,"max_tuv_SVM","SVM",16,17,984,965,19,1800,1555,245,0.778519983580254,0.181102362204724,1.23332486664973,667,245,422,44,1.7,64.66,6.3,0,0,0,0,0,0,0.0653543229021805,20.5645506036105,10.5609377475169
9.7,"max_tuv_SVM","SVM",16,18,884,865,19,1900,1655,245,0.802801308604199,0.196850393700787,1.23332486664973,659,245,414,-8,1.7,68.25,6.8,0,0,0,0,0,0,0.0191018406179965,5.78424784505718,3.53757897912431
9.7,"max_tuv_SVM","SVM",16,19,784,767,17,2000,1753,247,0.80693423393166,0.259842519685039,1.23332486664973,646,247,399,-13,1.6,71.84,7.1,0,0,0,0,0,0,0.0053612928524532,1.56282332992197,1.01654446409138
9.7,"max_tuv_SVM","SVM",16,20,684,671,13,2100,1849,251,0.796127675983628,0.21259842519685,1.22321564643129,675,251,424,29,1.7,75.43,7.4,0,0,0,0,0,0,0.0495164114826532,14.8699604937289,8.48317289297204
9.7,"max_tuv_SVM","SVM",16,21,584,571,13,2200,1949,251,0.811309723725288,0.267716535433071,1.21310642621285,659,251,408,-16,1.6,79.02,7.8,0,0,0,0,0,0,0.00825862836592633,2.68128693379016,1.8875873288656
9.7,"max_tuv_SVM","SVM",16,22,484,472,12,2300,2048,252,0.798945155552238,0.228346456692913,1.21310642621285,684,252,432,25,1.7,82.61,8.1,0,0,0,0,0,0,0.00671882959102607,4.46874279571839,3.92470191824196
9.7,"max_tuv_SVM","SVM",16,23,384,373,11,2400,2147,253,0.768033735119605,0.133858267716535,1.20299720599441,669,253,416,-15,1.6,86.21,8.5,0,0,0,0,0,0,0.00353816888664839,1.11605796505478,0.850193218484866
9.7,"max_tuv_SVM","SVM",16,24,284,276,8,2500,2244,256,0.817492007811823,0.275590551181102,1.22321564643129,694,256,438,25,1.7,89.8,8.8,0,0,0,0,0,0,0.00338369104796679,1.33932271448377,1.12899063985593
9.7,"max_tuv_SVM","SVM",16,25,184,182,2,2600,2338,262,0.75793310196415,0.15748031496063,1.2737617475235,727,262,465,33,1.8,93.39,8.9,0,0,0,0,0,0,0.00915094520604299,3.5805414824586,3.45236726042936
9.7,"max_tuv_SVM","SVM",16,26,84,84,0,2700,2436,264,0.810103120996135,0.228346456692913,1.28387096774194,735,264,471,8,1.8,96.98,9.2,0,0,0,0,0,0,2.57145667602618e-07,0.262738384527786,0.262738384527786
9.7,"max_tuv_SVM","SVM",16,27,0,0,0,2784,2520,264,0.798889179136968,0.21259842519685,1.28387096774194,737,264,473,2,1.8,100,9.5,0,0,0,0,0,0,0,0,0
9.7,"max_tuv_SVM","SVM",17,0,2684,2431,253,100,92,8,0.636701382544614,0.215384615384615,1.0863523573201,28,8,20,0,2.5,3.59,11.5,0,0,0,0,0,0,0.135437630161132,215.42530165862,17.1118446789687
9.7,"max_tuv_SVM","SVM",17,1,2584,2354,230,200,169,31,0.792569584018518,0.315384615384615,1.24436724565757,88,31,57,60,1.8,7.18,5.5,0,0,0,0,0,0,0.199079010800832,324.128899048004,20.6702945891729
9.7,"max_tuv_SVM","SVM",17,2,2484,2274,210,300,249,51,0.81549424447287,0.261538461538462,1.26411910669975,117,51,66,29,1.3,10.78,4.9,0,0,0,0,0,0,0.230531325360704,132.530955801409,26.4769500763205
9.7,"max_tuv_SVM","SVM",17,3,2384,2211,173,400,312,88,0.824307205067303,0.269230769230769,1.26411910669975,199,88,111,82,1.3,14.37,3.5,0,0,0,0,0,0,0.242862187780293,327.465329594361,25.2953824570305
9.7,"max_tuv_SVM","SVM",17,4,2284,2137,147,500,386,114,0.785455874291983,0.292307692307692,1.22461538461538,264,114,150,65,1.3,17.96,3.4,0,0,0,0,0,0,0.241051818506517,151.569580263422,26.4202713298464
9.7,"max_tuv_SVM","SVM",17,5,2184,2050,134,600,473,127,0.818381143796823,0.269230769230769,1.25424317617866,288,127,161,24,1.3,21.55,3.7,0,0,0,0,0,0,0.242313126963317,128.895506715788,26.5377864546935
9.7,"max_tuv_SVM","SVM",17,6,2084,1977,107,700,546,154,0.821663925939463,0.315384615384615,1.24436724565757,346,154,192,58,1.2,25.14,3.5,0,0,0,0,0,0,0.21820156960944,71.5526548112822,23.8026666676559
9.7,"max_tuv_SVM","SVM",17,7,1984,1901,83,800,622,178,0.825147694743897,0.330769230769231,1.25424317617866,410,178,232,64,1.3,28.74,3.5,0,0,0,0,0,0,0.16881185654505,46.6846325273868,20.1907892990645
9.7,"max_tuv_SVM","SVM",17,8,1884,1819,65,900,704,196,0.81737011998295,0.330769230769231,1.24436724565757,449,196,253,39,1.3,32.33,3.6,0,0,0,0,0,0,0.160488921216982,45.5245469718925,18.8772030670229
9.7,"max_tuv_SVM","SVM",17,9,1784,1733,51,1000,790,210,0.800870942201112,0.276923076923077,1.2048635235732,495,210,285,46,1.4,35.92,3.8,0,0,0,0,0,0,0.180224807195005,63.7316122977361,20.5419610420555
9.7,"max_tuv_SVM","SVM",17,10,1684,1641,43,1100,882,218,0.794567269626656,0.261538461538462,1.2048635235732,526,218,308,31,1.4,39.51,4,0,0,0,0,0,0,0.119993513929979,32.7488766454192,15.3049030182576
9.7,"max_tuv_SVM","SVM",17,11,1584,1545,39,1200,978,222,0.792423411900851,0.3,1.2048635235732,553,222,331,27,1.5,43.1,4.4,0,0,0,0,0,0,0.12966483199287,53.5979939840582,15.398886387518
9.7,"max_tuv_SVM","SVM",17,12,1484,1456,28,1300,1067,233,0.793050733905845,0.292307692307692,1.2048635235732,584,233,351,31,1.5,46.7,4.6,0,0,0,0,0,0,0.168290226757937,80.5856059073511,17.8444035523585
9.7,"max_tuv_SVM","SVM",17,13,1384,1360,24,1400,1163,237,0.787216030208909,0.3,1.2048635235732,590,237,353,6,1.5,50.29,4.9,0,0,0,0,0,0,0.150699223578417,74.7701939177489,16.1422541770267
9.7,"max_tuv_SVM","SVM",17,14,1284,1260,24,1500,1263,237,0.774587368292836,0.261538461538462,1.2048635235732,592,237,355,2,1.5,53.88,5.3,0,0,0,0,0,0,0.103730695384289,35.6562520579799,11.5877289400496
9.7,"max_tuv_SVM","SVM",17,15,1184,1161,23,1600,1362,238,0.746053352822953,0.176923076923077,1.2048635235732,611,238,373,19,1.6,57.47,5.7,0,0,0,0,0,0,0.128404323483145,42.7924039564173,14.4568580301985
9.7,"max_tuv_SVM","SVM",17,16,1084,1062,22,1700,1461,239,0.778853766977287,0.253846153846154,1.2048635235732,623,239,384,12,1.6,61.06,6.1,0,0,0,0,0,0,0.0819292920656213,20.3756256472002,10.2737433842733
9.7,"max_tuv_SVM","SVM",17,17,984,962,22,1800,1561,239,0.790084658018154,0.284615384615385,1.2048635235732,624,239,385,1,1.6,64.66,6.5,0,0,0,0,0,0,0.0245057160031182,5.04777579023943,3.90425466625916
9.7,"max_tuv_SVM","SVM",17,18,884,862,22,1900,1661,239,0.739369023692067,0.161538461538462,NA,615,239,376,-9,1.6,68.25,6.9,0,0,0,0,0,0,6.97047796853518e-05,0.291883719595867,0.291208177901414
9.7,"max_tuv_SVM","SVM",17,19,784,764,20,2000,1759,241,0.778448748401247,0.246153846153846,1.23449131513648,622,241,381,7,1.6,71.84,7.3,0,0,0,0,0,0,3.18466325972768e-06,0.0581070030446437,0.0579258374140593
9.7,"max_tuv_SVM","SVM",17,20,684,672,12,2100,1851,249,0.791302758998724,0.223076923076923,1.23449131513648,657,249,408,35,1.6,75.43,7.4,0,0,0,0,0,0,0.0404495328362132,14.7749868138423,6.85021826675887
9.7,"max_tuv_SVM","SVM",17,21,584,572,12,2200,1951,249,0.775004567878681,0.223076923076923,1.24436724565757,657,249,408,0,1.6,79.02,7.8,0,0,0,0,0,0,0.00172850270096632,0.611936081500777,0.404034723613076
9.7,"max_tuv_SVM","SVM",17,22,484,475,9,2300,2048,252,0.780583470369697,0.207692307692308,1.25424317617866,674,252,422,17,1.7,82.61,8.1,0,0,0,0,0,0,0.00286917463022457,1.15689347299502,0.843371285931541
9.7,"max_tuv_SVM","SVM",17,23,384,382,2,2400,2141,259,0.798270296607591,0.253846153846154,1.26411910669975,690,259,431,16,1.7,86.21,8.3,0,0,0,0,0,0,0.0037765669636526,1.70672681586003,1.48572581720128
9.7,"max_tuv_SVM","SVM",17,24,284,283,1,2500,2240,260,0.75647725196419,0.138461538461538,1.26411910669975,689,260,429,-1,1.6,89.8,8.6,0,0,0,0,0,0,0.00282762844467706,0.834339030342621,0.662984082020721
9.7,"max_tuv_SVM","SVM",17,25,184,183,1,2600,2340,260,0.80308788598575,0.246153846153846,1.26411910669975,682,260,422,-7,1.6,93.39,9,0,0,0,0,0,0,0.000189084887532065,0.0660392505155679,0.0612557641107269
9.7,"max_tuv_SVM","SVM",17,26,84,84,0,2700,2439,261,0.806730007917659,0.253846153846154,1.26411910669975,691,261,430,9,1.6,96.98,9.3,0,0,0,0,0,0,0.000249526883381664,2.2520972150871,2.2520972150871
9.7,"max_tuv_SVM","SVM",17,27,0,0,0,2784,2523,261,0.779943967354896,0.153846153846154,1.26411910669975,701,261,440,10,1.7,100,9.7,0,0,0,0,0,0,0,0,0
9.7,"max_tuv_SVM","SVM",18,0,2684,2431,253,100,92,8,0.773378403069616,0.238461538461538,1.28387096774194,25,8,17,0,2.1,3.59,11.5,0,0,0,0,0,0,0.121809788316647,197.373894645677,14.6894910163861
9.7,"max_tuv_SVM","SVM",18,1,2584,2350,234,200,173,27,0.764358365308487,0.238461538461538,1.25424317617866,74,27,47,49,1.7,7.18,6.4,0,0,0,0,0,0,0.187743533478671,299.145531584283,23.8705232876863
9.7,"max_tuv_SVM","SVM",18,2,2484,2275,209,300,248,52,0.777111882575069,0.269230769230769,1.22461538461538,129,52,77,55,1.5,10.78,4.8,0,0,0,0,0,0,0.195357899122087,341.375274027332,22.1168834899885
9.7,"max_tuv_SVM","SVM",18,3,2384,2201,183,400,322,78,0.76317071685243,0.238461538461538,1.23449131513648,184,78,106,55,1.4,14.37,4.1,0,0,0,0,0,0,0.200589999196741,270.524751074255,21.4544662836846
9.7,"max_tuv_SVM","SVM",18,4,2284,2115,169,500,408,92,0.765759181436144,0.215384615384615,1.22461538461538,225,92,133,41,1.4,17.96,4.4,0,0,0,0,0,0,0.180810415971596,176.287837496598,23.8182355769221
9.7,"max_tuv_SVM","SVM",18,5,2184,2028,156,600,495,105,0.763615323710339,0.223076923076923,1.22461538461538,245,105,140,20,1.3,21.55,4.7,0,0,0,0,0,0,0.172366926252696,183.039401958836,17.8177522799842
9.7,"max_tuv_SVM","SVM",18,6,2084,1954,130,700,569,131,0.782599427492543,0.215384615384615,1.22461538461538,306,131,175,61,1.3,25.14,4.3,0,0,0,0,0,0,0.184598070568699,180.967386022612,19.5160277822334
9.7,"max_tuv_SVM","SVM",18,7,1984,1876,108,800,647,153,0.782925269504845,0.223076923076923,1.22348774613968,362,153,209,56,1.4,28.74,4.2,0,0,0,0,0,0,0.175097893749355,140.485195493117,18.8114589293652
9.7,"max_tuv_SVM","SVM",18,8,1884,1800,84,900,723,177,0.79267921310677,0.184615384615385,1.22461538461538,415,177,238,53,1.3,32.33,4.1,0,0,0,0,0,0,0.170121960399957,120.28776249956,19.178898150865
9.7,"max_tuv_SVM","SVM",18,9,1784,1731,53,1000,792,208,0.796991290577993,0.230769230769231,1.22461538461538,489,208,281,74,1.4,35.92,3.8,0,0,0,0,0,0,0.176935661294436,160.038259976124,19.2873302758472
9.7,"max_tuv_SVM","SVM",18,10,1684,1637,47,1100,886,214,0.805170838662529,0.246153846153846,1.22461538461538,502,214,288,13,1.3,39.51,4.1,0,0,0,0,0,0,0.149490128469797,100.726288978965,16.3174258497004
9.7,"max_tuv_SVM","SVM",18,11,1584,1546,38,1200,977,223,0.791674279797799,0.192307692307692,1.22461538461538,539,223,316,37,1.4,43.1,4.4,0,0,0,0,0,0,0.139869257265609,72.0446148258557,16.3396234116766
9.7,"max_tuv_SVM","SVM",18,12,1484,1451,33,1300,1072,228,0.797478530970221,0.2,1.22461538461538,558,228,330,19,1.4,46.7,4.7,0,0,0,0,0,0,0.121499077081155,53.3098406104487,14.1512493038498
9.7,"max_tuv_SVM","SVM",18,13,1384,1360,24,1400,1163,237,0.801425178147272,0.2,1.22461538461538,590,237,353,32,1.5,50.29,4.9,0,0,0,0,0,0,0.110104373490618,53.2189525003899,13.1273223992087
9.7,"max_tuv_SVM","SVM",18,14,1284,1264,20,1500,1259,241,0.797216639259398,0.161538461538462,1.21473945409429,610,241,369,20,1.5,53.88,5.2,0,0,0,0,0,0,0.132264426272972,111.294120811161,13.8883147416885
9.7,"max_tuv_SVM","SVM",18,15,1184,1165,19,1600,1358,242,0.801412997137466,0.2,1.21473945409429,604,242,362,-6,1.5,57.47,5.6,0,0,0,0,0,0,0.105449977506389,46.7367757746968,12.5739182211838
9.7,"max_tuv_SVM","SVM",18,16,1084,1066,18,1700,1457,243,0.814093428345214,0.230769230769231,1.21473945409429,607,243,364,3,1.5,61.06,6,0,0,0,0,0,0,0.0917922053933258,37.3408348015605,11.6897817274453
9.7,"max_tuv_SVM","SVM",18,17,984,967,17,1800,1556,244,0.814647664291374,0.261538461538462,1.21473945409429,611,244,367,4,1.5,64.66,6.4,0,0,0,0,0,0,0.111969829583656,64.8444922740176,11.8893390218276
9.7,"max_tuv_SVM","SVM",18,18,884,867,17,1900,1656,244,0.810299043790734,0.246153846153846,1.21473945409429,625,244,381,14,1.6,68.25,6.8,0,0,0,0,0,0,0.0472161604108673,13.7474652692635,5.85623590475112
9.7,"max_tuv_SVM","SVM",18,19,784,767,17,2000,1756,244,0.794396735489376,0.2,1.21473945409429,612,244,368,-13,1.5,71.84,7.2,0,0,0,0,0,0,0.0187785585306339,4.9657359308731,2.81336151228624
9.7,"max_tuv_SVM","SVM",18,20,684,668,16,2100,1855,245,0.811096899933008,0.238461538461538,1.22461538461538,623,245,378,11,1.5,75.43,7.6,0,0,0,0,0,0,0.00679414480184373,1.99823280599747,1.37818613190027
9.7,"max_tuv_SVM","SVM",18,21,584,569,15,2200,1954,246,0.80041719958585,0.230769230769231,1.19498759305211,638,246,392,15,1.6,79.02,7.9,0,0,0,0,0,0,0.0113420012038347,4.80034018738134,3.76060689148535
9.7,"max_tuv_SVM","SVM",18,22,484,470,14,2300,2053,247,0.780211949570623,0.169230769230769,1.19498759305211,639,247,392,1,1.6,82.61,8.3,0,0,0,0,0,0,0.0137165846732061,3.77694981607921,2.36718601357302
9.7,"max_tuv_SVM","SVM",18,23,384,371,13,2400,2152,248,0.782830866678851,0.192307692307692,1.2048635235732,645,248,397,6,1.6,86.21,8.7,0,0,0,0,0,0,0.00224331281185303,0.635104873190681,0.503042433743407
9.7,"max_tuv_SVM","SVM",18,24,284,273,11,2500,2250,250,0.792106705645902,0.230769230769231,1.2048635235732,656,250,406,11,1.6,89.8,9,0,0,0,0,0,0,0.00015626178686064,0.363775424358405,0.35870293842349
9.7,"max_tuv_SVM","SVM",18,25,184,174,10,2600,2349,251,0.791972714538039,0.2,1.2048635235732,671,251,420,15,1.7,93.39,9.4,0,0,0,0,0,0,0.000163084022965854,0.0623673904582749,0.0587109908185957
9.7,"max_tuv_SVM","SVM",18,26,84,80,4,2700,2443,257,0.811322248614413,0.223076923076923,1.23449131513648,680,257,423,9,1.6,96.98,9.5,0,0,0,0,0,0,0.00209451874156192,3.43739579418723,3.43739579418723
9.7,"max_tuv_SVM","SVM",18,27,0,0,0,2784,2523,261,0.81415433339424,0.276923076923077,1.27399503722084,719,261,458,39,1.8,100,9.7,0,0,0,0,0,0,0,0,0
9.7,"max_tuv_SVM","SVM",19,0,2684,2402,282,100,95,5,0.539699826937997,0.0961538461538462,1.03697270471464,29,5,24,0,4.8,3.59,19,0,0,0,0,0,0,0.0664652664963044,149.2360632263,7.84466165408695
9.7,"max_tuv_SVM","SVM",19,1,2584,2310,274,200,187,13,0.706570388494363,0.173076923076923,1.25918114143921,51,13,38,22,2.9,7.18,14.4,0,0,0,0,0,0,0.086321748493861,183.580718539288,9.48553427542244
9.7,"max_tuv_SVM","SVM",19,2,2484,2230,254,300,267,33,0.692322611445963,0.201923076923077,1.20980148883375,95,33,62,44,1.9,10.78,8.1,0,0,0,0,0,0,0.142043359559906,259.580348680794,18.0280640598894
9.7,"max_tuv_SVM","SVM",19,3,2384,2138,246,400,359,41,0.671868472877007,0.163461538461538,1.22214640198511,130,41,89,35,2.2,14.37,8.8,0,0,0,0,0,0,0.111842797856338,228.50613299721,11.3218841054729
9.7,"max_tuv_SVM","SVM",19,4,2284,2056,228,500,441,59,0.696097153428419,0.163461538461538,1.20980148883375,170,59,111,40,1.9,17.96,7.5,0,0,0,0,0,0,0.140327503917194,192.740448210882,14.5652039394529
9.7,"max_tuv_SVM","SVM",19,5,2184,1979,205,600,518,82,0.730165005669273,0.182692307692308,1.23449131513648,226,82,144,56,1.8,21.55,6.3,0,0,0,0,0,0,0.155196434046814,222.597094349915,16.0369343187429
9.7,"max_tuv_SVM","SVM",19,6,2084,1921,163,700,576,124,0.730933341290207,0.182692307692308,1.23449131513648,317,124,193,91,1.6,25.14,4.6,0,0,0,0,0,0,0.192158134724157,209.512289670244,19.9086275598247
9.7,"max_tuv_SVM","SVM",19,7,1984,1858,126,800,639,161,0.738624157068689,0.153846153846154,1.24683622828784,398,161,237,81,1.5,28.74,4,0,0,0,0,0,0,0.201345236104763,168.884024415648,21.0071992479608
9.7,"max_tuv_SVM","SVM",19,8,1884,1791,93,900,706,194,0.770178134510954,0.201923076923077,1.27152605459057,466,194,272,68,1.4,32.33,3.6,0,0,0,0,0,0,0.205882690238638,201.136901645357,21.8897657559273
9.7,"max_tuv_SVM","SVM",19,9,1784,1710,74,1000,787,213,0.790990332398404,0.192307692307692,1.27152605459057,510,213,297,44,1.4,35.92,3.7,0,0,0,0,0,0,0.158735031193843,97.3937970732885,18.4126709631258
9.7,"max_tuv_SVM","SVM",19,10,1684,1624,60,1100,873,227,0.799442024228683,0.201923076923077,1.27152605459057,568,227,341,58,1.5,39.51,3.8,0,0,0,0,0,0,0.174373946601938,145.326561403311,19.2322040557652
9.7,"max_tuv_SVM","SVM",19,11,1584,1535,49,1200,962,238,0.811399713552547,0.211538461538462,1.27152605459057,589,238,351,21,1.5,43.1,4,0,0,0,0,0,0,0.150393724073615,103.626620884671,16.9284653671468
9.7,"max_tuv_SVM","SVM",19,12,1484,1445,39,1300,1052,248,0.810318076027931,0.221153846153846,1.27152605459057,627,248,379,38,1.5,46.7,4.2,0,0,0,0,0,0,0.134905977258828,74.1190085808439,16.1955615942831
9.7,"max_tuv_SVM","SVM",19,13,1384,1352,32,1400,1145,255,0.794265083248795,0.192307692307692,1.27152605459057,648,255,393,21,1.5,50.29,4.5,0,0,0,0,0,0,0.176382440048728,86.7655175923091,19.6264609605909
9.7,"max_tuv_SVM","SVM",19,14,1284,1266,18,1500,1231,269,0.795346720773412,0.173076923076923,1.27152605459057,686,269,417,38,1.6,53.88,4.6,0,0,0,0,0,0,0.144161313594584,56.7894210377738,17.1280015773244
9.7,"max_tuv_SVM","SVM",19,15,1184,1176,8,1600,1321,279,0.772296652145378,0.163461538461538,1.27152605459057,748,279,469,62,1.7,57.47,4.7,0,0,0,0,0,0,0.137852197472173,52.1476124685734,16.1309104542807
9.7,"max_tuv_SVM","SVM",19,16,1084,1077,7,1700,1420,280,0.797756161604111,0.201923076923077,1.27152605459057,741,280,461,-7,1.6,61.06,5.1,0,0,0,0,0,0,0.086629399650001,27.5143076085558,11.077832003716
9.7,"max_tuv_SVM","SVM",19,17,984,978,6,1800,1519,281,0.803380676732117,0.173076923076923,1.27152605459057,755,281,474,14,1.7,64.66,5.4,0,0,0,0,0,0,0.0610923512216876,18.5158851983986,7.81224751802836
9.7,"max_tuv_SVM","SVM",19,18,884,879,5,1900,1618,282,0.80074744882736,0.192307692307692,1.27152605459057,739,282,457,-16,1.6,68.25,5.7,0,0,0,0,0,0,0.0301401211175585,8.11275846046677,4.38895689058674
9.7,"max_tuv_SVM","SVM",19,19,784,780,4,2000,1717,283,0.80024019812616,0.211538461538462,1.27152605459057,758,283,475,19,1.7,71.84,6.1,0,0,0,0,0,0,0.0257263623785443,7.20265782029259,4.10999700976472
9.7,"max_tuv_SVM","SVM",19,20,684,683,1,2100,1814,286,0.802686936802532,0.192307692307692,1.25802167445814,776,286,490,18,1.7,75.43,6.3,0,0,0,0,0,0,0.0765395192254595,20.2241569760837,12.6139133059425
9.7,"max_tuv_SVM","SVM",19,21,584,583,1,2200,1914,286,0.809960016709438,0.221153846153846,1.27152605459057,780,286,494,4,1.7,79.02,6.7,0,0,0,0,0,0,0.0099171875862864,3.0309609165685,1.88243407665138
9.7,"max_tuv_SVM","SVM",19,22,484,483,1,2300,2014,286,0.802776451632158,0.182692307692308,1.27152605459057,783,286,497,3,1.7,82.61,7,0,0,0,0,0,0,0.0050955935152798,1.60952640849145,1.14609246525107
9.7,"max_tuv_SVM","SVM",19,23,384,384,0,2400,2113,287,0.75432655009847,0.134615384615385,1.25918114143921,765,287,478,-18,1.7,86.21,7.4,0,0,0,0,0,0,0.0140694149455878,6.0699978308984,5.27833424740948
9.7,"max_tuv_SVM","SVM",19,24,284,284,0,2500,2213,287,0.80310467267411,0.211538461538462,1.25918114143921,784,287,497,19,1.7,89.8,7.7,0,0,0,0,0,0,0.00139007938529844,0.671001774222711,0.612600426048691
9.7,"max_tuv_SVM","SVM",19,25,184,184,0,2600,2313,287,0.800919018917471,0.278846153846154,1.25918114143921,785,287,498,1,1.7,93.39,8.1,0,0,0,0,0,0,0.000610543866242587,0.260201477206312,0.239443607830211
9.7,"max_tuv_SVM","SVM",19,26,84,84,0,2700,2413,287,0.759234946589487,0.125,1.25918114143921,788,287,501,3,1.7,96.98,8.4,0,0,0,0,0,0,8.70783529038781e-07,0.0209707994607222,0.0209707994607222
9.7,"max_tuv_SVM","SVM",19,27,0,0,0,2784,2497,287,0.759704899445009,0.153846153846154,1.27152605459057,796,287,509,8,1.8,100,8.7,0,0,0,0,0,0,0,0,0
9.7,"max_tuv_SVM","SVM",20,0,2684,2422,262,100,87,13,0.765702211541051,0.224137931034483,1.23959955506118,35,13,22,0,1.7,3.59,6.7,0,0,0,0,0,0,0.174472292659374,339.95836062059,23.2259032970569
9.7,"max_tuv_SVM","SVM",20,1,2584,2345,239,200,164,36,0.77146058920422,0.146551724137931,1.27280311457175,96,36,60,61,1.7,7.18,4.6,0,0,0,0,0,0,0.192208265607504,420.597792413362,19.8853484504894
9.7,"max_tuv_SVM","SVM",20,2,2484,2259,225,300,250,50,0.769496125077633,0.181034482758621,1.28387096774194,131,50,81,35,1.6,10.78,5,0,0,0,0,0,0,0.198583072623927,324.952312304148,20.8004097426142
9.7,"max_tuv_SVM","SVM",20,3,2384,2188,196,400,321,79,0.782950341587231,0.163793103448276,1.28387096774194,197,79,118,66,1.5,14.37,4.1,0,0,0,0,0,0,0.207777668936404,318.610145660256,21.5030101997244
9.7,"max_tuv_SVM","SVM",20,4,2284,2116,168,500,393,107,0.77430264898874,0.21551724137931,1.28387096774194,256,107,149,59,1.4,17.96,3.7,0,0,0,0,0,0,0.212602039946188,341.203059213137,22.3477048699269
9.7,"max_tuv_SVM","SVM",20,5,2184,2034,150,600,475,125,0.786514730105582,0.224137931034483,1.28387096774194,307,125,182,51,1.5,21.55,3.8,0,0,0,0,0,0,0.200186968771557,241.473705983697,20.4187144046374
9.7,"max_tuv_SVM","SVM",20,6,2084,1954,130,700,555,145,0.791537277563256,0.232758620689655,1.28387096774194,351,145,206,44,1.4,25.14,3.8,0,0,0,0,0,0,0.202131959974664,279.918096598448,20.5240694558864
9.7,"max_tuv_SVM","SVM",20,7,1984,1873,111,800,636,164,0.799023843598952,0.224137931034483,1.28387096774194,397,164,233,46,1.4,28.74,3.9,0,0,0,0,0,0,0.188832677645756,166.377716537368,19.589951069351
9.7,"max_tuv_SVM","SVM",20,8,1884,1789,95,900,720,180,0.802628736532281,0.232758620689655,1.28387096774194,437,180,257,40,1.4,32.33,4,0,0,0,0,0,0,0.186754877004409,151.011822192675,19.2446878967464
9.7,"max_tuv_SVM","SVM",20,9,1784,1720,64,1000,789,211,0.807793049442384,0.206896551724138,1.27280311457175,518,211,307,81,1.5,35.92,3.7,0,0,0,0,0,0,0.192332631855026,101.483717818776,20.9177592496616
9.7,"max_tuv_SVM","SVM",20,10,1684,1650,34,1100,859,241,0.804390678583966,0.206896551724138,1.25066740823137,578,241,337,60,1.4,39.51,3.6,0,0,0,0,0,0,0.192522830290973,116.104314153567,20.8724525066549
9.7,"max_tuv_SVM","SVM",20,11,1584,1558,26,1200,951,249,0.803337563794458,0.206896551724138,1.25066740823137,618,249,369,40,1.5,43.1,3.8,0,0,0,0,0,0,0.186568962939466,134.006782417012,19.5866682772834
9.7,"max_tuv_SVM","SVM",20,12,1484,1461,23,1300,1048,252,0.810810628358495,0.21551724137931,1.25066740823137,625,252,373,7,1.5,46.7,4.2,0,0,0,0,0,0,0.170221379609167,133.025651056707,17.7365496635114
9.7,"max_tuv_SVM","SVM",20,13,1384,1363,21,1400,1146,254,0.806280884616428,0.198275862068966,1.25066740823137,636,254,382,11,1.5,50.29,4.5,0,0,0,0,0,0,0.106927704488873,54.2139372019919,13.0040442457148
9.7,"max_tuv_SVM","SVM",20,14,1284,1264,20,1500,1245,255,0.797606189074614,0.21551724137931,1.23959955506118,650,255,395,14,1.5,53.88,4.9,0,0,0,0,0,0,0.116441979539711,51.4898797571656,13.9552983874361
9.7,"max_tuv_SVM","SVM",20,15,1184,1164,20,1600,1345,255,0.804363675640648,0.21551724137931,1.25066740823137,643,255,388,-7,1.5,57.47,5.3,0,0,0,0,0,0,0.0760247844250969,26.6491228205238,9.93330886324425
9.7,"max_tuv_SVM","SVM",20,16,1084,1067,17,1700,1442,258,0.783692922528554,0.21551724137931,1.25066740823137,667,258,409,24,1.6,61.06,5.6,0,0,0,0,0,0,0.12278386625455,37.335030760216,15.6277366019349
9.7,"max_tuv_SVM","SVM",20,17,984,967,17,1800,1542,258,0.806638673615424,0.189655172413793,1.26057344256049,674,258,416,7,1.6,64.66,6,0,0,0,0,0,0,0.0253219555649243,6.86010065815324,4.54480340396252
9.7,"max_tuv_SVM","SVM",20,18,884,868,16,1900,1641,259,0.790760942942779,0.189655172413793,1.27280311457175,667,259,408,-7,1.6,68.25,6.3,0,0,0,0,0,0,0.0179130505581018,4.6002441790981,2.99807593324039
9.7,"max_tuv_SVM","SVM",20,19,784,773,11,2000,1736,264,0.808117084762238,0.198275862068966,1.28387096774194,695,264,431,28,1.6,71.84,6.6,0,0,0,0,0,0,0.00877723927794274,3.56077361933806,2.77874601394607
9.7,"max_tuv_SVM","SVM",20,20,684,680,4,2100,1829,271,0.774734696081867,0.181034482758621,1.27280311457175,730,271,459,35,1.7,75.43,6.7,0,0,0,0,0,0,0.0697276786725767,21.8098691283084,11.0563026424199
9.7,"max_tuv_SVM","SVM",20,21,584,581,3,2200,1928,272,0.806368644182212,0.198275862068966,1.27280311457175,710,272,438,-20,1.6,79.02,7.1,0,0,0,0,0,0,0.0179757191282482,5.1579298091866,3.55880332796094
9.7,"max_tuv_SVM","SVM",20,22,484,483,1,2300,2026,274,0.794676369724294,0.198275862068966,1.27280311457175,750,274,476,40,1.7,82.61,7.4,0,0,0,0,0,0,0.0509679519084042,14.8022909266355,10.4614237465859
9.7,"max_tuv_SVM","SVM",20,23,384,383,1,2400,2126,274,0.79870655901493,0.198275862068966,1.27280311457175,742,274,468,-8,1.7,86.21,7.8,0,0,0,0,0,0,0.0182700539260279,4.82177452805609,3.64853471990876
9.7,"max_tuv_SVM","SVM",20,24,284,284,0,2500,2225,275,0.814739556611662,0.224137931034483,1.27280311457175,738,275,463,-4,1.7,89.8,8.1,0,0,0,0,0,0,0.00943124487149497,2.98159710769028,2.52435783116836
9.7,"max_tuv_SVM","SVM",20,25,184,184,0,2600,2325,275,0.78498906380795,0.181034482758621,1.27280311457175,731,275,456,-7,1.7,93.39,8.5,0,0,0,0,0,0,0.00146397091836759,1.00703494370903,0.961156420805885
9.7,"max_tuv_SVM","SVM",20,26,84,84,0,2700,2425,275,0.781431426025433,0.189655172413793,1.27280311457175,745,275,470,14,1.7,96.98,8.8,0,0,0,0,0,0,7.58736880685591e-07,0.00453290131926358,0.00453290131926358
9.7,"max_tuv_SVM","SVM",20,27,0,0,0,2784,2509,275,0.786778008802954,0.172413793103448,1.27280311457175,723,275,448,-22,1.6,100,9.1,0,0,0,0,0,0,0,0,0
9.7,"max_tuv_SVM","SVM",21,0,2684,2427,257,100,88,12,0.748416762327329,0.163934426229508,1.27334743521946,31,12,19,0,1.6,3.59,7.3,0,0,0,0,0,0,0.235434060533499,337.705542630389,27.4013953029033
9.7,"max_tuv_SVM","SVM",21,1,2584,2353,231,200,162,38,0.774245140653419,0.204918032786885,1.25230037017451,91,38,53,60,1.4,7.18,4.3,0,0,0,0,0,0,0.232910868540259,392.827094510684,26.2811343350013
9.7,"max_tuv_SVM","SVM",21,2,2484,2281,203,300,234,66,0.813248893990793,0.319672131147541,1.25230037017451,152,66,86,61,1.3,10.78,3.5,0,0,0,0,0,0,0.233982623174803,504.403904444863,24.0312007756869
9.7,"max_tuv_SVM","SVM",21,3,2384,2209,175,400,306,94,0.808747468754427,0.237704918032787,1.24177683765204,220,94,126,68,1.3,14.37,3.3,0,0,0,0,0,0,0.244996228702037,420.565863488048,25.3266474692447
9.7,"max_tuv_SVM","SVM",21,4,2284,2122,162,500,393,107,0.822387174162597,0.278688524590164,1.24177683765204,248,107,141,28,1.3,17.96,3.7,0,0,0,0,0,0,0.218005196081701,287.927923482509,23.0907958153918
9.7,"max_tuv_SVM","SVM",21,5,2184,2047,137,600,468,132,0.835549651107301,0.327868852459016,1.25230037017451,306,132,174,58,1.3,21.55,3.5,0,0,0,0,0,0,0.22371298975727,338.623645834007,22.5390392506058
9.7,"max_tuv_SVM","SVM",21,6,2084,1982,102,700,533,167,0.84221795152907,0.336065573770492,1.25230037017451,389,167,222,83,1.3,25.14,3.2,0,0,0,0,0,0,0.238798426428521,283.076967637302,24.3161957439605
9.7,"max_tuv_SVM","SVM",21,7,1984,1912,72,800,603,197,0.835717325972844,0.344262295081967,1.23125330512956,469,197,272,80,1.4,28.74,3.1,0,0,0,0,0,0,0.241279144969452,243.031919520938,24.9228847366437
9.7,"max_tuv_SVM","SVM",21,8,1884,1818,66,900,697,203,0.834208252183002,0.344262295081967,1.24177683765204,472,203,269,3,1.3,32.33,3.4,0,0,0,0,0,0,0.212382460737523,229.315334735062,21.7947279456871
9.7,"max_tuv_SVM","SVM",21,9,1784,1731,53,1000,784,216,0.832376726728667,0.311475409836066,1.24177683765204,511,216,295,39,1.4,35.92,3.6,0,0,0,0,0,0,0.196875047092458,144.558850329007,20.8913326784687
9.7,"max_tuv_SVM","SVM",21,10,1684,1641,43,1100,874,226,0.826714475500125,0.254098360655738,1.24177683765204,547,226,321,36,1.4,39.51,3.9,0,0,0,0,0,0,0.193222378976288,227.932914931658,19.6964781371261
9.7,"max_tuv_SVM","SVM",21,11,1584,1544,40,1200,971,229,0.830267892842862,0.278688524590164,1.25230037017451,562,229,333,15,1.5,43.1,4.2,0,0,0,0,0,0,0.164709854891027,123.46920305801,17.20287645479
9.7,"max_tuv_SVM","SVM",21,12,1484,1449,35,1300,1066,234,0.82683055809934,0.254098360655738,1.25230037017451,596,234,362,34,1.5,46.7,4.6,0,0,0,0,0,0,0.129867654995459,80.4416570287047,15.6739916818725
9.7,"max_tuv_SVM","SVM",21,13,1384,1360,24,1400,1155,245,0.814500006449038,0.245901639344262,1.22072977260709,617,245,372,21,1.5,50.29,4.7,0,0,0,0,0,0,0.132821612819368,94.6234539931228,15.3012960262567
9.7,"max_tuv_SVM","SVM",21,14,1284,1262,22,1500,1253,247,0.816860352633153,0.245901639344262,1.23125330512956,623,247,376,6,1.5,53.88,5.1,0,0,0,0,0,0,0.121141927692089,77.4216510626414,13.4655374281154
9.7,"max_tuv_SVM","SVM",21,15,1184,1165,19,1600,1350,250,0.809843804413723,0.229508196721311,1.22072977260709,650,250,400,27,1.6,57.47,5.4,0,0,0,0,0,0,0.12414627110464,61.1693031501141,13.934047286499
9.7,"max_tuv_SVM","SVM",21,16,1084,1066,18,1700,1449,251,0.785266538545876,0.229508196721311,1.22072977260709,651,251,400,1,1.6,61.06,5.8,0,0,0,0,0,0,0.0943141470901596,42.8822179134502,10.9413124275149
9.7,"max_tuv_SVM","SVM",21,17,984,967,17,1800,1548,252,0.774625633617525,0.163934426229508,1.22072977260709,662,252,410,11,1.6,64.66,6.1,0,0,0,0,0,0,0.0906261273645035,40.0337812530804,10.8643932042362
9.7,"max_tuv_SVM","SVM",21,18,884,867,17,1900,1648,252,0.790548296810313,0.237704918032787,1.22072977260709,666,252,414,4,1.6,68.25,6.5,0,0,0,0,0,0,0.0681748205319969,27.873352218444,8.239460844297
9.7,"max_tuv_SVM","SVM",21,19,784,768,16,2000,1747,253,0.783048071094147,0.221311475409836,1.22072977260709,666,253,413,0,1.6,71.84,6.9,0,0,0,0,0,0,0.0586080862949202,22.6521972876281,13.292835855304
9.7,"max_tuv_SVM","SVM",21,20,684,668,16,2100,1847,253,0.773019824328338,0.172131147540984,1.22072977260709,670,253,417,4,1.6,75.43,7.3,0,0,0,0,0,0,0.0370248891169768,11.3478664852581,5.05604281413316
9.7,"max_tuv_SVM","SVM",21,21,584,569,15,2200,1946,254,0.782815905895712,0.229508196721311,1.22072977260709,665,254,411,-5,1.6,79.02,7.7,0,0,0,0,0,0,0.0266584290079576,7.70359156456054,4.02102424206634
9.7,"max_tuv_SVM","SVM",21,22,484,471,13,2300,2044,256,0.785214946279551,0.213114754098361,1.22072977260709,688,256,432,23,1.7,82.61,8,0,0,0,0,0,0,0.024630772144912,7.43573185813177,3.47979349425514
9.7,"max_tuv_SVM","SVM",21,23,384,373,11,2400,2142,258,0.779713920883262,0.204918032786885,1.22072977260709,691,258,433,3,1.7,86.21,8.3,0,0,0,0,0,0,0.0109550008206238,3.45470492096248,2.40082330918937
9.7,"max_tuv_SVM","SVM",21,24,284,273,11,2500,2242,258,0.778166152893682,0.204918032786885,1.22072977260709,702,258,444,11,1.7,89.8,8.7,0,0,0,0,0,0,6.00763854019527e-06,0.246311537939205,0.246053584434264
9.7,"max_tuv_SVM","SVM",21,25,184,176,8,2600,2339,261,0.773329377926254,0.204918032786885,1.23125330512956,684,261,423,-18,1.6,93.39,9,0,0,0,0,0,0,0.00340936686319135,0.96823901501372,0.922571804594095
9.7,"max_tuv_SVM","SVM",21,26,84,82,2,2700,2433,267,0.76444905908604,0.155737704918033,1.27334743521946,718,267,451,34,1.7,96.98,9.1,0,0,0,0,0,0,2.01659608481727e-09,0.623387343062438,0.623387343062438
9.7,"max_tuv_SVM","SVM",21,27,0,0,0,2784,2515,269,0.785840502508674,0.163934426229508,1.28387096774194,746,269,477,28,1.8,100,9.3,0,0,0,0,0,0,0,0,0
9.7,"max_tuv_SVM","SVM",22,0,2684,2424,260,100,93,7,0.604743384427669,0.193548387096774,1.10785639958377,24,7,17,0,2.4,3.59,13.3,0,0,0,0,0,0,0.0892993244461188,198.282328035358,9.20064411196073
9.7,"max_tuv_SVM","SVM",22,1,2584,2347,237,200,170,30,0.650372403975699,0.0967741935483871,1.18033298647242,94,30,64,70,2.1,7.18,5.7,0,0,0,0,0,0,0.223888488458912,318.312801234868,27.9154923459503
9.7,"max_tuv_SVM","SVM",22,2,2484,2259,225,300,258,42,0.613945448537076,0.282258064516129,0.962903225806452,119,42,77,25,1.8,10.78,6.1,0,0,0,0,0,0,0.190087566010652,278.077156185602,21.8280690507115
9.7,"max_tuv_SVM","SVM",22,3,2384,2178,206,400,339,61,0.728342103256317,0.185483870967742,1.23210197710718,164,61,103,45,1.7,14.37,5.6,0,0,0,0,0,0,0.18368150139648,283.21873128212,22.8189392437124
9.7,"max_tuv_SVM","SVM",22,4,2284,2098,186,500,419,81,0.759278324309211,0.137096774193548,1.24245577523413,213,81,132,49,1.6,17.96,5.2,0,0,0,0,0,0,0.182185165956709,204.588989264928,26.1587926819606
9.7,"max_tuv_SVM","SVM",22,5,2184,2027,157,600,490,110,0.78570248354051,0.209677419354839,1.24245577523413,287,110,177,74,1.6,21.55,4.5,0,0,0,0,0,0,0.184586920494165,234.360003101264,20.1902813620974
9.7,"max_tuv_SVM","SVM",22,6,2084,1952,132,700,565,135,0.813086250285984,0.225806451612903,1.26316337148803,338,135,203,51,1.5,25.14,4.2,0,0,0,0,0,0,0.19413648472797,172.995965283811,21.2006294276185
9.7,"max_tuv_SVM","SVM",22,7,1984,1875,109,800,642,158,0.813512036401543,0.266129032258065,1.24245577523413,395,158,237,57,1.5,28.74,4.1,0,0,0,0,0,0,0.185417761904306,146.887442064008,20.3005486179375
9.7,"max_tuv_SVM","SVM",22,8,1884,1799,85,900,718,182,0.820744045349405,0.274193548387097,1.24245577523413,456,182,274,61,1.5,32.33,3.9,0,0,0,0,0,0,0.192269027375073,139.030477985439,21.6249068720698
9.7,"max_tuv_SVM","SVM",22,9,1784,1714,70,1000,803,197,0.829183507460796,0.266129032258065,1.24245577523413,498,197,301,42,1.5,35.92,4.1,0,0,0,0,0,0,0.177369527138736,117.956314617458,19.5539552325875
9.7,"max_tuv_SVM","SVM",22,10,1684,1632,52,1100,885,215,0.831903454587055,0.258064516129032,1.24245577523413,541,215,326,43,1.5,39.51,4.1,0,0,0,0,0,0,0.173421917872367,102.077231802654,19.6052575225121
9.7,"max_tuv_SVM","SVM",22,11,1584,1549,35,1200,968,232,0.832691476651675,0.241935483870968,1.24245577523413,579,232,347,38,1.5,43.1,4.2,0,0,0,0,0,0,0.165581398003945,87.4975317372543,18.7857550679233
9.7,"max_tuv_SVM","SVM",22,12,1484,1455,29,1300,1062,238,0.832488116118868,0.330645161290323,1.24245577523413,605,238,367,26,1.5,46.7,4.5,0,0,0,0,0,0,0.152514684344698,75.1474760603452,18.0792787464692
9.7,"max_tuv_SVM","SVM",22,13,1384,1361,23,1400,1156,244,0.825694603319866,0.298387096774194,1.24245577523413,618,244,374,13,1.5,50.29,4.7,0,0,0,0,0,0,0.132265044639901,59.149417403835,16.1862611144675
9.7,"max_tuv_SVM","SVM",22,14,1284,1263,21,1500,1254,246,0.826838506316892,0.274193548387097,1.24245577523413,634,246,388,16,1.6,53.88,5.1,0,0,0,0,0,0,0.116856449051661,52.3918890949594,14.0461615192862
9.7,"max_tuv_SVM","SVM",22,15,1184,1166,18,1600,1351,249,0.794313531101454,0.209677419354839,1.23210197710718,655,249,406,21,1.6,57.47,5.4,0,0,0,0,0,0,0.143943621708762,62.9832824215021,19.8935895868705
9.7,"max_tuv_SVM","SVM",22,16,1084,1067,17,1700,1450,250,0.816892905259414,0.290322580645161,1.24245577523413,664,250,414,9,1.7,61.06,5.8,0,0,0,0,0,0,0.0857273653250581,34.0893721844076,11.8192081597643
9.7,"max_tuv_SVM","SVM",22,17,984,967,17,1800,1550,250,0.825275172220956,0.330645161290323,1.23210197710718,673,250,423,9,1.7,64.66,6.2,0,0,0,0,0,0,0.0728735432015008,30.2127467005716,9.55329133593696
9.7,"max_tuv_SVM","SVM",22,18,884,867,17,1900,1650,250,0.768690103968077,0.217741935483871,1.24245577523413,672,250,422,-1,1.7,68.25,6.6,0,0,0,0,0,0,0.0277905230228512,8.67740766747266,5.19402804913968
9.7,"max_tuv_SVM","SVM",22,19,784,769,15,2000,1748,252,0.790220900378759,0.217741935483871,1.24245577523413,665,252,413,-7,1.6,71.84,6.9,0,0,0,0,0,0,0.0269558047233151,9.21389519535232,4.84785112645299
9.7,"max_tuv_SVM","SVM",22,20,684,669,15,2100,1848,252,0.780078293805134,0.17741935483871,1.24245577523413,662,252,410,-3,1.6,75.43,7.3,0,0,0,0,0,0,0.00633312214659548,2.97740479785266,2.2448430434662
9.7,"max_tuv_SVM","SVM",22,21,584,574,10,2200,1943,257,0.782486845115539,0.193548387096774,1.26316337148803,718,257,461,56,1.8,79.02,7.6,0,0,0,0,0,0,0.0546736163494834,16.1807313815743,9.56303685570462
9.7,"max_tuv_SVM","SVM",22,22,484,475,9,2300,2042,258,0.817502986857828,0.225806451612903,1.27234450187132,722,258,464,4,1.8,82.61,7.9,0,0,0,0,0,0,0.0311694028033667,9.32329485319383,6.96184871600337
9.7,"max_tuv_SVM","SVM",22,23,384,382,2,2400,2135,265,0.81278756450342,0.225806451612903,1.27351716961498,737,265,472,15,1.8,86.21,8.1,0,0,0,0,0,0,0.00951016905752205,3.63286713794001,2.88310096560026
9.7,"max_tuv_SVM","SVM",22,24,284,282,2,2500,2235,265,0.795451079081829,0.209677419354839,1.27351716961498,725,265,460,-12,1.7,89.8,8.4,0,0,0,0,0,0,0.000977548456745524,1.45306048888107,1.41037468532073
9.7,"max_tuv_SVM","SVM",22,25,184,183,1,2600,2334,266,0.775045120618218,0.209677419354839,1.27351716961498,738,266,472,13,1.8,93.39,8.8,0,0,0,0,0,0,0.00231943481247856,2.20373359193131,2.11330147851482
9.7,"max_tuv_SVM","SVM",22,26,84,83,1,2700,2434,266,0.774041027987496,0.153225806451613,1.27351716961498,751,266,485,13,1.8,96.98,9.2,0,0,0,0,0,0,1.74885593897708e-06,1.03050122433059,1.03050122433059
9.7,"max_tuv_SVM","SVM",22,27,0,0,0,2784,2517,267,0.704301075268819,0.137096774193548,1.27351716961498,730,267,463,-21,1.7,100,9.4,0,0,0,0,0,0,0,0,0
9.7,"max_tuv_SVM","SVM",23,0,2684,2445,239,100,86,14,0.578093423407817,0.123188405797101,1.1164095371669,33,14,19,0,1.4,3.59,6.1,0,0,0,0,0,0,0.180977851696623,294.994491374387,36.1257215369034
9.7,"max_tuv_SVM","SVM",23,1,2584,2363,221,200,168,32,0.70894970841273,0.101449275362319,1.24665731650304,95,32,63,62,2,7.18,5.2,0,0,0,0,0,0,0.241543311050699,324.505559463305,32.4249722275925
9.7,"max_tuv_SVM","SVM",23,2,2484,2277,207,300,254,46,0.740267913851841,0.195652173913043,1.24665731650304,125,46,79,30,1.7,10.78,5.5,0,0,0,0,0,0,0.17008276859807,307.126723237761,17.6946480026148
9.7,"max_tuv_SVM","SVM",23,3,2384,2201,183,400,330,70,0.734355332294013,0.195652173913043,1.20014025245442,174,70,104,49,1.5,14.37,4.7,0,0,0,0,0,0,0.178052731322388,284.28852570878,18.379478618415
9.7,"max_tuv_SVM","SVM",23,4,2284,2123,161,500,408,92,0.738674288353836,0.231884057971014,1.21874707807387,220,92,128,46,1.4,17.96,4.4,0,0,0,0,0,0,0.171942864282706,217.971506605119,18.3833674547695
9.7,"max_tuv_SVM","SVM",23,5,2184,2040,144,600,491,109,0.742173335642939,0.246376811594203,1.20014025245442,265,109,156,45,1.4,21.55,4.5,0,0,0,0,0,0,0.17242538624859,225.546122122031,18.1153414901361
9.7,"max_tuv_SVM","SVM",23,6,2084,1956,128,700,575,125,0.788994745655062,0.289855072463768,1.23735390369331,300,125,175,35,1.4,25.14,4.6,0,0,0,0,0,0,0.181570568607303,158.042329460162,18.7339911501049
9.7,"max_tuv_SVM","SVM",23,7,1984,1888,96,800,643,157,0.789468214100124,0.282608695652174,1.21874707807387,370,157,213,70,1.4,28.74,4.1,0,0,0,0,0,0,0.199734557225801,161.127882297023,20.4055189179107
9.7,"max_tuv_SVM","SVM",23,8,1884,1808,76,900,723,177,0.797442115595592,0.282608695652174,1.20944366526414,417,177,240,47,1.4,32.33,4.1,0,0,0,0,0,0,0.189313394818508,133.664571229674,19.780987958972
9.7,"max_tuv_SVM","SVM",23,9,1784,1731,53,1000,800,200,0.786153934984703,0.253623188405797,1.20944366526414,469,200,269,52,1.3,35.92,4,0,0,0,0,0,0,0.177717146721182,117.830019544975,18.8236139616622
9.7,"max_tuv_SVM","SVM",23,10,1684,1645,39,1100,886,214,0.783370864368618,0.282608695652174,1.20014025245442,499,214,285,30,1.3,39.51,4.1,0,0,0,0,0,0,0.153252101197787,88.2899483428872,16.6633824145209
9.7,"max_tuv_SVM","SVM",23,11,1584,1556,28,1200,975,225,0.785114614007745,0.27536231884058,1.20944366526414,547,225,322,48,1.4,43.1,4.3,0,0,0,0,0,0,0.160999308989448,92.9941537421463,17.2268231157766
9.7,"max_tuv_SVM","SVM",23,12,1484,1464,20,1300,1067,233,0.78201974709857,0.268115942028986,1.20944366526414,561,233,328,14,1.4,46.7,4.6,0,0,0,0,0,0,0.164705066820803,94.9313922384278,17.4787476408185
9.7,"max_tuv_SVM","SVM",23,13,1384,1367,17,1400,1164,236,0.781442346555814,0.268115942028986,1.20944366526414,577,236,341,16,1.4,50.29,4.9,0,0,0,0,0,0,0.158759429220699,107.264741434669,16.4710020981172
9.7,"max_tuv_SVM","SVM",23,14,1284,1270,14,1500,1261,239,0.766256712281317,0.210144927536232,1.20944366526414,601,239,362,24,1.5,53.88,5.3,0,0,0,0,0,0,0.119981590382514,46.377680264016,13.6087305562451
9.7,"max_tuv_SVM","SVM",23,15,1184,1171,13,1600,1360,240,0.752012240891513,0.202898550724638,1.20944366526414,599,240,359,-2,1.5,57.47,5.7,0,0,0,0,0,0,0.10820377617252,42.4858439679125,11.9812659740426
9.7,"max_tuv_SVM","SVM",23,16,1084,1071,13,1700,1460,240,0.787585888330744,0.253623188405797,1.20944366526414,595,240,355,-4,1.5,61.06,6.1,0,0,0,0,0,0,0.0941810215686103,29.3008303161161,10.9079777591692
9.7,"max_tuv_SVM","SVM",23,17,984,972,12,1800,1559,241,0.747970437092217,0.181159420289855,1.20944366526414,617,241,376,22,1.6,64.66,6.5,0,0,0,0,0,0,0.117522583328754,26.9522455712122,14.8638034429494
9.7,"max_tuv_SVM","SVM",23,18,884,872,12,1900,1659,241,0.774415381950467,0.260869565217391,1.20944366526414,614,241,373,-3,1.5,68.25,6.9,0,0,0,0,0,0,0.0722830116499051,14.4669455779411,9.18178733918541
9.7,"max_tuv_SVM","SVM",23,19,784,773,11,2000,1758,242,0.756308100929621,0.202898550724638,1.20944366526414,617,242,375,3,1.5,71.84,7.3,0,0,0,0,0,0,0.00169856167203519,3.02003313085049,2.92772479403635
9.7,"max_tuv_SVM","SVM",23,20,684,677,7,2100,1854,246,0.790605693169357,0.260869565217391,1.20944366526414,625,246,379,8,1.5,75.43,7.5,0,0,0,0,0,0,0.0110100818768861,4.44871256086333,2.00756524501511
9.7,"max_tuv_SVM","SVM",23,21,584,581,3,2200,1950,250,0.764027946186267,0.181159420289855,1.25596072931276,652,250,402,27,1.6,79.02,7.8,0,0,0,0,0,0,0.121423256329426,47.2591967854223,13.7136786485295
9.7,"max_tuv_SVM","SVM",23,22,484,481,3,2300,2050,250,0.76815058606155,0.210144927536232,1.24665731650304,649,250,399,-3,1.6,82.61,8.2,0,0,0,0,0,0,0.0871017729739769,25.5580826079469,10.8519796107062
9.7,"max_tuv_SVM","SVM",23,23,384,382,2,2400,2149,251,0.797286217449044,0.289855072463768,1.24665731650304,665,251,414,16,1.6,86.21,8.6,0,0,0,0,0,0,0.0808836600892688,22.7935084465236,9.94538711795793
9.7,"max_tuv_SVM","SVM",23,24,284,282,2,2500,2249,251,0.809376984814367,0.282608695652174,1.25596072931276,668,251,417,3,1.7,89.8,9,0,0,0,0,0,0,0.0305376975968822,6.95440494413667,4.69572634388512
9.7,"max_tuv_SVM","SVM",23,25,184,184,0,2600,2347,253,0.782845429874706,0.22463768115942,1.25596072931276,671,253,418,3,1.7,93.39,9.3,0,0,0,0,0,0,0.00496752042450852,1.51076107231807,1.33241345208091
9.7,"max_tuv_SVM","SVM",23,26,84,84,0,2700,2447,253,0.808077833593164,0.27536231884058,1.25596072931276,671,253,418,0,1.7,96.98,9.7,0,0,0,0,0,0,0.000302042569742312,0.270564215283502,0.270564215283502
9.7,"max_tuv_SVM","SVM",23,27,0,0,0,2784,2531,253,0.775142906634333,0.217391304347826,1.25596072931276,672,253,419,1,1.7,100,10,0,0,0,0,0,0,0,0,0
9.7,"max_tuv_SVM","SVM",24,0,2684,2448,236,100,86,14,0.835474588176653,0.340425531914894,1.27476549988561,38,14,24,0,1.7,3.59,6.1,0,0,0,0,0,0,0.316951063565,329.056064919568,36.5525314066679
9.7,"max_tuv_SVM","SVM",24,1,2584,2367,217,200,167,33,0.827402397299073,0.340425531914894,1.25655456417296,83,33,50,45,1.5,7.18,5.1,0,0,0,0,0,0,0.225779598947048,300.612766077936,24.6854756451264
9.7,"max_tuv_SVM","SVM",24,2,2484,2294,190,300,240,60,0.699448258672647,0.184397163120567,1.201921757035,150,60,90,67,1.5,10.78,4,0,0,0,0,0,0,0.232268209078676,424.366150317629,26.4814034046856
9.7,"max_tuv_SVM","SVM",24,3,2384,2202,182,400,332,68,0.847500736410398,0.347517730496454,1.28387096774194,162,68,94,12,1.4,14.37,4.9,0,0,0,0,0,0,0.214060817024113,220.075506203306,23.5633147236389
9.7,"max_tuv_SVM","SVM",24,4,2284,2128,156,500,406,94,0.83397344390819,0.269503546099291,1.28387096774194,230,94,136,68,1.4,17.96,4.3,0,0,0,0,0,0,0.223677668763839,196.175102858183,23.8625941725281
9.7,"max_tuv_SVM","SVM",24,5,2184,2053,131,600,481,119,0.813994063399269,0.290780141843972,1.26566003202928,295,119,176,65,1.5,21.55,4,0,0,0,0,0,0,0.2145624526051,192.474570632238,29.5160821962805
9.7,"max_tuv_SVM","SVM",24,6,2084,1967,117,700,567,133,0.815619830965489,0.297872340425532,1.25655456417296,326,133,193,31,1.5,25.14,4.3,0,0,0,0,0,0,0.204154439768713,159.490923818062,22.0425704214431
9.7,"max_tuv_SVM","SVM",24,7,1984,1887,97,800,647,153,0.810102417691977,0.283687943262411,1.25655456417296,369,153,216,43,1.4,28.74,4.2,0,0,0,0,0,0,0.188492128179761,96.9291783887416,20.7457962582712
9.7,"max_tuv_SVM","SVM",24,8,1884,1819,65,900,715,185,0.809643577368407,0.319148936170213,1.24744909631663,446,185,261,77,1.4,32.33,3.9,0,0,0,0,0,0,0.185760579010241,104.507215967773,21.1834914846611
9.7,"max_tuv_SVM","SVM",24,9,1784,1735,49,1000,799,201,0.80969455962658,0.304964539007092,1.24744909631663,488,201,287,42,1.4,35.92,4,0,0,0,0,0,0,0.154904429589698,91.1076287348116,18.5531913979278
9.7,"max_tuv_SVM","SVM",24,10,1684,1647,37,1100,887,213,0.798829673940135,0.290780141843972,1.22923816060398,512,213,299,24,1.4,39.51,4.2,0,0,0,0,0,0,0.150746840174593,78.4388957680611,18.1141330309624
9.7,"max_tuv_SVM","SVM",24,11,1584,1555,29,1200,979,221,0.782294428205652,0.25531914893617,1.22923816060398,539,221,318,27,1.4,43.1,4.4,0,0,0,0,0,0,0.135231715633193,64.3902637980052,16.6455455509928
9.7,"max_tuv_SVM","SVM",24,12,1484,1459,25,1300,1075,225,0.785846192191785,0.226950354609929,1.21102722489133,554,225,329,15,1.5,46.7,4.8,0,0,0,0,0,0,0.12012125312569,60.9168240295461,14.981230920983
9.7,"max_tuv_SVM","SVM",24,13,1384,1368,16,1400,1166,234,0.786622255455105,0.24822695035461,1.21102722489133,590,234,356,36,1.5,50.29,5,0,0,0,0,0,0,0.118589576938974,47.18827802281,14.9622298801042
9.7,"max_tuv_SVM","SVM",24,14,1284,1271,13,1500,1263,237,0.761612625473009,0.24113475177305,1.17460535346603,597,237,360,7,1.5,53.88,5.3,0,0,0,0,0,0,0.136028827160196,76.6787569747649,15.9750006232899
9.7,"max_tuv_SVM","SVM",24,15,1184,1171,13,1600,1363,237,0.757647338726129,0.24113475177305,1.17460535346603,606,237,369,9,1.6,57.47,5.8,0,0,0,0,0,0,0.0852967102312006,34.8205504003134,10.7077099904135
9.7,"max_tuv_SVM","SVM",24,16,1084,1071,13,1700,1463,237,0.755806312736508,0.212765957446809,1.17460535346603,611,237,374,5,1.6,61.06,6.2,0,0,0,0,0,0,0.086322338420889,43.7514115762407,10.4185227558465
9.7,"max_tuv_SVM","SVM",24,17,984,973,11,1800,1561,239,0.737339405886759,0.198581560283688,1.1654998856097,628,239,389,17,1.6,64.66,6.5,0,0,0,0,0,0,0.120263336919105,52.9805459226313,14.4298784945858
9.7,"max_tuv_SVM","SVM",24,18,884,874,10,1900,1660,240,0.759743276006625,0.25531914893617,1.1654998856097,623,240,383,-5,1.6,68.25,6.9,0,0,0,0,0,0,0.103787337195424,58.1932014891933,11.9950629857775
9.7,"max_tuv_SVM","SVM",24,19,784,774,10,2000,1760,240,0.724299277184878,0.170212765957447,1.1654998856097,625,240,385,2,1.6,71.84,7.3,0,0,0,0,0,0,0.0211856481864725,6.53411251492678,3.96751120638973
9.7,"max_tuv_SVM","SVM",24,20,684,675,9,2100,1859,241,0.707752702059688,0.148936170212766,1.1654998856097,632,241,391,7,1.6,75.43,7.7,0,0,0,0,0,0,0.024883057145151,8.10382922235539,5.31149544766521
9.7,"max_tuv_SVM","SVM",24,21,584,575,9,2200,1959,241,0.76178256633359,0.25531914893617,1.1654998856097,628,241,387,-4,1.6,79.02,8.1,0,0,0,0,0,0,0.0123799764470231,4.34975380494949,2.91598988560508
9.7,"max_tuv_SVM","SVM",24,22,484,475,9,2300,2059,241,0.726684113928358,0.191489361702128,1.1654998856097,637,241,396,9,1.6,82.61,8.5,0,0,0,0,0,0,0.00275248522034471,1.53915950064787,1.50898020025102
9.7,"max_tuv_SVM","SVM",24,23,384,375,9,2400,2159,241,0.726389549770018,0.205673758865248,1.1654998856097,642,241,401,5,1.7,86.21,9,0,0,0,0,0,0,1.66120039059518e-05,1.41273865616573,1.41194309127772
9.7,"max_tuv_SVM","SVM",24,24,284,278,6,2500,2256,244,0.696706546121951,0.120567375886525,1.18371082132235,656,244,412,14,1.7,89.8,9.2,0,0,0,0,0,0,0.0540302754599727,14.6856271718129,12.072134696429
9.7,"max_tuv_SVM","SVM",24,25,184,178,6,2600,2356,244,0.712329775904655,0.177304964539007,1.18371082132235,647,244,403,-9,1.7,93.39,9.7,0,0,0,0,0,0,0.00432593492291561,2.90392006720849,2.83617944247291
9.7,"max_tuv_SVM","SVM",24,26,84,81,3,2700,2453,247,0.734388099608003,0.184397163120567,1.22013269274766,668,247,421,21,1.7,96.98,9.9,0,0,0,0,0,0,1.62681681159135e-07,1.86012283993032,1.86012283993032
9.7,"max_tuv_SVM","SVM",24,27,0,0,0,2784,2534,250,0.759363741417988,0.219858156028369,1.27476549988561,675,250,425,7,1.7,100,10.1,0,0,0,0,0,0,0,0,0
9.7,"max_tuv_SVM","SVM",25,0,2684,2430,254,100,88,12,0.813943217665624,0.336,1.20170322580645,29,12,17,0,1.4,3.59,7.3,0,0,0,0,0,0,0.32114626399617,316.509080911727,35.3364925230176
9.7,"max_tuv_SVM","SVM",25,1,2584,2368,216,200,150,50,0.811356466876982,0.328,1.23138121546961,105,50,55,76,1.1,7.18,3,0,0,0,0,0,0,0.417568658615172,388.034550432047,49.3359435909031
9.7,"max_tuv_SVM","SVM",25,2,2484,2301,183,300,217,83,0.803268138801265,0.264,1.24278709677419,178,83,95,73,1.1,10.78,2.6,0,0,0,0,0,0,0.309968864672756,437.635387312525,33.8196012496179
9.7,"max_tuv_SVM","SVM",25,3,2384,2218,166,400,300,100,0.781028391167197,0.288,1.19143225806452,226,100,126,48,1.3,14.37,3,0,0,0,0,0,0,0.267931033617818,386.469267825609,27.7093365132279
9.7,"max_tuv_SVM","SVM",25,4,2284,2156,128,500,362,138,0.76377917981073,0.296,1.21197419354839,313,138,175,87,1.3,17.96,2.6,0,0,0,0,0,0,0.269488081201086,362.860473498866,28.1521767399945
9.7,"max_tuv_SVM","SVM",25,5,2184,2083,101,600,435,165,0.771198738170349,0.272,1.20170322580645,376,165,211,63,1.3,21.55,2.6,0,0,0,0,0,0,0.238306834700369,232.813933963718,25.3375000946443
9.7,"max_tuv_SVM","SVM",25,6,2084,2001,83,700,517,183,0.76107255520505,0.28,1.19143225806452,413,183,230,37,1.3,25.14,2.8,0,0,0,0,0,0,0.231989407407732,272.024255451841,25.2165827560168
9.7,"max_tuv_SVM","SVM",25,7,1984,1909,75,800,609,191,0.741236593059939,0.232,1.24278709677419,437,191,246,24,1.3,28.74,3.2,0,0,0,0,0,0,0.246343613543015,115.346599870389,26.1805310591467
9.7,"max_tuv_SVM","SVM",25,8,1884,1809,75,900,709,191,0.815652996845426,0.224,NA,450,191,259,13,1.4,32.33,3.7,0,0,0,0,0,0,0.107114864563517,27.5710107067535,16.989584847837
9.7,"max_tuv_SVM","SVM",25,9,1784,1718,66,1000,800,200,0.816309148264991,0.256,1.2736,494,200,294,44,1.5,35.92,4,0,0,0,0,0,0,0.0717728529024856,17.8815537732654,10.7071716826988
9.7,"max_tuv_SVM","SVM",25,10,1684,1625,59,1100,893,207,0.807924290220828,0.248,1.2736,512,207,305,18,1.5,39.51,4.3,0,0,0,0,0,0,0.133816755656877,35.2311701012973,18.5911257670962
9.7,"max_tuv_SVM","SVM",25,11,1584,1537,47,1200,981,219,0.812561514195591,0.232,1.2736,545,219,326,33,1.5,43.1,4.5,0,0,0,0,0,0,0.0944816183852414,24.3228744201691,15.5959881895027
9.7,"max_tuv_SVM","SVM",25,12,1484,1446,38,1300,1072,228,0.82366561514196,0.24,1.2736,571,228,343,26,1.5,46.7,4.7,0,0,0,0,0,0,0.0109624370259382,6.25110832571004,5.69471545657833
9.7,"max_tuv_SVM","SVM",25,13,1384,1352,32,1400,1166,234,0.808145110410102,0.224,1.2736,577,234,343,6,1.5,50.29,5,0,0,0,0,0,0,0.0897715589663984,34.3550798084903,26.2704815235253
9.7,"max_tuv_SVM","SVM",25,14,1284,1258,26,1500,1260,240,0.810302839116727,0.232,1.2736,602,240,362,25,1.5,53.88,5.2,0,0,0,0,0,0,0.0996417046141448,30.3229638135059,18.5255622429346
9.7,"max_tuv_SVM","SVM",25,15,1184,1160,24,1600,1358,242,0.805394321766569,0.232,1.2736,612,242,370,10,1.5,57.47,5.6,0,0,0,0,0,0,0.045033460024682,13.4478296995724,9.43004157248963
9.7,"max_tuv_SVM","SVM",25,16,1084,1061,23,1700,1457,243,0.805394321766568,0.208,1.2736,620,243,377,8,1.6,61.06,6,0,0,0,0,0,0,0.00256054492478755,0.992924029006491,0.847497549022284
9.7,"max_tuv_SVM","SVM",25,17,984,965,19,1800,1553,247,0.814018927444791,0.208,1.28387096774194,642,247,395,22,1.6,64.66,6.3,0,0,0,0,0,0,0.0626523301410817,20.8012652075797,9.52517992657445
9.7,"max_tuv_SVM","SVM",25,18,884,872,12,1900,1646,254,0.809059936908518,0.184,1.28387096774194,672,254,418,30,1.6,68.25,6.5,0,0,0,0,0,0,0.0672598684725634,20.3581380761114,11.2543743913531
9.7,"max_tuv_SVM","SVM",25,19,784,778,6,2000,1740,260,0.828725552050472,0.272,1.28387096774194,709,260,449,37,1.7,71.84,6.7,0,0,0,0,0,0,0.0681454801842282,18.8883917630814,10.2350660027224
9.7,"max_tuv_SVM","SVM",25,20,684,679,5,2100,1839,261,0.807072555205051,0.256,1.28387096774194,699,261,438,-10,1.7,75.43,7,0,0,0,0,0,0,0.0758504630650866,23.3699240135839,10.5341699057109
9.7,"max_tuv_SVM","SVM",25,21,584,580,4,2200,1938,262,0.762940063091481,0.168,1.28387096774194,719,262,457,20,1.7,79.02,7.4,0,0,0,0,0,0,0.0558452887816,13.4733190252563,7.87387024462756
9.7,"max_tuv_SVM","SVM",25,22,484,481,3,2300,2037,263,0.839413249211357,0.28,1.28387096774194,739,263,476,20,1.8,82.61,7.7,0,0,0,0,0,0,0.0155093055516784,4.26737985441081,3.10759247050305
9.7,"max_tuv_SVM","SVM",25,23,384,381,3,2400,2137,263,0.827003154574132,0.28,1.28387096774194,737,263,474,-2,1.8,86.21,8.1,0,0,0,0,0,0,0.00257174597618188,0.821223864823101,0.691516984342958
9.7,"max_tuv_SVM","SVM",25,24,284,283,1,2500,2235,265,0.825993690851742,0.24,1.28387096774194,750,265,485,13,1.8,89.8,8.4,0,0,0,0,0,0,0.0365178902546076,10.416045214511,8.40430108706037
9.7,"max_tuv_SVM","SVM",25,25,184,183,1,2600,2335,265,0.744971608832809,0.168,1.28387096774194,735,265,470,-15,1.8,93.39,8.8,0,0,0,0,0,0,0.00329828623194151,1.65064759582497,1.57706806853275
9.7,"max_tuv_SVM","SVM",25,26,84,84,0,2700,2434,266,0.780126182965301,0.2,1.28387096774194,741,266,475,6,1.8,96.98,9.2,0,0,0,0,0,0,1.0000000994736e-07,0.274955415596937,0.274955415596937
9.7,"max_tuv_SVM","SVM",25,27,0,0,0,2784,2518,266,0.751520504731866,0.184,1.2736,738,266,472,-3,1.8,100,9.5,0,0,0,0,0,0,0,0,0
9.7,"max_tuv_SVM","SVM",26,0,2684,2422,262,100,90,10,0.831068691212756,0.361344537815126,1.24071564109515,28,10,18,0,1.8,3.59,9,0,0,0,0,0,0,0.226464990463438,241.189537199361,24.6187433604977
9.7,"max_tuv_SVM","SVM",26,1,2584,2359,225,200,153,47,0.784395076712008,0.100840336134454,1.26229330441854,108,47,61,80,1.3,7.18,3.3,0,0,0,0,0,0,0.301124733218281,476.074642514822,37.5963595375363
9.7,"max_tuv_SVM","SVM",26,2,2484,2271,213,300,241,59,0.801782251362084,0.319327731092437,1.19756031444836,139,59,80,31,1.4,10.78,4.1,0,0,0,0,0,0,0.25091952923785,263.785568504279,26.1304858758592
9.7,"max_tuv_SVM","SVM",26,3,2384,2202,182,400,310,90,0.787402873237211,0.319327731092437,1.17598265112497,204,90,114,65,1.3,14.37,3.4,0,0,0,0,0,0,0.251535588478557,262.296452555432,25.9891383568893
9.7,"max_tuv_SVM","SVM",26,4,2284,2127,157,500,385,115,0.788148226323502,0.327731092436975,1.16519381946327,271,115,156,67,1.4,17.96,3.3,0,0,0,0,0,0,0.244834117934281,255.499720851531,25.5571875659124
9.7,"max_tuv_SVM","SVM",26,5,2184,2058,126,600,454,146,0.798226983100935,0.336134453781513,1.17598265112497,343,146,197,72,1.3,21.55,3.1,0,0,0,0,0,0,0.237128333924609,193.360931812592,25.5627371097387
9.7,"max_tuv_SVM","SVM",26,6,2084,1987,97,700,525,175,0.806960146696044,0.319327731092437,1.19756031444836,405,175,230,62,1.3,25.14,3,0,0,0,0,0,0,0.240280576147565,210.753122870026,27.2414247681876
9.7,"max_tuv_SVM","SVM",26,7,1984,1904,80,800,608,192,0.783319921375146,0.252100840336134,1.25150447275684,451,192,259,46,1.3,28.74,3.2,0,0,0,0,0,0,0.236582374470282,202.55586816869,35.9504412990827
9.7,"max_tuv_SVM","SVM",26,8,1884,1811,73,900,701,199,0.803200401039543,0.327731092436975,1.22992680943345,476,199,277,25,1.4,32.33,3.5,0,0,0,0,0,0,0.198864401124718,173.92898291138,21.6308250907191
9.7,"max_tuv_SVM","SVM",26,9,1784,1726,58,1000,786,214,0.771869187235337,0.26890756302521,1.20834914611006,510,214,296,34,1.4,35.92,3.7,0,0,0,0,0,0,0.194316602125103,192.49370535729,21.1051708571776
9.7,"max_tuv_SVM","SVM",26,10,1684,1627,57,1100,885,215,0.787429257417256,0.294117647058824,1.22992680943345,524,215,309,14,1.4,39.51,4.1,0,0,0,0,0,0,0.145687183265243,90.8515936684707,16.5621922715979
9.7,"max_tuv_SVM","SVM",26,11,1584,1539,45,1200,973,227,0.759211376858438,0.252100840336134,1.17598265112497,567,227,340,43,1.5,43.1,4.3,0,0,0,0,0,0,0.142875927443259,92.4527470807194,16.0119832450012
9.7,"max_tuv_SVM","SVM",26,12,1484,1440,44,1300,1072,228,0.754660105800564,0.168067226890756,1.17598265112497,562,228,334,-5,1.5,46.7,4.7,0,0,0,0,0,0,0.114410901617843,72.9692108586645,12.8390003224864
9.7,"max_tuv_SVM","SVM",26,13,1384,1343,41,1400,1169,231,0.722220756434444,0.176470588235294,1.16519381946327,583,231,352,21,1.5,50.29,5.1,0,0,0,0,0,0,0.143318097305656,91.752475021485,18.5045677480389
9.7,"max_tuv_SVM","SVM",26,14,1284,1243,41,1500,1269,231,0.735993298418269,0.159663865546218,1.17598265112497,581,231,350,-2,1.5,53.88,5.5,0,0,0,0,0,0,0.0903301453781374,46.0240209920132,10.8503316273329
9.7,"max_tuv_SVM","SVM",26,15,1184,1150,34,1600,1362,238,0.759013495508096,0.210084033613445,1.16519381946327,607,238,369,26,1.6,57.47,5.7,0,0,0,0,0,0,0.119080747754671,76.8870847676411,13.232908799388
9.7,"max_tuv_SVM","SVM",26,16,1084,1060,24,1700,1452,248,0.783465034365398,0.285714285714286,1.18677148278666,636,248,388,29,1.6,61.06,5.9,0,0,0,0,0,0,0.103716753973871,60.7611523740416,13.2112878321154
9.7,"max_tuv_SVM","SVM",26,17,984,972,12,1800,1540,260,0.782620740603936,0.260504201680672,1.18677148278666,691,260,431,55,1.7,64.66,5.9,0,0,0,0,0,0,0.0605081746429256,22.6245943080055,7.98155494668271
9.7,"max_tuv_SVM","SVM",26,18,884,874,10,1900,1638,262,0.803642336055301,0.310924369747899,1.22992680943345,689,262,427,-2,1.6,68.25,6.3,0,0,0,0,0,0,0.0901140786689914,52.278750891612,10.0035015308424
9.7,"max_tuv_SVM","SVM",26,19,784,776,8,2000,1736,264,0.79007427146683,0.252100840336134,1.25150447275684,696,264,432,7,1.6,71.84,6.6,0,0,0,0,0,0,0.0119701894348293,4.03157787814204,2.18434191255591
9.7,"max_tuv_SVM","SVM",26,20,684,680,4,2100,1832,268,0.798952548052191,0.277310924369748,1.27308213608024,727,268,459,31,1.7,75.43,6.8,0,0,0,0,0,0,0.0477387761605596,17.6109668978806,7.9999660987081
9.7,"max_tuv_SVM","SVM",26,21,584,582,2,2200,1930,270,0.818199807395491,0.26890756302521,1.26229330441854,734,270,464,7,1.7,79.02,7.1,0,0,0,0,0,0,0.0275973515885594,7.9638803444721,4.02641070590465
9.7,"max_tuv_SVM","SVM",26,22,484,484,0,2300,2028,272,0.810225188976694,0.260504201680672,1.26229330441854,742,272,470,8,1.7,82.61,7.5,0,0,0,0,0,0,0.0195201339625397,5.5876425127006,2.97014230611873
9.7,"max_tuv_SVM","SVM",26,23,384,384,0,2400,2128,272,0.826576784559983,0.285714285714286,1.26229330441854,733,272,461,-9,1.7,86.21,7.8,0,0,0,0,0,0,0.00760262320747667,1.9644391380862,1.29515113765815
9.7,"max_tuv_SVM","SVM",26,24,284,284,0,2500,2228,272,0.834986741949533,0.285714285714286,1.26229330441854,740,272,468,7,1.7,89.8,8.2,0,0,0,0,0,0,0.000271876937044701,0.123510658512266,0.112851681623802
9.7,"max_tuv_SVM","SVM",26,25,184,184,0,2600,2328,272,0.783458438320388,0.176470588235294,1.26229330441854,757,272,485,17,1.8,93.39,8.6,0,0,0,0,0,0,8.62508642951371e-05,0.0644763633652286,0.0607618439218664
9.7,"max_tuv_SVM","SVM",26,26,84,84,0,2700,2428,272,0.777436249224969,0.168067226890756,1.26229330441854,747,272,475,-10,1.7,96.98,8.9,0,0,0,0,0,0,1.0000000994736e-07,0.0021316583185046,0.0021316583185046
9.7,"max_tuv_SVM","SVM",26,27,0,0,0,2784,2512,272,0.823509623629676,0.302521008403361,1.26229330441854,732,272,460,-15,1.7,100,9.2,0,0,0,0,0,0,0,0,0
9.7,"max_tuv_SVM","SVM",27,0,2684,2437,247,100,90,10,0.811328583452874,0.328358208955224,1.2263842079923,28,10,18,0,1.8,3.59,9,0,0,0,0,0,0,0.162386059357641,310.308061663603,17.4113007074869
9.7,"max_tuv_SVM","SVM",27,1,2584,2376,208,200,151,49,0.765123943428212,0.216417910447761,1.23596533461724,109,49,60,81,1.2,7.18,3.1,0,0,0,0,0,0,0.277042258368961,457.557629757275,29.8895998257904
9.7,"max_tuv_SVM","SVM",27,2,2484,2301,183,300,226,74,0.796077199388285,0.291044776119403,1.24554646124218,165,74,91,56,1.2,10.78,3.1,0,0,0,0,0,0,0.261683455574831,285.88730432184,28.6467842952834
9.7,"max_tuv_SVM","SVM",27,3,2384,2224,160,400,303,97,0.731770061527161,0.201492537313433,1.16889744824266,215,97,118,50,1.2,14.37,3.1,0,0,0,0,0,0,0.246668043176902,405.439228082549,43.8080978542775
9.7,"max_tuv_SVM","SVM",27,4,2284,2133,151,500,394,106,0.784388225670692,0.253731343283582,1.23596533461724,237,106,131,22,1.2,17.96,3.7,0,0,0,0,0,0,0.196525856000564,176.746569851274,26.8311307391805
9.7,"max_tuv_SVM","SVM",27,5,2184,2065,119,600,462,138,0.794749445781418,0.276119402985075,1.26470871449206,314,138,176,77,1.3,21.55,3.3,0,0,0,0,0,0,0.214861972237697,171.092607234144,22.6926282732276
9.7,"max_tuv_SVM","SVM",27,6,2084,1988,96,700,539,161,0.800576150225839,0.283582089552239,1.26470871449206,356,161,195,42,1.2,25.14,3.3,0,0,0,0,0,0,0.194768662901488,108.528546908077,21.0716110969106
9.7,"max_tuv_SVM","SVM",27,7,1984,1907,77,800,620,180,0.802567780636139,0.298507462686567,1.26470871449206,402,180,222,46,1.2,28.74,3.4,0,0,0,0,0,0,0.175045414277646,116.484636371657,19.349774003951
9.7,"max_tuv_SVM","SVM",27,8,1884,1818,66,900,709,191,0.809680746387208,0.283582089552239,1.28387096774194,434,191,243,32,1.3,32.33,3.7,0,0,0,0,0,0,0.168341984935013,88.4400682105574,18.9597781235002
9.7,"max_tuv_SVM","SVM",27,9,1784,1730,54,1000,797,203,0.806053133854163,0.238805970149254,1.274289841117,474,203,271,40,1.3,35.92,3.9,0,0,0,0,0,0,0.144169100350923,66.9924817104561,17.2526533538681
9.7,"max_tuv_SVM","SVM",27,10,1684,1638,46,1100,889,211,0.810996645051157,0.246268656716418,1.274289841117,484,211,273,10,1.3,39.51,4.2,0,0,0,0,0,0,0.10984700624884,50.660907719637,13.4711214294983
9.7,"max_tuv_SVM","SVM",27,11,1584,1548,36,1200,979,221,0.81955591383828,0.246268656716418,1.274289841117,522,221,301,38,1.4,43.1,4.4,0,0,0,0,0,0,0.0841860627473578,38.852123636443,12.2781913877671
9.7,"max_tuv_SVM","SVM",27,12,1484,1457,27,1300,1070,230,0.816058705677338,0.208955223880597,1.26470871449206,550,230,320,28,1.4,46.7,4.7,0,0,0,0,0,0,0.120917236958503,54.538367581512,15.6470223177003
9.7,"max_tuv_SVM","SVM",27,13,1384,1367,17,1400,1160,240,0.813794411579914,0.201492537313433,1.274289841117,575,240,335,25,1.4,50.29,4.8,0,0,0,0,0,0,0.109438193994753,44.5850772797629,13.5889449137229
9.7,"max_tuv_SVM","SVM",27,14,1284,1268,16,1500,1259,241,0.817564283427981,0.201492537313433,1.26470871449206,580,241,339,5,1.4,53.88,5.2,0,0,0,0,0,0,0.0629141385716601,27.4402291864754,8.0327818348989
9.7,"max_tuv_SVM","SVM",27,15,1184,1168,16,1600,1359,241,0.817617630671114,0.201492537313433,1.274289841117,588,241,347,8,1.4,57.47,5.6,0,0,0,0,0,0,0.0451323452347619,20.1943164644417,5.88217956531023
9.7,"max_tuv_SVM","SVM",27,16,1084,1069,15,1700,1458,242,0.791702725451386,0.156716417910448,1.25512758786712,584,242,342,-4,1.4,61.06,6,0,0,0,0,0,0,0.12921864277383,50.4698036546681,15.0255722222576
9.7,"max_tuv_SVM","SVM",27,17,984,970,14,1800,1557,243,0.795721551100739,0.208955223880597,1.25512758786712,600,243,357,16,1.5,64.66,6.4,0,0,0,0,0,0,0.0902948573306231,27.8095528830908,12.000656138268
9.7,"max_tuv_SVM","SVM",27,18,884,871,13,1900,1656,244,0.810682489063824,0.23134328358209,1.26470871449206,597,244,353,-3,1.4,68.25,6.8,0,0,0,0,0,0,0.053052879823079,17.1647471138991,7.50813997553463
9.7,"max_tuv_SVM","SVM",27,19,784,771,13,2000,1756,244,0.814659822412964,0.238805970149254,1.26470871449206,612,244,368,15,1.5,71.84,7.2,0,0,0,0,0,0,0.0261988217850795,8.19386143445992,3.59451336475863
9.7,"max_tuv_SVM","SVM",27,20,684,671,13,2100,1856,244,0.802917501452239,0.201492537313433,1.26470871449206,622,244,378,10,1.5,75.43,7.6,0,0,0,0,0,0,0.00710346490927948,2.21282278995068,1.23257974595169
9.7,"max_tuv_SVM","SVM",27,21,584,571,13,2200,1956,244,0.804263037473483,0.223880597014925,1.26470871449206,611,244,367,-11,1.5,79.02,8,0,0,0,0,0,0,0.00179875971685459,0.567261307192369,0.373820349112364
9.7,"max_tuv_SVM","SVM",27,22,484,473,11,2300,2054,246,0.793605443789794,0.201492537313433,1.24439954921525,608,246,362,-3,1.5,82.61,8.3,0,0,0,0,0,0,0.0281261114042486,9.11369227012395,7.31244293705983
9.7,"max_tuv_SVM","SVM",27,23,384,374,10,2400,2153,247,0.7784429717971,0.156716417910448,1.24554646124218,612,247,365,4,1.5,86.21,8.7,0,0,0,0,0,0,0.00319070079151655,1.30750307780935,1.02767321145266
9.7,"max_tuv_SVM","SVM",27,24,284,275,9,2500,2252,248,0.774086280274568,0.149253731343284,1.24554646124218,622,248,374,10,1.5,89.8,9.1,0,0,0,0,0,0,0.00346448778633596,0.902353632473573,0.653169984186606
9.7,"max_tuv_SVM","SVM",27,25,184,179,5,2600,2348,252,0.782764098490873,0.149253731343284,1.25512758786712,646,252,394,24,1.6,93.39,9.3,0,0,0,0,0,0,0.00782364154997123,1.82781452986094,1.43360815392763
9.7,"max_tuv_SVM","SVM",27,26,84,84,0,2700,2443,257,0.807612058847943,0.23134328358209,1.27311646188945,676,257,419,30,1.6,96.98,9.5,0,0,0,0,0,0,1.33509216192968e-06,1.24964681094642,1.24964681094642
9.7,"max_tuv_SVM","SVM",27,27,0,0,0,2784,2527,257,0.800718409540858,0.17910447761194,1.27311646188945,659,257,402,-17,1.6,100,9.8,0,0,0,0,0,0,0,0,0
9.7,"max_tuv_SVM","SVM",28,0,2684,2438,246,100,90,10,0.807831360772542,0.274074074074074,1.26485065710872,25,10,15,0,1.5,3.59,9,0,0,0,0,0,0,0.140317912229411,268.599981941457,14.8527207654497
9.7,"max_tuv_SVM","SVM",28,1,2584,2360,224,200,168,32,0.81762939409998,0.281481481481481,1.28387096774194,77,32,45,52,1.4,7.18,5.2,0,0,0,0,0,0,0.196934088850966,306.584090833972,23.0099447025239
9.7,"max_tuv_SVM","SVM",28,2,2484,2280,204,300,248,52,0.82732732732733,0.340740740740741,1.27436081242533,124,52,72,47,1.4,10.78,4.8,0,0,0,0,0,0,0.2088187985612,205.896436966052,22.0188586942585
9.7,"max_tuv_SVM","SVM",28,3,2384,2213,171,400,315,85,0.838762291703476,0.348148148148148,1.27436081242533,197,85,112,73,1.3,14.37,3.7,0,0,0,0,0,0,0.245422689660471,163.558355959192,25.1689309811799
9.7,"max_tuv_SVM","SVM",28,4,2284,2140,144,500,388,112,0.83810869693223,0.348148148148148,1.27436081242533,261,112,149,64,1.3,17.96,3.5,0,0,0,0,0,0,0.244132173881026,222.742352630104,24.6923923175458
9.7,"max_tuv_SVM","SVM",28,5,2184,2068,116,600,460,140,0.835394217747162,0.311111111111111,1.26485065710872,318,140,178,57,1.3,21.55,3.3,0,0,0,0,0,0,0.224681461005917,139.358494477406,23.9125965971397
9.7,"max_tuv_SVM","SVM",28,6,2084,1988,96,700,540,160,0.835482541364902,0.318518518518519,1.27436081242533,364,160,204,46,1.3,25.14,3.4,0,0,0,0,0,0,0.209630698230281,114.719262583867,22.3816903403886
9.7,"max_tuv_SVM","SVM",28,7,1984,1903,81,800,625,175,0.832927044691756,0.311111111111111,1.27436081242533,408,175,233,44,1.3,28.74,3.6,0,0,0,0,0,0,0.156247441986734,56.9278818443801,18.9683349828536
9.7,"max_tuv_SVM","SVM",28,8,1884,1825,59,900,703,197,0.848731084025198,0.348148148148148,1.26485065710872,474,197,277,66,1.4,32.33,3.6,0,0,0,0,0,0,0.176919649741325,91.1777344947705,19.7359630721762
9.7,"max_tuv_SVM","SVM",28,9,1784,1738,46,1000,790,210,0.839445327680627,0.303703703703704,1.27436081242533,505,210,295,31,1.4,35.92,3.8,0,0,0,0,0,0,0.17696628932473,89.3556779778929,19.4163391984504
9.7,"max_tuv_SVM","SVM",28,10,1684,1646,38,1100,882,218,0.83296826238003,0.274074074074074,1.26485065710872,521,218,303,16,1.4,39.51,4,0,0,0,0,0,0,0.161435328143738,80.8297412480576,18.0830702411883
9.7,"max_tuv_SVM","SVM",28,11,1584,1557,27,1200,971,229,0.832503091326624,0.266666666666667,1.25534050179211,568,229,339,47,1.5,43.1,4.2,0,0,0,0,0,0,0.157356290400223,97.4808257500465,17.1857270730896
9.7,"max_tuv_SVM","SVM",28,12,1484,1462,22,1300,1066,234,0.825708061002186,0.251851851851852,1.2363201911589,570,234,336,2,1.4,46.7,4.6,0,0,0,0,0,0,0.0989866454307206,46.2735230545897,11.6210228481775
9.7,"max_tuv_SVM","SVM",28,13,1384,1364,20,1400,1164,236,0.822275216392869,0.266666666666667,1.2363201911589,591,236,355,21,1.5,50.29,4.9,0,0,0,0,0,0,0.0946096114100291,40.4263198103663,11.3352114925816
9.7,"max_tuv_SVM","SVM",28,14,1284,1267,17,1500,1261,239,0.810893246187368,0.214814814814815,1.2363201911589,617,239,378,26,1.6,53.88,5.3,0,0,0,0,0,0,0.103477495494595,47.349362356872,11.6844322589085
9.7,"max_tuv_SVM","SVM",28,15,1184,1168,16,1600,1360,240,0.806818583289177,0.259259259259259,1.22681003584229,612,240,372,-5,1.6,57.47,5.7,0,0,0,0,0,0,0.0925100896405532,33.1379431606743,11.8446521816812
9.7,"max_tuv_SVM","SVM",28,16,1084,1069,15,1700,1459,241,0.783948654536894,0.207407407407407,1.22681003584229,633,241,392,21,1.6,61.06,6.1,0,0,0,0,0,0,0.102948799710778,48.9101270115559,11.8723590055342
9.7,"max_tuv_SVM","SVM",28,17,984,969,15,1800,1559,241,0.815804039333457,0.266666666666667,1.22681003584229,613,241,372,-20,1.5,64.66,6.5,0,0,0,0,0,0,0.0180971719880994,5.10127443397568,3.01764383558928
9.7,"max_tuv_SVM","SVM",28,18,884,870,14,1900,1658,242,0.814108225872938,0.259259259259259,1.21729988052569,627,242,385,14,1.6,68.25,6.9,0,0,0,0,0,0,0.0116183480102057,3.25443421502634,2.01011786513906
9.7,"max_tuv_SVM","SVM",28,19,784,771,13,2000,1757,243,0.801265971854213,0.22962962962963,1.21729988052569,629,243,386,2,1.6,71.84,7.2,0,0,0,0,0,0,0.00585809572988857,1.74245477202769,1.07717814494181
9.7,"max_tuv_SVM","SVM",28,20,684,674,10,2100,1854,246,0.800842018489083,0.266666666666667,1.21729988052569,638,246,392,9,1.6,75.43,7.5,0,0,0,0,0,0,0.0130138695635456,4.06921758819156,2.40626538392571
9.7,"max_tuv_SVM","SVM",28,21,584,574,10,2200,1954,246,0.780527586409945,0.2,1.21729988052569,632,246,386,-6,1.6,79.02,7.9,0,0,0,0,0,0,0.00868209407745528,2.58628290293303,1.49534635662542
9.7,"max_tuv_SVM","SVM",28,22,484,476,8,2300,2052,248,0.790084201848916,0.222222222222222,1.19827956989247,644,248,396,12,1.6,82.61,8.3,0,0,0,0,0,0,0.0412631472210052,11.9296397392445,8.04673825201371
9.7,"max_tuv_SVM","SVM",28,23,384,376,8,2400,2152,248,0.809856915739276,0.288888888888889,1.19827956989247,646,248,398,2,1.6,86.21,8.7,0,0,0,0,0,0,0.00391346472616836,1.21186803964017,0.893157550764282
9.7,"max_tuv_SVM","SVM",28,24,284,276,8,2500,2252,248,0.801837131248905,0.303703703703704,1.19827956989247,654,248,406,8,1.6,89.8,9.1,0,0,0,0,0,0,0.00412282885589636,1.05988017940032,0.741946152749459
9.7,"max_tuv_SVM","SVM",28,25,184,178,6,2600,2350,250,0.763928634516875,0.155555555555556,1.19827956989247,651,250,401,-3,1.6,93.39,9.4,0,0,0,0,0,0,0.0013448904075796,0.426956294613725,0.36909091144288
9.7,"max_tuv_SVM","SVM",28,26,84,83,1,2700,2445,255,0.828404875463695,0.266666666666667,1.28387096774194,694,255,439,43,1.7,96.98,9.6,0,0,0,0,0,0,0.001411485563347,1.36798568820879,1.36798568820879
9.7,"max_tuv_SVM","SVM",28,27,0,0,0,2784,2528,256,0.826714950244357,0.274074074074074,1.28387096774194,702,256,446,8,1.7,100,9.9,0,0,0,0,0,0,0,0,0
9.7,"max_tuv_SVM","SVM",29,0,2684,2427,257,100,90,10,0.817000940542466,0.314516129032258,1.27351716961498,32,10,22,0,2.2,3.59,9,0,0,0,0,0,0,0.142093667269999,272.12437717291,14.9902647398781
9.7,"max_tuv_SVM","SVM",29,1,2584,2345,239,200,172,28,0.813289610818783,0.338709677419355,1.23210197710718,75,28,47,43,1.7,7.18,6.1,0,0,0,0,0,0,0.182104917385831,303.659482458203,19.830455150637
9.7,"max_tuv_SVM","SVM",29,2,2484,2270,214,300,247,53,0.834928442512524,0.258064516129032,1.27351716961498,146,53,93,71,1.8,10.78,4.7,0,0,0,0,0,0,0.204394379444041,311.954344144268,22.3096082361965
9.7,"max_tuv_SVM","SVM",29,3,2384,2178,206,400,339,61,0.847384275146802,0.338709677419355,1.27351716961498,173,61,112,27,1.8,14.37,5.6,0,0,0,0,0,0,0.173733127807494,211.85218023283,20.0900255599209
9.7,"max_tuv_SVM","SVM",29,4,2284,2098,186,500,419,81,0.783865883728623,0.233870967741935,1.23210197710718,214,81,133,41,1.6,17.96,5.2,0,0,0,0,0,0,0.175220480378421,274.272900597908,21.4557461816108
9.7,"max_tuv_SVM","SVM",29,5,2184,2001,183,600,516,84,0.840215816365439,0.330645161290323,1.28387096774194,222,84,138,8,1.6,21.55,6.1,0,0,0,0,0,0,0.175354719759659,163.328402734337,17.9318283855948
9.7,"max_tuv_SVM","SVM",29,6,2084,1939,145,700,578,122,0.831617478837795,0.282258064516129,1.28387096774194,306,122,184,84,1.5,25.14,4.7,0,0,0,0,0,0,0.202551542337187,139.287453081498,20.688813843486
9.7,"max_tuv_SVM","SVM",29,7,1984,1873,111,800,644,156,0.846208597066528,0.387096774193548,1.28387096774194,392,156,236,86,1.5,28.74,4.1,0,0,0,0,0,0,0.215353788977962,114.439894568401,22.4804817060929
9.7,"max_tuv_SVM","SVM",29,8,1884,1791,93,900,726,174,0.836657007041361,0.379032258064516,1.28387096774194,440,174,266,48,1.5,32.33,4.2,0,0,0,0,0,0,0.201044285425679,105.945389472732,20.8762635736659
9.7,"max_tuv_SVM","SVM",29,9,1784,1708,76,1000,809,191,0.834267520780907,0.354838709677419,1.27351716961498,472,191,281,32,1.5,35.92,4.2,0,0,0,0,0,0,0.179643086316744,79.1358102152551,19.5149729001948
9.7,"max_tuv_SVM","SVM",29,10,1684,1624,60,1100,893,207,0.810220137776765,0.258064516129032,1.25280957336108,513,207,306,41,1.5,39.51,4.3,0,0,0,0,0,0,0.179649548175497,107.383358687902,19.1427229715369
9.7,"max_tuv_SVM","SVM",29,11,1584,1529,55,1200,988,212,0.813162510485779,0.266129032258065,1.23210197710718,548,212,336,35,1.6,43.1,4.7,0,0,0,0,0,0,0.156484273467229,73.6729726405144,16.8264871465747
9.7,"max_tuv_SVM","SVM",29,12,1484,1433,51,1300,1084,216,0.823781743308175,0.354838709677419,1.23210197710718,569,216,353,21,1.6,46.7,5,0,0,0,0,0,0,0.138591006452255,66.9686249692846,15.8551433394237
9.7,"max_tuv_SVM","SVM",29,13,1384,1335,49,1400,1182,218,0.754327766338749,0.112903225806452,1.23210197710718,572,218,354,3,1.6,50.29,5.4,0,0,0,0,0,0,0.130164250452062,57.5448070759445,13.9447144457294
9.7,"max_tuv_SVM","SVM",29,14,1284,1238,46,1500,1279,221,0.829831719159109,0.395161290322581,1.23210197710718,590,221,369,18,1.7,53.88,5.8,0,0,0,0,0,0,0.118865721085077,58.8594829423266,13.1477280788917
9.7,"max_tuv_SVM","SVM",29,15,1184,1143,41,1600,1374,226,0.792966267571624,0.201612903225806,1.23210197710718,624,226,398,34,1.8,57.47,6.1,0,0,0,0,0,0,0.132921597082202,53.8916168091786,14.3455984923331
9.7,"max_tuv_SVM","SVM",29,16,1084,1048,36,1700,1469,231,0.846640738198736,0.379032258064516,1.23210197710718,640,231,409,16,1.8,61.06,6.4,0,0,0,0,0,0,0.112713008181248,39.9905725721743,12.3500041344116
9.7,"max_tuv_SVM","SVM",29,17,984,954,30,1800,1563,237,0.796328071379547,0.217741935483871,1.23210197710718,652,237,415,12,1.8,64.66,6.6,0,0,0,0,0,0,0.0904960265707919,25.6561836337344,10.5982016181719
9.7,"max_tuv_SVM","SVM",29,18,884,862,22,1900,1655,245,0.769681486565495,0.112903225806452,1.23210197710718,670,245,425,18,1.7,68.25,6.8,0,0,0,0,0,0,0.0511468466770214,11.4315314486016,7.33454627549826
9.7,"max_tuv_SVM","SVM",29,19,784,766,18,2000,1751,249,0.829787234042558,0.290322580645161,1.23210197710718,685,249,436,15,1.8,71.84,7,0,0,0,0,0,0,0.0165409347902972,5.22952082538134,4.44662575331095
9.7,"max_tuv_SVM","SVM",29,20,684,673,11,2100,1844,256,0.833733699382301,0.338709677419355,1.25280957336108,691,256,435,6,1.7,75.43,7.2,0,0,0,0,0,0,0.019656190921117,6.03494947277734,3.73462161234762
9.7,"max_tuv_SVM","SVM",29,21,584,579,5,2200,1938,262,0.836593456874861,0.25,1.27351716961498,702,262,440,11,1.7,79.02,7.4,0,0,0,0,0,0,0.0279391430294023,8.46206243940369,5.20074644879928
9.7,"max_tuv_SVM","SVM",29,22,484,482,2,2300,2035,265,0.86135895676047,0.306451612903226,1.28387096774194,714,265,449,12,1.7,82.61,7.7,0,0,0,0,0,0,0.0623046665465184,16.2310662401863,7.94160467262957
9.7,"max_tuv_SVM","SVM",29,23,384,382,2,2400,2135,265,0.778425989476096,0.112903225806452,1.28387096774194,704,265,439,-10,1.7,86.21,8.1,0,0,0,0,0,0,0.0293357219281873,6.81991638492764,5.10648287023664
9.7,"max_tuv_SVM","SVM",29,24,284,282,2,2500,2235,265,0.812349068354562,0.193548387096774,1.28387096774194,734,265,469,30,1.8,89.8,8.4,0,0,0,0,0,0,0.00174297834402325,1.5469851066307,1.48573610967234
9.7,"max_tuv_SVM","SVM",29,25,184,183,1,2600,2334,266,0.837133633290123,0.25,1.27351716961498,733,266,467,-1,1.8,93.39,8.8,0,0,0,0,0,0,0.00728930145332875,5.05320804815584,4.82395907187317
9.7,"max_tuv_SVM","SVM",29,26,84,84,0,2700,2433,267,0.843755560639572,0.282258064516129,1.28387096774194,730,267,463,-3,1.7,96.98,9.1,0,0,0,0,0,0,1.09989848380594e-06,2.92938734154045,2.92938734154045
9.7,"max_tuv_SVM","SVM",29,27,0,0,0,2784,2517,267,0.835322453544834,0.282258064516129,1.26316337148803,725,267,458,-5,1.7,100,9.4,0,0,0,0,0,0,0,0,0
9.7,"max_tuv_SVM","SVM",30,0,2684,2426,258,100,90,10,0.241501824467063,0,0.469708890637293,31,10,21,0,2.1,3.59,9,0,0,0,0,0,0,0.103110124657613,270.453518887238,10.3559915365574
9.7,"max_tuv_SVM","SVM",30,1,2584,2346,238,200,170,30,0.786358107675571,0.211382113821138,1.25025242892723,81,30,51,50,1.7,7.18,5.7,0,0,0,0,0,0,0.361061458608305,303.384736112017,45.6231084783824
9.7,"max_tuv_SVM","SVM",30,2,2484,2271,213,300,245,55,0.750214454900456,0.121951219512195,1.24211906635195,152,55,97,71,1.8,10.78,4.5,0,0,0,0,0,0,0.211369158640383,411.384944101056,23.2539379404958
9.7,"max_tuv_SVM","SVM",30,3,2384,2176,208,400,340,60,0.80865501568403,0.276422764227642,1.25255704169945,157,60,97,5,1.6,14.37,5.7,0,0,0,0,0,0,0.160331229065346,312.398986944792,16.4482959670515
9.7,"max_tuv_SVM","SVM",30,4,2284,2097,187,500,419,81,0.817073170731716,0.268292682926829,1.25255704169945,214,81,133,57,1.6,17.96,5.2,0,0,0,0,0,0,0.190684485951157,162.009845770856,19.6881371215771
9.7,"max_tuv_SVM","SVM",30,5,2184,2029,155,600,487,113,0.822738621087005,0.268292682926829,1.25255704169945,281,113,168,67,1.5,21.55,4.3,0,0,0,0,0,0,0.21459907656446,145.30773417335,22.5985910181144
9.7,"max_tuv_SVM","SVM",30,6,2084,1970,114,700,546,154,0.827475833813464,0.317073170731707,1.24211906635195,369,154,215,88,1.4,25.14,3.5,0,0,0,0,0,0,0.218348472874889,174.511727570069,23.1893973113057
9.7,"max_tuv_SVM","SVM",30,7,1984,1894,90,800,622,178,0.824134178349666,0.268292682926829,1.26299501704694,433,178,255,64,1.4,28.74,3.5,0,0,0,0,0,0,0.200730412547526,144.93306792173,21.6712250829443
9.7,"max_tuv_SVM","SVM",30,8,1884,1809,75,900,707,193,0.826899686319705,0.292682926829268,1.25255704169945,477,193,284,44,1.5,32.33,3.7,0,0,0,0,0,0,0.174305817504441,97.3332357710784,18.9477386894589
9.7,"max_tuv_SVM","SVM",30,9,1784,1727,57,1000,789,211,0.826899686319696,0.308943089430894,1.24211906635195,524,211,313,47,1.5,35.92,3.7,0,0,0,0,0,0,0.174461366728123,99.0336884441056,19.5073914810191
9.7,"max_tuv_SVM","SVM",30,10,1684,1644,40,1100,872,228,0.821029383522177,0.235772357723577,1.24211906635195,568,228,340,44,1.5,39.51,3.8,0,0,0,0,0,0,0.14326531837143,57.8264980902594,16.8301556161876
9.7,"max_tuv_SVM","SVM",30,11,1584,1559,25,1200,957,243,0.814781384034315,0.227642276422764,1.24211906635195,590,243,347,22,1.4,43.1,3.9,0,0,0,0,0,0,0.187042312408935,173.335785825811,19.5935592559206
9.7,"max_tuv_SVM","SVM",30,12,1484,1462,22,1300,1054,246,0.824735932398693,0.24390243902439,1.24211906635195,623,246,377,33,1.5,46.7,4.3,0,0,0,0,0,0,0.110489799425739,51.355280339122,12.7593942847384
9.7,"max_tuv_SVM","SVM",30,13,1384,1365,19,1400,1151,249,0.814307662761672,0.268292682926829,1.24097531030559,620,249,371,-3,1.5,50.29,4.6,0,0,0,0,0,0,0.0837538835462433,39.1276844583421,11.391946222379
9.7,"max_tuv_SVM","SVM",30,14,1284,1268,16,1500,1248,252,0.809058318929643,0.186991869918699,1.26299501704694,634,252,382,14,1.5,53.88,5,0,0,0,0,0,0,0.101866933999273,43.2502706793679,15.1781435322932
9.7,"max_tuv_SVM","SVM",30,15,1184,1172,12,1600,1344,256,0.797989885410667,0.178861788617886,1.26299501704694,652,256,396,18,1.5,57.47,5.2,0,0,0,0,0,0,0.0878339052565647,32.8047241766394,15.4443282817665
9.7,"max_tuv_SVM","SVM",30,16,1084,1074,10,1700,1442,258,0.804353114397301,0.211382113821138,1.25255704169945,669,258,411,17,1.6,61.06,5.6,0,0,0,0,0,0,0.061454471524461,17.8750651970815,9.19775143660664
9.7,"max_tuv_SVM","SVM",30,17,984,977,7,1800,1539,261,0.787747263299412,0.203252032520325,1.26299501704694,675,261,414,6,1.6,64.66,5.9,0,0,0,0,0,0,0.103679421766691,37.2738867329033,14.5583681527842
9.7,"max_tuv_SVM","SVM",30,18,884,878,6,1900,1638,262,0.819384162345573,0.276422764227642,1.26299501704694,688,262,426,13,1.6,68.25,6.3,0,0,0,0,0,0,0.112315120362059,62.0092740216223,12.392248341322
9.7,"max_tuv_SVM","SVM",30,19,784,780,4,2000,1736,264,0.809903335253836,0.260162601626016,1.26299501704694,711,264,447,23,1.7,71.84,6.6,0,0,0,0,0,0,0.0448922221632998,15.1554078628697,7.65504736069542
9.7,"max_tuv_SVM","SVM",30,20,684,684,0,2100,1832,268,0.801222713014546,0.203252032520325,1.27343299239444,728,268,460,17,1.7,75.43,6.8,0,0,0,0,0,0,0.0252775904508749,8.55092377184363,4.78799569141576
9.7,"max_tuv_SVM","SVM",30,21,584,584,0,2200,1932,268,0.813129761218881,0.284552845528455,1.26299501704694,722,268,454,-6,1.7,79.02,7.2,0,0,0,0,0,0,0.0129691782128719,3.42425709749672,2.05860904514569
9.7,"max_tuv_SVM","SVM",30,22,484,484,0,2300,2032,268,0.796306254401136,0.203252032520325,1.26299501704694,709,268,441,-13,1.6,82.61,7.6,0,0,0,0,0,0,0.00205427238342956,0.618331193002277,0.474431099617925
9.7,"max_tuv_SVM","SVM",30,23,384,384,0,2400,2132,268,0.798732475513741,0.219512195121951,1.26299501704694,720,268,452,11,1.7,86.21,8,0,0,0,0,0,0,0.00276570882447874,1.04786152744519,0.845124691444712
9.7,"max_tuv_SVM","SVM",30,24,284,284,0,2500,2232,268,0.819281736124458,0.292682926829268,1.26299501704694,729,268,461,9,1.7,89.8,8.3,0,0,0,0,0,0,4.02776251507275e-05,0.0315988164333809,0.0296281520462921
9.7,"max_tuv_SVM","SVM",30,25,184,184,0,2600,2332,268,0.754516356187196,0.170731707317073,1.27343299239444,724,268,456,-5,1.7,93.39,8.7,0,0,0,0,0,0,1.56824844183422e-05,0.0153342912770552,0.0148817394267176
9.7,"max_tuv_SVM","SVM",30,26,84,84,0,2700,2432,268,0.779316304974084,0.195121951219512,1.27343299239444,728,268,460,4,1.7,96.98,9.1,0,0,0,0,0,0,1.76452808858163e-07,0.000786318078254075,0.000786318078254075
9.7,"max_tuv_SVM","SVM",30,27,0,0,0,2784,2516,268,0.780410985212225,0.211382113821138,1.26299501704694,730,268,462,2,1.7,100,9.4,0,0,0,0,0,0,0,0,0
9.7,"max_tuv_SVM","SVM",31,0,2684,2415,269,100,94,6,0.543657008613942,0.120689655172414,0.896496106785317,24,6,18,0,3,3.59,15.7,0,0,0,0,0,0,0.165014375208597,199.218822142307,20.017441568775
9.7,"max_tuv_SVM","SVM",31,1,2584,2328,256,200,181,19,0.823218480814403,0.241379310344828,1.27280311457175,57,19,38,33,2,7.18,9.5,0,0,0,0,0,0,0.178824176616214,110.470927901064,21.9503586898086
9.7,"max_tuv_SVM","SVM",31,2,2484,2257,227,300,252,48,0.830252747549477,0.189655172413793,1.28387096774194,136,48,88,79,1.8,10.78,5.2,0,0,0,0,0,0,0.208898051430273,191.176629491818,22.1922097706385
9.7,"max_tuv_SVM","SVM",31,3,2384,2185,199,400,324,76,0.779527718521315,0.120689655172414,1.26173526140156,194,76,118,58,1.6,14.37,4.3,0,0,0,0,0,0,0.248215026187736,257.179868645688,39.1613242066105
9.7,"max_tuv_SVM","SVM",31,4,2284,2097,187,500,412,88,0.778069559581992,0.163793103448276,1.22853170189099,234,88,146,40,1.7,17.96,4.7,0,0,0,0,0,0,0.204143111439809,247.788637674405,25.8395181003171
9.7,"max_tuv_SVM","SVM",31,5,2184,2017,167,600,492,108,0.819910620257602,0.241379310344828,1.27280311457175,284,108,176,50,1.6,21.55,4.6,0,0,0,0,0,0,0.197755815511701,230.996117821166,22.0320178269047
9.7,"max_tuv_SVM","SVM",31,6,2084,1940,144,700,569,131,0.82447411767882,0.21551724137931,1.27280311457175,326,131,195,42,1.5,25.14,4.3,0,0,0,0,0,0,0.199372704991492,192.694832642052,21.8979031527198
9.7,"max_tuv_SVM","SVM",31,7,1984,1877,107,800,632,168,0.818654983393191,0.232758620689655,1.26173526140156,400,168,232,74,1.4,28.74,3.8,0,0,0,0,0,0,0.220639651235435,131.026016328877,25.357224325064
9.7,"max_tuv_SVM","SVM",31,8,1884,1807,77,900,702,198,0.806557664785462,0.206896551724138,1.26173526140156,479,198,281,79,1.4,32.33,3.5,0,0,0,0,0,0,0.20554074279801,98.0840379239839,24.4765463726365
9.7,"max_tuv_SVM","SVM",31,9,1784,1724,60,1000,785,215,0.803101288040396,0.181034482758621,1.26173526140156,522,215,307,43,1.4,35.92,3.7,0,0,0,0,0,0,0.202640660262456,112.099686662202,23.5611572008928
9.7,"max_tuv_SVM","SVM",31,10,1684,1637,47,1100,872,228,0.785542624146028,0.163793103448276,1.25066740823137,570,228,342,48,1.5,39.51,3.8,0,0,0,0,0,0,0.182901638257681,98.4106289571292,22.2834012275873
9.7,"max_tuv_SVM","SVM",31,11,1584,1544,40,1200,965,235,0.832500742580939,0.301724137931034,1.27280311457175,582,235,347,12,1.5,43.1,4.1,0,0,0,0,0,0,0.0930892505510662,28.3054109962004,14.7301253469165
9.7,"max_tuv_SVM","SVM",31,12,1484,1448,36,1300,1061,239,0.819714848918527,0.241379310344828,1.27280311457175,600,239,361,18,1.5,46.7,4.4,0,0,0,0,0,0,0.123890435573837,54.1168558680187,17.6825645840561
9.7,"max_tuv_SVM","SVM",31,13,1384,1359,25,1400,1150,250,0.81838495395997,0.232758620689655,1.27280311457175,636,250,386,36,1.5,50.29,4.6,0,0,0,0,0,0,0.103643641926304,32.6587649900528,17.7474211677276
9.7,"max_tuv_SVM","SVM",31,14,1284,1270,14,1500,1239,261,0.818162179677577,0.189655172413793,1.27280311457175,667,261,406,31,1.6,53.88,4.7,0,0,0,0,0,0,0.0617706496181731,18.9681135897446,11.0472556942035
9.7,"max_tuv_SVM","SVM",31,15,1184,1173,11,1600,1336,264,0.789458050927549,0.146551724137931,1.28268876611418,667,264,403,0,1.5,57.47,5.1,0,0,0,0,0,0,0.104410220567731,49.6164880705967,28.711544047896
9.7,"max_tuv_SVM","SVM",31,16,1084,1073,11,1700,1436,264,0.810047795209675,0.189655172413793,1.28387096774194,657,264,393,-10,1.5,61.06,5.4,0,0,0,0,0,0,0.0280952497943295,12.1708562544945,8.70981770050475
9.7,"max_tuv_SVM","SVM",31,17,984,974,10,1800,1535,265,0.831839170469581,0.28448275862069,1.28268876611418,674,265,409,17,1.5,64.66,5.8,0,0,0,0,0,0,0.0365539139390388,16.4709588080898,9.64803938942729
9.7,"max_tuv_SVM","SVM",31,18,884,875,9,1900,1634,266,0.798882078146516,0.163793103448276,1.28387096774194,679,266,413,5,1.6,68.25,6.1,0,0,0,0,0,0,0.0778382860676627,28.4361479685685,15.433329467281
9.7,"max_tuv_SVM","SVM",31,19,784,778,6,2000,1731,269,0.798213755299329,0.198275862068966,1.28387096774194,699,269,430,20,1.6,71.84,6.4,0,0,0,0,0,0,0.101452112687417,41.9482220131256,18.9760041742167
9.7,"max_tuv_SVM","SVM",31,20,684,678,6,2100,1831,269,0.820065887181702,0.21551724137931,1.28387096774194,713,269,444,14,1.7,75.43,6.8,0,0,0,0,0,0,0.067973868338737,26.1661618411512,11.5611595469655
9.7,"max_tuv_SVM","SVM",31,21,584,579,5,2200,1930,270,0.803621094699324,0.181034482758621,1.28387096774194,714,270,444,1,1.6,79.02,7.1,0,0,0,0,0,0,0.0452731228517543,15.6624228990674,9.59421953324174
9.7,"max_tuv_SVM","SVM",31,22,484,480,4,2300,2029,271,0.794716874139281,0.181034482758621,1.28387096774194,739,271,468,25,1.7,82.61,7.5,0,0,0,0,0,0,0.018265422422871,7.67926344081624,6.09475652596037
9.7,"max_tuv_SVM","SVM",31,23,384,381,3,2400,2128,272,0.753841168687386,0.146551724137931,1.28387096774194,741,272,469,2,1.7,86.21,7.8,0,0,0,0,0,0,0.0171739214620656,8.11593994037327,7.08727280886123
9.7,"max_tuv_SVM","SVM",31,24,284,282,2,2500,2227,273,0.780243296519313,0.172413793103448,1.27280311457175,756,273,483,15,1.8,89.8,8.2,0,0,0,0,0,0,0.00179465934195843,3.81968690299037,3.74618104014664
9.7,"max_tuv_SVM","SVM",31,25,184,182,2,2600,2327,273,0.816440742040877,0.181034482758621,1.27280311457175,747,273,474,-9,1.7,93.39,8.5,0,0,0,0,0,0,2.40411677771627e-05,3.0519158334533,3.05143321844579
9.7,"max_tuv_SVM","SVM",31,26,84,83,1,2700,2426,274,0.834877001593166,0.28448275862069,1.27280311457175,737,274,463,-10,1.7,96.98,8.9,0,0,0,0,0,0,1.32087560576448e-06,6.13636528627852,6.13636528627852
9.7,"max_tuv_SVM","SVM",31,27,0,0,0,2784,2509,275,0.811094159263353,0.21551724137931,1.28387096774194,750,275,475,13,1.7,100,9.1,0,0,0,0,0,0,0,0,0
9.7,"max_tuv_SVM","SVM",32,0,2684,2442,242,100,95,5,0.66098434302998,0.243055555555556,1.15905017921147,23,5,18,0,3.6,3.59,19,0,0,0,0,0,0,0.057320014186431,147.551207981347,5.78019368799974
9.7,"max_tuv_SVM","SVM",32,1,2584,2370,214,200,167,33,0.690452361889512,0.243055555555556,1.20362903225806,90,33,57,67,1.7,7.18,5.1,0,0,0,0,0,0,0.170127908882338,409.09726948646,17.5327898321514
9.7,"max_tuv_SVM","SVM",32,2,2484,2280,204,300,257,43,0.74778711858375,0.340277777777778,1.21254480286738,115,43,72,25,1.7,10.78,6,0,0,0,0,0,0,0.166005840090845,208.334355247881,18.1753535212865
9.7,"max_tuv_SVM","SVM",32,3,2384,2215,169,400,322,78,0.747881638644241,0.347222222222222,1.18579749103943,191,78,113,76,1.4,14.37,4.1,0,0,0,0,0,0,0.206951806846197,194.602994961724,24.4185674893039
9.7,"max_tuv_SVM","SVM",32,4,2284,2141,143,500,396,104,0.773374254959516,0.361111111111111,1.21254480286738,251,104,147,60,1.4,17.96,3.8,0,0,0,0,0,0,0.199487815774786,218.412271199699,21.1001903911561
9.7,"max_tuv_SVM","SVM",32,5,2184,2062,122,600,475,125,0.780396539453778,0.333333333333333,1.2214605734767,303,125,178,52,1.4,21.55,3.8,0,0,0,0,0,0,0.195041548634253,170.245904277154,20.6132085388943
9.7,"max_tuv_SVM","SVM",32,6,2084,1987,97,700,550,150,0.778828618450305,0.305555555555556,1.20362903225806,356,150,206,53,1.4,25.14,3.7,0,0,0,0,0,0,0.208644524162462,217.575374415354,21.7928640248898
9.7,"max_tuv_SVM","SVM",32,7,1984,1904,80,800,633,167,0.770071612845832,0.284722222222222,1.21254480286738,411,167,244,55,1.5,28.74,3.8,0,0,0,0,0,0,0.19498701087747,138.210780107494,20.8577604002792
9.7,"max_tuv_SVM","SVM",32,8,1884,1817,67,900,720,180,0.781614180233074,0.305555555555556,1.2214605734767,445,180,265,34,1.5,32.33,4,0,0,0,0,0,0,0.193737073750421,110.342370167971,20.6272930621949
9.7,"max_tuv_SVM","SVM",32,9,1784,1726,58,1000,811,189,0.767931011475848,0.270833333333333,1.2214605734767,476,189,287,31,1.5,35.92,4.3,0,0,0,0,0,0,0.151900800975472,103.315753405199,17.8519375947168
9.7,"max_tuv_SVM","SVM",32,10,1684,1631,53,1100,906,194,0.764411529223379,0.277777777777778,1.23929211469534,495,194,301,19,1.6,39.51,4.7,0,0,0,0,0,0,0.113064125372641,66.6830203303219,13.0542662144796
9.7,"max_tuv_SVM","SVM",32,11,1584,1532,52,1200,1005,195,0.784911262343207,0.305555555555556,1.24820788530466,492,195,297,-3,1.5,43.1,5.2,0,0,0,0,0,0,0.0705772024825951,28.7755020501466,8.59813454348385
9.7,"max_tuv_SVM","SVM",32,12,1484,1435,49,1300,1102,198,0.786062183079795,0.263888888888889,1.27495519713262,512,198,314,20,1.6,46.7,5.6,0,0,0,0,0,0,0.0548155378903266,23.5846364975146,7.53258817583679
9.7,"max_tuv_SVM","SVM",32,13,1384,1341,43,1400,1196,204,0.785767502891199,0.256944444444444,1.23929211469534,520,204,316,8,1.5,50.29,5.9,0,0,0,0,0,0,0.165658978987524,66.6326753959501,20.0479147549678
9.7,"max_tuv_SVM","SVM",32,14,1284,1256,28,1500,1281,219,0.791394226492304,0.270833333333333,1.24820788530466,560,219,341,40,1.6,53.88,5.8,0,0,0,0,0,0,0.132304042469772,56.7023362979382,14.8658150079799
9.7,"max_tuv_SVM","SVM",32,15,1184,1171,13,1600,1366,234,0.78942042522907,0.243055555555556,1.23929211469534,608,234,374,48,1.6,57.47,5.8,0,0,0,0,0,0,0.117719161021073,40.8949702113974,13.666656035578
9.7,"max_tuv_SVM","SVM",32,16,1084,1071,13,1700,1466,234,0.790971666221864,0.291666666666667,1.24820788530466,608,234,374,0,1.6,61.06,6.3,0,0,0,0,0,0,0.0501803560562597,20.5475752887311,7.60120037273793
9.7,"max_tuv_SVM","SVM",32,17,984,972,12,1800,1565,235,0.789615025353617,0.298611111111111,1.2214605734767,627,235,392,19,1.7,64.66,6.7,0,0,0,0,0,0,0.0764442612960535,39.4616592245555,8.98518908211184
9.7,"max_tuv_SVM","SVM",32,18,884,873,11,1900,1664,236,0.791750066720045,0.284722222222222,1.20362903225806,633,236,397,6,1.7,68.25,7.1,0,0,0,0,0,0,0.0611030687931789,27.8996307068763,8.09364115121622
9.7,"max_tuv_SVM","SVM",32,19,784,774,10,2000,1763,237,0.75563228360466,0.243055555555556,1.19471326164875,637,237,400,4,1.7,71.84,7.4,0,0,0,0,0,0,0.0463757268415541,17.4420532124057,7.41976639371049
9.7,"max_tuv_SVM","SVM",32,20,684,674,10,2100,1863,237,0.755676763633129,0.277777777777778,1.20362903225806,628,237,391,-9,1.6,75.43,7.9,0,0,0,0,0,0,0.0236011679264025,7.68587445312838,3.17195001597693
9.7,"max_tuv_SVM","SVM",32,21,584,576,8,2200,1961,239,0.753880882483762,0.208333333333333,1.23037634408602,643,239,404,15,1.7,79.02,8.2,0,0,0,0,0,0,0.015320050651006,5.48224138672861,2.8592378893654
9.7,"max_tuv_SVM","SVM",32,22,484,478,6,2300,2059,241,0.747753758562403,0.1875,1.23929211469534,652,241,411,9,1.7,82.61,8.5,0,0,0,0,0,0,0.0354282600897791,11.6440249398228,4.73913134141052
9.7,"max_tuv_SVM","SVM",32,23,384,382,2,2400,2155,245,0.758479005426557,0.25,1.24820788530466,654,245,409,2,1.7,86.21,8.8,0,0,0,0,0,0,0.0185585491497265,4.8612419914923,3.23129148130467
9.7,"max_tuv_SVM","SVM",32,24,284,284,0,2500,2253,247,0.738891112890311,0.215277777777778,1.2660394265233,669,247,422,15,1.7,89.8,9.1,0,0,0,0,0,0,0.00608591673929097,1.62843527524243,1.31065061828423
9.7,"max_tuv_SVM","SVM",32,25,184,184,0,2600,2353,247,0.795186148919134,0.270833333333333,1.27495519713262,671,247,424,2,1.7,93.39,9.5,0,0,0,0,0,0,0.00320379039018732,0.691844851169759,0.639361654043055
9.7,"max_tuv_SVM","SVM",32,26,84,84,0,2700,2453,247,0.725207944133083,0.180555555555556,1.27495519713262,675,247,428,4,1.7,96.98,9.9,0,0,0,0,0,0,1.77074080683448e-11,0.000103206766415591,0.000103206766415591
9.7,"max_tuv_SVM","SVM",32,27,0,0,0,2784,2537,247,0.761826127568715,0.236111111111111,1.25712365591398,667,247,420,-8,1.7,100,10.3,0,0,0,0,0,0,0,0,0
9.7,"max_tuv_SVM","SVM",33,0,2684,2435,249,100,90,10,0.80047701439453,0.242424242424242,1.24496578690127,24,10,14,0,1.4,3.59,9,0,0,0,0,0,0,0.254338670694675,194.491031219239,36.5558894136463
9.7,"max_tuv_SVM","SVM",33,1,2584,2376,208,200,149,51,0.56841611996251,0.204545454545455,1.05043988269795,117,51,66,93,1.3,7.18,2.9,0,0,0,0,0,0,0.282377882905611,565.816727011112,33.1674280026858
9.7,"max_tuv_SVM","SVM",33,2,2484,2285,199,300,240,60,0.746106985797701,0.287878787878788,1.17688172043011,136,60,76,19,1.3,10.78,4,0,0,0,0,0,0,0.257962613257706,257.784049136645,27.042317318423
9.7,"max_tuv_SVM","SVM",33,3,2384,2210,174,400,315,85,0.780501285655924,0.287878787878788,1.24496578690127,194,85,109,58,1.3,14.37,3.7,0,0,0,0,0,0,0.249043134121443,280.448272291629,25.567612211283
9.7,"max_tuv_SVM","SVM",33,4,2284,2139,145,500,386,114,0.732451397399848,0.25,1.16715542521994,256,114,142,62,1.2,17.96,3.4,0,0,0,0,0,0,0.246999947804458,223.045486567982,25.564775445586
9.7,"max_tuv_SVM","SVM",33,5,2184,2056,128,600,469,131,0.806707038665795,0.257575757575758,1.2644183773216,285,131,154,29,1.2,21.55,3.6,0,0,0,0,0,0,0.252015358759276,112.086149062325,26.0696489552095
9.7,"max_tuv_SVM","SVM",33,6,2084,1982,102,700,543,157,0.805325258933499,0.272727272727273,1.2644183773216,356,157,199,71,1.3,25.14,3.5,0,0,0,0,0,0,0.234634942164492,86.2841211272085,24.4895611185889
9.7,"max_tuv_SVM","SVM",33,7,1984,1899,85,800,626,174,0.791615600893939,0.257575757575758,1.27414467253177,401,174,227,45,1.3,28.74,3.6,0,0,0,0,0,0,0.205236031225853,67.1604641023134,22.2134648589154
9.7,"max_tuv_SVM","SVM",33,8,1884,1813,71,900,712,188,0.756614519501113,0.234848484848485,1.16715542521994,435,188,247,34,1.3,32.33,3.8,0,0,0,0,0,0,0.20156247146859,126.862666624328,28.2166023185935
9.7,"max_tuv_SVM","SVM",33,9,1784,1723,61,1000,802,198,0.773856727464972,0.196969696969697,1.25469208211144,461,198,263,26,1.3,35.92,4.1,0,0,0,0,0,0,0.173553183773447,46.528908947269,22.0514287847913
9.7,"max_tuv_SVM","SVM",33,10,1684,1629,55,1100,896,204,0.79336986038017,0.212121212121212,1.2644183773216,484,204,280,23,1.4,39.51,4.4,0,0,0,0,0,0,0.101174821732797,34.6311514747073,15.6069034353799
9.7,"max_tuv_SVM","SVM",33,11,1584,1534,50,1200,991,209,0.793051450267947,0.21969696969697,1.2644183773216,502,209,293,18,1.4,43.1,4.7,0,0,0,0,0,0,0.0614789889782179,25.6943553455819,10.9014127814383
9.7,"max_tuv_SVM","SVM",33,12,1484,1443,41,1300,1082,218,0.803649100040846,0.25,1.2644183773216,516,218,298,14,1.4,46.7,5,0,0,0,0,0,0,0.119426556962955,46.6533874556234,14.0981205745069
9.7,"max_tuv_SVM","SVM",33,13,1384,1350,34,1400,1175,225,0.807686299954335,0.25,1.2644183773216,544,225,319,28,1.4,50.29,5.2,0,0,0,0,0,0,0.141044404447687,60.6794549601152,16.9703618463577
9.7,"max_tuv_SVM","SVM",33,14,1284,1263,21,1500,1262,238,0.800867517362353,0.242424242424242,1.2644183773216,598,238,360,54,1.5,53.88,5.3,0,0,0,0,0,0,0.0875222877251614,27.4169783865329,13.3619195243458
9.7,"max_tuv_SVM","SVM",33,15,1184,1168,16,1600,1357,243,0.796379737101378,0.242424242424242,1.24381940956527,615,243,372,17,1.5,57.47,5.6,0,0,0,0,0,0,0.0746298333464882,24.3483770400998,9.84325893411113
9.7,"max_tuv_SVM","SVM",33,16,1084,1068,16,1700,1457,243,0.788215221204902,0.21969696969697,1.25469208211144,602,243,359,-13,1.5,61.06,6,0,0,0,0,0,0,0.0723820114864841,26.7459415038676,8.56937912065039
9.7,"max_tuv_SVM","SVM",33,17,984,969,15,1800,1556,244,0.780687525532878,0.234848484848485,1.22551319648094,623,244,379,21,1.6,64.66,6.4,0,0,0,0,0,0,0.0691393538239349,18.7535414726302,10.7686402134575
9.7,"max_tuv_SVM","SVM",33,18,884,870,14,1900,1655,245,0.78546367721625,0.265151515151515,1.22551319648094,624,245,379,1,1.5,68.25,6.8,0,0,0,0,0,0,0.0377707094338761,12.9097532343804,7.10373916874276
9.7,"max_tuv_SVM","SVM",33,19,784,771,13,2000,1754,246,0.759492225987062,0.212121212121212,1.2352394916911,631,246,385,7,1.6,71.84,7.1,0,0,0,0,0,0,0.0545243186020185,15.2177413357369,7.31620515270897
9.7,"max_tuv_SVM","SVM",33,20,684,671,13,2100,1854,246,0.777719702977428,0.242424242424242,1.23410207042804,632,246,386,1,1.6,75.43,7.5,0,0,0,0,0,0,0.0348239983904312,9.75723689837735,4.571148568892
9.7,"max_tuv_SVM","SVM",33,21,584,572,12,2200,1953,247,0.780357099944722,0.242424242424242,1.2352394916911,639,247,392,7,1.6,79.02,7.9,0,0,0,0,0,0,0.0146490402264144,3.76258641332923,2.0851862386354
9.7,"max_tuv_SVM","SVM",33,22,484,473,11,2300,2052,248,0.782105351692974,0.21969696969697,1.2352394916911,652,248,404,13,1.6,82.61,8.3,0,0,0,0,0,0,0.00145702680011419,0.43685371181397,0.330154176017568
9.7,"max_tuv_SVM","SVM",33,23,384,375,9,2400,2150,250,0.789140412851748,0.227272727272727,1.24496578690127,657,250,407,5,1.6,86.21,8.6,0,0,0,0,0,0,0.00669227439480716,1.70499969978923,1.11678126150208
9.7,"max_tuv_SVM","SVM",33,24,284,279,5,2500,2246,254,0.762448033066587,0.227272727272727,1.25469208211144,697,254,443,40,1.7,89.8,8.8,0,0,0,0,0,0,0.0524679154706039,13.8633813969679,10.132231400795
9.7,"max_tuv_SVM","SVM",33,25,184,182,2,2600,2343,257,0.788629755124592,0.234848484848485,1.27414467253177,700,257,443,3,1.7,93.39,9.1,0,0,0,0,0,0,0.00259443188838318,1.43917388542261,1.35873003970676
9.7,"max_tuv_SVM","SVM",33,26,84,84,0,2700,2441,259,0.756986999255033,0.21969696969697,1.27414467253177,706,259,447,6,1.7,96.98,9.4,0,0,0,0,0,0,4.82768134346354e-05,1.40214690058599,1.40214690058599
9.7,"max_tuv_SVM","SVM",33,27,0,0,0,2784,2525,259,0.769927666834874,0.204545454545455,1.27414467253177,730,259,471,24,1.8,100,9.7,0,0,0,0,0,0,0,0,0
9.7,"max_tuv_SVM","SVM",34,0,2684,2419,265,100,93,7,0.560822131050223,0.151260504201681,1.02493900786121,25,7,18,0,2.6,3.59,13.3,0,0,0,0,0,0,0.0981832472085971,197.67858377182,11.5211136319976
9.7,"max_tuv_SVM","SVM",34,1,2584,2343,241,200,169,31,0.803925965990797,0.243697478991597,1.26229330441854,79,31,48,54,1.5,7.18,5.5,0,0,0,0,0,0,0.222857884812345,273.813631008021,25.874679268937
9.7,"max_tuv_SVM","SVM",34,2,2484,2267,217,300,245,55,0.815515217075846,0.235294117647059,1.26229330441854,129,55,74,50,1.3,10.78,4.5,0,0,0,0,0,0,0.206089170755988,313.21916054392,21.6169215967882
9.7,"max_tuv_SVM","SVM",34,3,2384,2194,190,400,318,82,0.816742081447969,0.327731092436975,1.26229330441854,188,82,106,59,1.3,14.37,3.9,0,0,0,0,0,0,0.221852760858209,351.04095721061,22.7375301662991
9.7,"max_tuv_SVM","SVM",34,4,2284,2122,162,500,390,110,0.804229384061321,0.294117647058824,1.26229330441854,253,110,143,65,1.3,17.96,3.5,0,0,0,0,0,0,0.226327739191603,232.590322749495,23.1549699002978
9.7,"max_tuv_SVM","SVM",34,5,2184,2058,126,600,454,146,0.802844214608927,0.252100840336134,1.26229330441854,336,146,190,83,1.3,21.55,3.1,0,0,0,0,0,0,0.248021674623173,255.975750840592,25.371930994313
9.7,"max_tuv_SVM","SVM",34,6,2084,1986,98,700,526,174,0.804486629816767,0.235294117647059,1.26229330441854,401,174,227,65,1.3,25.14,3,0,0,0,0,0,0,0.239553606269693,207.646046032849,25.0020447278606
9.7,"max_tuv_SVM","SVM",34,7,1984,1915,69,800,597,203,0.801775655317077,0.226890756302521,1.25150447275684,464,203,261,63,1.3,28.74,2.9,0,0,0,0,0,0,0.231551672703161,248.025566196861,24.673528630011
9.7,"max_tuv_SVM","SVM",34,8,1884,1831,53,900,681,219,0.794823423875051,0.218487394957983,1.25150447275684,510,219,291,46,1.3,32.33,3.1,0,0,0,0,0,0,0.184251450909007,138.911004545498,21.1912097379915
9.7,"max_tuv_SVM","SVM",34,9,1784,1735,49,1000,777,223,0.810554991227266,0.235294117647059,1.25997077763948,526,223,303,16,1.4,35.92,3.5,0,0,0,0,0,0,0.160347547021333,60.9528129140132,18.4472275142303
9.7,"max_tuv_SVM","SVM",34,10,1684,1648,36,1100,864,236,0.813951954408143,0.243697478991597,1.26229330441854,563,236,327,37,1.4,39.51,3.7,0,0,0,0,0,0,0.173901894161334,99.3920410308874,19.2001173544765
9.7,"max_tuv_SVM","SVM",34,11,1584,1555,29,1200,957,243,0.816016516496713,0.235294117647059,1.26229330441854,589,243,346,26,1.4,43.1,3.9,0,0,0,0,0,0,0.179570874090116,90.8470850982585,19.1134365926936
9.7,"max_tuv_SVM","SVM",34,12,1484,1457,27,1300,1055,245,0.80721739245149,0.184873949579832,1.26229330441854,606,245,361,17,1.5,46.7,4.3,0,0,0,0,0,0,0.144433335994344,61.3567147827979,16.0449850152352
9.7,"max_tuv_SVM","SVM",34,13,1384,1358,26,1400,1154,246,0.809097265279739,0.210084033613445,1.26229330441854,608,246,362,2,1.5,50.29,4.7,0,0,0,0,0,0,0.119903776772631,43.7696878360402,13.816087806366
9.7,"max_tuv_SVM","SVM",34,14,1284,1260,24,1500,1252,248,0.792838014326612,0.201680672268908,1.26229330441854,622,248,374,14,1.5,53.88,5,0,0,0,0,0,0,0.137130852610744,68.6574073698719,14.7071129280193
9.7,"max_tuv_SVM","SVM",34,15,1184,1161,23,1600,1351,249,0.803602759785235,0.226890756302521,1.26229330441854,634,249,385,12,1.5,57.47,5.4,0,0,0,0,0,0,0.107455144877957,44.7784676644323,12.1673000810957
9.7,"max_tuv_SVM","SVM",34,16,1084,1063,21,1700,1449,251,0.789295938155485,0.19327731092437,1.26229330441854,639,251,388,5,1.5,61.06,5.8,0,0,0,0,0,0,0.0735123788555673,26.7454803939723,10.1794054923304
9.7,"max_tuv_SVM","SVM",34,17,984,965,19,1800,1547,253,0.815825231191379,0.26890756302521,1.26229330441854,656,253,403,17,1.6,64.66,6.1,0,0,0,0,0,0,0.0422116299261927,12.4830670190586,5.67404709311752
9.7,"max_tuv_SVM","SVM",34,18,884,867,17,1900,1645,255,0.810350513831913,0.243697478991597,1.26229330441854,657,255,402,1,1.6,68.25,6.5,0,0,0,0,0,0,0.00801268651577227,2.38212193404837,1.3533226066299
9.7,"max_tuv_SVM","SVM",34,19,784,772,12,2000,1740,260,0.821814440061743,0.285714285714286,1.27308213608024,679,260,419,22,1.6,71.84,6.7,0,0,0,0,0,0,0.0740197903312285,25.1541831941459,9.54743397370697
9.7,"max_tuv_SVM","SVM",34,20,684,673,11,2100,1839,261,0.777284540189706,0.201680672268908,1.27308213608024,672,261,411,-7,1.6,75.43,7,0,0,0,0,0,0,0.0533078792774257,14.5179684534466,7.07461212034538
9.7,"max_tuv_SVM","SVM",34,21,584,578,6,2200,1934,266,0.813193409231828,0.201680672268908,1.27308213608024,686,266,420,14,1.6,79.02,7.3,0,0,0,0,0,0,0.0463400783094462,12.3173302370282,7.60596749090909
9.7,"max_tuv_SVM","SVM",34,22,484,483,1,2300,2029,271,0.820475442924426,0.26890756302521,1.27308213608024,729,271,458,43,1.7,82.61,7.5,0,0,0,0,0,0,0.00408136365843867,2.37576124696823,2.13804437819462
9.7,"max_tuv_SVM","SVM",34,23,384,384,0,2400,2128,272,0.819683917523058,0.19327731092437,1.27308213608024,740,272,468,11,1.7,86.21,7.8,0,0,0,0,0,0,0.0914678672319394,23.9342985364944,12.9054027540095
9.7,"max_tuv_SVM","SVM",34,24,284,284,0,2500,2228,272,0.824564990831502,0.260504201680672,1.27308213608024,767,272,495,27,1.8,89.8,8.2,0,0,0,0,0,0,0.00622365132739017,3.77435907503321,3.60612215877328
9.7,"max_tuv_SVM","SVM",34,25,184,184,0,2600,2328,272,0.801617350236801,0.218487394957983,1.27308213608024,748,272,476,-19,1.8,93.39,8.6,0,0,0,0,0,0,0.00657856231411634,1.73820955351888,1.44962858837418
9.7,"max_tuv_SVM","SVM",34,26,84,84,0,2700,2428,272,0.820343522024198,0.235294117647059,1.27308213608024,745,272,473,-3,1.7,96.98,8.9,0,0,0,0,0,0,1.51954808865442e-06,0.0437556762175644,0.0437556762175644
9.7,"max_tuv_SVM","SVM",34,27,0,0,0,2784,2512,272,0.809756869780883,0.277310924369748,1.27308213608024,713,272,441,-32,1.6,100,9.2,0,0,0,0,0,0,0,0,0
9.7,"max_tuv_SVM","SVM",35,0,2684,2441,243,100,92,8,0.736797400524457,0.135714285714286,1.27470046082949,26,8,18,0,2.2,3.59,11.5,0,0,0,0,0,0,0.137982529761683,221.928344076295,15.1554750128756
9.7,"max_tuv_SVM","SVM",35,1,2584,2358,226,200,175,25,0.692669022916434,0.114285714285714,1.16465437788018,74,25,49,48,2,7.18,7,0,0,0,0,0,0,0.164479436151296,266.497569808055,19.6668498724212
9.7,"max_tuv_SVM","SVM",35,2,2484,2263,221,300,270,30,0.745946870368257,0.142857142857143,1.27470046082949,101,30,71,27,2.4,10.78,9,0,0,0,0,0,0,0.113561965103869,224.483458233069,11.7917942540329
9.7,"max_tuv_SVM","SVM",35,3,2384,2176,208,400,357,43,0.78514992589215,0.228571428571429,1.26552995391705,138,43,95,37,2.2,14.37,8.3,0,0,0,0,0,0,0.127971162640933,163.56212852852,13.1270950382076
9.7,"max_tuv_SVM","SVM",35,4,2284,2110,174,500,423,77,0.792908448295516,0.235714285714286,1.27470046082949,222,77,145,84,1.9,17.96,5.5,0,0,0,0,0,0,0.193238964178805,155.92023838509,19.7349022049569
9.7,"max_tuv_SVM","SVM",35,5,2184,2030,154,600,503,97,0.79158020750199,0.207142857142857,1.27470046082949,260,97,163,38,1.7,21.55,5.2,0,0,0,0,0,0,0.18138781273823,196.059743602118,18.3250114023807
9.7,"max_tuv_SVM","SVM",35,6,2084,1960,124,700,573,127,0.798529244099871,0.257142857142857,1.27470046082949,329,127,202,69,1.6,25.14,4.5,0,0,0,0,0,0,0.197048959854985,98.5238269743478,20.8739809301396
9.7,"max_tuv_SVM","SVM",35,7,1984,1895,89,800,638,162,0.789978337703794,0.221428571428571,1.27470046082949,417,162,255,88,1.6,28.74,3.9,0,0,0,0,0,0,0.19286697942344,107.337550522319,21.37449048783
9.7,"max_tuv_SVM","SVM",35,8,1884,1812,72,900,721,179,0.79319347850872,0.228571428571429,1.27470046082949,453,179,274,36,1.5,32.33,4,0,0,0,0,0,0,0.179556820673583,107.813525302186,19.3342104427187
9.7,"max_tuv_SVM","SVM",35,9,1784,1726,58,1000,807,193,0.793655227454107,0.178571428571429,1.27470046082949,509,193,316,56,1.6,35.92,4.2,0,0,0,0,0,0,0.193648742034819,79.297889016515,26.5675845752417
9.7,"max_tuv_SVM","SVM",35,10,1684,1647,37,1100,886,214,0.811384106715306,0.25,1.27470046082949,574,214,360,65,1.7,39.51,4.1,0,0,0,0,0,0,0.172091736779371,83.4921319258139,19.3379324983759
9.7,"max_tuv_SVM","SVM",35,11,1584,1560,24,1200,973,227,0.793467107513392,0.178571428571429,1.27470046082949,572,227,345,-2,1.5,43.1,4.3,0,0,0,0,0,0,0.160853922759421,76.0388628041873,17.9256304207287
9.7,"max_tuv_SVM","SVM",35,12,1484,1464,20,1300,1069,231,0.79851784289134,0.2,1.27470046082949,601,231,370,29,1.6,46.7,4.6,0,0,0,0,0,0,0.13630213078432,72.9332069591526,16.5598034689051
9.7,"max_tuv_SVM","SVM",35,13,1384,1365,19,1400,1168,232,0.784539961235889,0.192857142857143,1.27470046082949,608,232,376,7,1.6,50.29,5,0,0,0,0,0,0,0.0892450408747355,34.4281317912981,12.794064203299
9.7,"max_tuv_SVM","SVM",35,14,1284,1268,16,1500,1265,235,0.805609394595829,0.207142857142857,1.27470046082949,618,235,383,10,1.6,53.88,5.4,0,0,0,0,0,0,0.061358749682382,23.083081445059,10.0758752800386
9.7,"max_tuv_SVM","SVM",35,15,1184,1173,11,1600,1360,240,0.802417056207959,0.242857142857143,1.28387096774194,649,240,409,31,1.7,57.47,5.7,0,0,0,0,0,0,0.117104847288615,52.4036844899023,18.6256891213695
9.7,"max_tuv_SVM","SVM",35,16,1084,1075,9,1700,1458,242,0.74212746551135,0.178571428571429,1.28387096774194,651,242,409,2,1.7,61.06,6,0,0,0,0,0,0,0.118805461477966,51.2367118434139,15.8271129294649
9.7,"max_tuv_SVM","SVM",35,17,984,978,6,1800,1555,245,0.810221183445442,0.264285714285714,1.27470046082949,647,245,402,-4,1.6,64.66,6.3,0,0,0,0,0,0,0.0978509655681511,47.2335294781974,13.2716672147748
9.7,"max_tuv_SVM","SVM",35,18,884,878,6,1900,1655,245,0.802206133850193,0.242857142857143,1.27470046082949,673,245,428,26,1.7,68.25,6.8,0,0,0,0,0,0,0.0659043594182659,23.3996889714364,9.82790811000974
9.7,"max_tuv_SVM","SVM",35,19,784,778,6,2000,1755,245,0.808339984038309,0.178571428571429,1.27470046082949,639,245,394,-34,1.6,71.84,7.2,0,0,0,0,0,0,0.0522056322674542,18.8802268040448,8.15841540609499
9.7,"max_tuv_SVM","SVM",35,20,684,681,3,2100,1852,248,0.788997833770386,0.2,1.27470046082949,688,248,440,49,1.8,75.43,7.5,0,0,0,0,0,0,0.0396500314718337,14.2627162849682,7.39799184263018
9.7,"max_tuv_SVM","SVM",35,21,584,582,2,2200,1951,249,0.737891916543156,0.135714285714286,1.28387096774194,688,249,439,0,1.8,79.02,7.8,0,0,0,0,0,0,0.0129923180801332,6.06198280142485,4.74344780737253
9.7,"max_tuv_SVM","SVM",35,22,484,482,2,2300,2051,249,0.802981416030104,0.242857142857143,1.28387096774194,677,249,428,-11,1.7,82.61,8.2,0,0,0,0,0,0,0.0100063302996963,4.51755728897934,3.60643183144562
9.7,"max_tuv_SVM","SVM",35,23,384,382,2,2400,2151,249,0.841945046174895,0.321428571428571,1.28387096774194,671,249,422,-6,1.7,86.21,8.6,0,0,0,0,0,0,0.00205790576005092,2.54244269499497,2.43633138069439
9.7,"max_tuv_SVM","SVM",35,24,284,283,1,2500,2250,250,0.788627294493216,0.221428571428571,1.27470046082949,677,250,427,6,1.7,89.8,9,0,0,0,0,0,0,0.0323931925721159,13.9573760829724,12.097124423661
9.7,"max_tuv_SVM","SVM",35,25,184,184,0,2600,2349,251,0.786164633451149,0.25,1.28387096774194,705,251,454,28,1.8,93.39,9.4,0,0,0,0,0,0,0.00760171784433812,5.91080934212768,5.63895184080718
9.7,"max_tuv_SVM","SVM",35,26,84,84,0,2700,2449,251,0.757638809713833,0.171428571428571,1.25635944700461,687,251,436,-18,1.7,96.98,9.8,0,0,0,0,0,0,7.32916964047027e-07,2.25609783031857,2.25609783031857
9.7,"max_tuv_SVM","SVM",35,27,0,0,0,2784,2533,251,0.741848135902406,0.164285714285714,1.24718894009217,692,251,441,5,1.8,100,10.1,0,0,0,0,0,0,0,0,0
9.7,"max_tuv_SVM","SVM",36,0,2684,2439,245,100,91,9,0.693267934353062,0.313868613138686,1.09644454909348,24,9,15,0,1.7,3.59,10.1,0,0,0,0,0,0,0.130595800046316,241.561598015512,13.7280291621433
9.7,"max_tuv_SVM","SVM",36,1,2584,2371,213,200,159,41,0.739481147426657,0.153284671532847,1.28387096774194,105,41,64,81,1.6,7.18,3.9,0,0,0,0,0,0,0.264117388228074,491.067304172092,31.9644047795842
9.7,"max_tuv_SVM","SVM",36,2,2484,2283,201,300,247,53,0.705338462968995,0.182481751824818,1.20890040028255,131,53,78,26,1.5,10.78,4.7,0,0,0,0,0,0,0.214714043108981,414.765422643583,23.435908355722
9.7,"max_tuv_SVM","SVM",36,3,2384,2189,195,400,341,59,0.742491515179695,0.262773722627737,1.2276430421474,152,59,93,21,1.6,14.37,5.8,0,0,0,0,0,0,0.176586137012712,319.410619347466,18.437633815104
9.7,"max_tuv_SVM","SVM",36,4,2284,2112,172,500,418,82,0.768591054907255,0.233576642335766,1.25575700494467,214,82,132,62,1.6,17.96,5.1,0,0,0,0,0,0,0.194319899483648,264.772658297911,21.1337221690983
9.7,"max_tuv_SVM","SVM",36,5,2184,2042,142,600,488,112,0.794946301548199,0.277372262773723,1.25575700494467,286,112,174,72,1.6,21.55,4.4,0,0,0,0,0,0,0.207749578105774,248.456239389092,21.3056739915944
9.7,"max_tuv_SVM","SVM",36,6,2084,1965,119,700,565,135,0.791819703379988,0.328467153284672,1.25575700494467,327,135,192,41,1.4,25.14,4.2,0,0,0,0,0,0,0.20222648995568,199.503188497505,21.2626360487059
9.7,"max_tuv_SVM","SVM",36,7,1984,1889,95,800,641,159,0.806900599748947,0.321167883211679,1.26512832587709,379,159,220,52,1.4,28.74,4,0,0,0,0,0,0,0.188486041071722,156.972007892269,20.5068914060162
9.7,"max_tuv_SVM","SVM",36,8,1884,1801,83,900,729,171,0.806848296062119,0.343065693430657,1.26512832587709,413,171,242,34,1.4,32.33,4.3,0,0,0,0,0,0,0.1750976421309,137.137695376467,19.0775200209687
9.7,"max_tuv_SVM","SVM",36,9,1784,1719,65,1000,811,189,0.822527779069232,0.343065693430657,1.25575700494467,458,189,269,45,1.4,35.92,4.3,0,0,0,0,0,0,0.150208598954944,102.711992519383,17.0111202087999
9.7,"max_tuv_SVM","SVM",36,10,1684,1624,60,1100,906,194,0.822766051420339,0.343065693430657,1.26512832587709,484,194,290,26,1.5,39.51,4.7,0,0,0,0,0,0,0.117794107930763,70.572243026996,13.391843503464
9.7,"max_tuv_SVM","SVM",36,11,1584,1532,52,1200,998,202,0.816693012227446,0.306569343065693,1.27449964680951,520,202,318,36,1.6,43.1,4.9,0,0,0,0,0,0,0.143098519502498,70.9995506365758,16.5740211040103
9.7,"max_tuv_SVM","SVM",36,12,1484,1435,49,1300,1095,205,0.819360500255714,0.328467153284672,1.27449964680951,522,205,317,2,1.5,46.7,5.3,0,0,0,0,0,0,0.117039623381342,58.4144728741669,13.9148701581988
9.7,"max_tuv_SVM","SVM",36,13,1384,1347,37,1400,1183,217,0.812485471198109,0.27007299270073,1.26512832587709,552,217,335,30,1.5,50.29,5.5,0,0,0,0,0,0,0.152073412844725,189.792910286994,15.3253587267227
9.7,"max_tuv_SVM","SVM",36,14,1284,1261,23,1500,1269,231,0.828850713654749,0.328467153284672,1.24638568401224,608,231,377,56,1.6,53.88,5.5,0,0,0,0,0,0,0.126576590816752,62.3333807892315,13.9987547705422
9.7,"max_tuv_SVM","SVM",36,15,1184,1168,16,1600,1362,238,0.826560974475809,0.299270072992701,1.26512832587709,634,238,396,26,1.7,57.47,5.7,0,0,0,0,0,0,0.0747662685942835,22.0395307867761,9.69874682824039
9.7,"max_tuv_SVM","SVM",36,16,1084,1071,13,1700,1459,241,0.802245571621183,0.255474452554745,1.26512832587709,624,241,383,-10,1.6,61.06,6.1,0,0,0,0,0,0,0.0667881151834061,25.220074030253,8.59853014025587
9.7,"max_tuv_SVM","SVM",36,17,984,972,12,1800,1558,242,0.827002650053474,0.335766423357664,1.27449964680951,637,242,395,13,1.6,64.66,6.4,0,0,0,0,0,0,0.0300793656167948,10.3766279243142,4.41437142578538
9.7,"max_tuv_SVM","SVM",36,18,884,875,9,1900,1655,245,0.836260402622166,0.364963503649635,1.27449964680951,658,245,413,21,1.7,68.25,6.8,0,0,0,0,0,0,0.0283554305193507,11.2224204301852,5.22258462637549
9.7,"max_tuv_SVM","SVM",36,19,784,778,6,2000,1752,248,0.808016411734628,0.255474452554745,1.26512832587709,673,248,425,15,1.7,71.84,7.1,0,0,0,0,0,0,0.0140038457142869,6.8742420047108,4.85573537082373
9.7,"max_tuv_SVM","SVM",36,20,684,679,5,2100,1851,249,0.779394671997771,0.175182481751825,1.26512832587709,660,249,411,-13,1.7,75.43,7.4,0,0,0,0,0,0,0.00890656019273459,2.67731339148157,1.48187721896724
9.7,"max_tuv_SVM","SVM",36,21,584,581,3,2200,1949,251,0.825625319633645,0.255474452554745,1.27449964680951,681,251,430,21,1.7,79.02,7.8,0,0,0,0,0,0,0.0169439231595468,6.25563376791322,4.31328058091093
9.7,"max_tuv_SVM","SVM",36,22,484,484,0,2300,2046,254,0.814385838486216,0.313868613138686,1.27449964680951,704,254,450,23,1.8,82.61,8.1,0,0,0,0,0,0,0.0130468831274479,4.303969416045,3.28063045281215
9.7,"max_tuv_SVM","SVM",36,23,384,384,0,2400,2146,254,0.760937282067974,0.182481751824818,1.27449964680951,715,254,461,11,1.8,86.21,8.4,0,0,0,0,0,0,0.00658410339803566,1.88241556918034,1.30657882604117
9.7,"max_tuv_SVM","SVM",36,24,284,284,0,2500,2246,254,0.803948347203499,0.233576642335766,1.27449964680951,718,254,464,3,1.8,89.8,8.8,0,0,0,0,0,0,0.000910397396722472,0.304550713285648,0.255788774651965
9.7,"max_tuv_SVM","SVM",36,25,184,184,0,2600,2346,254,0.833075689246364,0.335766423357664,1.27449964680951,709,254,455,-9,1.8,93.39,9.2,0,0,0,0,0,0,0.00017591877437674,0.132096145838014,0.125954955611954
9.7,"max_tuv_SVM","SVM",36,26,84,84,0,2700,2446,254,0.825119717327632,0.321167883211679,1.27449964680951,703,254,449,-6,1.8,96.98,9.6,0,0,0,0,0,0,4.02280725356704e-07,0.00269536307490324,0.00269536307490324
9.7,"max_tuv_SVM","SVM",36,27,0,0,0,2784,2530,254,0.820900553256781,0.299270072992701,1.27449964680951,714,254,460,11,1.8,100,10,0,0,0,0,0,0,0,0,0
9.7,"max_tuv_SVM","SVM",37,0,2684,2439,245,100,90,10,0.803266413964159,0.286764705882353,1.27443074003795,30,10,20,0,2,3.59,9,0,0,0,0,0,0,0.153870694419222,260.736389695063,16.8521763068293
9.7,"max_tuv_SVM","SVM",37,1,2584,2372,212,200,157,43,0.671697318545556,0.183823529411765,1.18946869070209,109,43,66,79,1.5,7.18,3.7,0,0,0,0,0,0,0.243104284793965,507.536618617534,27.6036353139922
9.7,"max_tuv_SVM","SVM",37,2,2484,2291,193,300,238,62,0.6968447283448,0.183823529411765,1.19890891840607,160,62,98,51,1.6,10.78,3.8,0,0,0,0,0,0,0.212712259681423,459.674670457714,21.7013250687099
9.7,"max_tuv_SVM","SVM",37,3,2384,2215,169,400,314,86,0.749625625906691,0.147058823529412,1.19890891840607,209,86,123,49,1.4,14.37,3.7,0,0,0,0,0,0,0.227785472642234,437.595413865377,23.746599759969
9.7,"max_tuv_SVM","SVM",37,4,2284,2133,151,500,396,104,0.787548551640228,0.213235294117647,1.26499051233397,260,104,156,51,1.5,17.96,3.8,0,0,0,0,0,0,0.239699753530296,300.336080032748,24.8011463202126
9.7,"max_tuv_SVM","SVM",37,5,2184,2057,127,600,472,128,0.815503767139318,0.242647058823529,1.27443074003795,308,128,180,48,1.4,21.55,3.7,0,0,0,0,0,0,0.228169903038876,275.651821933794,23.5608000389989
9.7,"max_tuv_SVM","SVM",37,6,2084,1988,96,700,541,159,0.815585661472224,0.257352941176471,1.27443074003795,384,159,225,76,1.4,25.14,3.4,0,0,0,0,0,0,0.230013457087875,260.616793779931,23.6759638700508
9.7,"max_tuv_SVM","SVM",37,7,1984,1913,71,800,616,184,0.811315456970378,0.264705882352941,1.246110056926,440,184,256,56,1.4,28.74,3.3,0,0,0,0,0,0,0.223168190230125,241.562438940319,23.1113923342741
9.7,"max_tuv_SVM","SVM",37,8,1884,1832,52,900,697,203,0.799019607843142,0.220588235294118,1.23666982922201,488,203,285,48,1.4,32.33,3.4,0,0,0,0,0,0,0.216705498829276,209.027780022392,22.9020737886123
9.7,"max_tuv_SVM","SVM",37,9,1784,1748,36,1000,781,219,0.7760657962469,0.191176470588235,1.21778937381404,533,219,314,45,1.4,35.92,3.6,0,0,0,0,0,0,0.218273970740858,210.557079752596,23.4332666144229
9.7,"max_tuv_SVM","SVM",37,10,1684,1654,30,1100,875,225,0.790549393981942,0.220588235294118,1.246110056926,564,225,339,31,1.5,39.51,3.9,0,0,0,0,0,0,0.187802076760657,133.032775559286,19.9810525968856
9.7,"max_tuv_SVM","SVM",37,11,1584,1558,26,1200,971,229,0.790139922317381,0.205882352941176,1.246110056926,589,229,360,25,1.6,43.1,4.2,0,0,0,0,0,0,0.179304811378069,173.604132284912,18.4092766489996
9.7,"max_tuv_SVM","SVM",37,12,1484,1462,22,1300,1067,233,0.785694229959294,0.205882352941176,1.23666982922201,600,233,367,11,1.6,46.7,4.6,0,0,0,0,0,0,0.136744390720633,82.7065171381198,15.2823378777384
9.7,"max_tuv_SVM","SVM",37,13,1384,1369,15,1400,1160,240,0.821745285226267,0.286764705882353,1.26382569602427,602,240,362,2,1.5,50.29,4.8,0,0,0,0,0,0,0.0702973898523095,27.8212761815071,9.23119034531432
9.7,"max_tuv_SVM","SVM",37,14,1284,1270,14,1500,1259,241,0.80549510973841,0.213235294117647,1.26499051233397,617,241,376,15,1.6,53.88,5.2,0,0,0,0,0,0,0.0545312682112128,20.8394121729241,6.62642432095447
9.7,"max_tuv_SVM","SVM",37,15,1184,1171,13,1600,1358,242,0.798908465534188,0.227941176470588,1.26499051233397,612,242,370,-5,1.5,57.47,5.6,0,0,0,0,0,0,0.0608815745542606,33.5178056096238,7.01177918535999
9.7,"max_tuv_SVM","SVM",37,16,1084,1072,12,1700,1457,243,0.783951050587306,0.183823529411765,1.26499051233397,627,243,384,15,1.6,61.06,6,0,0,0,0,0,0,0.0498211412278256,23.2046944435148,6.0332522203417
9.7,"max_tuv_SVM","SVM",37,17,984,974,10,1800,1555,245,0.80209064532734,0.227941176470588,1.246110056926,623,245,378,-4,1.5,64.66,6.3,0,0,0,0,0,0,0.0695587273737031,28.1357652421778,10.0430454089861
9.7,"max_tuv_SVM","SVM",37,18,884,875,9,1900,1654,246,0.81347980719734,0.272058823529412,1.246110056926,625,246,379,2,1.5,68.25,6.7,0,0,0,0,0,0,0.0494309587585732,19.3119284152885,6.7179901230298
9.7,"max_tuv_SVM","SVM",37,19,784,777,7,2000,1752,248,0.799364733960407,0.257352941176471,1.246110056926,631,248,383,6,1.5,71.84,7.1,0,0,0,0,0,0,0.0717719177582573,26.7377223052448,13.3017429498692
9.7,"max_tuv_SVM","SVM",37,20,684,677,7,2100,1852,248,0.775708970939214,0.176470588235294,1.246110056926,641,248,393,10,1.6,75.43,7.5,0,0,0,0,0,0,0.0361315505464105,11.7777104235158,5.86513373392359
9.7,"max_tuv_SVM","SVM",37,21,584,578,6,2200,1951,249,0.805337170667792,0.264705882352941,1.25555028462998,657,249,408,16,1.6,79.02,7.8,0,0,0,0,0,0,0.0122860601755832,3.91890134140214,2.15873677023056
9.7,"max_tuv_SVM","SVM",37,22,484,479,5,2300,2050,250,0.787975572090414,0.191176470588235,1.246110056926,671,250,421,14,1.7,82.61,8.2,0,0,0,0,0,0,0.0242744772312168,7.11442957639934,3.45495097638802
9.7,"max_tuv_SVM","SVM",37,23,384,383,1,2400,2146,254,0.787946324114369,0.213235294117647,1.28387096774194,683,254,429,12,1.7,86.21,8.4,0,0,0,0,0,0,0.0164940558178378,4.58705349073061,3.02392315767313
9.7,"max_tuv_SVM","SVM",37,24,284,284,0,2500,2245,255,0.720430296223501,0.125,1.27443074003795,690,255,435,7,1.7,89.8,8.8,0,0,0,0,0,0,0.0117142659660001,2.89999585890917,2.20972621154518
9.7,"max_tuv_SVM","SVM",37,25,184,184,0,2600,2345,255,0.803336609106652,0.213235294117647,1.27443074003795,699,255,444,9,1.7,93.39,9.2,0,0,0,0,0,0,0.00423506371217344,1.24993444802478,1.08364073646471
9.7,"max_tuv_SVM","SVM",37,26,84,84,0,2700,2445,255,0.820821049183398,0.279411764705882,1.27443074003795,690,255,435,-9,1.7,96.98,9.6,0,0,0,0,0,0,2.25385996908927e-05,0.121545961976884,0.121545961976884
9.7,"max_tuv_SVM","SVM",37,27,0,0,0,2784,2529,255,0.814731620571859,0.272058823529412,1.27443074003795,705,255,450,15,1.8,100,9.9,0,0,0,0,0,0,0,0,0
9.7,"max_tuv_SVM","SVM",38,0,2684,2422,262,100,91,9,0.794619010212096,0.183333333333333,1.26247311827957,28,9,19,0,2.1,3.59,10.1,0,0,0,0,0,0,0.136276218808001,241.070226121318,16.2414332089668
9.7,"max_tuv_SVM","SVM",38,1,2584,2346,238,200,167,33,0.816961246399575,0.241666666666667,1.25177419354839,80,33,47,52,1.4,7.18,5.1,0,0,0,0,0,0,0.226541149240315,266.847072005757,25.5364459088918
9.7,"max_tuv_SVM","SVM",38,2,2484,2280,204,300,233,67,0.805047132757255,0.191666666666667,1.27317204301075,166,67,99,86,1.5,10.78,3.5,0,0,0,0,0,0,0.231987089492384,492.055680485523,23.3620224315218
9.7,"max_tuv_SVM","SVM",38,3,2384,2201,183,400,312,88,0.81849960722702,0.316666666666667,1.26247311827957,219,88,131,53,1.5,14.37,3.5,0,0,0,0,0,0,0.234796872651655,350.405178980349,23.7856863309654
9.7,"max_tuv_SVM","SVM",38,4,2284,2137,147,500,376,124,0.81934406912804,0.3,1.26247311827957,303,124,179,84,1.4,17.96,3,0,0,0,0,0,0,0.252398685162684,221.92089341139,26.0376696428151
9.7,"max_tuv_SVM","SVM",38,5,2184,2065,119,600,448,152,0.820096884001034,0.266666666666667,1.27317204301075,355,152,203,52,1.3,21.55,2.9,0,0,0,0,0,0,0.247978714536945,222.419814749724,25.8458157868924
9.7,"max_tuv_SVM","SVM",38,6,2084,1993,91,700,520,180,0.819789211835548,0.241666666666667,1.27317204301075,432,180,252,77,1.4,25.14,2.9,0,0,0,0,0,0,0.249216244382953,201.029475722531,25.958048047624
9.7,"max_tuv_SVM","SVM",38,7,1984,1913,71,800,600,200,0.807246661429686,0.225,1.27317204301075,482,200,282,50,1.4,28.74,3,0,0,0,0,0,0,0.23203755699288,219.975295270325,24.461959617242
9.7,"max_tuv_SVM","SVM",38,8,1884,1828,56,900,685,215,0.806415291961238,0.216666666666667,1.27317204301075,535,215,320,53,1.5,32.33,3.2,0,0,0,0,0,0,0.198807834818421,148.677080998419,21.4739040390418
9.7,"max_tuv_SVM","SVM",38,9,1784,1740,44,1000,773,227,0.78762110500131,0.191666666666667,1.26247311827957,564,227,337,29,1.5,35.92,3.4,0,0,0,0,0,0,0.19461716223625,168.300362519469,21.5841339318183
9.7,"max_tuv_SVM","SVM",38,10,1684,1649,35,1100,864,236,0.761023828227283,0.1,1.26247311827957,561,236,325,-3,1.4,39.51,3.7,0,0,0,0,0,0,0.238587352200151,224.421424240436,28.115493087902
9.7,"max_tuv_SVM","SVM",38,11,1584,1556,28,1200,957,243,0.820411102382812,0.241666666666667,1.27317204301075,580,243,337,19,1.4,43.1,3.9,0,0,0,0,0,0,0.162755385446761,77.3507789936121,18.6307708965591
9.7,"max_tuv_SVM","SVM",38,12,1484,1466,18,1300,1047,253,0.773762765121752,0.0833333333333333,1.27317204301075,608,253,355,28,1.4,46.7,4.1,0,0,0,0,0,0,0.285314747673074,177.19248351293,38.9844588299119
9.7,"max_tuv_SVM","SVM",38,13,1384,1367,17,1400,1146,254,0.826832940560349,0.216666666666667,1.27317204301075,616,254,362,8,1.4,50.29,4.5,0,0,0,0,0,0,0.123777217483456,59.5645178475958,15.1851836492425
9.7,"max_tuv_SVM","SVM",38,14,1284,1272,12,1500,1241,259,0.827310814349302,0.241666666666667,1.26247311827957,650,259,391,34,1.5,53.88,4.8,0,0,0,0,0,0,0.109322396089972,49.716228600849,13.1331979703002
9.7,"max_tuv_SVM","SVM",38,15,1184,1172,12,1600,1341,259,0.812162869861214,0.216666666666667,1.26247311827957,640,259,381,-10,1.5,57.47,5.2,0,0,0,0,0,0,0.0866051599000748,37.5265101503751,9.82953079471435
9.7,"max_tuv_SVM","SVM",38,16,1084,1074,10,1700,1439,261,0.822113118617435,0.208333333333333,1.26131062001228,635,261,374,-5,1.4,61.06,5.5,0,0,0,0,0,0,0.0503535291957545,17.5223856965382,6.48846737205188
9.7,"max_tuv_SVM","SVM",38,17,984,979,5,1800,1534,266,0.814611154752547,0.191666666666667,1.26247311827957,677,266,411,42,1.5,64.66,5.8,0,0,0,0,0,0,0.0523023953970384,16.7791833565079,6.79577967367754
9.7,"max_tuv_SVM","SVM",38,18,884,883,1,1900,1630,270,0.805479183032196,0.233333333333333,1.27317204301075,709,270,439,32,1.6,68.25,6,0,0,0,0,0,0,0.115870024248171,45.6322165033273,18.7961994882152
9.7,"max_tuv_SVM","SVM",38,19,784,783,1,2000,1730,270,0.827356637863305,0.275,1.27317204301075,695,270,425,-14,1.6,71.84,6.4,0,0,0,0,0,0,0.0607500663370324,19.5436252368802,8.20533350492013
9.7,"max_tuv_SVM","SVM",38,20,684,683,1,2100,1830,270,0.801021209740762,0.208333333333333,1.27317204301075,703,270,433,8,1.6,75.43,6.8,0,0,0,0,0,0,0.0314315285006458,8.71088528609166,4.31075519870615
9.7,"max_tuv_SVM","SVM",38,21,584,583,1,2200,1930,270,0.818885833987946,0.225,1.27317204301075,696,270,426,-7,1.6,79.02,7.1,0,0,0,0,0,0,0.0113720297662642,3.13644295753872,1.88730796082397
9.7,"max_tuv_SVM","SVM",38,22,484,483,1,2300,2030,270,0.803292746792345,0.191666666666667,1.27317204301075,688,270,418,-8,1.5,82.61,7.5,0,0,0,0,0,0,0.00411820960226287,1.00900686130365,0.739810055754012
9.7,"max_tuv_SVM","SVM",38,23,384,383,1,2400,2130,270,0.814264205289332,0.233333333333333,1.27317204301075,689,270,419,1,1.6,86.21,7.9,0,0,0,0,0,0,0.00137508207150158,0.429243551841641,0.336673703253353
9.7,"max_tuv_SVM","SVM",38,24,284,284,0,2500,2229,271,0.774541764859908,0.125,1.27317204301075,699,271,428,10,1.6,89.8,8.2,0,0,0,0,0,0,0.0346623473672528,37.7183438657819,36.3305915190786
9.7,"max_tuv_SVM","SVM",38,25,184,184,0,2600,2329,271,0.813472113118615,0.216666666666667,1.28387096774194,698,271,427,-1,1.6,93.39,8.6,0,0,0,0,0,0,0.00157291867675149,1.59922107474477,1.55309871849931
9.7,"max_tuv_SVM","SVM",38,26,84,84,0,2700,2429,271,0.808071484681851,0.166666666666667,1.27317204301075,715,271,444,17,1.6,96.98,9,0,0,0,0,0,0,1.17861652905666e-06,0.014765119595155,0.014765119595155
9.7,"max_tuv_SVM","SVM",38,27,0,0,0,2784,2513,271,0.82249934537837,0.241666666666667,1.28387096774194,706,271,435,-9,1.6,100,9.3,0,0,0,0,0,0,0,0,0
9.7,"max_tuv_SVM","SVM",39,0,2684,2423,261,100,91,9,0.794512448671969,0.371900826446281,1.18837643295121,21,9,12,0,1.3,3.59,10.1,0,0,0,0,0,0,0.274954271881792,239.951204332016,30.5045505041809
9.7,"max_tuv_SVM","SVM",39,1,2584,2362,222,200,152,48,0.782291179375227,0.198347107438017,1.24142895227939,102,48,54,81,1.1,7.18,3.2,0,0,0,0,0,0,0.251776565418975,571.980202463192,25.7280342607508
9.7,"max_tuv_SVM","SVM",39,2,2484,2280,204,300,234,66,0.824016321014606,0.289256198347107,1.28387096774194,148,66,82,46,1.2,10.78,3.5,0,0,0,0,0,0,0.237868511828503,404.984697420139,24.6258050507721
9.7,"max_tuv_SVM","SVM",39,3,2384,2194,190,400,320,80,0.838095794999746,0.28099173553719,1.28387096774194,192,80,112,44,1.4,14.37,4,0,0,0,0,0,0,0.214958482754519,221.985976781006,21.9305793904236
9.7,"max_tuv_SVM","SVM",39,4,2284,2127,157,500,387,113,0.828687821612346,0.305785123966942,1.2732604638763,267,113,154,75,1.4,17.96,3.4,0,0,0,0,0,0,0.24056366985591,146.386706531495,25.4161093647099
9.7,"max_tuv_SVM","SVM",39,5,2184,2062,122,600,452,148,0.824990903893128,0.297520661157025,1.2732604638763,341,148,193,74,1.3,21.55,3.1,0,0,0,0,0,0,0.239223996175667,344.172972349205,24.4046069227656
9.7,"max_tuv_SVM","SVM",39,6,2084,1990,94,700,524,176,0.775365143718493,0.148760330578512,1.24142895227939,424,176,248,83,1.4,25.14,3,0,0,0,0,0,0,0.305225796029705,303.690607470848,40.4776260116004
9.7,"max_tuv_SVM","SVM",39,7,1984,1912,72,800,602,198,0.710665835022612,0.12396694214876,1.15654492135431,482,198,284,58,1.4,28.74,3,0,0,0,0,0,0,0.286939357988886,344.114501195493,37.7254472251639
9.7,"max_tuv_SVM","SVM",39,8,1884,1813,71,900,701,199,0.77726233172202,0.239669421487603,1.19898693681685,472,199,273,-10,1.4,32.33,3.5,0,0,0,0,0,0,0.242011320452165,160.541083974614,26.2357147542632
9.7,"max_tuv_SVM","SVM",39,9,1784,1721,63,1000,793,207,0.800476895888564,0.322314049586777,1.24142895227939,491,207,284,19,1.4,35.92,3.8,0,0,0,0,0,0,0.188944686427522,70.6016693937404,21.3128133764094
9.7,"max_tuv_SVM","SVM",39,10,1684,1628,56,1100,886,214,0.802361089453721,0.305785123966942,1.24142895227939,510,214,296,19,1.4,39.51,4.1,0,0,0,0,0,0,0.125624705996565,47.7919159918801,15.3473112324545
9.7,"max_tuv_SVM","SVM",39,11,1584,1533,51,1200,981,219,0.812646187431783,0.297520661157025,1.25203945614503,527,219,308,17,1.4,43.1,4.5,0,0,0,0,0,0,0.0737765971582715,22.8518974842296,10.6971592349127
9.7,"max_tuv_SVM","SVM",39,12,1484,1447,37,1300,1067,233,0.780627891262532,0.190082644628099,1.23081844841376,585,233,352,58,1.5,46.7,4.6,0,0,0,0,0,0,0.190807093057287,95.3891365645641,19.7713362843731
9.7,"max_tuv_SVM","SVM",39,13,1384,1354,30,1400,1160,240,0.814536878216116,0.305785123966942,1.23081844841376,604,240,364,19,1.5,50.29,4.8,0,0,0,0,0,0,0.145565415248396,40.7322447773115,16.4340588174205
9.7,"max_tuv_SVM","SVM",39,14,1284,1261,23,1500,1253,247,0.810820468839333,0.289256198347107,1.23081844841376,634,247,387,30,1.6,53.88,5.1,0,0,0,0,0,0,0.109554318709446,30.8977707161847,13.4505896978399
9.7,"max_tuv_SVM","SVM",39,15,1184,1163,21,1600,1351,249,0.777762617599665,0.140495867768595,1.23081844841376,651,249,402,17,1.6,57.47,5.4,0,0,0,0,0,0,0.12067422275911,42.4596345259923,13.6162810932431
9.7,"max_tuv_SVM","SVM",39,16,1084,1065,19,1700,1449,251,0.769030355008059,0.181818181818182,1.22020794454812,654,251,403,3,1.6,61.06,5.8,0,0,0,0,0,0,0.135755150814956,43.6680706063861,14.9056648659438
9.7,"max_tuv_SVM","SVM",39,17,984,966,18,1800,1548,252,0.775800457404231,0.190082644628099,1.22020794454812,686,252,434,32,1.7,64.66,6.1,0,0,0,0,0,0,0.128324603578529,32.8843241669368,13.9093998822128
9.7,"max_tuv_SVM","SVM",39,18,884,866,18,1900,1648,252,0.771889131451739,0.140495867768595,1.23081844841376,681,252,429,-5,1.7,68.25,6.5,0,0,0,0,0,0,0.080990860483685,14.7477154260452,10.1848585509411
9.7,"max_tuv_SVM","SVM",39,19,784,767,17,2000,1747,253,0.762741046831956,0.198347107438017,1.23081844841376,673,253,420,-8,1.7,71.84,6.9,0,0,0,0,0,0,0.014276268899999,6.52696398766849,6.0824310050003
9.7,"max_tuv_SVM","SVM",39,20,684,669,15,2100,1845,255,0.764232158636109,0.198347107438017,1.23081844841376,683,255,428,10,1.7,75.43,7.2,0,0,0,0,0,0,7.20400283639315e-10,0.026279525207608,0.0262795144933517
9.7,"max_tuv_SVM","SVM",39,21,584,571,13,2200,1943,257,0.746472009979734,0.15702479338843,1.25203945614503,679,257,422,-4,1.6,79.02,7.6,0,0,0,0,0,0,1.36136200632967e-09,1.47241878667567e-05,1.46840001512145e-05
9.7,"max_tuv_SVM","SVM",39,22,484,476,8,2300,2038,262,0.775176724361975,0.165289256198347,1.26264996001066,689,262,427,10,1.6,82.61,7.8,0,0,0,0,0,0,0.0144650472886756,5.55601720769745,2.39333672970929
9.7,"max_tuv_SVM","SVM",39,23,384,380,4,2400,2134,266,0.776904984666568,0.15702479338843,1.2732604638763,721,266,455,32,1.7,86.21,8,0,0,0,0,0,0,0.0775501349078361,22.6667903259001,11.0730133117674
9.7,"max_tuv_SVM","SVM",39,24,284,281,3,2500,2233,267,0.802809397577839,0.190082644628099,1.28387096774194,718,267,451,-3,1.7,89.8,8.4,0,0,0,0,0,0,0.0247276644846997,5.86152930346688,4.07544475027279
9.7,"max_tuv_SVM","SVM",39,25,184,183,1,2600,2331,269,0.746757887624102,0.15702479338843,1.2732604638763,731,269,462,13,1.7,93.39,8.7,0,0,0,0,0,0,0.0244536130084657,5.61850601769995,4.66874995366344
9.7,"max_tuv_SVM","SVM",39,26,84,83,1,2700,2431,269,0.747063256926037,0.12396694214876,1.2732604638763,732,269,463,1,1.7,96.98,9,0,0,0,0,0,0,7.62109737396071e-08,1.12209990571286,1.12209990571286
9.7,"max_tuv_SVM","SVM",39,27,0,0,0,2784,2514,270,0.758511357139146,0.140495867768595,1.28387096774194,726,270,456,-6,1.7,100,9.3,0,0,0,0,0,0,0,0,0
9.7,"max_tuv_SVM","SVM",40,0,2684,2425,259,100,91,9,0.782299468663982,0.195121951219512,1.27343299239444,30,9,21,0,2.3,3.59,10.1,0,0,0,0,0,0,0.101268160697945,243.000099294373,10.6367515153145
9.7,"max_tuv_SVM","SVM",40,1,2584,2337,247,200,179,21,0.749791946738372,0.308943089430894,1.24211906635195,61,21,40,31,1.9,7.18,8.5,0,0,0,0,0,0,0.12459852109303,260.206465969329,13.1545312984596
9.7,"max_tuv_SVM","SVM",40,2,2484,2272,212,300,244,56,0.749695922156079,0.211382113821138,1.27343299239444,143,56,87,82,1.6,10.78,4.4,0,0,0,0,0,0,0.20643450096463,442.233354817623,21.6070774037345
9.7,"max_tuv_SVM","SVM",40,3,2384,2184,200,400,332,68,0.747833045259599,0.211382113821138,1.23168109100446,169,68,101,26,1.5,14.37,4.9,0,0,0,0,0,0,0.180309668047076,361.20036833353,19.4166928813643
9.7,"max_tuv_SVM","SVM",40,4,2284,2098,186,500,418,82,0.764253248831703,0.260162601626016,1.23168109100446,204,82,122,35,1.5,17.96,5.1,0,0,0,0,0,0,0.17325371250803,259.056540030578,18.5409381855517
9.7,"max_tuv_SVM","SVM",40,5,2184,2015,169,600,501,99,0.776416362588828,0.292682926829268,1.23168109100446,248,99,149,44,1.5,21.55,5.1,0,0,0,0,0,0,0.170440898814164,242.806200627814,17.3492433862853
9.7,"max_tuv_SVM","SVM",40,6,2084,1933,151,700,583,117,0.79082004993279,0.292682926829268,1.23168109100446,292,117,175,44,1.5,25.14,5,0,0,0,0,0,0,0.171881481807717,204.349624308117,17.4874811988197
9.7,"max_tuv_SVM","SVM",40,7,1984,1871,113,800,645,155,0.797375328083997,0.268292682926829,1.23168109100446,383,155,228,91,1.5,28.74,4.2,0,0,0,0,0,0,0.196835267673301,157.2882433397,20.3055685623276
9.7,"max_tuv_SVM","SVM",40,8,1884,1807,77,900,709,191,0.796696754369124,0.219512195121951,1.23168109100446,467,191,276,84,1.4,32.33,3.7,0,0,0,0,0,0,0.208746189605269,169.935281570451,21.8415651250237
9.7,"max_tuv_SVM","SVM",40,9,1784,1724,60,1000,792,208,0.804698802893547,0.292682926829268,1.23168109100446,503,208,295,36,1.4,35.92,3.8,0,0,0,0,0,0,0.198964620606763,136.575513058543,20.8604742568043
9.7,"max_tuv_SVM","SVM",40,10,1684,1640,44,1100,876,224,0.80363613084951,0.300813008130081,1.23168109100446,540,224,316,37,1.4,39.51,3.9,0,0,0,0,0,0,0.19136565687253,135.54063736147,19.8244159085252
9.7,"max_tuv_SVM","SVM",40,11,1584,1553,31,1200,963,237,0.805716663465858,0.268292682926829,1.23168109100446,585,237,348,45,1.5,43.1,4.1,0,0,0,0,0,0,0.160973477907712,81.8908440563016,17.6709870480495
9.7,"max_tuv_SVM","SVM",40,12,1484,1459,25,1300,1057,243,0.80999935983613,0.260162601626016,1.23168109100446,598,243,355,13,1.5,46.7,4.3,0,0,0,0,0,0,0.149827703970781,79.3358585748956,15.9862407781695
9.7,"max_tuv_SVM","SVM",40,13,1384,1361,23,1400,1155,245,0.814838998783705,0.292682926829268,1.23168109100446,608,245,363,10,1.5,50.29,4.7,0,0,0,0,0,0,0.127750031038104,74.398144033148,14.0313773457187
9.7,"max_tuv_SVM","SVM",40,14,1284,1264,20,1500,1252,248,0.806401638819555,0.252032520325203,1.23168109100446,610,248,362,2,1.5,53.88,5,0,0,0,0,0,0,0.0952525803409058,39.7681008779201,11.1612916497392
9.7,"max_tuv_SVM","SVM",40,15,1184,1165,19,1600,1351,249,0.804154663593896,0.252032520325203,1.23168109100446,629,249,380,19,1.5,57.47,5.4,0,0,0,0,0,0,0.0783501226139652,37.4681444228153,9.17791461991973
9.7,"max_tuv_SVM","SVM",40,16,1084,1067,17,1700,1449,251,0.799551885282636,0.276422764227642,1.21080514030947,625,251,374,-4,1.5,61.06,5.8,0,0,0,0,0,0,0.0835870788694114,28.7642287550284,11.1001791268715
9.7,"max_tuv_SVM","SVM",40,17,984,968,16,1800,1548,252,0.78964855002881,0.260162601626016,1.21080514030947,636,252,384,11,1.5,64.66,6.1,0,0,0,0,0,0,0.0751803279322643,31.7609303972978,9.10151271111679
9.7,"max_tuv_SVM","SVM",40,18,884,869,15,1900,1647,253,0.800774598297171,0.235772357723577,1.22124311565696,650,253,397,14,1.6,68.25,6.5,0,0,0,0,0,0,0.0336379237764904,10.0963557759778,4.50519180780886
9.7,"max_tuv_SVM","SVM",40,19,784,769,15,2000,1747,253,0.783406952179764,0.24390243902439,1.21080514030947,647,253,394,-3,1.6,71.84,6.9,0,0,0,0,0,0,0.0102443003707313,3.13102836306096,1.7696369605883
9.7,"max_tuv_SVM","SVM",40,20,684,670,14,2100,1846,254,0.794609820113957,0.227642276422764,1.22124311565696,647,254,393,0,1.5,75.43,7.3,0,0,0,0,0,0,0.00946951349369002,2.93908094693978,1.51875276723516
9.7,"max_tuv_SVM","SVM",40,21,584,572,12,2200,1944,256,0.799980795083554,0.227642276422764,1.21080514030947,663,256,407,16,1.6,79.02,7.6,0,0,0,0,0,0,0.00598156879240923,2.00649101369988,1.20296411287461
9.7,"max_tuv_SVM","SVM",40,22,484,476,8,2300,2040,260,0.799122975481731,0.268292682926829,1.22124311565696,677,260,417,14,1.6,82.61,7.8,0,0,0,0,0,0,0.0329549164625247,11.2674144950732,7.4823247363915
9.7,"max_tuv_SVM","SVM",40,23,384,376,8,2400,2140,260,0.799487868894441,0.227642276422764,1.22124311565696,679,260,419,2,1.6,86.21,8.2,0,0,0,0,0,0,0.0139746260486611,3.93887951843457,1.9781413657183
9.7,"max_tuv_SVM","SVM",40,24,284,276,8,2500,2240,260,0.802163753921008,0.252032520325203,1.22124311565696,687,260,427,8,1.6,89.8,8.6,0,0,0,0,0,0,0.00543217654329942,1.3709287930085,0.869656509548798
9.7,"max_tuv_SVM","SVM",40,25,184,181,3,2600,2335,265,0.804218679982076,0.276422764227642,1.26299501704694,701,265,436,14,1.6,93.39,8.8,0,0,0,0,0,0,0.0034999703444272,3.74994261569447,3.63475587732952
9.7,"max_tuv_SVM","SVM",40,26,84,84,0,2700,2432,268,0.816477818321495,0.252032520325203,1.27343299239444,723,268,455,22,1.7,96.98,9.1,0,0,0,0,0,0,1.29562329993199e-05,0.0838119580517551,0.0838119580517551
9.7,"max_tuv_SVM","SVM",40,27,0,0,0,2784,2516,268,0.816170539658156,0.235772357723577,1.27343299239444,729,268,461,6,1.7,100,9.4,0,0,0,0,0,0,0,0,0
9.7,"max_tuv_SVM","SVM",41,0,2684,2434,250,100,90,10,0.762802288866574,0.229007633587786,1.25331421421844,25,10,15,0,1.5,3.59,9,0,0,0,0,0,0,0.275599388802569,254.117600872716,38.7418938212861
9.7,"max_tuv_SVM","SVM",41,1,2584,2364,220,200,160,40,0.751974933765617,0.374045801526718,1.22506771731101,92,40,52,67,1.3,7.18,4,0,0,0,0,0,0,0.225219351124904,404.482359164706,23.9738003796687
9.7,"max_tuv_SVM","SVM",41,2,2484,2296,188,300,228,72,0.793415274434129,0.305343511450382,1.27407042600345,166,72,94,74,1.3,10.78,3.2,0,0,0,0,0,0,0.273916697188549,472.223513945601,30.7778798754807
9.7,"max_tuv_SVM","SVM",41,3,2384,2220,164,400,304,96,0.819425121883353,0.290076335877863,1.27407042600345,219,96,123,53,1.3,14.37,3.2,0,0,0,0,0,0,0.253362306195761,326.673332793296,26.6023893665353
9.7,"max_tuv_SVM","SVM",41,4,2284,2143,141,500,381,119,0.804369654371459,0.274809160305344,1.2348682590495,283,119,164,64,1.4,17.96,3.2,0,0,0,0,0,0,0.235469471858592,256.443886189291,49.9853423277487
9.7,"max_tuv_SVM","SVM",41,5,2184,2067,117,600,457,143,0.738842985204621,0.229007633587786,1.19566609209554,331,143,188,48,1.3,21.55,3.2,0,0,0,0,0,0,0.241058253317928,489.149939442414,26.4738776930613
9.7,"max_tuv_SVM","SVM",41,6,2084,1983,101,700,541,159,0.801115399039444,0.251908396946565,1.25446934252647,371,159,212,40,1.3,25.14,3.4,0,0,0,0,0,0,0.223131080513543,373.855962685711,22.8268045616862
9.7,"max_tuv_SVM","SVM",41,7,1984,1903,81,800,621,179,0.811319727561962,0.244274809160305,1.24352269691985,416,179,237,45,1.3,28.74,3.5,0,0,0,0,0,0,0.202561649458585,176.952130762882,21.7439029793929
9.7,"max_tuv_SVM","SVM",41,8,1884,1821,63,900,703,197,0.813509393789084,0.236641221374046,1.24466880078798,472,197,275,56,1.4,32.33,3.6,0,0,0,0,0,0,0.190075658376223,151.615505859488,20.5692933364359
9.7,"max_tuv_SVM","SVM",41,9,1784,1739,45,1000,785,215,0.813581979409873,0.236641221374046,1.25331421421844,517,215,302,45,1.4,35.92,3.7,0,0,0,0,0,0,0.190924026469742,145.33584370956,20.2745757061686
9.7,"max_tuv_SVM","SVM",41,10,1684,1660,24,1100,864,236,0.814386470040279,0.267175572519084,1.25446934252647,571,236,335,54,1.4,39.51,3.7,0,0,0,0,0,0,0.180348188433935,95.1726529306115,19.6105970033412
9.7,"max_tuv_SVM","SVM",41,11,1584,1568,16,1200,956,244,0.812946855227973,0.236641221374046,1.24466880078798,594,244,350,23,1.4,43.1,3.9,0,0,0,0,0,0,0.133859379575043,59.5118572917056,15.5652720378352
9.7,"max_tuv_SVM","SVM",41,12,1484,1469,15,1300,1055,245,0.808222741074986,0.213740458015267,1.24466880078798,589,245,344,-5,1.4,46.7,4.3,0,0,0,0,0,0,0.13034233636649,82.2973192151908,14.5676475244631
9.7,"max_tuv_SVM","SVM",41,13,1384,1371,13,1400,1153,247,0.802004572894102,0.206106870229008,1.25446934252647,606,247,359,17,1.5,50.29,4.7,0,0,0,0,0,0,0.0612717781822081,25.1404356729586,7.70364967720365
9.7,"max_tuv_SVM","SVM",41,14,1284,1272,12,1500,1252,248,0.799101148062564,0.175572519083969,1.26426988426496,616,248,368,10,1.5,53.88,5,0,0,0,0,0,0,0.101580323416849,55.0380886407201,11.264392195456
9.7,"max_tuv_SVM","SVM",41,15,1184,1173,11,1600,1351,249,0.818239556743801,0.236641221374046,1.26426988426496,621,249,372,5,1.5,57.47,5.4,0,0,0,0,0,0,0.0270294463928593,8.7610089686895,3.56728442573252
9.7,"max_tuv_SVM","SVM",41,16,1084,1075,9,1700,1449,251,0.810950750656288,0.206106870229008,1.26426988426496,633,251,382,12,1.5,61.06,5.8,0,0,0,0,0,0,0.0269751157684747,8.37052040566999,3.72723495082085
9.7,"max_tuv_SVM","SVM",41,17,984,981,3,1800,1543,257,0.803153845223261,0.198473282442748,1.26426988426496,668,257,411,35,1.6,64.66,6,0,0,0,0,0,0,0.0191895879833146,10.9032576819623,8.65125714908835
9.7,"max_tuv_SVM","SVM",41,18,884,882,2,1900,1642,258,0.806414149357011,0.190839694656489,1.26426988426496,670,258,412,2,1.6,68.25,6.4,0,0,0,0,0,0,0.00941433376698041,2.72335051930707,1.58211357313779
9.7,"max_tuv_SVM","SVM",41,19,784,782,2,2000,1742,258,0.788418964203189,0.190839694656489,1.26426988426496,663,258,405,-7,1.6,71.84,6.8,0,0,0,0,0,0,0.00448730423461641,1.22435204950291,0.729710632067976
9.7,"max_tuv_SVM","SVM",41,20,684,682,2,2100,1842,258,0.824070601613817,0.236641221374046,1.27407042600345,653,258,395,-10,1.5,75.43,7.1,0,0,0,0,0,0,0.00088711050141002,0.279646749031022,0.216751112709757
9.7,"max_tuv_SVM","SVM",41,21,584,583,1,2200,1941,259,0.768131283192796,0.152671755725191,1.26426988426496,683,259,424,30,1.6,79.02,7.5,0,0,0,0,0,0,0.114985733679569,29.7491356544404,17.7799750053196
9.7,"max_tuv_SVM","SVM",41,22,484,484,0,2300,2040,260,0.782140308004984,0.190839694656489,1.26426988426496,685,260,425,2,1.6,82.61,7.8,0,0,0,0,0,0,0.000952773637508472,2.28208244711274,2.23436479238182
9.7,"max_tuv_SVM","SVM",41,23,384,384,0,2400,2140,260,0.770478218264958,0.175572519083969,1.26426988426496,696,260,436,11,1.7,86.21,8.2,0,0,0,0,0,0,0.00290221058333842,0.804580720107393,0.58470587509274
9.7,"max_tuv_SVM","SVM",41,24,284,284,0,2500,2240,260,0.806492783779532,0.213740458015267,1.26426988426496,696,260,436,0,1.7,89.8,8.6,0,0,0,0,0,0,0.000180203372359521,0.0574358573365526,0.0493135799161044
9.7,"max_tuv_SVM","SVM",41,25,184,184,0,2600,2340,260,0.810726944992195,0.259541984732824,1.27407042600345,667,260,407,-29,1.6,93.39,9,0,0,0,0,0,0,2.25581446342225e-05,0.0076914052680095,0.00695292002937082
9.7,"max_tuv_SVM","SVM",41,26,84,84,0,2700,2440,260,0.758689103688559,0.145038167938931,1.27407042600345,678,260,418,11,1.6,96.98,9.4,0,0,0,0,0,0,1.0000000994736e-07,0.000360919926812673,0.000360919926812673
9.7,"max_tuv_SVM","SVM",41,27,0,0,0,2784,2524,260,0.80591209881322,0.213740458015267,1.27407042600345,679,260,419,1,1.6,100,9.7,0,0,0,0,0,0,0,0,0
9.7,"max_tuv_SVM","SVM",42,0,2684,2432,252,100,91,9,0.805310920275293,0.253846153846154,1.26411910669975,24,9,15,0,1.7,3.59,10.1,0,0,0,0,0,0,0.333956263968903,234.246726062803,42.0935745459345
9.7,"max_tuv_SVM","SVM",42,1,2584,2357,227,200,166,34,0.786308544978382,0.261538461538462,1.23449131513648,84,34,50,60,1.5,7.18,4.9,0,0,0,0,0,0,0.201863070292062,377.19554760985,21.6041705457099
9.7,"max_tuv_SVM","SVM",42,2,2484,2269,215,300,254,46,0.765722638406727,0.2,1.24436724565757,120,46,74,36,1.6,10.78,5.5,0,0,0,0,0,0,0.171125799726127,299.23924629648,19.0326604003554
9.7,"max_tuv_SVM","SVM",42,3,2384,2191,193,400,332,68,0.788062610390404,0.176923076923077,1.24436724565757,172,68,104,52,1.5,14.37,4.9,0,0,0,0,0,0,0.171998242434588,354.230279828612,17.7165556568365
9.7,"max_tuv_SVM","SVM",42,4,2284,2123,161,500,400,100,0.778524879712531,0.2,1.25424317617866,244,100,144,72,1.4,17.96,4,0,0,0,0,0,0,0.204196023521425,183.296734838432,21.3896880090762
9.7,"max_tuv_SVM","SVM",42,5,2184,2050,134,600,473,127,0.793617150861809,0.246153846153846,1.27399503722084,313,127,186,69,1.5,21.55,3.7,0,0,0,0,0,0,0.207804510251439,314.544142073505,21.0023980692245
9.7,"max_tuv_SVM","SVM",42,6,2084,1976,108,700,547,153,0.792313782812598,0.246153846153846,1.26411910669975,371,153,218,58,1.4,25.14,3.6,0,0,0,0,0,0,0.215843407940094,218.258464905284,21.9997911873596
9.7,"max_tuv_SVM","SVM",42,7,1984,1891,93,800,632,168,0.805822522687133,0.269230769230769,1.27399503722084,412,168,244,41,1.5,28.74,3.8,0,0,0,0,0,0,0.191809822526908,88.3198706150483,20.4381934593418
9.7,"max_tuv_SVM","SVM",42,8,1884,1824,60,900,699,201,0.787185577684393,0.223076923076923,1.24436724565757,510,201,309,98,1.5,32.33,3.5,0,0,0,0,0,0,0.176585528616902,116.187632948878,20.0986264451268
9.7,"max_tuv_SVM","SVM",42,9,1784,1729,55,1000,794,206,0.786893233449056,0.207692307692308,1.25424317617866,523,206,317,13,1.5,35.92,3.9,0,0,0,0,0,0,0.114702630794051,65.5225827329988,13.4548162344884
9.7,"max_tuv_SVM","SVM",42,10,1684,1631,53,1100,892,208,0.799537121627386,0.230769230769231,1.25424317617866,523,208,315,0,1.5,39.51,4.3,0,0,0,0,0,0,0.0619281025210354,27.7991968862041,8.49766205669774
9.7,"max_tuv_SVM","SVM",42,11,1584,1540,44,1200,983,217,0.814672026310983,0.276923076923077,1.28387096774194,561,217,344,38,1.6,43.1,4.5,0,0,0,0,0,0,0.0978532976683512,49.4048306475479,13.8055382587763
9.7,"max_tuv_SVM","SVM",42,12,1484,1450,34,1300,1073,227,0.80884341311895,0.284615384615385,1.28387096774194,583,227,356,22,1.6,46.7,4.7,0,0,0,0,0,0,0.123004699544106,61.8320161551507,15.5405881813923
9.7,"max_tuv_SVM","SVM",42,13,1384,1355,29,1400,1168,232,0.766356050916624,0.207692307692308,1.26411910669975,612,232,380,29,1.6,50.29,5,0,0,0,0,0,0,0.157992780055431,66.3259166235076,18.8899044041452
9.7,"max_tuv_SVM","SVM",42,14,1284,1257,27,1500,1266,234,0.780516474815765,0.223076923076923,1.28387096774194,624,234,390,12,1.7,53.88,5.4,0,0,0,0,0,0,0.100457663100981,32.8678472597606,15.6654399169182
9.7,"max_tuv_SVM","SVM",42,15,1184,1157,27,1600,1366,234,0.793306535111763,0.246153846153846,1.28387096774194,633,234,399,9,1.7,57.47,5.8,0,0,0,0,0,0,0.0648995261997651,21.1525100467444,9.72450927276648
9.7,"max_tuv_SVM","SVM",42,16,1084,1059,25,1700,1464,236,0.775266459589502,0.215384615384615,1.28387096774194,655,236,419,22,1.8,61.06,6.2,0,0,0,0,0,0,0.0533680588567131,16.7869344937503,7.41642702103368
9.7,"max_tuv_SVM","SVM",42,17,984,961,23,1800,1562,238,0.768700895304223,0.138461538461538,1.28387096774194,659,238,421,4,1.8,64.66,6.6,0,0,0,0,0,0,0.0285280275446406,8.08550520864673,4.03990032673865
9.7,"max_tuv_SVM","SVM",42,18,884,865,19,1900,1658,242,0.717230038370183,0.153846153846154,1.26411910669975,662,242,420,3,1.7,68.25,6.9,0,0,0,0,0,0,0.144915124271327,47.7774527357557,22.8056538285374
9.7,"max_tuv_SVM","SVM",42,19,784,772,12,2000,1751,249,0.788848285522872,0.176923076923077,1.26411910669975,685,249,436,23,1.8,71.84,7,0,0,0,0,0,0,0.0784428789246245,25.9492937372073,12.951725827576
9.7,"max_tuv_SVM","SVM",42,20,684,681,3,2100,1842,258,0.776508922589685,0.176923076923077,1.26411910669975,698,258,440,13,1.7,75.43,7.1,0,0,0,0,0,0,0.0276532466635639,7.58596061643493,4.81791741352529
9.7,"max_tuv_SVM","SVM",42,21,584,583,1,2200,1940,260,0.811060356903589,0.238461538461538,1.26411910669975,706,260,446,8,1.7,79.02,7.5,0,0,0,0,0,0,0.0149148714618086,5.20235810028899,3.88621931026447
9.7,"max_tuv_SVM","SVM",42,22,484,484,0,2300,2039,261,0.767933491686463,0.161538461538462,1.27399503722084,723,261,462,17,1.8,82.61,7.8,0,0,0,0,0,0,0.00688666644363306,4.53830949293169,4.08577446241636
9.7,"max_tuv_SVM","SVM",42,23,384,384,0,2400,2139,261,0.822303428954262,0.238461538461538,1.26411910669975,694,261,433,-29,1.7,86.21,8.2,0,0,0,0,0,0,0.00211634032622336,0.671441141173616,0.549605945921948
9.7,"max_tuv_SVM","SVM",42,24,284,284,0,2500,2239,261,0.807363420427555,0.230769230769231,1.27399503722084,716,261,455,22,1.7,89.8,8.6,0,0,0,0,0,0,3.00313478807194e-05,0.0243391529028728,0.0233514104992553
9.7,"max_tuv_SVM","SVM",42,25,184,184,0,2600,2339,261,0.815743955173886,0.215384615384615,1.26411910669975,729,261,468,13,1.8,93.39,9,0,0,0,0,0,0,6.19979761408307e-06,0.0112586234741569,0.0111327789650411
9.7,"max_tuv_SVM","SVM",42,26,84,84,0,2700,2439,261,0.810274681771121,0.253846153846154,1.26411910669975,720,261,459,-9,1.8,96.98,9.3,0,0,0,0,0,0,1.0000000994736e-07,7.45639210053011e-05,7.45639210053011e-05
9.7,"max_tuv_SVM","SVM",42,27,0,0,0,2784,2523,261,0.818100980571291,0.276923076923077,1.27399503722084,722,261,461,2,1.8,100,9.7,0,0,0,0,0,0,0,0,0
9.7,"max_tuv_SVM","SVM",43,0,2684,2427,257,100,94,6,0.693502964426876,0.3125,1.07323588709677,17,6,11,0,1.8,3.59,15.7,0,0,0,0,0,0,0.155994664695032,158.932127789945,18.3103245129903
9.7,"max_tuv_SVM","SVM",43,1,2584,2359,225,200,162,38,0.737994071146246,0.21875,1.14344758064516,86,38,48,69,1.3,7.18,4.3,0,0,0,0,0,0,0.234252946449353,136.354463992123,28.308687508849
9.7,"max_tuv_SVM","SVM",43,2,2484,2281,203,300,240,60,0.792947134387346,0.2578125,1.21365927419355,141,60,81,55,1.4,10.78,4,0,0,0,0,0,0,0.241513805936312,92.8896392710562,25.3659734000331
9.7,"max_tuv_SVM","SVM",43,3,2384,2205,179,400,316,84,0.791464920948614,0.2734375,1.19359879032258,205,84,121,64,1.4,14.37,3.8,0,0,0,0,0,0,0.188763969342882,53.0795036880958,22.6378837165905
9.7,"max_tuv_SVM","SVM",43,4,2284,2139,145,500,382,118,0.805527420948619,0.2890625,1.22368951612903,292,118,174,87,1.5,17.96,3.2,0,0,0,0,0,0,0.209270345972447,99.0300411679715,26.2857066872154
9.7,"max_tuv_SVM","SVM",43,5,2184,2060,124,600,461,139,0.805478013834001,0.2265625,1.24375,339,139,200,47,1.4,21.55,3.3,0,0,0,0,0,0,0.267125993274933,152.3862194372,35.8471386736256
9.7,"max_tuv_SVM","SVM",43,6,2084,1977,107,700,544,156,0.770374258893278,0.2578125,1.19359879032258,363,156,207,24,1.3,25.14,3.5,0,0,0,0,0,0,0.171778714373962,88.7211372584652,23.4314746289922
9.7,"max_tuv_SVM","SVM",43,7,1984,1898,86,800,623,177,0.782658102766802,0.2890625,1.19359879032258,412,177,235,49,1.3,28.74,3.5,0,0,0,0,0,0,0.12574987956451,82.2849203462222,19.0860499176281
9.7,"max_tuv_SVM","SVM",43,8,1884,1819,65,900,702,198,0.825914031620553,0.3203125,1.24375,464,198,266,52,1.3,32.33,3.5,0,0,0,0,0,0,0.135811566074866,55.1415793122326,18.8014272509744
9.7,"max_tuv_SVM","SVM",43,9,1784,1736,48,1000,785,215,0.815322381422923,0.3046875,1.22368951612903,527,215,312,63,1.5,35.92,3.7,0,0,0,0,0,0,0.197638705621358,120.543579846357,22.4789734446056
9.7,"max_tuv_SVM","SVM",43,10,1684,1639,45,1100,882,218,0.830335968379448,0.234375,1.27384072580645,535,218,317,8,1.5,39.51,4,0,0,0,0,0,0,0.124616052711711,40.0652423442237,17.4467466189926
9.7,"max_tuv_SVM","SVM",43,11,1584,1545,39,1200,976,224,0.828643774703557,0.234375,1.28387096774194,548,224,324,13,1.4,43.1,4.4,0,0,0,0,0,0,0.169848424832382,57.5789697431036,22.4272065442092
9.7,"max_tuv_SVM","SVM",43,12,1484,1456,28,1300,1065,235,0.811814476284586,0.21875,1.27384072580645,595,235,360,47,1.5,46.7,4.5,0,0,0,0,0,0,0.118180527609929,46.1710976117386,18.352824360887
9.7,"max_tuv_SVM","SVM",43,13,1384,1366,18,1400,1155,245,0.829761610671937,0.2578125,1.27384072580645,631,245,386,36,1.6,50.29,4.7,0,0,0,0,0,0,0.0950947424777257,35.1224733558555,14.5373316301811
9.7,"max_tuv_SVM","SVM",43,14,1284,1266,18,1500,1255,245,0.843416501976286,0.2890625,1.27384072580645,617,245,372,-14,1.5,53.88,5.1,0,0,0,0,0,0,0.0503568233712076,17.421266618524,7.7983854595931
9.7,"max_tuv_SVM","SVM",43,15,1184,1167,17,1600,1354,246,0.831101778656129,0.28125,1.26381048387097,621,246,375,4,1.5,57.47,5.5,0,0,0,0,0,0,0.0373496630431529,13.9472076347339,6.10392614862555
9.7,"max_tuv_SVM","SVM",43,16,1084,1068,16,1700,1453,247,0.818138586956524,0.2109375,1.26381048387097,629,247,382,8,1.5,61.06,5.9,0,0,0,0,0,0,0.0257231215511784,9.23043554968493,4.95144978731619
9.7,"max_tuv_SVM","SVM",43,17,984,968,16,1800,1553,247,0.825926383399214,0.265625,1.26381048387097,627,247,380,-2,1.5,64.66,6.3,0,0,0,0,0,0,0.0141987357683349,5.61474245023649,3.05722209933781
9.7,"max_tuv_SVM","SVM",43,18,884,871,13,1900,1650,250,0.823863636363638,0.2421875,1.27384072580645,664,250,414,37,1.7,68.25,6.6,0,0,0,0,0,0,0.0415539385149932,16.041170041904,7.47296641268336
9.7,"max_tuv_SVM","SVM",43,19,784,777,7,2000,1744,256,0.81700839920949,0.2265625,1.27384072580645,687,256,431,23,1.7,71.84,6.8,0,0,0,0,0,0,0.0598572036506721,22.6776142926707,17.3300196250216
9.7,"max_tuv_SVM","SVM",43,20,684,679,5,2100,1842,258,0.805088932806321,0.203125,1.27384072580645,700,258,442,13,1.7,75.43,7.1,0,0,0,0,0,0,0.0148249114529733,6.12076970150501,4.45639951363467
9.7,"max_tuv_SVM","SVM",43,21,584,580,4,2200,1941,259,0.796986166007906,0.171875,1.26381048387097,693,259,434,-7,1.7,79.02,7.5,0,0,0,0,0,0,0.0020424409407933,1.69380936472385,1.54242983551645
9.7,"max_tuv_SVM","SVM",43,22,484,481,3,2300,2040,260,0.80363759881423,0.21875,1.26381048387097,698,260,438,5,1.7,82.61,7.8,0,0,0,0,0,0,0.00332414813103715,2.26453828115197,1.98434157432874
9.7,"max_tuv_SVM","SVM",43,23,384,384,0,2400,2137,263,0.787277667984191,0.1640625,1.27384072580645,702,263,439,4,1.7,86.21,8.1,0,0,0,0,0,0,0.0222742782623716,7.0657114020875,5.4663850512542
9.7,"max_tuv_SVM","SVM",43,24,284,284,0,2500,2237,263,0.817879199604746,0.2421875,1.27384072580645,707,263,444,5,1.7,89.8,8.5,0,0,0,0,0,0,0.00417428635386579,1.44507998002704,1.19736225805779
9.7,"max_tuv_SVM","SVM",43,25,184,184,0,2600,2337,263,0.785480484189729,0.1953125,1.27384072580645,712,263,449,5,1.7,93.39,8.9,0,0,0,0,0,0,0.00152339111210601,0.473446668359474,0.424539497468794
9.7,"max_tuv_SVM","SVM",43,26,84,84,0,2700,2437,263,0.835888092885382,0.28125,1.27384072580645,701,263,438,-11,1.7,96.98,9.3,0,0,0,0,0,0,2.27431657939612e-07,0.0124416274795441,0.0124416274795441
9.7,"max_tuv_SVM","SVM",43,27,0,0,0,2784,2521,263,0.836894762845849,0.3125,1.27384072580645,713,263,450,12,1.7,100,9.6,0,0,0,0,0,0,0,0,0
9.7,"max_tuv_SVM","SVM",44,0,2684,2423,261,100,85,15,0.776097162686262,0.339130434782609,1.21688639551192,40,15,25,0,1.7,3.59,5.7,0,0,0,0,0,0,0.382452316419856,395.370687774786,39.6791289312108
9.7,"max_tuv_SVM","SVM",44,1,2584,2363,221,200,145,55,0.730264679866643,0,1.25037868162693,128,55,73,88,1.3,7.18,2.6,0,0,0,0,0,0,0.370666299704661,591.765618379087,44.7066277817087
9.7,"max_tuv_SVM","SVM",44,2,2484,2263,221,300,245,55,0.788065591617339,0.156521739130435,1.28387096774194,131,55,76,3,1.4,10.78,4.5,0,0,0,0,0,0,0.229390192091471,426.741153108724,23.8007947299055
9.7,"max_tuv_SVM","SVM",44,3,2384,2183,201,400,325,75,0.647016397904335,0.147826086956522,1.08291725105189,178,75,103,47,1.4,14.37,4.3,0,0,0,0,0,0,0.315014683188525,393.740364390229,36.4331688631233
9.7,"max_tuv_SVM","SVM",44,4,2284,2096,188,500,412,88,0.715513370075529,0.139130434782609,1.14990182328191,213,88,125,35,1.4,17.96,4.7,0,0,0,0,0,0,0.239063003887591,296.217232054957,47.1854202088935
9.7,"max_tuv_SVM","SVM",44,5,2184,2011,173,600,497,103,0.783268694291355,0.2,1.27270687237027,253,103,150,40,1.5,21.55,4.8,0,0,0,0,0,0,0.230153388967752,300.452903200532,27.5963688845995
9.7,"max_tuv_SVM","SVM",44,6,2084,1928,156,700,580,120,0.796645573926657,0.234782608695652,1.27270687237027,287,120,167,34,1.4,25.14,4.8,0,0,0,0,0,0,0.208341147545759,296.681081488034,23.8871940654536
9.7,"max_tuv_SVM","SVM",44,7,1984,1842,142,800,666,134,0.810246989181471,0.252173913043478,1.28387096774194,328,134,194,41,1.4,28.74,5,0,0,0,0,0,0,0.198423679119395,194.601824201545,21.3761638268954
9.7,"max_tuv_SVM","SVM",44,8,1884,1768,116,900,740,160,0.826318296250943,0.278260869565217,1.27270687237027,395,160,235,67,1.5,32.33,4.6,0,0,0,0,0,0,0.203385000059341,209.039185446682,21.8908631465452
9.7,"max_tuv_SVM","SVM",44,9,1784,1693,91,1000,815,185,0.811818738518075,0.252173913043478,1.2615427769986,469,185,284,74,1.5,35.92,4.4,0,0,0,0,0,0,0.204361600337035,162.953101264372,21.88642175629
9.7,"max_tuv_SVM","SVM",44,10,1684,1619,65,1100,889,211,0.818854187929518,0.234782608695652,1.2615427769986,531,211,320,62,1.5,39.51,4.2,0,0,0,0,0,0,0.201822377717782,138.086577040236,22.1074394846591
9.7,"max_tuv_SVM","SVM",44,11,1584,1535,49,1200,973,227,0.834530856637413,0.278260869565217,1.28387096774194,574,227,347,43,1.5,43.1,4.3,0,0,0,0,0,0,0.18326566851739,120.198488584817,20.7147461516894
9.7,"max_tuv_SVM","SVM",44,12,1484,1442,42,1300,1066,234,0.830135401782684,0.243478260869565,1.28387096774194,592,234,358,18,1.5,46.7,4.6,0,0,0,0,0,0,0.160302034038124,88.4422021237499,18.5711667917623
9.7,"max_tuv_SVM","SVM",44,13,1384,1352,32,1400,1156,244,0.855861740491261,0.269565217391304,1.27270687237027,624,244,380,32,1.6,50.29,4.7,0,0,0,0,0,0,0.139905955337305,83.1855518050619,17.5602974710894
9.7,"max_tuv_SVM","SVM",44,14,1284,1263,21,1500,1245,255,0.851289378784788,0.252173913043478,1.27270687237027,657,255,402,33,1.6,53.88,4.9,0,0,0,0,0,0,0.107641812975714,53.0170411749136,13.4950337739516
9.7,"max_tuv_SVM","SVM",44,15,1184,1165,19,1600,1343,257,0.866265224195417,0.295652173913043,1.27270687237027,669,257,412,12,1.6,57.47,5.2,0,0,0,0,0,0,0.127288794552983,73.8208856564102,15.4404652430269
9.7,"max_tuv_SVM","SVM",44,16,1084,1069,15,1700,1439,261,0.833483023746342,0.173913043478261,1.28387096774194,696,261,435,27,1.7,61.06,5.5,0,0,0,0,0,0,0.111735747809187,65.9463582144927,13.4939062289894
9.7,"max_tuv_SVM","SVM",44,17,984,972,12,1800,1536,264,0.854344424032117,0.234782608695652,1.28387096774194,701,264,437,5,1.7,64.66,5.8,0,0,0,0,0,0,0.0789240589412833,39.0817227122174,10.326120144644
9.7,"max_tuv_SVM","SVM",44,18,884,880,4,1900,1628,272,0.84789412805335,0.234782608695652,1.28387096774194,747,272,475,46,1.7,68.25,6,0,0,0,0,0,0,0.109128379831838,47.0229014850715,14.5733033626532
9.7,"max_tuv_SVM","SVM",44,19,784,782,2,2000,1726,274,0.861339048785472,0.28695652173913,1.28387096774194,755,274,481,8,1.8,71.84,6.3,0,0,0,0,0,0,0.0904166900556088,41.0589293364026,11.5022032108966
9.7,"max_tuv_SVM","SVM",44,20,684,683,1,2100,1825,275,0.817636252296391,0.147826086956522,1.28268876611418,750,275,475,-5,1.7,75.43,6.6,0,0,0,0,0,0,0.063102265826642,22.0855057956444,9.38712536302916
9.7,"max_tuv_SVM","SVM",44,21,584,584,0,2200,1924,276,0.789351568347287,0.2,1.28387096774194,767,276,491,17,1.8,79.02,7,0,0,0,0,0,0,0.0523878780888753,17.3544436213331,7.23047164785344
9.7,"max_tuv_SVM","SVM",44,22,484,484,0,2300,2024,276,0.779233857249784,0.147826086956522,1.28387096774194,763,276,487,-4,1.8,82.61,7.3,0,0,0,0,0,0,0.0597853508365954,18.7131530962704,7.56062291375462
9.7,"max_tuv_SVM","SVM",44,23,384,384,0,2400,2124,276,0.822331087977144,0.208695652173913,1.28387096774194,783,276,507,20,1.8,86.21,7.7,0,0,0,0,0,0,0.0228334989728848,6.56919189007228,4.21268282016551
9.7,"max_tuv_SVM","SVM",44,24,284,284,0,2500,2224,276,0.80718513982446,0.182608695652174,1.28387096774194,769,276,493,-14,1.8,89.8,8.1,0,0,0,0,0,0,0.011283515758082,3.78259446612762,3.00460806658416
9.7,"max_tuv_SVM","SVM",44,25,184,184,0,2600,2324,276,0.832843437436217,0.208695652173913,1.28387096774194,768,276,492,-1,1.8,93.39,8.4,0,0,0,0,0,0,0.000824460617257123,1.29413510575671,1.26603425853465
9.7,"max_tuv_SVM","SVM",44,26,84,84,0,2700,2424,276,0.833918486766012,0.234782608695652,1.28387096774194,757,276,481,-11,1.7,96.98,8.8,0,0,0,0,0,0,1.0000000994736e-07,1.01382173467565,1.01382173467565
9.7,"max_tuv_SVM","SVM",44,27,0,0,0,2784,2508,276,0.824903041437033,0.165217391304348,1.28387096774194,756,276,480,-1,1.7,100,9.1,0,0,0,0,0,0,0,0,0
9.7,"max_tuv_SVM","SVM",45,0,2684,2430,254,100,92,8,0.688291139240504,0.170542635658915,1.18434608652163,28,8,20,0,2.5,3.59,11.5,0,0,0,0,0,0,0.105727759475022,209.413794092438,12.0371304990085
9.7,"max_tuv_SVM","SVM",45,1,2584,2334,250,200,188,12,0.710712883917175,0.0930232558139535,1.2739184796199,40,12,28,12,2.3,7.18,15.7,0,0,0,0,0,0,0.108019343286396,191.950939902733,13.3742123124909
9.7,"max_tuv_SVM","SVM",45,2,2484,2240,244,300,282,18,0.77063708173879,0.27906976744186,1.20425106276569,61,18,43,21,2.4,10.78,15.7,0,0,0,0,0,0,0.0814237323650682,145.535021834431,8.94831995746084
9.7,"max_tuv_SVM","SVM",45,3,2384,2167,217,400,355,45,0.783761407123925,0.263565891472868,1.21420355088772,113,45,68,52,1.5,14.37,7.9,0,0,0,0,0,0,0.163600374363836,218.83666950273,20.0352274672185
9.7,"max_tuv_SVM","SVM",45,4,2284,2093,191,500,429,71,0.788888480031401,0.341085271317829,1.18434608652163,177,71,106,64,1.5,17.96,6,0,0,0,0,0,0,0.166356208285535,181.722514572897,17.5396189126721
9.7,"max_tuv_SVM","SVM",45,5,2184,2019,165,600,503,97,0.806857766656847,0.325581395348837,1.18434608652163,235,97,138,58,1.4,21.55,5.2,0,0,0,0,0,0,0.188695808380011,149.032727354283,20.17118817273
9.7,"max_tuv_SVM","SVM",45,6,2084,1959,125,700,563,137,0.813229810617201,0.372093023255814,1.18434608652163,319,137,182,84,1.3,25.14,4.1,0,0,0,0,0,0,0.229067710500323,208.818725220933,24.0062789287458
9.7,"max_tuv_SVM","SVM",45,7,1984,1893,91,800,629,171,0.797541948778329,0.27906976744186,1.18434608652163,392,171,221,73,1.3,28.74,3.7,0,0,0,0,0,0,0.235627999960125,206.666336819839,24.8945515945796
9.7,"max_tuv_SVM","SVM",45,8,1884,1802,82,900,720,180,0.797799528996166,0.294573643410853,1.18434608652163,420,180,240,28,1.3,32.33,4,0,0,0,0,0,0,0.18305143967945,146.088346480012,20.1074882561014
9.7,"max_tuv_SVM","SVM",45,9,1784,1712,72,1000,810,190,0.792292218624272,0.302325581395349,1.18434608652163,456,190,266,36,1.4,35.92,4.3,0,0,0,0,0,0,0.175119967226577,153.554910083064,18.5008333587594
9.7,"max_tuv_SVM","SVM",45,10,1684,1621,63,1100,901,199,0.769183593366693,0.232558139534884,1.1743935983996,494,199,295,38,1.5,39.51,4.5,0,0,0,0,0,0,0.186876016939774,158.787878388474,19.6128607219901
9.7,"max_tuv_SVM","SVM",45,11,1584,1523,61,1200,999,201,0.777849327838287,0.302325581395349,1.1743935983996,497,201,296,3,1.5,43.1,5,0,0,0,0,0,0,0.149938785350342,101.890091425377,15.9476629223698
9.7,"max_tuv_SVM","SVM",45,12,1484,1425,59,1300,1097,203,0.746718918653712,0.248062015503876,1.1743935983996,520,203,317,23,1.6,46.7,5.4,0,0,0,0,0,0,0.164279413271508,121.620826839789,17.2627691078566
9.7,"max_tuv_SVM","SVM",45,13,1384,1328,56,1400,1194,206,0.715079481895786,0.178294573643411,1.1743935983996,534,206,328,14,1.6,50.29,5.8,0,0,0,0,0,0,0.130944050632044,63.9247405220869,14.7413937383852
9.7,"max_tuv_SVM","SVM",45,14,1284,1229,55,1500,1293,207,0.760376803061526,0.310077519379845,1.1743935983996,544,207,337,10,1.6,53.88,6.2,0,0,0,0,0,0,0.116049350963216,57.2533139949384,12.5714243404823
9.7,"max_tuv_SVM","SVM",45,15,1184,1132,52,1600,1390,210,0.758193504072225,0.286821705426357,1.1743935983996,533,210,323,-11,1.5,57.47,6.6,0,0,0,0,0,0,0.0949521323116477,43.6838409313505,10.426161361528
9.7,"max_tuv_SVM","SVM",45,16,1084,1035,49,1700,1487,213,0.762382249043275,0.263565891472868,1.1743935983996,556,213,343,23,1.6,61.06,7,0,0,0,0,0,0,0.0765551810185198,29.7364736273553,8.95812193193315
9.7,"max_tuv_SVM","SVM",45,17,984,940,44,1800,1582,218,0.769760082425673,0.302325581395349,1.1743935983996,577,218,359,21,1.6,64.66,7.3,0,0,0,0,0,0,0.0508269940085417,15.7180172489272,7.8150089634218
9.7,"max_tuv_SVM","SVM",45,18,884,845,39,1900,1677,223,0.760459596702972,0.217054263565891,1.1743935983996,588,223,365,11,1.6,68.25,7.5,0,0,0,0,0,0,0.035887466099274,10.7782320091712,6.48951810282645
9.7,"max_tuv_SVM","SVM",45,19,784,760,24,2000,1762,238,0.766810175645176,0.286821705426357,1.19429857464366,625,238,387,37,1.6,71.84,7.4,0,0,0,0,0,0,0.0381844731173047,13.1055528901493,7.71269083998323
9.7,"max_tuv_SVM","SVM",45,20,684,663,21,2100,1859,241,0.771060249239522,0.248062015503876,1.20425106276569,607,241,366,-18,1.5,75.43,7.7,0,0,0,0,0,0,0.0189067957420882,5.58981218234087,3.10824874808794
9.7,"max_tuv_SVM","SVM",45,21,584,568,16,2200,1954,246,0.800264939652632,0.294573643410853,1.21420355088772,644,246,398,37,1.6,79.02,7.9,0,0,0,0,0,0,0.00855863663676119,2.91629509747101,2.23249688060523
9.7,"max_tuv_SVM","SVM",45,22,484,470,14,2300,2052,248,0.790059856736324,0.248062015503876,1.22415603900975,653,248,405,9,1.6,82.61,8.3,0,0,0,0,0,0,0.00417158522424696,1.67191369030514,1.30628504908545
9.7,"max_tuv_SVM","SVM",45,23,384,374,10,2400,2148,252,0.781185604945526,0.217054263565891,1.22415603900975,659,252,407,6,1.6,86.21,8.5,0,0,0,0,0,0,0.000925962165155542,0.356416988871613,0.291013077653162
9.7,"max_tuv_SVM","SVM",45,24,284,277,7,2500,2245,255,0.77732190167794,0.224806201550388,1.24406101525381,675,255,420,16,1.6,89.8,8.8,0,0,0,0,0,0,0.00144801604106782,0.402901470182621,0.29557185618023
9.7,"max_tuv_SVM","SVM",45,25,184,181,3,2600,2341,259,0.807011088215084,0.271317829457364,1.26396599149787,711,259,452,36,1.7,93.39,9,0,0,0,0,0,0,0.00826202860961485,2.27875850357035,1.85861227971563
9.7,"max_tuv_SVM","SVM",45,26,84,84,0,2700,2438,262,0.790115052497298,0.232558139534884,1.28387096774194,733,262,471,22,1.8,96.98,9.3,0,0,0,0,0,0,3.79067319015525e-06,0.141792885181493,0.141792885181493
9.7,"max_tuv_SVM","SVM",45,27,0,0,0,2784,2522,262,0.804987243646349,0.201550387596899,1.28387096774194,706,262,444,-27,1.7,100,9.6,0,0,0,0,0,0,0,0,0
9.7,"max_tuv_SVM","SVM",46,0,2684,2441,243,100,90,10,0.737109532882962,0.152173913043478,1.23735390369331,31,10,21,0,2.1,3.59,9,0,0,0,0,0,0,0.111225731593695,275.388039189252,12.931796511949
9.7,"max_tuv_SVM","SVM",46,1,2584,2363,221,200,168,32,0.674011201570534,0.260869565217391,1.14326607414525,76,32,44,45,1.4,7.18,5.2,0,0,0,0,0,0,0.274461502570209,368.490344249191,35.5943447751682
9.7,"max_tuv_SVM","SVM",46,2,2484,2283,201,300,248,52,0.69063456319649,0.239130434782609,1.20014025245442,137,52,85,61,1.6,10.78,4.8,0,0,0,0,0,0,0.198178350041711,399.743440944641,20.480652195942
9.7,"max_tuv_SVM","SVM",46,3,2384,2202,182,400,329,71,0.748403487499283,0.231884057971014,1.23735390369331,182,71,111,45,1.6,14.37,4.6,0,0,0,0,0,0,0.179094152298306,302.859187269152,18.6928865094011
9.7,"max_tuv_SVM","SVM",46,4,2284,2115,169,500,416,84,0.740735608291476,0.231884057971014,1.23735390369331,208,84,124,26,1.5,17.96,5,0,0,0,0,0,0,0.166812975298527,254.620610895129,18.3586021760553
9.7,"max_tuv_SVM","SVM",46,5,2184,2027,157,600,504,96,0.759143137594552,0.239130434782609,1.23735390369331,233,96,137,25,1.4,21.55,5.2,0,0,0,0,0,0,0.149914766307055,198.318805472475,15.5587346601251
9.7,"max_tuv_SVM","SVM",46,6,2084,1951,133,700,580,120,0.797355505514175,0.260869565217391,1.25596072931276,288,120,168,55,1.4,25.14,4.8,0,0,0,0,0,0,0.169664168809211,214.013858255167,17.3833938284351
9.7,"max_tuv_SVM","SVM",46,7,1984,1887,97,800,644,156,0.808897742363877,0.297101449275362,1.25596072931276,373,156,217,85,1.4,28.74,4.1,0,0,0,0,0,0,0.198272166816447,216.768852128159,20.4562056018884
9.7,"max_tuv_SVM","SVM",46,8,1884,1818,66,900,713,187,0.808048963566024,0.318840579710145,1.24665731650304,458,187,271,85,1.4,32.33,3.8,0,0,0,0,0,0,0.198641416468223,163.905704303269,20.9383817985064
9.7,"max_tuv_SVM","SVM",46,9,1784,1730,54,1000,801,199,0.810993706334083,0.297101449275362,1.24665731650304,485,199,286,27,1.4,35.92,4,0,0,0,0,0,0,0.184127984462695,146.967636852651,19.5634562742268
9.7,"max_tuv_SVM","SVM",46,10,1684,1643,41,1100,888,212,0.817674230613776,0.311594202898551,1.24665731650304,512,212,300,27,1.4,39.51,4.2,0,0,0,0,0,0,0.178989963422717,155.209082218777,18.6697540056906
9.7,"max_tuv_SVM","SVM",46,11,1584,1550,34,1200,981,219,0.824383624920606,0.333333333333333,1.23735390369331,551,219,332,39,1.5,43.1,4.5,0,0,0,0,0,0,0.153097523276123,82.1919934850668,16.700660597477
9.7,"max_tuv_SVM","SVM",46,12,1484,1460,24,1300,1071,229,0.832605808649458,0.326086956521739,1.24665731650304,566,229,337,15,1.5,46.7,4.7,0,0,0,0,0,0,0.147904129185488,101.736071730322,16.1400320350818
9.7,"max_tuv_SVM","SVM",46,13,1384,1365,19,1400,1166,234,0.82788267220971,0.311594202898551,1.24665731650304,601,234,367,35,1.6,50.29,5,0,0,0,0,0,0,0.109345103651617,55.5013202716579,12.3821405580383
9.7,"max_tuv_SVM","SVM",46,14,1284,1269,15,1500,1262,238,0.813418788613661,0.27536231884058,1.21874707807387,602,238,364,1,1.5,53.88,5.3,0,0,0,0,0,0,0.126195481148706,67.1650155521683,15.2407650460531
9.7,"max_tuv_SVM","SVM",46,15,1184,1169,15,1600,1362,238,0.811057220393786,0.260869565217391,1.22805049088359,598,238,360,-4,1.5,57.47,5.7,0,0,0,0,0,0,0.102393689640305,47.0707287185935,11.4129979050652
9.7,"max_tuv_SVM","SVM",46,16,1084,1069,15,1700,1462,238,0.815780356833535,0.253623188405797,1.22805049088359,604,238,366,6,1.5,61.06,6.1,0,0,0,0,0,0,0.0633164774800946,24.3377084102412,7.67399574840833
9.7,"max_tuv_SVM","SVM",46,17,984,969,15,1800,1562,238,0.817477914429238,0.27536231884058,1.22805049088359,622,238,384,18,1.6,64.66,6.6,0,0,0,0,0,0,0.0857019119087193,50.2427422531855,9.27728581095975
9.7,"max_tuv_SVM","SVM",46,18,884,870,14,1900,1661,239,0.807142444713897,0.260869565217391,1.21874707807387,625,239,386,3,1.6,68.25,6.9,0,0,0,0,0,0,0.0531329486031527,20.6057491194669,6.30677909548116
9.7,"max_tuv_SVM","SVM",46,19,784,771,13,2000,1760,240,0.808216409723425,0.282608695652174,1.20944366526414,607,240,367,-18,1.5,71.84,7.3,0,0,0,0,0,0,0.0340563135715921,11.5140988535907,4.32784263199269
9.7,"max_tuv_SVM","SVM",46,20,684,671,13,2100,1860,240,0.808372307869969,0.304347826086957,1.20944366526414,629,240,389,22,1.6,75.43,7.8,0,0,0,0,0,0,0.0556803789124576,23.2089839994955,6.24548154570828
9.7,"max_tuv_SVM","SVM",46,21,584,571,13,2200,1960,240,0.807662105202379,0.27536231884058,1.20944366526414,621,240,381,-8,1.6,79.02,8.2,0,0,0,0,0,0,0.0143141446700937,4.60854754736675,1.93804862223354
9.7,"max_tuv_SVM","SVM",46,22,484,472,12,2300,2059,241,0.812835614065478,0.304347826086957,1.20014025245442,650,241,409,29,1.7,82.61,8.5,0,0,0,0,0,0,0.0286456715311373,9.56096557419535,4.13455214348127
9.7,"max_tuv_SVM","SVM",46,23,384,372,12,2400,2159,241,0.814284889427799,0.304347826086957,1.20014025245442,620,241,379,-30,1.6,86.21,9,0,0,0,0,0,0,0.00227002889823169,0.644813293623952,0.452783667522563
9.7,"max_tuv_SVM","SVM",46,24,284,273,11,2500,2258,242,0.785732432588487,0.246376811594203,1.21874707807387,649,242,407,29,1.7,89.8,9.3,0,0,0,0,0,0,0.00385933557258251,1.09111610822295,0.769318904286368
9.7,"max_tuv_SVM","SVM",46,25,184,176,8,2600,2355,245,0.780281771464863,0.202898550724638,1.22805049088359,671,245,426,22,1.7,93.39,9.6,0,0,0,0,0,0,0.0258354394775745,7.70166296522471,6.34222277938005
9.7,"max_tuv_SVM","SVM",46,26,84,81,3,2700,2450,250,0.808129799642017,0.231884057971014,1.27456755493221,657,250,407,-14,1.6,96.98,9.8,0,0,0,0,0,0,1.0000000994736e-07,0.629700226595476,0.629700226595476
9.7,"max_tuv_SVM","SVM",46,27,0,0,0,2784,2531,253,0.83126623939027,0.268115942028986,1.28387096774194,693,253,440,36,1.7,100,10,0,0,0,0,0,0,0,0,0
9.7,"max_tuv_SVM","SVM",47,0,2684,2418,266,100,90,10,0.739572701911955,0.217391304347826,1.21688639551192,27,10,17,0,1.7,3.59,9,0,0,0,0,0,0,0.189042816077575,287.325670790385,21.2535804457923
9.7,"max_tuv_SVM","SVM",47,1,2584,2350,234,200,158,42,0.80511669048106,0.304347826086957,1.2615427769986,103,42,61,76,1.5,7.18,3.8,0,0,0,0,0,0,0.25957961151089,398.445995799392,30.1509413838011
9.7,"max_tuv_SVM","SVM",47,2,2484,2277,207,300,231,69,0.764795536504055,0.11304347826087,1.27270687237027,167,69,98,64,1.4,10.78,3.3,0,0,0,0,0,0,0.26150861178155,462.049166405519,33.0527531710095
9.7,"max_tuv_SVM","SVM",47,3,2384,2193,191,400,315,85,0.807246376811599,0.208695652173913,1.28387096774194,203,85,118,36,1.4,14.37,3.7,0,0,0,0,0,0,0.218745288986395,377.209917738332,22.7731858001591
9.7,"max_tuv_SVM","SVM",47,4,2284,2106,178,500,402,98,0.821902429067159,0.243478260869565,1.28387096774194,241,98,143,38,1.5,17.96,4.1,0,0,0,0,0,0,0.195256956396597,365.72510964884,19.7254180904696
9.7,"max_tuv_SVM","SVM",47,5,2184,2030,154,600,478,122,0.827502211335651,0.252173913043478,1.27270687237027,298,122,176,57,1.4,21.55,3.9,0,0,0,0,0,0,0.194541877782235,274.670306015491,19.884950711764
9.7,"max_tuv_SVM","SVM",47,6,2084,1965,119,700,543,157,0.830700142886308,0.252173913043478,1.27270687237027,379,157,222,81,1.4,25.14,3.5,0,0,0,0,0,0,0.218631411695306,321.749137140844,22.2563439019618
9.7,"max_tuv_SVM","SVM",47,7,1984,1892,92,800,616,184,0.834857453902161,0.234782608695652,1.28387096774194,437,184,253,58,1.4,28.74,3.3,0,0,0,0,0,0,0.210529456605852,250.842913702263,21.7252746256634
9.7,"max_tuv_SVM","SVM",47,8,1884,1815,69,900,693,207,0.838470436143436,0.234782608695652,1.28387096774194,489,207,282,52,1.4,32.33,3.3,0,0,0,0,0,0,0.21958179746817,307.050545143695,22.4161745156599
9.7,"max_tuv_SVM","SVM",47,9,1784,1731,53,1000,777,223,0.84074981288699,0.234782608695652,1.28387096774194,531,223,308,42,1.4,35.92,3.5,0,0,0,0,0,0,0.210675839665852,280.145684482982,21.4997149881935
9.7,"max_tuv_SVM","SVM",47,10,1684,1646,38,1100,862,238,0.834054568959659,0.278260869565217,1.27270687237027,571,238,333,40,1.4,39.51,3.6,0,0,0,0,0,0,0.199558507885257,258.310246088092,20.5810246665282
9.7,"max_tuv_SVM","SVM",47,11,1584,1554,30,1200,954,246,0.833483023746349,0.278260869565217,1.2615427769986,616,246,370,45,1.5,43.1,3.9,0,0,0,0,0,0,0.187439399126194,250.812136859413,19.1235765865291
9.7,"max_tuv_SVM","SVM",47,12,1484,1464,20,1300,1044,256,0.828849425052736,0.260869565217391,1.27270687237027,652,256,396,36,1.5,46.7,4.1,0,0,0,0,0,0,0.180392398006258,226.008277524722,18.5464546573882
9.7,"max_tuv_SVM","SVM",47,13,1384,1371,13,1400,1137,263,0.83632714159353,0.243478260869565,1.27270687237027,659,263,396,7,1.5,50.29,4.3,0,0,0,0,0,0,0.178300683111991,208.602270232843,18.2008529646442
9.7,"max_tuv_SVM","SVM",47,14,1284,1274,10,1500,1234,266,0.79729196434647,0.226086956521739,1.27270687237027,681,266,415,22,1.6,53.88,4.6,0,0,0,0,0,0,0.177523158713941,198.943852097504,18.1355487500165
9.7,"max_tuv_SVM","SVM",47,15,1184,1174,10,1600,1334,266,0.807926787779822,0.252173913043478,1.27270687237027,696,266,430,15,1.6,57.47,5,0,0,0,0,0,0,0.133171135160757,87.2490361513575,14.6211171890844
9.7,"max_tuv_SVM","SVM",47,16,1084,1074,10,1700,1434,266,0.818697693406822,0.260869565217391,1.27270687237027,673,266,407,-23,1.5,61.06,5.4,0,0,0,0,0,0,0.111291276265063,68.9696746368694,12.3176864375525
9.7,"max_tuv_SVM","SVM",47,17,984,975,9,1800,1533,267,0.818071715316053,0.269565217391304,1.28387096774194,697,267,430,24,1.6,64.66,5.7,0,0,0,0,0,0,0.128924401281432,92.3269247158915,13.7800795950704
9.7,"max_tuv_SVM","SVM",47,18,884,878,6,1900,1630,270,0.800979791794247,0.191304347826087,1.28387096774194,696,270,426,-1,1.6,68.25,6,0,0,0,0,0,0,0.140516076366231,73.6962115589452,19.9602532835795
9.7,"max_tuv_SVM","SVM",47,19,784,779,5,2000,1729,271,0.819616248213924,0.234782608695652,1.28387096774194,712,271,441,16,1.6,71.84,6.4,0,0,0,0,0,0,0.0985673831390152,40.8795832011027,11.3051139556293
9.7,"max_tuv_SVM","SVM",47,20,684,680,4,2100,1828,272,0.82653602776077,0.243478260869565,1.28387096774194,731,272,459,19,1.7,75.43,6.7,0,0,0,0,0,0,0.0890126121989148,35.568539734227,9.66692870243274
9.7,"max_tuv_SVM","SVM",47,21,584,582,2,2200,1926,274,0.823120364700282,0.243478260869565,1.28387096774194,734,274,460,3,1.7,79.02,7,0,0,0,0,0,0,0.0697593346835311,24.7461956174945,8.86304449026694
9.7,"max_tuv_SVM","SVM",47,22,484,482,2,2300,2026,274,0.783527250459279,0.173913043478261,1.28387096774194,734,274,460,0,1.7,82.61,7.4,0,0,0,0,0,0,0.0422181928241845,12.9521193288569,5.24276410818612
9.7,"max_tuv_SVM","SVM",47,23,384,383,1,2400,2125,275,0.816744913928014,0.252173913043478,1.28387096774194,748,275,473,14,1.7,86.21,7.7,0,0,0,0,0,0,0.0701019850313457,16.959839098825,9.94819787380156
9.7,"max_tuv_SVM","SVM",47,24,284,283,1,2500,2225,275,0.748315982853645,0.130434782608696,1.28387096774194,763,275,488,15,1.8,89.8,8.1,0,0,0,0,0,0,0.0176109215243246,4.54680185008747,3.42069011125136
9.7,"max_tuv_SVM","SVM",47,25,184,184,0,2600,2324,276,0.754970402122882,0.165217391304348,1.28387096774194,756,276,480,-7,1.7,93.39,8.4,0,0,0,0,0,0,0.0138885475136164,3.90976317232522,3.27071560776116
9.7,"max_tuv_SVM","SVM",47,26,84,84,0,2700,2424,276,0.812315438524869,0.234782608695652,1.28387096774194,749,276,473,-7,1.7,96.98,8.8,0,0,0,0,0,0,1.91191301158002e-10,0.00287075136308928,0.00287075136308928
9.7,"max_tuv_SVM","SVM",47,27,0,0,0,2784,2508,276,0.786425801183916,0.191304347826087,1.28387096774194,771,276,495,22,1.8,100,9.1,0,0,0,0,0,0,0,0,0
9.7,"max_tuv_SVM","SVM",48,0,2684,2433,251,100,90,10,0.727035751263784,0.161538461538462,1.18511166253102,31,10,21,0,2.1,3.59,9,0,0,0,0,0,0,0.218589558783406,281.898055738114,31.1060903501541
9.7,"max_tuv_SVM","SVM",48,1,2584,2342,242,200,181,19,0.766593580607834,0.146153846153846,1.27399503722084,70,19,51,39,2.7,7.18,9.5,0,0,0,0,0,0,0.113327024716623,224.193102724863,11.743306459731
9.7,"max_tuv_SVM","SVM",48,2,2484,2260,224,300,263,37,0.766794567269628,0.238461538461538,1.26411910669975,113,37,76,43,2.1,10.78,7.1,0,0,0,0,0,0,0.138999648106103,276.842910776923,14.2594480972288
9.7,"max_tuv_SVM","SVM",48,3,2384,2198,186,400,325,75,0.74969242950241,0.223076923076923,1.2048635235732,189,75,114,76,1.5,14.37,4.3,0,0,0,0,0,0,0.204250089959798,359.749809411161,22.5613917437485
9.7,"max_tuv_SVM","SVM",48,4,2284,2119,165,500,404,96,0.613496558864734,0.130769230769231,1.11392682754228,224,96,128,35,1.3,17.96,4.2,0,0,0,0,0,0,0.257856969997609,285.893093288861,33.7717271305226
9.7,"max_tuv_SVM","SVM",48,5,2184,2025,159,600,498,102,0.7675802424021,0.269230769230769,1.19498759305211,237,102,135,13,1.3,21.55,4.9,0,0,0,0,0,0,0.207708690144797,229.76747148473,22.0434495990862
9.7,"max_tuv_SVM","SVM",48,6,2084,1954,130,700,569,131,0.78800779584628,0.284615384615385,1.22461538461538,304,131,173,67,1.3,25.14,4.3,0,0,0,0,0,0,0.215760899903459,181.237226224,22.3748399384624
9.7,"max_tuv_SVM","SVM",48,7,1984,1885,99,800,638,162,0.780199768560819,0.330769230769231,1.19498759305211,372,162,210,68,1.3,28.74,3.9,0,0,0,0,0,0,0.223728821634148,142.654091484909,23.5706563287241
9.7,"max_tuv_SVM","SVM",48,8,1884,1808,76,900,715,185,0.778195992447779,0.315384615384615,1.19498759305211,426,185,241,54,1.3,32.33,3.9,0,0,0,0,0,0,0.223085819456034,121.927642849743,23.1111110840225
9.7,"max_tuv_SVM","SVM",48,9,1784,1722,62,1000,801,199,0.769510932456306,0.284615384615385,1.19498759305211,466,199,267,40,1.3,35.92,4,0,0,0,0,0,0,0.195356145410655,125.315583266018,20.9751048654795
9.7,"max_tuv_SVM","SVM",48,10,1684,1627,57,1100,896,204,0.75600219258177,0.223076923076923,1.19498759305211,484,204,280,18,1.4,39.51,4.4,0,0,0,0,0,0,0.142011789405778,71.6692119922658,17.0316757112879
9.7,"max_tuv_SVM","SVM",48,11,1584,1529,55,1200,994,206,0.729873926548517,0.184615384615385,1.19498759305211,492,206,286,8,1.4,43.1,4.8,0,0,0,0,0,0,0.181718784722703,99.8632430332472,41.5673695632683
9.7,"max_tuv_SVM","SVM",48,12,1484,1432,52,1300,1091,209,0.749844692124983,0.215384615384615,1.21473945409429,501,209,292,9,1.4,46.7,5.2,0,0,0,0,0,0,0.0835718431589165,47.7313048869399,12.619176733274
9.7,"max_tuv_SVM","SVM",48,13,1384,1339,45,1400,1184,216,0.772568365917539,0.246153846153846,1.21473945409429,522,216,306,21,1.4,50.29,5.5,0,0,0,0,0,0,0.113316991128048,52.5604856021744,13.3920627384314
9.7,"max_tuv_SVM","SVM",48,14,1284,1253,31,1500,1270,230,0.79327608258725,0.261538461538462,1.22461538461538,562,230,332,40,1.4,53.88,5.5,0,0,0,0,0,0,0.154363203175879,64.1791576673494,16.6748202100438
9.7,"max_tuv_SVM","SVM",48,15,1184,1166,18,1600,1357,243,0.797046105122119,0.3,1.2048635235732,603,243,360,41,1.5,57.47,5.6,0,0,0,0,0,0,0.139702315033745,58.9702802167764,16.1188816238147
9.7,"max_tuv_SVM","SVM",48,16,1084,1070,14,1700,1453,247,0.782246178208178,0.253846153846154,1.2048635235732,599,247,352,-4,1.4,61.06,5.9,0,0,0,0,0,0,0.109729728504496,46.4522692830522,12.4104089402438
9.7,"max_tuv_SVM","SVM",48,17,984,970,14,1800,1553,247,0.787337840306965,0.215384615384615,1.2048635235732,613,247,366,14,1.5,64.66,6.3,0,0,0,0,0,0,0.0568050593518001,19.7318689349716,6.66826925817041
9.7,"max_tuv_SVM","SVM",48,18,884,870,14,1900,1653,247,0.791832632925274,0.269230769230769,1.2048635235732,615,247,368,2,1.5,68.25,6.7,0,0,0,0,0,0,0.04616897814137,14.5337647443313,5.94945437909975
9.7,"max_tuv_SVM","SVM",48,19,784,770,14,2000,1753,247,0.787910347767834,0.253846153846154,1.2048635235732,610,247,363,-5,1.5,71.84,7.1,0,0,0,0,0,0,0.0211453058623243,6.58898102280591,3.10466073222158
9.7,"max_tuv_SVM","SVM",48,20,684,670,14,2100,1853,247,0.785991838723434,0.246153846153846,1.2048635235732,616,247,369,6,1.5,75.43,7.5,0,0,0,0,0,0,0.0101545399792044,2.91953436658236,1.52803047472604
9.7,"max_tuv_SVM","SVM",48,21,584,570,14,2200,1953,247,0.778159449418361,0.230769230769231,1.2048635235732,608,247,361,-8,1.5,79.02,7.9,0,0,0,0,0,0,0.00226247332787343,0.700368194079626,0.47807645221164
9.7,"max_tuv_SVM","SVM",48,22,484,472,12,2300,2051,249,0.792551312503811,0.253846153846154,1.2048635235732,602,249,353,-6,1.4,82.61,8.2,0,0,0,0,0,0,0.00404235535116771,1.23733409021094,0.733873177508947
9.7,"max_tuv_SVM","SVM",48,23,384,377,7,2400,2146,254,0.794932699920827,0.246153846153846,1.21473945409429,637,254,383,35,1.5,86.21,8.4,0,0,0,0,0,0,0.0191580917838944,5.68474304249183,3.02066788045388
9.7,"max_tuv_SVM","SVM",48,24,284,280,4,2500,2243,257,0.794147024788358,0.261538461538462,1.26411910669975,659,257,402,22,1.6,89.8,8.7,0,0,0,0,0,0,0.0209082391182333,5.23752206191102,3.31224176574273
9.7,"max_tuv_SVM","SVM",48,25,184,183,1,2600,2340,260,0.800292344235339,0.246153846153846,1.26411910669975,672,260,412,13,1.6,93.39,9,0,0,0,0,0,0,0.0009366531269376,0.546468613187056,0.510220130950523
9.7,"max_tuv_SVM","SVM",48,26,84,84,0,2700,2439,261,0.782282721237593,0.215384615384615,1.27399503722084,654,261,393,-18,1.5,96.98,9.3,0,0,0,0,0,0,2.95721572148679e-06,2.14214127096737,2.14214127096737
9.7,"max_tuv_SVM","SVM",48,27,0,0,0,2784,2523,261,0.808782508069921,0.238461538461538,1.27399503722084,676,261,415,22,1.6,100,9.7,0,0,0,0,0,0,0,0,0
9.7,"max_tuv_SVM","SVM",49,0,2684,2429,255,100,91,9,0.816957122065906,0.409448818897638,1.22321564643129,36,9,27,0,3,3.59,10.1,0,0,0,0,0,0,0.116513086902038,247.608142451059,11.9244095099573
9.7,"max_tuv_SVM","SVM",49,1,2584,2371,213,200,149,51,0.648816409797119,0.165354330708661,1.12212344424689,121,51,70,85,1.4,7.18,2.9,0,0,0,0,0,0,0.271759419077579,577.385441959989,29.7039078959773
9.7,"max_tuv_SVM","SVM",49,2,2484,2286,198,300,234,66,0.766839571593836,0.141732283464567,1.28387096774194,153,66,87,32,1.3,10.78,3.5,0,0,0,0,0,0,0.260789591217596,452.249619282338,28.2054899210933
9.7,"max_tuv_SVM","SVM",49,3,2384,2201,183,400,319,81,0.769022651789381,0.141732283464567,1.28387096774194,196,81,115,43,1.4,14.37,3.9,0,0,0,0,0,0,0.215642606126021,342.498524938599,23.4713930819654
9.7,"max_tuv_SVM","SVM",49,4,2284,2114,170,500,406,94,0.791941884041746,0.173228346456693,1.2737617475235,223,94,129,27,1.4,17.96,4.3,0,0,0,0,0,0,0.203215597564639,242.15498278421,22.7362912870076
9.7,"max_tuv_SVM","SVM",49,5,2184,2037,147,600,483,117,0.82032192658382,0.244094488188976,1.2737617475235,285,117,168,62,1.4,21.55,4.1,0,0,0,0,0,0,0.200861721163679,213.940757243298,21.1255843811364
9.7,"max_tuv_SVM","SVM",49,6,2084,1965,119,700,555,145,0.830372802925699,0.267716535433071,1.26365252730505,345,145,200,60,1.4,25.14,3.8,0,0,0,0,0,0,0.198236952246671,194.018097770129,21.1437973075362
9.7,"max_tuv_SVM","SVM",49,7,1984,1878,106,800,642,158,0.833513701782535,0.267716535433071,1.26365252730505,369,158,211,24,1.3,28.74,4.1,0,0,0,0,0,0,0.183789894565729,153.568296132763,19.3882323951127
9.7,"max_tuv_SVM","SVM",49,8,1884,1795,89,900,725,175,0.837823885758352,0.251968503937008,1.26365252730505,406,175,231,37,1.3,32.33,4.1,0,0,0,0,0,0,0.18973080067397,171.324845079556,19.7573623356455
9.7,"max_tuv_SVM","SVM",49,9,1784,1709,75,1000,811,189,0.835081041410106,0.236220472440945,1.26365252730505,441,189,252,35,1.3,35.92,4.3,0,0,0,0,0,0,0.168031395089074,101.737110944307,18.6691069598625
9.7,"max_tuv_SVM","SVM",49,10,1684,1625,59,1100,895,205,0.845243870582524,0.275590551181102,1.26365252730505,487,205,282,46,1.4,39.51,4.4,0,0,0,0,0,0,0.161948939574379,106.322777479526,17.2507310553153
9.7,"max_tuv_SVM","SVM",49,11,1584,1531,53,1200,989,211,0.819121543456357,0.244094488188976,1.26365252730505,511,211,300,24,1.4,43.1,4.7,0,0,0,0,0,0,0.160537110396392,95.7758885466176,17.4204168503057
9.7,"max_tuv_SVM","SVM",49,12,1484,1435,49,1300,1085,215,0.828376310781059,0.244094488188976,1.26365252730505,531,215,316,20,1.5,46.7,5,0,0,0,0,0,0,0.149316848229091,83.8044276655601,15.532845471866
9.7,"max_tuv_SVM","SVM",49,13,1384,1344,40,1400,1176,224,0.842320657785072,0.251968503937008,1.26365252730505,561,224,337,30,1.5,50.29,5.2,0,0,0,0,0,0,0.139833874885036,66.6944104799273,15.0376563837727
9.7,"max_tuv_SVM","SVM",49,14,1284,1253,31,1500,1267,233,0.804760483138655,0.204724409448819,1.26365252730505,586,233,353,25,1.5,53.88,5.4,0,0,0,0,0,0,0.142152178076349,64.0670504926006,15.1900181656019
9.7,"max_tuv_SVM","SVM",49,15,1184,1155,29,1600,1365,235,0.799019790772594,0.188976377952756,1.26365252730505,598,235,363,12,1.5,57.47,5.8,0,0,0,0,0,0,0.124861459919913,46.760356469651,13.2494722698877
9.7,"max_tuv_SVM","SVM",49,16,1084,1056,28,1700,1464,236,0.824134542423899,0.244094488188976,1.26365252730505,605,236,369,7,1.6,61.06,6.2,0,0,0,0,0,0,0.0898431685244034,25.1396778541007,10.0786668391375
9.7,"max_tuv_SVM","SVM",49,17,984,956,28,1800,1564,236,0.833041012053583,0.267716535433071,1.26365252730505,607,236,371,2,1.6,64.66,6.6,0,0,0,0,0,0,0.0565892561019019,11.7352539782415,6.99116066849734
9.7,"max_tuv_SVM","SVM",49,18,884,857,27,1900,1663,237,0.834496398850612,0.228346456692913,1.26365252730505,623,237,386,16,1.6,68.25,7,0,0,0,0,0,0,0.0251177240280263,6.0563094945039,4.7074933244247
9.7,"max_tuv_SVM","SVM",49,19,784,762,22,2000,1758,242,0.845038623726533,0.267716535433071,1.26365252730505,608,242,366,-15,1.5,71.84,7.3,0,0,0,0,0,0,0.0115904919433464,3.60806413578809,2.54427061289661
9.7,"max_tuv_SVM","SVM",49,20,684,669,15,2100,1851,249,0.817852744710235,0.21259842519685,1.28387096774194,652,249,403,44,1.6,75.43,7.4,0,0,0,0,0,0,0.0208331820846516,6.78742406469413,3.77308340722079
9.7,"max_tuv_SVM","SVM",49,21,584,578,6,2200,1942,258,0.832580761528031,0.236220472440945,1.28387096774194,671,258,413,19,1.6,79.02,7.5,0,0,0,0,0,0,0.0871825659154785,24.2419690576205,13.4634980419699
9.7,"max_tuv_SVM","SVM",49,22,484,481,3,2300,2039,261,0.803989252528267,0.228346456692913,1.28387096774194,694,261,433,23,1.7,82.61,7.8,0,0,0,0,0,0,0.0458383779448218,11.0674636381163,6.45357369630814
9.7,"max_tuv_SVM","SVM",49,23,384,382,2,2400,2138,262,0.822318418728465,0.275590551181102,1.28387096774194,702,262,440,8,1.7,86.21,8.2,0,0,0,0,0,0,0.0226846794573604,5.58914698300611,3.78413371943106
9.7,"max_tuv_SVM","SVM",49,24,284,283,1,2500,2237,263,0.82058936945678,0.251968503937008,1.28387096774194,694,263,431,-8,1.6,89.8,8.5,0,0,0,0,0,0,0.0572737266150829,13.2046282363723,8.3938021495388
9.7,"max_tuv_SVM","SVM",49,25,184,183,1,2600,2337,263,0.844254953912751,0.322834645669291,1.28387096774194,714,263,451,20,1.7,93.39,8.9,0,0,0,0,0,0,0.00552000364900065,2.05705566775142,1.89671783440188
9.7,"max_tuv_SVM","SVM",49,26,84,84,0,2700,2436,264,0.810202634623276,0.236220472440945,1.28387096774194,698,264,434,-16,1.6,96.98,9.2,0,0,0,0,0,0,7.4244710951817e-05,1.41022859925806,1.41022859925806
9.7,"max_tuv_SVM","SVM",49,27,0,0,0,2784,2520,264,0.815439539251907,0.244094488188976,1.28268876611418,697,264,433,-1,1.6,100,9.5,0,0,0,0,0,0,0,0,0
9.7,"max_tuv_SVM","SVM",50,0,2684,2444,240,100,95,5,0.74104975228219,0.273972602739726,1.13437914273089,17,5,12,0,2.4,3.59,19,0,0,0,0,0,0,0.110065147574643,152.015886393198,16.386038047989
9.7,"max_tuv_SVM","SVM",50,1,2584,2364,220,200,175,25,0.730317144708942,0.178082191780822,1.25749005744587,81,25,56,64,2.2,7.18,7,0,0,0,0,0,0,0.144159733189535,275.75254937386,49.7497079812103
9.7,"max_tuv_SVM","SVM",50,2,2484,2275,209,300,264,36,0.784534938647272,0.315068493150685,1.22231551038445,100,36,64,19,1.8,10.78,7.3,0,0,0,0,0,0,0.144831747883738,260.718015943012,36.2378695869635
9.7,"max_tuv_SVM","SVM",50,3,2384,2203,181,400,336,64,0.763800243872969,0.232876712328767,1.22231551038445,183,64,119,83,1.9,14.37,5.2,0,0,0,0,0,0,0.171021141420925,364.272152650378,31.8101678780323
9.7,"max_tuv_SVM","SVM",50,4,2284,2108,176,500,431,69,0.764085860860585,0.198630136986301,1.22231551038445,188,69,119,5,1.7,17.96,6.2,0,0,0,0,0,0,0.194720921674934,279.193207642867,31.032015259944
9.7,"max_tuv_SVM","SVM",50,5,2184,2022,162,600,517,83,0.792960639782048,0.246575342465753,1.27507733097658,224,83,141,36,1.7,21.55,6.2,0,0,0,0,0,0,0.166994084916632,211.337861403796,18.3268043192253
9.7,"max_tuv_SVM","SVM",50,6,2084,1943,141,700,596,104,0.798903670178284,0.267123287671233,1.27507733097658,286,104,182,62,1.8,25.14,5.7,0,0,0,0,0,0,0.176663370128956,172.377294232918,18.2688293643555
9.7,"max_tuv_SVM","SVM",50,7,1984,1872,112,800,667,133,0.804390811921209,0.253424657534247,1.27507733097658,346,133,213,60,1.6,28.74,5,0,0,0,0,0,0,0.192966648189062,160.489458234832,19.969104602268
9.7,"max_tuv_SVM","SVM",50,8,1884,1797,87,900,742,158,0.806659269919034,0.253424657534247,1.27507733097658,426,158,268,80,1.7,32.33,4.7,0,0,0,0,0,0,0.197349086509098,145.757643844283,20.3796779731945
9.7,"max_tuv_SVM","SVM",50,9,1784,1717,67,1000,822,178,0.814486273906687,0.267123287671233,1.27507733097658,483,178,305,57,1.7,35.92,4.6,0,0,0,0,0,0,0.198192472057595,146.619908064944,20.2873139773454
9.7,"max_tuv_SVM","SVM",50,10,1684,1641,43,1100,898,202,0.811888257846223,0.246575342465753,1.27507733097658,523,202,321,40,1.6,39.51,4.4,0,0,0,0,0,0,0.193145202273671,97.5616568677224,20.3995468149156
9.7,"max_tuv_SVM","SVM",50,11,1584,1555,29,1200,984,216,0.81797409673627,0.219178082191781,1.27507733097658,565,216,349,42,1.6,43.1,4.6,0,0,0,0,0,0,0.18127854249581,82.6440761162596,19.6756127322776
9.7,"max_tuv_SVM","SVM",50,12,1484,1460,24,1300,1079,221,0.811020421614609,0.23972602739726,1.27507733097658,592,221,371,27,1.7,46.7,4.9,0,0,0,0,0,0,0.173152054107276,154.53483629761,17.6481754748571
9.7,"max_tuv_SVM","SVM",50,13,1384,1363,21,1400,1176,224,0.813426195471864,0.273972602739726,1.26628369421122,610,224,386,18,1.7,50.29,5.2,0,0,0,0,0,0,0.13082673833993,51.7308228276483,14.6273040450043
9.7,"max_tuv_SVM","SVM",50,14,1284,1266,18,1500,1273,227,0.828717689578266,0.308219178082192,1.26628369421122,606,227,379,-4,1.7,53.88,5.6,0,0,0,0,0,0,0.111443502721823,40.5897053822173,13.2972088976294
9.7,"max_tuv_SVM","SVM",50,15,1184,1169,15,1600,1370,230,0.823032812997761,0.349315068493151,1.26628369421122,629,230,399,23,1.7,57.47,6,0,0,0,0,0,0,0.089235162672172,34.0307322172895,11.1798689683189
9.7,"max_tuv_SVM","SVM",50,16,1084,1071,13,1700,1468,232,0.800946930166637,0.226027397260274,1.26628369421122,631,232,399,2,1.7,61.06,6.3,0,0,0,0,0,0,0.0782134613568584,28.8549147013149,10.0027928436703
9.7,"max_tuv_SVM","SVM",50,17,984,974,10,1800,1565,235,0.796997726049361,0.246575342465753,1.24869642068051,666,235,431,35,1.8,64.66,6.7,0,0,0,0,0,0,0.0614560203215802,23.8962818163205,8.32488243432102
9.7,"max_tuv_SVM","SVM",50,18,884,874,10,1900,1665,235,0.804473201436866,0.267123287671233,1.24869642068051,654,235,419,-12,1.8,68.25,7.1,0,0,0,0,0,0,0.0509734684190038,19.1679154385559,6.20510596908078
9.7,"max_tuv_SVM","SVM",50,19,784,775,9,2000,1764,236,0.8065219540596,0.301369863013699,1.24869642068051,661,236,425,7,1.8,71.84,7.5,0,0,0,0,0,0,0.0425461489574741,14.6749477292346,5.22072674639015
9.7,"max_tuv_SVM","SVM",50,20,684,678,6,2100,1861,239,0.796322132020954,0.315068493150685,1.26628369421122,652,239,413,-9,1.7,75.43,7.8,0,0,0,0,0,0,0.0330992112979962,10.4087939785494,6.67161593576072
9.7,"max_tuv_SVM","SVM",50,21,584,584,0,2200,1955,245,0.806780107875326,0.321917808219178,1.26628369421122,698,245,453,46,1.8,79.02,8,0,0,0,0,0,0,0.0133314870757673,3.95969717908051,3.11101328122899
9.7,"max_tuv_SVM","SVM",50,22,484,484,0,2300,2055,245,0.810789730970762,0.349315068493151,1.25749005744587,697,245,452,-1,1.8,82.61,8.4,0,0,0,0,0,0,0.00282187823123903,0.76629774741743,0.608063657565568
9.7,"max_tuv_SVM","SVM",50,23,384,384,0,2400,2155,245,0.763250980435225,0.212328767123288,1.26628369421122,699,245,454,2,1.9,86.21,8.8,0,0,0,0,0,0,0.00142886706363644,0.476200764649181,0.426202609322725
9.7,"max_tuv_SVM","SVM",50,24,284,284,0,2500,2255,245,0.792845294460118,0.301369863013699,1.26628369421122,692,245,447,-7,1.8,89.8,9.2,0,0,0,0,0,0,0.000125558457604147,0.0879677057173243,0.0834286514967693
9.7,"max_tuv_SVM","SVM",50,25,184,184,0,2600,2355,245,0.788846656633444,0.267123287671233,1.26628369421122,697,245,452,5,1.8,93.39,9.6,0,0,0,0,0,0,1.22476790111133e-06,0.00451102859261306,0.00447885227002661
9.7,"max_tuv_SVM","SVM",50,26,84,84,0,2700,2455,245,0.733777504366636,0.157534246575342,1.26628369421122,697,245,452,0,1.8,96.98,10,0,0,0,0,0,0,1.0000000994736e-07,1.82609161199056e-05,1.82609161199056e-05
9.7,"max_tuv_SVM","SVM",50,27,0,0,0,2784,2539,245,0.727395063220215,0.171232876712329,1.26628369421122,689,245,444,-8,1.8,100,10.4,0,0,0,0,0,0,0,0,0
9.7,"max_tuv_SVM","SVM",51,0,2684,2433,251,100,91,9,0.778190440473737,0.297709923664122,1.2348682590495,31,9,22,0,2.4,3.59,10.1,0,0,0,0,0,0,0.106481288983141,257.439326638764,10.9947105225871
9.7,"max_tuv_SVM","SVM",51,1,2584,2367,217,200,157,43,0.72138614340499,0.213740458015267,1.28387096774194,107,43,64,76,1.5,7.18,3.7,0,0,0,0,0,0,0.288273627431952,448.554484474303,34.547578896696
9.7,"max_tuv_SVM","SVM",51,2,2484,2290,194,300,234,66,0.746942330724279,0.190839694656489,1.24466880078798,168,66,102,61,1.5,10.78,3.5,0,0,0,0,0,0,0.241451591634337,478.760523688243,25.1182423390604
9.7,"max_tuv_SVM","SVM",51,3,2384,2195,189,400,329,71,0.770006411729824,0.259541984732824,1.20546663383403,191,71,120,23,1.7,14.37,4.6,0,0,0,0,0,0,0.198882550879318,337.282740113725,20.6031794498116
9.7,"max_tuv_SVM","SVM",51,4,2284,2119,165,500,405,95,0.760709403467163,0.282442748091603,1.21526717557252,248,95,153,57,1.6,17.96,4.3,0,0,0,0,0,0,0.199124020495526,234.996811250794,21.3151016422657
9.7,"max_tuv_SVM","SVM",51,5,2184,2042,142,600,482,118,0.773932084054137,0.290076335877863,1.21526717557252,306,118,188,58,1.6,21.55,4.1,0,0,0,0,0,0,0.197398522445728,285.118896666728,20.0928896084455
9.7,"max_tuv_SVM","SVM",51,6,2084,1960,124,700,564,136,0.762342579934903,0.274809160305344,1.20546663383403,358,136,222,52,1.6,25.14,4.1,0,0,0,0,0,0,0.193203444576714,218.032794316757,19.8514922124941
9.7,"max_tuv_SVM","SVM",51,7,1984,1889,95,800,635,165,0.771373440921341,0.251908396946565,1.20546663383403,437,165,272,79,1.6,28.74,3.8,0,0,0,0,0,0,0.202631870135822,222.144442780483,20.9280427235395
9.7,"max_tuv_SVM","SVM",51,8,1884,1801,83,900,723,177,0.789241601238784,0.312977099236641,1.22506771731101,468,177,291,31,1.6,32.33,4.1,0,0,0,0,0,0,0.195470664633894,203.40758623156,20.1058123419202
9.7,"max_tuv_SVM","SVM",51,9,1784,1708,76,1000,816,184,0.779847812148404,0.274809160305344,1.2348682590495,488,184,304,20,1.7,35.92,4.4,0,0,0,0,0,0,0.173008263741491,140.927077139057,18.1373707533678
9.7,"max_tuv_SVM","SVM",51,10,1684,1618,66,1100,906,194,0.796633236955751,0.259541984732824,1.2348682590495,513,194,319,25,1.6,39.51,4.7,0,0,0,0,0,0,0.168028548890747,141.120293937977,17.3576844872194
9.7,"max_tuv_SVM","SVM",51,11,1584,1525,59,1200,999,201,0.823925430372234,0.305343511450382,1.2348682590495,543,201,342,30,1.7,43.1,5,0,0,0,0,0,0,0.158730567829467,103.167154237885,17.0305405236005
9.7,"max_tuv_SVM","SVM",51,12,1484,1432,52,1300,1092,208,0.764520148558565,0.221374045801527,1.2348682590495,547,208,339,4,1.6,46.7,5.2,0,0,0,0,0,0,0.144816383262573,92.264365595724,15.4065312217389
9.7,"max_tuv_SVM","SVM",51,13,1384,1339,45,1400,1185,215,0.798351096647746,0.297709923664122,1.2348682590495,587,215,372,40,1.7,50.29,5.5,0,0,0,0,0,0,0.139131668651273,64.6174093841416,15.2252500599821
9.7,"max_tuv_SVM","SVM",51,14,1284,1242,42,1500,1282,218,0.751980982567348,0.190839694656489,1.2348682590495,597,218,379,10,1.7,53.88,5.9,0,0,0,0,0,0,0.131139125528426,68.7610676391093,13.7459095368569
9.7,"max_tuv_SVM","SVM",51,15,1184,1145,39,1600,1379,221,0.741558897182464,0.175572519083969,1.2348682590495,601,221,380,4,1.7,57.47,6.2,0,0,0,0,0,0,0.101559961958142,30.8490944488647,12.2664584161681
9.7,"max_tuv_SVM","SVM",51,16,1084,1049,35,1700,1475,225,0.803002625179943,0.267175572519084,1.2348682590495,596,225,371,-5,1.6,61.06,6.6,0,0,0,0,0,0,0.058131564574759,15.5994992622163,7.55177880292757
9.7,"max_tuv_SVM","SVM",51,17,984,949,35,1800,1575,225,0.828973155417902,0.320610687022901,1.2348682590495,585,225,360,-11,1.6,64.66,7,0,0,0,0,0,0,0.016007376852171,3.77306298096394,2.82063655335518
9.7,"max_tuv_SVM","SVM",51,18,884,852,32,1900,1672,228,0.809771234318478,0.312977099236641,1.26426988426496,592,228,364,7,1.6,68.25,7.3,0,0,0,0,0,0,0.0319454199787402,10.4257525926045,7.9888568706138
9.7,"max_tuv_SVM","SVM",51,19,784,755,29,2000,1769,231,0.824530310545477,0.282442748091603,1.27407042600345,601,231,370,9,1.6,71.84,7.7,0,0,0,0,0,0,0.0345267940461833,14.2554728736088,10.0358221359154
9.7,"max_tuv_SVM","SVM",51,20,684,664,20,2100,1860,240,0.806135904477317,0.229007633587786,1.26426988426496,646,240,406,45,1.7,75.43,7.8,0,0,0,0,0,0,0.0898463197769324,35.5066622436387,13.6112459102379
9.7,"max_tuv_SVM","SVM",51,21,584,571,13,2200,1953,247,0.786410762028035,0.229007633587786,1.25446934252647,658,247,411,12,1.7,79.02,7.9,0,0,0,0,0,0,0.110227468769815,38.8314612396432,19.4259459577269
9.7,"max_tuv_SVM","SVM",51,22,484,471,13,2300,2053,247,0.833216389833168,0.33587786259542,1.26426988426496,671,247,424,13,1.7,82.61,8.3,0,0,0,0,0,0,0.0412914290726281,11.8040526490794,5.7486249179895
9.7,"max_tuv_SVM","SVM",51,23,384,374,10,2400,2150,250,0.790064238274397,0.16793893129771,1.28150873965041,680,250,430,9,1.7,86.21,8.6,0,0,0,0,0,0,0.039174926363269,10.207815542062,6.21421993095103
9.7,"max_tuv_SVM","SVM",51,24,284,282,2,2500,2242,258,0.840698757576123,0.297709923664122,1.28387096774194,708,258,450,28,1.7,89.8,8.7,0,0,0,0,0,0,0.0265866810331272,6.28097385328041,4.79662708597262
9.7,"max_tuv_SVM","SVM",51,25,184,184,0,2600,2340,260,0.850352645140997,0.320610687022901,1.28387096774194,723,260,463,15,1.8,93.39,9,0,0,0,0,0,0,0.00447124773118214,2.24079164401922,2.18883017697651
9.7,"max_tuv_SVM","SVM",51,26,84,84,0,2700,2440,260,0.775081356383299,0.206106870229008,1.28387096774194,715,260,455,-8,1.8,96.98,9.4,0,0,0,0,0,0,9.89544194575489e-11,0.199025134254761,0.199025134254761
9.7,"max_tuv_SVM","SVM",51,27,0,0,0,2784,2524,260,0.823054402922778,0.236641221374046,1.28387096774194,725,260,465,10,1.8,100,9.7,0,0,0,0,0,0,0,0,0
9.7,"max_tuv_SVM","SVM",52,0,2684,2434,250,100,91,9,0.768083291279157,0.234848484848485,1.2352394916911,24,9,15,0,1.7,3.59,10.1,0,0,0,0,0,0,0.101463488778387,262.590362951463,10.2203890817432
9.7,"max_tuv_SVM","SVM",52,1,2584,2355,229,200,170,30,0.75049864225122,0.28030303030303,1.16715542521994,85,30,55,61,1.8,7.18,5.7,0,0,0,0,0,0,0.182356638928328,340.998310156318,23.0723030063597
9.7,"max_tuv_SVM","SVM",52,2,2484,2273,211,300,252,48,0.791970057433968,0.295454545454545,1.21578690127077,125,48,77,40,1.6,10.78,5.2,0,0,0,0,0,0,0.216065188360902,267.471281682875,25.4793299871123
9.7,"max_tuv_SVM","SVM",52,3,2384,2201,183,400,324,76,0.7788191190253,0.265151515151515,1.21578690127077,187,76,111,62,1.5,14.37,4.3,0,0,0,0,0,0,0.217659086733571,251.260931130951,23.512740667115
9.7,"max_tuv_SVM","SVM",52,4,2284,2130,154,500,395,105,0.789945449739258,0.272727272727273,1.21578690127077,258,105,153,71,1.5,17.96,3.8,0,0,0,0,0,0,0.227494555831789,224.993270228652,23.130881735804
9.7,"max_tuv_SVM","SVM",52,5,2184,2053,131,600,472,128,0.808479321365906,0.287878787878788,1.25469208211144,302,128,174,44,1.4,21.55,3.7,0,0,0,0,0,0,0.236848419404777,178.927741432956,23.9726966995812
9.7,"max_tuv_SVM","SVM",52,6,2084,1983,101,700,542,158,0.809620791579542,0.287878787878788,1.25469208211144,373,158,215,71,1.4,25.14,3.4,0,0,0,0,0,0,0.242132225703022,131.114945132307,24.6966499669943
9.7,"max_tuv_SVM","SVM",52,7,1984,1918,66,800,607,193,0.821419988945754,0.333333333333333,1.24496578690127,454,193,261,81,1.4,28.74,3.1,0,0,0,0,0,0,0.242485879129986,106.33715650481,25.8288742507532
9.7,"max_tuv_SVM","SVM",52,8,1884,1834,50,900,691,209,0.816800038449515,0.325757575757576,1.25469208211144,490,209,281,36,1.3,32.33,3.3,0,0,0,0,0,0,0.205104155866965,82.0406672804305,22.6691585969689
9.7,"max_tuv_SVM","SVM",52,9,1784,1742,42,1000,783,217,0.80973493860091,0.303030303030303,1.21578690127077,507,217,290,17,1.3,35.92,3.6,0,0,0,0,0,0,0.16902544649907,64.2457726673884,19.9744320461211
9.7,"max_tuv_SVM","SVM",52,10,1684,1646,38,1100,879,221,0.817220580107176,0.371212121212121,1.22551319648094,527,221,306,20,1.4,39.51,4,0,0,0,0,0,0,0.154202653032556,64.5251844521059,17.635830286785
9.7,"max_tuv_SVM","SVM",52,11,1584,1549,35,1200,976,224,0.809650830269384,0.295454545454545,1.22551319648094,542,224,318,15,1.4,43.1,4.4,0,0,0,0,0,0,0.0823775367428546,24.8046493433065,10.8113542297639
9.7,"max_tuv_SVM","SVM",52,12,1484,1455,29,1300,1070,230,0.80831711244082,0.272727272727273,1.22551319648094,566,230,336,24,1.5,46.7,4.7,0,0,0,0,0,0,0.070544184146563,22.1701928716033,10.4902861077045
9.7,"max_tuv_SVM","SVM",52,13,1384,1360,24,1400,1165,235,0.82108355561964,0.333333333333333,1.22551319648094,574,235,339,8,1.4,50.29,5,0,0,0,0,0,0,0.0536798378805248,16.321762136408,7.66186264010325
9.7,"max_tuv_SVM","SVM",52,14,1284,1262,22,1500,1263,237,0.813039194482494,0.295454545454545,1.20606060606061,593,237,356,19,1.5,53.88,5.3,0,0,0,0,0,0,0.0842213653632116,36.5167687274604,12.4966974433007
9.7,"max_tuv_SVM","SVM",52,15,1184,1165,19,1600,1360,240,0.789350683680577,0.265151515151515,1.20606060606061,607,240,367,14,1.5,57.47,5.7,0,0,0,0,0,0,0.149899172178427,60.3450046352463,18.0595140426504
9.7,"max_tuv_SVM","SVM",52,16,1084,1066,18,1700,1459,241,0.8091642034941,0.310606060606061,1.20606060606061,617,241,376,10,1.6,61.06,6.1,0,0,0,0,0,0,0.11467595468997,56.4416692475854,12.807964506036
9.7,"max_tuv_SVM","SVM",52,17,984,967,17,1800,1558,242,0.800290774517578,0.234848484848485,1.20606060606061,633,242,391,16,1.6,64.66,6.4,0,0,0,0,0,0,0.0837378328932313,32.5479972892683,9.92608795710273
9.7,"max_tuv_SVM","SVM",52,18,884,868,16,1900,1657,243,0.782694110013694,0.257575757575758,1.20606060606061,636,243,393,3,1.6,68.25,6.8,0,0,0,0,0,0,0.053846446018039,17.6826754186401,8.82578644060732
9.7,"max_tuv_SVM","SVM",52,19,784,768,16,2000,1757,243,0.814541128974117,0.318181818181818,1.20606060606061,638,243,395,2,1.6,71.84,7.2,0,0,0,0,0,0,0.0342377695360495,9.82082939358748,4.72908133357641
9.7,"max_tuv_SVM","SVM",52,20,684,668,16,2100,1857,243,0.794469276428037,0.242424242424242,1.20606060606061,636,243,393,-2,1.6,75.43,7.6,0,0,0,0,0,0,0.00684163767750277,1.92456488809197,1.33843671382519
9.7,"max_tuv_SVM","SVM",52,21,584,569,15,2200,1956,244,0.799720039410755,0.325757575757576,1.21578690127077,620,244,376,-16,1.5,79.02,8,0,0,0,0,0,0,0.010177000007486,2.61480410892187,1.5378961774939
9.7,"max_tuv_SVM","SVM",52,22,484,470,14,2300,2055,245,0.788404464950849,0.21969696969697,1.21578690127077,648,245,403,28,1.6,82.61,8.4,0,0,0,0,0,0,0.00261858795327429,0.968615685445879,0.759359316786852
9.7,"max_tuv_SVM","SVM",52,23,384,370,14,2400,2155,245,0.808713623146607,0.287878787878788,1.21578690127077,636,245,391,-12,1.6,86.21,8.8,0,0,0,0,0,0,0.000978071903806519,0.288490673540785,0.241861389502942
9.7,"max_tuv_SVM","SVM",52,24,284,271,13,2500,2254,246,0.803973517891039,0.242424242424242,1.21578690127077,634,246,388,-2,1.6,89.8,9.2,0,0,0,0,0,0,0.000947876854694091,0.392790461288131,0.340724016530104
9.7,"max_tuv_SVM","SVM",52,25,184,176,8,2600,2349,251,0.807488044601436,0.25,1.22551319648094,677,251,426,43,1.7,93.39,9.4,0,0,0,0,0,0,0.0025009508139626,0.992129006739903,0.892050164640252
9.7,"max_tuv_SVM","SVM",52,26,84,83,1,2700,2442,258,0.771862158460095,0.227272727272727,1.27414467253177,680,258,422,3,1.6,96.98,9.5,0,0,0,0,0,0,1.48296396949526e-07,2.56268551419811,2.56268551419811
9.7,"max_tuv_SVM","SVM",52,27,0,0,0,2784,2525,259,0.791195059236297,0.212121212121212,1.2644183773216,688,259,429,8,1.7,100,9.7,0,0,0,0,0,0,0,0,0
9.7,"max_tuv_SVM","SVM",53,0,2684,2423,261,100,83,17,0.802316095132735,0.327433628318584,1.21570082786183,42,17,25,0,1.5,3.59,4.9,0,0,0,0,0,0,0.235855484723852,441.858175829896,24.3194199804165
9.7,"max_tuv_SVM","SVM",53,1,2584,2352,232,200,154,46,0.676811393805305,0.0884955752212389,1.22706251784185,125,46,79,83,1.7,7.18,3.3,0,0,0,0,0,0,0.260029948091717,580.683235379111,27.9263373184013
9.7,"max_tuv_SVM","SVM",53,2,2484,2261,223,300,245,55,0.78988523230088,0.185840707964602,1.23842420782187,146,55,91,21,1.7,10.78,4.5,0,0,0,0,0,0,0.202241649767804,424.755493870543,23.1936204861083
9.7,"max_tuv_SVM","SVM",53,3,2384,2177,207,400,329,71,0.773561946902647,0.221238938053097,1.20433913788182,184,71,113,38,1.6,14.37,4.6,0,0,0,0,0,0,0.198284429081163,369.018540128984,21.228993082924
9.7,"max_tuv_SVM","SVM",53,4,2284,2100,184,500,406,94,0.801680033185835,0.238938053097345,1.24978589780188,248,94,154,64,1.6,17.96,4.3,0,0,0,0,0,0,0.206611938792479,361.883222991994,21.1219185392988
9.7,"max_tuv_SVM","SVM",53,5,2184,2027,157,600,479,121,0.803761061946895,0.274336283185841,1.22706251784185,304,121,183,56,1.5,21.55,4,0,0,0,0,0,0,0.2150052959835,334.688980879633,21.8161322375004
9.7,"max_tuv_SVM","SVM",53,6,2084,1957,127,700,549,151,0.806554203539816,0.230088495575221,1.23842420782187,379,151,228,75,1.5,25.14,3.6,0,0,0,0,0,0,0.225444696472766,214.703000359168,23.3066751592896
9.7,"max_tuv_SVM","SVM",53,7,1984,1889,95,800,617,183,0.811041205752205,0.274336283185841,1.23842420782187,446,183,263,67,1.4,28.74,3.4,0,0,0,0,0,0,0.232593473145238,317.769019770271,23.6928137242116
9.7,"max_tuv_SVM","SVM",53,8,1884,1806,78,900,700,200,0.809720685840701,0.238938053097345,1.23842420782187,494,200,294,48,1.5,32.33,3.5,0,0,0,0,0,0,0.217868647386257,238.198587746318,22.5767802465546
9.7,"max_tuv_SVM","SVM",53,9,1784,1720,64,1000,786,214,0.801106194690258,0.247787610619469,1.22706251784185,526,214,312,32,1.5,35.92,3.7,0,0,0,0,0,0,0.1909649601214,162.692476200708,20.3191790018208
9.7,"max_tuv_SVM","SVM",53,10,1684,1627,57,1100,879,221,0.813461006637161,0.256637168141593,1.23842420782187,543,221,322,17,1.5,39.51,4,0,0,0,0,0,0,0.189997144698454,230.588164675076,19.5188536866087
9.7,"max_tuv_SVM","SVM",53,11,1584,1536,48,1200,970,230,0.806872234513266,0.265486725663717,1.23842420782187,571,230,341,28,1.5,43.1,4.2,0,0,0,0,0,0,0.169835341301683,165.318205330258,18.5508885996545
9.7,"max_tuv_SVM","SVM",53,12,1484,1442,42,1300,1064,236,0.813571626106187,0.265486725663717,1.23842420782187,598,236,362,27,1.5,46.7,4.5,0,0,0,0,0,0,0.158241951630824,149.545757408681,17.046183273927
9.7,"max_tuv_SVM","SVM",53,13,1384,1349,35,1400,1157,243,0.80114076327433,0.230088495575221,1.20433913788182,612,243,369,14,1.5,50.29,4.8,0,0,0,0,0,0,0.176282744805614,123.304027616288,18.5064953683059
9.7,"max_tuv_SVM","SVM",53,14,1284,1251,33,1500,1255,245,0.803546736725657,0.238938053097345,1.20433913788182,643,245,398,31,1.6,53.88,5.1,0,0,0,0,0,0,0.147166176040971,85.6403699012332,15.9489458609248
9.7,"max_tuv_SVM","SVM",53,15,1184,1160,24,1600,1346,254,0.795257190265481,0.20353982300885,1.22706251784185,650,254,396,7,1.6,57.47,5.3,0,0,0,0,0,0,0.127195344648815,66.386659794848,14.692662140106
9.7,"max_tuv_SVM","SVM",53,16,1084,1061,23,1700,1445,255,0.79632190265486,0.247787610619469,1.1929774479018,666,255,411,16,1.6,61.06,5.7,0,0,0,0,0,0,0.128864005001051,91.8957205967966,13.7217518069803
9.7,"max_tuv_SVM","SVM",53,17,984,961,23,1800,1545,255,0.792056139380526,0.212389380530973,1.21570082786183,677,255,422,11,1.7,64.66,6.1,0,0,0,0,0,0,0.0903358188706541,44.1876322319905,9.82985952805198
9.7,"max_tuv_SVM","SVM",53,18,884,863,21,1900,1643,257,0.781298396017694,0.168141592920354,1.22706251784185,667,257,410,-10,1.6,68.25,6.4,0,0,0,0,0,0,0.0868876344224984,43.1048452566285,10.0565404719122
9.7,"max_tuv_SVM","SVM",53,19,784,767,17,2000,1739,261,0.783600663716811,0.194690265486726,1.2611475877819,693,261,432,26,1.7,71.84,6.7,0,0,0,0,0,0,0.0927576121081535,39.3460616292868,11.3736294121348
9.7,"max_tuv_SVM","SVM",53,20,684,676,8,2100,1830,270,0.822013274336281,0.185840707964602,1.27250927776192,738,270,468,45,1.7,75.43,6.8,0,0,0,0,0,0,0.0758615233890086,29.2178838998674,10.7250986108519
9.7,"max_tuv_SVM","SVM",53,21,584,581,3,2200,1925,275,0.822130807522122,0.185840707964602,1.27250927776192,745,275,470,7,1.7,79.02,7,0,0,0,0,0,0,0.0465483201141218,15.5023277060222,6.05250432969772
9.7,"max_tuv_SVM","SVM",53,22,484,481,3,2300,2025,275,0.823513550884954,0.212389380530973,1.27250927776192,739,275,464,-6,1.7,82.61,7.4,0,0,0,0,0,0,0.0394083883196821,11.7779819562493,4.8646846283217
9.7,"max_tuv_SVM","SVM",53,23,384,383,1,2400,2123,277,0.835218473451326,0.238938053097345,1.28387096774194,748,277,471,9,1.7,86.21,7.7,0,0,0,0,0,0,0.00982176848242897,3.46121644843581,2.90991644281773
9.7,"max_tuv_SVM","SVM",53,24,284,284,0,2500,2222,278,0.818100110619467,0.194690265486726,1.28387096774194,748,278,470,0,1.7,89.8,8,0,0,0,0,0,0,0.00766483450591334,1.94134128038169,1.53984348720263
9.7,"max_tuv_SVM","SVM",53,25,184,184,0,2600,2322,278,0.830696902654866,0.247787610619469,1.28387096774194,764,278,486,16,1.7,93.39,8.4,0,0,0,0,0,0,0.000336261685649971,0.201359800742342,0.19204369387388
9.7,"max_tuv_SVM","SVM",53,26,84,84,0,2700,2422,278,0.814193860619468,0.221238938053097,1.28387096774194,745,278,467,-19,1.7,96.98,8.7,0,0,0,0,0,0,9.65710717619754e-07,0.0471097127478381,0.0471097127478381
9.7,"max_tuv_SVM","SVM",53,27,0,0,0,2784,2506,278,0.808759679203538,0.185840707964602,1.28387096774194,755,278,477,10,1.7,100,9,0,0,0,0,0,0,0,0,0
9.7,"max_tuv_SVM","SVM",54,0,2684,2421,263,100,92,8,0.199620319455355,0.00833333333333333,0.588440860215054,26,8,18,0,2.2,3.59,11.5,0,0,0,0,0,0,0.0861441520016099,216.310347292137,8.68634787055599
9.7,"max_tuv_SVM","SVM",54,1,2584,2339,245,200,174,26,0.843905472636802,0.291666666666667,1.27317204301075,94,26,68,68,2.6,7.18,6.7,0,0,0,0,0,0,0.190248327139368,296.382551578143,21.649715231472
9.7,"max_tuv_SVM","SVM",54,2,2484,2261,223,300,252,48,0.825288033516621,0.241666666666667,1.27317204301075,143,48,95,49,2,10.78,5.2,0,0,0,0,0,0,0.196227369862622,333.501319389599,20.4130871570177
9.7,"max_tuv_SVM","SVM",54,3,2384,2193,191,400,320,80,0.817930086410052,0.233333333333333,1.27317204301075,207,80,127,64,1.6,14.37,4,0,0,0,0,0,0,0.209141750699506,420.083198677811,21.491673054239
9.7,"max_tuv_SVM","SVM",54,4,2284,2108,176,500,405,95,0.79359125425504,0.216666666666667,1.27317204301075,251,95,156,44,1.6,17.96,4.3,0,0,0,0,0,0,0.208407898592247,242.348061936171,21.7738694713996
9.7,"max_tuv_SVM","SVM",54,5,2184,2033,151,600,480,120,0.79497905210788,0.183333333333333,1.28387096774194,315,120,195,64,1.6,21.55,4,0,0,0,0,0,0,0.204955951164485,202.256375011812,21.4044854860267
9.7,"max_tuv_SVM","SVM",54,6,2084,1954,130,700,559,141,0.797270227808325,0.183333333333333,1.28387096774194,362,141,221,47,1.6,25.14,4,0,0,0,0,0,0,0.20673456612613,164.607227309907,23.5537746620276
9.7,"max_tuv_SVM","SVM",54,7,1984,1866,118,800,647,153,0.796969101859125,0.191666666666667,1.28387096774194,395,153,242,33,1.6,28.74,4.2,0,0,0,0,0,0,0.17688615207979,165.133474205163,18.3605803408867
9.7,"max_tuv_SVM","SVM",54,8,1884,1798,86,900,715,185,0.818938203718247,0.225,1.27317204301075,455,185,270,60,1.5,32.33,3.9,0,0,0,0,0,0,0.184046369687328,157.269265176759,19.3839839837733
9.7,"max_tuv_SVM","SVM",54,9,1784,1714,70,1000,799,201,0.833536266038227,0.258333333333333,1.28387096774194,500,201,299,45,1.5,35.92,4,0,0,0,0,0,0,0.177197863376679,154.462651747785,18.5124027861217
9.7,"max_tuv_SVM","SVM",54,10,1684,1635,49,1100,878,222,0.838393558523167,0.3,1.27317204301075,576,222,354,76,1.6,39.51,4,0,0,0,0,0,0,0.196047186657486,237.464449556074,20.0444874559373
9.7,"max_tuv_SVM","SVM",54,11,1584,1548,36,1200,965,235,0.844527363184075,0.325,1.28387096774194,605,235,370,29,1.6,43.1,4.1,0,0,0,0,0,0,0.189454071520653,247.477050194397,19.2172305428379
9.7,"max_tuv_SVM","SVM",54,12,1484,1462,22,1300,1051,249,0.815854935847082,0.241666666666667,1.28387096774194,637,249,388,32,1.6,46.7,4.2,0,0,0,0,0,0,0.184042998623122,155.15644060271,19.9794021531809
9.7,"max_tuv_SVM","SVM",54,13,1384,1365,19,1400,1148,252,0.843728724797069,0.275,1.28387096774194,659,252,407,22,1.6,50.29,4.6,0,0,0,0,0,0,0.146048608850653,90.1804312697753,15.9250150230734
9.7,"max_tuv_SVM","SVM",54,14,1284,1267,17,1500,1246,254,0.829366326263422,0.233333333333333,1.28387096774194,664,254,410,5,1.6,53.88,4.9,0,0,0,0,0,0,0.124904180388309,72.072533865534,14.0950740452105
9.7,"max_tuv_SVM","SVM",54,15,1184,1171,13,1600,1342,258,0.837765121759624,0.3,1.28387096774194,702,258,444,38,1.7,57.47,5.2,0,0,0,0,0,0,0.0981577935531241,48.9877549153193,11.5598568558151
9.7,"max_tuv_SVM","SVM",54,16,1084,1073,11,1700,1440,260,0.827081696779262,0.183333333333333,1.28387096774194,707,260,447,5,1.7,61.06,5.5,0,0,0,0,0,0,0.0817356640312883,33.8799149385902,9.9281261231477
9.7,"max_tuv_SVM","SVM",54,17,984,979,5,1800,1534,266,0.825608798114691,0.216666666666667,1.28387096774194,749,266,483,42,1.8,64.66,5.8,0,0,0,0,0,0,0.0788855635285533,26.6782674761244,10.5663907469109
9.7,"max_tuv_SVM","SVM",54,18,884,879,5,1900,1634,266,0.794605917779524,0.15,1.28387096774194,728,266,462,-21,1.7,68.25,6.1,0,0,0,0,0,0,0.128254969437703,91.1286124403529,13.2341109029684
9.7,"max_tuv_SVM","SVM",54,19,784,781,3,2000,1732,268,0.775320764598064,0.158333333333333,1.28387096774194,771,268,503,43,1.9,71.84,6.5,0,0,0,0,0,0,0.0506646350689144,15.9016679476366,8.8818392067612
9.7,"max_tuv_SVM","SVM",54,20,684,681,3,2100,1832,268,0.797073841319718,0.183333333333333,1.28387096774194,773,268,505,2,1.9,75.43,6.8,0,0,0,0,0,0,0.0384298770454238,11.3356199661896,5.47004922055373
9.7,"max_tuv_SVM","SVM",54,21,584,581,3,2200,1932,268,0.770299816705944,0.15,1.28387096774194,793,268,525,20,2,79.02,7.2,0,0,0,0,0,0,0.0128338291514219,3.68088460676606,2.28753742473044
9.7,"max_tuv_SVM","SVM",54,22,484,482,2,2300,2031,269,0.840095574757791,0.25,1.28387096774194,739,269,470,-54,1.7,82.61,7.6,0,0,0,0,0,0,0.00803489883907725,2.44727475347045,1.75429265772392
9.7,"max_tuv_SVM","SVM",54,23,384,383,1,2400,2130,270,0.827683948677665,0.275,1.28387096774194,807,270,537,68,2,86.21,7.9,0,0,0,0,0,0,0.0165768194932488,7.77486032582935,6.96157196071882
9.7,"max_tuv_SVM","SVM",54,24,284,283,1,2500,2230,270,0.687758575543337,0.108333333333333,1.27317204301075,806,270,536,-1,2,89.8,8.3,0,0,0,0,0,0,0.0035817536687719,1.32749726462271,1.13052364561484
9.7,"max_tuv_SVM","SVM",54,25,184,184,0,2600,2329,271,0.808189316575017,0.241666666666667,1.27317204301075,770,271,499,-36,1.8,93.39,8.6,0,0,0,0,0,0,0.000700470168112121,0.887579802756695,0.869764670981984
9.7,"max_tuv_SVM","SVM",54,26,84,84,0,2700,2429,271,0.74971851269966,0.141666666666667,1.28387096774194,790,271,519,20,1.9,96.98,9,0,0,0,0,0,0,3.08466165956408e-06,0.101481260040442,0.101481260040442
9.7,"max_tuv_SVM","SVM",54,27,0,0,0,2784,2513,271,0.790907305577377,0.175,1.28387096774194,774,271,503,-16,1.9,100,9.3,0,0,0,0,0,0,0,0,0
9.7,"max_tuv_SVM","SVM",55,0,2684,2420,264,100,91,9,0.381994017946162,0.0254237288135593,0.826899945325314,33,9,24,0,2.7,3.59,10.1,0,0,0,0,0,0,0.0998685057353668,244.754137602156,10.0712576361394
9.7,"max_tuv_SVM","SVM",55,1,2584,2338,246,200,173,27,0.603549351944168,0.0847457627118644,1.15330781848004,80,27,53,47,2,7.18,6.4,0,0,0,0,0,0,0.17589342166347,323.138059474965,20.8704831283004
9.7,"max_tuv_SVM","SVM",55,2,2484,2246,238,300,265,35,0.725144566301099,0.186440677966102,1.25123018042646,97,35,62,17,1.8,10.78,7.6,0,0,0,0,0,0,0.174448302731809,236.217768188997,19.7186645196737
9.7,"max_tuv_SVM","SVM",55,3,2384,2163,221,400,348,52,0.771439016284483,0.220338983050847,1.26211044286495,136,52,84,39,1.6,14.37,6.7,0,0,0,0,0,0,0.142696708313795,279.010607727697,14.6195003051993
9.7,"max_tuv_SVM","SVM",55,4,2284,2100,184,500,411,89,0.793253572615489,0.23728813559322,1.27299070530344,214,89,125,78,1.4,17.96,4.6,0,0,0,0,0,0,0.19494779645914,262.800909908164,21.1858933617492
9.7,"max_tuv_SVM","SVM",55,5,2184,2024,160,600,487,113,0.799029577932872,0.254237288135593,1.27299070530344,281,113,168,67,1.5,21.55,4.3,0,0,0,0,0,0,0.2116899560804,214.657038923266,22.993145711127
9.7,"max_tuv_SVM","SVM",55,6,2084,1960,124,700,551,149,0.800112994350288,0.228813559322034,1.26211044286495,350,149,201,69,1.3,25.14,3.7,0,0,0,0,0,0,0.210145457996869,187.020936584795,22.5648247982814
9.7,"max_tuv_SVM","SVM",55,7,1984,1892,92,800,619,181,0.803349950149557,0.271186440677966,1.27299070530344,426,181,245,76,1.4,28.74,3.4,0,0,0,0,0,0,0.206565418659954,170.922208389171,22.3996701455671
9.7,"max_tuv_SVM","SVM",55,8,1884,1821,63,900,690,210,0.807743436357599,0.245762711864407,1.27299070530344,482,210,272,56,1.3,32.33,3.3,0,0,0,0,0,0,0.205523271681969,171.39834576822,21.9471758644669
9.7,"max_tuv_SVM","SVM",55,9,1784,1738,46,1000,773,227,0.803549351944173,0.271186440677966,1.27299070530344,534,227,307,52,1.4,35.92,3.4,0,0,0,0,0,0,0.191250602444889,131.926927589316,21.7888823262433
9.7,"max_tuv_SVM","SVM",55,10,1684,1646,38,1100,865,235,0.807298105682956,0.271186440677966,1.26211044286495,569,235,334,35,1.4,39.51,3.7,0,0,0,0,0,0,0.157644908843565,106.994305228456,18.1468182916025
9.7,"max_tuv_SVM","SVM",55,11,1584,1554,30,1200,957,243,0.806513791957464,0.245762711864407,1.27299070530344,588,243,345,19,1.4,43.1,3.9,0,0,0,0,0,0,0.177212702279871,155.688975486541,18.5724591442991
9.7,"max_tuv_SVM","SVM",55,12,1484,1466,18,1300,1045,255,0.80687936191426,0.220338983050847,1.27299070530344,631,255,376,43,1.5,46.7,4.1,0,0,0,0,0,0,0.166267059149771,113.098795383359,19.049804492478
9.7,"max_tuv_SVM","SVM",55,13,1384,1372,12,1400,1139,261,0.789092721834499,0.152542372881356,1.28387096774194,651,261,390,20,1.5,50.29,4.4,0,0,0,0,0,0,0.173491336480809,128.060322366072,18.9059746899873
9.7,"max_tuv_SVM","SVM",55,14,1284,1273,11,1500,1238,262,0.793346626786309,0.220338983050847,1.28387096774194,667,262,405,16,1.5,53.88,4.7,0,0,0,0,0,0,0.165609902776994,110.463064748769,17.879449734928
9.7,"max_tuv_SVM","SVM",55,15,1184,1176,8,1600,1335,265,0.765609837155203,0.144067796610169,1.28387096774194,684,265,419,17,1.6,57.47,5,0,0,0,0,0,0,0.148165953117602,86.2080315755092,16.4292943165275
9.7,"max_tuv_SVM","SVM",55,16,1084,1077,7,1700,1434,266,0.783356596876041,0.186440677966102,1.28387096774194,689,266,423,5,1.6,61.06,5.4,0,0,0,0,0,0,0.144933521163868,112.180655727972,14.8618384721204
9.7,"max_tuv_SVM","SVM",55,17,984,979,5,1800,1532,268,0.776304420073117,0.186440677966102,1.28387096774194,709,268,441,20,1.6,64.66,5.7,0,0,0,0,0,0,0.106551301484525,52.4390444518117,11.7065204548909
9.7,"max_tuv_SVM","SVM",55,18,884,880,4,1900,1631,269,0.772987703556001,0.152542372881356,1.28387096774194,701,269,432,-8,1.6,68.25,6.1,0,0,0,0,0,0,0.0667011988780952,25.5306468416213,7.87013469482917
9.7,"max_tuv_SVM","SVM",55,19,784,780,4,2000,1731,269,0.782931206380861,0.220338983050847,1.28387096774194,700,269,431,-1,1.6,71.84,6.4,0,0,0,0,0,0,0.0947261864012135,47.6364226302817,10.2039559027862
9.7,"max_tuv_SVM","SVM",55,20,684,681,3,2100,1830,270,0.778005982053842,0.194915254237288,1.28387096774194,706,270,436,6,1.6,75.43,6.8,0,0,0,0,0,0,0.0789579782824596,33.5796101986866,8.88948336138914
9.7,"max_tuv_SVM","SVM",55,21,584,582,2,2200,1929,271,0.787371219674312,0.203389830508475,1.28387096774194,714,271,443,8,1.6,79.02,7.1,0,0,0,0,0,0,0.0170904864181794,4.45249808435012,2.25931968013429
9.7,"max_tuv_SVM","SVM",55,22,484,482,2,2300,2029,271,0.747982718511136,0.161016949152542,1.28387096774194,704,271,433,-10,1.6,82.61,7.5,0,0,0,0,0,0,0.00977243704055852,2.32108093095189,1.51684718356369
9.7,"max_tuv_SVM","SVM",55,23,384,383,1,2400,2128,272,0.769145895646397,0.203389830508475,1.28387096774194,727,272,455,23,1.7,86.21,7.8,0,0,0,0,0,0,0.0460316577846117,15.4471059460912,12.2698400310402
9.7,"max_tuv_SVM","SVM",55,24,284,283,1,2500,2228,272,0.777793286806251,0.161016949152542,1.28387096774194,722,272,450,-5,1.7,89.8,8.2,0,0,0,0,0,0,0.00752966600422914,2.68675159345565,2.30985116298444
9.7,"max_tuv_SVM","SVM",55,25,184,184,0,2600,2327,273,0.744965104685946,0.169491525423729,1.27299070530344,728,273,455,6,1.7,93.39,8.5,0,0,0,0,0,0,0.0213654956437087,5.48126837231461,4.42849962452895
9.7,"max_tuv_SVM","SVM",55,26,84,84,0,2700,2427,273,0.759601196410772,0.144067796610169,1.28387096774194,722,273,449,-6,1.6,96.98,8.9,0,0,0,0,0,0,4.00476095213892e-10,0.157257044017816,0.157257044017816
9.7,"max_tuv_SVM","SVM",55,27,0,0,0,2784,2511,273,0.709690927218348,0.0932203389830508,1.27299070530344,718,273,445,-4,1.6,100,9.2,0,0,0,0,0,0,0,0,0
9.7,"max_tuv_SVM","SVM",56,0,2684,2428,256,100,88,12,0.704525958645411,0.276422764227642,1.15861526357199,37,12,25,0,2.1,3.59,7.3,0,0,0,0,0,0,0.197792706980171,294.137606099077,23.3239294884207
9.7,"max_tuv_SVM","SVM",56,1,2584,2349,235,200,167,33,0.682856411241279,0.113821138211382,1.25255704169945,97,33,64,60,1.9,7.18,5.1,0,0,0,0,0,0,0.182937687509725,415.029281517488,18.9217235644562
9.7,"max_tuv_SVM","SVM",56,2,2484,2256,228,300,260,40,0.805652647077659,0.284552845528455,1.27343299239444,119,40,79,22,2,10.78,6.5,0,0,0,0,0,0,0.173135356237688,252.397428829373,18.7984669016594
9.7,"max_tuv_SVM","SVM",56,3,2384,2179,205,400,337,63,0.813129761218878,0.260162601626016,1.27343299239444,163,63,100,44,1.6,14.37,5.3,0,0,0,0,0,0,0.197110134755652,222.000992735398,22.3643732706359
9.7,"max_tuv_SVM","SVM",56,4,2284,2107,177,500,409,91,0.827981563280203,0.284552845528455,1.28387096774194,227,91,136,64,1.5,17.96,4.5,0,0,0,0,0,0,0.189744269161215,280.379763112834,20.1162141635357
9.7,"max_tuv_SVM","SVM",56,5,2184,2039,145,600,477,123,0.796133410153003,0.154471544715447,1.26299501704694,306,123,183,79,1.5,21.55,3.9,0,0,0,0,0,0,0.220312609388537,387.96651636322,27.7055248256383
9.7,"max_tuv_SVM","SVM",56,6,2084,1946,138,700,570,130,0.812233531784147,0.235772357723577,1.23168109100446,323,130,193,17,1.5,25.14,4.4,0,0,0,0,0,0,0.200345643236404,224.846406303419,22.0396603611063
9.7,"max_tuv_SVM","SVM",56,7,1984,1868,116,800,648,152,0.812617630113314,0.252032520325203,1.24211906635195,375,152,223,52,1.5,28.74,4.3,0,0,0,0,0,0,0.210398952845245,181.346018421059,23.278937729852
9.7,"max_tuv_SVM","SVM",56,8,1884,1785,99,900,731,169,0.811151654823637,0.268292682926829,1.26299501704694,438,169,269,63,1.6,32.33,4.3,0,0,0,0,0,0,0.201449742659645,231.476010278077,20.551460728186
9.7,"max_tuv_SVM","SVM",56,9,1784,1711,73,1000,805,195,0.821195826131492,0.235772357723577,1.26299501704694,474,195,279,36,1.4,35.92,4.1,0,0,0,0,0,0,0.198701604190218,197.968857328412,20.4349175160057
9.7,"max_tuv_SVM","SVM",56,10,1684,1632,52,1100,884,216,0.809480827091739,0.211382113821138,1.25255704169945,543,216,327,69,1.5,39.51,4.1,0,0,0,0,0,0,0.185881734308022,131.056551999723,19.7688878074556
9.7,"max_tuv_SVM","SVM",56,11,1584,1539,45,1200,977,223,0.820267588502659,0.260162601626016,1.25255704169945,555,223,332,12,1.5,43.1,4.4,0,0,0,0,0,0,0.179343400284184,137.192215746787,18.5455848588958
9.7,"max_tuv_SVM","SVM",56,12,1484,1448,36,1300,1068,232,0.787311951859681,0.195121951219512,1.25255704169945,594,232,362,39,1.6,46.7,4.6,0,0,0,0,0,0,0.178744297884354,119.643413204467,18.4625021722913
9.7,"max_tuv_SVM","SVM",56,13,1384,1355,29,1400,1161,239,0.785705140515977,0.195121951219512,1.25255704169945,620,239,381,26,1.6,50.29,4.9,0,0,0,0,0,0,0.164539126900237,103.194012970454,17.0644985312187
9.7,"max_tuv_SVM","SVM",56,14,1284,1257,27,1500,1259,241,0.782792394853086,0.178861788617886,1.25255704169945,623,241,382,3,1.6,53.88,5.2,0,0,0,0,0,0,0.14605709341851,71.7285793242818,15.4141270638398
9.7,"max_tuv_SVM","SVM",56,15,1184,1162,22,1600,1354,246,0.780641444209723,0.16260162601626,1.25255704169945,658,246,412,35,1.7,57.47,5.5,0,0,0,0,0,0,0.125740775382892,49.3150979887848,13.6005786663591
9.7,"max_tuv_SVM","SVM",56,16,1084,1064,20,1700,1452,248,0.785000960245828,0.170731707317073,1.25255704169945,662,248,414,4,1.7,61.06,5.9,0,0,0,0,0,0,0.106465351842918,35.0170635902561,11.7440812438298
9.7,"max_tuv_SVM","SVM",56,17,984,965,19,1800,1551,249,0.800070418027023,0.24390243902439,1.25255704169945,658,249,409,-4,1.6,64.66,6.2,0,0,0,0,0,0,0.0906362953487025,31.2439233149417,10.7187707811964
9.7,"max_tuv_SVM","SVM",56,18,884,867,17,1900,1649,251,0.793745598873317,0.219512195121951,1.25255704169945,659,251,408,1,1.6,68.25,6.6,0,0,0,0,0,0,0.0285198051131575,7.36119064778529,4.9545306876316
9.7,"max_tuv_SVM","SVM",56,19,784,769,15,2000,1747,253,0.765783240509573,0.121951219512195,1.25255704169945,664,253,411,5,1.6,71.84,6.9,0,0,0,0,0,0,0.00661360521565957,2.04166730817358,1.4940704341144
9.7,"max_tuv_SVM","SVM",56,20,684,672,12,2100,1844,256,0.784802509442424,0.121951219512195,1.26299501704694,694,256,438,30,1.7,75.43,7.2,0,0,0,0,0,0,0.0308540547314428,8.86591180640666,5.52199025894148
9.7,"max_tuv_SVM","SVM",56,21,584,574,10,2200,1942,258,0.806766532232259,0.195121951219512,1.27343299239444,709,258,451,15,1.7,79.02,7.5,0,0,0,0,0,0,0.0404976528564959,11.1545089523402,6.28257090034489
9.7,"max_tuv_SVM","SVM",56,22,484,475,9,2300,2041,259,0.803687343960055,0.195121951219512,1.28387096774194,699,259,440,-10,1.7,82.61,7.9,0,0,0,0,0,0,0.0169998022457835,5.26916723870916,3.88143551558408
9.7,"max_tuv_SVM","SVM",56,23,384,379,5,2400,2137,263,0.801382753985018,0.154471544715447,1.28387096774194,730,263,467,31,1.8,86.21,8.1,0,0,0,0,0,0,0.00242325507020944,1.77861642953884,1.63770140157031
9.7,"max_tuv_SVM","SVM",56,24,284,283,1,2500,2233,267,0.777901542794953,0.130081300813008,1.28387096774194,759,267,492,29,1.8,89.8,8.4,0,0,0,0,0,0,0.0408288508688323,13.4264081502906,11.6102688589273
9.7,"max_tuv_SVM","SVM",56,25,184,184,0,2600,2332,268,0.768868830420585,0.130081300813008,1.28387096774194,745,268,477,-14,1.8,93.39,8.7,0,0,0,0,0,0,0.000413958477161891,15.5332532666977,15.5236087726883
9.7,"max_tuv_SVM","SVM",56,26,84,84,0,2700,2432,268,0.822226489981432,0.227642276422764,1.28387096774194,744,268,476,-1,1.8,96.98,9.1,0,0,0,0,0,0,1.0000000994736e-07,0.00494375020264599,0.00494375020264599
9.7,"max_tuv_SVM","SVM",56,27,0,0,0,2784,2516,268,0.809845720504444,0.203252032520325,1.28387096774194,761,268,493,17,1.8,100,9.4,0,0,0,0,0,0,0,0,0
9.7,"max_tuv_SVM","SVM",57,0,2684,2427,257,100,87,13,0.832501689276997,0.347107438016529,1.25203945614503,29,13,16,0,1.2,3.59,6.7,0,0,0,0,0,0,0.390895398796882,375.440420310307,42.1692469753851
9.7,"max_tuv_SVM","SVM",57,1,2584,2370,214,200,144,56,0.776417693227295,0.140495867768595,1.2732604638763,128,56,72,99,1.3,7.18,2.6,0,0,0,0,0,0,0.308696970989314,659.105508374176,32.2679281472512
9.7,"max_tuv_SVM","SVM",57,2,2484,2290,194,300,224,76,0.746556473829199,0.223140495867769,1.23081844841376,176,76,100,48,1.3,10.78,2.9,0,0,0,0,0,0,0.254631850545713,576.417867131944,26.1168054210619
9.7,"max_tuv_SVM","SVM",57,3,2384,2206,178,400,308,92,0.830052237642286,0.231404958677686,1.2732604638763,211,92,119,35,1.3,14.37,3.3,0,0,0,0,0,0,0.263435909586156,257.102405366518,27.9699883073207
9.7,"max_tuv_SVM","SVM",57,4,2284,2128,156,500,386,114,0.841883673787625,0.297520661157025,1.2732604638763,274,114,160,63,1.4,17.96,3.4,0,0,0,0,0,0,0.247472845176356,209.944373478177,25.4505668689834
9.7,"max_tuv_SVM","SVM",57,5,2184,2058,126,600,456,144,0.840428296689026,0.28099173553719,1.26264996001066,345,144,201,71,1.4,21.55,3.2,0,0,0,0,0,0,0.250862545156556,235.19209998386,25.8840310784768
9.7,"max_tuv_SVM","SVM",57,6,2084,1986,98,700,528,172,0.831325692603566,0.256198347107438,1.2732604638763,398,172,226,53,1.3,25.14,3.1,0,0,0,0,0,0,0.248833709653935,216.569182451483,26.7616454379608
9.7,"max_tuv_SVM","SVM",57,7,1984,1907,77,800,607,193,0.83071495399969,0.289256198347107,1.26264996001066,460,193,267,62,1.4,28.74,3.1,0,0,0,0,0,0,0.227740321409844,125.016425278347,24.8359142030361
9.7,"max_tuv_SVM","SVM",57,8,1884,1816,68,900,698,202,0.833476272155519,0.247933884297521,1.26264996001066,481,202,279,21,1.4,32.33,3.5,0,0,0,0,0,0,0.195449338290596,101.90840477852,21.1082398614101
9.7,"max_tuv_SVM","SVM",57,9,1784,1729,55,1000,785,215,0.835600862830711,0.305785123966942,1.24142895227939,512,215,297,31,1.4,35.92,3.7,0,0,0,0,0,0,0.17106516763886,97.3174764259327,18.5267209500725
9.7,"max_tuv_SVM","SVM",57,10,1684,1634,50,1100,880,220,0.82343806850668,0.264462809917355,1.24142895227939,526,220,306,14,1.4,39.51,4,0,0,0,0,0,0,0.152748932745196,64.8612732246125,16.4710593057294
9.7,"max_tuv_SVM","SVM",57,11,1584,1542,42,1200,972,228,0.827290919486464,0.289256198347107,1.24142895227939,559,228,331,33,1.5,43.1,4.3,0,0,0,0,0,0,0.168072328009389,109.137452577814,18.3466482354822
9.7,"max_tuv_SVM","SVM",57,12,1484,1450,34,1300,1064,236,0.817941421071783,0.247933884297521,1.23081844841376,579,236,343,20,1.5,46.7,4.5,0,0,0,0,0,0,0.155753336643184,78.0983891294821,22.8969493526654
9.7,"max_tuv_SVM","SVM",57,13,1384,1353,31,1400,1161,239,0.811457196319981,0.214876033057851,1.25203945614503,598,239,359,19,1.5,50.29,4.9,0,0,0,0,0,0,0.122398333329515,54.2045290700697,14.9765585972502
9.7,"max_tuv_SVM","SVM",57,14,1284,1258,26,1500,1256,244,0.834567804979475,0.355371900826446,1.23081844841376,614,244,370,16,1.5,53.88,5.1,0,0,0,0,0,0,0.0909341032270018,36.7130258807471,10.8845147360804
9.7,"max_tuv_SVM","SVM",57,15,1184,1162,22,1600,1352,248,0.800152034929059,0.223140495867769,1.23081844841376,642,248,394,28,1.6,57.47,5.5,0,0,0,0,0,0,0.0802583520821222,30.655289073012,11.5061296151785
9.7,"max_tuv_SVM","SVM",57,16,1084,1064,20,1700,1450,250,0.812152398773336,0.214876033057851,1.24142895227939,638,250,388,-4,1.6,61.06,5.8,0,0,0,0,0,0,0.0654884888693551,25.4629676661013,8.13016493260379
9.7,"max_tuv_SVM","SVM",57,17,984,966,18,1800,1548,252,0.836023182078072,0.272727272727273,1.23081844841376,646,252,394,8,1.6,64.66,6.1,0,0,0,0,0,0,0.0275242459176744,9.93419791927782,5.36409806758303
9.7,"max_tuv_SVM","SVM",57,18,884,868,16,1900,1646,254,0.801795831384168,0.247933884297521,1.23081844841376,642,254,388,-4,1.5,68.25,6.5,0,0,0,0,0,0,0.0250315056026771,7.9789424905069,3.58493635131361
9.7,"max_tuv_SVM","SVM",57,19,784,771,13,2000,1743,257,0.822151619107023,0.239669421487603,1.25203945614503,667,257,410,25,1.6,71.84,6.8,0,0,0,0,0,0,0.0476812841636175,18.478769452413,5.76240851910211
9.7,"max_tuv_SVM","SVM",57,20,684,674,10,2100,1840,260,0.829779354436303,0.247933884297521,1.2732604638763,670,260,410,3,1.6,75.43,7.1,0,0,0,0,0,0,0.0417937133006958,12.7154308292857,5.9567947273801
9.7,"max_tuv_SVM","SVM",57,21,584,579,5,2200,1935,265,0.842163054212799,0.256198347107438,1.28387096774194,698,265,433,28,1.6,79.02,7.3,0,0,0,0,0,0,0.0338904494215741,13.7484875438532,8.66993394896438
9.7,"max_tuv_SVM","SVM",57,22,484,483,1,2300,2031,269,0.813757211913303,0.198347107438017,1.27208803250993,717,269,448,19,1.7,82.61,7.6,0,0,0,0,0,0,0.0118861725939855,2.96383499115044,1.88463163918624
9.7,"max_tuv_SVM","SVM",57,23,384,383,1,2400,2131,269,0.848660273402981,0.297520661157025,1.27208803250993,713,269,444,-4,1.7,86.21,7.9,0,0,0,0,0,0,0.00248016562998366,0.712752235486674,0.546476935876315
9.7,"max_tuv_SVM","SVM",57,24,284,284,0,2500,2230,270,0.805265346431727,0.198347107438017,1.27208803250993,714,270,444,1,1.6,89.8,8.3,0,0,0,0,0,0,0.00371954629876787,13.466796359534,13.3089817393619
9.7,"max_tuv_SVM","SVM",57,25,184,184,0,2600,2330,270,0.780790321742299,0.173553719008264,1.28268876611418,744,270,474,30,1.8,93.39,8.6,0,0,0,0,0,0,0.000619570192338008,0.332770688744211,0.317167517367781
9.7,"max_tuv_SVM","SVM",57,26,84,84,0,2700,2430,270,0.824763501221479,0.256198347107438,1.2732604638763,728,270,458,-16,1.7,96.98,9,0,0,0,0,0,0,2.83507181015973e-05,0.0966056179733565,0.0966056179733565
9.7,"max_tuv_SVM","SVM",57,27,0,0,0,2784,2514,270,0.836172618119446,0.247933884297521,1.27208803250993,725,270,455,-3,1.7,100,9.3,0,0,0,0,0,0,0,0,0
9.7,"max_tuv_SVM","SVM",58,0,2684,2431,253,100,93,7,0.821530104886216,0.297709923664122,1.24466880078798,19,7,12,0,1.7,3.59,13.3,0,0,0,0,0,0,0.163107538100949,208.449810174953,17.9130090682015
9.7,"max_tuv_SVM","SVM",58,1,2584,2365,219,200,159,41,0.691371989208936,0.213740458015267,1.24466880078798,105,41,64,86,1.6,7.18,3.9,0,0,0,0,0,0,0.244690508996086,530.929067195736,26.7625264211623
9.7,"max_tuv_SVM","SVM",58,2,2484,2285,199,300,239,61,0.802585257860408,0.282442748091603,1.22506771731101,150,61,89,45,1.5,10.78,3.9,0,0,0,0,0,0,0.256596702200492,257.236620309117,27.821111020745
9.7,"max_tuv_SVM","SVM",58,3,2384,2215,169,400,309,91,0.828316860429946,0.297709923664122,1.26426988426496,218,91,127,68,1.4,14.37,3.4,0,0,0,0,0,0,0.272323500338166,253.560961671994,30.0336094037332
9.7,"max_tuv_SVM","SVM",58,4,2284,2134,150,500,390,110,0.819824342797686,0.297709923664122,1.25446934252647,262,110,152,44,1.4,17.96,3.5,0,0,0,0,0,0,0.258337184716437,186.228465454638,26.7910511331076
9.7,"max_tuv_SVM","SVM",58,5,2184,2059,125,600,465,135,0.830730332321162,0.312977099236641,1.25446934252647,325,135,190,63,1.4,21.55,3.4,0,0,0,0,0,0,0.244375342845798,152.931927126207,25.1573172840583
9.7,"max_tuv_SVM","SVM",58,6,2084,1987,97,700,537,163,0.823435477431915,0.297709923664122,1.25446934252647,397,163,234,72,1.4,25.14,3.3,0,0,0,0,0,0,0.233796648779793,125.675725682944,24.6510955156347
9.7,"max_tuv_SVM","SVM",58,7,1984,1901,83,800,623,177,0.793772153736338,0.259541984732824,1.24466880078798,433,177,256,36,1.4,28.74,3.5,0,0,0,0,0,0,0.211143039932759,155.101133758639,24.177549096879
9.7,"max_tuv_SVM","SVM",58,8,1884,1814,70,900,710,190,0.814102176358857,0.297709923664122,1.25446934252647,468,190,278,35,1.5,32.33,3.7,0,0,0,0,0,0,0.182539775498353,91.6527215198866,20.2075327894397
9.7,"max_tuv_SVM","SVM",58,9,1784,1721,63,1000,803,197,0.816805990733229,0.267175572519084,1.25446934252647,485,197,288,17,1.5,35.92,4.1,0,0,0,0,0,0,0.172064752972581,71.7591402876081,19.638468600314
9.7,"max_tuv_SVM","SVM",58,10,1684,1631,53,1100,893,207,0.811247141941178,0.267175572519084,1.25446934252647,520,207,313,35,1.5,39.51,4.3,0,0,0,0,0,0,0.18358915600379,93.5649959897967,19.9468053420587
9.7,"max_tuv_SVM","SVM",58,11,1584,1548,36,1200,976,224,0.798768463967283,0.229007633587786,1.25446934252647,572,224,348,52,1.6,43.1,4.4,0,0,0,0,0,0,0.166563530586301,75.9465122896859,19.2688853637667
9.7,"max_tuv_SVM","SVM",58,12,1484,1461,23,1300,1063,237,0.772831202138846,0.183206106870229,1.2348682590495,608,237,371,36,1.6,46.7,4.5,0,0,0,0,0,0,0.175127912333673,136.747680649806,18.582343854642
9.7,"max_tuv_SVM","SVM",58,13,1384,1362,22,1400,1162,238,0.802252573765125,0.244274809160305,1.2348682590495,624,238,386,16,1.6,50.29,4.9,0,0,0,0,0,0,0.147784915980684,84.3622200697795,16.2180285036824
9.7,"max_tuv_SVM","SVM",58,14,1284,1264,20,1500,1260,240,0.795858990334003,0.221374045801527,1.2348682590495,630,240,390,6,1.6,53.88,5.2,0,0,0,0,0,0,0.12563952664987,46.3461486223151,15.154339641981
9.7,"max_tuv_SVM","SVM",58,15,1184,1165,19,1600,1359,241,0.780954742865427,0.221374045801527,1.2348682590495,647,241,406,17,1.7,57.47,5.6,0,0,0,0,0,0,0.125216797375582,48.7486811624406,14.371959981843
9.7,"max_tuv_SVM","SVM",58,16,1084,1066,18,1700,1458,242,0.745073250988971,0.16030534351145,1.2348682590495,656,242,414,9,1.7,61.06,6,0,0,0,0,0,0,0.118211606937473,39.9670170384276,13.0265020292848
9.7,"max_tuv_SVM","SVM",58,17,984,966,18,1800,1558,242,0.764399172523914,0.190839694656489,1.2348682590495,653,242,411,-3,1.7,64.66,6.4,0,0,0,0,0,0,0.0707503258456688,16.4004369978099,8.63114607508625
9.7,"max_tuv_SVM","SVM",58,18,884,866,18,1900,1658,242,0.68258308029179,0.122137404580153,1.2348682590495,647,242,405,-6,1.7,68.25,6.9,0,0,0,0,0,0,0.0399632600465807,10.8017725418977,7.13281009957532
9.7,"max_tuv_SVM","SVM",58,19,784,766,18,2000,1758,242,0.78167455027158,0.236641221374046,1.2348682590495,637,242,395,-10,1.6,71.84,7.3,0,0,0,0,0,0,0.00404945630196027,1.77054023989348,1.60417455304303
9.7,"max_tuv_SVM","SVM",58,20,684,670,14,2100,1854,246,0.807049273538907,0.244274809160305,1.26426988426496,675,246,429,38,1.7,75.43,7.5,0,0,0,0,0,0,0.115830448815836,39.0502502458621,15.6647818226706
9.7,"max_tuv_SVM","SVM",58,21,584,571,13,2200,1953,247,0.784692902336043,0.229007633587786,1.26426988426496,685,247,438,10,1.8,79.02,7.9,0,0,0,0,0,0,0.079751830828777,22.8633409218078,10.3672507966493
9.7,"max_tuv_SVM","SVM",58,22,484,472,12,2300,2052,248,0.769232165108091,0.206106870229008,1.28268876611418,690,248,442,5,1.8,82.61,8.3,0,0,0,0,0,0,0.0469853958903486,10.2209268886326,7.35373700030587
9.7,"max_tuv_SVM","SVM",58,23,384,375,9,2400,2149,251,0.757751539420038,0.16030534351145,1.28268876611418,702,251,451,12,1.8,86.21,8.6,0,0,0,0,0,0,0.00870878444166262,2.77244097402319,2.41326621930344
9.7,"max_tuv_SVM","SVM",58,24,284,282,2,2500,2242,258,0.767514305416097,0.145038167938931,1.28268876611418,720,258,462,18,1.8,89.8,8.7,0,0,0,0,0,0,0.010066512002652,2.60272439790386,2.10621690390462
9.7,"max_tuv_SVM","SVM",58,25,184,183,1,2600,2341,259,0.801581156772841,0.198473282442748,1.28268876611418,711,259,452,-9,1.7,93.39,9,0,0,0,0,0,0,0.00419133882739297,2.72586432764268,2.67250626796836
9.7,"max_tuv_SVM","SVM",58,26,84,84,0,2700,2440,260,0.766207764241901,0.16793893129771,1.27407042600345,729,260,469,18,1.8,96.98,9.4,0,0,0,0,0,0,1.73661002839218e-07,1.71744462290545,1.71744462290545
9.7,"max_tuv_SVM","SVM",58,27,0,0,0,2784,2524,260,0.780712790796141,0.206106870229008,1.2728972488156,738,260,478,9,1.8,100,9.7,0,0,0,0,0,0,0,0,0
9.7,"max_tuv_SVM","SVM",59,0,2684,2426,258,100,92,8,0.297779179810724,0,0.708696774193548,38,8,30,0,3.8,3.59,11.5,0,0,0,0,0,0,0.125352943111851,225.886476013563,13.3841682326891
9.7,"max_tuv_SVM","SVM",59,1,2584,2326,258,200,192,8,0.695331230283912,0.08,1.16061935483871,39,8,31,1,3.9,7.18,24,0,0,0,0,0,0,0.099400762402215,172.67767316733,10.9440365450809
9.7,"max_tuv_SVM","SVM",59,2,2484,2234,250,300,284,16,0.666138801261832,0.336,1.0989935483871,51,16,35,12,2.2,10.78,17.8,0,0,0,0,0,0,0.0738987346307361,138.743484191452,8.01171537934883
9.7,"max_tuv_SVM","SVM",59,3,2384,2169,215,400,349,51,0.724927444794958,0.128,1.20170322580645,133,51,82,82,1.6,14.37,6.8,0,0,0,0,0,0,0.230914064696381,308.206402293027,32.3618718705787
9.7,"max_tuv_SVM","SVM",59,4,2284,2082,202,500,436,64,0.796725552050468,0.216,1.24278709677419,161,64,97,28,1.5,17.96,6.8,0,0,0,0,0,0,0.191439491434286,225.805499097614,20.8593356767587
9.7,"max_tuv_SVM","SVM",59,5,2184,2000,184,600,518,82,0.778529968454256,0.248,1.24278709677419,213,82,131,52,1.6,21.55,6.3,0,0,0,0,0,0,0.173792371139745,196.467542587741,18.0531379683032
9.7,"max_tuv_SVM","SVM",59,6,2084,1930,154,700,588,112,0.773716088328074,0.2,1.24278709677419,284,112,172,71,1.5,25.14,5.2,0,0,0,0,0,0,0.187649055211281,186.222334691775,21.7409049241526
9.7,"max_tuv_SVM","SVM",59,7,1984,1847,137,800,671,129,0.803501577287063,0.312,1.24278709677419,318,129,189,34,1.5,28.74,5.2,0,0,0,0,0,0,0.178295830245803,158.036721769969,18.9016185643233
9.7,"max_tuv_SVM","SVM",59,8,1884,1777,107,900,741,159,0.810264984227127,0.288,1.24278709677419,395,159,236,77,1.5,32.33,4.7,0,0,0,0,0,0,0.188369660173402,164.724145116984,19.8868273121973
9.7,"max_tuv_SVM","SVM",59,9,1784,1687,97,1000,831,169,0.820965299684542,0.272,1.24278709677419,406,169,237,11,1.4,35.92,4.9,0,0,0,0,0,0,0.170884098900094,110.435585680625,20.2922106003364
9.7,"max_tuv_SVM","SVM",59,10,1684,1596,88,1100,922,178,0.812195583596211,0.24,1.24278709677419,431,178,253,25,1.4,39.51,5.2,0,0,0,0,0,0,0.155120791552481,110.117663019459,16.6612390125833
9.7,"max_tuv_SVM","SVM",59,11,1584,1514,70,1200,1004,196,0.828321766561509,0.256,1.24278709677419,499,196,303,68,1.5,43.1,5.1,0,0,0,0,0,0,0.167982273707947,162.748776584251,17.2935044010886
9.7,"max_tuv_SVM","SVM",59,12,1484,1426,58,1300,1092,208,0.808201892744477,0.208,1.24278709677419,518,208,310,19,1.5,46.7,5.2,0,0,0,0,0,0,0.154047892856505,91.25276813293,17.3753680516765
9.7,"max_tuv_SVM","SVM",59,13,1384,1340,44,1400,1178,222,0.821930599369082,0.24,1.24278709677419,576,222,354,58,1.6,50.29,5.3,0,0,0,0,0,0,0.150295713189506,75.9414423677535,16.3056671695702
9.7,"max_tuv_SVM","SVM",59,14,1284,1252,32,1500,1266,234,0.777640378548896,0.184,1.24278709677419,600,234,366,24,1.6,53.88,5.4,0,0,0,0,0,0,0.156083615270887,91.2305976140389,16.5805857746732
9.7,"max_tuv_SVM","SVM",59,15,1184,1155,29,1600,1363,237,0.812876971608831,0.208,1.24278709677419,626,237,389,26,1.6,57.47,5.8,0,0,0,0,0,0,0.112813240770871,47.3731955577813,12.546719021674
9.7,"max_tuv_SVM","SVM",59,16,1084,1056,28,1700,1462,238,0.814340694006308,0.24,1.24278709677419,622,238,384,-4,1.6,61.06,6.1,0,0,0,0,0,0,0.122072429847179,59.3226950548575,12.9872932361444
9.7,"max_tuv_SVM","SVM",59,17,984,957,27,1800,1561,239,0.801835962145108,0.208,1.23251612903226,612,239,373,-10,1.6,64.66,6.5,0,0,0,0,0,0,0.0918321115604151,35.717800793667,10.5101970561937
9.7,"max_tuv_SVM","SVM",59,18,884,858,26,1900,1660,240,0.801432176656149,0.192,1.23251612903226,623,240,383,11,1.6,68.25,6.9,0,0,0,0,0,0,0.0752778896826155,27.6295908922914,8.26451358401341
9.7,"max_tuv_SVM","SVM",59,19,784,758,26,2000,1760,240,0.79125552050473,0.2,1.23251612903226,627,240,387,4,1.6,71.84,7.3,0,0,0,0,0,0,0.0169658882059628,4.73361365372397,2.91888798463988
9.7,"max_tuv_SVM","SVM",59,20,684,662,22,2100,1856,244,0.80143848580441,0.208,1.24278709677419,646,244,402,19,1.6,75.43,7.6,0,0,0,0,0,0,0.0315374271041497,10.0840883399312,5.2401151884691
9.7,"max_tuv_SVM","SVM",59,21,584,566,18,2200,1952,248,0.801015772870659,0.232,1.24278709677419,662,248,414,16,1.7,79.02,7.9,0,0,0,0,0,0,0.11071150375322,63.7182448248819,11.1146130242361
9.7,"max_tuv_SVM","SVM",59,22,484,468,16,2300,2050,250,0.806372239747635,0.24,1.24278709677419,672,250,422,10,1.7,82.61,8.2,0,0,0,0,0,0,0.0157996239765599,4.22647844598691,2.25929617396115
9.7,"max_tuv_SVM","SVM",59,23,384,375,9,2400,2143,257,0.773892744479499,0.176,1.26332903225806,688,257,431,16,1.7,86.21,8.3,0,0,0,0,0,0,0.0234414495093535,6.40660742521675,4.16477765408831
9.7,"max_tuv_SVM","SVM",59,24,284,279,5,2500,2239,261,0.810075709779193,0.216,1.2736,694,261,433,6,1.7,89.8,8.6,0,0,0,0,0,0,0.0133228909903061,3.21092986090596,2.51996503431261
9.7,"max_tuv_SVM","SVM",59,25,184,184,0,2600,2334,266,0.788624605678237,0.192,1.2736,720,266,454,26,1.7,93.39,8.8,0,0,0,0,0,0,9.65292462403389e-06,0.579236806974091,0.579065685195747
9.7,"max_tuv_SVM","SVM",59,26,84,84,0,2700,2434,266,0.814208201892751,0.216,1.2736,730,266,464,10,1.7,96.98,9.2,0,0,0,0,0,0,5.39466246230474e-12,0.0157637406234689,0.0157637406234689
9.7,"max_tuv_SVM","SVM",59,27,0,0,0,2784,2518,266,0.818138801261838,0.232,1.2736,732,266,466,2,1.8,100,9.5,0,0,0,0,0,0,0,0,0
9.7,"max_tuv_SVM","SVM",60,0,2684,2437,247,100,91,9,0.818141671082847,0.288888888888889,1.28387096774194,29,9,20,0,2.2,3.59,10.1,0,0,0,0,0,0,0.152747984904713,254.340124493772,16.9268705776358
9.7,"max_tuv_SVM","SVM",60,1,2584,2361,223,200,167,33,0.805328858270037,0.192592592592593,1.28387096774194,84,33,51,55,1.5,7.18,5.1,0,0,0,0,0,0,0.243256424212487,283.761129135937,28.9597290643022
9.7,"max_tuv_SVM","SVM",60,2,2484,2272,212,300,256,44,0.825278219395864,0.303703703703704,1.28387096774194,113,44,69,29,1.6,10.78,5.8,0,0,0,0,0,0,0.201165627576717,192.287782297316,21.4366273923181
9.7,"max_tuv_SVM","SVM",60,3,2384,2202,182,400,326,74,0.81791791791792,0.22962962962963,1.28387096774194,177,74,103,64,1.4,14.37,4.4,0,0,0,0,0,0,0.21398163664891,197.060172237447,23.1784833651599
9.7,"max_tuv_SVM","SVM",60,4,2284,2129,155,500,399,101,0.831296001884241,0.296296296296296,1.27436081242533,243,101,142,66,1.4,17.96,4,0,0,0,0,0,0,0.219710938578419,227.918593397866,22.267638047437
9.7,"max_tuv_SVM","SVM",60,5,2184,2053,131,600,475,125,0.834475652122717,0.281481481481481,1.27436081242533,299,125,174,56,1.4,21.55,3.8,0,0,0,0,0,0,0.221806291706944,136.057287087572,22.8749764629034
9.7,"max_tuv_SVM","SVM",60,6,2084,1976,108,700,552,148,0.837290231407885,0.281481481481481,1.27436081242533,364,148,216,65,1.5,25.14,3.7,0,0,0,0,0,0,0.197347641502713,92.5858190144254,21.3013549592082
9.7,"max_tuv_SVM","SVM",60,7,1984,1906,78,800,622,178,0.839486545368905,0.288888888888889,1.27436081242533,454,178,276,90,1.6,28.74,3.5,0,0,0,0,0,0,0.202477353535389,128.192830255135,21.7775057721709
9.7,"max_tuv_SVM","SVM",60,8,1884,1821,63,900,707,193,0.831861273037751,0.274074074074074,1.26485065710872,507,193,314,53,1.6,32.33,3.7,0,0,0,0,0,0,0.201659087739783,126.887594240366,21.9251903385896
9.7,"max_tuv_SVM","SVM",60,9,1784,1727,57,1000,801,199,0.839928163457582,0.296296296296296,1.26485065710872,498,199,299,-9,1.5,35.92,4,0,0,0,0,0,0,0.18887998157781,102.194605988455,22.742070624666
9.7,"max_tuv_SVM","SVM",60,10,1684,1646,38,1100,882,218,0.84263675440147,0.311111111111111,1.25534050179211,586,218,368,88,1.7,39.51,4,0,0,0,0,0,0,0.189606400671598,145.460380553212,19.6699648294041
9.7,"max_tuv_SVM","SVM",60,11,1584,1554,30,1200,974,226,0.844732968262391,0.296296296296296,1.25534050179211,598,226,372,12,1.6,43.1,4.3,0,0,0,0,0,0,0.171334389557793,130.188174878459,18.0911679671099
9.7,"max_tuv_SVM","SVM",60,12,1484,1464,20,1300,1064,236,0.837849614320216,0.274074074074074,1.25534050179211,636,236,400,38,1.7,46.7,4.5,0,0,0,0,0,0,0.144778678342,97.6521500086062,15.8718883085417
9.7,"max_tuv_SVM","SVM",60,13,1384,1368,16,1400,1160,240,0.817140670081858,0.237037037037037,1.25534050179211,632,240,392,-4,1.6,50.29,4.8,0,0,0,0,0,0,0.133558129513192,103.703797921031,14.6257213308196
9.7,"max_tuv_SVM","SVM",60,14,1284,1271,13,1500,1257,243,0.80241417888478,0.2,1.25534050179211,647,243,404,15,1.7,53.88,5.2,0,0,0,0,0,0,0.156144206894928,132.416772790404,18.3675954260506
9.7,"max_tuv_SVM","SVM",60,15,1184,1174,10,1600,1354,246,0.82377082965319,0.22962962962963,1.25534050179211,664,246,418,17,1.7,57.47,5.5,0,0,0,0,0,0,0.0779105490576639,36.9442426958635,10.1296427849531
9.7,"max_tuv_SVM","SVM",60,16,1084,1077,7,1700,1451,249,0.834181240063595,0.266666666666667,1.26485065710872,683,249,434,19,1.7,61.06,5.8,0,0,0,0,0,0,0.0667464149953641,33.2239209175827,9.3220716587543
9.7,"max_tuv_SVM","SVM",60,17,984,979,5,1800,1549,251,0.838756403462295,0.274074074074074,1.26485065710872,686,251,435,3,1.7,64.66,6.2,0,0,0,0,0,0,0.0687938560937753,41.2587963685281,8.6819919938498
9.7,"max_tuv_SVM","SVM",60,18,884,881,3,1900,1647,253,0.839863392804577,0.311111111111111,1.27436081242533,688,253,435,2,1.7,68.25,6.5,0,0,0,0,0,0,0.0923550529691364,35.1092885727304,10.953407297446
9.7,"max_tuv_SVM","SVM",60,19,784,782,2,2000,1746,254,0.819884590472839,0.274074074074074,1.27436081242533,685,254,431,-3,1.7,71.84,6.9,0,0,0,0,0,0,0.0452572819755124,16.290937805621,8.65056601455071
9.7,"max_tuv_SVM","SVM",60,20,684,682,2,2100,1846,254,0.821250662427141,0.251851851851852,1.27436081242533,702,254,448,17,1.8,75.43,7.3,0,0,0,0,0,0,0.0338175078516038,9.60780103109134,4.37837302203227
9.7,"max_tuv_SVM","SVM",60,21,584,582,2,2200,1946,254,0.828110463404586,0.281481481481481,1.27436081242533,715,254,461,13,1.8,79.02,7.7,0,0,0,0,0,0,0.0202362434739602,5.92544363549873,3.09350439621848
9.7,"max_tuv_SVM","SVM",60,22,484,483,1,2300,2045,255,0.806123770829666,0.251851851851852,1.27436081242533,714,255,459,-1,1.8,82.61,8,0,0,0,0,0,0,0.0309093250087328,10.5662187795352,7.96113543380608
9.7,"max_tuv_SVM","SVM",60,23,384,383,1,2400,2145,255,0.783053641877179,0.207407407407407,1.27436081242533,733,255,478,19,1.9,86.21,8.4,0,0,0,0,0,0,0.0168246498983938,4.1740782785031,2.6586791224808
9.7,"max_tuv_SVM","SVM",60,24,284,284,0,2500,2244,256,0.83026555967733,0.244444444444444,1.27436081242533,724,256,468,-9,1.8,89.8,8.8,0,0,0,0,0,0,0.00313987909827855,1.17981395270586,1.01297265444878
9.7,"max_tuv_SVM","SVM",60,25,184,184,0,2600,2344,256,0.74811281870106,0.111111111111111,1.27436081242533,734,256,478,10,1.9,93.39,9.2,0,0,0,0,0,0,9.03982118550141e-06,0.0199701545012528,0.0198135185542358
9.7,"max_tuv_SVM","SVM",60,26,84,84,0,2700,2444,256,0.820461638108704,0.303703703703704,1.27436081242533,725,256,469,-9,1.8,96.98,9.5,0,0,0,0,0,0,1.0000000994736e-07,0.00082880209346422,0.00082880209346422
9.7,"max_tuv_SVM","SVM",60,27,0,0,0,2784,2528,256,0.799252193369849,0.214814814814815,1.27436081242533,705,256,449,-20,1.8,100,9.9,0,0,0,0,0,0,0,0,0
9.7,"max_tuv_SVM","SVM",61,0,2684,2420,264,100,91,9,0.787411100033237,0.254237288135593,1.27299070530344,31,9,22,0,2.4,3.59,10.1,0,0,0,0,0,0,0.0921401997378673,246.140572584944,9.22668708265654
9.7,"max_tuv_SVM","SVM",61,1,2584,2343,241,200,168,32,0.803562645397145,0.355932203389831,1.26211044286495,89,32,57,58,1.8,7.18,5.2,0,0,0,0,0,0,0.192091469574891,328.358495564868,20.7348453098108
9.7,"max_tuv_SVM","SVM",61,2,2484,2280,204,300,231,69,0.788035892323033,0.152542372881356,1.26211044286495,172,69,103,83,1.5,10.78,3.3,0,0,0,0,0,0,0.250732668683132,480.56478613152,26.1595028764896
9.7,"max_tuv_SVM","SVM",61,3,2384,2190,194,400,321,79,0.830588235294122,0.296610169491525,1.26211044286495,199,79,120,27,1.5,14.37,4.1,0,0,0,0,0,0,0.20950683239871,199.381759884352,22.5658871797577
9.7,"max_tuv_SVM","SVM",61,4,2284,2122,162,500,389,111,0.827364572947831,0.313559322033898,1.25123018042646,266,111,155,67,1.4,17.96,3.5,0,0,0,0,0,0,0.219815391816841,293.995485168336,22.6485175802136
9.7,"max_tuv_SVM","SVM",61,5,2184,2050,134,600,461,139,0.815294117647067,0.271186440677966,1.25123018042646,340,139,201,74,1.4,21.55,3.3,0,0,0,0,0,0,0.233820774932891,334.866051326892,24.0454720502628
9.7,"max_tuv_SVM","SVM",61,6,2084,1973,111,700,538,162,0.81713526088402,0.271186440677966,1.26211044286495,395,162,233,55,1.4,25.14,3.3,0,0,0,0,0,0,0.231219471751026,331.818253237833,23.6673006877703
9.7,"max_tuv_SVM","SVM",61,7,1984,1885,99,800,626,174,0.822372881355937,0.279661016949153,1.26211044286495,427,174,253,32,1.5,28.74,3.6,0,0,0,0,0,0,0.182515163893156,89.7693906918954,20.0235497440747
9.7,"max_tuv_SVM","SVM",61,8,1884,1809,75,900,702,198,0.824852110335664,0.271186440677966,1.26211044286495,485,198,287,58,1.4,32.33,3.5,0,0,0,0,0,0,0.1925562840541,134.175758437237,21.1412430472119
9.7,"max_tuv_SVM","SVM",61,9,1784,1730,54,1000,781,219,0.838185443668996,0.279661016949153,1.27299070530344,536,219,317,51,1.4,35.92,3.6,0,0,0,0,0,0,0.19460405747972,192.192726357963,20.605764823064
9.7,"max_tuv_SVM","SVM",61,10,1684,1644,40,1100,867,233,0.836444001329349,0.271186440677966,1.26211044286495,584,233,351,48,1.5,39.51,3.7,0,0,0,0,0,0,0.198529391771343,219.236341680747,21.0236142551728
9.7,"max_tuv_SVM","SVM",61,11,1584,1555,29,1200,956,244,0.835533399800602,0.271186440677966,1.27299070530344,619,244,375,35,1.5,43.1,3.9,0,0,0,0,0,0,0.179817469455677,141.900353203506,19.3513687327143
9.7,"max_tuv_SVM","SVM",61,12,1484,1460,24,1300,1051,249,0.841023595879035,0.305084745762712,1.27299070530344,626,249,377,7,1.5,46.7,4.2,0,0,0,0,0,0,0.175093893395592,160.4468140037,18.0826426431309
9.7,"max_tuv_SVM","SVM",61,13,1384,1362,22,1400,1149,251,0.839800598205389,0.296610169491525,1.27299070530344,646,251,395,20,1.6,50.29,4.6,0,0,0,0,0,0,0.15446573996162,120.413212987824,16.385190722254
9.7,"max_tuv_SVM","SVM",61,14,1284,1262,22,1500,1249,251,0.812449318710539,0.26271186440678,1.27299070530344,642,251,391,-4,1.6,53.88,5,0,0,0,0,0,0,0.0969621880909306,47.7371835907337,11.0508373129517
9.7,"max_tuv_SVM","SVM",61,15,1184,1165,19,1600,1346,254,0.836663343303428,0.296610169491525,1.26211044286495,654,254,400,12,1.6,57.47,5.3,0,0,0,0,0,0,0.122430074164716,84.5699714086983,13.9470473943052
9.7,"max_tuv_SVM","SVM",61,16,1084,1068,16,1700,1443,257,0.821156530408778,0.26271186440678,1.26211044286495,664,257,407,10,1.6,61.06,5.6,0,0,0,0,0,0,0.116107576017761,78.9870589829445,13.1668719284306
9.7,"max_tuv_SVM","SVM",61,17,984,969,15,1800,1542,258,0.841874376869395,0.288135593220339,1.26211044286495,687,258,429,23,1.7,64.66,6,0,0,0,0,0,0,0.0855130107684863,47.5960037934565,9.98815646812691
9.7,"max_tuv_SVM","SVM",61,18,884,869,15,1900,1642,258,0.832502492522436,0.254237288135593,1.26211044286495,672,258,414,-15,1.6,68.25,6.4,0,0,0,0,0,0,0.0743600350968604,38.9613947054293,8.07148611442332
9.7,"max_tuv_SVM","SVM",61,19,784,772,12,2000,1739,261,0.83006314390163,0.211864406779661,1.27299070530344,710,261,449,38,1.7,71.84,6.7,0,0,0,0,0,0,0.0375040045441277,12.5295937809207,5.47120489528309
9.7,"max_tuv_SVM","SVM",61,20,684,679,5,2100,1832,268,0.836437354602861,0.254237288135593,1.27299070530344,727,268,459,17,1.7,75.43,6.8,0,0,0,0,0,0,0.0610401751688472,18.9914784524482,8.03296919819553
9.7,"max_tuv_SVM","SVM",61,21,584,582,2,2200,1929,271,0.84029245596544,0.279661016949153,1.27299070530344,729,271,458,2,1.7,79.02,7.1,0,0,0,0,0,0,0.0564722582056256,18.901046774484,6.96346924323526
9.7,"max_tuv_SVM","SVM",61,22,484,482,2,2300,2029,271,0.840584911930876,0.245762711864407,1.27299070530344,732,271,461,3,1.7,82.61,7.5,0,0,0,0,0,0,0.0173192453642365,4.61586524556442,2.52785693804521
9.7,"max_tuv_SVM","SVM",61,23,384,382,2,2400,2129,271,0.811591890993689,0.211864406779661,1.27299070530344,753,271,482,21,1.8,86.21,7.9,0,0,0,0,0,0,0.0218654848900779,6.18844145768618,3.48697585421051
9.7,"max_tuv_SVM","SVM",61,24,284,283,1,2500,2228,272,0.763084081090065,0.186440677966102,1.27299070530344,751,272,479,-2,1.8,89.8,8.2,0,0,0,0,0,0,0.00633404124371398,1.99102996190655,1.55204749829886
9.7,"max_tuv_SVM","SVM",61,25,184,184,0,2600,2327,273,0.819561316051847,0.245762711864407,1.27299070530344,751,273,478,0,1.8,93.39,8.5,0,0,0,0,0,0,0.00492925883518639,4.15254275266355,3.98249663633298
9.7,"max_tuv_SVM","SVM",61,26,84,84,0,2700,2427,273,0.839468261881026,0.220338983050847,1.27299070530344,774,273,501,23,1.8,96.98,8.9,0,0,0,0,0,0,1.75904053301083e-06,0.0497613992297019,0.0497613992297019
9.7,"max_tuv_SVM","SVM",61,27,0,0,0,2784,2511,273,0.811950814223997,0.254237288135593,1.27299070530344,764,273,491,-10,1.8,100,9.2,0,0,0,0,0,0,0,0,0
9.7,"max_tuv_SVM","SVM",62,0,2684,2437,247,100,88,12,0.809722923124976,0.265151515151515,1.27414467253177,31,12,19,0,1.6,3.59,7.3,0,0,0,0,0,0,0.159328260749906,310.770574882515,17.8558029650458
9.7,"max_tuv_SVM","SVM",62,1,2584,2367,217,200,158,42,0.760303270612549,0.212121212121212,1.25469208211144,103,42,61,72,1.5,7.18,3.8,0,0,0,0,0,0,0.215296860549848,505.014553808273,21.8800785692597
9.7,"max_tuv_SVM","SVM",62,2,2484,2286,198,300,239,61,0.742934900151392,0.159090909090909,1.19633431085044,158,61,97,55,1.6,10.78,3.9,0,0,0,0,0,0,0.220503253625929,417.292940493279,24.6413389117845
9.7,"max_tuv_SVM","SVM",62,3,2384,2210,174,400,315,85,0.814048494460854,0.25,1.27414467253177,208,85,123,50,1.4,14.37,3.7,0,0,0,0,0,0,0.231189658362148,289.970913034882,23.5546404513196
9.7,"max_tuv_SVM","SVM",62,4,2284,2142,142,500,383,117,0.80581188570878,0.234848484848485,1.25469208211144,273,117,156,65,1.3,17.96,3.3,0,0,0,0,0,0,0.246013552354331,232.630480711357,25.2088968479345
9.7,"max_tuv_SVM","SVM",62,5,2184,2074,110,600,451,149,0.809452574916481,0.25,1.25469208211144,349,149,200,76,1.3,21.55,3,0,0,0,0,0,0,0.251314173875256,275.542182308391,25.7143241877989
9.7,"max_tuv_SVM","SVM",62,6,2084,2005,79,700,520,180,0.804826616682278,0.212121212121212,1.24496578690127,420,180,240,71,1.3,25.14,2.9,0,0,0,0,0,0,0.248344194582761,213.26625532688,25.4239494977606
9.7,"max_tuv_SVM","SVM",62,7,1984,1917,67,800,608,192,0.806382620815603,0.227272727272727,1.24496578690127,444,192,252,24,1.3,28.74,3.2,0,0,0,0,0,0,0.228445890771533,203.230156518933,23.8050345427285
9.7,"max_tuv_SVM","SVM",62,8,1884,1831,53,900,694,206,0.801384182827474,0.234848484848485,1.24496578690127,494,206,288,50,1.4,32.33,3.4,0,0,0,0,0,0,0.203602879424756,144.238687786946,21.5657461345012
9.7,"max_tuv_SVM","SVM",62,9,1784,1746,38,1000,779,221,0.813327565904877,0.25,1.24496578690127,528,221,307,34,1.4,35.92,3.5,0,0,0,0,0,0,0.169724153850152,103.899022379861,19.3252244204085
9.7,"max_tuv_SVM","SVM",62,10,1684,1653,31,1100,872,228,0.80973493860091,0.25,1.24496578690127,562,228,334,34,1.5,39.51,3.8,0,0,0,0,0,0,0.105974174532608,50.6747602245347,12.8390914747901
9.7,"max_tuv_SVM","SVM",62,11,1584,1558,26,1200,967,233,0.813844231369988,0.25,1.25469208211144,580,233,347,18,1.5,43.1,4.2,0,0,0,0,0,0,0.0723165030145258,27.9422125871864,10.1529211615837
9.7,"max_tuv_SVM","SVM",62,12,1484,1461,23,1300,1064,236,0.812624660562792,0.242424242424242,1.24496578690127,570,236,334,-10,1.4,46.7,4.5,0,0,0,0,0,0,0.0801786998656825,36.4822024335897,10.2294622720247
9.7,"max_tuv_SVM","SVM",62,13,1384,1362,22,1400,1163,237,0.810996563573874,0.257575757575758,1.2352394916911,592,237,355,22,1.5,50.29,4.9,0,0,0,0,0,0,0.0757016710859355,41.049641915693,8.7289987073129
9.7,"max_tuv_SVM","SVM",62,14,1284,1264,20,1500,1261,239,0.811146757023029,0.21969696969697,1.25469208211144,588,239,349,-4,1.5,53.88,5.3,0,0,0,0,0,0,0.0418155645020243,19.0315369399949,5.70304043912601
9.7,"max_tuv_SVM","SVM",62,15,1184,1171,13,1600,1354,246,0.809885132050081,0.242424242424242,1.28387096774194,621,246,375,33,1.5,57.47,5.5,0,0,0,0,0,0,0.116312812646034,55.3137830247507,15.0877406068275
9.7,"max_tuv_SVM","SVM",62,16,1084,1071,13,1700,1454,246,0.806749092831568,0.227272727272727,1.28387096774194,635,246,389,14,1.6,61.06,5.9,0,0,0,0,0,0,0.0868467642262854,42.6787490927371,10.6011575756026
9.7,"max_tuv_SVM","SVM",62,17,984,974,10,1800,1551,249,0.789512892605678,0.181818181818182,1.28387096774194,669,249,420,34,1.7,64.66,6.2,0,0,0,0,0,0,0.105505456495303,42.3220038205171,13.1089784575892
9.7,"max_tuv_SVM","SVM",62,18,884,876,8,1900,1649,251,0.805487467858602,0.257575757575758,1.28387096774194,672,251,421,3,1.7,68.25,6.6,0,0,0,0,0,0,0.0730036967430916,29.4010361471813,9.60618908882165
9.7,"max_tuv_SVM","SVM",62,19,784,778,6,2000,1747,253,0.798037872780144,0.181818181818182,1.28387096774194,695,253,442,23,1.7,71.84,6.9,0,0,0,0,0,0,0.0430504530049048,12.2406074427139,5.84554863597331
9.7,"max_tuv_SVM","SVM",62,20,684,680,4,2100,1845,255,0.78139043087497,0.204545454545455,1.28387096774194,680,255,425,-15,1.7,75.43,7.2,0,0,0,0,0,0,0.0409093121607277,12.7211261565,5.61006895796275
9.7,"max_tuv_SVM","SVM",62,21,584,581,3,2200,1944,256,0.774385408406029,0.136363636363636,1.28387096774194,684,256,428,4,1.7,79.02,7.6,0,0,0,0,0,0,0.0211409280638734,6.73102597698462,3.46975360985399
9.7,"max_tuv_SVM","SVM",62,22,484,481,3,2300,2044,256,0.785541777809821,0.21969696969697,1.28387096774194,700,256,444,16,1.7,82.61,8,0,0,0,0,0,0,0.00734058059230918,1.95120781341972,1.3085489553546
9.7,"max_tuv_SVM","SVM",62,23,384,382,2,2400,2143,257,0.803637084564922,0.234848484848485,1.28387096774194,680,257,423,-20,1.6,86.21,8.3,0,0,0,0,0,0,0.00897227371352132,2.50268695517999,1.92898337726647
9.7,"max_tuv_SVM","SVM",62,24,284,283,1,2500,2242,258,0.806016148799659,0.227272727272727,1.28387096774194,723,258,465,43,1.8,89.8,8.7,0,0,0,0,0,0,0.0643163664356757,15.2641610345682,10.8373819839233
9.7,"max_tuv_SVM","SVM",62,25,184,183,1,2600,2342,258,0.72179367024728,0.159090909090909,1.28387096774194,704,258,446,-19,1.7,93.39,9.1,0,0,0,0,0,0,0.00292137831574785,2.0498623118536,1.99040533029595
9.7,"max_tuv_SVM","SVM",62,26,84,84,0,2700,2441,259,0.796950472208205,0.272727272727273,1.28387096774194,684,259,425,-20,1.6,96.98,9.4,0,0,0,0,0,0,1.25717193140166e-06,0.242917026852657,0.242917026852657
9.7,"max_tuv_SVM","SVM",62,27,0,0,0,2784,2525,259,0.815832792636913,0.287878787878788,1.27414467253177,705,259,446,21,1.7,100,9.7,0,0,0,0,0,0,0,0,0
9.7,"max_tuv_SVM","SVM",63,0,2684,2440,244,100,90,10,0.784125249895392,0.197080291970803,1.27449964680951,29,10,19,0,1.9,3.59,9,0,0,0,0,0,0,0.148661039876177,261.450411279427,16.9584806385719
9.7,"max_tuv_SVM","SVM",63,1,2584,2354,230,200,176,24,0.778842577525687,0.18978102189781,1.27449964680951,70,24,46,41,1.9,7.18,7.3,0,0,0,0,0,0,0.20364319801227,248.12270511992,31.2500960823015
9.7,"max_tuv_SVM","SVM",63,2,2484,2260,224,300,270,30,0.726201822492914,0.240875912408759,1.19015775841771,100,30,70,30,2.3,10.78,9,0,0,0,0,0,0,0.110249559913772,234.746953718992,11.4217516883361
9.7,"max_tuv_SVM","SVM",63,3,2384,2181,203,400,349,51,0.756729741038636,0.357664233576642,1.20890040028255,128,51,77,28,1.5,14.37,6.8,0,0,0,0,0,0,0.179697691671468,209.518161879512,22.4146788139941
9.7,"max_tuv_SVM","SVM",63,4,2284,2113,171,500,417,83,0.764633409270539,0.291970802919708,1.20890040028255,201,83,118,73,1.4,17.96,5,0,0,0,0,0,0,0.174360198521875,231.503755229678,18.5200233745115
9.7,"max_tuv_SVM","SVM",63,5,2184,2031,153,600,499,101,0.759269375610204,0.313868613138686,1.18078643748528,244,101,143,43,1.4,21.55,4.9,0,0,0,0,0,0,0.164847901219934,199.949324623808,18.381792802714
9.7,"max_tuv_SVM","SVM",63,6,2084,1953,131,700,577,123,0.777604723604077,0.321167883211679,1.19952907935013,301,123,178,57,1.4,25.14,4.7,0,0,0,0,0,0,0.173650051747708,169.906102098972,18.4046115554317
9.7,"max_tuv_SVM","SVM",63,7,1984,1883,101,800,647,153,0.792284625040682,0.343065693430657,1.20890040028255,372,153,219,71,1.4,28.74,4.2,0,0,0,0,0,0,0.194170488276558,181.306518216584,20.6602013800723
9.7,"max_tuv_SVM","SVM",63,8,1884,1801,83,900,729,171,0.800112743502722,0.35036496350365,1.20890040028255,413,171,242,41,1.4,32.33,4.3,0,0,0,0,0,0,0.181454255382907,179.060222068238,18.9989108222408
9.7,"max_tuv_SVM","SVM",63,9,1784,1726,58,1000,804,196,0.805261750894977,0.386861313868613,1.20890040028255,474,196,278,61,1.4,35.92,4.1,0,0,0,0,0,0,0.182557183132724,166.508710257548,19.4404052486228
9.7,"max_tuv_SVM","SVM",63,10,1684,1637,47,1100,893,207,0.79748593611977,0.335766423357664,1.19952907935013,515,207,308,41,1.5,39.51,4.3,0,0,0,0,0,0,0.171376774478986,145.426214205041,18.285698865972
9.7,"max_tuv_SVM","SVM",63,11,1584,1542,42,1200,988,212,0.811288297921805,0.364963503649635,1.20890040028255,542,212,330,27,1.6,43.1,4.7,0,0,0,0,0,0,0.156265260386264,112.334996436944,16.6493750112723
9.7,"max_tuv_SVM","SVM",63,12,1484,1446,38,1300,1084,216,0.807900181319453,0.328467153284672,1.20890040028255,554,216,338,12,1.6,46.7,5,0,0,0,0,0,0,0.143882980200346,107.16194545578,15.1738646401373
9.7,"max_tuv_SVM","SVM",63,13,1384,1356,28,1400,1174,226,0.804756148588969,0.313868613138686,1.19952907935013,581,226,355,27,1.6,50.29,5.2,0,0,0,0,0,0,0.13220496270862,78.407167931864,14.8659956452367
9.7,"max_tuv_SVM","SVM",63,14,1284,1263,21,1500,1267,233,0.796683946255064,0.284671532846715,1.19952907935013,612,233,379,31,1.6,53.88,5.4,0,0,0,0,0,0,0.12515412828442,79.6859739745596,14.0127628971154
9.7,"max_tuv_SVM","SVM",63,15,1184,1163,21,1600,1367,233,0.80094379097123,0.321167883211679,1.19952907935013,616,233,383,4,1.6,57.47,5.9,0,0,0,0,0,0,0.0969534887141321,48.987541592866,10.8416126357603
9.7,"max_tuv_SVM","SVM",63,16,1084,1064,20,1700,1466,234,0.790907294620862,0.284671532846715,1.19952907935013,627,234,393,11,1.7,61.06,6.3,0,0,0,0,0,0,0.0950238160262563,46.9435469047596,12.4149859396852
9.7,"max_tuv_SVM","SVM",63,17,984,964,20,1800,1566,234,0.793929285415417,0.27007299270073,1.19015775841771,634,234,400,7,1.7,64.66,6.7,0,0,0,0,0,0,0.0675981545734097,24.3160188141152,7.84283415830028
9.7,"max_tuv_SVM","SVM",63,18,884,864,20,1900,1666,234,0.791302478032461,0.277372262773723,1.19952907935013,628,234,394,-6,1.7,68.25,7.1,0,0,0,0,0,0,0.0611321542276027,23.2459613727209,7.30339767044433
9.7,"max_tuv_SVM","SVM",63,19,784,764,20,2000,1766,234,0.796065019294254,0.291970802919708,1.19015775841771,621,234,387,-7,1.7,71.84,7.5,0,0,0,0,0,0,0.0224551339725794,6.17852422059665,3.27863203775161
9.7,"max_tuv_SVM","SVM",63,20,684,665,19,2100,1865,235,0.790889860058584,0.299270072992701,1.19952907935013,619,235,384,-2,1.6,75.43,7.9,0,0,0,0,0,0,0.015699100642977,4.34709707058403,2.6678738108249
9.7,"max_tuv_SVM","SVM",63,21,584,565,19,2200,1965,235,0.79348760983775,0.277372262773723,1.19015775841771,634,235,399,15,1.7,79.02,8.4,0,0,0,0,0,0,0.0210505791923825,6.51635882602913,3.02537980184341
9.7,"max_tuv_SVM","SVM",63,22,484,467,17,2300,2063,237,0.784793574782654,0.204379562043796,1.19952907935013,624,237,387,-10,1.6,82.61,8.7,0,0,0,0,0,0,0.00269774196891345,1.27844653339858,1.03130987479581
9.7,"max_tuv_SVM","SVM",63,23,384,373,11,2400,2157,243,0.805157143521325,0.35036496350365,1.19952907935013,631,243,388,7,1.6,86.21,8.9,0,0,0,0,0,0,0.0416066890875756,11.0867249732046,8.88755218022122
9.7,"max_tuv_SVM","SVM",63,24,284,273,11,2500,2257,243,0.767678646148129,0.233576642335766,1.19952907935013,651,243,408,20,1.7,89.8,9.3,0,0,0,0,0,0,0.00421787697448997,2.02135536492623,1.83329072598586
9.7,"max_tuv_SVM","SVM",63,25,184,174,10,2600,2356,244,0.791081640243625,0.27007299270073,1.19952907935013,653,244,409,2,1.7,93.39,9.7,0,0,0,0,0,0,0.000105345695456612,0.094936461005274,0.0921965884339805
9.7,"max_tuv_SVM","SVM",63,26,84,78,6,2700,2452,248,0.806313636152311,0.277372262773723,1.21827172121498,663,248,415,10,1.7,96.98,9.9,0,0,0,0,0,0,3.61450111680371e-05,1.78808321625837,1.78808321625837
9.7,"max_tuv_SVM","SVM",63,27,0,0,0,2784,2530,254,0.824579245897066,0.328467153284672,1.27449964680951,702,254,448,39,1.8,100,10,0,0,0,0,0,0,0,0,0
9.7,"max_tuv_SVM","SVM",64,0,2684,2432,252,100,87,13,0.702390348404555,0.0873015873015873,1.26349206349206,41,13,28,0,2.2,3.59,6.7,0,0,0,0,0,0,0.136793573205549,352.852810366913,13.8177979763039
9.7,"max_tuv_SVM","SVM",64,1,2584,2332,252,200,187,13,0.712707182320438,0.103174603174603,1.25330261136713,41,13,28,0,2.2,7.18,14.4,0,0,0,0,0,0,0.0777878399718634,185.225335121616,7.94711544425529
9.7,"max_tuv_SVM","SVM",64,2,2484,2249,235,300,270,30,0.709568910437103,0.214285714285714,1.21254480286738,80,30,50,39,1.7,10.78,9,0,0,0,0,0,0,0.130763536753217,257.136107085084,14.3062310202671
9.7,"max_tuv_SVM","SVM",64,3,2384,2176,208,400,343,57,0.727803460242295,0.206349206349206,1.19216589861751,142,57,85,62,1.5,14.37,6,0,0,0,0,0,0,0.176682953265672,324.832191802785,19.0123724703391
9.7,"max_tuv_SVM","SVM",64,4,2284,2087,197,500,432,68,0.771689154483149,0.222222222222222,1.25330261136713,175,68,107,33,1.6,17.96,6.4,0,0,0,0,0,0,0.160949972757698,255.689499616581,16.70223883704
9.7,"max_tuv_SVM","SVM",64,5,2184,1997,187,600,522,78,0.779274877538484,0.26984126984127,1.25330261136713,196,78,118,21,1.5,21.55,6.7,0,0,0,0,0,0,0.142716432793058,237.497396041467,14.498100251767
9.7,"max_tuv_SVM","SVM",64,6,2084,1919,165,700,600,100,0.797183698525438,0.293650793650794,1.25330261136713,249,100,149,53,1.5,25.14,6,0,0,0,0,0,0,0.161746915801215,207.133739572791,16.755558467035
9.7,"max_tuv_SVM","SVM",64,7,1984,1850,134,800,669,131,0.797991756555291,0.341269841269841,1.24311315924219,319,131,188,70,1.4,28.74,5.1,0,0,0,0,0,0,0.175867987433169,214.544001038047,18.2206919923562
9.7,"max_tuv_SVM","SVM",64,8,1884,1776,108,900,743,157,0.786628832011628,0.30952380952381,1.22273425499232,378,157,221,59,1.4,32.33,4.7,0,0,0,0,0,0,0.175865831516869,158.71296855341,18.7506594763922
9.7,"max_tuv_SVM","SVM",64,9,1784,1699,85,1000,820,180,0.785213164455466,0.238095238095238,1.23292370711726,442,180,262,64,1.5,35.92,4.6,0,0,0,0,0,0,0.18101489169214,159.427994560036,19.1616853299852
9.7,"max_tuv_SVM","SVM",64,10,1684,1617,67,1100,902,198,0.780014031395242,0.246031746031746,1.21254480286738,483,198,285,41,1.4,39.51,4.6,0,0,0,0,0,0,0.180702277487032,176.909480464347,18.747141556614
9.7,"max_tuv_SVM","SVM",64,11,1584,1536,48,1200,983,217,0.759154858997001,0.150793650793651,1.20235535074245,536,217,319,53,1.5,43.1,4.5,0,0,0,0,0,0,0.17945753045055,156.779925192659,19.232089857066
9.7,"max_tuv_SVM","SVM",64,12,1484,1439,45,1300,1080,220,0.761647937259616,0.158730158730159,1.21254480286738,546,220,326,10,1.5,46.7,4.9,0,0,0,0,0,0,0.146065146438933,100.604559716255,15.8043231212617
9.7,"max_tuv_SVM","SVM",64,13,1384,1342,42,1400,1177,223,0.767003670713218,0.214285714285714,1.22273425499232,557,223,334,11,1.5,50.29,5.3,0,0,0,0,0,0,0.140607816600278,112.273560981647,14.7133008957883
9.7,"max_tuv_SVM","SVM",64,14,1284,1243,41,1500,1276,224,0.776524974630731,0.222222222222222,1.23292370711726,565,224,341,8,1.5,53.88,5.7,0,0,0,0,0,0,0.110504520032222,74.5065075918192,11.8400401459784
9.7,"max_tuv_SVM","SVM",64,15,1184,1147,37,1600,1372,228,0.772277971962261,0.198412698412698,1.23292370711726,575,228,347,10,1.5,57.47,6,0,0,0,0,0,0,0.0968126785880735,55.9337689606422,11.3777160409339
9.7,"max_tuv_SVM","SVM",64,16,1084,1058,26,1700,1461,239,0.793249896643738,0.222222222222222,1.20235535074245,613,239,374,38,1.6,61.06,6.1,0,0,0,0,0,0,0.135010782275908,68.6844093112626,15.3750736601929
9.7,"max_tuv_SVM","SVM",64,17,984,967,17,1800,1552,248,0.797121058368097,0.206349206349206,1.20235535074245,631,248,383,18,1.5,64.66,6.3,0,0,0,0,0,0,0.109474874681035,56.0247137969694,12.4612831065385
9.7,"max_tuv_SVM","SVM",64,18,884,871,13,1900,1648,252,0.809874594404982,0.246031746031746,1.21254480286738,641,252,389,10,1.5,68.25,6.5,0,0,0,0,0,0,0.0636379702955139,30.1898270940301,7.87975096726081
9.7,"max_tuv_SVM","SVM",64,19,784,772,12,2000,1747,253,0.792003357512435,0.174603174603175,1.21254480286738,653,253,400,12,1.6,71.84,6.9,0,0,0,0,0,0,0.115429468398528,65.7227082823566,12.532365572428
9.7,"max_tuv_SVM","SVM",64,20,684,672,12,2100,1847,253,0.811052229363201,0.26984126984127,1.21254480286738,658,253,405,5,1.6,75.43,7.3,0,0,0,0,0,0,0.0673017254178787,28.7043654991155,7.85322512336282
9.7,"max_tuv_SVM","SVM",64,21,584,573,11,2200,1946,254,0.790525049798926,0.206349206349206,1.21254480286738,656,254,402,-2,1.6,79.02,7.7,0,0,0,0,0,0,0.0355381793861343,11.7293424945607,5.30568888523027
9.7,"max_tuv_SVM","SVM",64,22,484,473,11,2300,2046,254,0.774482905501059,0.182539682539683,1.21254480286738,647,254,393,-9,1.5,82.61,8.1,0,0,0,0,0,0,0.0347013140319888,10.5523477034588,4.26724665212236
9.7,"max_tuv_SVM","SVM",64,23,384,373,11,2400,2146,254,0.769521805038777,0.182539682539683,1.21254480286738,665,254,411,18,1.6,86.21,8.4,0,0,0,0,0,0,0.00889134731873414,2.45175536995269,1.41841130387321
9.7,"max_tuv_SVM","SVM",64,24,284,276,8,2500,2243,257,0.779212237381143,0.19047619047619,1.21254480286738,687,257,430,22,1.7,89.8,8.7,0,0,0,0,0,0,0.0149215977875979,3.74637795445531,2.33245748502374
9.7,"max_tuv_SVM","SVM",64,25,184,181,3,2600,2338,262,0.816107290061511,0.214285714285714,1.25330261136713,694,262,432,7,1.6,93.39,8.9,0,0,0,0,0,0,0.00783619595064177,2.74633509598664,2.2897574551454
9.7,"max_tuv_SVM","SVM",64,26,84,84,0,2700,2435,265,0.790280753185253,0.150793650793651,1.25330261136713,717,265,452,23,1.7,96.98,9.2,0,0,0,0,0,0,0.000483085706651011,0.218140693370005,0.218140693370005
9.7,"max_tuv_SVM","SVM",64,27,0,0,0,2784,2519,265,0.829029954523245,0.246031746031746,1.26349206349206,713,265,448,-4,1.7,100,9.5,0,0,0,0,0,0,0,0,0
9.7,"max_tuv_SVM","SVM",65,0,2684,2426,258,100,89,11,0.736524744940737,0.237704918032787,1.23125330512956,33,11,22,0,2,3.59,8.1,0,0,0,0,0,0,0.284674171325104,295.796788473807,44.7831666242257
9.7,"max_tuv_SVM","SVM",65,1,2584,2349,235,200,166,34,0.755523597012814,0.229508196721311,1.19968270756214,86,34,52,53,1.5,7.18,4.9,0,0,0,0,0,0,0.277917138309849,317.800766610953,32.2618905094558
9.7,"max_tuv_SVM","SVM",65,2,2484,2281,203,300,234,66,0.694844642788045,0.245901639344262,1.17863564251719,155,66,89,69,1.3,10.78,3.5,0,0,0,0,0,0,0.235679897709828,312.25190467571,26.6053998754452
9.7,"max_tuv_SVM","SVM",65,3,2384,2204,180,400,311,89,0.750854496910908,0.188524590163934,1.27334743521946,213,89,124,58,1.4,14.37,3.5,0,0,0,0,0,0,0.23367684020686,347.006583066341,23.8364909263638
9.7,"max_tuv_SVM","SVM",65,4,2284,2113,171,500,402,98,0.764906940449624,0.237704918032787,1.27334743521946,239,98,141,26,1.4,17.96,4.1,0,0,0,0,0,0,0.195195063204724,218.681105157207,20.2531271609454
9.7,"max_tuv_SVM","SVM",65,5,2184,2028,156,600,487,113,0.788516851323982,0.270491803278689,1.27334743521946,263,113,150,24,1.3,21.55,4.3,0,0,0,0,0,0,0.180422399001814,179.807733675504,18.6986627007739
9.7,"max_tuv_SVM","SVM",65,6,2084,1951,133,700,564,136,0.815248094310661,0.336065573770492,1.26282390269699,331,136,195,68,1.4,25.14,4.1,0,0,0,0,0,0,0.183824512565403,189.223041076452,19.1187622010905
9.7,"max_tuv_SVM","SVM",65,7,1984,1878,106,800,637,163,0.812320233197043,0.295081967213115,1.26282390269699,393,163,230,62,1.4,28.74,3.9,0,0,0,0,0,0,0.186117076277509,138.863168183092,20.2766440057126
9.7,"max_tuv_SVM","SVM",65,8,1884,1805,79,900,710,190,0.821871251499403,0.262295081967213,1.26282390269699,462,190,272,69,1.4,32.33,3.7,0,0,0,0,0,0,0.182155104023754,132.641274292473,19.8010370803884
9.7,"max_tuv_SVM","SVM",65,9,1784,1716,68,1000,799,201,0.826965987798436,0.311475409836066,1.26282390269699,482,201,281,20,1.4,35.92,4,0,0,0,0,0,0,0.176212688032439,166.550682336078,18.374421076669
9.7,"max_tuv_SVM","SVM",65,10,1684,1631,53,1100,884,216,0.814732171647478,0.270491803278689,1.25230037017451,533,216,317,51,1.5,39.51,4.1,0,0,0,0,0,0,0.174432868868557,147.464265126735,18.6770753257277
9.7,"max_tuv_SVM","SVM",65,11,1584,1541,43,1200,974,226,0.811752718267537,0.245901639344262,1.24177683765204,555,226,329,22,1.5,43.1,4.3,0,0,0,0,0,0,0.155059331571011,107.854588914114,16.5404183791089
9.7,"max_tuv_SVM","SVM",65,12,1484,1450,34,1300,1065,235,0.78796223446106,0.213114754098361,1.23125330512956,597,235,362,42,1.5,46.7,4.5,0,0,0,0,0,0,0.172055147473007,119.160358524374,19.0538699937405
9.7,"max_tuv_SVM","SVM",65,13,1384,1350,34,1400,1165,235,0.809618088248579,0.270491803278689,1.26282390269699,623,235,388,26,1.7,50.29,5,0,0,0,0,0,0,0.148454214349744,85.8188155949533,15.575901996296
9.7,"max_tuv_SVM","SVM",65,14,1284,1257,27,1500,1258,242,0.798777263288239,0.221311475409836,1.26282390269699,639,242,397,16,1.6,53.88,5.2,0,0,0,0,0,0,0.138089084263786,65.4317336681215,15.0023760015799
9.7,"max_tuv_SVM","SVM",65,15,1184,1158,26,1600,1357,243,0.818369426422985,0.278688524590164,1.25230037017451,642,243,399,3,1.6,57.47,5.6,0,0,0,0,0,0,0.108824858031748,41.5858379545141,11.5754685303843
9.7,"max_tuv_SVM","SVM",65,16,1084,1059,25,1700,1456,244,0.8016148379358,0.229508196721311,1.25230037017451,646,244,402,4,1.6,61.06,6,0,0,0,0,0,0,0.0849394603598356,27.1913376381648,9.66288744951799
9.7,"max_tuv_SVM","SVM",65,17,984,959,25,1800,1556,244,0.798009828326739,0.213114754098361,1.26282390269699,651,244,407,5,1.7,64.66,6.4,0,0,0,0,0,0,0.0235745760785075,6.06588253480442,3.9518988158388
9.7,"max_tuv_SVM","SVM",65,18,884,862,22,1900,1653,247,0.826256594136542,0.286885245901639,1.26282390269699,655,247,408,4,1.7,68.25,6.7,0,0,0,0,0,0,0.053758932685468,14.7342788190471,6.8564021879155
9.7,"max_tuv_SVM","SVM",65,19,784,766,18,2000,1749,251,0.816421818369431,0.237704918032787,1.26282390269699,660,251,409,5,1.6,71.84,7,0,0,0,0,0,0,0.00390626265275064,1.67486629584317,1.43418613257028
9.7,"max_tuv_SVM","SVM",65,20,684,670,14,2100,1845,255,0.83155769950085,0.286885245901639,1.26282390269699,689,255,434,29,1.7,75.43,7.2,0,0,0,0,0,0,0.0118784175992263,4.41285924871272,2.17055230751635
9.7,"max_tuv_SVM","SVM",65,21,584,571,13,2200,1944,256,0.82521185074357,0.286885245901639,1.25230037017451,677,256,421,-12,1.6,79.02,7.6,0,0,0,0,0,0,0.0192703591325445,5.32527401356358,2.95881396342674
9.7,"max_tuv_SVM","SVM",65,22,484,471,13,2300,2044,256,0.80597438443977,0.245901639344262,1.25230037017451,670,256,414,-7,1.6,82.61,8,0,0,0,0,0,0,0.0101995249221771,3.13990677132462,1.7215925554589
9.7,"max_tuv_SVM","SVM",65,23,384,375,9,2400,2140,260,0.778656279423713,0.172131147540984,1.23125330512956,698,260,438,28,1.7,86.21,8.2,0,0,0,0,0,0,0.0246420469976642,8.75105160194993,6.45248016634608
9.7,"max_tuv_SVM","SVM",65,24,284,275,9,2500,2240,260,0.805619687608826,0.204918032786885,1.24177683765204,709,260,449,11,1.7,89.8,8.6,0,0,0,0,0,0,0.00822673993246385,2.0238513024625,1.37091541346993
9.7,"max_tuv_SVM","SVM",65,25,184,177,7,2600,2338,262,0.824824908746174,0.278688524590164,1.27334743521946,698,262,436,-11,1.7,93.39,8.9,0,0,0,0,0,0,0.00577732636843036,1.75729222265612,1.57115070312546
9.7,"max_tuv_SVM","SVM",65,26,84,83,1,2700,2432,268,0.82271607486038,0.229508196721311,1.28387096774194,745,268,477,47,1.8,96.98,9.1,0,0,0,0,0,0,9.36820387705353e-07,0.314264275495038,0.314264275495038
9.7,"max_tuv_SVM","SVM",65,27,0,0,0,2784,2515,269,0.814403270949686,0.213114754098361,1.28387096774194,740,269,471,-5,1.8,100,9.3,0,0,0,0,0,0,0,0,0
9.7,"max_tuv_SVM","SVM",66,0,2684,2426,258,100,94,6,0.177855730119043,0,0.485242570485141,18,6,12,0,2,3.59,15.7,0,0,0,0,0,0,0.0623247039385188,167.212402614507,6.2326156229163
9.7,"max_tuv_SVM","SVM",66,1,2584,2348,236,200,172,28,0.817871403515317,0.299212598425197,1.26365252730505,72,28,44,54,1.6,7.18,6.1,0,0,0,0,0,0,0.198738077449166,244.25692433535,23.6387815859773
9.7,"max_tuv_SVM","SVM",66,2,2484,2264,220,300,256,44,0.853080568720386,0.377952755905512,1.2737617475235,113,44,69,41,1.6,10.78,5.8,0,0,0,0,0,0,0.158315270765814,120.631362627912,16.8487894556012
9.7,"max_tuv_SVM","SVM",66,3,2384,2193,191,400,327,73,0.842930178751355,0.362204724409449,1.26365252730505,181,73,108,68,1.5,14.37,4.5,0,0,0,0,0,0,0.18391846284122,141.715190391742,19.8693270287195
9.7,"max_tuv_SVM","SVM",66,4,2284,2122,162,500,398,102,0.810998743640463,0.228346456692913,1.26365252730505,235,102,133,54,1.3,17.96,3.9,0,0,0,0,0,0,0.246757081789673,384.456196449021,28.1408045037856
9.7,"max_tuv_SVM","SVM",66,5,2184,2032,152,600,488,112,0.731829433643062,0.149606299212598,1.21310642621285,276,112,164,41,1.5,21.55,4.4,0,0,0,0,0,0,0.217988769316746,276.588270192766,24.8432680755459
9.7,"max_tuv_SVM","SVM",66,6,2084,1934,150,700,586,114,0.849697105397378,0.307086614173228,1.25354330708661,295,114,181,19,1.6,25.14,5.1,0,0,0,0,0,0,0.18683646122615,135.035559158943,19.377634226819
9.7,"max_tuv_SVM","SVM",66,7,1984,1873,111,800,647,153,0.851562985906383,0.338582677165354,1.28387096774194,376,153,223,81,1.5,28.74,4.2,0,0,0,0,0,0,0.211729231577001,217.711476983661,22.6674777004521
9.7,"max_tuv_SVM","SVM",66,8,1884,1803,81,900,717,183,0.851793111169158,0.322834645669291,1.28387096774194,447,183,264,71,1.4,32.33,3.9,0,0,0,0,0,0,0.21505761173334,166.284480959203,22.0291188899773
9.7,"max_tuv_SVM","SVM",66,9,1784,1723,61,1000,797,203,0.852041895237027,0.307086614173228,1.2737617475235,499,203,296,52,1.5,35.92,3.9,0,0,0,0,0,0,0.178154320718241,95.4045950915924,19.9904004056284
9.7,"max_tuv_SVM","SVM",66,10,1684,1637,47,1100,883,217,0.820807055516168,0.236220472440945,1.26365252730505,542,217,325,43,1.5,39.51,4.1,0,0,0,0,0,0,0.186846686543044,134.662671231957,25.9700051074769
9.7,"max_tuv_SVM","SVM",66,11,1584,1541,43,1200,979,221,0.839615131047011,0.251968503937008,1.28387096774194,550,221,329,8,1.5,43.1,4.4,0,0,0,0,0,0,0.135274793382775,66.3729507126755,14.9681307580303
9.7,"max_tuv_SVM","SVM",66,12,1484,1449,35,1300,1071,229,0.843695189760053,0.275590551181102,1.28387096774194,581,229,352,31,1.5,46.7,4.7,0,0,0,0,0,0,0.151323534821942,78.8860650196376,16.8628748601254
9.7,"max_tuv_SVM","SVM",66,13,1384,1354,30,1400,1166,234,0.828133746314891,0.228346456692913,1.28387096774194,597,234,363,16,1.6,50.29,5,0,0,0,0,0,0,0.132156211859266,63.3330093831662,14.9442363536054
9.7,"max_tuv_SVM","SVM",66,14,1284,1258,26,1500,1262,238,0.839776840691128,0.283464566929134,1.28387096774194,612,238,374,15,1.6,53.88,5.3,0,0,0,0,0,0,0.0995218548817433,38.1610221089618,11.6334177559469
9.7,"max_tuv_SVM","SVM",66,15,1184,1163,21,1600,1357,243,0.826628602704287,0.21259842519685,1.28387096774194,628,243,385,16,1.6,57.47,5.6,0,0,0,0,0,0,0.0981243880372492,40.2981837196221,11.3076401510871
9.7,"max_tuv_SVM","SVM",66,16,1084,1077,7,1700,1443,257,0.767430433755019,0.102362204724409,1.28387096774194,684,257,427,56,1.7,61.06,5.6,0,0,0,0,0,0,0.155279624679392,71.5609058769891,18.2217286157422
9.7,"max_tuv_SVM","SVM",66,17,984,980,4,1800,1540,260,0.812441691234098,0.236220472440945,1.28387096774194,686,260,426,2,1.6,64.66,5.9,0,0,0,0,0,0,0.106377202784541,39.6768890400976,12.7255600496126
9.7,"max_tuv_SVM","SVM",66,18,884,881,3,1900,1639,261,0.802291301265071,0.204724409448819,1.2737617475235,700,261,439,14,1.7,68.25,6.3,0,0,0,0,0,0,0.0752149745496148,24.5392507080908,8.74476007208541
9.7,"max_tuv_SVM","SVM",66,19,784,781,3,2000,1739,261,0.793863740966034,0.15748031496063,1.2737617475235,703,261,442,3,1.7,71.84,6.7,0,0,0,0,0,0,0.0449539844312797,12.7804192741211,5.66258861904738
9.7,"max_tuv_SVM","SVM",66,20,684,682,2,2100,1838,262,0.786941324277597,0.15748031496063,1.2737617475235,713,262,451,10,1.7,75.43,7,0,0,0,0,0,0,0.0699121894357963,25.7622843798149,9.23707818731223
9.7,"max_tuv_SVM","SVM",66,21,584,583,1,2200,1937,263,0.772319040688637,0.181102362204724,1.2737617475235,727,263,464,14,1.8,79.02,7.4,0,0,0,0,0,0,0.0661295813523483,21.3777848120799,9.2964549072231
9.7,"max_tuv_SVM","SVM",66,22,484,483,1,2300,2037,263,0.770683285442405,0.173228346456693,1.2737617475235,726,263,463,-1,1.8,82.61,7.7,0,0,0,0,0,0,0.0412273465334571,11.0262632157221,5.52835527045294
9.7,"max_tuv_SVM","SVM",66,23,384,383,1,2400,2137,263,0.78506922416689,0.181102362204724,1.2737617475235,714,263,451,-12,1.7,86.21,8.1,0,0,0,0,0,0,0.0354651108260279,8.90054004858718,4.74487330117318
9.7,"max_tuv_SVM","SVM",66,24,284,283,1,2500,2237,263,0.796395118856591,0.181102362204724,1.2737617475235,715,263,452,1,1.7,89.8,8.5,0,0,0,0,0,0,0.0164293984519616,3.68934741484321,2.44279302427995
9.7,"max_tuv_SVM","SVM",66,25,184,183,1,2600,2337,263,0.762815489296068,0.110236220472441,1.2737617475235,722,263,459,7,1.7,93.39,8.9,0,0,0,0,0,0,0.00351687312480722,0.955045592830346,0.92201374756677
9.7,"max_tuv_SVM","SVM",66,26,84,84,0,2700,2436,264,0.738577701483996,0.125984251968504,1.2737617475235,733,264,469,11,1.8,96.98,9.2,0,0,0,0,0,0,8.93714733303e-12,2.58915064416791,2.58915064416791
9.7,"max_tuv_SVM","SVM",66,27,0,0,0,2784,2520,264,0.773724670672089,0.181102362204724,1.2737617475235,738,264,474,5,1.8,100,9.5,0,0,0,0,0,0,0,0,0
9.7,"max_tuv_SVM","SVM",67,0,2684,2436,248,100,88,12,0.71672856607106,0.213740458015267,1.2348682590495,38,12,26,0,2.2,3.59,7.3,0,0,0,0,0,0,0.202705450024683,337.766827033392,28.9195432961104
9.7,"max_tuv_SVM","SVM",67,1,2584,2336,248,200,188,12,0.706820628833427,0.221374045801527,1.2348682590495,39,12,27,1,2.2,7.18,15.7,0,0,0,0,0,0,0.112498708081017,182.813520846735,16.3316716231244
9.7,"max_tuv_SVM","SVM",67,2,2484,2251,233,300,273,27,0.78732413108963,0.213740458015267,1.27407042600345,83,27,56,44,2.1,10.78,10.1,0,0,0,0,0,0,0.262359574552823,236.444770397102,35.9706183530339
9.7,"max_tuv_SVM","SVM",67,3,2384,2166,218,400,358,42,0.7025562236121,0.274809160305344,1.25446934252647,123,42,81,40,1.9,14.37,8.5,0,0,0,0,0,0,0.217798398894615,210.222010001192,30.5583004837527
9.7,"max_tuv_SVM","SVM",67,4,2284,2102,182,500,422,78,0.690168277664186,0.137404580152672,1.19566609209554,195,78,117,72,1.5,17.96,5.4,0,0,0,0,0,0,0.231974174838665,312.447000110603,32.3677367559298
9.7,"max_tuv_SVM","SVM",67,5,2184,2014,170,600,510,90,0.803680090973976,0.229007633587786,1.24466880078798,214,90,124,19,1.4,21.55,5.7,0,0,0,0,0,0,0.195583283767992,194.956340566442,21.0101560441015
9.7,"max_tuv_SVM","SVM",67,6,2084,1943,141,700,581,119,0.801091203832517,0.282442748091603,1.24466880078798,284,119,165,70,1.4,25.14,4.9,0,0,0,0,0,0,0.20397433150875,184.517467737953,21.1044017976968
9.7,"max_tuv_SVM","SVM",67,7,1984,1877,107,800,647,153,0.814471153264534,0.312977099236641,1.24466880078798,358,153,205,74,1.3,28.74,4.2,0,0,0,0,0,0,0.212298551196282,198.421368155156,21.9138316420786
9.7,"max_tuv_SVM","SVM",67,8,1884,1803,81,900,721,179,0.814767544549419,0.282442748091603,1.24466880078798,424,179,245,66,1.4,32.33,4,0,0,0,0,0,0,0.205399537731988,123.267329954097,21.6229657899995
9.7,"max_tuv_SVM","SVM",67,9,1784,1724,60,1000,800,200,0.82082844388526,0.312977099236641,1.24466880078798,472,200,272,48,1.4,35.92,4,0,0,0,0,0,0,0.203551669996483,131.649161257793,21.3913351834065
9.7,"max_tuv_SVM","SVM",67,10,1684,1641,43,1100,883,217,0.832423996806226,0.33587786259542,1.25446934252647,526,217,309,54,1.4,39.51,4.1,0,0,0,0,0,0,0.193427087784592,109.17733222537,20.8862447019438
9.7,"max_tuv_SVM","SVM",67,11,1584,1554,30,1200,970,230,0.828093054765846,0.305343511450382,1.25446934252647,557,230,327,31,1.4,43.1,4.2,0,0,0,0,0,0,0.170267835800877,96.5212903081521,18.7878843552337
9.7,"max_tuv_SVM","SVM",67,12,1484,1460,24,1300,1064,236,0.83607747305258,0.305343511450382,1.25446934252647,584,236,348,27,1.5,46.7,4.5,0,0,0,0,0,0,0.163786442787306,93.8088281131647,17.8815777466931
9.7,"max_tuv_SVM","SVM",67,13,1384,1363,21,1400,1161,239,0.82557070444344,0.320610687022901,1.22506771731101,596,239,357,12,1.5,50.29,4.9,0,0,0,0,0,0,0.151217856663673,91.2017577941907,17.1624464731832
9.7,"max_tuv_SVM","SVM",67,14,1284,1267,17,1500,1257,243,0.82626631664266,0.32824427480916,1.22506771731101,608,243,365,12,1.5,53.88,5.2,0,0,0,0,0,0,0.125684229757938,65.4752852699665,14.2225072337251
9.7,"max_tuv_SVM","SVM",67,15,1184,1168,16,1600,1356,244,0.799131392071217,0.251908396946565,1.22506771731101,624,244,380,16,1.6,57.47,5.6,0,0,0,0,0,0,0.118619633424633,68.0614498791375,13.5230831734696
9.7,"max_tuv_SVM","SVM",67,16,1084,1069,15,1700,1455,245,0.810019235189495,0.282442748091603,1.22506771731101,625,245,380,1,1.6,61.06,5.9,0,0,0,0,0,0,0.0852080503876518,39.1791644977825,9.68516689883297
9.7,"max_tuv_SVM","SVM",67,17,984,970,14,1800,1554,246,0.81311622167647,0.297709923664122,1.22506771731101,628,246,382,3,1.6,64.66,6.3,0,0,0,0,0,0,0.0666600846842286,26.5915929673537,7.84640894395796
9.7,"max_tuv_SVM","SVM",67,18,884,870,14,1900,1654,246,0.804079311888298,0.274809160305344,1.22506771731101,611,246,365,-17,1.5,68.25,6.7,0,0,0,0,0,0,0.045024178871348,15.2337095825691,5.53917278890398
9.7,"max_tuv_SVM","SVM",67,19,784,770,14,2000,1754,246,0.802161841739136,0.251908396946565,1.22506771731101,640,246,394,29,1.6,71.84,7.1,0,0,0,0,0,0,0.0423941768621569,13.6135894256134,5.33040812713073
9.7,"max_tuv_SVM","SVM",67,20,684,671,13,2100,1853,247,0.798369243052934,0.267175572519084,1.22506771731101,621,247,374,-19,1.5,75.43,7.5,0,0,0,0,0,0,0.0250533087180989,7.75369446035908,3.89857313263154
9.7,"max_tuv_SVM","SVM",67,21,584,572,12,2200,1952,248,0.804248678336804,0.267175572519084,1.22506771731101,647,248,399,26,1.6,79.02,7.9,0,0,0,0,0,0,0.0113167379658977,3.09738281429817,1.96030726588753
9.7,"max_tuv_SVM","SVM",67,22,484,473,11,2300,2051,249,0.810122064818946,0.274809160305344,1.22506771731101,637,249,388,-10,1.6,82.61,8.2,0,0,0,0,0,0,0.00249711868532941,0.835642920177107,0.606168768987227
9.7,"max_tuv_SVM","SVM",67,23,384,375,9,2400,2149,251,0.795858990333998,0.251908396946565,1.21526717557252,668,251,417,31,1.7,86.21,8.6,0,0,0,0,0,0,0.0441139762756813,11.2633650000119,8.17762459363611
9.7,"max_tuv_SVM","SVM",67,24,284,275,9,2500,2249,251,0.81805809269182,0.312977099236641,1.21526717557252,662,251,411,-6,1.6,89.8,9,0,0,0,0,0,0,0.00571026281042636,1.78575928628179,1.33682436596003
9.7,"max_tuv_SVM","SVM",67,25,184,177,7,2600,2347,253,0.808500985954666,0.320610687022901,1.21526717557252,685,253,432,23,1.7,93.39,9.3,0,0,0,0,0,0,0.00478326265516989,1.79812148238261,1.63261691883373
9.7,"max_tuv_SVM","SVM",67,26,84,83,1,2700,2441,259,0.834002734058381,0.33587786259542,1.27407042600345,697,259,438,12,1.7,96.98,9.4,0,0,0,0,0,0,6.45247828066707e-07,0.733537922496262,0.733537922496262
9.7,"max_tuv_SVM","SVM",67,27,0,0,0,2784,2524,260,0.771911784275533,0.183206106870229,1.27407042600345,717,260,457,20,1.8,100,9.7,0,0,0,0,0,0,0,0,0
9.7,"max_tuv_SVM","SVM",68,0,2684,2419,265,100,91,9,0.786807062669132,0.239316239316239,1.28387096774194,30,9,21,0,2.3,3.59,10.1,0,0,0,0,0,0,0.115505013093837,252.477713992681,11.9586933277076
9.7,"max_tuv_SVM","SVM",68,1,2584,2338,246,200,172,28,0.731244808831013,0.239316239316239,1.26192445547284,73,28,45,43,1.6,7.18,6.1,0,0,0,0,0,0,0.154185677270698,341.657343770957,15.9972946906098
9.7,"max_tuv_SVM","SVM",68,2,2484,2276,208,300,234,66,0.737614875545907,0.196581196581197,1.2509511993383,160,66,94,87,1.4,10.78,3.5,0,0,0,0,0,0,0.225764374598704,460.320260028659,23.12063240752
9.7,"max_tuv_SVM","SVM",68,3,2384,2210,174,400,300,100,0.764253945288424,0.188034188034188,1.27289771160739,229,100,129,69,1.3,14.37,3,0,0,0,0,0,0,0.259086824535974,459.661808572392,29.1836260868825
9.7,"max_tuv_SVM","SVM",68,4,2284,2125,159,500,385,115,0.778675347640866,0.205128205128205,1.26192445547284,276,115,161,47,1.4,17.96,3.3,0,0,0,0,0,0,0.226860610476233,359.593103650501,23.2735220374918
9.7,"max_tuv_SVM","SVM",68,5,2184,2041,143,600,469,131,0.774401843367359,0.222222222222222,1.2509511993383,309,131,178,33,1.4,21.55,3.6,0,0,0,0,0,0,0.203725408855845,241.325213387466,21.0053859126748
9.7,"max_tuv_SVM","SVM",68,6,2084,1970,114,700,540,160,0.776223776223783,0.222222222222222,1.26192445547284,376,160,216,67,1.4,25.14,3.4,0,0,0,0,0,0,0.22240418098799,221.62867716521,23.2155774284287
9.7,"max_tuv_SVM","SVM",68,7,1984,1885,99,800,625,175,0.777248613455519,0.213675213675214,1.26192445547284,416,175,241,40,1.4,28.74,3.6,0,0,0,0,0,0,0.209534907562053,267.349145059847,21.5821898074316
9.7,"max_tuv_SVM","SVM",68,8,1884,1810,74,900,700,200,0.792527395975676,0.239316239316239,1.26192445547284,474,200,274,58,1.4,32.33,3.5,0,0,0,0,0,0,0.206002642993571,194.411467289129,25.9905180793361
9.7,"max_tuv_SVM","SVM",68,9,1784,1729,55,1000,781,219,0.796425796425801,0.222222222222222,1.2509511993383,518,219,299,44,1.4,35.92,3.6,0,0,0,0,0,0,0.203056045621199,231.942889141635,21.3577063606843
9.7,"max_tuv_SVM","SVM",68,10,1684,1640,44,1100,870,230,0.793712991988862,0.239316239316239,1.23997794320375,556,230,326,38,1.4,39.51,3.8,0,0,0,0,0,0,0.188983732305553,179.056284284221,19.7833786539227
9.7,"max_tuv_SVM","SVM",68,11,1584,1555,29,1200,955,245,0.793826862792386,0.247863247863248,1.2290046870692,606,245,361,50,1.5,43.1,3.9,0,0,0,0,0,0,0.175833294498184,141.608828567872,18.8456629577624
9.7,"max_tuv_SVM","SVM",68,12,1484,1458,26,1300,1052,248,0.788294081397533,0.222222222222222,1.2290046870692,610,248,362,4,1.5,46.7,4.2,0,0,0,0,0,0,0.14487703228213,99.4349750411908,15.4142497942405
9.7,"max_tuv_SVM","SVM",68,13,1384,1361,23,1400,1149,251,0.771481392171053,0.239316239316239,1.20705817480011,643,251,392,33,1.6,50.29,4.6,0,0,0,0,0,0,0.160389283760742,126.551189827674,17.4691547988811
9.7,"max_tuv_SVM","SVM",68,14,1284,1261,23,1500,1249,251,0.789405996302555,0.247863247863248,1.21803143093466,638,251,387,-5,1.5,53.88,5,0,0,0,0,0,0,0.127989712624077,80.6189844979272,13.7980955686433
9.7,"max_tuv_SVM","SVM",68,15,1184,1163,21,1600,1347,253,0.79012941081907,0.230769230769231,1.21803143093466,654,253,401,16,1.6,57.47,5.3,0,0,0,0,0,0,0.110649386295739,63.9760040179182,12.0635894294255
9.7,"max_tuv_SVM","SVM",68,16,1084,1064,20,1700,1446,254,0.7815757039895,0.239316239316239,1.21803143093466,653,254,399,-1,1.6,61.06,5.7,0,0,0,0,0,0,0.0905831093447376,41.6743785373707,10.2845973943347
9.7,"max_tuv_SVM","SVM",68,17,984,966,18,1800,1544,256,0.788381159070814,0.230769230769231,1.2290046870692,663,256,407,10,1.6,64.66,6,0,0,0,0,0,0,0.0609793246470017,24.4389763225185,7.27479921741044
9.7,"max_tuv_SVM","SVM",68,18,884,868,16,1900,1642,258,0.776418026418024,0.205128205128205,1.2290046870692,684,258,426,21,1.7,68.25,6.4,0,0,0,0,0,0,0.0350074495647976,11.7466315019862,4.79780742023723
9.7,"max_tuv_SVM","SVM",68,19,784,770,14,2000,1740,260,0.794690941242665,0.256410256410256,1.2290046870692,675,260,415,-9,1.6,71.84,6.7,0,0,0,0,0,0,0.0603425195066585,25.5227891921814,6.71524502792956
9.7,"max_tuv_SVM","SVM",68,20,684,672,12,2100,1838,262,0.805207244862415,0.247863247863248,1.27289771160739,678,262,416,3,1.6,75.43,7,0,0,0,0,0,0,0.0231259362704852,7.70125577890284,3.78338786123213
9.7,"max_tuv_SVM","SVM",68,21,584,578,6,2200,1932,268,0.811456742491223,0.247863247863248,1.28387096774194,702,268,434,24,1.6,79.02,7.2,0,0,0,0,0,0,0.0171194822325723,5.97083529830301,3.62672569721828
9.7,"max_tuv_SVM","SVM",68,22,484,483,1,2300,2027,273,0.807705704257421,0.239316239316239,1.27289771160739,746,273,473,44,1.7,82.61,7.4,0,0,0,0,0,0,0.0433395026457906,13.1355680308085,7.84384285866268
9.7,"max_tuv_SVM","SVM",68,23,384,383,1,2400,2127,273,0.805877073118447,0.290598290598291,1.27289771160739,756,273,483,10,1.8,86.21,7.8,0,0,0,0,0,0,0.0133772898704565,3.41055643005806,2.30708786778766
9.7,"max_tuv_SVM","SVM",68,24,284,284,0,2500,2226,274,0.810981164429432,0.230769230769231,1.27289771160739,740,274,466,-16,1.7,89.8,8.1,0,0,0,0,0,0,0.00143405940496931,2.32496861380621,2.26002740645281
9.7,"max_tuv_SVM","SVM",68,25,184,184,0,2600,2326,274,0.795461243737106,0.213675213675214,1.28387096774194,731,274,457,-9,1.7,93.39,8.5,0,0,0,0,0,0,0.000413198376539051,0.195592984700854,0.183734549233243
9.7,"max_tuv_SVM","SVM",68,26,84,84,0,2700,2426,274,0.810070198001227,0.264957264957265,1.27289771160739,730,274,456,-1,1.7,96.98,8.9,0,0,0,0,0,0,9.38750493905903e-06,0.0281189472356826,0.0281189472356826
9.7,"max_tuv_SVM","SVM",68,27,0,0,0,2784,2510,274,0.783317257455182,0.179487179487179,1.27289771160739,739,274,465,9,1.7,100,9.2,0,0,0,0,0,0,0,0,0
9.7,"max_tuv_SVM","SVM",69,0,2684,2422,262,100,89,11,0.30977733466268,0.00847457627118644,0.761618370694368,34,11,23,0,2.1,3.59,8.1,0,0,0,0,0,0,0.117674086450739,298.946632966351,11.8844061056355
9.7,"max_tuv_SVM","SVM",69,1,2584,2346,238,200,165,35,0.778338318378202,0.23728813559322,1.27299070530344,84,35,49,50,1.4,7.18,4.7,0,0,0,0,0,0,0.246176487954051,333.123275572264,27.8035743721797
9.7,"max_tuv_SVM","SVM",69,2,2484,2278,206,300,233,67,0.765171153207049,0.254237288135593,1.26211044286495,152,67,85,68,1.3,10.78,3.5,0,0,0,0,0,0,0.239502335280578,372.229338568702,25.4692219258589
9.7,"max_tuv_SVM","SVM",69,3,2384,2207,177,400,304,96,0.742731804586246,0.169491525423729,1.25123018042646,221,96,125,69,1.3,14.37,3.2,0,0,0,0,0,0,0.257353755930707,431.678168726675,28.9437037238653
9.7,"max_tuv_SVM","SVM",69,4,2284,2123,161,500,388,112,0.796317713526093,0.271186440677966,1.26211044286495,266,112,154,45,1.4,17.96,3.5,0,0,0,0,0,0,0.230014123866381,333.287782339429,24.9546992146596
9.7,"max_tuv_SVM","SVM",69,5,2184,2042,142,600,469,131,0.795367231638423,0.288135593220339,1.26211044286495,310,131,179,44,1.4,21.55,3.6,0,0,0,0,0,0,0.219219873774116,313.269686154084,22.4025678344481
9.7,"max_tuv_SVM","SVM",69,6,2084,1965,119,700,546,154,0.792635427052181,0.26271186440678,1.26211044286495,372,154,218,62,1.4,25.14,3.5,0,0,0,0,0,0,0.216702441524124,228.690108352283,22.3060998743985
9.7,"max_tuv_SVM","SVM",69,7,1984,1889,95,800,622,178,0.800478564307085,0.26271186440678,1.26211044286495,428,178,250,56,1.4,28.74,3.5,0,0,0,0,0,0,0.21646641207353,203.037405368545,22.347502189925
9.7,"max_tuv_SVM","SVM",69,8,1884,1817,67,900,694,206,0.792821535393823,0.254237288135593,1.27299070530344,497,206,291,69,1.4,32.33,3.4,0,0,0,0,0,0,0.219860131870726,192.714052445213,23.2513785475582
9.7,"max_tuv_SVM","SVM",69,9,1784,1725,59,1000,786,214,0.804021269524765,0.271186440677966,1.26211044286495,530,214,316,33,1.5,35.92,3.7,0,0,0,0,0,0,0.213483173209103,213.468454918452,22.0408852346127
9.7,"max_tuv_SVM","SVM",69,10,1684,1635,49,1100,876,224,0.806274509803927,0.279661016949153,1.26211044286495,561,224,337,31,1.5,39.51,3.9,0,0,0,0,0,0,0.177857177406505,116.218351008626,18.6537375496177
9.7,"max_tuv_SVM","SVM",69,11,1584,1545,39,1200,966,234,0.807936191425728,0.254237288135593,1.26211044286495,591,234,357,30,1.5,43.1,4.1,0,0,0,0,0,0,0.148136028053869,70.6557942755987,17.0750037012536
9.7,"max_tuv_SVM","SVM",69,12,1484,1462,22,1300,1049,251,0.818118976404126,0.254237288135593,1.26211044286495,629,251,378,38,1.5,46.7,4.2,0,0,0,0,0,0,0.173748023756477,120.049530958595,18.529587458377
9.7,"max_tuv_SVM","SVM",69,13,1384,1373,11,1400,1138,262,0.819687603855106,0.245762711864407,1.26211044286495,673,262,411,44,1.6,50.29,4.3,0,0,0,0,0,0,0.141285512914179,62.5157928694015,15.8344443194669
9.7,"max_tuv_SVM","SVM",69,14,1284,1276,8,1500,1235,265,0.814157527417751,0.228813559322034,1.26211044286495,672,265,407,-1,1.5,53.88,4.7,0,0,0,0,0,0,0.124445695525287,62.2854462112701,14.9352792566914
9.7,"max_tuv_SVM","SVM",69,15,1184,1177,7,1600,1334,266,0.810289132602197,0.194915254237288,1.26211044286495,690,266,424,18,1.6,57.47,5,0,0,0,0,0,0,0.0655083901325889,21.7113395503529,8.25548059028683
9.7,"max_tuv_SVM","SVM",69,16,1084,1078,6,1700,1433,267,0.819980059820542,0.26271186440678,1.26211044286495,685,267,418,-5,1.6,61.06,5.4,0,0,0,0,0,0,0.0971248753503906,39.75403476992,11.7275300593039
9.7,"max_tuv_SVM","SVM",69,17,984,980,4,1800,1531,269,0.802379528082423,0.169491525423729,1.26211044286495,698,269,429,13,1.6,64.66,5.7,0,0,0,0,0,0,0.080548592722251,36.6925765797498,10.1872261185903
9.7,"max_tuv_SVM","SVM",69,18,884,881,3,1900,1630,270,0.799202392821538,0.203389830508475,1.26211044286495,719,270,449,21,1.7,68.25,6,0,0,0,0,0,0,0.0672507079818128,25.355314573911,8.45206807900906
9.7,"max_tuv_SVM","SVM",69,19,784,782,2,2000,1729,271,0.820152874709209,0.23728813559322,1.26211044286495,726,271,455,7,1.7,71.84,6.4,0,0,0,0,0,0,0.0610343722994388,22.1258041875598,7.63328778612408
9.7,"max_tuv_SVM","SVM",69,20,684,682,2,2100,1829,271,0.822452642073782,0.254237288135593,1.26211044286495,720,271,449,-6,1.7,75.43,6.7,0,0,0,0,0,0,0.00920689933665054,2.49247437225521,1.48994080689186
9.7,"max_tuv_SVM","SVM",69,21,584,583,1,2200,1928,272,0.815068128946496,0.220338983050847,1.27299070530344,732,272,460,12,1.7,79.02,7.1,0,0,0,0,0,0,0.0378822207371546,12.5436048119667,6.30967179694606
9.7,"max_tuv_SVM","SVM",69,22,484,483,1,2300,2028,272,0.81453639082752,0.23728813559322,1.27299070530344,734,272,462,2,1.7,82.61,7.5,0,0,0,0,0,0,0.00935520586467448,2.48954455742113,1.60461329044063
9.7,"max_tuv_SVM","SVM",69,23,384,384,0,2400,2127,273,0.777401129943506,0.177966101694915,1.28387096774194,743,273,470,9,1.7,86.21,7.8,0,0,0,0,0,0,0.11170122208277,27.0500763227147,15.3319653262281
9.7,"max_tuv_SVM","SVM",69,24,284,284,0,2500,2227,273,0.791319375207711,0.220338983050847,1.28387096774194,763,273,490,20,1.8,89.8,8.2,0,0,0,0,0,0,0.0224871753797278,7.26995131595444,5.70849462501717
9.7,"max_tuv_SVM","SVM",69,25,184,184,0,2600,2327,273,0.80269192422732,0.203389830508475,1.28387096774194,763,273,490,0,1.8,93.39,8.5,0,0,0,0,0,0,0.0137248079708064,3.17889527946487,2.60232115481347
9.7,"max_tuv_SVM","SVM",69,26,84,84,0,2700,2427,273,0.79289464938518,0.220338983050847,1.28387096774194,775,273,502,12,1.8,96.98,8.9,0,0,0,0,0,0,0.000121563823811125,0.256656798493432,0.256656798493432
9.7,"max_tuv_SVM","SVM",69,27,0,0,0,2784,2511,273,0.818963110667998,0.254237288135593,1.28387096774194,746,273,473,-29,1.7,100,9.2,0,0,0,0,0,0,0,0,0
9.7,"max_tuv_SVM","SVM",70,0,2684,2451,233,100,89,11,0.756597984298055,0.312925170068027,1.1615975422427,30,11,19,0,1.7,3.59,8.1,0,0,0,0,0,0,0.210631559955811,276.928108231933,39.908437797539
9.7,"max_tuv_SVM","SVM",70,1,2584,2374,210,200,166,34,0.827977418896933,0.26530612244898,1.26640333552776,86,34,52,56,1.5,7.18,4.9,0,0,0,0,0,0,0.21859542599506,257.685876857428,28.612786865823
9.7,"max_tuv_SVM","SVM",70,2,2484,2293,191,300,247,53,0.747431235736663,0.183673469387755,1.24893570331358,140,53,87,54,1.6,10.78,4.7,0,0,0,0,0,0,0.200439897716996,359.493862932745,21.477684069939
9.7,"max_tuv_SVM","SVM",70,3,2384,2198,186,400,342,58,0.840944082287816,0.346938775510204,1.26640333552776,149,58,91,9,1.6,14.37,5.9,0,0,0,0,0,0,0.178330198816717,164.922805306751,19.2515631330649
9.7,"max_tuv_SVM","SVM",70,4,2284,2127,157,500,413,87,0.835582708203678,0.299319727891156,1.26640333552776,222,87,135,73,1.6,17.96,4.7,0,0,0,0,0,0,0.19804584692465,136.88402947189,20.8262245237965
9.7,"max_tuv_SVM","SVM",70,5,2184,2059,125,600,481,119,0.842751225690928,0.326530612244898,1.26640333552776,299,119,180,77,1.5,21.55,4,0,0,0,0,0,0,0.216179732199982,201.184879075377,22.3830604211884
9.7,"max_tuv_SVM","SVM",70,6,2084,1993,91,700,547,153,0.843597471091174,0.360544217687075,1.26640333552776,373,153,220,74,1.4,25.14,3.6,0,0,0,0,0,0,0.227510466371995,137.602896606592,23.9774675872518
9.7,"max_tuv_SVM","SVM",70,7,1984,1912,72,800,628,172,0.829648071106459,0.292517006802721,1.26640333552776,416,172,244,43,1.4,28.74,3.7,0,0,0,0,0,0,0.201877579418601,96.1366606445437,23.0516837699353
9.7,"max_tuv_SVM","SVM",70,8,1884,1821,63,900,719,181,0.83624332558064,0.333333333333333,1.25766951942067,442,181,261,26,1.4,32.33,4,0,0,0,0,0,0,0.159581377476821,79.7056721328502,18.7045470823474
9.7,"max_tuv_SVM","SVM",70,9,1784,1728,56,1000,812,188,0.827376857645145,0.306122448979592,1.25766951942067,456,188,268,14,1.4,35.92,4.3,0,0,0,0,0,0,0.132626021913978,63.385089964006,16.7931267979722
9.7,"max_tuv_SVM","SVM",70,10,1684,1634,50,1100,906,194,0.808950546510737,0.231292517006803,1.25766951942067,482,194,288,26,1.5,39.51,4.7,0,0,0,0,0,0,0.152070061152076,80.3187918104241,16.9087726640613
9.7,"max_tuv_SVM","SVM",70,11,1584,1544,40,1200,996,204,0.807853157314295,0.238095238095238,1.26640333552776,506,204,302,24,1.5,43.1,4.9,0,0,0,0,0,0,0.0764701736177075,20.0039134290841,10.6740024511458
9.7,"max_tuv_SVM","SVM",70,12,1484,1448,36,1300,1092,208,0.82390452168026,0.306122448979592,1.25766951942067,532,208,324,26,1.6,46.7,5.2,0,0,0,0,0,0,0.087409231639159,49.5303693638844,11.0900298879174
9.7,"max_tuv_SVM","SVM",70,13,1384,1360,24,1400,1180,220,0.72806040554263,0.0884353741496599,1.26640333552776,587,220,367,55,1.7,50.29,5.4,0,0,0,0,0,0,0.197735305377318,159.308981741449,29.3667522978577
9.7,"max_tuv_SVM","SVM",70,14,1284,1261,23,1500,1279,221,0.812690405215057,0.244897959183673,1.26640333552776,588,221,367,1,1.7,53.88,5.8,0,0,0,0,0,0,0.146538829160591,82.703393426751,15.7093067576444
9.7,"max_tuv_SVM","SVM",70,15,1184,1173,11,1600,1367,233,0.760965702492875,0.163265306122449,1.26640333552776,615,233,382,27,1.6,57.47,5.9,0,0,0,0,0,0,0.148072031553812,71.0727525919299,16.5917610962884
9.7,"max_tuv_SVM","SVM",70,16,1084,1075,9,1700,1465,235,0.793805483670188,0.204081632653061,1.27513715163485,623,235,388,8,1.7,61.06,6.2,0,0,0,0,0,0,0.11642697999014,54.1108035861585,13.3458310616832
9.7,"max_tuv_SVM","SVM",70,17,984,978,6,1800,1562,238,0.820175582271424,0.258503401360544,1.27513715163485,641,238,403,18,1.7,64.66,6.6,0,0,0,0,0,0,0.121280548702877,68.5179281928457,13.3106370324603
9.7,"max_tuv_SVM","SVM",70,18,884,879,5,1900,1661,239,0.778807831318714,0.204081632653061,1.27513715163485,656,239,417,15,1.7,68.25,6.9,0,0,0,0,0,0,0.109841715264923,53.5771529388508,12.8197453832374
9.7,"max_tuv_SVM","SVM",70,19,784,779,5,2000,1761,239,0.745400246776073,0.156462585034014,1.27513715163485,649,239,410,-7,1.7,71.84,7.4,0,0,0,0,0,0,0.0981570243554568,47.4757827979153,10.6698308809555
9.7,"max_tuv_SVM","SVM",70,20,684,681,3,2100,1859,241,0.779697753900906,0.217687074829932,1.27513715163485,648,241,407,-1,1.7,75.43,7.7,0,0,0,0,0,0,0.0773594277995324,31.0876157203326,8.8067431349543
9.7,"max_tuv_SVM","SVM",70,21,584,581,3,2200,1959,241,0.738280866118514,0.156462585034014,1.27513715163485,662,241,421,14,1.7,79.02,8.1,0,0,0,0,0,0,0.0677545181100259,25.2262893595271,7.8546217461581
9.7,"max_tuv_SVM","SVM",70,22,484,483,1,2300,2057,243,0.738046101265545,0.163265306122449,1.27513715163485,676,243,433,14,1.8,82.61,8.5,0,0,0,0,0,0,0.081675259463239,28.1320042355786,11.5486529433898
9.7,"max_tuv_SVM","SVM",70,23,384,383,1,2400,2157,243,0.741005230342531,0.142857142857143,1.27513715163485,680,243,437,4,1.8,86.21,8.9,0,0,0,0,0,0,0.0539100850624371,14.747807151926,6.55620876364376
9.7,"max_tuv_SVM","SVM",70,24,284,284,0,2500,2256,244,0.790982845786783,0.231292517006803,1.27513715163485,691,244,447,11,1.8,89.8,9.2,0,0,0,0,0,0,0.0203290779695202,4.44732108421195,3.20042910352204
9.7,"max_tuv_SVM","SVM",70,25,184,184,0,2600,2356,244,0.794073006409621,0.251700680272109,1.27513715163485,684,244,440,-7,1.8,93.39,9.7,0,0,0,0,0,0,0.00940250739678233,2.1554014774835,1.74937360042247
9.7,"max_tuv_SVM","SVM",70,26,84,84,0,2700,2456,244,0.693555431803536,0.122448979591837,1.27513715163485,686,244,442,2,1.8,96.98,10.1,0,0,0,0,0,0,1.54889933342386e-07,0.353345269917074,0.353345269917074
9.7,"max_tuv_SVM","SVM",70,27,0,0,0,2784,2540,244,0.75390637796049,0.163265306122449,1.27513715163485,691,244,447,5,1.8,100,10.4,0,0,0,0,0,0,0,0,0
9.7,"max_tuv_SVM","SVM",71,0,2684,2429,255,100,92,8,0.832466650197633,0.2890625,1.28387096774194,25,8,17,0,2.1,3.59,11.5,0,0,0,0,0,0,0.164010624339156,225.173331902042,19.5649737162104
9.7,"max_tuv_SVM","SVM",71,1,2584,2351,233,200,170,30,0.826735424901185,0.3046875,1.28387096774194,79,30,49,54,1.6,7.18,5.7,0,0,0,0,0,0,0.173790273506007,357.77627173498,17.5967125175347
9.7,"max_tuv_SVM","SVM",71,2,2484,2287,197,300,234,66,0.827840909090911,0.2890625,1.28387096774194,159,66,93,80,1.4,10.78,3.5,0,0,0,0,0,0,0.260489462836324,378.293720595123,26.6884969716139
9.7,"max_tuv_SVM","SVM",71,3,2384,2220,164,400,301,99,0.83601161067194,0.2734375,1.28387096774194,235,99,136,76,1.4,14.37,3,0,0,0,0,0,0,0.275454147231743,334.717711616652,28.1308791698434
9.7,"max_tuv_SVM","SVM",71,4,2284,2152,132,500,369,131,0.837178853754943,0.2734375,1.28387096774194,306,131,175,71,1.3,17.96,2.8,0,0,0,0,0,0,0.277350455596916,296.181135103981,28.1072784773576
9.7,"max_tuv_SVM","SVM",71,5,2184,2078,106,600,443,157,0.837833498023717,0.2578125,1.28387096774194,365,157,208,59,1.3,21.55,2.8,0,0,0,0,0,0,0.266600275269317,268.516825773313,27.3499844075814
9.7,"max_tuv_SVM","SVM",71,6,2084,1999,85,700,522,178,0.83877840909091,0.28125,1.28387096774194,422,178,244,57,1.4,25.14,2.9,0,0,0,0,0,0,0.225089789360293,140.511684337448,24.5845503339167
9.7,"max_tuv_SVM","SVM",71,7,1984,1910,74,800,611,189,0.84056324110672,0.296875,1.28387096774194,444,189,255,22,1.3,28.74,3.2,0,0,0,0,0,0,0.207738323460107,167.218459866582,22.3958066275407
9.7,"max_tuv_SVM","SVM",71,8,1884,1827,57,900,694,206,0.817564229249012,0.2421875,1.28387096774194,498,206,292,54,1.4,32.33,3.4,0,0,0,0,0,0,0.234904668921163,217.756635842078,25.6367731222738
9.7,"max_tuv_SVM","SVM",71,9,1784,1734,50,1000,787,213,0.817144268774703,0.203125,1.28387096774194,505,213,292,7,1.4,35.92,3.7,0,0,0,0,0,0,0.208529874369409,133.97863066053,30.7976123289044
9.7,"max_tuv_SVM","SVM",71,10,1684,1645,39,1100,876,224,0.828878458498025,0.2578125,1.28387096774194,545,224,321,40,1.4,39.51,3.9,0,0,0,0,0,0,0.176690436112316,107.126855376895,19.8358251102953
9.7,"max_tuv_SVM","SVM",71,11,1584,1554,30,1200,967,233,0.824969120553361,0.2578125,1.28387096774194,574,233,341,29,1.5,43.1,4.2,0,0,0,0,0,0,0.166112410425725,125.574603390743,17.8617325449091
9.7,"max_tuv_SVM","SVM",71,12,1484,1459,25,1300,1062,238,0.820960968379449,0.234375,1.28387096774194,572,238,334,-2,1.4,46.7,4.5,0,0,0,0,0,0,0.10402660265595,43.6098341199707,13.1958919813851
9.7,"max_tuv_SVM","SVM",71,13,1384,1366,18,1400,1155,245,0.820238389328065,0.2421875,1.28387096774194,614,245,369,42,1.5,50.29,4.7,0,0,0,0,0,0,0.100649973587313,32.1791100858945,14.9346670450769
9.7,"max_tuv_SVM","SVM",71,14,1284,1275,9,1500,1246,254,0.818725296442689,0.1875,1.28387096774194,650,254,396,36,1.6,53.88,4.9,0,0,0,0,0,0,0.0912142984285979,36.4958163586563,12.2242082438276
9.7,"max_tuv_SVM","SVM",71,15,1184,1177,7,1600,1344,256,0.829471343873517,0.2265625,1.28387096774194,636,256,380,-14,1.5,57.47,5.2,0,0,0,0,0,0,0.0671919915875015,22.6634987072532,9.15092989312812
9.7,"max_tuv_SVM","SVM",71,16,1084,1079,5,1700,1442,258,0.81285820158103,0.21875,1.28387096774194,664,258,406,28,1.6,61.06,5.6,0,0,0,0,0,0,0.105271984323183,41.1561299671997,12.7304235888685
9.7,"max_tuv_SVM","SVM",71,17,984,980,4,1800,1541,259,0.789328063241108,0.1953125,1.28387096774194,671,259,412,7,1.6,64.66,5.9,0,0,0,0,0,0,0.0442544389097518,13.2340292489933,6.99738871884923
9.7,"max_tuv_SVM","SVM",71,18,884,881,3,1900,1640,260,0.809770256916999,0.234375,1.28387096774194,679,260,419,8,1.6,68.25,6.3,0,0,0,0,0,0,0.0459652492406966,15.8818086256401,6.16034659982207
9.7,"max_tuv_SVM","SVM",71,19,784,782,2,2000,1739,261,0.802136857707515,0.2578125,1.28387096774194,683,261,422,4,1.6,71.84,6.7,0,0,0,0,0,0,0.0680095497931761,26.3307921450891,10.3458677209381
9.7,"max_tuv_SVM","SVM",71,20,684,682,2,2100,1839,261,0.791909584980239,0.171875,1.28387096774194,687,261,426,4,1.6,75.43,7,0,0,0,0,0,0,0.0282783773172292,9.62309998037363,4.00326256520379
9.7,"max_tuv_SVM","SVM",71,21,584,582,2,2200,1939,261,0.81831151185771,0.265625,1.28387096774194,684,261,423,-3,1.6,79.02,7.4,0,0,0,0,0,0,0.0105402411221864,2.73351008159416,1.47730866715333
9.7,"max_tuv_SVM","SVM",71,22,484,482,2,2300,2039,261,0.777365365612649,0.125,1.28387096774194,684,261,423,0,1.6,82.61,7.8,0,0,0,0,0,0,0.021913601040215,6.86726932232994,2.85564816202283
9.7,"max_tuv_SVM","SVM",71,23,384,383,1,2400,2138,262,0.786011610671937,0.1875,1.26381048387097,686,262,424,2,1.6,86.21,8.2,0,0,0,0,0,0,0.0680231071201886,18.9952394942841,14.667954250409
9.7,"max_tuv_SVM","SVM",71,24,284,284,0,2500,2237,263,0.79853631422925,0.25,1.27384072580645,698,263,435,12,1.7,89.8,8.5,0,0,0,0,0,0,0.00792572430244511,3.46093337215973,3.08124663805152
9.7,"max_tuv_SVM","SVM",71,25,184,184,0,2600,2337,263,0.762277667984191,0.1171875,1.27384072580645,708,263,445,10,1.7,93.39,8.9,0,0,0,0,0,0,1.04572693572137e-07,0.0711923563000563,0.0711910899838418
9.7,"max_tuv_SVM","SVM",71,26,84,84,0,2700,2437,263,0.80896739130435,0.2109375,1.28387096774194,701,263,438,-7,1.7,96.98,9.3,0,0,0,0,0,0,2.08604959191582e-09,0.0157902827552837,0.0157902827552837
9.7,"max_tuv_SVM","SVM",71,27,0,0,0,2784,2521,263,0.763938982213439,0.15625,1.27384072580645,706,263,443,5,1.7,100,9.6,0,0,0,0,0,0,0,0,0
9.7,"max_tuv_SVM","SVM",72,0,2684,2435,249,100,92,8,0.765082451128004,0.402985074626866,1.16889744824266,23,8,15,0,1.9,3.59,11.5,0,0,0,0,0,0,0.183956310791592,237.801719544191,20.7890209908655
9.7,"max_tuv_SVM","SVM",72,1,2584,2375,209,200,152,48,0.76548551918723,0.216417910447761,1.25512758786712,106,48,58,83,1.2,7.18,3.2,0,0,0,0,0,0,0.273187263657829,486.603205054828,29.9674541510649
9.7,"max_tuv_SVM","SVM",72,2,2484,2292,192,300,235,65,0.728486242338745,0.156716417910448,1.21680308136736,169,65,104,63,1.6,10.78,3.6,0,0,0,0,0,0,0.246925976201329,454.89808799694,28.6118417858172
9.7,"max_tuv_SVM","SVM",72,3,2384,2198,186,400,329,71,0.811945040484631,0.305970149253731,1.26470871449206,180,71,109,11,1.5,14.37,4.6,0,0,0,0,0,0,0.223271123735926,198.027552679224,24.51724394363
9.7,"max_tuv_SVM","SVM",72,4,2284,2118,166,500,409,91,0.790481666330782,0.164179104477612,1.26470871449206,245,91,154,65,1.7,17.96,4.5,0,0,0,0,0,0,0.207281471082221,202.406507146395,22.3603659251917
9.7,"max_tuv_SVM","SVM",72,5,2184,2035,149,600,492,108,0.805827889938714,0.223880597014925,1.26470871449206,283,108,175,38,1.6,21.55,4.6,0,0,0,0,0,0,0.197818230591572,160.243666495818,21.4545218423446
9.7,"max_tuv_SVM","SVM",72,6,2084,1966,118,700,561,139,0.808696786124979,0.238805970149254,1.25512758786712,355,139,216,72,1.6,25.14,4,0,0,0,0,0,0,0.203710091545994,125.168109908925,21.7179427464024
9.7,"max_tuv_SVM","SVM",72,7,1984,1892,92,800,635,165,0.808323355423048,0.246268656716418,1.25512758786712,417,165,252,62,1.5,28.74,3.8,0,0,0,0,0,0,0.191792421460251,98.40378180779,21.6491952641988
9.7,"max_tuv_SVM","SVM",72,8,1884,1823,61,900,704,196,0.810427607791072,0.238805970149254,1.24554646124218,490,196,294,73,1.5,32.33,3.6,0,0,0,0,0,0,0.210496838539768,140.17771771778,22.6028633222388
9.7,"max_tuv_SVM","SVM",72,9,1784,1734,50,1000,793,207,0.828619017699431,0.313432835820896,1.24554646124218,536,207,329,46,1.6,35.92,3.8,0,0,0,0,0,0,0.189163410298754,104.764086036292,21.2114212974678
9.7,"max_tuv_SVM","SVM",72,10,1684,1646,38,1100,881,219,0.813065332590424,0.276119402985075,1.24554646124218,572,219,353,36,1.6,39.51,4,0,0,0,0,0,0,0.185541580657318,137.577931514531,20.6223153911757
9.7,"max_tuv_SVM","SVM",72,11,1584,1548,36,1200,979,221,0.811648666911671,0.261194029850746,1.25512758786712,585,221,364,13,1.6,43.1,4.4,0,0,0,0,0,0,0.112483975323108,42.9942111366146,13.993048793682
9.7,"max_tuv_SVM","SVM",72,12,1484,1450,34,1300,1077,223,0.801459343473261,0.23134328358209,1.25512758786712,582,223,359,-3,1.6,46.7,4.8,0,0,0,0,0,0,0.0826386594794847,30.5524695564789,11.059182608375
9.7,"max_tuv_SVM","SVM",72,13,1384,1356,28,1400,1171,229,0.79484428532477,0.194029850746269,1.274289841117,613,229,384,31,1.7,50.29,5.1,0,0,0,0,0,0,0.180761852113238,88.4980909796275,23.8167083227619
9.7,"max_tuv_SVM","SVM",72,14,1284,1263,21,1500,1264,236,0.792834872500092,0.23134328358209,1.274289841117,627,236,391,14,1.7,53.88,5.4,0,0,0,0,0,0,0.15058155310401,89.8683591933762,18.4697865160123
9.7,"max_tuv_SVM","SVM",72,15,1184,1168,16,1600,1359,241,0.760174504759764,0.171641791044776,1.28387096774194,659,241,418,32,1.7,57.47,5.6,0,0,0,0,0,0,0.154857201285465,91.4169906515742,19.4121262086367
9.7,"max_tuv_SVM","SVM",72,16,1084,1070,14,1700,1457,243,0.786320581366404,0.201492537313433,1.274289841117,664,243,421,5,1.7,61.06,6,0,0,0,0,0,0,0.105537565780969,44.9612214637711,13.3779411488178
9.7,"max_tuv_SVM","SVM",72,17,984,972,12,1800,1555,245,0.739054923950544,0.194029850746269,1.274289841117,671,245,426,7,1.7,64.66,6.3,0,0,0,0,0,0,0.112018378267723,60.4929889822053,13.4484077521548
9.7,"max_tuv_SVM","SVM",72,18,884,878,6,1900,1649,251,0.765704835631219,0.208955223880597,1.274289841117,698,251,447,27,1.8,68.25,6.6,0,0,0,0,0,0,0.126965503826968,65.512361108909,16.4272794108284
9.7,"max_tuv_SVM","SVM",72,19,784,780,4,2000,1747,253,0.768680426303749,0.201492537313433,1.28387096774194,716,253,463,18,1.8,71.84,6.9,0,0,0,0,0,0,0.0896915071150207,36.2789675007321,12.2919442561694
9.7,"max_tuv_SVM","SVM",72,20,684,681,3,2100,1846,254,0.654908539115385,0.134328358208955,1.28387096774194,725,254,471,9,1.9,75.43,7.3,0,0,0,0,0,0,0.0803966780454625,30.0910771292785,10.1154501120746
9.7,"max_tuv_SVM","SVM",72,21,584,581,3,2200,1946,254,0.733293421692175,0.17910447761194,1.28387096774194,715,254,461,-10,1.8,79.02,7.7,0,0,0,0,0,0,0.0428475405715224,13.857490041413,6.3348964324614
9.7,"max_tuv_SVM","SVM",72,22,484,482,2,2300,2045,255,0.724455561746471,0.156716417910448,1.274289841117,750,255,495,35,1.9,82.61,8,0,0,0,0,0,0,0.0578230783064052,19.619375158992,8.90382884464919
9.7,"max_tuv_SVM","SVM",72,23,384,383,1,2400,2144,256,0.704758574087467,0.134328358208955,1.28387096774194,719,256,463,-31,1.8,86.21,8.4,0,0,0,0,0,0,0.0323895599108809,10.1783332987783,6.16427317379426
9.7,"max_tuv_SVM","SVM",72,24,284,284,0,2500,2243,257,0.724817137505484,0.164179104477612,1.274289841117,734,257,477,15,1.9,89.8,8.7,0,0,0,0,0,0,0.0149963468235406,10.8510006712485,9.92087984684768
9.7,"max_tuv_SVM","SVM",72,25,184,184,0,2600,2343,257,0.755100589190666,0.17910447761194,1.274289841117,737,257,480,3,1.9,93.39,9.1,0,0,0,0,0,0,0.00504760225251774,2.37662437946987,2.26410696325494
9.7,"max_tuv_SVM","SVM",72,26,84,84,0,2700,2443,257,0.755189501262554,0.194029850746269,1.274289841117,725,257,468,-12,1.8,96.98,9.5,0,0,0,0,0,0,9.13908523825338e-09,1.07448202174373,1.07448202174373
9.7,"max_tuv_SVM","SVM",72,27,0,0,0,2784,2527,257,0.764003651322422,0.17910447761194,1.274289841117,724,257,467,-1,1.8,100,9.8,0,0,0,0,0,0,0,0,0
9.7,"max_tuv_SVM","SVM",73,0,2684,2422,262,100,94,6,0.777895141156136,0.268292682926829,1.16905323891949,17,6,11,0,1.8,3.59,15.7,0,0,0,0,0,0,0.100766834096552,132.63394313404,23.6452244156541
9.7,"max_tuv_SVM","SVM",73,1,2584,2342,242,200,174,26,0.812553613725114,0.292682926829268,1.28387096774194,76,26,50,59,1.9,7.18,6.7,0,0,0,0,0,0,0.167497760614745,218.505874065802,17.4743407572327
9.7,"max_tuv_SVM","SVM",73,2,2484,2271,213,300,245,55,0.830542218808016,0.333333333333333,1.26299501704694,130,55,75,54,1.4,10.78,4.5,0,0,0,0,0,0,0.215016784483895,139.948271799718,23.1127509614138
9.7,"max_tuv_SVM","SVM",73,3,2384,2195,189,400,321,79,0.834684079124262,0.292682926829268,1.26299501704694,199,79,120,69,1.5,14.37,4.1,0,0,0,0,0,0,0.210490160147484,307.814813413696,21.6211912281357
9.7,"max_tuv_SVM","SVM",73,4,2284,2120,164,500,396,104,0.805294155303757,0.276422764227642,1.22124311565696,264,104,160,65,1.5,17.96,3.8,0,0,0,0,0,0,0.211369793537714,214.266154467311,22.2635687965414
9.7,"max_tuv_SVM","SVM",73,5,2184,2059,125,600,457,143,0.771954420331609,0.227642276422764,1.20036716496197,340,143,197,76,1.4,21.55,3.2,0,0,0,0,0,0,0.278484041651639,255.421527276602,45.1232891196763
9.7,"max_tuv_SVM","SVM",73,6,2084,1973,111,700,543,157,0.730990333525384,0.203252032520325,1.17949121426698,382,157,225,42,1.4,25.14,3.5,0,0,0,0,0,0,0.242085020974098,285.508649302266,26.2482591445172
9.7,"max_tuv_SVM","SVM",73,7,1984,1875,109,800,641,159,0.824748735676338,0.252032520325203,1.26299501704694,400,159,241,18,1.5,28.74,4,0,0,0,0,0,0,0.213145635004548,95.1282093980069,24.2964790461683
9.7,"max_tuv_SVM","SVM",73,8,1884,1799,85,900,717,183,0.82598425196851,0.292682926829268,1.26299501704694,453,183,270,53,1.5,32.33,3.9,0,0,0,0,0,0,0.199020005888112,131.26266979477,22.1613124926368
9.7,"max_tuv_SVM","SVM",73,9,1784,1713,71,1000,803,197,0.844875488124959,0.308943089430894,1.26299501704694,489,197,292,36,1.5,35.92,4.1,0,0,0,0,0,0,0.136953989602633,46.0855318576015,19.9956767957045
9.7,"max_tuv_SVM","SVM",73,10,1684,1635,49,1100,881,219,0.840362332757195,0.308943089430894,1.27343299239444,541,219,322,52,1.5,39.51,4,0,0,0,0,0,0,0.175628666828522,114.78144522781,20.6352456618516
9.7,"max_tuv_SVM","SVM",73,11,1584,1542,42,1200,974,226,0.829351513987586,0.268292682926829,1.27343299239444,568,226,342,27,1.5,43.1,4.3,0,0,0,0,0,0,0.172963318909398,110.709808954702,19.7328963722271
9.7,"max_tuv_SVM","SVM",73,12,1484,1453,31,1300,1063,237,0.811887843287881,0.227642276422764,1.28387096774194,606,237,369,38,1.6,46.7,4.5,0,0,0,0,0,0,0.166852818640934,78.5741038998757,20.2254959978369
9.7,"max_tuv_SVM","SVM",73,13,1384,1358,26,1400,1158,242,0.812028679341908,0.195121951219512,1.28387096774194,639,242,397,33,1.6,50.29,4.8,0,0,0,0,0,0,0.155348023921026,87.2233526657496,18.333185533296
9.7,"max_tuv_SVM","SVM",73,14,1284,1267,17,1500,1249,251,0.778663337814478,0.16260162601626,1.28387096774194,675,251,424,36,1.7,53.88,5,0,0,0,0,0,0,0.166918361409354,66.3329937227166,20.2518777278094
9.7,"max_tuv_SVM","SVM",73,15,1184,1171,13,1600,1345,255,0.808847064848598,0.235772357723577,1.28387096774194,671,255,416,-4,1.6,57.47,5.3,0,0,0,0,0,0,0.116423362930149,40.3048773608748,14.5919487757913
9.7,"max_tuv_SVM","SVM",73,16,1084,1074,10,1700,1442,258,0.81809743294283,0.252032520325203,1.28387096774194,696,258,438,25,1.7,61.06,5.6,0,0,0,0,0,0,0.0760464680829303,27.1123892461573,13.7985563585292
9.7,"max_tuv_SVM","SVM",73,17,984,974,10,1800,1542,258,0.809032712374365,0.235772357723577,1.28387096774194,691,258,433,-5,1.7,64.66,6,0,0,0,0,0,0,0.0574752592342893,18.7330577121168,8.591936906429
9.7,"max_tuv_SVM","SVM",73,18,884,876,8,1900,1640,260,0.76134050316881,0.154471544715447,1.28387096774194,701,260,441,10,1.7,68.25,6.3,0,0,0,0,0,0,0.0777537592360869,29.8298782095773,12.1085689213427
9.7,"max_tuv_SVM","SVM",73,19,784,778,6,2000,1738,262,0.798873311567758,0.219512195121951,1.28387096774194,716,262,454,15,1.7,71.84,6.6,0,0,0,0,0,0,0.0612466779398657,20.9156785205304,8.64530567399273
9.7,"max_tuv_SVM","SVM",73,20,684,679,5,2100,1837,263,0.786921451891683,0.203252032520325,1.28387096774194,731,263,468,15,1.8,75.43,7,0,0,0,0,0,0,0.0344478964007674,10.0503348188715,5.74306628514257
9.7,"max_tuv_SVM","SVM",73,21,584,580,4,2200,1936,264,0.720030727866333,0.178861788617886,1.28387096774194,733,264,469,2,1.8,79.02,7.3,0,0,0,0,0,0,0.115835049015189,42.177441387144,16.46102088359
9.7,"max_tuv_SVM","SVM",73,22,484,481,3,2300,2035,265,0.725408104474744,0.146341463414634,1.28387096774194,737,265,472,4,1.8,82.61,7.7,0,0,0,0,0,0,0.058030450988425,17.8432605118688,8.74182645450897
9.7,"max_tuv_SVM","SVM",73,23,384,382,2,2400,2134,266,0.706440048652454,0.170731707317073,1.28387096774194,749,266,483,12,1.8,86.21,8,0,0,0,0,0,0,0.0542525848390531,16.0828651076182,10.7489764622424
9.7,"max_tuv_SVM","SVM",73,24,284,282,2,2500,2234,266,0.792183599001345,0.235772357723577,1.28387096774194,764,266,498,15,1.9,89.8,8.4,0,0,0,0,0,0,0.0253793723772979,6.63625808160827,4.5823454068557
9.7,"max_tuv_SVM","SVM",73,25,184,182,2,2600,2334,266,0.747250496127007,0.16260162601626,1.28387096774194,749,266,483,-15,1.8,93.39,8.8,0,0,0,0,0,0,1.34381039796735e-05,1.65020535899121,1.64991951902939
9.7,"max_tuv_SVM","SVM",73,26,84,83,1,2700,2433,267,0.75927917546892,0.211382113821138,1.28387096774194,747,267,480,-2,1.8,96.98,9.1,0,0,0,0,0,0,2.62144287431074e-07,1.93405002413689,1.93405002413689
9.7,"max_tuv_SVM","SVM",73,27,0,0,0,2784,2516,268,0.786153255233344,0.219512195121951,1.27343299239444,755,268,487,8,1.8,100,9.4,0,0,0,0,0,0,0,0,0
9.7,"max_tuv_SVM","SVM",74,0,2684,2436,248,100,90,10,0.760651629072687,0.330827067669173,1.22595197671598,32,10,22,0,2.2,3.59,9,0,0,0,0,0,0,0.116712668439825,276.505814757635,12.2512360675907
9.7,"max_tuv_SVM","SVM",74,1,2584,2367,217,200,159,41,0.724985081752007,0.233082706766917,1.23560514188698,108,41,67,76,1.6,7.18,3.9,0,0,0,0,0,0,0.227274307676053,456.076088770502,24.689874137081
9.7,"max_tuv_SVM","SVM",74,2,2484,2289,195,300,237,63,0.771792576679798,0.285714285714286,1.23560514188698,160,63,97,52,1.5,10.78,3.8,0,0,0,0,0,0,0.21059705929519,512.398870793695,21.4213853037609
9.7,"max_tuv_SVM","SVM",74,3,2384,2199,185,400,327,73,0.7467955603294,0.233082706766917,1.24525830705797,190,73,117,30,1.6,14.37,4.5,0,0,0,0,0,0,0.195730988072305,309.497734427557,20.5156460735945
9.7,"max_tuv_SVM","SVM",74,4,2284,2110,174,500,416,84,0.799277956796759,0.345864661654135,1.24525830705797,221,84,137,31,1.6,17.96,5,0,0,0,0,0,0,0.176520156097056,279.916170778505,17.9779549786674
9.7,"max_tuv_SVM","SVM",74,5,2184,2039,145,600,487,113,0.807512829693284,0.345864661654135,1.24525830705797,286,113,173,65,1.5,21.55,4.3,0,0,0,0,0,0,0.193387869755661,274.005701068155,19.7842613540405
9.7,"max_tuv_SVM","SVM",74,6,2084,1972,112,700,554,146,0.802064685523342,0.315789473684211,1.23560514188698,354,146,208,68,1.4,25.14,3.8,0,0,0,0,0,0,0.218760869645467,343.571417472651,22.5352436291081
9.7,"max_tuv_SVM","SVM",74,7,1984,1907,77,800,619,181,0.80541234037475,0.323308270676692,1.23560514188698,428,181,247,74,1.4,28.74,3.4,0,0,0,0,0,0,0.22687477702931,294.127336231002,23.4498045821184
9.7,"max_tuv_SVM","SVM",74,8,1884,1820,64,900,706,194,0.799982098102407,0.315789473684211,1.23560514188698,465,194,271,37,1.4,32.33,3.6,0,0,0,0,0,0,0.208387100250502,269.927744171686,21.6072987345796
9.7,"max_tuv_SVM","SVM",74,9,1784,1723,61,1000,803,197,0.805066237021129,0.300751879699248,1.24525830705797,489,197,292,24,1.5,35.92,4.1,0,0,0,0,0,0,0.173945936772922,172.777629523055,18.0807336196547
9.7,"max_tuv_SVM","SVM",74,10,1684,1629,55,1100,897,203,0.806546127222822,0.278195488721804,1.25491147222896,491,203,288,2,1.4,39.51,4.4,0,0,0,0,0,0,0.163629285276987,167.8958071494,17.1158934855811
9.7,"max_tuv_SVM","SVM",74,11,1584,1537,47,1200,989,211,0.820766201217332,0.285714285714286,1.24525830705797,532,211,321,41,1.5,43.1,4.7,0,0,0,0,0,0,0.153606695176024,144.876741872858,16.0417626499641
9.7,"max_tuv_SVM","SVM",74,12,1484,1448,36,1300,1078,222,0.82623224728488,0.315789473684211,1.24525830705797,555,222,333,23,1.5,46.7,4.9,0,0,0,0,0,0,0.136875843405597,101.175048738867,15.0068655777383
9.7,"max_tuv_SVM","SVM",74,13,1384,1354,30,1400,1172,228,0.799958228905597,0.225563909774436,1.24525830705797,599,228,371,44,1.6,50.29,5.1,0,0,0,0,0,0,0.145807496767287,114.215370761393,15.6827794936419
9.7,"max_tuv_SVM","SVM",74,14,1284,1261,23,1500,1265,235,0.815986394557822,0.270676691729323,1.24525830705797,637,235,402,38,1.7,53.88,5.4,0,0,0,0,0,0,0.144855159491154,119.039672335591,15.0746253129659
9.7,"max_tuv_SVM","SVM",74,15,1184,1166,18,1600,1360,240,0.812740183792814,0.300751879699248,1.24525830705797,649,240,409,12,1.7,57.47,5.7,0,0,0,0,0,0,0.130131985625244,97.7089592419293,14.0022468302118
9.7,"max_tuv_SVM","SVM",74,16,1084,1066,18,1700,1460,240,0.805680868838762,0.293233082706767,1.24525830705797,641,240,401,-8,1.7,61.06,6.1,0,0,0,0,0,0,0.0939216184281916,53.4679889545101,10.3303719186641
9.7,"max_tuv_SVM","SVM",74,17,984,966,18,1800,1560,240,0.802792696025777,0.263157894736842,1.24525830705797,649,240,409,8,1.7,64.66,6.5,0,0,0,0,0,0,0.0559321695527003,22.406777601143,6.54411253534624
9.7,"max_tuv_SVM","SVM",74,18,884,867,17,1900,1659,241,0.800369972550423,0.24812030075188,1.24525830705797,652,241,411,3,1.7,68.25,6.9,0,0,0,0,0,0,0.0407227132914718,15.1830669657567,5.48976996101131
9.7,"max_tuv_SVM","SVM",74,19,784,768,16,2000,1758,242,0.807113020646855,0.240601503759398,1.24525830705797,654,242,412,2,1.7,71.84,7.3,0,0,0,0,0,0,0.0478464487670507,17.3707241817178,5.59487389439192
9.7,"max_tuv_SVM","SVM",74,20,684,669,15,2100,1857,243,0.809547678720612,0.255639097744361,1.24525830705797,642,243,399,-12,1.6,75.43,7.6,0,0,0,0,0,0,0.0371500124654213,11.8938179410716,4.68691410227722
9.7,"max_tuv_SVM","SVM",74,21,584,569,15,2200,1957,243,0.819638381668458,0.300751879699248,1.24525830705797,643,243,400,1,1.6,79.02,8.1,0,0,0,0,0,0,0.012958467240861,3.66897748981716,1.90750951725301
9.7,"max_tuv_SVM","SVM",74,22,484,469,15,2300,2057,243,0.785720253013487,0.240601503759398,1.24525830705797,660,243,417,17,1.7,82.61,8.5,0,0,0,0,0,0,0.00378360480170923,1.15268328237636,0.747659691500409
9.7,"max_tuv_SVM","SVM",74,23,384,372,12,2400,2154,246,0.79356128416279,0.233082706766917,1.24525830705797,677,246,431,17,1.8,86.21,8.8,0,0,0,0,0,0,0.011634632593701,3.2078580583063,1.84083449178088
9.7,"max_tuv_SVM","SVM",74,24,284,272,12,2500,2254,246,0.799343597087961,0.255639097744361,1.24525830705797,677,246,431,0,1.8,89.8,9.2,0,0,0,0,0,0,0.00534724505163122,1.29598404542833,0.872162542634892
9.7,"max_tuv_SVM","SVM",74,25,184,176,8,2600,2350,250,0.825474400286438,0.285714285714286,1.27421780257094,708,250,458,31,1.8,93.39,9.4,0,0,0,0,0,0,0.00123294715453214,2.55574072659844,2.52042302750708
9.7,"max_tuv_SVM","SVM",74,26,84,84,0,2700,2442,258,0.798502207900709,0.233082706766917,1.27421780257094,735,258,477,27,1.8,96.98,9.5,0,0,0,0,0,0,1.80562759963507e-06,0.00974030191338814,0.00974030191338814
9.7,"max_tuv_SVM","SVM",74,27,0,0,0,2784,2526,258,0.792284282133912,0.24812030075188,1.27421780257094,729,258,471,-6,1.8,100,9.8,0,0,0,0,0,0,0,0,0
9.7,"max_tuv_SVM","SVM",75,0,2684,2447,237,100,84,16,0.798775910849364,0.326086956521739,1.20014025245442,36,16,20,0,1.2,3.59,5.2,0,0,0,0,0,0,0.38505500568569,426.791505983714,40.9887309005556
9.7,"max_tuv_SVM","SVM",75,1,2584,2381,203,200,150,50,0.733009989029395,0.159420289855072,1.25134746676249,115,50,65,79,1.3,7.18,3,0,0,0,0,0,0,0.584943698741731,605.417592159261,66.8872254511961
9.7,"max_tuv_SVM","SVM",75,2,2484,2291,193,300,240,60,0.762324614585146,0.144927536231884,1.23735390369331,150,60,90,35,1.5,10.78,4,0,0,0,0,0,0,0.376883828222371,360.589718433105,48.6242176025902
9.7,"max_tuv_SVM","SVM",75,3,2384,2212,172,400,319,81,0.790836653386458,0.210144927536232,1.25596072931276,199,81,118,49,1.5,14.37,3.9,0,0,0,0,0,0,0.224394670835729,319.867426643607,26.6747371399651
9.7,"max_tuv_SVM","SVM",75,4,2284,2124,160,500,407,93,0.794993937294302,0.27536231884058,1.20944366526414,229,93,136,30,1.5,17.96,4.4,0,0,0,0,0,0,0.191126069536213,238.193466563862,19.8518266182025
9.7,"max_tuv_SVM","SVM",75,5,2184,2053,131,600,478,122,0.799237831283563,0.282608695652174,1.20944366526414,288,122,166,59,1.4,21.55,3.9,0,0,0,0,0,0,0.206469182300213,228.606825047598,21.3646007235693
9.7,"max_tuv_SVM","SVM",75,6,2084,1983,101,700,548,152,0.808054737571455,0.289855072463768,1.22805049088359,370,152,218,82,1.4,25.14,3.6,0,0,0,0,0,0,0.214864886072974,197.789202709285,22.1551789119946
9.7,"max_tuv_SVM","SVM",75,7,1984,1909,75,800,622,178,0.8073098908713,0.260869565217391,1.20944366526414,438,178,260,68,1.5,28.74,3.5,0,0,0,0,0,0,0.21715715265039,170.833704697922,22.5309259695327
9.7,"max_tuv_SVM","SVM",75,8,1884,1834,50,900,697,203,0.808181765690862,0.311594202898551,1.20944366526414,493,203,290,55,1.4,32.33,3.4,0,0,0,0,0,0,0.216618646640248,184.096251901621,22.6904290717588
9.7,"max_tuv_SVM","SVM",75,9,1784,1744,40,1000,787,213,0.81191177319707,0.27536231884058,1.20014025245442,512,213,299,19,1.4,35.92,3.7,0,0,0,0,0,0,0.188560320225213,150.906049591876,20.0571482083229
9.7,"max_tuv_SVM","SVM",75,10,1684,1656,28,1100,875,225,0.812437207690983,0.326086956521739,1.19083683964469,562,225,337,50,1.5,39.51,3.9,0,0,0,0,0,0,0.19168151578047,195.396300293838,19.6809268899701
9.7,"max_tuv_SVM","SVM",75,11,1584,1558,26,1200,973,227,0.799745943761194,0.289855072463768,1.19083683964469,575,227,348,13,1.5,43.1,4.3,0,0,0,0,0,0,0.172454749727891,156.053969122177,18.2867084297147
9.7,"max_tuv_SVM","SVM",75,12,1484,1458,26,1300,1073,227,0.815572492638145,0.340579710144928,1.20944366526414,568,227,341,-7,1.5,46.7,4.7,0,0,0,0,0,0,0.0923466481514356,31.3887435379279,10.9109462711511
9.7,"max_tuv_SVM","SVM",75,13,1384,1361,23,1400,1170,230,0.790992551533003,0.27536231884058,1.20944366526414,585,230,355,17,1.5,50.29,5.1,0,0,0,0,0,0,0.141004809150619,60.9533170625908,16.9811119574308
9.7,"max_tuv_SVM","SVM",75,14,1284,1261,23,1500,1270,230,0.796212252439522,0.282608695652174,1.20944366526414,591,230,361,6,1.6,53.88,5.5,0,0,0,0,0,0,0.130832844829833,53.9422715116295,13.9769219534208
9.7,"max_tuv_SVM","SVM",75,15,1184,1163,21,1600,1368,232,0.804313182054397,0.326086956521739,1.20944366526414,613,232,381,22,1.6,57.47,5.9,0,0,0,0,0,0,0.11272613584112,36.7023107228817,13.1227201918467
9.7,"max_tuv_SVM","SVM",75,16,1084,1064,20,1700,1467,233,0.803158380968884,0.318840579710145,1.20944366526414,612,233,379,-1,1.6,61.06,6.3,0,0,0,0,0,0,0.0778744929862648,19.4346043047573,9.68303103455167
9.7,"max_tuv_SVM","SVM",75,17,984,964,20,1800,1567,233,0.768485478376353,0.239130434782609,1.20944366526414,609,233,376,-3,1.6,64.66,6.7,0,0,0,0,0,0,0.0470144551557917,9.83828822308899,6.55212682626292
9.7,"max_tuv_SVM","SVM",75,18,884,864,20,1900,1667,233,0.794820717131479,0.289855072463768,1.20944366526414,599,233,366,-10,1.6,68.25,7.2,0,0,0,0,0,0,0.00972229466056873,3.17297045188536,2.65834950225867
9.7,"max_tuv_SVM","SVM",75,19,784,768,16,2000,1763,237,0.792026098504532,0.22463768115942,1.22805049088359,615,237,378,16,1.6,71.84,7.4,0,0,0,0,0,0,0.000206427366054054,0.452006664582137,0.440233489075809
9.7,"max_tuv_SVM","SVM",75,20,684,674,10,2100,1857,243,0.780726369882786,0.231884057971014,1.25596072931276,643,243,400,28,1.6,75.43,7.6,0,0,0,0,0,0,0.0142806637018205,6.59896480583269,4.74929665604878
9.7,"max_tuv_SVM","SVM",75,21,584,578,6,2200,1953,247,0.779138518390207,0.260869565217391,1.23735390369331,676,247,429,33,1.7,79.02,7.9,0,0,0,0,0,0,0.0778324105728023,22.9115063392837,11.4288512119623
9.7,"max_tuv_SVM","SVM",75,22,484,478,6,2300,2053,247,0.810040995438535,0.260869565217391,1.25596072931276,661,247,414,-15,1.7,82.61,8.3,0,0,0,0,0,0,0.0609254637998402,17.9522955096676,7.6223086643339
9.7,"max_tuv_SVM","SVM",75,23,384,379,5,2400,2152,248,0.789231479877591,0.268115942028986,1.22805049088359,671,248,423,10,1.7,86.21,8.7,0,0,0,0,0,0,0.0630890440612263,17.6390590922616,10.5535055684448
9.7,"max_tuv_SVM","SVM",75,24,284,279,5,2500,2252,248,0.772533056181072,0.210144927536232,1.22805049088359,662,248,414,-9,1.7,89.8,9.1,0,0,0,0,0,0,0.0383173277877543,8.94320597286741,4.95856140439247
9.7,"max_tuv_SVM","SVM",75,25,184,183,1,2600,2348,252,0.770217680004617,0.231884057971014,1.27456755493221,686,252,434,24,1.7,93.39,9.3,0,0,0,0,0,0,0.0343587513042355,8.83720932962749,7.49730697495216
9.7,"max_tuv_SVM","SVM",75,26,84,84,0,2700,2447,253,0.796119868352678,0.217391304347826,1.27456755493221,677,253,424,-9,1.7,96.98,9.7,0,0,0,0,0,0,3.84113136286672e-05,0.730839401688597,0.730839401688597
9.7,"max_tuv_SVM","SVM",75,27,0,0,0,2784,2531,253,0.807558173104684,0.202898550724638,1.28387096774194,688,253,435,11,1.7,100,10,0,0,0,0,0,0,0,0,0
9.7,"max_tuv_SVM","SVM",76,0,2684,2429,255,100,89,11,0.828050473186118,0.336,1.24278709677419,26,11,15,0,1.4,3.59,8.1,0,0,0,0,0,0,0.266906762598003,267.228984115867,30.2130044306382
9.7,"max_tuv_SVM","SVM",76,1,2584,2363,221,200,155,45,0.754277602523664,0.104,1.25305806451613,102,45,57,76,1.3,7.18,3.4,0,0,0,0,0,0,0.276954024681501,494.715204691856,33.3645286285984
9.7,"max_tuv_SVM","SVM",76,2,2484,2271,213,300,247,53,0.784075709779189,0.216,1.22224516129032,123,53,70,21,1.3,10.78,4.7,0,0,0,0,0,0,0.21367993601401,249.336843189871,25.8111547198107
9.7,"max_tuv_SVM","SVM",76,3,2384,2187,197,400,331,69,0.802107255520508,0.312,1.23251612903226,163,69,94,40,1.4,14.37,4.8,0,0,0,0,0,0,0.181024507575505,174.593244578816,20.2692886943794
9.7,"max_tuv_SVM","SVM",76,4,2284,2116,168,500,402,98,0.813993690851741,0.312,1.23251612903226,232,98,134,69,1.4,17.96,4.1,0,0,0,0,0,0,0.20813004678556,163.24061130158,22.6310472518399
9.7,"max_tuv_SVM","SVM",76,5,2184,2047,137,600,471,129,0.817388012618298,0.304,1.23251612903226,299,129,170,67,1.3,21.55,3.7,0,0,0,0,0,0,0.225350921014513,160.297122427451,24.1696067813664
9.7,"max_tuv_SVM","SVM",76,6,2084,1977,107,700,541,159,0.816365930599372,0.304,1.23251612903226,366,159,207,67,1.3,25.14,3.4,0,0,0,0,0,0,0.230135616728182,129.588424572656,25.0350079102496
9.7,"max_tuv_SVM","SVM",76,7,1984,1903,81,800,615,185,0.802536277602525,0.288,1.23251612903226,438,185,253,72,1.4,28.74,3.3,0,0,0,0,0,0,0.238041253165993,163.440128295648,25.793002159266
9.7,"max_tuv_SVM","SVM",76,8,1884,1804,80,900,714,186,0.805223974763415,0.216,1.25305806451613,439,186,253,1,1.4,32.33,3.8,0,0,0,0,0,0,0.20657022857636,94.0776179413034,22.723839592085
9.7,"max_tuv_SVM","SVM",76,9,1784,1719,65,1000,799,201,0.808593059936918,0.24,1.25305806451613,485,201,284,46,1.4,35.92,4,0,0,0,0,0,0,0.186491540162912,80.5089803801005,20.4557014128502
9.7,"max_tuv_SVM","SVM",76,10,1684,1631,53,1100,887,213,0.808012618296537,0.232,1.24278709677419,518,213,305,33,1.4,39.51,4.2,0,0,0,0,0,0,0.158185818370826,59.8071448789344,18.6937401238624
9.7,"max_tuv_SVM","SVM",76,11,1584,1539,45,1200,979,221,0.808397476340698,0.256,1.23251612903226,546,221,325,28,1.5,43.1,4.4,0,0,0,0,0,0,0.156282913148078,63.7579633746044,18.0595157093924
9.7,"max_tuv_SVM","SVM",76,12,1484,1445,39,1300,1073,227,0.822258675078875,0.28,1.23251612903226,573,227,346,27,1.5,46.7,4.7,0,0,0,0,0,0,0.145509694324449,57.5349021437617,16.1469718778114
9.7,"max_tuv_SVM","SVM",76,13,1384,1355,29,1400,1163,237,0.807463722397483,0.24,1.22224516129032,607,237,370,34,1.6,50.29,4.9,0,0,0,0,0,0,0.152790494600272,61.3804811114154,17.1058731575233
9.7,"max_tuv_SVM","SVM",76,14,1284,1259,25,1500,1259,241,0.795596214511045,0.248,1.21197419354839,613,241,372,6,1.5,53.88,5.2,0,0,0,0,0,0,0.134567206436747,56.7765661825663,14.9599163360347
9.7,"max_tuv_SVM","SVM",76,15,1184,1160,24,1600,1358,242,0.765003154574139,0.168,1.21197419354839,633,242,391,20,1.6,57.47,5.6,0,0,0,0,0,0,0.130012971507789,52.1475294658623,14.1846014956255
9.7,"max_tuv_SVM","SVM",76,16,1084,1062,22,1700,1456,244,0.741747634069407,0.168,1.21197419354839,638,244,394,5,1.6,61.06,6,0,0,0,0,0,0,0.130294343480066,50.8109562664642,14.903797601177
9.7,"max_tuv_SVM","SVM",76,17,984,962,22,1800,1556,244,0.744176656151425,0.16,1.21197419354839,641,244,397,3,1.6,64.66,6.4,0,0,0,0,0,0,0.102886679562838,27.7835484719344,11.5007360442904
9.7,"max_tuv_SVM","SVM",76,18,884,862,22,1900,1656,244,0.783141955835968,0.248,1.22224516129032,652,244,408,11,1.7,68.25,6.8,0,0,0,0,0,0,0.0443258309539822,8.99167717571457,5.93756054140069
9.7,"max_tuv_SVM","SVM",76,19,784,763,21,2000,1755,245,0.772353312302839,0.24,1.21197419354839,652,245,407,0,1.7,71.84,7.2,0,0,0,0,0,0,0.0183736739071764,4.82256723753266,4.25407622015221
9.7,"max_tuv_SVM","SVM",76,20,684,670,14,2100,1848,252,0.748971608832818,0.144,1.22224516129032,675,252,423,23,1.7,75.43,7.3,0,0,0,0,0,0,0.012260134080468,4.07108352105559,2.61832590300673
9.7,"max_tuv_SVM","SVM",76,21,584,577,7,2200,1941,259,0.756151419558367,0.176,1.22224516129032,683,259,424,8,1.6,79.02,7.5,0,0,0,0,0,0,0.0956105326538916,33.9441258156727,15.3696549685742
9.7,"max_tuv_SVM","SVM",76,22,484,477,7,2300,2041,259,0.793507886435333,0.248,1.25305806451613,684,259,425,1,1.6,82.61,7.9,0,0,0,0,0,0,0.031298077550751,10.702346234486,4.85556836294738
9.7,"max_tuv_SVM","SVM",76,23,384,380,4,2400,2138,262,0.745381703470032,0.16,1.25305806451613,702,262,440,18,1.7,86.21,8.2,0,0,0,0,0,0,0.0377403487432519,10.4606478113171,5.6712387718078
9.7,"max_tuv_SVM","SVM",76,24,284,283,1,2500,2235,265,0.758826498422718,0.152,1.24278709677419,708,265,443,6,1.7,89.8,8.4,0,0,0,0,0,0,0.026029162637801,6.31942365282378,4.99270571509896
9.7,"max_tuv_SVM","SVM",76,25,184,184,0,2600,2334,266,0.777495268138807,0.208,1.24278709677419,716,266,450,8,1.7,93.39,8.8,0,0,0,0,0,0,1.20489917483583e-06,0.823038437155722,0.823020586571711
9.7,"max_tuv_SVM","SVM",76,26,84,84,0,2700,2434,266,0.7392807570978,0.152,1.25305806451613,719,266,453,3,1.7,96.98,9.2,0,0,0,0,0,0,2.80149524798167e-11,0.0435069640989558,0.0435069640989558
9.7,"max_tuv_SVM","SVM",76,27,0,0,0,2784,2518,266,0.757179810725559,0.176,1.25305806451613,723,266,457,4,1.7,100,9.5,0,0,0,0,0,0,0,0,0
9.7,"max_tuv_SVM","SVM",77,0,2684,2424,260,100,92,8,0.799334229562776,0.276422764227642,1.25255704169945,23,8,15,0,1.9,3.59,11.5,0,0,0,0,0,0,0.148833112605967,189.436924653875,18.1917845060971
9.7,"max_tuv_SVM","SVM",77,1,2584,2346,238,200,170,30,0.63601561999872,0.105691056910569,1.15861526357199,86,30,56,63,1.9,7.18,5.7,0,0,0,0,0,0,0.200023864796682,366.357004978071,41.6097556397914
9.7,"max_tuv_SVM","SVM",77,2,2484,2262,222,300,254,46,0.750035209013513,0.235772357723577,1.22124311565696,130,46,84,44,1.8,10.78,5.5,0,0,0,0,0,0,0.185194428693892,299.334884243052,19.605407559744
9.7,"max_tuv_SVM","SVM",77,3,2384,2193,191,400,323,77,0.74910056974586,0.235772357723577,1.20036716496197,184,77,107,54,1.4,14.37,4.2,0,0,0,0,0,0,0.191751476612718,431.477935011457,19.365404391855
9.7,"max_tuv_SVM","SVM",77,4,2284,2125,159,500,391,109,0.759586454132264,0.24390243902439,1.20036716496197,258,109,149,74,1.4,17.96,3.6,0,0,0,0,0,0,0.216582999777718,285.599852091982,22.6535634283435
9.7,"max_tuv_SVM","SVM",77,5,2184,2055,129,600,461,139,0.768888035337058,0.235772357723577,1.23168109100446,323,139,184,65,1.3,21.55,3.3,0,0,0,0,0,0,0.207885296980738,172.954121565989,22.2660589982319
9.7,"max_tuv_SVM","SVM",77,6,2084,1976,108,700,540,160,0.779060239421293,0.227642276422764,1.25255704169945,364,160,204,41,1.3,25.14,3.4,0,0,0,0,0,0,0.221882225109775,305.016230393146,23.5649706085506
9.7,"max_tuv_SVM","SVM",77,7,1984,1896,88,800,620,180,0.786921451891689,0.252032520325203,1.24211906635195,415,180,235,51,1.3,28.74,3.4,0,0,0,0,0,0,0.208167342963945,170.247816269788,22.3364114666971
9.7,"max_tuv_SVM","SVM",77,8,1884,1820,64,900,696,204,0.793451123487614,0.24390243902439,1.24211906635195,467,204,263,52,1.3,32.33,3.4,0,0,0,0,0,0,0.209266694016314,132.044473674549,22.8154003439846
9.7,"max_tuv_SVM","SVM",77,9,1784,1737,47,1000,779,221,0.797010434671278,0.260162601626016,1.24211906635195,514,221,293,47,1.3,35.92,3.5,0,0,0,0,0,0,0.190016917900622,128.492834342184,20.5597472672393
9.7,"max_tuv_SVM","SVM",77,10,1684,1643,41,1100,873,227,0.785545099545485,0.235772357723577,1.26299501704694,534,227,307,20,1.4,39.51,3.8,0,0,0,0,0,0,0.186428612370765,161.317861357442,20.7507664115983
9.7,"max_tuv_SVM","SVM",77,11,1584,1551,33,1200,965,235,0.791415402343004,0.24390243902439,1.25255704169945,571,235,336,37,1.4,43.1,4.1,0,0,0,0,0,0,0.152231026857821,79.5067223772519,17.4100482153268
9.7,"max_tuv_SVM","SVM",77,12,1484,1459,25,1300,1057,243,0.777914346072597,0.227642276422764,1.24211906635195,597,243,354,26,1.5,46.7,4.3,0,0,0,0,0,0,0.168640538329692,141.109815347504,18.2573407231973
9.7,"max_tuv_SVM","SVM",77,13,1384,1360,24,1400,1156,244,0.779028231227203,0.211382113821138,1.25255704169945,602,244,358,5,1.5,50.29,4.7,0,0,0,0,0,0,0.129642129731921,60.934784262395,14.5718157121829
9.7,"max_tuv_SVM","SVM",77,14,1284,1272,12,1500,1244,256,0.77591703476091,0.211382113821138,1.25255704169945,639,256,383,37,1.5,53.88,4.9,0,0,0,0,0,0,0.128199206824948,50.9879562229367,15.1416613632962
9.7,"max_tuv_SVM","SVM",77,15,1184,1175,9,1600,1341,259,0.768094232123435,0.195121951219512,1.25255704169945,652,259,393,13,1.5,57.47,5.2,0,0,0,0,0,0,0.0777729394885048,26.0252372864095,9.9946781983586
9.7,"max_tuv_SVM","SVM",77,16,1084,1075,9,1700,1441,259,0.763190576787667,0.203252032520325,1.25255704169945,660,259,401,8,1.5,61.06,5.6,0,0,0,0,0,0,0.0954229246459979,52.4639877149203,10.6214677258478
9.7,"max_tuv_SVM","SVM",77,17,984,979,5,1800,1537,263,0.783086870238786,0.211382113821138,1.25255704169945,689,263,426,29,1.6,64.66,5.8,0,0,0,0,0,0,0.0401280937481838,12.0721375949367,6.81364762422731
9.7,"max_tuv_SVM","SVM",77,18,884,883,1,1900,1633,267,0.760610716343391,0.170731707317073,1.25255704169945,686,267,419,-3,1.6,68.25,6.1,0,0,0,0,0,0,0.0506905534075282,15.8214575730504,7.17952309878519
9.7,"max_tuv_SVM","SVM",77,19,784,784,0,2000,1732,268,0.792938992382057,0.227642276422764,1.25255704169945,709,268,441,23,1.6,71.84,6.5,0,0,0,0,0,0,0.025760159358095,7.91189317613939,3.63817961240093
9.7,"max_tuv_SVM","SVM",77,20,684,684,0,2100,1832,268,0.788720312399984,0.260162601626016,1.25255704169945,702,268,434,-7,1.6,75.43,6.8,0,0,0,0,0,0,0.0166822475010251,4.68575554414739,2.28641468021105
9.7,"max_tuv_SVM","SVM",77,21,584,584,0,2200,1932,268,0.778644132898026,0.227642276422764,1.25255704169945,700,268,432,-2,1.6,79.02,7.2,0,0,0,0,0,0,0.00999674155864254,2.72067078331351,1.60702817536472
9.7,"max_tuv_SVM","SVM",77,22,484,484,0,2300,2032,268,0.783855066897132,0.211382113821138,1.25255704169945,700,268,432,0,1.6,82.61,7.6,0,0,0,0,0,0,1.94533250526089e-06,0.101641537718369,0.101550215817943
9.7,"max_tuv_SVM","SVM",77,23,384,384,0,2400,2132,268,0.763299404647594,0.195121951219512,1.25255704169945,701,268,433,1,1.6,86.21,8,0,0,0,0,0,0,0.00996354607238477,2.90138347534808,1.44326425400157
9.7,"max_tuv_SVM","SVM",77,24,284,284,0,2500,2232,268,0.786614173228356,0.227642276422764,1.25255704169945,714,268,446,13,1.7,89.8,8.3,0,0,0,0,0,0,2.34580749293411e-07,9.43715955728924e-05,8.19082407561765e-05
9.7,"max_tuv_SVM","SVM",77,25,184,184,0,2600,2332,268,0.730446194225724,0.130081300813008,1.26299501704694,718,268,450,4,1.7,93.39,8.7,0,0,0,0,0,0,3.60124508738254e-09,1.38816142848368e-05,1.37920443138445e-05
9.7,"max_tuv_SVM","SVM",77,26,84,84,0,2700,2432,268,0.776723641252165,0.211382113821138,1.26299501704694,716,268,448,-2,1.7,96.98,9.1,0,0,0,0,0,0,3.00000089999998e-14,9.38222576935262e-09,9.38222576935262e-09
9.7,"max_tuv_SVM","SVM",77,27,0,0,0,2784,2516,268,0.781928173612447,0.195121951219512,1.26299501704694,725,268,457,9,1.7,100,9.4,0,0,0,0,0,0,0,0,0
9.7,"max_tuv_SVM","SVM",78,0,2684,2428,256,100,90,10,0.80617665615142,0.256,1.26332903225806,27,10,17,0,1.7,3.59,9,0,0,0,0,0,0,0.15119121312521,247.609384627756,15.8808772611779
9.7,"max_tuv_SVM","SVM",78,1,2584,2360,224,200,158,42,0.75454889589906,0.144,1.22224516129032,100,42,58,73,1.4,7.18,3.8,0,0,0,0,0,0,0.254107950380779,500.313120476732,34.8209628437668
9.7,"max_tuv_SVM","SVM",78,2,2484,2278,206,300,240,60,0.787741324921147,0.288,1.25305806451613,158,60,98,58,1.6,10.78,4,0,0,0,0,0,0,0.251796764548396,299.415448431484,29.6519795990198
9.7,"max_tuv_SVM","SVM",78,3,2384,2200,184,400,318,82,0.794700315457412,0.224,1.26332903225806,219,82,137,61,1.7,14.37,3.9,0,0,0,0,0,0,0.226164358304161,331.309987510406,23.6214657556907
9.7,"max_tuv_SVM","SVM",78,4,2284,2119,165,500,399,101,0.798971608832813,0.256,1.26332903225806,265,101,164,46,1.6,17.96,4,0,0,0,0,0,0,0.220648296082857,232.689215757245,22.4593128054709
9.7,"max_tuv_SVM","SVM",78,5,2184,2056,128,600,462,138,0.800164037854897,0.256,1.25305806451613,350,138,212,85,1.5,21.55,3.3,0,0,0,0,0,0,0.240466657139119,194.707593712573,24.4374884605211
9.7,"max_tuv_SVM","SVM",78,6,2084,1985,99,700,533,167,0.788485804416415,0.2,1.26332903225806,418,167,251,68,1.5,25.14,3.2,0,0,0,0,0,0,0.250186986659557,174.908960553018,29.3028965284239
9.7,"max_tuv_SVM","SVM",78,7,1984,1901,83,800,617,183,0.796548895899068,0.24,1.26332903225806,466,183,283,48,1.5,28.74,3.4,0,0,0,0,0,0,0.231299424475521,113.770534939207,23.7174011504853
9.7,"max_tuv_SVM","SVM",78,8,1884,1832,52,900,686,214,0.799299684542603,0.264,1.26332903225806,525,214,311,59,1.5,32.33,3.2,0,0,0,0,0,0,0.233559416082895,142.433385748605,24.324795446631
9.7,"max_tuv_SVM","SVM",78,9,1784,1741,43,1000,777,223,0.801451104100947,0.264,1.26332903225806,541,223,318,16,1.4,35.92,3.5,0,0,0,0,0,0,0.190989252815394,104.485716464286,21.1062949595922
9.7,"max_tuv_SVM","SVM",78,10,1684,1645,39,1100,873,227,0.798536277602522,0.232,1.26332903225806,558,227,331,17,1.5,39.51,3.8,0,0,0,0,0,0,0.138942753198871,60.0832165094631,15.7941987892063
9.7,"max_tuv_SVM","SVM",78,11,1584,1552,32,1200,966,234,0.783514195583597,0.168,1.24278709677419,581,234,347,23,1.5,43.1,4.1,0,0,0,0,0,0,0.154404220349059,73.3034082651489,19.2840794655198
9.7,"max_tuv_SVM","SVM",78,12,1484,1462,22,1300,1056,244,0.78794321766562,0.168,1.23251612903226,604,244,360,23,1.5,46.7,4.3,0,0,0,0,0,0,0.153124022923819,80.4735659265867,16.9556165978896
9.7,"max_tuv_SVM","SVM",78,13,1384,1364,20,1400,1154,246,0.763205047318617,0.184,1.21197419354839,627,246,381,23,1.5,50.29,4.7,0,0,0,0,0,0,0.171747130848347,133.813948829148,17.6429413221417
9.7,"max_tuv_SVM","SVM",78,14,1284,1265,19,1500,1253,247,0.753886435331236,0.176,1.21197419354839,632,247,385,5,1.6,53.88,5.1,0,0,0,0,0,0,0.154066555506763,73.9188183295088,16.9554069694284
9.7,"max_tuv_SVM","SVM",78,15,1184,1165,19,1600,1353,247,0.745287066246063,0.152,1.22224516129032,628,247,381,-4,1.5,57.47,5.5,0,0,0,0,0,0,0.118817501688674,38.1228296428362,14.157157181573
9.7,"max_tuv_SVM","SVM",78,16,1084,1067,17,1700,1451,249,0.726321766561519,0.128,1.22224516129032,658,249,409,30,1.6,61.06,5.8,0,0,0,0,0,0,0.119478794672337,38.0906490720609,14.6208481018627
9.7,"max_tuv_SVM","SVM",78,17,984,967,17,1800,1551,249,0.742858044164042,0.136,1.22224516129032,661,249,412,3,1.7,64.66,6.2,0,0,0,0,0,0,0.0985349543967457,30.5380786710925,11.2046317145035
9.7,"max_tuv_SVM","SVM",78,18,884,867,17,1900,1651,249,0.754958990536284,0.192,1.22224516129032,651,249,402,-10,1.6,68.25,6.6,0,0,0,0,0,0,0.03749237034095,9.01356904973173,6.16048319666475
9.7,"max_tuv_SVM","SVM",78,19,784,769,15,2000,1749,251,0.745305993690861,0.16,1.21197419354839,670,251,419,19,1.7,71.84,7,0,0,0,0,0,0,0.0332413751546197,13.5087842915776,6.60297105086498
9.7,"max_tuv_SVM","SVM",78,20,684,673,11,2100,1845,255,0.742492113564673,0.168,1.21197419354839,680,255,425,10,1.7,75.43,7.2,0,0,0,0,0,0,0.0563287097667341,17.1828571403777,10.7017372899131
9.7,"max_tuv_SVM","SVM",78,21,584,573,11,2200,1945,255,0.735318611987381,0.144,1.21197419354839,674,255,419,-6,1.6,79.02,7.6,0,0,0,0,0,0,0.0268659803208421,8.00931289290175,4.41737837891888
9.7,"max_tuv_SVM","SVM",78,22,484,475,9,2300,2043,257,0.734908517350166,0.144,1.21197419354839,681,257,424,7,1.6,82.61,7.9,0,0,0,0,0,0,0.0235684659038847,6.61986388079728,3.67858554485268
9.7,"max_tuv_SVM","SVM",78,23,384,376,8,2400,2142,258,0.72352681388013,0.096,1.22224516129032,704,258,446,23,1.7,86.21,8.3,0,0,0,0,0,0,0.0406361133854356,11.4421732915985,5.51745431085993
9.7,"max_tuv_SVM","SVM",78,24,284,282,2,2500,2236,264,0.734429022082028,0.144,1.2736,713,264,449,9,1.7,89.8,8.5,0,0,0,0,0,0,0.0161750034486041,4.5576877810844,3.47330778973341
9.7,"max_tuv_SVM","SVM",78,25,184,184,0,2600,2334,266,0.672056782334389,0.112,1.26332903225806,717,266,451,4,1.7,93.39,8.8,0,0,0,0,0,0,0.0043425076777455,0.972362868266652,0.864040751779162
9.7,"max_tuv_SVM","SVM",78,26,84,84,0,2700,2434,266,0.730479495268145,0.152,1.26332903225806,723,266,457,6,1.7,96.98,9.2,0,0,0,0,0,0,3.89749056719305e-11,0.00958985485152489,0.00958985485152489
9.7,"max_tuv_SVM","SVM",78,27,0,0,0,2784,2518,266,0.78620820189275,0.184,1.26332903225806,724,266,458,1,1.7,100,9.5,0,0,0,0,0,0,0,0,0
9.7,"max_tuv_SVM","SVM",79,0,2684,2418,266,100,94,6,0.735333693917131,0.176470588235294,1.24071564109515,22,6,16,0,2.7,3.59,15.7,0,0,0,0,0,0,0.0768711902233321,175.662636585931,7.88273962682642
9.7,"max_tuv_SVM","SVM",79,1,2584,2345,239,200,167,33,0.79633391818266,0.176470588235294,1.26229330441854,75,33,42,53,1.3,7.18,5.1,0,0,0,0,0,0,0.291474184209006,290.667714760028,32.6048951635649
9.7,"max_tuv_SVM","SVM",79,2,2484,2276,208,300,236,64,0.674471986596837,0.26890756302521,1.12203849281648,148,64,84,73,1.3,10.78,3.7,0,0,0,0,0,0,0.237798912277254,408.912700904223,26.5758550044491
9.7,"max_tuv_SVM","SVM",79,3,2384,2210,174,400,302,98,0.751177394034539,0.151260504201681,1.26229330441854,228,98,130,80,1.3,14.37,3.1,0,0,0,0,0,0,0.267658894127118,450.663897010303,33.497873597096
9.7,"max_tuv_SVM","SVM",79,4,2284,2119,165,500,393,107,0.794467237444436,0.151260504201681,1.22992680943345,250,107,143,22,1.3,17.96,3.7,0,0,0,0,0,0,0.237174421375337,198.727407342394,31.7068874088726
9.7,"max_tuv_SVM","SVM",79,5,2184,2048,136,600,464,136,0.7995330000132,0.142857142857143,1.24071564109515,315,136,179,65,1.3,21.55,3.4,0,0,0,0,0,0,0.232271802154635,211.404922006731,25.8359411165514
9.7,"max_tuv_SVM","SVM",79,6,2084,1978,106,700,534,166,0.800878593195529,0.201680672268908,1.21801538294876,374,166,208,59,1.3,25.14,3.2,0,0,0,0,0,0,0.22738533514657,163.985558013995,24.7866401301206
9.7,"max_tuv_SVM","SVM",79,7,1984,1901,83,800,611,189,0.799823225993701,0.210084033613445,1.21913797777175,438,189,249,64,1.3,28.74,3.2,0,0,0,0,0,0,0.225797509872778,135.71929334909,24.6419324063501
9.7,"max_tuv_SVM","SVM",79,8,1884,1818,66,900,694,206,0.77467250636519,0.19327731092437,1.21913797777175,486,206,280,48,1.4,32.33,3.4,0,0,0,0,0,0,0.226035515133653,157.715118675045,24.8472860056367
9.7,"max_tuv_SVM","SVM",79,9,1784,1723,61,1000,789,211,0.77018059971242,0.19327731092437,1.20834914611006,503,211,292,17,1.4,35.92,3.7,0,0,0,0,0,0,0.189509387449975,108.200693883691,21.0708533381672
9.7,"max_tuv_SVM","SVM",79,10,1684,1630,54,1100,882,218,0.785107449573244,0.201680672268908,1.20834914611006,524,218,306,21,1.4,39.51,4,0,0,0,0,0,0,0.150741656250407,80.1267050201881,17.854721496268
9.7,"max_tuv_SVM","SVM",79,11,1584,1533,51,1200,979,221,0.792534596256093,0.201680672268908,1.22992680943345,535,221,314,11,1.4,43.1,4.4,0,0,0,0,0,0,0.0779307942752457,29.4612102790906,11.8100006810694
9.7,"max_tuv_SVM","SVM",79,12,1484,1443,41,1300,1069,231,0.795027901270407,0.201680672268908,1.19756031444836,560,231,329,25,1.4,46.7,4.6,0,0,0,0,0,0,0.120282500035025,48.299779784383,17.3679455283657
9.7,"max_tuv_SVM","SVM",79,13,1384,1363,21,1400,1149,251,0.779289737873178,0.201680672268908,1.19756031444836,617,251,366,57,1.5,50.29,4.6,0,0,0,0,0,0,0.0736343670583787,24.9405349445304,11.1149496417061
9.7,"max_tuv_SVM","SVM",79,14,1284,1265,19,1500,1247,253,0.777541785945152,0.210084033613445,1.20834914611006,643,253,390,26,1.5,53.88,4.9,0,0,0,0,0,0,0.1291283708439,56.390868799516,15.4693823368966
9.7,"max_tuv_SVM","SVM",79,15,1184,1168,16,1600,1344,256,0.750544173713446,0.176470588235294,1.20834914611006,659,256,403,16,1.6,57.47,5.2,0,0,0,0,0,0,0.1484672093704,73.550066319548,17.3038708674349
9.7,"max_tuv_SVM","SVM",79,16,1084,1069,15,1700,1443,257,0.771506404759711,0.19327731092437,1.20834914611006,665,257,408,6,1.6,61.06,5.6,0,0,0,0,0,0,0.121459265541359,48.7601380301289,14.5300092858117
9.7,"max_tuv_SVM","SVM",79,17,984,969,15,1800,1543,257,0.74574884899015,0.19327731092437,1.20834914611006,666,257,409,1,1.6,64.66,6,0,0,0,0,0,0,0.0934380057642516,31.383266332659,11.4978026629968
9.7,"max_tuv_SVM","SVM",79,18,884,870,14,1900,1642,258,0.732959117713025,0.159663865546218,1.20834914611006,655,258,397,-11,1.5,68.25,6.4,0,0,0,0,0,0,0.0925225518073465,41.7143031338738,12.750439868623
9.7,"max_tuv_SVM","SVM",79,19,784,770,14,2000,1742,258,0.728454018970233,0.168067226890756,1.19756031444836,668,258,410,13,1.6,71.84,6.8,0,0,0,0,0,0,0.0407297181705137,14.5098928711625,6.15612381915112
9.7,"max_tuv_SVM","SVM",79,20,684,670,14,2100,1842,258,0.74419877841247,0.184873949579832,1.20834914611006,672,258,414,4,1.6,75.43,7.1,0,0,0,0,0,0,0.0201815596123319,6.90363937937187,3.8662377768001
9.7,"max_tuv_SVM","SVM",79,21,584,571,13,2200,1941,259,0.754277535189909,0.176470588235294,1.19645758856029,668,259,409,-4,1.6,79.02,7.5,0,0,0,0,0,0,0.010029625799067,3.73319013888304,2.51839066851248
9.7,"max_tuv_SVM","SVM",79,22,484,475,9,2300,2037,263,0.77372267588355,0.201680672268908,1.21913797777175,689,263,426,21,1.6,82.61,7.7,0,0,0,0,0,0,0.0273040948283093,9.42733519447744,5.44642710842142
9.7,"max_tuv_SVM","SVM",79,23,384,377,7,2400,2135,265,0.687571731989504,0.126050420168067,1.22992680943345,695,265,430,6,1.6,86.21,8.1,0,0,0,0,0,0,0.0626831897610297,18.1686160288418,8.81055985740494
9.7,"max_tuv_SVM","SVM",79,24,284,283,1,2500,2229,271,0.752582351621971,0.168067226890756,1.27308213608024,731,271,460,36,1.7,89.8,8.2,0,0,0,0,0,0,0.0142735102844287,5.60416811375624,4.65213032186016
9.7,"max_tuv_SVM","SVM",79,25,184,183,1,2600,2329,271,0.763406461485696,0.19327731092437,1.26229330441854,729,271,458,-2,1.7,93.39,8.6,0,0,0,0,0,0,0.00560729230940644,2.52432247612915,2.27840668298048
9.7,"max_tuv_SVM","SVM",79,26,84,84,0,2700,2428,272,0.730610925688959,0.168067226890756,1.27308213608024,729,272,457,0,1.7,96.98,8.9,0,0,0,0,0,0,1.29840502674145e-09,6.32577613287263,6.32577613287263
9.7,"max_tuv_SVM","SVM",79,27,0,0,0,2784,2512,272,0.724760233763837,0.126050420168067,1.27308213608024,748,272,476,19,1.8,100,9.2,0,0,0,0,0,0,0,0,0
9.7,"max_tuv_SVM","SVM",80,0,2684,2447,237,100,88,12,0.628747706060501,0.0985915492957746,1.10304407087687,33,12,21,0,1.8,3.59,7.3,0,0,0,0,0,0,0.296795177911918,325.744583928941,80.1635641707819
9.7,"max_tuv_SVM","SVM",80,1,2584,2359,225,200,176,24,0.826060278537735,0.23943661971831,1.25674693321218,71,24,47,38,2,7.18,7.3,0,0,0,0,0,0,0.159516711910158,274.433560011026,17.6807930525425
9.7,"max_tuv_SVM","SVM",80,2,2484,2281,203,300,254,46,0.788434041499199,0.302816901408451,1.21154020899591,122,46,76,51,1.7,10.78,5.5,0,0,0,0,0,0,0.170896677694089,292.384026655163,18.7239065354785
9.7,"max_tuv_SVM","SVM",80,3,2384,2207,177,400,328,72,0.809324371488731,0.26056338028169,1.23866424352567,184,72,112,62,1.6,14.37,4.6,0,0,0,0,0,0,0.192564059445806,255.174856840997,20.2098919836428
9.7,"max_tuv_SVM","SVM",80,4,2284,2128,156,500,407,93,0.808333614798305,0.26056338028169,1.23866424352567,232,93,139,48,1.5,17.96,4.4,0,0,0,0,0,0,0.197403614078584,203.71996076212,20.2370624933623
9.7,"max_tuv_SVM","SVM",80,5,2184,2052,132,600,483,117,0.810056180407792,0.267605633802817,1.23866424352567,293,117,176,61,1.5,21.55,4.1,0,0,0,0,0,0,0.19846777090225,149.935836867651,20.4298671433915
9.7,"max_tuv_SVM","SVM",80,6,2084,1985,99,700,550,150,0.808536269575894,0.28169014084507,1.23866424352567,368,150,218,75,1.5,25.14,3.7,0,0,0,0,0,0,0.211883321428419,152.036184416194,21.7822885531224
9.7,"max_tuv_SVM","SVM",80,7,1984,1911,73,800,624,176,0.802130126884414,0.302816901408451,1.23866424352567,445,176,269,77,1.5,28.74,3.5,0,0,0,0,0,0,0.210510108282632,131.467568055904,21.9115621119478
9.7,"max_tuv_SVM","SVM",80,8,1884,1824,60,900,711,189,0.804246743450316,0.316901408450704,1.23866424352567,464,189,275,19,1.5,32.33,3.8,0,0,0,0,0,0,0.193754862612459,168.36081785127,20.1697042676338
9.7,"max_tuv_SVM","SVM",80,9,1784,1737,47,1000,798,202,0.797699868274401,0.28169014084507,1.24770558836892,508,202,306,44,1.5,35.92,4,0,0,0,0,0,0,0.16952281892941,130.072101450041,18.4538740471317
9.7,"max_tuv_SVM","SVM",80,10,1684,1642,42,1100,893,207,0.801071818601467,0.28169014084507,1.24770558836892,532,207,325,24,1.6,39.51,4.3,0,0,0,0,0,0,0.135067637127145,119.457745990093,15.679909589347
9.7,"max_tuv_SVM","SVM",80,11,1584,1547,37,1200,988,212,0.817683881064159,0.302816901408451,1.24770558836892,536,212,324,4,1.5,43.1,4.7,0,0,0,0,0,0,0.0765729039124636,36.1758489458688,10.2740139792096
9.7,"max_tuv_SVM","SVM",80,12,1484,1452,32,1300,1083,217,0.810140619898448,0.232394366197183,1.24770558836892,562,217,345,26,1.6,46.7,5,0,0,0,0,0,0,0.0854467442640689,26.9211408554705,14.9195092973969
9.7,"max_tuv_SVM","SVM",80,13,1384,1366,18,1400,1169,231,0.82119656387566,0.309859154929577,1.24770558836892,607,231,376,45,1.6,50.29,5.1,0,0,0,0,0,0,0.048478607867045,16.4204801997524,7.85266090499947
9.7,"max_tuv_SVM","SVM",80,14,1284,1269,15,1500,1266,234,0.782545794350442,0.190140845070423,1.24770558836892,623,234,389,16,1.7,53.88,5.4,0,0,0,0,0,0,0.115566181120462,60.8444568843983,13.7472487465085
9.7,"max_tuv_SVM","SVM",80,15,1184,1170,14,1600,1365,235,0.816040125645967,0.316901408450704,1.24770558836892,620,235,385,-3,1.6,57.47,5.8,0,0,0,0,0,0,0.0593752072807665,21.6459533242862,8.04716155637614
9.7,"max_tuv_SVM","SVM",80,16,1084,1071,13,1700,1464,236,0.782416320464758,0.225352112676056,1.22962289868242,637,236,401,17,1.7,61.06,6.2,0,0,0,0,0,0,0.108475879777424,52.2485641086309,12.5787896520953
9.7,"max_tuv_SVM","SVM",80,17,984,971,13,1800,1564,236,0.801837403316789,0.309859154929577,1.22962289868242,633,236,397,-4,1.7,64.66,6.6,0,0,0,0,0,0,0.0297841062263926,9.473928460924,5.34885405102332
9.7,"max_tuv_SVM","SVM",80,18,884,871,13,1900,1664,236,0.782303734477213,0.225352112676056,1.22962289868242,621,236,385,-12,1.6,68.25,7.1,0,0,0,0,0,0,0.0311323304999041,10.4217243422256,4.26454564083419
9.7,"max_tuv_SVM","SVM",80,19,784,771,13,2000,1764,236,0.772677632541861,0.197183098591549,1.22962289868242,639,236,403,18,1.7,71.84,7.5,0,0,0,0,0,0,0.00620770889843178,1.87468654323397,0.958243843308921
9.7,"max_tuv_SVM","SVM",80,20,684,671,13,2100,1864,236,0.800762207135705,0.28169014084507,1.22962289868242,641,236,405,2,1.7,75.43,7.9,0,0,0,0,0,0,0.00180826612954763,0.652153524318359,0.418342194436757
9.7,"max_tuv_SVM","SVM",80,21,584,572,12,2200,1963,237,0.787139302642398,0.225352112676056,1.22962289868242,642,237,405,1,1.7,79.02,8.3,0,0,0,0,0,0,0.00524861911345474,1.74316922189281,1.06635764360909
9.7,"max_tuv_SVM","SVM",80,22,484,475,9,2300,2060,240,0.772970356109479,0.190140845070423,1.22962289868242,663,240,423,21,1.8,82.61,8.6,0,0,0,0,0,0,0.00789783620075334,2.49497088109234,1.77835767193034
9.7,"max_tuv_SVM","SVM",80,23,384,375,9,2400,2160,240,0.779483455489132,0.183098591549296,1.22962289868242,643,240,403,-20,1.7,86.21,9,0,0,0,0,0,0,0.00601005885355999,1.473293449966,0.978417319462325
9.7,"max_tuv_SVM","SVM",80,24,284,277,7,2500,2258,242,0.819034912914737,0.352112676056338,1.23866424352567,669,242,427,26,1.8,89.8,9.3,0,0,0,0,0,0,0.0132871986021033,3.39146006378328,2.25118275943178
9.7,"max_tuv_SVM","SVM",80,25,184,179,5,2600,2356,244,0.807078281037141,0.253521126760563,1.28387096774194,677,244,433,8,1.8,93.39,9.7,0,0,0,0,0,0,0.00034391843222413,0.606492503337542,0.593104354890893
9.7,"max_tuv_SVM","SVM",80,26,84,84,0,2700,2451,249,0.775283998153587,0.197183098591549,1.28387096774194,689,249,440,12,1.8,96.98,9.8,0,0,0,0,0,0,1.00842615497759e-06,2.03570174981265,2.03570174981265
9.7,"max_tuv_SVM","SVM",80,27,0,0,0,2784,2535,249,0.773454475855931,0.211267605633803,1.27482962289868,726,249,477,37,1.9,100,10.2,0,0,0,0,0,0,0,0,0
9.7,"max_tuv_SVM","SVM",81,0,2684,2421,263,100,91,9,0.741778029893278,0.210084033613445,1.22992680943345,27,9,18,0,2,3.59,10.1,0,0,0,0,0,0,0.176936451814861,254.362498496935,19.6488516224982
9.7,"max_tuv_SVM","SVM",81,1,2584,2346,238,200,166,34,0.770371885017745,0.19327731092437,1.27308213608024,92,34,58,65,1.7,7.18,4.9,0,0,0,0,0,0,0.227424842036245,306.379452559428,25.2395349759287
9.7,"max_tuv_SVM","SVM",81,2,2484,2272,212,300,240,60,0.788834215004687,0.252100840336134,1.27308213608024,142,60,82,50,1.4,10.78,4,0,0,0,0,0,0,0.274884318971834,287.804965761914,34.0782373688023
9.7,"max_tuv_SVM","SVM",81,3,2384,2199,185,400,313,87,0.781736870572408,0.19327731092437,1.27308213608024,207,87,120,65,1.4,14.37,3.6,0,0,0,0,0,0,0.230594755999845,349.462630516978,23.7110596253267
9.7,"max_tuv_SVM","SVM",81,4,2284,2119,165,500,393,107,0.788893579409788,0.210084033613445,1.27308213608024,261,107,154,54,1.4,17.96,3.7,0,0,0,0,0,0,0.220448735584619,296.934628159263,22.6298500824227
9.7,"max_tuv_SVM","SVM",81,5,2184,2048,136,600,464,136,0.777073466749341,0.201680672268908,1.27308213608024,326,136,190,65,1.4,21.55,3.4,0,0,0,0,0,0,0.220971074809959,261.409939838205,22.9145673933601
9.7,"max_tuv_SVM","SVM",81,6,2084,1973,111,700,539,161,0.784810627547726,0.218487394957983,1.27308213608024,387,161,226,61,1.4,25.14,3.3,0,0,0,0,0,0,0.226548196041383,259.107020437614,23.3518562932457
9.7,"max_tuv_SVM","SVM",81,7,1984,1892,92,800,620,180,0.801353508436344,0.226890756302521,1.27308213608024,445,180,265,58,1.5,28.74,3.4,0,0,0,0,0,0,0.221735112045102,139.498461655725,23.9790935686234
9.7,"max_tuv_SVM","SVM",81,8,1884,1815,69,900,697,203,0.799895782488821,0.201680672268908,1.27308213608024,514,203,311,69,1.5,32.33,3.4,0,0,0,0,0,0,0.211337220442932,217.067605975151,22.5199790780138
9.7,"max_tuv_SVM","SVM",81,9,1784,1728,56,1000,784,216,0.793860401303381,0.184873949579832,1.24071564109515,532,216,316,18,1.5,35.92,3.6,0,0,0,0,0,0,0.190595598631385,192.522733820216,20.3209015974166
9.7,"max_tuv_SVM","SVM",81,10,1684,1632,52,1100,880,220,0.79324696911732,0.218487394957983,1.24071564109515,550,220,330,18,1.5,39.51,4,0,0,0,0,0,0,0.140902903607637,106.571039547751,15.6655749036367
9.7,"max_tuv_SVM","SVM",81,11,1584,1535,49,1200,977,223,0.777891376330754,0.159663865546218,1.26229330441854,555,223,332,5,1.5,43.1,4.4,0,0,0,0,0,0,0.202935469528187,171.390867823241,22.1263294310966
9.7,"max_tuv_SVM","SVM",81,12,1484,1448,36,1300,1064,236,0.789144229120224,0.159663865546218,1.26229330441854,595,236,359,40,1.5,46.7,4.5,0,0,0,0,0,0,0.177736369299725,174.998629146638,18.6476111667571
9.7,"max_tuv_SVM","SVM",81,13,1384,1363,21,1400,1149,251,0.820501827104472,0.218487394957983,1.26229330441854,640,251,389,45,1.5,50.29,4.6,0,0,0,0,0,0,0.124280417526578,75.8012028232843,15.1051641613672
9.7,"max_tuv_SVM","SVM",81,14,1284,1272,12,1500,1240,260,0.804750471617221,0.201680672268908,1.27308213608024,676,260,416,36,1.6,53.88,4.8,0,0,0,0,0,0,0.141934049679932,59.3919234675936,17.3203129641222
9.7,"max_tuv_SVM","SVM",81,15,1184,1173,11,1600,1339,261,0.81666292890783,0.218487394957983,1.26229330441854,682,261,421,6,1.6,57.47,5.1,0,0,0,0,0,0,0.116559609242725,62.3406817423292,12.8659290597655
9.7,"max_tuv_SVM","SVM",81,16,1084,1073,11,1700,1439,261,0.819472844082691,0.252100840336134,1.27308213608024,686,261,425,4,1.6,61.06,5.5,0,0,0,0,0,0,0.0750827275167656,29.1885093434234,9.0600187416447
9.7,"max_tuv_SVM","SVM",81,17,984,974,10,1800,1538,262,0.82166273102648,0.218487394957983,1.26229330441854,710,262,448,24,1.7,64.66,5.9,0,0,0,0,0,0,0.0338628512799455,11.9803967874336,6.69411007790917
9.7,"max_tuv_SVM","SVM",81,18,884,875,9,1900,1637,263,0.829195414429512,0.252100840336134,1.27308213608024,700,263,437,-10,1.7,68.25,6.2,0,0,0,0,0,0,0.0141620611994042,4.21674235009835,2.9667280717203
9.7,"max_tuv_SVM","SVM",81,19,784,777,7,2000,1735,265,0.816352914792294,0.260504201680672,1.27308213608024,701,265,436,1,1.6,71.84,6.5,0,0,0,0,0,0,0.139060167777136,45.6025396760296,17.6189322779931
9.7,"max_tuv_SVM","SVM",81,20,684,679,5,2100,1833,267,0.806491827500234,0.210084033613445,1.27308213608024,731,267,464,30,1.7,75.43,6.9,0,0,0,0,0,0,0.0616086298824616,16.1157453591479,11.379715926991
9.7,"max_tuv_SVM","SVM",81,21,584,582,2,2200,1930,270,0.787989921243225,0.19327731092437,1.27308213608024,720,270,450,-11,1.7,79.02,7.1,0,0,0,0,0,0,0.0171811817613042,6.08266129344775,4.90309024281075
9.7,"max_tuv_SVM","SVM",81,22,484,483,1,2300,2029,271,0.774197591124364,0.134453781512605,1.27308213608024,716,271,445,-4,1.6,82.61,7.5,0,0,0,0,0,0,0.0143497636731669,3.60606900716111,2.58131461059532
9.7,"max_tuv_SVM","SVM",81,23,384,383,1,2400,2129,271,0.804143635476171,0.218487394957983,1.27308213608024,712,271,441,-4,1.6,86.21,7.9,0,0,0,0,0,0,8.82803438644383e-05,0.0591252632405227,0.05535396013473
9.7,"max_tuv_SVM","SVM",81,24,284,284,0,2500,2228,272,0.820851417490077,0.252100840336134,1.27308213608024,744,272,472,32,1.7,89.8,8.2,0,0,0,0,0,0,0.0272847555306689,9.11041480358017,7.66934946057648
9.7,"max_tuv_SVM","SVM",81,25,184,184,0,2600,2328,272,0.779138028837911,0.159663865546218,1.27308213608024,759,272,487,15,1.8,93.39,8.6,0,0,0,0,0,0,0.00182434880119886,0.729673732777703,0.672085928397465
9.7,"max_tuv_SVM","SVM",81,26,84,84,0,2700,2428,272,0.845019326411888,0.352941176470588,1.28387096774194,757,272,485,-2,1.8,96.98,8.9,0,0,0,0,0,0,1.4762795528398e-06,0.0366711975687474,0.0366711975687474
9.7,"max_tuv_SVM","SVM",81,27,0,0,0,2784,2512,272,0.813160429006772,0.226890756302521,1.27308213608024,742,272,470,-15,1.7,100,9.2,0,0,0,0,0,0,0,0,0
9.7,"max_tuv_SVM","SVM",82,0,2684,2444,240,100,95,5,0.763053245597657,0.328767123287671,1.21352187361909,13,5,8,0,1.6,3.59,19,0,0,0,0,0,0,0.245282543459732,214.833384539519,35.657194959074
9.7,"max_tuv_SVM","SVM",82,1,2584,2368,216,200,171,29,0.736562269995937,0.39041095890411,1.14317277949624,67,29,38,54,1.3,7.18,5.9,0,0,0,0,0,0,0.22059324424156,249.119879337292,31.2592197180162
9.7,"max_tuv_SVM","SVM",82,2,2484,2292,192,300,247,53,0.72604936779778,0.191780821917808,1.19593460008838,131,53,78,64,1.5,10.78,4.7,0,0,0,0,0,0,0.221939876418091,261.530269095201,29.9170610740542
9.7,"max_tuv_SVM","SVM",82,3,2384,2206,178,400,333,67,0.825553932176946,0.315068493150685,1.25749005744587,164,67,97,33,1.4,14.37,5,0,0,0,0,0,0,0.185670698751641,132.929477751886,19.6394014137781
9.7,"max_tuv_SVM","SVM",82,4,2284,2139,145,500,400,100,0.827536773187142,0.342465753424658,1.26628369421122,237,100,137,73,1.4,17.96,4,0,0,0,0,0,0,0.203055238682023,117.593701584584,21.3471645280277
9.7,"max_tuv_SVM","SVM",82,5,2184,2074,110,600,465,135,0.823593061704245,0.383561643835616,1.25749005744587,324,135,189,87,1.4,21.55,3.4,0,0,0,0,0,0,0.238079002593918,131.706255049927,24.7817680878276
9.7,"max_tuv_SVM","SVM",82,6,2084,1989,95,700,550,150,0.82129714053454,0.363013698630137,1.25749005744587,356,150,206,32,1.4,25.14,3.7,0,0,0,0,0,0,0.195055190820246,84.8260133394023,21.5013498620107
9.7,"max_tuv_SVM","SVM",82,7,1984,1904,80,800,635,165,0.820841251881224,0.363013698630137,1.25749005744587,401,165,236,45,1.4,28.74,3.8,0,0,0,0,0,0,0.175837164456045,82.0813412588198,19.768719314352
9.7,"max_tuv_SVM","SVM",82,8,1884,1821,63,900,718,182,0.832557041008009,0.335616438356164,1.25749005744587,462,182,280,61,1.5,32.33,3.9,0,0,0,0,0,0,0.151356407331497,55.5794905555885,17.9322250164399
9.7,"max_tuv_SVM","SVM",82,9,1784,1739,45,1000,800,200,0.841026683217809,0.383561643835616,1.24869642068051,494,200,294,32,1.5,35.92,4,0,0,0,0,0,0,0.144389842610504,58.1016528498194,18.4902222296911
9.7,"max_tuv_SVM","SVM",82,10,1684,1647,37,1100,892,208,0.832848150629999,0.356164383561644,1.24869642068051,526,208,318,32,1.5,39.51,4.3,0,0,0,0,0,0,0.193563976325161,111.43722022991,21.6109784649554
9.7,"max_tuv_SVM","SVM",82,11,1584,1557,27,1200,982,218,0.831941865957747,0.342465753424658,1.25749005744587,547,218,329,21,1.5,43.1,4.5,0,0,0,0,0,0,0.155315725296871,74.028586458769,17.3751884036684
9.7,"max_tuv_SVM","SVM",82,12,1484,1463,21,1300,1076,224,0.827371994155832,0.328767123287671,1.24869642068051,591,224,367,44,1.6,46.7,4.8,0,0,0,0,0,0,0.140455671085593,63.2895249044322,15.2317806386542
9.7,"max_tuv_SVM","SVM",82,13,1384,1364,20,1400,1175,225,0.810559040326917,0.321917808219178,1.25749005744587,592,225,367,1,1.6,50.29,5.2,0,0,0,0,0,0,0.13877971925004,60.8146199426513,15.4331216300836
9.7,"max_tuv_SVM","SVM",82,14,1284,1265,19,1500,1274,226,0.814975118366265,0.315068493150685,1.24869642068051,619,226,393,27,1.7,53.88,5.6,0,0,0,0,0,0,0.135125198775684,55.7584532516103,14.8677205353892
9.7,"max_tuv_SVM","SVM",82,15,1184,1166,18,1600,1373,227,0.815650712394674,0.363013698630137,1.25749005744587,609,227,382,-10,1.7,57.47,6,0,0,0,0,0,0,0.0994753984513226,32.7001070430677,11.5891334637766
9.7,"max_tuv_SVM","SVM",82,16,1084,1068,16,1700,1471,229,0.759384165833613,0.212328767123288,1.25749005744587,640,229,411,31,1.8,61.06,6.4,0,0,0,0,0,0,0.0987922491849022,29.2961036056402,11.4140858044788
9.7,"max_tuv_SVM","SVM",82,17,984,968,16,1800,1571,229,0.80139457986839,0.273972602739726,1.25749005744587,624,229,395,-16,1.7,64.66,6.9,0,0,0,0,0,0,0.0331781743543478,7.71563387308194,5.32414032200699
9.7,"max_tuv_SVM","SVM",82,18,884,869,15,1900,1670,230,0.809048565873159,0.308219178082192,1.25749005744587,639,230,409,15,1.8,68.25,7.3,0,0,0,0,0,0,0.0238279505450208,5.90025621334834,4.33497489700087
9.7,"max_tuv_SVM","SVM",82,19,784,772,12,2000,1767,233,0.814969625731892,0.315068493150685,1.24869642068051,655,233,422,16,1.8,71.84,7.6,0,0,0,0,0,0,0.00426411115197149,1.40422685934833,1.18690124239821
9.7,"max_tuv_SVM","SVM",82,20,684,678,6,2100,1861,239,0.789027913567906,0.23972602739726,1.28387096774194,672,239,433,17,1.8,75.43,7.8,0,0,0,0,0,0,0.140832860092484,43.9848457573083,20.931879759016
9.7,"max_tuv_SVM","SVM",82,21,584,578,6,2200,1961,239,0.813640408212581,0.308219178082192,1.27507733097658,670,239,431,-2,1.8,79.02,8.2,0,0,0,0,0,0,0.0244414850371386,8.08678026095562,5.84314183962033
9.7,"max_tuv_SVM","SVM",82,22,484,483,1,2300,2056,244,0.821747536553479,0.335616438356164,1.27507733097658,687,244,443,17,1.8,82.61,8.4,0,0,0,0,0,0,0.061404348994918,15.5863090177172,9.36826317276365
9.7,"max_tuv_SVM","SVM",82,23,384,383,1,2400,2156,244,0.799804462216162,0.280821917808219,1.27390322662025,693,244,449,6,1.8,86.21,8.8,0,0,0,0,0,0,0.013596476232857,3.74762076415662,2.944087865533
9.7,"max_tuv_SVM","SVM",82,24,284,283,1,2500,2256,244,0.78972547813382,0.253424657534247,1.27390322662025,708,244,464,15,1.9,89.8,9.2,0,0,0,0,0,0,0.0022149564954345,0.875076741938217,0.77713716293935
9.7,"max_tuv_SVM","SVM",82,25,184,183,1,2600,2356,244,0.798651008996932,0.26027397260274,1.27390322662025,696,244,452,-12,1.9,93.39,9.7,0,0,0,0,0,0,1.83795664672298e-05,0.0193763381800629,0.018986517931075
9.7,"max_tuv_SVM","SVM",82,26,84,84,0,2700,2455,245,0.770320000878823,0.212328767123288,1.26511768712632,659,245,414,-37,1.7,96.98,10,0,0,0,0,0,0,1.0000000994736e-07,1.67747840884807,1.67747840884807
9.7,"max_tuv_SVM","SVM",82,27,0,0,0,2784,2539,245,0.785408267513262,0.23972602739726,1.27390322662025,672,245,427,13,1.7,100,10.4,0,0,0,0,0,0,0,0,0
9.7,"max_tuv_SVM","SVM",83,0,2684,2440,244,100,86,14,0.698818474758323,0.157894736842105,1.22595197671598,44,14,30,0,2.1,3.59,6.1,0,0,0,0,0,0,0.1873124449128,377.657739718033,25.1587842167094
9.7,"max_tuv_SVM","SVM",83,1,2584,2356,228,200,170,30,0.770509607351728,0.180451127819549,1.27421780257094,92,30,62,48,2.1,7.18,5.7,0,0,0,0,0,0,0.206419901836118,315.133960064627,24.6909889155187
9.7,"max_tuv_SVM","SVM",83,2,2484,2266,218,300,260,40,0.763313044516066,0.120300751879699,1.25491147222896,140,40,100,48,2.5,10.78,6.5,0,0,0,0,0,0,0.18347839065079,297.772589371719,26.176798739353
9.7,"max_tuv_SVM","SVM",83,3,2384,2180,204,400,346,54,0.782981262680521,0.240601503759398,1.25491147222896,166,54,112,26,2.1,14.37,6.4,0,0,0,0,0,0,0.153567197185053,272.528307765588,16.596017147112
9.7,"max_tuv_SVM","SVM",83,4,2284,2099,185,500,427,73,0.809947487767051,0.308270676691729,1.27421780257094,193,73,120,27,1.6,17.96,5.8,0,0,0,0,0,0,0.169001554487007,234.391671415954,18.7197809386507
9.7,"max_tuv_SVM","SVM",83,5,2184,2033,151,600,493,107,0.810371166010274,0.285714285714286,1.26456463739995,273,107,166,80,1.6,21.55,4.6,0,0,0,0,0,0,0.192163625987034,228.967457685937,19.8710579867011
9.7,"max_tuv_SVM","SVM",83,6,2084,1963,121,700,563,137,0.824286907745564,0.308270676691729,1.26456463739995,340,137,203,67,1.5,25.14,4.1,0,0,0,0,0,0,0.198083836781397,183.716005517126,20.5923927086039
9.7,"max_tuv_SVM","SVM",83,7,1984,1892,92,800,634,166,0.833339300632543,0.308270676691729,1.26456463739995,407,166,241,67,1.5,28.74,3.8,0,0,0,0,0,0,0.207560923203394,163.348781890836,22.1124815263997
9.7,"max_tuv_SVM","SVM",83,8,1884,1818,66,900,708,192,0.830701754385975,0.278195488721804,1.26456463739995,463,192,271,56,1.4,32.33,3.7,0,0,0,0,0,0,0.210308200380276,176.26289081709,21.6988958284945
9.7,"max_tuv_SVM","SVM",83,9,1784,1739,45,1000,787,213,0.829526196443499,0.285714285714286,1.26456463739995,523,213,310,60,1.5,35.92,3.7,0,0,0,0,0,0,0.210766513739282,149.372967239879,22.008408856897
9.7,"max_tuv_SVM","SVM",83,10,1684,1653,31,1100,873,227,0.822711540756663,0.270676691729323,1.26456463739995,565,227,338,42,1.5,39.51,3.8,0,0,0,0,0,0,0.17903945613962,96.7335611524004,19.0262400917315
9.7,"max_tuv_SVM","SVM",83,11,1584,1561,23,1200,965,235,0.818862632772417,0.233082706766917,1.26456463739995,592,235,357,27,1.5,43.1,4.1,0,0,0,0,0,0,0.156349878894199,79.8824613364296,16.9068580466764
9.7,"max_tuv_SVM","SVM",83,12,1484,1463,21,1300,1063,237,0.813945578231303,0.233082706766917,1.26456463739995,606,237,369,14,1.6,46.7,4.5,0,0,0,0,0,0,0.127617168569121,60.1288603247521,14.387267781872
9.7,"max_tuv_SVM","SVM",83,13,1384,1366,18,1400,1160,240,0.813468194295276,0.225563909774436,1.27421780257094,621,240,381,15,1.6,50.29,4.8,0,0,0,0,0,0,0.0900650901642278,42.855914887497,10.8636836213018
9.7,"max_tuv_SVM","SVM",83,14,1284,1268,16,1500,1258,242,0.82137486573578,0.270676691729323,1.26456463739995,627,242,385,6,1.6,53.88,5.2,0,0,0,0,0,0,0.115258450587822,60.7325537023717,13.6232764943833
9.7,"max_tuv_SVM","SVM",83,15,1184,1169,15,1600,1357,243,0.807805227354111,0.240601503759398,1.25491147222896,645,243,402,18,1.7,57.47,5.6,0,0,0,0,0,0,0.0812420276948689,35.5785062482833,10.3972598264816
9.7,"max_tuv_SVM","SVM",83,16,1084,1071,13,1700,1455,245,0.792785535266748,0.218045112781955,1.25491147222896,658,245,413,13,1.7,61.06,5.9,0,0,0,0,0,0,0.105804838342832,48.7644709995517,14.3355509726722
9.7,"max_tuv_SVM","SVM",83,17,984,971,13,1800,1555,245,0.807518796992492,0.263157894736842,1.27421780257094,655,245,410,-3,1.7,64.66,6.3,0,0,0,0,0,0,0.0738824617126616,32.9111590334328,8.84508368567509
9.7,"max_tuv_SVM","SVM",83,18,884,871,13,1900,1655,245,0.792153001551508,0.195488721804511,1.26456463739995,657,245,412,2,1.7,68.25,6.8,0,0,0,0,0,0,0.0460496678544928,16.7989698981374,5.56394315540023
9.7,"max_tuv_SVM","SVM",83,19,784,775,9,2000,1751,249,0.797684687910264,0.218045112781955,1.27421780257094,690,249,441,33,1.8,71.84,7,0,0,0,0,0,0,0.108124207599029,59.5723447098949,11.6822649322126
9.7,"max_tuv_SVM","SVM",83,20,684,682,2,2100,1844,256,0.779770855710718,0.210526315789474,1.27421780257094,708,256,452,18,1.8,75.43,7.2,0,0,0,0,0,0,0.0383109915003922,12.3467405247854,5.40699992497634
9.7,"max_tuv_SVM","SVM",83,21,584,583,1,2200,1943,257,0.802619644348981,0.233082706766917,1.27421780257094,707,257,450,-1,1.8,79.02,7.6,0,0,0,0,0,0,0.0589920452570895,18.020729280052,7.21151635506518
9.7,"max_tuv_SVM","SVM",83,22,484,483,1,2300,2043,257,0.791108724191444,0.278195488721804,1.27421780257094,714,257,457,7,1.8,82.61,7.9,0,0,0,0,0,0,0.0167478781787481,4.22406548400232,2.57590004093509
9.7,"max_tuv_SVM","SVM",83,23,384,383,1,2400,2143,257,0.758031984723725,0.180451127819549,1.27421780257094,714,257,457,0,1.8,86.21,8.3,0,0,0,0,0,0,0.037477962649647,10.6674241127703,5.03257158424267
9.7,"max_tuv_SVM","SVM",83,24,284,284,0,2500,2242,258,0.780922544456381,0.218045112781955,1.26456463739995,710,258,452,-4,1.8,89.8,8.7,0,0,0,0,0,0,0.0242316988339426,7.97473932741084,7.10691104592697
9.7,"max_tuv_SVM","SVM",83,25,184,184,0,2600,2342,258,0.778150733977809,0.203007518796992,1.27304448967723,715,258,457,5,1.8,93.39,9.1,0,0,0,0,0,0,0.00331265624127591,1.13325850231949,1.08436698131198
9.7,"max_tuv_SVM","SVM",83,26,84,84,0,2700,2442,258,0.802918009308992,0.270676691729323,1.27421780257094,727,258,469,12,1.8,96.98,9.5,0,0,0,0,0,0,6.50233384948306e-09,0.0397167503169752,0.0397167503169752
9.7,"max_tuv_SVM","SVM",83,27,0,0,0,2784,2526,258,0.731865377730045,0.157894736842105,1.27421780257094,727,258,469,0,1.8,100,9.8,0,0,0,0,0,0,0,0,0
9.7,"max_tuv_SVM","SVM",84,0,2684,2427,257,100,91,9,0.695293375394325,0.272,1.15034838709677,32,9,23,0,2.6,3.59,10.1,0,0,0,0,0,0,0.0922055348330751,245.980510832636,9.22759395485429
9.7,"max_tuv_SVM","SVM",84,1,2584,2361,223,200,157,43,0.718410094637229,0.128,1.26332903225806,105,43,62,73,1.4,7.18,3.7,0,0,0,0,0,0,0.235327540469272,534.641277425301,24.4193744231107
9.7,"max_tuv_SVM","SVM",84,2,2484,2269,215,300,249,51,0.730113564668772,0.096,1.23251612903226,140,51,89,35,1.7,10.78,4.9,0,0,0,0,0,0,0.22414224548165,395.544459457355,24.0698138905021
9.7,"max_tuv_SVM","SVM",84,3,2384,2176,208,400,342,58,0.734441640378551,0.232,1.21197419354839,151,58,93,11,1.6,14.37,5.9,0,0,0,0,0,0,0.189238643691372,200.345808564564,22.6161278166911
9.7,"max_tuv_SVM","SVM",84,4,2284,2089,195,500,429,71,0.702630914826504,0.208,1.19143225806452,204,71,133,53,1.9,17.96,6,0,0,0,0,0,0,0.158463104518695,232.659848153126,16.3377804383891
9.7,"max_tuv_SVM","SVM",84,5,2184,2010,174,600,508,92,0.752246056782335,0.256,1.22224516129032,246,92,154,42,1.7,21.55,5.5,0,0,0,0,0,0,0.170897935321341,207.846405794438,17.9763020180249
9.7,"max_tuv_SVM","SVM",84,6,2084,1937,147,700,581,119,0.78704731861199,0.24,1.25305806451613,327,119,208,81,1.7,25.14,4.9,0,0,0,0,0,0,0.178594252699127,245.697776377862,18.4371643431533
9.7,"max_tuv_SVM","SVM",84,7,1984,1863,121,800,655,145,0.814750788643536,0.256,1.26332903225806,382,145,237,55,1.6,28.74,4.5,0,0,0,0,0,0,0.196027185221882,221.743539635624,21.6541597534616
9.7,"max_tuv_SVM","SVM",84,8,1884,1781,103,900,737,163,0.82528075709779,0.312,1.25305806451613,418,163,255,36,1.6,32.33,4.5,0,0,0,0,0,0,0.185275303904626,179.495739984861,19.2620983098981
9.7,"max_tuv_SVM","SVM",84,9,1784,1705,79,1000,813,187,0.823722397476344,0.312,1.25305806451613,486,187,299,68,1.6,35.92,4.3,0,0,0,0,0,0,0.163372239740823,133.263665064682,18.168415243107
9.7,"max_tuv_SVM","SVM",84,10,1684,1623,61,1100,895,205,0.817533123028397,0.28,1.23251612903226,533,205,328,47,1.6,39.51,4.4,0,0,0,0,0,0,0.136636445284598,84.7078394436241,15.7821528345453
9.7,"max_tuv_SVM","SVM",84,11,1584,1534,50,1200,984,216,0.823917981072558,0.28,1.26332903225806,566,216,350,33,1.6,43.1,4.6,0,0,0,0,0,0,0.123109453144647,85.881873635166,14.8907436442659
9.7,"max_tuv_SVM","SVM",84,12,1484,1447,37,1300,1071,229,0.826006309148276,0.272,1.2736,592,229,363,26,1.6,46.7,4.7,0,0,0,0,0,0,0.141616397054251,100.084009047455,17.30336057425
9.7,"max_tuv_SVM","SVM",84,13,1384,1356,28,1400,1162,238,0.838813880126187,0.312,1.2736,620,238,382,28,1.6,50.29,4.9,0,0,0,0,0,0,0.134293452113102,92.1369113362651,15.6725633195331
9.7,"max_tuv_SVM","SVM",84,14,1284,1261,23,1500,1257,243,0.815476340694011,0.208,1.28387096774194,651,243,408,31,1.7,53.88,5.2,0,0,0,0,0,0,0.11824266384163,69.0121069006048,14.478424608701
9.7,"max_tuv_SVM","SVM",84,15,1184,1164,20,1600,1354,246,0.82729968454259,0.264,1.28387096774194,647,246,401,-4,1.6,57.47,5.5,0,0,0,0,0,0,0.104349317357603,54.3247557598287,12.1334958513395
9.7,"max_tuv_SVM","SVM",84,16,1084,1070,14,1700,1448,252,0.827476340694005,0.2,1.28387096774194,682,252,430,35,1.7,61.06,5.7,0,0,0,0,0,0,0.10776637530218,43.8663394688235,13.1337025003302
9.7,"max_tuv_SVM","SVM",84,17,984,976,8,1800,1542,258,0.795854889589904,0.184,1.28387096774194,706,258,448,24,1.7,64.66,6,0,0,0,0,0,0,0.0862336819282038,38.8907299509016,11.5418278533202
9.7,"max_tuv_SVM","SVM",84,18,884,881,3,1900,1637,263,0.800832807570979,0.2,1.28387096774194,718,263,455,12,1.7,68.25,6.2,0,0,0,0,0,0,0.0685649025981569,23.1592205791416,8.54625441363904
9.7,"max_tuv_SVM","SVM",84,19,784,781,3,2000,1737,263,0.814599369085171,0.232,1.28387096774194,712,263,449,-6,1.7,71.84,6.6,0,0,0,0,0,0,0.044228620072998,14.147441000556,5.79882075615169
9.7,"max_tuv_SVM","SVM",84,20,684,681,3,2100,1837,263,0.833141955835963,0.256,1.28387096774194,717,263,454,5,1.7,75.43,7,0,0,0,0,0,0,0.0240451201270273,7.05148851022869,3.30430009389775
9.7,"max_tuv_SVM","SVM",84,21,584,582,2,2200,1936,264,0.780441640378551,0.208,1.28387096774194,737,264,473,20,1.8,79.02,7.3,0,0,0,0,0,0,0.0501188199822088,19.4991052724884,10.9016540515281
9.7,"max_tuv_SVM","SVM",84,22,484,482,2,2300,2036,264,0.827388012618293,0.296,1.28387096774194,742,264,478,5,1.8,82.61,7.7,0,0,0,0,0,0,0.0108154477079928,2.83965806391754,1.89540801934391
9.7,"max_tuv_SVM","SVM",84,23,384,382,2,2400,2136,264,0.803375394321771,0.208,1.28387096774194,735,264,471,-7,1.8,86.21,8.1,0,0,0,0,0,0,0.00501512789731252,1.33438327958287,0.983071958746003
9.7,"max_tuv_SVM","SVM",84,24,284,283,1,2500,2235,265,0.826561514195587,0.288,1.28387096774194,740,265,475,5,1.8,89.8,8.4,0,0,0,0,0,0,0.0021519879022939,4.33560288002765,4.2270296966633
9.7,"max_tuv_SVM","SVM",84,25,184,184,0,2600,2334,266,0.806542586750794,0.224,1.28387096774194,729,266,463,-11,1.7,93.39,8.8,0,0,0,0,0,0,0.000581380390584696,1.17971907958301,1.16826490976147
9.7,"max_tuv_SVM","SVM",84,26,84,84,0,2700,2434,266,0.807123028391168,0.192,1.28387096774194,753,266,487,24,1.8,96.98,9.2,0,0,0,0,0,0,1.0000000994736e-07,0.0274727002597719,0.0274727002597719
9.7,"max_tuv_SVM","SVM",84,27,0,0,0,2784,2518,266,0.804706624605677,0.224,1.28387096774194,732,266,466,-21,1.8,100,9.5,0,0,0,0,0,0,0,0,0
9.7,"max_tuv_SVM","SVM",85,0,2684,2448,236,100,95,5,0.798047733976935,0.24,1.26675268817204,20,5,15,0,3,3.59,19,0,0,0,0,0,0,0.0889799910533154,141.366193397645,10.5577811974073
9.7,"max_tuv_SVM","SVM",85,1,2584,2363,221,200,180,20,0.797114507910957,0.3,1.22395698924731,60,20,40,40,2,7.18,9,0,0,0,0,0,0,0.119323945505185,211.828355536638,13.2849436812561
9.7,"max_tuv_SVM","SVM",85,2,2484,2281,203,300,262,38,0.814808259587007,0.406666666666667,1.22395698924731,99,38,61,39,1.6,10.78,6.9,0,0,0,0,0,0,0.148204740112538,175.358348306892,16.0486009401286
9.7,"max_tuv_SVM","SVM",85,3,2384,2209,175,400,334,66,0.821662644140512,0.366666666666667,1.2410752688172,163,66,97,64,1.5,14.37,5.1,0,0,0,0,0,0,0.184329312537082,187.749039203462,19.0363101076267
9.7,"max_tuv_SVM","SVM",85,4,2284,2142,142,500,401,99,0.803663180477338,0.346666666666667,1.22395698924731,236,99,137,73,1.4,17.96,4.1,0,0,0,0,0,0,0.211621634393193,177.203015695426,24.9109407919476
9.7,"max_tuv_SVM","SVM",85,5,2184,2061,123,600,482,118,0.82413515687851,0.373333333333333,1.24963440860215,280,118,162,44,1.4,21.55,4.1,0,0,0,0,0,0,0.201033730928323,115.943101193874,21.1788368021556
9.7,"max_tuv_SVM","SVM",85,6,2084,1993,91,700,550,150,0.815789755966738,0.346666666666667,1.24963440860215,351,150,201,71,1.3,25.14,3.7,0,0,0,0,0,0,0.214844166361502,143.082684757408,22.7671916169798
9.7,"max_tuv_SVM","SVM",85,7,1984,1908,76,800,635,165,0.811161169214256,0.32,1.2410752688172,389,165,224,38,1.4,28.74,3.8,0,0,0,0,0,0,0.157785367859299,91.2767631761919,18.1415618408281
9.7,"max_tuv_SVM","SVM",85,8,1884,1819,65,900,724,176,0.793467417538207,0.353333333333333,1.22395698924731,409,176,233,20,1.3,32.33,4.1,0,0,0,0,0,0,0.173255906732791,152.379257481979,19.491901161422
9.7,"max_tuv_SVM","SVM",85,9,1784,1725,59,1000,818,182,0.792373290426379,0.306666666666667,1.23251612903226,436,182,254,27,1.4,35.92,4.5,0,0,0,0,0,0,0.168920651145648,98.1087856666018,20.5423870897352
9.7,"max_tuv_SVM","SVM",85,10,1684,1631,53,1100,912,188,0.797312952534189,0.286666666666667,1.2410752688172,440,188,252,4,1.3,39.51,4.9,0,0,0,0,0,0,0.130730169633698,85.5852427131537,15.944919159685
9.7,"max_tuv_SVM","SVM",85,11,1584,1536,48,1200,1007,193,0.794046661303291,0.246666666666667,1.22395698924731,470,193,277,30,1.4,43.1,5.2,0,0,0,0,0,0,0.0904483422507839,46.3935992622319,12.1371544008036
9.7,"max_tuv_SVM","SVM",85,12,1484,1444,40,1300,1099,201,0.816567444355046,0.353333333333333,1.21539784946237,504,201,303,34,1.5,46.7,5.5,0,0,0,0,0,0,0.12189899069326,64.9827032571733,15.1782586700408
9.7,"max_tuv_SVM","SVM",85,13,1384,1358,26,1400,1185,215,0.805486725663704,0.326666666666667,1.22395698924731,533,215,318,29,1.5,50.29,5.5,0,0,0,0,0,0,0.166162415960407,77.5032045286133,19.4136382747039
9.7,"max_tuv_SVM","SVM",85,14,1284,1266,18,1500,1277,223,0.810973451327421,0.333333333333333,1.21539784946237,558,223,335,25,1.5,53.88,5.7,0,0,0,0,0,0,0.122011156448351,54.7637604813068,14.7575585974165
9.7,"max_tuv_SVM","SVM",85,15,1184,1169,15,1600,1374,226,0.802257978010176,0.273333333333333,1.22395698924731,571,226,345,13,1.5,57.47,6.1,0,0,0,0,0,0,0.0839076944968184,35.8204287001156,11.2200456072173
9.7,"max_tuv_SVM","SVM",85,16,1084,1071,13,1700,1472,228,0.794963797264673,0.266666666666667,1.22395698924731,571,228,343,0,1.5,61.06,6.5,0,0,0,0,0,0,0.0723510345337701,31.1018437021314,9.49865358831156
9.7,"max_tuv_SVM","SVM",85,17,984,972,12,1800,1571,229,0.799093590775,0.313333333333333,1.19827956989247,597,229,368,26,1.6,64.66,6.9,0,0,0,0,0,0,0.0794465065469621,29.9653872202859,11.1194337262547
9.7,"max_tuv_SVM","SVM",85,18,884,873,11,1900,1670,230,0.78711718959506,0.286666666666667,1.18972043010753,599,230,369,2,1.6,68.25,7.3,0,0,0,0,0,0,0.0499301357148858,18.4758541971522,7.50957026262252
9.7,"max_tuv_SVM","SVM",85,19,784,773,11,2000,1770,230,0.786468222043436,0.333333333333333,1.20683870967742,600,230,370,1,1.6,71.84,7.7,0,0,0,0,0,0,0.0130598822812179,4.88409699222243,3.16630573569696
9.7,"max_tuv_SVM","SVM",85,20,684,673,11,2100,1870,230,0.796685438455341,0.306666666666667,1.20683870967742,601,230,371,1,1.6,75.43,8.1,0,0,0,0,0,0,0.0175569295513686,6.15454773388253,3.55564617717436
9.7,"max_tuv_SVM","SVM",85,21,584,575,9,2200,1968,232,0.799007776883878,0.36,1.20683870967742,605,232,373,4,1.6,79.02,8.5,0,0,0,0,0,0,0.00667097119474164,2.82239543460069,2.09997454973181
9.7,"max_tuv_SVM","SVM",85,22,484,475,9,2300,2068,232,0.801909359077493,0.333333333333333,1.20683870967742,613,232,381,8,1.6,82.61,8.9,0,0,0,0,0,0,0.00468531638735164,2.27581644310566,1.81908336978149
9.7,"max_tuv_SVM","SVM",85,23,384,378,6,2400,2165,235,0.78487530168946,0.306666666666667,1.18972043010753,625,235,390,12,1.7,86.21,9.2,0,0,0,0,0,0,0.00437230000738795,2.58594665261079,2.26532929484793
9.7,"max_tuv_SVM","SVM",85,24,284,281,3,2500,2262,238,0.772566371681414,0.266666666666667,1.2410752688172,634,238,396,9,1.7,89.8,9.5,0,0,0,0,0,0,0.00257391558524484,2.32623407469013,2.19501538363503
9.7,"max_tuv_SVM","SVM",85,25,184,184,0,2600,2359,241,0.797259318852235,0.28,1.24963440860215,666,241,425,32,1.8,93.39,9.8,0,0,0,0,0,0,0.001324963649129,1.5315538737642,1.47824779068794
9.7,"max_tuv_SVM","SVM",85,26,84,84,0,2700,2459,241,0.786934835076427,0.22,1.2581935483871,653,241,412,-13,1.7,96.98,10.2,0,0,0,0,0,0,7.78204477497801e-07,1.06515321906487,1.06515321906487
9.7,"max_tuv_SVM","SVM",85,27,0,0,0,2784,2543,241,0.749852507374633,0.173333333333333,1.24963440860215,654,241,413,1,1.7,100,10.6,0,0,0,0,0,0,0,0,0
9.7,"max_tuv_SVM","SVM",86,0,2684,2439,245,100,91,9,0.739457901343624,0.328467153284672,1.19952907935013,23,9,14,0,1.6,3.59,10.1,0,0,0,0,0,0,0.213160326387336,233.116954659509,27.2201570336294
9.7,"max_tuv_SVM","SVM",86,1,2584,2365,219,200,165,35,0.75006392672835,0.240875912408759,1.26512832587709,84,35,49,61,1.4,7.18,4.7,0,0,0,0,0,0,0.250905920172711,372.344289687072,29.3070718805815
9.7,"max_tuv_SVM","SVM",86,2,2484,2287,197,300,243,57,0.744496489841463,0.226277372262774,1.26512832587709,147,57,90,63,1.6,10.78,4.3,0,0,0,0,0,0,0.21111750219078,387.278753659419,23.5371470088266
9.7,"max_tuv_SVM","SVM",86,3,2384,2204,180,400,326,74,0.788332790924734,0.240875912408759,1.26512832587709,192,74,118,45,1.6,14.37,4.4,0,0,0,0,0,0,0.20016389350349,335.881150891558,20.9551413819125
9.7,"max_tuv_SVM","SVM",86,4,2284,2113,171,500,417,83,0.803123111255758,0.262773722627737,1.25575700494467,212,83,129,20,1.6,17.96,5,0,0,0,0,0,0,0.179538088641371,208.259119432801,18.3720384982819
9.7,"max_tuv_SVM","SVM",86,5,2184,2039,145,600,491,109,0.818035473522717,0.291970802919708,1.25575700494467,274,109,165,62,1.5,21.55,4.5,0,0,0,0,0,0,0.186919347792398,221.630118799881,19.0677048398288
9.7,"max_tuv_SVM","SVM",86,6,2084,1969,115,700,561,139,0.8271537495932,0.313868613138686,1.25575700494467,336,139,197,62,1.4,25.14,4,0,0,0,0,0,0,0.200187362619858,214.672208730243,20.6468521428725
9.7,"max_tuv_SVM","SVM",86,7,1984,1899,85,800,631,169,0.83563275838022,0.343065693430657,1.25575700494467,417,169,248,81,1.5,28.74,3.7,0,0,0,0,0,0,0.202286209463137,169.173701357066,21.2496909891338
9.7,"max_tuv_SVM","SVM",86,8,1884,1817,67,900,713,187,0.835365428425322,0.313868613138686,1.25575700494467,450,187,263,33,1.4,32.33,3.8,0,0,0,0,0,0,0.199105393940973,188.217414966195,21.1963452018067
9.7,"max_tuv_SVM","SVM",86,9,1784,1725,59,1000,805,195,0.837190245943567,0.321167883211679,1.25575700494467,477,195,282,27,1.4,35.92,4.1,0,0,0,0,0,0,0.173788661307623,132.798804521793,18.8011977161329
9.7,"max_tuv_SVM","SVM",86,10,1684,1633,51,1100,897,203,0.82975731089312,0.343065693430657,1.25575700494467,512,203,309,35,1.5,39.51,4.4,0,0,0,0,0,0,0.166244639856175,114.922601558515,17.6820227583817
9.7,"max_tuv_SVM","SVM",86,11,1584,1540,44,1200,990,210,0.830878934399561,0.335766423357664,1.25575700494467,531,210,321,19,1.5,43.1,4.7,0,0,0,0,0,0,0.148826806710123,81.1172998155617,16.1965628864878
9.7,"max_tuv_SVM","SVM",86,12,1484,1451,33,1300,1079,221,0.814443953693812,0.27007299270073,1.25575700494467,572,221,351,41,1.6,46.7,4.9,0,0,0,0,0,0,0.16148839504665,94.3492224188355,17.0026063186395
9.7,"max_tuv_SVM","SVM",86,13,1384,1357,27,1400,1173,227,0.813955785950077,0.262773722627737,1.25575700494467,595,227,368,23,1.6,50.29,5.2,0,0,0,0,0,0,0.156559944702646,103.485751904257,16.0563332400242
9.7,"max_tuv_SVM","SVM",86,14,1284,1261,23,1500,1269,231,0.824410711795073,0.291970802919708,1.25575700494467,624,231,393,29,1.7,53.88,5.5,0,0,0,0,0,0,0.122675508677944,49.5840023702476,13.2609397367531
9.7,"max_tuv_SVM","SVM",86,15,1184,1162,22,1600,1368,232,0.799519968385337,0.262773722627737,1.25575700494467,627,232,395,3,1.7,57.47,5.9,0,0,0,0,0,0,0.130960005141328,58.9147158731756,13.671312703181
9.7,"max_tuv_SVM","SVM",86,16,1084,1062,22,1700,1468,232,0.786932214421882,0.226277372262774,1.25575700494467,637,232,405,10,1.7,61.06,6.3,0,0,0,0,0,0,0.0984022106985172,32.5836458005646,10.8620212349308
9.7,"max_tuv_SVM","SVM",86,17,984,962,22,1800,1568,232,0.794725463759367,0.226277372262774,1.25575700494467,631,232,399,-6,1.7,64.66,6.8,0,0,0,0,0,0,0.0603563231439656,15.1325942562498,7.2720950325779
9.7,"max_tuv_SVM","SVM",86,18,884,865,19,1900,1665,235,0.780388442047524,0.218978102189781,1.25575700494467,631,235,396,0,1.7,68.25,7.1,0,0,0,0,0,0,0.0732067838423509,17.0734830899625,9.13492065900479
9.7,"max_tuv_SVM","SVM",86,19,784,766,18,2000,1764,236,0.814368403923947,0.277372262773723,1.25575700494467,613,236,377,-18,1.6,71.84,7.5,0,0,0,0,0,0,0.00108873750258063,1.08309370936821,1.06009330331372
9.7,"max_tuv_SVM","SVM",86,20,684,669,15,2100,1861,239,0.775814775210385,0.175182481751825,1.25575700494467,633,239,394,20,1.6,75.43,7.8,0,0,0,0,0,0,0.000371900436991185,0.29791708445224,0.277076915647841
9.7,"max_tuv_SVM","SVM",86,21,584,579,5,2200,1951,249,0.818866520991214,0.248175182481752,1.27449964680951,701,249,452,68,1.8,79.02,7.8,0,0,0,0,0,0,0.11720260889693,34.0488338774957,16.1351135019096
9.7,"max_tuv_SVM","SVM",86,22,484,483,1,2300,2047,253,0.751958482495697,0.131386861313869,1.27449964680951,701,253,448,0,1.8,82.61,8.1,0,0,0,0,0,0,0.0945256718661259,28.3637902868923,11.1554303789175
9.7,"max_tuv_SVM","SVM",86,23,384,383,1,2400,2147,253,0.809416988237482,0.233576642335766,1.27449964680951,711,253,458,10,1.8,86.21,8.5,0,0,0,0,0,0,0.0372982701252698,9.12386134828921,5.41307530814433
9.7,"max_tuv_SVM","SVM",86,24,284,283,1,2500,2247,253,0.779807289971637,0.18978102189781,1.27449964680951,705,253,452,-6,1.8,89.8,8.9,0,0,0,0,0,0,0.0088804385700569,2.40190988296182,2.05347037946318
9.7,"max_tuv_SVM","SVM",86,25,184,183,1,2600,2347,253,0.831739039471853,0.291970802919708,1.27449964680951,706,253,453,1,1.8,93.39,9.3,0,0,0,0,0,0,0.000672097713384091,0.430305529036281,0.408760316816344
9.7,"max_tuv_SVM","SVM",86,26,84,84,0,2700,2446,254,0.809655260588592,0.226277372262774,1.27449964680951,722,254,468,16,1.8,96.98,9.6,0,0,0,0,0,0,0.000282015798012067,2.03840446034175,2.03840446034175
9.7,"max_tuv_SVM","SVM",86,27,0,0,0,2784,2530,254,0.801060021386399,0.262773722627737,1.27449964680951,705,254,451,-17,1.8,100,10,0,0,0,0,0,0,0,0,0
9.7,"max_tuv_SVM","SVM",87,0,2684,2439,245,100,95,5,0.838964040513903,0.24822695035461,1.28387096774194,22,5,17,0,3.4,3.59,19,0,0,0,0,0,0,0.0934053779978661,139.012605601764,10.7074727457377
9.7,"max_tuv_SVM","SVM",87,1,2584,2360,224,200,174,26,0.802489067137971,0.226950354609929,1.28387096774194,74,26,48,52,1.8,7.18,6.7,0,0,0,0,0,0,0.181592200439514,234.094677820179,19.7893989938907
9.7,"max_tuv_SVM","SVM",87,2,2484,2293,191,300,241,59,0.822740353023816,0.283687943262411,1.28387096774194,149,59,90,75,1.5,10.78,4.1,0,0,0,0,0,0,0.239006361364685,181.702655770776,25.4321880883764
9.7,"max_tuv_SVM","SVM",87,3,2384,2217,167,400,317,83,0.831458319171598,0.283687943262411,1.28387096774194,204,83,121,55,1.5,14.37,3.8,0,0,0,0,0,0,0.221098220657647,156.829234582697,23.9905536811169
9.7,"max_tuv_SVM","SVM",87,4,2284,2144,140,500,390,110,0.84013663245191,0.297872340425532,1.28387096774194,272,110,162,68,1.5,17.96,3.5,0,0,0,0,0,0,0.228030546837232,139.082604007807,25.5979807305834
9.7,"max_tuv_SVM","SVM",87,5,2184,2070,114,600,464,136,0.839626809870169,0.304964539007092,1.28387096774194,340,136,204,68,1.5,21.55,3.4,0,0,0,0,0,0,0.204968502475,107.223712868051,23.2962524275247
9.7,"max_tuv_SVM","SVM",87,6,2084,1993,91,700,541,159,0.820219563591873,0.24822695035461,1.28387096774194,389,159,230,49,1.4,25.14,3.4,0,0,0,0,0,0,0.191625793474308,112.277811605748,21.9753975914773
9.7,"max_tuv_SVM","SVM",87,7,1984,1907,77,800,627,173,0.804601998504526,0.24822695035461,1.22923816060398,440,173,267,51,1.5,28.74,3.6,0,0,0,0,0,0,0.209496488303148,190.469195444477,24.4741870197082
9.7,"max_tuv_SVM","SVM",87,8,1884,1822,62,900,712,188,0.818202932046319,0.269503546099291,1.26566003202928,468,188,280,28,1.5,32.33,3.8,0,0,0,0,0,0,0.199326069331846,194.523485142333,27.7948049668144
9.7,"max_tuv_SVM","SVM",87,9,1784,1731,53,1000,803,197,0.822525094600419,0.312056737588652,1.25655456417296,489,197,292,21,1.5,35.92,4.1,0,0,0,0,0,0,0.178704244369479,117.992517398704,18.9013451912043
9.7,"max_tuv_SVM","SVM",87,10,1684,1646,38,1100,888,212,0.816758434731391,0.24822695035461,1.24744909631663,545,212,333,56,1.6,39.51,4.2,0,0,0,0,0,0,0.182571991713971,131.905692334733,22.6994315286969
9.7,"max_tuv_SVM","SVM",87,11,1584,1562,22,1200,972,228,0.820429157319928,0.269503546099291,1.24744909631663,594,228,366,49,1.6,43.1,4.3,0,0,0,0,0,0,0.170535338808586,122.286104259571,17.9948868942189
9.7,"max_tuv_SVM","SVM",87,12,1484,1465,19,1300,1069,231,0.821318514490299,0.269503546099291,1.24744909631663,604,231,373,10,1.6,46.7,4.6,0,0,0,0,0,0,0.140138404875746,82.958484480735,15.1484643017869
9.7,"max_tuv_SVM","SVM",87,13,1384,1366,18,1400,1168,232,0.819992975777771,0.297872340425532,1.24744909631663,610,232,378,6,1.6,50.29,5,0,0,0,0,0,0,0.11898433377574,65.8655882943808,12.98777593094
9.7,"max_tuv_SVM","SVM",87,14,1284,1267,17,1500,1267,233,0.80869757324452,0.24113475177305,1.24744909631663,612,233,379,2,1.6,53.88,5.4,0,0,0,0,0,0,0.0779939843192832,34.2625365310029,9.13794087832897
9.7,"max_tuv_SVM","SVM",87,15,1184,1169,15,1600,1365,235,0.797492805836912,0.212765957446809,1.22013269274766,611,235,376,-1,1.6,57.47,5.8,0,0,0,0,0,0,0.0905705316461243,44.0092383785628,12.3420638358322
9.7,"max_tuv_SVM","SVM",87,16,1084,1070,14,1700,1464,236,0.793958035936836,0.219858156028369,1.22013269274766,615,236,379,4,1.6,61.06,6.2,0,0,0,0,0,0,0.0722867334090936,30.7168369871096,10.3920868473154
9.7,"max_tuv_SVM","SVM",87,17,984,971,13,1800,1563,237,0.787432306890544,0.191489361702128,1.22013269274766,620,237,383,5,1.6,64.66,6.6,0,0,0,0,0,0,0.0885343092775742,42.8650790796805,10.0858366388921
9.7,"max_tuv_SVM","SVM",87,18,884,871,13,1900,1663,237,0.778368794326248,0.219858156028369,1.22013269274766,622,237,385,2,1.6,68.25,7,0,0,0,0,0,0,0.0656542850000111,29.7708460402437,7.59777263294012
9.7,"max_tuv_SVM","SVM",87,19,784,771,13,2000,1763,237,0.775111594498453,0.234042553191489,1.22013269274766,620,237,383,-2,1.6,71.84,7.4,0,0,0,0,0,0,0.0268798183660537,8.60032576886973,3.71348639921453
9.7,"max_tuv_SVM","SVM",87,20,684,672,12,2100,1862,238,0.778997575510397,0.219858156028369,1.22013269274766,634,238,396,14,1.7,75.43,7.8,0,0,0,0,0,0,0.0234993220087822,7.64259431086346,3.19667259546276
9.7,"max_tuv_SVM","SVM",87,21,584,573,11,2200,1961,239,0.787001790043741,0.24113475177305,1.22923816060398,624,239,385,-10,1.6,79.02,8.2,0,0,0,0,0,0,0.0130166644851354,3.84149655420657,1.81703625089197
9.7,"max_tuv_SVM","SVM",87,22,484,475,9,2300,2059,241,0.732411120929923,0.141843971631206,1.21102722489133,652,241,411,28,1.7,82.61,8.5,0,0,0,0,0,0,0.0494249807927531,15.708794870747,9.63134690247216
9.7,"max_tuv_SVM","SVM",87,23,384,376,8,2400,2158,242,0.795419527337828,0.276595744680851,1.21102722489133,659,242,417,7,1.7,86.21,8.9,0,0,0,0,0,0,0.0119129853125825,5.95042170198904,4.85896287792581
9.7,"max_tuv_SVM","SVM",87,24,284,277,7,2500,2257,243,0.702269276958292,0.120567375886525,1.21102722489133,669,243,426,10,1.8,89.8,9.3,0,0,0,0,0,0,0.00952954768920573,2.25127391013292,1.46669050492063
9.7,"max_tuv_SVM","SVM",87,25,184,183,1,2600,2351,249,0.743106065755788,0.134751773049645,1.26566003202928,688,249,439,19,1.8,93.39,9.4,0,0,0,0,0,0,0.0036875295823266,2.46286509574232,2.42840645250309
9.7,"max_tuv_SVM","SVM",87,26,84,84,0,2700,2450,250,0.740256723993388,0.156028368794326,1.26566003202928,687,250,437,-1,1.7,96.98,9.8,0,0,0,0,0,0,9.35855491426504e-06,0.814791566828325,0.814791566828325
9.7,"max_tuv_SVM","SVM",87,27,0,0,0,2784,2534,250,0.742137402850479,0.141843971631206,1.26566003202928,698,250,448,11,1.8,100,10.1,0,0,0,0,0,0,0,0,0
9.7,"max_tuv_SVM","SVM",88,0,2684,2437,247,100,91,9,0.296543602425955,0,0.884444444444444,30,9,21,0,2.3,3.59,10.1,0,0,0,0,0,0,0.10722181476408,231.407978443099,11.0637891066331
9.7,"max_tuv_SVM","SVM",88,1,2584,2337,247,200,191,9,0.695701583936878,0.103703703703704,1.26485065710872,33,9,24,3,2.7,7.18,21.2,0,0,0,0,0,0,0.0572853092526618,134.185033222805,6.89061047046328
9.7,"max_tuv_SVM","SVM",88,2,2484,2246,238,300,282,18,0.633892716245656,0.155555555555556,1.22681003584229,68,18,50,35,2.8,10.78,15.7,0,0,0,0,0,0,0.0917912061307338,189.363436049637,9.61379776934611
9.7,"max_tuv_SVM","SVM",88,3,2384,2160,224,400,368,32,0.645969498910679,0.162962962962963,1.17925925925926,97,32,65,29,2,14.37,11.5,0,0,0,0,0,0,0.116180948326665,195.933815915621,13.9490483977925
9.7,"max_tuv_SVM","SVM",88,4,2284,2070,214,500,458,42,0.749991167638234,0.259259259259259,1.16974910394265,125,42,83,28,2,17.96,10.9,0,0,0,0,0,0,0.106406019026318,176.028825357959,11.1885642291536
9.7,"max_tuv_SVM","SVM",88,5,2184,2004,180,600,524,76,0.75267620561739,0.237037037037037,1.19827956989247,203,76,127,78,1.7,21.55,6.9,0,0,0,0,0,0,0.152318873367963,207.044852116707,15.7457782598678
9.7,"max_tuv_SVM","SVM",88,6,2084,1924,160,700,604,96,0.740269681446161,0.244444444444444,1.17925925925926,253,96,157,50,1.6,25.14,6.3,0,0,0,0,0,0,0.15421588904244,169.484327415009,16.0753875897308
9.7,"max_tuv_SVM","SVM",88,7,1984,1841,143,800,687,113,0.759553671318384,0.288888888888889,1.18876941457587,281,113,168,28,1.5,28.74,6.1,0,0,0,0,0,0,0.163623360514957,169.837409618212,16.86704918474
9.7,"max_tuv_SVM","SVM",88,8,1884,1767,117,900,761,139,0.771406700818476,0.281481481481481,1.20778972520908,349,139,210,68,1.5,32.33,5.5,0,0,0,0,0,0,0.17624985358035,163.937312180226,18.2798027473651
9.7,"max_tuv_SVM","SVM",88,9,1784,1697,87,1000,831,169,0.771436142024389,0.303703703703704,1.19827956989247,419,169,250,70,1.5,35.92,4.9,0,0,0,0,0,0,0.174973779086001,138.336196791257,18.8218966566921
9.7,"max_tuv_SVM","SVM",88,10,1684,1625,59,1100,903,197,0.77284343166697,0.259259259259259,1.19827956989247,485,197,288,66,1.5,39.51,4.6,0,0,0,0,0,0,0.173441048250307,118.880179236919,18.9469712073
9.7,"max_tuv_SVM","SVM",88,11,1584,1533,51,1200,995,205,0.773061296590718,0.274074074074074,1.20778972520908,512,205,307,27,1.5,43.1,4.9,0,0,0,0,0,0,0.166209351447554,124.542593234073,18.1005445785396
9.7,"max_tuv_SVM","SVM",88,12,1484,1437,47,1300,1091,209,0.777501030442217,0.281481481481481,1.20778972520908,537,209,328,25,1.6,46.7,5.2,0,0,0,0,0,0,0.139450284393511,97.9674152373065,15.1676542160556
9.7,"max_tuv_SVM","SVM",88,13,1384,1343,41,1400,1185,215,0.766484131190023,0.296296296296296,1.20778972520908,560,215,345,23,1.6,50.29,5.5,0,0,0,0,0,0,0.145939183638924,89.6276897014863,15.7127071540804
9.7,"max_tuv_SVM","SVM",88,14,1284,1243,41,1500,1285,215,0.777783666018968,0.311111111111111,1.19827956989247,567,215,352,7,1.6,53.88,6,0,0,0,0,0,0,0.102522805936079,53.4103976110123,11.3395799130788
9.7,"max_tuv_SVM","SVM",88,15,1184,1145,39,1600,1383,217,0.793069540128375,0.325925925925926,1.19827956989247,555,217,338,-12,1.6,57.47,6.4,0,0,0,0,0,0,0.0984650292333045,48.2858583149709,12.1285971210095
9.7,"max_tuv_SVM","SVM",88,16,1084,1065,19,1700,1463,237,0.782517811929587,0.214814814814815,1.18876941457587,625,237,388,70,1.6,61.06,6.2,0,0,0,0,0,0,0.125297271296974,68.4072959170213,14.3964214607609
9.7,"max_tuv_SVM","SVM",88,17,984,973,11,1800,1555,245,0.752723311546849,0.185185185185185,1.18876941457587,644,245,399,19,1.6,64.66,6.3,0,0,0,0,0,0,0.0971660187725888,46.1412029200941,10.8282987241443
9.7,"max_tuv_SVM","SVM",88,18,884,873,11,1900,1655,245,0.770700111876591,0.207407407407407,1.18876941457587,649,245,404,5,1.6,68.25,6.8,0,0,0,0,0,0,0.0702394585939887,29.5682446287679,8.12591546694787
9.7,"max_tuv_SVM","SVM",88,19,784,773,11,2000,1755,245,0.746393452275813,0.177777777777778,1.18876941457587,647,245,402,-2,1.6,71.84,7.2,0,0,0,0,0,0,0.0542147070494112,20.4962493793973,6.34756701126935
9.7,"max_tuv_SVM","SVM",88,20,684,674,10,2100,1854,246,0.767084731790624,0.207407407407407,1.19827956989247,651,246,405,4,1.6,75.43,7.5,0,0,0,0,0,0,0.0382082247886285,12.4459446740675,4.66595202658382
9.7,"max_tuv_SVM","SVM",88,21,584,574,10,2200,1954,246,0.781758228817059,0.244444444444444,1.18876941457587,643,246,397,-8,1.6,79.02,7.9,0,0,0,0,0,0,0.0172403605774968,4.79818256855159,2.46320788992828
9.7,"max_tuv_SVM","SVM",88,22,484,474,10,2300,2054,246,0.754907849025506,0.222222222222222,1.18876941457587,646,246,400,3,1.6,82.61,8.3,0,0,0,0,0,0,0.00634683986408601,1.60278756499512,1.18719875725653
9.7,"max_tuv_SVM","SVM",88,23,384,377,7,2400,2151,249,0.785665076841549,0.244444444444444,1.22568037650911,665,249,416,19,1.7,86.21,8.6,0,0,0,0,0,0,0.0203163006076087,7.24443238403605,5.59853912864828
9.7,"max_tuv_SVM","SVM",88,24,284,277,7,2500,2251,249,0.776732614967913,0.207407407407407,1.21617897824159,677,249,428,12,1.7,89.8,9,0,0,0,0,0,0,0.00738363787568064,1.88453054888351,1.41416537753815
9.7,"max_tuv_SVM","SVM",88,25,184,177,7,2600,2351,249,0.751804745922395,0.177777777777778,1.21729988052569,671,249,422,-6,1.7,93.39,9.4,0,0,0,0,0,0,0.00296686304404824,0.638243809700816,0.604527407660328
9.7,"max_tuv_SVM","SVM",88,26,84,82,2,2700,2446,254,0.805493729023151,0.251851851851852,1.27436081242533,685,254,431,14,1.7,96.98,9.6,0,0,0,0,0,0,3.96438474879699e-06,3.01438238049063,3.01438238049063
9.7,"max_tuv_SVM","SVM",88,27,0,0,0,2784,2528,256,0.750927397986228,0.2,1.26485065710872,700,256,444,15,1.7,100,9.9,0,0,0,0,0,0,0,0,0
9.7,"max_tuv_SVM","SVM",89,0,2684,2437,247,100,89,11,0.69630624179497,0.195488721804511,1.21629881154499,33,11,22,0,2,3.59,8.1,0,0,0,0,0,0,0.129434996114944,292.172427764419,15.586278279601
9.7,"max_tuv_SVM","SVM",89,1,2584,2339,245,200,187,13,0.657703783267693,0.270676691729323,1.06184816880912,42,13,29,9,2.2,7.18,14.4,0,0,0,0,0,0,0.0791457527635833,176.162835991234,8.42411276561474
9.7,"max_tuv_SVM","SVM",89,2,2484,2266,218,300,260,40,0.689652703186545,0.195488721804511,1.19699248120301,110,40,70,68,1.8,10.78,6.5,0,0,0,0,0,0,0.178731485105662,342.122548986334,20.2137148957528
9.7,"max_tuv_SVM","SVM",89,3,2384,2183,201,400,343,57,0.723517126148709,0.157894736842105,1.25491147222896,154,57,97,44,1.7,14.37,6,0,0,0,0,0,0,0.158554355868208,314.795373246658,17.406202533438
9.7,"max_tuv_SVM","SVM",89,4,2284,2094,190,500,432,68,0.743179377013971,0.203007518796992,1.24525830705797,183,68,115,29,1.7,17.96,6.4,0,0,0,0,0,0,0.198397099132595,278.940646062684,26.4122509316607
9.7,"max_tuv_SVM","SVM",89,5,2184,2005,179,600,521,79,0.745482754505325,0.255639097744361,1.26456463739995,211,79,132,28,1.7,21.55,6.6,0,0,0,0,0,0,0.139585965779416,248.581229815012,14.2926175049906
9.7,"max_tuv_SVM","SVM",89,6,2084,1921,163,700,605,95,0.771028762382158,0.24812030075188,1.27421780257094,256,95,161,45,1.7,25.14,6.4,0,0,0,0,0,0,0.140871624585729,228.15093097619,14.5071509566669
9.7,"max_tuv_SVM","SVM",89,7,1984,1842,142,800,684,116,0.751724549468909,0.233082706766917,1.26456463739995,303,116,187,47,1.6,28.74,5.9,0,0,0,0,0,0,0.149222786882872,218.785599021213,15.2849509774429
9.7,"max_tuv_SVM","SVM",89,8,1884,1759,125,900,767,133,0.785588972431077,0.24812030075188,1.27421780257094,343,133,210,40,1.6,32.33,5.8,0,0,0,0,0,0,0.152494885936687,212.23187406657,15.5911485127522
9.7,"max_tuv_SVM","SVM",89,9,1784,1684,100,1000,842,158,0.783876357560567,0.24812030075188,1.28387096774194,403,158,245,60,1.6,35.92,5.3,0,0,0,0,0,0,0.159252016026417,181.463933619258,16.6287610570105
9.7,"max_tuv_SVM","SVM",89,10,1684,1598,86,1100,928,172,0.785463659147869,0.24812030075188,1.28387096774194,442,172,270,39,1.6,39.51,5.4,0,0,0,0,0,0,0.152279872692943,167.120131791251,16.0505530258455
9.7,"max_tuv_SVM","SVM",89,11,1584,1519,65,1200,1007,193,0.810782909655092,0.263157894736842,1.28387096774194,498,193,305,56,1.6,43.1,5.2,0,0,0,0,0,0,0.155908227590361,149.809044483864,16.4587598971506
9.7,"max_tuv_SVM","SVM",89,12,1484,1434,50,1300,1092,208,0.81509726697697,0.263157894736842,1.27421780257094,534,208,326,36,1.6,46.7,5.2,0,0,0,0,0,0,0.145683141365533,115.104386447599,15.6785142412989
9.7,"max_tuv_SVM","SVM",89,13,1384,1351,33,1400,1175,225,0.833780880773364,0.315789473684211,1.28387096774194,579,225,354,45,1.6,50.29,5.2,0,0,0,0,0,0,0.149391813491633,138.235662663075,16.2151488743672
9.7,"max_tuv_SVM","SVM",89,14,1284,1266,18,1500,1260,240,0.811988304093569,0.210526315789474,1.27421780257094,629,240,389,50,1.6,53.88,5.2,0,0,0,0,0,0,0.135887317892102,87.7242352279973,14.6587985698125
9.7,"max_tuv_SVM","SVM",89,15,1184,1170,14,1600,1356,244,0.831555078171619,0.293233082706767,1.27421780257094,644,244,400,15,1.6,57.47,5.6,0,0,0,0,0,0,0.136352314418292,108.604571156782,14.3484175482544
9.7,"max_tuv_SVM","SVM",89,16,1084,1075,9,1700,1451,249,0.812131519274377,0.24812030075188,1.26456463739995,667,249,418,23,1.7,61.06,5.8,0,0,0,0,0,0,0.112616273109495,66.1503433738817,12.3860154898972
9.7,"max_tuv_SVM","SVM",89,17,984,978,6,1800,1548,252,0.815920754266618,0.255639097744361,1.26456463739995,673,252,421,6,1.7,64.66,6.1,0,0,0,0,0,0,0.116507130935302,74.4550058838286,12.4619455862169
9.7,"max_tuv_SVM","SVM",89,18,884,878,6,1900,1648,252,0.827479412817758,0.278195488721804,1.26456463739995,684,252,432,11,1.7,68.25,6.5,0,0,0,0,0,0,0.0874885192312511,39.7369064600744,9.53615045695109
9.7,"max_tuv_SVM","SVM",89,19,784,779,5,2000,1747,253,0.816935195130686,0.263157894736842,1.27421780257094,682,253,429,-2,1.7,71.84,6.9,0,0,0,0,0,0,0.0420786918980986,13.0623856958723,5.54560612036049
9.7,"max_tuv_SVM","SVM",89,20,684,680,4,2100,1846,254,0.808067788518914,0.240601503759398,1.26456463739995,686,254,432,4,1.7,75.43,7.3,0,0,0,0,0,0,0.0239255779366969,6.73990469464678,3.60543895197571
9.7,"max_tuv_SVM","SVM",89,21,584,581,3,2200,1945,255,0.816069936746631,0.225563909774436,1.26456463739995,686,255,431,0,1.7,79.02,7.6,0,0,0,0,0,0,0.0199535929221047,6.40177828581303,3.0977796418116
9.7,"max_tuv_SVM","SVM",89,22,484,481,3,2300,2045,255,0.817132116004302,0.233082706766917,1.27421780257094,680,255,425,-6,1.7,82.61,8,0,0,0,0,0,0,0.00946984472161531,2.94481302437815,1.67566335258212
9.7,"max_tuv_SVM","SVM",89,23,384,383,1,2400,2143,257,0.811564625850345,0.240601503759398,1.27421780257094,700,257,443,20,1.7,86.21,8.3,0,0,0,0,0,0,0.0146584288423284,6.24888060231191,4.7791495553077
9.7,"max_tuv_SVM","SVM",89,24,284,283,1,2500,2243,257,0.830134860961934,0.300751879699248,1.27421780257094,723,257,466,23,1.8,89.8,8.7,0,0,0,0,0,0,7.94946636793561e-05,0.0433871326897979,0.0396244225310349
9.7,"max_tuv_SVM","SVM",89,25,184,184,0,2600,2342,258,0.770760233918131,0.180451127819549,1.26456463739995,753,258,495,30,1.9,93.39,9.1,0,0,0,0,0,0,0.00090855535363761,7.03178947029663,7.01216525376856
9.7,"max_tuv_SVM","SVM",89,26,84,84,0,2700,2442,258,0.79779806659506,0.195488721804511,1.27421780257094,714,258,456,-39,1.8,96.98,9.5,0,0,0,0,0,0,6.07285814947234e-07,0.0185517894549516,0.0185517894549516
9.7,"max_tuv_SVM","SVM",89,27,0,0,0,2784,2526,258,0.780128893662731,0.218045112781955,1.27421780257094,704,258,446,-10,1.7,100,9.8,0,0,0,0,0,0,0,0,0
9.7,"max_tuv_SVM","SVM",90,0,2684,2418,266,100,93,7,0.824858757062151,0.279661016949153,1.26211044286495,23,7,16,0,2.3,3.59,13.3,0,0,0,0,0,0,0.0978941574623581,203.531775235108,11.4816408242051
9.7,"max_tuv_SVM","SVM",90,1,2584,2344,240,200,167,33,0.819853772017287,0.211864406779661,1.26211044286495,87,33,54,64,1.6,7.18,5.1,0,0,0,0,0,0,0.183400684646219,383.801938862464,19.3175156600585
9.7,"max_tuv_SVM","SVM",90,2,2484,2262,222,300,249,51,0.82227318045863,0.23728813559322,1.25123018042646,137,51,86,50,1.7,10.78,4.9,0,0,0,0,0,0,0.199051488299394,177.169388612968,21.4608645016938
9.7,"max_tuv_SVM","SVM",90,3,2384,2192,192,400,319,81,0.816869391824534,0.245762711864407,1.24034991798797,197,81,116,60,1.4,14.37,3.9,0,0,0,0,0,0,0.209522915534088,166.182116972608,22.213795166059
9.7,"max_tuv_SVM","SVM",90,4,2284,2135,149,500,376,124,0.808667331339322,0.26271186440678,1.24034991798797,286,124,162,89,1.3,17.96,3,0,0,0,0,0,0,0.226952399804584,241.347928585744,24.0359467505941
9.7,"max_tuv_SVM","SVM",90,5,2184,2063,121,600,448,152,0.80498504486541,0.23728813559322,1.24034991798797,357,152,205,71,1.3,21.55,2.9,0,0,0,0,0,0,0.239379924257703,182.649367112174,25.1531091892556
9.7,"max_tuv_SVM","SVM",90,6,2084,1977,107,700,534,166,0.805948820206055,0.203389830508475,1.26211044286495,400,166,234,43,1.4,25.14,3.2,0,0,0,0,0,0,0.205065726014152,124.636990786235,22.6040159759855
9.7,"max_tuv_SVM","SVM",90,7,1984,1901,83,800,610,190,0.809099368560991,0.23728813559322,1.25123018042646,451,190,261,51,1.4,28.74,3.2,0,0,0,0,0,0,0.199448584537774,145.42526309413,22.5032337986671
9.7,"max_tuv_SVM","SVM",90,8,1884,1828,56,900,683,217,0.815942173479568,0.220338983050847,1.22833754721104,514,217,297,63,1.4,32.33,3.1,0,0,0,0,0,0,0.225604799687107,214.367887146166,24.9976034564659
9.7,"max_tuv_SVM","SVM",90,9,1784,1734,50,1000,777,223,0.826985709538059,0.228813559322034,1.26211044286495,538,223,315,24,1.4,35.92,3.5,0,0,0,0,0,0,0.196837726781717,147.26847854706,20.6204846244218
9.7,"max_tuv_SVM","SVM",90,10,1684,1649,35,1100,862,238,0.819302093718851,0.26271186440678,1.24034991798797,579,238,341,41,1.4,39.51,3.6,0,0,0,0,0,0,0.177314234941928,110.563724298002,19.5912891299068
9.7,"max_tuv_SVM","SVM",90,11,1584,1557,27,1200,954,246,0.816231306081762,0.211864406779661,1.22946965554948,608,246,362,29,1.5,43.1,3.9,0,0,0,0,0,0,0.146201879321859,100.415447971416,16.4296940669182
9.7,"max_tuv_SVM","SVM",90,12,1484,1460,24,1300,1051,249,0.835759388501172,0.296610169491525,1.24034991798797,621,249,372,13,1.5,46.7,4.2,0,0,0,0,0,0,0.150333697011435,69.7970128737345,17.1137005329552
9.7,"max_tuv_SVM","SVM",90,13,1384,1362,22,1400,1149,251,0.801528747092065,0.161016949152542,1.24034991798797,624,251,373,3,1.5,50.29,4.6,0,0,0,0,0,0,0.114871295232457,43.9967164248738,13.3662614954861
9.7,"max_tuv_SVM","SVM",90,14,1284,1263,21,1500,1248,252,0.811385842472592,0.203389830508475,1.21858939311099,639,252,387,15,1.5,53.88,5,0,0,0,0,0,0,0.101688758636125,38.2474793164126,12.3308416637201
9.7,"max_tuv_SVM","SVM",90,15,1184,1165,19,1600,1346,254,0.819727484214035,0.271186440677966,1.21858939311099,641,254,387,2,1.5,57.47,5.3,0,0,0,0,0,0,0.105060079147642,37.6555835135217,12.6312761874593
9.7,"max_tuv_SVM","SVM",90,16,1084,1066,18,1700,1445,255,0.80073778664009,0.194915254237288,1.21858939311099,655,255,400,14,1.6,61.06,5.7,0,0,0,0,0,0,0.0889366705601851,33.4580505478525,11.0119488265704
9.7,"max_tuv_SVM","SVM",90,17,984,966,18,1800,1545,255,0.815260884014633,0.288135593220339,1.21858939311099,668,255,413,13,1.6,64.66,6.1,0,0,0,0,0,0,0.0513492929152983,13.253723039673,6.28041187995683
9.7,"max_tuv_SVM","SVM",90,18,884,868,16,1900,1643,257,0.7796410767697,0.169491525423729,1.21858939311099,671,257,414,3,1.6,68.25,6.4,0,0,0,0,0,0,0.0233365881850304,6.13115855670441,3.99919056780477
9.7,"max_tuv_SVM","SVM",90,19,784,770,14,2000,1741,259,0.800511797939524,0.211864406779661,1.21858939311099,667,259,408,-4,1.6,71.84,6.7,0,0,0,0,0,0,0.0193077110231754,6.5977883173448,2.97550187327
9.7,"max_tuv_SVM","SVM",90,20,684,671,13,2100,1840,260,0.785350614822209,0.161016949152542,1.21858939311099,663,260,403,-4,1.6,75.43,7.1,0,0,0,0,0,0,0.0121062972997455,3.7950848363235,1.95000586835506
9.7,"max_tuv_SVM","SVM",90,21,584,575,9,2200,1936,264,0.816650049850458,0.288135593220339,1.21858939311099,696,264,432,33,1.6,79.02,7.3,0,0,0,0,0,0,0.0214564761331984,6.79886009475056,3.98242162543511
9.7,"max_tuv_SVM","SVM",90,22,484,475,9,2300,2036,264,0.806759720837496,0.23728813559322,1.22946965554948,686,264,422,-10,1.6,82.61,7.7,0,0,0,0,0,0,0.0078658500677588,2.29047023378822,1.25640012520034
9.7,"max_tuv_SVM","SVM",90,23,384,376,8,2400,2135,265,0.801222997673655,0.211864406779661,1.2077091306725,696,265,431,10,1.6,86.21,8.1,0,0,0,0,0,0,0.0160793218021828,4.55751639456744,2.37255777029605
9.7,"max_tuv_SVM","SVM",90,24,284,282,2,2500,2229,271,0.814622798271857,0.211864406779661,1.25123018042646,732,271,461,36,1.7,89.8,8.2,0,0,0,0,0,0,0.0014779050451675,2.67623608906108,2.60494987089436
9.7,"max_tuv_SVM","SVM",90,25,184,184,0,2600,2327,273,0.814184114323701,0.186440677966102,1.26211044286495,719,273,446,-13,1.6,93.39,8.5,0,0,0,0,0,0,0.00391147877577233,1.01921649032298,0.851739978012408
9.7,"max_tuv_SVM","SVM",90,26,84,84,0,2700,2427,273,0.835041542040551,0.271186440677966,1.27299070530344,732,273,459,13,1.7,96.98,8.9,0,0,0,0,0,0,9.73502431475047e-06,0.0666824545530881,0.0666824545530881
9.7,"max_tuv_SVM","SVM",90,27,0,0,0,2784,2511,273,0.809132602193424,0.228813559322034,1.28387096774194,732,273,459,0,1.7,100,9.2,0,0,0,0,0,0,0,0,0
9.7,"max_tuv_SVM","SVM",91,0,2684,2431,253,100,94,6,0.86156970177587,0.371212121212121,1.27414467253177,20,6,14,0,2.3,3.59,15.7,0,0,0,0,0,0,0.0766689241228643,157.99534934362,8.01789491374241
9.7,"max_tuv_SVM","SVM",91,1,2584,2366,218,200,159,41,0.817797322951954,0.303030303030303,1.25469208211144,102,41,61,82,1.5,7.18,3.9,0,0,0,0,0,0,0.275151516400541,373.531690804515,31.9894631523213
9.7,"max_tuv_SVM","SVM",91,2,2484,2291,193,300,234,66,0.769014490663975,0.242424242424242,1.17688172043011,165,66,99,63,1.5,10.78,3.5,0,0,0,0,0,0,0.22409204458391,476.292750199379,23.66372482494
9.7,"max_tuv_SVM","SVM",91,3,2384,2202,182,400,323,77,0.794102804412088,0.340909090909091,1.18660801564027,193,77,116,28,1.5,14.37,4.2,0,0,0,0,0,0,0.213988031237635,293.851068911403,22.3519855830766
9.7,"max_tuv_SVM","SVM",91,4,2284,2125,159,500,400,100,0.799263451325311,0.325757575757576,1.20606060606061,243,100,143,50,1.4,17.96,4,0,0,0,0,0,0,0.211067888640469,211.409438882403,21.765843062385
9.7,"max_tuv_SVM","SVM",91,5,2184,2051,133,600,474,126,0.797190781726863,0.318181818181818,1.20606060606061,311,126,185,68,1.5,21.55,3.8,0,0,0,0,0,0,0.217592247655551,275.973351914945,22.0381119770801
9.7,"max_tuv_SVM","SVM",91,6,2084,1980,104,700,545,155,0.798746785860185,0.318181818181818,1.19633431085044,388,155,233,77,1.5,25.14,3.5,0,0,0,0,0,0,0.233482327068199,233.705018245334,23.7479521757426
9.7,"max_tuv_SVM","SVM",91,7,1984,1911,73,800,614,186,0.789687117006703,0.310606060606061,1.19633431085044,454,186,268,66,1.4,28.74,3.3,0,0,0,0,0,0,0.242083490201166,187.592059817884,24.8200642943284
9.7,"max_tuv_SVM","SVM",91,8,1884,1826,58,900,699,201,0.785559801023716,0.257575757575758,1.19633431085044,503,201,302,49,1.5,32.33,3.5,0,0,0,0,0,0,0.22701146617165,174.402640822739,23.7703910740914
9.7,"max_tuv_SVM","SVM",91,9,1784,1732,52,1000,793,207,0.790594285439646,0.303030303030303,1.22551319648094,522,207,315,19,1.5,35.92,3.8,0,0,0,0,0,0,0.18860578550561,123.38056769171,19.9004589623503
9.7,"max_tuv_SVM","SVM",91,10,1684,1640,44,1100,885,215,0.789975488429095,0.272727272727273,1.20606060606061,542,215,327,20,1.5,39.51,4.1,0,0,0,0,0,0,0.171527357949314,90.6345096132493,18.6656891471531
9.7,"max_tuv_SVM","SVM",91,11,1584,1547,37,1200,978,222,0.796704154951576,0.303030303030303,1.21578690127077,559,222,337,17,1.5,43.1,4.4,0,0,0,0,0,0,0.154196107149219,71.9591269420044,16.8439603328651
9.7,"max_tuv_SVM","SVM",91,12,1484,1455,29,1300,1070,230,0.804081657174443,0.303030303030303,1.21578690127077,580,230,350,21,1.5,46.7,4.7,0,0,0,0,0,0,0.133782086284653,45.4865225852487,15.3997134382587
9.7,"max_tuv_SVM","SVM",91,13,1384,1357,27,1400,1168,232,0.781480546944469,0.242424242424242,1.21578690127077,596,232,364,16,1.6,50.29,5,0,0,0,0,0,0,0.0727286366062558,19.6414990348241,9.61780138763145
9.7,"max_tuv_SVM","SVM",91,14,1284,1260,24,1500,1265,235,0.790005527118928,0.303030303030303,1.20606060606061,606,235,371,10,1.6,53.88,5.4,0,0,0,0,0,0,0.067547108465802,18.422845770448,9.71811428863385
9.7,"max_tuv_SVM","SVM",91,15,1184,1160,24,1600,1365,235,0.780528320476774,0.234848484848485,1.20606060606061,600,235,365,-6,1.6,57.47,5.8,0,0,0,0,0,0,0.0326589411296988,8.87408916093916,5.4779780802432
9.7,"max_tuv_SVM","SVM",91,16,1084,1061,23,1700,1464,236,0.781435488909722,0.272727272727273,1.20606060606061,619,236,383,19,1.6,61.06,6.2,0,0,0,0,0,0,0.0449146976607142,11.6597199853636,7.3090946479039
9.7,"max_tuv_SVM","SVM",91,17,984,963,21,1800,1562,238,0.767278254391666,0.25,1.16715542521994,627,238,389,8,1.6,64.66,6.6,0,0,0,0,0,0,0.0675700940150757,15.8787293971131,9.73014778857505
9.7,"max_tuv_SVM","SVM",91,18,884,863,21,1900,1662,238,0.797058611491611,0.371212121212121,1.17688172043011,624,238,386,-3,1.6,68.25,7,0,0,0,0,0,0,0.00485701298468661,2.49381289630913,2.42071528820639
9.7,"max_tuv_SVM","SVM",91,19,784,765,19,2000,1760,240,0.778506716651055,0.303030303030303,1.14770283479961,635,240,395,11,1.6,71.84,7.3,0,0,0,0,0,0,0.0221438663040773,7.85272483958191,4.51789650405239
9.7,"max_tuv_SVM","SVM",91,20,684,666,18,2100,1859,241,0.783060582029659,0.363636363636364,1.15742913000977,634,241,393,-1,1.6,75.43,7.7,0,0,0,0,0,0,0.00569639373935817,1.71981408493036,1.25239281686718
9.7,"max_tuv_SVM","SVM",91,21,584,567,17,2200,1958,242,0.794174897267683,0.356060606060606,1.15742913000977,644,242,402,10,1.7,79.02,8.1,0,0,0,0,0,0,0.00148664680026149,0.524515921589519,0.406714224125665
9.7,"max_tuv_SVM","SVM",91,22,484,468,16,2300,2057,243,0.764905197894891,0.234848484848485,1.16715542521994,639,243,396,-5,1.6,82.61,8.5,0,0,0,0,0,0,0.000917407442147669,0.288617053420272,0.220721662586536
9.7,"max_tuv_SVM","SVM",91,23,384,373,11,2400,2152,248,0.788695840242233,0.318181818181818,1.20606060606061,656,248,408,17,1.6,86.21,8.7,0,0,0,0,0,0,0.0147383745512371,6.36294198522097,5.30386716603261
9.7,"max_tuv_SVM","SVM",91,24,284,274,10,2500,2251,249,0.794451253214137,0.272727272727273,1.20606060606061,669,249,420,13,1.7,89.8,9,0,0,0,0,0,0,0.00204917833184109,0.566970649490427,0.43110001052446
9.7,"max_tuv_SVM","SVM",91,25,184,178,6,2600,2347,253,0.809368466584954,0.287878787878788,1.2352394916911,698,253,445,29,1.8,93.39,9.3,0,0,0,0,0,0,0.0132069565494348,5.05418085359234,4.48482100252861
9.7,"max_tuv_SVM","SVM",91,26,84,84,0,2700,2441,259,0.767945113305932,0.166666666666667,1.27414467253177,731,259,472,33,1.8,96.98,9.4,0,0,0,0,0,0,1.0000000994736e-07,0.0951238212402007,0.0951238212402007
9.7,"max_tuv_SVM","SVM",91,27,0,0,0,2784,2525,259,0.762808497344577,0.181818181818182,1.27414467253177,712,259,453,-19,1.7,100,9.7,0,0,0,0,0,0,0,0,0
9.7,"max_tuv_SVM","SVM",92,0,2684,2429,255,100,88,12,0.767342840438245,0.193548387096774,1.27351716961498,31,12,19,0,1.6,3.59,7.3,0,0,0,0,0,0,0.389886460611818,315.974945358259,49.9160449786512
9.7,"max_tuv_SVM","SVM",92,1,2584,2356,228,200,161,39,0.744172449731824,0.217741935483871,1.22174817898023,89,39,50,58,1.3,7.18,4.1,0,0,0,0,0,0,0.245711138308771,356.148975686971,31.9544813544478
9.7,"max_tuv_SVM","SVM",92,2,2484,2284,200,300,233,67,0.795648084597985,0.282258064516129,1.24245577523413,153,67,86,64,1.3,10.78,3.5,0,0,0,0,0,0,0.248779744940948,392.443600342045,26.78093911973
9.7,"max_tuv_SVM","SVM",92,3,2384,2218,166,400,299,101,0.796963573044563,0.290322580645161,1.24245577523413,236,101,135,83,1.3,14.37,3,0,0,0,0,0,0,0.265179750711237,315.996667277954,27.673494987455
9.7,"max_tuv_SVM","SVM",92,4,2284,2133,151,500,384,116,0.793188693154376,0.258064516129032,1.24245577523413,273,116,157,37,1.4,17.96,3.3,0,0,0,0,0,0,0.238024390013873,232.08766707746,24.9304288198004
9.7,"max_tuv_SVM","SVM",92,5,2184,2057,127,600,460,140,0.801609090215816,0.32258064516129,1.24245577523413,331,140,191,58,1.4,21.55,3.3,0,0,0,0,0,0,0.232231086283508,241.553487195635,23.7073578050578
9.7,"max_tuv_SVM","SVM",92,6,2084,1982,102,700,535,165,0.803121584178554,0.32258064516129,1.21139438085328,395,165,230,64,1.4,25.14,3.2,0,0,0,0,0,0,0.227030802323218,147.565827332653,23.8570641668534
9.7,"max_tuv_SVM","SVM",92,7,1984,1917,67,800,600,200,0.797662624876087,0.25,1.19068678459938,479,200,279,84,1.4,28.74,3,0,0,0,0,0,0,0.245553026502934,156.603046160935,30.8923935425128
9.7,"max_tuv_SVM","SVM",92,8,1884,1838,46,900,679,221,0.795501919215041,0.32258064516129,1.19068678459938,529,221,308,50,1.4,32.33,3.1,0,0,0,0,0,0,0.214507097562928,176.048837424357,23.1542590653053
9.7,"max_tuv_SVM","SVM",92,9,1784,1746,38,1000,771,229,0.794364371234665,0.290322580645161,1.19068678459938,543,229,314,14,1.4,35.92,3.4,0,0,0,0,0,0,0.197217118138979,149.724230320532,21.1224106855106
9.7,"max_tuv_SVM","SVM",92,10,1684,1655,29,1100,862,238,0.787106942220202,0.290322580645161,1.18033298647242,579,238,341,36,1.4,39.51,3.6,0,0,0,0,0,0,0.18302803312395,114.006837054472,19.9265955677897
9.7,"max_tuv_SVM","SVM",92,11,1584,1557,27,1200,960,240,0.789680723963507,0.25,1.19068678459938,595,240,355,16,1.5,43.1,4,0,0,0,0,0,0,0.184618580443723,137.840629804946,19.009490074269
9.7,"max_tuv_SVM","SVM",92,12,1484,1459,25,1300,1058,242,0.782963471364307,0.274193548387097,1.19068678459938,600,242,358,5,1.5,46.7,4.4,0,0,0,0,0,0,0.128456914965298,53.9799218606972,15.4403289803601
9.7,"max_tuv_SVM","SVM",92,13,1384,1360,24,1400,1157,243,0.785168662141904,0.241935483870968,1.19068678459938,594,243,351,-6,1.4,50.29,4.8,0,0,0,0,0,0,0.0547508913950863,15.5729807990956,8.14854951540059
9.7,"max_tuv_SVM","SVM",92,14,1284,1260,24,1500,1257,243,0.788422430666778,0.241935483870968,1.18033298647242,598,243,355,4,1.5,53.88,5.2,0,0,0,0,0,0,0.0271454085850965,8.19101292047787,4.15282175464592
9.7,"max_tuv_SVM","SVM",92,15,1184,1162,22,1600,1355,245,0.7760936983655,0.25,1.19068678459938,614,245,369,16,1.5,57.47,5.5,0,0,0,0,0,0,0.125396801913274,37.7579241886014,14.7908852869918
9.7,"max_tuv_SVM","SVM",92,16,1084,1064,20,1700,1453,247,0.756901548082064,0.193548387096774,1.20104058272633,639,247,392,25,1.6,61.06,5.9,0,0,0,0,0,0,0.0962537961291805,24.3506333262226,11.759347118498
9.7,"max_tuv_SVM","SVM",92,17,984,964,20,1800,1553,247,0.762382749942812,0.201612903225806,1.20104058272633,634,247,387,-5,1.6,64.66,6.3,0,0,0,0,0,0,0.0495295516613191,10.1963063657483,6.88350834343197
9.7,"max_tuv_SVM","SVM",92,18,884,864,20,1900,1653,247,0.73357863697603,0.193548387096774,NA,639,247,392,5,1.6,68.25,6.7,0,0,0,0,0,0,0.00182280496335825,1.30406868648053,1.28135995862821
9.7,"max_tuv_SVM","SVM",92,19,784,766,18,2000,1751,249,0.783735605887295,0.290322580645161,1.21139438085328,633,249,384,-6,1.5,71.84,7,0,0,0,0,0,0,0.000352610880233555,0.718909846389879,0.699872993740114
9.7,"max_tuv_SVM","SVM",92,20,684,669,15,2100,1848,252,0.789464653397398,0.274193548387097,1.22174817898023,638,252,386,5,1.5,75.43,7.3,0,0,0,0,0,0,5.01426395547632e-06,0.0232698185311446,0.0230601585929863
9.7,"max_tuv_SVM","SVM",92,21,584,575,9,2200,1942,258,0.793372988637231,0.225806451612903,1.24245577523413,673,258,415,35,1.6,79.02,7.5,0,0,0,0,0,0,0.00104819280001845,0.512291159446107,0.427950100584458
9.7,"max_tuv_SVM","SVM",92,22,484,480,4,2300,2037,263,0.775718752383135,0.193548387096774,1.26316337148803,693,263,430,20,1.6,82.61,7.7,0,0,0,0,0,0,0.116901997542671,34.0871660698105,16.6917702154852
9.7,"max_tuv_SVM","SVM",92,23,384,381,3,2400,2136,264,0.776227153715145,0.193548387096774,1.26316337148803,698,264,434,5,1.6,86.21,8.1,0,0,0,0,0,0,0.0535077173555463,12.9973673936982,7.05218266325854
9.7,"max_tuv_SVM","SVM",92,24,284,283,1,2500,2234,266,0.772541244058063,0.161290322580645,1.27351716961498,725,266,459,27,1.7,89.8,8.4,0,0,0,0,0,0,0.0237004314618873,6.96872794876313,5.4529411071183
9.7,"max_tuv_SVM","SVM",92,25,184,184,0,2600,2333,267,0.80075116296805,0.201612903225806,1.27351716961498,711,267,444,-14,1.7,93.39,8.7,0,0,0,0,0,0,0.0231332034309018,8.67278744850688,7.86954979099266
9.7,"max_tuv_SVM","SVM",92,26,84,84,0,2700,2433,267,0.774943440351815,0.161290322580645,1.26316337148803,721,267,454,10,1.7,96.98,9.1,0,0,0,0,0,0,0.0367290105428053,6.05806879519156,6.05806879519156
9.7,"max_tuv_SVM","SVM",92,27,0,0,0,2784,2517,267,0.798361676707598,0.266129032258065,1.27351716961498,730,267,463,9,1.7,100,9.4,0,0,0,0,0,0,0,0,0
9.7,"max_tuv_SVM","SVM",93,0,2684,2429,255,100,88,12,0.782181804316327,0.233870967741935,1.28387096774194,34,12,22,0,1.8,3.59,7.3,0,0,0,0,0,0,0.121333132909158,320.06511618321,12.1943916960147
9.7,"max_tuv_SVM","SVM",93,1,2584,2331,253,200,186,14,0.739819263326475,0.233870967741935,1.23210197710718,46,14,32,12,2.3,7.18,13.3,0,0,0,0,0,0,0.075526553820474,186.812427657939,7.66735959877246
9.7,"max_tuv_SVM","SVM",93,2,2484,2258,226,300,259,41,0.748220595337962,0.104838709677419,1.20104058272633,125,41,84,79,2,10.78,6.3,0,0,0,0,0,0,0.148395627808143,324.469052318454,15.2445048829512
9.7,"max_tuv_SVM","SVM",93,3,2384,2167,217,400,350,50,0.755802130201584,0.137096774193548,1.20104058272633,148,50,98,23,2,14.37,7,0,0,0,0,0,0,0.146644803508242,248.306491007015,18.5981823574229
9.7,"max_tuv_SVM","SVM",93,4,2284,2080,204,500,437,63,0.76487709397799,0.233870967741935,1.21139438085328,182,63,119,34,1.9,17.96,6.9,0,0,0,0,0,0,0.158272548227278,196.692837566571,19.2289825603249
9.7,"max_tuv_SVM","SVM",93,5,2184,2005,179,600,512,88,0.79709067337757,0.25,1.20104058272633,240,88,152,58,1.7,21.55,5.8,0,0,0,0,0,0,0.164937182345713,214.784655044503,17.6422549007153
9.7,"max_tuv_SVM","SVM",93,6,2084,1924,160,700,593,107,0.79043697094487,0.258064516129032,1.20104058272633,278,107,171,38,1.6,25.14,5.5,0,0,0,0,0,0,0.165316178765579,204.39369696738,16.8744787641562
9.7,"max_tuv_SVM","SVM",93,7,1984,1860,124,800,657,143,0.802327207097289,0.233870967741935,1.20104058272633,362,143,219,84,1.5,28.74,4.6,0,0,0,0,0,0,0.188006431166071,211.114127080044,19.1928578434106
9.7,"max_tuv_SVM","SVM",93,8,1884,1779,105,900,738,162,0.802492437530193,0.201612903225806,1.20104058272633,406,162,244,44,1.5,32.33,4.6,0,0,0,0,0,0,0.181780954214493,165.350649663293,18.7294694506456
9.7,"max_tuv_SVM","SVM",93,9,1784,1705,79,1000,812,188,0.806667683469337,0.25,1.20104058272633,465,188,277,59,1.5,35.92,4.3,0,0,0,0,0,0,0.189034206589412,173.080157338106,19.3475009704727
9.7,"max_tuv_SVM","SVM",93,10,1684,1613,71,1100,904,196,0.796232746129801,0.201612903225806,1.20104058272633,487,196,291,22,1.5,39.51,4.6,0,0,0,0,0,0,0.175195377800505,143.125294030734,18.0399269882912
9.7,"max_tuv_SVM","SVM",93,11,1584,1528,56,1200,989,211,0.791695264241598,0.169354838709677,1.20104058272633,529,211,318,42,1.5,43.1,4.7,0,0,0,0,0,0,0.170224636689584,108.240104527561,17.8864028674761
9.7,"max_tuv_SVM","SVM",93,12,1484,1445,39,1300,1072,228,0.807614580950208,0.233870967741935,1.20104058272633,581,228,353,52,1.5,46.7,4.7,0,0,0,0,0,0,0.163622287797126,109.12462271803,17.3388571419406
9.7,"max_tuv_SVM","SVM",93,13,1384,1352,32,1400,1165,235,0.787844124151611,0.193548387096774,1.20104058272633,606,235,371,25,1.6,50.29,5,0,0,0,0,0,0,0.157079599849305,90.9717271077504,16.4254265722629
9.7,"max_tuv_SVM","SVM",93,14,1284,1256,28,1500,1261,239,0.805053509240201,0.241935483870968,1.20104058272633,618,239,379,12,1.6,53.88,5.3,0,0,0,0,0,0,0.124320897686511,52.9707399382221,13.4498231182372
9.7,"max_tuv_SVM","SVM",93,15,1184,1157,27,1600,1360,240,0.804678563257844,0.225806451612903,1.20104058272633,636,240,396,18,1.6,57.47,5.7,0,0,0,0,0,0,0.11946671852397,52.7211835311743,12.6263259958681
9.7,"max_tuv_SVM","SVM",93,16,1084,1059,25,1700,1458,242,0.807856071582916,0.233870967741935,1.20104058272633,644,242,402,8,1.7,61.06,6,0,0,0,0,0,0,0.110258694997313,44.1096957110944,11.9607313839852
9.7,"max_tuv_SVM","SVM",93,17,984,959,25,1800,1558,242,0.799797910470533,0.225806451612903,1.20104058272633,627,242,385,-17,1.6,64.66,6.4,0,0,0,0,0,0,0.0578725989743162,14.8480214406151,7.01679194405468
9.7,"max_tuv_SVM","SVM",93,18,884,860,24,1900,1657,243,0.805514247947337,0.266129032258065,1.20104058272633,632,243,389,5,1.6,68.25,6.8,0,0,0,0,0,0,0.0146308069319979,4.27456604353058,2.95111833102326
9.7,"max_tuv_SVM","SVM",93,19,784,764,20,2000,1753,247,0.807837006532964,0.225806451612903,1.20104058272633,642,247,395,10,1.6,71.84,7.1,0,0,0,0,0,0,0.0285590099008216,8.07842817635271,4.5598364161682
9.7,"max_tuv_SVM","SVM",93,20,684,666,18,2100,1851,249,0.802168331681031,0.241935483870968,1.22174817898023,654,249,405,12,1.6,75.43,7.4,0,0,0,0,0,0,0.0298162844846894,8.83926833670701,4.38456332278995
9.7,"max_tuv_SVM","SVM",93,21,584,567,17,2200,1950,250,0.784498207885307,0.17741935483871,1.21139438085328,645,250,395,-9,1.6,79.02,7.8,0,0,0,0,0,0,0.00382796608481798,1.15424603951985,0.801679876963637
9.7,"max_tuv_SVM","SVM",93,22,484,469,15,2300,2048,252,0.820299194183894,0.25,1.20104058272633,665,252,413,20,1.6,82.61,8.1,0,0,0,0,0,0,0.00461918592531006,1.43644146806622,0.972383085488887
9.7,"max_tuv_SVM","SVM",93,23,384,371,13,2400,2146,254,0.778337019242992,0.145161290322581,1.22174817898023,669,254,415,4,1.6,86.21,8.4,0,0,0,0,0,0,0.00151166747544197,0.438029838593645,0.310931759074755
9.7,"max_tuv_SVM","SVM",93,24,284,275,9,2500,2242,258,0.801984036198176,0.225806451612903,1.22174817898023,670,258,412,1,1.6,89.8,8.7,0,0,0,0,0,0,0.00173969776972448,0.470092864417125,0.360145242450664
9.7,"max_tuv_SVM","SVM",93,25,184,179,5,2600,2338,262,0.816162078344645,0.25,1.22174817898023,692,262,430,22,1.6,93.39,8.9,0,0,0,0,0,0,0.0193208470641373,4.46642395563315,3.60893316336721
9.7,"max_tuv_SVM","SVM",93,26,84,84,0,2700,2433,267,0.7632184346323,0.120967741935484,1.27351716961498,717,267,450,25,1.7,96.98,9.1,0,0,0,0,0,0,8.53850373243022e-05,0.379665784198781,0.379665784198781
9.7,"max_tuv_SVM","SVM",93,27,0,0,0,2784,2517,267,0.827277002465747,0.201612903225806,1.26316337148803,721,267,454,4,1.7,100,9.4,0,0,0,0,0,0,0,0,0
9.7,"max_tuv_SVM","SVM",94,0,2684,2446,238,100,88,12,0.260326739627943,0,0.600960878517502,35,12,23,0,1.9,3.59,7.3,0,0,0,0,0,0,0.128698506851522,316.090406405842,13.3020200204671
9.7,"max_tuv_SVM","SVM",94,1,2584,2364,220,200,170,30,0.811671538304671,0.312056737588652,1.22923816060398,86,30,56,51,1.9,7.18,5.7,0,0,0,0,0,0,0.189502529830231,353.809348556213,22.0823074866224
9.7,"max_tuv_SVM","SVM",94,2,2484,2290,194,300,244,56,0.782135816735777,0.219858156028369,1.26566003202928,150,56,94,64,1.7,10.78,4.4,0,0,0,0,0,0,0.219464501346885,367.091163790194,24.8253376212131
9.7,"max_tuv_SVM","SVM",94,3,2384,2208,176,400,326,74,0.786537285024814,0.25531914893617,1.24744909631663,190,74,116,40,1.6,14.37,4.4,0,0,0,0,0,0,0.19759098564647,283.69937777007,20.3250662802301
9.7,"max_tuv_SVM","SVM",94,4,2284,2133,151,500,401,99,0.805270432556138,0.269503546099291,1.25655456417296,249,99,150,59,1.5,17.96,4.1,0,0,0,0,0,0,0.202060943493434,311.273418737533,20.5418629649123
9.7,"max_tuv_SVM","SVM",94,5,2184,2059,125,600,475,125,0.808046133278952,0.290780141843972,1.24744909631663,294,125,169,45,1.4,21.55,3.8,0,0,0,0,0,0,0.212592920647701,281.28376483584,22.2548246413178
9.7,"max_tuv_SVM","SVM",94,6,2084,1979,105,700,555,145,0.802794960687018,0.276595744680851,1.25655456417296,349,145,204,55,1.4,25.14,3.8,0,0,0,0,0,0,0.203111590141167,239.510473201216,20.8611167537307
9.7,"max_tuv_SVM","SVM",94,7,1984,1904,80,800,630,170,0.816129653547232,0.290780141843972,1.25655456417296,409,170,239,60,1.4,28.74,3.7,0,0,0,0,0,0,0.211601389076526,210.202979502212,21.7059078886816
9.7,"max_tuv_SVM","SVM",94,8,1884,1825,59,900,709,191,0.81973239979154,0.319148936170213,1.25655456417296,462,191,271,53,1.4,32.33,3.7,0,0,0,0,0,0,0.207870783959154,225.464856633423,21.5642945973144
9.7,"max_tuv_SVM","SVM",94,9,1784,1738,46,1000,796,204,0.814617179888067,0.304964539007092,1.25655456417296,506,204,302,44,1.5,35.92,3.9,0,0,0,0,0,0,0.185821482801283,181.336633286309,19.5420911605269
9.7,"max_tuv_SVM","SVM",94,10,1684,1648,36,1100,886,214,0.814096027915623,0.312056737588652,1.25655456417296,532,214,318,26,1.5,39.51,4.1,0,0,0,0,0,0,0.169583642358674,156.25605853424,18.1215819721022
9.7,"max_tuv_SVM","SVM",94,11,1584,1556,28,1200,978,222,0.820627421657271,0.26241134751773,1.24744909631663,555,222,333,23,1.5,43.1,4.4,0,0,0,0,0,0,0.14456867433101,122.404545057346,15.6279407818253
9.7,"max_tuv_SVM","SVM",94,12,1484,1458,26,1300,1076,224,0.820179910724407,0.361702127659574,1.24744909631663,564,224,340,9,1.5,46.7,4.8,0,0,0,0,0,0,0.128801632175029,108.200595469111,14.2138977688407
9.7,"max_tuv_SVM","SVM",94,13,1384,1360,24,1400,1174,226,0.794252600095173,0.25531914893617,1.25655456417296,588,226,362,24,1.6,50.29,5.2,0,0,0,0,0,0,0.121573035645396,79.6750065843218,13.5087202420136
9.7,"max_tuv_SVM","SVM",94,14,1284,1263,21,1500,1271,229,0.814917408741764,0.283687943262411,1.25655456417296,600,229,371,12,1.6,53.88,5.6,0,0,0,0,0,0,0.151785751743845,121.145515283417,16.2902760816244
9.7,"max_tuv_SVM","SVM",94,15,1184,1164,20,1600,1370,230,0.831764212720644,0.354609929078014,1.25655456417296,602,230,372,2,1.6,57.47,6,0,0,0,0,0,0,0.106226105222972,51.1617044106591,11.7179548307853
9.7,"max_tuv_SVM","SVM",94,16,1084,1070,14,1700,1464,236,0.772058323703356,0.212765957446809,1.25655456417296,632,236,396,30,1.7,61.06,6.2,0,0,0,0,0,0,0.1017796950236,47.6696354515666,11.7469469570918
9.7,"max_tuv_SVM","SVM",94,17,984,970,14,1800,1564,236,0.801458092583788,0.24113475177305,1.25655456417296,633,236,397,1,1.7,64.66,6.6,0,0,0,0,0,0,0.0519065003265143,19.5887856394883,6.7179544924957
9.7,"max_tuv_SVM","SVM",94,18,884,871,13,1900,1663,237,0.812810142070566,0.297872340425532,1.25655456417296,641,237,404,8,1.7,68.25,7,0,0,0,0,0,0,0.0519971307673547,21.2026638965624,6.00702509639136
9.7,"max_tuv_SVM","SVM",94,19,784,771,13,2000,1763,237,0.806012507647344,0.276595744680851,1.25655456417296,633,237,396,-8,1.7,71.84,7.4,0,0,0,0,0,0,0.0349638902298674,13.4005361446855,4.4410112611648
9.7,"max_tuv_SVM","SVM",94,20,684,674,10,2100,1860,240,0.81187546733737,0.276595744680851,1.25655456417296,659,240,419,26,1.7,75.43,7.8,0,0,0,0,0,0,0.0278344971035813,10.1170722396932,3.92261446768058
9.7,"max_tuv_SVM","SVM",94,21,584,577,7,2200,1957,243,0.825623682958332,0.283687943262411,1.25655456417296,689,243,446,30,1.8,79.02,8.1,0,0,0,0,0,0,0.0418243371054304,15.4576726621036,5.5305606162152
9.7,"max_tuv_SVM","SVM",94,22,484,483,1,2300,2051,249,0.791522216935177,0.219858156028369,1.26566003202928,708,249,459,19,1.8,82.61,8.2,0,0,0,0,0,0,0.0373297985472033,11.7378795652995,5.51685623326136
9.7,"max_tuv_SVM","SVM",94,23,384,384,0,2400,2150,250,0.729108603539304,0.141843971631206,1.26566003202928,702,250,452,-6,1.8,86.21,8.6,0,0,0,0,0,0,0.0425262108441355,12.2590790728957,5.21226686937204
9.7,"max_tuv_SVM","SVM",94,24,284,284,0,2500,2250,250,0.769084358643193,0.219858156028369,1.26566003202928,677,250,427,-25,1.7,89.8,9,0,0,0,0,0,0,0.00784254665521127,1.93071861873024,1.24250660266969
9.7,"max_tuv_SVM","SVM",94,25,184,184,0,2600,2350,250,0.818724084018766,0.24822695035461,1.27476549988561,689,250,439,12,1.8,93.39,9.4,0,0,0,0,0,0,0.000715791148671234,0.175017432213803,0.142670838527922
9.7,"max_tuv_SVM","SVM",94,26,84,84,0,2700,2450,250,0.821465796569463,0.333333333333333,1.26566003202928,671,250,421,-18,1.7,96.98,9.8,0,0,0,0,0,0,0.000154064266062468,0.0631126389622132,0.0631126389622132
9.7,"max_tuv_SVM","SVM",94,27,0,0,0,2784,2534,250,0.747348922574948,0.212765957446809,1.27476549988561,686,250,436,15,1.7,100,10.1,0,0,0,0,0,0,0,0,0
9.7,"max_tuv_SVM","SVM",95,0,2684,2432,252,100,90,10,0.796802938867625,0.201550387596899,1.2528587948092,26,10,16,0,1.6,3.59,9,0,0,0,0,0,0,0.360838188384106,333.848696285554,45.720362701881
9.7,"max_tuv_SVM","SVM",95,1,2584,2353,231,200,169,31,0.80997326072024,0.255813953488372,1.28387096774194,78,31,47,52,1.5,7.18,5.5,0,0,0,0,0,0,0.251404497077217,355.321608440281,30.619539971576
9.7,"max_tuv_SVM","SVM",95,2,2484,2292,192,300,230,70,0.7890172701403,0.193798449612403,1.26396599149787,165,70,95,87,1.4,10.78,3.3,0,0,0,0,0,0,0.36295174066589,495.493394295625,43.3087490365548
9.7,"max_tuv_SVM","SVM",95,3,2384,2205,179,400,317,83,0.763271514081049,0.178294573643411,1.2739184796199,199,83,116,34,1.4,14.37,3.8,0,0,0,0,0,0,0.259048044040847,339.874355290388,30.0879171304343
9.7,"max_tuv_SVM","SVM",95,4,2284,2117,167,500,405,95,0.805661858502598,0.193798449612403,1.28387096774194,228,95,133,29,1.4,17.96,4.3,0,0,0,0,0,0,0.20691501929245,279.460188716143,22.2425801810735
9.7,"max_tuv_SVM","SVM",95,5,2184,2033,151,600,489,111,0.808605632420762,0.255813953488372,1.28387096774194,263,111,152,35,1.4,21.55,4.4,0,0,0,0,0,0,0.186394450041145,231.522983966394,20.4281105863044
9.7,"max_tuv_SVM","SVM",95,6,2084,1956,128,700,566,134,0.810224708075751,0.232558139534884,1.28387096774194,326,134,192,63,1.4,25.14,4.2,0,0,0,0,0,0,0.194647585951269,228.995729477573,19.9327885602695
9.7,"max_tuv_SVM","SVM",95,7,1984,1885,99,800,637,163,0.819080561279558,0.248062015503876,1.28387096774194,378,163,215,52,1.3,28.74,3.9,0,0,0,0,0,0,0.193253040259748,126.965085896993,20.5538907804336
9.7,"max_tuv_SVM","SVM",95,8,1884,1821,63,900,701,199,0.821453979001071,0.24031007751938,1.2739184796199,470,199,271,92,1.4,32.33,3.5,0,0,0,0,0,0,0.209970900353031,142.848882494738,23.4121981841316
9.7,"max_tuv_SVM","SVM",95,9,1784,1741,43,1000,781,219,0.830861789814532,0.255813953488372,1.2739184796199,525,219,306,55,1.4,35.92,3.6,0,0,0,0,0,0,0.167732050723688,112.214396763881,18.9977917607112
9.7,"max_tuv_SVM","SVM",95,10,1684,1652,32,1100,870,230,0.827353792562053,0.27906976744186,1.26396599149787,544,230,314,19,1.4,39.51,3.8,0,0,0,0,0,0,0.137888006106101,81.8155842508906,16.1274752179517
9.7,"max_tuv_SVM","SVM",95,11,1584,1561,23,1200,961,239,0.832802840741822,0.263565891472868,1.27274544234585,579,239,340,35,1.4,43.1,4,0,0,0,0,0,0,0.149346370799767,86.5973425038123,17.3432790907988
9.7,"max_tuv_SVM","SVM",95,12,1484,1468,16,1300,1054,246,0.827807624374433,0.294573643410853,1.2739184796199,606,246,360,27,1.5,46.7,4.3,0,0,0,0,0,0,0.157032405596547,107.275635873094,17.0854568040214
9.7,"max_tuv_SVM","SVM",95,13,1384,1372,12,1400,1150,250,0.818313953488359,0.286821705426357,1.26396599149787,637,250,387,31,1.5,50.29,4.6,0,0,0,0,0,0,0.140386253060182,90.817852702376,16.03700976467
9.7,"max_tuv_SVM","SVM",95,14,1284,1273,11,1500,1249,251,0.819589588852894,0.263565891472868,1.26396599149787,642,251,391,5,1.6,53.88,5,0,0,0,0,0,0,0.0976126241073042,50.8876710777425,11.1363295232898
9.7,"max_tuv_SVM","SVM",95,15,1184,1178,6,1600,1344,256,0.800289471101949,0.255813953488372,1.26396599149787,665,256,409,23,1.6,57.47,5.2,0,0,0,0,0,0,0.129852236981707,78.7450032437743,15.5361627384793
9.7,"max_tuv_SVM","SVM",95,16,1084,1078,6,1700,1444,256,0.827304729663422,0.302325581395349,1.2739184796199,671,256,415,6,1.6,61.06,5.6,0,0,0,0,0,0,0.083776034251397,44.7902409779706,9.7176658383049
9.7,"max_tuv_SVM","SVM",95,17,984,980,4,1800,1542,258,0.82443455009321,0.302325581395349,1.2739184796199,694,258,436,23,1.7,64.66,6,0,0,0,0,0,0,0.0665352171683836,29.2664997790339,7.73835382581584
9.7,"max_tuv_SVM","SVM",95,18,884,880,4,1900,1642,258,0.814750760474922,0.263565891472868,1.2739184796199,685,258,427,-9,1.7,68.25,6.4,0,0,0,0,0,0,0.036387857535357,11.9990022569318,4.77986058653313
9.7,"max_tuv_SVM","SVM",95,19,784,781,3,2000,1741,259,0.824029781179462,0.263565891472868,1.2739184796199,701,259,442,16,1.7,71.84,6.7,0,0,0,0,0,0,0.0282094595219397,9.05337682995666,4.1457340877949
9.7,"max_tuv_SVM","SVM",95,20,684,681,3,2100,1841,259,0.815842409969574,0.224806201550388,1.2739184796199,695,259,436,-6,1.7,75.43,7.1,0,0,0,0,0,0,0.0140365536569365,4.17849678937308,2.13528779853425
9.7,"max_tuv_SVM","SVM",95,21,584,582,2,2200,1940,260,0.812383475615729,0.24031007751938,1.2739184796199,694,260,434,-1,1.7,79.02,7.5,0,0,0,0,0,0,0.0113183137580621,4.40938853728374,2.93705385936656
9.7,"max_tuv_SVM","SVM",95,22,484,482,2,2300,2040,260,0.802945000490621,0.224806201550388,1.28387096774194,694,260,434,0,1.7,82.61,7.8,0,0,0,0,0,0,0.0047411469217224,1.23759343348381,0.842791352296896
9.7,"max_tuv_SVM","SVM",95,23,384,383,1,2400,2139,261,0.818037974683535,0.263565891472868,1.28387096774194,714,261,453,20,1.7,86.21,8.2,0,0,0,0,0,0,0.00439644134983907,1.23979186721503,0.910046876065495
9.7,"max_tuv_SVM","SVM",95,24,284,283,1,2500,2239,261,0.815186193700318,0.255813953488372,1.28387096774194,699,261,438,-15,1.7,89.8,8.6,0,0,0,0,0,0,0.000600746044786203,0.214551381015942,0.179442848954012
9.7,"max_tuv_SVM","SVM",95,25,184,184,0,2600,2338,262,0.823606613678733,0.24031007751938,1.28387096774194,702,262,440,3,1.7,93.39,8.9,0,0,0,0,0,0,0.000493500481953282,1.22981702347459,1.21751194201078
9.7,"max_tuv_SVM","SVM",95,26,84,84,0,2700,2438,262,0.815707486998324,0.263565891472868,1.2739184796199,714,262,452,12,1.7,96.98,9.3,0,0,0,0,0,0,5.41471513162947e-07,0.0239698941672802,0.0239698941672802
9.7,"max_tuv_SVM","SVM",95,27,0,0,0,2784,2522,262,0.806722843685601,0.255813953488372,1.28387096774194,707,262,445,-7,1.7,100,9.6,0,0,0,0,0,0,0,0,0
9.7,"max_tuv_SVM","SVM",96,0,2684,2417,267,100,87,13,0.586449944484265,0,1.05157367312063,42,13,29,0,2.2,3.59,6.7,0,0,0,0,0,0,0.283322643444898,379.647163594453,40.3289123658754
9.7,"max_tuv_SVM","SVM",96,1,2584,2331,253,200,173,27,0.671845792750634,0,1.1913397268236,70,27,43,28,1.6,7.18,6.4,0,0,0,0,0,0,0.758453021906159,450.62797268734,91.0751050897344
9.7,"max_tuv_SVM","SVM",96,2,2484,2258,226,300,246,54,0.744641677558992,0.135135135135135,1.28387096774194,139,54,85,69,1.6,10.78,4.6,0,0,0,0,0,0,0.247830154460913,445.250961071437,26.2741863357896
9.7,"max_tuv_SVM","SVM",96,3,2384,2174,210,400,330,70,0.67227445854591,0.045045045045045,1.23760534728277,191,70,121,52,1.7,14.37,4.7,0,0,0,0,0,0,0.185954741294387,414.842844560237,19.2158197600099
9.7,"max_tuv_SVM","SVM",96,4,2284,2080,204,500,424,76,0.765800902306362,0.144144144144144,1.28387096774194,197,76,121,6,1.6,17.96,5.6,0,0,0,0,0,0,0.215424085030316,262.19283213025,30.0537808338791
9.7,"max_tuv_SVM","SVM",96,5,2184,1986,198,600,518,82,0.787149864372957,0.18018018018018,1.23760534728277,216,82,134,19,1.6,21.55,6.3,0,0,0,0,0,0,0.182116607782342,189.596085174741,18.7978409096279
9.7,"max_tuv_SVM","SVM",96,6,2084,1908,176,700,596,104,0.789925651080103,0.216216216216216,1.23760534728277,284,104,180,68,1.7,25.14,5.7,0,0,0,0,0,0,0.180856588351146,169.356906420871,18.5704839830209
9.7,"max_tuv_SVM","SVM",96,7,1984,1845,139,800,659,141,0.804865708141847,0.279279279279279,1.23760534728277,362,141,221,78,1.6,28.74,4.7,0,0,0,0,0,0,0.219232581329705,147.982254362593,22.6561176413752
9.7,"max_tuv_SVM","SVM",96,8,1884,1785,99,900,719,181,0.80048769518349,0.252252252252252,1.23760534728277,442,181,261,80,1.4,32.33,4,0,0,0,0,0,0,0.221167459439602,111.113100436195,23.6580972439744
9.7,"max_tuv_SVM","SVM",96,9,1784,1710,74,1000,794,206,0.805821422046077,0.234234234234234,1.23760534728277,502,206,296,60,1.4,35.92,3.9,0,0,0,0,0,0,0.20453457589238,123.164053805284,21.9972452137014
9.7,"max_tuv_SVM","SVM",96,10,1684,1624,60,1100,880,220,0.798133546963508,0.225225225225225,1.23760534728277,535,220,315,33,1.4,39.51,4,0,0,0,0,0,0,0.17849805265421,99.5654400669829,19.6574535897635
9.7,"max_tuv_SVM","SVM",96,11,1584,1538,46,1200,966,234,0.785667102359777,0.243243243243243,1.22603894216797,574,234,340,39,1.5,43.1,4.1,0,0,0,0,0,0,0.160537319626372,81.034680589455,18.6065254784519
9.7,"max_tuv_SVM","SVM",96,12,1484,1444,40,1300,1060,240,0.78921589296005,0.198198198198198,1.22603894216797,582,240,342,8,1.4,46.7,4.4,0,0,0,0,0,0,0.134335587717684,67.3115708515851,15.0203412936508
9.7,"max_tuv_SVM","SVM",96,13,1384,1357,27,1400,1147,253,0.786419024328547,0.198198198198198,1.22603894216797,629,253,376,47,1.5,50.29,4.5,0,0,0,0,0,0,0.141331481200814,55.4184281597341,17.1673886790149
9.7,"max_tuv_SVM","SVM",96,14,1284,1258,26,1500,1246,254,0.793056316847271,0.243243243243243,1.21335423821612,623,254,369,-6,1.5,53.88,4.9,0,0,0,0,0,0,0.126190469225287,44.0504838134039,13.9847173306053
9.7,"max_tuv_SVM","SVM",96,15,1184,1160,24,1600,1344,256,0.773745274135291,0.153153153153153,1.21447253705318,635,256,379,12,1.5,57.47,5.2,0,0,0,0,0,0,0.0897886711662174,26.4790038215231,11.0890201964863
9.7,"max_tuv_SVM","SVM",96,16,1084,1062,22,1700,1442,258,0.792560891624858,0.225225225225225,1.21447253705318,654,258,396,19,1.5,61.06,5.6,0,0,0,0,0,0,0.13706093193981,72.7085000059348,14.3619663139913
9.7,"max_tuv_SVM","SVM",96,17,984,962,22,1800,1542,258,0.804148922713669,0.252252252252252,1.22603894216797,649,258,391,-5,1.5,64.66,6,0,0,0,0,0,0,0.0807643914332258,19.5565996693007,9.33020761047958
9.7,"max_tuv_SVM","SVM",96,18,884,863,21,1900,1641,259,0.795575606808063,0.207207207207207,1.22603894216797,657,259,398,8,1.5,68.25,6.3,0,0,0,0,0,0,0.0302393060201317,7.53605442934866,5.13897016970336
9.7,"max_tuv_SVM","SVM",96,19,784,766,18,2000,1738,262,0.808133406417346,0.243243243243243,1.23760534728277,664,262,402,7,1.5,71.84,6.6,0,0,0,0,0,0,0.00148926943172854,1.05495417607613,1.01398736041297
9.7,"max_tuv_SVM","SVM",96,20,684,670,14,2100,1834,266,0.812068698964183,0.234234234234234,1.23760534728277,660,266,394,-4,1.5,75.43,6.9,0,0,0,0,0,0,0.017372695350544,6.26019580185086,2.34292617241848
9.7,"max_tuv_SVM","SVM",96,21,584,572,12,2200,1932,268,0.737052184790103,0.18018018018018,1.20290613193839,688,268,420,28,1.6,79.02,7.2,0,0,0,0,0,0,0.0398265955997193,15.5672004861679,11.7047266633666
9.7,"max_tuv_SVM","SVM",96,22,484,472,12,2300,2032,268,0.798702758921177,0.216216216216216,1.20290613193839,694,268,426,6,1.6,82.61,7.6,0,0,0,0,0,0,0.0128033769886405,3.76370292343886,2.52908786285654
9.7,"max_tuv_SVM","SVM",96,23,384,375,9,2400,2129,271,0.754957765878215,0.171171171171171,1.20290613193839,702,271,431,8,1.6,86.21,7.9,0,0,0,0,0,0,0.0281610601076008,8.02059822519418,5.83485207127174
9.7,"max_tuv_SVM","SVM",96,24,284,276,8,2500,2228,272,0.781984792905241,0.207207207207207,1.20290613193839,695,272,423,-7,1.6,89.8,8.2,0,0,0,0,0,0,0.00697100211509769,2.14493212144203,1.66002767498093
9.7,"max_tuv_SVM","SVM",96,25,184,179,5,2600,2325,275,0.781865328667209,0.18018018018018,1.20290613193839,706,275,431,11,1.6,93.39,8.5,0,0,0,0,0,0,0.00466821434406779,2.31763480052326,2.17136645988327
9.7,"max_tuv_SVM","SVM",96,26,84,83,1,2700,2421,279,0.765941448468757,0.135135135135135,1.24917175239756,735,279,456,29,1.6,96.98,8.7,0,0,0,0,0,0,2.51338081139357e-05,1.17420099675897,1.17420099675897
9.7,"max_tuv_SVM","SVM",96,27,0,0,0,2784,2504,280,0.770080532951047,0.144144144144144,1.27230456262714,743,280,463,8,1.7,100,8.9,0,0,0,0,0,0,0,0,0
9.7,"max_tuv_SVM","SVM",97,0,2684,2427,257,100,93,7,0.358392108569368,0.0236220472440945,0.839065278130556,30,7,23,0,3.3,3.59,13.3,0,0,0,0,0,0,0.0864886972139012,183.30506632351,9.24332181100024
9.7,"max_tuv_SVM","SVM",97,1,2584,2327,257,200,193,7,0.636445622022373,0.094488188976378,1.19288798577597,30,7,23,0,3.3,7.18,27.6,0,0,0,0,0,0,0.0517428041491193,114.13894791573,5.46615970170108
9.7,"max_tuv_SVM","SVM",97,2,2484,2234,250,300,286,14,0.588871888644253,0.259842519685039,1.03114046228092,46,14,32,16,2.3,10.78,20.4,0,0,0,0,0,0,0.0928741459856336,121.855174321636,11.2814273086565
9.7,"max_tuv_SVM","SVM",97,3,2384,2169,215,400,351,49,0.660359990546207,0.149606299212598,1.22321564643129,129,49,80,83,1.6,14.37,7.2,0,0,0,0,0,0,0.173997051442134,258.162836597046,19.3051451448224
9.7,"max_tuv_SVM","SVM",97,4,2284,2081,203,500,439,61,0.7432921595701,0.204724409448819,1.24343408686817,162,61,101,33,1.7,17.96,7.2,0,0,0,0,0,0,0.158104354002569,217.427930289808,16.9472542949975
9.7,"max_tuv_SVM","SVM",97,5,2184,2015,169,600,505,95,0.741413839857697,0.275590551181102,1.20299720599441,234,95,139,72,1.5,21.55,5.3,0,0,0,0,0,0,0.209724360847822,258.041287019825,24.6975635083037
9.7,"max_tuv_SVM","SVM",97,6,2084,1933,151,700,587,113,0.762261944745056,0.228346456692913,1.21310642621285,272,113,159,38,1.4,25.14,5.2,0,0,0,0,0,0,0.187736962191373,161.411578191642,20.7562304323281
9.7,"max_tuv_SVM","SVM",97,7,1984,1862,122,800,658,142,0.794317771889891,0.291338582677165,1.25354330708661,341,142,199,69,1.4,28.74,4.6,0,0,0,0,0,0,0.206758116849037,133.726214242341,22.6486660400236
9.7,"max_tuv_SVM","SVM",97,8,1884,1798,86,900,722,178,0.798640395069104,0.299212598425197,1.26365252730505,427,178,249,86,1.4,32.33,4.1,0,0,0,0,0,0,0.208891552513013,131.973942205795,23.9802958564186
9.7,"max_tuv_SVM","SVM",97,9,1784,1718,66,1000,802,198,0.802272642459978,0.283464566929134,1.25354330708661,488,198,290,61,1.5,35.92,4.1,0,0,0,0,0,0,0.199217511564637,167.911707461888,22.2875652512439
9.7,"max_tuv_SVM","SVM",97,10,1684,1633,51,1100,887,213,0.812012538717019,0.267716535433071,1.26365252730505,523,213,310,35,1.5,39.51,4.2,0,0,0,0,0,0,0.163546152017112,107.216777244807,18.7621156773326
9.7,"max_tuv_SVM","SVM",97,11,1584,1544,40,1200,976,224,0.816366259904712,0.291338582677165,1.26365252730505,553,224,329,30,1.5,43.1,4.4,0,0,0,0,0,0,0.101779002245734,55.7028102542411,12.6088865363838
9.7,"max_tuv_SVM","SVM",97,12,1484,1455,29,1300,1065,235,0.822685375228577,0.283464566929134,1.26365252730505,591,235,356,38,1.5,46.7,4.5,0,0,0,0,0,0,0.134679969991707,78.729414432616,15.9812023752728
9.7,"max_tuv_SVM","SVM",97,13,1384,1359,25,1400,1161,239,0.838209501063555,0.291338582677165,1.2737617475235,603,239,364,12,1.5,50.29,4.9,0,0,0,0,0,0,0.124593861789972,93.8764190797301,14.030415383818
9.7,"max_tuv_SVM","SVM",97,14,1284,1268,16,1500,1252,248,0.837326317622618,0.299212598425197,1.28387096774194,621,248,373,18,1.5,53.88,5,0,0,0,0,0,0,0.145475781525007,83.4312199152092,16.3236955159428
9.7,"max_tuv_SVM","SVM",97,15,1184,1172,12,1600,1348,252,0.840759537759202,0.291338582677165,1.28387096774194,662,252,410,41,1.6,57.47,5.3,0,0,0,0,0,0,0.105265095470302,52.9107001316252,12.2654430706703
9.7,"max_tuv_SVM","SVM",97,16,1084,1078,6,1700,1442,258,0.819731064422636,0.251968503937008,1.28387096774194,679,258,421,17,1.6,61.06,5.6,0,0,0,0,0,0,0.120682937762869,72.1508968789638,13.5772322005428
9.7,"max_tuv_SVM","SVM",97,17,984,979,5,1800,1541,259,0.834962868977871,0.244094488188976,1.28387096774194,676,259,417,-3,1.6,64.66,5.9,0,0,0,0,0,0,0.0897281505192999,46.4179045240198,10.1157300741677
9.7,"max_tuv_SVM","SVM",97,18,884,879,5,1900,1641,259,0.837842544563449,0.299212598425197,1.28387096774194,689,259,430,13,1.7,68.25,6.3,0,0,0,0,0,0,0.0684020533339747,32.3548134806699,7.99821648572257
9.7,"max_tuv_SVM","SVM",97,19,784,780,4,2000,1740,260,0.811116916072694,0.275590551181102,1.28387096774194,700,260,440,11,1.7,71.84,6.7,0,0,0,0,0,0,0.0611305064597462,25.615926370907,7.51756162652062
9.7,"max_tuv_SVM","SVM",97,20,684,680,4,2100,1840,260,0.802322399273551,0.204724409448819,1.28387096774194,687,260,427,-13,1.6,75.43,7.1,0,0,0,0,0,0,0.0318018492597185,10.6021561407174,4.13035296753431
9.7,"max_tuv_SVM","SVM",97,21,584,582,2,2200,1938,262,0.834092124740333,0.291338582677165,1.28387096774194,691,262,429,4,1.6,79.02,7.4,0,0,0,0,0,0,0.0374469245613085,12.0488262993864,6.37376009695224
9.7,"max_tuv_SVM","SVM",97,22,484,482,2,2300,2038,262,0.809617992063786,0.228346456692913,1.28387096774194,703,262,441,12,1.7,82.61,7.8,0,0,0,0,0,0,0.0291688896368332,8.38733282422115,4.23736995220564
9.7,"max_tuv_SVM","SVM",97,23,384,383,1,2400,2137,263,0.834166759960695,0.283464566929134,1.28387096774194,713,263,450,10,1.7,86.21,8.1,0,0,0,0,0,0,0.0150452025118681,4.89513008468614,3.21478529716763
9.7,"max_tuv_SVM","SVM",97,24,284,284,0,2500,2236,264,0.775553233570921,0.204724409448819,1.28387096774194,727,264,463,14,1.8,89.8,8.5,0,0,0,0,0,0,0.017009678483802,4.19723497238689,2.97286960693326
9.7,"max_tuv_SVM","SVM",97,25,184,184,0,2600,2336,264,0.806371359978112,0.299212598425197,1.2737617475235,717,264,453,-10,1.7,93.39,8.8,0,0,0,0,0,0,0.00348296390246108,1.24028668502133,1.09717122518037
9.7,"max_tuv_SVM","SVM",97,26,84,84,0,2700,2436,264,0.813654513564951,0.244094488188976,1.28387096774194,727,264,463,10,1.8,96.98,9.2,0,0,0,0,0,0,1.60469154886215e-05,0.101966665553852,0.101966665553852
9.7,"max_tuv_SVM","SVM",97,27,0,0,0,2784,2520,264,0.763823064770932,0.149606299212598,1.28387096774194,731,264,467,4,1.8,100,9.5,0,0,0,0,0,0,0,0,0
9.7,"max_tuv_SVM","SVM",98,0,2684,2425,259,100,91,9,0.761833429357924,0.16260162601626,1.27343299239444,26,9,17,0,1.9,3.59,10.1,0,0,0,0,0,0,0.261088956334049,266.914342631572,33.0053885701966
9.7,"max_tuv_SVM","SVM",98,1,2584,2345,239,200,171,29,0.609500032008196,0.292682926829268,1.00204563335956,80,29,51,54,1.8,7.18,5.9,0,0,0,0,0,0,0.178433801207762,345.103796466781,19.4440390019215
9.7,"max_tuv_SVM","SVM",98,2,2484,2280,204,300,236,64,0.661987068689587,0.146341463414634,1.09397087531133,158,64,94,78,1.5,10.78,3.7,0,0,0,0,0,0,0.464450214886611,454.603578791848,53.0777434540831
9.7,"max_tuv_SVM","SVM",98,3,2384,2186,198,400,330,70,0.671499903975418,0.24390243902439,1.09598741148702,168,70,98,10,1.4,14.37,4.7,0,0,0,0,0,0,0.223128810773591,314.356375181196,27.2678987879419
9.7,"max_tuv_SVM","SVM",98,4,2284,2106,178,500,410,90,0.72569617822163,0.252032520325203,1.1481772882245,227,90,137,59,1.5,17.96,4.6,0,0,0,0,0,0,0.181466019824678,188.868612573538,20.4059554908347
9.7,"max_tuv_SVM","SVM",98,5,2184,2028,156,600,488,112,0.719057678765766,0.284552845528455,1.137739312877,272,112,160,45,1.4,21.55,4.4,0,0,0,0,0,0,0.16789905661614,138.890344840263,18.8730123080352
9.7,"max_tuv_SVM","SVM",98,6,2084,1960,124,700,556,144,0.704077843928049,0.292682926829268,1.1273013375295,339,144,195,67,1.4,25.14,3.9,0,0,0,0,0,0,0.190036301155443,202.223490388763,20.9311752226259
9.7,"max_tuv_SVM","SVM",98,7,1984,1875,109,800,641,159,0.714250048012289,0.292682926829268,1.1481772882245,384,159,225,45,1.4,28.74,4,0,0,0,0,0,0,0.169479843826871,138.225711207375,18.7556059036934
9.7,"max_tuv_SVM","SVM",98,8,1884,1793,91,900,723,177,0.721112604826834,0.292682926829268,1.15861526357199,423,177,246,39,1.4,32.33,4.1,0,0,0,0,0,0,0.167805043885514,125.962341141927,18.7770530964472
9.7,"max_tuv_SVM","SVM",98,9,1784,1706,78,1000,810,190,0.697503360860384,0.24390243902439,1.18992918961448,461,190,271,38,1.4,35.92,4.3,0,0,0,0,0,0,0.185177911443934,143.476608692528,22.9902490862181
9.7,"max_tuv_SVM","SVM",98,10,1684,1607,77,1100,909,191,0.732174636707006,0.235772357723577,1.23168109100446,478,191,287,17,1.5,39.51,4.8,0,0,0,0,0,0,0.162398717948115,111.550763755891,18.4474882867636
9.7,"max_tuv_SVM","SVM",98,11,1584,1513,71,1200,1003,197,0.771935215415162,0.252032520325203,1.27343299239444,494,197,297,16,1.5,43.1,5.1,0,0,0,0,0,0,0.140387896704895,83.6436574941649,21.1346794948798
9.7,"max_tuv_SVM","SVM",98,12,1484,1420,64,1300,1096,204,0.757826003456896,0.300813008130081,1.25255704169945,504,204,300,10,1.5,46.7,5.4,0,0,0,0,0,0,0.15658580438026,219.495552771648,16.5343282339026
9.7,"max_tuv_SVM","SVM",98,13,1384,1329,55,1400,1187,213,0.789514115613606,0.333333333333333,1.26299501704694,525,213,312,21,1.5,50.29,5.6,0,0,0,0,0,0,0.119216884859901,67.0553398103555,14.4167627249164
9.7,"max_tuv_SVM","SVM",98,14,1284,1241,43,1500,1275,225,0.769739453300053,0.252032520325203,1.26299501704694,571,225,346,46,1.5,53.88,5.7,0,0,0,0,0,0,0.120520007295769,53.7786551194991,16.1066625226656
9.7,"max_tuv_SVM","SVM",98,15,1184,1153,31,1600,1363,237,0.771237436783826,0.252032520325203,1.24211906635195,612,237,375,41,1.6,57.47,5.8,0,0,0,0,0,0,0.115092313468088,49.7374682068432,14.2681215459785
9.7,"max_tuv_SVM","SVM",98,16,1084,1068,16,1700,1448,252,0.792010754753225,0.24390243902439,1.24211906635195,655,252,403,43,1.6,61.06,5.7,0,0,0,0,0,0,0.116223363516917,50.7456145264837,14.8342529016074
9.7,"max_tuv_SVM","SVM",98,17,984,970,14,1800,1546,254,0.789469304141869,0.284552845528455,1.24211906635195,660,254,406,5,1.6,64.66,6.1,0,0,0,0,0,0,0.0777385398692373,27.5677844808626,10.6245803580374
9.7,"max_tuv_SVM","SVM",98,18,884,871,13,1900,1645,255,0.784770501248327,0.260162601626016,1.24211906635195,656,255,401,-4,1.6,68.25,6.5,0,0,0,0,0,0,0.0461986932471176,16.5476989481349,7.14232018968063
9.7,"max_tuv_SVM","SVM",98,19,784,774,10,2000,1742,258,0.800448114717372,0.252032520325203,1.26299501704694,681,258,423,25,1.6,71.84,6.8,0,0,0,0,0,0,0.0583983317202505,20.844567708626,12.3013120860845
9.7,"max_tuv_SVM","SVM",98,20,684,677,7,2100,1839,261,0.810895589270859,0.252032520325203,1.26299501704694,669,261,408,-12,1.6,75.43,7,0,0,0,0,0,0,0.0604544268167543,21.182942946356,9.60360853413829
9.7,"max_tuv_SVM","SVM",98,21,584,577,7,2200,1939,261,0.810357851610018,0.292682926829268,1.26299501704694,697,261,436,28,1.7,79.02,7.4,0,0,0,0,0,0,0.0314041221499113,10.7685692235929,5.23590510819758
9.7,"max_tuv_SVM","SVM",98,22,484,480,4,2300,2036,264,0.77499519877089,0.211382113821138,1.27343299239444,744,264,480,47,1.8,82.61,7.7,0,0,0,0,0,0,0.0368397546422207,11.2380018407469,6.61132968265377
9.7,"max_tuv_SVM","SVM",98,23,384,382,2,2400,2134,266,0.840151078676144,0.284552845528455,1.27343299239444,715,266,449,-29,1.7,86.21,8,0,0,0,0,0,0,0.00964628202740471,3.4441900414156,2.63842913924019
9.7,"max_tuv_SVM","SVM",98,24,284,283,1,2500,2233,267,0.829588374623912,0.317073170731707,1.27343299239444,760,267,493,45,1.8,89.8,8.4,0,0,0,0,0,0,0.00765739880196926,3.50008802683104,2.93692217427694
9.7,"max_tuv_SVM","SVM",98,25,184,184,0,2600,2332,268,0.764374879969272,0.178861788617886,1.27343299239444,750,268,482,-10,1.8,93.39,8.7,0,0,0,0,0,0,0.0187831842329742,14.7542165940177,14.1881761336847
9.7,"max_tuv_SVM","SVM",98,26,84,84,0,2700,2432,268,0.774675116829907,0.235772357723577,1.28387096774194,761,268,493,11,1.8,96.98,9.1,0,0,0,0,0,0,1.8097384824345e-05,1.2802859950087,1.2802859950087
9.7,"max_tuv_SVM","SVM",98,27,0,0,0,2784,2516,268,0.772568977658284,0.203252032520325,1.27343299239444,768,268,500,7,1.9,100,9.4,0,0,0,0,0,0,0,0,0
9.7,"max_tuv_SVM","SVM",99,0,2684,2414,270,100,88,12,0.767962788304902,0.247706422018349,1.20142053862089,34,12,22,0,1.8,3.59,7.3,0,0,0,0,0,0,0.181262453422215,327.208543495195,19.6643653784944
9.7,"max_tuv_SVM","SVM",99,1,2584,2350,234,200,152,48,0.783674869244625,0.211009174311927,1.22497780408405,109,48,61,75,1.3,7.18,3.2,0,0,0,0,0,0,0.262842715330032,447.572189128727,28.1360213126974
9.7,"max_tuv_SVM","SVM",99,2,2484,2281,203,300,221,79,0.739189459544427,0.201834862385321,1.14252737496301,172,79,93,63,1.2,10.78,2.8,0,0,0,0,0,0,0.263672863416591,391.371391515799,28.3753985067868
9.7,"max_tuv_SVM","SVM",99,3,2384,2201,183,400,301,99,0.715939295207065,0.211009174311927,1.15430600769458,227,99,128,55,1.3,14.37,3,0,0,0,0,0,0,0.216980538747457,250.717688390633,24.3044911983388
9.7,"max_tuv_SVM","SVM",99,4,2284,2125,159,500,377,123,0.75142187544657,0.229357798165138,1.17786327315774,279,123,156,52,1.3,17.96,3.1,0,0,0,0,0,0,0.237315143106474,379.699508936628,24.5855914584281
9.7,"max_tuv_SVM","SVM",99,5,2184,2054,130,600,448,152,0.753711880876854,0.201834862385321,1.17677868450842,357,152,205,78,1.3,21.55,2.9,0,0,0,0,0,0,0.238851537870197,288.299044314791,27.4919675302239
9.7,"max_tuv_SVM","SVM",99,6,2084,1979,105,700,523,177,0.757237989082289,0.18348623853211,1.2485350695472,411,177,234,54,1.3,25.14,3,0,0,0,0,0,0,0.252427059675879,413.982444245127,29.270935982465
9.7,"max_tuv_SVM","SVM",99,7,1984,1887,97,800,615,185,0.79656463459945,0.256880733944954,1.27209233501036,430,185,245,19,1.3,28.74,3.3,0,0,0,0,0,0,0.209806736037984,191.862867041748,22.9381165748514
9.7,"max_tuv_SVM","SVM",99,8,1884,1802,82,900,700,200,0.793456514904689,0.26605504587156,1.26031370227878,469,200,269,39,1.3,32.33,3.5,0,0,0,0,0,0,0.195133400743442,208.255870138869,20.3997898117701
9.7,"max_tuv_SVM","SVM",99,9,1784,1717,67,1000,785,215,0.801644802652267,0.247706422018349,1.26031370227878,507,215,292,38,1.4,35.92,3.7,0,0,0,0,0,0,0.196072810663048,182.885710656139,20.4879236160524
9.7,"max_tuv_SVM","SVM",99,10,1684,1634,50,1100,868,232,0.800015719226048,0.238532110091743,1.26031370227878,552,232,320,45,1.4,39.51,3.7,0,0,0,0,0,0,0.188332366510347,148.493120610806,21.1370316186343
9.7,"max_tuv_SVM","SVM",99,11,1584,1544,40,1200,958,242,0.809961702249285,0.220183486238532,1.2485350695472,586,242,344,34,1.4,43.1,4,0,0,0,0,0,0,0.166297049857116,110.736513589071,17.8121304570504
9.7,"max_tuv_SVM","SVM",99,12,1484,1453,31,1300,1049,251,0.816799565577759,0.211009174311927,1.2485350695472,618,251,367,32,1.5,46.7,4.2,0,0,0,0,0,0,0.164853690591557,109.221202790244,17.5900491794149
9.7,"max_tuv_SVM","SVM",99,13,1384,1357,27,1400,1145,255,0.808918517248285,0.238532110091743,1.2485350695472,626,255,371,8,1.5,50.29,4.5,0,0,0,0,0,0,0.143513979396437,88.9992288660163,15.288653414845
9.7,"max_tuv_SVM","SVM",99,14,1284,1259,25,1500,1243,257,0.812526794135306,0.247706422018349,1.2485350695472,623,257,366,-3,1.4,53.88,4.8,0,0,0,0,0,0,0.124856282760851,70.2165924240049,13.4159761530428
9.7,"max_tuv_SVM","SVM",99,15,1184,1162,22,1600,1340,260,0.814141587356033,0.229357798165138,1.26031370227878,650,260,390,27,1.5,57.47,5.2,0,0,0,0,0,0,0.12657843121563,92.0043342647973,13.4427853957562
9.7,"max_tuv_SVM","SVM",99,16,1084,1064,20,1700,1438,262,0.818714453113842,0.229357798165138,1.2485350695472,663,262,401,13,1.5,61.06,5.5,0,0,0,0,0,0,0.0971115188453269,49.2435037953162,11.0868619275615
9.7,"max_tuv_SVM","SVM",99,17,984,965,19,1800,1537,263,0.797079081997205,0.211009174311927,1.26031370227878,658,263,395,-5,1.5,64.66,5.8,0,0,0,0,0,0,0.0651840882429294,29.21574392856,8.15225027860961
9.7,"max_tuv_SVM","SVM",99,18,884,865,19,1900,1637,263,0.814077281431313,0.247706422018349,1.26031370227878,655,263,392,-3,1.5,68.25,6.2,0,0,0,0,0,0,0.0598785609393903,26.338601156805,7.21293670574393
9.7,"max_tuv_SVM","SVM",99,19,784,765,19,2000,1737,263,0.810454714338798,0.238532110091743,1.26031370227878,673,263,410,18,1.6,71.84,6.6,0,0,0,0,0,0,0.0524713138928696,20.84639219868,6.79714158215832
9.7,"max_tuv_SVM","SVM",99,20,684,665,19,2100,1837,263,0.811783703449662,0.220183486238532,1.2485350695472,665,263,402,-8,1.5,75.43,7,0,0,0,0,0,0,0.0226483756109653,7.93027804031316,3.52001681670811
9.7,"max_tuv_SVM","SVM",99,21,584,565,19,2200,1937,263,0.809540141187236,0.238532110091743,1.2485350695472,648,263,385,-17,1.5,79.02,7.4,0,0,0,0,0,0,0.00635271492620782,2.17183385539538,1.27941506817889
9.7,"max_tuv_SVM","SVM",99,22,484,468,16,2300,2034,266,0.802845179913693,0.220183486238532,1.2485350695472,665,266,399,17,1.5,82.61,7.6,0,0,0,0,0,0,0.00803295671423833,2.80948761224994,1.87720361039113
9.7,"max_tuv_SVM","SVM",99,23,384,368,16,2400,2134,266,0.773721741118641,0.146788990825688,1.2485350695472,664,266,398,-1,1.5,86.21,8,0,0,0,0,0,0,0.001324063239655,0.428271598071019,0.343187482682919
9.7,"max_tuv_SVM","SVM",99,24,284,275,9,2500,2227,273,0.761039183743466,0.174311926605505,1.26031370227878,729,273,456,65,1.7,89.8,8.2,0,0,0,0,0,0,0.0729352023404459,17.9257975527904,13.600615671896
9.7,"max_tuv_SVM","SVM",99,25,184,178,6,2600,2324,276,0.786039898253741,0.220183486238532,1.27209233501036,731,276,455,2,1.6,93.39,8.4,0,0,0,0,0,0,0.0544358519682975,10.6134074093724,8.34509673480612
9.7,"max_tuv_SVM","SVM",99,26,84,84,0,2700,2418,282,0.783567692703423,0.192660550458716,1.28387096774194,746,282,464,15,1.6,96.98,8.6,0,0,0,0,0,0,1.65360832445527e-05,0.46545086088657,0.46545086088657
9.7,"max_tuv_SVM","SVM",99,27,0,0,0,2784,2502,282,0.774050415844982,0.119266055045872,1.27209233501036,754,282,472,8,1.7,100,8.9,0,0,0,0,0,0,0,0,0
9.7,"max_tuv_SVM","SVM",100,0,2684,2444,240,100,91,9,0.705976064219049,0.316901408450704,1.21154020899591,27,9,18,0,2,3.59,10.1,0,0,0,0,0,0,0.157552225466152,249.602709762908,22.4595881814727
9.7,"max_tuv_SVM","SVM",100,1,2584,2372,212,200,163,37,0.739250852838851,0.246478873239437,1.26578827805543,94,37,57,67,1.5,7.18,4.4,0,0,0,0,0,0,0.259368596918628,326.419659714386,34.3503855456336
9.7,"max_tuv_SVM","SVM",100,2,2484,2286,198,300,249,51,0.826302338410964,0.330985915492958,1.28387096774194,125,51,74,31,1.5,10.78,4.9,0,0,0,0,0,0,0.209304846339968,255.946482515021,23.4963850540409
9.7,"max_tuv_SVM","SVM",100,3,2384,2212,172,400,323,77,0.837712928248951,0.330985915492958,1.28387096774194,188,77,111,63,1.4,14.37,4.2,0,0,0,0,0,0,0.210878033744561,214.231966567582,23.2121622646259
9.7,"max_tuv_SVM","SVM",100,4,2284,2144,140,500,391,109,0.775548575224325,0.154929577464789,1.27482962289868,264,109,155,76,1.4,17.96,3.6,0,0,0,0,0,0,0.284222007046967,298.937537713776,36.2598394131811
9.7,"max_tuv_SVM","SVM",100,5,2184,2054,130,600,481,119,0.824529109107071,0.295774647887324,1.27482962289868,290,119,171,26,1.4,21.55,4,0,0,0,0,0,0,0.219485821175206,191.48981761012,24.6269446078894
9.7,"max_tuv_SVM","SVM",100,6,2084,1981,103,700,554,146,0.836114207225763,0.302816901408451,1.27482962289868,366,146,220,76,1.5,25.14,3.8,0,0,0,0,0,0,0.221498443768231,192.48107685107,24.5191223342192
9.7,"max_tuv_SVM","SVM",100,7,1984,1906,78,800,629,171,0.836665878564751,0.274647887323944,1.27482962289868,425,171,254,59,1.5,28.74,3.7,0,0,0,0,0,0,0.20429206814507,135.340727314233,23.6182924995905
9.7,"max_tuv_SVM","SVM",100,8,1884,1821,63,900,714,186,0.835877776651911,0.302816901408451,1.27482962289868,466,186,280,41,1.5,32.33,3.8,0,0,0,0,0,0,0.203475941282307,115.086528623636,23.7026522536517
9.7,"max_tuv_SVM","SVM",100,9,1784,1727,57,1000,808,192,0.83216243906283,0.302816901408451,1.27482962289868,479,192,287,13,1.5,35.92,4.2,0,0,0,0,0,0,0.165826073962128,98.499288325852,19.6986764221212
9.7,"max_tuv_SVM","SVM",100,10,1684,1642,42,1100,893,207,0.838501030161782,0.309859154929577,1.27482962289868,516,207,309,37,1.5,39.51,4.3,0,0,0,0,0,0,0.133405852190796,63.4724572548036,17.3485019446877
9.7,"max_tuv_SVM","SVM",100,11,1584,1548,36,1200,987,213,0.83216243906283,0.309859154929577,1.27482962289868,538,213,325,22,1.5,43.1,4.6,0,0,0,0,0,0,0.130249134744418,69.4017093710223,16.5719056350383
9.7,"max_tuv_SVM","SVM",100,12,1484,1457,27,1300,1078,222,0.817092804629533,0.28169014084507,1.27482962289868,561,222,339,23,1.5,46.7,4.9,0,0,0,0,0,0,0.101177308705108,50.6530294560645,14.2702620537525
9.7,"max_tuv_SVM","SVM",100,13,1384,1362,22,1400,1173,227,0.819952488713253,0.295774647887324,1.27482962289868,598,227,371,37,1.6,50.29,5.2,0,0,0,0,0,0,0.0859454183934842,39.0491208599617,12.9416008362147
9.7,"max_tuv_SVM","SVM",100,14,1284,1268,16,1500,1267,233,0.808508123078994,0.246478873239437,1.26578827805543,608,233,375,10,1.6,53.88,5.4,0,0,0,0,0,0,0.0618827347791087,24.3046211666172,11.0061411022315
9.7,"max_tuv_SVM","SVM",100,15,1184,1176,8,1600,1359,241,0.815223877236242,0.28169014084507,1.25674693321218,647,241,406,39,1.7,57.47,5.6,0,0,0,0,0,0,0.0466141715504045,18.4293627105877,9.17268342942029
9.7,"max_tuv_SVM","SVM",100,16,1084,1079,5,1700,1456,244,0.784448497539994,0.23943661971831,1.26578827805543,668,244,424,21,1.7,61.06,6,0,0,0,0,0,0,0.0607193430598338,28.6926305909829,10.206996180848
9.7,"max_tuv_SVM","SVM",100,17,984,979,5,1800,1556,244,0.766682428704921,0.232394366197183,1.27482962289868,663,244,419,-5,1.7,64.66,6.4,0,0,0,0,0,0,0.0299872658889458,10.0606650272671,6.62429310612944
9.7,"max_tuv_SVM","SVM",100,18,884,879,5,1900,1656,244,0.810742954931827,0.288732394366197,1.26578827805543,675,244,431,12,1.8,68.25,6.8,0,0,0,0,0,0,0.0120660260397016,5.26673999262462,3.99884159447533
9.7,"max_tuv_SVM","SVM",100,19,784,780,4,2000,1755,245,0.801494016054754,0.288732394366197,1.27482962289868,698,245,453,23,1.8,71.84,7.2,0,0,0,0,0,0,0.125732141914935,45.3695445945109,20.7983672548704
9.7,"max_tuv_SVM","SVM",100,20,684,682,2,2100,1853,247,0.74472816113306,0.225352112676056,1.25674693321218,702,247,455,4,1.8,75.43,7.5,0,0,0,0,0,0,0.0581171784611998,23.77915100646,18.4394527734502
9.7,"max_tuv_SVM","SVM",100,21,584,582,2,2200,1953,247,0.755170511478136,0.197183098591549,1.27482962289868,686,247,439,-16,1.8,79.02,7.9,0,0,0,0,0,0,0.0190915281960252,7.30099078605989,5.86353067717391
9.7,"max_tuv_SVM","SVM",100,22,484,483,1,2300,2052,248,0.801184404588999,0.288732394366197,1.27482962289868,702,248,454,16,1.8,82.61,8.3,0,0,0,0,0,0,0.00886661476441667,4.58978758837372,3.84727849510334
9.7,"max_tuv_SVM","SVM",100,23,384,384,0,2400,2151,249,0.722391101203542,0.204225352112676,1.27482962289868,735,249,486,33,2,86.21,8.6,0,0,0,0,0,0,0.0284513880743246,11.1258979850784,8.93722095089664
9.7,"max_tuv_SVM","SVM",100,24,284,284,0,2500,2251,249,0.728476373830508,0.169014084507042,1.27482962289868,730,249,481,-5,1.9,89.8,9,0,0,0,0,0,0,0.00236805714851019,2.7618754203947,2.65743921468662
9.7,"max_tuv_SVM","SVM",100,25,184,184,0,2600,2351,249,0.763361142072251,0.183098591549296,1.27482962289868,721,249,472,-9,1.9,93.39,9.4,0,0,0,0,0,0,0.000519223228335797,2.25721766892987,2.24222265995682
9.7,"max_tuv_SVM","SVM",100,26,84,84,0,2700,2451,249,0.735625584039806,0.140845070422535,1.26578827805543,721,249,472,0,1.9,96.98,9.8,0,0,0,0,0,0,1.0000000994736e-07,2.00957691599581,2.00957691599581
9.7,"max_tuv_SVM","SVM",100,27,0,0,0,2784,2535,249,0.800728431339432,0.316901408450704,1.27482962289868,721,249,472,0,1.9,100,10.2,0,0,0,0,0,0,0,0,0
9.7,"greedy_SVM","SVM",1,0,2684,2444,240,100,92,8,0.8167944055944,0.286713286713287,1.25693661177532,19,8,11,0,1.4,3.59,11.5,0,0,0,0,0,0,0.274861358709326,209.038902484711,33.7440753435211
9.7,"greedy_SVM","SVM",1,1,2584,2361,223,200,175,25,0.83282797202797,0.335664335664336,1.2500240364585,69,25,44,50,1.8,7.18,7,0,0,0,0,0,0,0.482314452565512,275.904369363639,55.8707699618598
9.7,"greedy_SVM","SVM",1,2,2484,2298,186,300,238,62,0.724772027972024,0.188811188811189,1.23898037446425,162,62,100,93,1.6,10.78,3.8,0,0,0,0,0,0,0.256321437690206,383.330666559266,31.3139046991505
9.7,"greedy_SVM","SVM",1,3,2384,2210,174,400,326,74,0.766847552447548,0.258741258741259,1.20306789984209,188,74,114,26,1.5,14.37,4.4,0,0,0,0,0,0,0.193437109774077,395.532881710036,20.7803548204084
9.7,"greedy_SVM","SVM",1,4,2284,2140,144,500,396,104,0.779871328671325,0.265734265734266,1.21204601849763,262,104,158,74,1.5,17.96,3.8,0,0,0,0,0,0,0.227952209336798,207.667996159596,23.7926547282095
9.7,"greedy_SVM","SVM",1,5,2184,2071,113,600,465,135,0.780654545454542,0.265734265734266,1.21204601849763,322,135,187,60,1.4,21.55,3.4,0,0,0,0,0,0,0.232393684380215,189.361037442916,23.7285579760761
9.7,"greedy_SVM","SVM",1,6,2084,2004,80,700,532,168,0.778819580419572,0.272727272727273,1.21204601849763,400,168,232,78,1.4,25.14,3.2,0,0,0,0,0,0,0.239362174199267,159.939481429149,24.6378511739097
9.7,"greedy_SVM","SVM",1,7,1984,1922,62,800,614,186,0.780609790209782,0.272727272727273,1.21204601849763,441,186,255,41,1.4,28.74,3.3,0,0,0,0,0,0,0.214088141596193,117.661162768692,22.592805549516
9.7,"greedy_SVM","SVM",1,8,1884,1838,46,900,698,202,0.785051748251747,0.244755244755245,1.21204601849763,487,202,285,46,1.4,32.33,3.5,0,0,0,0,0,0,0.201877796711222,107.993618133046,21.3753891335888
9.7,"greedy_SVM","SVM",1,9,1784,1744,40,1000,792,208,0.781269930069928,0.293706293706294,1.21204601849763,516,208,308,29,1.5,35.92,3.8,0,0,0,0,0,0,0.17009849007362,83.2120425398818,18.2789824651015
9.7,"greedy_SVM","SVM",1,10,1684,1648,36,1100,888,212,0.770539860139857,0.251748251748252,1.19408978118656,519,212,307,3,1.4,39.51,4.2,0,0,0,0,0,0,0.142703565964165,53.2253792269429,15.6380311811959
9.7,"greedy_SVM","SVM",1,11,1584,1548,36,1200,988,212,0.770959440559436,0.251748251748252,1.19408978118656,527,212,315,8,1.5,43.1,4.7,0,0,0,0,0,0,0.0780538133498774,19.0552857357939,9.39416620733704
9.7,"greedy_SVM","SVM",1,12,1484,1451,33,1300,1085,215,0.767597202797202,0.272727272727273,1.20306789984209,535,215,320,8,1.5,46.7,5,0,0,0,0,0,0,0.14290243728771,56.1435131141881,18.5605871419732
9.7,"greedy_SVM","SVM",1,13,1384,1360,24,1400,1176,224,0.740234965034964,0.181818181818182,1.19408978118656,574,224,350,39,1.6,50.29,5.2,0,0,0,0,0,0,0.155962754229925,84.3386850277369,16.9188994392093
9.7,"greedy_SVM","SVM",1,14,1284,1262,22,1500,1274,226,0.724702097902097,0.153846153846154,1.1929902510013,610,226,384,36,1.7,53.88,5.6,0,0,0,0,0,0,0.166356703254351,64.828331035757,19.1915786564978
9.7,"greedy_SVM","SVM",1,15,1184,1163,21,1600,1373,227,0.738254545454546,0.230769230769231,1.20306789984209,613,227,386,3,1.7,57.47,6,0,0,0,0,0,0,0.122715411453207,41.9858128958669,13.4398652738955
9.7,"greedy_SVM","SVM",1,16,1084,1066,18,1700,1470,230,0.736179020979022,0.174825174825175,1.20306789984209,619,230,389,6,1.7,61.06,6.4,0,0,0,0,0,0,0.101391299644789,29.7491261066048,12.1916849823607
9.7,"greedy_SVM","SVM",1,17,984,966,18,1800,1570,230,0.744262937062935,0.195804195804196,1.19408978118656,621,230,391,2,1.7,64.66,6.8,0,0,0,0,0,0,0.0900516537321749,21.6424522984958,9.99354316902425
9.7,"greedy_SVM","SVM",1,18,884,867,17,1900,1669,231,0.779675524475527,0.272727272727273,1.20306789984209,613,231,382,-8,1.7,68.25,7.2,0,0,0,0,0,0,0.021687258437922,6.22695699627232,5.53857313400216
9.7,"greedy_SVM","SVM",1,19,784,767,17,2000,1769,231,0.757395804195804,0.20979020979021,1.21204601849763,612,231,381,-1,1.6,71.84,7.7,0,0,0,0,0,0,1.55590515014904e-08,0.219137693786103,0.219137466909343
9.7,"greedy_SVM","SVM",1,20,684,671,13,2100,1865,235,0.776699300699295,0.258741258741259,1.24795849311978,614,235,379,2,1.6,75.43,7.9,0,0,0,0,0,0,2.60012196074367e-06,1.69889631652765,1.69883100128919
9.7,"greedy_SVM","SVM",1,21,584,578,6,2200,1958,242,0.750243356643357,0.188811188811189,1.2647490630916,655,242,413,41,1.7,79.02,8.1,0,0,0,0,0,0,0.091544547263407,28.2620147397673,12.7646944170515
9.7,"greedy_SVM","SVM",1,22,484,479,5,2300,2057,243,0.747692307692306,0.160839160839161,1.25577921158032,677,243,434,22,1.8,82.61,8.5,0,0,0,0,0,0,0.0682739668237407,21.4768455197924,8.40372405734454
9.7,"greedy_SVM","SVM",1,23,384,380,4,2400,2156,244,0.757924475524476,0.244755244755245,1.2647490630916,676,244,432,-1,1.8,86.21,8.8,0,0,0,0,0,0,0.0352170683779003,9.49222795312413,6.15259606663575
9.7,"greedy_SVM","SVM",1,24,284,283,1,2500,2253,247,0.7924979020979,0.251748251748252,1.28268876611418,691,247,444,15,1.8,89.8,9.1,0,0,0,0,0,0,0.00755895731711472,2.46783729836354,2.12825828173248
9.7,"greedy_SVM","SVM",1,25,184,183,1,2600,2353,247,0.804844755244752,0.258741258741259,1.28268876611418,679,247,432,-12,1.7,93.39,9.5,0,0,0,0,0,0,5.38872829217887e-06,0.405884761028359,0.405797232683549
9.7,"greedy_SVM","SVM",1,26,84,83,1,2700,2453,247,0.769918881118878,0.223776223776224,1.28268876611418,688,247,441,9,1.8,96.98,9.9,0,0,0,0,0,0,5.32800615125958e-09,0.00351200789262038,0.00351200789262038
9.7,"greedy_SVM","SVM",1,27,0,0,0,2784,2536,248,0.76430769230769,0.202797202797203,1.27371891460289,708,248,460,20,1.9,100,10.2,0,0,0,0,0,0,0,0,0
9.7,"greedy_SVM","SVM",2,0,2684,2438,246,100,89,11,0.750903939397533,0.246268656716418,1.23596533461724,32,11,21,0,1.9,3.59,8.1,0,0,0,0,0,0,0.125532650621015,301.852585932197,14.578560630903
9.7,"greedy_SVM","SVM",2,1,2584,2356,228,200,171,29,0.764892772041307,0.276119402985075,1.2263842079923,87,29,58,55,2,7.18,5.9,0,0,0,0,0,0,0.22943001082507,327.295289490125,24.1552135441409
9.7,"greedy_SVM","SVM",2,2,2484,2284,200,300,243,57,0.776249807357181,0.291044776119403,1.24554646124218,160,57,103,73,1.8,10.78,4.3,0,0,0,0,0,0,0.230254366139853,358.171744800855,23.9383516703324
9.7,"greedy_SVM","SVM",2,3,2384,2200,184,400,327,73,0.753677996040448,0.111940298507463,1.26470871449206,209,73,136,49,1.9,14.37,4.5,0,0,0,0,0,0,0.244182013758293,271.797942650757,26.1801458138901
9.7,"greedy_SVM","SVM",2,4,2284,2108,176,500,419,81,0.801767571989141,0.328358208955224,1.25512758786712,244,81,163,35,2,17.96,5.2,0,0,0,0,0,0,0.185821026425493,200.946101137318,18.9131496618863
9.7,"greedy_SVM","SVM",2,5,2184,2044,140,600,483,117,0.776409849086578,0.238805970149254,1.25512758786712,316,117,199,72,1.7,21.55,4.1,0,0,0,0,0,0,0.235822459985828,181.905198322409,25.1487715132728
9.7,"greedy_SVM","SVM",2,6,2084,1972,112,700,555,145,0.793558024018116,0.26865671641791,1.25512758786712,384,145,239,68,1.6,25.14,3.8,0,0,0,0,0,0,0.223619395952894,158.576724933044,23.7295191946004
9.7,"greedy_SVM","SVM",2,7,1984,1897,87,800,630,170,0.787701682216401,0.276119402985075,1.25512758786712,448,170,278,64,1.6,28.74,3.7,0,0,0,0,0,0,0.21650252992536,108.711205250944,22.8740826666185
9.7,"greedy_SVM","SVM",2,8,1884,1819,65,900,708,192,0.788312211776702,0.276119402985075,1.24554646124218,497,192,305,49,1.6,32.33,3.7,0,0,0,0,0,0,0.212184723453146,121.492123508593,22.1051633197619
9.7,"greedy_SVM","SVM",2,9,1784,1733,51,1000,794,206,0.788531528220693,0.253731343283582,1.2263842079923,528,206,322,31,1.6,35.92,3.9,0,0,0,0,0,0,0.191288346278388,100.763623075033,20.4477358054527
9.7,"greedy_SVM","SVM",2,10,1684,1651,33,1100,876,224,0.772829656325206,0.223880597014925,1.21680308136736,593,224,369,65,1.6,39.51,3.9,0,0,0,0,0,0,0.172985796358414,74.0436050002461,19.11763353622
9.7,"greedy_SVM","SVM",2,11,1584,1555,29,1200,972,228,0.7932260856164,0.313432835820896,1.21680308136736,601,228,373,8,1.6,43.1,4.3,0,0,0,0,0,0,0.129660675257466,52.1596625297686,14.8964871608652
9.7,"greedy_SVM","SVM",2,12,1484,1460,24,1300,1067,233,0.791358932106742,0.26865671641791,1.2263842079923,607,233,374,6,1.6,46.7,4.6,0,0,0,0,0,0,0.128001975531883,61.1794056318023,17.1801894006868
9.7,"greedy_SVM","SVM",2,13,1384,1363,21,1400,1164,236,0.779877419890226,0.26865671641791,1.19764082811748,624,236,388,17,1.6,50.29,4.9,0,0,0,0,0,0,0.096185001344964,45.3830204165417,12.5719948639207
9.7,"greedy_SVM","SVM",2,14,1284,1264,20,1500,1263,237,0.769883703009971,0.201492537313433,1.19764082811748,636,237,399,12,1.7,53.88,5.3,0,0,0,0,0,0,0.0455581497953475,16.302020238386,6.75441744353968
9.7,"greedy_SVM","SVM",2,15,1184,1164,20,1600,1363,237,0.781128116368121,0.261194029850746,1.19764082811748,643,237,406,7,1.7,57.47,5.8,0,0,0,0,0,0,0.0497613052997504,19.5428543333007,5.93095592143949
9.7,"greedy_SVM","SVM",2,16,1084,1066,18,1700,1461,239,0.783528742309109,0.238805970149254,1.26470871449206,642,239,403,-1,1.7,61.06,6.1,0,0,0,0,0,0,0.0677157969226434,32.5100698848481,10.8550544271195
9.7,"greedy_SVM","SVM",2,17,984,973,11,1800,1554,246,0.788169952461679,0.238805970149254,1.21680308136736,642,246,396,0,1.6,64.66,6.3,0,0,0,0,0,0,0.0484562235997927,20.2628673168575,6.14322464737144
9.7,"greedy_SVM","SVM",2,18,884,874,10,1900,1653,247,0.807096368830983,0.291044776119403,1.24554646124218,654,247,407,12,1.6,68.25,6.7,0,0,0,0,0,0,0.0319453378629944,11.7174788140548,5.10542537959977
9.7,"greedy_SVM","SVM",2,19,784,776,8,2000,1751,249,0.816669235237635,0.283582089552239,1.26470871449206,661,249,412,7,1.7,71.84,7,0,0,0,0,0,0,0.0169657660375861,5.60430716060901,3.15755731373515
9.7,"greedy_SVM","SVM",2,20,684,681,3,2100,1846,254,0.820646568586776,0.328358208955224,1.26470871449206,684,254,430,23,1.7,75.43,7.3,0,0,0,0,0,0,0.00868693556953106,4.90971552929603,3.85209350188099
9.7,"greedy_SVM","SVM",2,21,584,583,1,2200,1944,256,0.788407051320054,0.216417910447761,1.26470871449206,688,256,432,4,1.7,79.02,7.6,0,0,0,0,0,0,0.00502854582028401,1.44758122653194,0.933925315477735
9.7,"greedy_SVM","SVM",2,22,484,484,0,2300,2043,257,0.78492762557349,0.216417910447761,1.25512758786712,710,257,453,22,1.8,82.61,7.9,0,0,0,0,0,0,0.00118011601062956,2.53877879649002,2.48180352509153
9.7,"greedy_SVM","SVM",2,23,384,384,0,2400,2143,257,0.806930399630128,0.261194029850746,1.26470871449206,700,257,443,-10,1.7,86.21,8.3,0,0,0,0,0,0,0.000343664690816133,0.193379675790125,0.174310546194126
9.7,"greedy_SVM","SVM",2,24,284,284,0,2500,2243,257,0.792230270411252,0.201492537313433,1.26470871449206,706,257,449,6,1.7,89.8,8.7,0,0,0,0,0,0,0.000181746896626145,0.0792288458498194,0.0683767475384905
9.7,"greedy_SVM","SVM",2,25,184,184,0,2600,2343,257,0.806663663414465,0.261194029850746,1.26470871449206,691,257,434,-15,1.7,93.39,9.1,0,0,0,0,0,0,1.51021665354684e-05,0.00599471776564765,0.00549663395486593
9.7,"greedy_SVM","SVM",2,26,84,84,0,2700,2443,257,0.820287956563492,0.276119402985075,1.26470871449206,709,257,452,18,1.8,96.98,9.5,0,0,0,0,0,0,1.0000000994736e-07,3.6640469186853e-05,3.6640469186853e-05
9.7,"greedy_SVM","SVM",2,27,0,0,0,2784,2527,257,0.774791649378214,0.216417910447761,1.26470871449206,699,257,442,-10,1.7,100,9.8,0,0,0,0,0,0,0,0,0
9.7,"greedy_SVM","SVM",3,0,2684,2447,237,100,85,15,0.690435211639306,0.172661870503597,1.05295892318403,41,15,26,0,1.7,3.59,5.7,0,0,0,0,0,0,0.397026325721534,414.697482464903,42.1728417550085
9.7,"greedy_SVM","SVM",3,1,2584,2353,231,200,179,21,0.669730244512531,0.115107913669065,1.08689959796868,55,21,34,14,1.6,7.18,8.5,0,0,0,0,0,0,0.480631902813249,305.841262074508,66.6260159497943
9.7,"greedy_SVM","SVM",3,2,2484,2261,223,300,271,29,0.759400135394081,0.280575539568345,1.23768855883036,79,29,50,24,1.7,10.78,9.3,0,0,0,0,0,0,0.154504091263495,226.559778039319,18.5934631120136
9.7,"greedy_SVM","SVM",3,3,2384,2177,207,400,355,45,0.803690062304228,0.345323741007194,1.25616152239499,119,45,74,40,1.6,14.37,7.9,0,0,0,0,0,0,0.162621431460237,216.195996669549,19.4302455151809
9.7,"greedy_SVM","SVM",3,4,2284,2105,179,500,427,73,0.76112124654344,0.237410071942446,1.23768855883036,185,73,112,66,1.5,17.96,5.8,0,0,0,0,0,0,0.170846026748569,256.281662463043,18.2646236216247
9.7,"greedy_SVM","SVM",3,5,2184,2027,157,600,505,95,0.760295113191744,0.244604316546763,1.22845207704804,236,95,141,51,1.5,21.55,5.3,0,0,0,0,0,0,0.174881768211893,217.102599809693,19.0100620876662
9.7,"greedy_SVM","SVM",3,6,2084,1946,138,700,586,114,0.748671875896417,0.172661870503597,1.23768855883036,280,114,166,44,1.5,25.14,5.1,0,0,0,0,0,0,0.187000883250426,175.565543084839,22.6501267289416
9.7,"greedy_SVM","SVM",3,7,1984,1854,130,800,678,122,0.791481647218114,0.302158273381295,1.24692504061267,303,122,181,23,1.5,28.74,5.6,0,0,0,0,0,0,0.173274553358725,107.122706970993,17.8267041390423
9.7,"greedy_SVM","SVM",3,8,1884,1790,94,900,742,158,0.796105699172721,0.338129496402878,1.24692504061267,389,158,231,86,1.5,32.33,4.7,0,0,0,0,0,0,0.195472064817773,96.0957384631384,20.6810946152324
9.7,"greedy_SVM","SVM",3,9,1784,1712,72,1000,820,180,0.790380136082524,0.316546762589928,1.24692504061267,440,180,260,51,1.4,35.92,4.6,0,0,0,0,0,0,0.165047931771217,77.867055961035,18.0093630203655
9.7,"greedy_SVM","SVM",3,10,1684,1626,58,1100,906,194,0.772078987527683,0.244604316546763,1.24692504061267,475,194,281,35,1.4,39.51,4.7,0,0,0,0,0,0,0.145228597439891,70.82882496652,16.2332894163031
9.7,"greedy_SVM","SVM",3,11,1584,1530,54,1200,1002,198,0.769445687469167,0.280575539568345,1.24692504061267,480,198,282,5,1.4,43.1,5.1,0,0,0,0,0,0,0.101406287154366,42.1711429681233,11.867333988539
9.7,"greedy_SVM","SVM",3,12,1484,1433,51,1300,1099,201,0.760283639117415,0.20863309352518,1.24692504061267,505,201,304,25,1.5,46.7,5.5,0,0,0,0,0,0,0.0938820394734094,43.5363071003255,10.5005197288089
9.7,"greedy_SVM","SVM",3,13,1384,1337,47,1400,1195,205,0.782302387754872,0.266187050359712,1.21921559526572,505,205,300,0,1.5,50.29,5.8,0,0,0,0,0,0,0.109389130924619,51.9026449240207,12.8498540335601
9.7,"greedy_SVM","SVM",3,14,1284,1243,41,1500,1289,211,0.787809943432815,0.258992805755396,1.21921559526572,523,211,312,18,1.5,53.88,6.1,0,0,0,0,0,0,0.0965413054718898,37.811937223546,11.2595034679254
9.7,"greedy_SVM","SVM",3,15,1184,1150,34,1600,1382,218,0.780340321044602,0.251798561151079,1.20997911348341,564,218,346,41,1.6,57.47,6.3,0,0,0,0,0,0,0.111985462162336,36.2780756652555,12.4196990728138
9.7,"greedy_SVM","SVM",3,16,1084,1057,27,1700,1475,225,0.813821669936782,0.294964028776978,1.21921559526572,572,225,347,8,1.5,61.06,6.6,0,0,0,0,0,0,0.0602916992192784,16.3436845917372,9.26683234246709
9.7,"greedy_SVM","SVM",3,17,984,969,15,1800,1563,237,0.816632818147404,0.302158273381295,1.20997911348341,623,237,386,51,1.6,64.66,6.6,0,0,0,0,0,0,0.0554314369189163,13.5520217605966,6.94571202978492
9.7,"greedy_SVM","SVM",3,18,884,869,15,1900,1663,237,0.808371484630483,0.294964028776978,1.20997911348341,612,237,375,-11,1.6,68.25,7,0,0,0,0,0,0,0.0142230233390397,3.81529668852615,2.88560751611124
9.7,"greedy_SVM","SVM",3,19,784,771,13,2000,1761,239,0.821457666402769,0.302158273381295,1.24692504061267,615,239,376,3,1.6,71.84,7.4,0,0,0,0,0,0,0.000571604291796718,0.361475665198366,0.344836530249707
9.7,"greedy_SVM","SVM",3,20,684,674,10,2100,1858,242,0.782107328491283,0.165467625899281,1.24692504061267,646,242,404,31,1.7,75.43,7.7,0,0,0,0,0,0,0.00196116200343611,0.765930695369598,0.532662235117129
9.7,"greedy_SVM","SVM",3,21,584,579,5,2200,1953,247,0.81150964395948,0.258992805755396,1.2653980041773,666,247,419,20,1.7,79.02,7.9,0,0,0,0,0,0,0.127441705389044,41.7184383164281,15.7567438777557
9.7,"greedy_SVM","SVM",3,22,484,479,5,2300,2053,247,0.814320792170104,0.237410071942446,1.24692504061267,657,247,410,-9,1.7,82.61,8.3,0,0,0,0,0,0,0.0581251251760772,15.1700265460749,7.23457621777668
9.7,"greedy_SVM","SVM",3,23,384,379,5,2400,2153,247,0.832392459238358,0.330935251798561,1.2653980041773,658,247,411,1,1.7,86.21,8.7,0,0,0,0,0,0,0.0471122567493849,11.5973574478131,6.05905110703908
9.7,"greedy_SVM","SVM",3,24,284,280,4,2500,2252,248,0.795239406560883,0.266187050359712,1.25616152239499,654,248,406,-4,1.6,89.8,9.1,0,0,0,0,0,0,0.0312835405508486,6.64949813523227,4.3432818714175
9.7,"greedy_SVM","SVM",3,25,184,181,3,2600,2351,249,0.797780914024765,0.244604316546763,1.2653980041773,655,249,406,1,1.6,93.39,9.4,0,0,0,0,0,0,0.0035542005369861,2.04337859278327,1.92619080839925
9.7,"greedy_SVM","SVM",3,26,84,84,0,2700,2448,252,0.838531089004398,0.294964028776978,1.28387096774194,659,252,407,4,1.6,96.98,9.7,0,0,0,0,0,0,3.81202061036476e-05,2.77131780209852,2.77131780209852
9.7,"greedy_SVM","SVM",3,27,0,0,0,2784,2532,252,0.830436129565247,0.302158273381295,1.27463448595962,669,252,417,10,1.7,100,10,0,0,0,0,0,0,0,0,0
9.7,"greedy_SVM","SVM",4,0,2684,2435,249,100,92,8,0.719227531919439,0.26865671641791,1.21680308136736,29,8,21,0,2.6,3.59,11.5,0,0,0,0,0,0,0.109879871932389,230.430067283199,11.9707329096446
9.7,"greedy_SVM","SVM",4,1,2584,2362,222,200,165,35,0.770577217170704,0.126865671641791,1.25512758786712,93,35,58,64,1.7,7.18,4.7,0,0,0,0,0,0,0.254655837166424,326.050343757031,28.0248406530236
9.7,"greedy_SVM","SVM",4,2,2484,2279,205,300,248,52,0.735658482804409,0.216417910447761,1.23596533461724,137,52,85,44,1.6,10.78,4.8,0,0,0,0,0,0,0.19103884706902,362.778963429663,21.4331648797502
9.7,"greedy_SVM","SVM",4,3,2384,2202,182,400,325,75,0.795282918212754,0.208955223880597,1.274289841117,194,75,119,57,1.6,14.37,4.3,0,0,0,0,0,0,0.213116684606638,315.043975333008,24.9477895347406
9.7,"greedy_SVM","SVM",4,4,2284,2116,168,500,411,89,0.802372174077986,0.238805970149254,1.26470871449206,241,89,152,47,1.7,17.96,4.6,0,0,0,0,0,0,0.194541936324499,284.214839309305,20.1555457488573
9.7,"greedy_SVM","SVM",4,5,2184,2046,138,600,481,119,0.822033596908236,0.283582089552239,1.274289841117,315,119,196,74,1.6,21.55,4,0,0,0,0,0,0,0.211094289371169,249.420933819906,21.8332143255356
9.7,"greedy_SVM","SVM",4,6,2084,1980,104,700,547,153,0.815762332104376,0.216417910447761,1.274289841117,375,153,222,60,1.5,25.14,3.6,0,0,0,0,0,0,0.233066821210113,217.50854400359,23.9428325306545
9.7,"greedy_SVM","SVM",4,7,1984,1907,77,800,620,180,0.817605775728195,0.246268656716418,1.274289841117,445,180,265,70,1.5,28.74,3.4,0,0,0,0,0,0,0.221955806918184,270.380236160943,22.8573690934809
9.7,"greedy_SVM","SVM",4,8,1884,1827,57,900,700,200,0.81435159389708,0.238805970149254,1.274289841117,502,200,302,57,1.5,32.33,3.5,0,0,0,0,0,0,0.193378752931495,147.328540253988,20.8876663520858
9.7,"greedy_SVM","SVM",4,9,1784,1741,43,1000,786,214,0.815252569558882,0.238805970149254,1.274289841117,554,214,340,52,1.6,35.92,3.7,0,0,0,0,0,0,0.201426041684869,183.436679163474,21.5669355582637
9.7,"greedy_SVM","SVM",4,10,1684,1648,36,1100,879,221,0.815857171647723,0.253731343283582,1.274289841117,573,221,352,19,1.6,39.51,4,0,0,0,0,0,0,0.189573231880458,240.979231029997,19.3970430596581
9.7,"greedy_SVM","SVM",4,11,1584,1556,28,1200,971,229,0.802751532251376,0.208955223880597,1.274289841117,589,229,360,16,1.6,43.1,4.2,0,0,0,0,0,0,0.136982342996133,72.0084550384339,16.1466592395846
9.7,"greedy_SVM","SVM",4,12,1484,1467,17,1300,1060,240,0.80617168328335,0.201492537313433,1.274289841117,617,240,377,28,1.6,46.7,4.4,0,0,0,0,0,0,0.149271980725464,87.5959755218034,18.4260255106607
9.7,"greedy_SVM","SVM",4,13,1384,1370,14,1400,1157,243,0.805644138323478,0.201492537313433,1.274289841117,625,243,382,8,1.6,50.29,4.8,0,0,0,0,0,0,0.12294340148816,62.4978526781324,14.0441989533389
9.7,"greedy_SVM","SVM",4,14,1284,1275,9,1500,1252,248,0.789468068711252,0.164179104477612,1.26470871449206,653,248,405,28,1.6,53.88,5,0,0,0,0,0,0,0.102729242915505,36.7735454844839,12.684875347262
9.7,"greedy_SVM","SVM",4,15,1184,1179,5,1600,1348,252,0.808364847723262,0.23134328358209,1.26470871449206,668,252,416,15,1.7,57.47,5.3,0,0,0,0,0,0,0.106508882418813,44.3045497110585,13.2461789807907
9.7,"greedy_SVM","SVM",4,16,1084,1081,3,1700,1446,254,0.799384728462536,0.238805970149254,1.26470871449206,684,254,430,16,1.7,61.06,5.7,0,0,0,0,0,0,0.0771638302869108,33.1917456585338,10.0761375107973
9.7,"greedy_SVM","SVM",4,17,984,981,3,1800,1546,254,0.765070596185082,0.216417910447761,1.274289841117,693,254,439,9,1.7,64.66,6.1,0,0,0,0,0,0,0.0563987095735563,18.5709335842098,6.81877853191804
9.7,"greedy_SVM","SVM",4,18,884,883,1,1900,1644,256,0.808833117968541,0.291044776119403,1.26470871449206,718,256,462,25,1.8,68.25,6.4,0,0,0,0,0,0,0.0379766151154365,12.4109330087745,5.43625816235297
9.7,"greedy_SVM","SVM",4,19,784,783,1,2000,1744,256,0.797268621151592,0.208955223880597,1.274289841117,702,256,446,-16,1.7,71.84,6.8,0,0,0,0,0,0,0.0314765832883817,10.9958694304517,4.3657984545485
9.7,"greedy_SVM","SVM",4,20,684,683,1,2100,1844,256,0.778028048794948,0.238805970149254,1.274289841117,705,256,449,3,1.8,75.43,7.2,0,0,0,0,0,0,0.0759675714259555,35.3377924597085,8.42568991351473
9.7,"greedy_SVM","SVM",4,21,584,583,1,2200,1944,256,0.765527011487443,0.17910447761194,1.274289841117,700,256,444,-5,1.7,79.02,7.6,0,0,0,0,0,0,0.0059598094229867,1.65880410545665,0.998609346251371
9.7,"greedy_SVM","SVM",4,22,484,484,0,2300,2043,257,0.788122532690007,0.223880597014925,1.274289841117,704,257,447,4,1.7,82.61,7.9,0,0,0,0,0,0,0.00378434544551897,1.11009199230675,0.795210056871048
9.7,"greedy_SVM","SVM",4,23,384,384,0,2400,2143,257,0.761342216637229,0.186567164179104,1.274289841117,702,257,445,-2,1.7,86.21,8.3,0,0,0,0,0,0,0.00226468671299652,0.68586683318727,0.536920465777809
9.7,"greedy_SVM","SVM",4,24,284,284,0,2500,2243,257,0.754744940903113,0.17910447761194,1.274289841117,717,257,460,15,1.8,89.8,8.7,0,0,0,0,0,0,0.000280844628684091,0.115408592817799,0.102504178272194
9.7,"greedy_SVM","SVM",4,25,184,184,0,2600,2343,257,0.76418740293766,0.17910447761194,1.26470871449206,707,257,450,-10,1.8,93.39,9.1,0,0,0,0,0,0,4.43899722773608e-06,0.00474239158286968,0.00461096961736983
9.7,"greedy_SVM","SVM",4,26,84,84,0,2700,2443,257,0.731687076926728,0.156716417910448,1.274289841117,703,257,446,-4,1.7,96.98,9.5,0,0,0,0,0,0,1.0000000994736e-07,0.00017196450963037,0.00017196450963037
9.7,"greedy_SVM","SVM",4,27,0,0,0,2784,2527,257,0.774157409932073,0.186567164179104,1.274289841117,714,257,457,11,1.8,100,9.8,0,0,0,0,0,0,0,0,0
9.7,"greedy_SVM","SVM",5,0,2684,2432,252,100,89,11,0.74890686758893,0.34375,1.07323588709677,25,11,14,0,1.3,3.59,8.1,0,0,0,0,0,0,0.181600994689075,287.759373159024,18.9537319833917
9.7,"greedy_SVM","SVM",5,1,2584,2368,216,200,153,47,0.693330039525695,0.109375,1.16350806451613,108,47,61,83,1.3,7.18,3.3,0,0,0,0,0,0,0.299386034327235,572.923544422418,37.3781216597974
9.7,"greedy_SVM","SVM",5,2,2484,2283,201,300,238,62,0.730379199604742,0.1171875,1.24375,162,62,100,54,1.6,10.78,3.8,0,0,0,0,0,0,0.263151029717679,451.510047718606,28.3068928500996
9.7,"greedy_SVM","SVM",5,3,2384,2192,192,400,329,71,0.831367341897235,0.25,1.27384072580645,169,71,98,7,1.4,14.37,4.6,0,0,0,0,0,0,0.231601403746815,323.737609155946,27.9683919114378
9.7,"greedy_SVM","SVM",5,4,2284,2119,165,500,402,98,0.789760375494074,0.203125,1.22368951612903,250,98,152,81,1.6,17.96,4.1,0,0,0,0,0,0,0.222239577455516,318.994693992364,25.2150911076099
9.7,"greedy_SVM","SVM",5,5,2184,2038,146,600,483,117,0.813352272727283,0.2109375,1.24375,290,117,173,40,1.5,21.55,4.1,0,0,0,0,0,0,0.206673590578248,300.229097734632,21.6469115060485
9.7,"greedy_SVM","SVM",5,6,2084,1963,121,700,558,142,0.821597084980243,0.28125,1.26381048387097,344,142,202,54,1.4,25.14,3.9,0,0,0,0,0,0,0.215310496335989,188.68499678168,22.0620277115125
9.7,"greedy_SVM","SVM",5,7,1984,1895,89,800,626,174,0.82919342885376,0.3359375,1.26381048387097,424,174,250,80,1.4,28.74,3.6,0,0,0,0,0,0,0.221395572662978,168.988618796295,22.7838946048707
9.7,"greedy_SVM","SVM",5,8,1884,1820,64,900,701,199,0.829588685770756,0.3125,1.26381048387097,488,199,289,64,1.5,32.33,3.5,0,0,0,0,0,0,0.213093902724712,141.2936853779,22.4352930596871
9.7,"greedy_SVM","SVM",5,9,1784,1735,49,1000,786,214,0.835918972332021,0.3046875,1.26381048387097,508,214,294,20,1.4,35.92,3.7,0,0,0,0,0,0,0.184533339697757,105.572662193362,19.9520343537752
9.7,"greedy_SVM","SVM",5,10,1684,1650,34,1100,871,229,0.827377717391309,0.3046875,1.26381048387097,564,229,335,56,1.5,39.51,3.8,0,0,0,0,0,0,0.185063299843283,83.156050824743,20.0545940754611
9.7,"greedy_SVM","SVM",5,11,1584,1561,23,1200,960,240,0.820429841897236,0.265625,1.26381048387097,584,240,344,20,1.4,43.1,4,0,0,0,0,0,0,0.183384886782211,79.0165724010782,19.4501551088332
9.7,"greedy_SVM","SVM",5,12,1484,1462,22,1300,1059,241,0.808510375494072,0.25,1.26148516559338,595,241,354,11,1.5,46.7,4.4,0,0,0,0,0,0,0.109932007229636,30.5764792601762,13.0675367994989
9.7,"greedy_SVM","SVM",5,13,1384,1364,20,1400,1157,243,0.813346096837946,0.2265625,1.26381048387097,594,243,351,-1,1.4,50.29,4.8,0,0,0,0,0,0,0.0690615991263925,18.7756291104473,9.31902274314762
9.7,"greedy_SVM","SVM",5,14,1284,1265,19,1500,1256,244,0.814735671936765,0.2734375,1.25378024193548,617,244,373,23,1.5,53.88,5.1,0,0,0,0,0,0,0.131631174226757,93.4120541408177,13.9619704018958
9.7,"greedy_SVM","SVM",5,15,1184,1166,18,1600,1355,245,0.79115612648222,0.2265625,1.24146159153634,602,245,357,-15,1.5,57.47,5.5,0,0,0,0,0,0,0.0741583147062767,23.0260240057461,9.66112683131047
9.7,"greedy_SVM","SVM",5,16,1084,1067,17,1700,1454,246,0.780601531620564,0.25,1.25378024193548,632,246,386,30,1.6,61.06,5.9,0,0,0,0,0,0,0.109125786152219,34.6331990680928,12.8273989956112
9.7,"greedy_SVM","SVM",5,17,984,968,16,1800,1553,247,0.796417984189734,0.2734375,1.25147337856486,640,247,393,8,1.6,64.66,6.3,0,0,0,0,0,0,0.051656963784518,12.4632767532564,7.95076358202426
9.7,"greedy_SVM","SVM",5,18,884,868,16,1900,1653,247,0.803829051383407,0.2734375,1.25378024193548,621,247,374,-19,1.5,68.25,6.7,0,0,0,0,0,0,0.0200512950237718,4.88873388748755,3.89847998320703
9.7,"greedy_SVM","SVM",5,19,784,768,16,2000,1753,247,0.780410079051392,0.2578125,1.25147337856486,635,247,388,14,1.6,71.84,7.1,0,0,0,0,0,0,0.000176946307615514,0.315286353286285,0.310207218404939
9.7,"greedy_SVM","SVM",5,20,684,671,13,2100,1850,250,0.818904397233204,0.296875,1.2714969526219,671,250,421,36,1.7,75.43,7.4,0,0,0,0,0,0,2.82056378556966e-05,0.178289329807768,0.177446879082907
9.7,"greedy_SVM","SVM",5,21,584,578,6,2200,1943,257,0.762290019762846,0.15625,1.28268876611418,684,257,427,13,1.7,79.02,7.6,0,0,0,0,0,0,0.106098004258214,33.66078259106,13.6765463948741
9.7,"greedy_SVM","SVM",5,22,484,482,2,2300,2039,261,0.73179347826087,0.1484375,1.28268876611418,697,261,436,13,1.7,82.61,7.8,0,0,0,0,0,0,0.0804600773965377,20.8135045601407,10.867841167575
9.7,"greedy_SVM","SVM",5,23,384,382,2,2400,2139,261,0.824197134387353,0.2578125,1.28268876611418,691,261,430,-6,1.6,86.21,8.2,0,0,0,0,0,0,0.0382839217231023,9.01659014134793,5.81907515750457
9.7,"greedy_SVM","SVM",5,24,284,282,2,2500,2239,261,0.765001235177865,0.2265625,1.28268876611418,703,261,442,12,1.7,89.8,8.6,0,0,0,0,0,0,0.00687788538193949,3.03381911969121,2.76278540089283
9.7,"greedy_SVM","SVM",5,25,184,183,1,2600,2338,262,0.817601284584981,0.2890625,1.28268876611418,712,262,450,9,1.7,93.39,8.9,0,0,0,0,0,0,0.0221425640520086,6.84458788769846,6.22736687586919
9.7,"greedy_SVM","SVM",5,26,84,83,1,2700,2438,262,0.772548171936758,0.2109375,1.28268876611418,739,262,477,27,1.8,96.98,9.3,0,0,0,0,0,0,0.000649142491756283,1.67718332667392,1.67718332667392
9.7,"greedy_SVM","SVM",5,27,0,0,0,2784,2521,263,0.761166007905139,0.1953125,1.28268876611418,729,263,466,-10,1.8,100,9.6,0,0,0,0,0,0,0,0,0
9.7,"greedy_SVM","SVM",6,0,2684,2422,262,100,93,7,0.68016019398692,0.0901639344262295,1.26282390269699,26,7,19,0,2.7,3.59,13.3,0,0,0,0,0,0,0.102415930980949,216.141262833793,11.3377992104366
9.7,"greedy_SVM","SVM",6,1,2584,2330,254,200,185,15,0.320149359610994,0,0.789264939185616,63,15,48,37,3.2,7.18,12.3,0,0,0,0,0,0,0.0769549313799288,194.880105469169,7.71600089571778
9.7,"greedy_SVM","SVM",6,2,2484,2230,254,300,285,15,0.650410803420571,0.163934426229508,1.15758857747224,64,15,49,1,3.3,10.78,19,0,0,0,0,0,0,0.0902453815663414,161.31221255374,9.87917408255904
9.7,"greedy_SVM","SVM",6,3,2384,2136,248,400,379,21,0.760289432614052,0.163934426229508,1.26282390269699,71,21,50,7,2.4,14.37,18,0,0,0,0,0,0,0.0821477022531219,149.288193958219,13.044749819809
9.7,"greedy_SVM","SVM",6,4,2284,2052,232,500,463,37,0.794940088480739,0.213114754098361,1.26282390269699,109,37,72,38,1.9,17.96,12.5,0,0,0,0,0,0,0.109222142406121,150.507663577845,11.8561056203535
9.7,"greedy_SVM","SVM",6,5,2184,1970,214,600,545,55,0.825611690807551,0.30327868852459,1.26282390269699,152,55,97,43,1.8,21.55,9.9,0,0,0,0,0,0,0.132213147889767,142.069850535751,14.5954404310859
9.7,"greedy_SVM","SVM",6,6,2084,1899,185,700,616,84,0.818917594252625,0.270491803278689,1.26282390269699,215,84,131,63,1.6,25.14,7.3,0,0,0,0,0,0,0.14353188499104,177.793822244905,14.8050060628096
9.7,"greedy_SVM","SVM",6,7,1984,1833,151,800,682,118,0.826475861268392,0.270491803278689,1.27334743521946,284,118,166,69,1.4,28.74,5.8,0,0,0,0,0,0,0.172058708636284,167.040244202573,17.9716035960615
9.7,"greedy_SVM","SVM",6,8,1884,1765,119,900,750,150,0.81762778759464,0.237704918032787,1.26282390269699,362,150,212,78,1.4,32.33,5,0,0,0,0,0,0,0.188298332399648,199.29516050385,19.4062531552217
9.7,"greedy_SVM","SVM",6,9,1784,1689,95,1000,826,174,0.825373076575819,0.286885245901639,1.27334743521946,424,174,250,62,1.4,35.92,4.7,0,0,0,0,0,0,0.196107401404187,188.361071922046,20.2864288510446
9.7,"greedy_SVM","SVM",6,10,1684,1623,61,1100,892,208,0.825766467606503,0.295081967213115,1.26282390269699,504,208,296,80,1.4,39.51,4.3,0,0,0,0,0,0,0.205262459478541,195.623121518476,21.2852897504324
9.7,"greedy_SVM","SVM",6,11,1584,1536,48,1200,979,221,0.826869252299076,0.30327868852459,1.26282390269699,539,221,318,35,1.4,43.1,4.4,0,0,0,0,0,0,0.192119702343449,158.09885238837,19.871463375733
9.7,"greedy_SVM","SVM",6,12,1484,1449,35,1300,1066,234,0.818530652255227,0.245901639344262,1.25230037017451,569,234,335,30,1.4,46.7,4.6,0,0,0,0,0,0,0.189258194231112,135.084747184042,20.3218073392561
9.7,"greedy_SVM","SVM",6,13,1384,1359,25,1400,1156,244,0.816963537165778,0.245901639344262,1.25230037017451,599,244,355,30,1.5,50.29,4.7,0,0,0,0,0,0,0.15847723895976,89.5201628641254,17.3662673502574
9.7,"greedy_SVM","SVM",6,14,1284,1266,18,1500,1249,251,0.811127162038413,0.245901639344262,1.25230037017451,620,251,369,21,1.5,53.88,5,0,0,0,0,0,0,0.143058404777577,76.8014538787884,15.7882086280352
9.7,"greedy_SVM","SVM",6,15,1184,1172,12,1600,1343,257,0.800138009312405,0.221311475409836,1.24177683765204,643,257,386,23,1.5,57.47,5.2,0,0,0,0,0,0,0.130509273060971,70.8700437166261,14.9252125574951
9.7,"greedy_SVM","SVM",6,16,1084,1074,10,1700,1441,259,0.755491351846356,0.19672131147541,1.21020624008461,672,259,413,29,1.6,61.06,5.6,0,0,0,0,0,0,0.141573894351627,69.0144265269988,16.5288108097552
9.7,"greedy_SVM","SVM",6,17,984,975,9,1800,1540,260,0.804220247384911,0.286885245901639,1.21020624008461,670,260,410,-2,1.6,64.66,5.9,0,0,0,0,0,0,0.113997501729253,64.5123065525212,12.6237444934931
9.7,"greedy_SVM","SVM",6,18,884,876,8,1900,1639,261,0.809921192813194,0.286885245901639,1.21020624008461,673,261,412,3,1.6,68.25,6.3,0,0,0,0,0,0,0.07850339299398,35.5727399626766,8.92192086203652
9.7,"greedy_SVM","SVM",6,19,784,776,8,2000,1739,261,0.799331880151162,0.254098360655738,1.21020624008461,674,261,413,1,1.6,71.84,6.7,0,0,0,0,0,0,0.0572765916125974,19.0226936203053,6.80880822237926
9.7,"greedy_SVM","SVM",6,20,684,677,7,2100,1838,262,0.797474558563668,0.254098360655738,1.22072977260709,692,262,430,18,1.6,75.43,7,0,0,0,0,0,0,0.0291415963730067,8.96353388890002,4.3941966894205
9.7,"greedy_SVM","SVM",6,21,584,577,7,2200,1938,262,0.797874398627643,0.278688524590164,1.22072977260709,665,262,403,-27,1.5,79.02,7.4,0,0,0,0,0,0,0.0169222965382891,5.01365828944114,2.39446222886371
9.7,"greedy_SVM","SVM",6,22,484,478,6,2300,2037,263,0.813616488888315,0.270491803278689,1.24177683765204,679,263,416,14,1.6,82.61,7.7,0,0,0,0,0,0,0.0469694557758333,15.6317827126524,5.56648788239124
9.7,"greedy_SVM","SVM",6,23,384,379,5,2400,2136,264,0.785653480543272,0.213114754098361,1.23125330512956,687,264,423,8,1.6,86.21,8.1,0,0,0,0,0,0,0.0134057369406508,3.94567447520014,1.92136494034444
9.7,"greedy_SVM","SVM",6,24,284,283,1,2500,2232,268,0.79987359894752,0.221311475409836,1.26282390269699,695,268,427,8,1.6,89.8,8.3,0,0,0,0,0,0,0.0143128528690536,4.68729519791014,3.35776908277078
9.7,"greedy_SVM","SVM",6,25,184,184,0,2600,2331,269,0.826127613470746,0.286885245901639,1.26282390269699,717,269,448,22,1.7,93.39,8.7,0,0,0,0,0,0,0.000343999672182387,0.122476621535448,0.110273326962277
9.7,"greedy_SVM","SVM",6,26,84,84,0,2700,2431,269,0.83265403516013,0.30327868852459,1.26282390269699,711,269,442,-6,1.6,96.98,9,0,0,0,0,0,0,0.00033449480560218,0.39440359986949,0.39440359986949
9.7,"greedy_SVM","SVM",6,27,0,0,0,2784,2515,269,0.829997033444688,0.270491803278689,1.26282390269699,699,269,430,-12,1.6,100,9.3,0,0,0,0,0,0,0,0,0
9.7,"greedy_SVM","SVM",7,0,2684,2441,243,100,90,10,0.816525203533693,0.347826086956522,1.21906201519551,23,10,13,0,1.3,3.59,9,0,0,0,0,0,0,0.482200116001966,311.201412339137,50.9779478307274
9.7,"greedy_SVM","SVM",7,1,2584,2379,205,200,152,48,0.838708932386401,0.36231884057971,1.27456755493221,105,48,57,82,1.2,7.18,3.2,0,0,0,0,0,0,0.310310467459443,479.170163491642,36.3700343775261
9.7,"greedy_SVM","SVM",7,2,2484,2305,179,300,226,74,0.832161210231541,0.304347826086957,1.27456755493221,176,74,102,71,1.4,10.78,3.1,0,0,0,0,0,0,0.284899266931695,392.094601046049,34.7344053237563
9.7,"greedy_SVM","SVM",7,3,2384,2214,170,400,317,83,0.776771176164909,0.347826086956522,1.24665731650304,203,83,120,27,1.4,14.37,3.8,0,0,0,0,0,0,0.235299956204779,294.757780358573,25.3541079498639
9.7,"greedy_SVM","SVM",7,4,2284,2131,153,500,400,100,0.815399272475321,0.41304347826087,1.25596072931276,247,100,147,44,1.5,17.96,4,0,0,0,0,0,0,0.219912020531992,279.447291665295,22.2453938292124
9.7,"greedy_SVM","SVM",7,5,2184,2069,115,600,462,138,0.806033835671812,0.420289855072464,1.24665731650304,337,138,199,90,1.4,21.55,3.3,0,0,0,0,0,0,0.237432660885257,270.898055829556,24.6147758815838
9.7,"greedy_SVM","SVM",7,6,2084,1989,95,700,542,158,0.800600496564471,0.427536231884058,1.23735390369331,390,158,232,53,1.5,25.14,3.4,0,0,0,0,0,0,0.22018439842483,294.435387219973,22.6687282773338
9.7,"greedy_SVM","SVM",7,7,1984,1898,86,800,633,167,0.790975229516721,0.41304347826087,1.22805049088359,427,167,260,37,1.6,28.74,3.8,0,0,0,0,0,0,0.194233373042864,206.243547935182,21.4874214664143
9.7,"greedy_SVM","SVM",7,8,1884,1804,80,900,727,173,0.80616086379122,0.376811594202899,1.22805049088359,442,173,269,15,1.6,32.33,4.2,0,0,0,0,0,0,0.172018512507244,194.69270220496,18.4391774239356
9.7,"greedy_SVM","SVM",7,9,1784,1713,71,1000,818,182,0.82248975114037,0.36231884057971,1.27456755493221,456,182,274,14,1.5,35.92,4.5,0,0,0,0,0,0,0.146063023855346,96.0800703351399,17.19255722442
9.7,"greedy_SVM","SVM",7,10,1684,1616,68,1100,915,185,0.828379236676486,0.355072463768116,1.27456755493221,476,185,291,20,1.6,39.51,4.9,0,0,0,0,0,0,0.108551480699833,66.0944460920949,12.3881514553297
9.7,"greedy_SVM","SVM",7,11,1584,1523,61,1200,1008,192,0.845291298573822,0.347826086956522,1.26526414212249,498,192,306,22,1.6,43.1,5.2,0,0,0,0,0,0,0.142720192508656,83.7185557188083,16.4224553777211
9.7,"greedy_SVM","SVM",7,12,1484,1444,40,1300,1087,213,0.851862116750389,0.369565217391304,1.25596072931276,569,213,356,71,1.7,46.7,5.1,0,0,0,0,0,0,0.12099056714488,71.0187207371136,14.4592306892179
9.7,"greedy_SVM","SVM",7,13,1384,1355,29,1400,1176,224,0.840654772215486,0.297101449275362,1.23735390369331,589,224,365,20,1.6,50.29,5.2,0,0,0,0,0,0,0.105579782458006,47.289539874595,13.0376328625325
9.7,"greedy_SVM","SVM",7,14,1284,1258,26,1500,1273,227,0.81748368843467,0.282608695652174,1.20944366526414,609,227,382,20,1.7,53.88,5.6,0,0,0,0,0,0,0.130742738271703,80.22381603409,14.638010048191
9.7,"greedy_SVM","SVM",7,15,1184,1160,24,1600,1371,229,0.812616201859234,0.311594202898551,1.20944366526414,614,229,385,5,1.7,57.47,6,0,0,0,0,0,0,0.126983895816672,73.6170638430373,14.010876382529
9.7,"greedy_SVM","SVM",7,16,1084,1061,23,1700,1470,230,0.800975806917262,0.260869565217391,1.20944366526414,623,230,393,9,1.7,61.06,6.4,0,0,0,0,0,0,0.0978475363178269,46.8600098465492,11.3123644312045
9.7,"greedy_SVM","SVM",7,17,984,961,23,1800,1570,230,0.830463652635838,0.36231884057971,1.20944366526414,660,230,430,37,1.9,64.66,6.8,0,0,0,0,0,0,0.0375857433326501,11.9427707984521,5.0746093226252
9.7,"greedy_SVM","SVM",7,18,884,861,23,1900,1670,230,0.820976961718348,0.326086956521739,1.20944366526414,626,230,396,-34,1.7,68.25,7.3,0,0,0,0,0,0,0.0232112095847069,7.56710973036073,3.59032947247595
9.7,"greedy_SVM","SVM",7,19,784,762,22,2000,1769,231,0.816969801951618,0.311594202898551,1.20944366526414,646,231,415,20,1.8,71.84,7.7,0,0,0,0,0,0,0.0174210267955602,6.13251740065312,2.97152654091952
9.7,"greedy_SVM","SVM",7,20,684,664,20,2100,1867,233,0.830094116288476,0.36231884057971,1.22805049088359,651,233,418,5,1.8,75.43,8,0,0,0,0,0,0,0.0830187047781544,36.2052616794981,14.5720752538079
9.7,"greedy_SVM","SVM",7,21,584,569,15,2200,1962,238,0.818159247069694,0.27536231884058,1.22805049088359,665,238,427,14,1.8,79.02,8.2,0,0,0,0,0,0,0.0245837483234658,9.15805657012678,5.47869786691407
9.7,"greedy_SVM","SVM",7,22,484,472,12,2300,2059,241,0.805941451584969,0.217391304347826,1.22805049088359,655,241,414,-10,1.7,82.61,8.5,0,0,0,0,0,0,0.043601963262368,14.193710422381,5.67713327024291
9.7,"greedy_SVM","SVM",7,23,384,372,12,2400,2159,241,0.828379236676487,0.318840579710145,1.22805049088359,679,241,438,24,1.8,86.21,9,0,0,0,0,0,0,0.0268370332132068,7.74123015174632,3.41422000646953
9.7,"greedy_SVM","SVM",7,24,284,275,9,2500,2256,244,0.82279577342803,0.333333333333333,1.24665731650304,675,244,431,-4,1.8,89.8,9.2,0,0,0,0,0,0,0.00349230743872859,1.12951625489853,0.868165744429075
9.7,"greedy_SVM","SVM",7,25,184,179,5,2600,2352,248,0.815763034817258,0.246376811594203,1.26526414212249,697,248,449,22,1.8,93.39,9.5,0,0,0,0,0,0,0.00571801135565753,2.33377625195313,2.18554292489068
9.7,"greedy_SVM","SVM",7,26,84,84,0,2700,2447,253,0.794070096425893,0.239130434782609,1.27456755493221,701,253,448,4,1.8,96.98,9.7,0,0,0,0,0,0,1.13966806457148e-06,0.0236885509175553,0.0236885509175553
9.7,"greedy_SVM","SVM",7,27,0,0,0,2784,2531,253,0.842207979675505,0.355072463768116,1.27456755493221,720,253,467,19,1.8,100,10,0,0,0,0,0,0,0,0,0
9.7,"greedy_SVM","SVM",8,0,2684,2452,232,100,89,11,0.726598285032022,0.297297297297297,1.17109851787271,30,11,19,0,1.7,3.59,8.1,0,0,0,0,0,0,0.269087920593453,241.128425181546,33.9629128268824
9.7,"greedy_SVM","SVM",8,1,2584,2391,193,200,150,50,0.584538152610444,0.148648648648649,1.14507410636443,110,50,60,80,1.2,7.18,3,0,0,0,0,0,0,0.269963620305654,524.018515758335,35.866346475996
9.7,"greedy_SVM","SVM",8,2,2484,2308,176,300,233,67,0.540220340822748,0.175675675675676,1.09302528334786,160,67,93,50,1.4,10.78,3.5,0,0,0,0,0,0,0.225269215662062,510.635492696479,23.1151152199682
9.7,"greedy_SVM","SVM",8,3,2384,2225,159,400,316,84,0.623548247042221,0.189189189189189,1.10170008718396,197,84,113,37,1.3,14.37,3.8,0,0,0,0,0,0,0.208983640358844,362.340863284471,22.0591839012125
9.7,"greedy_SVM","SVM",8,4,2284,2129,155,500,412,88,0.607055248019101,0.195945945945946,1.06700087183958,214,88,126,17,1.4,17.96,4.7,0,0,0,0,0,0,0.168015621955119,239.659563081203,17.5352957578534
9.7,"greedy_SVM","SVM",8,5,2184,2039,145,600,502,98,0.638879843699119,0.216216216216216,1.08435047951177,238,98,140,24,1.4,21.55,5.1,0,0,0,0,0,0,0.153446966465081,224.0730787493,15.9442578630911
9.7,"greedy_SVM","SVM",8,6,2084,1954,130,700,587,113,0.67225116682948,0.243243243243243,1.11037489102005,267,113,154,29,1.4,25.14,5.2,0,0,0,0,0,0,0.144705858400934,183.877425623906,15.2504758774366
9.7,"greedy_SVM","SVM",8,7,1984,1872,112,800,669,131,0.7358189514816,0.277027027027027,1.20579773321709,311,131,180,44,1.4,28.74,5.1,0,0,0,0,0,0,0.154280561838711,172.349263687396,16.4432656741217
9.7,"greedy_SVM","SVM",8,8,1884,1792,92,900,749,151,0.750320199717788,0.277027027027027,1.21447253705318,368,151,217,57,1.4,32.33,5,0,0,0,0,0,0,0.170587369387493,159.114181661961,18.5073071637276
9.7,"greedy_SVM","SVM",8,9,1784,1701,83,1000,840,160,0.764740041246066,0.304054054054054,1.22314734088928,394,160,234,26,1.5,35.92,5.2,0,0,0,0,0,0,0.139169366997862,114.91680389789,15.2028122832364
9.7,"greedy_SVM","SVM",8,10,1684,1618,66,1100,923,177,0.768642136112023,0.25,1.23182214472537,446,177,269,52,1.5,39.51,5.2,0,0,0,0,0,0,0.144409580959058,136.571733113061,15.4911399036308
9.7,"greedy_SVM","SVM",8,11,1584,1532,52,1200,1009,191,0.797270161727995,0.297297297297297,1.25784655623365,480,191,289,34,1.5,43.1,5.3,0,0,0,0,0,0,0.143362132415257,128.297954475378,15.6831142234667
9.7,"greedy_SVM","SVM",8,12,1484,1449,35,1300,1092,208,0.814392705958958,0.317567567567568,1.26652136006975,517,208,309,37,1.5,46.7,5.2,0,0,0,0,0,0,0.156956973174932,171.848327799589,16.1990875179311
9.7,"greedy_SVM","SVM",8,13,1384,1360,24,1400,1181,219,0.789710192119824,0.222972972972973,1.26652136006975,560,219,341,43,1.6,50.29,5.4,0,0,0,0,0,0,0.153118285405297,129.172933433024,16.2419581473833
9.7,"greedy_SVM","SVM",8,14,1284,1264,20,1500,1277,223,0.812905676761094,0.27027027027027,1.25784655623365,587,223,364,27,1.6,53.88,5.7,0,0,0,0,0,0,0.127548118911501,99.2275106992162,13.8242140208416
9.7,"greedy_SVM","SVM",8,15,1184,1168,16,1600,1373,227,0.811169000325625,0.27027027027027,1.25784655623365,588,227,361,1,1.6,57.47,6,0,0,0,0,0,0,0.115613095091076,83.3460955982666,12.3532051608267
9.7,"greedy_SVM","SVM",8,16,1084,1072,12,1700,1469,231,0.746021925539993,0.155405405405405,1.24049694856146,629,231,398,41,1.7,61.06,6.4,0,0,0,0,0,0,0.149283369729154,106.859382034976,15.3730823136288
9.7,"greedy_SVM","SVM",8,17,984,973,11,1800,1568,232,0.79120807554542,0.236486486486486,1.24049694856146,635,232,403,6,1.7,64.66,6.8,0,0,0,0,0,0,0.123026471755635,81.0149814799355,12.9722981703153
9.7,"greedy_SVM","SVM",8,18,884,874,10,1900,1667,233,0.777005318571582,0.256756756756757,1.24049694856146,639,233,406,4,1.7,68.25,7.2,0,0,0,0,0,0,0.104213338199167,55.7366636029007,11.6311490041861
9.7,"greedy_SVM","SVM",8,19,784,774,10,2000,1767,233,0.793085856941274,0.263513513513513,1.24049694856146,633,233,400,-6,1.7,71.84,7.6,0,0,0,0,0,0,0.0792316975544706,39.1664827665122,8.74736640077826
9.7,"greedy_SVM","SVM",8,20,684,675,9,2100,1866,234,0.712927385216538,0.162162162162162,1.24917175239756,637,234,403,4,1.7,75.43,8,0,0,0,0,0,0,0.0632986329798864,26.3484122814757,7.66126043690836
9.7,"greedy_SVM","SVM",8,21,584,575,9,2200,1966,234,0.766786063171603,0.202702702702703,1.24917175239756,648,234,414,11,1.8,79.02,8.4,0,0,0,0,0,0,0.0197646418221139,5.9783793810294,2.73932198471972
9.7,"greedy_SVM","SVM",8,22,484,476,8,2300,2065,235,0.815255617062839,0.290540540540541,1.27519616390584,637,235,402,-11,1.7,82.61,8.8,0,0,0,0,0,0,0.0344945873608977,11.464664983121,4.12264321395673
9.7,"greedy_SVM","SVM",8,23,384,383,1,2400,2158,242,0.781222186041466,0.236486486486486,1.25784655623365,671,242,429,34,1.8,86.21,8.9,0,0,0,0,0,0,0.0612141649862594,16.8154719654413,9.37436910144413
9.7,"greedy_SVM","SVM",8,24,284,284,0,2500,2257,243,0.740209486595029,0.202702702702703,1.25784655623365,677,243,434,6,1.8,89.8,9.3,0,0,0,0,0,0,0.0413424111986094,10.130220776361,5.45515492692635
9.7,"greedy_SVM","SVM",8,25,184,184,0,2600,2357,243,0.749305329425811,0.195945945945946,1.25784655623365,672,243,429,-5,1.8,93.39,9.7,0,0,0,0,0,0,0.0176429046073115,3.75431045802122,2.66537687646024
9.7,"greedy_SVM","SVM",8,26,84,84,0,2700,2457,243,0.757907304895251,0.202702702702703,1.26652136006975,685,243,442,13,1.8,96.98,10.1,0,0,0,0,0,0,1.1749562909736e-07,0.792039210253057,0.792039210253057
9.7,"greedy_SVM","SVM",8,27,0,0,0,2784,2541,243,0.774465429284698,0.243243243243243,1.26652136006975,685,243,442,0,1.8,100,10.5,0,0,0,0,0,0,0,0,0
9.7,"greedy_SVM","SVM",9,0,2684,2439,245,100,95,5,0.380956427163347,0.0354609929078014,0.965179592770533,25,5,20,0,4,3.59,19,0,0,0,0,0,0,0.102036450108841,94.3547580401493,14.0076778099553
9.7,"greedy_SVM","SVM",9,1,2584,2345,239,200,189,11,0.364500487163801,0,0.855913978494624,47,11,36,22,3.3,7.18,17.2,0,0,0,0,0,0,0.0679789306716925,138.7299291601,7.11510571991777
9.7,"greedy_SVM","SVM",9,2,2484,2246,238,300,288,12,0.651978111617159,0.120567375886525,1.22013269274766,55,12,43,8,3.6,10.78,24,0,0,0,0,0,0,0.0422140019666147,104.266598590176,4.23208342308846
9.7,"greedy_SVM","SVM",9,3,2384,2156,228,400,378,22,0.726990007477401,0.212765957446809,1.21102722489133,69,22,47,14,2.1,14.37,17.2,0,0,0,0,0,0,0.0835791039716253,135.626727105634,10.4316154720865
9.7,"greedy_SVM","SVM",9,4,2284,2073,211,500,461,39,0.78726803072531,0.26241134751773,1.25655456417296,108,39,69,39,1.8,17.96,11.8,0,0,0,0,0,0,0.087647235457672,174.091800524694,9.3552694310285
9.7,"greedy_SVM","SVM",9,5,2184,1998,186,600,536,64,0.767169691613988,0.276595744680851,1.24744909631663,169,64,105,61,1.6,21.55,8.4,0,0,0,0,0,0,0.122984519815588,202.03502367514,12.896255026244
9.7,"greedy_SVM","SVM",9,6,2084,1928,156,700,606,94,0.774448825142186,0.269503546099291,1.25655456417296,230,94,136,61,1.4,25.14,6.4,0,0,0,0,0,0,0.15349329093508,224.431360439735,16.1045804733118
9.7,"greedy_SVM","SVM",9,7,1984,1849,135,800,685,115,0.787692882876761,0.304964539007092,1.25655456417296,275,115,160,45,1.4,28.74,6,0,0,0,0,0,0,0.154201119569965,187.092461531802,16.1792596859806
9.7,"greedy_SVM","SVM",9,8,1884,1778,106,900,756,144,0.804981533093151,0.297872340425532,1.25655456417296,344,144,200,69,1.4,32.33,5.2,0,0,0,0,0,0,0.170378670956072,179.923957651391,17.5336112090528
9.7,"greedy_SVM","SVM",9,9,1784,1702,82,1000,832,168,0.79729454149956,0.269503546099291,1.25655456417296,407,168,239,63,1.4,35.92,5,0,0,0,0,0,0,0.185794290789936,179.771213004453,19.5706889260644
9.7,"greedy_SVM","SVM",9,10,1684,1618,66,1100,916,184,0.808244397616299,0.290780141843972,1.25655456417296,445,184,261,38,1.4,39.51,5,0,0,0,0,0,0,0.16356729868085,152.825070692477,17.3017803664357
9.7,"greedy_SVM","SVM",9,11,1584,1533,51,1200,1001,199,0.814543538848481,0.304964539007092,1.25655456417296,485,199,286,40,1.4,43.1,5,0,0,0,0,0,0,0.157140406086175,148.012422726159,16.5913387033325
9.7,"greedy_SVM","SVM",9,12,1484,1444,40,1300,1090,210,0.803752294201619,0.25531914893617,1.25655456417296,501,210,291,16,1.4,46.7,5.2,0,0,0,0,0,0,0.155170908161981,144.178313230371,16.1725446607742
9.7,"greedy_SVM","SVM",9,13,1384,1350,34,1400,1184,216,0.807604287041446,0.304964539007092,1.25655456417296,534,216,318,33,1.5,50.29,5.5,0,0,0,0,0,0,0.155518974982423,129.174801112849,16.564086794976
9.7,"greedy_SVM","SVM",9,14,1284,1253,31,1500,1281,219,0.808165091881361,0.312056737588652,1.25655456417296,542,219,323,8,1.5,53.88,5.8,0,0,0,0,0,0,0.134761190923904,97.2845788158604,14.4656690553488
9.7,"greedy_SVM","SVM",9,15,1184,1157,27,1600,1377,223,0.818520154986068,0.340425531914894,1.25655456417296,562,223,339,20,1.5,57.47,6.2,0,0,0,0,0,0,0.121428175550121,78.3730701461871,12.9478092380504
9.7,"greedy_SVM","SVM",9,16,1084,1063,21,1700,1471,229,0.814577527020601,0.297872340425532,1.25655456417296,578,229,349,16,1.5,61.06,6.4,0,0,0,0,0,0,0.109775883572439,64.528584675154,12.7527985200333
9.7,"greedy_SVM","SVM",9,17,984,972,12,1800,1562,238,0.814390592073958,0.319148936170213,1.25655456417296,618,238,380,40,1.6,64.66,6.6,0,0,0,0,0,0,0.0881647109388041,42.9262925340461,10.5485208603102
9.7,"greedy_SVM","SVM",9,18,884,876,8,1900,1658,242,0.81430562164367,0.290780141843972,1.25655456417296,630,242,388,12,1.6,68.25,6.9,0,0,0,0,0,0,0.0556414160004765,20.9486676274349,7.44537576401346
9.7,"greedy_SVM","SVM",9,19,784,779,5,2000,1755,245,0.806176783812569,0.276595744680851,1.26566003202928,657,245,412,27,1.7,71.84,7.2,0,0,0,0,0,0,0.0775393691362442,29.7407585060018,9.36247354647277
9.7,"greedy_SVM","SVM",9,20,684,682,2,2100,1852,248,0.814135680783091,0.290780141843972,1.26566003202928,653,248,405,-4,1.6,75.43,7.5,0,0,0,0,0,0,0.0322858919407787,9.79627681715998,4.74712089452428
9.7,"greedy_SVM","SVM",9,21,584,584,0,2200,1950,250,0.821335508576354,0.297872340425532,1.26566003202928,659,250,409,6,1.6,79.02,7.8,0,0,0,0,0,0,0.0174791913727302,5.53692414368838,2.81024683449206
9.7,"greedy_SVM","SVM",9,22,484,484,0,2300,2050,250,0.806346724673151,0.283687943262411,1.25655456417296,675,250,425,16,1.7,82.61,8.2,0,0,0,0,0,0,0.00135814005271393,0.378187832163964,0.24417439235809
9.7,"greedy_SVM","SVM",9,23,384,384,0,2400,2150,250,0.818486166813953,0.312056737588652,1.26566003202928,658,250,408,-17,1.6,86.21,8.6,0,0,0,0,0,0,0.00362364035969596,1.04026208921811,0.634815594967646
9.7,"greedy_SVM","SVM",9,24,284,284,0,2500,2250,250,0.830348038882472,0.319148936170213,1.25655456417296,671,250,421,13,1.7,89.8,9,0,0,0,0,0,0,1.25204371407288e-05,0.00457064329685229,0.00385825600221694
9.7,"greedy_SVM","SVM",9,25,184,184,0,2600,2350,250,0.796937665692344,0.269503546099291,1.25655456417296,678,250,428,7,1.7,93.39,9.4,0,0,0,0,0,0,0.000136563365733192,0.0361185403734753,0.0303222183371203
9.7,"greedy_SVM","SVM",9,26,84,84,0,2700,2450,250,0.819392518070382,0.283687943262411,1.25655456417296,665,250,415,-13,1.7,96.98,9.8,0,0,0,0,0,0,7.3788519385433e-07,0.00122695478505509,0.00122695478505509
9.7,"greedy_SVM","SVM",9,27,0,0,0,2784,2534,250,0.800795323227521,0.26241134751773,1.25655456417296,668,250,418,3,1.7,100,10.1,0,0,0,0,0,0,0,0,0
9.7,"greedy_SVM","SVM",10,0,2684,2445,239,100,89,11,0.729595767339634,0.163120567375887,1.25655456417296,28,11,17,0,1.5,3.59,8.1,0,0,0,0,0,0,0.127218838944274,294.964904199328,13.0446125902909
9.7,"greedy_SVM","SVM",10,1,2584,2363,221,200,171,29,0.666677996057374,0.212765957446809,1.21102722489133,75,29,46,47,1.6,7.18,5.9,0,0,0,0,0,0,0.273759789967153,317.936008053952,41.4913568930935
9.7,"greedy_SVM","SVM",10,2,2484,2278,206,300,256,44,0.737401717535633,0.205673758865248,1.24744909631663,119,44,75,44,1.7,10.78,5.8,0,0,0,0,0,0,0.165552862956836,306.739636822388,16.9851034021373
9.7,"greedy_SVM","SVM",10,3,2384,2204,180,400,330,70,0.746918405728141,0.163120567375887,1.22013269274766,177,70,107,58,1.5,14.37,4.7,0,0,0,0,0,0,0.198072500845308,366.96566000373,24.5608753912978
9.7,"greedy_SVM","SVM",10,4,2284,2106,178,500,428,72,0.792049033602972,0.304964539007092,1.22923816060398,188,72,116,11,1.6,17.96,5.9,0,0,0,0,0,0,0.168452836603262,237.410618651275,17.206140517823
9.7,"greedy_SVM","SVM",10,5,2184,2038,146,600,496,104,0.820004305168468,0.326241134751773,1.22923816060398,266,104,162,78,1.6,21.55,4.8,0,0,0,0,0,0,0.203941008313931,261.822171672194,20.8308173077735
9.7,"greedy_SVM","SVM",10,6,2084,1969,115,700,565,135,0.81160922665579,0.304964539007092,1.22923816060398,332,135,197,66,1.5,25.14,4.2,0,0,0,0,0,0,0.213012135659721,187.221980944953,21.9498248297345
9.7,"greedy_SVM","SVM",10,7,1984,1893,91,800,641,159,0.81122969206716,0.283687943262411,1.22013269274766,402,159,243,70,1.5,28.74,4,0,0,0,0,0,0,0.208851761203779,174.450286458126,21.5772628643613
9.7,"greedy_SVM","SVM",10,8,1884,1811,73,900,723,177,0.808725896721275,0.290780141843972,1.22013269274766,449,177,272,47,1.5,32.33,4.1,0,0,0,0,0,0,0.201536171880688,161.873319005762,20.8538602635286
9.7,"greedy_SVM","SVM",10,9,1784,1728,56,1000,806,194,0.801582715881542,0.276595744680851,1.22013269274766,488,194,294,39,1.5,35.92,4.2,0,0,0,0,0,0,0.200158737245256,171.369899287842,20.6390158541444
9.7,"greedy_SVM","SVM",10,10,1684,1647,37,1100,887,213,0.809671900845174,0.290780141843972,1.22013269274766,557,213,344,69,1.6,39.51,4.2,0,0,0,0,0,0,0.198021517785094,179.895550279665,20.3301982509555
9.7,"greedy_SVM","SVM",10,11,1584,1558,26,1200,976,224,0.809281036865838,0.290780141843972,1.23834362846031,575,224,351,18,1.6,43.1,4.4,0,0,0,0,0,0,0.17831951408315,122.067993740867,18.6355924748237
9.7,"greedy_SVM","SVM",10,12,1484,1464,20,1300,1070,230,0.807762898511318,0.297872340425532,1.23834362846031,596,230,366,21,1.6,46.7,4.7,0,0,0,0,0,0,0.156962482184918,88.4010406158741,16.5927874792848
9.7,"greedy_SVM","SVM",10,13,1384,1365,19,1400,1169,231,0.812634536514628,0.326241134751773,1.22013269274766,605,231,374,9,1.6,50.29,5.1,0,0,0,0,0,0,0.135074429594045,66.5358623890496,14.6220988420197
9.7,"greedy_SVM","SVM",10,14,1284,1265,19,1500,1269,231,0.786350350078173,0.26241134751773,1.22013269274766,611,231,380,6,1.6,53.88,5.5,0,0,0,0,0,0,0.113740836190737,54.2203953306748,12.3807151642222
9.7,"greedy_SVM","SVM",10,15,1184,1167,17,1600,1367,233,0.804352751909004,0.340425531914894,1.21102722489133,614,233,381,3,1.6,57.47,5.9,0,0,0,0,0,0,0.0940870986783988,37.5701526564018,12.0862948320029
9.7,"greedy_SVM","SVM",10,16,1084,1068,16,1700,1466,234,0.809326354428662,0.326241134751773,1.21102722489133,626,234,392,12,1.7,61.06,6.3,0,0,0,0,0,0,0.0782192286725473,27.9257389974208,10.0851846653079
9.7,"greedy_SVM","SVM",10,17,984,968,16,1800,1566,234,0.777230190560351,0.212765957446809,1.21102722489133,628,234,394,2,1.7,64.66,6.7,0,0,0,0,0,0,0.0373060769274526,10.83641859561,5.18836723896566
9.7,"greedy_SVM","SVM",10,18,884,870,14,1900,1664,236,0.797810028776653,0.283687943262411,1.22923816060398,615,236,379,-13,1.6,68.25,7.1,0,0,0,0,0,0,0.0231888709765222,7.67304731253735,3.29027315490138
9.7,"greedy_SVM","SVM",10,19,784,772,12,2000,1762,238,0.818021661795029,0.361702127659574,1.23834362846031,626,238,388,11,1.6,71.84,7.4,0,0,0,0,0,0,0.0366172321276,11.2006971936519,6.13746123611874
9.7,"greedy_SVM","SVM",10,20,684,672,12,2100,1862,238,0.807615616432148,0.276595744680851,1.23834362846031,633,238,395,7,1.7,75.43,7.8,0,0,0,0,0,0,0.0125835622670895,3.76700436981218,2.19073212232348
9.7,"greedy_SVM","SVM",10,21,584,574,10,2200,1960,240,0.782645639317516,0.24822695035461,1.23834362846031,640,240,400,7,1.7,79.02,8.2,0,0,0,0,0,0,0.0121685638656696,3.75181908964643,2.30898312955838
9.7,"greedy_SVM","SVM",10,22,484,476,8,2300,2058,242,0.776675050415789,0.26241134751773,1.22923816060398,642,242,400,2,1.7,82.61,8.5,0,0,0,0,0,0,0.0324479143869286,9.81324366165087,4.30692481345754
9.7,"greedy_SVM","SVM",10,23,384,378,6,2400,2156,244,0.830042145333425,0.404255319148936,1.25655456417296,655,244,411,13,1.7,86.21,8.8,0,0,0,0,0,0,0.00363889013279161,1.15799224073358,0.952078714904739
9.7,"greedy_SVM","SVM",10,24,284,283,1,2500,2251,249,0.79566877393334,0.234042553191489,1.26566003202928,686,249,437,31,1.8,89.8,9,0,0,0,0,0,0,0.000363755580360184,0.403934653982508,0.389837871250237
9.7,"greedy_SVM","SVM",10,25,184,184,0,2600,2350,250,0.809224389912314,0.283687943262411,1.26566003202928,645,250,395,-41,1.6,93.39,9.4,0,0,0,0,0,0,5.00583953581471e-05,0.0475267963513333,0.046201118343225
9.7,"greedy_SVM","SVM",10,26,84,84,0,2700,2450,250,0.745366279201508,0.156028368794326,1.26566003202928,683,250,433,38,1.7,96.98,9.8,0,0,0,0,0,0,1.36018921197787e-07,0.000311583438590477,0.000311583438590477
9.7,"greedy_SVM","SVM",10,27,0,0,0,2784,2534,250,0.836182675095737,0.404255319148936,1.26566003202928,675,250,425,-8,1.7,100,10.1,0,0,0,0,0,0,0,0,0
9.7,"greedy_SVM","SVM",11,0,2684,2444,240,100,88,12,0.753995846385101,0.402877697841727,1.13608725922488,33,12,21,0,1.8,3.59,7.3,0,0,0,0,0,0,0.176985676770523,327.884472399507,18.997685921107
9.7,"greedy_SVM","SVM",11,1,2584,2379,205,200,153,47,0.644716762475194,0.122302158273381,1.09914133209561,111,47,64,78,1.4,7.18,3.3,0,0,0,0,0,0,0.255550993563326,585.645244893472,26.8795888210148
9.7,"greedy_SVM","SVM",11,2,2484,2293,191,300,239,61,0.682523837389423,0.158273381294964,1.09914133209561,150,61,89,39,1.5,10.78,3.9,0,0,0,0,0,0,0.206585797790678,497.708650305256,20.9080618455036
9.7,"greedy_SVM","SVM",11,3,2384,2197,187,400,335,65,0.767500831870401,0.266187050359712,1.19150614991877,163,65,98,13,1.5,14.37,5.2,0,0,0,0,0,0,0.188555752672379,302.512949709794,20.9154371083309
9.7,"greedy_SVM","SVM",11,4,2284,2115,169,500,417,83,0.780076417335045,0.345323741007194,1.18226966813646,199,83,116,36,1.4,17.96,5,0,0,0,0,0,0,0.194288256743434,250.090231434768,20.7625123530391
9.7,"greedy_SVM","SVM",11,5,2184,2044,140,600,488,112,0.773966472754823,0.302158273381295,1.18226966813646,265,112,153,66,1.4,21.55,4.4,0,0,0,0,0,0,0.205114634206103,212.607006049921,21.0272332446126
9.7,"greedy_SVM","SVM",11,6,2084,1965,119,700,567,133,0.76548713182565,0.309352517985612,1.18226966813646,318,133,185,53,1.4,25.14,4.3,0,0,0,0,0,0,0.207545890599044,211.663528220935,21.2814724163596
9.7,"greedy_SVM","SVM",11,7,1984,1891,93,800,641,159,0.758292887221336,0.280575539568345,1.18226966813646,381,159,222,63,1.4,28.74,4,0,0,0,0,0,0,0.207558592944462,218.979598281981,21.2072479345786
9.7,"greedy_SVM","SVM",11,8,1884,1801,83,900,731,169,0.769640746732769,0.309352517985612,1.18226966813646,410,169,241,29,1.4,32.33,4.3,0,0,0,0,0,0,0.189854531766496,165.174816771044,19.6854138659063
9.7,"greedy_SVM","SVM",11,9,1784,1723,61,1000,809,191,0.763301320665971,0.266187050359712,1.19150614991877,466,191,275,56,1.4,35.92,4.2,0,0,0,0,0,0,0.180083807405753,154.50575995147,19.0210896249712
9.7,"greedy_SVM","SVM",11,10,1684,1631,53,1100,901,199,0.759853361330092,0.287769784172662,1.19150614991877,491,199,292,25,1.5,39.51,4.5,0,0,0,0,0,0,0.155855912309272,114.579798933058,17.0460940080906
9.7,"greedy_SVM","SVM",11,11,1584,1533,51,1200,999,201,0.748878409234347,0.23021582733813,1.19150614991877,503,201,302,12,1.5,43.1,5,0,0,0,0,0,0,0.129468022938635,86.1764960046879,14.0752350447326
9.7,"greedy_SVM","SVM",11,12,1484,1437,47,1300,1095,205,0.762584191020402,0.23021582733813,1.19150614991877,513,205,308,10,1.5,46.7,5.3,0,0,0,0,0,0,0.141985247787406,87.8380046416621,15.7970773233815
9.7,"greedy_SVM","SVM",11,13,1384,1344,40,1400,1188,212,0.792485628721909,0.273381294964029,1.19150614991877,536,212,324,23,1.5,50.29,5.6,0,0,0,0,0,0,0.142051772730078,63.4369874191779,15.7935243567916
9.7,"greedy_SVM","SVM",11,14,1284,1258,26,1500,1274,226,0.777758654320574,0.23021582733813,1.19150614991877,579,226,353,43,1.6,53.88,5.6,0,0,0,0,0,0,0.131342952609937,51.6074272576162,14.9438728904581
9.7,"greedy_SVM","SVM",11,15,1184,1166,18,1600,1366,234,0.776267024657798,0.287769784172662,1.19150614991877,619,234,385,40,1.6,57.47,5.8,0,0,0,0,0,0,0.122959068140514,42.5195811567724,13.8288885455159
9.7,"greedy_SVM","SVM",11,16,1084,1067,17,1700,1465,235,0.759457505765736,0.237410071942446,1.19150614991877,620,235,385,1,1.6,61.06,6.2,0,0,0,0,0,0,0.0946177182959825,29.8153099496289,10.9748484958081
9.7,"greedy_SVM","SVM",11,17,984,967,17,1800,1565,235,0.755017039000389,0.237410071942446,1.19150614991877,621,235,386,1,1.6,64.66,6.7,0,0,0,0,0,0,0.0679913242338387,20.1296294919971,8.18646588697247
9.7,"greedy_SVM","SVM",11,18,884,867,17,1900,1665,235,0.750978164836564,0.215827338129496,1.19150614991877,627,235,392,6,1.7,68.25,7.1,0,0,0,0,0,0,0.0207706236995182,6.0776014352602,3.9082504318949
9.7,"greedy_SVM","SVM",11,19,784,767,17,2000,1765,235,0.75567679827431,0.201438848920863,1.19150614991877,610,235,375,-17,1.6,71.84,7.5,0,0,0,0,0,0,0.00575046111572123,2.24918941191879,1.33129491744813
9.7,"greedy_SVM","SVM",11,20,684,668,16,2100,1864,236,0.803081936364797,0.381294964028777,1.19150614991877,626,236,390,16,1.7,75.43,7.9,0,0,0,0,0,0,0.0014685822397349,0.456729909575838,0.249006332402543
9.7,"greedy_SVM","SVM",11,21,584,572,12,2200,1960,240,0.789812169403243,0.323741007194245,1.19150614991877,633,240,393,7,1.6,79.02,8.2,0,0,0,0,0,0,0.00878891307764457,2.59552971190794,1.91396107790751
9.7,"greedy_SVM","SVM",11,22,484,474,10,2300,2058,242,0.757931453879969,0.20863309352518,1.19150614991877,638,242,396,5,1.6,82.61,8.5,0,0,0,0,0,0,0.011578188185361,3.4282699936391,2.53955152442176
9.7,"greedy_SVM","SVM",11,23,384,374,10,2400,2158,242,0.810161440225828,0.359712230215827,1.19150614991877,635,242,393,-3,1.6,86.21,8.9,0,0,0,0,0,0,0.00270233858316351,0.687928025084033,0.495316095467803
9.7,"greedy_SVM","SVM",11,24,284,277,7,2500,2255,245,0.80644384014321,0.316546762589928,1.19150614991877,645,245,400,10,1.6,89.8,9.2,0,0,0,0,0,0,0.0407049638669426,9.32550100927611,7.52940930625286
9.7,"greedy_SVM","SVM",11,25,184,177,7,2600,2355,245,0.77530893945132,0.244604316546763,1.18226966813646,644,245,399,-1,1.6,93.39,9.6,0,0,0,0,0,0,0.00508778153679702,2.09210388295545,1.91692870459431
9.7,"greedy_SVM","SVM",11,26,84,80,4,2700,2452,248,0.804240817872025,0.330935251798561,1.20997911348341,666,248,418,22,1.7,96.98,9.9,0,0,0,0,0,0,0.001103036428828,0.919983395475291,0.919983395475291
9.7,"greedy_SVM","SVM",11,27,0,0,0,2784,2532,252,0.810092595779839,0.287769784172662,1.23768855883036,701,252,449,35,1.8,100,10,0,0,0,0,0,0,0,0,0
9.7,"greedy_SVM","SVM",12,0,2684,2440,244,100,85,15,0.774727849470121,0.356060606060606,1.19633431085044,40,15,25,0,1.7,3.59,5.7,0,0,0,0,0,0,0.249820912546197,383.905119266374,28.1817993338521
9.7,"greedy_SVM","SVM",12,1,2584,2365,219,200,160,40,0.725380289813275,0.143939393939394,1.20606060606061,104,40,64,64,1.6,7.18,4,0,0,0,0,0,0,0.209725209741701,493.425325378433,21.5773998999317
9.7,"greedy_SVM","SVM",12,2,2484,2272,212,300,253,47,0.725278158267836,0.106060606060606,1.20606060606061,128,47,81,24,1.7,10.78,5.4,0,0,0,0,0,0,0.289276443107335,386.094549121894,46.2243490162322
9.7,"greedy_SVM","SVM",12,3,2384,2188,196,400,337,63,0.721487275610981,0.189393939393939,1.16715542521994,169,63,106,41,1.7,14.37,5.3,0,0,0,0,0,0,0.187908177304832,327.946468974888,23.8742407617703
9.7,"greedy_SVM","SVM",12,4,2284,2094,190,500,431,69,0.759576334318596,0.234848484848485,1.20606060606061,174,69,105,5,1.5,17.96,6.2,0,0,0,0,0,0,0.166898862867916,212.150755115332,17.4603395588879
9.7,"greedy_SVM","SVM",12,5,2184,2019,165,600,506,94,0.765866435969524,0.257575757575758,1.20606060606061,242,94,148,68,1.6,21.55,5.4,0,0,0,0,0,0,0.175213885296949,212.929563680385,17.7658574138574
9.7,"greedy_SVM","SVM",12,6,2084,1961,123,700,564,136,0.768335616273761,0.287878787878788,1.20606060606061,334,136,198,92,1.5,25.14,4.1,0,0,0,0,0,0,0.224135135315251,238.483598945594,22.829981703647
9.7,"greedy_SVM","SVM",12,7,1984,1894,90,800,631,169,0.766178838343786,0.25,1.21578690127077,407,169,238,73,1.4,28.74,3.7,0,0,0,0,0,0,0.227844913094112,212.682178346218,23.634549784296
9.7,"greedy_SVM","SVM",12,8,1884,1817,67,900,708,192,0.757527695672025,0.234848484848485,1.19633431085044,470,192,278,63,1.4,32.33,3.7,0,0,0,0,0,0,0.209315264794013,179.575636258212,22.233974314216
9.7,"greedy_SVM","SVM",12,9,1784,1733,51,1000,792,208,0.751820344603847,0.234848484848485,1.19633431085044,516,208,308,46,1.5,35.92,3.8,0,0,0,0,0,0,0.207434042489678,183.813557597275,21.4925085434295
9.7,"greedy_SVM","SVM",12,10,1684,1641,43,1100,884,216,0.749261048230114,0.265151515151515,1.19633431085044,547,216,331,31,1.5,39.51,4.1,0,0,0,0,0,0,0.195875868436057,182.825913329341,20.3204155281799
9.7,"greedy_SVM","SVM",12,11,1584,1542,42,1200,983,217,0.752162785667935,0.204545454545455,1.19633431085044,554,217,337,7,1.6,43.1,4.5,0,0,0,0,0,0,0.140292556079788,89.9472803340221,15.6449774861706
9.7,"greedy_SVM","SVM",12,12,1484,1446,38,1300,1079,221,0.769639295412486,0.234848484848485,1.20606060606061,556,221,335,2,1.5,46.7,4.9,0,0,0,0,0,0,0.132161788152993,102.727738516185,15.218832055379
9.7,"greedy_SVM","SVM",12,13,1384,1353,31,1400,1172,228,0.780327061254891,0.242424242424242,1.21578690127077,565,228,337,9,1.5,50.29,5.1,0,0,0,0,0,0,0.107529693531557,61.3914679979993,11.868386780931
9.7,"greedy_SVM","SVM",12,14,1284,1259,25,1500,1266,234,0.774451493523657,0.21969696969697,1.21578690127077,594,234,360,29,1.5,53.88,5.4,0,0,0,0,0,0,0.152365801373335,66.3363405020973,16.583243717567
9.7,"greedy_SVM","SVM",12,15,1184,1170,14,1600,1355,245,0.78318073678898,0.242424242424242,1.21578690127077,634,245,389,40,1.6,57.47,5.5,0,0,0,0,0,0,0.130240040057152,58.6642004090437,14.5279570122982
9.7,"greedy_SVM","SVM",12,16,1084,1074,10,1700,1451,249,0.778873188667001,0.21969696969697,1.21578690127077,647,249,398,13,1.6,61.06,5.8,0,0,0,0,0,0,0.101368143066663,42.8454339057105,11.6199742720554
9.7,"greedy_SVM","SVM",12,17,984,974,10,1800,1551,249,0.767025929397061,0.181818181818182,1.21578690127077,644,249,395,-3,1.6,64.66,6.2,0,0,0,0,0,0,0.0605188503598597,20.5116467407742,7.1624538042221
9.7,"greedy_SVM","SVM",12,18,884,874,10,1900,1651,249,0.785944296253574,0.25,1.20606060606061,652,249,403,8,1.6,68.25,6.6,0,0,0,0,0,0,0.0505321454679916,16.7063080810158,5.96693052231376
9.7,"greedy_SVM","SVM",12,19,784,774,10,2000,1751,249,0.769086583519571,0.212121212121212,1.21578690127077,657,249,408,5,1.6,71.84,7,0,0,0,0,0,0,0.020798325954676,6.06878074298576,2.8753640502547
9.7,"greedy_SVM","SVM",12,20,684,674,10,2100,1851,249,0.789572969985341,0.242424242424242,1.21578690127077,662,249,413,5,1.7,75.43,7.4,0,0,0,0,0,0,0.00952992084635639,2.55814026763287,1.40261214911064
9.7,"greedy_SVM","SVM",12,21,584,574,10,2200,1951,249,0.780254968399295,0.21969696969697,1.21578690127077,631,249,382,-31,1.5,79.02,7.8,0,0,0,0,0,0,0.00414257456427667,1.11074155166418,0.65661209257321
9.7,"greedy_SVM","SVM",12,22,484,476,8,2300,2049,251,0.782057289789249,0.272727272727273,1.20606060606061,657,251,406,26,1.6,82.61,8.2,0,0,0,0,0,0,0.00538202460379216,1.84295975310719,1.3172025486403
9.7,"greedy_SVM","SVM",12,23,384,379,5,2400,2146,254,0.794991949631123,0.21969696969697,1.19633431085044,672,254,418,15,1.6,86.21,8.4,0,0,0,0,0,0,0.00569956435484027,1.74499074099119,1.22693702436027
9.7,"greedy_SVM","SVM",12,24,284,279,5,2500,2246,254,0.793568115733064,0.295454545454545,1.19633431085044,677,254,423,5,1.7,89.8,8.8,0,0,0,0,0,0,0.00125623576381986,0.340189877236128,0.25662064917554
9.7,"greedy_SVM","SVM",12,25,184,180,4,2600,2345,255,0.782928411794389,0.242424242424242,1.19633431085044,675,255,420,-2,1.6,93.39,9.2,0,0,0,0,0,0,0.000767436301202023,0.210984713163896,0.182379799469723
9.7,"greedy_SVM","SVM",12,26,84,82,2,2700,2443,257,0.797352990651962,0.21969696969697,1.22551319648094,682,257,425,7,1.7,96.98,9.5,0,0,0,0,0,0,4.57970966792825e-05,0.388764949843414,0.388764949843414
9.7,"greedy_SVM","SVM",12,27,0,0,0,2784,2525,259,0.764785043135552,0.189393939393939,1.2352394916911,695,259,436,13,1.7,100,9.7,0,0,0,0,0,0,0,0,0
9.7,"greedy_SVM","SVM",13,0,2684,2445,239,100,91,9,0.8194965034965,0.370629370629371,1.24795849311978,22,9,13,0,1.4,3.59,10.1,0,0,0,0,0,0,0.104841394030106,227.475756392162,10.797660394731
9.7,"greedy_SVM","SVM",13,1,2584,2376,208,200,160,40,0.721997202797197,0.13986013986014,1.22102413715317,102,40,62,80,1.6,7.18,4,0,0,0,0,0,0,0.250336853799434,496.124701996568,31.2155575618115
9.7,"greedy_SVM","SVM",13,2,2484,2281,203,300,255,45,0.808704895104892,0.293706293706294,1.26591473043086,113,45,68,11,1.5,10.78,5.7,0,0,0,0,0,0,0.192836689567649,214.952776331125,20.1950223386706
9.7,"greedy_SVM","SVM",13,3,2384,2205,179,400,331,69,0.786875524475519,0.27972027972028,1.25693661177532,163,69,94,50,1.4,14.37,4.8,0,0,0,0,0,0,0.200082156112115,207.471188560167,23.6669749735384
9.7,"greedy_SVM","SVM",13,4,2284,2126,158,500,410,90,0.769572027972023,0.307692307692308,1.23000225580871,218,90,128,55,1.4,17.96,4.6,0,0,0,0,0,0,0.207203640610215,153.574631151869,21.529446250553
9.7,"greedy_SVM","SVM",13,5,2184,2056,128,600,480,120,0.758248951048943,0.314685314685315,1.23000225580871,280,120,160,62,1.3,21.55,4,0,0,0,0,0,0,0.212218043948078,120.036375105784,22.3704360653845
9.7,"greedy_SVM","SVM",13,6,2084,1980,104,700,556,144,0.743597202797198,0.293706293706294,1.21204601849763,339,144,195,59,1.4,25.14,3.9,0,0,0,0,0,0,0.213452081957946,124.276189988069,22.585627977808
9.7,"greedy_SVM","SVM",13,7,1984,1887,97,800,649,151,0.821476923076923,0.314685314685315,1.25693661177532,364,151,213,25,1.4,28.74,4.3,0,0,0,0,0,0,0.183461781455542,57.7377217612961,20.5358011770922
9.7,"greedy_SVM","SVM",13,8,1884,1811,73,900,725,175,0.819188811188807,0.300699300699301,1.25693661177532,424,175,249,60,1.4,32.33,4.1,0,0,0,0,0,0,0.1707717261163,65.5797860760019,19.1273081978788
9.7,"greedy_SVM","SVM",13,9,1784,1730,54,1000,806,194,0.825079720279717,0.307692307692308,1.25693661177532,467,194,273,43,1.4,35.92,4.2,0,0,0,0,0,0,0.178001307504261,91.7337472318376,19.4143587398404
9.7,"greedy_SVM","SVM",13,10,1684,1643,41,1100,893,207,0.790825174825177,0.230769230769231,1.21204601849763,521,207,314,54,1.5,39.51,4.3,0,0,0,0,0,0,0.189580673286803,100.431507934616,20.4615884696739
9.7,"greedy_SVM","SVM",13,11,1584,1548,36,1200,988,212,0.814081118881122,0.314685314685315,1.22102413715317,522,212,310,1,1.5,43.1,4.7,0,0,0,0,0,0,0.156680545339497,74.9273816205637,16.8316259699104
9.7,"greedy_SVM","SVM",13,12,1484,1458,26,1300,1078,222,0.795328671328671,0.307692307692308,1.21204601849763,578,222,356,56,1.6,46.7,4.9,0,0,0,0,0,0,0.174034516845603,95.8479493372081,18.188732001161
9.7,"greedy_SVM","SVM",13,13,1384,1362,22,1400,1174,226,0.787155244755245,0.244755244755245,1.21204601849763,583,226,357,5,1.6,50.29,5.2,0,0,0,0,0,0,0.148336446628604,63.1973487126344,15.8420964896317
9.7,"greedy_SVM","SVM",13,14,1284,1263,21,1500,1273,227,0.770366433566432,0.202797202797203,1.21204601849763,602,227,375,19,1.7,53.88,5.6,0,0,0,0,0,0,0.138723248533302,66.6426752157561,14.5445310965988
9.7,"greedy_SVM","SVM",13,15,1184,1164,20,1600,1372,228,0.782064335664336,0.244755244755245,1.21204601849763,598,228,370,-4,1.6,57.47,6,0,0,0,0,0,0,0.13764422995757,76.1501094811327,14.2096931825219
9.7,"greedy_SVM","SVM",13,16,1084,1066,18,1700,1470,230,0.722411188811189,0.146853146853147,1.21204601849763,627,230,397,29,1.7,61.06,6.4,0,0,0,0,0,0,0.131212314238932,44.4499305754504,14.1962660685317
9.7,"greedy_SVM","SVM",13,17,984,967,17,1800,1569,231,0.729935664335663,0.13986013986014,1.21204601849763,630,231,399,3,1.7,64.66,6.8,0,0,0,0,0,0,0.103002716942282,26.8355587027872,11.3502402960453
9.7,"greedy_SVM","SVM",13,18,884,867,17,1900,1669,231,0.739479720279719,0.153846153846154,1.21204601849763,625,231,394,-5,1.7,68.25,7.2,0,0,0,0,0,0,0.0332731936610839,6.50893444524975,5.23820376869157
9.7,"greedy_SVM","SVM",13,19,784,768,16,2000,1768,232,0.776688111888113,0.237762237762238,1.22102413715317,634,232,402,9,1.7,71.84,7.6,0,0,0,0,0,0,0.006757802736587,3.52102194488465,3.20588164872566
9.7,"greedy_SVM","SVM",13,20,684,671,13,2100,1865,235,0.737812587412584,0.174825174825175,1.19408978118656,621,235,386,-13,1.6,75.43,7.9,0,0,0,0,0,0,0.0338713399035838,11.7002615684388,7.15652830480503
9.7,"greedy_SVM","SVM",13,21,584,572,12,2200,1964,236,0.741683916083911,0.153846153846154,1.20306789984209,628,236,392,7,1.7,79.02,8.3,0,0,0,0,0,0,0.0219010556220067,7.09480644383664,3.60223861315923
9.7,"greedy_SVM","SVM",13,22,484,474,10,2300,2062,238,0.725862937062932,0.160839160839161,1.20306789984209,641,238,403,13,1.7,82.61,8.7,0,0,0,0,0,0,0.0282403356227554,9.29562076680865,5.80808948242962
9.7,"greedy_SVM","SVM",13,23,384,374,10,2400,2162,238,0.782427972027965,0.272727272727273,1.21204601849763,639,238,401,-2,1.7,86.21,9.1,0,0,0,0,0,0,0.00522234804640204,1.13979544301973,0.870663699362761
9.7,"greedy_SVM","SVM",13,24,284,276,8,2500,2260,240,0.747457342657338,0.167832167832168,1.21204601849763,643,240,403,4,1.7,89.8,9.4,0,0,0,0,0,0,0.0138847771084066,3.50910042052553,2.38207654764221
9.7,"greedy_SVM","SVM",13,25,184,177,7,2600,2359,241,0.771832167832164,0.202797202797203,1.23000225580871,644,241,403,1,1.7,93.39,9.8,0,0,0,0,0,0,0.01154164723174,2.74927275628874,2.23185395236774
9.7,"greedy_SVM","SVM",13,26,84,83,1,2700,2453,247,0.814914685314682,0.300699300699301,1.2748928490864,677,247,430,33,1.7,96.98,9.9,0,0,0,0,0,0,5.5166290869705e-11,1.24046204671265,1.24046204671265
9.7,"greedy_SVM","SVM",13,27,0,0,0,2784,2536,248,0.772710489510488,0.216783216783217,1.26591473043086,664,248,416,-13,1.7,100,10.2,0,0,0,0,0,0,0,0,0
9.7,"greedy_SVM","SVM",14,0,2684,2420,264,100,89,11,0.807550022952494,0.198275862068966,1.27280311457175,30,11,19,0,1.7,3.59,8.1,0,0,0,0,0,0,0.192683186007687,280.969613510639,21.2861307131373
9.7,"greedy_SVM","SVM",14,1,2584,2337,247,200,172,28,0.745693030540327,0.28448275862069,1.19532814238042,84,28,56,54,2,7.18,6.1,0,0,0,0,0,0,0.164257233772693,354.854861638734,17.7857686334527
9.7,"greedy_SVM","SVM",14,2,2484,2267,217,300,242,58,0.787081791915309,0.198275862068966,1.23959955506118,137,58,79,53,1.4,10.78,4.2,0,0,0,0,0,0,0.225352993891636,390.884407531485,24.5273422987737
9.7,"greedy_SVM","SVM",14,3,2384,2186,198,400,323,77,0.804208408716545,0.267241379310345,1.27280311457175,188,77,111,51,1.4,14.37,4.2,0,0,0,0,0,0,0.197631265737625,384.547978880356,20.2150629191845
9.7,"greedy_SVM","SVM",14,4,2284,2112,172,500,397,103,0.838353630545715,0.293103448275862,1.27280311457175,251,103,148,63,1.4,17.96,3.9,0,0,0,0,0,0,0.210363278612326,276.836241289059,21.8240725658578
9.7,"greedy_SVM","SVM",14,5,2184,2044,140,600,465,135,0.833277077201402,0.267241379310345,1.27280311457175,321,135,186,70,1.4,21.55,3.4,0,0,0,0,0,0,0.217273239587115,287.160640506202,22.4148973306464
9.7,"greedy_SVM","SVM",14,6,2084,1975,109,700,534,166,0.840162827748214,0.275862068965517,1.27280311457175,393,166,227,72,1.4,25.14,3.2,0,0,0,0,0,0,0.231161880354653,316.289710291425,23.7472321646366
9.7,"greedy_SVM","SVM",14,7,1984,1906,78,800,603,197,0.846940566521742,0.258620689655172,1.27280311457175,469,197,272,76,1.4,28.74,3.1,0,0,0,0,0,0,0.223792023548219,212.275661831704,23.8217355288861
9.7,"greedy_SVM","SVM",14,8,1884,1827,57,900,682,218,0.839771285070065,0.21551724137931,1.27280311457175,526,218,308,57,1.4,32.33,3.1,0,0,0,0,0,0,0.221269180814518,241.770285883362,23.4833065336179
9.7,"greedy_SVM","SVM",14,9,1784,1740,44,1000,769,231,0.824595630923762,0.181034482758621,1.27280311457175,563,231,332,37,1.4,35.92,3.3,0,0,0,0,0,0,0.214084961859815,158.509522161679,23.9891984640396
9.7,"greedy_SVM","SVM",14,10,1684,1650,34,1100,859,241,0.824075824264835,0.206896551724138,1.27280311457175,609,241,368,46,1.5,39.51,3.6,0,0,0,0,0,0,0.19895509800767,120.726519256777,21.4252097378575
9.7,"greedy_SVM","SVM",14,11,1584,1552,32,1200,957,243,0.82358977128506,0.206896551724138,1.27280311457175,613,243,370,4,1.5,43.1,3.9,0,0,0,0,0,0,0.152024741702007,76.3314646668707,16.8009245678648
9.7,"greedy_SVM","SVM",14,12,1484,1462,22,1300,1047,253,0.829118623929999,0.206896551724138,1.27280311457175,639,253,386,26,1.5,46.7,4.1,0,0,0,0,0,0,0.149199845023961,75.9711692938232,16.3713645450717
9.7,"greedy_SVM","SVM",14,13,1384,1370,14,1400,1139,261,0.813132881484072,0.172413793103448,1.27280311457175,660,261,399,21,1.5,50.29,4.4,0,0,0,0,0,0,0.149232642886574,70.968701654593,16.4428300881426
9.7,"greedy_SVM","SVM",14,14,1284,1273,11,1500,1236,264,0.827289174520012,0.232758620689655,1.27280311457175,675,264,411,15,1.6,53.88,4.7,0,0,0,0,0,0,0.0956145563172281,33.0156339523799,11.236822163676
9.7,"greedy_SVM","SVM",14,15,1184,1173,11,1600,1336,264,0.802000918100063,0.146551724137931,1.27280311457175,670,264,406,-5,1.5,57.47,5.1,0,0,0,0,0,0,0.0821789475699624,27.3805380705372,9.37318250062799
9.7,"greedy_SVM","SVM",14,16,1084,1074,10,1700,1435,265,0.823400750681809,0.206896551724138,1.27280311457175,704,265,439,34,1.7,61.06,5.4,0,0,0,0,0,0,0.0703345715211265,24.6399404738311,11.0615651461742
9.7,"greedy_SVM","SVM",14,17,984,977,7,1800,1532,268,0.800353738557491,0.163793103448276,1.27280311457175,719,268,451,15,1.7,64.66,5.7,0,0,0,0,0,0,0.0634504556926347,19.1971416837444,11.0322599470707
9.7,"greedy_SVM","SVM",14,18,884,877,7,1900,1632,268,0.800617017254869,0.189655172413793,1.27280311457175,710,268,442,-9,1.6,68.25,6.1,0,0,0,0,0,0,0.0316440772258132,8.56236864611125,4.66662566806504
9.7,"greedy_SVM","SVM",14,19,784,779,5,2000,1730,270,0.793278967407436,0.129310344827586,1.27280311457175,719,270,449,9,1.7,71.84,6.4,0,0,0,0,0,0,0.039030754917731,11.6679889816505,6.46726864367291
9.7,"greedy_SVM","SVM",14,20,684,681,3,2100,1828,272,0.794386088083592,0.163793103448276,1.27280311457175,732,272,460,13,1.7,75.43,6.7,0,0,0,0,0,0,0.0782457722413439,31.8565733137938,9.52714350551208
9.7,"greedy_SVM","SVM",14,21,584,582,2,2200,1927,273,0.773350795236676,0.129310344827586,1.27280311457175,739,273,466,7,1.7,79.02,7.1,0,0,0,0,0,0,0.0801341257374,30.4589946150983,11.9113623004638
9.7,"greedy_SVM","SVM",14,22,484,483,1,2300,2026,274,0.699376232009287,0.0862068965517241,1.27280311457175,745,274,471,6,1.7,82.61,7.4,0,0,0,0,0,0,0.0615388627015904,18.6144243759333,7.63879376741861
9.7,"greedy_SVM","SVM",14,23,384,384,0,2400,2125,275,0.789437798720052,0.258620689655172,1.27280311457175,755,275,480,10,1.7,86.21,7.7,0,0,0,0,0,0,0.0502903056940247,14.0641620242032,8.13712732710775
9.7,"greedy_SVM","SVM",14,24,284,284,0,2500,2225,275,0.764210298922577,0.181034482758621,1.27280311457175,752,275,477,-3,1.7,89.8,8.1,0,0,0,0,0,0,0.0129672702833394,3.02374841192861,2.34102132747909
9.7,"greedy_SVM","SVM",14,25,184,184,0,2600,2325,275,0.723894904544593,0.129310344827586,1.26173526140156,767,275,492,15,1.8,93.39,8.5,0,0,0,0,0,0,0.0088827023909699,2.18348542826695,1.84239123229727
9.7,"greedy_SVM","SVM",14,26,84,84,0,2700,2425,275,0.74097426619501,0.112068965517241,1.26173526140156,748,275,473,-19,1.7,96.98,8.8,0,0,0,0,0,0,9.5972954573473e-09,0.157768927346923,0.157768927346923
9.7,"greedy_SVM","SVM",14,27,0,0,0,2784,2509,275,0.792185348202947,0.189655172413793,1.26173526140156,745,275,470,-3,1.7,100,9.1,0,0,0,0,0,0,0,0,0
9.7,"greedy_SVM","SVM",15,0,2684,2432,252,100,88,12,0.827126170840029,0.291338582677165,1.2737617475235,34,12,22,0,1.8,3.59,7.3,0,0,0,0,0,0,0.161743916048587,342.932497219046,17.3584365477819
9.7,"greedy_SVM","SVM",15,1,2584,2352,232,200,168,32,0.8245388165342,0.330708661417323,1.26365252730505,73,32,41,39,1.3,7.18,5.2,0,0,0,0,0,0,0.248529674440273,306.921581523593,27.8509666004668
9.7,"greedy_SVM","SVM",15,2,2484,2287,197,300,233,67,0.805059024020106,0.228346456692913,1.26365252730505,162,67,95,89,1.4,10.78,3.5,0,0,0,0,0,0,0.250478345352665,465.094179461965,26.0807969956331
9.7,"greedy_SVM","SVM",15,3,2384,2199,185,400,321,79,0.832381734273744,0.307086614173228,1.28387096774194,193,79,114,31,1.4,14.37,4.1,0,0,0,0,0,0,0.21061946659709,380.489062947933,21.3507486239066
9.7,"greedy_SVM","SVM",15,4,2284,2127,157,500,393,107,0.802247764053194,0.31496062992126,1.25354330708661,263,107,156,70,1.5,17.96,3.7,0,0,0,0,0,0,0.225286795597664,282.131897659158,23.2941202128815
9.7,"greedy_SVM","SVM",15,5,2184,2055,129,600,465,135,0.817995795549264,0.31496062992126,1.24343408686817,331,135,196,68,1.5,21.55,3.4,0,0,0,0,0,0,0.228323217140707,160.7157654881,23.9685218752623
9.7,"greedy_SVM","SVM",15,6,2084,1977,107,700,543,157,0.830410120535888,0.338582677165354,1.2737617475235,375,157,218,44,1.4,25.14,3.5,0,0,0,0,0,0,0.211538180196365,134.466986447799,22.6578369377467
9.7,"greedy_SVM","SVM",15,7,1984,1901,83,800,619,181,0.81689492604894,0.330708661417323,1.26365252730505,429,181,248,54,1.4,28.74,3.4,0,0,0,0,0,0,0.192306072142849,182.533970684324,22.4384006559828
9.7,"greedy_SVM","SVM",15,8,1884,1826,58,900,694,206,0.796090358373448,0.299212598425197,1.26365252730505,499,206,293,70,1.4,32.33,3.4,0,0,0,0,0,0,0.224268694529278,158.925978631648,24.9745254243365
9.7,"greedy_SVM","SVM",15,9,1784,1727,57,1000,793,207,0.844839596472249,0.307086614173228,1.28387096774194,496,207,289,-3,1.4,35.92,3.8,0,0,0,0,0,0,0.120402059114458,31.3061181481754,16.2886287002592
9.7,"greedy_SVM","SVM",15,10,1684,1635,49,1100,885,215,0.824330459877352,0.275590551181102,1.25238903148156,522,215,307,26,1.4,39.51,4.1,0,0,0,0,0,0,0.160755661537111,69.8263465782778,18.4061669669081
9.7,"greedy_SVM","SVM",15,11,1584,1542,42,1200,978,222,0.833544799791023,0.338582677165354,1.25354330708661,541,222,319,19,1.4,43.1,4.4,0,0,0,0,0,0,0.163337201555188,64.5946199350025,18.47063416863
9.7,"greedy_SVM","SVM",15,12,1484,1453,31,1300,1067,233,0.784161162319168,0.228346456692913,1.25354330708661,581,233,348,40,1.5,46.7,4.6,0,0,0,0,0,0,0.187517415941105,95.1347563966603,22.0913912697318
9.7,"greedy_SVM","SVM",15,13,1384,1358,26,1400,1162,238,0.7941063054322,0.228346456692913,1.25354330708661,589,238,351,8,1.5,50.29,4.9,0,0,0,0,0,0,0.154367548614397,66.2979093764589,17.5235845124149
9.7,"greedy_SVM","SVM",15,14,1284,1261,23,1500,1259,241,0.793067631948853,0.283464566929134,1.25354330708661,626,241,385,37,1.6,53.88,5.2,0,0,0,0,0,0,0.110812716238732,36.7321028273039,13.5892906225403
9.7,"greedy_SVM","SVM",15,15,1184,1162,22,1600,1358,242,0.793086290753941,0.275590551181102,1.25354330708661,648,242,406,22,1.7,57.47,5.6,0,0,0,0,0,0,0.145357335188765,64.1231111553568,15.4202191114912
9.7,"greedy_SVM","SVM",15,16,1084,1063,21,1700,1457,243,0.783613837369854,0.283464566929134,1.25354330708661,634,243,391,-14,1.6,61.06,6,0,0,0,0,0,0,0.106484393596341,31.6250256869217,12.2231604459564
9.7,"greedy_SVM","SVM",15,17,984,963,21,1800,1557,243,0.778171685885238,0.21259842519685,1.25354330708661,647,243,404,13,1.7,64.66,6.4,0,0,0,0,0,0,0.0423867517975111,9.57698734897068,5.99727051543621
9.7,"greedy_SVM","SVM",15,18,884,863,21,1900,1657,243,0.800288589518728,0.291338582677165,1.25354330708661,658,243,415,11,1.7,68.25,6.8,0,0,0,0,0,0,0.0529828708035416,11.7964287141592,6.68556484646891
9.7,"greedy_SVM","SVM",15,19,784,765,19,2000,1755,245,0.760557773880164,0.165354330708661,1.25354330708661,660,245,415,2,1.7,71.84,7.2,0,0,0,0,0,0,0.000494057738898658,1.36036018361974,1.34470746033919
9.7,"greedy_SVM","SVM",15,20,684,670,14,2100,1850,250,0.801719097908977,0.220472440944882,1.28387096774194,658,250,408,-2,1.6,75.43,7.4,0,0,0,0,0,0,0.0596484967088754,21.8784578913543,14.344810197174
9.7,"greedy_SVM","SVM",15,21,584,572,12,2200,1948,252,0.800941647696879,0.251968503937008,1.26365252730505,677,252,425,19,1.7,79.02,7.7,0,0,0,0,0,0,0.0435235402067795,13.2636040381474,8.11779392356148
9.7,"greedy_SVM","SVM",15,22,484,472,12,2300,2048,252,0.804169620977471,0.251968503937008,1.26365252730505,678,252,426,1,1.7,82.61,8.1,0,0,0,0,0,0,0.0383992316151886,10.3658451532547,5.13553317198966
9.7,"greedy_SVM","SVM",15,23,384,374,10,2400,2146,254,0.775752260825217,0.181102362204724,1.28387096774194,705,254,451,27,1.8,86.21,8.4,0,0,0,0,0,0,0.0163568841732861,4.57145380347496,3.53997010112901
9.7,"greedy_SVM","SVM",15,24,284,279,5,2500,2241,259,0.775497257155652,0.236220472440945,1.28387096774194,743,259,484,38,1.9,89.8,8.7,0,0,0,0,0,0,0.0666492350442654,17.8467843828275,12.5827153171415
9.7,"greedy_SVM","SVM",15,25,184,182,2,2600,2338,262,0.79891405754376,0.275590551181102,1.2737617475235,762,262,500,19,1.9,93.39,8.9,0,0,0,0,0,0,0.0161000836868514,5.75658304567081,5.25321057658179
9.7,"greedy_SVM","SVM",15,26,84,84,0,2700,2436,264,0.822511226381064,0.283464566929134,1.28387096774194,763,264,499,1,1.9,96.98,9.2,0,0,0,0,0,0,1.0000000994736e-07,0.517389152964047,0.517389152964047
9.7,"greedy_SVM","SVM",15,27,0,0,0,2784,2520,264,0.730653928922398,0.125984251968504,1.2737617475235,756,264,492,-7,1.9,100,9.5,0,0,0,0,0,0,0,0,0
9.7,"greedy_SVM","SVM",16,0,2684,2427,257,100,93,7,0.863193641079226,0.291338582677165,1.28387096774194,19,7,12,0,1.7,3.59,13.3,0,0,0,0,0,0,0.136914011540247,212.745548522229,14.4964889186559
9.7,"greedy_SVM","SVM",16,1,2584,2352,232,200,168,32,0.769893396026928,0.173228346456693,1.24343408686817,83,32,51,64,1.6,7.18,5.2,0,0,0,0,0,0,0.188900349635324,363.280852270548,21.9174010167555
9.7,"greedy_SVM","SVM",16,2,2484,2257,227,300,263,37,0.854392904678391,0.338582677165354,1.2737617475235,100,37,63,17,1.7,10.78,7.1,0,0,0,0,0,0,0.155476677893833,231.600416165391,16.9625761199702
9.7,"greedy_SVM","SVM",16,3,2384,2186,198,400,334,66,0.809114204326362,0.251968503937008,1.24343408686817,167,66,101,67,1.5,14.37,5.1,0,0,0,0,0,0,0.195042638677991,223.328315698731,21.7716869899457
9.7,"greedy_SVM","SVM",16,4,2284,2096,188,500,424,76,0.830198654078197,0.259842519685039,1.2737617475235,198,76,122,31,1.6,17.96,5.6,0,0,0,0,0,0,0.197448655772148,172.098174207331,21.38245093548
9.7,"greedy_SVM","SVM",16,5,2184,2019,165,600,501,99,0.839254394148597,0.307086614173228,1.2737617475235,243,99,144,45,1.5,21.55,5.1,0,0,0,0,0,0,0.204078653027735,147.430794009219,20.6997402264809
9.7,"greedy_SVM","SVM",16,6,2084,1957,127,700,563,137,0.845666803497902,0.31496062992126,1.2737617475235,331,137,194,88,1.4,25.14,4.1,0,0,0,0,0,0,0.232532901136446,124.823198058109,23.8355433418716
9.7,"greedy_SVM","SVM",16,7,1984,1876,108,800,644,156,0.839832817106389,0.291338582677165,1.2737617475235,376,156,220,45,1.4,28.74,4.1,0,0,0,0,0,0,0.220751420005809,115.020796688791,22.9027492966646
9.7,"greedy_SVM","SVM",16,8,1884,1793,91,900,727,173,0.846798771006707,0.322834645669291,1.26365252730505,410,173,237,34,1.4,32.33,4.2,0,0,0,0,0,0,0.185970887555863,85.6643744565393,20.3386959712229
9.7,"greedy_SVM","SVM",16,9,1784,1709,75,1000,811,189,0.833252478511281,0.267716535433071,1.26365252730505,460,189,271,50,1.4,35.92,4.3,0,0,0,0,0,0,0.179200909567041,94.000114354758,20.6496946801234
9.7,"greedy_SVM","SVM",16,10,1684,1627,57,1100,893,207,0.820440099016069,0.228346456692913,1.26365252730505,503,207,296,43,1.4,39.51,4.3,0,0,0,0,0,0,0.180072583907859,85.3388177428199,21.8871371220639
9.7,"greedy_SVM","SVM",16,11,1584,1532,52,1200,988,212,0.811490092174508,0.181102362204724,1.26365252730505,518,212,306,15,1.4,43.1,4.7,0,0,0,0,0,0,0.167451375238956,95.9856896737956,17.5966342512863
9.7,"greedy_SVM","SVM",16,12,1484,1438,46,1300,1082,218,0.808952494682252,0.196850393700787,1.24343408686817,535,218,317,17,1.5,46.7,5,0,0,0,0,0,0,0.158932727061712,79.2528923549347,16.7767434444648
9.7,"greedy_SVM","SVM",16,13,1384,1348,36,1400,1172,228,0.831884166138015,0.283464566929134,1.24343408686817,582,228,354,47,1.6,50.29,5.1,0,0,0,0,0,0,0.160337422314404,152.845655024548,16.2638236635168
9.7,"greedy_SVM","SVM",16,14,1284,1258,26,1500,1262,238,0.829520717493266,0.291338582677165,1.24343408686817,598,238,360,16,1.5,53.88,5.3,0,0,0,0,0,0,0.0678142045221365,17.101020827289,9.55309289631855
9.7,"greedy_SVM","SVM",16,15,1184,1158,26,1600,1362,238,0.822610740008216,0.267716535433071,NA,612,238,374,14,1.6,57.47,5.7,0,0,0,0,0,0,0.00766227682928421,2.37217310880651,1.9843347769027
9.7,"greedy_SVM","SVM",16,16,1084,1059,25,1700,1461,239,0.832269781443206,0.299212598425197,1.24343408686817,604,239,365,-8,1.5,61.06,6.1,0,0,0,0,0,0,0.0205595758775731,6.08820239989711,4.29724733811826
9.7,"greedy_SVM","SVM",16,17,984,960,24,1800,1560,240,0.803852421290944,0.236220472440945,NA,618,240,378,14,1.6,64.66,6.5,0,0,0,0,0,0,0.0399807964393423,14.3014218242311,12.4293391504851
9.7,"greedy_SVM","SVM",16,18,884,860,24,1900,1660,240,0.817025537684571,0.220472440944882,NA,617,240,377,-1,1.6,68.25,6.9,0,0,0,0,0,0,0.00144499446837448,1.14900936905529,1.12422306010881
9.7,"greedy_SVM","SVM",16,19,784,760,24,2000,1760,240,0.829166200196541,0.31496062992126,NA,631,240,391,14,1.6,71.84,7.3,0,0,0,0,0,0,7.3725839659536e-07,0.0499735655908199,0.049899180912758
9.7,"greedy_SVM","SVM",16,20,684,665,19,2100,1855,245,0.799324551255741,0.204724409448819,1.2737617475235,632,245,387,1,1.6,75.43,7.6,0,0,0,0,0,0,0.000756294322488187,2.05930631594216,1.99034636053926
9.7,"greedy_SVM","SVM",16,21,584,575,9,2200,1945,255,0.790747720515978,0.15748031496063,1.28387096774194,681,255,426,49,1.7,79.02,7.6,0,0,0,0,0,0,0.13338325454439,44.8079205113112,17.7007058657591
9.7,"greedy_SVM","SVM",16,22,484,477,7,2300,2043,257,0.831100496324216,0.228346456692913,1.28387096774194,701,257,444,20,1.7,82.61,7.9,0,0,0,0,0,0,0.0347897014460492,9.21791924193541,5.98267595705171
9.7,"greedy_SVM","SVM",16,23,384,381,3,2400,2139,261,0.838657312385714,0.283464566929134,1.28387096774194,713,261,452,12,1.7,86.21,8.2,0,0,0,0,0,0,0.0297436269846968,7.32379598886979,5.1515628379251
9.7,"greedy_SVM","SVM",16,24,284,282,2,2500,2238,262,0.81278998892911,0.236220472440945,1.28387096774194,716,262,454,3,1.7,89.8,8.5,0,0,0,0,0,0,0.0163280795831135,4.51587402656762,3.71707676790071
9.7,"greedy_SVM","SVM",16,25,184,183,1,2600,2337,263,0.795928648729335,0.228346456692913,1.28387096774194,711,263,448,-5,1.7,93.39,8.9,0,0,0,0,0,0,0.0295693237265391,10.539124120861,9.72448695536562
9.7,"greedy_SVM","SVM",16,26,84,83,1,2700,2437,263,0.752397656454083,0.110236220472441,1.26365252730505,743,263,480,32,1.8,96.98,9.3,0,0,0,0,0,0,1.0000000994736e-07,0.587266327083773,0.587266327083773
9.7,"greedy_SVM","SVM",16,27,0,0,0,2784,2520,264,0.798889179136968,0.21259842519685,1.28387096774194,737,264,473,-6,1.8,100,9.5,0,0,0,0,0,0,0,0,0
9.7,"greedy_SVM","SVM",17,0,2684,2431,253,100,92,8,0.636701382544614,0.215384615384615,1.0863523573201,28,8,20,0,2.5,3.59,11.5,0,0,0,0,0,0,0.135437630161132,215.42530165862,17.1118446789687
9.7,"greedy_SVM","SVM",17,1,2584,2353,231,200,170,30,0.779060844143982,0.292307692307692,1.23449131513648,91,30,61,63,2,7.18,5.7,0,0,0,0,0,0,0.199040786741877,323.366316852452,20.5962092938721
9.7,"greedy_SVM","SVM",17,2,2484,2279,205,300,244,56,0.805737255618493,0.223076923076923,1.26411910669975,132,56,76,41,1.4,10.78,4.4,0,0,0,0,0,0,0.238125689458284,168.562882325,25.6103329911206
9.7,"greedy_SVM","SVM",17,3,2384,2206,178,400,317,83,0.823813874170171,0.253846153846154,1.27399503722084,189,83,106,57,1.3,14.37,3.8,0,0,0,0,0,0,0.253705929502308,154.232008006913,31.8961035151251
9.7,"greedy_SVM","SVM",17,4,2284,2137,147,500,386,114,0.816310372129852,0.246153846153846,1.26411910669975,256,114,142,67,1.2,17.96,3.4,0,0,0,0,0,0,0.245479054186195,106.335531501094,28.2081868104759
9.7,"greedy_SVM","SVM",17,5,2184,2060,124,600,463,137,0.817723369267315,0.292307692307692,1.25424317617866,308,137,171,52,1.2,21.55,3.4,0,0,0,0,0,0,0.220874020051891,89.8489201731051,23.4830045934851
9.7,"greedy_SVM","SVM",17,6,2084,1984,100,700,539,161,0.815597783056219,0.3,1.22461538461538,374,161,213,66,1.3,25.14,3.3,0,0,0,0,0,0,0.162522042205049,50.0670073123577,19.7600023860253
9.7,"greedy_SVM","SVM",17,7,1984,1904,80,800,619,181,0.806589926304894,0.284615384615385,1.23449131513648,424,181,243,50,1.3,28.74,3.4,0,0,0,0,0,0,0.128858526004016,44.8457276307428,16.0363513788027
9.7,"greedy_SVM","SVM",17,8,1884,1824,60,900,699,201,0.749387904257269,0.238461538461538,1.16535980148883,481,201,280,57,1.4,32.33,3.5,0,0,0,0,0,0,0.202054732112843,139.135238433066,24.2953926454149
9.7,"greedy_SVM","SVM",17,9,1784,1730,54,1000,793,207,0.755886472988615,0.261538461538462,1.22461538461538,508,207,301,27,1.5,35.92,3.8,0,0,0,0,0,0,0.216564933759048,129.983721830609,24.0734382308402
9.7,"greedy_SVM","SVM",17,10,1684,1632,52,1100,891,209,0.80666910286863,0.253846153846154,1.27399503722084,503,209,294,-5,1.4,39.51,4.3,0,0,0,0,0,0,0.180810066396735,74.6839468437412,20.5195369715943
9.7,"greedy_SVM","SVM",17,11,1584,1541,43,1200,982,218,0.817717278762412,0.307692307692308,1.27399503722084,523,218,305,20,1.4,43.1,4.5,0,0,0,0,0,0,0.115745529441296,34.3137416149083,14.2700004139472
9.7,"greedy_SVM","SVM",17,12,1484,1451,33,1300,1072,228,0.801138924416837,0.238461538461538,1.25424317617866,564,228,336,41,1.5,46.7,4.7,0,0,0,0,0,0,0.117401072456836,49.7221592208538,17.9480180839648
9.7,"greedy_SVM","SVM",17,13,1384,1360,24,1400,1163,237,0.807205067300081,0.238461538461538,1.28387096774194,592,237,355,28,1.5,50.29,4.9,0,0,0,0,0,0,0.115525428232915,54.3722737407024,14.2320263935193
9.7,"greedy_SVM","SVM",17,14,1284,1265,19,1500,1258,242,0.801163286436447,0.246153846153846,1.28387096774194,605,242,363,13,1.5,53.88,5.2,0,0,0,0,0,0,0.116846277892041,53.9169012546434,18.7536119379441
9.7,"greedy_SVM","SVM",17,15,1184,1170,14,1600,1353,247,0.816206833546502,0.238461538461538,1.27399503722084,622,247,375,17,1.5,57.47,5.5,0,0,0,0,0,0,0.100056378628267,36.6161899908736,16.3534975502233
9.7,"greedy_SVM","SVM",17,16,1084,1080,4,1700,1443,257,0.799342225470493,0.207692307692308,1.28387096774194,671,257,414,49,1.6,61.06,5.6,0,0,0,0,0,0,0.0960862021391826,31.7140281318935,12.3978024303873
9.7,"greedy_SVM","SVM",17,17,984,981,3,1800,1542,258,0.803148791034779,0.192307692307692,1.28387096774194,659,258,401,-12,1.6,64.66,6,0,0,0,0,0,0,0.054309625964316,17.8880877565531,7.37282961406719
9.7,"greedy_SVM","SVM",17,18,884,882,2,1900,1641,259,0.779030391619467,0.153846153846154,1.26411910669975,676,259,417,17,1.6,68.25,6.3,0,0,0,0,0,0,0.0975615217526339,47.0056727620652,11.702665795839
9.7,"greedy_SVM","SVM",17,19,784,782,2,2000,1741,259,0.786180644375421,0.169230769230769,1.26411910669975,678,259,419,2,1.6,71.84,6.7,0,0,0,0,0,0,0.0305526094416878,9.85755346394539,4.32632275082037
9.7,"greedy_SVM","SVM",17,20,684,683,1,2100,1840,260,0.79560265546014,0.215384615384615,1.26411910669975,695,260,435,17,1.7,75.43,7.1,0,0,0,0,0,0,0.0308088668531646,10.8906014788024,4.8850970617056
9.7,"greedy_SVM","SVM",17,21,584,583,1,2200,1940,260,0.805822522687133,0.223076923076923,1.26411910669975,681,260,421,-14,1.6,79.02,7.5,0,0,0,0,0,0,0.0111227279682947,3.32152960527611,1.76817207985607
9.7,"greedy_SVM","SVM",17,22,484,483,1,2300,2040,260,0.790577988915283,0.246153846153846,1.26411910669975,677,260,417,-4,1.6,82.61,7.8,0,0,0,0,0,0,0.00784030312191328,2.05884888196229,1.11314711915233
9.7,"greedy_SVM","SVM",17,23,384,383,1,2400,2140,260,0.819446982154823,0.253846153846154,1.26411910669975,683,260,423,6,1.6,86.21,8.2,0,0,0,0,0,0,0.00262515738793428,0.686125545386428,0.457918460959354
9.7,"greedy_SVM","SVM",17,24,284,283,1,2500,2240,260,0.804397344539865,0.223076923076923,1.26411910669975,680,260,420,-3,1.6,89.8,8.6,0,0,0,0,0,0,0.000586201513627043,0.162050028117651,0.133456644601261
9.7,"greedy_SVM","SVM",17,25,184,183,1,2600,2340,260,0.817461477556492,0.284615384615385,1.26411910669975,687,260,427,7,1.6,93.39,9,0,0,0,0,0,0,0.000116146284023113,0.0441676594773132,0.0407486057805113
9.7,"greedy_SVM","SVM",17,26,84,84,0,2700,2439,261,0.794762165783546,0.215384615384615,1.26411910669975,687,261,426,0,1.6,96.98,9.3,0,0,0,0,0,0,4.15818435029658e-06,1.01827488603095,1.01827488603095
9.7,"greedy_SVM","SVM",17,27,0,0,0,2784,2523,261,0.779943967354896,0.153846153846154,1.26411910669975,701,261,440,14,1.7,100,9.7,0,0,0,0,0,0,0,0,0
9.7,"greedy_SVM","SVM",18,0,2684,2431,253,100,92,8,0.773378403069616,0.238461538461538,1.28387096774194,25,8,17,0,2.1,3.59,11.5,0,0,0,0,0,0,0.121809788316647,197.373894645677,14.6894910163861
9.7,"greedy_SVM","SVM",18,1,2584,2348,236,200,175,25,0.781356964492359,0.284615384615385,1.26411910669975,68,25,43,43,1.7,7.18,7,0,0,0,0,0,0,0.178172387395261,264.411152571193,21.2682703163472
9.7,"greedy_SVM","SVM",18,2,2484,2276,208,300,247,53,0.774042268104028,0.230769230769231,1.25424317617866,129,53,76,61,1.4,10.78,4.7,0,0,0,0,0,0,0.18047353233784,397.087039300969,18.3761069389149
9.7,"greedy_SVM","SVM",18,3,2384,2196,188,400,327,73,0.778573603751754,0.223076923076923,1.25424317617866,170,73,97,41,1.3,14.37,4.5,0,0,0,0,0,0,0.192669944118986,223.936507821762,24.7248818928932
9.7,"greedy_SVM","SVM",18,4,2284,2108,176,500,415,85,0.786661794262748,0.238461538461538,1.23449131513648,205,85,120,35,1.4,17.96,4.9,0,0,0,0,0,0,0.166362209742719,173.466636355839,17.6081306077739
9.7,"greedy_SVM","SVM",18,5,2184,2031,153,600,492,108,0.79310554844997,0.246153846153846,1.23449131513648,262,108,154,57,1.4,21.55,4.6,0,0,0,0,0,0,0.178517175108839,181.727739201108,23.4103802720733
9.7,"greedy_SVM","SVM",18,6,2084,1963,121,700,560,140,0.796071624337661,0.238461538461538,1.23449131513648,332,140,192,70,1.4,25.14,4,0,0,0,0,0,0,0.19190672623013,199.304156987006,19.9988342286228
9.7,"greedy_SVM","SVM",18,7,1984,1889,95,800,634,166,0.799476216578357,0.215384615384615,1.23449131513648,399,166,233,67,1.4,28.74,3.8,0,0,0,0,0,0,0.183385538637053,118.270749895298,19.8458496506913
9.7,"greedy_SVM","SVM",18,8,1884,1818,66,900,705,195,0.805785979657717,0.230769230769231,1.22461538461538,457,195,262,58,1.3,32.33,3.6,0,0,0,0,0,0,0.193689123617671,207.252018863436,20.6327763457077
9.7,"greedy_SVM","SVM",18,9,1784,1736,48,1000,787,213,0.811638954869362,0.253846153846154,1.22461538461538,501,213,288,44,1.4,35.92,3.7,0,0,0,0,0,0,0.166664800733338,142.377375891537,18.6207143994787
9.7,"greedy_SVM","SVM",18,10,1684,1644,40,1100,879,221,0.798988976186129,0.207692307692308,1.22461538461538,532,221,311,31,1.4,39.51,4,0,0,0,0,0,0,0.137319429473076,81.8498797763078,15.4780878347689
9.7,"greedy_SVM","SVM",18,11,1584,1549,35,1200,974,226,0.802521469029786,0.230769230769231,1.22461538461538,539,226,313,7,1.4,43.1,4.3,0,0,0,0,0,0,0.146937893427562,110.466236727548,15.6853252238541
9.7,"greedy_SVM","SVM",18,12,1484,1455,29,1300,1068,232,0.804324258481032,0.2,1.22461538461538,578,232,346,39,1.5,46.7,4.6,0,0,0,0,0,0,0.124358843855716,71.2355342769539,14.7670082899348
9.7,"greedy_SVM","SVM",18,13,1384,1363,21,1400,1160,240,0.813173762104882,0.192307692307692,1.22461538461538,585,240,345,7,1.4,50.29,4.8,0,0,0,0,0,0,0.110105813877215,53.8555584075754,12.9761628337506
9.7,"greedy_SVM","SVM",18,14,1284,1264,20,1500,1259,241,0.822394786527806,0.261538461538462,1.24436724565757,604,241,363,19,1.5,53.88,5.2,0,0,0,0,0,0,0.0929722933447312,35.1143896254544,10.7964877352594
9.7,"greedy_SVM","SVM",18,15,1184,1164,20,1600,1359,241,0.81161459284975,0.223076923076923,1.24436724565757,594,241,353,-10,1.5,57.47,5.6,0,0,0,0,0,0,0.062514432722555,22.7114441263484,7.48687516164516
9.7,"greedy_SVM","SVM",18,16,1084,1066,18,1700,1457,243,0.783878433522142,0.184615384615385,1.21473945409429,607,243,364,13,1.5,61.06,6,0,0,0,0,0,0,0.0881712827553133,34.591742341526,11.7334108778125
9.7,"greedy_SVM","SVM",18,17,984,968,16,1800,1555,245,0.799183872343021,0.215384615384615,1.21473945409429,618,245,373,11,1.5,64.66,6.3,0,0,0,0,0,0,0.0864816768923507,32.2253142390684,11.5524843994027
9.7,"greedy_SVM","SVM",18,18,884,868,16,1900,1655,245,0.81048175893782,0.246153846153846,1.21473945409429,626,245,381,8,1.6,68.25,6.8,0,0,0,0,0,0,0.0669756794572667,25.9591254062474,7.51790268373281
9.7,"greedy_SVM","SVM",18,19,784,769,15,2000,1754,246,0.797862232779101,0.176923076923077,1.22461538461538,625,246,379,-1,1.5,71.84,7.1,0,0,0,0,0,0,0.0405204357470899,12.638110770004,5.65784176829145
9.7,"greedy_SVM","SVM",18,20,684,669,15,2100,1854,246,0.798538278823318,0.215384615384615,1.22461538461538,601,246,355,-24,1.4,75.43,7.5,0,0,0,0,0,0,0.022376655068817,5.81733011656034,2.98469741819142
9.7,"greedy_SVM","SVM",18,21,584,570,14,2200,1953,247,0.81250685181802,0.223076923076923,1.2048635235732,614,247,367,13,1.5,79.02,7.9,0,0,0,0,0,0,0.0129151326465605,4.57797949605234,3.45344034488413
9.7,"greedy_SVM","SVM",18,22,484,471,13,2300,2052,248,0.763840672391745,0.184615384615385,1.19498759305211,637,248,389,23,1.6,82.61,8.3,0,0,0,0,0,0,0.00355598987003077,1.3057629159661,1.06281050478587
9.7,"greedy_SVM","SVM",18,23,384,371,13,2400,2152,248,0.794366282964862,0.230769230769231,1.19498759305211,633,248,385,-4,1.6,86.21,8.7,0,0,0,0,0,0,0.00375666553144786,0.984070328250441,0.747927685974179
9.7,"greedy_SVM","SVM",18,24,284,273,11,2500,2250,250,0.805268286740975,0.276923076923077,1.2048635235732,663,250,413,30,1.7,89.8,9,0,0,0,0,0,0,0.000211032774645191,0.439571993805266,0.432553240357163
9.7,"greedy_SVM","SVM",18,25,184,174,10,2600,2349,251,0.806206224496014,0.246153846153846,1.2048635235732,664,251,413,1,1.6,93.39,9.4,0,0,0,0,0,0,0.000289819695004733,0.0924519369193834,0.0856951071278189
9.7,"greedy_SVM","SVM",18,26,84,80,4,2700,2443,257,0.797667336622209,0.192307692307692,1.23449131513648,684,257,427,20,1.7,96.98,9.5,0,0,0,0,0,0,0.00217801460948728,3.37622233324514,3.37622233324514
9.7,"greedy_SVM","SVM",18,27,0,0,0,2784,2523,261,0.81415433339424,0.276923076923077,1.27399503722084,719,261,458,35,1.8,100,9.7,0,0,0,0,0,0,0,0,0
9.7,"greedy_SVM","SVM",19,0,2684,2402,282,100,95,5,0.539699826937997,0.0961538461538462,1.03697270471464,29,5,24,0,4.8,3.59,19,0,0,0,0,0,0,0.0664652664963044,149.2360632263,7.84466165408695
9.7,"greedy_SVM","SVM",19,1,2584,2316,268,200,181,19,0.742182371546222,0.192307692307692,1.25918114143921,66,19,47,37,2.5,7.18,9.5,0,0,0,0,0,0,0.130127766391176,229.348000223992,16.1184909638394
9.7,"greedy_SVM","SVM",19,2,2484,2231,253,300,266,34,0.724764277615328,0.221153846153846,1.24683622828784,99,34,65,33,1.9,10.78,7.8,0,0,0,0,0,0,0.131094793274222,258.666493746334,13.7195836590426
9.7,"greedy_SVM","SVM",19,3,2384,2154,230,400,343,57,0.794391895924095,0.25,1.27152605459057,156,57,99,57,1.7,14.37,6,0,0,0,0,0,0,0.166305000794872,244.659812883183,17.5329262307497
9.7,"greedy_SVM","SVM",19,4,2284,2076,208,500,421,79,0.774743390821749,0.221153846153846,1.27152605459057,206,79,127,50,1.6,17.96,5.3,0,0,0,0,0,0,0.181852633394667,183.393434051919,19.7774630019864
9.7,"greedy_SVM","SVM",19,5,2184,2019,165,600,478,122,0.776653040520383,0.259615384615385,1.27152605459057,296,122,174,90,1.4,21.55,3.9,0,0,0,0,0,0,0.211964810376897,251.064013709045,22.0825817679304
9.7,"greedy_SVM","SVM",19,6,2084,1954,130,700,543,157,0.78936414632691,0.221153846153846,1.27152605459057,378,157,221,82,1.4,25.14,3.5,0,0,0,0,0,0,0.220694542840064,195.156765946259,23.1887190601875
9.7,"greedy_SVM","SVM",19,7,1984,1889,95,800,608,192,0.796965447275768,0.230769230769231,1.27152605459057,459,192,267,81,1.4,28.74,3.2,0,0,0,0,0,0,0.232764507658726,202.624996191695,24.3462596066048
9.7,"greedy_SVM","SVM",19,8,1884,1814,70,900,683,217,0.798845258697861,0.230769230769231,1.27152605459057,528,217,311,69,1.4,32.33,3.1,0,0,0,0,0,0,0.216620419271016,147.387906781894,23.5905970468993
9.7,"greedy_SVM","SVM",19,9,1784,1724,60,1000,773,227,0.801321835650777,0.230769230769231,1.27152605459057,555,227,328,27,1.4,35.92,3.4,0,0,0,0,0,0,0.166976827576806,95.3313078613841,18.9705428352117
9.7,"greedy_SVM","SVM",19,10,1684,1636,48,1100,861,239,0.806528614907208,0.201923076923077,1.27152605459057,587,239,348,32,1.5,39.51,3.6,0,0,0,0,0,0,0.166894875067492,115.649783109643,18.6181046896631
9.7,"greedy_SVM","SVM",19,11,1584,1541,43,1200,956,244,0.80085934236439,0.173076923076923,1.27152605459057,614,244,370,27,1.5,43.1,3.9,0,0,0,0,0,0,0.106258238130113,52.3045100811836,12.7606284620681
9.7,"greedy_SVM","SVM",19,12,1484,1449,35,1300,1048,252,0.788073640866506,0.182692307692308,1.27152605459057,639,252,387,25,1.5,46.7,4.2,0,0,0,0,0,0,0.170862685758595,117.498689218813,20.7224123503806
9.7,"greedy_SVM","SVM",19,13,1384,1354,30,1400,1143,257,0.785156949334611,0.182692307692308,1.27152605459057,660,257,403,21,1.6,50.29,4.4,0,0,0,0,0,0,0.163715366937168,96.2089635560796,18.5913181960404
9.7,"greedy_SVM","SVM",19,14,1284,1264,20,1500,1233,267,0.787588768872714,0.192307692307692,1.27152605459057,676,267,409,16,1.5,53.88,4.6,0,0,0,0,0,0,0.166546669215313,116.083954159542,17.546218911912
9.7,"greedy_SVM","SVM",19,15,1184,1175,9,1600,1322,278,0.763360088321302,0.153846153846154,1.27152605459057,731,278,453,55,1.6,57.47,4.8,0,0,0,0,0,0,0.146128061832697,70.9755402409376,16.2185757830896
9.7,"greedy_SVM","SVM",19,16,1084,1078,6,1700,1419,281,0.789229874082478,0.201923076923077,1.27152605459057,751,281,470,20,1.7,61.06,5,0,0,0,0,0,0,0.0984250917816885,35.3213377780235,11.4463145930775
9.7,"greedy_SVM","SVM",19,17,984,979,5,1800,1518,282,0.803582085098769,0.211538461538462,1.27152605459057,752,282,470,1,1.7,64.66,5.4,0,0,0,0,0,0,0.0980201427488378,42.208715593691,11.17049900261
9.7,"greedy_SVM","SVM",19,18,884,879,5,1900,1618,282,0.775750432655014,0.173076923076923,1.27152605459057,742,282,460,-10,1.6,68.25,5.7,0,0,0,0,0,0,0.0302706046588786,8.44269759087805,4.35032227776689
9.7,"greedy_SVM","SVM",19,19,784,780,4,2000,1717,283,0.778107656501765,0.182692307692308,1.27152605459057,744,283,461,2,1.6,71.84,6.1,0,0,0,0,0,0,0.0617252026212068,22.2244101259113,7.72125039652884
9.7,"greedy_SVM","SVM",19,20,684,682,2,2100,1815,285,0.803015157844487,0.201923076923077,1.27152605459057,762,285,477,18,1.7,75.43,6.4,0,0,0,0,0,0,0.0877960990790703,23.3403518224167,12.3857718454151
9.7,"greedy_SVM","SVM",19,21,584,583,1,2200,1914,286,0.758451691830285,0.153846153846154,1.25918114143921,776,286,490,14,1.7,79.02,6.7,0,0,0,0,0,0,0.00820146227258371,3.26965027046466,2.58905959835752
9.7,"greedy_SVM","SVM",19,22,484,483,1,2300,2014,286,0.760167392731401,0.163461538461538,1.25918114143921,760,286,474,-16,1.7,82.61,7,0,0,0,0,0,0,0.00739725664376923,2.09230616991432,1.46349627553294
9.7,"greedy_SVM","SVM",19,23,384,384,0,2400,2113,287,0.762561914423825,0.182692307692308,1.27152605459057,769,287,482,9,1.7,86.21,7.4,0,0,0,0,0,0,0.051252641897867,19.2522133217061,16.8430050554702
9.7,"greedy_SVM","SVM",19,24,284,284,0,2500,2213,287,0.775534105150088,0.211538461538462,1.25918114143921,792,287,505,23,1.8,89.8,7.7,0,0,0,0,0,0,0.00349675631688238,1.81349522166246,1.65996151162362
9.7,"greedy_SVM","SVM",19,25,184,184,0,2600,2313,287,0.806349585247958,0.230769230769231,1.25918114143921,773,287,486,-19,1.7,93.39,8.1,0,0,0,0,0,0,7.28604315689268e-06,0.0245786473321361,0.0244671538488448
9.7,"greedy_SVM","SVM",19,26,84,84,0,2700,2413,287,0.793787670824137,0.25,1.25918114143921,794,287,507,21,1.8,96.98,8.4,0,0,0,0,0,0,1.0000000994736e-07,0.00091512052270433,0.00091512052270433
9.7,"greedy_SVM","SVM",19,27,0,0,0,2784,2497,287,0.759704899445009,0.153846153846154,1.27152605459057,796,287,509,2,1.8,100,8.7,0,0,0,0,0,0,0,0,0
9.7,"greedy_SVM","SVM",20,0,2684,2422,262,100,87,13,0.765702211541051,0.224137931034483,1.23959955506118,35,13,22,0,1.7,3.59,6.7,0,0,0,0,0,0,0.174472292659374,339.95836062059,23.2259032970569
9.7,"greedy_SVM","SVM",20,1,2584,2343,241,200,166,34,0.789053006777738,0.181034482758621,1.28387096774194,103,34,69,68,2,7.18,4.9,0,0,0,0,0,0,0.18501057534153,417.18857845272,19.1948759462936
9.7,"greedy_SVM","SVM",20,2,2484,2255,229,300,254,46,0.794804633705074,0.163793103448276,1.27280311457175,123,46,77,20,1.7,10.78,5.5,0,0,0,0,0,0,0.183256164107132,260.087867357979,19.2672742219928
9.7,"greedy_SVM","SVM",20,3,2384,2170,214,400,339,61,0.808798909081088,0.232758620689655,1.26173526140156,161,61,100,38,1.6,14.37,5.6,0,0,0,0,0,0,0.1841230066776,207.232733613001,20.4560620025162
9.7,"greedy_SVM","SVM",20,4,2284,2107,177,500,402,98,0.808002322253126,0.25,1.27280311457175,231,98,133,70,1.4,17.96,4.1,0,0,0,0,0,0,0.200126340029831,211.769854868006,21.2056503563172
9.7,"greedy_SVM","SVM",20,5,2184,2035,149,600,474,126,0.794892393270873,0.232758620689655,1.25066740823137,296,126,170,65,1.3,21.55,3.8,0,0,0,0,0,0,0.209131560943759,252.840569700012,25.3339613589682
9.7,"greedy_SVM","SVM",20,6,2084,1950,134,700,559,141,0.798861825939018,0.232758620689655,1.27280311457175,337,141,196,41,1.4,25.14,4,0,0,0,0,0,0,0.198027052721672,223.724616588523,20.9324039397911
9.7,"greedy_SVM","SVM",20,7,1984,1871,113,800,638,162,0.806760186860361,0.232758620689655,1.27280311457175,386,162,224,49,1.4,28.74,3.9,0,0,0,0,0,0,0.196696887452422,187.089858096547,20.1988016016997
9.7,"greedy_SVM","SVM",20,8,1884,1791,93,900,718,182,0.811856992412166,0.206896551724138,1.27280311457175,442,182,260,56,1.4,32.33,3.9,0,0,0,0,0,0,0.196217529650491,158.643471647428,20.2747066783528
9.7,"greedy_SVM","SVM",20,9,1784,1722,62,1000,787,213,0.817136067831393,0.224137931034483,1.25066740823137,516,213,303,74,1.4,35.92,3.7,0,0,0,0,0,0,0.197381097001257,126.055298914126,21.6704129282628
9.7,"greedy_SVM","SVM",20,10,1684,1648,36,1100,861,239,0.810790376151,0.206896551724138,1.25066740823137,578,239,339,62,1.4,39.51,3.6,0,0,0,0,0,0,0.180355484213894,87.9714281069289,20.4810204567621
9.7,"greedy_SVM","SVM",20,11,1584,1556,28,1200,953,247,0.805707072070853,0.189655172413793,1.25066740823137,611,247,364,33,1.5,43.1,3.9,0,0,0,0,0,0,0.185231186779669,160.658475813196,19.4391479378061
9.7,"greedy_SVM","SVM",20,12,1484,1461,23,1300,1048,252,0.809500985607426,0.198275862068966,1.26173526140156,623,252,371,12,1.5,46.7,4.2,0,0,0,0,0,0,0.154331775324955,97.8967810868759,17.3098395832196
9.7,"greedy_SVM","SVM",20,13,1384,1368,16,1400,1141,259,0.811728728431394,0.232758620689655,1.26173526140156,649,259,390,26,1.5,50.29,4.4,0,0,0,0,0,0,0.136899315775885,68.7321325212312,15.237973732687
9.7,"greedy_SVM","SVM",20,14,1284,1269,15,1500,1240,260,0.809332217211669,0.267241379310345,1.26173526140156,648,260,388,-1,1.5,53.88,4.8,0,0,0,0,0,0,0.127599465787746,69.1109540841862,13.9111846189263
9.7,"greedy_SVM","SVM",20,15,1184,1169,15,1600,1340,260,0.802838009343011,0.21551724137931,1.26173526140156,654,260,394,6,1.5,57.47,5.2,0,0,0,0,0,0,0.0835436906869536,36.7003878113185,9.56499573324891
9.7,"greedy_SVM","SVM",20,16,1084,1071,13,1700,1438,262,0.797855966300317,0.189655172413793,1.25066740823137,682,262,420,28,1.6,61.06,5.5,0,0,0,0,0,0,0.0817221176204847,31.8745557160862,12.3541798581634
9.7,"greedy_SVM","SVM",20,17,984,972,12,1800,1537,263,0.795094915345763,0.206896551724138,1.26173526140156,671,263,408,-11,1.6,64.66,5.8,0,0,0,0,0,0,0.0589687438808107,23.8431811781969,7.25324168987517
9.7,"greedy_SVM","SVM",20,18,884,872,12,1900,1637,263,0.796580077228409,0.232758620689655,1.25066740823137,683,263,420,12,1.6,68.25,6.2,0,0,0,0,0,0,0.0120230930126155,3.48992380434215,1.66859383094392
9.7,"greedy_SVM","SVM",20,19,784,774,10,2000,1735,265,0.798375772959245,0.25,1.22853170189099,684,265,419,1,1.6,71.84,6.5,0,0,0,0,0,0,0.0320174343836088,12.2280387924411,6.72529585019328
9.7,"greedy_SVM","SVM",20,20,684,675,9,2100,1834,266,0.790261388491342,0.181034482758621,1.25066740823137,688,266,422,4,1.6,75.43,6.9,0,0,0,0,0,0,0.0197532487861618,6.89360056569165,4.06943948876805
9.7,"greedy_SVM","SVM",20,21,584,576,8,2200,1933,267,0.793312721086603,0.189655172413793,1.25066740823137,691,267,424,3,1.6,79.02,7.2,0,0,0,0,0,0,0.0188332881193041,5.40697336192997,2.64551435650062
9.7,"greedy_SVM","SVM",20,22,484,479,5,2300,2030,270,0.81023681581292,0.189655172413793,1.27280311457175,715,270,445,24,1.6,82.61,7.5,0,0,0,0,0,0,0.0332247389130924,8.27887861358615,5.49659769819651
9.7,"greedy_SVM","SVM",20,23,384,384,0,2400,2125,275,0.768767045607965,0.155172413793103,1.27280311457175,747,275,472,32,1.7,86.21,7.7,0,0,0,0,0,0,0.00967756673009266,5.23059967941902,4.84861922915986
9.7,"greedy_SVM","SVM",20,24,284,284,0,2500,2225,275,0.794298328517803,0.181034482758621,1.27280311457175,741,275,466,-6,1.7,89.8,8.1,0,0,0,0,0,0,0.00407247512206011,1.17722352957723,0.967089700198406
9.7,"greedy_SVM","SVM",20,25,184,184,0,2600,2325,275,0.794932897685843,0.172413793103448,1.27280311457175,743,275,468,2,1.7,93.39,8.5,0,0,0,0,0,0,0.000249334428860803,0.144404729718305,0.138219868828832
9.7,"greedy_SVM","SVM",20,26,84,84,0,2700,2425,275,0.771325574487611,0.146551724137931,1.26173526140156,743,275,468,0,1.7,96.98,8.8,0,0,0,0,0,0,0.000126457758470848,0.103747707607297,0.103747707607297
9.7,"greedy_SVM","SVM",20,27,0,0,0,2784,2509,275,0.786778008802954,0.172413793103448,1.27280311457175,723,275,448,-20,1.6,100,9.1,0,0,0,0,0,0,0,0,0
9.7,"greedy_SVM","SVM",21,0,2684,2427,257,100,88,12,0.748416762327329,0.163934426229508,1.27334743521946,31,12,19,0,1.6,3.59,7.3,0,0,0,0,0,0,0.235434060533499,337.705542630389,27.4013953029033
9.7,"greedy_SVM","SVM",21,1,2584,2351,233,200,164,36,0.801047323006279,0.262295081967213,1.25230037017451,88,36,52,57,1.4,7.18,4.6,0,0,0,0,0,0,0.229200955198563,402.9441707993,27.0124347361759
9.7,"greedy_SVM","SVM",21,2,2484,2271,213,300,244,56,0.716442455275951,0.188524590163934,1.17863564251719,140,56,84,52,1.5,10.78,4.4,0,0,0,0,0,0,0.215809716102654,400.769881068389,24.5893623304013
9.7,"greedy_SVM","SVM",21,3,2384,2183,201,400,332,68,0.827398073028849,0.286885245901639,1.27334743521946,162,68,94,22,1.4,14.37,4.9,0,0,0,0,0,0,0.196008076190578,244.319186912694,19.8721409170717
9.7,"greedy_SVM","SVM",21,4,2284,2113,171,500,402,98,0.831312636235827,0.30327868852459,1.27334743521946,242,98,144,80,1.5,17.96,4.1,0,0,0,0,0,0,0.218428285833199,170.922742199235,22.2425389550913
9.7,"greedy_SVM","SVM",21,5,2184,2051,133,600,464,136,0.826901497465531,0.327868852459016,1.25230037017451,314,136,178,72,1.3,21.55,3.4,0,0,0,0,0,0,0.234144705913541,179.122038382538,24.1142764957117
9.7,"greedy_SVM","SVM",21,6,2084,1975,109,700,540,160,0.827997833124817,0.319672131147541,1.25230037017451,370,160,210,56,1.3,25.14,3.4,0,0,0,0,0,0,0.238310995803711,182.466369941769,24.4969411192958
9.7,"greedy_SVM","SVM",21,7,1984,1899,85,800,616,184,0.824502457081685,0.30327868852459,1.25230037017451,432,184,248,62,1.3,28.74,3.3,0,0,0,0,0,0,0.224933108751302,132.103722941291,23.7762300298849
9.7,"greedy_SVM","SVM",21,8,1884,1816,68,900,699,201,0.819149759451059,0.295081967213115,1.25230037017451,485,201,284,53,1.4,32.33,3.5,0,0,0,0,0,0,0.209865335614542,170.600728789528,22.2102386150857
9.7,"greedy_SVM","SVM",21,9,1784,1719,65,1000,796,204,0.822148559930865,0.30327868852459,1.25230037017451,489,204,285,4,1.4,35.92,3.9,0,0,0,0,0,0,0.170173291502062,125.682129994395,18.3785800995573
9.7,"greedy_SVM","SVM",21,10,1684,1624,60,1100,891,209,0.819362577549622,0.295081967213115,1.25230037017451,509,209,300,20,1.4,39.51,4.3,0,0,0,0,0,0,0.153120981166888,94.395484570083,16.8214421140534
9.7,"greedy_SVM","SVM",21,11,1584,1538,46,1200,977,223,0.817176355264341,0.245901639344262,1.24177683765204,532,223,309,23,1.4,43.1,4.4,0,0,0,0,0,0,0.179298863723437,149.05708038854,19.0068419688887
9.7,"greedy_SVM","SVM",21,12,1484,1443,41,1300,1072,228,0.796068669306467,0.204918032786885,1.25230037017451,565,228,337,33,1.5,46.7,4.7,0,0,0,0,0,0,0.156311919085102,60.27320851869,17.1194843039343
9.7,"greedy_SVM","SVM",21,13,1384,1352,32,1400,1163,237,0.817801911493463,0.213114754098361,1.25230037017451,613,237,376,48,1.6,50.29,4.9,0,0,0,0,0,0,0.0947176579099292,30.2414499097994,13.6944531876572
9.7,"greedy_SVM","SVM",21,14,1284,1261,23,1500,1254,246,0.784434613251468,0.180327868852459,1.24177683765204,644,246,398,31,1.6,53.88,5.1,0,0,0,0,0,0,0.143881215625254,62.1207511730753,15.5688242426104
9.7,"greedy_SVM","SVM",21,15,1184,1163,21,1600,1352,248,0.789974332847499,0.221311475409836,1.24177683765204,658,248,410,14,1.7,57.47,5.5,0,0,0,0,0,0,0.144190672487625,67.0694811381028,15.3758222445579
9.7,"greedy_SVM","SVM",21,16,1084,1064,20,1700,1451,249,0.738917336291284,0.155737704918033,1.24177683765204,656,249,407,-2,1.6,61.06,5.8,0,0,0,0,0,0,0.130665441118465,56.2875435613898,13.7326619483535
9.7,"greedy_SVM","SVM",21,17,984,964,20,1800,1551,249,0.783119010460323,0.180327868852459,1.24177683765204,657,249,408,1,1.6,64.66,6.2,0,0,0,0,0,0,0.0789282711690313,18.8512837377233,9.27873102626459
9.7,"greedy_SVM","SVM",21,18,884,864,20,1900,1651,249,0.758051618062444,0.180327868852459,1.24177683765204,659,249,410,2,1.6,68.25,6.6,0,0,0,0,0,0,0.0525841383328375,12.654953566647,7.35649722267189
9.7,"greedy_SVM","SVM",21,19,784,765,19,2000,1750,250,0.74308986082986,0.172131147540984,1.24177683765204,657,250,407,-2,1.6,71.84,7,0,0,0,0,0,0,0.00258238410752724,1.25441159436932,1.2514166405564
9.7,"greedy_SVM","SVM",21,20,684,672,12,2100,1843,257,0.75667152493841,0.163934426229508,1.22072977260709,695,257,438,38,1.7,75.43,7.2,0,0,0,0,0,0,0.107501797835818,42.8561574544419,15.6414530857858
9.7,"greedy_SVM","SVM",21,21,584,574,10,2200,1941,259,0.772245940333548,0.19672131147541,1.23125330512956,692,259,433,-3,1.7,79.02,7.5,0,0,0,0,0,0,0.101812641836831,38.1951651822648,11.5647774471044
9.7,"greedy_SVM","SVM",21,22,484,475,9,2300,2040,260,0.737343772168557,0.188524590163934,1.23125330512956,691,260,431,-1,1.7,82.61,7.8,0,0,0,0,0,0,0.0665813662627232,18.6819217057059,8.70789044498688
9.7,"greedy_SVM","SVM",21,23,384,376,8,2400,2139,261,0.692155395906156,0.114754098360656,1.22072977260709,716,261,455,25,1.7,86.21,8.2,0,0,0,0,0,0,0.0545162840878326,17.3011826310199,9.06486226582786
9.7,"greedy_SVM","SVM",21,24,284,278,6,2500,2237,263,0.772742515896872,0.180327868852459,1.23125330512956,720,263,457,4,1.7,89.8,8.5,0,0,0,0,0,0,0.0276138500142563,6.53382829627658,3.94043718291394
9.7,"greedy_SVM","SVM",21,25,184,180,4,2600,2335,265,0.745134204382759,0.155737704918033,1.23125330512956,731,265,466,11,1.8,93.39,8.8,0,0,0,0,0,0,0.0162372523623335,3.66100077509308,2.90493633653798
9.7,"greedy_SVM","SVM",21,26,84,84,0,2700,2431,269,0.751144703408959,0.172131147540984,1.27334743521946,752,269,483,21,1.8,96.98,9,0,0,0,0,0,0,1.62023706039873e-07,1.38515882770537,1.38515882770537
9.7,"greedy_SVM","SVM",21,27,0,0,0,2784,2515,269,0.785840502508674,0.163934426229508,1.28387096774194,746,269,477,-6,1.8,100,9.3,0,0,0,0,0,0,0,0,0
9.7,"greedy_SVM","SVM",22,0,2684,2424,260,100,93,7,0.604743384427669,0.193548387096774,1.10785639958377,24,7,17,0,2.4,3.59,13.3,0,0,0,0,0,0,0.0892993244461188,198.282328035358,9.20064411196073
9.7,"greedy_SVM","SVM",22,1,2584,2347,237,200,170,30,0.672754772617505,0.129032258064516,1.20104058272633,92,30,62,68,2.1,7.18,5.7,0,0,0,0,0,0,0.194578801679357,330.694524525695,22.6858914963744
9.7,"greedy_SVM","SVM",22,2,2484,2261,223,300,256,44,0.609674877348184,0.32258064516129,0.931841831425598,122,44,78,30,1.8,10.78,5.8,0,0,0,0,0,0,0.23645604314083,266.235520178398,29.2274578310586
9.7,"greedy_SVM","SVM",22,3,2384,2178,206,400,339,61,0.702432700373677,0.185483870967742,1.24245577523413,170,61,109,48,1.8,14.37,5.6,0,0,0,0,0,0,0.183114681316612,265.08721479094,26.7327127130988
9.7,"greedy_SVM","SVM",22,4,2284,2104,180,500,413,87,0.768423193268767,0.201612903225806,1.24245577523413,224,87,137,54,1.6,17.96,4.7,0,0,0,0,0,0,0.194612604989982,299.099878057782,21.0935640111198
9.7,"greedy_SVM","SVM",22,5,2184,2034,150,600,483,117,0.778012913393834,0.17741935483871,1.24245577523413,292,117,175,68,1.5,21.55,4.1,0,0,0,0,0,0,0.204699776712519,333.07212813137,21.2816808626776
9.7,"greedy_SVM","SVM",22,6,2084,1949,135,700,568,132,0.813798012150795,0.241935483870968,1.25280957336108,337,132,205,45,1.6,25.14,4.3,0,0,0,0,0,0,0.200090224705322,192.736833623295,20.7179002941184
9.7,"greedy_SVM","SVM",22,7,1984,1873,111,800,644,156,0.814242863316305,0.233870967741935,1.25280957336108,397,156,241,60,1.5,28.74,4.1,0,0,0,0,0,0,0.190232959892465,151.163444173786,19.7015199795854
9.7,"greedy_SVM","SVM",22,8,1884,1798,86,900,719,181,0.819708177635425,0.25,1.24245577523413,436,181,255,39,1.4,32.33,4,0,0,0,0,0,0,0.190832305734212,124.18853960348,19.951394528143
9.7,"greedy_SVM","SVM",22,9,1784,1722,62,1000,795,205,0.829507613309946,0.241935483870968,1.24245577523413,502,205,297,66,1.4,35.92,3.9,0,0,0,0,0,0,0.193228450596856,132.414715493639,20.0851741164162
9.7,"greedy_SVM","SVM",22,10,1684,1640,44,1100,877,223,0.8341785505478,0.25,1.24245577523413,547,223,324,45,1.5,39.51,3.9,0,0,0,0,0,0,0.18978874492112,134.249670563277,19.8564863667129
9.7,"greedy_SVM","SVM",22,11,1584,1554,30,1200,963,237,0.837152698340068,0.306451612903226,1.24245577523413,595,237,358,48,1.5,43.1,4.1,0,0,0,0,0,0,0.17145621589304,90.1586438596266,18.4400231557515
9.7,"greedy_SVM","SVM",22,12,1484,1459,25,1300,1058,242,0.83281857698467,0.266129032258065,1.24245577523413,612,242,370,17,1.5,46.7,4.4,0,0,0,0,0,0,0.151216744974876,78.715909566127,16.3838499233673
9.7,"greedy_SVM","SVM",22,13,1384,1363,21,1400,1154,246,0.807519255700454,0.225806451612903,1.24245577523413,631,246,385,19,1.6,50.29,4.7,0,0,0,0,0,0,0.122969196001223,52.5222352220441,14.0282412521724
9.7,"greedy_SVM","SVM",22,14,1284,1264,20,1500,1253,247,0.828700526195379,0.225806451612903,1.24245577523413,628,247,381,-3,1.5,53.88,5.1,0,0,0,0,0,0,0.071452980093261,24.3623070269763,9.0606845655906
9.7,"greedy_SVM","SVM",22,15,1184,1166,18,1600,1351,249,0.831344213121843,0.314516129032258,1.22174817898023,651,249,402,23,1.6,57.47,5.4,0,0,0,0,0,0,0.0969239129177963,40.9221855642505,11.900689262868
9.7,"greedy_SVM","SVM",22,16,1084,1067,17,1700,1450,250,0.790716591677477,0.193548387096774,1.22174817898023,639,250,389,-12,1.6,61.06,5.8,0,0,0,0,0,0,0.0680994229933692,25.7955296287234,9.09560877313037
9.7,"greedy_SVM","SVM",22,17,984,968,16,1800,1549,251,0.812825694603323,0.241935483870968,1.22174817898023,663,251,412,24,1.6,64.66,6.2,0,0,0,0,0,0,0.0619087608287092,22.4672177483615,8.49262328982789
9.7,"greedy_SVM","SVM",22,18,884,868,16,1900,1649,251,0.82414397925723,0.274193548387097,1.22174817898023,656,251,405,-7,1.6,68.25,6.6,0,0,0,0,0,0,0.0260611309789996,7.68423272743017,3.50893612321373
9.7,"greedy_SVM","SVM",22,19,784,769,15,2000,1748,252,0.823597447825319,0.282258064516129,1.22174817898023,646,252,394,-10,1.6,71.84,6.9,0,0,0,0,0,0,0.0103098099270706,2.8972077405389,1.58336454847353
9.7,"greedy_SVM","SVM",22,20,684,669,15,2100,1848,252,0.816441699077256,0.258064516129032,1.22174817898023,655,252,403,9,1.6,75.43,7.3,0,0,0,0,0,0,0.00529125984055724,1.42703120812484,0.864685835504133
9.7,"greedy_SVM","SVM",22,21,584,570,14,2200,1947,253,0.798450646940698,0.209677419354839,1.22174817898023,675,253,422,20,1.7,79.02,7.7,0,0,0,0,0,0,0.00548934337331822,2.6835420140348,2.24004741480354
9.7,"greedy_SVM","SVM",22,22,484,470,14,2300,2047,253,0.803655405577163,0.258064516129032,1.22174817898023,675,253,422,0,1.7,82.61,8.1,0,0,0,0,0,0,0.000963488607078614,0.307475220916578,0.242978279064548
9.7,"greedy_SVM","SVM",22,23,384,373,11,2400,2144,256,0.77049492869672,0.169354838709677,1.23210197710718,687,256,431,12,1.7,86.21,8.4,0,0,0,0,0,0,0.0389729203460472,11.2031218069961,7.30283470506377
9.7,"greedy_SVM","SVM",22,24,284,273,11,2500,2244,256,0.785626223340711,0.201612903225806,1.22174817898023,686,256,430,-1,1.7,89.8,8.8,0,0,0,0,0,0,0.00685456559852102,1.88766732803573,1.41897959033669
9.7,"greedy_SVM","SVM",22,25,184,175,9,2600,2342,258,0.799448384554771,0.233870967741935,1.23210197710718,694,258,436,8,1.7,93.39,9.1,0,0,0,0,0,0,0.00392376156498198,1.58123416913401,1.45021666554774
9.7,"greedy_SVM","SVM",22,26,84,82,2,2700,2435,265,0.719959836294776,0.153225806451613,1.26316337148803,739,265,474,45,1.8,96.98,9.2,0,0,0,0,0,0,3.68011715305962e-05,1.320095461681,1.320095461681
9.7,"greedy_SVM","SVM",22,27,0,0,0,2784,2517,267,0.704301075268819,0.137096774193548,1.27351716961498,730,267,463,-9,1.7,100,9.4,0,0,0,0,0,0,0,0,0
9.7,"greedy_SVM","SVM",23,0,2684,2445,239,100,86,14,0.578093423407817,0.123188405797101,1.1164095371669,33,14,19,0,1.4,3.59,6.1,0,0,0,0,0,0,0.180977851696623,294.994491374387,36.1257215369034
9.7,"greedy_SVM","SVM",23,1,2584,2363,221,200,168,32,0.73074657890179,0.0869565217391304,1.25596072931276,87,32,55,54,1.7,7.18,5.2,0,0,0,0,0,0,0.206161925301601,320.099000697617,24.0830237805777
9.7,"greedy_SVM","SVM",23,2,2484,2274,210,300,257,43,0.647167850337784,0.115942028985507,1.1536231884058,113,43,70,26,1.6,10.78,6,0,0,0,0,0,0,0.195646756004247,273.363804030624,22.9843682821331
9.7,"greedy_SVM","SVM",23,3,2384,2182,202,400,349,51,0.756746925342112,0.202898550724638,1.20944366526414,133,51,82,20,1.6,14.37,6.8,0,0,0,0,0,0,0.148160369882576,152.832382811156,15.7329637353733
9.7,"greedy_SVM","SVM",23,4,2284,2117,167,500,414,86,0.770783532536521,0.231884057971014,1.21874707807387,206,86,120,73,1.4,17.96,4.8,0,0,0,0,0,0,0.201534486750926,223.080721860059,22.9734703127992
9.7,"greedy_SVM","SVM",23,5,2184,2036,148,600,495,105,0.770061781858077,0.239130434782609,1.20944366526414,251,105,146,45,1.4,21.55,4.7,0,0,0,0,0,0,0.179280254961716,162.960714262135,18.792242833696
9.7,"greedy_SVM","SVM",23,6,2084,1964,120,700,567,133,0.780818753969631,0.27536231884058,1.20944366526414,312,133,179,61,1.3,25.14,4.3,0,0,0,0,0,0,0.188651132937041,127.839253464374,19.6841293881448
9.7,"greedy_SVM","SVM",23,7,1984,1887,97,800,644,156,0.78596916681102,0.268115942028986,1.20944366526414,375,156,219,63,1.4,28.74,4.1,0,0,0,0,0,0,0.196656498394797,176.200641054196,20.1437028439106
9.7,"greedy_SVM","SVM",23,8,1884,1807,77,900,724,176,0.785310930192278,0.268115942028986,1.20944366526414,412,176,236,37,1.3,32.33,4.1,0,0,0,0,0,0,0.179011399868178,97.764939259583,18.9981621126482
9.7,"greedy_SVM","SVM",23,9,1784,1727,57,1000,804,196,0.787343380102783,0.268115942028986,1.20014025245442,463,196,267,51,1.4,35.92,4.1,0,0,0,0,0,0,0.180292101338707,143.632977055062,18.9446560344424
9.7,"greedy_SVM","SVM",23,10,1684,1648,36,1100,883,217,0.788625209307704,0.304347826086957,1.20014025245442,504,217,287,41,1.3,39.51,4.1,0,0,0,0,0,0,0.163440175388829,97.173507781176,17.5944781688392
9.7,"greedy_SVM","SVM",23,11,1584,1560,24,1200,971,229,0.787066227842262,0.27536231884058,1.20014025245442,543,229,314,39,1.4,43.1,4.2,0,0,0,0,0,0,0.149621965490788,72.8967020693823,16.266729871969
9.7,"greedy_SVM","SVM",23,12,1484,1469,15,1300,1062,238,0.772406028061675,0.268115942028986,1.20014025245442,586,238,348,43,1.5,46.7,4.5,0,0,0,0,0,0,0.185169328121186,106.418012153074,20.3304356606847
9.7,"greedy_SVM","SVM",23,13,1384,1369,15,1400,1162,238,0.7730815866967,0.239130434782609,1.20014025245442,581,238,343,-5,1.4,50.29,4.9,0,0,0,0,0,0,0.148500415784961,82.1892269609227,15.629899296219
9.7,"greedy_SVM","SVM",23,14,1284,1270,14,1500,1261,239,0.776390091806695,0.268115942028986,1.20014025245442,582,239,343,1,1.4,53.88,5.3,0,0,0,0,0,0,0.130319777553642,60.8936226083552,14.4067844117599
9.7,"greedy_SVM","SVM",23,15,1184,1170,14,1600,1361,239,0.786431087245231,0.304347826086957,1.20014025245442,598,239,359,16,1.5,57.47,5.7,0,0,0,0,0,0,0.10806230304343,40.3831616654944,11.7885144227571
9.7,"greedy_SVM","SVM",23,16,1084,1071,13,1700,1460,240,0.784467925399858,0.282608695652174,1.20014025245442,602,240,362,4,1.5,61.06,6.1,0,0,0,0,0,0,0.0812926516327704,26.0602150742701,9.38502082707859
9.7,"greedy_SVM","SVM",23,17,984,972,12,1800,1559,241,0.760061204457539,0.239130434782609,1.20014025245442,609,241,368,7,1.5,64.66,6.5,0,0,0,0,0,0,0.107732755885814,25.8575210968655,13.2467369632372
9.7,"greedy_SVM","SVM",23,18,884,872,12,1900,1659,241,0.791925053409557,0.304347826086957,1.20944366526414,604,241,363,-5,1.5,68.25,6.9,0,0,0,0,0,0,0.0294148481966004,5.7802123133643,4.90570971520194
9.7,"greedy_SVM","SVM",23,19,784,773,11,2000,1758,242,0.765875627923097,0.268115942028986,1.20944366526414,615,242,373,11,1.5,71.84,7.3,0,0,0,0,0,0,0.00306122991021693,3.00733530204663,2.77080628110756
9.7,"greedy_SVM","SVM",23,20,684,678,6,2100,1853,247,0.749061724118024,0.181159420289855,1.20944366526414,623,247,376,8,1.5,75.43,7.5,0,0,0,0,0,0,0.0217868786319208,8.01135557774296,3.43295051303517
9.7,"greedy_SVM","SVM",23,21,584,579,5,2200,1952,248,0.787147063918245,0.282608695652174,1.22805049088359,623,248,375,0,1.5,79.02,7.9,0,0,0,0,0,0,0.092046994234502,28.9020461616125,11.5811072337643
9.7,"greedy_SVM","SVM",23,22,484,479,5,2300,2052,248,0.770592990357415,0.246376811594203,1.22805049088359,639,248,391,16,1.6,82.61,8.3,0,0,0,0,0,0,0.0727259558848946,25.139122168106,8.30754647425347
9.7,"greedy_SVM","SVM",23,23,384,380,4,2400,2151,249,0.777238870604542,0.239130434782609,1.21874707807387,645,249,396,6,1.6,86.21,8.6,0,0,0,0,0,0,0.0443750160944939,11.5607634611617,7.39139054357681
9.7,"greedy_SVM","SVM",23,24,284,280,4,2500,2251,249,0.746648189849301,0.202898550724638,1.20014025245442,653,249,404,8,1.6,89.8,9,0,0,0,0,0,0,0.0166679772670122,4.18917022117243,2.71843364192074
9.7,"greedy_SVM","SVM",23,25,184,181,3,2600,2350,250,0.80554881921589,0.27536231884058,1.23735390369331,659,250,409,6,1.6,93.39,9.4,0,0,0,0,0,0,0.00275647880729954,0.98714521086757,0.883544366974163
9.7,"greedy_SVM","SVM",23,26,84,84,0,2700,2447,253,0.758357872856401,0.181159420289855,1.25596072931276,664,253,411,5,1.6,96.98,9.7,0,0,0,0,0,0,6.38620342014427e-05,0.107087181699425,0.107087181699425
9.7,"greedy_SVM","SVM",23,27,0,0,0,2784,2531,253,0.775142906634333,0.217391304347826,1.25596072931276,672,253,419,8,1.7,100,10,0,0,0,0,0,0,0,0,0
9.7,"greedy_SVM","SVM",24,0,2684,2448,236,100,86,14,0.835474588176653,0.340425531914894,1.27476549988561,38,14,24,0,1.7,3.59,6.1,0,0,0,0,0,0,0.316951063565,329.056064919568,36.5525314066679
9.7,"greedy_SVM","SVM",24,1,2584,2367,217,200,167,33,0.831962477057982,0.340425531914894,1.25655456417296,83,33,50,45,1.5,7.18,5.1,0,0,0,0,0,0,0.201192004828229,314.694876519905,21.5941445128132
9.7,"greedy_SVM","SVM",24,2,2484,2293,191,300,241,59,0.696315682142612,0.184397163120567,1.201921757035,149,59,90,66,1.5,10.78,4.1,0,0,0,0,0,0,0.250102870741438,407.687259980206,29.6135441268755
9.7,"greedy_SVM","SVM",24,3,2384,2202,182,400,332,68,0.848803616341517,0.361702127659574,1.28387096774194,167,68,99,18,1.5,14.37,4.9,0,0,0,0,0,0,0.230445866888898,195.857208426135,26.2466790029392
9.7,"greedy_SVM","SVM",24,4,2284,2126,158,500,408,92,0.816073006593708,0.297872340425532,1.25655456417296,228,92,136,61,1.5,17.96,4.4,0,0,0,0,0,0,0.210664350780833,253.095897202237,25.5045045293855
9.7,"greedy_SVM","SVM",24,5,2184,2044,140,600,490,110,0.827119162531439,0.333333333333333,1.27476549988561,266,110,156,38,1.4,21.55,4.5,0,0,0,0,0,0,0.204143785632025,170.346711507751,20.829435928462
9.7,"greedy_SVM","SVM",24,6,2084,1978,106,700,556,144,0.826258128837832,0.326241134751773,1.27476549988561,349,144,205,83,1.4,25.14,3.9,0,0,0,0,0,0,0.21374428083426,132.118507914425,22.1683126827574
9.7,"greedy_SVM","SVM",24,7,1984,1910,74,800,624,176,0.816543176307979,0.319148936170213,1.26566003202928,422,176,246,73,1.4,28.74,3.5,0,0,0,0,0,0,0.22117636643685,153.273970645455,23.0111308564853
9.7,"greedy_SVM","SVM",24,8,1884,1824,60,900,710,190,0.812079396370063,0.304964539007092,1.25655456417296,462,190,272,40,1.4,32.33,3.7,0,0,0,0,0,0,0.199344524355401,154.679603538555,21.0978032225218
9.7,"greedy_SVM","SVM",24,9,1784,1736,48,1000,798,202,0.798676727165615,0.283687943262411,1.24744909631663,494,202,292,32,1.4,35.92,4,0,0,0,0,0,0,0.166701043071108,90.2234603280183,18.4085163842848
9.7,"greedy_SVM","SVM",24,10,1684,1645,39,1100,889,211,0.801027575736977,0.290780141843972,1.24744909631663,513,211,302,19,1.4,39.51,4.2,0,0,0,0,0,0,0.157296521842399,88.6608031535889,17.2662905102722
9.7,"greedy_SVM","SVM",24,11,1584,1553,31,1200,981,219,0.781507035551632,0.25531914893617,1.19281628917868,537,219,318,24,1.5,43.1,4.5,0,0,0,0,0,0,0.168823036126669,106.939798833236,18.2643040056814
9.7,"greedy_SVM","SVM",24,12,1484,1458,26,1300,1076,224,0.785376022477515,0.25531914893617,1.21102722489133,557,224,333,20,1.5,46.7,4.8,0,0,0,0,0,0,0.151684265933266,80.2176916928094,16.2693036841012
9.7,"greedy_SVM","SVM",24,13,1384,1363,21,1400,1171,229,0.750504157886395,0.198581560283688,1.17460535346603,570,229,341,13,1.5,50.29,5.1,0,0,0,0,0,0,0.133741711134933,63.9388131979059,16.7981183135649
9.7,"greedy_SVM","SVM",24,14,1284,1266,18,1500,1268,232,0.75739242743526,0.219858156028369,1.17460535346603,590,232,358,20,1.5,53.88,5.5,0,0,0,0,0,0,0.152316959229633,105.932678953888,15.6285656210884
9.7,"greedy_SVM","SVM",24,15,1184,1168,16,1600,1366,234,0.745502231889975,0.191489361702128,1.17460535346603,602,234,368,12,1.6,57.47,5.8,0,0,0,0,0,0,0.12988880094775,61.5170442191419,14.4049053951419
9.7,"greedy_SVM","SVM",24,16,1084,1068,16,1700,1466,234,0.740234065211978,0.191489361702128,1.18371082132235,602,234,368,0,1.6,61.06,6.3,0,0,0,0,0,0,0.125042097382948,66.6224367192169,12.9552350960308
9.7,"greedy_SVM","SVM",24,17,984,968,16,1800,1566,234,0.73998481861646,0.156028368794326,1.18371082132235,609,234,375,7,1.6,64.66,6.7,0,0,0,0,0,0,0.115188748423988,56.5782353103209,11.9397495905584
9.7,"greedy_SVM","SVM",24,18,884,870,14,1900,1664,236,0.706126934493465,0.120567375886525,1.19281628917868,615,236,379,6,1.6,68.25,7.1,0,0,0,0,0,0,0.0816144095641769,27.756259749273,9.84172031520134
9.7,"greedy_SVM","SVM",24,19,784,770,14,2000,1764,236,0.743140053927904,0.184397163120567,1.19281628917868,607,236,371,-8,1.6,71.84,7.5,0,0,0,0,0,0,0.0211575806216721,8.47857253468468,4.38029382093838
9.7,"greedy_SVM","SVM",24,20,684,674,10,2100,1860,240,0.72844016948769,0.163120567375887,1.17460535346603,639,240,399,32,1.7,75.43,7.8,0,0,0,0,0,0,0.0595435773946999,23.1720986395273,8.11399311953424
9.7,"greedy_SVM","SVM",24,21,584,576,8,2200,1958,242,0.73840436861306,0.191489361702128,1.17460535346603,639,242,397,0,1.6,79.02,8.1,0,0,0,0,0,0,0.0513018374480301,15.5655410336181,7.09959715892814
9.7,"greedy_SVM","SVM",24,22,484,476,8,2300,2058,242,0.738721591552811,0.184397163120567,1.17460535346603,630,242,388,-9,1.6,82.61,8.5,0,0,0,0,0,0,0.020856368044977,5.60594063722515,2.85862149597178
9.7,"greedy_SVM","SVM",24,23,384,378,6,2400,2156,244,0.735504044592486,0.191489361702128,1.17460535346603,636,244,392,6,1.6,86.21,8.8,0,0,0,0,0,0,0.0448084685076014,12.9595537678986,9.44159469111996
9.7,"greedy_SVM","SVM",24,24,284,278,6,2500,2256,244,0.711412095257521,0.170212765957447,1.1654998856097,639,244,395,3,1.6,89.8,9.2,0,0,0,0,0,0,0.0122237214297753,3.12185650833487,2.25227554151354
9.7,"greedy_SVM","SVM",24,25,184,179,5,2600,2355,245,0.730836335621873,0.198581560283688,1.17460535346603,653,245,408,14,1.7,93.39,9.6,0,0,0,0,0,0,0.00748313743634722,1.69262164912408,1.36875183350628
9.7,"greedy_SVM","SVM",24,26,84,83,1,2700,2451,249,0.722622527360479,0.134751773049645,1.25655456417296,675,249,426,22,1.7,96.98,9.8,0,0,0,0,0,0,3.1096201306202e-07,1.61990646598177,1.61990646598177
9.7,"greedy_SVM","SVM",24,27,0,0,0,2784,2534,250,0.759363741417988,0.219858156028369,1.27476549988561,675,250,425,0,1.7,100,10.1,0,0,0,0,0,0,0,0,0
9.7,"greedy_SVM","SVM",25,0,2684,2430,254,100,88,12,0.813943217665624,0.336,1.20170322580645,29,12,17,0,1.4,3.59,7.3,0,0,0,0,0,0,0.32114626399617,316.509080911727,35.3364925230176
9.7,"greedy_SVM","SVM",25,1,2584,2377,207,200,141,59,0.82476340694008,0.32,1.25305806451613,126,59,67,97,1.1,7.18,2.4,0,0,0,0,0,0,0.299727452795176,718.135353904033,30.2735872466705
9.7,"greedy_SVM","SVM",25,2,2484,2307,177,300,211,89,0.813621451104105,0.232,1.26332903225806,195,89,106,69,1.2,10.78,2.4,0,0,0,0,0,0,0.352676752598448,423.808580670037,41.1989061734835
9.7,"greedy_SVM","SVM",25,3,2384,2228,156,400,290,110,0.709104100946373,0.192,1.19143225806452,252,110,142,57,1.3,14.37,2.6,0,0,0,0,0,0,0.294879577698188,581.881512223585,31.6472736242543
9.7,"greedy_SVM","SVM",25,4,2284,2142,142,500,376,124,0.748611987381704,0.176,1.22224516129032,292,124,168,40,1.4,17.96,3,0,0,0,0,0,0,0.284352223985904,376.695386748706,32.7190342960167
9.7,"greedy_SVM","SVM",25,5,2184,2049,135,600,469,131,0.824088328075723,0.256,1.2736,302,131,171,10,1.3,21.55,3.6,0,0,0,0,0,0,0.235392921380563,187.856395143157,24.6645508045032
9.7,"greedy_SVM","SVM",25,6,2084,1978,106,700,540,160,0.832662460567837,0.288,1.2736,372,160,212,70,1.3,25.14,3.4,0,0,0,0,0,0,0.231256571111769,172.470487016993,24.2449690520223
9.7,"greedy_SVM","SVM",25,7,1984,1904,80,800,614,186,0.829066246056794,0.272,1.2736,440,186,254,68,1.4,28.74,3.3,0,0,0,0,0,0,0.214952297380444,134.761956387264,23.630493665848
9.7,"greedy_SVM","SVM",25,8,1884,1822,62,900,696,204,0.822220820189289,0.272,1.2736,486,204,282,46,1.4,32.33,3.4,0,0,0,0,0,0,0.205085824723392,115.00805075242,23.0165599287849
9.7,"greedy_SVM","SVM",25,9,1784,1729,55,1000,789,211,0.821350157728721,0.28,1.2736,506,211,295,20,1.4,35.92,3.7,0,0,0,0,0,0,0.168854443473127,94.0503882601925,18.5667799789507
9.7,"greedy_SVM","SVM",25,10,1684,1642,42,1100,876,224,0.817482649842287,0.24,1.2736,542,224,318,36,1.4,39.51,3.9,0,0,0,0,0,0,0.122094792413186,42.2470003230489,18.4787518399324
9.7,"greedy_SVM","SVM",25,11,1584,1551,33,1200,967,233,0.814378548895913,0.232,1.2736,566,233,333,24,1.4,43.1,4.2,0,0,0,0,0,0,0.0901572088765573,29.6267829148403,10.9370982890342
9.7,"greedy_SVM","SVM",25,12,1484,1454,30,1300,1064,236,0.805223974763414,0.24,1.24278709677419,582,236,346,16,1.5,46.7,4.5,0,0,0,0,0,0,0.0801892520082299,31.2708170337797,11.912783406056
9.7,"greedy_SVM","SVM",25,13,1384,1355,29,1400,1163,237,0.797343848580447,0.24,1.26332903225806,605,237,368,23,1.6,50.29,4.9,0,0,0,0,0,0,0.0887769356532923,29.3135335787331,12.0630369582316
9.7,"greedy_SVM","SVM",25,14,1284,1258,26,1500,1260,240,0.796403785488963,0.248,1.25305806451613,613,240,373,8,1.6,53.88,5.2,0,0,0,0,0,0,0.0514569127855784,12.6808066631036,8.65984682298201
9.7,"greedy_SVM","SVM",25,15,1184,1159,25,1600,1359,241,0.800984227129343,0.28,1.26332903225806,618,241,377,5,1.6,57.47,5.6,0,0,0,0,0,0,0.00812357532061826,2.61333801478018,1.99665836967289
9.7,"greedy_SVM","SVM",25,16,1084,1062,22,1700,1456,244,0.813249211356476,0.232,1.2736,633,244,389,15,1.6,61.06,6,0,0,0,0,0,0,0.00480233431379044,2.00148417422586,1.39771087739248
9.7,"greedy_SVM","SVM",25,17,984,973,11,1800,1545,255,0.800347003154578,0.2,1.28387096774194,673,255,418,40,1.6,64.66,6.1,0,0,0,0,0,0,0.160388989057818,77.5964136433626,28.6834159759252
9.7,"greedy_SVM","SVM",25,18,884,875,9,1900,1643,257,0.808290220820188,0.248,1.28387096774194,682,257,425,9,1.7,68.25,6.4,0,0,0,0,0,0,0.105339544929566,39.3943358499341,13.7730239731739
9.7,"greedy_SVM","SVM",25,19,784,779,5,2000,1739,261,0.805451104100945,0.24,1.28268876611418,725,261,464,43,1.8,71.84,6.7,0,0,0,0,0,0,0.0913239306020468,29.7990065820889,11.76356789423
9.7,"greedy_SVM","SVM",25,20,684,680,4,2100,1838,262,0.761110410094637,0.192,1.28387096774194,722,262,460,-3,1.8,75.43,7,0,0,0,0,0,0,0.100346292765729,32.9012514427614,12.8753068557969
9.7,"greedy_SVM","SVM",25,21,584,582,2,2200,1936,264,0.76631545741325,0.192,1.28387096774194,720,264,456,-2,1.7,79.02,7.3,0,0,0,0,0,0,0.0483183351814866,13.3123190244641,7.14483413187741
9.7,"greedy_SVM","SVM",25,22,484,482,2,2300,2036,264,0.770864353312306,0.24,1.28387096774194,726,264,462,6,1.8,82.61,7.7,0,0,0,0,0,0,0.0437734824368108,11.5670871377291,6.20323318214833
9.7,"greedy_SVM","SVM",25,23,384,382,2,2400,2136,264,0.820529968454262,0.264,1.28387096774194,741,264,477,15,1.8,86.21,8.1,0,0,0,0,0,0,0.0143939166433936,3.93123445865957,2.86125226199266
9.7,"greedy_SVM","SVM",25,24,284,283,1,2500,2235,265,0.774094637223977,0.224,1.28387096774194,733,265,468,-8,1.8,89.8,8.4,0,0,0,0,0,0,0.00309232655004184,1.36388819679331,1.20734615776245
9.7,"greedy_SVM","SVM",25,25,184,184,0,2600,2334,266,0.814914826498423,0.232,1.28387096774194,726,266,460,-7,1.7,93.39,8.8,0,0,0,0,0,0,0.000284009540682898,0.639684663447937,0.634714522259145
9.7,"greedy_SVM","SVM",25,26,84,84,0,2700,2434,266,0.763432176656155,0.184,1.2736,744,266,478,18,1.8,96.98,9.2,0,0,0,0,0,0,1.0000000994736e-07,0.00741588252207262,0.00741588252207262
9.7,"greedy_SVM","SVM",25,27,0,0,0,2784,2518,266,0.751520504731866,0.184,1.2736,738,266,472,-6,1.8,100,9.5,0,0,0,0,0,0,0,0,0
9.7,"greedy_SVM","SVM",26,0,2684,2422,262,100,90,10,0.831068691212756,0.361344537815126,1.24071564109515,28,10,18,0,1.8,3.59,9,0,0,0,0,0,0,0.226464990463438,241.189537199361,24.6187433604977
9.7,"greedy_SVM","SVM",26,1,2584,2359,225,200,153,47,0.791927760115041,0.159663865546218,1.25150447275684,107,47,60,79,1.3,7.18,3.3,0,0,0,0,0,0,0.296245621061726,468.18370522734,35.1402693431048
9.7,"greedy_SVM","SVM",26,2,2484,2274,210,300,238,62,0.834940569634452,0.319327731092437,1.27308213608024,152,62,90,45,1.5,10.78,3.8,0,0,0,0,0,0,0.245242585769306,298.402055712453,25.6298152539497
9.7,"greedy_SVM","SVM",26,3,2384,2207,177,400,305,95,0.851602179333276,0.327731092436975,1.26229330441854,221,95,126,69,1.3,14.37,3.2,0,0,0,0,0,0,0.264117641577317,292.315875620192,27.9330745944749
9.7,"greedy_SVM","SVM",26,4,2284,2136,148,500,376,124,0.858316953154893,0.352941176470588,1.27308213608024,298,124,174,77,1.4,17.96,3,0,0,0,0,0,0,0.251259636440972,294.908630748255,26.1928200821626
9.7,"greedy_SVM","SVM",26,5,2184,2065,119,600,447,153,0.84445866258592,0.319327731092437,1.27308213608024,360,153,207,62,1.4,21.55,2.9,0,0,0,0,0,0,0.257816701151453,249.196571621381,29.2820408911988
9.7,"greedy_SVM","SVM",26,6,2084,1987,97,700,525,175,0.810957349972962,0.285714285714286,1.21913797777175,418,175,243,58,1.4,25.14,3,0,0,0,0,0,0,0.266056852226056,228.015079118354,48.5234939316076
9.7,"greedy_SVM","SVM",26,7,1984,1897,87,800,615,185,0.790503014392574,0.26890756302521,1.24071564109515,450,185,265,32,1.4,28.74,3.3,0,0,0,0,0,0,0.244883994961509,257.623390116601,25.2780309769146
9.7,"greedy_SVM","SVM",26,8,1884,1799,85,900,713,187,0.830422278801634,0.235294117647059,1.27308213608024,456,187,269,6,1.4,32.33,3.8,0,0,0,0,0,0,0.225464129253533,127.52640416274,24.6920056470677
9.7,"greedy_SVM","SVM",26,9,1784,1715,69,1000,797,203,0.805588169333674,0.176470588235294,1.26229330441854,482,203,279,26,1.4,35.92,3.9,0,0,0,0,0,0,0.207798473677446,131.565002603119,29.9379711687037
9.7,"greedy_SVM","SVM",26,10,1684,1630,54,1100,882,218,0.803174016859496,0.176470588235294,1.28387096774194,532,218,314,50,1.4,39.51,4,0,0,0,0,0,0,0.199041707506452,161.171825930556,22.4221418711352
9.7,"greedy_SVM","SVM",26,11,1584,1540,44,1200,972,228,0.806722689075634,0.235294117647059,1.27308213608024,573,228,345,41,1.5,43.1,4.3,0,0,0,0,0,0,0.193728996088848,164.024644349108,21.1558520888092
9.7,"greedy_SVM","SVM",26,12,1484,1447,37,1300,1065,235,0.766539582866119,0.134453781512605,1.26229330441854,607,235,372,34,1.6,46.7,4.5,0,0,0,0,0,0,0.187928068152887,168.927732063471,19.7360554946165
9.7,"greedy_SVM","SVM",26,13,1384,1354,30,1400,1158,242,0.826504228064853,0.336134453781513,1.26229330441854,607,242,365,0,1.5,50.29,4.8,0,0,0,0,0,0,0.164008666022973,119.706086207315,17.683351721339
9.7,"greedy_SVM","SVM",26,14,1284,1268,16,1500,1244,256,0.816999327203413,0.277310924369748,1.26229330441854,648,256,392,41,1.5,53.88,4.9,0,0,0,0,0,0,0.128626688165365,58.9181478469122,14.8798452852391
9.7,"greedy_SVM","SVM",26,15,1184,1174,10,1600,1338,262,0.812758070261073,0.294117647058824,1.26229330441854,664,262,402,16,1.5,57.47,5.1,0,0,0,0,0,0,0.15297804871643,121.43873263347,15.8205101555149
9.7,"greedy_SVM","SVM",26,16,1084,1074,10,1700,1438,262,0.814130047623449,0.277310924369748,1.26229330441854,681,262,419,17,1.6,61.06,5.5,0,0,0,0,0,0,0.0567337903975102,20.300715156771,7.17278933799469
9.7,"greedy_SVM","SVM",26,17,984,976,8,1800,1536,264,0.812777858396111,0.260504201680672,1.26229330441854,681,264,417,0,1.6,64.66,5.8,0,0,0,0,0,0,0.102445335383202,48.0756203462348,11.3586692641872
9.7,"greedy_SVM","SVM",26,18,884,877,7,1900,1635,265,0.815581177525961,0.277310924369748,1.27308213608024,670,265,405,-11,1.5,68.25,6.2,0,0,0,0,0,0,0.0408375599830441,12.9638847181422,5.36421540882733
9.7,"greedy_SVM","SVM",26,19,784,780,4,2000,1732,268,0.836404891626986,0.319327731092437,1.27308213608024,691,268,423,21,1.6,71.84,6.5,0,0,0,0,0,0,0.0347572225863977,10.7395787807227,5.60718575178532
9.7,"greedy_SVM","SVM",26,20,684,683,1,2100,1829,271,0.783946545651231,0.134453781512605,1.27308213608024,722,271,451,31,1.7,75.43,6.7,0,0,0,0,0,0,0.0683932052136354,27.3051105731661,13.2392414039304
9.7,"greedy_SVM","SVM",26,21,584,583,1,2200,1929,271,0.793959341978554,0.19327731092437,1.27308213608024,729,271,458,7,1.7,79.02,7.1,0,0,0,0,0,0,0.0151394190455273,4.1381891194778,2.36787979602495
9.7,"greedy_SVM","SVM",26,22,484,483,1,2300,2029,271,0.767350896402521,0.117647058823529,1.26229330441854,729,271,458,0,1.7,82.61,7.5,0,0,0,0,0,0,0.0100622907340969,2.60937091926805,1.75232777380843
9.7,"greedy_SVM","SVM",26,23,384,383,1,2400,2129,271,0.801894384127282,0.218487394957983,1.26229330441854,723,271,452,-6,1.7,86.21,7.9,0,0,0,0,0,0,0.00736848873851531,2.42031291883549,1.78535493413075
9.7,"greedy_SVM","SVM",26,24,284,284,0,2500,2228,272,0.822454256427851,0.285714285714286,1.26229330441854,734,272,462,11,1.7,89.8,8.2,0,0,0,0,0,0,0.00460328913380214,2.596076213841,2.32029896201595
9.7,"greedy_SVM","SVM",26,25,184,184,0,2600,2328,272,0.814057491128324,0.235294117647059,1.26229330441854,743,272,471,9,1.7,93.39,8.6,0,0,0,0,0,0,0.000152709327165857,0.111851056690044,0.108158380802359
9.7,"greedy_SVM","SVM",26,26,84,84,0,2700,2428,272,0.795159822170633,0.210084033613445,1.26229330441854,749,272,477,6,1.8,96.98,8.9,0,0,0,0,0,0,1.0000000994736e-07,0.0128494050758862,0.0128494050758862
9.7,"greedy_SVM","SVM",26,27,0,0,0,2784,2512,272,0.823509623629676,0.302521008403361,1.26229330441854,732,272,460,-17,1.7,100,9.2,0,0,0,0,0,0,0,0,0
9.7,"greedy_SVM","SVM",27,0,2684,2437,247,100,90,10,0.811328583452874,0.328358208955224,1.2263842079923,28,10,18,0,1.8,3.59,9,0,0,0,0,0,0,0.162386059357641,310.308061663603,17.4113007074869
9.7,"greedy_SVM","SVM",27,1,2584,2377,207,200,150,50,0.772100577335725,0.298507462686567,1.1784785748676,111,50,61,83,1.2,7.18,3,0,0,0,0,0,0,0.313618023585916,426.341501627716,34.8980940751007
9.7,"greedy_SVM","SVM",27,2,2484,2305,179,300,222,78,0.697171410619664,0.201492537313433,1.09224843524314,171,78,93,60,1.2,10.78,2.8,0,0,0,0,0,0,0.27687241822757,519.846135157218,38.7488864563745
9.7,"greedy_SVM","SVM",27,3,2384,2217,167,400,310,90,0.774068497860192,0.253731343283582,1.14973519499278,198,90,108,27,1.2,14.37,3.4,0,0,0,0,0,0,0.219277805993333,221.182096427132,23.6062636872134
9.7,"greedy_SVM","SVM",27,4,2284,2145,139,500,382,118,0.756155679110416,0.261194029850746,1.15931632161772,259,118,141,61,1.2,17.96,3.2,0,0,0,0,0,0,0.221522276579847,267.851531077549,24.7773158070152
9.7,"greedy_SVM","SVM",27,5,2184,2062,122,600,465,135,0.771567104904397,0.261194029850746,1.15931632161772,294,135,159,35,1.2,21.55,3.4,0,0,0,0,0,0,0.2030127328232,166.773894508587,21.2397661123247
9.7,"greedy_SVM","SVM",27,6,2084,1982,102,700,545,155,0.774311524190018,0.283582089552239,1.15931632161772,343,155,188,49,1.2,25.14,3.5,0,0,0,0,0,0,0.195081216086926,122.110090358317,20.9321895396498
9.7,"greedy_SVM","SVM",27,7,1984,1904,80,800,623,177,0.765965644375431,0.283582089552239,1.16782111541739,404,177,227,61,1.3,28.74,3.5,0,0,0,0,0,0,0.194692531680436,130.530913809584,21.4945472596107
9.7,"greedy_SVM","SVM",27,8,1884,1812,72,900,715,185,0.787903216246017,0.291044776119403,1.21680308136736,423,185,238,19,1.3,32.33,3.9,0,0,0,0,0,0,0.172369541669169,104.019846266607,19.0412089876414
9.7,"greedy_SVM","SVM",27,9,1784,1725,59,1000,802,198,0.794796865553094,0.26865671641791,1.25512758786712,455,198,257,32,1.3,35.92,4.1,0,0,0,0,0,0,0.160122039186834,81.3671569762857,18.2161827944916
9.7,"greedy_SVM","SVM",27,10,1684,1635,49,1100,892,208,0.787642407501809,0.23134328358209,1.25512758786712,489,208,281,34,1.4,39.51,4.3,0,0,0,0,0,0,0.11680345075052,59.6972102332739,14.2668129232389
9.7,"greedy_SVM","SVM",27,11,1584,1540,44,1200,987,213,0.807819520349015,0.194029850746269,1.26470871449206,508,213,295,19,1.4,43.1,4.6,0,0,0,0,0,0,0.122318974602587,74.1361126652205,15.545313714462
9.7,"greedy_SVM","SVM",27,12,1484,1453,31,1300,1074,226,0.823284293386133,0.223880597014925,1.274289841117,540,226,314,32,1.4,46.7,4.8,0,0,0,0,0,0,0.121296817616301,42.7268606908738,15.9781179026654
9.7,"greedy_SVM","SVM",27,13,1384,1365,19,1400,1162,238,0.815791969461673,0.208955223880597,1.26470871449206,567,238,329,27,1.4,50.29,4.9,0,0,0,0,0,0,0.102353588008165,37.1095699435362,12.5259202334462
9.7,"greedy_SVM","SVM",27,14,1284,1266,18,1500,1261,239,0.822715256126048,0.238805970149254,1.26470871449206,573,239,334,6,1.4,53.88,5.3,0,0,0,0,0,0,0.0712510542311791,28.8181610318,8.68617057572403
9.7,"greedy_SVM","SVM",27,15,1184,1166,18,1600,1361,239,0.814369376311459,0.201492537313433,1.26470871449206,576,239,337,3,1.4,57.47,5.7,0,0,0,0,0,0,0.0253171291758945,9.22363711583019,3.50846885013739
9.7,"greedy_SVM","SVM",27,16,1084,1068,16,1700,1459,241,0.792977131815119,0.194029850746269,1.25512758786712,588,241,347,12,1.4,61.06,6.1,0,0,0,0,0,0,0.10889889541428,38.6843418009376,13.6840425794515
9.7,"greedy_SVM","SVM",27,17,984,969,15,1800,1558,242,0.794654606238079,0.171641791044776,1.25512758786712,595,242,353,7,1.5,64.66,6.4,0,0,0,0,0,0,0.0692624565896277,20.9740528812373,9.6325802669882
9.7,"greedy_SVM","SVM",27,18,884,870,14,1900,1657,243,0.782995269877783,0.186567164179104,1.26470871449206,598,243,355,3,1.5,68.25,6.8,0,0,0,0,0,0,0.031161481105038,9.54259079497411,5.7627998210842
9.7,"greedy_SVM","SVM",27,19,784,770,14,2000,1757,243,0.800979218285072,0.208955223880597,1.25512758786712,595,243,352,-3,1.4,71.84,7.2,0,0,0,0,0,0,0.0303720007543117,10.3228738191945,4.24513237589949
9.7,"greedy_SVM","SVM",27,20,684,670,14,2100,1857,243,0.808121821393439,0.238805970149254,1.25512758786712,593,243,350,-2,1.4,75.43,7.6,0,0,0,0,0,0,0.008786053847524,2.59388718665855,1.30400313523915
9.7,"greedy_SVM","SVM",27,21,584,572,12,2200,1955,245,0.775864521712337,0.171641791044776,1.24554646124218,610,245,365,17,1.5,79.02,8,0,0,0,0,0,0,0.0484991633569794,15.067657299224,9.68352118099781
9.7,"greedy_SVM","SVM",27,22,484,473,11,2300,2054,246,0.796397282847091,0.186567164179104,1.24554646124218,608,246,362,-2,1.5,82.61,8.3,0,0,0,0,0,0,0.00775288900033772,2.35438507846748,1.63888339147625
9.7,"greedy_SVM","SVM",27,23,384,373,11,2400,2154,246,0.801281519329495,0.201492537313433,1.24554646124218,627,246,381,19,1.5,86.21,8.8,0,0,0,0,0,0,0.00573786753268128,1.45336557953019,0.879019799812999
9.7,"greedy_SVM","SVM",27,24,284,274,10,2500,2253,247,0.807552784133352,0.223880597014925,1.24554646124218,621,247,374,-6,1.5,89.8,9.1,0,0,0,0,0,0,0.00150300327905377,0.359376302767397,0.255430138230319
9.7,"greedy_SVM","SVM",27,25,184,177,7,2600,2350,250,0.795591146728635,0.208955223880597,1.24554646124218,631,250,381,10,1.5,93.39,9.4,0,0,0,0,0,0,0.00233505412959698,0.588053245510706,0.484802160232924
9.7,"greedy_SVM","SVM",27,26,84,81,3,2700,2446,254,0.765005393999034,0.126865671641791,1.274289841117,666,254,412,35,1.6,96.98,9.6,0,0,0,0,0,0,3.37726457716794e-05,1.7815385189809,1.7815385189809
9.7,"greedy_SVM","SVM",27,27,0,0,0,2784,2527,257,0.800718409540858,0.17910447761194,1.27311646188945,659,257,402,-7,1.6,100,9.8,0,0,0,0,0,0,0,0,0
9.7,"greedy_SVM","SVM",28,0,2684,2438,246,100,90,10,0.807831360772542,0.274074074074074,1.26485065710872,25,10,15,0,1.5,3.59,9,0,0,0,0,0,0,0.140317912229411,268.599981941457,14.8527207654497
9.7,"greedy_SVM","SVM",28,1,2584,2357,227,200,171,29,0.8017370311488,0.303703703703704,1.27436081242533,69,29,40,44,1.4,7.18,5.9,0,0,0,0,0,0,0.21082156158361,254.23722856086,27.7430062035804
9.7,"greedy_SVM","SVM",28,2,2484,2285,199,300,243,57,0.80947418006242,0.266666666666667,1.24583034647551,129,57,72,60,1.3,10.78,4.3,0,0,0,0,0,0,0.23225852768244,342.841654667842,26.6397883163386
9.7,"greedy_SVM","SVM",28,3,2384,2208,176,400,320,80,0.827574633456988,0.266666666666667,1.27436081242533,185,80,105,56,1.3,14.37,4,0,0,0,0,0,0,0.233691153413731,222.966245763957,24.6619122204517
9.7,"greedy_SVM","SVM",28,4,2284,2133,151,500,395,105,0.831460872637347,0.303703703703704,1.27436081242533,255,105,150,70,1.4,17.96,3.8,0,0,0,0,0,0,0.232416223127161,188.603197150012,23.7031632045347
9.7,"greedy_SVM","SVM",28,5,2184,2065,119,600,463,137,0.833992816345764,0.288888888888889,1.27436081242533,315,137,178,60,1.3,21.55,3.4,0,0,0,0,0,0,0.240515476481272,178.793484574836,24.8540858676025
9.7,"greedy_SVM","SVM",28,6,2084,1993,91,700,535,165,0.830760171936652,0.303703703703704,1.27436081242533,383,165,218,68,1.3,25.14,3.2,0,0,0,0,0,0,0.232072455860775,166.625035437296,24.3280637054483
9.7,"greedy_SVM","SVM",28,7,1984,1909,75,800,619,181,0.823388093976335,0.251851851851852,1.24583034647551,429,181,248,46,1.4,28.74,3.4,0,0,0,0,0,0,0.209646888417429,110.213077459645,22.3561258921374
9.7,"greedy_SVM","SVM",28,8,1884,1828,56,900,700,200,0.828387210740156,0.296296296296296,1.24583034647551,482,200,282,53,1.4,32.33,3.5,0,0,0,0,0,0,0.210103734474264,134.789619887659,22.4722819022967
9.7,"greedy_SVM","SVM",28,9,1784,1738,46,1000,790,210,0.829688512041457,0.311111111111111,1.24583034647551,504,210,294,22,1.4,35.92,3.8,0,0,0,0,0,0,0.1448818256325,67.2289098501754,16.6820645720143
9.7,"greedy_SVM","SVM",28,10,1684,1641,43,1100,887,213,0.826667844314906,0.274074074074074,1.2363201911589,520,213,307,16,1.4,39.51,4.2,0,0,0,0,0,0,0.151168076327737,95.051691121874,16.9542966181159
9.7,"greedy_SVM","SVM",28,11,1584,1555,29,1200,973,227,0.828075133957492,0.251851851851852,1.25534050179211,565,227,338,45,1.5,43.1,4.3,0,0,0,0,0,0,0.125613234613776,54.6268953431198,16.3914453659997
9.7,"greedy_SVM","SVM",28,12,1484,1462,22,1300,1066,234,0.830324442089155,0.274074074074074,1.25534050179211,586,234,352,21,1.5,46.7,4.6,0,0,0,0,0,0,0.0919931013820796,34.3664741637478,11.0705446832035
9.7,"greedy_SVM","SVM",28,13,1384,1363,21,1400,1165,235,0.835347111817706,0.296296296296296,1.25534050179211,579,235,344,-7,1.5,50.29,5,0,0,0,0,0,0,0.0909993697429868,38.0606286215108,10.5427522213203
9.7,"greedy_SVM","SVM",28,14,1284,1266,18,1500,1262,238,0.816987575811112,0.214814814814815,1.2363201911589,592,238,354,13,1.5,53.88,5.3,0,0,0,0,0,0,0.0516108187221287,16.2212545742226,8.28146422138086
9.7,"greedy_SVM","SVM",28,15,1184,1167,17,1600,1361,239,0.814567508685161,0.251851851851852,1.2363201911589,594,239,355,2,1.5,57.47,5.7,0,0,0,0,0,0,0.0665711439219104,26.8834303999525,8.71946636488616
9.7,"greedy_SVM","SVM",28,16,1084,1068,16,1700,1460,240,0.81286580698346,0.274074074074074,1.22681003584229,618,240,378,24,1.6,61.06,6.1,0,0,0,0,0,0,0.090538519918197,31.5825227287431,11.3361994145142
9.7,"greedy_SVM","SVM",28,17,984,969,15,1800,1559,241,0.807460401578054,0.251851851851852,1.22681003584229,618,241,377,0,1.6,64.66,6.5,0,0,0,0,0,0,0.0491139159329342,15.9718116432963,7.45709068992435
9.7,"greedy_SVM","SVM",28,18,884,869,15,1900,1659,241,0.819113230877942,0.318518518518519,1.22681003584229,626,241,385,8,1.6,68.25,6.9,0,0,0,0,0,0,0.0289769968504804,8.54598034827824,3.84903406110891
9.7,"greedy_SVM","SVM",28,19,784,770,14,2000,1758,242,0.817111228875942,0.281481481481481,1.21729988052569,624,242,382,-2,1.6,71.84,7.3,0,0,0,0,0,0,0.0109597667843256,3.2980416026426,1.73886154956689
9.7,"greedy_SVM","SVM",28,20,684,672,12,2100,1856,244,0.817623505858805,0.288888888888889,1.21729988052569,636,244,392,12,1.6,75.43,7.6,0,0,0,0,0,0,0.00579193448878341,1.61806607566783,0.868490018134096
9.7,"greedy_SVM","SVM",28,21,584,574,10,2200,1954,246,0.809862803980456,0.281481481481481,1.21729988052569,626,246,380,-10,1.5,79.02,7.9,0,0,0,0,0,0,0.0400934465581818,15.016100294004,5.49256634338844
9.7,"greedy_SVM","SVM",28,22,484,475,9,2300,2053,247,0.781752340575877,0.222222222222222,1.19827956989247,639,247,392,13,1.6,82.61,8.3,0,0,0,0,0,0,0.0290607742339054,8.80051277174507,6.94921337624072
9.7,"greedy_SVM","SVM",28,23,384,376,8,2400,2152,248,0.78782900547607,0.214814814814815,1.20778972520908,653,248,405,14,1.6,86.21,8.7,0,0,0,0,0,0,0.0029086877614607,1.6575265616953,1.43194322989136
9.7,"greedy_SVM","SVM",28,24,284,276,8,2500,2252,248,0.796419949361133,0.222222222222222,1.19827956989247,660,248,412,7,1.7,89.8,9.1,0,0,0,0,0,0,0.000557678635315987,0.157176463310095,0.124333376600395
9.7,"greedy_SVM","SVM",28,25,184,177,7,2600,2351,249,0.787958546782084,0.244444444444444,1.19827956989247,661,249,412,1,1.7,93.39,9.4,0,0,0,0,0,0,0.000688294019190038,0.190441041793413,0.163381723074535
9.7,"greedy_SVM","SVM",28,26,84,83,1,2700,2445,255,0.779326385208735,0.22962962962963,1.28387096774194,686,255,431,25,1.7,96.98,9.6,0,0,0,0,0,0,1.62665335523952e-05,2.72479900234575,2.72479900234575
9.7,"greedy_SVM","SVM",28,27,0,0,0,2784,2528,256,0.826714950244357,0.274074074074074,1.28387096774194,702,256,446,16,1.7,100,9.9,0,0,0,0,0,0,0,0,0
9.7,"greedy_SVM","SVM",29,0,2684,2427,257,100,90,10,0.817000940542466,0.314516129032258,1.27351716961498,32,10,22,0,2.2,3.59,9,0,0,0,0,0,0,0.142093667269999,272.12437717291,14.9902647398781
9.7,"greedy_SVM","SVM",29,1,2584,2346,238,200,171,29,0.785365667658054,0.306451612903226,1.27351716961498,80,29,51,48,1.8,7.18,5.9,0,0,0,0,0,0,0.184580929310732,328.824632531857,19.8936192000494
9.7,"greedy_SVM","SVM",29,2,2484,2274,210,300,243,57,0.816721319809863,0.241935483870968,1.27351716961498,157,57,100,77,1.8,10.78,4.3,0,0,0,0,0,0,0.223628370396211,333.638832503727,25.4730558640888
9.7,"greedy_SVM","SVM",29,3,2384,2184,200,400,333,67,0.851343450519846,0.338709677419355,1.27351716961498,180,67,113,23,1.7,14.37,5,0,0,0,0,0,0,0.195088893080558,243.161609700639,21.9897800648431
9.7,"greedy_SVM","SVM",29,4,2284,2106,178,500,411,89,0.820991890998755,0.25,1.25280957336108,218,89,129,38,1.4,17.96,4.6,0,0,0,0,0,0,0.202512194969026,204.62492746293,23.5664699722532
9.7,"greedy_SVM","SVM",29,5,2184,2018,166,600,499,101,0.862337629324591,0.370967741935484,1.28387096774194,253,101,152,35,1.5,21.55,4.9,0,0,0,0,0,0,0.200592833135476,147.267867097124,20.6454544928413
9.7,"greedy_SVM","SVM",29,6,2084,1955,129,700,562,138,0.81510079056408,0.290322580645161,1.21139438085328,332,138,194,79,1.4,25.14,4.1,0,0,0,0,0,0,0.215733883067467,216.351163977529,28.2485781375257
9.7,"greedy_SVM","SVM",29,7,1984,1879,105,800,638,162,0.843539490073466,0.330645161290323,1.27351716961498,395,162,233,63,1.4,28.74,3.9,0,0,0,0,0,0,0.225771627779201,146.280271298663,23.1969759778632
9.7,"greedy_SVM","SVM",29,8,1884,1799,85,900,718,182,0.844569002770791,0.395161290322581,1.27351716961498,458,182,276,63,1.5,32.33,3.9,0,0,0,0,0,0,0.215909246069344,111.453247249323,22.352292945521
9.7,"greedy_SVM","SVM",29,9,1784,1710,74,1000,807,193,0.839745545133333,0.330645161290323,1.27351716961498,484,193,291,26,1.5,35.92,4.2,0,0,0,0,0,0,0.183713685793725,82.9031199967578,19.654877310694
9.7,"greedy_SVM","SVM",29,10,1684,1626,58,1100,891,209,0.832265690536114,0.346774193548387,1.24245577523413,532,209,323,48,1.5,39.51,4.3,0,0,0,0,0,0,0.184290637750921,119.713302346867,19.393218198097
9.7,"greedy_SVM","SVM",29,11,1584,1530,54,1200,987,213,0.803871476143272,0.241935483870968,1.23210197710718,540,213,327,8,1.5,43.1,4.6,0,0,0,0,0,0,0.161344202609901,102.832221627429,17.114182459725
9.7,"greedy_SVM","SVM",29,12,1484,1435,49,1300,1082,218,0.779849513205728,0.201612903225806,1.23210197710718,573,218,355,33,1.6,46.7,5,0,0,0,0,0,0,0.164912875212305,109.765918822707,17.1082253683578
9.7,"greedy_SVM","SVM",29,13,1384,1336,48,1400,1181,219,0.813651846767842,0.266129032258065,1.23210197710718,575,219,356,2,1.6,50.29,5.4,0,0,0,0,0,0,0.132216210285981,68.3563777584927,14.0102108638981
9.7,"greedy_SVM","SVM",29,14,1284,1245,39,1500,1272,228,0.820229289000741,0.241935483870968,1.23210197710718,616,228,388,41,1.7,53.88,5.6,0,0,0,0,0,0,0.146740235379961,79.9557338536939,15.574557077848
9.7,"greedy_SVM","SVM",29,15,1184,1160,24,1600,1357,243,0.810391723226312,0.266129032258065,1.23210197710718,653,243,410,37,1.7,57.47,5.6,0,0,0,0,0,0,0.145678664455365,64.5668712502362,15.4273278968886
9.7,"greedy_SVM","SVM",29,16,1084,1062,22,1700,1455,245,0.813829787234044,0.266129032258065,1.23210197710718,660,245,415,7,1.7,61.06,5.9,0,0,0,0,0,0,0.118824098264439,38.1461130771173,13.2811954285272
9.7,"greedy_SVM","SVM",29,17,984,962,22,1800,1555,245,0.821735427946821,0.241935483870968,1.23210197710718,654,245,409,-6,1.7,64.66,6.3,0,0,0,0,0,0,0.0736203406049164,17.0431440132507,9.30368385193331
9.7,"greedy_SVM","SVM",29,18,884,862,22,1900,1655,245,0.852830524415974,0.387096774193548,1.23210197710718,667,245,422,13,1.7,68.25,6.8,0,0,0,0,0,0,0.0718931393635434,15.6132841884961,8.92096915087073
9.7,"greedy_SVM","SVM",29,19,784,763,21,2000,1754,246,0.837362413889524,0.330645161290323,1.23210197710718,659,246,413,-8,1.7,71.84,7.1,0,0,0,0,0,0,0.0151346540915655,6.03965853071259,5.12022433636302
9.7,"greedy_SVM","SVM",29,20,684,671,13,2100,1846,254,0.822599710211248,0.185483870967742,1.26316337148803,651,254,397,-8,1.6,75.43,7.3,0,0,0,0,0,0,0.00584367845152421,2.67351751675591,2.06871238424753
9.7,"greedy_SVM","SVM",29,21,584,579,5,2200,1938,262,0.83805511070439,0.298387096774194,1.27351716961498,696,262,434,45,1.7,79.02,7.4,0,0,0,0,0,0,0.0694033417399891,22.5186682437689,10.0964293933155
9.7,"greedy_SVM","SVM",29,22,484,480,4,2300,2037,263,0.83800427057119,0.282258064516129,1.28387096774194,736,263,473,40,1.8,82.61,7.7,0,0,0,0,0,0,0.0516848617573343,13.9251563680826,6.42139504527755
9.7,"greedy_SVM","SVM",29,23,384,382,2,2400,2135,265,0.858480134217957,0.314516129032258,1.28387096774194,705,265,440,-31,1.7,86.21,8.1,0,0,0,0,0,0,0.0344521025105154,7.94903163826451,5.419879574278
9.7,"greedy_SVM","SVM",29,24,284,282,2,2500,2235,265,0.745367192862047,0.137096774193548,1.28387096774194,743,265,478,38,1.8,89.8,8.4,0,0,0,0,0,0,0.0173940412971018,4.12787294203556,3.33207927250415
9.7,"greedy_SVM","SVM",29,25,184,183,1,2600,2334,266,0.824658735605888,0.241935483870968,1.27351716961498,726,266,460,-17,1.7,93.39,8.8,0,0,0,0,0,0,0.0173569233959368,6.02458552737392,5.47901084636548
9.7,"greedy_SVM","SVM",29,26,84,84,0,2700,2433,267,0.824506215206286,0.258064516129032,1.27351716961498,740,267,473,14,1.8,96.98,9.1,0,0,0,0,0,0,0.000105421062154254,2.61879298060062,2.61879298060062
9.7,"greedy_SVM","SVM",29,27,0,0,0,2784,2517,267,0.835322453544834,0.282258064516129,1.26316337148803,725,267,458,-15,1.7,100,9.4,0,0,0,0,0,0,0,0,0
9.7,"greedy_SVM","SVM",30,0,2684,2426,258,100,90,10,0.241501824467063,0,0.469708890637293,31,10,21,0,2.1,3.59,9,0,0,0,0,0,0,0.103110124657613,270.453518887238,10.3559915365574
9.7,"greedy_SVM","SVM",30,1,2584,2326,258,200,190,10,0.754330708661414,0.24390243902439,1.16475919580132,34,10,24,3,2.4,7.18,19,0,0,0,0,0,0,0.5,272.449819934855,56.4854792148808
9.7,"greedy_SVM","SVM",30,2,2484,2254,230,300,262,38,0.775558542987008,0.235772357723577,1.25255704169945,88,38,50,54,1.3,10.78,6.9,0,0,0,0,0,0,0.414913217904956,366.762904546329,53.1562410385311
9.7,"greedy_SVM","SVM",30,3,2384,2178,206,400,338,62,0.715837654439541,0.121951219512195,1.23168109100446,169,62,107,81,1.7,14.37,5.5,0,0,0,0,0,0,0.202245688076078,345.551052338135,23.1706771034006
9.7,"greedy_SVM","SVM",30,4,2284,2082,202,500,434,66,0.799539082004997,0.24390243902439,1.23168109100446,171,66,105,2,1.6,17.96,6.6,0,0,0,0,0,0,0.195379671331484,193.036534628682,25.5546551250097
9.7,"greedy_SVM","SVM",30,5,2184,2003,181,600,513,87,0.816913129761229,0.227642276422764,1.25255704169945,234,87,147,63,1.7,21.55,5.9,0,0,0,0,0,0,0.184761128648491,182.822490380856,19.2941125411713
9.7,"greedy_SVM","SVM",30,6,2084,1930,154,700,586,114,0.832469112092704,0.300813008130081,1.25255704169945,290,114,176,56,1.5,25.14,5.1,0,0,0,0,0,0,0.215392248042407,153.401052011654,22.6035339692475
9.7,"greedy_SVM","SVM",30,7,1984,1868,116,800,648,152,0.826714038793935,0.276422764227642,1.26299501704694,374,152,222,84,1.5,28.74,4.3,0,0,0,0,0,0,0.212899471506562,215.277413879149,21.9397847773691
9.7,"greedy_SVM","SVM",30,8,1884,1798,86,900,718,182,0.827821522309714,0.276422764227642,1.25255704169945,447,182,265,73,1.5,32.33,3.9,0,0,0,0,0,0,0.210216685516283,122.546843450509,22.5115119211332
9.7,"greedy_SVM","SVM",30,9,1784,1715,69,1000,801,199,0.829121054990087,0.300813008130081,1.25255704169945,483,199,284,36,1.4,35.92,4,0,0,0,0,0,0,0.18928036685734,119.02367312979,20.5391927096486
9.7,"greedy_SVM","SVM",30,10,1684,1630,54,1100,886,214,0.824646309455225,0.24390243902439,1.25255704169945,518,214,304,35,1.4,39.51,4.1,0,0,0,0,0,0,0.166958962980149,92.3558577101455,19.7245803582346
9.7,"greedy_SVM","SVM",30,11,1584,1542,42,1200,974,226,0.831604890852051,0.300813008130081,1.24211906635195,570,226,344,52,1.5,43.1,4.3,0,0,0,0,0,0,0.152600086090003,80.7528063433754,16.8605659547413
9.7,"greedy_SVM","SVM",30,12,1484,1457,27,1300,1059,241,0.826496383074068,0.268292682926829,1.24211906635195,597,241,356,27,1.5,46.7,4.4,0,0,0,0,0,0,0.13729777305057,70.7008815048282,16.3654568560895
9.7,"greedy_SVM","SVM",30,13,1384,1364,20,1400,1152,248,0.814883810255438,0.292682926829268,1.25255704169945,635,248,387,38,1.6,50.29,4.6,0,0,0,0,0,0,0.127172101789044,60.2044492919737,15.1115389621336
9.7,"greedy_SVM","SVM",30,14,1284,1268,16,1500,1248,252,0.76670507649959,0.170731707317073,1.25255704169945,645,252,393,10,1.6,53.88,5,0,0,0,0,0,0,0.155557827518716,98.901034519625,18.4124006846677
9.7,"greedy_SVM","SVM",30,15,1184,1169,15,1600,1347,253,0.779226682030605,0.195121951219512,1.25255704169945,655,253,402,10,1.6,57.47,5.3,0,0,0,0,0,0,0.10699303443929,46.3356695082517,12.9167383978004
9.7,"greedy_SVM","SVM",30,16,1084,1070,14,1700,1446,254,0.757608347737026,0.195121951219512,1.23168109100446,661,254,407,6,1.6,61.06,5.7,0,0,0,0,0,0,0.0790609182423801,33.268419153293,10.4072512665653
9.7,"greedy_SVM","SVM",30,17,984,970,14,1800,1546,254,0.791485820370016,0.211382113821138,1.24211906635195,673,254,419,12,1.6,64.66,6.1,0,0,0,0,0,0,0.0696126631130071,31.4478744764592,8.58790590561546
9.7,"greedy_SVM","SVM",30,18,884,873,11,1900,1643,257,0.772799436655797,0.211382113821138,1.27343299239444,681,257,424,8,1.6,68.25,6.4,0,0,0,0,0,0,0.0632824303961323,22.0879953870489,10.8710360522778
9.7,"greedy_SVM","SVM",30,19,784,777,7,2000,1739,261,0.743339094808282,0.16260162601626,1.27343299239444,692,261,431,11,1.7,71.84,6.7,0,0,0,0,0,0,0.0340926786032486,9.77875627207364,5.12538654950454
9.7,"greedy_SVM","SVM",30,20,684,678,6,2100,1838,262,0.817738941168951,0.268292682926829,1.26299501704694,704,262,442,12,1.7,75.43,7,0,0,0,0,0,0,0.0131960477505909,3.72847225481654,2.49634998287004
9.7,"greedy_SVM","SVM",30,21,584,583,1,2200,1933,267,0.789975033608611,0.227642276422764,1.26299501704694,716,267,449,12,1.7,79.02,7.2,0,0,0,0,0,0,0.0550850782891152,16.8995075807341,7.89835897960783
9.7,"greedy_SVM","SVM",30,22,484,484,0,2300,2032,268,0.774118174252621,0.211382113821138,1.27343299239444,723,268,455,7,1.7,82.61,7.6,0,0,0,0,0,0,0.00999353905848553,2.65355597073549,1.69803182068087
9.7,"greedy_SVM","SVM",30,23,384,384,0,2400,2132,268,0.761871839190843,0.186991869918699,1.27343299239444,729,268,461,6,1.7,86.21,8,0,0,0,0,0,0,0.00759374580761841,2.10445779902314,1.46036347080093
9.7,"greedy_SVM","SVM",30,24,284,284,0,2500,2232,268,0.817226810063386,0.235772357723577,1.26299501704694,725,268,457,-4,1.7,89.8,8.3,0,0,0,0,0,0,7.95905495264937e-05,0.0321744595923348,0.0290098700338546
9.7,"greedy_SVM","SVM",30,25,184,184,0,2600,2332,268,0.805505409384812,0.24390243902439,1.27343299239444,735,268,467,10,1.7,93.39,8.7,0,0,0,0,0,0,3.06335100825343e-05,0.021303680205923,0.0203541731364209
9.7,"greedy_SVM","SVM",30,26,84,84,0,2700,2432,268,0.79014787785674,0.227642276422764,1.27343299239444,725,268,457,-10,1.7,96.98,9.1,0,0,0,0,0,0,1.22556463676295e-07,0.000984252557633326,0.000984252557633326
9.7,"greedy_SVM","SVM",30,27,0,0,0,2784,2516,268,0.780410985212225,0.211382113821138,1.26299501704694,730,268,462,5,1.7,100,9.4,0,0,0,0,0,0,0,0,0
9.7,"greedy_SVM","SVM",31,0,2684,2415,269,100,94,6,0.543657008613942,0.120689655172414,0.896496106785317,24,6,18,0,3,3.59,15.7,0,0,0,0,0,0,0.165014375208597,199.218822142307,20.017441568775
9.7,"greedy_SVM","SVM",31,1,2584,2320,264,200,189,11,0.840291091728996,0.344827586206897,1.27280311457175,40,11,29,16,2.6,7.18,17.2,0,0,0,0,0,0,0.101573073973767,87.4514772218606,11.4101777645573
9.7,"greedy_SVM","SVM",31,2,2484,2256,228,300,253,47,0.812592822617662,0.206896551724138,1.28387096774194,134,47,87,94,1.9,10.78,5.4,0,0,0,0,0,0,0.223907541998215,166.05760422296,27.2952634856814
9.7,"greedy_SVM","SVM",31,3,2384,2189,195,400,320,80,0.8309953284908,0.301724137931034,1.27280311457175,202,80,122,68,1.5,14.37,4,0,0,0,0,0,0,0.234786073125833,232.036052635042,25.9261704939424
9.7,"greedy_SVM","SVM",31,4,2284,2109,175,500,400,100,0.835018767045599,0.293103448275862,1.27280311457175,253,100,153,51,1.5,17.96,4,0,0,0,0,0,0,0.233957241965515,120.134216441785,24.2358461614999
9.7,"greedy_SVM","SVM",31,5,2184,2039,145,600,470,130,0.801440607026158,0.258620689655172,1.27280311457175,322,130,192,69,1.5,21.55,3.6,0,0,0,0,0,0,0.244839112992112,129.975608733378,33.2987357656849
9.7,"greedy_SVM","SVM",31,6,2084,1957,127,700,552,148,0.773647827613202,0.206896551724138,1.26173526140156,361,148,213,39,1.4,25.14,3.7,0,0,0,0,0,0,0.228162087950526,200.72074682956,28.7465972524974
9.7,"greedy_SVM","SVM",31,7,1984,1891,93,800,618,182,0.783814435773496,0.25,1.27280311457175,444,182,262,83,1.4,28.74,3.4,0,0,0,0,0,0,0.231454607174059,142.689237293496,24.6695188519724
9.7,"greedy_SVM","SVM",31,8,1884,1808,76,900,701,199,0.78201874004266,0.224137931034483,1.27280311457175,487,199,288,43,1.4,32.33,3.5,0,0,0,0,0,0,0.210262367221335,143.162748911469,22.7961631729664
9.7,"greedy_SVM","SVM",31,9,1784,1715,69,1000,794,206,0.774950719628435,0.198275862068966,1.27280311457175,509,206,303,22,1.5,35.92,3.9,0,0,0,0,0,0,0.186732568536726,142.012072015299,19.7345912227356
9.7,"greedy_SVM","SVM",31,10,1684,1619,65,1100,890,210,0.789991359058127,0.258620689655172,1.27280311457175,516,210,306,7,1.5,39.51,4.2,0,0,0,0,0,0,0.150458483258494,100.628990105014,17.6495958782063
9.7,"greedy_SVM","SVM",31,11,1584,1527,57,1200,982,218,0.806145869899812,0.224137931034483,1.26173526140156,539,218,321,23,1.5,43.1,4.5,0,0,0,0,0,0,0.146762895625123,73.4479838464476,18.6017450423186
9.7,"greedy_SVM","SVM",31,12,1484,1442,42,1300,1067,233,0.803263305700318,0.232758620689655,1.23959955506118,588,233,355,49,1.5,46.7,4.6,0,0,0,0,0,0,0.111082291847332,48.1821775088952,15.7592037339854
9.7,"greedy_SVM","SVM",31,13,1384,1357,27,1400,1152,248,0.801400102611179,0.232758620689655,1.23959955506118,619,248,371,31,1.5,50.29,4.6,0,0,0,0,0,0,0.0890359055567009,40.4560779147097,12.1829914478592
9.7,"greedy_SVM","SVM",31,14,1284,1261,23,1500,1248,252,0.805504549995943,0.21551724137931,1.23959955506118,637,252,385,18,1.5,53.88,5,0,0,0,0,0,0,0.0602538939373704,21.6512647358316,7.89356278830363
9.7,"greedy_SVM","SVM",31,15,1184,1165,19,1600,1344,256,0.795756487457128,0.206896551724138,1.23959955506118,651,256,395,14,1.5,57.47,5.2,0,0,0,0,0,0,0.10383830742624,43.208864200776,12.388904240387
9.7,"greedy_SVM","SVM",31,16,1084,1067,17,1700,1442,258,0.78612993816325,0.21551724137931,1.23959955506118,661,258,403,10,1.6,61.06,5.6,0,0,0,0,0,0,0.0973540390106661,29.4489264001958,11.9728461574502
9.7,"greedy_SVM","SVM",31,17,984,967,17,1800,1542,258,0.78525571787324,0.206896551724138,1.2384581190068,664,258,406,3,1.6,64.66,6,0,0,0,0,0,0,0.0583176200450709,15.1345504639502,7.38396819901891
9.7,"greedy_SVM","SVM",31,18,884,867,17,1900,1642,258,0.794190316744513,0.224137931034483,1.23959955506118,680,258,422,16,1.6,68.25,6.4,0,0,0,0,0,0,0.0620015184710614,20.1678589417452,7.77153497232094
9.7,"greedy_SVM","SVM",31,19,784,769,15,2000,1740,260,0.795000405044144,0.198275862068966,1.25066740823137,670,260,410,-10,1.6,71.84,6.7,0,0,0,0,0,0,0.000644318792458264,0.329152578030581,0.298577268380134
9.7,"greedy_SVM","SVM",31,20,684,675,9,2100,1834,266,0.772122161315579,0.181034482758621,1.27280311457175,708,266,442,38,1.7,75.43,6.9,0,0,0,0,0,0,0.0960242007808539,31.3490588128861,19.6627362770523
9.7,"greedy_SVM","SVM",31,21,584,575,9,2200,1934,266,0.803958631490825,0.241379310344828,1.26173526140156,695,266,429,-13,1.6,79.02,7.3,0,0,0,0,0,0,0.0164657505874405,5.95743515278736,3.22151526044548
9.7,"greedy_SVM","SVM",31,22,484,481,3,2300,2028,272,0.821652310101798,0.241379310344828,1.28387096774194,719,272,447,24,1.6,82.61,7.5,0,0,0,0,0,0,0.0576769222200193,14.319695107746,8.98990010455938
9.7,"greedy_SVM","SVM",31,23,384,382,2,2400,2127,273,0.782174006966759,0.189655172413793,1.28387096774194,723,273,450,4,1.6,86.21,7.8,0,0,0,0,0,0,0.0344391643245518,8.7132050598949,5.99780926180068
9.7,"greedy_SVM","SVM",31,24,284,282,2,2500,2227,273,0.758971727918341,0.155172413793103,1.28387096774194,746,273,473,23,1.7,89.8,8.2,0,0,0,0,0,0,0.00150953052226307,1.09649161305999,1.0695653628944
9.7,"greedy_SVM","SVM",31,25,184,183,1,2600,2326,274,0.826128047957223,0.25,1.28387096774194,735,274,461,-11,1.7,93.39,8.5,0,0,0,0,0,0,1.88108853030232e-05,0.0760080743372371,0.0755914798008491
9.7,"greedy_SVM","SVM",31,26,84,84,0,2700,2425,275,0.795020657251632,0.206896551724138,1.27280311457175,732,275,457,-3,1.7,96.98,8.8,0,0,0,0,0,0,2.85938719561371e-05,2.51825583387399,2.51825583387399
9.7,"greedy_SVM","SVM",31,27,0,0,0,2784,2509,275,0.811094159263353,0.21551724137931,1.28387096774194,750,275,475,18,1.7,100,9.1,0,0,0,0,0,0,0,0,0
9.7,"greedy_SVM","SVM",32,0,2684,2442,242,100,95,5,0.66098434302998,0.243055555555556,1.15905017921147,23,5,18,0,3.6,3.59,19,0,0,0,0,0,0,0.057320014186431,147.551207981347,5.78019368799974
9.7,"greedy_SVM","SVM",32,1,2584,2369,215,200,168,32,0.772584734454228,0.298611111111111,1.23929211469534,94,32,62,71,1.9,7.18,5.2,0,0,0,0,0,0,0.163850934921282,398.206523047824,16.6768317984103
9.7,"greedy_SVM","SVM",32,2,2484,2291,193,300,246,54,0.76375544880348,0.263888888888889,1.18579749103943,143,54,89,49,1.6,10.78,4.6,0,0,0,0,0,0,0.196591910286103,342.327617909819,23.4440040765692
9.7,"greedy_SVM","SVM",32,3,2384,2207,177,400,330,70,0.806478516146247,0.340277777777778,1.23037634408602,175,70,105,32,1.5,14.37,4.7,0,0,0,0,0,0,0.194117043787028,309.427768041619,20.3208319178932
9.7,"greedy_SVM","SVM",32,4,2284,2151,133,500,386,114,0.802831153811941,0.3125,1.23037634408602,278,114,164,103,1.4,17.96,3.4,0,0,0,0,0,0,0.241049211247844,349.660266012522,24.4641844931623
9.7,"greedy_SVM","SVM",32,5,2184,2076,108,600,461,139,0.799762031847695,0.298611111111111,1.23037634408602,334,139,195,56,1.4,21.55,3.3,0,0,0,0,0,0,0.23402565719956,325.752129172886,23.7442006253596
9.7,"greedy_SVM","SVM",32,6,2084,1997,87,700,540,160,0.799144871452712,0.291666666666667,1.22924340085942,382,160,222,48,1.4,25.14,3.4,0,0,0,0,0,0,0.222496542679837,202.23432957327,22.9885095337983
9.7,"greedy_SVM","SVM",32,7,1984,1915,69,800,622,178,0.797082110132547,0.319444444444444,1.21254480286738,435,178,257,53,1.4,28.74,3.5,0,0,0,0,0,0,0.208453494551363,186.075849652161,22.137576903219
9.7,"greedy_SVM","SVM",32,8,1884,1825,59,900,712,188,0.786262343207906,0.291666666666667,1.21254480286738,461,188,273,26,1.5,32.33,3.8,0,0,0,0,0,0,0.199890276072385,213.885963554798,21.1127944338343
9.7,"greedy_SVM","SVM",32,9,1784,1732,52,1000,805,195,0.796526109776715,0.298611111111111,1.19471326164875,484,195,289,23,1.5,35.92,4.1,0,0,0,0,0,0,0.184086571522906,184.748799040612,19.0495209381893
9.7,"greedy_SVM","SVM",32,10,1684,1651,33,1100,886,214,0.79103282626101,0.333333333333333,1.19471326164875,551,214,337,67,1.6,39.51,4.1,0,0,0,0,0,0,0.18429777459469,159.909419273722,19.5102478271235
9.7,"greedy_SVM","SVM",32,11,1584,1562,22,1200,975,225,0.794652388577528,0.326388888888889,1.21254480286738,579,225,354,28,1.6,43.1,4.3,0,0,0,0,0,0,0.177884329745058,198.293769159657,18.148236051239
9.7,"greedy_SVM","SVM",32,12,1484,1465,19,1300,1072,228,0.780657859621031,0.298611111111111,1.20362903225806,595,228,367,16,1.6,46.7,4.7,0,0,0,0,0,0,0.154966588268567,129.800385372287,15.9858379041905
9.7,"greedy_SVM","SVM",32,13,1384,1367,17,1400,1170,230,0.77383017525131,0.284722222222222,1.19471326164875,607,230,377,12,1.6,50.29,5.1,0,0,0,0,0,0,0.12845818518497,68.8279755879163,14.1543153358169
9.7,"greedy_SVM","SVM",32,14,1284,1267,17,1500,1270,230,0.764778489458231,0.270833333333333,1.19471326164875,601,230,371,-6,1.6,53.88,5.5,0,0,0,0,0,0,0.134731880152971,100.420399153179,13.9112429020302
9.7,"greedy_SVM","SVM",32,15,1184,1170,14,1600,1367,233,0.777850057824036,0.298611111111111,1.19471326164875,614,233,381,13,1.6,57.47,5.9,0,0,0,0,0,0,0.108959751482865,60.1590372202766,12.3311793131615
9.7,"greedy_SVM","SVM",32,16,1084,1070,14,1700,1467,233,0.762181967796459,0.270833333333333,1.19471326164875,616,233,383,2,1.6,61.06,6.3,0,0,0,0,0,0,0.0844499873050816,40.1642522200574,9.49183554982626
9.7,"greedy_SVM","SVM",32,17,984,971,13,1800,1566,234,0.775603816386441,0.291666666666667,1.18579749103943,618,234,384,2,1.6,64.66,6.7,0,0,0,0,0,0,0.0648042461506611,27.8482424958012,7.47871240528077
9.7,"greedy_SVM","SVM",32,18,884,872,12,1900,1665,235,0.758150965216617,0.236111111111111,1.18579749103943,608,235,373,-10,1.6,68.25,7.1,0,0,0,0,0,0,0.0454712141303492,16.3349923722834,5.71247525955687
9.7,"greedy_SVM","SVM",32,19,784,773,11,2000,1764,236,0.776471176941551,0.291666666666667,1.18579749103943,626,236,390,18,1.7,71.84,7.5,0,0,0,0,0,0,0.0368955458279581,12.7196245752403,4.54924122818149
9.7,"greedy_SVM","SVM",32,20,684,673,11,2100,1864,236,0.751312160839777,0.229166666666667,1.18579749103943,621,236,385,-5,1.6,75.43,7.9,0,0,0,0,0,0,0.020836277026217,6.01281961126112,2.74662628460403
9.7,"greedy_SVM","SVM",32,21,584,573,11,2200,1964,236,0.766040610265986,0.229166666666667,1.18579749103943,621,236,385,0,1.6,79.02,8.3,0,0,0,0,0,0,0.0219262066862009,6.41665978466777,2.74715486205622
9.7,"greedy_SVM","SVM",32,22,484,473,11,2300,2064,236,0.747992838715414,0.243055555555556,1.18579749103943,626,236,390,5,1.7,82.61,8.7,0,0,0,0,0,0,0.00655512384302172,1.55517525009236,0.928196544802488
9.7,"greedy_SVM","SVM",32,23,384,373,11,2400,2164,236,0.735210390534646,0.173611111111111,1.18579749103943,632,236,396,6,1.7,86.21,9.2,0,0,0,0,0,0,0.00264433380813725,0.431570662084945,0.409837300791425
9.7,"greedy_SVM","SVM",32,24,284,273,11,2500,2264,236,0.759062805800191,0.222222222222222,1.18579749103943,631,236,395,-1,1.7,89.8,9.6,0,0,0,0,0,0,2.93724017587981e-06,0.0662858076693801,0.0661776122840086
9.7,"greedy_SVM","SVM",32,25,184,174,10,2600,2363,237,0.769721332621651,0.277777777777778,1.17688172043011,637,237,400,6,1.7,93.39,10,0,0,0,0,0,0,2.01303219688342e-07,0.00699855824330862,0.00699503612495889
9.7,"greedy_SVM","SVM",32,26,84,81,3,2700,2456,244,0.735532870741033,0.201388888888889,1.23929211469534,664,244,420,27,1.7,96.98,10.1,0,0,0,0,0,0,1.60451394984913e-08,3.10742153798943,3.10742153798943
9.7,"greedy_SVM","SVM",32,27,0,0,0,2784,2537,247,0.761826127568715,0.236111111111111,1.25712365591398,667,247,420,3,1.7,100,10.3,0,0,0,0,0,0,0,0,0
9.7,"greedy_SVM","SVM",33,0,2684,2435,249,100,90,10,0.80047701439453,0.242424242424242,1.24496578690127,24,10,14,0,1.4,3.59,9,0,0,0,0,0,0,0.254338670694675,194.491031219239,36.5558894136463
9.7,"greedy_SVM","SVM",33,1,2584,2373,211,200,152,48,0.657432773412157,0.181818181818182,1.08934506353861,110,48,62,86,1.3,7.18,3.2,0,0,0,0,0,0,0.273353228504094,520.179556138817,32.6916808408478
9.7,"greedy_SVM","SVM",33,2,2484,2287,197,300,238,62,0.758356763511398,0.325757575757576,1.17688172043011,139,62,77,29,1.2,10.78,3.8,0,0,0,0,0,0,0.24258613043655,308.49500031075,26.2126200672725
9.7,"greedy_SVM","SVM",33,3,2384,2218,166,400,307,93,0.735088794367141,0.227272727272727,1.15742913000977,213,93,120,74,1.3,14.37,3.3,0,0,0,0,0,0,0.260387855681808,295.523153967261,27.2823392605581
9.7,"greedy_SVM","SVM",33,4,2284,2144,140,500,381,119,0.768942397808371,0.234848484848485,1.19633431085044,269,119,150,56,1.3,17.96,3.2,0,0,0,0,0,0,0.239501739276937,327.529573981124,24.9228669480246
9.7,"greedy_SVM","SVM",33,5,2184,2069,115,600,456,144,0.789518900343637,0.25,1.22551319648094,319,144,175,50,1.2,21.55,3.2,0,0,0,0,0,0,0.233300565429507,214.477608701299,23.925045624974
9.7,"greedy_SVM","SVM",33,6,2084,1987,97,700,538,162,0.79149544613462,0.265151515151515,1.2352394916911,364,162,202,45,1.2,25.14,3.3,0,0,0,0,0,0,0.18511543124222,93.9223046093255,20.7365253064959
9.7,"greedy_SVM","SVM",33,7,1984,1908,76,800,617,183,0.795166174032152,0.25,1.24381940956527,417,183,234,53,1.3,28.74,3.4,0,0,0,0,0,0,0.134866617845826,68.0822595321016,16.3585882234606
9.7,"greedy_SVM","SVM",33,8,1884,1823,61,900,702,198,0.793177612765242,0.257575757575758,1.24496578690127,457,198,259,40,1.3,32.33,3.5,0,0,0,0,0,0,0.169984074891312,126.878127208442,18.8199517930364
9.7,"greedy_SVM","SVM",33,9,1784,1732,52,1000,793,207,0.778344507725948,0.227272727272727,1.25469208211144,485,207,278,28,1.3,35.92,3.8,0,0,0,0,0,0,0.158879042126763,70.5316067427105,18.3860124157255
9.7,"greedy_SVM","SVM",33,10,1684,1632,52,1100,893,207,0.791669670535649,0.257575757575758,1.2644183773216,492,207,285,7,1.4,39.51,4.3,0,0,0,0,0,0,0.0491514794220752,21.0088717910308,8.67805485068264
9.7,"greedy_SVM","SVM",33,11,1584,1541,43,1200,984,216,0.798572561459149,0.25,1.2644183773216,525,216,309,33,1.4,43.1,4.6,0,0,0,0,0,0,0.176869044474295,118.986972676875,19.6612847614079
9.7,"greedy_SVM","SVM",33,12,1484,1455,29,1300,1070,230,0.807548121981102,0.234848484848485,1.27414467253177,559,230,329,34,1.4,46.7,4.7,0,0,0,0,0,0,0.151290440619845,59.4474262273542,18.1172815304436
9.7,"greedy_SVM","SVM",33,13,1384,1366,18,1400,1159,241,0.789657078316859,0.234848484848485,1.24496578690127,586,241,345,27,1.4,50.29,4.8,0,0,0,0,0,0,0.14171316448634,64.948727163754,15.619356206695
9.7,"greedy_SVM","SVM",33,14,1284,1268,16,1500,1257,243,0.792612885396376,0.227272727272727,1.2352394916911,603,243,360,17,1.5,53.88,5.2,0,0,0,0,0,0,0.103642252976092,44.4295111573532,12.1576383812922
9.7,"greedy_SVM","SVM",33,15,1184,1169,15,1600,1356,244,0.795424506764698,0.257575757575758,1.2352394916911,605,244,361,2,1.5,57.47,5.6,0,0,0,0,0,0,0.0727035495442723,28.0086070907243,8.84485487250559
9.7,"greedy_SVM","SVM",33,16,1084,1070,14,1700,1455,245,0.75933001706197,0.196969696969697,1.22551319648094,621,245,376,16,1.5,61.06,5.9,0,0,0,0,0,0,0.122246611289847,42.3649893440809,16.0231801779528
9.7,"greedy_SVM","SVM",33,17,984,971,13,1800,1554,246,0.786737317665149,0.272727272727273,1.22551319648094,630,246,384,9,1.6,64.66,6.3,0,0,0,0,0,0,0.0703622311032735,28.9625071369642,9.06477678275204
9.7,"greedy_SVM","SVM",33,18,884,872,12,1900,1653,247,0.78028500708912,0.242424242424242,1.2352394916911,628,247,381,-2,1.5,68.25,6.7,0,0,0,0,0,0,0.0428564396517503,14.2547286228215,6.33490591637839
9.7,"greedy_SVM","SVM",33,19,784,772,12,2000,1753,247,0.781498570158356,0.257575757575758,1.2352394916911,638,247,391,10,1.6,71.84,7.1,0,0,0,0,0,0,0.0471122873720552,16.0480707683627,5.67745079650221
9.7,"greedy_SVM","SVM",33,20,684,672,12,2100,1853,247,0.758374786725296,0.21969696969697,1.2352394916911,632,247,385,-6,1.6,75.43,7.5,0,0,0,0,0,0,0.0160586987484855,4.54107579893387,2.31629572594888
9.7,"greedy_SVM","SVM",33,21,584,573,11,2200,1952,248,0.745938769134639,0.212121212121212,1.2352394916911,646,248,398,14,1.6,79.02,7.9,0,0,0,0,0,0,0.0184963681507994,5.13275371391931,2.63633578197489
9.7,"greedy_SVM","SVM",33,22,484,473,11,2300,2052,248,0.761468771778042,0.227272727272727,1.2352394916911,644,248,396,-2,1.6,82.61,8.3,0,0,0,0,0,0,0.00719604576590984,1.8147956682728,1.11042859974286
9.7,"greedy_SVM","SVM",33,23,384,375,9,2400,2150,250,0.75337634873717,0.196969696969697,1.2352394916911,662,250,412,18,1.6,86.21,8.6,0,0,0,0,0,0,0.00620761414579144,1.50974865593917,1.03681440312364
9.7,"greedy_SVM","SVM",33,24,284,280,4,2500,2245,255,0.786959603969908,0.242424242424242,1.27414467253177,688,255,433,26,1.7,89.8,8.8,0,0,0,0,0,0,0.0398866538839955,10.3523688828485,7.61023835229429
9.7,"greedy_SVM","SVM",33,25,184,182,2,2600,2343,257,0.78164876360752,0.227272727272727,1.27414467253177,704,257,447,16,1.7,93.39,9.1,0,0,0,0,0,0,0.00461346796137775,1.86159859705377,1.69319751376195
9.7,"greedy_SVM","SVM",33,26,84,84,0,2700,2441,259,0.791555523514286,0.242424242424242,1.27414467253177,736,259,477,32,1.8,96.98,9.4,0,0,0,0,0,0,4.51176651917344e-05,0.861909015723654,0.861909015723654
9.7,"greedy_SVM","SVM",33,27,0,0,0,2784,2525,259,0.769927666834874,0.204545454545455,1.27414467253177,730,259,471,-6,1.8,100,9.7,0,0,0,0,0,0,0,0,0
9.7,"greedy_SVM","SVM",34,0,2684,2419,265,100,93,7,0.560822131050223,0.151260504201681,1.02493900786121,25,7,18,0,2.6,3.59,13.3,0,0,0,0,0,0,0.0981832472085971,197.67858377182,11.5211136319976
9.7,"greedy_SVM","SVM",34,1,2584,2343,241,200,169,31,0.808741078849127,0.260504201680672,1.26229330441854,75,31,44,50,1.4,7.18,5.5,0,0,0,0,0,0,0.205373661931812,301.580904280694,22.7564319156947
9.7,"greedy_SVM","SVM",34,2,2484,2268,216,300,244,56,0.801808635542134,0.226890756302521,1.26229330441854,137,56,81,62,1.4,10.78,4.4,0,0,0,0,0,0,0.211606016504936,314.893001345334,23.2371605121039
9.7,"greedy_SVM","SVM",34,3,2384,2197,187,400,315,85,0.809631544925666,0.327731092436975,1.25150447275684,197,85,112,60,1.3,14.37,3.7,0,0,0,0,0,0,0.232233434192628,255.92808776804,24.7122477634229
9.7,"greedy_SVM","SVM",34,4,2284,2122,162,500,390,110,0.79520599448571,0.285714285714286,1.25150447275684,261,110,151,64,1.4,17.96,3.5,0,0,0,0,0,0,0.222306697701595,260.000470351505,23.5087809731319
9.7,"greedy_SVM","SVM",34,5,2184,2047,137,600,465,135,0.806894186245931,0.235294117647059,1.25150447275684,317,135,182,56,1.3,21.55,3.4,0,0,0,0,0,0,0.232924906252766,212.985710583448,23.6619995508962
9.7,"greedy_SVM","SVM",34,6,2084,1968,116,700,544,156,0.808530005408761,0.285714285714286,1.25150447275684,365,156,209,48,1.3,25.14,3.5,0,0,0,0,0,0,0.228848950214204,177.689918876145,23.4039758666153
9.7,"greedy_SVM","SVM",34,7,1984,1906,78,800,606,194,0.809987731356284,0.243697478991597,1.25150447275684,452,194,258,87,1.3,28.74,3.1,0,0,0,0,0,0,0.230989093447586,142.853784493907,24.6198188497329
9.7,"greedy_SVM","SVM",34,8,1884,1827,57,900,685,215,0.806439059140145,0.218487394957983,1.26229330441854,496,215,281,44,1.3,32.33,3.2,0,0,0,0,0,0,0.206423585085872,176.805880000508,22.4693330176369
9.7,"greedy_SVM","SVM",34,9,1784,1735,49,1000,777,223,0.81305489228659,0.226890756302521,1.26229330441854,523,223,300,27,1.3,35.92,3.5,0,0,0,0,0,0,0.18535398315637,175.247816325798,19.7478599528244
9.7,"greedy_SVM","SVM",34,10,1684,1648,36,1100,864,236,0.828443465298212,0.226890756302521,1.26229330441854,548,236,312,25,1.3,39.51,3.7,0,0,0,0,0,0,0.140747176825178,81.3750425816968,16.8732632034619
9.7,"greedy_SVM","SVM",34,11,1584,1558,26,1200,954,246,0.817711700064647,0.184873949579832,1.26229330441854,583,246,337,35,1.4,43.1,3.9,0,0,0,0,0,0,0.165779634496822,90.4147625293555,18.7107808245016
9.7,"greedy_SVM","SVM",34,12,1484,1462,22,1300,1050,250,0.806234581744792,0.19327731092437,1.26229330441854,609,250,359,26,1.4,46.7,4.2,0,0,0,0,0,0,0.157979516284759,70.7396031373853,17.4870695405151
9.7,"greedy_SVM","SVM",34,13,1384,1364,20,1400,1148,252,0.803648932100319,0.19327731092437,1.26229330441854,631,252,379,22,1.5,50.29,4.6,0,0,0,0,0,0,0.150166419157556,77.8114392519723,16.8589399798035
9.7,"greedy_SVM","SVM",34,14,1284,1266,18,1500,1246,254,0.80416342361121,0.176470588235294,1.26229330441854,632,254,378,1,1.5,53.88,4.9,0,0,0,0,0,0,0.122704698499483,55.6508016598549,14.4640508926175
9.7,"greedy_SVM","SVM",34,15,1184,1166,18,1600,1346,254,0.793682308088077,0.201680672268908,1.26229330441854,650,254,396,18,1.6,57.47,5.3,0,0,0,0,0,0,0.0945717377814829,37.9927932637806,10.7837901256686
9.7,"greedy_SVM","SVM",34,16,1084,1067,17,1700,1445,255,0.790509610437588,0.184873949579832,1.26229330441854,656,255,401,6,1.6,61.06,5.7,0,0,0,0,0,0,0.0509388581165423,15.5510101591945,6.17660880809525
9.7,"greedy_SVM","SVM",34,17,984,967,17,1800,1545,255,0.795766658311684,0.210084033613445,1.26229330441854,656,255,401,0,1.6,64.66,6.1,0,0,0,0,0,0,0.0196424453014446,6.06917211303893,3.04631078685323
9.7,"greedy_SVM","SVM",34,18,884,868,16,1900,1644,256,0.809598564700611,0.226890756302521,1.26229330441854,657,256,401,1,1.6,68.25,6.4,0,0,0,0,0,0,0.00450716557492266,1.39853811075914,0.780207047255577
9.7,"greedy_SVM","SVM",34,19,784,773,11,2000,1739,261,0.775351899001362,0.184873949579832,1.27308213608024,657,261,396,0,1.5,71.84,6.7,0,0,0,0,0,0,0.106796909208347,35.9186803356979,12.83468805482
9.7,"greedy_SVM","SVM",34,20,684,676,8,2100,1836,264,0.794374892814271,0.184873949579832,1.27308213608024,709,264,445,52,1.7,75.43,7,0,0,0,0,0,0,0.0610597684013606,15.4870222659845,8.4287310300455
9.7,"greedy_SVM","SVM",34,21,584,582,2,2200,1930,270,0.804005118530932,0.252100840336134,1.27308213608024,721,270,451,12,1.7,79.02,7.1,0,0,0,0,0,0,0.0240189854919778,6.72007504715968,5.36646403114792
9.7,"greedy_SVM","SVM",34,22,484,483,1,2300,2029,271,0.804849412292392,0.226890756302521,1.27308213608024,721,271,450,0,1.7,82.61,7.5,0,0,0,0,0,0,0.0129322791251654,3.70206034178121,2.78462279809784
9.7,"greedy_SVM","SVM",34,23,384,384,0,2400,2128,272,0.803312533804733,0.210084033613445,1.28387096774194,741,272,469,20,1.7,86.21,7.8,0,0,0,0,0,0,0.0678969112434044,21.2434278175446,15.2010587089594
9.7,"greedy_SVM","SVM",34,24,284,284,0,2500,2228,272,0.816049496721769,0.294117647058824,1.27308213608024,748,272,476,7,1.8,89.8,8.2,0,0,0,0,0,0,0.00602331813490878,3.74654033715589,3.50264094120002
9.7,"greedy_SVM","SVM",34,25,184,184,0,2600,2328,272,0.803451050749972,0.210084033613445,1.27308213608024,715,272,443,-33,1.6,93.39,8.6,0,0,0,0,0,0,0.00056697419694779,0.353162471088124,0.333516481386151
9.7,"greedy_SVM","SVM",34,26,84,84,0,2700,2428,272,0.800265161009462,0.243697478991597,1.27308213608024,734,272,462,19,1.7,96.98,8.9,0,0,0,0,0,0,1.78962881355209e-06,0.0899327338124258,0.0899327338124258
9.7,"greedy_SVM","SVM",34,27,0,0,0,2784,2512,272,0.809756869780883,0.277310924369748,1.27308213608024,713,272,441,-21,1.6,100,9.2,0,0,0,0,0,0,0,0,0
9.7,"greedy_SVM","SVM",35,0,2684,2441,243,100,92,8,0.736797400524457,0.135714285714286,1.27470046082949,26,8,18,0,2.2,3.59,11.5,0,0,0,0,0,0,0.137982529761683,221.928344076295,15.1554750128756
9.7,"greedy_SVM","SVM",35,1,2584,2354,230,200,179,21,0.687395963972181,0.142857142857143,1.13714285714286,64,21,43,38,2,7.18,8.5,0,0,0,0,0,0,0.135707752872727,249.481347509519,15.1214950187039
9.7,"greedy_SVM","SVM",35,2,2484,2259,225,300,274,26,0.774370083228823,0.214285714285714,1.27470046082949,90,26,64,26,2.5,10.78,10.5,0,0,0,0,0,0,0.104674620910848,190.091723489769,10.9109747279389
9.7,"greedy_SVM","SVM",35,3,2384,2173,211,400,360,40,0.802189032037393,0.192857142857143,1.27470046082949,128,40,88,38,2.2,14.37,9,0,0,0,0,0,0,0.114207560813666,189.612635495254,11.5780320523277
9.7,"greedy_SVM","SVM",35,4,2284,2095,189,500,438,62,0.830167597765361,0.285714285714286,1.27470046082949,187,62,125,59,2,17.96,7.1,0,0,0,0,0,0,0.14797781842415,138.650667364998,15.1328319388889
9.7,"greedy_SVM","SVM",35,5,2184,2025,159,600,508,92,0.827020864211604,0.285714285714286,1.27470046082949,253,92,161,66,1.8,21.55,5.5,0,0,0,0,0,0,0.183284395322335,132.58302628651,18.7736207904478
9.7,"greedy_SVM","SVM",35,6,2084,1957,127,700,576,124,0.831701060312389,0.271428571428571,1.27470046082949,323,124,199,70,1.6,25.14,4.6,0,0,0,0,0,0,0.203762451016429,106.012123184379,21.751677710961
9.7,"greedy_SVM","SVM",35,7,1984,1892,92,800,641,159,0.824216166913691,0.264285714285714,1.27470046082949,407,159,248,84,1.6,28.74,4,0,0,0,0,0,0,0.204091752768691,126.777746121265,21.7145749793937
9.7,"greedy_SVM","SVM",35,8,1884,1811,73,900,722,178,0.800518754988027,0.157142857142857,1.27470046082949,458,178,280,51,1.6,32.33,4.1,0,0,0,0,0,0,0.181560618227936,77.7108191088293,21.1514799121398
9.7,"greedy_SVM","SVM",35,9,1784,1721,63,1000,812,188,0.812661042070455,0.235714285714286,1.27470046082949,502,188,314,44,1.7,35.92,4.3,0,0,0,0,0,0,0.146033976154425,61.0259681443857,16.7715027517291
9.7,"greedy_SVM","SVM",35,10,1684,1631,53,1100,902,198,0.823258465397327,0.264285714285714,1.27470046082949,526,198,328,24,1.7,39.51,4.6,0,0,0,0,0,0,0.140051916354936,74.0200598687234,18.19677432308
9.7,"greedy_SVM","SVM",35,11,1584,1545,39,1200,988,212,0.821571086535168,0.207142857142857,1.27470046082949,544,212,332,18,1.6,43.1,4.7,0,0,0,0,0,0,0.107056710470185,40.3479143272839,13.9749588732316
9.7,"greedy_SVM","SVM",35,12,1484,1456,28,1300,1077,223,0.825304982328122,0.242857142857143,1.27470046082949,585,223,362,41,1.6,46.7,4.8,0,0,0,0,0,0,0.117556100610546,47.5765278193634,14.7334204154423
9.7,"greedy_SVM","SVM",35,13,1384,1369,15,1400,1164,236,0.823554896819058,0.221428571428571,1.27470046082949,613,236,377,28,1.6,50.29,4.9,0,0,0,0,0,0,0.09823589571105,38.6315101358525,12.9878537780321
9.7,"greedy_SVM","SVM",35,14,1284,1272,12,1500,1261,239,0.828548626154377,0.271428571428571,1.27470046082949,611,239,372,-2,1.6,53.88,5.3,0,0,0,0,0,0,0.0736257952836153,29.7466758024665,10.6836146160229
9.7,"greedy_SVM","SVM",35,15,1184,1175,9,1600,1358,242,0.816052901607576,0.235714285714286,1.26552995391705,648,242,406,37,1.7,57.47,5.6,0,0,0,0,0,0,0.0994107075668685,47.7671199878287,13.363940356344
9.7,"greedy_SVM","SVM",35,16,1084,1078,6,1700,1455,245,0.812398814274312,0.207142857142857,1.27470046082949,648,245,403,0,1.6,61.06,5.9,0,0,0,0,0,0,0.0838690345338965,33.2019198410761,12.6579026530863
9.7,"greedy_SVM","SVM",35,17,984,979,5,1800,1554,246,0.825310682932393,0.278571428571429,1.27470046082949,670,246,424,22,1.7,64.66,6.3,0,0,0,0,0,0,0.0978259806141791,38.3103140329837,13.3108055464784
9.7,"greedy_SVM","SVM",35,18,884,879,5,1900,1654,246,0.8122905027933,0.285714285714286,1.28387096774194,683,246,437,13,1.8,68.25,6.7,0,0,0,0,0,0,0.0464991723390604,15.758477165983,6.39966961248229
9.7,"greedy_SVM","SVM",35,19,784,780,4,2000,1753,247,0.827830350017101,0.278571428571429,1.27470046082949,667,247,420,-16,1.7,71.84,7.1,0,0,0,0,0,0,0.0458937911887031,16.7797065411588,5.98788218983088
9.7,"greedy_SVM","SVM",35,20,684,682,2,2100,1851,249,0.780236005016534,0.157142857142857,1.27470046082949,676,249,427,9,1.7,75.43,7.4,0,0,0,0,0,0,0.0194600988098949,7.3221218052243,4.82284185520099
9.7,"greedy_SVM","SVM",35,21,584,582,2,2200,1951,249,0.825949150609969,0.307142857142857,1.27470046082949,691,249,442,15,1.8,79.02,7.8,0,0,0,0,0,0,0.0286562558809857,8.04772213450922,3.7379557044313
9.7,"greedy_SVM","SVM",35,22,484,482,2,2300,2051,249,0.77008892942652,0.2,1.27470046082949,674,249,425,-17,1.7,82.61,8.2,0,0,0,0,0,0,0.00296995736859023,0.90126787737049,0.692536773265279
9.7,"greedy_SVM","SVM",35,23,384,382,2,2400,2151,249,0.827950062706646,0.3,1.27470046082949,678,249,429,4,1.7,86.21,8.6,0,0,0,0,0,0,0.000411337358706603,0.146476295175451,0.125543017182953
9.7,"greedy_SVM","SVM",35,24,284,283,1,2500,2250,250,0.802120624786227,0.228571428571429,1.27470046082949,705,250,455,27,1.8,89.8,9,0,0,0,0,0,0,0.0398596434067946,13.4753446669926,11.7913550976498
9.7,"greedy_SVM","SVM",35,25,184,184,0,2600,2349,251,0.796670847109794,0.228571428571429,1.27470046082949,672,251,421,-33,1.7,93.39,9.4,0,0,0,0,0,0,0.00379641192229643,3.2587109766036,3.1614802462242
9.7,"greedy_SVM","SVM",35,26,84,84,0,2700,2449,251,0.744145479420819,0.171428571428571,1.26552995391705,715,251,464,43,1.8,96.98,9.8,0,0,0,0,0,0,1.0000000994736e-07,0.0288532591534492,0.0288532591534492
9.7,"greedy_SVM","SVM",35,27,0,0,0,2784,2533,251,0.741848135902406,0.164285714285714,1.24718894009217,692,251,441,-23,1.8,100,10.1,0,0,0,0,0,0,0,0,0
9.7,"greedy_SVM","SVM",36,0,2684,2439,245,100,91,9,0.693267934353062,0.313868613138686,1.09644454909348,24,9,15,0,1.7,3.59,10.1,0,0,0,0,0,0,0.130595800046316,241.561598015512,13.7280291621433
9.7,"greedy_SVM","SVM",36,1,2584,2372,212,200,158,42,0.687177460597895,0.116788321167883,1.23701436307982,109,42,67,85,1.6,7.18,3.8,0,0,0,0,0,0,0.257522702830578,517.1599292384,29.9913421667007
9.7,"greedy_SVM","SVM",36,2,2484,2281,203,300,249,51,0.673407062160028,0.175182481751825,1.17033646543265,129,51,78,20,1.5,10.78,4.9,0,0,0,0,0,0,0.352804194000805,389.182075178872,44.909846290847
9.7,"greedy_SVM","SVM",36,3,2384,2188,196,400,342,58,0.769549955832441,0.18978102189781,1.24638568401224,160,58,102,31,1.8,14.37,5.9,0,0,0,0,0,0,0.183620558516074,256.16760828932,19.9104586780017
9.7,"greedy_SVM","SVM",36,4,2284,2109,175,500,421,79,0.749569947463856,0.255474452554745,1.20890040028255,204,79,125,44,1.6,17.96,5.3,0,0,0,0,0,0,0.204020764795144,269.447994145464,25.6050484328984
9.7,"greedy_SVM","SVM",36,5,2184,2033,151,600,497,103,0.795306615835238,0.284671532846715,1.26512832587709,266,103,163,62,1.6,21.55,4.8,0,0,0,0,0,0,0.197462724168854,213.612144247465,20.4089278664312
9.7,"greedy_SVM","SVM",36,6,2084,1966,118,700,564,136,0.801350597424336,0.306569343065693,1.26512832587709,332,136,196,66,1.4,25.14,4.1,0,0,0,0,0,0,0.194119743901365,195.098445872553,20.5620111212653
9.7,"greedy_SVM","SVM",36,7,1984,1889,95,800,641,159,0.807382955971923,0.313868613138686,1.26512832587709,385,159,226,53,1.4,28.74,4,0,0,0,0,0,0,0.18007422797466,147.691591225154,19.3638537438742
9.7,"greedy_SVM","SVM",36,8,1884,1812,72,900,718,182,0.831378725184814,0.343065693430657,1.26512832587709,436,182,254,51,1.4,32.33,3.9,0,0,0,0,0,0,0.186986507347613,193.826057026912,19.9464267838448
9.7,"greedy_SVM","SVM",36,9,1784,1730,54,1000,800,200,0.83846296898973,0.364963503649635,1.26512832587709,481,200,281,45,1.4,35.92,4,0,0,0,0,0,0,0.173494621798488,130.279257643931,18.9633662427242
9.7,"greedy_SVM","SVM",36,10,1684,1643,41,1100,887,213,0.822760239899585,0.335766423357664,1.26512832587709,516,213,303,35,1.4,39.51,4.2,0,0,0,0,0,0,0.165412786548438,110.539434661274,18.9234004964994
9.7,"greedy_SVM","SVM",36,11,1584,1550,34,1200,980,220,0.810834999302624,0.262773722627737,1.26512832587709,546,220,326,30,1.5,43.1,4.5,0,0,0,0,0,0,0.163127602109394,110.239401210684,17.7120185200018
9.7,"greedy_SVM","SVM",36,12,1484,1455,29,1300,1075,225,0.818285368915346,0.299270072992701,1.26396338266726,582,225,357,36,1.6,46.7,4.8,0,0,0,0,0,0,0.139717252022095,65.188243133046,16.1352652762669
9.7,"greedy_SVM","SVM",36,13,1384,1363,21,1400,1167,233,0.830018829327266,0.357664233576642,1.27449964680951,608,233,375,26,1.6,50.29,5,0,0,0,0,0,0,0.142223637551559,75.6598883473334,15.6364171761674
9.7,"greedy_SVM","SVM",36,14,1284,1269,15,1500,1261,239,0.813769817285789,0.291970802919708,1.24638568401224,637,239,398,29,1.7,53.88,5.3,0,0,0,0,0,0,0.140937691646265,93.1065841680347,15.0108628548902
9.7,"greedy_SVM","SVM",36,15,1184,1171,13,1600,1359,241,0.819959086893864,0.328467153284672,1.25575700494467,632,241,391,-5,1.6,57.47,5.6,0,0,0,0,0,0,0.094267209428991,36.8365999154422,11.4200873244557
9.7,"greedy_SVM","SVM",36,16,1084,1072,12,1700,1458,242,0.810695522804415,0.284671532846715,1.25575700494467,652,242,410,20,1.7,61.06,6,0,0,0,0,0,0,0.0292359819491069,8.73655017090981,4.61635844011762
9.7,"greedy_SVM","SVM",36,17,984,973,11,1800,1557,243,0.796445673903953,0.284671532846715,1.26512832587709,644,243,401,-8,1.7,64.66,6.4,0,0,0,0,0,0,0.0457130399811078,17.3064146058734,5.67102628572586
9.7,"greedy_SVM","SVM",36,18,884,873,11,1900,1657,243,0.827793016876662,0.321167883211679,1.25575700494467,641,243,398,-3,1.6,68.25,6.8,0,0,0,0,0,0,0.00819030012827587,2.58553658916492,1.4760712705322
9.7,"greedy_SVM","SVM",36,19,784,773,11,2000,1757,243,0.814577618671262,0.27007299270073,1.26512832587709,641,243,398,0,1.6,71.84,7.2,0,0,0,0,0,0,0.00242616374618775,0.749600817704046,0.476386601117295
9.7,"greedy_SVM","SVM",36,20,684,678,6,2100,1852,248,0.777970849411877,0.197080291970803,1.27449964680951,664,248,416,23,1.7,75.43,7.5,0,0,0,0,0,0,0.106987921376164,31.911891027084,14.7239706526401
9.7,"greedy_SVM","SVM",36,21,584,580,4,2200,1950,250,0.809585522339488,0.218978102189781,1.27449964680951,709,250,459,45,1.8,79.02,7.8,0,0,0,0,0,0,0.0825670031785659,21.465728630392,10.6477354484778
9.7,"greedy_SVM","SVM",36,22,484,482,2,2300,2048,252,0.798131014923991,0.211678832116788,1.27449964680951,704,252,452,-5,1.8,82.61,8.1,0,0,0,0,0,0,0.0424345427525255,9.6109075825744,6.6179926992149
9.7,"greedy_SVM","SVM",36,23,384,384,0,2400,2146,254,0.780719698730764,0.240875912408759,1.27449964680951,690,254,436,-14,1.7,86.21,8.4,0,0,0,0,0,0,0.0503870411064892,15.1243037141674,11.578559493247
9.7,"greedy_SVM","SVM",36,24,284,284,0,2500,2246,254,0.765778278860015,0.204379562043796,1.26512832587709,704,254,450,14,1.8,89.8,8.8,0,0,0,0,0,0,0.00632567235830328,2.83104625657099,2.63150449232098
9.7,"greedy_SVM","SVM",36,25,184,184,0,2600,2346,254,0.812456413594309,0.27007299270073,1.27449964680951,706,254,452,2,1.8,93.39,9.2,0,0,0,0,0,0,0.000114136817881331,0.097792886481705,0.0942264612201076
9.7,"greedy_SVM","SVM",36,26,84,84,0,2700,2446,254,0.78293969966061,0.218978102189781,1.27449964680951,696,254,442,-10,1.7,96.98,9.6,0,0,0,0,0,0,3.33342349039298e-06,0.0220448478832851,0.0220448478832851
9.7,"greedy_SVM","SVM",36,27,0,0,0,2784,2530,254,0.820900553256781,0.299270072992701,1.27449964680951,714,254,460,18,1.8,100,10,0,0,0,0,0,0,0,0,0
9.7,"greedy_SVM","SVM",37,0,2684,2439,245,100,90,10,0.803266413964159,0.286764705882353,1.27443074003795,30,10,20,0,2,3.59,9,0,0,0,0,0,0,0.153870694419222,260.736389695063,16.8521763068293
9.7,"greedy_SVM","SVM",37,1,2584,2373,211,200,156,44,0.690538864710568,0.161764705882353,1.246110056926,109,44,65,79,1.5,7.18,3.5,0,0,0,0,0,0,0.240846413239449,512.571274051443,26.6922723191975
9.7,"greedy_SVM","SVM",37,2,2484,2285,199,300,244,56,0.610422808741632,0.0882352941176471,1.13282732447818,149,56,93,40,1.7,10.78,4.4,0,0,0,0,0,0,0.214275462990543,352.640481668969,23.0173697015251
9.7,"greedy_SVM","SVM",37,3,2384,2189,195,400,340,60,0.724589358416398,0.264705882352941,1.20834914611006,153,60,93,4,1.6,14.37,5.7,0,0,0,0,0,0,0.184518790051293,212.542034905972,19.4501658444478
9.7,"greedy_SVM","SVM",37,4,2284,2118,166,500,411,89,0.694955309092612,0.294117647058824,1.1800284629981,214,89,125,61,1.4,17.96,4.6,0,0,0,0,0,0,0.1886521416135,218.267245806278,19.5695684662813
9.7,"greedy_SVM","SVM",37,5,2184,2040,144,600,489,111,0.702928307361131,0.286764705882353,1.16114800759013,266,111,155,52,1.4,21.55,4.4,0,0,0,0,0,0,0.173877005066919,154.73120794335,18.5142233373377
9.7,"greedy_SVM","SVM",37,6,2084,1966,118,700,563,137,0.725443399316768,0.308823529411765,1.18946869070209,326,137,189,60,1.4,25.14,4.1,0,0,0,0,0,0,0.184291469188117,151.963522953831,19.5065306543028
9.7,"greedy_SVM","SVM",37,7,1984,1885,99,800,644,156,0.757083859796908,0.279411764705882,1.19890891840607,370,156,214,44,1.4,28.74,4.1,0,0,0,0,0,0,0.187963028104422,175.117483081316,19.7955718870187
9.7,"greedy_SVM","SVM",37,8,1884,1810,74,900,719,181,0.775697271748795,0.301470588235294,1.20834914611006,437,181,256,67,1.4,32.33,4,0,0,0,0,0,0,0.186135547205822,174.138323926019,19.6728321783848
9.7,"greedy_SVM","SVM",37,9,1784,1725,59,1000,804,196,0.778499227853434,0.279411764705882,1.20834914611006,469,196,273,32,1.4,35.92,4.1,0,0,0,0,0,0,0.163076237478159,109.245082802459,17.4573976197485
9.7,"greedy_SVM","SVM",37,10,1684,1635,49,1100,894,206,0.784477514156017,0.242647058823529,1.20834914611006,500,206,294,31,1.4,39.51,4.3,0,0,0,0,0,0,0.152516221425604,103.205403524064,16.933479986415
9.7,"greedy_SVM","SVM",37,11,1584,1549,35,1200,980,220,0.791368337311055,0.227941176470588,1.20834914611006,539,220,319,39,1.4,43.1,4.5,0,0,0,0,0,0,0.147616304812035,91.9023974293436,16.8323492854153
9.7,"greedy_SVM","SVM",37,12,1484,1462,22,1300,1067,233,0.808607094389064,0.294117647058824,1.20834914611006,588,233,355,49,1.5,46.7,4.6,0,0,0,0,0,0,0.108693550664603,52.2545798702014,13.7282074244586
9.7,"greedy_SVM","SVM",37,13,1384,1364,20,1400,1165,235,0.789209836679297,0.205882352941176,1.20834914611006,596,235,361,8,1.5,50.29,5,0,0,0,0,0,0,0.0786482889191391,36.9158003207779,9.25773119429513
9.7,"greedy_SVM","SVM",37,14,1284,1264,20,1500,1265,235,0.788917356918898,0.235294117647059,1.21778937381404,602,235,367,6,1.6,53.88,5.4,0,0,0,0,0,0,0.0543252884400516,21.9965989835933,6.80585419144243
9.7,"greedy_SVM","SVM",37,15,1184,1165,19,1600,1364,236,0.796223501333703,0.242647058823529,1.21778937381404,603,236,367,1,1.6,57.47,5.8,0,0,0,0,0,0,0.061529513921627,23.6049210848528,8.60438329166665
9.7,"greedy_SVM","SVM",37,16,1084,1065,19,1700,1464,236,0.804114605269311,0.272058823529412,1.21778937381404,607,236,371,4,1.6,61.06,6.2,0,0,0,0,0,0,0.0404126632473186,15.6909575508609,5.37375827771917
9.7,"greedy_SVM","SVM",37,17,984,966,18,1800,1563,237,0.794222939772564,0.264705882352941,1.21778937381404,617,237,380,10,1.6,64.66,6.6,0,0,0,0,0,0,0.0723012538325255,21.0186646770098,12.0690324945903
9.7,"greedy_SVM","SVM",37,18,884,866,18,1900,1663,237,0.784676400393089,0.242647058823529,1.21778937381404,610,237,373,-7,1.6,68.25,7,0,0,0,0,0,0,0.0250157805587894,7.63945326303279,4.03375237148369
9.7,"greedy_SVM","SVM",37,19,784,766,18,2000,1763,237,0.761623145678314,0.220588235294118,1.21778937381404,616,237,379,6,1.6,71.84,7.4,0,0,0,0,0,0,0.0159045428913173,4.5765887462808,2.42952639398996
9.7,"greedy_SVM","SVM",37,20,684,668,16,2100,1861,239,0.778528475829469,0.213235294117647,1.21778937381404,625,239,386,9,1.6,75.43,7.8,0,0,0,0,0,0,0.0139049405718546,4.42314501125241,2.34090327508772
9.7,"greedy_SVM","SVM",37,21,584,571,13,2200,1958,242,0.8111165707333,0.301470588235294,1.22722960151803,626,242,384,1,1.6,79.02,8.1,0,0,0,0,0,0,0.01100041578823,3.56221259002568,1.94145187170407
9.7,"greedy_SVM","SVM",37,22,484,477,7,2300,2052,248,0.791959146427067,0.264705882352941,1.20834914611006,653,248,405,27,1.6,82.61,8.3,0,0,0,0,0,0,0.0294154104595828,12.1008888945732,9.61450514810967
9.7,"greedy_SVM","SVM",37,23,384,378,6,2400,2151,249,0.777276662454952,0.213235294117647,1.22722960151803,649,249,400,-4,1.6,86.21,8.6,0,0,0,0,0,0,0.0122726740313965,8.91723568711037,7.84684131904704
9.7,"greedy_SVM","SVM",37,24,284,279,5,2500,2250,250,0.780868313912676,0.213235294117647,1.22722960151803,650,250,400,1,1.6,89.8,9,0,0,0,0,0,0,0.00303346907202977,0.927407997151354,0.732112821437272
9.7,"greedy_SVM","SVM",37,25,184,182,2,2600,2347,253,0.796632972998274,0.257352941176471,1.27443074003795,693,253,440,43,1.7,93.39,9.3,0,0,0,0,0,0,0.00581036841590495,3.47416379621045,3.30891244003879
9.7,"greedy_SVM","SVM",37,26,84,84,0,2700,2445,255,0.818791239646223,0.286764705882353,1.26499051233397,676,255,421,-17,1.7,96.98,9.6,0,0,0,0,0,0,5.4048864670497e-05,0.15084818830913,0.15084818830913
9.7,"greedy_SVM","SVM",37,27,0,0,0,2784,2529,255,0.814731620571859,0.272058823529412,1.27443074003795,705,255,450,29,1.8,100,9.9,0,0,0,0,0,0,0,0,0
9.7,"greedy_SVM","SVM",38,0,2684,2422,262,100,91,9,0.794619010212096,0.183333333333333,1.26247311827957,28,9,19,0,2.1,3.59,10.1,0,0,0,0,0,0,0.136276218808001,241.070226121318,16.2414332089668
9.7,"greedy_SVM","SVM",38,1,2584,2346,238,200,167,33,0.79702801780571,0.191666666666667,1.25177419354839,81,33,48,53,1.5,7.18,5.1,0,0,0,0,0,0,0.212943191709187,262.707106218148,23.9490287576871
9.7,"greedy_SVM","SVM",38,2,2484,2273,211,300,240,60,0.808012568735258,0.25,1.27317204301075,156,60,96,75,1.6,10.78,4,0,0,0,0,0,0,0.23971183014795,258.034563532737,25.4157393736692
9.7,"greedy_SVM","SVM",38,3,2384,2197,187,400,316,84,0.799410840534155,0.25,1.27317204301075,209,84,125,53,1.5,14.37,3.8,0,0,0,0,0,0,0.228767649524437,294.083775759173,23.2653857128371
9.7,"greedy_SVM","SVM",38,4,2284,2130,154,500,383,117,0.790213406650946,0.241666666666667,1.26247311827957,287,117,170,78,1.5,17.96,3.3,0,0,0,0,0,0,0.24366692500405,264.363478239388,24.9728253541352
9.7,"greedy_SVM","SVM",38,5,2184,2059,125,600,454,146,0.801839486776635,0.258333333333333,1.26247311827957,350,146,204,63,1.4,21.55,3.1,0,0,0,0,0,0,0.248521359565598,278.966678002967,25.3823899961771
9.7,"greedy_SVM","SVM",38,6,2084,1985,99,700,528,172,0.796995286724261,0.233333333333333,1.26247311827957,413,172,241,63,1.4,25.14,3.1,0,0,0,0,0,0,0.242303751239722,247.772518498327,24.943044101342
9.7,"greedy_SVM","SVM",38,7,1984,1907,77,800,606,194,0.799345378371291,0.258333333333333,1.26247311827957,486,194,292,73,1.5,28.74,3.1,0,0,0,0,0,0,0.222461119644845,165.478883924395,23.6610019776072
9.7,"greedy_SVM","SVM",38,8,1884,1831,53,900,682,218,0.778482587064675,0.2,1.21967741935484,542,218,324,56,1.5,32.33,3.1,0,0,0,0,0,0,0.229980388882289,188.673456959925,24.1648562365549
9.7,"greedy_SVM","SVM",38,9,1784,1738,46,1000,775,225,0.782469232783448,0.183333333333333,1.25177419354839,556,225,331,14,1.5,35.92,3.4,0,0,0,0,0,0,0.192527479327367,167.810521103714,21.0159538642216
9.7,"greedy_SVM","SVM",38,10,1684,1649,35,1100,864,236,0.779169939774808,0.183333333333333,1.20897849462366,570,236,334,14,1.4,39.51,3.7,0,0,0,0,0,0,0.216338375344602,188.492462947481,36.7669393840682
9.7,"greedy_SVM","SVM",38,11,1584,1561,23,1200,952,248,0.806997905210776,0.233333333333333,1.27317204301075,599,248,351,29,1.4,43.1,3.8,0,0,0,0,0,0,0.161315085462419,84.1334034610836,18.1117453509062
9.7,"greedy_SVM","SVM",38,12,1484,1465,19,1300,1048,252,0.807312123592551,0.225,1.27317204301075,615,252,363,16,1.4,46.7,4.2,0,0,0,0,0,0,0.105050942850522,40.2615274955497,12.6992095423011
9.7,"greedy_SVM","SVM",38,13,1384,1367,17,1400,1146,254,0.770064152919613,0.125,1.21743330266789,612,254,358,-3,1.4,50.29,4.5,0,0,0,0,0,0,0.255499877205587,104.870485783595,43.6068712503769
9.7,"greedy_SVM","SVM",38,14,1284,1268,16,1500,1245,255,0.814290390154487,0.291666666666667,1.23037634408602,620,255,365,8,1.4,53.88,4.9,0,0,0,0,0,0,0.058706684572223,20.3281462232324,8.24004467014684
9.7,"greedy_SVM","SVM",38,15,1184,1171,13,1600,1342,258,0.794671379942396,0.191666666666667,1.21967741935484,636,258,378,16,1.5,57.47,5.2,0,0,0,0,0,0,0.126957152149734,49.3644844026276,15.3559742910105
9.7,"greedy_SVM","SVM",38,16,1084,1071,13,1700,1442,258,0.79450772453522,0.183333333333333,1.21967741935484,643,258,385,7,1.5,61.06,5.6,0,0,0,0,0,0,0.0617654757981862,20.2515828624895,7.89213911186575
9.7,"greedy_SVM","SVM",38,17,984,971,13,1800,1542,258,0.800877192982459,0.233333333333333,1.21967741935484,645,258,387,2,1.5,64.66,6,0,0,0,0,0,0,0.078433611028331,35.875732137323,8.75476514918746
9.7,"greedy_SVM","SVM",38,18,884,871,13,1900,1642,258,0.793918565069393,0.208333333333333,1.21967741935484,646,258,388,1,1.5,68.25,6.4,0,0,0,0,0,0,0.0389000315323974,13.6547267517673,4.92641839672745
9.7,"greedy_SVM","SVM",38,19,784,771,13,2000,1742,258,0.811344592825349,0.25,1.21967741935484,644,258,386,-2,1.5,71.84,6.8,0,0,0,0,0,0,0.00490348862521012,1.47876125823958,0.854573672426923
9.7,"greedy_SVM","SVM",38,20,684,675,9,2100,1838,262,0.805348258706466,0.225,1.26247311827957,671,262,409,27,1.6,75.43,7,0,0,0,0,0,0,0.00999816430186506,3.23738216240948,1.8937203384549
9.7,"greedy_SVM","SVM",38,21,584,579,5,2200,1934,266,0.814997381513474,0.2,1.27317204301075,678,266,412,7,1.5,79.02,7.3,0,0,0,0,0,0,0.0078806673724819,4.46916942851016,3.80994665873137
9.7,"greedy_SVM","SVM",38,22,484,483,1,2300,2030,270,0.807403770620572,0.183333333333333,1.27317204301075,685,270,415,7,1.5,82.61,7.5,0,0,0,0,0,0,0.00638178443621763,6.12629443653515,5.57423344075751
9.7,"greedy_SVM","SVM",38,23,384,383,1,2400,2130,270,0.81570437287247,0.225,1.27317204301075,699,270,429,14,1.6,86.21,7.9,0,0,0,0,0,0,0.00742177025809859,2.11349975245092,1.38277684016386
9.7,"greedy_SVM","SVM",38,24,284,284,0,2500,2229,271,0.795803875360042,0.175,1.28387096774194,701,271,430,2,1.6,89.8,8.2,0,0,0,0,0,0,0.0226766006401986,16.1120288223283,14.9534038891315
9.7,"greedy_SVM","SVM",38,25,184,184,0,2600,2329,271,0.82697695731867,0.216666666666667,1.28387096774194,706,271,435,5,1.6,93.39,8.6,0,0,0,0,0,0,0.000512024642440838,0.334156601227786,0.321031951945367
9.7,"greedy_SVM","SVM",38,26,84,84,0,2700,2429,271,0.793558523173601,0.175,1.27317204301075,712,271,441,6,1.6,96.98,9,0,0,0,0,0,0,9.39853888613642e-06,0.0490136877896881,0.0490136877896881
9.7,"greedy_SVM","SVM",38,27,0,0,0,2784,2513,271,0.82249934537837,0.241666666666667,1.28387096774194,706,271,435,-6,1.6,100,9.3,0,0,0,0,0,0,0,0,0
9.7,"greedy_SVM","SVM",39,0,2684,2423,261,100,91,9,0.794512448671969,0.371900826446281,1.18837643295121,21,9,12,0,1.3,3.59,10.1,0,0,0,0,0,0,0.274954271881792,239.951204332016,30.5045505041809
9.7,"greedy_SVM","SVM",39,1,2584,2361,223,200,153,47,0.790672592130571,0.214876033057851,1.26264996001066,102,47,55,81,1.2,7.18,3.3,0,0,0,0,0,0,0.318881052284979,426.9531078331,35.7142667830649
9.7,"greedy_SVM","SVM",39,2,2484,2283,201,300,231,69,0.772993658714071,0.223140495867769,1.24142895227939,159,69,90,57,1.3,10.78,3.3,0,0,0,0,0,0,0.256849312051008,364.223259033147,29.3582636400232
9.7,"greedy_SVM","SVM",39,3,2384,2190,194,400,324,76,0.821826758147514,0.272727272727273,1.2732604638763,177,76,101,18,1.3,14.37,4.3,0,0,0,0,0,0,0.217534015398447,226.009950236587,22.4997250328687
9.7,"greedy_SVM","SVM",39,4,2284,2119,165,500,395,105,0.825419720359683,0.272727272727273,1.2732604638763,259,105,154,82,1.5,17.96,3.8,0,0,0,0,0,0,0.225835426628311,161.798737571315,24.1333476913521
9.7,"greedy_SVM","SVM",39,5,2184,2047,137,600,467,133,0.825159831592069,0.322314049586777,1.2732604638763,323,133,190,64,1.4,21.55,3.5,0,0,0,0,0,0,0.241241597275986,175.379898801076,27.0939843056095
9.7,"greedy_SVM","SVM",39,6,2084,1978,106,700,536,164,0.787735849056604,0.256198347107438,1.23081844841376,389,164,225,66,1.4,25.14,3.3,0,0,0,0,0,0,0.245512017652156,193.993271258551,30.2614455775913
9.7,"greedy_SVM","SVM",39,7,1984,1894,90,800,620,180,0.683877800301468,0.132231404958678,1.06105038656358,432,180,252,43,1.4,28.74,3.4,0,0,0,0,0,0,0.438628916777063,276.965452439588,70.437655332656
9.7,"greedy_SVM","SVM",39,8,1884,1815,69,900,699,201,0.786878216123503,0.322314049586777,1.24142895227939,477,201,276,45,1.4,32.33,3.5,0,0,0,0,0,0,0.225220466349747,96.8689663985422,23.5716303521386
9.7,"greedy_SVM","SVM",39,9,1784,1725,59,1000,789,211,0.782655023649884,0.289256198347107,1.22020794454812,507,211,296,30,1.4,35.92,3.7,0,0,0,0,0,0,0.174734235323849,59.487095053133,19.662469122248
9.7,"greedy_SVM","SVM",39,10,1684,1627,57,1100,887,213,0.792322885804882,0.289256198347107,1.24142895227939,511,213,298,4,1.4,39.51,4.2,0,0,0,0,0,0,0.0387747220585032,13.7936229338832,10.7239812482505
9.7,"greedy_SVM","SVM",39,11,1584,1531,53,1200,983,217,0.792134466448361,0.256198347107438,1.25203945614503,514,217,297,3,1.4,43.1,4.5,0,0,0,0,0,0,0.0714681266132873,35.6640068024676,10.0914709617627
9.7,"greedy_SVM","SVM",39,12,1484,1442,42,1300,1072,228,0.79711133634804,0.223140495867769,1.24142895227939,570,228,342,56,1.5,46.7,4.7,0,0,0,0,0,0,0.0993741235731031,25.436601028867,14.5389712683465
9.7,"greedy_SVM","SVM",39,13,1384,1355,29,1400,1159,241,0.796013306304895,0.247933884297521,1.23081844841376,607,241,366,37,1.5,50.29,4.8,0,0,0,0,0,0,0.163835388873027,62.7297458370498,17.4797049214105
9.7,"greedy_SVM","SVM",39,14,1284,1261,23,1500,1253,247,0.798326316336601,0.239669421487603,1.23081844841376,632,247,385,25,1.6,53.88,5.1,0,0,0,0,0,0,0.122947487647646,33.0415848673031,15.0122955249461
9.7,"greedy_SVM","SVM",39,15,1184,1163,21,1600,1351,249,0.761662508446383,0.140495867768595,1.23081844841376,654,249,405,22,1.6,57.47,5.4,0,0,0,0,0,0,0.143422782098951,47.7345434178605,15.8104607824007
9.7,"greedy_SVM","SVM",39,16,1084,1064,20,1700,1450,250,0.757666718644422,0.15702479338843,1.23081844841376,659,250,409,5,1.6,61.06,5.8,0,0,0,0,0,0,0.144027733277927,57.8566597654765,14.9490198627452
9.7,"greedy_SVM","SVM",39,17,984,966,18,1800,1548,252,0.732886324653048,0.140495867768595,1.22020794454812,689,252,437,30,1.7,64.66,6.1,0,0,0,0,0,0,0.138257935522981,32.2726035917152,15.3571617234408
9.7,"greedy_SVM","SVM",39,18,884,866,18,1900,1648,252,0.751059046727997,0.140495867768595,1.23081844841376,685,252,433,-4,1.7,68.25,6.5,0,0,0,0,0,0,0.102591444286463,17.4153977400604,11.899894215089
9.7,"greedy_SVM","SVM",39,19,784,767,17,2000,1747,253,0.76424190446489,0.15702479338843,1.23081844841376,683,253,430,-2,1.7,71.84,6.9,0,0,0,0,0,0,7.01113387695816e-06,4.0762662496541,4.07620146513664
9.7,"greedy_SVM","SVM",39,20,684,669,15,2100,1845,255,0.759856281511515,0.140495867768595,1.23081844841376,681,255,426,-2,1.7,75.43,7.2,0,0,0,0,0,0,3.84510271482823e-06,0.300502747253002,0.300350626901867
9.7,"greedy_SVM","SVM",39,21,584,573,11,2200,1941,259,0.775787462965853,0.173553719008264,1.25203945614503,687,259,428,6,1.7,79.02,7.5,0,0,0,0,0,0,1.17325074726375e-08,0.0392676407922805,0.0392672583852458
9.7,"greedy_SVM","SVM",39,22,484,479,5,2300,2035,265,0.744899682935706,0.132231404958678,1.28387096774194,714,265,449,27,1.7,82.61,7.7,0,0,0,0,0,0,0.0588156669602097,20.321241520094,10.0703490036368
9.7,"greedy_SVM","SVM",39,23,384,381,3,2400,2133,267,0.774403555278343,0.165289256198347,1.28387096774194,709,267,442,-5,1.7,86.21,8,0,0,0,0,0,0,0.0458659800625136,13.148446782692,7.71065177303493
9.7,"greedy_SVM","SVM",39,24,284,282,2,2500,2232,268,0.761266178075789,0.181818181818182,1.25203945614503,731,268,463,22,1.7,89.8,8.3,0,0,0,0,0,0,0.0606812084642564,14.6295637508156,9.19709036203172
9.7,"greedy_SVM","SVM",39,25,184,182,2,2600,2332,268,0.794564426425493,0.15702479338843,1.2732604638763,735,268,467,4,1.7,93.39,8.7,0,0,0,0,0,0,0.0253403660327724,5.35231499218324,4.03698245400155
9.7,"greedy_SVM","SVM",39,26,84,84,0,2700,2430,270,0.809352097302355,0.198347107438017,1.28387096774194,744,270,474,9,1.8,96.98,9,0,0,0,0,0,0,1.3804176876381e-08,2.90852800959341,2.90852800959341
9.7,"greedy_SVM","SVM",39,27,0,0,0,2784,2514,270,0.758511357139146,0.140495867768595,1.28387096774194,726,270,456,-18,1.7,100,9.3,0,0,0,0,0,0,0,0,0
9.7,"greedy_SVM","SVM",40,0,2684,2425,259,100,91,9,0.782299468663982,0.195121951219512,1.27343299239444,30,9,21,0,2.3,3.59,10.1,0,0,0,0,0,0,0.101268160697945,243.000099294373,10.6367515153145
9.7,"greedy_SVM","SVM",40,1,2584,2337,247,200,179,21,0.75007361884643,0.300813008130081,1.22124311565696,64,21,43,34,2,7.18,8.5,0,0,0,0,0,0,0.122698288071688,260.702014662943,12.9024978191977
9.7,"greedy_SVM","SVM",40,2,2484,2272,212,300,244,56,0.727731899366242,0.219512195121951,1.25255704169945,138,56,82,74,1.5,10.78,4.4,0,0,0,0,0,0,0.198799902209463,433.665939855034,20.6511421926894
9.7,"greedy_SVM","SVM",40,3,2384,2186,198,400,330,70,0.730759874527883,0.203252032520325,1.21080514030947,183,70,113,45,1.6,14.37,4.7,0,0,0,0,0,0,0.202471149788351,358.968721017146,24.3678724522425
9.7,"greedy_SVM","SVM",40,4,2284,2101,183,500,415,85,0.725644965111067,0.186991869918699,1.24211906635195,220,85,135,37,1.6,17.96,4.9,0,0,0,0,0,0,0.183586532636244,313.214289044797,19.3652998991707
9.7,"greedy_SVM","SVM",40,5,2184,2010,174,600,506,94,0.775769797068062,0.235772357723577,1.23168109100446,248,94,154,28,1.6,21.55,5.4,0,0,0,0,0,0,0.175631016892764,178.747004746125,18.0790831424522
9.7,"greedy_SVM","SVM",40,6,2084,1936,148,700,580,120,0.784418411113257,0.276422764227642,1.23168109100446,305,120,185,57,1.5,25.14,4.8,0,0,0,0,0,0,0.191541024913875,186.864961062209,19.9478040512277
9.7,"greedy_SVM","SVM",40,7,1984,1877,107,800,639,161,0.786959861724616,0.284552845528455,1.23168109100446,395,161,234,90,1.5,28.74,4,0,0,0,0,0,0,0.21063574089874,199.326297489341,21.4330217822269
9.7,"greedy_SVM","SVM",40,8,1884,1806,78,900,710,190,0.790058254913272,0.284552845528455,1.23168109100446,459,190,269,64,1.4,32.33,3.7,0,0,0,0,0,0,0.213509199159824,192.977519107266,21.8733538160351
9.7,"greedy_SVM","SVM",40,9,1784,1728,56,1000,788,212,0.792042762947329,0.268292682926829,1.23168109100446,516,212,304,57,1.4,35.92,3.7,0,0,0,0,0,0,0.199511887740155,157.396683777629,20.7982759974329
9.7,"greedy_SVM","SVM",40,10,1684,1641,43,1100,875,225,0.790128672940288,0.276422764227642,1.23168109100446,543,225,318,27,1.4,39.51,3.9,0,0,0,0,0,0,0.185179664826831,107.769711039958,19.697152462407
9.7,"greedy_SVM","SVM",40,11,1584,1551,33,1200,965,235,0.804673196338276,0.24390243902439,1.23168109100446,577,235,342,34,1.5,43.1,4.1,0,0,0,0,0,0,0.191152857852302,211.873512430648,19.4070155977823
9.7,"greedy_SVM","SVM",40,12,1484,1459,25,1300,1057,243,0.802042122783449,0.24390243902439,1.23168109100446,594,243,351,17,1.4,46.7,4.3,0,0,0,0,0,0,0.160876531547657,79.3830386575883,17.192702000139
9.7,"greedy_SVM","SVM",40,13,1384,1362,22,1400,1154,246,0.794757057806817,0.252032520325203,1.23168109100446,614,246,368,20,1.5,50.29,4.7,0,0,0,0,0,0,0.129689248180132,66.3454314014851,14.2298050777587
9.7,"greedy_SVM","SVM",40,14,1284,1264,20,1500,1252,248,0.809826515587999,0.300813008130081,1.22124311565696,617,248,369,3,1.5,53.88,5,0,0,0,0,0,0,0.0937407749144339,38.589001043265,11.3589657976245
9.7,"greedy_SVM","SVM",40,15,1184,1165,19,1600,1351,249,0.796965623199536,0.24390243902439,1.20036716496197,624,249,375,7,1.5,57.47,5.4,0,0,0,0,0,0,0.103472042976814,43.1173275729449,12.9058909747675
9.7,"greedy_SVM","SVM",40,16,1084,1066,18,1700,1450,250,0.793195057934832,0.260162601626016,1.20036716496197,635,250,385,11,1.5,61.06,5.8,0,0,0,0,0,0,0.0564846615335267,16.8495854549128,7.71779582573285
9.7,"greedy_SVM","SVM",40,17,984,966,18,1800,1550,250,0.779617181998593,0.227642276422764,1.21080514030947,630,250,380,-5,1.5,64.66,6.2,0,0,0,0,0,0,0.0739531521748899,30.2783948670335,8.40447865677481
9.7,"greedy_SVM","SVM",40,18,884,866,18,1900,1650,250,0.788054541962742,0.24390243902439,1.21080514030947,626,250,376,-4,1.5,68.25,6.6,0,0,0,0,0,0,0.0225103900094404,6.89002105691775,3.17979803404898
9.7,"greedy_SVM","SVM",40,19,784,768,16,2000,1748,252,0.787600025606558,0.227642276422764,1.21080514030947,637,252,385,11,1.5,71.84,6.9,0,0,0,0,0,0,0.0172779385349484,4.39741415259648,2.2220107253225
9.7,"greedy_SVM","SVM",40,20,684,669,15,2100,1847,253,0.784975353690552,0.260162601626016,1.21080514030947,651,253,398,14,1.6,75.43,7.3,0,0,0,0,0,0,0.00694704547242621,2.26595568710109,1.31802382533231
9.7,"greedy_SVM","SVM",40,21,584,571,13,2200,1945,255,0.795902951155504,0.227642276422764,1.21080514030947,651,255,396,0,1.6,79.02,7.6,0,0,0,0,0,0,0.00570383005953137,1.67489141299143,0.865576825501077
9.7,"greedy_SVM","SVM",40,22,484,473,11,2300,2043,257,0.802387811279693,0.260162601626016,1.22124311565696,668,257,411,17,1.6,82.61,7.9,0,0,0,0,0,0,0.0221476767080688,8.30248186729953,6.87338188149626
9.7,"greedy_SVM","SVM",40,23,384,373,11,2400,2143,257,0.802080532616355,0.268292682926829,1.22124311565696,655,257,398,-13,1.5,86.21,8.3,0,0,0,0,0,0,0.00202793114631842,0.641677576576264,0.486909445755573
9.7,"greedy_SVM","SVM",40,24,284,276,8,2500,2240,260,0.781076755649453,0.211382113821138,1.22124311565696,674,260,414,19,1.6,89.8,8.6,0,0,0,0,0,0,0.00480548948239689,1.17728309435013,0.765599514516763
9.7,"greedy_SVM","SVM",40,25,184,179,5,2600,2337,263,0.804378720952576,0.235772357723577,1.25255704169945,687,263,424,13,1.6,93.39,8.9,0,0,0,0,0,0,0.00627314800415701,1.83998545698529,1.58549061508046
9.7,"greedy_SVM","SVM",40,26,84,84,0,2700,2432,268,0.785487484796115,0.235772357723577,1.27343299239444,718,268,450,31,1.7,96.98,9.1,0,0,0,0,0,0,2.39256325435023e-05,0.772996209328676,0.772996209328676
9.7,"greedy_SVM","SVM",40,27,0,0,0,2784,2516,268,0.816170539658156,0.235772357723577,1.27343299239444,729,268,461,11,1.7,100,9.4,0,0,0,0,0,0,0,0,0
9.7,"greedy_SVM","SVM",41,0,2684,2434,250,100,90,10,0.762802288866574,0.229007633587786,1.25331421421844,25,10,15,0,1.5,3.59,9,0,0,0,0,0,0,0.275599388802569,254.117600872716,38.7418938212861
9.7,"greedy_SVM","SVM",41,1,2584,2358,226,200,166,34,0.736102878019855,0.267175572519084,1.19566609209554,91,34,57,66,1.7,7.18,4.9,0,0,0,0,0,0,0.216139775501849,381.366506370742,23.7311325486529
9.7,"greedy_SVM","SVM",41,2,2484,2294,190,300,230,70,0.778523124569017,0.206106870229008,1.26426988426496,161,70,91,70,1.3,10.78,3.3,0,0,0,0,0,0,0.245766698822342,427.543950891927,27.2034086955024
9.7,"greedy_SVM","SVM",41,3,2384,2221,163,400,303,97,0.791407072258983,0.290076335877863,1.25446934252647,226,97,129,65,1.3,14.37,3.1,0,0,0,0,0,0,0.241584942475406,396.622609808137,25.2710739789513
9.7,"greedy_SVM","SVM",41,4,2284,2134,150,500,390,110,0.781801575107963,0.274809160305344,1.21526717557252,257,110,147,31,1.3,17.96,3.5,0,0,0,0,0,0,0.209348012355214,230.970960290554,44.8981880967966
9.7,"greedy_SVM","SVM",41,5,2184,2061,123,600,463,137,0.708175560421477,0.229007633587786,1.17606500861857,321,137,184,64,1.3,21.55,3.4,0,0,0,0,0,0,0.223953715682757,411.780656008409,25.1115525262319
9.7,"greedy_SVM","SVM",41,6,2084,1976,108,700,548,152,0.802591306662143,0.274809160305344,1.26426988426496,352,152,200,31,1.3,25.14,3.6,0,0,0,0,0,0,0.18960671976193,199.576802557954,20.1203320295744
9.7,"greedy_SVM","SVM",41,7,1984,1903,81,800,621,179,0.814985301411784,0.274809160305344,1.25446934252647,412,179,233,60,1.3,28.74,3.5,0,0,0,0,0,0,0.19490682205299,172.954737521373,21.1527725820893
9.7,"greedy_SVM","SVM",41,8,1884,1823,61,900,701,199,0.809789380723673,0.259541984732824,1.25446934252647,464,199,265,52,1.3,32.33,3.5,0,0,0,0,0,0,0.210736602281276,270.511451835445,21.7044821137303
9.7,"greedy_SVM","SVM",41,9,1784,1749,35,1000,775,225,0.786797885338907,0.229007633587786,1.2348682590495,539,225,314,75,1.4,35.92,3.4,0,0,0,0,0,0,0.225335156275133,292.130788931286,23.0793334638511
9.7,"greedy_SVM","SVM",41,10,1684,1653,31,1100,871,229,0.796863091421586,0.229007633587786,1.24466880078798,556,229,327,17,1.4,39.51,3.8,0,0,0,0,0,0,0.165499795330298,95.6266150812616,18.3002136086489
9.7,"greedy_SVM","SVM",41,11,1584,1557,27,1200,967,233,0.791691365940403,0.221374045801527,1.2348682590495,567,233,334,11,1.4,43.1,4.2,0,0,0,0,0,0,0.133018765098048,77.5514201377692,14.912944560211
9.7,"greedy_SVM","SVM",41,12,1484,1460,24,1300,1064,236,0.804043019077912,0.259541984732824,1.24466880078798,576,236,340,9,1.4,46.7,4.5,0,0,0,0,0,0,0.0837733961038573,39.5206317922449,11.5354584386594
9.7,"greedy_SVM","SVM",41,13,1384,1368,16,1400,1156,244,0.8072912256082,0.221374045801527,1.25446934252647,593,244,349,17,1.4,50.29,4.7,0,0,0,0,0,0,0.12059037638824,87.3603532607621,13.5880846139837
9.7,"greedy_SVM","SVM",41,14,1284,1271,13,1500,1253,247,0.808464693144282,0.236641221374046,1.25446934252647,599,247,352,6,1.4,53.88,5.1,0,0,0,0,0,0,0.0806885638682084,45.3143664074213,8.97228251233498
9.7,"greedy_SVM","SVM",41,15,1184,1172,12,1600,1352,248,0.803613554154916,0.175572519083969,1.25446934252647,611,248,363,12,1.5,57.47,5.5,0,0,0,0,0,0,0.0430572718904511,17.496538895025,5.38130161450448
9.7,"greedy_SVM","SVM",41,16,1084,1073,11,1700,1451,249,0.80401277506925,0.213740458015267,1.26426988426496,619,249,370,8,1.5,61.06,5.8,0,0,0,0,0,0,0.0167087843730535,5.60744483682143,2.45377397291134
9.7,"greedy_SVM","SVM",41,17,984,976,8,1800,1548,252,0.79555655024739,0.198473282442748,1.26426988426496,633,252,381,14,1.5,64.66,6.1,0,0,0,0,0,0,0.0116661791929112,4.62997023512635,3.26433155295554
9.7,"greedy_SVM","SVM",41,18,884,881,3,1900,1643,257,0.806613759814181,0.221374045801527,1.26426988426496,667,257,410,34,1.6,68.25,6.4,0,0,0,0,0,0,0.00528918832355025,4.51684563405009,4.00744190585422
9.7,"greedy_SVM","SVM",41,19,784,782,2,2000,1742,258,0.819546097918001,0.229007633587786,1.26426988426496,658,258,400,-9,1.6,71.84,6.8,0,0,0,0,0,0,0.000680544143360262,0.197370463426381,0.140796349532552
9.7,"greedy_SVM","SVM",41,20,684,682,2,2100,1842,258,0.800794812547633,0.16793893129771,1.27407042600345,665,258,407,7,1.6,75.43,7.1,0,0,0,0,0,0,0.000385805308783493,0.139944950271249,0.117160248376744
9.7,"greedy_SVM","SVM",41,21,584,583,1,2200,1941,259,0.768143380796262,0.145038167938931,1.25446934252647,678,259,419,13,1.6,79.02,7.5,0,0,0,0,0,0,0.103921993098685,23.614611785645,15.2580777871085
9.7,"greedy_SVM","SVM",41,22,484,484,0,2300,2040,260,0.792520051777739,0.175572519083969,1.27407042600345,663,260,403,-15,1.6,82.61,7.8,0,0,0,0,0,0,0.00584222045382266,4.48712473702523,3.99773831960564
9.7,"greedy_SVM","SVM",41,23,384,384,0,2400,2140,260,0.770163680574878,0.16793893129771,1.26426988426496,679,260,419,16,1.6,86.21,8.2,0,0,0,0,0,0,0.00103487718261343,0.610716843843175,0.517798531304275
9.7,"greedy_SVM","SVM",41,24,284,284,0,2500,2240,260,0.797510313206951,0.198473282442748,1.27407042600345,681,260,421,2,1.6,89.8,8.6,0,0,0,0,0,0,8.96477001126303e-05,0.0367251322004547,0.0315070842071403
9.7,"greedy_SVM","SVM",41,25,184,184,0,2600,2340,260,0.781807623909699,0.175572519083969,1.26426988426496,695,260,435,14,1.7,93.39,9,0,0,0,0,0,0,7.40206802314215e-05,0.0222896797651288,0.0198872148117593
9.7,"greedy_SVM","SVM",41,26,84,84,0,2700,2440,260,0.784148510180132,0.16030534351145,1.26426988426496,677,260,417,-18,1.6,96.98,9.4,0,0,0,0,0,0,1.0000000994736e-07,0.000300624742557614,0.000300624742557614
9.7,"greedy_SVM","SVM",41,27,0,0,0,2784,2524,260,0.80591209881322,0.213740458015267,1.27407042600345,679,260,419,2,1.6,100,9.7,0,0,0,0,0,0,0,0,0
9.7,"greedy_SVM","SVM",42,0,2684,2432,252,100,91,9,0.805310920275293,0.253846153846154,1.26411910669975,24,9,15,0,1.7,3.59,10.1,0,0,0,0,0,0,0.333956263968903,234.246726062803,42.0935745459345
9.7,"greedy_SVM","SVM",42,1,2584,2357,227,200,166,34,0.786345088007799,0.284615384615385,1.22461538461538,83,34,49,59,1.4,7.18,4.9,0,0,0,0,0,0,0.206866048821609,382.674184295207,22.4595774968748
9.7,"greedy_SVM","SVM",42,2,2484,2267,217,300,256,44,0.793190815518609,0.192307692307692,1.26411910669975,118,44,74,35,1.7,10.78,5.8,0,0,0,0,0,0,0.150477784708629,315.316195480858,15.4944175011084
9.7,"greedy_SVM","SVM",42,3,2384,2192,192,400,331,69,0.805286558255682,0.253846153846154,1.28387096774194,173,69,104,55,1.5,14.37,4.8,0,0,0,0,0,0,0.187903997358461,331.002921426759,20.161996953817
9.7,"greedy_SVM","SVM",42,4,2284,2117,167,500,406,94,0.811206529021258,0.215384615384615,1.28387096774194,236,94,142,63,1.5,17.96,4.3,0,0,0,0,0,0,0.20683641400346,175.11988771938,21.418735017689
9.7,"greedy_SVM","SVM",42,5,2184,2054,130,600,469,131,0.807491321030516,0.246153846153846,1.26411910669975,315,131,184,79,1.4,21.55,3.6,0,0,0,0,0,0,0.225104733924002,187.93196219418,22.9082528285947
9.7,"greedy_SVM","SVM",42,6,2084,1978,106,700,545,155,0.812132285766492,0.3,1.26411910669975,369,155,214,54,1.4,25.14,3.5,0,0,0,0,0,0,0.225731479287662,140.222394107874,23.145450368487
9.7,"greedy_SVM","SVM",42,7,1984,1907,77,800,616,184,0.810390401364276,0.261538461538462,1.26411910669975,449,184,265,80,1.4,28.74,3.3,0,0,0,0,0,0,0.194164801702922,79.207856622535,22.579017996457
9.7,"greedy_SVM","SVM",42,8,1884,1824,60,900,699,201,0.79858700286254,0.261538461538462,1.26411910669975,492,201,291,43,1.4,32.33,3.5,0,0,0,0,0,0,0.153428961418875,83.3009420121715,18.8842394007971
9.7,"greedy_SVM","SVM",42,9,1784,1728,56,1000,795,205,0.799080333759671,0.261538461538462,1.26411910669975,505,205,300,13,1.5,35.92,3.9,0,0,0,0,0,0,0.180251234593274,219.268121280649,18.7514413754451
9.7,"greedy_SVM","SVM",42,10,1684,1631,53,1100,892,208,0.799305682441077,0.230769230769231,1.27399503722084,509,208,301,4,1.4,39.51,4.3,0,0,0,0,0,0,0.0728111343869904,37.2504806965683,9.70329481165704
9.7,"greedy_SVM","SVM",42,11,1584,1539,45,1200,984,216,0.80786284182959,0.261538461538462,1.28387096774194,550,216,334,41,1.5,43.1,4.6,0,0,0,0,0,0,0.0929732468615771,39.5384093562084,14.1936327277714
9.7,"greedy_SVM","SVM",42,12,1484,1449,35,1300,1074,226,0.805718984103785,0.215384615384615,1.27399503722084,569,226,343,19,1.5,46.7,4.8,0,0,0,0,0,0,0.107658922103344,44.4217294717471,16.9095134607251
9.7,"greedy_SVM","SVM",42,13,1384,1353,31,1400,1170,230,0.784487484012427,0.230769230769231,1.28387096774194,598,230,368,29,1.6,50.29,5.1,0,0,0,0,0,0,0.136229975651035,52.6027637873527,15.6633259099345
9.7,"greedy_SVM","SVM",42,14,1284,1255,29,1500,1268,232,0.767013825446132,0.146153846153846,1.27399503722084,624,232,392,26,1.7,53.88,5.5,0,0,0,0,0,0,0.109449805219616,42.9495338587147,15.7092424198464
9.7,"greedy_SVM","SVM",42,15,1184,1158,26,1600,1365,235,0.776222668859251,0.253846153846154,1.28387096774194,629,235,394,5,1.7,57.47,5.8,0,0,0,0,0,0,0.0771275964216066,24.9949710781949,10.1659580506671
9.7,"greedy_SVM","SVM",42,16,1084,1059,25,1700,1464,236,0.762878372617092,0.230769230769231,1.28387096774194,639,236,403,10,1.7,61.06,6.2,0,0,0,0,0,0,0.044144932182521,12.7181392678522,5.92308683169919
9.7,"greedy_SVM","SVM",42,17,984,963,21,1800,1560,240,0.81360009744808,0.253846153846154,1.28387096774194,662,240,422,23,1.8,64.66,6.5,0,0,0,0,0,0,0.0298417358050408,12.5592008289886,8.3077093571374
9.7,"greedy_SVM","SVM",42,18,884,875,9,1900,1648,252,0.784895547840918,0.184615384615385,1.28387096774194,696,252,444,34,1.8,68.25,6.5,0,0,0,0,0,0,0.039360285125889,12.6439119577819,5.08636350083285
9.7,"greedy_SVM","SVM",42,19,784,777,7,2000,1746,254,0.79240514038614,0.223076923076923,1.26411910669975,705,254,451,9,1.8,71.84,6.9,0,0,0,0,0,0,0.126730564953591,52.368502383042,14.1298100387316
9.7,"greedy_SVM","SVM",42,20,684,680,4,2100,1843,257,0.752518423777333,0.161538461538462,1.26411910669975,718,257,461,13,1.8,75.43,7.2,0,0,0,0,0,0,0.0619745838936333,18.4152364070973,11.5200203000673
9.7,"greedy_SVM","SVM",42,21,584,582,2,2200,1941,259,0.749406175771973,0.146153846153846,1.26411910669975,712,259,453,-6,1.7,79.02,7.5,0,0,0,0,0,0,0.0341305877573996,8.53585822093046,5.22182961911537
9.7,"greedy_SVM","SVM",42,22,484,483,1,2300,2040,260,0.776009501187651,0.223076923076923,1.26411910669975,737,260,477,25,1.8,82.61,7.8,0,0,0,0,0,0,0.00506778226419826,3.18450456274018,2.91222769984935
9.7,"greedy_SVM","SVM",42,23,384,384,0,2400,2139,261,0.806053961873441,0.269230769230769,1.26411910669975,714,261,453,-23,1.7,86.21,8.2,0,0,0,0,0,0,0.0133297375766718,4.31522667255606,3.14347171072637
9.7,"greedy_SVM","SVM",42,24,284,284,0,2500,2239,261,0.809756988854378,0.207692307692308,1.26411910669975,715,261,454,1,1.7,89.8,8.6,0,0,0,0,0,0,7.87695318896793e-05,0.0410791813594836,0.0380334820230163
9.7,"greedy_SVM","SVM",42,25,184,184,0,2600,2339,261,0.807424325476584,0.223076923076923,1.27399503722084,704,261,443,-11,1.7,93.39,9,0,0,0,0,0,0,2.3763342045888e-06,0.00441329936953766,0.00437123434842856
9.7,"greedy_SVM","SVM",42,26,84,84,0,2700,2439,261,0.792642670077352,0.215384615384615,1.26411910669975,708,261,447,4,1.7,96.98,9.3,0,0,0,0,0,0,7.74216212419365e-06,0.0227614943760606,0.0227614943760606
9.7,"greedy_SVM","SVM",42,27,0,0,0,2784,2523,261,0.818100980571291,0.276923076923077,1.27399503722084,722,261,461,14,1.8,100,9.7,0,0,0,0,0,0,0,0,0
9.7,"greedy_SVM","SVM",43,0,2684,2427,257,100,94,6,0.693502964426876,0.3125,1.07323588709677,17,6,11,0,1.8,3.59,15.7,0,0,0,0,0,0,0.155994664695032,158.932127789945,18.3103245129903
9.7,"greedy_SVM","SVM",43,1,2584,2359,225,200,162,38,0.757201086956523,0.21875,1.17353830645161,84,38,46,67,1.2,7.18,4.3,0,0,0,0,0,0,0.212736112940326,122.203233402582,26.6653956248984
9.7,"greedy_SVM","SVM",43,2,2484,2287,197,300,234,66,0.818651185770754,0.25,1.27384072580645,157,66,91,73,1.4,10.78,3.5,0,0,0,0,0,0,0.257715629847476,136.130906194376,27.1107850562006
9.7,"greedy_SVM","SVM",43,3,2384,2211,173,400,310,90,0.811135128458504,0.265625,1.23371975806452,211,90,121,54,1.3,14.37,3.4,0,0,0,0,0,0,0.232844707461215,83.1507915402189,24.6796517748842
9.7,"greedy_SVM","SVM",43,4,2284,2137,147,500,384,116,0.801327816205543,0.2578125,1.23371975806452,282,116,166,71,1.4,17.96,3.3,0,0,0,0,0,0,0.159880711079308,59.2258651676651,21.8014587149959
9.7,"greedy_SVM","SVM",43,5,2184,2064,120,600,457,143,0.803322628458493,0.28125,1.22368951612903,350,143,207,68,1.4,21.55,3.2,0,0,0,0,0,0,0.185419516348138,87.8315772193628,24.3030849877874
9.7,"greedy_SVM","SVM",43,6,2084,1990,94,700,531,169,0.736493330039529,0.140625,1.18139086936523,397,169,228,47,1.3,25.14,3.1,0,0,0,0,0,0,0.273099012532782,272.702802726326,46.2625595094144
9.7,"greedy_SVM","SVM",43,7,1984,1897,87,800,624,176,0.757423418972332,0.2265625,1.15347782258065,425,176,249,28,1.4,28.74,3.5,0,0,0,0,0,0,0.218509543299151,243.635018895055,23.8257153953115
9.7,"greedy_SVM","SVM",43,8,1884,1809,75,900,712,188,0.780558300395259,0.296875,1.1835685483871,450,188,262,25,1.4,32.33,3.8,0,0,0,0,0,0,0.171035679431481,139.770265189459,20.293709838639
9.7,"greedy_SVM","SVM",43,9,1784,1724,60,1000,797,203,0.794571393280632,0.3125,1.1835685483871,482,203,279,32,1.4,35.92,3.9,0,0,0,0,0,0,0.153734137304607,123.880994865108,17.0948619921142
9.7,"greedy_SVM","SVM",43,10,1684,1638,46,1100,883,217,0.81382781620554,0.3125,1.23371975806452,516,217,299,34,1.4,39.51,4.1,0,0,0,0,0,0,0.16962648080448,160.220096456745,19.0463934121343
9.7,"greedy_SVM","SVM",43,11,1584,1546,38,1200,975,225,0.805885622529649,0.296875,1.20362903225806,556,225,331,40,1.5,43.1,4.3,0,0,0,0,0,0,0.141295822815557,79.7157789693853,16.93768148152
9.7,"greedy_SVM","SVM",43,12,1484,1451,33,1300,1070,230,0.79559041501976,0.2421875,1.22368951612903,564,230,334,8,1.5,46.7,4.7,0,0,0,0,0,0,0.135567535949852,85.7453954235154,17.4330623676453
9.7,"greedy_SVM","SVM",43,13,1384,1352,32,1400,1169,231,0.822325839920951,0.3046875,1.23371975806452,580,231,349,16,1.5,50.29,5.1,0,0,0,0,0,0,0.0968108125720274,48.0434585952458,12.1381247246277
9.7,"greedy_SVM","SVM",43,14,1284,1258,26,1500,1263,237,0.825129693675891,0.265625,1.25378024193548,591,237,354,11,1.5,53.88,5.3,0,0,0,0,0,0,0.157833401430801,68.293895451784,21.3915837944173
9.7,"greedy_SVM","SVM",43,15,1184,1164,20,1600,1357,243,0.818428853754951,0.234375,1.24375,622,243,379,31,1.6,57.47,5.6,0,0,0,0,0,0,0.0810475201700814,39.5260012458282,11.1471730003028
9.7,"greedy_SVM","SVM",43,16,1084,1072,12,1700,1449,251,0.819836956521746,0.25,1.26381048387097,655,251,404,33,1.6,61.06,5.8,0,0,0,0,0,0,0.0540608011672316,23.8103206785644,8.25178418022775
9.7,"greedy_SVM","SVM",43,17,984,972,12,1800,1549,251,0.821343873517793,0.2109375,1.26381048387097,648,251,397,-7,1.6,64.66,6.2,0,0,0,0,0,0,0.0328064053447639,13.4054919734431,4.07686987358857
9.7,"greedy_SVM","SVM",43,18,884,873,11,1900,1648,252,0.820825098814232,0.2421875,1.26381048387097,646,252,394,-2,1.6,68.25,6.5,0,0,0,0,0,0,0.0295297173373872,10.7847922475075,4.44128343650402
9.7,"greedy_SVM","SVM",43,19,784,776,8,2000,1745,255,0.811740365612649,0.2265625,1.27384072580645,664,255,409,18,1.6,71.84,6.8,0,0,0,0,0,0,0.0185682369683755,6.38558602745877,4.30432506054494
9.7,"greedy_SVM","SVM",43,20,684,681,3,2100,1840,260,0.826513092885377,0.265625,1.27384072580645,684,260,424,20,1.6,75.43,7.1,0,0,0,0,0,0,0.00610417477581654,2.04884221096276,1.50454784375149
9.7,"greedy_SVM","SVM",43,21,584,583,1,2200,1938,262,0.770503952569172,0.1328125,1.28387096774194,704,262,442,20,1.7,79.02,7.4,0,0,0,0,0,0,0.114772365679427,36.6670920575038,19.9934423270377
9.7,"greedy_SVM","SVM",43,22,484,483,1,2300,2038,262,0.828353507905141,0.328125,1.28387096774194,698,262,436,-6,1.7,82.61,7.8,0,0,0,0,0,0,0.0314101638641685,8.43534958283759,5.3957771924963
9.7,"greedy_SVM","SVM",43,23,384,384,0,2400,2137,263,0.815909090909094,0.2265625,1.27384072580645,710,263,447,12,1.7,86.21,8.1,0,0,0,0,0,0,0.0297387627067179,24.9859288977968,22.9918440685144
9.7,"greedy_SVM","SVM",43,24,284,284,0,2500,2237,263,0.819077322134391,0.2109375,1.27384072580645,695,263,432,-15,1.6,89.8,8.5,0,0,0,0,0,0,0.0029478909093666,0.993832658327033,0.831232642080819
9.7,"greedy_SVM","SVM",43,25,184,184,0,2600,2337,263,0.783683300395261,0.1640625,1.27384072580645,721,263,458,26,1.7,93.39,8.9,0,0,0,0,0,0,0.000353875947726753,0.138232522321192,0.128763752860345
9.7,"greedy_SVM","SVM",43,26,84,84,0,2700,2437,263,0.812012104743088,0.203125,1.27384072580645,707,263,444,-14,1.7,96.98,9.3,0,0,0,0,0,0,1.0000000994736e-07,0.00625123798292855,0.00625123798292855
9.7,"greedy_SVM","SVM",43,27,0,0,0,2784,2521,263,0.836894762845849,0.3125,1.27384072580645,713,263,450,6,1.7,100,9.6,0,0,0,0,0,0,0,0,0
9.7,"greedy_SVM","SVM",44,0,2684,2423,261,100,85,15,0.776097162686262,0.339130434782609,1.21688639551192,40,15,25,0,1.7,3.59,5.7,0,0,0,0,0,0,0.382452316419856,395.370687774786,39.6791289312108
9.7,"greedy_SVM","SVM",44,1,2584,2364,220,200,144,56,0.716615635844049,0,1.25037868162693,125,56,69,85,1.2,7.18,2.6,0,0,0,0,0,0,0.301846981705889,688.939946288944,31.5712122034771
9.7,"greedy_SVM","SVM",44,2,2484,2270,214,300,238,62,0.810417091923521,0.217391304347826,1.28387096774194,148,62,86,23,1.4,10.78,3.8,0,0,0,0,0,0,0.254465897636386,434.421157550804,27.3534397077213
9.7,"greedy_SVM","SVM",44,3,2384,2194,190,400,314,86,0.765550792678788,0.208695652173913,1.25037868162693,200,86,114,52,1.3,14.37,3.7,0,0,0,0,0,0,0.259745405158028,402.301664741914,31.6821809123818
9.7,"greedy_SVM","SVM",44,4,2284,2110,174,500,398,102,0.82119480166021,0.28695652173913,1.25037868162693,244,102,142,44,1.4,17.96,3.9,0,0,0,0,0,0,0.223301049233101,376.733818987783,23.8809007267252
9.7,"greedy_SVM","SVM",44,5,2184,2033,151,600,475,125,0.780846431244483,0.243478260869565,1.2615427769986,297,125,172,53,1.4,21.55,3.8,0,0,0,0,0,0,0.224933184702854,291.668203829025,23.558378369338
9.7,"greedy_SVM","SVM",44,6,2084,1947,137,700,561,139,0.791249914948635,0.278260869565217,1.2615427769986,332,139,193,35,1.4,25.14,4,0,0,0,0,0,0,0.216037025777863,252.668642725405,21.9947252619204
9.7,"greedy_SVM","SVM",44,7,1984,1874,110,800,634,166,0.801217935633131,0.28695652173913,1.2615427769986,418,166,252,86,1.5,28.74,3.8,0,0,0,0,0,0,0.219443262372129,210.539959251989,22.7409438479579
9.7,"greedy_SVM","SVM",44,8,1884,1806,78,900,702,198,0.810138123426557,0.234782608695652,1.2615427769986,483,198,285,65,1.4,32.33,3.5,0,0,0,0,0,0,0.226615589108912,205.338435390481,23.5155804184669
9.7,"greedy_SVM","SVM",44,9,1784,1718,66,1000,790,210,0.834728175818201,0.252173913043478,1.2615427769986,523,210,313,40,1.5,35.92,3.8,0,0,0,0,0,0,0.220257896630976,193.406673289072,22.7143057484153
9.7,"greedy_SVM","SVM",44,10,1684,1630,54,1100,878,222,0.851146492481467,0.295652173913043,1.2615427769986,554,222,332,31,1.5,39.51,4,0,0,0,0,0,0,0.201707815091117,170.264407056564,21.345399276444
9.7,"greedy_SVM","SVM",44,11,1584,1539,45,1200,969,231,0.835231679934688,0.252173913043478,1.2615427769986,585,231,354,31,1.5,43.1,4.2,0,0,0,0,0,0,0.177485241245536,158.59680410775,18.4333113116208
9.7,"greedy_SVM","SVM",44,12,1484,1441,43,1300,1067,233,0.850207525345315,0.28695652173913,1.2615427769986,589,233,356,4,1.5,46.7,4.6,0,0,0,0,0,0,0.119318237336567,63.8710505896558,13.7278073336011
9.7,"greedy_SVM","SVM",44,13,1384,1351,33,1400,1157,243,0.849452269170591,0.252173913043478,1.2615427769986,621,243,378,32,1.6,50.29,4.8,0,0,0,0,0,0,0.145844944211753,98.3818085197335,16.5670985802933
9.7,"greedy_SVM","SVM",44,14,1284,1258,26,1500,1250,250,0.82627066748317,0.234782608695652,1.2615427769986,627,250,377,6,1.5,53.88,5,0,0,0,0,0,0,0.138865972396025,92.5157192004433,15.5240318797886
9.7,"greedy_SVM","SVM",44,15,1184,1162,22,1600,1346,254,0.867047696808885,0.28695652173913,1.2615427769986,654,254,400,27,1.6,57.47,5.3,0,0,0,0,0,0,0.144095782041477,84.3299293099307,15.4691627066378
9.7,"greedy_SVM","SVM",44,16,1084,1064,20,1700,1444,256,0.837232088181272,0.252173913043478,1.2615427769986,670,256,414,16,1.6,61.06,5.6,0,0,0,0,0,0,0.121112523129718,62.4385914279738,13.334671746947
9.7,"greedy_SVM","SVM",44,17,984,964,20,1800,1544,256,0.848839899299188,0.260869565217391,1.2615427769986,664,256,408,-6,1.6,64.66,6,0,0,0,0,0,0,0.0770821790388686,32.3992310569692,8.95634187718269
9.7,"greedy_SVM","SVM",44,18,884,864,20,1900,1644,256,0.833197251139699,0.217391304347826,1.2615427769986,680,256,424,16,1.7,68.25,6.4,0,0,0,0,0,0,0.067246172409888,26.4249093759254,7.80088502636895
9.7,"greedy_SVM","SVM",44,19,784,765,19,2000,1743,257,0.847043614343075,0.260869565217391,1.2615427769986,678,257,421,-2,1.6,71.84,6.8,0,0,0,0,0,0,0.0539199121296531,18.0281739755864,6.20317635737727
9.7,"greedy_SVM","SVM",44,20,684,666,18,2100,1842,258,0.847288562291633,0.278260869565217,1.2615427769986,683,258,425,5,1.6,75.43,7.1,0,0,0,0,0,0,0.0345816119238833,11.4159128997452,4.40147465763305
9.7,"greedy_SVM","SVM",44,21,584,568,16,2200,1940,260,0.835326937470242,0.182608695652174,1.2615427769986,688,260,428,5,1.6,79.02,7.5,0,0,0,0,0,0,0.0249399570560884,8.26144028646559,4.10411419137637
9.7,"greedy_SVM","SVM",44,22,484,473,11,2300,2035,265,0.776587058583392,0.130434782608696,1.2615427769986,712,265,447,24,1.7,82.61,7.7,0,0,0,0,0,0,0.0680352198049354,21.99230489985,9.96030806851692
9.7,"greedy_SVM","SVM",44,23,384,375,9,2400,2133,267,0.849322991086624,0.234782608695652,1.28387096774194,725,267,458,13,1.7,86.21,8,0,0,0,0,0,0,0.0680937768054442,17.8302932490909,8.93522412260525
9.7,"greedy_SVM","SVM",44,24,284,283,1,2500,2225,275,0.855399061032868,0.226086956521739,1.28387096774194,759,275,484,34,1.8,89.8,8.1,0,0,0,0,0,0,0.0180838798179871,6.30458554481717,5.74305646652165
9.7,"greedy_SVM","SVM",44,25,184,184,0,2600,2324,276,0.823188405797106,0.191304347826087,1.28387096774194,759,276,483,0,1.8,93.39,8.4,0,0,0,0,0,0,0.000596612536401667,0.470307499671918,0.453204516677245
9.7,"greedy_SVM","SVM",44,26,84,84,0,2700,2424,276,0.832979519629861,0.226086956521739,1.28387096774194,763,276,487,4,1.8,96.98,8.8,0,0,0,0,0,0,1.3679908716841e-06,0.0133396528782095,0.0133396528782095
9.7,"greedy_SVM","SVM",44,27,0,0,0,2784,2508,276,0.824903041437033,0.165217391304348,1.28387096774194,756,276,480,-7,1.7,100,9.1,0,0,0,0,0,0,0,0,0
9.7,"greedy_SVM","SVM",45,0,2684,2430,254,100,92,8,0.688291139240504,0.170542635658915,1.18434608652163,28,8,20,0,2.5,3.59,11.5,0,0,0,0,0,0,0.105727759475022,209.413794092438,12.0371304990085
9.7,"greedy_SVM","SVM",45,1,2584,2336,248,200,186,14,0.659779462270629,0.193798449612403,1.14453613403351,47,14,33,19,2.4,7.18,13.3,0,0,0,0,0,0,0.0918566719076475,153.781996237668,9.98409809727186
9.7,"greedy_SVM","SVM",45,2,2484,2247,237,300,275,25,0.74863850456284,0.224806201550388,1.18434608652163,75,25,50,28,2,10.78,11,0,0,0,0,0,0,0.103068672295201,145.011774683636,11.2797851079539
9.7,"greedy_SVM","SVM",45,3,2384,2165,219,400,357,43,0.763700814444119,0.27906976744186,1.1743935983996,119,43,76,44,1.8,14.37,8.3,0,0,0,0,0,0,0.132517702605303,133.025376610897,15.2722042321094
9.7,"greedy_SVM","SVM",45,4,2284,2088,196,500,434,66,0.766816308507507,0.263565891472868,1.1743935983996,183,66,117,64,1.8,17.96,6.6,0,0,0,0,0,0,0.153189895953276,107.009570957242,15.8916044861409
9.7,"greedy_SVM","SVM",45,5,2184,2016,168,600,506,94,0.781939947012067,0.271317829457364,1.18434608652163,245,94,151,62,1.6,21.55,5.4,0,0,0,0,0,0,0.177846562721336,136.271631093698,18.4608984599966
9.7,"greedy_SVM","SVM",45,6,2084,1961,123,700,561,139,0.787459523108617,0.294573643410853,1.18434608652163,345,139,206,100,1.5,25.14,4,0,0,0,0,0,0,0.182820243685226,78.0131695865009,21.0489626929067
9.7,"greedy_SVM","SVM",45,7,1984,1892,92,800,630,170,0.785674860170732,0.271317829457364,1.18434608652163,412,170,242,67,1.4,28.74,3.7,0,0,0,0,0,0,0.178198014062776,100.331416461429,20.5834778018979
9.7,"greedy_SVM","SVM",45,8,1884,1805,79,900,717,183,0.779002305956229,0.24031007751938,1.22415603900975,453,183,270,41,1.5,32.33,3.9,0,0,0,0,0,0,0.165790271626739,90.5290781532514,18.6833329742782
9.7,"greedy_SVM","SVM",45,9,1784,1714,70,1000,808,192,0.7545321852615,0.124031007751938,1.25401350337584,497,192,305,44,1.6,35.92,4.2,0,0,0,0,0,0,0.205688614550734,104.856330628162,24.2321718104567
9.7,"greedy_SVM","SVM",45,10,1684,1615,69,1100,907,193,0.774218673339217,0.224806201550388,1.24406101525381,496,193,303,-1,1.6,39.51,4.7,0,0,0,0,0,0,0.124803550876351,59.7001025109247,15.1317191337775
9.7,"greedy_SVM","SVM",45,11,1584,1517,67,1200,1005,195,0.769845942498276,0.155038759689922,1.23410852713178,502,195,307,6,1.6,43.1,5.2,0,0,0,0,0,0,0.108561943465146,68.9495840315243,22.4226011037592
9.7,"greedy_SVM","SVM",45,12,1484,1419,65,1300,1103,197,0.794690167795107,0.186046511627907,1.23410852713178,498,197,301,-4,1.5,46.7,5.6,0,0,0,0,0,0,0.126445055856995,65.4720351572042,17.3522519746464
9.7,"greedy_SVM","SVM",45,13,1384,1342,42,1400,1180,220,0.782424443136097,0.201550387596899,1.21420355088772,579,220,359,81,1.6,50.29,5.4,0,0,0,0,0,0,0.167094940363854,110.347908308282,28.5150634641863
9.7,"greedy_SVM","SVM",45,14,1284,1255,29,1500,1267,233,0.802460504366598,0.263565891472868,1.20425106276569,597,233,364,18,1.6,53.88,5.4,0,0,0,0,0,0,0.127314350288971,62.8227093570193,14.8085163536073
9.7,"greedy_SVM","SVM",45,15,1184,1162,22,1600,1360,240,0.79672014522618,0.263565891472868,1.20425106276569,621,240,381,24,1.6,57.47,5.7,0,0,0,0,0,0,0.124247468195426,45.3981434642792,14.0676968585576
9.7,"greedy_SVM","SVM",45,16,1084,1065,19,1700,1457,243,0.792746050436659,0.286821705426357,1.20425106276569,648,243,405,27,1.7,61.06,6,0,0,0,0,0,0,0.0951616750371731,30.0004266466701,12.2886307381131
9.7,"greedy_SVM","SVM",45,17,984,965,19,1800,1557,243,0.797124914139928,0.294573643410853,1.20425106276569,647,243,404,-1,1.7,64.66,6.4,0,0,0,0,0,0,0.0574196503480298,13.7431636268409,7.23139925946723
9.7,"greedy_SVM","SVM",45,18,884,865,19,1900,1657,243,0.800080953782746,0.302325581395349,1.20425106276569,639,243,396,-8,1.6,68.25,6.8,0,0,0,0,0,0,0.0311163137959928,8.50679628811578,4.90385784701941
9.7,"greedy_SVM","SVM",45,19,784,766,18,2000,1756,244,0.781053748405454,0.193798449612403,1.20425106276569,634,244,390,-5,1.6,71.84,7.2,0,0,0,0,0,0,0.00996743932684556,2.59208583452617,1.77872953704008
9.7,"greedy_SVM","SVM",45,20,684,668,16,2100,1854,246,0.787281670101068,0.248062015503876,1.20425106276569,656,246,410,22,1.7,75.43,7.5,0,0,0,0,0,0,0.0133952112766502,4.28747999645067,3.02160985876727
9.7,"greedy_SVM","SVM",45,21,584,573,11,2200,1949,251,0.812794377391805,0.294573643410853,1.22415603900975,666,251,415,10,1.7,79.02,7.8,0,0,0,0,0,0,0.0216053691840121,6.85622284071667,4.91859108668939
9.7,"greedy_SVM","SVM",45,22,484,474,10,2300,2048,252,0.801957609655566,0.232558139534884,1.22415603900975,663,252,411,-3,1.6,82.61,8.1,0,0,0,0,0,0,0.00350279890213874,1.16807897189865,0.829572012478056
9.7,"greedy_SVM","SVM",45,23,384,375,9,2400,2147,253,0.782583897556655,0.209302325581395,1.22415603900975,672,253,419,9,1.7,86.21,8.5,0,0,0,0,0,0,0.000812341576131139,0.222136022322936,0.165714229765255
9.7,"greedy_SVM","SVM",45,24,284,277,7,2500,2245,255,0.759892306937485,0.186046511627907,1.24406101525381,673,255,418,1,1.6,89.8,8.8,0,0,0,0,0,0,0.00370315646979455,0.967977365124987,0.656216310471516
9.7,"greedy_SVM","SVM",45,25,184,181,3,2600,2341,259,0.81045162398194,0.27906976744186,1.26396599149787,700,259,441,27,1.7,93.39,9,0,0,0,0,0,0,0.0110961267191666,2.84356246570165,2.49366901682261
9.7,"greedy_SVM","SVM",45,26,84,84,0,2700,2438,262,0.754716171131388,0.162790697674419,1.28387096774194,731,262,469,31,1.8,96.98,9.3,0,0,0,0,0,0,4.0486257691398e-05,0.883598481878789,0.883598481878789
9.7,"greedy_SVM","SVM",45,27,0,0,0,2784,2522,262,0.804987243646349,0.201550387596899,1.28387096774194,706,262,444,-25,1.7,100,9.6,0,0,0,0,0,0,0,0,0
9.7,"greedy_SVM","SVM",46,0,2684,2441,243,100,90,10,0.737109532882962,0.152173913043478,1.23735390369331,31,10,21,0,2.1,3.59,9,0,0,0,0,0,0,0.111225731593695,275.388039189252,12.931796511949
9.7,"greedy_SVM","SVM",46,1,2584,2362,222,200,169,31,0.668012009931293,0.260869565217391,1.1164095371669,72,31,41,41,1.3,7.18,5.5,0,0,0,0,0,0,0.242531119643919,358.334018006443,30.6963755724712
9.7,"greedy_SVM","SVM",46,2,2484,2285,199,300,246,54,0.686581211386339,0.246376811594203,1.18153342683497,138,54,84,66,1.6,10.78,4.6,0,0,0,0,0,0,0.196970524412096,411.389303633742,20.4124787378599
9.7,"greedy_SVM","SVM",46,3,2384,2206,178,400,325,75,0.713037704255443,0.159420289855072,1.23735390369331,186,75,111,48,1.5,14.37,4.3,0,0,0,0,0,0,0.193105503154093,398.542258976223,19.5744312748046
9.7,"greedy_SVM","SVM",46,4,2284,2109,175,500,422,78,0.756019400658237,0.260869565217391,1.24665731650304,195,78,117,9,1.5,17.96,5.4,0,0,0,0,0,0,0.159128047579019,286.725488249348,16.1774411348901
9.7,"greedy_SVM","SVM",46,5,2184,2029,155,600,502,98,0.756435129049022,0.246376811594203,1.23735390369331,247,98,149,52,1.5,21.55,5.1,0,0,0,0,0,0,0.165332126726352,247.239359287855,17.0270715861557
9.7,"greedy_SVM","SVM",46,6,2084,1946,138,700,585,115,0.787395346151626,0.27536231884058,1.24665731650304,288,115,173,41,1.5,25.14,5.1,0,0,0,0,0,0,0.161296257824214,208.727812290638,16.4484127659991
9.7,"greedy_SVM","SVM",46,7,1984,1878,106,800,653,147,0.80066401062417,0.326086956521739,1.23735390369331,356,147,209,68,1.4,28.74,4.4,0,0,0,0,0,0,0.184853458006307,230.538525762616,18.909625320677
9.7,"greedy_SVM","SVM",46,8,1884,1810,74,900,721,179,0.795438535712224,0.289855072463768,1.22805049088359,425,179,246,69,1.4,32.33,4,0,0,0,0,0,0,0.193562665035722,220.596396121586,19.8310967590435
9.7,"greedy_SVM","SVM",46,9,1784,1732,52,1000,799,201,0.801478145389458,0.282608695652174,1.20944366526414,491,201,290,66,1.4,35.92,4,0,0,0,0,0,0,0.198313587176433,243.324897707412,20.1326438354562
9.7,"greedy_SVM","SVM",46,10,1684,1638,46,1100,893,207,0.808915064380161,0.282608695652174,1.21874707807387,509,207,302,18,1.5,39.51,4.3,0,0,0,0,0,0,0.184028774684819,209.920145676493,18.6788466358201
9.7,"greedy_SVM","SVM",46,11,1584,1545,39,1200,986,214,0.81572261677926,0.326086956521739,1.20944366526414,548,214,334,39,1.6,43.1,4.6,0,0,0,0,0,0,0.169434331693195,154.729610797694,17.2861406866066
9.7,"greedy_SVM","SVM",46,12,1484,1456,28,1300,1075,225,0.815393498469888,0.297101449275362,1.20944366526414,555,225,330,7,1.5,46.7,4.8,0,0,0,0,0,0,0.157640122789298,103.376677458929,16.9930667136181
9.7,"greedy_SVM","SVM",46,13,1384,1361,23,1400,1170,230,0.813996189156418,0.22463768115942,1.21874707807387,583,230,353,28,1.5,50.29,5.1,0,0,0,0,0,0,0.158665830374599,170.165130341379,16.0449550746978
9.7,"greedy_SVM","SVM",46,14,1284,1264,20,1500,1267,233,0.821981638662741,0.340579710144928,1.22805049088359,607,233,374,24,1.6,53.88,5.4,0,0,0,0,0,0,0.123219749445401,63.7300363347771,13.2915804954803
9.7,"greedy_SVM","SVM",46,15,1184,1164,20,1600,1367,233,0.813389918586523,0.282608695652174,1.22805049088359,610,233,377,3,1.6,57.47,5.9,0,0,0,0,0,0,0.0902999431936348,34.7162852435384,10.0235566660039
9.7,"greedy_SVM","SVM",46,16,1084,1065,19,1700,1466,234,0.801131705063803,0.239130434782609,1.21874707807387,605,234,371,-5,1.6,61.06,6.3,0,0,0,0,0,0,0.11739762063817,57.9129124773768,20.3177146959794
9.7,"greedy_SVM","SVM",46,17,984,966,18,1800,1565,235,0.815254922339626,0.289855072463768,1.22805049088359,601,235,366,-4,1.6,64.66,6.7,0,0,0,0,0,0,0.0392803282433707,12.0807891923631,5.48739247312953
9.7,"greedy_SVM","SVM",46,18,884,867,17,1900,1664,236,0.813407240602805,0.297101449275362,1.22691968932661,613,236,377,12,1.6,68.25,7.1,0,0,0,0,0,0,0.0148558231931675,4.26818660813299,2.26958286973108
9.7,"greedy_SVM","SVM",46,19,784,769,15,2000,1762,238,0.809688781107454,0.304347826086957,1.20944366526414,603,238,365,-10,1.5,71.84,7.4,0,0,0,0,0,0,0.0386647359408664,13.8607126368156,5.37851545479168
9.7,"greedy_SVM","SVM",46,20,684,670,14,2100,1861,239,0.811507592817137,0.246376811594203,1.20944366526414,616,239,377,13,1.6,75.43,7.8,0,0,0,0,0,0,0.00721719621226005,2.17341661099574,1.41750183275763
9.7,"greedy_SVM","SVM",46,21,584,571,13,2200,1960,240,0.817910964836307,0.297101449275362,1.20944366526414,631,240,391,15,1.6,79.02,8.2,0,0,0,0,0,0,0.0147230795915713,4.78390983116803,2.15737560066055
9.7,"greedy_SVM","SVM",46,22,484,471,13,2300,2060,240,0.821843062532479,0.297101449275362,1.20944366526414,613,240,373,-18,1.6,82.61,8.6,0,0,0,0,0,0,0.00372557101753974,1.06002513657106,0.520320559865067
9.7,"greedy_SVM","SVM",46,23,384,373,11,2400,2158,242,0.79255730700387,0.253623188405797,1.20944366526414,645,242,403,32,1.7,86.21,8.9,0,0,0,0,0,0,0.00495070965598347,2.11012227268145,1.5528428631138
9.7,"greedy_SVM","SVM",46,24,284,273,11,2500,2258,242,0.787476182227611,0.260869565217391,1.21874707807387,632,242,390,-13,1.6,89.8,9.3,0,0,0,0,0,0,0.00464505651220108,1.1267833473607,0.671808487670523
9.7,"greedy_SVM","SVM",46,25,184,174,10,2600,2357,243,0.790103354697152,0.260869565217391,1.21874707807387,651,243,408,19,1.7,93.39,9.7,0,0,0,0,0,0,0.00278458185948257,0.638953862736136,0.496047039816645
9.7,"greedy_SVM","SVM",46,26,84,80,4,2700,2451,249,0.787724464460999,0.210144927536232,1.27456755493221,671,249,422,20,1.7,96.98,9.8,0,0,0,0,0,0,2.67702116529234e-07,1.1809296987254,1.1809296987254
9.7,"greedy_SVM","SVM",46,27,0,0,0,2784,2531,253,0.83126623939027,0.268115942028986,1.28387096774194,693,253,440,22,1.7,100,10,0,0,0,0,0,0,0,0,0
9.7,"greedy_SVM","SVM",47,0,2684,2418,266,100,90,10,0.739572701911955,0.217391304347826,1.21688639551192,27,10,17,0,1.7,3.59,9,0,0,0,0,0,0,0.189042816077575,287.325670790385,21.2535804457923
9.7,"greedy_SVM","SVM",47,1,2584,2349,235,200,159,41,0.792202490304149,0.31304347826087,1.23921458625526,99,41,58,72,1.4,7.18,3.9,0,0,0,0,0,0,0.229023024462836,429.444275406041,25.7020991303635
9.7,"greedy_SVM","SVM",47,2,2484,2278,206,300,230,70,0.751772470572232,0.156521739130435,1.27270687237027,165,70,95,66,1.4,10.78,3.3,0,0,0,0,0,0,0.235041681015754,568.810613638815,24.043512435796
9.7,"greedy_SVM","SVM",47,3,2384,2191,193,400,317,83,0.801143090426622,0.2,1.28387096774194,200,83,117,35,1.4,14.37,3.8,0,0,0,0,0,0,0.215359755916109,388.636843252127,22.1917912140622
9.7,"greedy_SVM","SVM",47,4,2284,2111,173,500,397,103,0.822106552357628,0.226086956521739,1.28387096774194,258,103,155,58,1.5,17.96,3.9,0,0,0,0,0,0,0.216407658399733,304.708880202694,22.3151681829044
9.7,"greedy_SVM","SVM",47,5,2184,2029,155,600,479,121,0.819555011226784,0.226086956521739,1.28387096774194,291,121,170,33,1.4,21.55,4,0,0,0,0,0,0,0.198844407744852,292.402216309966,20.287787185038
9.7,"greedy_SVM","SVM",47,6,2084,1952,132,700,556,144,0.826372729128397,0.243478260869565,1.28387096774194,343,144,199,52,1.4,25.14,3.9,0,0,0,0,0,0,0.189977831200165,204.428131415975,19.6826866898139
9.7,"greedy_SVM","SVM",47,7,1984,1890,94,800,618,182,0.830271483976325,0.226086956521739,1.28387096774194,428,182,246,85,1.4,28.74,3.4,0,0,0,0,0,0,0.215404137531958,249.345341279736,22.1368145793951
9.7,"greedy_SVM","SVM",47,8,1884,1810,74,900,698,202,0.834279104579168,0.226086956521739,1.28387096774194,474,202,272,46,1.3,32.33,3.5,0,0,0,0,0,0,0.206487222906033,212.566865029434,21.3049239008087
9.7,"greedy_SVM","SVM",47,9,1784,1737,47,1000,771,229,0.836959923793975,0.234782608695652,1.28387096774194,544,229,315,70,1.4,35.92,3.4,0,0,0,0,0,0,0.218358607362811,284.068666273899,22.3858926116157
9.7,"greedy_SVM","SVM",47,10,1684,1648,36,1100,860,240,0.843117643056408,0.243478260869565,1.28387096774194,576,240,336,32,1.4,39.51,3.6,0,0,0,0,0,0,0.183340846932474,165.593214516354,19.2454202716156
9.7,"greedy_SVM","SVM",47,11,1584,1559,25,1200,949,251,0.83432673334695,0.243478260869565,1.27270687237027,627,251,376,51,1.5,43.1,3.8,0,0,0,0,0,0,0.177830757373743,150.767340491694,19.0248064753064
9.7,"greedy_SVM","SVM",47,12,1484,1467,17,1300,1041,259,0.791488058787517,0.2,1.2615427769986,652,259,393,25,1.5,46.7,4,0,0,0,0,0,0,0.197281694389412,204.039886721325,20.7621707381592
9.7,"greedy_SVM","SVM",47,13,1384,1367,17,1400,1141,259,0.823324487990759,0.260869565217391,1.2615427769986,663,259,404,11,1.6,50.29,4.4,0,0,0,0,0,0,0.177444642913069,210.753148493026,18.0230881930948
9.7,"greedy_SVM","SVM",47,14,1284,1269,15,1500,1239,261,0.808518745322182,0.226086956521739,1.2615427769986,678,261,417,15,1.6,53.88,4.7,0,0,0,0,0,0,0.168579680299015,182.43513328996,17.5409879681732
9.7,"greedy_SVM","SVM",47,15,1184,1171,13,1600,1337,263,0.799442063006059,0.217391304347826,1.2615427769986,686,263,423,8,1.6,57.47,5.1,0,0,0,0,0,0,0.152610436927217,132.228383653679,15.792202251493
9.7,"greedy_SVM","SVM",47,16,1084,1073,11,1700,1435,265,0.794651969789757,0.182608695652174,1.2615427769986,696,265,431,10,1.6,61.06,5.4,0,0,0,0,0,0,0.145218360570302,121.177224140377,14.908562584022
9.7,"greedy_SVM","SVM",47,17,984,977,7,1800,1531,269,0.791229502619587,0.173913043478261,1.28387096774194,706,269,437,10,1.6,64.66,5.7,0,0,0,0,0,0,0.140110855070423,91.4532805666267,17.7925903844606
9.7,"greedy_SVM","SVM",47,18,884,881,3,1900,1627,273,0.793406817717903,0.182608695652174,1.28387096774194,754,273,481,48,1.8,68.25,6,0,0,0,0,0,0,0.144383834954773,94.1541110704826,15.3603854123699
9.7,"greedy_SVM","SVM",47,19,784,781,3,2000,1727,273,0.803014220589236,0.208695652173913,1.28387096774194,741,273,468,-13,1.7,71.84,6.3,0,0,0,0,0,0,0.104073944110413,45.9957781915081,11.6613891054227
9.7,"greedy_SVM","SVM",47,20,684,682,2,2100,1826,274,0.782744777845821,0.165217391304348,1.28387096774194,748,274,474,7,1.7,75.43,6.7,0,0,0,0,0,0,0.103624790234681,51.0441723582021,11.0382812072588
9.7,"greedy_SVM","SVM",47,21,584,582,2,2200,1926,274,0.793461250595362,0.173913043478261,1.28387096774194,741,274,467,-7,1.7,79.02,7,0,0,0,0,0,0,0.0808458862649822,29.7690480707797,8.8227739092191
9.7,"greedy_SVM","SVM",47,22,484,483,1,2300,2025,275,0.771742532489624,0.165217391304348,1.28387096774194,748,275,473,7,1.7,82.61,7.4,0,0,0,0,0,0,0.0837700665540206,30.8513164006261,9.37434086045772
9.7,"greedy_SVM","SVM",47,23,384,383,1,2400,2125,275,0.780118391508475,0.182608695652174,1.28387096774194,752,275,477,4,1.7,86.21,7.7,0,0,0,0,0,0,0.043129095022865,10.9927822410235,5.20629686263026
9.7,"greedy_SVM","SVM",47,24,284,284,0,2500,2224,276,0.785139824453972,0.173913043478261,1.28387096774194,750,276,474,-2,1.7,89.8,8.1,0,0,0,0,0,0,0.0295087270598641,12.8044139046748,10.6582007598411
9.7,"greedy_SVM","SVM",47,25,184,184,0,2600,2324,276,0.775253453085665,0.156521739130435,1.28387096774194,750,276,474,0,1.7,93.39,8.4,0,0,0,0,0,0,0.0165310552475812,3.8273196843327,2.92597974468123
9.7,"greedy_SVM","SVM",47,26,84,84,0,2700,2424,276,0.721657481118597,0.130434782608696,1.28387096774194,749,276,473,-1,1.7,96.98,8.8,0,0,0,0,0,0,2.03051442669768e-07,0.211965473949324,0.211965473949324
9.7,"greedy_SVM","SVM",47,27,0,0,0,2784,2508,276,0.786425801183916,0.191304347826087,1.28387096774194,771,276,495,22,1.8,100,9.1,0,0,0,0,0,0,0,0,0
9.7,"greedy_SVM","SVM",48,0,2684,2433,251,100,90,10,0.727035751263784,0.161538461538462,1.18511166253102,31,10,21,0,2.1,3.59,9,0,0,0,0,0,0,0.218589558783406,281.898055738114,31.1060903501541
9.7,"greedy_SVM","SVM",48,1,2584,2342,242,200,181,19,0.793909495097146,0.238461538461538,1.27399503722084,61,19,42,30,2.2,7.18,9.5,0,0,0,0,0,0,0.123786735996935,237.277763559492,12.8279507716141
9.7,"greedy_SVM","SVM",48,2,2484,2265,219,300,258,42,0.775138558986542,0.2,1.27399503722084,132,42,90,71,2.1,10.78,6.1,0,0,0,0,0,0,0.17597054407168,240.636138802673,20.3155649793464
9.7,"greedy_SVM","SVM",48,3,2384,2187,197,400,336,64,0.776253121383766,0.261538461538462,1.24436724565757,157,64,93,25,1.5,14.37,5.2,0,0,0,0,0,0,0.186062545260047,289.475199749136,20.6472285836781
9.7,"greedy_SVM","SVM",48,4,2284,2118,166,500,405,95,0.74252390523175,0.215384615384615,1.15548387096774,230,95,135,73,1.4,17.96,4.3,0,0,0,0,0,0,0.199419379299127,270.341146016733,22.2001088402941
9.7,"greedy_SVM","SVM",48,5,2184,2034,150,600,489,111,0.77188622936842,0.276923076923077,1.18511166253102,257,111,146,27,1.3,21.55,4.4,0,0,0,0,0,0,0.177534513029762,172.325346545273,18.5832689972753
9.7,"greedy_SVM","SVM",48,6,2084,1958,126,700,565,135,0.769742371642614,0.269230769230769,1.18511166253102,312,135,177,55,1.3,25.14,4.2,0,0,0,0,0,0,0.174126355603052,131.696600086426,18.2441636029166
9.7,"greedy_SVM","SVM",48,7,1984,1883,101,800,640,160,0.781314330958041,0.307692307692308,1.19498759305211,373,160,213,61,1.3,28.74,4,0,0,0,0,0,0,0.166110935941163,124.947735653271,18.4873900273292
9.7,"greedy_SVM","SVM",48,8,1884,1813,71,900,710,190,0.779079115658694,0.323076923076923,1.17523573200993,436,190,246,63,1.3,32.33,3.7,0,0,0,0,0,0,0.14654703758278,113.975344027599,16.3450413347375
9.7,"greedy_SVM","SVM",48,9,1784,1729,55,1000,794,206,0.758816005846891,0.269230769230769,1.17523573200993,479,206,273,43,1.3,35.92,3.9,0,0,0,0,0,0,0.171671588324521,153.636801549358,18.6447940141068
9.7,"greedy_SVM","SVM",48,10,1684,1632,52,1100,891,209,0.775059382422808,0.269230769230769,1.2048635235732,488,209,279,9,1.3,39.51,4.3,0,0,0,0,0,0,0.16489734774386,132.783500813744,21.0471414729244
9.7,"greedy_SVM","SVM",48,11,1584,1538,46,1200,985,215,0.77452950849626,0.284615384615385,1.19498759305211,511,215,296,23,1.4,43.1,4.6,0,0,0,0,0,0,0.137279225064974,94.6335564647721,15.1919629772483
9.7,"greedy_SVM","SVM",48,12,1484,1445,39,1300,1078,222,0.774115354162865,0.269230769230769,1.19498759305211,534,222,312,23,1.4,46.7,4.9,0,0,0,0,0,0,0.116071968078297,80.1751134327125,12.8095325711949
9.7,"greedy_SVM","SVM",48,13,1384,1353,31,1400,1170,230,0.774754857177664,0.223076923076923,1.2048635235732,565,230,335,31,1.5,50.29,5.1,0,0,0,0,0,0,0.139921446683157,88.7501013636463,15.2916532960267
9.7,"greedy_SVM","SVM",48,14,1284,1266,18,1500,1257,243,0.787228211218714,0.261538461538462,1.2048635235732,603,243,360,38,1.5,53.88,5.2,0,0,0,0,0,0,0.108814694254533,51.7305511597704,12.9224254688723
9.7,"greedy_SVM","SVM",48,15,1184,1168,16,1600,1355,245,0.789439064498451,0.269230769230769,1.2048635235732,612,245,367,9,1.5,57.47,5.5,0,0,0,0,0,0,0.0959822806936184,50.9561565799971,10.655053122108
9.7,"greedy_SVM","SVM",48,16,1084,1068,16,1700,1455,245,0.783872343017241,0.261538461538462,1.2048635235732,612,245,367,0,1.5,61.06,5.9,0,0,0,0,0,0,0.0584418859576674,20.937339211772,6.76764977326654
9.7,"greedy_SVM","SVM",48,17,984,970,14,1800,1553,247,0.783969791095686,0.253846153846154,1.2048635235732,611,247,364,-1,1.5,64.66,6.3,0,0,0,0,0,0,0.0553196160327972,22.1890909938701,6.43380706144023
9.7,"greedy_SVM","SVM",48,18,884,870,14,1900,1653,247,0.791381935562462,0.276923076923077,1.2048635235732,610,247,363,-1,1.5,68.25,6.7,0,0,0,0,0,0,0.00855665427700607,2.73025808622352,1.27347188055903
9.7,"greedy_SVM","SVM",48,19,784,770,14,2000,1753,247,0.791034776782999,0.246153846153846,1.2048635235732,608,247,361,-2,1.5,71.84,7.1,0,0,0,0,0,0,0.00740232305633464,2.33254079473327,1.049729104496
9.7,"greedy_SVM","SVM",48,20,684,670,14,2100,1853,247,0.790230830135822,0.246153846153846,1.2048635235732,608,247,361,0,1.5,75.43,7.5,0,0,0,0,0,0,0.00634824684392782,1.8123969549961,0.854349520007898
9.7,"greedy_SVM","SVM",48,21,584,571,13,2200,1952,248,0.795968085754313,0.276923076923077,1.2048635235732,612,248,364,4,1.5,79.02,7.9,0,0,0,0,0,0,0.00437688744648986,1.33025494522218,0.747602727535815
9.7,"greedy_SVM","SVM",48,22,484,474,10,2300,2049,251,0.77549180827091,0.2,1.21473945409429,619,251,368,7,1.5,82.61,8.2,0,0,0,0,0,0,0.0228774965780796,10.0752610485198,7.84460928584395
9.7,"greedy_SVM","SVM",48,23,384,374,10,2400,2149,251,0.779517632011698,0.253846153846154,1.21473945409429,621,251,370,2,1.5,86.21,8.6,0,0,0,0,0,0,0.000455983399500435,0.208219717397675,0.178086909670583
9.7,"greedy_SVM","SVM",48,24,284,277,7,2500,2246,254,0.78604665326756,0.238461538461538,1.21473945409429,643,254,389,22,1.5,89.8,8.8,0,0,0,0,0,0,0.0115343782606312,3.06797009208733,2.02468723860525
9.7,"greedy_SVM","SVM",48,25,184,181,3,2600,2342,258,0.782087825080703,0.215384615384615,1.25424317617866,661,258,403,18,1.6,93.39,9.1,0,0,0,0,0,0,0.00597127310244361,2.37708934154151,2.2264805190208
9.7,"greedy_SVM","SVM",48,26,84,84,0,2700,2439,261,0.784645837139901,0.215384615384615,1.28387096774194,690,261,429,29,1.6,96.98,9.3,0,0,0,0,0,0,1.60819921818755e-07,0.170241486743593,0.170241486743593
9.7,"greedy_SVM","SVM",48,27,0,0,0,2784,2523,261,0.808782508069921,0.238461538461538,1.27399503722084,676,261,415,-14,1.6,100,9.7,0,0,0,0,0,0,0,0,0
9.7,"greedy_SVM","SVM",49,0,2684,2429,255,100,91,9,0.816957122065906,0.409448818897638,1.22321564643129,36,9,27,0,3,3.59,10.1,0,0,0,0,0,0,0.116513086902038,247.608142451059,11.9244095099573
9.7,"greedy_SVM","SVM",49,1,2584,2371,213,200,149,51,0.654022216417261,0.196850393700787,1.13223266446533,122,51,71,86,1.4,7.18,2.9,0,0,0,0,0,0,0.260041337739977,585.3467912138,27.5719288337785
9.7,"greedy_SVM","SVM",49,2,2484,2287,197,300,233,67,0.750413603512834,0.149606299212598,1.28387096774194,157,67,90,35,1.3,10.78,3.5,0,0,0,0,0,0,0.274814675277925,445.504498011592,29.9888286843676
9.7,"greedy_SVM","SVM",49,3,2384,2203,181,400,317,83,0.774178701595952,0.165354330708661,1.28387096774194,203,83,120,46,1.4,14.37,3.8,0,0,0,0,0,0,0.225809967756392,267.069193894364,24.3905494656859
9.7,"greedy_SVM","SVM",49,4,2284,2116,168,500,404,96,0.814407085370256,0.299212598425197,1.28387096774194,228,96,132,25,1.4,17.96,4.2,0,0,0,0,0,0,0.197089648434674,276.496638914243,20.3411410520733
9.7,"greedy_SVM","SVM",49,5,2184,2049,135,600,471,129,0.805625007774505,0.259842519685039,1.28387096774194,301,129,172,73,1.3,21.55,3.7,0,0,0,0,0,0,0.217695409133117,247.717552076011,22.9399072609844
9.7,"greedy_SVM","SVM",49,6,2084,1967,117,700,553,147,0.832182707019444,0.259842519685039,1.28387096774194,343,147,196,42,1.3,25.14,3.8,0,0,0,0,0,0,0.209175379013642,235.691121361614,22.1128499275356
9.7,"greedy_SVM","SVM",49,7,1984,1886,98,800,634,166,0.837102411961538,0.267716535433071,1.28387096774194,394,166,228,51,1.4,28.74,3.8,0,0,0,0,0,0,0.189027127432073,158.040033843898,19.7583947929841
9.7,"greedy_SVM","SVM",49,8,1884,1807,77,900,713,187,0.844497518378924,0.228346456692913,1.28387096774194,439,187,252,45,1.3,32.33,3.8,0,0,0,0,0,0,0.191404705413641,148.583393085553,20.3151460849121
9.7,"greedy_SVM","SVM",49,9,1784,1719,65,1000,801,199,0.848366110634274,0.228346456692913,1.28387096774194,466,199,267,27,1.3,35.92,4,0,0,0,0,0,0,0.15133283810267,91.2297908921569,16.847808832318
9.7,"greedy_SVM","SVM",49,10,1684,1633,51,1100,887,213,0.822511226381066,0.228346456692913,1.26365252730505,515,213,302,49,1.4,39.51,4.2,0,0,0,0,0,0,0.195617087602741,141.349547422821,20.9061319979968
9.7,"greedy_SVM","SVM",49,11,1584,1534,50,1200,986,214,0.820769737905986,0.204724409448819,1.28387096774194,526,214,312,11,1.5,43.1,4.6,0,0,0,0,0,0,0.157537436652308,79.3313081644106,17.378127257422
9.7,"greedy_SVM","SVM",49,12,1484,1436,48,1300,1084,216,0.840106479581049,0.244094488188976,1.28387096774194,544,216,328,18,1.5,46.7,5,0,0,0,0,0,0,0.118425157721466,52.1357864586561,12.8527304477767
9.7,"greedy_SVM","SVM",49,13,1384,1344,40,1400,1176,224,0.837811446554962,0.251968503937008,1.28387096774194,561,224,337,17,1.5,50.29,5.2,0,0,0,0,0,0,0.117963780395948,51.5806359757413,13.5729025861889
9.7,"greedy_SVM","SVM",49,14,1284,1255,29,1500,1265,235,0.802235324849793,0.188976377952756,1.26365252730505,602,235,367,41,1.6,53.88,5.4,0,0,0,0,0,0,0.127528436960018,52.5035171327,14.1020659664417
9.7,"greedy_SVM","SVM",49,15,1184,1157,27,1600,1363,237,0.841138933462698,0.267716535433071,1.26365252730505,606,237,369,4,1.6,57.47,5.8,0,0,0,0,0,0,0.108329434718116,36.3045603660528,12.0142575863546
9.7,"greedy_SVM","SVM",49,16,1084,1058,26,1700,1462,238,0.80894627508054,0.21259842519685,1.26365252730505,626,238,388,20,1.6,61.06,6.1,0,0,0,0,0,0,0.100387983843961,33.8117614943486,11.0917128613651
9.7,"greedy_SVM","SVM",49,17,984,958,26,1800,1562,238,0.835392021494938,0.228346456692913,1.26365252730505,613,238,375,-13,1.6,64.66,6.6,0,0,0,0,0,0,0.0611464693610269,15.1925928119374,7.4356815959928
9.7,"greedy_SVM","SVM",49,18,884,860,24,1900,1660,240,0.846612182955799,0.299212598425197,1.26365252730505,613,240,373,0,1.6,68.25,6.9,0,0,0,0,0,0,0.0155992514990858,4.17297529235212,3.2694638095913
9.7,"greedy_SVM","SVM",49,19,784,762,22,2000,1758,242,0.826858727967059,0.236220472440945,1.26365252730505,618,242,376,5,1.6,71.84,7.3,0,0,0,0,0,0,0.019337981792513,7.58830277749309,4.23035039312926
9.7,"greedy_SVM","SVM",49,20,684,669,15,2100,1851,249,0.840286848030257,0.267716535433071,1.28387096774194,658,249,409,40,1.6,75.43,7.4,0,0,0,0,0,0,0.0221828246363839,6.96630282513987,3.6453422259937
9.7,"greedy_SVM","SVM",49,21,584,576,8,2200,1944,256,0.841935042479879,0.291338582677165,1.28387096774194,675,256,419,17,1.6,79.02,7.6,0,0,0,0,0,0,0.0693139346270445,21.9544458645467,10.8469018413453
9.7,"greedy_SVM","SVM",49,22,484,480,4,2300,2040,260,0.825235411924221,0.244094488188976,1.28387096774194,678,260,418,3,1.6,82.61,7.8,0,0,0,0,0,0,0.034589680789809,8.21387551287598,5.30546340463722
9.7,"greedy_SVM","SVM",49,23,384,382,2,2400,2138,262,0.849435882126109,0.307086614173228,1.28387096774194,702,262,440,24,1.7,86.21,8.2,0,0,0,0,0,0,0.015984036540663,4.25416620736783,3.36475974390405
9.7,"greedy_SVM","SVM",49,24,284,282,2,2500,2238,262,0.85818064211168,0.322834645669291,1.28387096774194,702,262,440,0,1.7,89.8,8.5,0,0,0,0,0,0,0.00253782081858269,0.860780637908301,0.753797792884342
9.7,"greedy_SVM","SVM",49,25,184,183,1,2600,2337,263,0.806004403478,0.21259842519685,1.28268876611418,723,263,460,21,1.7,93.39,8.9,0,0,0,0,0,0,0.0149370904551394,6.06115200193389,5.57357749104012
9.7,"greedy_SVM","SVM",49,26,84,84,0,2700,2436,264,0.764756005025438,0.141732283464567,1.28268876611418,704,264,440,-19,1.7,96.98,9.2,0,0,0,0,0,0,1.95979493160632e-06,2.15046413198732,2.15046413198732
9.7,"greedy_SVM","SVM",49,27,0,0,0,2784,2520,264,0.815439539251907,0.244094488188976,1.28268876611418,697,264,433,-7,1.6,100,9.5,0,0,0,0,0,0,0,0,0
9.7,"greedy_SVM","SVM",50,0,2684,2444,240,100,95,5,0.74104975228219,0.273972602739726,1.13437914273089,17,5,12,0,2.4,3.59,19,0,0,0,0,0,0,0.110065147574643,152.015886393198,16.386038047989
9.7,"greedy_SVM","SVM",50,1,2584,2362,222,200,177,23,0.731179488306179,0.184931506849315,1.2311091471498,78,23,55,61,2.4,7.18,7.7,0,0,0,0,0,0,0.146587727226518,254.925600869963,47.2900878578902
9.7,"greedy_SVM","SVM",50,2,2484,2273,211,300,266,34,0.790219815227768,0.253424657534247,1.26628369421122,107,34,73,29,2.1,10.78,7.8,0,0,0,0,0,0,0.142944397671348,206.333460974532,14.8241650649353
9.7,"greedy_SVM","SVM",50,3,2384,2190,194,400,349,51,0.799051971306469,0.294520547945205,1.26628369421122,154,51,103,47,2,14.37,6.8,0,0,0,0,0,0,0.160592847426305,167.99579544493,16.6364389684685
9.7,"greedy_SVM","SVM",50,4,2284,2119,165,500,420,80,0.807016291153553,0.294520547945205,1.27507733097658,212,80,132,58,1.6,17.96,5.2,0,0,0,0,0,0,0.183931670415195,155.561683751767,19.5210131399619
9.7,"greedy_SVM","SVM",50,5,2184,2051,133,600,488,112,0.781459063395979,0.184931506849315,1.27507733097658,282,112,170,70,1.5,21.55,4.4,0,0,0,0,0,0,0.234455153897663,206.376447277509,44.2517200136796
9.7,"greedy_SVM","SVM",50,6,2084,1960,124,700,579,121,0.803951401171023,0.267123287671233,1.26628369421122,317,121,196,35,1.6,25.14,4.8,0,0,0,0,0,0,0.193548504946822,167.837148946081,19.9841042622039
9.7,"greedy_SVM","SVM",50,7,1984,1888,96,800,651,149,0.808515780338558,0.280821917808219,1.26511768712632,399,149,250,82,1.7,28.74,4.4,0,0,0,0,0,0,0.206296788044965,129.533255614057,21.6567349354548
9.7,"greedy_SVM","SVM",50,8,1884,1815,69,900,724,176,0.798607067921908,0.226027397260274,1.26628369421122,453,176,277,54,1.6,32.33,4.1,0,0,0,0,0,0,0.208967396488081,181.873063384502,21.1863904397678
9.7,"greedy_SVM","SVM",50,9,1784,1732,52,1000,807,193,0.813629422943825,0.253424657534247,1.26628369421122,496,193,303,43,1.6,35.92,4.2,0,0,0,0,0,0,0.197819044383232,126.326533850758,20.6712531804716
9.7,"greedy_SVM","SVM",50,10,1684,1651,33,1100,888,212,0.811586162955471,0.246575342465753,1.26628369421122,530,212,318,34,1.5,39.51,4.2,0,0,0,0,0,0,0.169523340479342,102.736742574475,18.4561755545121
9.7,"greedy_SVM","SVM",50,11,1584,1556,28,1200,983,217,0.808230163350946,0.26027397260274,1.26628369421122,560,217,343,30,1.6,43.1,4.5,0,0,0,0,0,0,0.116482654489779,50.5189704599044,14.3684148232908
9.7,"greedy_SVM","SVM",50,12,1484,1461,23,1300,1078,222,0.813404224934362,0.273972602739726,1.24869642068051,577,222,355,17,1.6,46.7,4.9,0,0,0,0,0,0,0.109508984286485,48.0971038196356,12.866183824791
9.7,"greedy_SVM","SVM",50,13,1384,1365,19,1400,1174,226,0.819830607155796,0.321917808219178,1.25749005744587,594,226,368,17,1.6,50.29,5.2,0,0,0,0,0,0,0.109560364441283,34.9183737381196,13.5338433795973
9.7,"greedy_SVM","SVM",50,14,1284,1267,17,1500,1272,228,0.815485933363354,0.335616438356164,1.24869642068051,631,228,403,37,1.8,53.88,5.6,0,0,0,0,0,0,0.119533154180849,62.0341685145047,13.358586665665
9.7,"greedy_SVM","SVM",50,15,1184,1169,15,1600,1370,230,0.800101064472536,0.280821917808219,1.23990278391516,628,230,398,-3,1.7,57.47,6,0,0,0,0,0,0,0.0645381010925914,23.9485029696953,8.65967297589332
9.7,"greedy_SVM","SVM",50,16,1084,1070,14,1700,1469,231,0.793037536663332,0.26027397260274,1.23990278391516,642,231,411,14,1.8,61.06,6.4,0,0,0,0,0,0,0.0501950955799584,18.6759565572987,7.93015397546062
9.7,"greedy_SVM","SVM",50,17,984,972,12,1800,1567,233,0.79926069141281,0.321917808219178,1.2311091471498,651,233,418,9,1.8,64.66,6.7,0,0,0,0,0,0,0.123672805704103,108.821312845713,12.6474519154636
9.7,"greedy_SVM","SVM",50,18,884,872,12,1900,1667,233,0.793614263272947,0.267123287671233,1.2311091471498,646,233,413,-5,1.8,68.25,7.2,0,0,0,0,0,0,0.045510132435307,16.3289057211414,5.43479798852424
9.7,"greedy_SVM","SVM",50,19,784,773,11,2000,1766,234,0.791345805275124,0.273972602739726,1.23990278391516,650,234,416,4,1.8,71.84,7.5,0,0,0,0,0,0,0.0175834186108932,5.76554439190354,2.72919286440638
9.7,"greedy_SVM","SVM",50,20,684,675,9,2100,1864,236,0.784606342894174,0.273972602739726,1.24869642068051,645,236,409,-5,1.7,75.43,7.9,0,0,0,0,0,0,0.0351996632174468,11.9693336186612,4.6718249786087
9.7,"greedy_SVM","SVM",50,21,584,578,6,2200,1961,239,0.787610813898554,0.267123287671233,1.26628369421122,700,239,461,55,1.9,79.02,8.2,0,0,0,0,0,0,0.0275449408653244,8.30609053681025,7.13099095961506
9.7,"greedy_SVM","SVM",50,22,484,484,0,2300,2055,245,0.765717173270635,0.219178082191781,1.26628369421122,708,245,463,8,1.9,82.61,8.4,0,0,0,0,0,0,0.00254504798620859,1.60715760932178,1.50365900087867
9.7,"greedy_SVM","SVM",50,23,384,384,0,2400,2155,245,0.789115795717934,0.267123287671233,1.25749005744587,691,245,446,-17,1.8,86.21,8.8,0,0,0,0,0,0,0.0010510847962031,0.412133819642236,0.353243041924982
9.7,"greedy_SVM","SVM",50,24,284,284,0,2500,2255,245,0.740797091100825,0.184931506849315,1.25749005744587,682,245,437,-9,1.8,89.8,9.2,0,0,0,0,0,0,2.06117146347273e-05,0.0213101768721609,0.0207033896742575
9.7,"greedy_SVM","SVM",50,25,184,184,0,2600,2355,245,0.817161186848431,0.321917808219178,1.25749005744587,698,245,453,16,1.8,93.39,9.6,0,0,0,0,0,0,2.65920005612382e-06,0.00272973658916439,0.00264742236492796
9.7,"greedy_SVM","SVM",50,26,84,84,0,2700,2455,245,0.76423965462314,0.232876712328767,1.26628369421122,685,245,440,-13,1.8,96.98,10,0,0,0,0,0,0,1.06827686719574e-05,0.0100487406400374,0.0100487406400374
9.7,"greedy_SVM","SVM",50,27,0,0,0,2784,2539,245,0.727395063220215,0.171232876712329,1.26628369421122,689,245,444,4,1.8,100,10.4,0,0,0,0,0,0,0,0,0
9.7,"greedy_SVM","SVM",51,0,2684,2433,251,100,91,9,0.778190440473737,0.297709923664122,1.2348682590495,31,9,22,0,2.4,3.59,10.1,0,0,0,0,0,0,0.106481288983141,257.439326638764,10.9947105225871
9.7,"greedy_SVM","SVM",51,1,2584,2367,217,200,157,43,0.730501687615681,0.198473282442748,1.26426988426496,111,43,68,80,1.6,7.18,3.7,0,0,0,0,0,0,0.224714841412173,528.667468994108,23.145013255847
9.7,"greedy_SVM","SVM",51,2,2484,2283,201,300,241,59,0.765348834395903,0.267175572519084,1.24466880078798,151,59,92,40,1.6,10.78,4.1,0,0,0,0,0,0,0.216209058428321,426.937602262376,22.1372683480061
9.7,"greedy_SVM","SVM",51,3,2384,2188,196,400,336,64,0.781196694934729,0.282442748091603,1.24466880078798,175,64,111,24,1.7,14.37,5.2,0,0,0,0,0,0,0.179055404946341,259.358242635545,18.4641520124276
9.7,"greedy_SVM","SVM",51,4,2284,2113,171,500,411,89,0.78639261562284,0.282442748091603,1.24466880078798,232,89,143,57,1.6,17.96,4.6,0,0,0,0,0,0,0.190576789809167,232.914602303733,20.0038084492255
9.7,"greedy_SVM","SVM",51,5,2184,2030,154,600,494,106,0.792653125415847,0.297709923664122,1.2348682590495,286,106,180,54,1.7,21.55,4.7,0,0,0,0,0,0,0.183402809011501,202.623358803195,18.7043659749153
9.7,"greedy_SVM","SVM",51,6,2084,1964,120,700,560,140,0.805053168967217,0.282442748091603,1.22506771731101,365,140,225,79,1.6,25.14,4,0,0,0,0,0,0,0.207005205782248,209.065957691185,21.1578227225045
9.7,"greedy_SVM","SVM",51,7,1984,1896,88,800,628,172,0.804672094458075,0.305343511450382,1.21526717557252,436,172,264,71,1.5,28.74,3.7,0,0,0,0,0,0,0.209885490017996,156.084576771955,22.0231906993583
9.7,"greedy_SVM","SVM",51,8,1884,1817,67,900,707,193,0.812426658278978,0.305343511450382,1.20546663383403,484,193,291,48,1.5,32.33,3.7,0,0,0,0,0,0,0.212172166985172,300.883424207616,21.4931584463828
9.7,"greedy_SVM","SVM",51,9,1784,1728,56,1000,796,204,0.790753801671874,0.274809160305344,1.20546663383403,527,204,323,43,1.6,35.92,3.9,0,0,0,0,0,0,0.193485322121232,170.53433727462,20.4337052667195
9.7,"greedy_SVM","SVM",51,10,1684,1632,52,1100,892,208,0.792604735001989,0.206106870229008,1.2348682590495,554,208,346,27,1.7,39.51,4.3,0,0,0,0,0,0,0.183989666514212,113.277516107926,19.4564928695494
9.7,"greedy_SVM","SVM",51,11,1584,1537,47,1200,987,213,0.778027122826961,0.221374045801527,1.2348682590495,564,213,351,10,1.6,43.1,4.6,0,0,0,0,0,0,0.183420498930209,152.037298203798,19.5463079423665
9.7,"greedy_SVM","SVM",51,12,1484,1441,43,1300,1083,217,0.811579826036455,0.297709923664122,1.24466880078798,572,217,355,8,1.6,46.7,5,0,0,0,0,0,0,0.153562352032001,89.8279023958461,16.2074942343393
9.7,"greedy_SVM","SVM",51,13,1384,1342,42,1400,1182,218,0.771185928067646,0.198473282442748,1.24466880078798,573,218,355,1,1.6,50.29,5.4,0,0,0,0,0,0,0.135494831268933,63.0306015619624,14.4602315002438
9.7,"greedy_SVM","SVM",51,14,1284,1247,37,1500,1277,223,0.794564546763281,0.221374045801527,1.2348682590495,596,223,373,23,1.7,53.88,5.7,0,0,0,0,0,0,0.101805133084967,36.4717815995649,12.1077111579692
9.7,"greedy_SVM","SVM",51,15,1184,1149,35,1600,1375,225,0.803274821257901,0.267175572519084,1.2348682590495,580,225,355,-16,1.6,57.47,6.1,0,0,0,0,0,0,0.111031865910187,41.8391399606694,12.1321911816228
9.7,"greedy_SVM","SVM",51,16,1084,1049,35,1700,1475,225,0.804829363303122,0.282442748091603,1.2348682590495,599,225,374,19,1.7,61.06,6.6,0,0,0,0,0,0,0.046844135104549,12.3391662654957,7.26565718124185
9.7,"greedy_SVM","SVM",51,17,984,949,35,1800,1575,225,0.797425629982691,0.251908396946565,1.2348682590495,586,225,361,-13,1.6,64.66,7,0,0,0,0,0,0,0.0709011443525293,18.6379962973315,8.6427658736711
9.7,"greedy_SVM","SVM",51,18,884,850,34,1900,1674,226,0.787684034792705,0.236641221374046,1.25446934252647,599,226,373,13,1.7,68.25,7.4,0,0,0,0,0,0,1.60560477626602e-05,1.25075670246121,1.25034764521577
9.7,"greedy_SVM","SVM",51,19,784,754,30,2000,1770,230,0.792562393389867,0.244274809160305,1.27407042600345,610,230,380,11,1.7,71.84,7.7,0,0,0,0,0,0,0.0089736676410685,5.16348644312789,4.54616335497384
9.7,"greedy_SVM","SVM",51,20,684,668,16,2100,1856,244,0.807980789005695,0.221374045801527,1.27407042600345,657,244,413,47,1.7,75.43,7.6,0,0,0,0,0,0,0.126427080161971,54.2127284326922,32.6580160792159
9.7,"greedy_SVM","SVM",51,21,584,575,9,2200,1949,251,0.791153022586225,0.198473282442748,1.28387096774194,677,251,426,20,1.7,79.02,7.8,0,0,0,0,0,0,0.134159982965908,55.5366271183657,24.5273309613681
9.7,"greedy_SVM","SVM",51,22,484,477,7,2300,2047,253,0.833561171531918,0.251908396946565,1.28387096774194,700,253,447,23,1.8,82.61,8.1,0,0,0,0,0,0,0.0979413336184505,30.604118899607,13.1604545571441
9.7,"greedy_SVM","SVM",51,23,384,380,4,2400,2144,256,0.784069875757611,0.183206106870229,1.28387096774194,693,256,437,-7,1.7,86.21,8.4,0,0,0,0,0,0,0.0992627383291568,30.6183066284223,10.7667954223546
9.7,"greedy_SVM","SVM",51,24,284,282,2,2500,2242,258,0.770109241359286,0.213740458015267,1.28387096774194,732,258,474,39,1.8,89.8,8.7,0,0,0,0,0,0,0.0369368718360109,7.8556309526838,5.66727494715001
9.7,"greedy_SVM","SVM",51,25,184,184,0,2600,2340,260,0.815039740627383,0.259541984732824,1.28387096774194,722,260,462,-10,1.8,93.39,9,0,0,0,0,0,0,0.0252487425578022,6.09859702854247,5.28046242260901
9.7,"greedy_SVM","SVM",51,26,84,84,0,2700,2440,260,0.837861869563639,0.290076335877863,1.28387096774194,714,260,454,-8,1.7,96.98,9.4,0,0,0,0,0,0,3.6258465228355e-12,0.147402479458687,0.147402479458687
9.7,"greedy_SVM","SVM",51,27,0,0,0,2784,2524,260,0.823054402922778,0.236641221374046,1.28387096774194,725,260,465,11,1.8,100,9.7,0,0,0,0,0,0,0,0,0
9.7,"greedy_SVM","SVM",52,0,2684,2434,250,100,91,9,0.768083291279157,0.234848484848485,1.2352394916911,24,9,15,0,1.7,3.59,10.1,0,0,0,0,0,0,0.101463488778387,262.590362951463,10.2203890817432
9.7,"greedy_SVM","SVM",52,1,2584,2356,228,200,169,31,0.745518227476993,0.242424242424242,1.17688172043011,90,31,59,66,1.9,7.18,5.5,0,0,0,0,0,0,0.1998544274106,341.951202470703,27.3760018119222
9.7,"greedy_SVM","SVM",52,2,2484,2272,212,300,253,47,0.787920842044547,0.303030303030303,1.21578690127077,124,47,77,34,1.6,10.78,5.4,0,0,0,0,0,0,0.201456220552849,272.034217152587,23.4326493833677
9.7,"greedy_SVM","SVM",52,3,2384,2198,186,400,327,73,0.789687117006696,0.318181818181818,1.21578690127077,180,73,107,56,1.5,14.37,4.5,0,0,0,0,0,0,0.215903944494317,218.516335390419,22.1452633749897
9.7,"greedy_SVM","SVM",52,4,2284,2128,156,500,397,103,0.794769663326354,0.295454545454545,1.21578690127077,258,103,155,78,1.5,17.96,3.9,0,0,0,0,0,0,0.228967415927009,199.522981438256,23.1734531586596
9.7,"greedy_SVM","SVM",52,5,2184,2061,123,600,464,136,0.78921851344531,0.242424242424242,1.21578690127077,329,136,193,71,1.4,21.55,3.4,0,0,0,0,0,0,0.243426728278837,211.079391569783,24.6258586909151
9.7,"greedy_SVM","SVM",52,6,2084,1989,95,700,536,164,0.792492730637052,0.265151515151515,1.21578690127077,391,164,227,62,1.4,25.14,3.3,0,0,0,0,0,0,0.251357956019892,168.134300746107,25.5069485637382
9.7,"greedy_SVM","SVM",52,7,1984,1915,69,800,610,190,0.798368298368289,0.310606060606061,1.21578690127077,452,190,262,61,1.4,28.74,3.2,0,0,0,0,0,0,0.243344967463183,217.838810667963,24.8628401471327
9.7,"greedy_SVM","SVM",52,8,1884,1837,47,900,688,212,0.798091942421833,0.295454545454545,1.21578690127077,518,212,306,66,1.4,32.33,3.2,0,0,0,0,0,0,0.22383037647311,113.211198577987,23.8061022451
9.7,"greedy_SVM","SVM",52,9,1784,1742,42,1000,783,217,0.796097373416959,0.310606060606061,1.21578690127077,527,217,310,9,1.4,35.92,3.6,0,0,0,0,0,0,0.188627843022606,85.9175456455174,20.2966122529261
9.7,"greedy_SVM","SVM",52,10,1684,1643,41,1100,882,218,0.806989402350217,0.310606060606061,1.21578690127077,531,218,313,4,1.4,39.51,4,0,0,0,0,0,0,0.149150220514646,59.6667546397785,17.199758666949
9.7,"greedy_SVM","SVM",52,11,1584,1544,40,1200,981,219,0.796355706149515,0.310606060606061,1.21578690127077,536,219,317,5,1.4,43.1,4.5,0,0,0,0,0,0,0.0609097843046018,18.0045179007854,8.95570640534335
9.7,"greedy_SVM","SVM",52,12,1484,1450,34,1300,1075,225,0.816193256914898,0.325757575757576,1.21578690127077,548,225,323,12,1.4,46.7,4.8,0,0,0,0,0,0,0.110424545871863,37.0007282568815,14.9457576248618
9.7,"greedy_SVM","SVM",52,13,1384,1358,26,1400,1167,233,0.818902746737793,0.340909090909091,1.21578690127077,568,233,335,20,1.4,50.29,5,0,0,0,0,0,0,0.0751716545869644,20.8934175858499,9.92904870652679
9.7,"greedy_SVM","SVM",52,14,1284,1259,25,1500,1266,234,0.803531949150508,0.242424242424242,1.21578690127077,591,234,357,23,1.5,53.88,5.4,0,0,0,0,0,0,0.0809929058109887,31.219982573825,10.3020398226087
9.7,"greedy_SVM","SVM",52,15,1184,1160,24,1600,1365,235,0.779401869608051,0.25,1.21578690127077,602,235,367,11,1.6,57.47,5.8,0,0,0,0,0,0,0.165406773046753,62.157183533353,18.2151920086242
9.7,"greedy_SVM","SVM",52,16,1084,1061,23,1700,1464,236,0.80166955038089,0.303030303030303,1.21578690127077,594,236,358,-8,1.5,61.06,6.2,0,0,0,0,0,0,0.103391112942958,26.0079222404903,13.1368488780047
9.7,"greedy_SVM","SVM",52,17,984,962,22,1800,1563,237,0.81198183260039,0.318181818181818,1.21578690127077,614,237,377,20,1.6,64.66,6.6,0,0,0,0,0,0,0.0536423446451251,11.8270169810018,7.41050086144495
9.7,"greedy_SVM","SVM",52,18,884,863,21,1900,1662,238,0.764451613678416,0.212121212121212,1.21578690127077,617,238,379,3,1.6,68.25,7,0,0,0,0,0,0,0.0349576354459476,8.15502021501709,7.0647450887966
9.7,"greedy_SVM","SVM",52,19,784,763,21,2000,1762,238,0.78114411361834,0.174242424242424,1.21578690127077,605,238,367,-12,1.5,71.84,7.4,0,0,0,0,0,0,0.000101834674298339,1.01774254627948,1.01531696065158
9.7,"greedy_SVM","SVM",52,20,684,666,18,2100,1859,241,0.813766130776435,0.325757575757576,1.22551319648094,628,241,387,23,1.6,75.43,7.7,0,0,0,0,0,0,2.97740896650615e-05,0.168615149616021,0.16700147507303
9.7,"greedy_SVM","SVM",52,21,584,573,11,2200,1952,248,0.817929493187214,0.287878787878788,1.25469208211144,644,248,396,16,1.6,79.02,7.9,0,0,0,0,0,0,0.00802878860580362,4.14241766827856,3.22608153025875
9.7,"greedy_SVM","SVM",52,22,484,475,9,2300,2050,250,0.829692644125621,0.325757575757576,1.25469208211144,650,250,400,6,1.6,82.61,8.2,0,0,0,0,0,0,0.0123966275694685,3.7266384693529,2.37397468593078
9.7,"greedy_SVM","SVM",52,23,384,378,6,2400,2147,253,0.805361305361298,0.265151515151515,1.25469208211144,668,253,415,18,1.6,86.21,8.5,0,0,0,0,0,0,0.075412483792531,21.4076401575974,12.2169837237515
9.7,"greedy_SVM","SVM",52,24,284,278,6,2500,2247,253,0.807488044601442,0.242424242424242,1.25469208211144,666,253,413,-2,1.6,89.8,8.9,0,0,0,0,0,0,0.0458834573016472,10.2902744439767,6.02567381367368
9.7,"greedy_SVM","SVM",52,25,184,178,6,2600,2347,253,0.823853122822188,0.295454545454545,1.25469208211144,649,253,396,-17,1.6,93.39,9.3,0,0,0,0,0,0,0.0207091566902371,4.22521875035955,3.34689543667414
9.7,"greedy_SVM","SVM",52,26,84,84,0,2700,2441,259,0.790597289308625,0.227272727272727,1.27297142697695,690,259,431,41,1.7,96.98,9.4,0,0,0,0,0,0,6.53416825495756e-07,0.447905935145249,0.447905935145249
9.7,"greedy_SVM","SVM",52,27,0,0,0,2784,2525,259,0.791195059236297,0.212121212121212,1.2644183773216,688,259,429,-2,1.7,100,9.7,0,0,0,0,0,0,0,0,0
9.7,"greedy_SVM","SVM",53,0,2684,2423,261,100,83,17,0.802316095132735,0.327433628318584,1.21570082786183,42,17,25,0,1.5,3.59,4.9,0,0,0,0,0,0,0.235855484723852,441.858175829896,24.3194199804165
9.7,"greedy_SVM","SVM",53,1,2584,2351,233,200,155,45,0.679424778761057,0.0973451327433628,1.24978589780188,121,45,76,79,1.7,7.18,3.4,0,0,0,0,0,0,0.238784293158243,577.253139873216,24.599862369628
9.7,"greedy_SVM","SVM",53,2,2484,2260,224,300,246,54,0.764909430309729,0.176991150442478,1.21458139800192,147,54,93,26,1.7,10.78,4.6,0,0,0,0,0,0,0.201070004848384,423.785130116424,23.4308611412025
9.7,"greedy_SVM","SVM",53,3,2384,2170,214,400,336,64,0.812085176991144,0.230088495575221,1.23842420782187,181,64,117,34,1.8,14.37,5.2,0,0,0,0,0,0,0.182887090056397,323.85042231891,18.9353760505202
9.7,"greedy_SVM","SVM",53,4,2284,2100,184,500,406,94,0.80866980088495,0.292035398230089,1.27250927776192,242,94,148,61,1.6,17.96,4.3,0,0,0,0,0,0,0.227544943113351,344.69179508596,24.1958226833903
9.7,"greedy_SVM","SVM",53,5,2184,2036,148,600,470,130,0.818660121681411,0.31858407079646,1.28387096774194,324,130,194,82,1.5,21.55,3.6,0,0,0,0,0,0,0.23178356841917,382.062558723993,23.6488668710093
9.7,"greedy_SVM","SVM",53,6,2084,1962,122,700,544,156,0.822683904867251,0.292035398230089,1.27250927776192,383,156,227,59,1.5,25.14,3.5,0,0,0,0,0,0,0.226037495831398,368.242450895047,22.8969489727497
9.7,"greedy_SVM","SVM",53,7,1984,1885,99,800,621,179,0.827046460176987,0.256637168141593,1.2611475877819,439,179,260,56,1.5,28.74,3.5,0,0,0,0,0,0,0.225519237311485,315.921272814145,23.1012572245128
9.7,"greedy_SVM","SVM",53,8,1884,1807,77,900,699,201,0.797289823008846,0.176991150442478,1.2611475877819,503,201,302,64,1.5,32.33,3.5,0,0,0,0,0,0,0.23026470716637,324.596064086655,24.1014591767422
9.7,"greedy_SVM","SVM",53,9,1784,1709,75,1000,797,203,0.817035398230085,0.230088495575221,1.27250927776192,509,203,306,6,1.5,35.92,3.9,0,0,0,0,0,0,0.200958837062709,268.594807959544,20.4682450970353
9.7,"greedy_SVM","SVM",53,10,1684,1620,64,1100,886,214,0.831457411504422,0.256637168141593,1.27250927776192,539,214,325,30,1.5,39.51,4.1,0,0,0,0,0,0,0.182532819846654,190.054713764631,19.1523368386633
9.7,"greedy_SVM","SVM",53,11,1584,1531,53,1200,975,225,0.832985342920351,0.256637168141593,1.27250927776192,566,225,341,27,1.5,43.1,4.3,0,0,0,0,0,0,0.171277170362301,174.126939407394,17.8537515881564
9.7,"greedy_SVM","SVM",53,12,1484,1443,41,1300,1063,237,0.833192754424777,0.221238938053097,1.27250927776192,602,237,365,36,1.5,46.7,4.5,0,0,0,0,0,0,0.171642668876565,164.781612773766,18.0431764547603
9.7,"greedy_SVM","SVM",53,13,1384,1357,27,1400,1149,251,0.834133019911503,0.20353982300885,1.27250927776192,635,251,384,33,1.5,50.29,4.6,0,0,0,0,0,0,0.132570463240045,80.6983963675801,15.8485160591847
9.7,"greedy_SVM","SVM",53,14,1284,1268,16,1500,1238,262,0.833483130530972,0.221238938053097,1.27250927776192,663,262,401,28,1.5,53.88,4.7,0,0,0,0,0,0,0.128949090832267,76.5754364225457,16.7068641657273
9.7,"greedy_SVM","SVM",53,15,1184,1174,10,1600,1332,268,0.815272400442477,0.194690265486726,1.27250927776192,694,268,426,31,1.6,57.47,5,0,0,0,0,0,0,0.161570284442172,120.898844271983,17.0294226305752
9.7,"greedy_SVM","SVM",53,16,1084,1075,9,1700,1431,269,0.822918971238936,0.185840707964602,1.27250927776192,704,269,435,10,1.6,61.06,5.3,0,0,0,0,0,0,0.126806700401905,72.608066271315,13.8824102531445
9.7,"greedy_SVM","SVM",53,17,984,978,6,1800,1528,272,0.83288163716814,0.221238938053097,1.27250927776192,717,272,445,13,1.6,64.66,5.6,0,0,0,0,0,0,0.115890045661106,63.3696112716664,12.6773549113498
9.7,"greedy_SVM","SVM",53,18,884,879,5,1900,1627,273,0.827482024336282,0.230088495575221,1.27250927776192,720,273,447,3,1.6,68.25,6,0,0,0,0,0,0,0.0715682153046111,29.6796574684042,8.7271827154955
9.7,"greedy_SVM","SVM",53,19,784,781,3,2000,1725,275,0.824329369469025,0.194690265486726,1.27250927776192,731,275,456,11,1.7,71.84,6.3,0,0,0,0,0,0,0.0485669215365982,15.9586789828217,6.28907717731066
9.7,"greedy_SVM","SVM",53,20,684,681,3,2100,1825,275,0.815306969026547,0.168141592920354,1.27250927776192,736,275,461,5,1.7,75.43,6.6,0,0,0,0,0,0,0.0684636981413967,27.8641094025777,7.81796051274243
9.7,"greedy_SVM","SVM",53,21,584,581,3,2200,1925,275,0.842671460176989,0.230088495575221,1.27250927776192,734,275,459,-2,1.7,79.02,7,0,0,0,0,0,0,0.036504594599523,11.5518086535433,4.56966280380687
9.7,"greedy_SVM","SVM",53,22,484,482,2,2300,2024,276,0.810405143805307,0.168141592920354,1.27250927776192,740,276,464,6,1.7,82.61,7.3,0,0,0,0,0,0,0.0220229272654198,10.1943269568185,7.84110957674711
9.7,"greedy_SVM","SVM",53,23,384,384,0,2400,2122,278,0.824412334070795,0.176991150442478,1.28387096774194,763,278,485,23,1.7,86.21,7.6,0,0,0,0,0,0,0.0252121291191522,7.4198814144444,5.16380533528798
9.7,"greedy_SVM","SVM",53,24,284,284,0,2500,2222,278,0.794676438053096,0.141592920353982,1.28387096774194,764,278,486,1,1.7,89.8,8,0,0,0,0,0,0,0.00788575341063546,1.83183418941671,1.42794789685212
9.7,"greedy_SVM","SVM",53,25,184,184,0,2600,2322,278,0.826037057522122,0.194690265486726,1.28387096774194,752,278,474,-12,1.7,93.39,8.4,0,0,0,0,0,0,0.00150215798758769,0.628230615110648,0.586357422934989
9.7,"greedy_SVM","SVM",53,26,84,84,0,2700,2422,278,0.814055586283184,0.238938053097345,1.28387096774194,760,278,482,8,1.7,96.98,8.7,0,0,0,0,0,0,2.69856023074462e-07,0.0222474033469573,0.0222474033469573
9.7,"greedy_SVM","SVM",53,27,0,0,0,2784,2506,278,0.808759679203538,0.185840707964602,1.28387096774194,755,278,477,-5,1.7,100,9,0,0,0,0,0,0,0,0,0
9.7,"greedy_SVM","SVM",54,0,2684,2421,263,100,92,8,0.199620319455355,0.00833333333333333,0.588440860215054,26,8,18,0,2.2,3.59,11.5,0,0,0,0,0,0,0.0861441520016099,216.310347292137,8.68634787055599
9.7,"greedy_SVM","SVM",54,1,2584,2321,263,200,192,8,0.783051846032986,0.166666666666667,1.2410752688172,25,8,17,-1,2.1,7.18,24,0,0,0,0,0,0,0.0468064215395422,112.567389319259,4.8319840546247
9.7,"greedy_SVM","SVM",54,2,2484,2240,244,300,273,27,0.830459544383333,0.2,1.27317204301075,88,27,61,63,2.3,10.78,10.1,0,0,0,0,0,0,0.162886456304584,247.185024881931,19.7572579434339
9.7,"greedy_SVM","SVM",54,3,2384,2160,224,400,353,47,0.801505629746002,0.241666666666667,1.27317204301075,134,47,87,46,1.9,14.37,7.5,0,0,0,0,0,0,0.184897151452134,277.184584364978,20.0889673139341
9.7,"greedy_SVM","SVM",54,4,2284,2084,200,500,429,71,0.788819062581829,0.258333333333333,1.26247311827957,187,71,116,53,1.6,17.96,6,0,0,0,0,0,0,0.221046356808078,234.957919798554,26.1325593665222
9.7,"greedy_SVM","SVM",54,5,2184,2011,173,600,502,98,0.780466090599635,0.216666666666667,1.28387096774194,249,98,151,62,1.5,21.55,5.1,0,0,0,0,0,0,0.208911484404399,244.784861471313,21.7731384142834
9.7,"greedy_SVM","SVM",54,6,2084,1925,159,700,588,112,0.80904687090861,0.266666666666667,1.27317204301075,292,112,180,43,1.6,25.14,5.2,0,0,0,0,0,0,0.182702037848981,185.12212764156,19.2403127606448
9.7,"greedy_SVM","SVM",54,7,1984,1852,132,800,661,139,0.792687876407433,0.2,1.27317204301075,356,139,217,64,1.6,28.74,4.8,0,0,0,0,0,0,0.182250110514866,156.333724701037,20.018931927333
9.7,"greedy_SVM","SVM",54,8,1884,1765,119,900,748,152,0.806893165750194,0.225,1.28387096774194,399,152,247,43,1.6,32.33,4.9,0,0,0,0,0,0,0.168812055361154,137.803775073948,17.7482041119183
9.7,"greedy_SVM","SVM",54,9,1784,1685,99,1000,828,172,0.818565069389885,0.25,1.27317204301075,439,172,267,40,1.6,35.92,4.8,0,0,0,0,0,0,0.173800416864064,127.620528801478,18.6339994703833
9.7,"greedy_SVM","SVM",54,10,1684,1606,78,1100,907,193,0.819141136423142,0.233333333333333,1.27317204301075,489,193,296,50,1.5,39.51,4.7,0,0,0,0,0,0,0.176402714351489,136.921318668968,18.720881757569
9.7,"greedy_SVM","SVM",54,11,1584,1536,48,1200,977,223,0.82602775595705,0.225,1.27317204301075,563,223,340,74,1.5,43.1,4.4,0,0,0,0,0,0,0.168839571751319,92.5457193711476,19.8304424561116
9.7,"greedy_SVM","SVM",54,12,1484,1451,33,1300,1062,238,0.844376800209472,0.258333333333333,1.27317204301075,598,238,360,35,1.5,46.7,4.5,0,0,0,0,0,0,0.118964815488786,55.5769929401637,14.3339286695196
9.7,"greedy_SVM","SVM",54,13,1384,1362,22,1400,1151,249,0.83466221523959,0.275,1.28387096774194,646,249,397,48,1.6,50.29,4.6,0,0,0,0,0,0,0.148945031371949,86.2911772332756,16.4601774336909
9.7,"greedy_SVM","SVM",54,14,1284,1268,16,1500,1245,255,0.806101073579469,0.208333333333333,1.27317204301075,681,255,426,35,1.7,53.88,4.9,0,0,0,0,0,0,0.152418203178763,73.2000950199089,17.9376463581888
9.7,"greedy_SVM","SVM",54,15,1184,1169,15,1600,1344,256,0.791044776119398,0.175,1.25177419354839,679,256,423,-2,1.7,57.47,5.2,0,0,0,0,0,0,0.157910862683085,165.623296963841,16.0085462007965
9.7,"greedy_SVM","SVM",54,16,1084,1070,14,1700,1443,257,0.826093218119921,0.266666666666667,1.25177419354839,685,257,428,6,1.7,61.06,5.6,0,0,0,0,0,0,0.0985929494248685,44.3006394741744,11.8023762010667
9.7,"greedy_SVM","SVM",54,17,984,971,13,1800,1542,258,0.819468447237489,0.208333333333333,1.25177419354839,714,258,456,29,1.8,64.66,6,0,0,0,0,0,0,0.0866386542422925,37.0040338580527,11.2879751663547
9.7,"greedy_SVM","SVM",54,18,884,871,13,1900,1642,258,0.792026708562449,0.225,1.25177419354839,709,258,451,-5,1.7,68.25,6.4,0,0,0,0,0,0,0.0516237580475397,18.7063286608226,6.74513368377333
9.7,"greedy_SVM","SVM",54,19,784,773,11,2000,1740,260,0.792700968840009,0.225,1.26247311827957,763,260,503,54,1.9,71.84,6.7,0,0,0,0,0,0,0.0647280741603637,23.8584449049912,8.42524969157749
9.7,"greedy_SVM","SVM",54,20,684,675,9,2100,1838,262,0.816149515579997,0.266666666666667,1.28387096774194,735,262,473,-28,1.8,75.43,7,0,0,0,0,0,0,0.070682753448913,21.4053018238225,9.42487586119972
9.7,"greedy_SVM","SVM",54,21,584,582,2,2200,1931,269,0.766915422885573,0.158333333333333,1.28387096774194,759,269,490,24,1.8,79.02,7.2,0,0,0,0,0,0,0.0349211825501296,9.30673646575259,6.16930792164288
9.7,"greedy_SVM","SVM",54,22,484,482,2,2300,2031,269,0.80701754385965,0.191666666666667,1.28387096774194,734,269,465,-25,1.7,82.61,7.6,0,0,0,0,0,0,0.00390600574277778,1.52919060987575,1.29205721573304
9.7,"greedy_SVM","SVM",54,23,384,382,2,2400,2131,269,0.799862529457975,0.216666666666667,1.28387096774194,773,269,504,39,1.9,86.21,7.9,0,0,0,0,0,0,0.00118953835946412,0.550611878132805,0.493518192346938
9.7,"greedy_SVM","SVM",54,24,284,283,1,2500,2230,270,0.781506938989266,0.208333333333333,1.28387096774194,787,270,517,14,1.9,89.8,8.3,0,0,0,0,0,0,0.00888560541314042,4.84122169923542,4.46166868635757
9.7,"greedy_SVM","SVM",54,25,184,184,0,2600,2329,271,0.82065331238544,0.233333333333333,1.28387096774194,780,271,509,-7,1.9,93.39,8.6,0,0,0,0,0,0,9.04147738250951e-05,9.14908339000201,9.14808322025264
9.7,"greedy_SVM","SVM",54,26,84,84,0,2700,2429,271,0.771111547525531,0.141666666666667,1.28387096774194,758,271,487,-22,1.8,96.98,9,0,0,0,0,0,0,1.0000000994736e-07,0.00237324427699722,0.00237324427699722
9.7,"greedy_SVM","SVM",54,27,0,0,0,2784,2513,271,0.790907305577377,0.175,1.28387096774194,774,271,503,16,1.9,100,9.3,0,0,0,0,0,0,0,0,0
9.7,"greedy_SVM","SVM",55,0,2684,2420,264,100,91,9,0.381994017946162,0.0254237288135593,0.826899945325314,33,9,24,0,2.7,3.59,10.1,0,0,0,0,0,0,0.0998685057353668,244.754137602156,10.0712576361394
9.7,"greedy_SVM","SVM",55,1,2584,2321,263,200,190,10,0.664479893652379,0.0932203389830508,1.25123018042646,37,10,27,4,2.7,7.18,19,0,0,0,0,0,0,0.0615827154433352,146.518063015833,6.48613830166562
9.7,"greedy_SVM","SVM",55,2,2484,2239,245,300,272,28,0.756663343303427,0.161016949152542,1.25123018042646,81,28,53,44,1.9,10.78,9.7,0,0,0,0,0,0,0.170147117415713,239.460689516399,21.0352308974198
9.7,"greedy_SVM","SVM",55,3,2384,2154,230,400,357,43,0.74386174808907,0.135593220338983,1.25123018042646,112,43,69,31,1.6,14.37,8.3,0,0,0,0,0,0,0.156027797567931,243.904641996084,17.4596266272087
9.7,"greedy_SVM","SVM",55,4,2284,2071,213,500,440,60,0.794509803921575,0.211864406779661,1.25123018042646,161,60,101,49,1.7,17.96,7.3,0,0,0,0,0,0,0.16516243160834,181.356081991729,18.2471356443373
9.7,"greedy_SVM","SVM",55,5,2184,1995,189,600,516,84,0.78973745430376,0.203389830508475,1.26211044286495,218,84,134,57,1.6,21.55,6.1,0,0,0,0,0,0,0.172827366670532,194.39204765417,18.5085430252359
9.7,"greedy_SVM","SVM",55,6,2084,1930,154,700,581,119,0.803004320372223,0.23728813559322,1.26211044286495,290,119,171,72,1.4,25.14,4.9,0,0,0,0,0,0,0.196585690319273,164.381261384334,20.885512789431
9.7,"greedy_SVM","SVM",55,7,1984,1863,121,800,648,152,0.803642406114995,0.228813559322034,1.25123018042646,362,152,210,72,1.4,28.74,4.3,0,0,0,0,0,0,0.199176597999607,148.481491836339,20.9103142635514
9.7,"greedy_SVM","SVM",55,8,1884,1796,88,900,715,185,0.80108341641742,0.23728813559322,1.25123018042646,430,185,245,68,1.3,32.33,3.9,0,0,0,0,0,0,0.208173573855583,163.816040095868,22.1524542453605
9.7,"greedy_SVM","SVM",55,9,1784,1718,66,1000,793,207,0.805157859754078,0.254237288135593,1.25123018042646,487,207,280,57,1.4,35.92,3.8,0,0,0,0,0,0,0.181181215805014,113.486170142494,19.9738512876155
9.7,"greedy_SVM","SVM",55,10,1684,1639,45,1100,872,228,0.798275174476577,0.203389830508475,1.25007803477229,546,228,318,59,1.4,39.51,3.8,0,0,0,0,0,0,0.190891353457164,125.713969321388,20.9641880132347
9.7,"greedy_SVM","SVM",55,11,1584,1552,32,1200,959,241,0.793732136922572,0.220338983050847,1.25123018042646,587,241,346,41,1.4,43.1,4,0,0,0,0,0,0,0.178815176307569,108.013686277232,19.2126186431462
9.7,"greedy_SVM","SVM",55,12,1484,1465,19,1300,1046,254,0.795054835493526,0.186440677966102,1.25123018042646,637,254,383,50,1.5,46.7,4.1,0,0,0,0,0,0,0.168435069098214,93.0904764209428,18.5919094122718
9.7,"greedy_SVM","SVM",55,13,1384,1368,16,1400,1143,257,0.793226985709545,0.211864406779661,1.25123018042646,633,257,376,-4,1.5,50.29,4.4,0,0,0,0,0,0,0.153995113668261,75.8463041364489,16.938478917824
9.7,"greedy_SVM","SVM",55,14,1284,1268,16,1500,1243,257,0.802678630774351,0.194915254237288,1.25123018042646,641,257,384,8,1.5,53.88,4.8,0,0,0,0,0,0,0.12207759580243,56.8588347418894,13.5023507281394
9.7,"greedy_SVM","SVM",55,15,1184,1170,14,1600,1341,259,0.782033898305091,0.211864406779661,1.24034991798797,654,259,395,13,1.5,57.47,5.2,0,0,0,0,0,0,0.106569610100773,45.3267528146784,12.3513626736588
9.7,"greedy_SVM","SVM",55,16,1084,1071,13,1700,1440,260,0.79031571950815,0.211864406779661,1.24034991798797,667,260,407,13,1.6,61.06,5.5,0,0,0,0,0,0,0.116378634515415,65.0269826210227,13.4516155517434
9.7,"greedy_SVM","SVM",55,17,984,971,13,1800,1540,260,0.800119641076778,0.228813559322034,1.24034991798797,656,260,396,-11,1.5,64.66,5.9,0,0,0,0,0,0,0.0856250808787782,43.5666274583023,9.72446197444564
9.7,"greedy_SVM","SVM",55,18,884,872,12,1900,1639,261,0.765324027916259,0.169491525423729,1.24034991798797,676,261,415,20,1.6,68.25,6.3,0,0,0,0,0,0,0.0640844195446665,27.9057313288815,7.79639070881434
9.7,"greedy_SVM","SVM",55,19,784,774,10,2000,1737,263,0.775799268860093,0.220338983050847,1.24034991798797,674,263,411,-2,1.6,71.84,6.6,0,0,0,0,0,0,0.0561847722117103,22.7911279508524,6.91036065583859
9.7,"greedy_SVM","SVM",55,20,684,676,8,2100,1835,265,0.783230309072786,0.203389830508475,1.28387096774194,689,265,424,15,1.6,75.43,6.9,0,0,0,0,0,0,0.0732391349592363,32.0127768292268,8.53585612668136
9.7,"greedy_SVM","SVM",55,21,584,580,4,2200,1931,269,0.762751744765707,0.161016949152542,1.28387096774194,716,269,447,27,1.7,79.02,7.2,0,0,0,0,0,0,0.0790736486161698,30.1524448244337,18.3259235015669
9.7,"greedy_SVM","SVM",55,22,484,480,4,2300,2031,269,0.776304420073117,0.194915254237288,1.28387096774194,703,269,434,-13,1.6,82.61,7.6,0,0,0,0,0,0,0.0443606045012975,13.7272397474752,5.84723161544329
9.7,"greedy_SVM","SVM",55,23,384,381,3,2400,2130,270,0.756696576935863,0.152542372881356,1.27299070530344,717,270,447,14,1.7,86.21,7.9,0,0,0,0,0,0,0.0102760709089346,2.43326087753829,1.63226980024889
9.7,"greedy_SVM","SVM",55,24,284,284,0,2500,2227,273,0.770176138251915,0.152542372881356,1.27299070530344,741,273,468,24,1.7,89.8,8.2,0,0,0,0,0,0,0.0134219880433441,5.06620847155759,4.24492403939942
9.7,"greedy_SVM","SVM",55,25,184,184,0,2600,2327,273,0.734263875041546,0.135593220338983,1.27299070530344,712,273,439,-29,1.6,93.39,8.5,0,0,0,0,0,0,0.00432159763841086,1.11443001031129,1.03748944877354
9.7,"greedy_SVM","SVM",55,26,84,84,0,2700,2427,273,0.755221003655703,0.177966101694915,1.27299070530344,722,273,449,10,1.6,96.98,8.9,0,0,0,0,0,0,3.52246361843898e-09,0.0572001489124552,0.0572001489124552
9.7,"greedy_SVM","SVM",55,27,0,0,0,2784,2511,273,0.709690927218348,0.0932203389830508,1.27299070530344,718,273,445,-4,1.6,100,9.2,0,0,0,0,0,0,0,0,0
9.7,"greedy_SVM","SVM",56,0,2684,2428,256,100,88,12,0.704525958645411,0.276422764227642,1.15861526357199,37,12,25,0,2.1,3.59,7.3,0,0,0,0,0,0,0.197792706980171,294.137606099077,23.3239294884207
9.7,"greedy_SVM","SVM",56,1,2584,2347,237,200,169,31,0.693233467767747,0.170731707317073,1.25255704169945,92,31,61,55,2,7.18,5.5,0,0,0,0,0,0,0.201044878849364,366.463161859848,21.7935889801528
9.7,"greedy_SVM","SVM",56,2,2484,2255,229,300,261,39,0.790871263043338,0.292682926829268,1.24211906635195,104,39,65,12,1.7,10.78,6.7,0,0,0,0,0,0,0.172147366255491,234.055680276178,18.9224706278229
9.7,"greedy_SVM","SVM",56,3,2384,2183,201,400,333,67,0.828961014019589,0.308943089430894,1.28387096774194,172,67,105,68,1.6,14.37,5,0,0,0,0,0,0,0.183619869139508,250.583454520704,19.2267828849797
9.7,"greedy_SVM","SVM",56,4,2284,2105,179,500,411,89,0.83377504641188,0.292682926829268,1.28387096774194,234,89,145,62,1.6,17.96,4.6,0,0,0,0,0,0,0.183022220218309,291.222703430722,18.6586679825983
9.7,"greedy_SVM","SVM",56,5,2184,2035,149,600,481,119,0.821861596568722,0.227642276422764,1.28387096774194,295,119,176,61,1.5,21.55,4,0,0,0,0,0,0,0.221734502975841,221.482598473812,24.0860313691244
9.7,"greedy_SVM","SVM",56,6,2084,1946,138,700,570,130,0.830651046667946,0.260162601626016,1.28387096774194,325,130,195,30,1.5,25.14,4.4,0,0,0,0,0,0,0.187899406325947,153.649107549453,19.893755064813
9.7,"greedy_SVM","SVM",56,7,1984,1878,106,800,638,162,0.839491709877727,0.227642276422764,1.28387096774194,389,162,227,64,1.4,28.74,3.9,0,0,0,0,0,0,0.18662235007543,132.52373036127,20.3279297299707
9.7,"greedy_SVM","SVM",56,8,1884,1799,85,900,717,183,0.83931246399078,0.227642276422764,1.28387096774194,454,183,271,65,1.5,32.33,3.9,0,0,0,0,0,0,0.183583022427313,179.458231760651,19.4743757674781
9.7,"greedy_SVM","SVM",56,9,1784,1721,63,1000,795,205,0.803258434159147,0.24390243902439,1.17949121426698,511,205,306,57,1.5,35.92,3.9,0,0,0,0,0,0,0.205956862444446,188.483247072792,39.5852282983567
9.7,"greedy_SVM","SVM",56,10,1684,1630,54,1100,886,214,0.84929261891044,0.260162601626016,1.28387096774194,548,214,334,37,1.6,39.51,4.1,0,0,0,0,0,0,0.133935234536489,76.7937639184548,16.1937285541823
9.7,"greedy_SVM","SVM",56,11,1584,1546,38,1200,970,230,0.796287049484675,0.178861788617886,1.21080514030947,586,230,356,38,1.5,43.1,4.2,0,0,0,0,0,0,0.155778424064082,79.858220003327,22.4393229938912
9.7,"greedy_SVM","SVM",56,12,1484,1456,28,1300,1060,240,0.796415082261065,0.219512195121951,1.21080514030947,611,240,371,25,1.5,46.7,4.4,0,0,0,0,0,0,0.177829774667186,117.698126284853,20.776255973238
9.7,"greedy_SVM","SVM",56,13,1384,1359,25,1400,1157,243,0.78680622239294,0.203252032520325,1.22124311565696,634,243,391,23,1.6,50.29,4.8,0,0,0,0,0,0,0.160478640045888,65.6808872855597,17.4326453180404
9.7,"greedy_SVM","SVM",56,14,1284,1261,23,1500,1255,245,0.774847961078044,0.186991869918699,1.22124311565696,642,245,397,8,1.6,53.88,5.1,0,0,0,0,0,0,0.138331755675718,48.4877449633869,15.2717601845153
9.7,"greedy_SVM","SVM",56,15,1184,1162,22,1600,1354,246,0.806964983035664,0.252032520325203,1.22124311565696,651,246,405,9,1.6,57.47,5.5,0,0,0,0,0,0,0.11505208492038,37.8774437399147,12.7003919355654
9.7,"greedy_SVM","SVM",56,16,1084,1064,20,1700,1452,248,0.800544139299668,0.260162601626016,1.22124311565696,658,248,410,7,1.7,61.06,5.9,0,0,0,0,0,0,0.112322214673497,38.6779533543342,12.1557065558388
9.7,"greedy_SVM","SVM",56,17,984,965,19,1800,1551,249,0.799993598361187,0.219512195121951,1.23168109100446,660,249,411,2,1.7,64.66,6.2,0,0,0,0,0,0,0.059378257423189,14.8463495473411,8.01622439735414
9.7,"greedy_SVM","SVM",56,18,884,865,19,1900,1651,249,0.744379361116452,0.154471544715447,1.23168109100446,641,249,392,-19,1.6,68.25,6.6,0,0,0,0,0,0,0.0159021526944452,3.51120184761003,2.92875846806308
9.7,"greedy_SVM","SVM",56,19,784,766,18,2000,1750,250,0.770616477818325,0.178861788617886,1.26299501704694,654,250,404,13,1.6,71.84,7,0,0,0,0,0,0,0.0103623832109562,3.87113870334422,2.75901922462211
9.7,"greedy_SVM","SVM",56,20,684,671,13,2100,1845,255,0.793111836630179,0.154471544715447,1.26299501704694,679,255,424,25,1.7,75.43,7.2,0,0,0,0,0,0,0.00233476773770955,1.87926410889598,1.71455576251268
9.7,"greedy_SVM","SVM",56,21,584,577,7,2200,1939,261,0.8423980539018,0.252032520325203,1.28387096774194,719,261,458,40,1.8,79.02,7.4,0,0,0,0,0,0,0.0587848212091922,15.9303608249292,10.2065234003437
9.7,"greedy_SVM","SVM",56,22,484,480,4,2300,2036,264,0.819921900006402,0.227642276422764,1.28387096774194,730,264,466,11,1.8,82.61,7.7,0,0,0,0,0,0,0.0202624075604752,5.72842361479579,4.66353219147019
9.7,"greedy_SVM","SVM",56,23,384,382,2,2400,2134,266,0.790813648293961,0.113821138211382,1.28387096774194,719,266,453,-11,1.7,86.21,8,0,0,0,0,0,0,0.00661410616852798,2.24949020422559,1.96399883745351
9.7,"greedy_SVM","SVM",56,24,284,282,2,2500,2234,266,0.814531720120349,0.178861788617886,1.28387096774194,736,266,470,17,1.8,89.8,8.4,0,0,0,0,0,0,0.00074090413530909,0.336904504347738,0.309773348869109
9.7,"greedy_SVM","SVM",56,25,184,183,1,2600,2333,267,0.831764931822546,0.317073170731707,1.28387096774194,750,267,483,14,1.8,93.39,8.7,0,0,0,0,0,0,0.0254708891592466,8.10261894350945,7.1121979104604
9.7,"greedy_SVM","SVM",56,26,84,84,0,2700,2432,268,0.781448050700978,0.154471544715447,1.28387096774194,748,268,480,-2,1.8,96.98,9.1,0,0,0,0,0,0,0.000216201937089359,2.40125744672089,2.40125744672089
9.7,"greedy_SVM","SVM",56,27,0,0,0,2784,2516,268,0.809845720504444,0.203252032520325,1.28387096774194,761,268,493,13,1.8,100,9.4,0,0,0,0,0,0,0,0,0
9.7,"greedy_SVM","SVM",57,0,2684,2427,257,100,87,13,0.832501689276997,0.347107438016529,1.25203945614503,29,13,16,0,1.2,3.59,6.7,0,0,0,0,0,0,0.390895398796882,375.440420310307,42.1692469753851
9.7,"greedy_SVM","SVM",57,1,2584,2368,216,200,146,54,0.78069286345444,0.148760330578512,1.2732604638763,122,54,68,93,1.3,7.18,2.7,0,0,0,0,0,0,0.316706334819537,599.534244138726,34.102830639651
9.7,"greedy_SVM","SVM",57,2,2484,2288,196,300,226,74,0.802692447632422,0.239669421487603,1.26264996001066,176,74,102,54,1.4,10.78,3.1,0,0,0,0,0,0,0.248067931231313,599.199884931911,25.119049481228
9.7,"greedy_SVM","SVM",57,3,2384,2209,175,400,305,95,0.838050314465415,0.247933884297521,1.26264996001066,222,95,127,46,1.3,14.37,3.2,0,0,0,0,0,0,0.257490439458563,380.247209877911,27.777070683816
9.7,"greedy_SVM","SVM",57,4,2284,2136,148,500,378,122,0.83552939341962,0.289256198347107,1.26264996001066,289,122,167,67,1.4,17.96,3.1,0,0,0,0,0,0,0.252561177024777,398.712693811844,25.7154127212941
9.7,"greedy_SVM","SVM",57,5,2184,2062,122,600,452,148,0.847607723894174,0.305785123966942,1.26264996001066,361,148,213,72,1.4,21.55,3.1,0,0,0,0,0,0,0.257182962027647,242.683537217542,26.3549033026249
9.7,"greedy_SVM","SVM",57,6,2084,1997,87,700,517,183,0.843917303394148,0.31404958677686,1.24142895227939,438,183,255,77,1.4,25.14,2.8,0,0,0,0,0,0,0.260424848934753,247.324171839705,26.6923883568191
9.7,"greedy_SVM","SVM",57,7,1984,1915,69,800,599,201,0.838966422371229,0.247933884297521,1.24142895227939,481,201,280,43,1.4,28.74,3,0,0,0,0,0,0,0.240912969829466,191.441415047396,24.9580430137954
9.7,"greedy_SVM","SVM",57,8,1884,1830,54,900,684,216,0.834470346691612,0.305785123966942,1.24142895227939,512,216,296,31,1.4,32.33,3.2,0,0,0,0,0,0,0.21671528180552,164.188529372154,22.9207569733337
9.7,"greedy_SVM","SVM",57,9,1784,1738,46,1000,776,224,0.826615208690682,0.231404958677686,1.24142895227939,548,224,324,36,1.4,35.92,3.5,0,0,0,0,0,0,0.214460748051729,233.649874044329,21.882179464114
9.7,"greedy_SVM","SVM",57,10,1684,1646,38,1100,868,232,0.84263085399449,0.297520661157025,1.24142895227939,567,232,335,19,1.4,39.51,3.7,0,0,0,0,0,0,0.170928415464922,89.142963409143,18.7460843610272
9.7,"greedy_SVM","SVM",57,11,1584,1551,33,1200,963,237,0.815550444409794,0.206611570247934,1.24142895227939,581,237,344,14,1.5,43.1,4.1,0,0,0,0,0,0,0.156229359142543,80.8534051473322,16.6360999263485
9.7,"greedy_SVM","SVM",57,12,1484,1456,28,1300,1058,242,0.822466734237746,0.247933884297521,1.22968509809293,590,242,348,9,1.4,46.7,4.4,0,0,0,0,0,0,0.146484040480322,93.8120954079929,19.8251193544856
9.7,"greedy_SVM","SVM",57,13,1384,1358,26,1400,1156,244,0.829032174229442,0.289256198347107,1.22020794454812,609,244,365,19,1.5,50.29,4.7,0,0,0,0,0,0,0.14525636857409,96.3888644739306,15.7697404808428
9.7,"greedy_SVM","SVM",57,14,1284,1260,24,1500,1254,246,0.828895732626438,0.305785123966942,1.23081844841376,626,246,380,17,1.5,53.88,5.1,0,0,0,0,0,0,0.122776597655755,53.3718858340141,15.2377397282913
9.7,"greedy_SVM","SVM",57,15,1184,1162,22,1600,1352,248,0.821833255366713,0.206611570247934,1.25203945614503,641,248,393,15,1.6,57.47,5.5,0,0,0,0,0,0,0.0872098643947648,33.023476288466,10.705931621863
9.7,"greedy_SVM","SVM",57,16,1084,1063,21,1700,1451,249,0.829454493476802,0.239669421487603,1.25203945614503,626,249,377,-15,1.5,61.06,5.8,0,0,0,0,0,0,0.0534699568630529,19.6923653661042,6.89390350742265
9.7,"greedy_SVM","SVM",57,17,984,963,21,1800,1551,249,0.819162898279545,0.272727272727273,1.24142895227939,630,249,381,4,1.5,64.66,6.2,0,0,0,0,0,0,0.0223958354415056,6.79827979869946,3.20362586001648
9.7,"greedy_SVM","SVM",57,18,884,868,16,1900,1646,254,0.7896590259369,0.190082644628099,1.24142895227939,655,254,401,25,1.6,68.25,6.5,0,0,0,0,0,0,0.0271925582296216,8.9610812925399,5.09288917249005
9.7,"greedy_SVM","SVM",57,19,784,772,12,2000,1742,258,0.80767581475129,0.181818181818182,1.26264996001066,653,258,395,-2,1.5,71.84,6.8,0,0,0,0,0,0,0.0513054018620053,18.796593897518,6.80794651629093
9.7,"greedy_SVM","SVM",57,20,684,675,9,2100,1839,261,0.837485056395867,0.305785123966942,1.28387096774194,673,261,412,20,1.6,75.43,7,0,0,0,0,0,0,0.0661129912514521,22.6724686930069,8.82449579086412
9.7,"greedy_SVM","SVM",57,21,584,580,4,2200,1934,266,0.807578356463436,0.206611570247934,1.28268876611418,699,266,433,26,1.6,79.02,7.3,0,0,0,0,0,0,0.0413731836734116,12.2864834781986,7.20402267750443
9.7,"greedy_SVM","SVM",57,22,484,483,1,2300,2031,269,0.813094495555905,0.173553719008264,1.28387096774194,715,269,446,16,1.7,82.61,7.6,0,0,0,0,0,0,0.0205395438530481,5.71752564014931,3.0799354957909
9.7,"greedy_SVM","SVM",57,23,384,384,0,2400,2130,270,0.832020895056915,0.247933884297521,1.2732604638763,724,270,454,9,1.7,86.21,7.9,0,0,0,0,0,0,0.0219135443994423,11.3720836051089,8.95723750807041
9.7,"greedy_SVM","SVM",57,24,284,284,0,2500,2230,270,0.829662404490878,0.231404958677686,1.27208803250993,710,270,440,-14,1.6,89.8,8.3,0,0,0,0,0,0,0.00270394625790374,0.783258370698051,0.665927845304435
9.7,"greedy_SVM","SVM",57,25,184,184,0,2600,2330,270,0.851155205572017,0.330578512396694,1.28268876611418,726,270,456,16,1.7,93.39,8.6,0,0,0,0,0,0,8.01289454424191e-05,0.0537067665847943,0.0517957751042623
9.7,"greedy_SVM","SVM",57,26,84,84,0,2700,2430,270,0.807760278600764,0.231404958677686,1.28268876611418,739,270,469,13,1.7,96.98,9,0,0,0,0,0,0,1.0000000994736e-07,0.0040511400867031,0.0040511400867031
9.7,"greedy_SVM","SVM",57,27,0,0,0,2784,2514,270,0.836172618119446,0.247933884297521,1.27208803250993,725,270,455,-14,1.7,100,9.3,0,0,0,0,0,0,0,0,0
9.7,"greedy_SVM","SVM",58,0,2684,2431,253,100,93,7,0.821530104886216,0.297709923664122,1.24466880078798,19,7,12,0,1.7,3.59,13.3,0,0,0,0,0,0,0.163107538100949,208.449810174953,17.9130090682015
9.7,"greedy_SVM","SVM",58,1,2584,2365,219,200,159,41,0.665507313001293,0.183206106870229,1.21526717557252,106,41,65,87,1.6,7.18,3.9,0,0,0,0,0,0,0.267658032854115,479.218453531201,32.3762978887395
9.7,"greedy_SVM","SVM",58,2,2484,2280,204,300,244,56,0.813745297056644,0.33587786259542,1.22506771731101,137,56,81,31,1.4,10.78,4.4,0,0,0,0,0,0,0.266878973277186,218.63108481664,29.1398522657265
9.7,"greedy_SVM","SVM",58,3,2384,2207,177,400,317,83,0.834958444732097,0.290076335877863,1.27407042600345,205,83,122,68,1.5,14.37,3.8,0,0,0,0,0,0,0.257359000101099,253.247217839252,31.7967308331718
9.7,"greedy_SVM","SVM",58,4,2284,2127,157,500,397,103,0.821179274385738,0.267175572519084,1.2348682590495,255,103,152,50,1.5,17.96,3.9,0,0,0,0,0,0,0.232004884750516,226.876720901361,24.6147730826085
9.7,"greedy_SVM","SVM",58,5,2184,2048,136,600,476,124,0.818729509684124,0.244274809160305,1.25446934252647,318,124,194,63,1.6,21.55,3.8,0,0,0,0,0,0,0.226424222936594,190.559383314135,24.2836761393522
9.7,"greedy_SVM","SVM",58,6,2084,1967,117,700,557,143,0.810551529741951,0.251908396946565,1.25446934252647,359,143,216,41,1.5,25.14,3.9,0,0,0,0,0,0,0.221380782094306,207.606270224949,23.6076193123731
9.7,"greedy_SVM","SVM",58,7,1984,1893,91,800,631,169,0.813376320150972,0.290076335877863,1.25446934252647,417,169,248,58,1.5,28.74,3.7,0,0,0,0,0,0,0.217085453585365,174.376728256107,22.8064463146757
9.7,"greedy_SVM","SVM",58,8,1884,1814,70,900,710,190,0.817495554130722,0.290076335877863,1.25446934252647,469,190,279,52,1.5,32.33,3.7,0,0,0,0,0,0,0.212167041434712,165.67581827354,22.2078644404922
9.7,"greedy_SVM","SVM",58,9,1784,1728,56,1000,796,204,0.808380009920028,0.206106870229008,1.25446934252647,501,204,297,32,1.5,35.92,3.9,0,0,0,0,0,0,0.197444712230435,117.089519328153,20.7614487317821
9.7,"greedy_SVM","SVM",58,10,1684,1639,45,1100,885,215,0.807248883996073,0.259541984732824,1.25446934252647,545,215,330,44,1.5,39.51,4.1,0,0,0,0,0,0,0.183994736356334,108.236089812382,19.7948338767402
9.7,"greedy_SVM","SVM",58,11,1584,1553,31,1200,971,229,0.789447260497688,0.198473282442748,1.2348682590495,595,229,366,50,1.6,43.1,4.2,0,0,0,0,0,0,0.172465817837168,96.8082543787801,18.5677905916944
9.7,"greedy_SVM","SVM",58,12,1484,1459,25,1300,1065,235,0.816025695309753,0.267175572519084,1.25446934252647,610,235,375,15,1.6,46.7,4.5,0,0,0,0,0,0,0.155609888810108,65.5406183504657,17.3223368670739
9.7,"greedy_SVM","SVM",58,13,1384,1361,23,1400,1163,237,0.82554650923651,0.274809160305344,1.24466880078798,609,237,372,-1,1.6,50.29,4.9,0,0,0,0,0,0,0.107369042568329,36.4882173982533,12.2824040832067
9.7,"greedy_SVM","SVM",58,14,1284,1263,21,1500,1261,239,0.824663384183584,0.305343511450382,1.2348682590495,617,239,378,8,1.6,53.88,5.3,0,0,0,0,0,0,0.0871887985982584,27.1491931130994,10.5455604641138
9.7,"greedy_SVM","SVM",58,15,1184,1165,19,1600,1359,241,0.786616421286931,0.221374045801527,1.2348682590495,649,241,408,32,1.7,57.47,5.6,0,0,0,0,0,0,0.139783633117228,44.7939521028126,16.5867775016985
9.7,"greedy_SVM","SVM",58,16,1084,1066,18,1700,1458,242,0.794909328462019,0.259541984732824,1.2348682590495,652,242,410,3,1.7,61.06,6,0,0,0,0,0,0,0.0974923792657219,28.2742587482984,11.1464037598623
9.7,"greedy_SVM","SVM",58,17,984,966,18,1800,1558,242,0.782926652230183,0.251908396946565,1.2348682590495,642,242,400,-10,1.7,64.66,6.4,0,0,0,0,0,0,0.0588641216165115,14.5262794993625,7.3172935008723
9.7,"greedy_SVM","SVM",58,18,884,866,18,1900,1658,242,0.798925732812317,0.282442748091603,1.2348682590495,644,242,402,2,1.7,68.25,6.9,0,0,0,0,0,0,0.0178531194873943,4.48990604109089,3.43627784794447
9.7,"greedy_SVM","SVM",58,19,784,766,18,2000,1758,242,0.791310291431255,0.229007633587786,1.2348682590495,654,242,412,10,1.7,71.84,7.3,0,0,0,0,0,0,0.00951293179912271,3.23819950177168,1.8025162868768
9.7,"greedy_SVM","SVM",58,20,684,668,16,2100,1856,244,0.778287221301457,0.206106870229008,1.2348682590495,651,244,407,-3,1.7,75.43,7.6,0,0,0,0,0,0,0.00501703592918308,1.68623475735158,1.50890660233967
9.7,"greedy_SVM","SVM",58,21,584,576,8,2200,1948,252,0.700142751720882,0.114503816793893,1.28268876611418,691,252,439,40,1.7,79.02,7.7,0,0,0,0,0,0,0.178709684047615,56.726050331762,21.4881136641792
9.7,"greedy_SVM","SVM",58,22,484,476,8,2300,2048,252,0.81473125173903,0.236641221374046,1.28268876611418,709,252,457,18,1.8,82.61,8.1,0,0,0,0,0,0,0.0932578029183739,21.3608707663898,11.4245327573475
9.7,"greedy_SVM","SVM",58,23,384,381,3,2400,2143,257,0.794491961142497,0.190839694656489,1.28268876611418,721,257,464,12,1.8,86.21,8.3,0,0,0,0,0,0,0.0365831724876685,9.37214384010534,6.10973886845144
9.7,"greedy_SVM","SVM",58,24,284,282,2,2500,2242,258,0.803153845223261,0.229007633587786,1.28268876611418,729,258,471,8,1.8,89.8,8.7,0,0,0,0,0,0,0.0156768799403741,3.67425624768621,2.89948275617037
9.7,"greedy_SVM","SVM",58,25,184,183,1,2600,2341,259,0.769976167721174,0.175572519083969,1.28268876611418,730,259,471,1,1.8,93.39,9,0,0,0,0,0,0,0.0146828075783306,6.2954607132136,5.86059253379976
9.7,"greedy_SVM","SVM",58,26,84,84,0,2700,2440,260,0.786344225208986,0.175572519083969,1.28268876611418,728,260,468,-2,1.8,96.98,9.4,0,0,0,0,0,0,1.17212517207287e-08,1.09188747140825,1.09188747140825
9.7,"greedy_SVM","SVM",58,27,0,0,0,2784,2524,260,0.780712790796141,0.206106870229008,1.2728972488156,738,260,478,10,1.8,100,9.7,0,0,0,0,0,0,0,0,0
9.7,"greedy_SVM","SVM",59,0,2684,2426,258,100,92,8,0.297779179810724,0,0.708696774193548,38,8,30,0,3.8,3.59,11.5,0,0,0,0,0,0,0.125352943111851,225.886476013563,13.3841682326891
9.7,"greedy_SVM","SVM",59,1,2584,2326,258,200,192,8,0.699823343848583,0.104,1.16061935483871,38,8,30,0,3.8,7.18,24,0,0,0,0,0,0,0.097386850140391,173.129845702619,10.717076658612
9.7,"greedy_SVM","SVM",59,2,2484,2234,250,300,284,16,0.677230283911675,0.336,1.08872258064516,47,16,31,9,1.9,10.78,17.8,0,0,0,0,0,0,0.0803496942911971,142.84806667214,8.83501660988812
9.7,"greedy_SVM","SVM",59,3,2384,2167,217,400,351,49,0.669312302839114,0.064,1.14007741935484,129,49,80,82,1.6,14.37,7.2,0,0,0,0,0,0,0.329345472258815,270.871642831455,47.0167572237041
9.7,"greedy_SVM","SVM",59,4,2284,2073,211,500,445,55,0.711501577287069,0.144,1.16061935483871,149,55,94,20,1.7,17.96,8.1,0,0,0,0,0,0,0.154600809137102,205.951396326762,17.3298175777524
9.7,"greedy_SVM","SVM",59,5,2184,1980,204,600,538,62,0.756214511041019,0.312,1.21197419354839,169,62,107,20,1.7,21.55,8.7,0,0,0,0,0,0,0.133485919662501,189.338786588761,14.6243565551977
9.7,"greedy_SVM","SVM",59,6,2084,1910,174,700,608,92,0.77577917981073,0.288,1.24278709677419,232,92,140,63,1.5,25.14,6.6,0,0,0,0,0,0,0.154783847375186,214.586147582794,15.9471073328664
9.7,"greedy_SVM","SVM",59,7,1984,1833,151,800,685,115,0.800359621451107,0.312,1.24278709677419,289,115,174,57,1.5,28.74,6,0,0,0,0,0,0,0.157369959920601,121.849073430013,16.8789632331973
9.7,"greedy_SVM","SVM",59,8,1884,1770,114,900,748,152,0.798996845425872,0.288,1.24278709677419,367,152,215,78,1.4,32.33,4.9,0,0,0,0,0,0,0.184431958113699,149.256181059704,19.9014481137757
9.7,"greedy_SVM","SVM",59,9,1784,1682,102,1000,836,164,0.799299684542588,0.264,1.25305806451613,398,164,234,31,1.4,35.92,5.1,0,0,0,0,0,0,0.16946652875842,155.638200177906,17.7839386427091
9.7,"greedy_SVM","SVM",59,10,1684,1592,92,1100,926,174,0.789072555205051,0.2,1.25305806451613,424,174,250,26,1.4,39.51,5.3,0,0,0,0,0,0,0.154779755008601,113.085355689484,16.3438265106679
9.7,"greedy_SVM","SVM",59,11,1584,1504,80,1200,1014,186,0.803791798107254,0.208,1.24278709677419,469,186,283,45,1.5,43.1,5.5,0,0,0,0,0,0,0.148441991054421,100.78232639621,15.9769943281974
9.7,"greedy_SVM","SVM",59,12,1484,1420,64,1300,1098,202,0.808378548895891,0.2,1.24278709677419,518,202,316,49,1.6,46.7,5.4,0,0,0,0,0,0,0.15563672867064,100.31546255644,17.2076339374693
9.7,"greedy_SVM","SVM",59,13,1384,1329,55,1400,1189,211,0.784132492113561,0.16,1.24278709677419,545,211,334,27,1.6,50.29,5.6,0,0,0,0,0,0,0.138603172934283,82.0242596004982,18.1469073997458
9.7,"greedy_SVM","SVM",59,14,1284,1247,37,1500,1271,229,0.79639747634069,0.184,1.24278709677419,585,229,356,40,1.6,53.88,5.6,0,0,0,0,0,0,0.144873532321531,75.7868763588332,16.0696284565651
9.7,"greedy_SVM","SVM",59,15,1184,1155,29,1600,1363,237,0.806750788643528,0.208,1.24278709677419,634,237,397,49,1.7,57.47,5.8,0,0,0,0,0,0,0.132157916792349,66.4859401436405,14.6085978116668
9.7,"greedy_SVM","SVM",59,16,1084,1057,27,1700,1461,239,0.818984227129334,0.248,1.23251612903226,630,239,391,-4,1.6,61.06,6.1,0,0,0,0,0,0,0.100744529651786,39.9819893054029,11.4728044227521
9.7,"greedy_SVM","SVM",59,17,984,957,27,1800,1561,239,0.81647318611987,0.256,1.23251612903226,629,239,390,-1,1.6,64.66,6.5,0,0,0,0,0,0,0.0913983137974468,40.8385264746357,10.7233816221931
9.7,"greedy_SVM","SVM",59,18,884,859,25,1900,1659,241,0.822271293375392,0.232,1.23251612903226,635,241,394,6,1.6,68.25,6.9,0,0,0,0,0,0,0.0759853895241481,30.6237569735191,8.73950551549248
9.7,"greedy_SVM","SVM",59,19,784,760,24,2000,1758,242,0.787627760252365,0.192,1.23251612903226,658,242,416,23,1.7,71.84,7.3,0,0,0,0,0,0,0.059754440969491,20.4913970032539,7.17977375290651
9.7,"greedy_SVM","SVM",59,20,684,662,22,2100,1856,244,0.761053627760252,0.168,1.23251612903226,644,244,400,-14,1.6,75.43,7.6,0,0,0,0,0,0,0.0417292582666207,12.4885882621628,5.62203744847121
9.7,"greedy_SVM","SVM",59,21,584,563,21,2200,1955,245,0.793981072555204,0.232,1.23251612903226,660,245,415,16,1.7,79.02,8,0,0,0,0,0,0,0.0257421979458069,6.85575549940687,3.94798451137955
9.7,"greedy_SVM","SVM",59,22,484,463,21,2300,2055,245,0.77784858044164,0.192,1.23251612903226,659,245,414,-1,1.7,82.61,8.4,0,0,0,0,0,0,0.0106699063375485,2.72386181093717,1.84417634165861
9.7,"greedy_SVM","SVM",59,23,384,368,16,2400,2150,250,0.805880126182966,0.216,1.24278709677419,665,250,415,6,1.7,86.21,8.6,0,0,0,0,0,0,0.0140700083269876,5.0515075821552,3.77436279586855
9.7,"greedy_SVM","SVM",59,24,284,274,10,2500,2244,256,0.805211356466882,0.208,1.26332903225806,691,256,435,26,1.7,89.8,8.8,0,0,0,0,0,0,0.0187232252506053,5.45750739863021,4.41597161674305
9.7,"greedy_SVM","SVM",59,25,184,181,3,2600,2337,263,0.808485804416413,0.2,1.2736,725,263,462,34,1.8,93.39,8.9,0,0,0,0,0,0,8.77731998304334e-06,1.62008620856417,1.61991561780848
9.7,"greedy_SVM","SVM",59,26,84,84,0,2700,2434,266,0.810643533123036,0.216,1.2736,727,266,461,2,1.7,96.98,9.2,0,0,0,0,0,0,6.85460511542085e-09,0.277990864210983,0.277990864210983
9.7,"greedy_SVM","SVM",59,27,0,0,0,2784,2518,266,0.818138801261838,0.232,1.2736,732,266,466,5,1.8,100,9.5,0,0,0,0,0,0,0,0,0
9.7,"greedy_SVM","SVM",60,0,2684,2437,247,100,91,9,0.818141671082847,0.288888888888889,1.28387096774194,29,9,20,0,2.2,3.59,10.1,0,0,0,0,0,0,0.152747984904713,254.340124493772,16.9268705776358
9.7,"greedy_SVM","SVM",60,1,2584,2358,226,200,170,30,0.798857681210627,0.185185185185185,1.27436081242533,75,30,45,46,1.5,7.18,5.7,0,0,0,0,0,0,0.21264655043132,285.182659664531,24.9772816251452
9.7,"greedy_SVM","SVM",60,2,2484,2270,214,300,258,42,0.81635753400459,0.251851851851852,1.28387096774194,120,42,78,45,1.9,10.78,6.1,0,0,0,0,0,0,0.164853742218835,219.436357733706,17.061732003394
9.7,"greedy_SVM","SVM",60,3,2384,2197,187,400,331,69,0.824000471059298,0.288888888888889,1.27436081242533,177,69,108,57,1.6,14.37,4.8,0,0,0,0,0,0,0.18991083476829,171.087777466572,21.1519850627544
9.7,"greedy_SVM","SVM",60,4,2284,2122,162,500,406,94,0.834051698757582,0.288888888888889,1.28387096774194,242,94,148,65,1.6,17.96,4.3,0,0,0,0,0,0,0.199889861519344,240.120734424503,20.2052088650045
9.7,"greedy_SVM","SVM",60,5,2184,2051,133,600,477,123,0.846581875993646,0.333333333333333,1.27436081242533,308,123,185,66,1.5,21.55,3.9,0,0,0,0,0,0,0.218728221493704,188.507216746271,22.3645218215369
9.7,"greedy_SVM","SVM",60,6,2084,1984,100,700,544,156,0.851033386327514,0.340740740740741,1.27436081242533,379,156,223,71,1.4,25.14,3.5,0,0,0,0,0,0,0.207354779724932,111.857399408697,22.5653826022844
9.7,"greedy_SVM","SVM",60,7,1984,1906,78,800,622,178,0.851410233763184,0.340740740740741,1.27436081242533,448,178,270,69,1.5,28.74,3.5,0,0,0,0,0,0,0.210215903613104,136.845768268911,22.281752348227
9.7,"greedy_SVM","SVM",60,8,1884,1822,62,900,706,194,0.846634870164291,0.333333333333333,1.26485065710872,502,194,308,54,1.6,32.33,3.6,0,0,0,0,0,0,0.205812679101886,177.65283973361,21.4837662254414
9.7,"greedy_SVM","SVM",60,9,1784,1737,47,1000,791,209,0.847264911970804,0.311111111111111,1.26485065710872,543,209,334,41,1.6,35.92,3.8,0,0,0,0,0,0,0.193049708979795,167.715835710433,20.2618476474011
9.7,"greedy_SVM","SVM",60,10,1684,1646,38,1100,882,218,0.833038921274228,0.274074074074074,1.25534050179211,588,218,370,45,1.7,39.51,4,0,0,0,0,0,0,0.185705708243351,169.646130402872,19.5688416867665
9.7,"greedy_SVM","SVM",60,11,1584,1554,30,1200,974,226,0.832461873638356,0.259259259259259,1.25534050179211,608,226,382,20,1.7,43.1,4.3,0,0,0,0,0,0,0.176295908664175,166.914244034061,18.5453933044277
9.7,"greedy_SVM","SVM",60,12,1484,1464,20,1300,1064,236,0.832620856150278,0.22962962962963,1.25534050179211,636,236,400,28,1.7,46.7,4.5,0,0,0,0,0,0,0.152440060015078,133.169273036382,16.6617374481535
9.7,"greedy_SVM","SVM",60,13,1384,1369,15,1400,1159,241,0.832349997055891,0.281481481481481,1.25534050179211,653,241,412,17,1.7,50.29,4.8,0,0,0,0,0,0,0.11722532500262,79.1414072602713,13.5278349598184
9.7,"greedy_SVM","SVM",60,14,1284,1272,12,1500,1256,244,0.806494730024154,0.207407407407407,1.25534050179211,666,244,422,13,1.7,53.88,5.1,0,0,0,0,0,0,0.157008462163888,169.889270205853,16.946110142937
9.7,"greedy_SVM","SVM",60,15,1184,1175,9,1600,1353,247,0.842212801036338,0.311111111111111,1.25534050179211,678,247,431,12,1.7,57.47,5.5,0,0,0,0,0,0,0.101980139628739,63.4307297979112,11.9644339857371
9.7,"greedy_SVM","SVM",60,16,1084,1078,6,1700,1450,250,0.814155331802397,0.237037037037037,1.27436081242533,686,250,436,8,1.7,61.06,5.8,0,0,0,0,0,0,0.0896144068089972,44.4739473935071,12.4358256370531
9.7,"greedy_SVM","SVM",60,17,984,980,4,1800,1548,252,0.830589412942365,0.237037037037037,1.27436081242533,712,252,460,26,1.8,64.66,6.1,0,0,0,0,0,0,0.093748487841861,36.2237987912005,11.5553763445844
9.7,"greedy_SVM","SVM",60,18,884,881,3,1900,1647,253,0.819578401931357,0.251851851851852,1.27436081242533,695,253,442,-17,1.7,68.25,6.5,0,0,0,0,0,0,0.0781789715124158,35.7644017354073,9.67994843305992
9.7,"greedy_SVM","SVM",60,19,784,782,2,2000,1746,254,0.833274450921521,0.274074074074074,1.27436081242533,690,254,436,-5,1.7,71.84,6.9,0,0,0,0,0,0,0.0527494758268106,18.0921633068062,6.94830251630311
9.7,"greedy_SVM","SVM",60,20,684,682,2,2100,1846,254,0.825348878290069,0.259259259259259,1.27436081242533,724,254,470,34,1.9,75.43,7.3,0,0,0,0,0,0,0.0296624683998234,9.75445618531041,3.97053961077202
9.7,"greedy_SVM","SVM",60,21,584,582,2,2200,1946,254,0.838850615321209,0.259259259259259,1.27436081242533,713,254,459,-11,1.8,79.02,7.7,0,0,0,0,0,0,0.0198828065585198,5.75174300218987,2.9259851163029
9.7,"greedy_SVM","SVM",60,22,484,482,2,2300,2046,254,0.830489312842262,0.22962962962963,1.27436081242533,716,254,462,3,1.8,82.61,8.1,0,0,0,0,0,0,0.00781729719304484,2.20920684821286,1.23760389718729
9.7,"greedy_SVM","SVM",60,23,384,383,1,2400,2145,255,0.828334216569522,0.237037037037037,1.27436081242533,733,255,478,17,1.9,86.21,8.4,0,0,0,0,0,0,0.0227628328297561,7.59840350475319,6.04824295785718
9.7,"greedy_SVM","SVM",60,24,284,284,0,2500,2244,256,0.783842666195613,0.155555555555556,1.27436081242533,712,256,456,-21,1.8,89.8,8.8,0,0,0,0,0,0,0.0035471255698701,7.26559971285017,7.14620100005384
9.7,"greedy_SVM","SVM",60,25,184,184,0,2600,2344,256,0.803986339280461,0.237037037037037,1.27436081242533,707,256,451,-5,1.8,93.39,9.2,0,0,0,0,0,0,0.000210847845343516,0.258312637422206,0.253534731094239
9.7,"greedy_SVM","SVM",60,26,84,84,0,2700,2444,256,0.793681917211332,0.207407407407407,1.27436081242533,721,256,465,14,1.8,96.98,9.5,0,0,0,0,0,0,6.23991514689804e-07,0.0127094662695385,0.0127094662695385
9.7,"greedy_SVM","SVM",60,27,0,0,0,2784,2528,256,0.799252193369849,0.214814814814815,1.27436081242533,705,256,449,-16,1.8,100,9.9,0,0,0,0,0,0,0,0,0
9.7,"greedy_SVM","SVM",61,0,2684,2420,264,100,91,9,0.787411100033237,0.254237288135593,1.27299070530344,31,9,22,0,2.4,3.59,10.1,0,0,0,0,0,0,0.0921401997378673,246.140572584944,9.22668708265654
9.7,"greedy_SVM","SVM",61,1,2584,2342,242,200,169,31,0.802279827185114,0.305084745762712,1.27299070530344,80,31,49,49,1.6,7.18,5.5,0,0,0,0,0,0,0.187230242394509,300.439956517581,19.9739325938559
9.7,"greedy_SVM","SVM",61,2,2484,2274,210,300,237,63,0.80250581588568,0.186440677966102,1.28387096774194,160,63,97,80,1.5,10.78,3.8,0,0,0,0,0,0,0.228099481913021,386.278876171477,23.4933782030011
9.7,"greedy_SVM","SVM",61,3,2384,2189,195,400,322,78,0.812442671984053,0.271186440677966,1.26211044286495,203,78,125,43,1.6,14.37,4.1,0,0,0,0,0,0,0.197447212302954,371.674206618729,20.1662059264373
9.7,"greedy_SVM","SVM",61,4,2284,2122,162,500,389,111,0.83064140910602,0.305084745762712,1.26211044286495,273,111,162,70,1.5,17.96,3.5,0,0,0,0,0,0,0.216819606658381,196.987342760641,22.6230364904623
9.7,"greedy_SVM","SVM",61,5,2184,2051,133,600,460,140,0.833811897640417,0.279661016949153,1.25123018042646,346,140,206,73,1.5,21.55,3.3,0,0,0,0,0,0,0.234683472021687,287.072009584106,24.3588220966726
9.7,"greedy_SVM","SVM",61,6,2084,1980,104,700,531,169,0.819594549684285,0.254237288135593,1.25123018042646,414,169,245,68,1.4,25.14,3.1,0,0,0,0,0,0,0.248784523439484,216.864538451014,26.2875565572097
9.7,"greedy_SVM","SVM",61,7,1984,1887,97,800,624,176,0.829850448654042,0.288135593220339,1.26211044286495,433,176,257,19,1.5,28.74,3.5,0,0,0,0,0,0,0.215192332764947,192.692401627464,22.0849683062032
9.7,"greedy_SVM","SVM",61,8,1884,1803,81,900,708,192,0.829491525423734,0.296610169491525,1.26211044286495,467,192,275,34,1.4,32.33,3.7,0,0,0,0,0,0,0.196669071945532,191.414332132994,20.5239080627083
9.7,"greedy_SVM","SVM",61,9,1784,1732,52,1000,779,221,0.818059155865744,0.245762711864407,1.25123018042646,547,221,326,80,1.5,35.92,3.5,0,0,0,0,0,0,0.214955383467584,270.906072727527,22.1049533488528
9.7,"greedy_SVM","SVM",61,10,1684,1649,35,1100,862,238,0.832289797274848,0.254237288135593,1.26211044286495,591,238,353,44,1.5,39.51,3.6,0,0,0,0,0,0,0.172475815265704,88.0645549647955,19.8093977807099
9.7,"greedy_SVM","SVM",61,11,1584,1555,29,1200,956,244,0.827796610169497,0.245762711864407,1.26211044286495,619,244,375,28,1.5,43.1,3.9,0,0,0,0,0,0,0.18041628253778,161.679096317348,18.7820845095923
9.7,"greedy_SVM","SVM",61,12,1484,1456,28,1300,1055,245,0.825915586573619,0.288135593220339,1.26211044286495,606,245,361,-13,1.5,46.7,4.3,0,0,0,0,0,0,0.163897840883286,136.548285947652,17.2184059761451
9.7,"greedy_SVM","SVM",61,13,1384,1357,27,1400,1154,246,0.829391824526427,0.271186440677966,1.26211044286495,621,246,375,15,1.5,50.29,4.7,0,0,0,0,0,0,0.132304388012439,82.379473965144,14.4532085565016
9.7,"greedy_SVM","SVM",61,14,1284,1258,26,1500,1253,247,0.824160850780997,0.254237288135593,1.26211044286495,643,247,396,22,1.6,53.88,5.1,0,0,0,0,0,0,0.122539946720489,68.5037123251343,14.7343093025785
9.7,"greedy_SVM","SVM",61,15,1184,1159,25,1600,1352,248,0.818318378198741,0.279661016949153,1.25123018042646,642,248,394,-1,1.6,57.47,5.5,0,0,0,0,0,0,0.0861986659037039,39.5322973108658,10.9959786301756
9.7,"greedy_SVM","SVM",61,16,1084,1060,24,1700,1451,249,0.816098371552018,0.245762711864407,1.25123018042646,654,249,405,12,1.6,61.06,5.8,0,0,0,0,0,0,0.0553793806956196,18.6352712603461,6.72385242775091
9.7,"greedy_SVM","SVM",61,17,984,964,20,1800,1547,253,0.814935194416755,0.23728813559322,1.26211044286495,669,253,416,15,1.6,64.66,6.1,0,0,0,0,0,0,0.0535045975831461,22.4988832283198,7.06679913735562
9.7,"greedy_SVM","SVM",61,18,884,868,16,1900,1643,257,0.823948155533403,0.245762711864407,1.27299070530344,671,257,414,2,1.6,68.25,6.4,0,0,0,0,0,0,0.0578321992201263,23.4867314965115,7.35786839271566
9.7,"greedy_SVM","SVM",61,19,784,769,15,2000,1742,258,0.834257228315057,0.271186440677966,1.26211044286495,680,258,422,9,1.6,71.84,6.8,0,0,0,0,0,0,0.0390340959848171,14.1202755801767,4.83819210827525
9.7,"greedy_SVM","SVM",61,20,684,673,11,2100,1838,262,0.838351611831176,0.245762711864407,1.27299070530344,689,262,427,9,1.6,75.43,7,0,0,0,0,0,0,0.0511622043425107,14.7187918908473,7.44614177769599
9.7,"greedy_SVM","SVM",61,21,584,581,3,2200,1930,270,0.832356264539716,0.288135593220339,1.27299070530344,740,270,470,51,1.7,79.02,7.1,0,0,0,0,0,0,0.0279965234718077,9.44943566273876,5.973330347744
9.7,"greedy_SVM","SVM",61,22,484,482,2,2300,2029,271,0.820764373546031,0.271186440677966,1.27299070530344,727,271,456,-13,1.7,82.61,7.5,0,0,0,0,0,0,0.0454312559658774,13.6807986313676,6.3349636336339
9.7,"greedy_SVM","SVM",61,23,384,382,2,2400,2129,271,0.854948487869727,0.313559322033898,1.27299070530344,737,271,466,10,1.7,86.21,7.9,0,0,0,0,0,0,0.0193224847697082,5.10259052144738,2.63244148906787
9.7,"greedy_SVM","SVM",61,24,284,283,1,2500,2228,272,0.807131937520773,0.211864406779661,1.27299070530344,756,272,484,19,1.8,89.8,8.2,0,0,0,0,0,0,0.00934223874953433,2.2796985208726,1.58697828154451
9.7,"greedy_SVM","SVM",61,25,184,184,0,2600,2327,273,0.805596543702229,0.203389830508475,1.27299070530344,760,273,487,4,1.8,93.39,8.5,0,0,0,0,0,0,0.0249678231494626,15.3615523638835,14.5886716861089
9.7,"greedy_SVM","SVM",61,26,84,84,0,2700,2427,273,0.823894981721504,0.279661016949153,1.27299070530344,741,273,468,-19,1.7,96.98,8.9,0,0,0,0,0,0,7.16355588865903e-07,0.0784311528973395,0.0784311528973395
9.7,"greedy_SVM","SVM",61,27,0,0,0,2784,2511,273,0.811950814223997,0.254237288135593,1.27299070530344,764,273,491,23,1.8,100,9.2,0,0,0,0,0,0,0,0,0
9.7,"greedy_SVM","SVM",62,0,2684,2437,247,100,88,12,0.809722923124976,0.265151515151515,1.27414467253177,31,12,19,0,1.6,3.59,7.3,0,0,0,0,0,0,0.159328260749906,310.770574882515,17.8558029650458
9.7,"greedy_SVM","SVM",62,1,2584,2368,216,200,157,43,0.774667772090446,0.204545454545455,1.27414467253177,105,43,62,74,1.4,7.18,3.7,0,0,0,0,0,0,0.228113862282264,489.502104844484,24.1437154032932
9.7,"greedy_SVM","SVM",62,2,2484,2284,200,300,241,59,0.74978972917117,0.151515151515152,1.2352394916911,151,59,92,46,1.6,10.78,4.1,0,0,0,0,0,0,0.209544917351746,444.9451171613,23.0277717530364
9.7,"greedy_SVM","SVM",62,3,2384,2198,186,400,327,73,0.8065448297407,0.234848484848485,1.27414467253177,181,73,108,30,1.5,14.37,4.5,0,0,0,0,0,0,0.198068279935576,343.642021528529,21.0912199559005
9.7,"greedy_SVM","SVM",62,4,2284,2105,179,500,420,80,0.821534135967115,0.265151515151515,1.27414467253177,213,80,133,32,1.7,17.96,5.2,0,0,0,0,0,0,0.177719413449857,189.282896841547,18.3284759479758
9.7,"greedy_SVM","SVM",62,5,2184,2030,154,600,495,105,0.823516689496059,0.25,1.27414467253177,267,105,162,54,1.5,21.55,4.7,0,0,0,0,0,0,0.190961466151214,172.668588410389,19.6410053564115
9.7,"greedy_SVM","SVM",62,6,2084,1971,113,700,554,146,0.819557590176135,0.242424242424242,1.27414467253177,354,146,208,87,1.4,25.14,3.8,0,0,0,0,0,0,0.222089360400966,181.769547969098,22.8837946257532
9.7,"greedy_SVM","SVM",62,7,1984,1909,75,800,616,184,0.824820368634791,0.257575757575758,1.27414467253177,438,184,254,84,1.4,28.74,3.3,0,0,0,0,0,0,0.234696079215918,171.979278350776,24.6017855907524
9.7,"greedy_SVM","SVM",62,8,1884,1828,56,900,697,203,0.833982169033703,0.265151515151515,1.27414467253177,484,203,281,46,1.4,32.33,3.4,0,0,0,0,0,0,0.227230120879008,174.764682477408,23.8696645556362
9.7,"greedy_SVM","SVM",62,9,1784,1737,47,1000,788,212,0.828581212601819,0.287878787878788,1.27414467253177,503,212,291,19,1.4,35.92,3.7,0,0,0,0,0,0,0.20182284085019,120.144001614766,21.0926697076
9.7,"greedy_SVM","SVM",62,10,1684,1649,35,1100,876,224,0.814342873621213,0.212121212121212,1.27414467253177,555,224,331,52,1.5,39.51,3.9,0,0,0,0,0,0,0.17580226134434,93.7215723943859,19.2980203373738
9.7,"greedy_SVM","SVM",62,11,1584,1562,22,1200,963,237,0.829055823901171,0.265151515151515,1.27414467253177,592,237,355,37,1.5,43.1,4.1,0,0,0,0,0,0,0.154683176896977,81.0697872906776,17.0531023395147
9.7,"greedy_SVM","SVM",62,12,1484,1468,16,1300,1057,243,0.821798476437637,0.25,1.27414467253177,606,243,363,14,1.5,46.7,4.3,0,0,0,0,0,0,0.123312950857506,59.5769320289568,14.3260660861313
9.7,"greedy_SVM","SVM",62,13,1384,1373,11,1400,1152,248,0.833801936894705,0.272727272727273,1.27414467253177,630,248,382,24,1.5,50.29,4.6,0,0,0,0,0,0,0.0633599798883265,21.6621572057658,9.0688377025598
9.7,"greedy_SVM","SVM",62,14,1284,1273,11,1500,1252,248,0.823636844255387,0.21969696969697,1.27414467253177,627,248,379,-3,1.5,53.88,5,0,0,0,0,0,0,0.0655636457307048,24.1484583505373,7.62588882876667
9.7,"greedy_SVM","SVM",62,15,1184,1174,10,1600,1351,249,0.816325427150156,0.272727272727273,1.27414467253177,634,249,385,7,1.5,57.47,5.4,0,0,0,0,0,0,0.033546170601313,9.66665021359889,4.72414762043205
9.7,"greedy_SVM","SVM",62,16,1084,1077,7,1700,1448,252,0.801648523297997,0.25,1.27414467253177,640,252,388,6,1.5,61.06,5.7,0,0,0,0,0,0,0.0585061614154433,19.6221478296536,10.0004569238082
9.7,"greedy_SVM","SVM",62,17,984,978,6,1800,1547,253,0.785391584360646,0.166666666666667,1.27414467253177,638,253,385,-2,1.5,64.66,6.1,0,0,0,0,0,0,0.0268607003816558,8.33810774590409,4.25408822078613
9.7,"greedy_SVM","SVM",62,18,884,880,4,1900,1645,255,0.811669430226125,0.227272727272727,1.27414467253177,666,255,411,28,1.6,68.25,6.5,0,0,0,0,0,0,0.0545169999056994,15.6896877168807,8.44387341147434
9.7,"greedy_SVM","SVM",62,19,784,781,3,2000,1744,256,0.803090380409966,0.242424242424242,1.27414467253177,671,256,415,5,1.6,71.84,6.8,0,0,0,0,0,0,0.04458034568811,14.3071991211739,6.97929375389831
9.7,"greedy_SVM","SVM",62,20,684,682,2,2100,1843,257,0.790972772931538,0.196969696969697,1.28387096774194,689,257,432,18,1.7,75.43,7.2,0,0,0,0,0,0,0.0410818474485598,12.3691725119783,7.25688868236291
9.7,"greedy_SVM","SVM",62,21,584,582,2,2200,1943,257,0.800350851897246,0.242424242424242,1.28387096774194,695,257,438,6,1.7,79.02,7.6,0,0,0,0,0,0,0.0207503110615155,5.58790923817151,3.38879386632366
9.7,"greedy_SVM","SVM",62,22,484,482,2,2300,2043,257,0.764773027659628,0.159090909090909,1.28387096774194,681,257,424,-14,1.6,82.61,7.9,0,0,0,0,0,0,0.0129752458360685,3.71304643230255,2.11752498755848
9.7,"greedy_SVM","SVM",62,23,384,383,1,2400,2142,258,0.791291183043762,0.227272727272727,1.28387096774194,695,258,437,14,1.7,86.21,8.3,0,0,0,0,0,0,0.0734547059628548,17.6004990543212,10.9797118382234
9.7,"greedy_SVM","SVM",62,24,284,283,1,2500,2242,258,0.785661932569145,0.204545454545455,1.27414467253177,697,258,439,2,1.7,89.8,8.7,0,0,0,0,0,0,0.0205453028901543,5.24529996304619,3.82812161101502
9.7,"greedy_SVM","SVM",62,25,184,184,0,2600,2341,259,0.740051185927477,0.136363636363636,1.28387096774194,704,259,445,7,1.7,93.39,9,0,0,0,0,0,0,0.000470403772107595,0.740717454375318,0.731464661719496
9.7,"greedy_SVM","SVM",62,26,84,84,0,2700,2441,259,0.79165765505972,0.189393939393939,1.28387096774194,704,259,445,0,1.7,96.98,9.4,0,0,0,0,0,0,2.76255330211734e-07,0.00262003318730444,0.00262003318730444
9.7,"greedy_SVM","SVM",62,27,0,0,0,2784,2525,259,0.815832792636913,0.287878787878788,1.27414467253177,705,259,446,1,1.7,100,9.7,0,0,0,0,0,0,0,0,0
9.7,"greedy_SVM","SVM",63,0,2684,2440,244,100,90,10,0.784125249895392,0.197080291970803,1.27449964680951,29,10,19,0,1.9,3.59,9,0,0,0,0,0,0,0.148661039876177,261.450411279427,16.9584806385719
9.7,"greedy_SVM","SVM",63,1,2584,2354,230,200,176,24,0.777686084894696,0.18978102189781,1.27449964680951,71,24,47,42,2,7.18,7.3,0,0,0,0,0,0,0.207340836264032,238.763731105976,33.2520884976353
9.7,"greedy_SVM","SVM",63,2,2484,2260,224,300,270,30,0.746077223487845,0.226277372262774,1.19952907935013,87,30,57,16,1.9,10.78,9,0,0,0,0,0,0,0.13181820146642,206.074611608357,14.3934098343828
9.7,"greedy_SVM","SVM",63,3,2384,2185,199,400,345,55,0.694418615463299,0.18978102189781,1.17141511655286,141,55,86,54,1.6,14.37,6.3,0,0,0,0,0,0,0.165915414586015,236.040472396385,18.5437745663188
9.7,"greedy_SVM","SVM",63,4,2284,2105,179,500,425,75,0.780516295504212,0.226277372262774,1.25575700494467,178,75,103,37,1.4,17.96,5.7,0,0,0,0,0,0,0.17119988519363,178.18655784087,18.0122772338231
9.7,"greedy_SVM","SVM",63,5,2184,2041,143,600,489,111,0.793249337486637,0.27007299270073,1.25575700494467,262,111,151,84,1.4,21.55,4.4,0,0,0,0,0,0,0.202836015859138,176.282823070613,21.3115545567923
9.7,"greedy_SVM","SVM",63,6,2084,1975,109,700,555,145,0.797151773676136,0.291970802919708,1.21714992404995,340,145,195,78,1.3,25.14,3.8,0,0,0,0,0,0,0.207057209828768,190.842365570458,21.9811807594593
9.7,"greedy_SVM","SVM",63,7,1984,1895,89,800,635,165,0.808591752289736,0.291970802919708,1.2276430421474,385,165,220,45,1.3,28.74,3.8,0,0,0,0,0,0,0.193463327487777,173.314602609416,20.6053812176139
9.7,"greedy_SVM","SVM",63,8,1884,1821,63,900,709,191,0.807673532009858,0.328467153284672,1.20890040028255,459,191,268,74,1.4,32.33,3.7,0,0,0,0,0,0,0.212089452623858,205.460469712909,22.0749073571965
9.7,"greedy_SVM","SVM",63,9,1784,1734,50,1000,796,204,0.80175740387745,0.313868613138686,1.19952907935013,499,204,295,40,1.4,35.92,3.9,0,0,0,0,0,0,0.20378106692626,168.678213195414,21.1794201007343
9.7,"greedy_SVM","SVM",63,10,1684,1641,43,1100,889,211,0.798915570226423,0.27007299270073,1.19952907935013,517,211,306,18,1.5,39.51,4.2,0,0,0,0,0,0,0.174410704524922,119.1231923167,18.59935692918
9.7,"greedy_SVM","SVM",63,11,1584,1552,32,1200,978,222,0.789710121344561,0.27007299270073,1.19015775841771,581,222,359,64,1.6,43.1,4.4,0,0,0,0,0,0,0.180543290963041,142.733885484636,18.9788675278403
9.7,"greedy_SVM","SVM",63,12,1484,1455,29,1300,1075,225,0.797148867915768,0.321167883211679,1.19015775841771,575,225,350,-6,1.6,46.7,4.8,0,0,0,0,0,0,0.160613665725705,132.070957571927,16.7189273221607
9.7,"greedy_SVM","SVM",63,13,1384,1359,25,1400,1171,229,0.802751173927198,0.306569343065693,1.19015775841771,590,229,361,15,1.6,50.29,5.1,0,0,0,0,0,0,0.13701732770081,90.488576723,14.8279964279634
9.7,"greedy_SVM","SVM",63,14,1284,1261,23,1500,1269,231,0.793016876656294,0.27007299270073,1.19015775841771,605,231,374,15,1.6,53.88,5.5,0,0,0,0,0,0,0.124753785784919,72.3956228936859,13.7375088090862
9.7,"greedy_SVM","SVM",63,15,1184,1162,22,1600,1368,232,0.777697707936215,0.248175182481752,1.18078643748528,614,232,382,9,1.6,57.47,5.9,0,0,0,0,0,0,0.127849766941652,84.2739670838258,14.723361150336
9.7,"greedy_SVM","SVM",63,16,1084,1062,22,1700,1468,232,0.800728764703153,0.299270072992701,1.19015775841771,620,232,388,6,1.7,61.06,6.3,0,0,0,0,0,0,0.10098159409804,55.5348359255251,10.7758504398631
9.7,"greedy_SVM","SVM",63,17,984,962,22,1800,1568,232,0.801960807104009,0.299270072992701,1.19015775841771,621,232,389,1,1.7,64.66,6.8,0,0,0,0,0,0,0.0766015670360183,36.1108027890102,8.44988847650735
9.7,"greedy_SVM","SVM",63,18,884,864,20,1900,1666,234,0.799822167464786,0.328467153284672,1.19952907935013,607,234,373,-14,1.6,68.25,7.1,0,0,0,0,0,0,0.0622728684419946,23.8486350254606,8.06470338056728
9.7,"greedy_SVM","SVM",63,19,784,764,20,2000,1766,234,0.799938397879961,0.284671532846715,1.19015775841771,613,234,379,6,1.6,71.84,7.5,0,0,0,0,0,0,0.0428552260043626,14.0997770733085,5.23031374983061
9.7,"greedy_SVM","SVM",63,20,684,665,19,2100,1865,235,0.795881956390351,0.284671532846715,1.19015775841771,630,235,395,17,1.7,75.43,7.9,0,0,0,0,0,0,0.00817950947235372,2.39099822971578,1.66957287037903
9.7,"greedy_SVM","SVM",63,21,584,565,19,2200,1965,235,0.763372309265893,0.182481751824818,1.19952907935013,610,235,375,-20,1.6,79.02,8.4,0,0,0,0,0,0,0.0254602626034953,7.45409562739186,3.41385295933189
9.7,"greedy_SVM","SVM",63,22,484,465,19,2300,2065,235,0.80612766748803,0.328467153284672,1.19015775841771,622,235,387,12,1.6,82.61,8.8,0,0,0,0,0,0,0.00151180503268592,0.420575421643343,0.295877168363253
9.7,"greedy_SVM","SVM",63,23,384,368,16,2400,2162,238,0.774902366451256,0.255474452554745,1.18078643748528,638,238,400,16,1.7,86.21,9.1,0,0,0,0,0,0,0.0477578177291016,12.1621330468595,9.75342506747711
9.7,"greedy_SVM","SVM",63,24,284,269,15,2500,2261,239,0.794405830117623,0.321167883211679,1.18078643748528,642,239,403,4,1.7,89.8,9.5,0,0,0,0,0,0,0.005673387512501,2.33193033674756,2.06629296838157
9.7,"greedy_SVM","SVM",63,25,184,173,11,2600,2357,243,0.757775814775214,0.204379562043796,1.19952907935013,658,243,415,16,1.7,93.39,9.7,0,0,0,0,0,0,0.000541558075797349,0.403875076601557,0.388015074807359
9.7,"greedy_SVM","SVM",63,26,84,78,6,2700,2452,248,0.779609698265841,0.240875912408759,1.20890040028255,678,248,430,20,1.7,96.98,9.9,0,0,0,0,0,0,1.62320110016889e-05,1.19972421035212,1.19972421035212
9.7,"greedy_SVM","SVM",63,27,0,0,0,2784,2530,254,0.824579245897066,0.328467153284672,1.27449964680951,702,254,448,24,1.8,100,10,0,0,0,0,0,0,0,0,0
9.7,"greedy_SVM","SVM",64,0,2684,2432,252,100,87,13,0.702390348404555,0.0873015873015873,1.26349206349206,41,13,28,0,2.2,3.59,6.7,0,0,0,0,0,0,0.136793573205549,352.852810366913,13.8177979763039
9.7,"greedy_SVM","SVM",64,1,2584,2345,239,200,174,26,0.573683617093247,0.134920634920635,1.14121863799283,76,26,50,35,1.9,7.18,6.7,0,0,0,0,0,0,0.136667966004618,339.50952104059,13.9185623022848
9.7,"greedy_SVM","SVM",64,2,2484,2262,222,300,257,43,0.701770210846768,0.166666666666667,1.22273425499232,119,43,76,43,1.8,10.78,6,0,0,0,0,0,0,0.152681161749936,340.355045275043,15.6665091093028
9.7,"greedy_SVM","SVM",64,3,2384,2180,204,400,339,61,0.751243407123442,0.277777777777778,1.20235535074245,157,61,96,38,1.6,14.37,5.6,0,0,0,0,0,0,0.162293345173101,314.35329327707,16.7483387523177
9.7,"greedy_SVM","SVM",64,4,2284,2107,177,500,412,88,0.739329249195071,0.238095238095238,1.20235535074245,222,88,134,65,1.5,17.96,4.7,0,0,0,0,0,0,0.185417781307712,336.323201443417,18.8717628098371
9.7,"greedy_SVM","SVM",64,5,2184,2023,161,600,496,104,0.759969181042579,0.301587301587302,1.22273425499232,258,104,154,36,1.5,21.55,4.8,0,0,0,0,0,0,0.177901565518255,277.310250662379,18.2659243982538
9.7,"greedy_SVM","SVM",64,6,2084,1947,137,700,572,128,0.765287330401775,0.293650793650794,1.21254480286738,304,128,176,46,1.4,25.14,4.5,0,0,0,0,0,0,0.183266972019654,265.493905132484,18.8094878730443
9.7,"greedy_SVM","SVM",64,7,1984,1866,118,800,653,147,0.772246651883591,0.341269841269841,1.21254480286738,355,147,208,51,1.4,28.74,4.4,0,0,0,0,0,0,0.183300639570313,263.225539107631,18.8712850617069
9.7,"greedy_SVM","SVM",64,8,1884,1795,89,900,724,176,0.780208215883038,0.277777777777778,1.20235535074245,429,176,253,74,1.4,32.33,4.1,0,0,0,0,0,0,0.183318800661355,197.325970847628,19.5246246624919
9.7,"greedy_SVM","SVM",64,9,1784,1711,73,1000,808,192,0.767110158980721,0.214285714285714,1.17178699436764,469,192,277,40,1.4,35.92,4.2,0,0,0,0,0,0,0.191134017725128,244.123076512014,19.594302574361
9.7,"greedy_SVM","SVM",64,10,1684,1623,61,1100,896,204,0.75807744829055,0.253968253968254,1.17178699436764,511,204,307,42,1.5,39.51,4.4,0,0,0,0,0,0,0.174475213613781,164.626388604247,18.7578675681989
9.7,"greedy_SVM","SVM",64,11,1584,1531,53,1200,988,212,0.767937009057765,0.253968253968254,1.20235535074245,533,212,321,22,1.5,43.1,4.7,0,0,0,0,0,0,0.155044748476928,148.80103161995,16.5331998401478
9.7,"greedy_SVM","SVM",64,12,1484,1441,43,1300,1078,222,0.754657295699125,0.182539682539683,1.21254480286738,567,222,345,34,1.6,46.7,4.9,0,0,0,0,0,0,0.1519727018616,146.265832230378,16.1200065044822
9.7,"greedy_SVM","SVM",64,13,1384,1342,42,1400,1177,223,0.775804612821185,0.222222222222222,1.22273425499232,557,223,334,-10,1.5,50.29,5.3,0,0,0,0,0,0,0.119935152799933,82.9614135362981,12.7391100266159
9.7,"greedy_SVM","SVM",64,14,1284,1244,40,1500,1275,225,0.770417559288908,0.198412698412698,1.22273425499232,574,225,349,17,1.6,53.88,5.7,0,0,0,0,0,0,0.111166978653373,79.8423867386912,11.9581405857332
9.7,"greedy_SVM","SVM",64,15,1184,1152,32,1600,1367,233,0.786152766815748,0.19047619047619,1.20235535074245,593,233,360,19,1.5,57.47,5.9,0,0,0,0,0,0,0.134993231422962,89.9241259860921,14.6379260169503
9.7,"greedy_SVM","SVM",64,16,1084,1063,21,1700,1456,244,0.794790844514597,0.222222222222222,1.20235535074245,620,244,376,27,1.5,61.06,6,0,0,0,0,0,0,0.104703725993621,55.4145034969971,12.3979455819086
9.7,"greedy_SVM","SVM",64,17,984,969,15,1800,1550,250,0.807763621102216,0.277777777777778,1.21254480286738,643,250,393,23,1.6,64.66,6.2,0,0,0,0,0,0,0.0757455220692244,36.2824568656508,9.2424977123697
9.7,"greedy_SVM","SVM",64,18,884,871,13,1900,1648,252,0.755859986720288,0.158730158730159,1.21254480286738,652,252,400,9,1.6,68.25,6.5,0,0,0,0,0,0,0.100846876473712,40.2203485912448,13.5600572126893
9.7,"greedy_SVM","SVM",64,19,784,771,13,2000,1748,252,0.791558612395237,0.214285714285714,1.21254480286738,657,252,405,5,1.6,71.84,6.9,0,0,0,0,0,0,0.0364929264392821,12.1647961657079,5.15674075439373
9.7,"greedy_SVM","SVM",64,20,684,673,11,2100,1846,254,0.789704463737614,0.214285714285714,1.21254480286738,659,254,405,2,1.6,75.43,7.3,0,0,0,0,0,0,0.0566567612478147,21.2081787293141,7.01280489700914
9.7,"greedy_SVM","SVM",64,21,584,573,11,2200,1946,254,0.800040089700707,0.206349206349206,1.21254480286738,658,254,404,-1,1.6,79.02,7.7,0,0,0,0,0,0,0.0360813037617221,11.2154400214392,4.28937869842352
9.7,"greedy_SVM","SVM",64,22,484,473,11,2300,2046,254,0.793544305383294,0.246031746031746,1.20235535074245,660,254,406,2,1.6,82.61,8.1,0,0,0,0,0,0,0.0116705685871924,3.13550443936048,1.67270386638072
9.7,"greedy_SVM","SVM",64,23,384,373,11,2400,2146,254,0.75020984452713,0.182539682539683,1.21254480286738,664,254,410,4,1.6,86.21,8.4,0,0,0,0,0,0,0.0148223232805919,4.04400035807409,2.11565247941552
9.7,"greedy_SVM","SVM",64,24,284,275,9,2500,2244,256,0.780227007930242,0.182539682539683,1.21254480286738,686,256,430,22,1.7,89.8,8.8,0,0,0,0,0,0,0.00896924416888861,2.47778273093726,1.63304880927811
9.7,"greedy_SVM","SVM",64,25,184,179,5,2600,2340,260,0.767122687012191,0.166666666666667,1.23292370711726,699,260,439,13,1.7,93.39,9,0,0,0,0,0,0,0.00131565536802096,1.02904099266152,0.974981311304129
9.7,"greedy_SVM","SVM",64,26,84,84,0,2700,2435,265,0.792185013968748,0.166666666666667,1.26349206349206,715,265,450,16,1.7,96.98,9.2,0,0,0,0,0,0,0.000297139210505598,0.1510895256253,0.1510895256253
9.7,"greedy_SVM","SVM",64,27,0,0,0,2784,2519,265,0.829029954523245,0.246031746031746,1.26349206349206,713,265,448,-2,1.7,100,9.5,0,0,0,0,0,0,0,0,0
9.7,"greedy_SVM","SVM",65,0,2684,2426,258,100,89,11,0.736524744940737,0.237704918032787,1.23125330512956,33,11,22,0,2,3.59,8.1,0,0,0,0,0,0,0.284674171325104,295.796788473807,44.7831666242257
9.7,"greedy_SVM","SVM",65,1,2584,2348,236,200,167,33,0.757135855335289,0.229508196721311,1.23125330512956,82,33,49,49,1.5,7.18,5.1,0,0,0,0,0,0,0.270520746209368,321.196749253848,30.979329350036
9.7,"greedy_SVM","SVM",65,2,2484,2277,207,300,238,62,0.678605976964053,0.213114754098361,1.15758857747224,148,62,86,66,1.4,10.78,3.8,0,0,0,0,0,0,0.216811694312408,302.363082164033,24.067964461671
9.7,"greedy_SVM","SVM",65,3,2384,2194,190,400,321,79,0.737388915401579,0.229508196721311,1.26282390269699,187,79,108,39,1.4,14.37,4.1,0,0,0,0,0,0,0.193707179607037,208.500228213038,20.3770597916572
9.7,"greedy_SVM","SVM",65,4,2284,2108,176,500,407,93,0.761837200603627,0.229508196721311,1.27334743521946,221,93,128,34,1.4,17.96,4.4,0,0,0,0,0,0,0.165493432694906,125.161212055347,17.680871486055
9.7,"greedy_SVM","SVM",65,5,2184,2027,157,600,488,112,0.78386064928867,0.270491803278689,1.26282390269699,265,112,153,44,1.4,21.55,4.4,0,0,0,0,0,0,0.176392096771045,155.42954721998,18.4187024968382
9.7,"greedy_SVM","SVM",65,6,2084,1950,134,700,565,135,0.810011479279254,0.344262295081967,1.26282390269699,323,135,188,58,1.4,25.14,4.2,0,0,0,0,0,0,0.183839369714486,171.977322451679,19.1501426961622
9.7,"greedy_SVM","SVM",65,7,1984,1877,107,800,638,162,0.797126310766017,0.237704918032787,1.26282390269699,394,162,232,71,1.4,28.74,3.9,0,0,0,0,0,0,0.202020359493824,171.216995280091,21.7192307916939
9.7,"greedy_SVM","SVM",65,8,1884,1787,97,900,728,172,0.822084069597969,0.336065573770492,1.26282390269699,418,172,246,24,1.4,32.33,4.2,0,0,0,0,0,0,0.161250780282621,97.3920797265192,18.2937977703021
9.7,"greedy_SVM","SVM",65,9,1784,1708,76,1000,807,193,0.824863602945925,0.319672131147541,1.26282390269699,465,193,272,47,1.4,35.92,4.2,0,0,0,0,0,0,0.154263741009099,94.6926329329191,17.2509342568622
9.7,"greedy_SVM","SVM",65,10,1684,1622,62,1100,893,207,0.814016328952292,0.30327868852459,1.24177683765204,498,207,291,33,1.4,39.51,4.3,0,0,0,0,0,0,0.172908881846247,150.502175327225,18.2918252098559
9.7,"greedy_SVM","SVM",65,11,1584,1533,51,1200,982,218,0.800969934606809,0.270491803278689,1.24177683765204,532,218,314,34,1.4,43.1,4.5,0,0,0,0,0,0,0.164835225967921,119.975016606096,17.5756138492902
9.7,"greedy_SVM","SVM",65,12,1484,1436,48,1300,1079,221,0.818743470353797,0.295081967213115,1.24177683765204,558,221,337,26,1.5,46.7,4.9,0,0,0,0,0,0,0.117187943568004,55.0624000518966,12.9660625374146
9.7,"greedy_SVM","SVM",65,13,1384,1348,36,1400,1167,233,0.812062271865454,0.278688524590164,1.26282390269699,613,233,380,55,1.6,50.29,5,0,0,0,0,0,0,0.147398732578886,76.9342528137951,16.0030413340102
9.7,"greedy_SVM","SVM",65,14,1284,1258,26,1500,1257,243,0.813706775354382,0.262295081967213,1.25230037017451,648,243,405,35,1.7,53.88,5.2,0,0,0,0,0,0,0.140773969899871,81.5998244057226,14.8072979021582
9.7,"greedy_SVM","SVM",65,15,1184,1159,25,1600,1356,244,0.816937741032625,0.30327868852459,1.25230037017451,651,244,407,3,1.7,57.47,5.6,0,0,0,0,0,0,0.109281755713018,45.7763344990896,12.150842592892
9.7,"greedy_SVM","SVM",65,16,1084,1059,25,1700,1456,244,0.810063071545582,0.270491803278689,1.25230037017451,639,244,395,-12,1.6,61.06,6,0,0,0,0,0,0,0.0778251538106401,25.3895517118548,8.86814281084812
9.7,"greedy_SVM","SVM",65,17,984,959,25,1800,1556,244,0.821967986998754,0.319672131147541,1.25230037017451,646,244,402,7,1.6,64.66,6.4,0,0,0,0,0,0,0.0480341672894066,12.7077641976297,6.1216741513852
9.7,"greedy_SVM","SVM",65,18,884,860,24,1900,1655,245,0.823477060788594,0.295081967213115,1.26282390269699,653,245,408,7,1.7,68.25,6.8,0,0,0,0,0,0,0.0304012145725594,8.33031361306549,4.38578326781929
9.7,"greedy_SVM","SVM",65,19,784,763,21,2000,1752,248,0.833202202989774,0.295081967213115,1.26282390269699,663,248,415,10,1.7,71.84,7.1,0,0,0,0,0,0,0.0134670642321306,4.84713350216053,3.24924506406772
9.7,"greedy_SVM","SVM",65,20,684,670,14,2100,1845,255,0.829248945583063,0.336065573770492,1.25230037017451,686,255,431,23,1.7,75.43,7.2,0,0,0,0,0,0,0.0258388719534569,9.57072738687267,3.9651935508434
9.7,"greedy_SVM","SVM",65,21,584,571,13,2200,1944,256,0.794675678115847,0.221311475409836,1.25230037017451,673,256,417,-13,1.6,79.02,7.6,0,0,0,0,0,0,0.0294866291813341,8.33475556534085,4.41374297891094
9.7,"greedy_SVM","SVM",65,22,484,471,13,2300,2044,256,0.825798712772952,0.262295081967213,1.25230037017451,679,256,423,6,1.7,82.61,8,0,0,0,0,0,0,0.0159092534252417,4.14403799112629,2.16541171516453
9.7,"greedy_SVM","SVM",65,23,384,373,11,2400,2142,258,0.828868452618949,0.254098360655738,1.22072977260709,684,258,426,5,1.7,86.21,8.3,0,0,0,0,0,0,0.0378168584632631,11.2029772439954,6.79896424028365
9.7,"greedy_SVM","SVM",65,24,284,274,10,2500,2241,259,0.806032425739381,0.213114754098361,1.22072977260709,700,259,441,16,1.7,89.8,8.7,0,0,0,0,0,0,0.0154856606200455,4.16398870606134,2.89035955573181
9.7,"greedy_SVM","SVM",65,25,184,175,9,2600,2340,260,0.772252389366831,0.172131147540984,1.22072977260709,695,260,435,-5,1.7,93.39,9,0,0,0,0,0,0,0.0151982877603139,3.01975473121629,2.27939996796442
9.7,"greedy_SVM","SVM",65,26,84,80,4,2700,2435,265,0.818214649624023,0.254098360655738,1.28387096774194,726,265,461,31,1.7,96.98,9.2,0,0,0,0,0,0,2.12274789717649e-06,1.384543110099,1.384543110099
9.7,"greedy_SVM","SVM",65,27,0,0,0,2784,2515,269,0.814403270949686,0.213114754098361,1.28387096774194,740,269,471,14,1.8,100,9.3,0,0,0,0,0,0,0,0,0
9.7,"greedy_SVM","SVM",66,0,2684,2426,258,100,94,6,0.177855730119043,0,0.485242570485141,18,6,12,0,2,3.59,15.7,0,0,0,0,0,0,0.0623247039385188,167.212402614507,6.2326156229163
9.7,"greedy_SVM","SVM",66,1,2584,2328,256,200,192,8,0.762498289609532,0.291338582677165,1.17266954533909,32,8,24,14,3,7.18,24,0,0,0,0,0,0,0.0483117139773539,100.137828181683,5.24985100687275
9.7,"greedy_SVM","SVM",66,2,2484,2252,232,300,268,32,0.730517097685067,0.283464566929134,1.18277876555753,89,32,57,57,1.8,10.78,8.4,0,0,0,0,0,0,0.144001107420115,188.32461711715,19.168503984008
9.7,"greedy_SVM","SVM",66,3,2384,2167,217,400,353,47,0.804256695401232,0.330708661417323,1.25354330708661,128,47,81,39,1.7,14.37,7.5,0,0,0,0,0,0,0.139578977956547,121.824454387892,15.1358440865338
9.7,"greedy_SVM","SVM",66,4,2284,2096,188,500,424,76,0.833159184485832,0.346456692913386,1.2737617475235,200,76,124,72,1.6,17.96,5.6,0,0,0,0,0,0,0.184696842251528,157.48799660544,18.9429189567258
9.7,"greedy_SVM","SVM",66,5,2184,2022,162,600,498,102,0.810893010411618,0.267716535433071,1.23332486664973,267,102,165,67,1.6,21.55,4.9,0,0,0,0,0,0,0.191160762329251,192.92725161036,19.7144175873343
9.7,"greedy_SVM","SVM",66,6,2084,1951,133,700,569,131,0.833924195494529,0.322834645669291,1.24343408686817,327,131,196,60,1.5,25.14,4.3,0,0,0,0,0,0,0.201175848466649,98.4028172961063,21.8677051975626
9.7,"greedy_SVM","SVM",66,7,1984,1888,96,800,632,168,0.81645955393017,0.244094488188976,1.25354330708661,415,168,247,88,1.5,28.74,3.8,0,0,0,0,0,0,0.20640874596385,151.231821127352,23.0944119980839
9.7,"greedy_SVM","SVM",66,8,1884,1807,77,900,713,187,0.816801632023496,0.251968503937008,1.2737617475235,457,187,270,42,1.4,32.33,3.8,0,0,0,0,0,0,0.218942608217606,183.755357187262,34.9977818434996
9.7,"greedy_SVM","SVM",66,9,1784,1721,63,1000,799,201,0.835068602206717,0.267716535433071,1.25354330708661,492,201,291,35,1.4,35.92,4,0,0,0,0,0,0,0.190894247017838,130.967443380875,22.1105935204064
9.7,"greedy_SVM","SVM",66,10,1684,1631,53,1100,889,211,0.84262541826822,0.338582677165354,1.25354330708661,522,211,311,30,1.5,39.51,4.2,0,0,0,0,0,0,0.166358969038207,121.906472663429,17.7789458465898
9.7,"greedy_SVM","SVM",66,11,1584,1539,45,1200,981,219,0.835031284596543,0.31496062992126,1.25354330708661,547,219,328,25,1.5,43.1,4.5,0,0,0,0,0,0,0.162646225716679,104.264930107553,17.6238028882121
9.7,"greedy_SVM","SVM",66,12,1484,1447,37,1300,1073,227,0.840230871614987,0.322834645669291,1.25354330708661,572,227,345,25,1.5,46.7,4.7,0,0,0,0,0,0,0.14547674315723,86.0371737740963,15.8017489543651
9.7,"greedy_SVM","SVM",66,13,1384,1353,31,1400,1167,233,0.818082869973012,0.228346456692913,1.24343408686817,614,233,381,42,1.6,50.29,5,0,0,0,0,0,0,0.148019180125327,83.9348063120731,15.7631430108288
9.7,"greedy_SVM","SVM",66,14,1284,1261,23,1500,1259,241,0.828911196526975,0.275590551181102,1.24343408686817,639,241,398,25,1.7,53.88,5.2,0,0,0,0,0,0,0.137644559804576,73.0447557825721,14.4729377537181
9.7,"greedy_SVM","SVM",66,15,1184,1165,19,1600,1355,245,0.780858553818213,0.173228346456693,1.24343408686817,655,245,410,16,1.7,57.47,5.5,0,0,0,0,0,0,0.14092948163465,63.7363561584728,14.7933095942742
9.7,"greedy_SVM","SVM",66,16,1084,1067,17,1700,1453,247,0.7984538070182,0.21259842519685,1.24343408686817,654,247,407,-1,1.6,61.06,5.9,0,0,0,0,0,0,0.121073750765156,46.0421502523799,12.9679920091529
9.7,"greedy_SVM","SVM",66,17,984,967,17,1800,1553,247,0.774502120884178,0.15748031496063,1.24343408686817,659,247,412,5,1.7,64.66,6.3,0,0,0,0,0,0,0.0999243864995393,27.842464999903,11.0528745265029
9.7,"greedy_SVM","SVM",66,18,884,867,17,1900,1653,247,0.820906569143313,0.236220472440945,1.24343408686817,642,247,395,-17,1.6,68.25,6.7,0,0,0,0,0,0,0.0629865346304959,14.73930067138,8.15757504372637
9.7,"greedy_SVM","SVM",66,19,784,767,17,2000,1753,247,0.81805799156622,0.291338582677165,1.24343408686817,666,247,419,24,1.7,71.84,7.1,0,0,0,0,0,0,0.0256996828124132,6.16476291261899,4.63005832649622
9.7,"greedy_SVM","SVM",66,20,684,669,15,2100,1851,249,0.772406115112388,0.165354330708661,1.26365252730505,664,249,415,-2,1.7,75.43,7.4,0,0,0,0,0,0,2.0559749741153e-06,0.566056534065172,0.566005620271994
9.7,"greedy_SVM","SVM",66,21,584,580,4,2200,1940,260,0.771920986180047,0.110236220472441,1.2737617475235,713,260,453,49,1.7,79.02,7.5,0,0,0,0,0,0,0.103739307350233,32.2433403829681,13.8881064233034
9.7,"greedy_SVM","SVM",66,22,484,482,2,2300,2038,262,0.730709905337662,0.094488188976378,1.2737617475235,715,262,453,2,1.7,82.61,7.8,0,0,0,0,0,0,0.0765523199909272,20.6265861972567,9.74112988538852
9.7,"greedy_SVM","SVM",66,23,384,383,1,2400,2137,263,0.728607679964175,0.102362204724409,1.2737617475235,732,263,469,17,1.8,86.21,8.1,0,0,0,0,0,0,0.0447778024776077,10.4343896527309,6.13428560136894
9.7,"greedy_SVM","SVM",66,24,284,283,1,2500,2237,263,0.731064422634374,0.102362204724409,1.2737617475235,725,263,462,-7,1.8,89.8,8.5,0,0,0,0,0,0,0.00566375978122347,1.35902452229355,1.20856572508545
9.7,"greedy_SVM","SVM",66,25,184,183,1,2600,2337,263,0.763499645482704,0.125984251968504,1.2737617475235,728,263,465,3,1.8,93.39,8.9,0,0,0,0,0,0,1.25309636830086e-06,0.245595991655318,0.24557838773242
9.7,"greedy_SVM","SVM",66,26,84,84,0,2700,2436,264,0.767306041721091,0.141732283464567,1.2737617475235,719,264,455,-9,1.7,96.98,9.2,0,0,0,0,0,0,4.96675030352009e-12,4.15889382326397,4.15889382326397
9.7,"greedy_SVM","SVM",66,27,0,0,0,2784,2520,264,0.773724670672089,0.181102362204724,1.2737617475235,738,264,474,19,1.8,100,9.5,0,0,0,0,0,0,0,0,0
9.7,"greedy_SVM","SVM",67,0,2684,2436,248,100,88,12,0.71672856607106,0.213740458015267,1.2348682590495,38,12,26,0,2.2,3.59,7.3,0,0,0,0,0,0,0.202705450024683,337.766827033392,28.9195432961104
9.7,"greedy_SVM","SVM",67,1,2584,2353,231,200,171,29,0.765064540714479,0.16793893129771,1.27407042600345,84,29,55,46,1.9,7.18,5.9,0,0,0,0,0,0,0.204518892534356,340.630886263667,24.0225589927708
9.7,"greedy_SVM","SVM",67,2,2484,2266,218,300,258,42,0.702731638862338,0.244274809160305,1.20546663383403,116,42,74,32,1.8,10.78,6.1,0,0,0,0,0,0,0.272664219908645,275.398930059102,37.3903357012848
9.7,"greedy_SVM","SVM",67,3,2384,2194,190,400,330,70,0.755023529838732,0.137404580152672,1.2348682590495,172,70,102,56,1.5,14.37,4.7,0,0,0,0,0,0,0.201062987326748,292.997496295586,24.0984419055173
9.7,"greedy_SVM","SVM",67,4,2284,2103,181,500,421,79,0.8281777379901,0.290076335877863,1.25446934252647,205,79,126,33,1.6,17.96,5.3,0,0,0,0,0,0,0.188350989711355,187.460457585596,19.6489471683226
9.7,"greedy_SVM","SVM",67,5,2184,2032,152,600,492,108,0.822280156301032,0.290076335877863,1.25446934252647,260,108,152,55,1.4,21.55,4.6,0,0,0,0,0,0,0.192986338951251,178.597717884861,19.8338243685807
9.7,"greedy_SVM","SVM",67,6,2084,1970,114,700,554,146,0.828752374154676,0.312977099236641,1.24466880078798,346,146,200,86,1.4,25.14,3.8,0,0,0,0,0,0,0.213274011022165,222.746165949139,21.8611167385866
9.7,"greedy_SVM","SVM",67,7,1984,1902,82,800,622,178,0.823217720569551,0.305343511450382,1.24466880078798,418,178,240,72,1.3,28.74,3.5,0,0,0,0,0,0,0.22216549932385,157.936065615116,23.3934767981994
9.7,"greedy_SVM","SVM",67,8,1884,1825,59,900,699,201,0.828268470016083,0.297709923664122,1.25446934252647,474,201,273,56,1.4,32.33,3.5,0,0,0,0,0,0,0.217080861596831,152.256017487075,22.7043902855022
9.7,"greedy_SVM","SVM",67,9,1784,1742,42,1000,782,218,0.827899493110408,0.305343511450382,1.25446934252647,526,218,308,52,1.4,35.92,3.6,0,0,0,0,0,0,0.196738317438148,109.924186517311,21.2625770395618
9.7,"greedy_SVM","SVM",67,10,1684,1655,29,1100,869,231,0.83307121859159,0.305343511450382,1.25446934252647,562,231,331,36,1.4,39.51,3.8,0,0,0,0,0,0,0.185882238096053,108.905386806796,20.0631657715769
9.7,"greedy_SVM","SVM",67,11,1584,1559,25,1200,965,235,0.834819322292247,0.305343511450382,1.25446934252647,587,235,352,25,1.5,43.1,4.1,0,0,0,0,0,0,0.162833386372297,90.0798149954241,17.1725970743529
9.7,"greedy_SVM","SVM",67,12,1484,1462,22,1300,1062,238,0.817719359794816,0.259541984732824,1.24466880078798,582,238,344,-5,1.4,46.7,4.5,0,0,0,0,0,0,0.148123846950881,92.6096141154758,16.1029877682054
9.7,"greedy_SVM","SVM",67,13,1384,1367,17,1400,1157,243,0.818705314477187,0.305343511450382,1.22506771731101,600,243,357,18,1.5,50.29,4.8,0,0,0,0,0,0,0.135224483242445,75.5994740336294,15.4292161337373
9.7,"greedy_SVM","SVM",67,14,1284,1268,16,1500,1256,244,0.806105660468645,0.236641221374046,1.22506771731101,618,244,374,18,1.5,53.88,5.1,0,0,0,0,0,0,0.107117819268045,52.1333636456416,12.8530593041536
9.7,"greedy_SVM","SVM",67,15,1184,1168,16,1600,1356,244,0.812674659150006,0.312977099236641,1.22506771731101,631,244,387,13,1.6,57.47,5.6,0,0,0,0,0,0,0.10357649615876,55.3433587470898,11.1208978037366
9.7,"greedy_SVM","SVM",67,16,1084,1068,16,1700,1456,244,0.816793893129756,0.290076335877863,1.22506771731101,632,244,388,1,1.6,61.06,6,0,0,0,0,0,0,0.0639257190694288,27.1157758656491,7.51676496718503
9.7,"greedy_SVM","SVM",67,17,984,969,15,1800,1555,245,0.812656512744808,0.282442748091603,1.22506771731101,618,245,373,-14,1.5,64.66,6.3,0,0,0,0,0,0,0.0318698918530002,10.8260594523657,4.21572700457008
9.7,"greedy_SVM","SVM",67,18,884,869,15,1900,1655,245,0.811652411657234,0.267175572519084,1.22506771731101,619,245,374,1,1.5,68.25,6.8,0,0,0,0,0,0,0.0375701652753708,12.5195751032697,4.53156602109346
9.7,"greedy_SVM","SVM",67,19,784,769,15,2000,1755,245,0.814598178100901,0.320610687022901,1.22506771731101,624,245,379,5,1.5,71.84,7.2,0,0,0,0,0,0,0.0304741868400919,9.54610168054472,3.69556730502329
9.7,"greedy_SVM","SVM",67,20,684,670,14,2100,1854,246,0.799476173769959,0.244274809160305,1.22506771731101,634,246,388,10,1.6,75.43,7.5,0,0,0,0,0,0,0.0129364195469067,4.12966810411338,2.45987336642029
9.7,"greedy_SVM","SVM",67,21,584,571,13,2200,1953,247,0.816164817749587,0.305343511450382,1.22506771731101,636,247,389,2,1.6,79.02,7.9,0,0,0,0,0,0,0.0174708716859495,4.85077776122598,2.48111521785677
9.7,"greedy_SVM","SVM",67,22,484,472,12,2300,2052,248,0.784620316715243,0.213740458015267,1.22506771731101,650,248,402,14,1.6,82.61,8.3,0,0,0,0,0,0,0.00305728857675099,0.858172242835945,0.569975877937659
9.7,"greedy_SVM","SVM",67,23,384,375,9,2400,2149,251,0.807823520160639,0.312977099236641,1.21526717557252,673,251,422,23,1.7,86.21,8.6,0,0,0,0,0,0,0.0313740993296616,8.79439606237402,6.4040508917406
9.7,"greedy_SVM","SVM",67,24,284,275,9,2500,2249,251,0.78725759427056,0.251908396946565,1.21526717557252,674,251,423,1,1.7,89.8,9,0,0,0,0,0,0,0.00575094859821332,1.51426682684755,1.11154931519881
9.7,"greedy_SVM","SVM",67,25,184,177,7,2600,2347,253,0.813327929737106,0.274809160305344,1.21526717557252,678,253,425,4,1.7,93.39,9.3,0,0,0,0,0,0,0.0114519269038138,2.90479972512226,2.456162444986
9.7,"greedy_SVM","SVM",67,26,84,83,1,2700,2441,259,0.793264054390825,0.244274809160305,1.28387096774194,697,259,438,19,1.7,96.98,9.4,0,0,0,0,0,0,4.43722412637343e-07,1.1642668464861,1.1642668464861
9.7,"greedy_SVM","SVM",67,27,0,0,0,2784,2524,260,0.771911784275533,0.183206106870229,1.27407042600345,717,260,457,20,1.8,100,9.7,0,0,0,0,0,0,0,0,0
9.7,"greedy_SVM","SVM",68,0,2684,2419,265,100,91,9,0.786807062669132,0.239316239316239,1.28387096774194,30,9,21,0,2.3,3.59,10.1,0,0,0,0,0,0,0.115505013093837,252.477713992681,11.9586933277076
9.7,"greedy_SVM","SVM",68,1,2584,2338,246,200,172,28,0.730561584009859,0.247863247863248,1.23997794320375,72,28,44,42,1.6,7.18,6.1,0,0,0,0,0,0,0.176305351589527,312.750094187008,19.4339776599263
9.7,"greedy_SVM","SVM",68,2,2484,2274,210,300,236,64,0.745880556225382,0.205128205128205,1.23997794320375,153,64,89,81,1.4,10.78,3.7,0,0,0,0,0,0,0.235075919389647,378.415542103932,24.5919798844283
9.7,"greedy_SVM","SVM",68,3,2384,2197,187,400,313,87,0.741761112450765,0.213675213675214,1.23997794320375,206,87,119,53,1.4,14.37,3.6,0,0,0,0,0,0,0.225003925981193,391.551257510598,23.2457142176569
9.7,"greedy_SVM","SVM",68,4,2284,2124,160,500,386,114,0.75918334539024,0.213675213675214,1.27289771160739,273,114,159,67,1.4,17.96,3.4,0,0,0,0,0,0,0.239854525628128,252.763470329804,39.5574456625842
9.7,"greedy_SVM","SVM",68,5,2184,2032,152,600,478,122,0.778427511186134,0.247863247863248,1.26192445547284,290,122,168,17,1.4,21.55,3.9,0,0,0,0,0,0,0.197938420335649,203.133187105703,20.5699721008018
9.7,"greedy_SVM","SVM",68,6,2084,1957,127,700,553,147,0.778139485036039,0.213675213675214,1.26192445547284,346,147,199,56,1.4,25.14,3.8,0,0,0,0,0,0,0.204546336673585,265.862853345548,20.9844323389912
9.7,"greedy_SVM","SVM",68,7,1984,1877,107,800,633,167,0.788508426439461,0.239316239316239,1.26192445547284,394,167,227,48,1.4,28.74,3.8,0,0,0,0,0,0,0.199495594630334,204.719578904575,20.6433641910879
9.7,"greedy_SVM","SVM",68,8,1884,1804,80,900,706,194,0.794938777697407,0.230769230769231,1.26192445547284,467,194,273,73,1.4,32.33,3.6,0,0,0,0,0,0,0.204460187018092,199.405414434686,21.3674510396223
9.7,"greedy_SVM","SVM",68,9,1784,1725,59,1000,785,215,0.787503684055413,0.247863247863248,1.26192445547284,518,215,303,51,1.4,35.92,3.7,0,0,0,0,0,0,0.209611123303765,268.49125747093,21.388507482949
9.7,"greedy_SVM","SVM",68,10,1684,1639,45,1100,871,229,0.788615598960436,0.230769230769231,1.26192445547284,558,229,329,40,1.4,39.51,3.8,0,0,0,0,0,0,0.195940341556546,224.270458309071,20.3724088094547
9.7,"greedy_SVM","SVM",68,11,1584,1554,30,1200,956,244,0.784214827318281,0.239316239316239,1.2509511993383,609,244,365,51,1.5,43.1,3.9,0,0,0,0,0,0,0.181278132250447,152.041817392334,19.109544096595
9.7,"greedy_SVM","SVM",68,12,1484,1459,25,1300,1051,249,0.792011628218529,0.247863247863248,1.2290046870692,619,249,370,10,1.5,46.7,4.2,0,0,0,0,0,0,0.168157391786683,149.999488150978,17.6038550807674
9.7,"greedy_SVM","SVM",68,13,1384,1361,23,1400,1149,251,0.788963909653569,0.247863247863248,1.2290046870692,635,251,384,16,1.5,50.29,4.6,0,0,0,0,0,0,0.152559831966473,94.0969381006181,17.0308399324721
9.7,"greedy_SVM","SVM",68,14,1284,1262,22,1500,1248,252,0.77715483749967,0.256410256410256,1.2509511993383,631,252,379,-4,1.5,53.88,5,0,0,0,0,0,0,0.130474683824617,59.3676352437055,14.4592311196662
9.7,"greedy_SVM","SVM",68,15,1184,1164,20,1600,1346,254,0.78818690887657,0.239316239316239,1.2509511993383,653,254,399,22,1.6,57.47,5.3,0,0,0,0,0,0,0.111360534622293,45.1385202551035,12.1103101293362
9.7,"greedy_SVM","SVM",68,16,1084,1065,19,1700,1445,255,0.786733381560974,0.230769230769231,1.26192445547284,664,255,409,11,1.6,61.06,5.7,0,0,0,0,0,0,0.0789846788198673,23.8705184540042,9.01035869373066
9.7,"greedy_SVM","SVM",68,17,984,965,19,1800,1545,255,0.76687297376953,0.188034188034188,1.26192445547284,645,255,390,-19,1.5,64.66,6.1,0,0,0,0,0,0,0.0212845367748394,5.34891470782727,3.59554461515231
9.7,"greedy_SVM","SVM",68,18,884,865,19,1900,1645,255,0.785259759397694,0.256410256410256,1.26192445547284,659,255,404,14,1.6,68.25,6.5,0,0,0,0,0,0,0.00393282706548255,1.2495159428638,0.898749158183959
9.7,"greedy_SVM","SVM",68,19,784,771,13,2000,1739,261,0.790497816359889,0.188034188034188,1.26192445547284,680,261,419,21,1.6,71.84,6.7,0,0,0,0,0,0,0.140044530744858,52.3810267687182,36.2709627917492
9.7,"greedy_SVM","SVM",68,20,684,673,11,2100,1837,263,0.815535996570477,0.264957264957265,1.27289771160739,692,263,429,12,1.6,75.43,7,0,0,0,0,0,0,0.0476248798769131,13.1475857372809,7.3567173196466
9.7,"greedy_SVM","SVM",68,21,584,575,9,2200,1935,265,0.822046727219141,0.273504273504274,1.28387096774194,688,265,423,-4,1.6,79.02,7.3,0,0,0,0,0,0,0.0399547239163341,10.7524870918134,6.18621020144926
9.7,"greedy_SVM","SVM",68,22,484,481,3,2300,2029,271,0.822950995364784,0.247863247863248,1.28387096774194,732,271,461,44,1.7,82.61,7.5,0,0,0,0,0,0,0.020175209410468,6.37824618231845,4.7311474356453
9.7,"greedy_SVM","SVM",68,23,384,382,2,2400,2128,272,0.793324491600352,0.264957264957265,1.27289771160739,729,272,457,-3,1.7,86.21,7.8,0,0,0,0,0,0,0.00670671633662556,1.85338990735006,1.48582954215409
9.7,"greedy_SVM","SVM",68,24,284,283,1,2500,2227,273,0.759397690432169,0.11965811965812,1.27289771160739,743,273,470,14,1.7,89.8,8.2,0,0,0,0,0,0,0.0323187254048448,10.0333769490837,8.25398272962148
9.7,"greedy_SVM","SVM",68,25,184,184,0,2600,2326,274,0.805059882646087,0.222222222222222,1.27289771160739,743,274,469,0,1.7,93.39,8.5,0,0,0,0,0,0,0.000471923538121908,2.51832653024831,2.51024297720672
9.7,"greedy_SVM","SVM",68,26,84,84,0,2700,2426,274,0.793558931489964,0.196581196581197,1.28387096774194,735,274,461,-8,1.7,96.98,8.9,0,0,0,0,0,0,0.00011006313282086,0.160017988880776,0.160017988880776
9.7,"greedy_SVM","SVM",68,27,0,0,0,2784,2510,274,0.783317257455182,0.179487179487179,1.27289771160739,739,274,465,4,1.7,100,9.2,0,0,0,0,0,0,0,0,0
9.7,"greedy_SVM","SVM",69,0,2684,2422,262,100,89,11,0.30977733466268,0.00847457627118644,0.761618370694368,34,11,23,0,2.1,3.59,8.1,0,0,0,0,0,0,0.117674086450739,298.946632966351,11.8844061056355
9.7,"greedy_SVM","SVM",69,1,2584,2322,262,200,189,11,0.658664007976072,0.135593220338983,1.18594860579552,35,11,24,1,2.2,7.18,17.2,0,0,0,0,0,0,0.0827406338675181,179.243990806449,8.85959468978607
9.7,"greedy_SVM","SVM",69,2,2484,2243,241,300,268,32,0.772037221668334,0.211864406779661,1.26211044286495,85,32,53,50,1.7,10.78,8.4,0,0,0,0,0,0,0.242438015578762,235.813916498427,26.8950901594818
9.7,"greedy_SVM","SVM",69,3,2384,2174,210,400,337,63,0.7597939514789,0.271186440677966,1.24034991798797,149,63,86,64,1.4,14.37,5.3,0,0,0,0,0,0,0.241539467022943,247.866265476288,29.2323766370506
9.7,"greedy_SVM","SVM",69,4,2284,2107,177,500,404,96,0.762738451312731,0.186440677966102,1.26211044286495,229,96,133,80,1.4,17.96,4.2,0,0,0,0,0,0,0.24148172140376,303.540921674495,27.0216533479186
9.7,"greedy_SVM","SVM",69,5,2184,2023,161,600,488,112,0.788248587570625,0.228813559322034,1.26211044286495,266,112,154,37,1.4,21.55,4.4,0,0,0,0,0,0,0.219606269362379,235.457602866837,22.4849714494147
9.7,"greedy_SVM","SVM",69,6,2084,1952,132,700,559,141,0.799893652376209,0.245762711864407,1.26211044286495,330,141,189,64,1.3,25.14,4,0,0,0,0,0,0,0.23727196057957,201.277922491587,24.6200676680141
9.7,"greedy_SVM","SVM",69,7,1984,1873,111,800,638,162,0.790847457627122,0.254237288135593,1.26211044286495,386,162,224,56,1.4,28.74,3.9,0,0,0,0,0,0,0.228514704185783,210.670201529754,23.3001570464925
9.7,"greedy_SVM","SVM",69,8,1884,1803,81,900,708,192,0.791119973413097,0.245762711864407,1.26211044286495,453,192,261,67,1.4,32.33,3.7,0,0,0,0,0,0,0.226499775314712,177.577829259574,23.5437056001869
9.7,"greedy_SVM","SVM",69,9,1784,1720,64,1000,791,209,0.782897972748423,0.228813559322034,1.26211044286495,508,209,299,55,1.4,35.92,3.8,0,0,0,0,0,0,0.20036205991874,158.548071440503,22.1332613413001
9.7,"greedy_SVM","SVM",69,10,1684,1623,61,1100,888,212,0.780013293452978,0.245762711864407,1.26211044286495,510,212,298,2,1.4,39.51,4.2,0,0,0,0,0,0,0.164152091648228,108.618358530551,17.6404105456998
9.7,"greedy_SVM","SVM",69,11,1584,1534,50,1200,977,223,0.810003323363249,0.254237288135593,1.26211044286495,560,223,337,50,1.5,43.1,4.4,0,0,0,0,0,0,0.174541805494498,100.441226077439,20.0499543825969
9.7,"greedy_SVM","SVM",69,12,1484,1456,28,1300,1055,245,0.803077434363582,0.220338983050847,1.26211044286495,611,245,366,51,1.5,46.7,4.3,0,0,0,0,0,0,0.184234853252129,135.820271157475,20.1180642316215
9.7,"greedy_SVM","SVM",69,13,1384,1368,16,1400,1143,257,0.809896975739454,0.203389830508475,1.26211044286495,640,257,383,29,1.5,50.29,4.4,0,0,0,0,0,0,0.162473289482781,101.001361552026,17.8357935860153
9.7,"greedy_SVM","SVM",69,14,1284,1271,13,1500,1240,260,0.81806580259223,0.220338983050847,1.26211044286495,657,260,397,17,1.5,53.88,4.8,0,0,0,0,0,0,0.139338757049271,92.9623599087232,15.2927895138296
9.7,"greedy_SVM","SVM",69,15,1184,1173,11,1600,1338,262,0.806247922897978,0.211864406779661,1.27299070530344,668,262,406,11,1.5,57.47,5.1,0,0,0,0,0,0,0.115726019119955,60.8369685676607,14.3139014530269
9.7,"greedy_SVM","SVM",69,16,1084,1073,11,1700,1438,262,0.803502824858762,0.220338983050847,1.27299070530344,681,262,419,13,1.6,61.06,5.5,0,0,0,0,0,0,0.0674502982262971,26.3100305742185,8.27070130354145
9.7,"greedy_SVM","SVM",69,17,984,975,9,1800,1536,264,0.818511133266871,0.23728813559322,1.26211044286495,673,264,409,-8,1.5,64.66,5.8,0,0,0,0,0,0,0.0630451721233345,27.9353032327849,7.74431344926412
9.7,"greedy_SVM","SVM",69,18,884,880,4,1900,1631,269,0.824818876703226,0.220338983050847,1.27299070530344,716,269,447,43,1.7,68.25,6.1,0,0,0,0,0,0,0.0942250917215292,40.6993162911352,11.2166093544405
9.7,"greedy_SVM","SVM",69,19,784,781,3,2000,1730,270,0.823010967098707,0.203389830508475,1.27299070530344,723,270,453,7,1.7,71.84,6.4,0,0,0,0,0,0,0.0528141780837025,18.5155929842884,6.49141773147595
9.7,"greedy_SVM","SVM",69,20,684,682,2,2100,1829,271,0.811319375207712,0.186440677966102,1.27299070530344,720,271,449,-3,1.7,75.43,6.7,0,0,0,0,0,0,0.0373710417993847,11.668234428956,5.92085787818757
9.7,"greedy_SVM","SVM",69,21,584,583,1,2200,1928,272,0.820272515785978,0.23728813559322,1.27299070530344,743,272,471,23,1.7,79.02,7.1,0,0,0,0,0,0,0.0239032612615916,6.84937548598529,4.25223651733715
9.7,"greedy_SVM","SVM",69,22,484,483,1,2300,2028,272,0.820644732469261,0.220338983050847,1.27299070530344,738,272,466,-5,1.7,82.61,7.5,0,0,0,0,0,0,0.0203776737389904,5.82438894306737,2.94180621741193
9.7,"greedy_SVM","SVM",69,23,384,384,0,2400,2127,273,0.754742439348622,0.144067796610169,1.28387096774194,744,273,471,6,1.7,86.21,7.8,0,0,0,0,0,0,0.0822010347168443,21.5296455864072,13.3148436421689
9.7,"greedy_SVM","SVM",69,24,284,284,0,2500,2227,273,0.817102027251581,0.245762711864407,1.28387096774194,743,273,470,-1,1.7,89.8,8.2,0,0,0,0,0,0,0.0263356271070269,6.57567858532944,4.23070769613835
9.7,"greedy_SVM","SVM",69,25,184,184,0,2600,2327,273,0.810874044533069,0.26271186440678,1.28387096774194,761,273,488,18,1.8,93.39,8.5,0,0,0,0,0,0,0.00558705286377704,1.61114347449673,1.38564242473288
9.7,"greedy_SVM","SVM",69,26,84,84,0,2700,2427,273,0.743914921900965,0.11864406779661,1.28387096774194,764,273,491,3,1.8,96.98,8.9,0,0,0,0,0,0,2.90303880163886e-05,0.389984968250532,0.389984968250532
9.7,"greedy_SVM","SVM",69,27,0,0,0,2784,2511,273,0.818963110667998,0.254237288135593,1.28387096774194,746,273,473,-18,1.7,100,9.2,0,0,0,0,0,0,0,0,0
9.7,"greedy_SVM","SVM",70,0,2684,2451,233,100,89,11,0.756597984298055,0.312925170068027,1.1615975422427,30,11,19,0,1.7,3.59,8.1,0,0,0,0,0,0,0.210631559955811,276.928108231933,39.908437797539
9.7,"greedy_SVM","SVM",70,1,2584,2375,209,200,165,35,0.830357825313111,0.292517006802721,1.26640333552776,90,35,55,60,1.6,7.18,4.7,0,0,0,0,0,0,0.209038630074214,272.939851207962,25.2533009684242
9.7,"greedy_SVM","SVM",70,2,2484,2294,190,300,246,54,0.820868957534856,0.306122448979592,1.26640333552776,143,54,89,53,1.6,10.78,4.6,0,0,0,0,0,0,0.199249331957657,294.341510310717,20.2643637695684
9.7,"greedy_SVM","SVM",70,3,2384,2224,160,400,316,84,0.830537993688646,0.326530612244898,1.26640333552776,204,84,120,61,1.4,14.37,3.8,0,0,0,0,0,0,0.22582838712007,284.137151085725,22.8935674378545
9.7,"greedy_SVM","SVM",70,4,2284,2149,135,500,391,109,0.82190083095838,0.319727891156463,1.27513715163485,267,109,158,63,1.4,17.96,3.6,0,0,0,0,0,0,0.223929095867385,309.404889196743,22.6106780802776
9.7,"greedy_SVM","SVM",70,5,2184,2081,103,600,459,141,0.823533265633696,0.312925170068027,1.25766951942067,343,141,202,76,1.4,21.55,3.3,0,0,0,0,0,0,0.239142972496752,271.645325147371,24.284912157389
9.7,"greedy_SVM","SVM",70,6,2084,1997,87,700,543,157,0.820399427828914,0.306122448979592,1.26640333552776,384,157,227,41,1.4,25.14,3.5,0,0,0,0,0,0,0.20717760398021,222.750072580328,22.0867722983274
9.7,"greedy_SVM","SVM",70,7,1984,1913,71,800,627,173,0.827300422576732,0.312925170068027,1.25766951942067,422,173,249,38,1.4,28.74,3.6,0,0,0,0,0,0,0.183763647120343,209.816614952203,19.8118912040119
9.7,"greedy_SVM","SVM",70,8,1884,1827,57,900,713,187,0.837892139199184,0.340136054421769,1.26640333552776,461,187,274,39,1.5,32.33,3.8,0,0,0,0,0,0,0.178426615909098,200.11166329245,19.0000119579014
9.7,"greedy_SVM","SVM",70,9,1784,1737,47,1000,803,197,0.834747382098911,0.312925170068027,1.26640333552776,488,197,291,27,1.5,35.92,4.1,0,0,0,0,0,0,0.165271078876247,149.823869718525,18.1996313502714
9.7,"greedy_SVM","SVM",70,10,1684,1645,39,1100,895,205,0.834758301394394,0.333333333333333,1.26640333552776,516,205,311,28,1.5,39.51,4.4,0,0,0,0,0,0,0.134138293303699,127.155350956164,14.7840534097027
9.7,"greedy_SVM","SVM",70,11,1584,1554,30,1200,986,214,0.829850078072962,0.306122448979592,1.26640333552776,548,214,334,32,1.6,43.1,4.6,0,0,0,0,0,0,0.158049737069699,141.259198231133,17.1693059108764
9.7,"greedy_SVM","SVM",70,12,1484,1462,22,1300,1078,222,0.825520577412345,0.285714285714286,1.26640333552776,581,222,359,33,1.6,46.7,4.9,0,0,0,0,0,0,0.142849465727993,100.515266487291,15.3789399713663
9.7,"greedy_SVM","SVM",70,13,1384,1370,14,1400,1170,230,0.832317838853045,0.333333333333333,1.26640333552776,594,230,364,13,1.6,50.29,5.1,0,0,0,0,0,0,0.118058319778238,71.342155982375,13.8946796731661
9.7,"greedy_SVM","SVM",70,14,1284,1273,11,1500,1267,233,0.82293816402965,0.27891156462585,1.27513715163485,616,233,383,22,1.6,53.88,5.4,0,0,0,0,0,0,0.120271451151889,90.4039354264326,13.1612020692032
9.7,"greedy_SVM","SVM",70,15,1184,1176,8,1600,1364,236,0.834507157598179,0.312925170068027,1.27513715163485,629,236,393,13,1.7,57.47,5.8,0,0,0,0,0,0,0.12274007965832,92.3482932904733,13.3948747336511
9.7,"greedy_SVM","SVM",70,16,1084,1077,7,1700,1463,237,0.796644500496822,0.224489795918367,1.26640333552776,646,237,409,17,1.7,61.06,6.2,0,0,0,0,0,0,0.118489786291119,90.6590417893409,12.7380066465197
9.7,"greedy_SVM","SVM",70,17,984,977,7,1800,1563,237,0.777088042279503,0.197278911564626,1.26640333552776,650,237,413,4,1.7,64.66,6.6,0,0,0,0,0,0,0.0829910071531677,43.4372547115666,9.15216549462038
9.7,"greedy_SVM","SVM",70,18,884,880,4,1900,1660,240,0.839557331760939,0.346938775510204,1.27513715163485,665,240,425,15,1.8,68.25,6.9,0,0,0,0,0,0,0.0752948429743446,39.033834447833,8.72202752558963
9.7,"greedy_SVM","SVM",70,19,784,781,3,2000,1759,241,0.790999224730007,0.224489795918367,1.27513715163485,673,241,432,8,1.8,71.84,7.3,0,0,0,0,0,0,0.0622022188810755,27.6374863770467,7.25809039188656
9.7,"greedy_SVM","SVM",70,20,684,681,3,2100,1859,241,0.787734355379379,0.231292517006803,1.27513715163485,669,241,428,-4,1.8,75.43,7.7,0,0,0,0,0,0,0.0500603310233704,20.049069147471,5.70561357930526
9.7,"greedy_SVM","SVM",70,21,584,583,1,2200,1957,243,0.779108111944604,0.17687074829932,1.27513715163485,684,243,441,15,1.8,79.02,8.1,0,0,0,0,0,0,0.0404752347118246,13.6218547593462,5.36287303249752
9.7,"greedy_SVM","SVM",70,22,484,483,1,2300,2057,243,0.753431388606797,0.17687074829932,1.27513715163485,677,243,434,-7,1.8,82.61,8.5,0,0,0,0,0,0,0.0223692121432641,6.61646152030606,2.89023048170429
9.7,"greedy_SVM","SVM",70,23,384,384,0,2400,2156,244,0.748430351273733,0.17687074829932,1.26640333552776,682,244,438,5,1.8,86.21,8.8,0,0,0,0,0,0,0.0741822520149244,19.674398158933,11.892087799092
9.7,"greedy_SVM","SVM",70,24,284,284,0,2500,2256,244,0.777754119304223,0.224489795918367,1.26640333552776,680,244,436,-2,1.8,89.8,9.2,0,0,0,0,0,0,0.0294712468846294,7.3983514532516,4.47100038850968
9.7,"greedy_SVM","SVM",70,25,184,184,0,2600,2356,244,0.796273244450257,0.258503401360544,1.27513715163485,688,244,444,8,1.8,93.39,9.7,0,0,0,0,0,0,0.0126673234365187,2.71198122881616,2.00790142026278
9.7,"greedy_SVM","SVM",70,26,84,84,0,2700,2456,244,0.773353643222934,0.258503401360544,1.26640333552776,693,244,449,5,1.8,96.98,10.1,0,0,0,0,0,0,4.11020152076477e-07,0.346642911234141,0.346642911234141
9.7,"greedy_SVM","SVM",70,27,0,0,0,2784,2540,244,0.75390637796049,0.163265306122449,1.27513715163485,691,244,447,-2,1.8,100,10.4,0,0,0,0,0,0,0,0,0
9.7,"greedy_SVM","SVM",71,0,2684,2429,255,100,92,8,0.832466650197633,0.2890625,1.28387096774194,25,8,17,0,2.1,3.59,11.5,0,0,0,0,0,0,0.164010624339156,225.173331902042,19.5649737162104
9.7,"greedy_SVM","SVM",71,1,2584,2351,233,200,170,30,0.830088932806323,0.296875,1.28387096774194,83,30,53,58,1.8,7.18,5.7,0,0,0,0,0,0,0.176039092830471,357.723494136444,17.9366480238119
9.7,"greedy_SVM","SVM",71,2,2484,2285,199,300,236,64,0.81623023715415,0.2890625,1.28387096774194,163,64,99,80,1.5,10.78,3.7,0,0,0,0,0,0,0.246615880565216,375.403319941553,25.3881411025818
9.7,"greedy_SVM","SVM",71,3,2384,2214,170,400,307,93,0.822906373517786,0.2734375,1.28387096774194,229,93,136,66,1.5,14.37,3.3,0,0,0,0,0,0,0.250626022494772,315.510676701826,25.7152175277948
9.7,"greedy_SVM","SVM",71,4,2284,2139,145,500,382,118,0.824431818181818,0.265625,1.28387096774194,279,118,161,50,1.4,17.96,3.2,0,0,0,0,0,0,0.23796206717759,245.304157640856,24.3358182718215
9.7,"greedy_SVM","SVM",71,5,2184,2068,116,600,453,147,0.825963438735178,0.2578125,1.28387096774194,351,147,204,72,1.4,21.55,3.1,0,0,0,0,0,0,0.242226305509309,190.226792438936,24.9093744201349
9.7,"greedy_SVM","SVM",71,6,2084,1990,94,700,531,169,0.829712203557312,0.25,1.28387096774194,408,169,239,57,1.4,25.14,3.1,0,0,0,0,0,0,0.236477559507227,240.535129233062,24.4310074817127
9.7,"greedy_SVM","SVM",71,7,1984,1910,74,800,611,189,0.829570158102767,0.2578125,1.28387096774194,450,189,261,42,1.4,28.74,3.2,0,0,0,0,0,0,0.166959252729917,81.9218784159925,19.4558973848746
9.7,"greedy_SVM","SVM",71,8,1884,1828,56,900,693,207,0.819095849802372,0.2265625,1.28387096774194,508,207,301,58,1.5,32.33,3.3,0,0,0,0,0,0,0.236326306386001,239.60305358462,26.1632997078258
9.7,"greedy_SVM","SVM",71,9,1784,1734,50,1000,787,213,0.833281867588934,0.2890625,1.28387096774194,512,213,299,4,1.4,35.92,3.7,0,0,0,0,0,0,0.197635033875299,124.98075610577,22.5301689053895
9.7,"greedy_SVM","SVM",71,10,1684,1650,34,1100,871,229,0.824147727272728,0.2578125,1.28387096774194,546,229,317,34,1.4,39.51,3.8,0,0,0,0,0,0,0.170459144051028,88.5821272689308,21.0717166763838
9.7,"greedy_SVM","SVM",71,11,1584,1554,30,1200,967,233,0.824993824110672,0.2578125,1.28387096774194,579,233,346,33,1.5,43.1,4.2,0,0,0,0,0,0,0.161065871115067,115.319852478134,17.0611237646253
9.7,"greedy_SVM","SVM",71,12,1484,1460,24,1300,1061,239,0.824641798418975,0.2734375,1.28387096774194,584,239,345,5,1.4,46.7,4.4,0,0,0,0,0,0,0.132463206195915,77.823791104888,15.1046781881925
9.7,"greedy_SVM","SVM",71,13,1384,1367,17,1400,1154,246,0.824604743083006,0.25,1.28387096774194,624,246,378,40,1.5,50.29,4.7,0,0,0,0,0,0,0.124520908318707,43.7379853985584,16.422532594536
9.7,"greedy_SVM","SVM",71,14,1284,1276,8,1500,1245,255,0.818780879446641,0.1875,1.28387096774194,638,255,383,14,1.5,53.88,4.9,0,0,0,0,0,0,0.0578851609529509,18.2387932982755,9.29516884863373
9.7,"greedy_SVM","SVM",71,15,1184,1176,8,1600,1345,255,0.818391798418974,0.2109375,1.28387096774194,631,255,376,-7,1.5,57.47,5.3,0,0,0,0,0,0,0.0308066971341409,8.45710656965976,4.38738702438475
9.7,"greedy_SVM","SVM",71,16,1084,1079,5,1700,1442,258,0.82458621541502,0.2578125,1.28387096774194,661,258,403,30,1.6,61.06,5.6,0,0,0,0,0,0,0.0654933921420188,22.6315013519719,9.31490785341127
9.7,"greedy_SVM","SVM",71,17,984,981,3,1800,1540,260,0.822918725296446,0.25,1.28387096774194,678,260,418,17,1.6,64.66,5.9,0,0,0,0,0,0,0.0751112008330534,25.9419710066035,10.2432820106352
9.7,"greedy_SVM","SVM",71,18,884,881,3,1900,1640,260,0.820818922924904,0.2421875,1.28387096774194,674,260,414,-4,1.6,68.25,6.3,0,0,0,0,0,0,0.0558801952900169,19.090261951966,6.6965030305391
9.7,"greedy_SVM","SVM",71,19,784,782,2,2000,1739,261,0.804545454545458,0.21875,1.28387096774194,683,261,422,9,1.6,71.84,6.7,0,0,0,0,0,0,0.049304828598973,17.1627640668189,8.26234681063952
9.7,"greedy_SVM","SVM",71,20,684,682,2,2100,1839,261,0.796325345849804,0.1953125,1.28387096774194,692,261,431,9,1.7,75.43,7,0,0,0,0,0,0,0.0277912330923508,8.73237540915022,3.65933601643916
9.7,"greedy_SVM","SVM",71,21,584,582,2,2200,1939,261,0.770448369565219,0.15625,1.28387096774194,686,261,425,-6,1.6,79.02,7.4,0,0,0,0,0,0,0.0250064992326086,8.04054733390107,3.20164124847872
9.7,"greedy_SVM","SVM",71,22,484,482,2,2300,2039,261,0.798406620553361,0.2265625,1.28387096774194,687,261,426,1,1.6,82.61,7.8,0,0,0,0,0,0,0.0517573467940387,18.3484663404686,5.65203763521339
9.7,"greedy_SVM","SVM",71,23,384,382,2,2400,2139,261,0.766823122529646,0.1796875,1.28387096774194,695,261,434,8,1.7,86.21,8.2,0,0,0,0,0,0,0.0135158621173538,3.74833616461098,1.81458124926265
9.7,"greedy_SVM","SVM",71,24,284,284,0,2500,2237,263,0.773301630434783,0.1640625,1.27384072580645,705,263,442,10,1.7,89.8,8.5,0,0,0,0,0,0,0.00782622269586885,5.4865256791879,5.20519328848852
9.7,"greedy_SVM","SVM",71,25,184,184,0,2600,2337,263,0.790155632411067,0.2109375,1.27384072580645,708,263,445,3,1.7,93.39,8.9,0,0,0,0,0,0,0.00520612036898879,1.4341643824721,1.32631138954407
9.7,"greedy_SVM","SVM",71,26,84,84,0,2700,2437,263,0.797992835968379,0.2265625,1.27384072580645,705,263,442,-3,1.7,96.98,9.3,0,0,0,0,0,0,5.0033502382319e-13,4.79226257645871e-05,4.79226257645871e-05
9.7,"greedy_SVM","SVM",71,27,0,0,0,2784,2521,263,0.763938982213439,0.15625,1.27384072580645,706,263,443,1,1.7,100,9.6,0,0,0,0,0,0,0,0,0
9.7,"greedy_SVM","SVM",72,0,2684,2435,249,100,92,8,0.765082451128004,0.402985074626866,1.16889744824266,23,8,15,0,1.9,3.59,11.5,0,0,0,0,0,0,0.183956310791592,237.801719544191,20.7890209908655
9.7,"greedy_SVM","SVM",72,1,2584,2369,215,200,158,42,0.767414911147206,0.141791044776119,1.25397185343998,106,42,64,83,1.5,7.18,3.8,0,0,0,0,0,0,0.34370308579833,409.062266744986,42.747301479072
9.7,"greedy_SVM","SVM",72,2,2484,2282,202,300,245,55,0.808542671867037,0.223880597014925,1.274289841117,155,55,100,49,1.8,10.78,4.5,0,0,0,0,0,0,0.189836685270481,430.210242271319,19.7431482823957
9.7,"greedy_SVM","SVM",72,3,2384,2202,182,400,325,75,0.830426896494498,0.26865671641791,1.26470871449206,195,75,120,40,1.6,14.37,4.3,0,0,0,0,0,0,0.216877513702617,314.492994023099,22.2993663072347
9.7,"greedy_SVM","SVM",72,4,2284,2127,157,500,400,100,0.838019987433767,0.26865671641791,1.25512758786712,251,100,151,56,1.5,17.96,4,0,0,0,0,0,0,0.226516305426756,195.183234870527,23.6299912796528
9.7,"greedy_SVM","SVM",72,5,2184,2052,132,600,475,125,0.83145234905694,0.276119402985075,1.24554646124218,316,125,191,65,1.5,21.55,3.8,0,0,0,0,0,0,0.21771466121469,275.350045582401,22.1599950466497
9.7,"greedy_SVM","SVM",72,6,2084,1985,99,700,542,158,0.816574395694288,0.261194029850746,1.24554646124218,393,158,235,77,1.5,25.14,3.4,0,0,0,0,0,0,0.234992792246366,205.322075759042,24.1551135830528
9.7,"greedy_SVM","SVM",72,7,1984,1909,75,800,618,182,0.821867627707375,0.291044776119403,1.24554646124218,456,182,274,63,1.5,28.74,3.4,0,0,0,0,0,0,0.232572160564025,209.963392294159,23.7869612564738
9.7,"greedy_SVM","SVM",72,8,1884,1823,61,900,704,196,0.818056263559093,0.26865671641791,1.24554646124218,480,196,284,24,1.4,32.33,3.6,0,0,0,0,0,0,0.210854604618151,171.839883973142,21.8077154961287
9.7,"greedy_SVM","SVM",72,9,1784,1737,47,1000,790,210,0.804517918746224,0.276119402985075,1.23596533461724,541,210,331,61,1.6,35.92,3.8,0,0,0,0,0,0,0.190734738342222,140.681858269428,20.1451838138262
9.7,"greedy_SVM","SVM",72,10,1684,1646,38,1100,881,219,0.807920287363817,0.291044776119403,1.23596533461724,569,219,350,28,1.6,39.51,4,0,0,0,0,0,0,0.186689649303394,190.590892293554,19.5662137444877
9.7,"greedy_SVM","SVM",72,11,1584,1549,35,1200,978,222,0.799876708593646,0.26865671641791,1.24554646124218,573,222,351,4,1.6,43.1,4.4,0,0,0,0,0,0,0.152042627586858,108.489587957186,16.849056473662
9.7,"greedy_SVM","SVM",72,12,1484,1452,32,1300,1075,225,0.794731663367039,0.261194029850746,1.274289841117,597,225,372,24,1.7,46.7,4.8,0,0,0,0,0,0,0.124631972031927,47.8278388612228,15.4336604807357
9.7,"greedy_SVM","SVM",72,13,1384,1357,27,1400,1170,230,0.801595675316822,0.291044776119403,1.20722195474242,626,230,396,29,1.7,50.29,5.1,0,0,0,0,0,0,0.156611676303284,132.551484790887,16.5071748889242
9.7,"greedy_SVM","SVM",72,14,1284,1258,26,1500,1269,231,0.775734117340223,0.23134328358209,1.25512758786712,637,231,406,11,1.8,53.88,5.5,0,0,0,0,0,0,0.116513313397866,46.4769928003716,13.8009209553478
9.7,"greedy_SVM","SVM",72,15,1184,1158,26,1600,1369,231,0.80527070762154,0.283582089552239,1.26470871449206,624,231,393,-13,1.7,57.47,5.9,0,0,0,0,0,0,0.101725309950175,46.7134494880478,11.2325413835938
9.7,"greedy_SVM","SVM",72,16,1084,1062,22,1700,1465,235,0.775787464583362,0.194029850746269,1.26470871449206,655,235,420,31,1.8,61.06,6.2,0,0,0,0,0,0,0.11914669523592,56.0983624523728,15.0226254383744
9.7,"greedy_SVM","SVM",72,17,984,970,14,1800,1557,243,0.806432492027555,0.253731343283582,1.274289841117,662,243,419,7,1.7,64.66,6.4,0,0,0,0,0,0,0.0863578286668956,33.6761037499187,11.6684132954006
9.7,"greedy_SVM","SVM",72,18,884,878,6,1900,1649,251,0.74405178239067,0.201492537313433,1.274289841117,715,251,464,53,1.8,68.25,6.6,0,0,0,0,0,0,0.131603400533605,58.2602232425402,15.6961153780538
9.7,"greedy_SVM","SVM",72,19,784,780,4,2000,1747,253,0.756339430725643,0.201492537313433,1.274289841117,729,253,476,14,1.9,71.84,6.9,0,0,0,0,0,0,0.120412057158785,56.8000032454897,12.9986765975646
9.7,"greedy_SVM","SVM",72,20,684,683,1,2100,1844,256,0.742824795798611,0.194029850746269,1.274289841117,730,256,474,1,1.9,75.43,7.2,0,0,0,0,0,0,0.109016278204381,51.8002126490925,11.7224984769299
9.7,"greedy_SVM","SVM",72,21,584,583,1,2200,1944,256,0.757181131672853,0.201492537313433,1.274289841117,741,256,485,11,1.9,79.02,7.6,0,0,0,0,0,0,0.0432651954540867,12.2892474544296,6.4179707847702
9.7,"greedy_SVM","SVM",72,22,484,483,1,2300,2044,256,0.803759202399443,0.201492537313433,1.28387096774194,728,256,472,-13,1.8,82.61,8,0,0,0,0,0,0,0.0538793055569836,16.6399517511133,6.53402166603321
9.7,"greedy_SVM","SVM",72,23,384,384,0,2400,2143,257,0.716163029175016,0.134328358208955,1.274289841117,718,257,461,-10,1.8,86.21,8.3,0,0,0,0,0,0,0.0401399950809563,11.5224935937266,7.18591723343992
9.7,"greedy_SVM","SVM",72,24,284,284,0,2500,2243,257,0.785212144203529,0.201492537313433,1.28387096774194,736,257,479,18,1.9,89.8,8.7,0,0,0,0,0,0,0.00264742143051023,0.672095319342884,0.668862385441247
9.7,"greedy_SVM","SVM",72,25,184,184,0,2600,2343,257,0.793801050347946,0.223880597014925,1.28387096774194,739,257,482,3,1.9,93.39,9.1,0,0,0,0,0,0,5.7773337784643e-06,0.309796254809359,0.30971515943398
9.7,"greedy_SVM","SVM",72,26,84,84,0,2700,2443,257,0.753672068568992,0.17910447761194,1.274289841117,735,257,478,-4,1.9,96.98,9.5,0,0,0,0,0,0,2.11566753136289e-08,0.000192239655549602,0.000192239655549602
9.7,"greedy_SVM","SVM",72,27,0,0,0,2784,2527,257,0.764003651322422,0.17910447761194,1.274289841117,724,257,467,-11,1.8,100,9.8,0,0,0,0,0,0,0,0,0
9.7,"greedy_SVM","SVM",73,0,2684,2422,262,100,94,6,0.777895141156136,0.268292682926829,1.16905323891949,17,6,11,0,1.8,3.59,15.7,0,0,0,0,0,0,0.100766834096552,132.63394313404,23.6452244156541
9.7,"greedy_SVM","SVM",73,1,2584,2342,242,200,174,26,0.830241341783497,0.341463414634146,1.28387096774194,71,26,45,54,1.7,7.18,6.7,0,0,0,0,0,0,0.161667913442801,215.182554440792,16.6829265731612
9.7,"greedy_SVM","SVM",73,2,2484,2273,211,300,243,57,0.819499391844322,0.268292682926829,1.27343299239444,146,57,89,75,1.6,10.78,4.3,0,0,0,0,0,0,0.217682603530701,187.324367616036,22.992677654814
9.7,"greedy_SVM","SVM",73,3,2384,2188,196,400,328,72,0.817937391972342,0.260162601626016,1.24211906635195,192,72,120,46,1.7,14.37,4.6,0,0,0,0,0,0,0.188900352384849,198.162074624761,19.8185464450245
9.7,"greedy_SVM","SVM",73,4,2284,2113,171,500,403,97,0.826694833877477,0.252032520325203,1.26299501704694,248,97,151,56,1.6,17.96,4.2,0,0,0,0,0,0,0.199539037761177,132.157283066264,21.1430204463879
9.7,"greedy_SVM","SVM",73,5,2184,2048,136,600,468,132,0.80697778631331,0.365853658536585,1.25255704169945,323,132,191,75,1.4,21.55,3.5,0,0,0,0,0,0,0.224893104680266,257.733138041591,24.5269626310361
9.7,"greedy_SVM","SVM",73,6,2084,1977,107,700,539,161,0.778861788617885,0.211382113821138,1.24211906635195,376,161,215,53,1.3,25.14,3.3,0,0,0,0,0,0,0.308176693496418,215.857392169262,57.8413180538509
9.7,"greedy_SVM","SVM",73,7,1984,1890,94,800,626,174,0.734415210293846,0.195121951219512,1.21080514030947,417,174,243,41,1.4,28.74,3.6,0,0,0,0,0,0,0.230838707949557,254.568925404833,24.1121305019247
9.7,"greedy_SVM","SVM",73,8,1884,1791,93,900,725,175,0.830734267972608,0.292682926829268,1.26299501704694,422,175,247,5,1.4,32.33,4.1,0,0,0,0,0,0,0.183778513387744,116.628175015872,20.3359164943919
9.7,"greedy_SVM","SVM",73,9,1784,1718,66,1000,798,202,0.842410857179446,0.333333333333333,1.25255704169945,477,202,275,55,1.4,35.92,4,0,0,0,0,0,0,0.152363483473885,60.1638612774975,18.8298371308021
9.7,"greedy_SVM","SVM",73,10,1684,1636,48,1100,880,220,0.828071186223674,0.268292682926829,1.26299501704694,537,220,317,60,1.4,39.51,4,0,0,0,0,0,0,0.189210853999106,106.687002554706,21.1031440402362
9.7,"greedy_SVM","SVM",73,11,1584,1545,39,1200,971,229,0.820920555662256,0.268292682926829,1.26299501704694,563,229,334,26,1.5,43.1,4.2,0,0,0,0,0,0,0.182456261141751,83.6980080341568,20.0648915619059
9.7,"greedy_SVM","SVM",73,12,1484,1448,36,1300,1068,232,0.806196786377317,0.227642276422764,1.26299501704694,579,232,347,16,1.5,46.7,4.6,0,0,0,0,0,0,0.122255433835805,52.4648593409149,14.7035794700059
9.7,"greedy_SVM","SVM",73,13,1384,1355,29,1400,1161,239,0.804173868510354,0.252032520325203,1.27343299239444,601,239,362,22,1.5,50.29,4.9,0,0,0,0,0,0,0.155729555567362,77.692941741961,17.3750787650807
9.7,"greedy_SVM","SVM",73,14,1284,1265,19,1500,1251,249,0.7968503937008,0.235772357723577,1.27343299239444,644,249,395,43,1.6,53.88,5,0,0,0,0,0,0,0.163505343699137,73.6867444393022,17.6254938180704
9.7,"greedy_SVM","SVM",73,15,1184,1171,13,1600,1345,255,0.813923564432511,0.24390243902439,1.27343299239444,677,255,422,33,1.7,57.47,5.3,0,0,0,0,0,0,0.142852851931288,58.095575932534,16.0335036654957
9.7,"greedy_SVM","SVM",73,16,1084,1071,13,1700,1445,255,0.792567697330532,0.195121951219512,1.27343299239444,670,255,415,-7,1.6,61.06,5.7,0,0,0,0,0,0,0.0779524575907419,22.0061330899521,9.66283399766013
9.7,"greedy_SVM","SVM",73,17,984,971,13,1800,1545,255,0.801376352346216,0.260162601626016,1.27343299239444,665,255,410,-5,1.6,64.66,6.1,0,0,0,0,0,0,0.0618932978231903,21.7997404917961,7.76283529926263
9.7,"greedy_SVM","SVM",73,18,884,872,12,1900,1644,256,0.791639459701695,0.276422764227642,1.22124311565696,682,256,426,17,1.7,68.25,6.4,0,0,0,0,0,0,0.110338059865704,30.9679258062255,13.7523487599151
9.7,"greedy_SVM","SVM",73,19,784,773,11,2000,1743,257,0.771461494142515,0.211382113821138,1.25255704169945,686,257,429,4,1.7,71.84,6.8,0,0,0,0,0,0,0.0557587577752944,15.4605717519422,8.41322858281289
9.7,"greedy_SVM","SVM",73,20,684,673,11,2100,1843,257,0.794283336534169,0.227642276422764,1.25255704169945,668,257,411,-18,1.6,75.43,7.2,0,0,0,0,0,0,0.0309638786675742,9.11113495076079,4.47739226939856
9.7,"greedy_SVM","SVM",73,21,584,574,10,2200,1942,258,0.773087510402679,0.24390243902439,1.25255704169945,686,258,428,18,1.7,79.02,7.5,0,0,0,0,0,0,0.0079246692131594,2.23918393201301,1.36224066470446
9.7,"greedy_SVM","SVM",73,22,484,479,5,2300,2037,263,0.730977530247741,0.138211382113821,1.28387096774194,712,263,449,26,1.7,82.61,7.7,0,0,0,0,0,0,0.118426837299493,36.4853476072697,16.2291736208772
9.7,"greedy_SVM","SVM",73,23,384,380,4,2400,2136,264,0.751206708917484,0.211382113821138,1.27343299239444,723,264,459,11,1.7,86.21,8.1,0,0,0,0,0,0,0.0598755666227515,15.4341139657994,8.3013647659055
9.7,"greedy_SVM","SVM",73,24,284,282,2,2500,2234,266,0.793924844760259,0.227642276422764,1.28387096774194,735,266,469,12,1.8,89.8,8.4,0,0,0,0,0,0,0.0463097629876563,11.9101696701701,8.07228804045637
9.7,"greedy_SVM","SVM",73,25,184,182,2,2600,2334,266,0.779405927917548,0.170731707317073,1.27343299239444,728,266,462,-7,1.7,93.39,8.8,0,0,0,0,0,0,0.0100559377859769,2.63086364924277,2.2796790176429
9.7,"greedy_SVM","SVM",73,26,84,84,0,2700,2432,268,0.754919659432817,0.178861788617886,1.27343299239444,739,268,471,11,1.8,96.98,9.1,0,0,0,0,0,0,4.30541477607176e-11,1.45627523347944,1.45627523347944
9.7,"greedy_SVM","SVM",73,27,0,0,0,2784,2516,268,0.786153255233344,0.219512195121951,1.27343299239444,755,268,487,16,1.8,100,9.4,0,0,0,0,0,0,0,0,0
9.7,"greedy_SVM","SVM",74,0,2684,2436,248,100,90,10,0.760651629072687,0.330827067669173,1.22595197671598,32,10,22,0,2.2,3.59,9,0,0,0,0,0,0,0.116712668439825,276.505814757635,12.2512360675907
9.7,"greedy_SVM","SVM",74,1,2584,2366,218,200,160,40,0.742499104905127,0.315789473684211,1.19699248120301,103,40,63,71,1.6,7.18,4,0,0,0,0,0,0,0.211775968716626,489.604037343988,21.8519579831343
9.7,"greedy_SVM","SVM",74,2,2484,2290,194,300,236,64,0.715670127700205,0.18796992481203,1.14872665534805,161,64,97,58,1.5,10.78,3.7,0,0,0,0,0,0,0.222177790076809,465.180977471644,22.8818799941845
9.7,"greedy_SVM","SVM",74,3,2384,2198,186,400,328,72,0.724656880295986,0.225563909774436,1.16803298569003,190,72,118,29,1.6,14.37,4.6,0,0,0,0,0,0,0.189916872561598,354.152098716385,20.0468987112713
9.7,"greedy_SVM","SVM",74,4,2284,2113,171,500,413,87,0.764249910490514,0.330827067669173,1.18733931603202,225,87,138,35,1.6,17.96,4.7,0,0,0,0,0,0,0.177800756174611,270.482227839755,18.2308563603222
9.7,"greedy_SVM","SVM",74,5,2184,2045,139,600,481,119,0.772508652583846,0.323308270676692,1.206645646374,301,119,182,76,1.5,21.55,4,0,0,0,0,0,0,0.199021449316483,259.754468001363,20.3792091677488
9.7,"greedy_SVM","SVM",74,6,2084,1980,104,700,546,154,0.785224967179865,0.330827067669173,1.22595197671598,383,154,229,82,1.5,25.14,3.5,0,0,0,0,0,0,0.222111512499957,305.35259446728,22.7353311727466
9.7,"greedy_SVM","SVM",74,7,1984,1901,83,800,625,175,0.778559493973033,0.285714285714286,1.24525830705797,426,175,251,43,1.4,28.74,3.6,0,0,0,0,0,0,0.216051904157803,258.946840557827,22.2463406031917
9.7,"greedy_SVM","SVM",74,8,1884,1810,74,900,716,184,0.778135815729804,0.293233082706767,1.23560514188698,453,184,269,27,1.5,32.33,3.9,0,0,0,0,0,0,0.184365721174491,193.095619123313,19.6702350982865
9.7,"greedy_SVM","SVM",74,9,1784,1719,65,1000,807,193,0.795984007638146,0.300751879699248,1.24525830705797,485,193,292,32,1.5,35.92,4.2,0,0,0,0,0,0,0.171275600769813,171.822759686137,18.295594462814
9.7,"greedy_SVM","SVM",74,10,1684,1625,59,1100,901,199,0.80084138918726,0.315789473684211,1.22595197671598,500,199,301,15,1.5,39.51,4.5,0,0,0,0,0,0,0.151812691074051,136.218613423583,15.9446723944812
9.7,"greedy_SVM","SVM",74,11,1584,1534,50,1200,992,208,0.800393841747225,0.300751879699248,1.18733931603202,529,208,321,29,1.5,43.1,4.8,0,0,0,0,0,0,0.161953699678974,192.421505455378,16.674281667592
9.7,"greedy_SVM","SVM",74,12,1484,1444,40,1300,1082,218,0.787170306719181,0.270676691729323,1.19699248120301,571,218,353,42,1.6,46.7,5,0,0,0,0,0,0,0.136498058862429,108.660471694462,14.5444118963368
9.7,"greedy_SVM","SVM",74,13,1384,1349,35,1400,1177,223,0.781895214226043,0.24812030075188,1.18733931603202,596,223,373,25,1.7,50.29,5.3,0,0,0,0,0,0,0.158551078433102,214.846532332488,15.8758834693754
9.7,"greedy_SVM","SVM",74,14,1284,1252,32,1500,1274,226,0.793990929705216,0.263157894736842,1.23560514188698,617,226,391,21,1.7,53.88,5.6,0,0,0,0,0,0,0.138636667323861,135.554983531828,14.2408200161742
9.7,"greedy_SVM","SVM",74,15,1184,1156,28,1600,1370,230,0.80986991287743,0.308270676691729,1.24525830705797,637,230,407,20,1.8,57.47,6,0,0,0,0,0,0,0.133460796488064,127.891954945133,13.7725586853236
9.7,"greedy_SVM","SVM",74,16,1084,1065,19,1700,1461,239,0.805776345625968,0.263157894736842,1.24525830705797,648,239,409,11,1.7,61.06,6.1,0,0,0,0,0,0,0.0971208534127043,57.1178593898609,10.5349211303175
9.7,"greedy_SVM","SVM",74,17,984,966,18,1800,1560,240,0.818188327962763,0.285714285714286,1.24525830705797,655,240,415,7,1.7,64.66,6.5,0,0,0,0,0,0,0.0644266175217486,29.2598441179234,7.2090229975256
9.7,"greedy_SVM","SVM",74,18,884,867,17,1900,1659,241,0.813384652106456,0.278195488721804,1.24525830705797,652,241,411,-3,1.7,68.25,6.9,0,0,0,0,0,0,0.0331446819991424,11.7622329418323,4.28040246894527
9.7,"greedy_SVM","SVM",74,19,784,767,17,2000,1759,241,0.819411624298842,0.323308270676692,1.24525830705797,640,241,399,-12,1.7,71.84,7.3,0,0,0,0,0,0,0.0354992952994146,12.5579355497613,4.36049521440968
9.7,"greedy_SVM","SVM",74,20,684,669,15,2100,1857,243,0.826876715598522,0.315789473684211,1.24525830705797,653,243,410,13,1.7,75.43,7.6,0,0,0,0,0,0,0.0333434559265294,11.4381177423323,4.49967208717035
9.7,"greedy_SVM","SVM",74,21,584,569,15,2200,1957,243,0.820945220193343,0.300751879699248,1.24525830705797,663,243,420,10,1.7,79.02,8.1,0,0,0,0,0,0,0.0167389693003483,4.72861797385072,2.25111098666659
9.7,"greedy_SVM","SVM",74,22,484,469,15,2300,2057,243,0.835398018856667,0.345864661654135,1.24525830705797,638,243,395,-25,1.6,82.61,8.5,0,0,0,0,0,0,0.00810802967748122,2.19879364636551,1.20407923778185
9.7,"greedy_SVM","SVM",74,23,384,372,12,2400,2154,246,0.798734932569527,0.240601503759398,1.24525830705797,665,246,419,27,1.7,86.21,8.8,0,0,0,0,0,0,0.00875644624521554,2.62258877254028,1.7724922473455
9.7,"greedy_SVM","SVM",74,24,284,272,12,2500,2254,246,0.799719536937586,0.270676691729323,1.24525830705797,669,246,423,4,1.7,89.8,9.2,0,0,0,0,0,0,0.00654206230892822,1.64224078648395,1.06871275881918
9.7,"greedy_SVM","SVM",74,25,184,174,10,2600,2352,248,0.822419143095842,0.300751879699248,1.24525830705797,689,248,441,20,1.8,93.39,9.5,0,0,0,0,0,0,0.00228491686823083,1.37844033697673,1.32273500326277
9.7,"greedy_SVM","SVM",74,26,84,83,1,2700,2443,257,0.805340732784342,0.278195488721804,1.27421780257094,735,257,478,46,1.9,96.98,9.5,0,0,0,0,0,0,7.82631140876611e-06,0.204013761022936,0.204013761022936
9.7,"greedy_SVM","SVM",74,27,0,0,0,2784,2526,258,0.792284282133912,0.24812030075188,1.27421780257094,729,258,471,-6,1.8,100,9.8,0,0,0,0,0,0,0,0,0
9.7,"greedy_SVM","SVM",75,0,2684,2447,237,100,84,16,0.798775910849364,0.326086956521739,1.20014025245442,36,16,20,0,1.2,3.59,5.2,0,0,0,0,0,0,0.38505500568569,426.791505983714,40.9887309005556
9.7,"greedy_SVM","SVM",75,1,2584,2381,203,200,150,50,0.733362203360477,0.159420289855072,1.25364985400584,115,50,65,79,1.3,7.18,3,0,0,0,0,0,0,0.403807643372707,605.491818025257,45.0504334531931
9.7,"greedy_SVM","SVM",75,2,2484,2301,183,300,230,70,0.715289566372193,0.0942028985507246,1.27456755493221,172,70,102,57,1.5,10.78,3.3,0,0,0,0,0,0,0.295905585152535,514.936118788813,33.13145524639
9.7,"greedy_SVM","SVM",75,3,2384,2214,170,400,317,83,0.72732259368324,0.22463768115942,1.20944366526414,200,83,117,28,1.4,14.37,3.8,0,0,0,0,0,0,0.241824511372295,358.186619388899,29.1640804657931
9.7,"greedy_SVM","SVM",75,4,2284,2124,160,500,407,93,0.807234828800741,0.289855072463768,1.26526414212249,220,93,127,20,1.4,17.96,4.4,0,0,0,0,0,0,0.204475142528724,223.774107253482,21.1495356776615
9.7,"greedy_SVM","SVM",75,5,2184,2058,126,600,473,127,0.804931000635142,0.27536231884058,1.25596072931276,302,127,175,82,1.4,21.55,3.7,0,0,0,0,0,0,0.220833969060163,230.878907341101,22.7062996604262
9.7,"greedy_SVM","SVM",75,6,2084,1987,97,700,544,156,0.806992320572783,0.297101449275362,1.24665731650304,366,156,210,64,1.3,25.14,3.5,0,0,0,0,0,0,0.226019850610962,216.543212894799,23.5262707094217
9.7,"greedy_SVM","SVM",75,7,1984,1913,71,800,618,182,0.806565044171145,0.282608695652174,1.23735390369331,426,182,244,60,1.3,28.74,3.4,0,0,0,0,0,0,0.217566593455503,187.012504402529,22.7242719996896
9.7,"greedy_SVM","SVM",75,8,1884,1831,53,900,700,200,0.808343437842834,0.297101449275362,1.23735390369331,481,200,281,55,1.4,32.33,3.5,0,0,0,0,0,0,0.205070777603055,140.127035751497,21.9688991585267
9.7,"greedy_SVM","SVM",75,9,1784,1742,42,1000,789,211,0.810439401813037,0.289855072463768,1.22805049088359,518,211,307,37,1.5,35.92,3.7,0,0,0,0,0,0,0.175866272244222,110.458231647085,19.2846380666447
9.7,"greedy_SVM","SVM",75,10,1684,1649,35,1100,882,218,0.81112073445349,0.311594202898551,1.21874707807387,540,218,322,22,1.5,39.51,4,0,0,0,0,0,0,0.162589104576391,121.037195854911,17.3848048813426
9.7,"greedy_SVM","SVM",75,11,1584,1560,24,1200,971,229,0.786991165771699,0.27536231884058,1.20014025245442,594,229,365,54,1.6,43.1,4.2,0,0,0,0,0,0,0.189210782369743,141.931435224202,20.1077268969643
9.7,"greedy_SVM","SVM",75,12,1484,1464,20,1300,1067,233,0.802898550724641,0.282608695652174,1.20014025245442,590,233,357,-4,1.5,46.7,4.6,0,0,0,0,0,0,0.161998325661151,108.106540753596,16.969180573427
9.7,"greedy_SVM","SVM",75,13,1384,1367,17,1400,1164,236,0.780668629828513,0.239130434782609,1.20944366526414,601,236,365,11,1.5,50.29,4.9,0,0,0,0,0,0,0.161251696125697,85.1683813860888,17.6300558964555
9.7,"greedy_SVM","SVM",75,14,1284,1268,16,1500,1263,237,0.789624112246668,0.253623188405797,1.20944366526414,618,237,381,17,1.6,53.88,5.3,0,0,0,0,0,0,0.138900343174535,66.0224610835896,15.0009722446558
9.7,"greedy_SVM","SVM",75,15,1184,1169,15,1600,1362,238,0.788394249090595,0.239130434782609,1.21874707807387,610,238,372,-8,1.6,57.47,5.7,0,0,0,0,0,0,0.108903564783778,38.6015602518638,12.376711036432
9.7,"greedy_SVM","SVM",75,16,1084,1069,15,1700,1462,238,0.797805877937528,0.268115942028986,1.20944366526414,635,238,397,25,1.7,61.06,6.1,0,0,0,0,0,0,0.0771271276736824,23.6710627829217,9.14301425169823
9.7,"greedy_SVM","SVM",75,17,984,969,15,1800,1562,238,0.7996015936255,0.282608695652174,1.21874707807387,613,238,375,-22,1.6,64.66,6.6,0,0,0,0,0,0,0.0230443014982695,5.94624393129679,4.54667888660789
9.7,"greedy_SVM","SVM",75,18,884,869,15,1900,1662,238,0.77491194641723,0.22463768115942,1.21874707807387,625,238,387,12,1.6,68.25,7,0,0,0,0,0,0,0.0165551483503083,4.05407364601204,2.78223661389455
9.7,"greedy_SVM","SVM",75,19,784,769,15,2000,1762,238,0.794127836480167,0.282608695652174,1.21874707807387,612,238,374,-13,1.6,71.84,7.4,0,0,0,0,0,0,0.000694198849704046,0.404785837483304,0.353994791769074
9.7,"greedy_SVM","SVM",75,20,684,674,10,2100,1857,243,0.783723078699691,0.22463768115942,1.24665731650304,636,243,393,24,1.6,75.43,7.6,0,0,0,0,0,0,0.0127264963887327,6.36355175586628,4.9513073756263
9.7,"greedy_SVM","SVM",75,21,584,578,6,2200,1953,247,0.779138518390206,0.210144927536232,1.23735390369331,658,247,411,22,1.7,79.02,7.9,0,0,0,0,0,0,0.0810420051963336,22.8904698447682,11.7946316167901
9.7,"greedy_SVM","SVM",75,22,484,478,6,2300,2053,247,0.811957965240486,0.326086956521739,1.23735390369331,657,247,410,-1,1.7,82.61,8.3,0,0,0,0,0,0,0.061312193122809,19.2699774062533,7.44694547741859
9.7,"greedy_SVM","SVM",75,23,384,378,6,2400,2153,247,0.809567526993475,0.289855072463768,1.25596072931276,649,247,402,-8,1.6,86.21,8.7,0,0,0,0,0,0,0.0387277240326786,10.3527322986473,5.05885485408007
9.7,"greedy_SVM","SVM",75,24,284,282,2,2500,2249,251,0.799948033951152,0.268115942028986,1.28387096774194,681,251,430,32,1.7,89.8,9,0,0,0,0,0,0,0.0487443201778898,12.7982548377038,9.37113121324653
9.7,"greedy_SVM","SVM",75,25,184,182,2,2600,2349,251,0.797615335758415,0.27536231884058,1.27456755493221,692,251,441,11,1.8,93.39,9.4,0,0,0,0,0,0,0.0242502886254891,5.55621159802606,4.30498224934507
9.7,"greedy_SVM","SVM",75,26,84,84,0,2700,2447,253,0.817010219989608,0.311594202898551,1.27456755493221,680,253,427,-12,1.7,96.98,9.7,0,0,0,0,0,0,0.000189388912768216,2.91356642148359,2.91356642148359
9.7,"greedy_SVM","SVM",75,27,0,0,0,2784,2531,253,0.807558173104684,0.202898550724638,1.28387096774194,688,253,435,8,1.7,100,10,0,0,0,0,0,0,0,0,0
9.7,"greedy_SVM","SVM",76,0,2684,2429,255,100,89,11,0.828050473186118,0.336,1.24278709677419,26,11,15,0,1.4,3.59,8.1,0,0,0,0,0,0,0.266906762598003,267.228984115867,30.2130044306382
9.7,"greedy_SVM","SVM",76,1,2584,2360,224,200,158,42,0.755230283911676,0.128,1.24278709677419,99,42,57,73,1.4,7.18,3.8,0,0,0,0,0,0,0.283834826736895,390.202686667159,36.7583103494417
9.7,"greedy_SVM","SVM",76,2,2484,2269,215,300,249,51,0.815179810725551,0.296,1.26332903225806,124,51,73,25,1.4,10.78,4.9,0,0,0,0,0,0,0.206118392906868,258.024353752719,21.7559261591069
9.7,"greedy_SVM","SVM",76,3,2384,2202,182,400,316,84,0.816000000000004,0.288,1.25305806451613,201,84,117,77,1.4,14.37,3.8,0,0,0,0,0,0,0.2329541221394,252.699671244963,24.0099861804507
9.7,"greedy_SVM","SVM",76,4,2284,2124,160,500,394,106,0.816201892744481,0.296,1.23251612903226,245,106,139,44,1.3,17.96,3.7,0,0,0,0,0,0,0.22709310499525,165.247771138381,23.7164580649626
9.7,"greedy_SVM","SVM",76,5,2184,2054,130,600,464,136,0.812605678233439,0.304,1.23251612903226,321,136,185,76,1.4,21.55,3.4,0,0,0,0,0,0,0.237395867096647,165.519318040191,24.569795166658
9.7,"greedy_SVM","SVM",76,6,2084,1977,107,700,541,159,0.810548895899054,0.32,1.23251612903226,373,159,214,52,1.3,25.14,3.4,0,0,0,0,0,0,0.224102754621646,158.911853522501,23.5713520561251
9.7,"greedy_SVM","SVM",76,7,1984,1897,87,800,621,179,0.815564668769719,0.344,1.23251612903226,427,179,248,54,1.4,28.74,3.5,0,0,0,0,0,0,0.202511213237278,130.829425355863,22.1858620020421
9.7,"greedy_SVM","SVM",76,8,1884,1816,68,900,702,198,0.814056782334392,0.32,1.23251612903226,477,198,279,50,1.4,32.33,3.5,0,0,0,0,0,0,0.19492671043833,132.64222296665,20.7940779450144
9.7,"greedy_SVM","SVM",76,9,1784,1725,59,1000,793,207,0.812511041009472,0.248,1.23251612903226,504,207,297,27,1.4,35.92,3.8,0,0,0,0,0,0,0.180550834277984,103.100985445912,19.8088864851029
9.7,"greedy_SVM","SVM",76,10,1684,1635,49,1100,883,217,0.813236593059942,0.28,1.24278709677419,529,217,312,25,1.4,39.51,4.1,0,0,0,0,0,0,0.168007075150196,91.1758980121414,18.1376458274836
9.7,"greedy_SVM","SVM",76,11,1584,1545,39,1200,973,227,0.816290220820197,0.28,1.23251612903226,569,227,342,40,1.5,43.1,4.3,0,0,0,0,0,0,0.174534516510611,103.555668489253,18.5847490018668
9.7,"greedy_SVM","SVM",76,12,1484,1454,30,1300,1064,236,0.804801261829659,0.264,1.22224516129032,597,236,361,28,1.5,46.7,4.5,0,0,0,0,0,0,0.168092887765134,114.819954812276,17.9664091084004
9.7,"greedy_SVM","SVM",76,13,1384,1358,26,1400,1160,240,0.781829652996857,0.232,1.21197419354839,620,240,380,23,1.6,50.29,4.8,0,0,0,0,0,0,0.154638020439863,88.5720023834634,16.5514627648111
9.7,"greedy_SVM","SVM",76,14,1284,1259,25,1500,1259,241,0.777678233438495,0.232,1.21197419354839,619,241,378,-1,1.6,53.88,5.2,0,0,0,0,0,0,0.147374002114989,83.8699138636356,15.6820774623732
9.7,"greedy_SVM","SVM",76,15,1184,1161,23,1600,1357,243,0.753211356466883,0.208,1.21197419354839,630,243,387,11,1.6,57.47,5.6,0,0,0,0,0,0,0.14057482532808,78.6947552910373,14.9191892703636
9.7,"greedy_SVM","SVM",76,16,1084,1061,23,1700,1457,243,0.775943217665623,0.216,1.21197419354839,627,243,384,-3,1.6,61.06,6,0,0,0,0,0,0,0.105553751431784,31.9355691242394,11.4336854566144
9.7,"greedy_SVM","SVM",76,17,984,961,23,1800,1557,243,0.754965299684547,0.168,1.21197419354839,638,243,395,11,1.6,64.66,6.4,0,0,0,0,0,0,0.0962652021461249,31.186648392033,10.6636162350751
9.7,"greedy_SVM","SVM",76,18,884,862,22,1900,1656,244,0.741697160883285,0.184,1.21197419354839,645,244,401,7,1.6,68.25,6.8,0,0,0,0,0,0,0.0189470722252343,4.44442107598415,3.51595728390053
9.7,"greedy_SVM","SVM",76,19,784,763,21,2000,1755,245,0.77449211356467,0.2,1.21197419354839,651,245,406,6,1.7,71.84,7.2,0,0,0,0,0,0,0.00488677657317911,3.00113451926697,2.86080764794447
9.7,"greedy_SVM","SVM",76,20,684,674,10,2100,1844,256,0.777533123028396,0.2,1.23251612903226,674,256,418,23,1.6,75.43,7.2,0,0,0,0,0,0,0.0122174210729246,4.763164213064,3.19542396244292
9.7,"greedy_SVM","SVM",76,21,584,581,3,2200,1937,263,0.704182965299687,0.104,1.26332903225806,700,263,437,26,1.7,79.02,7.4,0,0,0,0,0,0,0.202922662585012,69.404122984616,35.2542177779182
9.7,"greedy_SVM","SVM",76,22,484,481,3,2300,2037,263,0.772145110410102,0.168,1.25305806451613,697,263,434,-3,1.7,82.61,7.7,0,0,0,0,0,0,0.0447857759754634,13.0397312789812,6.6679778764535
9.7,"greedy_SVM","SVM",76,23,384,383,1,2400,2135,265,0.776252365930609,0.192,1.25305806451613,716,265,451,19,1.7,86.21,8.1,0,0,0,0,0,0,0.0254690605803851,6.39199500436097,4.44497072905398
9.7,"greedy_SVM","SVM",76,24,284,284,0,2500,2234,266,0.761476340694012,0.16,1.24278709677419,720,266,454,4,1.7,89.8,8.4,0,0,0,0,0,0,0.0136281786525118,3.56222902761041,3.10836871297051
9.7,"greedy_SVM","SVM",76,25,184,184,0,2600,2334,266,0.765041009463728,0.2,1.24278709677419,731,266,465,11,1.7,93.39,8.8,0,0,0,0,0,0,8.59490954908403e-06,0.61259440201098,0.612406838701663
9.7,"greedy_SVM","SVM",76,26,84,84,0,2700,2434,266,0.783362776025245,0.184,1.25305806451613,713,266,447,-18,1.7,96.98,9.2,0,0,0,0,0,0,1.81035447043663e-10,0.130265451660282,0.130265451660282
9.7,"greedy_SVM","SVM",76,27,0,0,0,2784,2518,266,0.757179810725559,0.176,1.25305806451613,723,266,457,10,1.7,100,9.5,0,0,0,0,0,0,0,0,0
9.7,"greedy_SVM","SVM",77,0,2684,2424,260,100,92,8,0.799334229562776,0.276422764227642,1.25255704169945,23,8,15,0,1.9,3.59,11.5,0,0,0,0,0,0,0.148833112605967,189.436924653875,18.1917845060971
9.7,"greedy_SVM","SVM",77,1,2584,2346,238,200,170,30,0.652557454708408,0.138211382113821,1.137739312877,86,30,56,63,1.9,7.18,5.7,0,0,0,0,0,0,0.240778492617124,366.756111863414,53.5393281691944
9.7,"greedy_SVM","SVM",77,2,2484,2262,222,300,254,46,0.747052045323609,0.203252032520325,1.21080514030947,126,46,80,40,1.7,10.78,5.5,0,0,0,0,0,0,0.171703828588633,314.54047751715,19.7212518041401
9.7,"greedy_SVM","SVM",77,3,2384,2188,196,400,328,72,0.628743358299726,0.0975609756097561,1.17949121426698,183,72,111,57,1.5,14.37,4.6,0,0,0,0,0,0,0.211730230365599,356.333749586889,25.2297837792076
9.7,"greedy_SVM","SVM",77,4,2284,2094,190,500,422,78,0.764855002880744,0.211382113821138,1.24211906635195,199,78,121,16,1.6,17.96,5.4,0,0,0,0,0,0,0.181287663652663,190.112166416575,19.6800169045831
9.7,"greedy_SVM","SVM",77,5,2184,2012,172,600,504,96,0.777895141156149,0.227642276422764,1.25255704169945,245,96,149,46,1.6,21.55,5.2,0,0,0,0,0,0,0.164658863886301,134.26225308098,18.4055440691692
9.7,"greedy_SVM","SVM",77,6,2084,1946,138,700,570,130,0.795365213494661,0.252032520325203,1.25255704169945,316,130,186,71,1.4,25.14,4.4,0,0,0,0,0,0,0.186727542335345,167.094689876385,21.0752678414584
9.7,"greedy_SVM","SVM",77,7,1984,1879,105,800,637,163,0.794520197170484,0.260162601626016,1.26299501704694,392,163,229,76,1.4,28.74,3.9,0,0,0,0,0,0,0.209128945298208,163.245500663638,22.9702690688533
9.7,"greedy_SVM","SVM",77,8,1884,1799,85,900,717,183,0.800358491773909,0.276422764227642,1.25255704169945,438,183,255,46,1.4,32.33,3.9,0,0,0,0,0,0,0.198446068543155,111.851255308026,20.8818226401154
9.7,"greedy_SVM","SVM",77,9,1784,1723,61,1000,793,207,0.797810639523734,0.260162601626016,1.25255704169945,507,207,300,69,1.4,35.92,3.8,0,0,0,0,0,0,0.199226772644377,88.4183465238191,21.6889055291794
9.7,"greedy_SVM","SVM",77,10,1684,1637,47,1100,879,221,0.799551885282648,0.235772357723577,1.25255704169945,549,221,328,42,1.5,39.51,4,0,0,0,0,0,0,0.145161268857754,53.660177929026,16.9887461400567
9.7,"greedy_SVM","SVM",77,11,1584,1551,33,1200,965,235,0.78992382049806,0.211382113821138,1.25255704169945,575,235,340,26,1.4,43.1,4.1,0,0,0,0,0,0,0.158468673823644,72.460988651378,17.6872428080924
9.7,"greedy_SVM","SVM",77,12,1484,1460,24,1300,1056,244,0.797721016580252,0.227642276422764,1.26299501704694,613,244,369,38,1.5,46.7,4.3,0,0,0,0,0,0,0.125593289456995,51.465881038186,14.0599649317754
9.7,"greedy_SVM","SVM",77,13,1384,1370,14,1400,1146,254,0.785903591319384,0.211382113821138,1.26299501704694,640,254,386,27,1.5,50.29,4.5,0,0,0,0,0,0,0.145714852277211,61.560767892284,16.2015050442426
9.7,"greedy_SVM","SVM",77,14,1284,1276,8,1500,1240,260,0.7773574034953,0.203252032520325,1.26299501704694,669,260,409,29,1.6,53.88,4.8,0,0,0,0,0,0,0.160771232794725,97.7730251081607,17.0353201087201
9.7,"greedy_SVM","SVM",77,15,1184,1176,8,1600,1340,260,0.768446322258503,0.195121951219512,1.25255704169945,661,260,401,-8,1.5,57.47,5.2,0,0,0,0,0,0,0.0739055171265356,21.5941164085353,9.67304575223132
9.7,"greedy_SVM","SVM",77,16,1084,1079,5,1700,1437,263,0.782606747327318,0.211382113821138,1.26299501704694,675,263,412,14,1.6,61.06,5.5,0,0,0,0,0,0,0.0621179501359667,19.7852516522977,8.30290039493266
9.7,"greedy_SVM","SVM",77,17,984,981,3,1800,1535,265,0.799283016452218,0.252032520325203,1.26299501704694,691,265,426,16,1.6,64.66,5.8,0,0,0,0,0,0,0.0627279434731838,23.2484775669883,7.80667556482694
9.7,"greedy_SVM","SVM",77,18,884,884,0,1900,1632,268,0.759797708213307,0.203252032520325,1.25255704169945,705,268,437,14,1.6,68.25,6.1,0,0,0,0,0,0,0.0638126810222648,21.5024558127597,9.67763078420554
9.7,"greedy_SVM","SVM",77,19,784,784,0,2000,1732,268,0.766474617502083,0.16260162601626,1.25255704169945,706,268,438,1,1.6,71.84,6.5,0,0,0,0,0,0,0.0527915884960051,18.1696915574025,6.59166202344263
9.7,"greedy_SVM","SVM",77,20,684,684,0,2100,1832,268,0.76195506049549,0.195121951219512,1.25255704169945,706,268,438,0,1.6,75.43,6.8,0,0,0,0,0,0,0.0314795582344854,8.58420619867437,3.98654856612276
9.7,"greedy_SVM","SVM",77,21,584,584,0,2200,1932,268,0.782856411241287,0.195121951219512,1.25255704169945,707,268,439,1,1.6,79.02,7.2,0,0,0,0,0,0,0.0565168723748349,20.9973975210396,6.35806037217648
9.7,"greedy_SVM","SVM",77,22,484,484,0,2300,2032,268,0.777645477242179,0.195121951219512,1.25255704169945,702,268,434,-5,1.6,82.61,7.6,0,0,0,0,0,0,0.0137764212932584,3.70009008009527,1.91086328984048
9.7,"greedy_SVM","SVM",77,23,384,384,0,2400,2132,268,0.796754369118501,0.211382113821138,1.25255704169945,699,268,431,-3,1.6,86.21,8,0,0,0,0,0,0,2.09027851944963e-06,0.0371062975267601,0.0370039078814536
9.7,"greedy_SVM","SVM",77,24,284,284,0,2500,2232,268,0.771864797388135,0.186991869918699,1.26299501704694,707,268,439,8,1.6,89.8,8.3,0,0,0,0,0,0,2.30558908150515e-08,1.42576322750786e-05,1.33143042280229e-05
9.7,"greedy_SVM","SVM",77,25,184,184,0,2600,2332,268,0.79770821330261,0.227642276422764,1.26299501704694,727,268,459,20,1.7,93.39,8.7,0,0,0,0,0,0,3.43001321787092e-08,2.74278415800529e-05,2.65949807652607e-05
9.7,"greedy_SVM","SVM",77,26,84,84,0,2700,2432,268,0.766762691248961,0.195121951219512,1.26299501704694,713,268,445,-14,1.7,96.98,9.1,0,0,0,0,0,0,3.00000089999998e-14,5.56247919103448e-09,5.56247919103448e-09
9.7,"greedy_SVM","SVM",77,27,0,0,0,2784,2516,268,0.781928173612447,0.195121951219512,1.26299501704694,725,268,457,12,1.7,100,9.4,0,0,0,0,0,0,0,0,0
9.7,"greedy_SVM","SVM",78,0,2684,2428,256,100,90,10,0.80617665615142,0.256,1.26332903225806,27,10,17,0,1.7,3.59,9,0,0,0,0,0,0,0.15119121312521,247.609384627756,15.8808772611779
9.7,"greedy_SVM","SVM",78,1,2584,2361,223,200,157,43,0.757709779179818,0.136,1.23251612903226,101,43,58,74,1.3,7.18,3.7,0,0,0,0,0,0,0.242156627304958,514.945897597955,30.2861412236091
9.7,"greedy_SVM","SVM",78,2,2484,2279,205,300,239,61,0.788788643533129,0.288,1.26332903225806,156,61,95,55,1.6,10.78,3.9,0,0,0,0,0,0,0.251335652500863,347.180396799225,27.8584836333061
9.7,"greedy_SVM","SVM",78,3,2384,2202,182,400,316,84,0.812946372239748,0.24,1.26332903225806,211,84,127,55,1.5,14.37,3.8,0,0,0,0,0,0,0.238116573852295,307.807372716319,24.5852104139012
9.7,"greedy_SVM","SVM",78,4,2284,2133,151,500,385,115,0.800447949526823,0.232,1.25305806451613,291,115,176,80,1.5,17.96,3.3,0,0,0,0,0,0,0.249036671765092,273.727514671669,25.4677919321092
9.7,"greedy_SVM","SVM",78,5,2184,2053,131,600,465,135,0.797009463722398,0.24,1.26332903225806,339,135,204,48,1.5,21.55,3.4,0,0,0,0,0,0,0.23471930679942,179.213208648328,23.8865653327428
9.7,"greedy_SVM","SVM",78,6,2084,1991,93,700,527,173,0.785331230283912,0.176,1.26332903225806,418,173,245,79,1.4,25.14,3,0,0,0,0,0,0,0.257946213265569,208.851453605485,27.8133148890203
9.7,"greedy_SVM","SVM",78,7,1984,1911,73,800,607,193,0.803381703470037,0.256,1.26332903225806,474,193,281,56,1.5,28.74,3.1,0,0,0,0,0,0,0.240953700610911,144.316374226355,24.8740529884052
9.7,"greedy_SVM","SVM",78,8,1884,1836,48,900,682,218,0.795003154574136,0.224,1.26332903225806,538,218,320,64,1.5,32.33,3.1,0,0,0,0,0,0,0.230305569649185,169.865402112016,24.1147613563736
9.7,"greedy_SVM","SVM",78,9,1784,1742,42,1000,776,224,0.78510410094638,0.192,1.26332903225806,544,224,320,6,1.4,35.92,3.5,0,0,0,0,0,0,0.18726730158555,113.768578349527,20.4250203387085
9.7,"greedy_SVM","SVM",78,10,1684,1645,39,1100,873,227,0.798675078864357,0.2,1.26332903225806,552,227,325,8,1.4,39.51,3.8,0,0,0,0,0,0,0.136788599820567,69.2723872509533,15.440521456948
9.7,"greedy_SVM","SVM",78,11,1584,1553,31,1200,965,235,0.79482018927445,0.224,1.25305806451613,585,235,350,33,1.5,43.1,4.1,0,0,0,0,0,0,0.139855138231546,73.207605366003,17.6308022101444
9.7,"greedy_SVM","SVM",78,12,1484,1461,23,1300,1057,243,0.78536277602524,0.192,1.22224516129032,604,243,361,19,1.5,46.7,4.3,0,0,0,0,0,0,0.135113639518503,64.3597962635876,15.4364586238385
9.7,"greedy_SVM","SVM",78,13,1384,1363,21,1400,1155,245,0.748580441640381,0.152,1.21197419354839,621,245,376,17,1.5,50.29,4.7,0,0,0,0,0,0,0.168871519825588,112.861652746535,17.6117853737712
9.7,"greedy_SVM","SVM",78,14,1284,1264,20,1500,1254,246,0.754422712933756,0.2,1.21197419354839,628,246,382,7,1.6,53.88,5.1,0,0,0,0,0,0,0.15777935543087,84.7754501662883,16.8141065152002
9.7,"greedy_SVM","SVM",78,15,1184,1165,19,1600,1353,247,0.751905362776025,0.152,1.22224516129032,634,247,387,6,1.6,57.47,5.5,0,0,0,0,0,0,0.149341516021793,53.5112405560699,16.3932027590868
9.7,"greedy_SVM","SVM",78,16,1084,1066,18,1700,1452,248,0.72036593059937,0.112,1.23251612903226,651,248,403,17,1.6,61.06,5.9,0,0,0,0,0,0,0.117565032917784,37.1062454859222,13.2431564488579
9.7,"greedy_SVM","SVM",78,17,984,966,18,1800,1552,248,0.725962145110411,0.112,1.22224516129032,657,248,409,6,1.6,64.66,6.3,0,0,0,0,0,0,0.0687899432957361,16.7403209904949,8.51909205127957
9.7,"greedy_SVM","SVM",78,18,884,866,18,1900,1652,248,0.751217665615145,0.16,1.22224516129032,647,248,399,-10,1.6,68.25,6.7,0,0,0,0,0,0,0.0300392553389649,7.4838039975682,5.00436778971623
9.7,"greedy_SVM","SVM",78,19,784,769,15,2000,1749,251,0.752000000000008,0.2,1.21197419354839,660,251,409,13,1.6,71.84,7,0,0,0,0,0,0,0.0176469199368309,6.19950268833517,3.13919965383531
9.7,"greedy_SVM","SVM",78,20,684,674,10,2100,1844,256,0.763741324921141,0.2,1.22224516129032,670,256,414,10,1.6,75.43,7.2,0,0,0,0,0,0,0.0962086081333963,29.6134506134454,13.8050194476332
9.7,"greedy_SVM","SVM",78,21,584,574,10,2200,1944,256,0.767993690851744,0.232,1.20170322580645,679,256,423,9,1.7,79.02,7.6,0,0,0,0,0,0,0.0461301801840886,13.8449377496608,6.67601357589686
9.7,"greedy_SVM","SVM",78,22,484,474,10,2300,2044,256,0.731678233438492,0.136,1.21197419354839,689,256,433,10,1.7,82.61,8,0,0,0,0,0,0,0.0176370583043247,4.74411937625506,2.72584025563509
9.7,"greedy_SVM","SVM",78,23,384,376,8,2400,2142,258,0.765287066246066,0.16,1.22224516129032,698,258,440,9,1.7,86.21,8.3,0,0,0,0,0,0,0.0267329899804445,7.39827915740667,3.94771461327363
9.7,"greedy_SVM","SVM",78,24,284,280,4,2500,2238,262,0.729671924290229,0.144,1.2736,704,262,442,6,1.7,89.8,8.5,0,0,0,0,0,0,0.0222516284720788,6.89504410170429,5.42215670724654
9.7,"greedy_SVM","SVM",78,25,184,184,0,2600,2334,266,0.767419558359625,0.16,1.26332903225806,723,266,457,19,1.7,93.39,8.8,0,0,0,0,0,0,0.00287809292707574,0.780753918146176,0.752858672747757
9.7,"greedy_SVM","SVM",78,26,84,84,0,2700,2434,266,0.743116719242907,0.16,1.26332903225806,731,266,465,8,1.7,96.98,9.2,0,0,0,0,0,0,7.34555402474529e-14,2.09187488954567e-05,2.09187488954567e-05
9.7,"greedy_SVM","SVM",78,27,0,0,0,2784,2518,266,0.78620820189275,0.184,1.26332903225806,724,266,458,-7,1.7,100,9.5,0,0,0,0,0,0,0,0,0
9.7,"greedy_SVM","SVM",79,0,2684,2418,266,100,94,6,0.735333693917131,0.176470588235294,1.24071564109515,22,6,16,0,2.7,3.59,15.7,0,0,0,0,0,0,0.0768711902233321,175.662636585931,7.88273962682642
9.7,"greedy_SVM","SVM",79,1,2584,2345,239,200,167,33,0.787165415616801,0.142857142857143,1.26229330441854,77,33,44,55,1.3,7.18,5.1,0,0,0,0,0,0,0.303712807708161,240.402654872979,35.9320384441046
9.7,"greedy_SVM","SVM",79,2,2484,2266,218,300,246,54,0.668858752292128,0.210084033613445,1.17598265112497,134,54,80,57,1.5,10.78,4.6,0,0,0,0,0,0,0.235944802779732,274.130023324582,28.0511855793607
9.7,"greedy_SVM","SVM",79,3,2384,2184,200,400,328,72,0.771585557299846,0.19327731092437,1.26229330441854,183,72,111,49,1.5,14.37,4.6,0,0,0,0,0,0,0.205471840922574,165.943634178371,21.9777967778516
9.7,"greedy_SVM","SVM",79,4,2284,2117,167,500,395,105,0.768472224054461,0.210084033613445,1.21801538294876,250,105,145,67,1.4,17.96,3.8,0,0,0,0,0,0,0.189375243956721,132.260467611968,21.6000326697356
9.7,"greedy_SVM","SVM",79,5,2184,2041,143,600,471,129,0.772997110932288,0.210084033613445,1.26229330441854,311,129,182,61,1.4,21.55,3.7,0,0,0,0,0,0,0.206982134997434,117.685030914042,32.2039864325074
9.7,"greedy_SVM","SVM",79,6,2084,1956,128,700,556,144,0.793728480403155,0.218487394957983,1.26229330441854,347,144,203,36,1.4,25.14,3.9,0,0,0,0,0,0,0.177260923074722,90.5052326659846,20.0820300821129
9.7,"greedy_SVM","SVM",79,7,1984,1879,105,800,633,167,0.814393889423907,0.218487394957983,1.26229330441854,411,167,244,64,1.5,28.74,3.8,0,0,0,0,0,0,0.153269195737097,82.7465977212207,18.4735208551565
9.7,"greedy_SVM","SVM",79,8,1884,1799,85,900,713,187,0.822513620832954,0.243697478991597,1.26229330441854,462,187,275,51,1.5,32.33,3.8,0,0,0,0,0,0,0.183638442013054,98.4077457422726,21.2238977274255
9.7,"greedy_SVM","SVM",79,9,1784,1722,62,1000,790,210,0.772660712636707,0.176470588235294,1.19756031444836,527,210,317,65,1.5,35.92,3.8,0,0,0,0,0,0,0.217246168650653,136.560088291937,43.6841879418014
9.7,"greedy_SVM","SVM",79,10,1684,1640,44,1100,872,228,0.770206983892465,0.184873949579832,1.18677148278666,564,228,336,37,1.5,39.51,3.8,0,0,0,0,0,0,0.205299213066011,151.30063613015,23.247116697942
9.7,"greedy_SVM","SVM",79,11,1584,1554,30,1200,958,242,0.765418255214179,0.168067226890756,1.19756031444836,602,242,360,38,1.5,43.1,4,0,0,0,0,0,0,0.201128719429624,95.4927765413732,20.7047388690875
9.7,"greedy_SVM","SVM",79,12,1484,1460,24,1300,1052,248,0.777047082569296,0.226890756302521,1.20834914611006,618,248,370,16,1.5,46.7,4.2,0,0,0,0,0,0,0.158956800987664,57.3464698907514,17.5659636010981
9.7,"greedy_SVM","SVM",79,13,1384,1361,23,1400,1151,249,0.766394469875867,0.201680672268908,1.20834914611006,630,249,381,12,1.5,50.29,4.6,0,0,0,0,0,0,0.0871471147107613,23.8927190944964,11.2713990070181
9.7,"greedy_SVM","SVM",79,14,1284,1263,21,1500,1249,251,0.769375882221026,0.19327731092437,1.21913797777175,620,251,369,-10,1.5,53.88,5,0,0,0,0,0,0,0.0805253633885237,28.4385471189174,10.6825256980605
9.7,"greedy_SVM","SVM",79,15,1184,1165,19,1600,1347,253,0.761018693191566,0.218487394957983,1.19756031444836,650,253,397,30,1.6,57.47,5.3,0,0,0,0,0,0,0.126080839430326,41.7958814210522,14.4267858089091
9.7,"greedy_SVM","SVM",79,16,1084,1067,17,1700,1445,255,0.707696265319319,0.134453781512605,1.19756031444836,661,255,406,11,1.6,61.06,5.7,0,0,0,0,0,0,0.142587959950841,54.2484690863733,15.4414936210188
9.7,"greedy_SVM","SVM",79,17,984,967,17,1800,1545,255,0.750682690658685,0.168067226890756,1.19756031444836,665,255,410,4,1.6,64.66,6.1,0,0,0,0,0,0,0.0985831735956911,27.1257840340172,11.1511767759709
9.7,"greedy_SVM","SVM",79,18,884,867,17,1900,1645,255,0.733341688323685,0.159663865546218,1.19756031444836,662,255,407,-3,1.6,68.25,6.5,0,0,0,0,0,0,0.0834899071858857,27.7080867164811,9.94028914268296
9.7,"greedy_SVM","SVM",79,19,784,767,17,2000,1745,255,0.720855375117084,0.159663865546218,1.19756031444836,658,255,403,-4,1.6,71.84,6.8,0,0,0,0,0,0,0.010514160269811,3.71000011730484,2.75409500300515
9.7,"greedy_SVM","SVM",79,20,684,671,13,2100,1841,259,0.726171787396285,0.142857142857143,1.21913797777175,690,259,431,32,1.7,75.43,7.1,0,0,0,0,0,0,0.0325911513337322,11.2890363528612,5.64019040076131
9.7,"greedy_SVM","SVM",79,21,584,572,12,2200,1940,260,0.751408255609946,0.126050420168067,1.20834914611006,680,260,420,-10,1.6,79.02,7.5,0,0,0,0,0,0,0.0156728745222891,4.57827370516108,2.26358002537059
9.7,"greedy_SVM","SVM",79,22,484,475,9,2300,2037,263,0.710710657889535,0.134453781512605,1.21913797777175,687,263,424,7,1.6,82.61,7.7,0,0,0,0,0,0,0.0243993268134964,7.30180507565061,3.33562575377904
9.7,"greedy_SVM","SVM",79,23,384,377,7,2400,2135,265,0.719971505085556,0.151260504201681,1.22992680943345,699,265,434,12,1.6,86.21,8.1,0,0,0,0,0,0,0.0726860408320106,20.2033233626963,8.95883106883359
9.7,"greedy_SVM","SVM",79,24,284,281,3,2500,2231,269,0.717333087080989,0.109243697478992,1.26229330441854,728,269,459,29,1.7,89.8,8.3,0,0,0,0,0,0,0.0229484385438565,6.70928294118645,5.4293756796642
9.7,"greedy_SVM","SVM",79,25,184,183,1,2600,2329,271,0.730505388968777,0.151260504201681,1.27308213608024,719,271,448,-9,1.7,93.39,8.6,0,0,0,0,0,0,0.0132522716237131,2.78321052725677,2.19617684150624
9.7,"greedy_SVM","SVM",79,26,84,84,0,2700,2428,272,0.717240742450828,0.151260504201681,1.27308213608024,732,272,460,13,1.7,96.98,8.9,0,0,0,0,0,0,2.42999222752547e-08,4.87435149853109,4.87435149853109
9.7,"greedy_SVM","SVM",79,27,0,0,0,2784,2512,272,0.724760233763837,0.126050420168067,1.27308213608024,748,272,476,16,1.8,100,9.2,0,0,0,0,0,0,0,0,0
9.7,"greedy_SVM","SVM",80,0,2684,2447,237,100,88,12,0.628747706060501,0.0985915492957746,1.10304407087687,33,12,21,0,1.8,3.59,7.3,0,0,0,0,0,0,0.296795177911918,325.744583928941,80.1635641707819
9.7,"greedy_SVM","SVM",80,1,2584,2366,218,200,169,31,0.785602503912359,0.161971830985915,1.26578827805543,88,31,57,55,1.8,7.18,5.5,0,0,0,0,0,0,0.201785264795197,301.795651777935,21.5203304365063
9.7,"greedy_SVM","SVM",80,2,2484,2283,201,300,252,48,0.781459339570596,0.373239436619718,1.15729213993639,127,48,79,39,1.6,10.78,5.2,0,0,0,0,0,0,0.16704783516847,351.943414390666,17.0721821309286
9.7,"greedy_SVM","SVM",80,3,2384,2210,174,400,325,75,0.747942491077557,0.28169014084507,1.18441617446615,191,75,116,64,1.5,14.37,4.3,0,0,0,0,0,0,0.20882339045687,319.517291502532,23.3240465945784
9.7,"greedy_SVM","SVM",80,4,2284,2141,143,500,394,106,0.806684230080728,0.309859154929577,1.25674693321218,266,106,160,75,1.5,17.96,3.7,0,0,0,0,0,0,0.226647303685256,342.052079598565,22.9256956366971
9.7,"greedy_SVM","SVM",80,5,2184,2067,117,600,468,132,0.820656151135424,0.345070422535211,1.26578827805543,334,132,202,68,1.5,21.55,3.5,0,0,0,0,0,0,0.228369330256918,287.361106801066,23.0895058521628
9.7,"greedy_SVM","SVM",80,6,2084,1997,87,700,538,162,0.811621125634698,0.302816901408451,1.25674693321218,398,162,236,64,1.5,25.14,3.3,0,0,0,0,0,0,0.239436491083605,210.535439015181,24.3835500617865
9.7,"greedy_SVM","SVM",80,7,1984,1910,74,800,625,175,0.802113238986274,0.309859154929577,1.22058155383916,445,175,270,47,1.5,28.74,3.6,0,0,0,0,0,0,0.217453240964397,216.359644942226,22.3241193969174
9.7,"greedy_SVM","SVM",80,8,1884,1826,58,900,709,191,0.801178775289632,0.373239436619718,1.20249886415266,495,191,304,50,1.6,32.33,3.7,0,0,0,0,0,0,0.200745921299871,193.167143327598,20.9332866975417
9.7,"greedy_SVM","SVM",80,9,1784,1734,50,1000,801,199,0.788169464428453,0.330985915492958,1.18441617446615,513,199,314,18,1.6,35.92,4,0,0,0,0,0,0,0.177572261904519,191.265441790448,18.7421156875878
9.7,"greedy_SVM","SVM",80,10,1684,1640,44,1100,895,205,0.777417502617626,0.23943661971831,1.1753748296229,535,205,330,22,1.6,39.51,4.4,0,0,0,0,0,0,0.116541962435409,104.398494370922,14.2867973313538
9.7,"greedy_SVM","SVM",80,11,1584,1548,36,1200,987,213,0.811018790601319,0.246478873239437,1.25674693321218,548,213,335,13,1.6,43.1,4.6,0,0,0,0,0,0,0.182368958909118,133.709003917458,32.4377088717061
9.7,"greedy_SVM","SVM",80,12,1484,1459,25,1300,1076,224,0.801043672104577,0.274647887323944,1.25674693321218,586,224,362,38,1.6,46.7,4.8,0,0,0,0,0,0,0.159409006722488,92.6762620056923,18.2036234735049
9.7,"greedy_SVM","SVM",80,13,1384,1366,18,1400,1169,231,0.79915222751377,0.253521126760563,1.24770558836892,596,231,365,10,1.6,50.29,5.1,0,0,0,0,0,0,0.159003908314133,132.684662354611,17.2430889951144
9.7,"greedy_SVM","SVM",80,14,1284,1268,16,1500,1267,233,0.799107193118751,0.28169014084507,1.22962289868242,619,233,386,23,1.7,53.88,5.4,0,0,0,0,0,0,0.137084148768027,75.2187073624791,15.0309074508761
9.7,"greedy_SVM","SVM",80,15,1184,1169,15,1600,1366,234,0.781639477150681,0.23943661971831,1.23866424352567,621,234,387,2,1.7,57.47,5.8,0,0,0,0,0,0,0.119470315658793,64.2232707243428,12.6429157921364
9.7,"greedy_SVM","SVM",80,16,1084,1069,15,1700,1466,234,0.809026018621729,0.274647887323944,1.23866424352567,613,234,379,-8,1.6,61.06,6.3,0,0,0,0,0,0,0.0795693900623319,32.4394098104278,8.93521259973107
9.7,"greedy_SVM","SVM",80,17,984,970,14,1800,1565,235,0.802732461917797,0.316901408450704,1.23866424352567,649,235,414,36,1.8,64.66,6.7,0,0,0,0,0,0,0.049606172067208,17.6063265899075,7.30444300559877
9.7,"greedy_SVM","SVM",80,18,884,871,13,1900,1664,236,0.812983416084042,0.288732394366197,1.23866424352567,640,236,404,-9,1.7,68.25,7.1,0,0,0,0,0,0,0.0617653722163196,29.9923324938603,7.12559297994526
9.7,"greedy_SVM","SVM",80,19,784,771,13,2000,1764,236,0.79536370903278,0.253521126760563,1.23866424352567,629,236,393,-11,1.7,71.84,7.5,0,0,0,0,0,0,0.00472219361052776,1.35153301098783,0.762636374906841
9.7,"greedy_SVM","SVM",80,20,684,672,12,2100,1863,237,0.795515700115971,0.274647887323944,1.23866424352567,653,237,416,24,1.8,75.43,7.9,0,0,0,0,0,0,0.00544942857224325,1.65667376336397,0.977797253319603
9.7,"greedy_SVM","SVM",80,21,584,573,11,2200,1962,238,0.77503630898099,0.211267605633803,1.22962289868242,650,238,412,-3,1.7,79.02,8.2,0,0,0,0,0,0,0.00790800486780826,2.71121625783194,1.94420638944086
9.7,"greedy_SVM","SVM",80,22,484,474,10,2300,2061,239,0.775582351020595,0.197183098591549,1.22962289868242,633,239,394,-17,1.6,82.61,8.6,0,0,0,0,0,0,0.00970491859839178,2.78203980906839,1.66928688095387
9.7,"greedy_SVM","SVM",80,23,384,375,9,2400,2160,240,0.774456491145108,0.176056338028169,1.23866424352567,666,240,426,33,1.8,86.21,9,0,0,0,0,0,0,0.00551928045608169,1.51086678466577,1.14345511618546
9.7,"greedy_SVM","SVM",80,24,284,280,4,2500,2255,245,0.781341124283669,0.183098591549296,1.27482962289868,671,245,426,5,1.7,89.8,9.2,0,0,0,0,0,0,0.00077770035067531,3.48561215240187,3.44345915453106
9.7,"greedy_SVM","SVM",80,25,184,183,1,2600,2352,248,0.797868747255713,0.246478873239437,1.28387096774194,701,248,453,30,1.8,93.39,9.5,0,0,0,0,0,0,0.000164844805288827,0.0676152063126997,0.0605380514362141
9.7,"greedy_SVM","SVM",80,26,84,84,0,2700,2451,249,0.808992242825455,0.232394366197183,1.27482962289868,696,249,447,-5,1.8,96.98,9.8,0,0,0,0,0,0,0.000151022429104343,1.41920880667838,1.41920880667838
9.7,"greedy_SVM","SVM",80,27,0,0,0,2784,2535,249,0.773454475855931,0.211267605633803,1.27482962289868,726,249,477,30,1.9,100,10.2,0,0,0,0,0,0,0,0,0
9.7,"greedy_SVM","SVM",81,0,2684,2421,263,100,91,9,0.741778029893278,0.210084033613445,1.22992680943345,27,9,18,0,2,3.59,10.1,0,0,0,0,0,0,0.176936451814861,254.362498496935,19.6488516224982
9.7,"greedy_SVM","SVM",81,1,2584,2345,239,200,167,33,0.770695091223305,0.201680672268908,1.27308213608024,90,33,57,63,1.7,7.18,5.1,0,0,0,0,0,0,0.209008104507726,304.386482889678,23.0886222264334
9.7,"greedy_SVM","SVM",81,2,2484,2267,217,300,245,55,0.779048982230256,0.260504201680672,1.26113097172571,140,55,85,50,1.5,10.78,4.5,0,0,0,0,0,0,0.335514042608677,260.90489461068,44.2572635301428
9.7,"greedy_SVM","SVM",81,3,2384,2202,182,400,310,90,0.756751052069182,0.19327731092437,1.27308213608024,220,90,130,80,1.4,14.37,3.4,0,0,0,0,0,0,0.246683908040452,355.480963211608,25.4654169675369
9.7,"greedy_SVM","SVM",81,4,2284,2125,159,500,387,113,0.775767449837078,0.226890756302521,1.27308213608024,265,113,152,45,1.3,17.96,3.4,0,0,0,0,0,0,0.236993069325176,204.439439311671,25.7949270408982
9.7,"greedy_SVM","SVM",81,5,2184,2050,134,600,462,138,0.780265952534861,0.218487394957983,1.27308213608024,325,138,187,60,1.4,21.55,3.3,0,0,0,0,0,0,0.223945075796226,178.739579837039,23.8601974307025
9.7,"greedy_SVM","SVM",81,6,2084,1973,111,700,539,161,0.788649525744363,0.252100840336134,1.27308213608024,374,161,213,49,1.3,25.14,3.3,0,0,0,0,0,0,0.207015741564432,149.444671243522,22.2672907083669
9.7,"greedy_SVM","SVM",81,7,1984,1898,86,800,614,186,0.806485231455222,0.252100840336134,1.26229330441854,444,186,258,70,1.4,28.74,3.3,0,0,0,0,0,0,0.210901196370586,140.755296363661,23.3992875373891
9.7,"greedy_SVM","SVM",81,8,1884,1818,66,900,694,206,0.797534398374742,0.243697478991597,1.22992680943345,496,206,290,52,1.4,32.33,3.4,0,0,0,0,0,0,0.200084928069639,95.4938666585452,23.4482837238865
9.7,"greedy_SVM","SVM",81,9,1784,1722,62,1000,790,210,0.786545387385729,0.243697478991597,1.20834914611006,509,210,299,13,1.4,35.92,3.8,0,0,0,0,0,0,0.132176868726532,77.2185731408187,15.460607693434
9.7,"greedy_SVM","SVM",81,10,1684,1631,53,1100,881,219,0.775741065657037,0.226890756302521,1.20834914611006,543,219,324,34,1.5,39.51,4,0,0,0,0,0,0,0.188526029954594,181.110004711633,20.0085411739029
9.7,"greedy_SVM","SVM",81,11,1584,1539,45,1200,973,227,0.772218777620941,0.210084033613445,1.21913797777175,579,227,352,36,1.6,43.1,4.3,0,0,0,0,0,0,0.151940690457585,104.763455096485,17.0142890958359
9.7,"greedy_SVM","SVM",81,12,1484,1447,37,1300,1065,235,0.792455443715952,0.19327731092437,1.21913797777175,585,235,350,6,1.5,46.7,4.5,0,0,0,0,0,0,0.140437281778676,80.2273298788148,17.2617595704668
9.7,"greedy_SVM","SVM",81,13,1384,1359,25,1400,1153,247,0.795140034035597,0.210084033613445,1.21913797777175,623,247,376,38,1.5,50.29,4.7,0,0,0,0,0,0,0.104732861983925,50.0542183023898,12.5971747894701
9.7,"greedy_SVM","SVM",81,14,1284,1262,22,1500,1250,250,0.777040486524287,0.151260504201681,1.21913797777175,639,250,389,16,1.6,53.88,5,0,0,0,0,0,0,0.10722356793964,47.532674246213,14.2054402272386
9.7,"greedy_SVM","SVM",81,15,1184,1162,22,1600,1350,250,0.798504016991416,0.218487394957983,1.22992680943345,666,250,416,27,1.7,57.47,5.4,0,0,0,0,0,0,0.0606361931008609,20.3620493609994,7.69123756117844
9.7,"greedy_SVM","SVM",81,16,1084,1063,21,1700,1449,251,0.768538184504575,0.19327731092437,1.21913797777175,660,251,409,-6,1.6,61.06,5.8,0,0,0,0,0,0,0.0601201342963354,19.1710320003058,7.30675496085759
9.7,"greedy_SVM","SVM",81,17,984,963,21,1800,1549,251,0.767720274923161,0.159663865546218,1.22992680943345,669,251,418,9,1.7,64.66,6.2,0,0,0,0,0,0,0.013556433301091,4.37941750843273,2.52442480303855
9.7,"greedy_SVM","SVM",81,18,884,867,17,1900,1645,255,0.810739680487583,0.226890756302521,1.27308213608024,679,255,424,10,1.7,68.25,6.5,0,0,0,0,0,0,0.0127567809482977,6.75236786695764,5.84694806189434
9.7,"greedy_SVM","SVM",81,19,784,777,7,2000,1735,265,0.803068480139311,0.218487394957983,1.27308213608024,707,265,442,28,1.7,71.84,6.5,0,0,0,0,0,0,0.130951749871606,44.0940994341985,16.7336082663296
9.7,"greedy_SVM","SVM",81,20,684,678,6,2100,1834,266,0.795621545321428,0.184873949579832,1.27308213608024,719,266,453,12,1.7,75.43,6.9,0,0,0,0,0,0,0.0838509911004961,23.2497973261702,11.4944144888763
9.7,"greedy_SVM","SVM",81,21,584,582,2,2200,1930,270,0.800238776829415,0.210084033613445,1.27308213608024,716,270,446,-3,1.7,79.02,7.1,0,0,0,0,0,0,0.0179248848451413,6.19013972999926,5.1902982366814
9.7,"greedy_SVM","SVM",81,22,484,483,1,2300,2029,271,0.831114863527833,0.252100840336134,1.27308213608024,740,271,469,24,1.7,82.61,7.5,0,0,0,0,0,0,0.0127735478531715,3.82959307932168,2.73644842571856
9.7,"greedy_SVM","SVM",81,23,384,383,1,2400,2129,271,0.796934158278699,0.210084033613445,1.27308213608024,737,271,466,-3,1.7,86.21,7.9,0,0,0,0,0,0,0.00293800241088378,0.967844796497275,0.70260581357064
9.7,"greedy_SVM","SVM",81,24,284,284,0,2500,2228,272,0.758894766697891,0.159663865546218,1.27308213608024,730,272,458,-7,1.7,89.8,8.2,0,0,0,0,0,0,0.0203808683372644,8.43852104435521,7.37200715714687
9.7,"greedy_SVM","SVM",81,25,184,184,0,2600,2328,272,0.838667335065898,0.277310924369748,1.28387096774194,750,272,478,20,1.8,93.39,8.6,0,0,0,0,0,0,0.00464221431895328,1.45362982957478,1.26426649731129
9.7,"greedy_SVM","SVM",81,26,84,84,0,2700,2428,272,0.818602166141185,0.218487394957983,1.27308213608024,763,272,491,13,1.8,96.98,8.9,0,0,0,0,0,0,1.31384975722464e-06,0.0182573077625558,0.0182573077625558
9.7,"greedy_SVM","SVM",81,27,0,0,0,2784,2512,272,0.813160429006772,0.226890756302521,1.27308213608024,742,272,470,-21,1.7,100,9.2,0,0,0,0,0,0,0,0,0
9.7,"greedy_SVM","SVM",82,0,2684,2444,240,100,95,5,0.763053245597657,0.328767123287671,1.21352187361909,13,5,8,0,1.6,3.59,19,0,0,0,0,0,0,0.245282543459732,214.833384539519,35.657194959074
9.7,"greedy_SVM","SVM",82,1,2584,2368,216,200,171,29,0.719941558370229,0.36986301369863,1.16076005302696,71,29,42,58,1.4,7.18,5.9,0,0,0,0,0,0,0.211372247436438,277.642616499778,27.8677045405741
9.7,"greedy_SVM","SVM",82,2,2484,2291,193,300,248,52,0.736891828058568,0.26027397260274,1.16076005302696,126,52,74,55,1.4,10.78,4.8,0,0,0,0,0,0,0.204049994790061,267.006978973253,23.3558943047703
9.7,"greedy_SVM","SVM",82,3,2384,2213,171,400,326,74,0.805137810196522,0.363013698630137,1.24869642068051,185,74,111,59,1.5,14.37,4.4,0,0,0,0,0,0,0.198312871945443,187.351371866135,20.7619885943189
9.7,"greedy_SVM","SVM",82,4,2284,2143,141,500,396,104,0.800013182322507,0.349315068493151,1.21352187361909,246,104,142,61,1.4,17.96,3.8,0,0,0,0,0,0,0.21642960131703,188.126705067162,24.483405714537
9.7,"greedy_SVM","SVM",82,5,2184,2069,115,600,470,130,0.827608177434057,0.410958904109589,1.25749005744587,303,130,173,57,1.3,21.55,3.6,0,0,0,0,0,0,0.230929058900876,144.71854414862,23.7532347273707
9.7,"greedy_SVM","SVM",82,6,2084,1986,98,700,553,147,0.822164976766153,0.376712328767123,1.25749005744587,357,147,210,54,1.4,25.14,3.8,0,0,0,0,0,0,0.211719119713347,100.578715600219,22.8669963199842
9.7,"greedy_SVM","SVM",82,7,1984,1902,82,800,637,163,0.823785303907453,0.363013698630137,1.25749005744587,398,163,235,41,1.4,28.74,3.9,0,0,0,0,0,0,0.181781301846316,78.213780383732,20.3838822594994
9.7,"greedy_SVM","SVM",82,8,1884,1818,66,900,721,179,0.834034559655499,0.328767123287671,1.25749005744587,445,179,266,47,1.5,32.33,4,0,0,0,0,0,0,0.178346634541457,83.3514402513275,19.6575436062031
9.7,"greedy_SVM","SVM",82,9,1784,1737,47,1000,802,198,0.834320176643124,0.308219178082192,1.25749005744587,490,198,292,45,1.5,35.92,4.1,0,0,0,0,0,0,0.1730716314903,114.973673398543,19.2570463256479
9.7,"greedy_SVM","SVM",82,10,1684,1651,33,1100,888,212,0.834122441805532,0.328767123287671,1.26628369421122,546,212,334,56,1.6,39.51,4.2,0,0,0,0,0,0,0.180013845452614,106.558692810988,18.863948768172
9.7,"greedy_SVM","SVM",82,11,1584,1555,29,1200,984,216,0.834737616855791,0.342465753424658,1.26628369421122,573,216,357,27,1.7,43.1,4.6,0,0,0,0,0,0,0.160820793452904,74.3323014333457,17.3436015327782
9.7,"greedy_SVM","SVM",82,12,1484,1462,22,1300,1077,223,0.820215091562215,0.287671232876712,1.25749005744587,593,223,370,20,1.7,46.7,4.8,0,0,0,0,0,0,0.13731988827873,59.7130350797508,15.2064190627869
9.7,"greedy_SVM","SVM",82,13,1384,1364,20,1400,1175,225,0.84072458832705,0.349315068493151,1.26628369421122,590,225,365,-3,1.6,50.29,5.2,0,0,0,0,0,0,0.0993311172833708,39.6431181740276,11.9115379496575
9.7,"greedy_SVM","SVM",82,14,1284,1266,18,1500,1273,227,0.824922279223552,0.328767123287671,1.26628369421122,601,227,374,11,1.6,53.88,5.6,0,0,0,0,0,0,0.0934326945996576,38.2058368760014,12.9845654731235
9.7,"greedy_SVM","SVM",82,15,1184,1167,17,1600,1372,228,0.817831288242457,0.308219178082192,1.26628369421122,624,228,396,23,1.7,57.47,6,0,0,0,0,0,0,0.0927787564467961,31.7781747416548,10.9977881920926
9.7,"greedy_SVM","SVM",82,16,1084,1069,15,1700,1470,230,0.808691544638631,0.315068493150685,1.24869642068051,614,230,384,-10,1.7,61.06,6.4,0,0,0,0,0,0,0.0842807951804479,24.7517723872378,10.8054448576237
9.7,"greedy_SVM","SVM",82,17,984,969,15,1800,1570,230,0.776032340631208,0.253424657534247,1.24869642068051,638,230,408,24,1.8,64.66,6.8,0,0,0,0,0,0,0.0483577325215415,12.1807736407738,6.2718958792375
9.7,"greedy_SVM","SVM",82,18,884,869,15,1900,1670,230,0.814324241192555,0.315068493150685,1.25749005744587,641,230,411,3,1.8,68.25,7.3,0,0,0,0,0,0,0.00745257944220646,1.97930007244431,1.5809071254401
9.7,"greedy_SVM","SVM",82,19,784,769,15,2000,1770,230,0.815117926860072,0.315068493150685,1.25749005744587,625,230,395,-16,1.7,71.84,7.7,0,0,0,0,0,0,0.00253122309954441,0.829197688089733,0.661965374357368
9.7,"greedy_SVM","SVM",82,20,684,672,12,2100,1867,233,0.793339631554076,0.267123287671233,1.26628369421122,650,233,417,25,1.8,75.43,8,0,0,0,0,0,0,0.00330081561122782,1.6013534127278,1.11635449563757
9.7,"greedy_SVM","SVM",82,21,584,580,4,2200,1959,241,0.815282705891395,0.294520547945205,1.27390322662025,671,241,430,21,1.8,79.02,8.1,0,0,0,0,0,0,0.0636226096384042,16.4380662150086,11.1364692418978
9.7,"greedy_SVM","SVM",82,22,484,483,1,2300,2056,244,0.816578967604435,0.287671232876712,1.27390322662025,686,244,442,15,1.8,82.61,8.4,0,0,0,0,0,0,0.0324908534986066,9.1122363029837,6.99670478595685
9.7,"greedy_SVM","SVM",82,23,384,383,1,2400,2156,244,0.834891410618354,0.335616438356164,1.27390322662025,699,244,455,13,1.9,86.21,8.8,0,0,0,0,0,0,0.0174828992290423,4.60580174844712,3.58100981652847
9.7,"greedy_SVM","SVM",82,24,284,283,1,2500,2256,244,0.821780492359741,0.315068493150685,1.27390322662025,689,244,445,-10,1.8,89.8,9.2,0,0,0,0,0,0,0.000405166423259254,0.241940393881658,0.22919428481556
9.7,"greedy_SVM","SVM",82,25,184,183,1,2600,2356,244,0.774851424240094,0.246575342465753,1.27390322662025,699,244,455,10,1.9,93.39,9.7,0,0,0,0,0,0,4.4917886188642e-05,0.0302036415317783,0.0288615087971888
9.7,"greedy_SVM","SVM",82,26,84,84,0,2700,2455,245,0.796410014170996,0.26027397260274,1.27390322662025,701,245,456,2,1.9,96.98,10,0,0,0,0,0,0,1.0000000994736e-07,1.22483726499242,1.22483726499242
9.7,"greedy_SVM","SVM",82,27,0,0,0,2784,2539,245,0.785408267513262,0.23972602739726,1.27390322662025,672,245,427,-29,1.7,100,10.4,0,0,0,0,0,0,0,0,0
9.7,"greedy_SVM","SVM",83,0,2684,2440,244,100,86,14,0.698818474758323,0.157894736842105,1.22595197671598,44,14,30,0,2.1,3.59,6.1,0,0,0,0,0,0,0.1873124449128,377.657739718033,25.1587842167094
9.7,"greedy_SVM","SVM",83,1,2584,2356,228,200,170,30,0.770509607351728,0.180451127819549,1.27421780257094,92,30,62,48,2.1,7.18,5.7,0,0,0,0,0,0,0.206419901836118,315.133960064627,24.6909889155187
9.7,"greedy_SVM","SVM",83,2,2484,2266,218,300,260,40,0.758622747344557,0.105263157894737,1.24525830705797,121,40,81,29,2,10.78,6.5,0,0,0,0,0,0,0.182125246581032,296.057899796017,26.5313445651969
9.7,"greedy_SVM","SVM",83,3,2384,2178,206,400,348,52,0.816809881847478,0.225563909774436,1.26456463739995,171,52,119,50,2.3,14.37,6.7,0,0,0,0,0,0,0.151762166863313,235.622697620242,15.614285561296
9.7,"greedy_SVM","SVM",83,4,2284,2105,179,500,421,79,0.814810836615356,0.315789473684211,1.25491147222896,207,79,128,36,1.6,17.96,5.3,0,0,0,0,0,0,0.186993893102833,299.268842715868,21.2579891458109
9.7,"greedy_SVM","SVM",83,5,2184,2037,147,600,489,111,0.804797708557115,0.255639097744361,1.25491147222896,277,111,166,70,1.5,21.55,4.4,0,0,0,0,0,0,0.190813131057673,298.796112972557,20.6063401957546
9.7,"greedy_SVM","SVM",83,6,2084,1965,119,700,561,139,0.820676691729336,0.270676691729323,1.25491147222896,354,139,215,77,1.5,25.14,4,0,0,0,0,0,0,0.2081092283631,243.151633459886,21.8222272693244
9.7,"greedy_SVM","SVM",83,7,1984,1893,91,800,633,167,0.822514619883046,0.293233082706767,1.26456463739995,419,167,252,65,1.5,28.74,3.8,0,0,0,0,0,0,0.213168689802046,247.271788344615,21.574357002176
9.7,"greedy_SVM","SVM",83,8,1884,1826,58,900,700,200,0.818385248836382,0.278195488721804,1.26456463739995,479,200,279,60,1.4,32.33,3.5,0,0,0,0,0,0,0.223348348266878,177.961701040713,22.9946533427245
9.7,"greedy_SVM","SVM",83,9,1784,1744,40,1000,782,218,0.816601026375467,0.255639097744361,1.26456463739995,549,218,331,70,1.5,35.92,3.6,0,0,0,0,0,0,0.203862095664967,165.050491695453,21.2034580131565
9.7,"greedy_SVM","SVM",83,10,1684,1652,32,1100,874,226,0.826285952977688,0.315789473684211,1.26456463739995,558,226,332,9,1.5,39.51,3.9,0,0,0,0,0,0,0.171485841617895,102.553017575371,18.3873628791198
9.7,"greedy_SVM","SVM",83,11,1584,1560,24,1200,966,234,0.813008712256839,0.278195488721804,1.26456463739995,580,234,346,22,1.5,43.1,4.1,0,0,0,0,0,0,0.16393856870277,97.6158495790645,17.4879587968918
9.7,"greedy_SVM","SVM",83,12,1484,1464,20,1300,1062,238,0.811737677527157,0.233082706766917,1.26456463739995,613,238,375,33,1.6,46.7,4.5,0,0,0,0,0,0,0.125159700489587,62.6682579363785,14.0629027101102
9.7,"greedy_SVM","SVM",83,13,1384,1366,18,1400,1160,240,0.808700322234164,0.240601503759398,1.26456463739995,611,240,371,-2,1.5,50.29,4.8,0,0,0,0,0,0,0.0800662531814024,32.7121807100541,9.34680817300589
9.7,"greedy_SVM","SVM",83,14,1284,1269,15,1500,1257,243,0.827813581572997,0.278195488721804,1.27421780257094,638,243,395,27,1.6,53.88,5.2,0,0,0,0,0,0,0.105766927611666,49.6361297664588,12.364237362167
9.7,"greedy_SVM","SVM",83,15,1184,1175,9,1600,1351,249,0.793077932927571,0.195488721804511,1.27421780257094,663,249,414,25,1.7,57.47,5.4,0,0,0,0,0,0,0.127471195449658,56.7509545458789,14.8690944354142
9.7,"greedy_SVM","SVM",83,16,1084,1079,5,1700,1447,253,0.784640171858232,0.203007518796992,1.27421780257094,676,253,423,13,1.7,61.06,5.7,0,0,0,0,0,0,0.0933231489959554,35.2971805477005,11.2378927021948
9.7,"greedy_SVM","SVM",83,17,984,979,5,1800,1547,253,0.782104069698068,0.225563909774436,1.27421780257094,691,253,438,15,1.7,64.66,6.1,0,0,0,0,0,0,0.0829841411982804,32.6179655667565,9.7005073237828
9.7,"greedy_SVM","SVM",83,18,884,882,2,1900,1644,256,0.793406134383592,0.225563909774436,1.27421780257094,701,256,445,10,1.7,68.25,6.4,0,0,0,0,0,0,0.0632863767326514,23.1897054786054,8.32586339582784
9.7,"greedy_SVM","SVM",83,19,784,782,2,2000,1744,256,0.793048096431569,0.225563909774436,1.27421780257094,705,256,449,4,1.8,71.84,6.8,0,0,0,0,0,0,0.0305605139673898,8.61998117825172,3.89512134237587
9.7,"greedy_SVM","SVM",83,20,684,683,1,2100,1843,257,0.787552213868016,0.218045112781955,1.27421780257094,718,257,461,13,1.8,75.43,7.2,0,0,0,0,0,0,0.0458465014114733,15.0397683748919,6.34870084057457
9.7,"greedy_SVM","SVM",83,21,584,583,1,2200,1943,257,0.807626208378103,0.233082706766917,1.27421780257094,722,257,465,4,1.8,79.02,7.6,0,0,0,0,0,0,0.014097609579924,3.38044461357864,1.9731123392177
9.7,"greedy_SVM","SVM",83,22,484,483,1,2300,2043,257,0.78978398376896,0.233082706766917,1.27421780257094,706,257,449,-16,1.7,82.61,7.9,0,0,0,0,0,0,0.017385739789961,4.39615538294995,2.48486371636324
9.7,"greedy_SVM","SVM",83,23,384,383,1,2400,2143,257,0.799409237379176,0.263157894736842,1.27421780257094,703,257,446,-3,1.7,86.21,8.3,0,0,0,0,0,0,0.00586463487529504,1.43013119411526,1.10574351775847
9.7,"greedy_SVM","SVM",83,24,284,284,0,2500,2242,258,0.781041890440394,0.203007518796992,1.27421780257094,714,258,456,11,1.8,89.8,8.7,0,0,0,0,0,0,0.0350406322572248,9.57325759636439,8.40211213250813
9.7,"greedy_SVM","SVM",83,25,184,184,0,2600,2342,258,0.695345506623704,0.150375939849624,1.27421780257094,718,258,460,4,1.8,93.39,9.1,0,0,0,0,0,0,1.86221701909652e-05,1.24409175410207,1.24370324266259
9.7,"greedy_SVM","SVM",83,26,84,84,0,2700,2442,258,0.731155269125198,0.172932330827068,1.27421780257094,724,258,466,6,1.8,96.98,9.5,0,0,0,0,0,0,1.09175173984682e-08,0.0234778616864082,0.0234778616864082
9.7,"greedy_SVM","SVM",83,27,0,0,0,2784,2526,258,0.731865377730045,0.157894736842105,1.27421780257094,727,258,469,3,1.8,100,9.8,0,0,0,0,0,0,0,0,0
9.7,"greedy_SVM","SVM",84,0,2684,2427,257,100,91,9,0.695293375394325,0.272,1.15034838709677,32,9,23,0,2.6,3.59,10.1,0,0,0,0,0,0,0.0922055348330751,245.980510832636,9.22759395485429
9.7,"greedy_SVM","SVM",84,1,2584,2361,223,200,157,43,0.731015772870668,0.12,1.24278709677419,109,43,66,77,1.5,7.18,3.7,0,0,0,0,0,0,0.227589595989037,539.611555247865,23.3502626423914
9.7,"greedy_SVM","SVM",84,2,2484,2267,217,300,251,49,0.73292113564669,0.104,1.25305806451613,138,49,89,29,1.8,10.78,5.1,0,0,0,0,0,0,0.20774152335588,366.58424059805,22.3907435371414
9.7,"greedy_SVM","SVM",84,3,2384,2171,213,400,347,53,0.75158990536278,0.24,1.23251612903226,155,53,102,17,1.9,14.37,6.5,0,0,0,0,0,0,0.212138971115163,232.267725763998,33.2435928423949
9.7,"greedy_SVM","SVM",84,4,2284,2089,195,500,429,71,0.81321766561514,0.24,1.26332903225806,217,71,146,62,2.1,17.96,6,0,0,0,0,0,0,0.17243825431462,248.318871547996,17.7854626613111
9.7,"greedy_SVM","SVM",84,5,2184,2022,162,600,496,104,0.825242902208208,0.336,1.23251612903226,271,104,167,54,1.6,21.55,4.8,0,0,0,0,0,0,0.214672522638698,225.372279819352,23.9063268285811
9.7,"greedy_SVM","SVM",84,6,2084,1953,131,700,565,135,0.821533123028395,0.28,1.2736,352,135,217,81,1.6,25.14,4.2,0,0,0,0,0,0,0.221701184267674,228.347638612882,24.4545732738665
9.7,"greedy_SVM","SVM",84,7,1984,1882,102,800,636,164,0.813968454258681,0.296,1.23251612903226,407,164,243,55,1.5,28.74,3.9,0,0,0,0,0,0,0.222860056768593,195.108379657161,24.6729876209876
9.7,"greedy_SVM","SVM",84,8,1884,1801,83,900,717,183,0.801110410094645,0.232,1.25305806451613,459,183,276,52,1.5,32.33,3.9,0,0,0,0,0,0,0.209320114447106,162.858793288948,22.3261762307164
9.7,"greedy_SVM","SVM",84,9,1784,1714,70,1000,804,196,0.80704731861199,0.28,1.26332903225806,509,196,313,50,1.6,35.92,4.1,0,0,0,0,0,0,0.185858619517474,164.559532740939,19.8005511346471
9.7,"greedy_SVM","SVM",84,10,1684,1625,59,1100,893,207,0.817716088328077,0.272,1.26332903225806,527,207,320,18,1.5,39.51,4.3,0,0,0,0,0,0,0.129940884763059,62.2456620635408,15.7143574113552
9.7,"greedy_SVM","SVM",84,11,1584,1541,43,1200,977,223,0.825432176656152,0.28,1.26332903225806,563,223,340,36,1.5,43.1,4.4,0,0,0,0,0,0,0.137536768199017,108.390014453258,17.6521134192743
9.7,"greedy_SVM","SVM",84,12,1484,1447,37,1300,1071,229,0.821110410094639,0.232,1.26332903225806,598,229,369,35,1.6,46.7,4.7,0,0,0,0,0,0,0.0894933278997665,49.8160187080042,10.8573892264186
9.7,"greedy_SVM","SVM",84,13,1384,1351,33,1400,1167,233,0.797671924290226,0.176,1.26332903225806,618,233,385,20,1.7,50.29,5,0,0,0,0,0,0,0.145122357555951,115.418636272562,17.8302701824303
9.7,"greedy_SVM","SVM",84,14,1284,1253,31,1500,1265,235,0.814113564668774,0.2,1.2736,615,235,380,-3,1.6,53.88,5.4,0,0,0,0,0,0,0.116546613185537,62.9876835755343,14.9478096919367
9.7,"greedy_SVM","SVM",84,15,1184,1158,26,1600,1360,240,0.821211356466881,0.24,1.26332903225806,620,240,380,5,1.6,57.47,5.7,0,0,0,0,0,0,0.0758792416823935,39.1750687175172,9.90092167147231
9.7,"greedy_SVM","SVM",84,16,1084,1063,21,1700,1455,245,0.811110410094642,0.184,1.28387096774194,663,245,418,43,1.7,61.06,5.9,0,0,0,0,0,0,0.0884336814912777,41.8443133725085,10.9735397831752
9.7,"greedy_SVM","SVM",84,17,984,972,12,1800,1546,254,0.828725552050477,0.248,1.28387096774194,683,254,429,20,1.7,64.66,6.1,0,0,0,0,0,0,0.115470280233024,40.4230116913959,14.9653341843076
9.7,"greedy_SVM","SVM",84,18,884,879,5,1900,1639,261,0.828839116719241,0.28,1.28387096774194,709,261,448,26,1.7,68.25,6.3,0,0,0,0,0,0,0.0694048689074685,25.4531876262648,8.60311745959086
9.7,"greedy_SVM","SVM",84,19,784,781,3,2000,1737,263,0.811892744479496,0.216,1.28387096774194,711,263,448,2,1.7,71.84,6.6,0,0,0,0,0,0,0.0385781196835985,11.6675330514891,5.30500334437043
9.7,"greedy_SVM","SVM",84,20,684,681,3,2100,1837,263,0.822132492113567,0.216,1.28387096774194,715,263,452,4,1.7,75.43,7,0,0,0,0,0,0,0.0226997022224936,6.51007021438985,3.46169479423128
9.7,"greedy_SVM","SVM",84,21,584,581,3,2200,1937,263,0.810403785488957,0.176,1.28387096774194,707,263,444,-8,1.7,79.02,7.4,0,0,0,0,0,0,0.00763356158018822,1.95261485490006,1.29963872825555
9.7,"greedy_SVM","SVM",84,22,484,482,2,2300,2036,264,0.803621451104105,0.224,1.2736,731,264,467,24,1.8,82.61,7.7,0,0,0,0,0,0,0.0172029810107584,8.34713547364235,7.21956893414772
9.7,"greedy_SVM","SVM",84,23,384,382,2,2400,2136,264,0.79993690851735,0.192,1.28387096774194,736,264,472,5,1.8,86.21,8.1,0,0,0,0,0,0,0.00237793957817934,0.856652691299761,0.741175451699629
9.7,"greedy_SVM","SVM",84,24,284,283,1,2500,2235,265,0.809949526813881,0.176,1.28387096774194,726,265,461,-10,1.7,89.8,8.4,0,0,0,0,0,0,0.000508344441988453,3.30692863900971,3.28701266977235
9.7,"greedy_SVM","SVM",84,25,184,184,0,2600,2334,266,0.801671924290224,0.232,1.28387096774194,733,266,467,7,1.8,93.39,8.8,0,0,0,0,0,0,0.000404551205504685,1.03470603950955,1.02534323474404
9.7,"greedy_SVM","SVM",84,26,84,84,0,2700,2434,266,0.760138801261826,0.144,1.28387096774194,762,266,496,29,1.9,96.98,9.2,0,0,0,0,0,0,1.0000000994736e-07,0.00350334650299321,0.00350334650299321
9.7,"greedy_SVM","SVM",84,27,0,0,0,2784,2518,266,0.804706624605677,0.224,1.28387096774194,732,266,466,-30,1.8,100,9.5,0,0,0,0,0,0,0,0,0
9.7,"greedy_SVM","SVM",85,0,2684,2448,236,100,95,5,0.798047733976935,0.24,1.26675268817204,20,5,15,0,3,3.59,19,0,0,0,0,0,0,0.0889799910533154,141.366193397645,10.5577811974073
9.7,"greedy_SVM","SVM",85,1,2584,2363,221,200,180,20,0.803555913113426,0.3,1.23251612903226,58,20,38,38,1.9,7.18,9,0,0,0,0,0,0,0.11974863188448,207.809186147416,13.2762432553716
9.7,"greedy_SVM","SVM",85,2,2484,2285,199,300,258,42,0.815274872619996,0.38,1.23251612903226,111,42,69,53,1.6,10.78,6.1,0,0,0,0,0,0,0.161616915270687,242.170917947869,16.9942341715635
9.7,"greedy_SVM","SVM",85,3,2384,2209,175,400,334,66,0.818685974792159,0.413333333333333,1.24963440860215,175,66,109,64,1.7,14.37,5.1,0,0,0,0,0,0,0.190686260556748,230.566725285086,19.8589103568851
9.7,"greedy_SVM","SVM",85,4,2284,2142,142,500,401,99,0.820659694288003,0.393333333333333,1.2410752688172,252,99,153,77,1.5,17.96,4.1,0,0,0,0,0,0,0.210815808826297,275.645810854701,21.4404247623498
9.7,"greedy_SVM","SVM",85,5,2184,2076,108,600,467,133,0.82128184499865,0.393333333333333,1.24963440860215,329,133,196,77,1.5,21.55,3.5,0,0,0,0,0,0,0.222826027501476,209.069391080095,23.2357760848883
9.7,"greedy_SVM","SVM",85,6,2084,1999,85,700,544,156,0.819361759184764,0.32,1.2581935483871,370,156,214,41,1.4,25.14,3.5,0,0,0,0,0,0,0.216040366748279,192.435628020019,23.2607372415523
9.7,"greedy_SVM","SVM",85,7,1984,1908,76,800,635,165,0.825872888173769,0.346666666666667,1.24963440860215,396,165,231,26,1.4,28.74,3.8,0,0,0,0,0,0,0.194046977622235,233.631279021422,20.1245778735856
9.7,"greedy_SVM","SVM",85,8,1884,1820,64,900,723,177,0.816637168141586,0.326666666666667,1.24963440860215,427,177,250,31,1.4,32.33,4.1,0,0,0,0,0,0,0.169579950478886,179.026600958601,18.3116307914467
9.7,"greedy_SVM","SVM",85,9,1784,1741,43,1000,802,198,0.81251273799946,0.326666666666667,1.2581935483871,481,198,283,54,1.4,35.92,4.1,0,0,0,0,0,0,0.179464393691943,186.437572523957,18.8995313715183
9.7,"greedy_SVM","SVM",85,10,1684,1648,36,1100,895,205,0.807900241351565,0.306666666666667,1.24963440860215,515,205,310,34,1.5,39.51,4.4,0,0,0,0,0,0,0.148484327321496,117.820922581025,16.6274567936347
9.7,"greedy_SVM","SVM",85,11,1584,1551,33,1200,992,208,0.800166264414047,0.293333333333333,1.2410752688172,511,208,303,-4,1.5,43.1,4.8,0,0,0,0,0,0,0.12187207732436,99.8341800893272,13.3176984903437
9.7,"greedy_SVM","SVM",85,12,1484,1459,25,1300,1084,216,0.758197908286393,0.166666666666667,1.21539784946237,545,216,329,34,1.5,46.7,5,0,0,0,0,0,0,0.185537761550769,136.619619653919,20.4846064506268
9.7,"greedy_SVM","SVM",85,13,1384,1364,20,1400,1179,221,0.799608474121737,0.28,1.23251612903226,557,221,336,12,1.5,50.29,5.3,0,0,0,0,0,0,0.14551288672766,70.5458505345803,17.2229975383655
9.7,"greedy_SVM","SVM",85,14,1284,1269,15,1500,1274,226,0.797076964333591,0.266666666666667,1.22395698924731,584,226,358,27,1.6,53.88,5.6,0,0,0,0,0,0,0.124946598868758,75.3494952110115,13.9668664421378
9.7,"greedy_SVM","SVM",85,15,1184,1172,12,1600,1371,229,0.801732367927048,0.266666666666667,1.23251612903226,594,229,365,10,1.6,57.47,6,0,0,0,0,0,0,0.104413196385077,59.1239564989087,11.3686856981488
9.7,"greedy_SVM","SVM",85,16,1084,1072,12,1700,1471,229,0.806296594261185,0.326666666666667,1.22395698924731,592,229,363,-2,1.6,61.06,6.4,0,0,0,0,0,0,0.0692155461803975,34.3565754658107,7.98462304127842
9.7,"greedy_SVM","SVM",85,17,984,972,12,1800,1571,229,0.803191204076148,0.293333333333333,1.22395698924731,585,229,356,-7,1.6,64.66,6.9,0,0,0,0,0,0,0.0634980616122671,31.1849270049639,7.07603157222583
9.7,"greedy_SVM","SVM",85,18,884,876,8,1900,1667,233,0.781871815500123,0.266666666666667,1.21539784946237,603,233,370,18,1.6,68.25,7.2,0,0,0,0,0,0,0.0959176765228994,49.5677731380259,11.5410111630994
9.7,"greedy_SVM","SVM",85,19,784,777,7,2000,1766,234,0.770581925449174,0.24,1.21539784946237,630,234,396,27,1.7,71.84,7.5,0,0,0,0,0,0,0.0804547892118029,40.8969114086597,9.25284173686291
9.7,"greedy_SVM","SVM",85,20,684,677,7,2100,1866,234,0.799490480021439,0.313333333333333,1.22395698924731,629,234,395,-1,1.7,75.43,8,0,0,0,0,0,0,0.049025496536811,19.3080450587173,5.76353516774453
9.7,"greedy_SVM","SVM",85,21,584,579,5,2200,1964,236,0.760005363368188,0.193333333333333,1.22395698924731,628,236,392,-1,1.7,79.02,8.3,0,0,0,0,0,0,0.0420232781141696,14.5351612062693,5.39231240877302
9.7,"greedy_SVM","SVM",85,22,484,480,4,2300,2063,237,0.749648699383207,0.166666666666667,1.2410752688172,640,237,403,12,1.7,82.61,8.7,0,0,0,0,0,0,0.0260937916746526,8.59897342635887,3.59938106992017
9.7,"greedy_SVM","SVM",85,23,384,383,1,2400,2160,240,0.805406275140785,0.306666666666667,1.26675268817204,645,240,405,5,1.7,86.21,9,0,0,0,0,0,0,0.0172999073794944,5.18944623072505,3.58286171762892
9.7,"greedy_SVM","SVM",85,24,284,284,0,2500,2259,241,0.755553767766157,0.18,1.24963440860215,656,241,415,11,1.7,89.8,9.4,0,0,0,0,0,0,0.00367289935778796,1.10235350568264,0.866546443869317
9.7,"greedy_SVM","SVM",85,25,184,184,0,2600,2359,241,0.810442477876107,0.326666666666667,1.24963440860215,660,241,419,4,1.7,93.39,9.8,0,0,0,0,0,0,0.000513482233588313,0.173508735704217,0.151353735280219
9.7,"greedy_SVM","SVM",85,26,84,84,0,2700,2459,241,0.801013676588897,0.293333333333333,1.24963440860215,663,241,422,3,1.8,96.98,10.2,0,0,0,0,0,0,3.65084654745956e-06,0.0632638789104738,0.0632638789104738
9.7,"greedy_SVM","SVM",85,27,0,0,0,2784,2543,241,0.749852507374633,0.173333333333333,1.24963440860215,654,241,413,-9,1.7,100,10.6,0,0,0,0,0,0,0,0,0
9.7,"greedy_SVM","SVM",86,0,2684,2439,245,100,91,9,0.739457901343624,0.328467153284672,1.19952907935013,23,9,14,0,1.6,3.59,10.1,0,0,0,0,0,0,0.213160326387336,233.116954659509,27.2201570336294
9.7,"greedy_SVM","SVM",86,1,2584,2363,221,200,167,33,0.784776140220375,0.291970802919708,1.25575700494467,84,33,51,61,1.5,7.18,5.1,0,0,0,0,0,0,0.237048133178454,351.101963245451,26.2051107260512
9.7,"greedy_SVM","SVM",86,2,2484,2290,194,300,240,60,0.730804546933848,0.18978102189781,1.24638568401224,156,60,96,72,1.6,10.78,4,0,0,0,0,0,0,0.237187021665206,414.711378067833,25.465356506542
9.7,"greedy_SVM","SVM",86,3,2384,2197,187,400,333,67,0.782718861871774,0.233576642335766,1.28387096774194,173,67,106,17,1.6,14.37,5,0,0,0,0,0,0,0.184578074365634,362.603990021622,21.0360389599385
9.7,"greedy_SVM","SVM",86,4,2284,2111,173,500,419,81,0.759466967316007,0.18978102189781,1.24638568401224,200,81,119,27,1.5,17.96,5.2,0,0,0,0,0,0,0.195766131068222,237.734367707564,22.0645892936828
9.7,"greedy_SVM","SVM",86,5,2184,2023,161,600,507,93,0.798944627830214,0.255474452554745,1.27449964680951,244,93,151,44,1.6,21.55,5.5,0,0,0,0,0,0,0.172599395008274,270.61159520709,17.6533976834802
9.7,"greedy_SVM","SVM",86,6,2084,1951,133,700,579,121,0.818256311311548,0.313868613138686,1.27449964680951,307,121,186,63,1.5,25.14,4.8,0,0,0,0,0,0,0.193068886364169,199.42000227406,19.7286137023643
9.7,"greedy_SVM","SVM",86,7,1984,1881,103,800,649,151,0.821702543121487,0.335766423357664,1.27449964680951,373,151,222,66,1.5,28.74,4.3,0,0,0,0,0,0,0.195922256414697,181.57301429651,20.3943590573992
9.7,"greedy_SVM","SVM",86,8,1884,1794,90,900,736,164,0.832262076340141,0.291970802919708,1.27449964680951,400,164,236,27,1.4,32.33,4.5,0,0,0,0,0,0,0.176220353153199,172.235454906851,18.6390677902161
9.7,"greedy_SVM","SVM",86,9,1784,1720,64,1000,810,190,0.840927053791441,0.328467153284672,1.26512832587709,470,190,280,70,1.5,35.92,4.3,0,0,0,0,0,0,0.19002809977831,203.122030905395,20.2244219612007
9.7,"greedy_SVM","SVM",86,10,1684,1631,53,1100,899,201,0.836126737644712,0.313868613138686,1.26512832587709,499,201,298,29,1.5,39.51,4.5,0,0,0,0,0,0,0.164297828941437,163.446865078813,17.2560934108874
9.7,"greedy_SVM","SVM",86,11,1584,1537,47,1200,993,207,0.825154586452187,0.277372262773723,1.27449964680951,519,207,312,20,1.5,43.1,4.8,0,0,0,0,0,0,0.145982414187537,108.638999024573,15.8199066341497
9.7,"greedy_SVM","SVM",86,12,1484,1448,36,1300,1082,218,0.82325421916408,0.262773722627737,1.27449964680951,554,218,336,35,1.5,46.7,5,0,0,0,0,0,0,0.141590249998798,97.5125307377121,15.6825972189771
9.7,"greedy_SVM","SVM",86,13,1384,1354,30,1400,1176,224,0.83024547863686,0.277372262773723,1.25575700494467,572,224,348,18,1.6,50.29,5.2,0,0,0,0,0,0,0.113480803100225,59.3737025855249,12.7545600518845
9.7,"greedy_SVM","SVM",86,14,1284,1261,23,1500,1269,231,0.793470175275472,0.218978102189781,1.25575700494467,608,231,377,36,1.6,53.88,5.5,0,0,0,0,0,0,0.130432389460851,81.4449076215949,13.8738072360685
9.7,"greedy_SVM","SVM",86,15,1184,1166,18,1600,1364,236,0.814821702543127,0.255474452554745,1.25575700494467,634,236,398,26,1.7,57.47,5.8,0,0,0,0,0,0,0.119249188920158,59.9154814349544,13.1651855947944
9.7,"greedy_SVM","SVM",86,16,1084,1070,14,1700,1460,240,0.811671858291882,0.240875912408759,1.25575700494467,635,240,395,1,1.6,61.06,6.1,0,0,0,0,0,0,0.126108105430685,92.6405314825619,13.4339356102261
9.7,"greedy_SVM","SVM",86,17,984,970,14,1800,1560,240,0.826008880003723,0.240875912408759,1.25575700494467,638,240,398,3,1.7,64.66,6.5,0,0,0,0,0,0,0.0881172837710811,43.1409067410578,9.73234679470621
9.7,"greedy_SVM","SVM",86,18,884,871,13,1900,1659,241,0.80669138500163,0.204379562043796,1.24638568401224,639,241,398,1,1.7,68.25,6.9,0,0,0,0,0,0,0.0712737453385287,31.6582407644704,8.32478524873742
9.7,"greedy_SVM","SVM",86,19,784,772,12,2000,1758,242,0.807888558277931,0.218978102189781,1.24638568401224,653,242,411,14,1.7,71.84,7.3,0,0,0,0,0,0,0.0369852633358327,12.6367689753971,4.97240289096129
9.7,"greedy_SVM","SVM",86,20,684,672,12,2100,1858,242,0.787914361430103,0.175182481751825,1.24523799922034,665,242,423,12,1.7,75.43,7.7,0,0,0,0,0,0,0.024569203443742,7.50674867537934,3.11723357466481
9.7,"greedy_SVM","SVM",86,21,584,576,8,2200,1954,246,0.813426937561019,0.233576642335766,1.24638568401224,666,246,420,1,1.7,79.02,7.9,0,0,0,0,0,0,0.0257920031041598,9.28431085928973,4.55472865988305
9.7,"greedy_SVM","SVM",86,22,484,477,7,2300,2053,247,0.819970709935378,0.27007299270073,1.25575700494467,675,247,428,9,1.7,82.61,8.3,0,0,0,0,0,0,0.0275163176412491,7.62580835381927,3.7379578584934
9.7,"greedy_SVM","SVM",86,23,384,380,4,2400,2150,250,0.801519131526343,0.204379562043796,1.27449964680951,677,250,427,2,1.7,86.21,8.6,0,0,0,0,0,0,0.0214884784506012,6.38931109003195,4.42278278773762
9.7,"greedy_SVM","SVM",86,24,284,283,1,2500,2247,253,0.831779720117164,0.240875912408759,1.27449964680951,713,253,460,36,1.8,89.8,8.9,0,0,0,0,0,0,0.0081590645097024,2.19277337518583,1.41524589235039
9.7,"greedy_SVM","SVM",86,25,184,184,0,2600,2346,254,0.833604537635413,0.284671532846715,1.27332607439072,714,254,460,1,1.8,93.39,9.2,0,0,0,0,0,0,0.00178506009544229,1.97496886149965,1.92591993108274
9.7,"greedy_SVM","SVM",86,26,84,84,0,2700,2446,254,0.811689292854155,0.255474452554745,1.27449964680951,712,254,458,-2,1.8,96.98,9.6,0,0,0,0,0,0,2.10053571708854e-06,0.0392189201581782,0.0392189201581782
9.7,"greedy_SVM","SVM",86,27,0,0,0,2784,2530,254,0.801060021386399,0.262773722627737,1.27449964680951,705,254,451,-7,1.8,100,10,0,0,0,0,0,0,0,0,0
9.7,"greedy_SVM","SVM",87,0,2684,2439,245,100,95,5,0.838964040513903,0.24822695035461,1.28387096774194,22,5,17,0,3.4,3.59,19,0,0,0,0,0,0,0.0934053779978661,139.012605601764,10.7074727457377
9.7,"greedy_SVM","SVM",87,1,2584,2358,226,200,176,24,0.81052726984343,0.226950354609929,1.28387096774194,69,24,45,47,1.9,7.18,7.3,0,0,0,0,0,0,0.193896234373082,175.482249557723,22.1625268357154
9.7,"greedy_SVM","SVM",87,2,2484,2289,195,300,245,55,0.825589694786216,0.269503546099291,1.28387096774194,142,55,87,73,1.6,10.78,4.5,0,0,0,0,0,0,0.223503279498185,162.527476920797,24.9689805979681
9.7,"greedy_SVM","SVM",87,3,2384,2216,168,400,318,82,0.830348038882471,0.319148936170213,1.28387096774194,211,82,129,69,1.6,14.37,3.9,0,0,0,0,0,0,0.218952506779306,183.617772889566,22.8874116096459
9.7,"greedy_SVM","SVM",87,4,2284,2146,138,500,388,112,0.846424444293388,0.340425531914894,1.28387096774194,286,112,174,75,1.6,17.96,3.5,0,0,0,0,0,0,0.241105196481893,201.258205545148,24.9927246118402
9.7,"greedy_SVM","SVM",87,5,2184,2071,113,600,463,137,0.842804703963023,0.340425531914894,1.28387096774194,352,137,215,66,1.6,21.55,3.4,0,0,0,0,0,0,0.231706402917985,186.571694604596,23.8348259458149
9.7,"greedy_SVM","SVM",87,6,2084,1995,89,700,539,161,0.832257041216326,0.276595744680851,1.28387096774194,404,161,243,52,1.5,25.14,3.3,0,0,0,0,0,0,0.238393792517167,225.64664887703,26.9255618712853
9.7,"greedy_SVM","SVM",87,7,1984,1915,69,800,619,181,0.813931751750401,0.234042553191489,1.24744909631663,451,181,270,47,1.5,28.74,3.4,0,0,0,0,0,0,0.260218271524798,205.683668913649,70.1189187468772
9.7,"greedy_SVM","SVM",87,8,1884,1828,56,900,706,194,0.815059026125585,0.24822695035461,1.25655456417296,474,194,280,23,1.4,32.33,3.6,0,0,0,0,0,0,0.218675434234838,207.648920351403,28.1855940780289
9.7,"greedy_SVM","SVM",87,9,1784,1742,42,1000,792,208,0.838329594634406,0.297872340425532,1.27476549988561,512,208,304,38,1.5,35.92,3.8,0,0,0,0,0,0,0.189631947069287,107.77565937247,20.3955248823542
9.7,"greedy_SVM","SVM",87,10,1684,1652,32,1100,882,218,0.825159177939415,0.283687943262411,1.27476549988561,550,218,332,38,1.5,39.51,4,0,0,0,0,0,0,0.182943533428897,102.63370892453,19.5059767929147
9.7,"greedy_SVM","SVM",87,11,1584,1561,23,1200,973,227,0.837372261119801,0.312056737588652,1.27476549988561,589,227,362,39,1.6,43.1,4.3,0,0,0,0,0,0,0.164173320715161,100.335838172907,17.6221440474879
9.7,"greedy_SVM","SVM",87,12,1484,1464,20,1300,1070,230,0.814594521106659,0.24113475177305,1.27476549988561,578,230,348,-11,1.5,46.7,4.7,0,0,0,0,0,0,0.135129468756224,68.792101546004,14.7174238624431
9.7,"greedy_SVM","SVM",87,13,1384,1366,18,1400,1168,232,0.812759159812392,0.219858156028369,1.25655456417296,608,232,376,30,1.6,50.29,5,0,0,0,0,0,0,0.114088172554333,59.5871999125639,12.7628584207753
9.7,"greedy_SVM","SVM",87,14,1284,1270,14,1500,1264,236,0.814974055695289,0.24822695035461,1.27476549988561,608,236,372,0,1.6,53.88,5.4,0,0,0,0,0,0,0.0959469789051764,50.1031908399113,11.1026016476313
9.7,"greedy_SVM","SVM",87,15,1184,1171,13,1600,1363,237,0.798495456914334,0.24822695035461,1.24744909631663,624,237,387,16,1.6,57.47,5.8,0,0,0,0,0,0,0.0905023946011632,48.4272238988959,12.669472830358
9.7,"greedy_SVM","SVM",87,16,1084,1072,12,1700,1462,238,0.802432420184449,0.25531914893617,1.23834362846031,622,238,384,-2,1.6,61.06,6.1,0,0,0,0,0,0,0.0970244175771787,54.7472644291863,11.0462333740284
9.7,"greedy_SVM","SVM",87,17,984,973,11,1800,1561,239,0.768121360433244,0.148936170212766,1.22013269274766,638,239,399,16,1.7,64.66,6.5,0,0,0,0,0,0,0.069340942663711,26.7440442736894,8.72973648233707
9.7,"greedy_SVM","SVM",87,18,884,873,11,1900,1661,239,0.769095688033905,0.177304964539007,1.22013269274766,622,239,383,-16,1.6,68.25,6.9,0,0,0,0,0,0,0.0320013347265749,9.97463000342852,4.14338093927673
9.7,"greedy_SVM","SVM",87,19,784,773,11,2000,1761,239,0.769276958285191,0.177304964539007,1.22923816060398,635,239,396,13,1.7,71.84,7.4,0,0,0,0,0,0,0.0337640574617161,11.1374461951597,4.22799103030243
9.7,"greedy_SVM","SVM",87,20,684,674,10,2100,1860,240,0.781354088777112,0.212765957446809,1.22923816060398,623,240,383,-12,1.6,75.43,7.8,0,0,0,0,0,0,0.0375836744494582,13.674638524167,4.52541171496788
9.7,"greedy_SVM","SVM",87,21,584,574,10,2200,1960,240,0.794909704756085,0.24822695035461,1.22923816060398,635,240,395,12,1.6,79.02,8.2,0,0,0,0,0,0,0.0255051719840583,7.87590286866262,2.96296984328809
9.7,"greedy_SVM","SVM",87,22,484,475,9,2300,2059,241,0.753381823125558,0.141843971631206,1.22013269274766,655,241,414,20,1.7,82.61,8.5,0,0,0,0,0,0,0.0179101727078385,5.54017715231935,3.2356965161165
9.7,"greedy_SVM","SVM",87,23,384,377,7,2400,2157,243,0.774471483923596,0.198581560283688,1.23834362846031,661,243,418,6,1.7,86.21,8.9,0,0,0,0,0,0,0.00916594707407812,2.61048114000421,2.37915473420806
9.7,"greedy_SVM","SVM",87,24,284,282,2,2500,2252,248,0.786899825527387,0.170212765957447,1.28387096774194,683,248,435,22,1.8,89.8,9.1,0,0,0,0,0,0,0.0044238687524454,1.13380962501311,0.977283858244196
9.7,"greedy_SVM","SVM",87,25,184,184,0,2600,2350,250,0.724588176647862,0.127659574468085,1.26566003202928,707,250,457,24,1.8,93.39,9.4,0,0,0,0,0,0,0.0150743014841882,7.34758552301855,6.94036279753885
9.7,"greedy_SVM","SVM",87,26,84,84,0,2700,2450,250,0.735209480434147,0.120567375886525,1.26566003202928,700,250,450,-7,1.8,96.98,9.8,0,0,0,0,0,0,4.64472562068324e-06,1.06186297643869,1.06186297643869
9.7,"greedy_SVM","SVM",87,27,0,0,0,2784,2534,250,0.742137402850479,0.141843971631206,1.26566003202928,698,250,448,-2,1.8,100,10.1,0,0,0,0,0,0,0,0,0
9.7,"greedy_SVM","SVM",88,0,2684,2437,247,100,91,9,0.296543602425955,0,0.884444444444444,30,9,21,0,2.3,3.59,10.1,0,0,0,0,0,0,0.10722181476408,231.407978443099,11.0637891066331
9.7,"greedy_SVM","SVM",88,1,2584,2337,247,200,191,9,0.708579167402694,0.111111111111111,1.26485065710872,31,9,22,1,2.4,7.18,21.2,0,0,0,0,0,0,0.0554627695882762,130.253695555175,6.64750767295549
9.7,"greedy_SVM","SVM",88,2,2484,2247,237,300,281,19,0.62668550903845,0.177777777777778,1.25534050179211,73,19,54,42,2.8,10.78,14.8,0,0,0,0,0,0,0.0920145159806768,194.329304550391,9.67830755501129
9.7,"greedy_SVM","SVM",88,3,2384,2165,219,400,363,37,0.652134487428607,0.125925925925926,1.22681003584229,115,37,78,42,2.1,14.37,9.8,0,0,0,0,0,0,0.13838252847135,231.230819153548,16.5145036299735
9.7,"greedy_SVM","SVM",88,4,2284,2070,214,500,458,42,0.695542601424958,0.162962962962963,1.26485065710872,125,42,83,10,2,17.96,10.9,0,0,0,0,0,0,0.116985746555659,209.406341163572,12.2605901968479
9.7,"greedy_SVM","SVM",88,5,2184,1979,205,600,549,51,0.674874874874878,0.22962962962963,1.19827956989247,159,51,108,34,2.1,21.55,10.8,0,0,0,0,0,0,0.110772543261379,172.501591890556,14.9065158426416
9.7,"greedy_SVM","SVM",88,6,2084,1899,185,700,629,71,0.77096508272979,0.296296296296296,1.26485065710872,197,71,126,38,1.8,25.14,8.9,0,0,0,0,0,0,0.12233367816778,176.547420114721,12.7785996304611
9.7,"greedy_SVM","SVM",88,7,1984,1829,155,800,699,101,0.772207501619268,0.266666666666667,1.26485065710872,275,101,174,78,1.7,28.74,6.9,0,0,0,0,0,0,0.154335094671697,179.458650746083,15.9656100084099
9.7,"greedy_SVM","SVM",88,8,1884,1754,130,900,774,126,0.777574633456988,0.288888888888889,1.26368596957916,339,126,213,64,1.7,32.33,6.1,0,0,0,0,0,0,0.16242584233612,189.141711783435,16.7974645869043
9.7,"greedy_SVM","SVM",88,9,1784,1680,104,1000,848,152,0.814973797326741,0.355555555555556,1.26485065710872,393,152,241,54,1.6,35.92,5.6,0,0,0,0,0,0,0.173699001223204,163.667016498867,18.2752203149698
9.7,"greedy_SVM","SVM",88,10,1684,1608,76,1100,920,180,0.808885355944183,0.281481481481481,1.26485065710872,454,180,274,61,1.5,39.51,5.1,0,0,0,0,0,0,0.182083311020204,158.55429084474,19.3800910908577
9.7,"greedy_SVM","SVM",88,11,1584,1524,60,1200,1004,196,0.77673555908851,0.266666666666667,1.25534050179211,494,196,298,40,1.5,43.1,5.1,0,0,0,0,0,0,0.172267458351183,163.720137533043,18.0958242948182
9.7,"greedy_SVM","SVM",88,12,1484,1432,52,1300,1096,204,0.82921745274687,0.340740740740741,1.26485065710872,509,204,305,15,1.5,46.7,5.4,0,0,0,0,0,0,0.152982068484843,101.25110672283,16.6089951695993
9.7,"greedy_SVM","SVM",88,13,1384,1351,33,1400,1177,223,0.798504386739687,0.251851851851852,1.26485065710872,559,223,336,50,1.5,50.29,5.3,0,0,0,0,0,0,0.164344656453457,129.827799308212,17.753278826465
9.7,"greedy_SVM","SVM",88,14,1284,1263,21,1500,1265,235,0.80704822469529,0.266666666666667,1.25534050179211,609,235,374,50,1.6,53.88,5.4,0,0,0,0,0,0,0.144495485164354,105.844054512643,16.1339654639395
9.7,"greedy_SVM","SVM",88,15,1184,1172,12,1600,1356,244,0.775958311252429,0.222222222222222,1.2363201911589,637,244,393,28,1.6,57.47,5.6,0,0,0,0,0,0,0.148762188220809,115.596874929626,15.6440414253199
9.7,"greedy_SVM","SVM",88,16,1084,1075,9,1700,1453,247,0.734516869810984,0.177777777777778,1.21729988052569,674,247,427,37,1.7,61.06,5.9,0,0,0,0,0,0,0.149045560496367,103.083137568658,16.2851177508952
9.7,"greedy_SVM","SVM",88,17,984,976,8,1800,1552,248,0.757051168815874,0.2,1.21729988052569,679,248,431,5,1.7,64.66,6.3,0,0,0,0,0,0,0.115192620102794,68.7295156616924,12.525470205907
9.7,"greedy_SVM","SVM",88,18,884,876,8,1900,1652,248,0.723764941411999,0.192592592592593,1.21729988052569,664,248,416,-15,1.7,68.25,6.7,0,0,0,0,0,0,0.112725256794319,70.1866353075241,12.1320211062879
9.7,"greedy_SVM","SVM",88,19,784,777,7,2000,1751,249,0.717688276511803,0.185185185185185,1.21729988052569,686,249,437,22,1.8,71.84,7,0,0,0,0,0,0,0.0970669561155445,46.8168902374706,11.4855445169259
9.7,"greedy_SVM","SVM",88,20,684,677,7,2100,1851,249,0.74331979037861,0.207407407407407,1.21729988052569,677,249,428,-9,1.7,75.43,7.4,0,0,0,0,0,0,0.0601208965054607,24.3054201868161,6.99607199346397
9.7,"greedy_SVM","SVM",88,21,584,577,7,2200,1951,249,0.727421539186243,0.17037037037037,1.22681003584229,685,249,436,8,1.8,79.02,7.8,0,0,0,0,0,0,0.0661212744464596,24.8722476728397,7.43163735322794
9.7,"greedy_SVM","SVM",88,22,484,477,7,2300,2051,249,0.753223812047344,0.214814814814815,1.21729988052569,688,249,439,3,1.8,82.61,8.2,0,0,0,0,0,0,0.0281653694985064,8.78152141752395,3.66096137629027
9.7,"greedy_SVM","SVM",88,23,384,377,7,2400,2151,249,0.735847612318198,0.2,1.22681003584229,688,249,439,0,1.8,86.21,8.6,0,0,0,0,0,0,0.0284645292813617,7.81729412951831,3.50893730697143
9.7,"greedy_SVM","SVM",88,24,284,278,6,2500,2250,250,0.746623093681919,0.207407407407407,1.21729988052569,686,250,436,-2,1.7,89.8,9,0,0,0,0,0,0,0.0177557235194955,4.35402221880618,2.56137901192074
9.7,"greedy_SVM","SVM",88,25,184,182,2,2600,2346,254,0.727074132956492,0.17037037037037,1.26368596957916,698,254,444,12,1.7,93.39,9.2,0,0,0,0,0,0,0.00544601864347147,2.3143974822344,2.10655583918238
9.7,"greedy_SVM","SVM",88,26,84,84,0,2700,2444,256,0.77110051227699,0.185185185185185,1.27318736784667,696,256,440,-2,1.7,96.98,9.5,0,0,0,0,0,0,1.15947422205076e-07,0.154456013559085,0.154456013559085
9.7,"greedy_SVM","SVM",88,27,0,0,0,2784,2528,256,0.750927397986228,0.2,1.26485065710872,700,256,444,4,1.7,100,9.9,0,0,0,0,0,0,0,0,0
9.7,"greedy_SVM","SVM",89,0,2684,2437,247,100,89,11,0.69630624179497,0.195488721804511,1.21629881154499,33,11,22,0,2,3.59,8.1,0,0,0,0,0,0,0.129434996114944,292.172427764419,15.586278279601
9.7,"greedy_SVM","SVM",89,1,2584,2359,225,200,167,33,0.775981620718466,0.278195488721804,1.23560514188698,93,33,60,60,1.8,7.18,5.1,0,0,0,0,0,0,0.183753781871251,410.293993768853,19.124617411694
9.7,"greedy_SVM","SVM",89,2,2484,2288,196,300,238,62,0.719835302542069,0.180451127819549,1.25491147222896,161,62,99,68,1.6,10.78,3.8,0,0,0,0,0,0,0.213452111461877,479.580964282314,21.8117187157596
9.7,"greedy_SVM","SVM",89,3,2384,2199,185,400,327,73,0.764005251223301,0.195488721804511,1.27421780257094,194,73,121,33,1.7,14.37,4.5,0,0,0,0,0,0,0.183812933474851,409.81463997456,18.5533205457058
9.7,"greedy_SVM","SVM",89,4,2284,2114,170,500,412,88,0.761421410669537,0.24812030075188,1.27421780257094,230,88,142,36,1.6,17.96,4.7,0,0,0,0,0,0,0.178947331624746,356.133244663764,18.1705804541036
9.7,"greedy_SVM","SVM",89,5,2184,2029,155,600,497,103,0.74720133667502,0.24812030075188,1.26456463739995,263,103,160,33,1.6,21.55,4.8,0,0,0,0,0,0,0.17823891368342,270.137596868956,21.3391391052851
9.7,"greedy_SVM","SVM",89,6,2084,1938,146,700,588,112,0.784109082229393,0.263157894736842,1.27421780257094,290,112,178,27,1.6,25.14,5.2,0,0,0,0,0,0,0.153005964103687,202.572659303713,16.3972354659022
9.7,"greedy_SVM","SVM",89,7,1984,1859,125,800,667,133,0.799940327008011,0.225563909774436,1.27421780257094,338,133,205,48,1.5,28.74,5,0,0,0,0,0,0,0.167737541438354,242.288064530275,17.0430924176441
9.7,"greedy_SVM","SVM",89,8,1884,1784,100,900,742,158,0.812441818832811,0.24812030075188,1.27421780257094,388,158,230,50,1.5,32.33,4.7,0,0,0,0,0,0,0.170009644394359,183.673560326194,17.5397861232836
9.7,"greedy_SVM","SVM",89,9,1784,1712,72,1000,814,186,0.81661892827308,0.270676691729323,1.27421780257094,466,186,280,78,1.5,35.92,4.4,0,0,0,0,0,0,0.173837051683234,140.476052373499,18.1619242375597
9.7,"greedy_SVM","SVM",89,10,1684,1633,51,1100,893,207,0.820634920634937,0.270676691729323,1.27421780257094,516,207,309,50,1.5,39.51,4.3,0,0,0,0,0,0,0.160550111963072,114.70079995235,17.57458670793
9.7,"greedy_SVM","SVM",89,11,1584,1552,32,1200,974,226,0.809852010979844,0.263157894736842,1.25491147222896,576,226,350,60,1.5,43.1,4.3,0,0,0,0,0,0,0.164592339138983,127.927931718273,17.3913540244291
9.7,"greedy_SVM","SVM",89,12,1484,1459,25,1300,1067,233,0.822723475355067,0.293233082706767,1.27421780257094,594,233,361,18,1.5,46.7,4.6,0,0,0,0,0,0,0.145932702569799,89.0413072128454,15.887390326223
9.7,"greedy_SVM","SVM",89,13,1384,1363,21,1400,1163,237,0.802929943907397,0.263157894736842,1.26456463739995,623,237,386,29,1.6,50.29,4.9,0,0,0,0,0,0,0.115700621677292,58.6893907227719,13.2923946724786
9.7,"greedy_SVM","SVM",89,14,1284,1267,17,1500,1259,241,0.79578111946534,0.240601503759398,1.26456463739995,644,241,403,21,1.7,53.88,5.2,0,0,0,0,0,0,0.100241772415607,47.2511273279776,11.8073019095853
9.7,"greedy_SVM","SVM",89,15,1184,1170,14,1600,1356,244,0.789742212674548,0.218045112781955,1.26456463739995,642,244,398,-2,1.6,57.47,5.6,0,0,0,0,0,0,0.087073361830444,39.6413143263475,10.5765368574706
9.7,"greedy_SVM","SVM",89,16,1084,1072,12,1700,1454,246,0.803108962883401,0.285714285714286,1.26456463739995,651,246,405,9,1.6,61.06,5.9,0,0,0,0,0,0,0.0750121751956572,38.2844505637765,9.15974960448029
9.7,"greedy_SVM","SVM",89,17,984,972,12,1800,1554,246,0.807453156701288,0.255639097744361,1.26456463739995,647,246,401,-4,1.6,64.66,6.3,0,0,0,0,0,0,0.0371153837699833,12.8294303159978,4.84799805207638
9.7,"greedy_SVM","SVM",89,18,884,875,9,1900,1651,249,0.827897123761792,0.285714285714286,1.25491147222896,664,249,415,17,1.7,68.25,6.6,0,0,0,0,0,0,0.0424048063647902,17.8658172965868,5.70638377989069
9.7,"greedy_SVM","SVM",89,19,784,778,6,2000,1748,252,0.798245614035087,0.210526315789474,1.27421780257094,671,252,419,7,1.7,71.84,6.9,0,0,0,0,0,0,0.0586593540532272,25.9993002385591,14.5124193813265
9.7,"greedy_SVM","SVM",89,20,684,678,6,2100,1848,252,0.803371524048219,0.225563909774436,1.26456463739995,699,252,447,28,1.8,75.43,7.3,0,0,0,0,0,0,0.0162836832312461,4.81062525450644,2.78744582915859
9.7,"greedy_SVM","SVM",89,21,584,579,5,2200,1947,253,0.804045828857864,0.233082706766917,1.27421780257094,689,253,436,-10,1.7,79.02,7.7,0,0,0,0,0,0,0.0764317361368169,30.3421856642001,9.42427245193265
9.7,"greedy_SVM","SVM",89,22,484,482,2,2300,2044,256,0.812209094163987,0.210526315789474,1.27421780257094,693,256,437,4,1.7,82.61,8,0,0,0,0,0,0,0.0101852079699483,2.77394986016984,2.13644855273023
9.7,"greedy_SVM","SVM",89,23,384,383,1,2400,2143,257,0.810007160759047,0.225563909774436,1.27421780257094,711,257,454,18,1.8,86.21,8.3,0,0,0,0,0,0,0.00559776501422587,2.62306662673197,2.27436051641081
9.7,"greedy_SVM","SVM",89,24,284,283,1,2500,2243,257,0.823976608187139,0.263157894736842,1.27421780257094,720,257,463,9,1.8,89.8,8.7,0,0,0,0,0,0,0.000391733795954438,0.146615858724478,0.123280552601649
9.7,"greedy_SVM","SVM",89,25,184,184,0,2600,2342,258,0.816571189879458,0.285714285714286,1.26456463739995,710,258,452,-10,1.8,93.39,9.1,0,0,0,0,0,0,0.00166591242865474,6.96509867006336,6.93502095220655
9.7,"greedy_SVM","SVM",89,26,84,84,0,2700,2442,258,0.824161594462349,0.270676691729323,1.26456463739995,717,258,459,7,1.8,96.98,9.5,0,0,0,0,0,0,8.77868961346095e-07,0.0220110198427333,0.0220110198427333
9.7,"greedy_SVM","SVM",89,27,0,0,0,2784,2526,258,0.780128893662731,0.218045112781955,1.27421780257094,704,258,446,-13,1.7,100,9.8,0,0,0,0,0,0,0,0,0
9.7,"greedy_SVM","SVM",90,0,2684,2418,266,100,93,7,0.824858757062151,0.279661016949153,1.26211044286495,23,7,16,0,2.3,3.59,13.3,0,0,0,0,0,0,0.0978941574623581,203.531775235108,11.4816408242051
9.7,"greedy_SVM","SVM",90,1,2584,2342,242,200,169,31,0.813147224991696,0.169491525423729,1.26211044286495,89,31,58,66,1.9,7.18,5.5,0,0,0,0,0,0,0.197967935527898,286.018187247652,24.2194334710713
9.7,"greedy_SVM","SVM",90,2,2484,2260,224,300,251,49,0.829464938517786,0.26271186440678,1.25123018042646,128,49,79,39,1.6,10.78,5.1,0,0,0,0,0,0,0.187007195957707,207.091623069605,19.3521761913219
9.7,"greedy_SVM","SVM",90,3,2384,2192,192,400,319,81,0.821302758391499,0.288135593220339,1.25123018042646,193,81,112,65,1.4,14.37,3.9,0,0,0,0,0,0,0.216889978503801,256.424147402165,22.6893700827534
9.7,"greedy_SVM","SVM",90,4,2284,2128,156,500,383,117,0.809079428381528,0.254237288135593,1.22946965554948,276,117,159,83,1.4,17.96,3.3,0,0,0,0,0,0,0.217730802012165,236.942013045815,23.1294826053801
9.7,"greedy_SVM","SVM",90,5,2184,2060,124,600,451,149,0.806281156530416,0.211864406779661,1.24034991798797,349,149,200,73,1.3,21.55,3,0,0,0,0,0,0,0.233133892835164,244.649798636706,24.6003944951958
9.7,"greedy_SVM","SVM",90,6,2084,1977,107,700,534,166,0.817673645729485,0.254237288135593,1.26211044286495,388,166,222,39,1.3,25.14,3.2,0,0,0,0,0,0,0.215468783492785,142.531925910142,23.7826209606679
9.7,"greedy_SVM","SVM",90,7,1984,1899,85,800,612,188,0.821495513459628,0.26271186440678,1.26211044286495,450,188,262,62,1.4,28.74,3.3,0,0,0,0,0,0,0.214793368038585,176.996477262187,22.9367208144091
9.7,"greedy_SVM","SVM",90,8,1884,1820,64,900,691,209,0.809139248919915,0.245762711864407,1.24034991798797,515,209,306,65,1.5,32.33,3.3,0,0,0,0,0,0,0.207716114790474,182.013976021571,21.8470424893189
9.7,"greedy_SVM","SVM",90,9,1784,1734,50,1000,777,223,0.788600864074452,0.203389830508475,1.24034991798797,552,223,329,37,1.5,35.92,3.5,0,0,0,0,0,0,0.215653904533731,172.465714712436,22.897688809423
9.7,"greedy_SVM","SVM",90,10,1684,1635,49,1100,876,224,0.803961448986382,0.194915254237288,1.25123018042646,543,224,319,-9,1.4,39.51,3.9,0,0,0,0,0,0,0.197829242246936,99.1447734056067,20.9413079409628
9.7,"greedy_SVM","SVM",90,11,1584,1548,36,1200,963,237,0.820950481887679,0.271186440677966,1.24034991798797,576,237,339,33,1.4,43.1,4.1,0,0,0,0,0,0,0.177479579542455,91.7020498214854,19.1372117414147
9.7,"greedy_SVM","SVM",90,12,1484,1455,29,1300,1056,244,0.820325689597881,0.245762711864407,1.24034991798797,598,244,354,22,1.5,46.7,4.3,0,0,0,0,0,0,0.154634946497132,74.0556827074482,17.1048442465464
9.7,"greedy_SVM","SVM",90,13,1384,1358,26,1400,1153,247,0.79030907278166,0.161016949152542,1.24034991798797,602,247,355,4,1.4,50.29,4.7,0,0,0,0,0,0,0.155904192281084,66.8915938501373,17.2897962720849
9.7,"greedy_SVM","SVM",90,14,1284,1260,24,1500,1251,249,0.795446992356271,0.186440677966102,1.22946965554948,626,249,377,24,1.5,53.88,5,0,0,0,0,0,0,0.152351743898819,67.4953756243571,16.7493258104626
9.7,"greedy_SVM","SVM",90,15,1184,1162,22,1600,1349,251,0.785942173479567,0.152542372881356,1.22946965554948,650,251,399,24,1.6,57.47,5.4,0,0,0,0,0,0,0.123740094866102,45.602008050224,13.738055361094
9.7,"greedy_SVM","SVM",90,16,1084,1062,22,1700,1449,251,0.788394815553343,0.152542372881356,1.22946965554948,650,251,399,0,1.6,61.06,5.8,0,0,0,0,0,0,0.0840001974942317,25.0804407667598,9.56297143784787
9.7,"greedy_SVM","SVM",90,17,984,962,22,1800,1549,251,0.787191758059162,0.161016949152542,1.22946965554948,641,251,390,-9,1.6,64.66,6.2,0,0,0,0,0,0,0.0647169800541488,15.988741472383,8.0219162573026
9.7,"greedy_SVM","SVM",90,18,884,863,21,1900,1648,252,0.751811232967766,0.135593220338983,1.22946965554948,644,252,392,3,1.6,68.25,6.5,0,0,0,0,0,0,0.0733509360068295,14.7853370022497,8.96643894155491
9.7,"greedy_SVM","SVM",90,19,784,763,21,2000,1748,252,0.756118311731477,0.110169491525424,1.22946965554948,653,252,401,9,1.6,71.84,6.9,0,0,0,0,0,0,0.00361588900042322,3.25940162245694,3.09697111912613
9.7,"greedy_SVM","SVM",90,20,684,670,14,2100,1841,259,0.805051512130282,0.211864406779661,1.24034991798797,658,259,399,5,1.5,75.43,7.1,0,0,0,0,0,0,0.00211955724434946,0.93686804620639,0.707139897144894
9.7,"greedy_SVM","SVM",90,21,584,578,6,2200,1933,267,0.825456962446001,0.228813559322034,1.25123018042646,685,267,418,27,1.6,79.02,7.2,0,0,0,0,0,0,0.0708461057300911,22.1608948400058,9.33785471894855
9.7,"greedy_SVM","SVM",90,22,484,480,4,2300,2031,269,0.836457294782326,0.245762711864407,1.25123018042646,694,269,425,9,1.6,82.61,7.6,0,0,0,0,0,0,0.0658937864705546,18.8137696631353,8.27197846265857
9.7,"greedy_SVM","SVM",90,23,384,382,2,2400,2129,271,0.809219009637757,0.152542372881356,1.27299070530344,704,271,433,10,1.6,86.21,7.9,0,0,0,0,0,0,0.00894536068209011,2.69291210011778,1.92521305215547
9.7,"greedy_SVM","SVM",90,24,284,284,0,2500,2227,273,0.794888667331343,0.211864406779661,1.25123018042646,720,273,447,16,1.6,89.8,8.2,0,0,0,0,0,0,0.015077568679501,4.89275811842388,4.21440037863999
9.7,"greedy_SVM","SVM",90,25,184,184,0,2600,2327,273,0.818265204386844,0.220338983050847,1.24034991798797,712,273,439,-8,1.6,93.39,8.5,0,0,0,0,0,0,0.00486349385337782,1.38525228310816,1.1944029972103
9.7,"greedy_SVM","SVM",90,26,84,84,0,2700,2427,273,0.81687603855102,0.228813559322034,1.25123018042646,732,273,459,20,1.7,96.98,8.9,0,0,0,0,0,0,5.55233543338835e-07,0.0113227767782374,0.0113227767782374
9.7,"greedy_SVM","SVM",90,27,0,0,0,2784,2511,273,0.809132602193424,0.228813559322034,1.28387096774194,732,273,459,0,1.7,100,9.2,0,0,0,0,0,0,0,0,0
9.7,"greedy_SVM","SVM",91,0,2684,2431,253,100,94,6,0.86156970177587,0.371212121212121,1.27414467253177,20,6,14,0,2.3,3.59,15.7,0,0,0,0,0,0,0.0766689241228643,157.99534934362,8.01789491374241
9.7,"greedy_SVM","SVM",91,1,2584,2367,217,200,158,42,0.806857232114962,0.303030303030303,1.22551319648094,98,42,56,78,1.3,7.18,3.8,0,0,0,0,0,0,0.251538314868617,468.576367079168,27.9960087591005
9.7,"greedy_SVM","SVM",91,2,2484,2286,198,300,239,61,0.781420469564792,0.257575757575758,1.21578690127077,156,61,95,58,1.6,10.78,3.9,0,0,0,0,0,0,0.209174181921746,465.131124828694,21.3653833461412
9.7,"greedy_SVM","SVM",91,3,2384,2200,184,400,325,75,0.824688198399535,0.348484848484849,1.24496578690127,188,75,113,32,1.5,14.37,4.3,0,0,0,0,0,0,0.203520270247286,274.31880627652,21.0037298443258
9.7,"greedy_SVM","SVM",91,4,2284,2130,154,500,395,105,0.824147501982542,0.318181818181818,1.22551319648094,254,105,149,66,1.4,17.96,3.8,0,0,0,0,0,0,0.2239164561158,307.958422664391,22.815039475155
9.7,"greedy_SVM","SVM",91,5,2184,2061,123,600,464,136,0.815430274193151,0.333333333333333,1.21578690127077,343,136,207,89,1.5,21.55,3.4,0,0,0,0,0,0,0.242027252779585,301.46115169353,24.7697606400425
9.7,"greedy_SVM","SVM",91,6,2084,1986,98,700,539,161,0.810930478456242,0.318181818181818,1.21578690127077,401,161,240,58,1.5,25.14,3.3,0,0,0,0,0,0,0.243082921771812,267.442865081973,24.8862577488111
9.7,"greedy_SVM","SVM",91,7,1984,1899,85,800,626,174,0.819082978876787,0.348484848484849,1.21578690127077,442,174,268,41,1.5,28.74,3.6,0,0,0,0,0,0,0.217130986876406,206.121080252204,22.5576932710406
9.7,"greedy_SVM","SVM",91,8,1884,1824,60,900,701,199,0.817677168192626,0.371212121212121,1.22551319648094,497,199,298,55,1.5,32.33,3.5,0,0,0,0,0,0,0.208448613055108,178.922229344282,22.0622670767795
9.7,"greedy_SVM","SVM",91,9,1784,1739,45,1000,786,214,0.812486482589571,0.318181818181818,1.22551319648094,540,214,326,43,1.5,35.92,3.7,0,0,0,0,0,0,0.203025844186917,154.235214015614,21.4161462278897
9.7,"greedy_SVM","SVM",91,10,1684,1643,41,1100,882,218,0.807343858890251,0.287878787878788,1.22551319648094,546,218,328,6,1.5,39.51,4,0,0,0,0,0,0,0.188412426804238,157.491073910659,19.3242663103945
9.7,"greedy_SVM","SVM",91,11,1584,1550,34,1200,975,225,0.821486074063394,0.363636363636364,1.22551319648094,563,225,338,17,1.5,43.1,4.3,0,0,0,0,0,0,0.171941201759132,134.525248015957,18.16163542105
9.7,"greedy_SVM","SVM",91,12,1484,1459,25,1300,1066,234,0.798482445389658,0.257575757575758,1.21578690127077,601,234,367,38,1.6,46.7,4.6,0,0,0,0,0,0,0.136445628450458,65.0343776525116,15.0764534123749
9.7,"greedy_SVM","SVM",91,13,1384,1362,22,1400,1163,237,0.808130872563863,0.310606060606061,1.21578690127077,611,237,374,10,1.6,50.29,4.9,0,0,0,0,0,0,0.125120273458857,40.3482984901459,14.4571728741505
9.7,"greedy_SVM","SVM",91,14,1284,1263,21,1500,1262,238,0.809981255857548,0.333333333333333,1.21578690127077,601,238,363,-10,1.5,53.88,5.3,0,0,0,0,0,0,0.111141304562569,42.5510226392511,12.404730226449
9.7,"greedy_SVM","SVM",91,15,1184,1164,20,1600,1361,239,0.802135150073295,0.287878787878788,1.21578690127077,610,239,371,9,1.6,57.47,5.7,0,0,0,0,0,0,0.0426219683046525,10.8173385577916,6.25280335208013
9.7,"greedy_SVM","SVM",91,16,1084,1065,19,1700,1460,240,0.804466152404296,0.303030303030303,1.21578690127077,632,240,392,22,1.6,61.06,6.1,0,0,0,0,0,0,0.0693482140295729,23.5200630209612,9.11574234516593
9.7,"greedy_SVM","SVM",91,17,984,966,18,1800,1559,241,0.810930478456254,0.340909090909091,1.21578690127077,629,241,388,-3,1.6,64.66,6.5,0,0,0,0,0,0,0.0627958427192607,14.4561831196179,9.19519398669857
9.7,"greedy_SVM","SVM",91,18,884,866,18,1900,1659,241,0.812138033787517,0.356060606060606,1.21578690127077,638,241,397,9,1.6,68.25,6.9,0,0,0,0,0,0,0.025929335106803,6.24147745871403,4.49543786864499
9.7,"greedy_SVM","SVM",91,19,784,766,18,2000,1759,241,0.813820200418141,0.325757575757576,1.22551319648094,641,241,400,3,1.7,71.84,7.3,0,0,0,0,0,0,7.17122392739729e-05,0.142662688493876,0.140132901643312
9.7,"greedy_SVM","SVM",91,20,684,673,11,2100,1852,248,0.762490087232347,0.204545454545455,1.25469208211144,670,248,422,29,1.7,75.43,7.5,0,0,0,0,0,0,0.0320802024422555,10.5457232432101,6.14809589577335
9.7,"greedy_SVM","SVM",91,21,584,576,8,2200,1949,251,0.82000216278566,0.310606060606061,1.24267514147919,679,251,428,9,1.7,79.02,7.8,0,0,0,0,0,0,0.0462341405361248,13.1924845352857,8.49691809357652
9.7,"greedy_SVM","SVM",91,22,484,476,8,2300,2049,251,0.808911878499501,0.265151515151515,1.24496578690127,668,251,417,-11,1.7,82.61,8.2,0,0,0,0,0,0,0.0545531396922458,17.0133408879327,6.89710060610001
9.7,"greedy_SVM","SVM",91,23,384,379,5,2400,2146,254,0.824994593035825,0.371212121212121,1.2644183773216,681,254,427,13,1.7,86.21,8.4,0,0,0,0,0,0,0.0294728629483746,8.06394500843758,5.45903956810561
9.7,"greedy_SVM","SVM",91,24,284,280,4,2500,2245,255,0.804736500612785,0.272727272727273,1.27414467253177,698,255,443,17,1.7,89.8,8.8,0,0,0,0,0,0,0.0237430551167913,5.28906954046537,3.85688065294171
9.7,"greedy_SVM","SVM",91,25,184,184,0,2600,2341,259,0.829752721505288,0.356060606060606,1.27414467253177,713,259,454,15,1.8,93.39,9,0,0,0,0,0,0,0.00609289332658646,2.18764874902018,1.95452740874666
9.7,"greedy_SVM","SVM",91,26,84,84,0,2700,2441,259,0.781516593372254,0.204545454545455,1.27414467253177,726,259,467,13,1.8,96.98,9.4,0,0,0,0,0,0,7.791145217339e-07,0.0354326353848564,0.0354326353848564
9.7,"greedy_SVM","SVM",91,27,0,0,0,2784,2525,259,0.762808497344577,0.181818181818182,1.27414467253177,712,259,453,-14,1.7,100,9.7,0,0,0,0,0,0,0,0,0
9.7,"greedy_SVM","SVM",92,0,2684,2429,255,100,88,12,0.767342840438245,0.193548387096774,1.27351716961498,31,12,19,0,1.6,3.59,7.3,0,0,0,0,0,0,0.389886460611818,315.974945358259,49.9160449786512
9.7,"greedy_SVM","SVM",92,1,2584,2354,230,200,163,37,0.813569231551391,0.266129032258065,1.26316337148803,89,37,52,58,1.4,7.18,4.4,0,0,0,0,0,0,0.272777255816997,325.597469836186,37.2793968532793
9.7,"greedy_SVM","SVM",92,2,2484,2286,198,300,231,69,0.827995119347216,0.306451612903226,1.26316337148803,151,69,82,62,1.2,10.78,3.3,0,0,0,0,0,0,0.288197275008263,430.459707645805,30.4222720648164
9.7,"greedy_SVM","SVM",92,3,2384,2224,160,400,293,107,0.804602303058036,0.290322580645161,1.24245577523413,241,107,134,90,1.3,14.37,2.7,0,0,0,0,0,0,0.287177254243709,438.970592413884,29.8549455064878
9.7,"greedy_SVM","SVM",92,4,2284,2144,140,500,373,127,0.800242761636037,0.314516129032258,1.22174817898023,296,127,169,55,1.3,17.96,2.9,0,0,0,0,0,0,0.259580390385854,286.147631702863,26.4421572108799
9.7,"greedy_SVM","SVM",92,5,2184,2068,116,600,449,151,0.782804595948048,0.241935483870968,1.18033298647242,358,151,207,62,1.4,21.55,3,0,0,0,0,0,0,0.258025909215879,342.016455074062,28.0537092082179
9.7,"greedy_SVM","SVM",92,6,2084,1987,97,700,530,170,0.798558682223758,0.290322580645161,1.19068678459938,416,170,246,58,1.4,25.14,3.1,0,0,0,0,0,0,0.248423896809249,190.277682865761,25.7111478634033
9.7,"greedy_SVM","SVM",92,7,1984,1924,60,800,593,207,0.795991255497102,0.282258064516129,1.19068678459938,496,207,289,80,1.4,28.74,2.9,0,0,0,0,0,0,0.250776313751557,162.879231180349,25.9518441408765
9.7,"greedy_SVM","SVM",92,8,1884,1842,42,900,675,225,0.790386130811678,0.282258064516129,1.18033298647242,536,225,311,40,1.4,32.33,3,0,0,0,0,0,0,0.241606607729548,262.716612940209,24.7352835215411
9.7,"greedy_SVM","SVM",92,9,1784,1750,34,1000,767,233,0.789807824296515,0.274193548387097,1.18033298647242,559,233,326,23,1.4,35.92,3.3,0,0,0,0,0,0,0.208718665438142,167.256066893395,21.8327245279392
9.7,"greedy_SVM","SVM",92,10,1684,1656,28,1100,861,239,0.779163171407523,0.258064516129032,1.18033298647242,575,239,336,16,1.4,39.51,3.6,0,0,0,0,0,0,0.192750264731843,121.915470613503,20.7229429408837
9.7,"greedy_SVM","SVM",92,11,1584,1556,28,1200,961,239,0.787450113119303,0.193548387096774,1.21139438085328,589,239,350,14,1.5,43.1,4,0,0,0,0,0,0,0.1714010126289,70.5580286283932,18.4966482681122
9.7,"greedy_SVM","SVM",92,12,1484,1459,25,1300,1058,242,0.777498157045179,0.233870967741935,1.21139438085328,600,242,358,11,1.5,46.7,4.4,0,0,0,0,0,0,0.159164002306551,65.5775870473333,17.5945794101274
9.7,"greedy_SVM","SVM",92,13,1384,1359,25,1400,1158,242,0.773202165789682,0.217741935483871,1.20104058272633,594,242,352,-6,1.5,50.29,4.8,0,0,0,0,0,0,0.14519400394671,70.4359188088732,15.4182402315154
9.7,"greedy_SVM","SVM",92,14,1284,1260,24,1500,1257,243,0.782041993950032,0.241935483870968,1.20104058272633,596,243,353,2,1.5,53.88,5.2,0,0,0,0,0,0,0.0669674204416753,18.6961862288836,8.91800323757259
9.7,"greedy_SVM","SVM",92,15,1184,1162,22,1600,1355,245,0.777307506545678,0.258064516129032,1.20104058272633,611,245,366,15,1.5,57.47,5.5,0,0,0,0,0,0,0.134195655560406,43.9439119739075,14.8957018584461
9.7,"greedy_SVM","SVM",92,16,1084,1064,20,1700,1453,247,0.740588220341143,0.145161290322581,1.20104058272633,642,247,395,31,1.6,61.06,5.9,0,0,0,0,0,0,0.102975598987036,26.7527842175349,12.409910203513
9.7,"greedy_SVM","SVM",92,17,984,964,20,1800,1553,247,0.755471669335781,0.201612903225806,1.21139438085328,625,247,378,-17,1.5,64.66,6.3,0,0,0,0,0,0,0.0781829994464941,16.2781430194773,9.43606875506062
9.7,"greedy_SVM","SVM",92,18,884,864,20,1900,1653,247,0.744058059432122,0.169354838709677,1.21139438085328,621,247,374,-4,1.5,68.25,6.7,0,0,0,0,0,0,0.0333091552093329,6.59734177897809,5.99128275519154
9.7,"greedy_SVM","SVM",92,19,784,764,20,2000,1753,247,0.778368794326249,0.258064516129032,1.21139438085328,638,247,391,17,1.6,71.84,7.1,0,0,0,0,0,0,5.1046263503731e-05,0.46939966096269,0.467696511536309
9.7,"greedy_SVM","SVM",92,20,684,670,14,2100,1847,253,0.779614377589681,0.258064516129032,1.16997918834547,646,253,393,8,1.6,75.43,7.3,0,0,0,0,0,0,0.0825616888049155,26.3658524710539,16.5852979312391
9.7,"greedy_SVM","SVM",92,21,584,571,13,2200,1946,254,0.76645313810723,0.217741935483871,1.20104058272633,648,254,394,2,1.6,79.02,7.7,0,0,0,0,0,0,0.0101481408727223,3.36086535486473,2.43596589926824
9.7,"greedy_SVM","SVM",92,22,484,472,12,2300,2045,255,0.797497394443184,0.330645161290323,1.19068678459938,667,255,412,19,1.6,82.61,8,0,0,0,0,0,0,0.00340270027745681,1.00147329771435,0.715403341525527
9.7,"greedy_SVM","SVM",92,23,384,375,9,2400,2142,258,0.779881288288987,0.314516129032258,1.20104058272633,680,258,422,13,1.6,86.21,8.3,0,0,0,0,0,0,0.0324214662741078,8.36692602671181,5.93722555737704
9.7,"greedy_SVM","SVM",92,24,284,275,9,2500,2242,258,0.698479880017292,0.193548387096774,1.19068678459938,692,258,434,12,1.7,89.8,8.7,0,0,0,0,0,0,0.00444069027800677,1.44759820594275,1.19136209505924
9.7,"greedy_SVM","SVM",92,25,184,177,7,2600,2340,260,0.766637433590087,0.290322580645161,1.19068678459938,703,260,443,11,1.7,93.39,9,0,0,0,0,0,0,0.00141076334955033,0.609313588364526,0.575221520415674
9.7,"greedy_SVM","SVM",92,26,84,78,6,2700,2439,261,0.768912529550837,0.233870967741935,1.19068678459938,703,261,442,0,1.7,96.98,9.3,0,0,0,0,0,0,0.000133576030686836,0.311254711970747,0.311254711970747
9.7,"greedy_SVM","SVM",92,27,0,0,0,2784,2517,267,0.798361676707598,0.266129032258065,1.27351716961498,730,267,463,27,1.7,100,9.4,0,0,0,0,0,0,0,0,0
9.7,"greedy_SVM","SVM",93,0,2684,2429,255,100,88,12,0.782181804316327,0.233870967741935,1.28387096774194,34,12,22,0,1.8,3.59,7.3,0,0,0,0,0,0,0.121333132909158,320.06511618321,12.1943916960147
9.7,"greedy_SVM","SVM",93,1,2584,2353,231,200,164,36,0.776913495513358,0.120967741935484,1.22174817898023,102,36,66,68,1.8,7.18,4.6,0,0,0,0,0,0,0.235415072584963,355.005696254493,30.8114601264005
9.7,"greedy_SVM","SVM",93,2,2484,2259,225,300,258,42,0.716769617936405,0.17741935483871,1.18033298647242,124,42,82,22,2,10.78,6.1,0,0,0,0,0,0,0.160624938830682,272.893020926389,18.2798278384543
9.7,"greedy_SVM","SVM",93,3,2384,2178,206,400,339,61,0.732510994178806,0.209677419354839,1.22174817898023,153,61,92,29,1.5,14.37,5.6,0,0,0,0,0,0,0.1727409981359,290.314859256019,21.7343559774504
9.7,"greedy_SVM","SVM",93,4,2284,2086,198,500,431,69,0.770361473347062,0.233870967741935,1.22174817898023,180,69,111,27,1.6,17.96,6.2,0,0,0,0,0,0,0.140478211484675,233.600261057254,14.2804768331375
9.7,"greedy_SVM","SVM",93,5,2184,2006,178,600,511,89,0.775350161417423,0.233870967741935,1.22174817898023,224,89,135,44,1.5,21.55,5.7,0,0,0,0,0,0,0.148520950048664,278.622806069998,14.9330041604125
9.7,"greedy_SVM","SVM",93,6,2084,1924,160,700,593,107,0.78659854088818,0.209677419354839,1.22174817898023,267,107,160,43,1.5,25.14,5.5,0,0,0,0,0,0,0.157443403960511,156.664085106821,16.236837472695
9.7,"greedy_SVM","SVM",93,7,1984,1858,126,800,659,141,0.79278832710542,0.25,1.22174817898023,354,141,213,87,1.5,28.74,4.7,0,0,0,0,0,0,0.172107903334965,140.711684811762,18.0916524878351
9.7,"greedy_SVM","SVM",93,8,1884,1780,104,900,737,163,0.795273138615627,0.233870967741935,1.22174817898023,396,163,233,42,1.4,32.33,4.5,0,0,0,0,0,0,0.163803779815627,116.945447709055,17.1663185112073
9.7,"greedy_SVM","SVM",93,9,1784,1695,89,1000,822,178,0.773437301405732,0.145161290322581,1.21139438085328,440,178,262,44,1.5,35.92,4.6,0,0,0,0,0,0,0.176963289541475,127.732466846715,20.0583723558494
9.7,"greedy_SVM","SVM",93,10,1684,1598,86,1100,919,181,0.807551030783704,0.266129032258065,1.23210197710718,449,181,268,9,1.5,39.51,5.1,0,0,0,0,0,0,0.139428495048934,79.2754458165909,15.3514992105295
9.7,"greedy_SVM","SVM",93,11,1584,1518,66,1200,999,201,0.795679859681236,0.225806451612903,1.23210197710718,501,201,300,52,1.5,43.1,5,0,0,0,0,0,0,0.143730070611073,74.8504263772531,15.6848477841008
9.7,"greedy_SVM","SVM",93,12,1484,1433,51,1300,1084,216,0.809590991128402,0.274193548387097,1.23210197710718,545,216,329,44,1.5,46.7,5,0,0,0,0,0,0,0.148860643841198,77.8298121567718,15.7058153077002
9.7,"greedy_SVM","SVM",93,13,1384,1347,37,1400,1170,230,0.817007295559119,0.25,1.23210197710718,571,230,341,26,1.5,50.29,5.1,0,0,0,0,0,0,0.128160041821738,54.4072193009405,14.7768450841204
9.7,"greedy_SVM","SVM",93,14,1284,1258,26,1500,1259,241,0.811961412338905,0.233870967741935,1.23210197710718,613,241,372,42,1.5,53.88,5.2,0,0,0,0,0,0,0.113907494561592,42.3868119043112,12.8192727097638
9.7,"greedy_SVM","SVM",93,15,1184,1159,25,1600,1358,242,0.797357584076873,0.217741935483871,1.23210197710718,615,242,373,2,1.5,57.47,5.6,0,0,0,0,0,0,0.0953609621477719,32.1347369142123,10.5832959426276
9.7,"greedy_SVM","SVM",93,16,1084,1059,25,1700,1458,242,0.810445740867845,0.25,1.23210197710718,622,242,380,7,1.6,61.06,6,0,0,0,0,0,0,0.0362625189052502,8.58583907610405,4.8813319434792
9.7,"greedy_SVM","SVM",93,17,984,960,24,1800,1557,243,0.818519789521853,0.258064516129032,1.23210197710718,617,243,374,-5,1.5,64.66,6.4,0,0,0,0,0,0,0.0371600342442049,9.3180380582695,5.38965088678927
9.7,"greedy_SVM","SVM",93,18,884,861,23,1900,1656,244,0.78977604921325,0.201612903225806,1.23210197710718,617,244,373,0,1.5,68.25,6.8,0,0,0,0,0,0,0.0241943084861459,7.66279760217936,3.72167731210728
9.7,"greedy_SVM","SVM",93,19,784,765,19,2000,1752,248,0.810379013193018,0.225806451612903,1.22174817898023,639,248,391,22,1.6,71.84,7.1,0,0,0,0,0,0,0.0096321790661204,3.8834677017164,2.21401964407789
9.7,"greedy_SVM","SVM",93,20,684,666,18,2100,1851,249,0.825313302320854,0.25,1.23210197710718,651,249,402,12,1.6,75.43,7.4,0,0,0,0,0,0,0.017124167151472,6.37531167827473,2.55998717951655
9.7,"greedy_SVM","SVM",93,21,584,567,17,2200,1950,250,0.807748036299857,0.274193548387097,1.23210197710718,646,250,396,-5,1.6,79.02,7.8,0,0,0,0,0,0,0.00249266962625369,0.771803739253818,0.476757171396189
9.7,"greedy_SVM","SVM",93,22,484,473,11,2300,2044,256,0.789210452731387,0.25,1.22174817898023,657,256,401,11,1.6,82.61,8,0,0,0,0,0,0,0.0207892138391582,6.8474211354449,5.00194175802407
9.7,"greedy_SVM","SVM",93,23,384,374,10,2400,2143,257,0.777243956379167,0.137096774193548,1.20104058272633,694,257,437,37,1.7,86.21,8.3,0,0,0,0,0,0,0.0163064934642921,5.60832264256252,4.06043604431686
9.7,"greedy_SVM","SVM",93,24,284,275,9,2500,2242,258,0.816479829177156,0.233870967741935,1.20104058272633,677,258,419,-17,1.6,89.8,8.7,0,0,0,0,0,0,0.00256792550938539,0.648780248283492,0.476947678380252
9.7,"greedy_SVM","SVM",93,25,184,177,7,2600,2340,260,0.798514197107197,0.209677419354839,1.22174817898023,694,260,434,17,1.7,93.39,9,0,0,0,0,0,0,0.000307108268273651,0.172706852542373,0.161795732675903
9.7,"greedy_SVM","SVM",93,26,84,83,1,2700,2434,266,0.812520653804111,0.225806451612903,1.26316337148803,719,266,453,25,1.7,96.98,9.2,0,0,0,0,0,0,7.98776616178509e-06,0.959174527237897,0.959174527237897
9.7,"greedy_SVM","SVM",93,27,0,0,0,2784,2517,267,0.827277002465747,0.201612903225806,1.26316337148803,721,267,454,2,1.7,100,9.4,0,0,0,0,0,0,0,0,0
9.7,"greedy_SVM","SVM",94,0,2684,2446,238,100,88,12,0.260326739627943,0,0.600960878517502,35,12,23,0,1.9,3.59,7.3,0,0,0,0,0,0,0.128698506851522,316.090406405842,13.3020200204671
9.7,"greedy_SVM","SVM",94,1,2584,2346,238,200,188,12,0.748748102327057,0.177304964539007,1.22923816060398,34,12,22,-1,1.8,7.18,15.7,0,0,0,0,0,0,0.130619789449567,194.903298515183,20.1164873521373
9.7,"greedy_SVM","SVM",94,2,2484,2262,222,300,272,28,0.809836177010406,0.382978723404255,1.22013269274766,78,28,50,44,1.8,10.78,9.7,0,0,0,0,0,0,0.347647003924336,315.440674529422,45.4138892700569
9.7,"greedy_SVM","SVM",94,3,2384,2193,191,400,341,59,0.749212607345978,0.141843971631206,1.24744909631663,144,59,85,66,1.4,14.37,5.8,0,0,0,0,0,0,0.192432397315698,345.427881512445,22.2305123194529
9.7,"greedy_SVM","SVM",94,4,2284,2101,183,500,433,67,0.782356739854534,0.184397163120567,1.24744909631663,169,67,102,25,1.5,17.96,6.5,0,0,0,0,0,0,0.18330549241926,222.252626057057,20.762233907787
9.7,"greedy_SVM","SVM",94,5,2184,2015,169,600,519,81,0.803457730043281,0.290780141843972,1.24744909631663,201,81,120,32,1.5,21.55,6.4,0,0,0,0,0,0,0.161168335859832,197.145703096114,16.9863650327845
9.7,"greedy_SVM","SVM",94,6,2084,1939,145,700,595,105,0.818939342442166,0.319148936170213,1.24744909631663,259,105,154,58,1.5,25.14,5.7,0,0,0,0,0,0,0.162634170091394,138.744310348792,16.9462776030912
9.7,"greedy_SVM","SVM",94,7,1984,1877,107,800,657,143,0.826909568803393,0.361702127659574,1.25655456417296,341,143,198,82,1.4,28.74,4.6,0,0,0,0,0,0,0.185436553829553,145.782727263181,19.2431535157848
9.7,"greedy_SVM","SVM",94,8,1884,1809,75,900,725,175,0.823856298008296,0.354609929078014,1.24744909631663,416,175,241,75,1.4,32.33,4.1,0,0,0,0,0,0,0.207710058960943,202.714748725091,21.4807548794695
9.7,"greedy_SVM","SVM",94,9,1784,1728,56,1000,806,194,0.818746742800174,0.340425531914894,1.24744909631663,462,194,268,46,1.4,35.92,4.2,0,0,0,0,0,0,0.192292250966835,150.017818243891,20.0777725571477
9.7,"greedy_SVM","SVM",94,10,1684,1644,40,1100,890,210,0.809592595110238,0.297872340425532,1.24744909631663,517,210,307,55,1.5,39.51,4.2,0,0,0,0,0,0,0.185721522596504,157.319677829849,19.7788340255072
9.7,"greedy_SVM","SVM",94,11,1584,1554,30,1200,980,220,0.805763261051823,0.297872340425532,1.24744909631663,551,220,331,34,1.5,43.1,4.5,0,0,0,0,0,0,0.14367907234689,76.5145534617875,16.6197955197765
9.7,"greedy_SVM","SVM",94,12,1484,1458,26,1300,1076,224,0.803706976638801,0.312056737588652,1.23834362846031,562,224,338,11,1.5,46.7,4.8,0,0,0,0,0,0,0.125743269279103,80.1181071051208,14.0304642007643
9.7,"greedy_SVM","SVM",94,13,1384,1361,23,1400,1173,227,0.818163279178853,0.297872340425532,1.23834362846031,575,227,348,13,1.5,50.29,5.2,0,0,0,0,0,0,0.0893743154085979,45.6893779035401,10.3975569520574
9.7,"greedy_SVM","SVM",94,14,1284,1266,18,1500,1268,232,0.811025763034473,0.24113475177305,1.25655456417296,583,232,351,8,1.5,53.88,5.5,0,0,0,0,0,0,0.121441353166815,61.6591708809592,16.33166799106
9.7,"greedy_SVM","SVM",94,15,1184,1169,15,1600,1365,235,0.820168581333705,0.25531914893617,1.24744909631663,607,235,372,24,1.6,57.47,5.8,0,0,0,0,0,0,0.141450084379428,114.123147331722,15.0272173898224
9.7,"greedy_SVM","SVM",94,16,1084,1071,13,1700,1463,237,0.818894024879347,0.276595744680851,1.25655456417296,639,237,402,32,1.7,61.06,6.2,0,0,0,0,0,0,0.103710676364128,55.6583831894048,11.9891457059636
9.7,"greedy_SVM","SVM",94,17,984,971,13,1800,1563,237,0.787896811909459,0.234042553191489,1.25655456417296,624,237,387,-15,1.6,64.66,6.6,0,0,0,0,0,0,0.0850501474092488,41.3837257386824,9.66572235486303
9.7,"greedy_SVM","SVM",94,18,884,871,13,1900,1663,237,0.832092765051099,0.333333333333333,1.25655456417296,629,237,392,5,1.7,68.25,7,0,0,0,0,0,0,0.0528111602558353,22.8031549043899,6.11349234619641
9.7,"greedy_SVM","SVM",94,19,784,774,10,2000,1760,240,0.820015634559177,0.304964539007092,1.25655456417296,631,240,391,2,1.6,71.84,7.3,0,0,0,0,0,0,0.0348672096380543,12.9838579666083,5.41080503053194
9.7,"greedy_SVM","SVM",94,20,684,675,9,2100,1859,241,0.810867151564595,0.26241134751773,1.25655456417296,648,241,407,17,1.7,75.43,7.7,0,0,0,0,0,0,0.0261420017286715,8.90064089006131,3.27311228977274
9.7,"greedy_SVM","SVM",94,21,584,577,7,2200,1957,243,0.842578116148918,0.361702127659574,1.27476549988561,662,243,419,14,1.7,79.02,8.1,0,0,0,0,0,0,0.0352206391872223,13.1721947374596,4.77027612797434
9.7,"greedy_SVM","SVM",94,22,484,482,2,2300,2052,248,0.820961638683076,0.226950354609929,1.27476549988561,690,248,442,28,1.8,82.61,8.3,0,0,0,0,0,0,0.0110744648547265,4.70822318441305,3.48665929236969
9.7,"greedy_SVM","SVM",94,23,384,384,0,2400,2150,250,0.794003353499651,0.276595744680851,1.26566003202928,694,250,444,4,1.8,86.21,8.6,0,0,0,0,0,0,0.0493707512253813,14.3881958548741,6.28900644452778
9.7,"greedy_SVM","SVM",94,24,284,284,0,2500,2250,250,0.763442322071921,0.191489361702128,1.27476549988561,683,250,433,-11,1.7,89.8,9,0,0,0,0,0,0,0.000962750265181217,0.385636553863048,0.330601412023559
9.7,"greedy_SVM","SVM",94,25,184,184,0,2600,2350,250,0.792077357079739,0.26241134751773,1.26566003202928,688,250,438,5,1.8,93.39,9.4,0,0,0,0,0,0,0.00115282047372631,0.371969409543481,0.317149566174643
9.7,"greedy_SVM","SVM",94,26,84,84,0,2700,2450,250,0.828019849092518,0.312056737588652,1.27476549988561,702,250,452,14,1.8,96.98,9.8,0,0,0,0,0,0,1.9754296293836e-06,0.00797035276828611,0.00797035276828611
9.7,"greedy_SVM","SVM",94,27,0,0,0,2784,2534,250,0.747348922574948,0.212765957446809,1.27476549988561,686,250,436,-16,1.7,100,10.1,0,0,0,0,0,0,0,0,0
9.7,"greedy_SVM","SVM",95,0,2684,2432,252,100,90,10,0.796802938867625,0.201550387596899,1.2528587948092,26,10,16,0,1.6,3.59,9,0,0,0,0,0,0,0.360838188384106,333.848696285554,45.720362701881
9.7,"greedy_SVM","SVM",95,1,2584,2353,231,200,169,31,0.807655038759677,0.271317829457364,1.26396599149787,74,31,43,48,1.4,7.18,5.5,0,0,0,0,0,0,0.252423962025794,334.77261987607,32.4839000839094
9.7,"greedy_SVM","SVM",95,2,2484,2290,194,300,232,68,0.788741291335479,0.124031007751938,1.26164038709769,162,68,94,88,1.4,10.78,3.4,0,0,0,0,0,0,0.42409026145811,461.332778877156,52.5125105813848
9.7,"greedy_SVM","SVM",95,3,2384,2201,183,400,321,79,0.820767098420165,0.302325581395349,1.2739184796199,191,79,112,29,1.4,14.37,4.1,0,0,0,0,0,0,0.237991564936461,308.692586097966,25.8261700841233
9.7,"greedy_SVM","SVM",95,4,2284,2125,159,500,397,103,0.712479148268076,0.178294573643411,1.21420355088772,256,103,153,65,1.5,17.96,3.9,0,0,0,0,0,0,0.229619172808012,382.499899605717,26.0565225133529
9.7,"greedy_SVM","SVM",95,5,2184,2036,148,600,486,114,0.824833186144629,0.217054263565891,1.28387096774194,285,114,171,29,1.5,21.55,4.3,0,0,0,0,0,0,0.21084890165407,234.692220681706,23.4692297519311
9.7,"greedy_SVM","SVM",95,6,2084,1965,119,700,557,143,0.826881562162687,0.263565891472868,1.28387096774194,349,143,206,64,1.4,25.14,3.9,0,0,0,0,0,0,0.212128198974247,205.071913637424,21.7420824824563
9.7,"greedy_SVM","SVM",95,7,1984,1898,86,800,624,176,0.824330291433614,0.263565891472868,1.28387096774194,422,176,246,73,1.4,28.74,3.5,0,0,0,0,0,0,0.206308044524911,124.036468423779,22.0559576027755
9.7,"greedy_SVM","SVM",95,8,1884,1826,58,900,696,204,0.837252232361883,0.263565891472868,1.28387096774194,479,204,275,57,1.3,32.33,3.4,0,0,0,0,0,0,0.21737326086709,129.801141305062,23.848142396976
9.7,"greedy_SVM","SVM",95,9,1784,1744,40,1000,778,222,0.831033509959764,0.294573643410853,1.28387096774194,532,222,310,53,1.4,35.92,3.5,0,0,0,0,0,0,0.203653322118257,183.311635630873,21.5601155909186
9.7,"greedy_SVM","SVM",95,10,1684,1655,29,1100,867,233,0.830898586988514,0.24031007751938,1.2739184796199,558,233,325,26,1.4,39.51,3.7,0,0,0,0,0,0,0.165744479087047,92.2518944262287,18.2825695120799
9.7,"greedy_SVM","SVM",95,11,1584,1566,18,1200,956,244,0.835443037974678,0.263565891472868,1.2739184796199,599,244,355,41,1.5,43.1,3.9,0,0,0,0,0,0,0.1714918778057,96.2289883159581,19.4017069939883
9.7,"greedy_SVM","SVM",95,12,1484,1468,16,1300,1054,246,0.837699931311932,0.271317829457364,1.2739184796199,625,246,379,26,1.5,46.7,4.3,0,0,0,0,0,0,0.149750132597714,76.2547593784959,16.5690449682512
9.7,"greedy_SVM","SVM",95,13,1384,1372,12,1400,1150,250,0.826654646256492,0.232558139534884,1.2739184796199,635,250,385,10,1.5,50.29,4.6,0,0,0,0,0,0,0.125023642618693,62.4483664368824,14.3755197032426
9.7,"greedy_SVM","SVM",95,14,1284,1275,9,1500,1247,253,0.822079530958679,0.248062015503876,1.2739184796199,660,253,407,25,1.6,53.88,4.9,0,0,0,0,0,0,0.0868460016451674,37.3331967921948,10.8062615016784
9.7,"greedy_SVM","SVM",95,15,1184,1177,7,1600,1345,255,0.812493867137656,0.248062015503876,1.26396599149787,661,255,406,1,1.6,57.47,5.3,0,0,0,0,0,0,0.120359383540877,58.9996910570689,15.3026479959129
9.7,"greedy_SVM","SVM",95,16,1084,1078,6,1700,1444,256,0.81468943185162,0.248062015503876,1.26396599149787,677,256,421,16,1.6,61.06,5.6,0,0,0,0,0,0,0.0979371013428866,45.9768147379904,11.6079128357192
9.7,"greedy_SVM","SVM",95,17,984,979,5,1800,1543,257,0.819252281424774,0.24031007751938,1.26396599149787,684,257,427,7,1.7,64.66,6,0,0,0,0,0,0,0.0494119253534136,16.0717799326779,5.88505798234786
9.7,"greedy_SVM","SVM",95,18,884,879,5,1900,1643,257,0.81522912373662,0.248062015503876,1.26396599149787,676,257,419,-8,1.6,68.25,6.4,0,0,0,0,0,0,0.0270851548432254,7.5031027922628,3.44453697960653
9.7,"greedy_SVM","SVM",95,19,784,782,2,2000,1740,260,0.794794426454708,0.186046511627907,1.2739184796199,698,260,438,22,1.7,71.84,6.7,0,0,0,0,0,0,0.071456696592888,23.4282702277518,9.47525037108295
9.7,"greedy_SVM","SVM",95,20,684,683,1,2100,1839,261,0.813370866450784,0.224806201550388,1.2739184796199,701,261,440,3,1.7,75.43,7,0,0,0,0,0,0,0.0405882460295323,11.7302359129069,5.34816403904818
9.7,"greedy_SVM","SVM",95,21,584,583,1,2200,1939,261,0.798106172112645,0.232558139534884,1.28387096774194,690,261,429,-11,1.6,79.02,7.4,0,0,0,0,0,0,0.0138546726862177,3.94508322917063,2.42205242607297
9.7,"greedy_SVM","SVM",95,22,484,483,1,2300,2039,261,0.800915023059552,0.217054263565891,1.2739184796199,691,261,430,1,1.6,82.61,7.8,0,0,0,0,0,0,0.0033244609031888,1.00800931106067,0.785587986097903
9.7,"greedy_SVM","SVM",95,23,384,383,1,2400,2139,261,0.825532332450192,0.286821705426357,1.28387096774194,703,261,442,12,1.7,86.21,8.2,0,0,0,0,0,0,0.000859128606835567,0.260863864965759,0.21787291021993
9.7,"greedy_SVM","SVM",95,24,284,283,1,2500,2239,261,0.824980374840538,0.263565891472868,1.28387096774194,690,261,429,-13,1.6,89.8,8.6,0,0,0,0,0,0,0.000298651065756266,0.12690776267462,0.111443768229148
9.7,"greedy_SVM","SVM",95,25,184,184,0,2600,2338,262,0.817246835443034,0.263565891472868,1.28387096774194,687,262,425,-3,1.6,93.39,8.9,0,0,0,0,0,0,0.000359687120823345,2.03802317868661,2.03130202174426
9.7,"greedy_SVM","SVM",95,26,84,84,0,2700,2438,262,0.833547983514859,0.27906976744186,1.28387096774194,703,262,441,16,1.7,96.98,9.3,0,0,0,0,0,0,1.1021965316225e-06,0.00627983776215786,0.00627983776215786
9.7,"greedy_SVM","SVM",95,27,0,0,0,2784,2522,262,0.806722843685601,0.255813953488372,1.28387096774194,707,262,445,4,1.7,100,9.6,0,0,0,0,0,0,0,0,0
9.7,"greedy_SVM","SVM",96,0,2684,2417,267,100,87,13,0.586449944484265,0,1.05157367312063,42,13,29,0,2.2,3.59,6.7,0,0,0,0,0,0,0.283322643444898,379.647163594453,40.3289123658754
9.7,"greedy_SVM","SVM",96,1,2584,2323,261,200,181,19,0.750881927168981,0.144144144144144,1.27230456262714,58,19,39,16,2.1,7.18,9.5,0,0,0,0,0,0,0.102628461141089,244.834913321028,10.4252799924236
9.7,"greedy_SVM","SVM",96,2,2484,2248,236,300,256,44,0.635149189751376,0.0810810810810811,1.20290613193839,120,44,76,62,1.7,10.78,5.8,0,0,0,0,0,0,0.175095086725312,358.114809243057,19.9984179164176
9.7,"greedy_SVM","SVM",96,3,2384,2156,228,400,348,52,0.770881646076658,0.162162162162162,1.27230456262714,143,52,91,23,1.8,14.37,6.7,0,0,0,0,0,0,0.155847217921422,234.379703532107,16.2414075819916
9.7,"greedy_SVM","SVM",96,4,2284,2076,208,500,428,72,0.740214473443805,0.189189189189189,1.23760534728277,200,72,128,57,1.8,17.96,5.9,0,0,0,0,0,0,0.162248477430373,248.000969866233,16.9129616993119
9.7,"greedy_SVM","SVM",96,5,2184,1999,185,600,505,95,0.776369973717864,0.225225225225225,1.26073815751235,251,95,156,51,1.6,21.55,5.3,0,0,0,0,0,0,0.166839388370513,260.938896767462,18.1351631455041
9.7,"greedy_SVM","SVM",96,6,2084,1916,168,700,588,112,0.789047237565178,0.252252252252252,1.28387096774194,298,112,186,47,1.7,25.14,5.2,0,0,0,0,0,0,0.167409960222378,297.252590455604,16.9920329657858
9.7,"greedy_SVM","SVM",96,7,1984,1835,149,800,669,131,0.800375258253571,0.171171171171171,1.28387096774194,346,131,215,48,1.6,28.74,5.1,0,0,0,0,0,0,0.178157870991793,165.397532556133,18.2725826411502
9.7,"greedy_SVM","SVM",96,8,1884,1768,116,900,736,164,0.811850852412475,0.198198198198198,1.28387096774194,442,164,278,96,1.7,32.33,4.5,0,0,0,0,0,0,0.192367700943639,109.486793168221,20.2518065234837
9.7,"greedy_SVM","SVM",96,9,1784,1707,77,1000,797,203,0.820887970653961,0.234234234234234,1.28387096774194,517,203,314,75,1.5,35.92,3.9,0,0,0,0,0,0,0.188604733029251,129.254035656063,20.5676439701312
9.7,"greedy_SVM","SVM",96,10,1684,1630,54,1100,874,226,0.809658332279241,0.162162162162162,1.26073815751235,583,226,357,66,1.6,39.51,3.9,0,0,0,0,0,0,0.198930721844031,133.474149730918,21.6721670693564
9.7,"greedy_SVM","SVM",96,11,1584,1545,39,1200,959,241,0.827022810642164,0.207207207207207,1.27230456262714,602,241,361,19,1.5,43.1,4,0,0,0,0,0,0,0.172671062636488,143.697831784522,19.3504920546202
9.7,"greedy_SVM","SVM",96,12,1484,1454,30,1300,1050,250,0.82357942966367,0.207207207207207,1.28387096774194,617,250,367,15,1.5,46.7,4.2,0,0,0,0,0,0,0.126750980015599,80.0221295826233,14.4511188603041
9.7,"greedy_SVM","SVM",96,13,1384,1360,24,1400,1144,256,0.825575185169567,0.18018018018018,1.28387096774194,619,256,363,2,1.4,50.29,4.5,0,0,0,0,0,0,0.133053430280097,80.3572742128861,15.4296240918249
9.7,"greedy_SVM","SVM",96,14,1284,1269,15,1500,1235,265,0.824872454357633,0.171171171171171,1.28387096774194,668,265,403,49,1.5,53.88,4.7,0,0,0,0,0,0,0.132768677085755,76.256880455688,14.9205563521256
9.7,"greedy_SVM","SVM",96,15,1184,1173,11,1600,1331,269,0.822588579218841,0.171171171171171,1.28387096774194,688,269,419,20,1.6,57.47,4.9,0,0,0,0,0,0,0.110407757528073,50.0209494193851,13.3429926598503
9.7,"greedy_SVM","SVM",96,16,1084,1075,9,1700,1429,271,0.799820100912146,0.171171171171171,1.28387096774194,675,271,404,-13,1.5,61.06,5.3,0,0,0,0,0,0,0.101483696003214,45.5064717470915,12.255512430126
9.7,"greedy_SVM","SVM",96,17,984,975,9,1800,1529,271,0.815336397239674,0.18018018018018,1.28387096774194,682,271,411,7,1.5,64.66,5.6,0,0,0,0,0,0,0.0877682312216063,39.9855215107463,9.90471243313785
9.7,"greedy_SVM","SVM",96,18,884,875,9,1900,1629,271,0.819960365982209,0.225225225225225,1.28387096774194,679,271,408,-3,1.5,68.25,6,0,0,0,0,0,0,0.0636837215960365,26.5316223999823,7.43586338892508
9.7,"greedy_SVM","SVM",96,19,784,776,8,2000,1728,272,0.82121825413557,0.198198198198198,1.28387096774194,688,272,416,9,1.5,71.84,6.4,0,0,0,0,0,0,0.0556691704512978,21.8324058053438,9.40640653650446
9.7,"greedy_SVM","SVM",96,20,684,677,7,2100,1827,273,0.83572964540203,0.234234234234234,1.28387096774194,682,273,409,-6,1.5,75.43,6.7,0,0,0,0,0,0,0.0288519100144847,8.71954776061653,4.98353838904526
9.7,"greedy_SVM","SVM",96,21,584,581,3,2200,1923,277,0.815322342623429,0.207207207207207,1.28387096774194,709,277,432,27,1.6,79.02,6.9,0,0,0,0,0,0,0.0344182929986521,11.2196801099925,8.11093870717429
9.7,"greedy_SVM","SVM",96,22,484,483,1,2300,2021,279,0.784865989234165,0.171171171171171,1.26073815751235,735,279,456,26,1.6,82.61,7.2,0,0,0,0,0,0,0.0342056068874359,10.80868677365,7.24408019455708
9.7,"greedy_SVM","SVM",96,23,384,383,1,2400,2121,279,0.792834956641506,0.207207207207207,1.28387096774194,739,279,460,4,1.6,86.21,7.6,0,0,0,0,0,0,0.0153205514693734,3.76782972388409,2.501252059118
9.7,"greedy_SVM","SVM",96,24,284,283,1,2500,2221,279,0.808084215260502,0.216216216216216,1.28387096774194,750,279,471,11,1.7,89.8,8,0,0,0,0,0,0,0.0244677056363633,5.70492296015273,3.56494454620706
9.7,"greedy_SVM","SVM",96,25,184,184,0,2600,2320,280,0.751781422608254,0.117117117117117,1.28387096774194,761,280,481,11,1.7,93.39,8.3,0,0,0,0,0,0,0.00111778080484112,2.63032402296258,2.5956338993738
9.7,"greedy_SVM","SVM",96,26,84,84,0,2700,2420,280,0.772568200025296,0.189189189189189,1.26073815751235,736,280,456,-25,1.6,96.98,8.6,0,0,0,0,0,0,4.66027506666557e-06,0.0386062831552186,0.0386062831552186
9.7,"greedy_SVM","SVM",96,27,0,0,0,2784,2504,280,0.770080532951047,0.144144144144144,1.27230456262714,743,280,463,7,1.7,100,8.9,0,0,0,0,0,0,0,0,0
9.7,"greedy_SVM","SVM",97,0,2684,2427,257,100,93,7,0.358392108569368,0.0236220472440945,0.839065278130556,30,7,23,0,3.3,3.59,13.3,0,0,0,0,0,0,0.0864886972139012,183.30506632351,9.24332181100024
9.7,"greedy_SVM","SVM",97,1,2584,2327,257,200,193,7,0.641017029269452,0.118110236220472,1.18277876555753,28,7,21,-2,3,7.18,27.6,0,0,0,0,0,0,0.0650126836370233,126.603518537429,7.30378865581564
9.7,"greedy_SVM","SVM",97,2,2484,2236,248,300,284,16,0.606181040166191,0.275590551181102,1.02103124206248,50,16,34,22,2.1,10.78,17.8,0,0,0,0,0,0,0.100471460441407,140.636863460884,12.355001305776
9.7,"greedy_SVM","SVM",97,3,2384,2173,211,400,347,53,0.663687477453943,0.078740157480315,1.22321564643129,139,53,86,89,1.6,14.37,6.5,0,0,0,0,0,0,0.202864813603358,327.269462575059,22.7441631330865
9.7,"greedy_SVM","SVM",97,4,2284,2080,204,500,440,60,0.77384284310433,0.220472440944882,1.25354330708661,165,60,105,26,1.8,17.96,7.3,0,0,0,0,0,0,0.181697692993789,181.975760705544,20.2272677885601
9.7,"greedy_SVM","SVM",97,5,2184,2002,182,600,518,82,0.792252864126579,0.275590551181102,1.25354330708661,214,82,132,49,1.6,21.55,6.3,0,0,0,0,0,0,0.171970208848123,216.256330485783,17.7710831462683
9.7,"greedy_SVM","SVM",97,6,2084,1937,147,700,583,117,0.797166349466985,0.267716535433071,1.25354330708661,294,117,177,80,1.5,25.14,5,0,0,0,0,0,0,0.222096498055971,142.365706172611,24.6021839358547
9.7,"greedy_SVM","SVM",97,7,1984,1865,119,800,655,145,0.796998420221165,0.275590551181102,1.26365252730505,355,145,210,61,1.4,28.74,4.5,0,0,0,0,0,0,0.201920220944938,131.406092217673,23.7749114260856
9.7,"greedy_SVM","SVM",97,8,1884,1798,86,900,722,178,0.812715353708753,0.283464566929134,1.26365252730505,415,178,237,60,1.3,32.33,4.1,0,0,0,0,0,0,0.216942113778937,169.001317381726,25.5273500814594
9.7,"greedy_SVM","SVM",97,9,1784,1722,62,1000,798,202,0.817324078566006,0.299212598425197,1.26365252730505,484,202,282,69,1.4,35.92,4,0,0,0,0,0,0,0.192712018654136,119.452855524702,21.7664407765383
9.7,"greedy_SVM","SVM",97,10,1684,1637,47,1100,883,217,0.814431963777042,0.267716535433071,1.26365252730505,515,217,298,31,1.4,39.51,4.1,0,0,0,0,0,0,0.170743478298433,113.603076064892,20.4392405961164
9.7,"greedy_SVM","SVM",97,11,1584,1545,39,1200,975,225,0.819724844820942,0.259842519685039,1.26365252730505,545,225,320,30,1.4,43.1,4.3,0,0,0,0,0,0,0.121625628756208,78.7616525704807,14.031141219625
9.7,"greedy_SVM","SVM",97,12,1484,1454,30,1300,1066,234,0.832493687104292,0.291338582677165,1.2737617475235,584,234,350,39,1.5,46.7,4.6,0,0,0,0,0,0,0.132143059879371,84.4513887950436,15.0093311211565
9.7,"greedy_SVM","SVM",97,13,1384,1360,24,1400,1160,240,0.831305743180218,0.251968503937008,1.2737617475235,593,240,353,9,1.5,50.29,4.8,0,0,0,0,0,0,0.142592195981473,79.1589593409965,15.9455863264011
9.7,"greedy_SVM","SVM",97,14,1284,1266,18,1500,1254,246,0.811639362615232,0.220472440944882,1.2737617475235,620,246,374,27,1.5,53.88,5.1,0,0,0,0,0,0,0.117684934116728,46.2815016935079,14.592267798959
9.7,"greedy_SVM","SVM",97,15,1184,1169,15,1600,1351,249,0.810277269843649,0.236220472440945,1.2737617475235,638,249,389,18,1.6,57.47,5.4,0,0,0,0,0,0,0.0907714266928216,38.7311857445619,11.097638446794
9.7,"greedy_SVM","SVM",97,16,1084,1071,13,1700,1449,251,0.82309586894056,0.275590551181102,1.26365252730505,658,251,407,20,1.6,61.06,5.8,0,0,0,0,0,0,0.0899246443693747,42.4746262519724,10.2730781864979
9.7,"greedy_SVM","SVM",97,17,984,973,11,1800,1547,253,0.805743180206747,0.196850393700787,1.26365252730505,658,253,405,0,1.6,64.66,6.1,0,0,0,0,0,0,0.0604789857926816,21.5529424801031,7.50330969764017
9.7,"greedy_SVM","SVM",97,18,884,873,11,1900,1647,253,0.809761042902816,0.283464566929134,1.26365252730505,641,253,388,-17,1.5,68.25,6.5,0,0,0,0,0,0,0.051686571288935,17.963121361736,6.2721055157267
9.7,"greedy_SVM","SVM",97,19,784,776,8,2000,1744,256,0.777045937978133,0.188976377952756,1.26365252730505,678,256,422,37,1.6,71.84,6.8,0,0,0,0,0,0,0.043652127568159,16.1720398067988,8.31697150005578
9.7,"greedy_SVM","SVM",97,20,684,678,6,2100,1842,258,0.83256832232464,0.299212598425197,1.28387096774194,692,258,434,14,1.7,75.43,7.1,0,0,0,0,0,0,0.0745308932877199,30.5231616916696,8.8038587066906
9.7,"greedy_SVM","SVM",97,21,584,581,3,2200,1939,261,0.834222736375964,0.307086614173228,1.28387096774194,701,261,440,9,1.7,79.02,7.4,0,0,0,0,0,0,0.054354065656429,16.5510210318316,7.6136409672004
9.7,"greedy_SVM","SVM",97,22,484,481,3,2300,2039,261,0.820359244194005,0.291338582677165,1.28387096774194,705,261,444,4,1.7,82.61,7.8,0,0,0,0,0,0,0.0138693755865056,3.61091770631387,2.18064207284005
9.7,"greedy_SVM","SVM",97,23,384,382,2,2400,2138,262,0.817050416091355,0.275590551181102,1.28387096774194,696,262,434,-9,1.7,86.21,8.2,0,0,0,0,0,0,0.0124068520106212,3.45581391343984,2.33025017286855
9.7,"greedy_SVM","SVM",97,24,284,282,2,2500,2238,262,0.80470761652424,0.204724409448819,1.28268876611418,709,262,447,13,1.7,89.8,8.5,0,0,0,0,0,0,0.00359976460439918,0.921708526793112,0.690278458821946
9.7,"greedy_SVM","SVM",97,25,184,184,0,2600,2336,264,0.821534748914682,0.322834645669291,1.28387096774194,719,264,455,10,1.7,93.39,8.8,0,0,0,0,0,0,0.00391995314477375,1.33603906315421,1.2031085841613
9.7,"greedy_SVM","SVM",97,26,84,84,0,2700,2436,264,0.773401251383864,0.173228346456693,1.2737617475235,748,264,484,29,1.8,96.98,9.2,0,0,0,0,0,0,4.61895196975085e-05,0.169024164810111,0.169024164810111
9.7,"greedy_SVM","SVM",97,27,0,0,0,2784,2520,264,0.763823064770932,0.149606299212598,1.28387096774194,731,264,467,-17,1.8,100,9.5,0,0,0,0,0,0,0,0,0
9.7,"greedy_SVM","SVM",98,0,2684,2425,259,100,91,9,0.761833429357924,0.16260162601626,1.27343299239444,26,9,17,0,1.9,3.59,10.1,0,0,0,0,0,0,0.261088956334049,266.914342631572,33.0053885701966
9.7,"greedy_SVM","SVM",98,1,2584,2347,237,200,169,31,0.638909160745154,0.292682926829268,1.02292158405455,78,31,47,52,1.5,7.18,5.5,0,0,0,0,0,0,0.18781763856115,364.344704578422,20.3055109993148
9.7,"greedy_SVM","SVM",98,2,2484,2281,203,300,235,65,0.689296459893734,0.146341463414634,1.16905323891949,157,65,92,79,1.4,10.78,3.6,0,0,0,0,0,0,0.288573204978341,445.002538800603,31.6980686026582
9.7,"greedy_SVM","SVM",98,3,2384,2192,192,400,324,76,0.803360860380266,0.32520325203252,1.27343299239444,193,76,117,36,1.5,14.37,4.3,0,0,0,0,0,0,0.197896378153764,372.286505234624,20.5722130523612
9.7,"greedy_SVM","SVM",98,4,2284,2118,166,500,398,102,0.751552397413745,0.276422764227642,1.26299501704694,258,102,156,65,1.5,17.96,3.9,0,0,0,0,0,0,0.206300813009774,381.114776562638,21.8398573537227
9.7,"greedy_SVM","SVM",98,5,2184,2035,149,600,481,119,0.808840663209788,0.276422764227642,1.27343299239444,298,119,179,40,1.5,21.55,4,0,0,0,0,0,0,0.202628163519313,302.897824796581,20.7819966453662
9.7,"greedy_SVM","SVM",98,6,2084,1963,121,700,553,147,0.791652262979328,0.300813008130081,1.27343299239444,359,147,212,61,1.4,25.14,3.8,0,0,0,0,0,0,0.211449403443642,309.936668087014,22.349096931703
9.7,"greedy_SVM","SVM",98,7,1984,1880,104,800,636,164,0.807579540362341,0.308943089430894,1.27343299239444,399,164,235,40,1.4,28.74,3.9,0,0,0,0,0,0,0.203816454833089,223.992153666145,20.9960345640838
9.7,"greedy_SVM","SVM",98,8,1884,1805,79,900,711,189,0.807931630497417,0.276422764227642,1.27343299239444,457,189,268,58,1.4,32.33,3.8,0,0,0,0,0,0,0.199879457157146,220.41775880115,20.8011619789075
9.7,"greedy_SVM","SVM",98,9,1784,1727,57,1000,789,211,0.807259458421368,0.284552845528455,1.27343299239444,513,211,302,56,1.4,35.92,3.7,0,0,0,0,0,0,0.201491015273713,244.994117095227,20.7785786943119
9.7,"greedy_SVM","SVM",98,10,1684,1643,41,1100,873,227,0.812604826835681,0.268292682926829,1.27343299239444,558,227,331,45,1.5,39.51,3.8,0,0,0,0,0,0,0.193434715176858,166.200120954977,20.0742987551116
9.7,"greedy_SVM","SVM",98,11,1584,1554,30,1200,962,238,0.80972408936689,0.24390243902439,1.27343299239444,599,238,361,41,1.5,43.1,4,0,0,0,0,0,0,0.188219002674726,170.498179024357,19.283523791825
9.7,"greedy_SVM","SVM",98,12,1484,1463,21,1300,1053,247,0.818718391908339,0.300813008130081,1.26299501704694,639,247,392,40,1.6,46.7,4.3,0,0,0,0,0,0,0.147763617436799,69.303389837251,16.531809476044
9.7,"greedy_SVM","SVM",98,13,1384,1367,17,1400,1149,251,0.805927917546902,0.235772357723577,1.26299501704694,646,251,395,7,1.6,50.29,4.6,0,0,0,0,0,0,0.146083245842399,91.1928162507425,15.6639165717502
9.7,"greedy_SVM","SVM",98,14,1284,1271,13,1500,1245,255,0.819672236092452,0.260162601626016,1.27343299239444,671,255,416,25,1.6,53.88,4.9,0,0,0,0,0,0,0.136779871018317,95.5627241899424,14.3483433046322
9.7,"greedy_SVM","SVM",98,15,1184,1174,10,1600,1342,258,0.809173548428406,0.284552845528455,1.26299501704694,677,258,419,6,1.6,57.47,5.2,0,0,0,0,0,0,0.13749147193152,84.6097977501274,14.9646942604093
9.7,"greedy_SVM","SVM",98,16,1084,1075,9,1700,1441,259,0.791645861340512,0.260162601626016,1.26299501704694,690,259,431,13,1.7,61.06,5.6,0,0,0,0,0,0,0.119724983457776,59.6680439416666,13.6112829401367
9.7,"greedy_SVM","SVM",98,17,984,975,9,1800,1541,259,0.815607195442044,0.300813008130081,1.26299501704694,705,259,446,15,1.7,64.66,5.9,0,0,0,0,0,0,0.120734009937357,76.2527965944122,12.8199416856134
9.7,"greedy_SVM","SVM",98,18,884,875,9,1900,1641,259,0.801344344152114,0.292682926829268,1.27343299239444,682,259,423,-23,1.6,68.25,6.3,0,0,0,0,0,0,0.0641655474700054,22.7864833702992,7.73249486890171
9.7,"greedy_SVM","SVM",98,19,784,776,8,2000,1740,260,0.81209909736894,0.276422764227642,1.26299501704694,700,260,440,18,1.7,71.84,6.7,0,0,0,0,0,0,0.0585295618568772,19.6160498631723,6.88890240219095
9.7,"greedy_SVM","SVM",98,20,684,679,5,2100,1837,263,0.800070418027015,0.195121951219512,1.28387096774194,726,263,463,26,1.8,75.43,7,0,0,0,0,0,0,0.120250460333827,49.0583428288252,16.4706979900312
9.7,"greedy_SVM","SVM",98,21,584,579,5,2200,1937,263,0.826067473273169,0.284552845528455,1.27343299239444,703,263,440,-23,1.7,79.02,7.4,0,0,0,0,0,0,0.0237868632245745,7.12028160659193,3.93097950378532
9.7,"greedy_SVM","SVM",98,22,484,482,2,2300,2034,266,0.839082004993286,0.317073170731707,1.27343299239444,732,266,466,29,1.8,82.61,7.6,0,0,0,0,0,0,0.0596572831025712,14.9081002827483,8.4561223360385
9.7,"greedy_SVM","SVM",98,23,384,383,1,2400,2133,267,0.799039754177072,0.276422764227642,1.27343299239444,762,267,495,30,1.9,86.21,8,0,0,0,0,0,0,0.0213480469345079,5.80557762243688,4.6700011162526
9.7,"greedy_SVM","SVM",98,24,284,283,1,2500,2233,267,0.78409832917227,0.203252032520325,1.27343299239444,740,267,473,-22,1.8,89.8,8.4,0,0,0,0,0,0,0.0123775179470068,2.96304153995639,2.22819430194662
9.7,"greedy_SVM","SVM",98,25,184,183,1,2600,2333,267,0.810274630305364,0.252032520325203,1.27343299239444,735,267,468,-5,1.8,93.39,8.7,0,0,0,0,0,0,0.00175979355950912,0.540344146787206,0.467304793337146
9.7,"greedy_SVM","SVM",98,26,84,84,0,2700,2432,268,0.829300300877024,0.276422764227642,1.28387096774194,743,268,475,8,1.8,96.98,9.1,0,0,0,0,0,0,0.000123019062946796,1.69260115522294,1.69260115522294
9.7,"greedy_SVM","SVM",98,27,0,0,0,2784,2516,268,0.772568977658284,0.203252032520325,1.27343299239444,768,268,500,25,1.9,100,9.4,0,0,0,0,0,0,0,0,0
9.7,"greedy_SVM","SVM",99,0,2684,2414,270,100,88,12,0.767962788304902,0.247706422018349,1.20142053862089,34,12,22,0,1.8,3.59,7.3,0,0,0,0,0,0,0.181262453422215,327.208543495195,19.6643653784944
9.7,"greedy_SVM","SVM",99,1,2584,2349,235,200,153,47,0.752000628769044,0.220183486238532,1.2485350695472,108,47,61,74,1.3,7.18,3.3,0,0,0,0,0,0,0.261886167588414,464.939112810097,27.9204751149963
9.7,"greedy_SVM","SVM",99,2,2484,2275,209,300,227,73,0.732680270942299,0.211009174311927,1.15430600769458,167,73,94,59,1.3,10.78,3.1,0,0,0,0,0,0,0.236874326822371,449.505562727047,24.5607368942292
9.7,"greedy_SVM","SVM",99,3,2384,2203,181,400,299,101,0.741282974649175,0.220183486238532,1.17786327315774,225,101,124,58,1.2,14.37,3,0,0,0,0,0,0,0.216908724045102,307.146329619044,23.2643888126195
9.7,"greedy_SVM","SVM",99,4,2284,2128,156,500,374,126,0.748628140272656,0.201834862385321,1.17786327315774,284,126,158,59,1.3,17.96,3,0,0,0,0,0,0,0.231361017669719,297.381985754532,24.0244397949014
9.7,"greedy_SVM","SVM",99,5,2184,2063,121,600,439,161,0.760338963674298,0.229357798165138,1.22497780408405,359,161,198,75,1.2,21.55,2.7,0,0,0,0,0,0,0.23705632626521,222.298733876264,25.1546627472012
9.7,"greedy_SVM","SVM",99,6,2084,1986,98,700,516,184,0.755694646889023,0.247706422018349,1.23675643681563,411,184,227,52,1.2,25.14,2.8,0,0,0,0,0,0,0.21167244871449,187.063462169377,23.4864355420632
9.7,"greedy_SVM","SVM",99,7,1984,1901,83,800,601,199,0.77507931064049,0.256880733944954,1.22497780408405,459,199,260,48,1.3,28.74,3,0,0,0,0,0,0,0.211379858880194,251.018732220275,23.1051059370249
9.7,"greedy_SVM","SVM",99,8,1884,1822,62,900,680,220,0.790191202949502,0.229357798165138,1.26031370227878,515,220,295,56,1.3,32.33,3.1,0,0,0,0,0,0,0.231520414600213,289.379955050213,28.3692410748573
9.7,"greedy_SVM","SVM",99,9,1784,1726,58,1000,776,224,0.832590242647692,0.238532110091743,1.27209233501036,524,224,300,9,1.3,35.92,3.5,0,0,0,0,0,0,0.190252511847209,150.307960311726,21.3809724162342
9.7,"greedy_SVM","SVM",99,10,1684,1644,40,1100,858,242,0.825923861785136,0.220183486238532,1.27209233501036,574,242,332,50,1.4,39.51,3.5,0,0,0,0,0,0,0.177031900133708,86.5304348913516,20.3622456752276
9.7,"greedy_SVM","SVM",99,11,1584,1548,36,1200,954,246,0.817213981537058,0.18348623853211,1.27209233501036,583,246,337,9,1.4,43.1,3.9,0,0,0,0,0,0,0.169251492150682,101.630027655466,18.3772985291853
9.7,"greedy_SVM","SVM",99,12,1484,1456,28,1300,1046,254,0.822358455514594,0.229357798165138,1.27209233501036,615,254,361,32,1.4,46.7,4.1,0,0,0,0,0,0,0.153445965711073,74.3817797498067,17.4012427236816
9.7,"greedy_SVM","SVM",99,13,1384,1360,24,1400,1142,258,0.818485809825949,0.229357798165138,1.27209233501036,623,258,365,8,1.4,50.29,4.4,0,0,0,0,0,0,0.152775091476607,84.0578892714397,16.5734789152662
9.7,"greedy_SVM","SVM",99,14,1284,1262,22,1500,1240,260,0.824987853325335,0.238532110091743,1.27209233501036,650,260,390,27,1.5,53.88,4.8,0,0,0,0,0,0,0.133911200442036,59.2823569387813,15.3883339618651
9.7,"greedy_SVM","SVM",99,15,1184,1164,20,1600,1338,262,0.817757009345798,0.211009174311927,1.27209233501036,659,262,397,9,1.5,57.47,5.1,0,0,0,0,0,0,0.110702112548319,38.2148508230215,12.2682408083245
9.7,"greedy_SVM","SVM",99,16,1084,1064,20,1700,1438,262,0.818407213695737,0.201834862385321,1.27209233501036,651,262,389,-8,1.5,61.06,5.5,0,0,0,0,0,0,0.0905775947707104,31.6652916827818,10.2690393030306
9.7,"greedy_SVM","SVM",99,17,984,964,20,1800,1538,262,0.810840549887111,0.220183486238532,1.27209233501036,661,262,399,10,1.5,64.66,5.9,0,0,0,0,0,0,0.0302041488213874,7.8599314835847,4.37032790379001
9.7,"greedy_SVM","SVM",99,18,884,866,18,1900,1636,264,0.822029780788252,0.211009174311927,1.27209233501036,661,264,397,0,1.5,68.25,6.2,0,0,0,0,0,0,0.0272234740971471,8.51111298091075,4.3748404789007
9.7,"greedy_SVM","SVM",99,19,784,766,18,2000,1736,264,0.816220812255284,0.201834862385321,1.27209233501036,651,264,387,-10,1.5,71.84,6.6,0,0,0,0,0,0,0.00430806315883697,1.05320138968536,0.726474470397214
9.7,"greedy_SVM","SVM",99,20,684,670,14,2100,1832,268,0.823394495412847,0.220183486238532,1.26031370227878,673,268,405,22,1.5,75.43,6.8,0,0,0,0,0,0,0.0868131239881918,29.4433360135616,11.130965451535
9.7,"greedy_SVM","SVM",99,21,584,570,14,2200,1932,268,0.806110491868876,0.220183486238532,1.26031370227878,671,268,403,-2,1.5,79.02,7.2,0,0,0,0,0,0,0.0193055003008536,5.89862668867887,3.35027406876597
9.7,"greedy_SVM","SVM",99,22,484,473,11,2300,2029,271,0.809990282660267,0.220183486238532,1.27209233501036,710,271,439,39,1.6,82.61,7.5,0,0,0,0,0,0,0.0415210263080785,9.7320159851883,6.21213897673247
9.7,"greedy_SVM","SVM",99,23,384,378,6,2400,2124,276,0.807060790534172,0.256880733944954,1.27209233501036,702,276,426,-8,1.5,86.21,7.7,0,0,0,0,0,0,0.0156284542686991,4.64723445882154,3.7923375652322
9.7,"greedy_SVM","SVM",99,24,284,284,0,2500,2218,282,0.819707622395613,0.247706422018349,1.27209233501036,744,282,462,42,1.6,89.8,7.9,0,0,0,0,0,0,0.0377081713241234,11.4822634261523,9.76100552259136
9.7,"greedy_SVM","SVM",99,25,184,184,0,2600,2318,282,0.769298922518508,0.146788990825688,1.27209233501036,750,282,468,6,1.7,93.39,8.2,0,0,0,0,0,0,0.00250240202488836,1.69384309635019,1.63566252406856
9.7,"greedy_SVM","SVM",99,26,84,84,0,2700,2418,282,0.797064791791709,0.192660550458716,1.28387096774194,732,282,450,-18,1.6,96.98,8.6,0,0,0,0,0,0,8.83121857832619e-07,0.445841543857978,0.445841543857978
9.7,"greedy_SVM","SVM",99,27,0,0,0,2784,2502,282,0.774050415844982,0.119266055045872,1.27209233501036,754,282,472,22,1.7,100,8.9,0,0,0,0,0,0,0,0,0
9.7,"greedy_SVM","SVM",100,0,2684,2444,240,100,91,9,0.705976064219049,0.316901408450704,1.21154020899591,27,9,18,0,2,3.59,10.1,0,0,0,0,0,0,0.157552225466152,249.602709762908,22.4595881814727
9.7,"greedy_SVM","SVM",100,1,2584,2372,212,200,163,37,0.708785084608367,0.211267605633803,1.1934575193094,92,37,55,65,1.5,7.18,4.4,0,0,0,0,0,0,0.279427140948536,321.896149810345,38.0974646688447
9.7,"greedy_SVM","SVM",100,2,2484,2284,200,300,251,49,0.849410612355186,0.345070422535211,1.28387096774194,115,49,66,23,1.3,10.78,5.1,0,0,0,0,0,0,0.230846229542033,170.94998074386,28.2121166075627
9.7,"greedy_SVM","SVM",100,3,2384,2211,173,400,324,76,0.768894743360241,0.232394366197183,1.27482962289868,185,76,109,70,1.4,14.37,4.3,0,0,0,0,0,0,0.224537367989362,277.485402810552,26.905267035957
9.7,"greedy_SVM","SVM",100,4,2284,2116,168,500,419,81,0.824422152418901,0.288732394366197,1.27482962289868,208,81,127,23,1.6,17.96,5.2,0,0,0,0,0,0,0.201287719980506,179.674731968843,21.1019632141658
9.7,"greedy_SVM","SVM",100,5,2184,2047,137,600,488,112,0.826904673444333,0.267605633802817,1.27482962289868,287,112,175,79,1.6,21.55,4.4,0,0,0,0,0,0,0.208301260864419,137.396141317647,22.3591860748796
9.7,"greedy_SVM","SVM",100,6,2084,1970,114,700,565,135,0.833119419956983,0.295774647887324,1.27482962289868,343,135,208,56,1.5,25.14,4.2,0,0,0,0,0,0,0.216918054645827,134.012833547305,22.4737452747691
9.7,"greedy_SVM","SVM",100,7,1984,1896,88,800,639,161,0.835832742256892,0.352112676056338,1.27482962289868,397,161,236,54,1.5,28.74,4,0,0,0,0,0,0,0.221133721841662,135.463099151307,23.0460825379082
9.7,"greedy_SVM","SVM",100,8,1884,1816,68,900,719,181,0.800604586753128,0.253521126760563,1.27482962289868,453,181,272,56,1.5,32.33,4,0,0,0,0,0,0,0.219327785846457,131.544095342837,23.0165160960555
9.7,"greedy_SVM","SVM",100,9,1784,1721,63,1000,814,186,0.826347372805975,0.295774647887324,1.27482962289868,475,186,289,22,1.6,35.92,4.4,0,0,0,0,0,0,0.186163975108595,79.4776807181191,19.5102667965925
9.7,"greedy_SVM","SVM",100,10,1684,1634,50,1100,901,199,0.824444669616413,0.246478873239437,1.27482962289868,509,199,310,34,1.6,39.51,4.5,0,0,0,0,0,0,0.179429529601886,97.5388879595456,18.752728195916
9.7,"greedy_SVM","SVM",100,11,1584,1549,35,1200,986,214,0.82085317661363,0.288732394366197,1.27482962289868,557,214,343,48,1.6,43.1,4.6,0,0,0,0,0,0,0.107902556379679,29.3542381293484,14.5387612775804
9.7,"greedy_SVM","SVM",100,12,1484,1455,29,1300,1080,220,0.828171265804251,0.330985915492958,1.27482962289868,579,220,359,22,1.6,46.7,4.9,0,0,0,0,0,0,0.0793773769150215,21.6766327704811,11.07378273845
9.7,"greedy_SVM","SVM",100,13,1384,1355,29,1400,1180,220,0.830777631415985,0.295774647887324,1.27482962289868,588,220,368,9,1.7,50.29,5.4,0,0,0,0,0,0,0.0658511629018255,21.8079643490681,8.63428083720748
9.7,"greedy_SVM","SVM",100,14,1284,1259,25,1500,1276,224,0.758624086646173,0.154929577464789,1.26578827805543,600,224,376,12,1.7,53.88,5.7,0,0,0,0,0,0,0.492985723292882,122.551326800118,82.2388042782135
9.7,"greedy_SVM","SVM",100,15,1184,1160,24,1600,1375,225,0.807230272120332,0.274647887323944,1.27482962289868,601,225,376,1,1.7,57.47,6.1,0,0,0,0,0,0,0.108856738732888,43.537543453106,13.5159525111044
9.7,"greedy_SVM","SVM",100,16,1084,1062,22,1700,1473,227,0.799867148534686,0.253521126760563,1.27482962289868,625,227,398,24,1.8,61.06,6.5,0,0,0,0,0,0,0.0736223885479866,27.4977959112025,12.3508379438612
9.7,"greedy_SVM","SVM",100,17,984,966,18,1800,1569,231,0.79578590648608,0.288732394366197,1.25674693321218,636,231,405,11,1.8,64.66,6.8,0,0,0,0,0,0,0.0945144677014692,37.7314214741358,12.8909672690268
9.7,"greedy_SVM","SVM",100,18,884,868,16,1900,1667,233,0.790742054243926,0.267605633802817,1.26578827805543,633,233,400,-3,1.7,68.25,7.2,0,0,0,0,0,0,0.0525781346640055,17.4500130994597,6.9323413930602
9.7,"greedy_SVM","SVM",100,19,784,770,14,2000,1765,235,0.809048535819226,0.295774647887324,1.27482962289868,656,235,421,23,1.8,71.84,7.5,0,0,0,0,0,0,0.0454903048004639,11.9459873624382,6.33819165715578
9.7,"greedy_SVM","SVM",100,20,684,678,6,2100,1857,243,0.793382195651923,0.316901408450704,1.27482962289868,663,243,420,7,1.7,75.43,7.6,0,0,0,0,0,0,0.0277727406934912,9.34977267259514,6.67307951108041
9.7,"greedy_SVM","SVM",100,21,584,583,1,2200,1952,248,0.777271140833805,0.253521126760563,1.27482962289868,709,248,461,46,1.9,79.02,7.9,0,0,0,0,0,0,0.00896533589662118,2.57435124636275,1.96666022220858
9.7,"greedy_SVM","SVM",100,22,484,483,1,2300,2052,248,0.780716272052774,0.246478873239437,1.27482962289868,713,248,465,4,1.9,82.61,8.3,0,0,0,0,0,0,0.00295191449940511,1.00989958212849,0.850545957169394
9.7,"greedy_SVM","SVM",100,23,384,384,0,2400,2151,249,0.790055279719882,0.225352112676056,1.26578827805543,731,249,482,18,1.9,86.21,8.6,0,0,0,0,0,0,0.0712697439154411,32.7996764463413,29.9257758823046
9.7,"greedy_SVM","SVM",100,24,284,284,0,2500,2251,249,0.819350153679866,0.309859154929577,1.26578827805543,700,249,451,-31,1.8,89.8,9,0,0,0,0,0,0,0.000593961003243642,0.622973137563251,0.606454572540202
9.7,"greedy_SVM","SVM",100,25,184,184,0,2600,2351,249,0.817346123101512,0.359154929577465,1.26578827805543,714,249,465,14,1.9,93.39,9.4,0,0,0,0,0,0,0.00498635793106232,1.35144068743943,1.18300524651437
9.7,"greedy_SVM","SVM",100,26,84,84,0,2700,2451,249,0.783119982886925,0.274647887323944,1.27482962289868,710,249,461,-4,1.9,96.98,9.8,0,0,0,0,0,0,1.0000000994736e-07,0.0124024659291712,0.0124024659291712
9.7,"greedy_SVM","SVM",100,27,0,0,0,2784,2535,249,0.800728431339432,0.316901408450704,1.27482962289868,721,249,472,11,1.9,100,10.2,0,0,0,0,0,0,0,0,0
9.7,"eps_greedy_SVM","SVM",1,0,2684,2444,240,100,92,8,0.8167944055944,0.286713286713287,1.25693661177532,19,8,11,0,1.4,3.59,11.5,0,0,0,0,0,0,0.274861358709326,209.038902484711,33.7440753435211
9.7,"eps_greedy_SVM","SVM",1,1,2584,2361,223,200,175,25,0.83282797202797,0.335664335664336,1.2500240364585,69,25,44,50,1.8,7.18,7,0,0,0,0,0,0,0.482314452565512,275.904369363639,55.8707699618598
9.7,"eps_greedy_SVM","SVM",1,2,2484,2298,186,300,238,62,0.735681118881117,0.202797202797203,1.23898037446425,160,62,98,91,1.6,10.78,3.8,0,0,0,0,0,0,0.242163079197619,391.151097230832,27.5720605815085
9.7,"eps_greedy_SVM","SVM",1,3,2384,2214,170,400,322,78,0.796335664335666,0.237762237762238,1.25693661177532,192,78,114,32,1.5,14.37,4.1,0,0,0,0,0,0,0.221152593095363,274.714262754558,25.5323817118556
9.7,"eps_greedy_SVM","SVM",1,4,2284,2133,151,500,403,97,0.78857062937063,0.258741258741259,1.23898037446425,247,97,150,55,1.5,17.96,4.2,0,0,0,0,0,0,0.213709510280768,213.715811679687,22.0769863124289
9.7,"eps_greedy_SVM","SVM",1,5,2184,2060,124,600,476,124,0.794618181818185,0.272727272727273,1.24795849311978,301,124,177,54,1.4,21.55,3.8,0,0,0,0,0,0,0.215895664603672,185.301059053958,22.0305144035064
9.7,"eps_greedy_SVM","SVM",1,6,2084,1989,95,700,547,153,0.792346853146854,0.258741258741259,1.26591473043086,373,153,220,72,1.4,25.14,3.6,0,0,0,0,0,0,0.22347664755331,152.684301544703,23.183529570182
9.7,"eps_greedy_SVM","SVM",1,7,1984,1920,64,800,616,184,0.796587412587411,0.286713286713287,1.25693661177532,441,184,257,68,1.4,28.74,3.3,0,0,0,0,0,0,0.225002511901006,141.31031375871,23.1393885352133
9.7,"eps_greedy_SVM","SVM",1,8,1884,1833,51,900,703,197,0.796598601398599,0.27972027972028,1.24795849311978,487,197,290,46,1.5,32.33,3.6,0,0,0,0,0,0,0.184980168242719,92.4841069785593,20.216666681854
9.7,"eps_greedy_SVM","SVM",1,9,1784,1744,40,1000,792,208,0.810243356643356,0.314685314685315,1.26591473043086,524,208,316,37,1.5,35.92,3.8,0,0,0,0,0,0,0.156357001605118,56.2432581907891,18.1457552447785
9.7,"eps_greedy_SVM","SVM",1,10,1684,1650,34,1100,886,214,0.79730909090909,0.293706293706294,1.23898037446425,528,214,314,4,1.5,39.51,4.1,0,0,0,0,0,0,0.147795818726139,67.1991192015457,16.4461658250826
9.7,"eps_greedy_SVM","SVM",1,11,1584,1552,32,1200,984,216,0.79154685314685,0.230769230769231,1.24795849311978,541,216,325,13,1.5,43.1,4.6,0,0,0,0,0,0,0.150003868082076,123.285619434183,15.9357991981775
9.7,"eps_greedy_SVM","SVM",1,12,1484,1455,29,1300,1081,219,0.791278321678317,0.244755244755245,1.23898037446425,548,219,329,7,1.5,46.7,4.9,0,0,0,0,0,0,0.13260757391127,55.4265279705166,16.2799234638636
9.7,"eps_greedy_SVM","SVM",1,13,1384,1363,21,1400,1173,227,0.774959440559439,0.20979020979021,1.23000225580871,581,227,354,33,1.6,50.29,5.2,0,0,0,0,0,0,0.107592019532963,45.8750990347282,12.9643985212941
9.7,"eps_greedy_SVM","SVM",1,14,1284,1267,17,1500,1269,231,0.734595804195803,0.167832167832168,1.23898037446425,606,231,375,25,1.6,53.88,5.5,0,0,0,0,0,0,0.17273572507685,69.9205026410546,19.0198174726713
9.7,"eps_greedy_SVM","SVM",1,15,1184,1169,15,1600,1367,233,0.76083916083916,0.223776223776224,1.23000225580871,594,233,361,-12,1.5,57.47,5.9,0,0,0,0,0,0,0.144265592100949,61.199127214717,15.5261779920858
9.7,"eps_greedy_SVM","SVM",1,16,1084,1069,15,1700,1467,233,0.763183216783214,0.188811188811189,1.23898037446425,616,233,383,22,1.6,61.06,6.3,0,0,0,0,0,0,0.0968839562522845,29.2571008386842,10.9983196358226
9.7,"eps_greedy_SVM","SVM",1,17,984,970,14,1800,1566,234,0.747132867132865,0.202797202797203,1.23898037446425,626,234,392,10,1.7,64.66,6.7,0,0,0,0,0,0,0.0739639314094465,18.8765676290531,8.83202201001584
9.7,"eps_greedy_SVM","SVM",1,18,884,871,13,1900,1665,235,0.738601398601396,0.174825174825175,1.23898037446425,615,235,380,-11,1.6,68.25,7.1,0,0,0,0,0,0,0.0582778794223241,12.490639602127,8.411688439868
9.7,"eps_greedy_SVM","SVM",1,19,784,771,13,2000,1765,235,0.766120279720279,0.251748251748252,1.23783950855774,619,235,384,4,1.6,71.84,7.5,0,0,0,0,0,0,0.00287945335515321,1.20444426152722,1.19052522921234
9.7,"eps_greedy_SVM","SVM",1,20,684,671,13,2100,1865,235,0.778332867132866,0.223776223776224,1.23898037446425,617,235,382,-2,1.6,75.43,7.9,0,0,0,0,0,0,1.87579700701524e-06,0.309062032904376,0.309004107227755
9.7,"eps_greedy_SVM","SVM",1,21,584,578,6,2200,1958,242,0.731384615384616,0.153846153846154,1.25577921158032,665,242,423,48,1.7,79.02,8.1,0,0,0,0,0,0,0.115498699200614,35.0022400948089,17.5896531329437
9.7,"eps_greedy_SVM","SVM",1,22,484,479,5,2300,2057,243,0.762271328671328,0.216783216783217,1.25577921158032,678,243,435,13,1.8,82.61,8.5,0,0,0,0,0,0,0.0620434781147073,19.1013195928797,7.6486402436545
9.7,"eps_greedy_SVM","SVM",1,23,384,380,4,2400,2156,244,0.74681958041958,0.20979020979021,1.25577921158032,673,244,429,-5,1.8,86.21,8.8,0,0,0,0,0,0,0.0476357748394784,12.1775172248746,6.43628978770911
9.7,"eps_greedy_SVM","SVM",1,24,284,282,2,2500,2254,246,0.779395804195804,0.216783216783217,1.28268876611418,691,246,445,18,1.8,89.8,9.2,0,0,0,0,0,0,0.0268522004764028,5.97595758449844,4.04930043006196
9.7,"eps_greedy_SVM","SVM",1,25,184,183,1,2600,2353,247,0.779255944055942,0.244755244755245,1.28268876611418,686,247,439,-5,1.8,93.39,9.5,0,0,0,0,0,0,1.862185162042e-06,0.236227849442354,0.236200126662706
9.7,"eps_greedy_SVM","SVM",1,26,84,83,1,2700,2453,247,0.747591608391608,0.181818181818182,1.28268876611418,681,247,434,-5,1.8,96.98,9.9,0,0,0,0,0,0,1.45036235071228e-09,0.0203300460988074,0.0203300460988074
9.7,"eps_greedy_SVM","SVM",1,27,0,0,0,2784,2536,248,0.76430769230769,0.202797202797203,1.27371891460289,708,248,460,27,1.9,100,10.2,0,0,0,0,0,0,0,0,0
9.7,"eps_greedy_SVM","SVM",2,0,2684,2438,246,100,89,11,0.750903939397533,0.246268656716418,1.23596533461724,32,11,21,0,1.9,3.59,8.1,0,0,0,0,0,0,0.125532650621015,301.852585932197,14.578560630903
9.7,"eps_greedy_SVM","SVM",2,1,2584,2339,245,200,188,12,0.73081573862222,0.238805970149254,1.2263842079923,39,12,27,7,2.2,7.18,15.7,0,0,0,0,0,0,0.155876253199436,228.235587241163,17.8451560153445
9.7,"eps_greedy_SVM","SVM",2,2,2484,2270,214,300,257,43,0.749949616492598,0.149253731343284,1.23596533461724,114,43,71,75,1.7,10.78,6,0,0,0,0,0,0,0.278265923512577,387.027929393227,45.2787004956014
9.7,"eps_greedy_SVM","SVM",2,3,2384,2181,203,400,346,54,0.775526655839152,0.201492537313433,1.24554646124218,149,54,95,35,1.8,14.37,6.4,0,0,0,0,0,0,0.218766834238271,328.041180531978,26.1008611737282
9.7,"eps_greedy_SVM","SVM",2,4,2284,2094,190,500,433,67,0.78653989781039,0.23134328358209,1.26470871449206,178,67,111,29,1.7,17.96,6.5,0,0,0,0,0,0,0.183114436695891,283.877468743007,19.4635871852028
9.7,"eps_greedy_SVM","SVM",2,5,2184,2012,172,600,515,85,0.795063601768758,0.23134328358209,1.25512758786712,240,85,155,62,1.8,21.55,6.1,0,0,0,0,0,0,0.198792792692558,222.525701225404,20.3944073119212
9.7,"eps_greedy_SVM","SVM",2,6,2084,1940,144,700,587,113,0.81484950149965,0.283582089552239,1.25512758786712,294,113,181,54,1.6,25.14,5.2,0,0,0,0,0,0,0.198209080293752,243.662575012463,20.1171430680801
9.7,"eps_greedy_SVM","SVM",2,7,1984,1867,117,800,660,140,0.814073002738492,0.298507462686567,1.25512758786712,375,140,235,81,1.7,28.74,4.7,0,0,0,0,0,0,0.211831079668158,203.407679870986,21.5608686519108
9.7,"eps_greedy_SVM","SVM",2,8,1884,1796,88,900,731,169,0.821950612307803,0.343283582089552,1.25512758786712,435,169,266,60,1.6,32.33,4.3,0,0,0,0,0,0,0.225049913031526,158.554908723428,23.0588259652363
9.7,"eps_greedy_SVM","SVM",2,9,1784,1726,58,1000,801,199,0.816034995791497,0.283582089552239,1.26470871449206,497,199,298,62,1.5,35.92,4,0,0,0,0,0,0,0.222926875157315,175.617949292179,23.0316088738215
9.7,"eps_greedy_SVM","SVM",2,10,1684,1638,46,1100,889,211,0.813130534776476,0.298507462686567,1.24554646124218,542,211,331,45,1.6,39.51,4.2,0,0,0,0,0,0,0.202707960111841,145.952233491667,21.2655560606431
9.7,"eps_greedy_SVM","SVM",2,11,1584,1555,29,1200,972,228,0.816509193508234,0.313432835820896,1.24554646124218,604,228,376,62,1.6,43.1,4.3,0,0,0,0,0,0,0.198100445373165,128.997094652031,20.7923349571847
9.7,"eps_greedy_SVM","SVM",2,12,1484,1465,19,1300,1062,238,0.815708984861238,0.291044776119403,1.24554646124218,617,238,379,13,1.6,46.7,4.5,0,0,0,0,0,0,0.174375964304296,94.6411854223514,18.5438089727842
9.7,"eps_greedy_SVM","SVM",2,13,1384,1368,16,1400,1159,241,0.805875309710383,0.276119402985075,1.24554646124218,617,241,376,0,1.6,50.29,4.8,0,0,0,0,0,0,0.144914722418491,70.2946478145734,16.1545830717183
9.7,"eps_greedy_SVM","SVM",2,14,1284,1270,14,1500,1257,243,0.805744905338281,0.26865671641791,1.23596533461724,629,243,386,12,1.6,53.88,5.2,0,0,0,0,0,0,0.10999268470105,54.2486262061362,12.9602768091727
9.7,"eps_greedy_SVM","SVM",2,15,1184,1172,12,1600,1355,245,0.761798631939586,0.171641791044776,1.20722195474242,647,245,402,18,1.6,57.47,5.5,0,0,0,0,0,0,0.0987949171482757,45.1527952165,13.4761806603289
9.7,"eps_greedy_SVM","SVM",2,16,1084,1072,12,1700,1455,245,0.801204462200514,0.276119402985075,1.20722195474242,656,245,411,9,1.7,61.06,5.9,0,0,0,0,0,0,0.0589560027552291,21.0338845967038,7.11926960659009
9.7,"eps_greedy_SVM","SVM",2,17,984,973,11,1800,1554,246,0.801915758775623,0.26865671641791,1.19764082811748,646,246,400,-10,1.6,64.66,6.3,0,0,0,0,0,0,0.068214483435499,29.5506069321634,8.41323501720705
9.7,"eps_greedy_SVM","SVM",2,18,884,873,11,1900,1654,246,0.774809431792585,0.253731343283582,1.19764082811748,648,246,402,2,1.6,68.25,6.7,0,0,0,0,0,0,0.0598277676463913,20.6316724703472,7.21220380055124
9.7,"eps_greedy_SVM","SVM",2,19,784,773,11,2000,1754,246,0.779367657344729,0.208955223880597,1.19764082811748,654,246,408,6,1.7,71.84,7.1,0,0,0,0,0,0,0.0216827733770483,6.90354824383564,3.08038857399641
9.7,"eps_greedy_SVM","SVM",2,20,684,675,9,2100,1852,248,0.821304517918745,0.32089552238806,1.23596533461724,658,248,410,4,1.7,75.43,7.5,0,0,0,0,0,0,0.0274129947038084,9.69438155101816,3.56849068398567
9.7,"eps_greedy_SVM","SVM",2,21,584,576,8,2200,1951,249,0.81953220395244,0.335820895522388,1.26470871449206,664,249,415,6,1.7,79.02,7.8,0,0,0,0,0,0,0.0151733588999158,4.04653638246268,2.50194759125195
9.7,"eps_greedy_SVM","SVM",2,22,484,480,4,2300,2047,253,0.807754318162962,0.261194029850746,1.26470871449206,681,253,428,17,1.7,82.61,8.1,0,0,0,0,0,0,0.00437656161917704,2.98060453543072,2.56755269167966
9.7,"eps_greedy_SVM","SVM",2,23,384,383,1,2400,2144,256,0.81356916766446,0.283582089552239,1.26470871449206,690,256,434,9,1.7,86.21,8.4,0,0,0,0,0,0,0.000893968186239444,0.530790111448219,0.478632966367071
9.7,"eps_greedy_SVM","SVM",2,24,284,284,0,2500,2243,257,0.799740376750089,0.238805970149254,1.26470871449206,693,257,436,3,1.7,89.8,8.7,0,0,0,0,0,0,0.000358193568547811,0.253417871242502,0.239145839618621
9.7,"eps_greedy_SVM","SVM",2,25,184,184,0,2600,2343,257,0.812810451317679,0.261194029850746,1.26470871449206,703,257,446,10,1.7,93.39,9.1,0,0,0,0,0,0,1.13102880922005e-05,0.0101014692379127,0.00972360833197825
9.7,"eps_greedy_SVM","SVM",2,26,84,84,0,2700,2443,257,0.817961424015749,0.253731343283582,1.26470871449206,702,257,445,-1,1.7,96.98,9.5,0,0,0,0,0,0,1.0000000994736e-07,8.38037069400983e-05,8.38037069400983e-05
9.7,"eps_greedy_SVM","SVM",2,27,0,0,0,2784,2527,257,0.774791649378214,0.216417910447761,1.26470871449206,699,257,442,-3,1.7,100,9.8,0,0,0,0,0,0,0,0,0
9.7,"eps_greedy_SVM","SVM",3,0,2684,2447,237,100,85,15,0.690435211639306,0.172661870503597,1.05295892318403,41,15,26,0,1.7,3.59,5.7,0,0,0,0,0,0,0.397026325721534,414.697482464903,42.1728417550085
9.7,"eps_greedy_SVM","SVM",3,1,2584,2353,231,200,179,21,0.670585063050048,0.115107913669065,1.0899048503133,57,21,36,16,1.7,7.18,8.5,0,0,0,0,0,0,0.606003890651635,320.398474150678,79.3024944711395
9.7,"eps_greedy_SVM","SVM",3,2,2484,2263,221,300,269,31,0.752699275985915,0.309352517985612,1.22845207704804,77,31,46,20,1.5,10.78,8.7,0,0,0,0,0,0,0.107399572184531,244.051951882982,11.1725857084471
9.7,"eps_greedy_SVM","SVM",3,3,2384,2181,203,400,351,49,0.785004532259367,0.280575539568345,1.21921559526572,127,49,78,50,1.6,14.37,7.2,0,0,0,0,0,0,0.177277749134927,198.668276862456,22.0779207569167
9.7,"eps_greedy_SVM","SVM",3,4,2284,2107,177,500,425,75,0.737811664543969,0.251798561151079,1.20074263170109,187,75,112,60,1.5,17.96,5.7,0,0,0,0,0,0,0.18168340246357,168.596410968076,20.9732403251295
9.7,"eps_greedy_SVM","SVM",3,5,2184,2024,160,600,508,92,0.773673883859423,0.273381294964029,1.24692504061267,224,92,132,37,1.4,21.55,5.5,0,0,0,0,0,0,0.178832022845415,179.218554768256,18.6829520982236
9.7,"eps_greedy_SVM","SVM",3,6,2084,1955,129,700,577,123,0.792319254644134,0.302158273381295,1.24692504061267,298,123,175,74,1.4,25.14,4.7,0,0,0,0,0,0,0.18315871107775,159.478656107561,19.5806403137301
9.7,"eps_greedy_SVM","SVM",3,7,1984,1878,106,800,654,146,0.787150184158896,0.287769784172662,1.24692504061267,350,146,204,52,1.4,28.74,4.5,0,0,0,0,0,0,0.193850830375202,171.574487130082,19.7639263385613
9.7,"eps_greedy_SVM","SVM",3,8,1884,1807,77,900,725,175,0.793300287999272,0.309352517985612,1.24692504061267,412,175,237,62,1.4,32.33,4.1,0,0,0,0,0,0,0.186981697796596,128.126680668863,19.9611536708092
9.7,"eps_greedy_SVM","SVM",3,9,1784,1720,64,1000,812,188,0.791736945371935,0.302158273381295,1.24577685917564,454,188,266,42,1.4,35.92,4.3,0,0,0,0,0,0,0.134035194313344,63.6695767709111,15.4011379429395
9.7,"eps_greedy_SVM","SVM",3,10,1684,1630,54,1100,902,198,0.786427317476165,0.273381294964029,1.24692504061267,491,198,293,37,1.5,39.51,4.6,0,0,0,0,0,0,0.127038138012523,61.7780680301913,15.1512337703252
9.7,"eps_greedy_SVM","SVM",3,11,1584,1534,50,1200,998,202,0.794028891719162,0.302158273381295,1.24692504061267,494,202,292,3,1.4,43.1,4.9,0,0,0,0,0,0,0.0946594131361302,42.2267314900322,10.8545447807066
9.7,"eps_greedy_SVM","SVM",3,12,1484,1439,45,1300,1093,207,0.788039424919395,0.266187050359712,1.24692504061267,511,207,304,17,1.5,46.7,5.3,0,0,0,0,0,0,0.0987553616548908,46.2500129886167,11.6521841498201
9.7,"eps_greedy_SVM","SVM",3,13,1384,1353,31,1400,1179,221,0.808164951292559,0.294964028776978,1.21921559526572,571,221,350,60,1.6,50.29,5.3,0,0,0,0,0,0,0.155358278493601,76.9280297656914,16.6142722799117
9.7,"eps_greedy_SVM","SVM",3,14,1284,1262,22,1500,1270,230,0.805738184571964,0.287769784172662,1.21921559526572,580,230,350,9,1.5,53.88,5.5,0,0,0,0,0,0,0.11524984414852,45.1861850440414,13.42690920915
9.7,"eps_greedy_SVM","SVM",3,15,1184,1169,15,1600,1363,237,0.80690854015353,0.266187050359712,1.20997911348341,605,237,368,25,1.6,57.47,5.8,0,0,0,0,0,0,0.102121204518954,38.3555650007607,11.8201881785053
9.7,"eps_greedy_SVM","SVM",3,16,1084,1070,14,1700,1462,238,0.804688306770858,0.280575539568345,1.20997911348341,617,238,379,12,1.6,61.06,6.1,0,0,0,0,0,0,0.0612561089022297,17.9654235834904,7.65452570579771
9.7,"eps_greedy_SVM","SVM",3,17,984,970,14,1800,1562,238,0.811997292118466,0.280575539568345,1.20997911348341,621,238,383,4,1.6,64.66,6.6,0,0,0,0,0,0,0.0383956912552923,9.02004770231646,5.07072594598721
9.7,"eps_greedy_SVM","SVM",3,18,884,871,13,1900,1661,239,0.813609399561698,0.273381294964029,1.23768855883036,628,239,389,7,1.6,68.25,6.9,0,0,0,0,0,0,0.00675087507340986,1.84267845518597,1.43766591900016
9.7,"eps_greedy_SVM","SVM",3,19,784,773,11,2000,1759,241,0.82823310729408,0.323741007194245,1.23768855883036,628,241,387,0,1.6,71.84,7.3,0,0,0,0,0,0,0.00263515285069181,1.99685486955798,1.89264470515763
9.7,"eps_greedy_SVM","SVM",3,20,684,676,8,2100,1856,244,0.820184044152248,0.316546762589928,1.25616152239499,631,244,387,3,1.6,75.43,7.6,0,0,0,0,0,0,0.00975219011420275,3.64999425958466,1.40910760828438
9.7,"eps_greedy_SVM","SVM",3,21,584,578,6,2200,1954,246,0.805543125308373,0.23021582733813,1.24692504061267,645,246,399,14,1.6,79.02,7.9,0,0,0,0,0,0,0.0968955117992624,29.0665800681455,13.7034631210215
9.7,"eps_greedy_SVM","SVM",3,22,484,478,6,2300,2054,246,0.839334274207433,0.323741007194245,1.24692504061267,648,246,402,3,1.6,82.61,8.3,0,0,0,0,0,0,0.0728345299453443,22.6018868850767,8.76765820419624
9.7,"eps_greedy_SVM","SVM",3,23,384,379,5,2400,2153,247,0.822381329386253,0.280575539568345,1.28387096774194,647,247,400,-1,1.6,86.21,8.7,0,0,0,0,0,0,0.0211376146786663,6.00880427854293,3.9743505439301
9.7,"eps_greedy_SVM","SVM",3,24,284,281,3,2500,2251,249,0.835335559303758,0.294964028776978,1.28387096774194,670,249,421,23,1.7,89.8,9,0,0,0,0,0,0,0.0134331379115671,3.93168563295913,3.29876030468153
9.7,"eps_greedy_SVM","SVM",3,25,184,183,1,2600,2349,251,0.804005599348277,0.223021582733813,1.28387096774194,680,251,429,10,1.7,93.39,9.4,0,0,0,0,0,0,0.000654528667857579,0.853802783824333,0.836475071498055
9.7,"eps_greedy_SVM","SVM",3,26,84,84,0,2700,2448,252,0.843568207634849,0.309352517985612,1.28387096774194,694,252,442,14,1.8,96.98,9.7,0,0,0,0,0,0,1.68512305951933e-05,0.819653526739611,0.819653526739611
9.7,"eps_greedy_SVM","SVM",3,27,0,0,0,2784,2532,252,0.830436129565247,0.302158273381295,1.27463448595962,669,252,417,-25,1.7,100,10,0,0,0,0,0,0,0,0,0
9.7,"eps_greedy_SVM","SVM",4,0,2684,2435,249,100,92,8,0.719227531919439,0.26865671641791,1.21680308136736,29,8,21,0,2.6,3.59,11.5,0,0,0,0,0,0,0.109879871932389,230.430067283199,11.9707329096446
9.7,"eps_greedy_SVM","SVM",4,1,2584,2362,222,200,165,35,0.763452396476715,0.0970149253731343,1.25512758786712,96,35,61,67,1.7,7.18,4.7,0,0,0,0,0,0,0.230140247569738,371.29483771387,24.4651309970366
9.7,"eps_greedy_SVM","SVM",4,2,2484,2277,207,300,250,50,0.718415468329522,0.186567164179104,1.23596533461724,138,50,88,42,1.8,10.78,5,0,0,0,0,0,0,0.187152864474089,339.512312315852,21.2579590635686
9.7,"eps_greedy_SVM","SVM",4,3,2384,2190,194,400,337,63,0.796154256517257,0.149253731343284,1.274289841117,173,63,110,35,1.7,14.37,5.3,0,0,0,0,0,0,0.188220817664788,324.530004876988,23.4153809821048
9.7,"eps_greedy_SVM","SVM",4,4,2284,2096,188,500,431,69,0.808637511410387,0.276119402985075,1.28387096774194,198,69,129,25,1.9,17.96,6.2,0,0,0,0,0,0,0.168864383562579,203.611050334238,17.5546730233214
9.7,"eps_greedy_SVM","SVM",4,5,2184,2030,154,600,497,103,0.815975721076907,0.276119402985075,1.274289841117,267,103,164,69,1.6,21.55,4.8,0,0,0,0,0,0,0.18744350729453,175.063459804002,19.4986730722018
9.7,"eps_greedy_SVM","SVM",4,6,2084,1964,120,700,563,137,0.829976408663597,0.305970149253731,1.274289841117,345,137,208,78,1.5,25.14,4.1,0,0,0,0,0,0,0.216218386837628,164.579949457795,22.661513603023
9.7,"eps_greedy_SVM","SVM",4,7,1984,1896,88,800,631,169,0.828435266084199,0.253731343283582,1.274289841117,423,169,254,78,1.5,28.74,3.7,0,0,0,0,0,0,0.216172261632407,227.788695614487,22.4992291516477
9.7,"eps_greedy_SVM","SVM",4,8,1884,1824,60,900,703,197,0.821446777233772,0.246268656716418,1.274289841117,474,197,277,51,1.4,32.33,3.6,0,0,0,0,0,0,0.196919958948055,149.55970457171,21.2612684906875
9.7,"eps_greedy_SVM","SVM",4,9,1784,1735,49,1000,792,208,0.811358220810171,0.261194029850746,1.274289841117,515,208,307,41,1.5,35.92,3.8,0,0,0,0,0,0,0.197893864610628,171.890886608756,21.4640526685325
9.7,"eps_greedy_SVM","SVM",4,10,1684,1644,40,1100,883,217,0.810297203418969,0.238805970149254,1.274289841117,556,217,339,41,1.6,39.51,4.1,0,0,0,0,0,0,0.184965336767226,158.731937005432,19.8119239189208
9.7,"eps_greedy_SVM","SVM",4,11,1584,1553,31,1200,974,226,0.830924804097072,0.313432835820896,1.274289841117,580,226,354,24,1.6,43.1,4.3,0,0,0,0,0,0,0.137216435077896,58.8273135334356,16.1182064911498
9.7,"eps_greedy_SVM","SVM",4,12,1484,1469,15,1300,1058,242,0.823586594430551,0.238805970149254,1.274289841117,638,242,396,58,1.6,46.7,4.4,0,0,0,0,0,0,0.159799828129729,106.08407968292,17.1648513991001
9.7,"eps_greedy_SVM","SVM",4,13,1384,1374,10,1400,1153,247,0.788750844664686,0.171641791044776,1.274289841117,641,247,394,3,1.6,50.29,4.7,0,0,0,0,0,0,0.175858309251116,99.4591857598503,22.6255922455331
9.7,"eps_greedy_SVM","SVM",4,14,1284,1276,8,1500,1251,249,0.788887176508248,0.186567164179104,1.26470871449206,654,249,405,13,1.6,53.88,5,0,0,0,0,0,0,0.11812262210033,47.4566070675932,14.3543374811313
9.7,"eps_greedy_SVM","SVM",4,15,1184,1179,5,1600,1348,252,0.804755017604593,0.283582089552239,1.26470871449206,672,252,420,18,1.7,57.47,5.3,0,0,0,0,0,0,0.13433140799249,66.5127216668892,18.0497374643714
9.7,"eps_greedy_SVM","SVM",4,16,1084,1082,2,1700,1445,255,0.815294061859096,0.291044776119403,1.274289841117,702,255,447,30,1.8,61.06,5.7,0,0,0,0,0,0,0.0801743571434807,33.8898410058741,9.87265505468965
9.7,"eps_greedy_SVM","SVM",4,17,984,982,2,1800,1545,255,0.8050158263488,0.253731343283582,1.274289841117,701,255,446,-1,1.7,64.66,6.1,0,0,0,0,0,0,0.0819087538638211,35.5164308133261,9.33452462532868
9.7,"eps_greedy_SVM","SVM",4,18,884,883,1,1900,1644,256,0.762023875855041,0.171641791044776,1.274289841117,693,256,437,-8,1.7,68.25,6.4,0,0,0,0,0,0,0.0595653876129646,19.9834241902415,7.82106446924302
9.7,"eps_greedy_SVM","SVM",4,19,784,783,1,2000,1744,256,0.784856495915977,0.208955223880597,1.274289841117,703,256,447,10,1.7,71.84,6.8,0,0,0,0,0,0,0.035149929499568,10.8290182237682,5.06853424121932
9.7,"eps_greedy_SVM","SVM",4,20,684,683,1,2100,1844,256,0.790641708060178,0.238805970149254,1.274289841117,708,256,452,5,1.8,75.43,7.2,0,0,0,0,0,0,0.0288508784498292,8.70627449972831,3.9698223813172
9.7,"eps_greedy_SVM","SVM",4,21,584,583,1,2200,1944,256,0.774542695576925,0.223880597014925,1.274289841117,703,256,447,-5,1.7,79.02,7.6,0,0,0,0,0,0,0.0102021796444515,2.94657140018604,1.68524328377914
9.7,"eps_greedy_SVM","SVM",4,22,484,483,1,2300,2044,256,0.777613125792804,0.186567164179104,1.26470871449206,692,256,436,-11,1.7,82.61,8,0,0,0,0,0,0,0.00327384393334532,0.980231942612714,0.718193347318798
9.7,"eps_greedy_SVM","SVM",4,23,384,384,0,2400,2143,257,0.79100921129065,0.216417910447761,1.274289841117,717,257,460,25,1.8,86.21,8.3,0,0,0,0,0,0,0.000360998730245598,0.254663614695374,0.239468375245153
9.7,"eps_greedy_SVM","SVM",4,24,284,284,0,2500,2243,257,0.779284672744303,0.186567164179104,1.274289841117,723,257,466,6,1.8,89.8,8.7,0,0,0,0,0,0,0.00035920845340516,0.115867794319089,0.0986383687839683
9.7,"eps_greedy_SVM","SVM",4,25,184,184,0,2600,2343,257,0.806005714082491,0.26865671641791,1.26470871449206,707,257,450,-16,1.8,93.39,9.1,0,0,0,0,0,0,1.44214404303767e-05,0.0294235826873651,0.0291091555475594
9.7,"eps_greedy_SVM","SVM",4,26,84,84,0,2700,2443,257,0.767838725356542,0.156716417910448,1.274289841117,700,257,443,-7,1.7,96.98,9.5,0,0,0,0,0,0,1.0000000994736e-07,0.000570046149845457,0.000570046149845457
9.7,"eps_greedy_SVM","SVM",4,27,0,0,0,2784,2527,257,0.774157409932073,0.186567164179104,1.274289841117,714,257,457,14,1.8,100,9.8,0,0,0,0,0,0,0,0,0
9.7,"eps_greedy_SVM","SVM",5,0,2684,2432,252,100,89,11,0.74890686758893,0.34375,1.07323588709677,25,11,14,0,1.3,3.59,8.1,0,0,0,0,0,0,0.181600994689075,287.759373159024,18.9537319833917
9.7,"eps_greedy_SVM","SVM",5,1,2584,2370,214,200,151,49,0.686030138339924,0.109375,1.16350806451613,113,49,64,88,1.3,7.18,3.1,0,0,0,0,0,0,0.283767147501806,588.96197109521,33.0553443208188
9.7,"eps_greedy_SVM","SVM",5,2,2484,2285,199,300,236,64,0.73998888339921,0.125,1.25378024193548,165,64,101,52,1.6,10.78,3.7,0,0,0,0,0,0,0.236815297010896,529.439705405822,24.3117219718405
9.7,"eps_greedy_SVM","SVM",5,3,2384,2192,192,400,329,71,0.828489377470355,0.2421875,1.28387096774194,169,71,98,4,1.4,14.37,4.6,0,0,0,0,0,0,0.277724181340289,221.351536366057,47.0313679742062
9.7,"eps_greedy_SVM","SVM",5,4,2284,2109,175,500,412,88,0.804076086956518,0.2734375,1.21365927419355,215,88,127,46,1.4,17.96,4.7,0,0,0,0,0,0,0.235570611971174,246.971438192725,32.3415857344821
9.7,"eps_greedy_SVM","SVM",5,5,2184,2037,147,600,484,116,0.819244071146253,0.2421875,1.25378024193548,283,116,167,68,1.4,21.55,4.2,0,0,0,0,0,0,0.214261345820794,246.621479600673,24.337609410372
9.7,"eps_greedy_SVM","SVM",5,6,2084,1958,126,700,563,137,0.818157114624509,0.25,1.26381048387097,337,137,200,54,1.5,25.14,4.1,0,0,0,0,0,0,0.219293092044394,188.745553403643,22.4231050884407
9.7,"eps_greedy_SVM","SVM",5,7,1984,1886,98,800,635,165,0.824876482213444,0.28125,1.26381048387097,410,165,245,73,1.5,28.74,3.8,0,0,0,0,0,0,0.213799374666886,132.707768119364,22.0798585145062
9.7,"eps_greedy_SVM","SVM",5,8,1884,1810,74,900,711,189,0.83244194664032,0.3046875,1.26381048387097,453,189,264,43,1.4,32.33,3.8,0,0,0,0,0,0,0.198622808543,112.085023112266,21.1697377784938
9.7,"eps_greedy_SVM","SVM",5,9,1784,1729,55,1000,792,208,0.83958745059289,0.3125,1.26381048387097,496,208,288,43,1.4,35.92,3.8,0,0,0,0,0,0,0.17054094308415,74.819833751876,18.9811604175468
9.7,"eps_greedy_SVM","SVM",5,10,1684,1645,39,1100,876,224,0.826025197628464,0.2734375,1.26381048387097,544,224,320,48,1.4,39.51,3.9,0,0,0,0,0,0,0.180009739667431,100.147918653401,19.031692647174
9.7,"eps_greedy_SVM","SVM",5,11,1584,1557,27,1200,964,236,0.831392045454551,0.3125,1.26381048387097,584,236,348,40,1.5,43.1,4.1,0,0,0,0,0,0,0.151521625102176,52.5544649495575,17.9393190066777
9.7,"eps_greedy_SVM","SVM",5,12,1484,1462,22,1300,1059,241,0.801519268774708,0.2421875,1.25378024193548,608,241,367,24,1.5,46.7,4.4,0,0,0,0,0,0,0.137110411877513,41.5842031355124,16.1823594676159
9.7,"eps_greedy_SVM","SVM",5,13,1384,1362,22,1400,1159,241,0.810221096837947,0.234375,1.26148516559338,601,241,360,-7,1.5,50.29,4.8,0,0,0,0,0,0,0.0696142271940401,17.0292701287828,9.4045361157653
9.7,"eps_greedy_SVM","SVM",5,14,1284,1265,19,1500,1256,244,0.809767168972339,0.2421875,1.25262574815838,613,244,369,12,1.5,53.88,5.1,0,0,0,0,0,0,0.0468183200142726,12.6806917409853,6.91551307371296
9.7,"eps_greedy_SVM","SVM",5,15,1184,1166,18,1600,1355,245,0.806441452569174,0.2734375,1.25378024193548,625,245,380,12,1.6,57.47,5.5,0,0,0,0,0,0,0.0744724342394468,24.5277214315037,9.20212159773727
9.7,"eps_greedy_SVM","SVM",5,16,1084,1067,17,1700,1454,246,0.812407361660086,0.296875,1.25147337856486,630,246,384,5,1.6,61.06,5.9,0,0,0,0,0,0,0.0813644235099817,21.1788883444057,10.4180150367563
9.7,"eps_greedy_SVM","SVM",5,17,984,968,16,1800,1553,247,0.771059782608704,0.1875,1.25147337856486,627,247,380,-3,1.5,64.66,6.3,0,0,0,0,0,0,0.0510300370656409,11.5656278359401,7.93140642644566
9.7,"eps_greedy_SVM","SVM",5,18,884,868,16,1900,1653,247,0.803473937747044,0.28125,1.25262574815838,635,247,388,8,1.6,68.25,6.7,0,0,0,0,0,0,0.0226946546059826,5.28128838101177,4.27839325354681
9.7,"eps_greedy_SVM","SVM",5,19,784,768,16,2000,1753,247,0.79552248023716,0.2890625,1.25147337856486,643,247,396,8,1.6,71.84,7.1,0,0,0,0,0,0,0.000304491712374024,0.59220590505598,0.581853941488781
9.7,"eps_greedy_SVM","SVM",5,20,684,670,14,2100,1851,249,0.770988759881427,0.2265625,1.27266776012891,643,249,394,0,1.6,75.43,7.4,0,0,0,0,0,0,0.00013440722146147,0.126230912338501,0.118352514677459
9.7,"eps_greedy_SVM","SVM",5,21,584,577,7,2200,1944,256,0.726296936758894,0.1796875,1.28268876611418,704,256,448,61,1.8,79.02,7.6,0,0,0,0,0,0,0.0974315456461567,34.133352059551,13.427122889862
9.7,"eps_greedy_SVM","SVM",5,22,484,482,2,2300,2039,261,0.775160573122529,0.203125,1.28268876611418,694,261,433,-10,1.7,82.61,7.8,0,0,0,0,0,0,0.0887811052474337,22.8295263136736,11.8369024637147
9.7,"eps_greedy_SVM","SVM",5,23,384,382,2,2400,2139,261,0.828927865612652,0.2890625,1.28268876611418,718,261,457,24,1.8,86.21,8.2,0,0,0,0,0,0,0.0557208394546136,12.335914687504,6.97858732792179
9.7,"eps_greedy_SVM","SVM",5,24,284,282,2,2500,2239,261,0.802377717391306,0.234375,1.28268876611418,695,261,434,-23,1.7,89.8,8.6,0,0,0,0,0,0,0.022578299542175,5.68891604043182,4.27727950446511
9.7,"eps_greedy_SVM","SVM",5,25,184,183,1,2600,2338,262,0.804366353754943,0.296875,1.28268876611418,717,262,455,22,1.7,93.39,8.9,0,0,0,0,0,0,0.0308358049830937,8.13746006981147,6.90641672896276
9.7,"eps_greedy_SVM","SVM",5,26,84,84,0,2700,2437,263,0.798554841897232,0.2578125,1.28268876611418,722,263,459,5,1.7,96.98,9.3,0,0,0,0,0,0,2.38153450944488e-07,0.6808643207209,0.6808643207209
9.7,"eps_greedy_SVM","SVM",5,27,0,0,0,2784,2521,263,0.761166007905139,0.1953125,1.28268876611418,729,263,466,7,1.8,100,9.6,0,0,0,0,0,0,0,0,0
9.7,"eps_greedy_SVM","SVM",6,0,2684,2422,262,100,93,7,0.68016019398692,0.0901639344262295,1.26282390269699,26,7,19,0,2.7,3.59,13.3,0,0,0,0,0,0,0.102415930980949,216.141262833793,11.3377992104366
9.7,"eps_greedy_SVM","SVM",6,1,2584,2332,252,200,183,17,0.711644374508259,0.286885245901639,1.18915917503966,57,17,40,31,2.4,7.18,10.8,0,0,0,0,0,0,0.0916008169564468,219.156147664558,9.27919806454636
9.7,"eps_greedy_SVM","SVM",6,2,2484,2258,226,300,257,43,0.639157240329673,0.221311475409836,1.08392384981491,122,43,79,65,1.8,10.78,6,0,0,0,0,0,0,0.184578422284825,290.208186347635,21.4571764571284
9.7,"eps_greedy_SVM","SVM",6,3,2384,2180,204,400,335,65,0.645103249022977,0.172131147540984,1.16811210999471,170,65,105,48,1.6,14.37,5.2,0,0,0,0,0,0,0.179605507277954,276.526362506676,18.8551961957307
9.7,"eps_greedy_SVM","SVM",6,4,2284,2089,195,500,426,74,0.675865137815834,0.213114754098361,1.15758857747224,195,74,121,25,1.6,17.96,5.8,0,0,0,0,0,0,0.155699401507365,185.325419182607,16.229439609336
9.7,"eps_greedy_SVM","SVM",6,5,2184,2005,179,600,510,90,0.683158994466727,0.245901639344262,1.14706504494976,227,90,137,32,1.5,21.55,5.7,0,0,0,0,0,0,0.148910242074268,217.731185079171,15.1905992791811
9.7,"eps_greedy_SVM","SVM",6,6,2084,1914,170,700,601,99,0.691239633178983,0.245901639344262,1.19968270756214,247,99,148,20,1.5,25.14,6.1,0,0,0,0,0,0,0.129436213016934,142.663765910832,13.3853775765061
9.7,"eps_greedy_SVM","SVM",6,7,1984,1831,153,800,684,116,0.720286079116745,0.229508196721311,1.25230037017451,296,116,180,49,1.6,28.74,5.9,0,0,0,0,0,0,0.143172777703782,154.345897799701,14.8648949653568
9.7,"eps_greedy_SVM","SVM",6,8,1884,1750,134,900,765,135,0.729617830287242,0.229508196721311,1.25230037017451,349,135,214,53,1.6,32.33,5.7,0,0,0,0,0,0,0.140765424551365,112.982929301344,14.7460467195986
9.7,"eps_greedy_SVM","SVM",6,9,1784,1680,104,1000,835,165,0.759509099585969,0.295081967213115,1.26282390269699,411,165,246,62,1.5,35.92,5.1,0,0,0,0,0,0,0.14456249646717,91.8120163946978,15.8980097254937
9.7,"eps_greedy_SVM","SVM",6,10,1684,1604,80,1100,911,189,0.758483703292878,0.221311475409836,1.26282390269699,476,189,287,65,1.5,39.51,4.8,0,0,0,0,0,0,0.152141130249063,136.409975543455,16.0351662101607
9.7,"eps_greedy_SVM","SVM",6,11,1584,1517,67,1200,998,202,0.779907391881954,0.286885245901639,1.26282390269699,525,202,323,49,1.6,43.1,4.9,0,0,0,0,0,0,0.143944303201049,115.427549501205,15.5133270323208
9.7,"eps_greedy_SVM","SVM",6,12,1484,1426,58,1300,1089,211,0.794714372315588,0.295081967213115,1.27334743521946,541,211,330,16,1.6,46.7,5.2,0,0,0,0,0,0,0.134511273760085,104.396011878657,15.3757427324174
9.7,"eps_greedy_SVM","SVM",6,13,1384,1341,43,1400,1174,226,0.758599785892102,0.295081967213115,1.16811210999471,558,226,332,17,1.5,50.29,5.2,0,0,0,0,0,0,0.138807643854307,92.4914749209613,15.3473715080062
9.7,"eps_greedy_SVM","SVM",6,14,1284,1248,36,1500,1267,233,0.755368820213857,0.262295081967213,1.17863564251719,599,233,366,41,1.6,53.88,5.4,0,0,0,0,0,0,0.135318463751446,87.8356406572502,14.6283082274293
9.7,"eps_greedy_SVM","SVM",6,15,1184,1149,35,1600,1366,234,0.749790406418087,0.245901639344262,1.16811210999471,616,234,382,17,1.6,57.47,5.8,0,0,0,0,0,0,0.116211418154329,61.3171699458651,12.9915461663553
9.7,"eps_greedy_SVM","SVM",6,16,1084,1052,32,1700,1463,237,0.761102010808586,0.262295081967213,1.12601797990481,615,237,378,-1,1.6,61.06,6.2,0,0,0,0,0,0,0.110728663389639,70.8376951574099,12.1064461795383
9.7,"eps_greedy_SVM","SVM",6,17,984,953,31,1800,1562,238,0.747978228063615,0.278688524590164,1.16811210999471,627,238,389,12,1.6,64.66,6.6,0,0,0,0,0,0,0.0614252683358363,25.1239091254068,7.63498717704252
9.7,"eps_greedy_SVM","SVM",6,18,884,854,30,1900,1661,239,0.75743895989992,0.286885245901639,1.17863564251719,631,239,392,4,1.6,68.25,6.9,0,0,0,0,0,0,0.0508284801783911,21.1595991306891,6.30148909400995
9.7,"eps_greedy_SVM","SVM",6,19,784,754,30,2000,1761,239,0.763423662792945,0.278688524590164,1.17863564251719,621,239,382,-10,1.6,71.84,7.4,0,0,0,0,0,0,0.015465949458312,5.45128624012921,2.4903132900998
9.7,"eps_greedy_SVM","SVM",6,20,684,657,27,2100,1858,242,0.763455907959395,0.254098360655738,1.18915917503966,624,242,382,3,1.6,75.43,7.7,0,0,0,0,0,0,0.0227650944412327,8.7906793921685,4.05418325813149
9.7,"eps_greedy_SVM","SVM",6,21,584,567,17,2200,1948,252,0.803433465323546,0.245901639344262,1.25230037017451,666,252,414,42,1.6,79.02,7.7,0,0,0,0,0,0,0.0377726872785893,14.4050402005826,6.69033220944966
9.7,"eps_greedy_SVM","SVM",6,22,484,481,3,2300,2034,266,0.822922443925656,0.262295081967213,1.26282390269699,700,266,434,34,1.6,82.61,7.6,0,0,0,0,0,0,0.0289374316770825,10.4471263666481,5.05777377229278
9.7,"eps_greedy_SVM","SVM",6,23,384,384,0,2400,2131,269,0.831357779468861,0.295081967213115,1.26282390269699,713,269,444,13,1.7,86.21,7.9,0,0,0,0,0,0,0.0107280290942673,3.53430179972852,2.12644590552194
9.7,"eps_greedy_SVM","SVM",6,24,284,284,0,2500,2231,269,0.8163766751364,0.270491803278689,1.26282390269699,737,269,468,24,1.7,89.8,8.3,0,0,0,0,0,0,0.00120062124508631,0.42947956887562,0.338821750755128
9.7,"eps_greedy_SVM","SVM",6,25,184,184,0,2600,2331,269,0.831028878771074,0.311475409836066,1.26282390269699,719,269,450,-18,1.7,93.39,8.7,0,0,0,0,0,0,0.000247937169150148,0.0848035314476296,0.0727632977596787
9.7,"eps_greedy_SVM","SVM",6,26,84,84,0,2700,2431,269,0.817098966864865,0.262295081967213,1.27334743521946,712,269,443,-7,1.6,96.98,9,0,0,0,0,0,0,6.16659991244754e-06,0.119887580361366,0.119887580361366
9.7,"eps_greedy_SVM","SVM",6,27,0,0,0,2784,2515,269,0.829997033444688,0.270491803278689,1.26282390269699,699,269,430,-13,1.6,100,9.3,0,0,0,0,0,0,0,0,0
9.7,"eps_greedy_SVM","SVM",7,0,2684,2441,243,100,90,10,0.816525203533693,0.347826086956522,1.21906201519551,23,10,13,0,1.3,3.59,9,0,0,0,0,0,0,0.482200116001966,311.201412339137,50.9779478307274
9.7,"eps_greedy_SVM","SVM",7,1,2584,2377,207,200,154,46,0.838847508516662,0.333333333333333,1.27456755493221,105,46,59,82,1.3,7.18,3.3,0,0,0,0,0,0,0.314043715193094,495.525180948804,35.7555630139463
9.7,"eps_greedy_SVM","SVM",7,2,2484,2298,186,300,233,67,0.815220278307064,0.27536231884058,1.26526414212249,161,67,94,56,1.4,10.78,3.5,0,0,0,0,0,0,0.239198687528265,445.626123466482,26.5390474460935
9.7,"eps_greedy_SVM","SVM",7,3,2384,2217,167,400,314,86,0.878035683353545,0.384057971014493,1.28387096774194,211,86,125,50,1.5,14.37,3.7,0,0,0,0,0,0,0.24627435870555,224.31364885798,25.2425725960723
9.7,"eps_greedy_SVM","SVM",7,4,2284,2145,139,500,386,114,0.875523990992554,0.384057971014493,1.28387096774194,287,114,173,76,1.5,17.96,3.4,0,0,0,0,0,0,0.257375370694084,254.36057740131,26.0428377741341
9.7,"eps_greedy_SVM","SVM",7,5,2184,2078,106,600,453,147,0.879461862694153,0.41304347826087,1.27456755493221,362,147,215,75,1.5,21.55,3.1,0,0,0,0,0,0,0.256158513062759,181.000461898446,26.6648954508015
9.7,"eps_greedy_SVM","SVM",7,6,2084,2002,82,700,529,171,0.872654310295054,0.398550724637681,1.27456755493221,408,171,237,46,1.4,25.14,3.1,0,0,0,0,0,0,0.24608951556758,240.217955413934,25.4089066866253
9.7,"eps_greedy_SVM","SVM",7,7,1984,1916,68,800,615,185,0.861712570009818,0.434782608695652,1.27456755493221,455,185,270,47,1.5,28.74,3.3,0,0,0,0,0,0,0.224831808141615,213.545158209179,23.4785626166105
9.7,"eps_greedy_SVM","SVM",7,8,1884,1827,57,900,704,196,0.849079046134305,0.333333333333333,1.28387096774194,485,196,289,30,1.5,32.33,3.6,0,0,0,0,0,0,0.2078420367453,132.696167686926,21.7222921101983
9.7,"eps_greedy_SVM","SVM",7,9,1784,1733,51,1000,798,202,0.867024655003179,0.391304347826087,1.28387096774194,505,202,303,20,1.5,35.92,4,0,0,0,0,0,0,0.179960417119919,99.1645903752677,19.4280405908281
9.7,"eps_greedy_SVM","SVM",7,10,1684,1642,42,1100,889,211,0.856712281309548,0.333333333333333,1.28387096774194,538,211,327,33,1.5,39.51,4.2,0,0,0,0,0,0,0.148882618927201,55.2614005806603,16.9173078938529
9.7,"eps_greedy_SVM","SVM",7,11,1584,1547,37,1200,984,216,0.859368323806228,0.333333333333333,1.28387096774194,553,216,337,15,1.6,43.1,4.6,0,0,0,0,0,0,0.109199832332063,35.6879989850812,13.2877108916542
9.7,"eps_greedy_SVM","SVM",7,12,1484,1454,30,1300,1077,223,0.847878053005373,0.311594202898551,1.27456755493221,561,223,338,8,1.5,46.7,4.8,0,0,0,0,0,0,0.140430796664165,70.1567481840573,16.0550591848295
9.7,"eps_greedy_SVM","SVM",7,13,1384,1360,24,1400,1171,229,0.750228073214386,0.181159420289855,1.26526414212249,595,229,366,34,1.6,50.29,5.1,0,0,0,0,0,0,0.180512728221574,116.259531087953,18.8751338346252
9.7,"eps_greedy_SVM","SVM",7,14,1284,1260,24,1500,1271,229,0.830798544950632,0.260869565217391,1.27456755493221,573,229,344,-22,1.5,53.88,5.6,0,0,0,0,0,0,0.119333272896869,52.0999576371839,13.7256668576751
9.7,"eps_greedy_SVM","SVM",7,15,1184,1165,19,1600,1366,234,0.83854726023442,0.355072463768116,1.27456755493221,614,234,380,41,1.6,57.47,5.8,0,0,0,0,0,0,0.133245127569832,53.8599283224869,14.7671949279176
9.7,"eps_greedy_SVM","SVM",7,16,1084,1065,19,1700,1466,234,0.824031410589524,0.246376811594203,1.27456755493221,637,234,403,23,1.7,61.06,6.3,0,0,0,0,0,0,0.122134863835217,55.4745659128767,12.7743232357495
9.7,"eps_greedy_SVM","SVM",7,17,984,966,18,1800,1565,235,0.830192274380735,0.304347826086957,1.27456755493221,645,235,410,8,1.7,64.66,6.7,0,0,0,0,0,0,0.100974728929154,31.7132234938358,11.1454830511666
9.7,"eps_greedy_SVM","SVM",7,18,884,866,18,1900,1665,235,0.831618453721343,0.268115942028986,1.27456755493221,619,235,384,-26,1.6,68.25,7.1,0,0,0,0,0,0,0.0365129486510906,8.45476559223659,5.61758808862447
9.7,"eps_greedy_SVM","SVM",7,19,784,769,15,2000,1762,238,0.766274034297593,0.13768115942029,1.27456755493221,620,238,382,1,1.6,71.84,7.4,0,0,0,0,0,0,0.00442905160686884,1.74161212836896,1.54024691700869
9.7,"eps_greedy_SVM","SVM",7,20,684,671,13,2100,1860,240,0.817685778624632,0.304347826086957,1.27456755493221,628,240,388,8,1.6,75.43,7.8,0,0,0,0,0,0,0.00481391981491856,1.33780162251337,1.02673331365625
9.7,"eps_greedy_SVM","SVM",7,21,584,578,6,2200,1953,247,0.842485131936026,0.318840579710145,1.27456755493221,685,247,438,57,1.8,79.02,7.9,0,0,0,0,0,0,0.0998804587683494,32.104131058938,12.8899703360498
9.7,"eps_greedy_SVM","SVM",7,22,484,482,2,2300,2049,251,0.863525607714074,0.340579710144928,1.28387096774194,661,251,410,-24,1.6,82.61,8.2,0,0,0,0,0,0,0.0376205033351663,9.28083088753886,5.9170622486653
9.7,"eps_greedy_SVM","SVM",7,23,384,382,2,2400,2149,251,0.805646977308163,0.22463768115942,1.28387096774194,701,251,450,40,1.8,86.21,8.6,0,0,0,0,0,0,0.0117797362155795,3.17434413536549,2.53811013592965
9.7,"eps_greedy_SVM","SVM",7,24,284,283,1,2500,2248,252,0.790074484670018,0.195652173913043,1.27456755493221,704,252,452,3,1.8,89.8,8.9,0,0,0,0,0,0,0.0763630674489188,18.0717781816013,11.2940170168011
9.7,"eps_greedy_SVM","SVM",7,25,184,183,1,2600,2348,252,0.799307119348694,0.268115942028986,1.27456755493221,745,252,493,41,2,93.39,9.3,0,0,0,0,0,0,0.0063293075225256,3.01946837609595,2.82914676406189
9.7,"eps_greedy_SVM","SVM",7,26,84,84,0,2700,2447,253,0.815283792366769,0.27536231884058,1.26526414212249,732,253,479,-13,1.9,96.98,9.7,0,0,0,0,0,0,0.00169921142334681,1.62787140341121,1.62787140341121
9.7,"eps_greedy_SVM","SVM",7,27,0,0,0,2784,2531,253,0.842207979675505,0.355072463768116,1.27456755493221,720,253,467,-12,1.8,100,10,0,0,0,0,0,0,0,0,0
9.7,"eps_greedy_SVM","SVM",8,0,2684,2452,232,100,89,11,0.726598285032022,0.297297297297297,1.17109851787271,30,11,19,0,1.7,3.59,8.1,0,0,0,0,0,0,0.269087920593453,241.128425181546,33.9629128268824
9.7,"eps_greedy_SVM","SVM",8,1,2584,2392,192,200,149,51,0.64935417345056,0.182432432432432,1.1884481255449,111,51,60,81,1.2,7.18,2.9,0,0,0,0,0,0,0.283276925721548,475.746259585882,31.6581315847029
9.7,"eps_greedy_SVM","SVM",8,2,2484,2307,177,300,234,66,0.510278953652447,0.114864864864865,1.0409764603313,157,66,91,46,1.4,10.78,3.5,0,0,0,0,0,0,0.223927468588619,485.644433936274,23.200045372833
9.7,"eps_greedy_SVM","SVM",8,3,2384,2211,173,400,330,70,0.530212742863345,0.114864864864865,1.05832606800349,168,70,98,11,1.4,14.37,4.7,0,0,0,0,0,0,0.177914192875008,383.114244444338,17.9936329929877
9.7,"eps_greedy_SVM","SVM",8,4,2284,2119,165,500,422,78,0.636361662867685,0.22972972972973,1.09302528334786,191,78,113,23,1.4,17.96,5.4,0,0,0,0,0,0,0.156841670210564,261.299648902638,16.5180221678137
9.7,"eps_greedy_SVM","SVM",8,5,2184,2036,148,600,505,95,0.614251600998589,0.202702702702703,1.08435047951177,226,95,131,35,1.4,21.55,5.3,0,0,0,0,0,0,0.134013964086363,124.840345119765,14.3863197084417
9.7,"eps_greedy_SVM","SVM",8,6,2084,1941,143,700,600,100,0.63247584934332,0.209459459459459,1.13639930252833,242,100,142,16,1.4,25.14,6,0,0,0,0,0,0,0.119790805512479,122.54920798638,12.7732466169736
9.7,"eps_greedy_SVM","SVM",8,7,1984,1853,131,800,688,112,0.666379029632044,0.236486486486486,1.17977332170881,276,112,164,34,1.5,28.74,6.1,0,0,0,0,0,0,0.125282976718645,141.000772229618,13.0829391096691
9.7,"eps_greedy_SVM","SVM",8,8,1884,1766,118,900,775,125,0.695978508629112,0.243243243243243,1.20579773321709,300,125,175,24,1.4,32.33,6.2,0,0,0,0,0,0,0.128640858154052,149.339844220004,13.518961399987
9.7,"eps_greedy_SVM","SVM",8,9,1784,1687,97,1000,854,146,0.74254314555519,0.256756756756757,1.21447253705318,346,146,200,46,1.4,35.92,5.8,0,0,0,0,0,0,0.14118265377829,131.903938190571,15.0017307668766
9.7,"eps_greedy_SVM","SVM",8,10,1684,1604,80,1100,937,163,0.76485401063715,0.283783783783784,1.21447253705318,404,163,241,58,1.5,39.51,5.7,0,0,0,0,0,0,0.148224114234009,93.5768053418877,16.2748966203062
9.7,"eps_greedy_SVM","SVM",8,11,1584,1517,67,1200,1024,176,0.77629436665581,0.283783783783784,1.22314734088928,438,176,262,34,1.5,43.1,5.8,0,0,0,0,0,0,0.137287003676759,86.7382305084547,16.0571444203558
9.7,"eps_greedy_SVM","SVM",8,12,1484,1435,49,1300,1106,194,0.792320633886897,0.277027027027027,1.23068787019063,485,194,291,47,1.5,46.7,5.7,0,0,0,0,0,0,0.129646115099838,67.9722445464963,14.854722093054
9.7,"eps_greedy_SVM","SVM",8,13,1384,1348,36,1400,1193,207,0.785216541843045,0.209459459459459,1.22314734088928,518,207,311,33,1.5,50.29,5.8,0,0,0,0,0,0,0.134357398977497,90.207493438621,14.4657184372297
9.7,"eps_greedy_SVM","SVM",8,14,1284,1261,23,1500,1280,220,0.78763160751112,0.22972972972973,1.22314734088928,564,220,344,46,1.6,53.88,5.8,0,0,0,0,0,0,0.131161172470306,88.7859063358234,14.5091886008635
9.7,"eps_greedy_SVM","SVM",8,15,1184,1164,20,1600,1377,223,0.800629545207853,0.263513513513513,1.22314734088928,583,223,360,19,1.6,57.47,6.2,0,0,0,0,0,0,0.103454589791122,64.9353326051632,11.2535214943432
9.7,"eps_greedy_SVM","SVM",8,16,1084,1068,16,1700,1473,227,0.788098339303158,0.263513513513513,1.21447253705318,609,227,382,26,1.7,61.06,6.5,0,0,0,0,0,0,0.135560834447625,85.533118713736,15.3083349763394
9.7,"eps_greedy_SVM","SVM",8,17,984,969,15,1800,1572,228,0.775974166938026,0.22972972972973,1.22314734088928,610,228,382,1,1.7,64.66,6.9,0,0,0,0,0,0,0.123722638252172,69.0365672783743,13.0598789215018
9.7,"eps_greedy_SVM","SVM",8,18,884,871,13,1900,1670,230,0.749012265277325,0.189189189189189,1.21447253705318,627,230,397,17,1.7,68.25,7.3,0,0,0,0,0,0,0.102523617868769,47.6329854058593,11.1754662629375
9.7,"eps_greedy_SVM","SVM",8,19,784,771,13,2000,1770,230,0.780207315749483,0.25,1.21447253705318,626,230,396,-1,1.7,71.84,7.7,0,0,0,0,0,0,0.0740142290778357,28.0549066561092,8.34439664846625
9.7,"eps_greedy_SVM","SVM",8,20,684,671,13,2100,1870,230,0.773727341799633,0.236486486486486,1.20579773321709,626,230,396,0,1.7,75.43,8.1,0,0,0,0,0,0,0.0570904550639156,20.8847098415791,6.57904978139637
9.7,"eps_greedy_SVM","SVM",8,21,584,571,13,2200,1970,230,0.766715510691417,0.22972972972973,1.20579773321709,628,230,398,2,1.7,79.02,8.6,0,0,0,0,0,0,0.0473628787468697,13.7872135130334,5.5581811409388
9.7,"eps_greedy_SVM","SVM",8,22,484,472,12,2300,2069,231,0.761814826875069,0.216216216216216,1.21447253705318,631,231,400,3,1.7,82.61,9,0,0,0,0,0,0,0.0312470693814649,8.75009704582713,4.14787931244803
9.7,"eps_greedy_SVM","SVM",8,23,384,372,12,2400,2169,231,0.763291001845224,0.222972972972973,1.20579773321709,632,231,401,1,1.7,86.21,9.4,0,0,0,0,0,0,0.022050504450639,5.63248281167346,3.02665007091308
9.7,"eps_greedy_SVM","SVM",8,24,284,272,12,2500,2269,231,0.746494084445894,0.222972972972973,1.20579773321709,633,231,402,1,1.7,89.8,9.8,0,0,0,0,0,0,0.00528842008697965,1.07089060182056,0.858833543188191
9.7,"eps_greedy_SVM","SVM",8,25,184,172,12,2600,2369,231,0.772989254314559,0.216216216216216,1.22314734088928,627,231,396,-6,1.7,93.39,10.3,0,0,0,0,0,0,1.28259733767097e-06,0.124798256589806,0.124776227253451
9.7,"eps_greedy_SVM","SVM",8,26,84,77,7,2700,2464,236,0.763698035384778,0.209459459459459,1.22314734088928,649,236,413,22,1.8,96.98,10.4,0,0,0,0,0,0,1.83977186629775e-06,2.24303523094155,2.24303523094155
9.7,"eps_greedy_SVM","SVM",8,27,0,0,0,2784,2541,243,0.774465429284698,0.243243243243243,1.26652136006975,685,243,442,36,1.8,100,10.5,0,0,0,0,0,0,0,0,0
9.7,"eps_greedy_SVM","SVM",9,0,2684,2439,245,100,95,5,0.380956427163347,0.0354609929078014,0.965179592770533,25,5,20,0,4,3.59,19,0,0,0,0,0,0,0.102036450108841,94.3547580401493,14.0076778099553
9.7,"eps_greedy_SVM","SVM",9,1,2584,2345,239,200,189,11,0.353244737498017,0.0141843971631206,0.883230382063601,44,11,33,19,3,7.18,17.2,0,0,0,0,0,0,0.0600976503860434,148.086968091225,6.04949953850569
9.7,"eps_greedy_SVM","SVM",9,2,2484,2246,238,300,288,12,0.642869281490042,0.120567375886525,1.17460535346603,54,12,42,10,3.5,10.78,24,0,0,0,0,0,0,0.0433991544301588,105.541175260337,4.38545645738473
9.7,"eps_greedy_SVM","SVM",9,3,2384,2146,238,400,388,12,0.279354451317609,0.00709219858156028,0.737542896362388,55,12,43,1,3.6,14.37,32.3,0,0,0,0,0,0,0.0311496020243216,70.2203280957866,3.16077585343252
9.7,"eps_greedy_SVM","SVM",9,4,2284,2062,222,500,472,28,0.68966532979857,0.205673758865248,1.14728894989705,83,28,55,28,2,17.96,16.9,0,0,0,0,0,0,0.111210378930634,146.21256669398,14.2215098444062
9.7,"eps_greedy_SVM","SVM",9,5,2184,1986,198,600,548,52,0.746063036729889,0.26241134751773,1.19281628917868,143,52,91,60,1.8,21.55,10.5,0,0,0,0,0,0,0.116105860333281,174.232402743069,12.6275991436247
9.7,"eps_greedy_SVM","SVM",9,6,2084,1916,168,700,618,82,0.757109192667619,0.24822695035461,1.22923816060398,204,82,122,61,1.5,25.14,7.5,0,0,0,0,0,0,0.147682403556148,218.337041434952,15.8353641728279
9.7,"eps_greedy_SVM","SVM",9,7,1984,1843,141,800,691,109,0.799747354587272,0.276595744680851,1.26566003202928,260,109,151,56,1.4,28.74,6.3,0,0,0,0,0,0,0.166171541459478,221.98462318181,17.6233977610724
9.7,"eps_greedy_SVM","SVM",9,8,1884,1774,110,900,760,140,0.825198830806885,0.276595744680851,1.25655456417296,323,140,183,63,1.3,32.33,5.4,0,0,0,0,0,0,0.190622905303102,224.434631279137,24.6940408458432
9.7,"eps_greedy_SVM","SVM",9,9,1784,1695,89,1000,839,161,0.827844243536589,0.26241134751773,1.25655456417296,375,161,214,52,1.3,35.92,5.2,0,0,0,0,0,0,0.189615095644451,214.846105335086,19.6534646264465
9.7,"eps_greedy_SVM","SVM",9,10,1684,1615,69,1100,919,181,0.829436022930692,0.283687943262411,1.25655456417296,437,181,256,62,1.4,39.51,5.1,0,0,0,0,0,0,0.180265930242086,180.935423378699,18.8685588646233
9.7,"eps_greedy_SVM","SVM",9,11,1584,1537,47,1200,997,203,0.828501348197499,0.312056737588652,1.25655456417296,493,203,290,56,1.4,43.1,4.9,0,0,0,0,0,0,0.179166078950309,166.223471598907,19.4011882864279
9.7,"eps_greedy_SVM","SVM",9,12,1484,1444,40,1300,1090,210,0.827204132961733,0.319148936170213,1.25655456417296,519,210,309,26,1.5,46.7,5.2,0,0,0,0,0,0,0.162441636102874,144.742865666838,17.0275199121683
9.7,"eps_greedy_SVM","SVM",9,13,1384,1349,35,1400,1185,215,0.818384202297604,0.26241134751773,1.25655456417296,534,215,319,15,1.5,50.29,5.5,0,0,0,0,0,0,0.147507165081304,108.864025175109,15.630651848807
9.7,"eps_greedy_SVM","SVM",9,14,1284,1256,28,1500,1278,222,0.82404889765029,0.297872340425532,1.25655456417296,549,222,327,15,1.5,53.88,5.8,0,0,0,0,0,0,0.130092278768782,87.8306279076644,14.5858260766739
9.7,"eps_greedy_SVM","SVM",9,15,1184,1162,22,1600,1372,228,0.82063875104797,0.269503546099291,1.25655456417296,592,228,364,43,1.6,57.47,6,0,0,0,0,0,0,0.138695426378436,94.1504750524082,14.6756373232278
9.7,"eps_greedy_SVM","SVM",9,16,1084,1072,12,1700,1462,238,0.820196904810464,0.26241134751773,1.25655456417296,630,238,392,38,1.6,61.06,6.1,0,0,0,0,0,0,0.141358618628027,88.2144722939559,15.8510828253039
9.7,"eps_greedy_SVM","SVM",9,17,984,975,9,1800,1559,241,0.829022500169945,0.319148936170213,1.25655456417296,630,241,389,0,1.6,64.66,6.5,0,0,0,0,0,0,0.0747216056862605,25.1956356949691,9.22394226112608
9.7,"eps_greedy_SVM","SVM",9,18,884,877,7,1900,1657,243,0.823335146035848,0.304964539007092,1.25655456417296,636,243,393,6,1.6,68.25,6.8,0,0,0,0,0,0,0.0816993341871047,32.7266176155475,9.44603151455998
9.7,"eps_greedy_SVM","SVM",9,19,784,781,3,2000,1753,247,0.801480751365195,0.276595744680851,1.26566003202928,668,247,421,32,1.7,71.84,7.1,0,0,0,0,0,0,0.067701378041842,21.8193217698441,8.20282003906622
9.7,"eps_greedy_SVM","SVM",9,20,684,683,1,2100,1851,249,0.832795187274833,0.312056737588652,1.26566003202928,666,249,417,-2,1.7,75.43,7.4,0,0,0,0,0,0,0.0803241230312687,30.4587483241405,9.0654465469419
9.7,"eps_greedy_SVM","SVM",9,21,584,583,1,2200,1951,249,0.818010332404326,0.304964539007092,1.26566003202928,654,249,405,-12,1.6,79.02,7.8,0,0,0,0,0,0,0.0478374438373048,12.6962070212678,5.84453818580788
9.7,"eps_greedy_SVM","SVM",9,22,484,484,0,2300,2050,250,0.813438923254711,0.312056737588652,1.26566003202928,672,250,422,18,1.7,82.61,8.2,0,0,0,0,0,0,0.0103744590836033,2.92885152314456,1.97543315805173
9.7,"eps_greedy_SVM","SVM",9,23,384,384,0,2400,2150,250,0.808901502277211,0.297872340425532,1.26566003202928,667,250,417,-5,1.7,86.21,8.6,0,0,0,0,0,0,0.00344833357722004,0.97372122531824,0.682560188540927
9.7,"eps_greedy_SVM","SVM",9,24,284,284,0,2500,2250,250,0.823244510910208,0.297872340425532,1.26566003202928,675,250,425,8,1.7,89.8,9,0,0,0,0,0,0,0.00129440136080816,0.311260844981048,0.227406498854206
9.7,"eps_greedy_SVM","SVM",9,25,184,184,0,2600,2350,250,0.772381211338457,0.24113475177305,1.25655456417296,657,250,407,-18,1.6,93.39,9.4,0,0,0,0,0,0,6.73623637658181e-05,0.0338660803619288,0.0314538202033403
9.7,"eps_greedy_SVM","SVM",9,26,84,84,0,2700,2450,250,0.795510162463467,0.234042553191489,1.25655456417296,672,250,422,15,1.7,96.98,9.8,0,0,0,0,0,0,1.79382734832379e-05,0.0282867450762905,0.0282867450762905
9.7,"eps_greedy_SVM","SVM",9,27,0,0,0,2784,2534,250,0.800795323227521,0.26241134751773,1.25655456417296,668,250,418,-4,1.7,100,10.1,0,0,0,0,0,0,0,0,0
9.7,"eps_greedy_SVM","SVM",10,0,2684,2445,239,100,89,11,0.729595767339634,0.163120567375887,1.25655456417296,28,11,17,0,1.5,3.59,8.1,0,0,0,0,0,0,0.127218838944274,294.964904199328,13.0446125902909
9.7,"eps_greedy_SVM","SVM",10,1,2584,2362,222,200,172,28,0.713519361928718,0.219858156028369,1.22923816060398,70,28,42,42,1.5,7.18,6.1,0,0,0,0,0,0,0.311780522835497,264.660236311861,47.2593238527751
9.7,"eps_greedy_SVM","SVM",10,2,2484,2280,204,300,254,46,0.77323658033671,0.26241134751773,1.24744909631663,126,46,80,56,1.7,10.78,5.5,0,0,0,0,0,0,0.176857579024387,225.704279485995,19.4139240043525
9.7,"eps_greedy_SVM","SVM",10,3,2384,2211,173,400,323,77,0.819823034917187,0.290780141843972,1.24744909631663,189,77,112,63,1.5,14.37,4.2,0,0,0,0,0,0,0.210883981761949,251.036369210736,21.6909885586067
9.7,"eps_greedy_SVM","SVM",10,4,2284,2135,149,500,399,101,0.819483153196024,0.297872340425532,1.23834362846031,254,101,153,65,1.5,17.96,4,0,0,0,0,0,0,0.206774727841477,183.958946403564,21.3033469120033
9.7,"eps_greedy_SVM","SVM",10,5,2184,2063,121,600,471,129,0.827736614324883,0.361702127659574,1.23834362846031,316,129,187,62,1.4,21.55,3.7,0,0,0,0,0,0,0.229446219405491,187.744463437498,23.8389534935511
9.7,"eps_greedy_SVM","SVM",10,6,2084,1990,94,700,544,156,0.82247977703759,0.354609929078014,1.24744909631663,375,156,219,59,1.4,25.14,3.5,0,0,0,0,0,0,0.2081089746796,131.642265146766,22.3149711266251
9.7,"eps_greedy_SVM","SVM",10,7,1984,1918,66,800,616,184,0.820871003557428,0.382978723404255,1.24744909631663,456,184,272,81,1.5,28.74,3.3,0,0,0,0,0,0,0.234097352615607,150.20883646319,24.3569864185558
9.7,"eps_greedy_SVM","SVM",10,8,1884,1831,53,900,703,197,0.809921147440692,0.319148936170213,1.24744909631663,494,197,297,38,1.5,32.33,3.6,0,0,0,0,0,0,0.172531560953133,86.8329051715943,20.210973859873
9.7,"eps_greedy_SVM","SVM",10,9,1784,1742,42,1000,792,208,0.811886796728076,0.326241134751773,1.23834362846031,537,208,329,43,1.6,35.92,3.8,0,0,0,0,0,0,0.183353751573824,102.951218226101,20.1856727975519
9.7,"eps_greedy_SVM","SVM",10,10,1684,1645,39,1100,889,211,0.812238007839943,0.347517730496454,1.23834362846031,558,211,347,21,1.6,39.51,4.2,0,0,0,0,0,0,0.12532316612839,59.1188474744043,15.8576364110488
9.7,"eps_greedy_SVM","SVM",10,11,1584,1551,33,1200,983,217,0.817517503908644,0.340425531914894,1.24744909631663,564,217,347,6,1.6,43.1,4.5,0,0,0,0,0,0,0.154312787386915,70.3263868531399,17.2872998997876
9.7,"eps_greedy_SVM","SVM",10,12,1484,1461,23,1300,1073,227,0.80917340765414,0.304964539007092,1.23834362846031,604,227,377,40,1.7,46.7,4.7,0,0,0,0,0,0,0.118883753371677,40.8759036025649,14.4345396553235
9.7,"eps_greedy_SVM","SVM",10,13,1384,1362,22,1400,1172,228,0.803967552625022,0.304964539007092,1.23834362846031,612,228,384,8,1.7,50.29,5.1,0,0,0,0,0,0,0.0759643300824642,25.558037721856,9.77871710544122
9.7,"eps_greedy_SVM","SVM",10,14,1284,1266,18,1500,1268,232,0.815982371468066,0.297872340425532,1.23834362846031,603,232,371,-9,1.6,53.88,5.5,0,0,0,0,0,0,0.0698635633947411,26.5179447887882,9.13021617540653
9.7,"eps_greedy_SVM","SVM",10,15,1184,1167,17,1600,1367,233,0.795793397231101,0.226950354609929,1.23834362846031,625,233,392,22,1.7,57.47,5.9,0,0,0,0,0,0,0.0706664844795227,23.9499251253505,9.98865113279429
9.7,"eps_greedy_SVM","SVM",10,16,1084,1068,16,1700,1466,234,0.753851992839826,0.24113475177305,1.22923816060398,623,234,389,-2,1.7,61.06,6.3,0,0,0,0,0,0,0.129524929768642,39.2423909997635,15.0695061193369
9.7,"eps_greedy_SVM","SVM",10,17,984,968,16,1800,1566,234,0.81017039403621,0.312056737588652,1.23834362846031,622,234,388,-1,1.7,64.66,6.7,0,0,0,0,0,0,0.0633399380906145,19.8819875433379,8.33130528211422
9.7,"eps_greedy_SVM","SVM",10,18,884,869,15,1900,1665,235,0.811195703895046,0.304964539007092,1.23834362846031,599,235,364,-23,1.5,68.25,7.1,0,0,0,0,0,0,0.0182128287571154,4.80714470940098,3.12402323706209
9.7,"eps_greedy_SVM","SVM",10,19,784,771,13,2000,1763,237,0.816922710896609,0.375886524822695,1.22923816060398,635,237,398,36,1.7,71.84,7.4,0,0,0,0,0,0,0.0114851478005596,3.83876194473932,1.82089538763431
9.7,"eps_greedy_SVM","SVM",10,20,684,675,9,2100,1859,241,0.818576801939592,0.312056737588652,1.22923816060398,635,241,394,0,1.6,75.43,7.7,0,0,0,0,0,0,0.0404481053887976,13.0595369268515,7.73046256043518
9.7,"eps_greedy_SVM","SVM",10,21,584,576,8,2200,1958,242,0.801429769107017,0.312056737588652,1.23834362846031,644,242,402,9,1.7,79.02,8.1,0,0,0,0,0,0,0.0141209189421182,4.10562010059931,2.76116840861455
9.7,"eps_greedy_SVM","SVM",10,22,484,477,7,2300,2057,243,0.818735413409467,0.368794326241135,1.24744909631663,651,243,408,7,1.7,82.61,8.5,0,0,0,0,0,0,0.00226377967472739,0.738328250528749,0.564532179651398
9.7,"eps_greedy_SVM","SVM",10,23,384,380,4,2400,2154,246,0.788315999365554,0.191489361702128,1.25655456417296,660,246,414,9,1.7,86.21,8.8,0,0,0,0,0,0,0.00172487599034204,1.34011455792515,1.24386794997674
9.7,"eps_greedy_SVM","SVM",10,24,284,284,0,2500,2250,250,0.819364194593618,0.290780141843972,1.26566003202928,692,250,442,32,1.8,89.8,9,0,0,0,0,0,0,0.000406490539543537,0.15833562839765,0.13962228003603
9.7,"eps_greedy_SVM","SVM",10,25,184,184,0,2600,2350,250,0.81696802845943,0.333333333333333,1.26566003202928,668,250,418,-24,1.7,93.39,9.4,0,0,0,0,0,0,3.39442220912413e-05,0.0207795156703341,0.0197454438805178
9.7,"eps_greedy_SVM","SVM",10,26,84,84,0,2700,2450,250,0.775417488047495,0.205673758865248,1.26566003202928,660,250,410,-8,1.6,96.98,9.8,0,0,0,0,0,0,1.48886907084927e-06,0.00411223714765543,0.00411223714765543
9.7,"eps_greedy_SVM","SVM",10,27,0,0,0,2784,2534,250,0.836182675095737,0.404255319148936,1.26566003202928,675,250,425,15,1.7,100,10.1,0,0,0,0,0,0,0,0,0
9.7,"eps_greedy_SVM","SVM",11,0,2684,2444,240,100,88,12,0.753995846385101,0.402877697841727,1.13608725922488,33,12,21,0,1.8,3.59,7.3,0,0,0,0,0,0,0.176985676770523,327.884472399507,18.997685921107
9.7,"eps_greedy_SVM","SVM",11,1,2584,2379,205,200,153,47,0.639180521611422,0.151079136690647,1.08066836853098,111,47,64,78,1.4,7.18,3.3,0,0,0,0,0,0,0.282870319924219,569.369262626671,31.5053043418827
9.7,"eps_greedy_SVM","SVM",11,2,2484,2293,191,300,239,61,0.710715638015911,0.20863309352518,1.15456022278951,152,61,91,41,1.5,10.78,3.9,0,0,0,0,0,0,0.210247630609496,474.239040657828,21.795590900704
9.7,"eps_greedy_SVM","SVM",11,3,2384,2196,188,400,336,64,0.712086789898227,0.273381294964029,1.15456022278951,159,64,95,7,1.5,14.37,5.2,0,0,0,0,0,0,0.177194751071086,294.932205591871,18.8640535138696
9.7,"eps_greedy_SVM","SVM",11,4,2284,2117,167,500,415,85,0.773599302376286,0.338129496402878,1.18226966813646,205,85,120,46,1.4,17.96,4.9,0,0,0,0,0,0,0.188808894836114,256.711509093878,20.1039365397393
9.7,"eps_greedy_SVM","SVM",11,5,2184,2041,143,600,491,109,0.760105790965328,0.323741007194245,1.19150614991877,263,109,154,58,1.4,21.55,4.5,0,0,0,0,0,0,0.194251109960907,220.571574206692,20.0785004878653
9.7,"eps_greedy_SVM","SVM",11,6,2084,1964,120,700,568,132,0.758390416853132,0.338129496402878,1.14532374100719,320,132,188,57,1.4,25.14,4.3,0,0,0,0,0,0,0.193596632577542,212.378063918149,20.0643849745338
9.7,"eps_greedy_SVM","SVM",11,7,1984,1894,90,800,638,162,0.752102624120808,0.294964028776978,1.18226966813646,392,162,230,72,1.4,28.74,3.9,0,0,0,0,0,0,0.21047783547188,236.386925437546,21.6235247478431
9.7,"eps_greedy_SVM","SVM",11,8,1884,1813,71,900,719,181,0.749520957396766,0.266187050359712,1.14532374100719,444,181,263,52,1.5,32.33,4,0,0,0,0,0,0,0.200120160413241,191.382949220696,21.2398502588017
9.7,"eps_greedy_SVM","SVM",11,9,1784,1720,64,1000,812,188,0.744810849884694,0.237410071942446,1.18226966813646,466,188,278,22,1.5,35.92,4.3,0,0,0,0,0,0,0.178994411032341,155.305559304769,18.9711136937311
9.7,"eps_greedy_SVM","SVM",11,10,1684,1627,57,1100,905,195,0.746336901770463,0.23021582733813,1.19150614991877,480,195,285,14,1.5,39.51,4.6,0,0,0,0,0,0,0.148464158876441,114.206778775422,16.4537547101423
9.7,"eps_greedy_SVM","SVM",11,11,1584,1531,53,1200,1001,199,0.763238213257162,0.287769784172662,1.19150614991877,497,199,298,17,1.5,43.1,5,0,0,0,0,0,0,0.122350076980172,89.4347434196396,13.7041379823993
9.7,"eps_greedy_SVM","SVM",11,12,1484,1439,45,1300,1093,207,0.769204731908268,0.280575539568345,1.19150614991877,518,207,311,21,1.5,46.7,5.3,0,0,0,0,0,0,0.14700477337618,78.2199703173747,17.3973234295302
9.7,"eps_greedy_SVM","SVM",11,13,1384,1344,40,1400,1188,212,0.78141314699438,0.237410071942446,1.19150614991877,539,212,327,21,1.5,50.29,5.6,0,0,0,0,0,0,0.129716538430904,49.5236627907212,15.0284207592121
9.7,"eps_greedy_SVM","SVM",11,14,1284,1255,29,1500,1277,223,0.776622720962002,0.309352517985612,1.19150614991877,558,223,335,19,1.5,53.88,5.7,0,0,0,0,0,0,0.122697743885826,42.7007564052189,14.466306973216
9.7,"eps_greedy_SVM","SVM",11,15,1184,1165,19,1600,1367,233,0.749056257386447,0.215827338129496,1.19150614991877,610,233,377,52,1.6,57.47,5.9,0,0,0,0,0,0,0.124010263151135,50.5471638964934,13.6824209361335
9.7,"eps_greedy_SVM","SVM",11,16,1084,1066,18,1700,1466,234,0.785434810046713,0.309352517985612,1.19150614991877,609,234,375,-1,1.6,61.06,6.3,0,0,0,0,0,0,0.0826670816461561,26.0779060513004,9.72174419127064
9.7,"eps_greedy_SVM","SVM",11,17,984,967,17,1800,1565,235,0.779479765469932,0.258992805755396,1.19150614991877,617,235,382,8,1.6,64.66,6.7,0,0,0,0,0,0,0.0694704489436963,22.9386606485273,8.5393427422738
9.7,"eps_greedy_SVM","SVM",11,18,884,867,17,1900,1665,235,0.783358002593154,0.330935251798561,1.19150614991877,612,235,377,-5,1.6,68.25,7.1,0,0,0,0,0,0,0.040540123968718,12.1463860078538,5.38244546450084
9.7,"eps_greedy_SVM","SVM",11,19,784,768,16,2000,1764,236,0.794375982467629,0.287769784172662,1.19150614991877,631,236,395,19,1.7,71.84,7.5,0,0,0,0,0,0,0.0130431964581718,3.9158686186076,2.24106322075916
9.7,"eps_greedy_SVM","SVM",11,20,684,669,15,2100,1863,237,0.793951441717454,0.359712230215827,1.19150614991877,624,237,387,-7,1.6,75.43,7.9,0,0,0,0,0,0,0.00779158562573122,2.92459494589607,2.23322203252673
9.7,"eps_greedy_SVM","SVM",11,21,584,569,15,2200,1963,237,0.77571053205284,0.244604316546763,1.19150614991877,624,237,387,0,1.6,79.02,8.3,0,0,0,0,0,0,0.00396321219415771,1.09044304214507,0.742761958073261
9.7,"eps_greedy_SVM","SVM",11,22,484,471,13,2300,2061,239,0.787712413801029,0.273381294964029,1.19150614991877,643,239,404,19,1.7,82.61,8.6,0,0,0,0,0,0,0.00342902999526062,1.01168156191332,0.648325253888201
9.7,"eps_greedy_SVM","SVM",11,23,384,374,10,2400,2158,242,0.744331807281444,0.194244604316547,1.17303318635414,639,242,397,-4,1.6,86.21,8.9,0,0,0,0,0,0,0.0207585780156738,8.95676701377863,8.01100609056826
9.7,"eps_greedy_SVM","SVM",11,24,284,275,9,2500,2257,243,0.786817436003354,0.302158273381295,1.19150614991877,640,243,397,1,1.6,89.8,9.3,0,0,0,0,0,0,0.0095998571739974,2.77673601906714,2.20189359012189
9.7,"eps_greedy_SVM","SVM",11,25,184,177,7,2600,2355,245,0.799393021468002,0.309352517985612,1.19150614991877,651,245,406,11,1.7,93.39,9.6,0,0,0,0,0,0,0.00496848199221525,1.37357450020751,1.18347656706926
9.7,"eps_greedy_SVM","SVM",11,26,84,80,4,2700,2452,248,0.783048202586271,0.273381294964029,1.19150614991877,669,248,421,18,1.7,96.98,9.9,0,0,0,0,0,0,0.000132640107740457,0.568796502517669,0.568796502517669
9.7,"eps_greedy_SVM","SVM",11,27,0,0,0,2784,2532,252,0.810092595779839,0.287769784172662,1.23768855883036,701,252,449,32,1.8,100,10,0,0,0,0,0,0,0,0,0
9.7,"eps_greedy_SVM","SVM",12,0,2684,2440,244,100,85,15,0.774727849470121,0.356060606060606,1.19633431085044,40,15,25,0,1.7,3.59,5.7,0,0,0,0,0,0,0.249820912546197,383.905119266374,28.1817993338521
9.7,"eps_greedy_SVM","SVM",12,1,2584,2365,219,200,160,40,0.723902386273517,0.166666666666667,1.14770283479961,101,40,61,61,1.5,7.18,4,0,0,0,0,0,0,0.206905287553472,478.419762131722,21.7595150104402
9.7,"eps_greedy_SVM","SVM",12,2,2484,2276,208,300,249,51,0.730835315886867,0.181818181818182,1.16715542521994,132,51,81,31,1.6,10.78,4.9,0,0,0,0,0,0,0.18696625857371,396.827225028032,20.2350028350837
9.7,"eps_greedy_SVM","SVM",12,3,2384,2193,191,400,332,68,0.767590656765912,0.272727272727273,1.21578690127077,176,68,108,44,1.6,14.37,4.9,0,0,0,0,0,0,0.190535171908394,248.508796443169,19.8457414700518
9.7,"eps_greedy_SVM","SVM",12,4,2284,2120,164,500,405,95,0.765259654434913,0.295454545454545,1.20606060606061,240,95,145,64,1.5,17.96,4.3,0,0,0,0,0,0,0.206261151682334,284.740610868535,20.8059351544558
9.7,"eps_greedy_SVM","SVM",12,5,2184,2060,124,600,465,135,0.76004493787999,0.272727272727273,1.19633431085044,323,135,188,83,1.4,21.55,3.4,0,0,0,0,0,0,0.238084197036919,240.000634108466,24.2892612713512
9.7,"eps_greedy_SVM","SVM",12,6,2084,1984,100,700,541,159,0.760465479537644,0.303030303030303,1.18660801564027,377,159,218,54,1.4,25.14,3.4,0,0,0,0,0,0,0.226597973510973,197.498614129379,23.3488739181642
9.7,"eps_greedy_SVM","SVM",12,7,1984,1916,68,800,609,191,0.756620527239084,0.295454545454545,1.18660801564027,473,191,282,96,1.5,28.74,3.2,0,0,0,0,0,0,0.237766177730908,234.809488633162,24.2567090197745
9.7,"eps_greedy_SVM","SVM",12,8,1884,1829,55,900,696,204,0.754758128469471,0.295454545454545,1.17688172043011,499,204,295,26,1.4,32.33,3.4,0,0,0,0,0,0,0.214595575726245,190.671943429377,22.5122083626231
9.7,"eps_greedy_SVM","SVM",12,9,1784,1734,50,1000,791,209,0.751441857111966,0.28030303030303,1.19633431085044,527,209,318,28,1.5,35.92,3.8,0,0,0,0,0,0,0.178732268418186,148.557288710236,19.0644364428679
9.7,"eps_greedy_SVM","SVM",12,10,1684,1635,49,1100,890,210,0.770522432893567,0.318181818181818,1.21578690127077,515,210,305,-12,1.5,39.51,4.2,0,0,0,0,0,0,0.145423748993149,92.9441993701457,16.2452058713515
9.7,"eps_greedy_SVM","SVM",12,11,1584,1539,45,1200,986,214,0.766395116910582,0.28030303030303,1.22551319648094,529,214,315,14,1.5,43.1,4.6,0,0,0,0,0,0,0.1302992372919,80.6009716077252,16.5374747709214
9.7,"eps_greedy_SVM","SVM",12,12,1484,1446,38,1300,1079,221,0.770059837070147,0.265151515151515,1.22551319648094,540,221,319,11,1.4,46.7,4.9,0,0,0,0,0,0,0.0953453001622452,48.9154568811339,10.8310218136374
9.7,"eps_greedy_SVM","SVM",12,13,1384,1347,37,1400,1178,222,0.783090620719489,0.28030303030303,1.22551319648094,540,222,318,0,1.4,50.29,5.3,0,0,0,0,0,0,0.120304950995095,61.1332600771401,12.7902396573103
9.7,"eps_greedy_SVM","SVM",12,14,1284,1258,26,1500,1267,233,0.796025280561367,0.28030303030303,1.2352394916911,598,233,365,58,1.6,53.88,5.4,0,0,0,0,0,0,0.156669982909516,54.9707677144942,17.0976229344186
9.7,"eps_greedy_SVM","SVM",12,15,1184,1165,19,1600,1360,240,0.795520630572182,0.310606060606061,1.2352394916911,610,240,370,12,1.5,57.47,5.7,0,0,0,0,0,0,0.132291236082013,39.6816870361207,14.2124427823211
9.7,"eps_greedy_SVM","SVM",12,16,1084,1068,16,1700,1457,243,0.795418499026751,0.287878787878788,1.22551319648094,627,243,384,17,1.6,61.06,6,0,0,0,0,0,0,0.0969780074732212,23.1246948761238,11.6723587135812
9.7,"eps_greedy_SVM","SVM",12,17,984,968,16,1800,1557,243,0.756572465335355,0.181818181818182,1.21578690127077,641,243,398,14,1.6,64.66,6.4,0,0,0,0,0,0,0.0439440095971181,10.0580663452072,7.10224563308491
9.7,"eps_greedy_SVM","SVM",12,18,884,868,16,1900,1657,243,0.756404248672294,0.166666666666667,1.22551319648094,629,243,386,-12,1.6,68.25,6.8,0,0,0,0,0,0,0.0112918283039948,3.22995831501108,2.83150454103302
9.7,"eps_greedy_SVM","SVM",12,19,784,769,15,2000,1756,244,0.792871218128955,0.257575757575758,1.21578690127077,623,244,379,-6,1.6,71.84,7.2,0,0,0,0,0,0,0.00247114251219236,1.12460075047774,0.855725997669207
9.7,"eps_greedy_SVM","SVM",12,20,684,670,14,2100,1855,245,0.769909643620986,0.227272727272727,1.21578690127077,638,245,393,15,1.6,75.43,7.6,0,0,0,0,0,0,0.000520089122567703,0.240318971559855,0.200164723708142
9.7,"eps_greedy_SVM","SVM",12,21,584,573,11,2200,1952,248,0.769591233508761,0.227272727272727,1.20606060606061,632,248,384,-6,1.5,79.02,7.9,0,0,0,0,0,0,0.00566183872253525,2.48911140877254,2.12565932844432
9.7,"eps_greedy_SVM","SVM",12,22,484,474,10,2300,2051,249,0.789969480691135,0.265151515151515,1.20606060606061,653,249,404,21,1.6,82.61,8.2,0,0,0,0,0,0,0.00750912945339989,2.34462537226433,1.58816552815791
9.7,"eps_greedy_SVM","SVM",12,23,384,375,9,2400,2150,250,0.790287890803357,0.272727272727273,1.20606060606061,644,250,394,-9,1.6,86.21,8.6,0,0,0,0,0,0,0.000173572907401471,0.077627247631008,0.0672825481759862
9.7,"eps_greedy_SVM","SVM",12,24,284,278,6,2500,2247,253,0.722106072621535,0.189393939393939,1.19633431085044,659,253,406,15,1.6,89.8,8.9,0,0,0,0,0,0,0.00677051350097394,1.89004483119454,1.38679726360261
9.7,"eps_greedy_SVM","SVM",12,25,184,179,5,2600,2346,254,0.778182298800858,0.25,1.19633431085044,670,254,416,11,1.6,93.39,9.2,0,0,0,0,0,0,0.0006906456276678,0.197327137023648,0.173334503271667
9.7,"eps_greedy_SVM","SVM",12,26,84,82,2,2700,2443,257,0.79517218177012,0.242424242424242,1.22551319648094,669,257,412,-1,1.6,96.98,9.5,0,0,0,0,0,0,4.66192324603337e-05,0.624099222724986,0.624099222724986
9.7,"eps_greedy_SVM","SVM",12,27,0,0,0,2784,2525,259,0.764785043135552,0.189393939393939,1.2352394916911,695,259,436,26,1.7,100,9.7,0,0,0,0,0,0,0,0,0
9.7,"eps_greedy_SVM","SVM",13,0,2684,2445,239,100,91,9,0.8194965034965,0.370629370629371,1.24795849311978,22,9,13,0,1.4,3.59,10.1,0,0,0,0,0,0,0.104841394030106,227.475756392162,10.797660394731
9.7,"eps_greedy_SVM","SVM",13,1,2584,2378,206,200,158,42,0.661918881118877,0.111888111888112,1.20306789984209,103,42,61,81,1.5,7.18,3.8,0,0,0,0,0,0,0.273144245808971,546.395343885253,34.7496762341595
9.7,"eps_greedy_SVM","SVM",13,2,2484,2285,199,300,251,49,0.813667132867128,0.286713286713287,1.28387096774194,113,49,64,10,1.3,10.78,5.1,0,0,0,0,0,0,0.199177688380698,220.978992955369,23.3499591338052
9.7,"eps_greedy_SVM","SVM",13,3,2384,2207,177,400,329,71,0.820430769230767,0.328671328671329,1.26591473043086,166,71,95,53,1.3,14.37,4.6,0,0,0,0,0,0,0.201100556409926,160.894029775298,20.5203053089261
9.7,"eps_greedy_SVM","SVM",13,4,2284,2142,142,500,394,106,0.80754685314685,0.321678321678322,1.25693661177532,251,106,145,85,1.4,17.96,3.7,0,0,0,0,0,0,0.2228477593794,151.076749059962,23.0447903228989
9.7,"eps_greedy_SVM","SVM",13,5,2184,2072,112,600,464,136,0.804945454545454,0.335664335664336,1.25693661177532,317,136,181,66,1.3,21.55,3.4,0,0,0,0,0,0,0.224917773006937,174.936956533855,23.7058262497459
9.7,"eps_greedy_SVM","SVM",13,6,2084,1993,91,700,543,157,0.811787412587409,0.335664335664336,1.25693661177532,365,157,208,48,1.3,25.14,3.5,0,0,0,0,0,0,0.219552658198455,192.880473000669,22.9368284849558
9.7,"eps_greedy_SVM","SVM",13,7,1984,1912,72,800,624,176,0.804565034965038,0.293706293706294,1.26591473043086,416,176,240,51,1.4,28.74,3.5,0,0,0,0,0,0,0.197078688834878,115.222536447223,21.2860998510404
9.7,"eps_greedy_SVM","SVM",13,8,1884,1825,59,900,711,189,0.814254545454544,0.314685314685315,1.25693661177532,449,189,260,33,1.4,32.33,3.8,0,0,0,0,0,0,0.181437000390961,79.4165787965756,22.7979823722657
9.7,"eps_greedy_SVM","SVM",13,9,1784,1730,54,1000,806,194,0.822618181818176,0.314685314685315,1.2748928490864,465,194,271,16,1.4,35.92,4.2,0,0,0,0,0,0,0.156085008888752,61.2471671150717,18.6877454696779
9.7,"eps_greedy_SVM","SVM",13,10,1684,1642,42,1100,894,206,0.804240559440557,0.216783216783217,1.25693661177532,506,206,300,41,1.5,39.51,4.3,0,0,0,0,0,0,0.160350738029155,74.0416634721987,17.5537405335163
9.7,"eps_greedy_SVM","SVM",13,11,1584,1553,31,1200,983,217,0.798758041958042,0.258741258741259,1.22102413715317,541,217,324,35,1.5,43.1,4.5,0,0,0,0,0,0,0.169486467503015,80.9885740598557,18.0865348549578
9.7,"eps_greedy_SVM","SVM",13,12,1484,1460,24,1300,1076,224,0.798629370629372,0.251748251748252,1.22102413715317,574,224,350,33,1.6,46.7,4.8,0,0,0,0,0,0,0.163628396633921,70.9668296322031,17.9236734144845
9.7,"eps_greedy_SVM","SVM",13,13,1384,1364,20,1400,1172,228,0.814937062937064,0.335664335664336,1.22102413715317,588,228,360,14,1.6,50.29,5.1,0,0,0,0,0,0,0.131188300302749,47.2890535375307,14.3765316126341
9.7,"eps_greedy_SVM","SVM",13,14,1284,1265,19,1500,1271,229,0.796593006993006,0.27972027972028,1.21204601849763,592,229,363,4,1.6,53.88,5.6,0,0,0,0,0,0,0.128625008521325,56.0854994176316,13.8830006281113
9.7,"eps_greedy_SVM","SVM",13,15,1184,1167,17,1600,1369,231,0.754483916083918,0.174825174825175,1.21204601849763,613,231,382,21,1.7,57.47,5.9,0,0,0,0,0,0,0.139482375844657,96.4072197403314,14.3137388131636
9.7,"eps_greedy_SVM","SVM",13,16,1084,1069,15,1700,1467,233,0.755765034965035,0.195804195804196,1.21204601849763,617,233,384,4,1.6,61.06,6.3,0,0,0,0,0,0,0.127783838754018,54.1864864961375,13.5512987130328
9.7,"eps_greedy_SVM","SVM",13,17,984,969,15,1800,1567,233,0.7032,0.132867132867133,1.21204601849763,633,233,400,16,1.7,64.66,6.7,0,0,0,0,0,0,0.100231560329671,27.131342339539,11.1664094548861
9.7,"eps_greedy_SVM","SVM",13,18,884,869,15,1900,1667,233,0.751211188811188,0.181818181818182,1.21204601849763,630,233,397,-3,1.7,68.25,7.2,0,0,0,0,0,0,0.0366457972343068,7.72985182290793,5.74017376654338
9.7,"eps_greedy_SVM","SVM",13,19,784,769,15,2000,1767,233,0.760973426573426,0.237762237762238,1.21204601849763,622,233,389,-8,1.7,71.84,7.6,0,0,0,0,0,0,0.0133839210043559,5.61738079574841,3.66229834059583
9.7,"eps_greedy_SVM","SVM",13,20,684,672,12,2100,1864,236,0.752525874125868,0.230769230769231,1.21204601849763,628,236,392,6,1.7,75.43,7.9,0,0,0,0,0,0,0.019833357035957,5.91810999056445,3.59187937024329
9.7,"eps_greedy_SVM","SVM",13,21,584,572,12,2200,1964,236,0.722914685314681,0.104895104895105,1.21204601849763,639,236,403,11,1.7,79.02,8.3,0,0,0,0,0,0,0.00598055648449164,1.4520553045914,0.939481964659521
9.7,"eps_greedy_SVM","SVM",13,22,484,475,9,2300,2061,239,0.730444755244753,0.153846153846154,1.21204601849763,640,239,401,1,1.7,82.61,8.6,0,0,0,0,0,0,0.0164308889965327,5.0432097456898,3.85873069063456
9.7,"eps_greedy_SVM","SVM",13,23,384,375,9,2400,2161,239,0.744917482517481,0.181818181818182,1.21204601849763,633,239,394,-7,1.6,86.21,9,0,0,0,0,0,0,0.00423809860771392,1.07362394013812,0.899730049677863
9.7,"eps_greedy_SVM","SVM",13,24,284,275,9,2500,2261,239,0.772128671328667,0.230769230769231,1.21204601849763,639,239,400,6,1.7,89.8,9.5,0,0,0,0,0,0,0.00704546569913294,1.67545823976107,1.10241161800357
9.7,"eps_greedy_SVM","SVM",13,25,184,177,7,2600,2359,241,0.780576223776221,0.244755244755245,1.22102413715317,644,241,403,5,1.7,93.39,9.8,0,0,0,0,0,0,0.00549655354156963,1.4862326567346,1.3163847664015
9.7,"eps_greedy_SVM","SVM",13,26,84,83,1,2700,2453,247,0.781650349650348,0.230769230769231,1.26591473043086,691,247,444,47,1.8,96.98,9.9,0,0,0,0,0,0,1.17124292008806e-11,0.753378621378785,0.753378621378785
9.7,"eps_greedy_SVM","SVM",13,27,0,0,0,2784,2536,248,0.772710489510488,0.216783216783217,1.26591473043086,664,248,416,-27,1.7,100,10.2,0,0,0,0,0,0,0,0,0
9.7,"eps_greedy_SVM","SVM",14,0,2684,2420,264,100,89,11,0.807550022952494,0.198275862068966,1.27280311457175,30,11,19,0,1.7,3.59,8.1,0,0,0,0,0,0,0.192683186007687,280.969613510639,21.2861307131373
9.7,"eps_greedy_SVM","SVM",14,1,2584,2336,248,200,173,27,0.723948910431232,0.267241379310345,1.16212458286986,80,27,53,50,2,7.18,6.4,0,0,0,0,0,0,0.163258926337443,335.914758138839,17.5944748759258
9.7,"eps_greedy_SVM","SVM",14,2,2484,2273,211,300,236,64,0.727142008478926,0.25,1.16212458286986,150,64,86,70,1.3,10.78,3.7,0,0,0,0,0,0,0.223388438000182,467.896453071371,23.6638624933134
9.7,"eps_greedy_SVM","SVM",14,3,2384,2191,193,400,318,82,0.748339318985767,0.172413793103448,1.20639599555061,189,82,107,39,1.3,14.37,3.9,0,0,0,0,0,0,0.237973683735137,312.723077457083,25.2072419594264
9.7,"eps_greedy_SVM","SVM",14,4,2284,2099,185,500,410,90,0.750587314017226,0.25,1.20639599555061,219,90,129,30,1.4,17.96,4.6,0,0,0,0,0,0,0.184611977261908,222.841645978522,19.0974522413753
9.7,"eps_greedy_SVM","SVM",14,5,2184,2024,160,600,485,115,0.764912375448926,0.267241379310345,1.20639599555061,289,115,174,70,1.5,21.55,4.2,0,0,0,0,0,0,0.187535158409759,187.999377954602,19.5596245036097
9.7,"eps_greedy_SVM","SVM",14,6,2084,1946,138,700,563,137,0.768591526476387,0.301724137931034,1.20639599555061,334,137,197,45,1.4,25.14,4.1,0,0,0,0,0,0,0.186668132300953,146.948972401144,19.4586954795677
9.7,"eps_greedy_SVM","SVM",14,7,1984,1872,112,800,637,163,0.775706802041423,0.301724137931034,1.20639599555061,395,163,232,61,1.4,28.74,3.9,0,0,0,0,0,0,0.193434600427275,163.864779999561,19.9961566248416
9.7,"eps_greedy_SVM","SVM",14,8,1884,1804,80,900,705,195,0.777549752923076,0.258620689655172,1.20639599555061,474,195,279,79,1.4,32.33,3.6,0,0,0,0,0,0,0.202072448585736,152.584299903385,21.6944062871846
9.7,"eps_greedy_SVM","SVM",14,9,1784,1721,63,1000,788,212,0.790173628925559,0.28448275862069,1.20639599555061,521,212,309,47,1.5,35.92,3.7,0,0,0,0,0,0,0.180154221285069,119.620769185893,19.5223100952196
9.7,"eps_greedy_SVM","SVM",14,10,1684,1635,49,1100,874,226,0.764122539356793,0.198275862068966,1.18426028921023,561,226,335,40,1.5,39.51,3.9,0,0,0,0,0,0,0.18932459482183,128.571012544754,20.5952773035439
9.7,"eps_greedy_SVM","SVM",14,11,1584,1539,45,1200,970,230,0.758607188183514,0.181034482758621,1.19532814238042,579,230,349,18,1.5,43.1,4.2,0,0,0,0,0,0,0.167743026893016,99.7415701464802,18.0445352642634
9.7,"eps_greedy_SVM","SVM",14,12,1484,1447,37,1300,1062,238,0.778069559582002,0.21551724137931,1.19532814238042,609,238,371,30,1.6,46.7,4.5,0,0,0,0,0,0,0.156578036868537,90.9583876257652,22.1385102946944
9.7,"eps_greedy_SVM","SVM",14,13,1384,1353,31,1400,1156,244,0.785961169767511,0.232758620689655,1.20639599555061,627,244,383,18,1.6,50.29,4.7,0,0,0,0,0,0,0.113827161204988,49.8905455510311,12.8138454786263
9.7,"eps_greedy_SVM","SVM",14,14,1284,1262,22,1500,1247,253,0.73973213080226,0.155172413793103,1.20639599555061,661,253,408,34,1.6,53.88,4.9,0,0,0,0,0,0,0.139978091113912,70.2342636683786,16.2758485889174
9.7,"eps_greedy_SVM","SVM",14,15,1184,1164,20,1600,1345,255,0.756993762320094,0.181034482758621,1.20639599555061,674,255,419,13,1.6,57.47,5.3,0,0,0,0,0,0,0.107255977405333,41.351665886743,12.025842383936
9.7,"eps_greedy_SVM","SVM",14,16,1084,1065,19,1700,1444,256,0.780202792104343,0.224137931034483,1.20639599555061,670,256,414,-4,1.6,61.06,5.6,0,0,0,0,0,0,0.0787512954254121,26.2143113589446,9.57262821906747
9.7,"eps_greedy_SVM","SVM",14,17,984,965,19,1800,1544,256,0.770569492074639,0.189655172413793,1.20639599555061,661,256,405,-9,1.6,64.66,6,0,0,0,0,0,0,0.0485737584388609,13.4122689969435,6.935995314238
9.7,"eps_greedy_SVM","SVM",14,18,884,867,17,1900,1642,258,0.780364809764259,0.206896551724138,1.2174638487208,665,258,407,4,1.6,68.25,6.4,0,0,0,0,0,0,0.0232041405299315,6.39807020770762,4.10610913900578
9.7,"eps_greedy_SVM","SVM",14,19,784,770,14,2000,1739,261,0.777718521318817,0.206896551724138,1.23959955506118,667,261,406,2,1.6,71.84,6.7,0,0,0,0,0,0,0.00808790839396206,2.37206246960497,1.70167871264156
9.7,"eps_greedy_SVM","SVM",14,20,684,675,9,2100,1834,266,0.745186725353058,0.0948275862068965,1.26173526140156,712,266,446,45,1.7,75.43,6.9,0,0,0,0,0,0,0.0602762540333233,17.1951663795721,12.7102354635466
9.7,"eps_greedy_SVM","SVM",14,21,584,580,4,2200,1929,271,0.77307401506764,0.137931034482759,1.28387096774194,728,271,457,16,1.7,79.02,7.1,0,0,0,0,0,0,0.090355381095993,31.573953447214,11.0442672924087
9.7,"eps_greedy_SVM","SVM",14,22,484,482,2,2300,2027,273,0.786170442578238,0.137931034482759,1.28387096774194,745,273,472,17,1.7,82.61,7.4,0,0,0,0,0,0,0.0724359770804779,19.3837715894484,9.45277691635953
9.7,"eps_greedy_SVM","SVM",14,23,384,383,1,2400,2126,274,0.767356141819451,0.172413793103448,1.27280311457175,756,274,482,11,1.8,86.21,7.8,0,0,0,0,0,0,0.059737563019422,15.0362753652923,9.19480428111027
9.7,"eps_greedy_SVM","SVM",14,24,284,283,1,2500,2226,274,0.784935057921307,0.181034482758621,1.27280311457175,755,274,481,-1,1.8,89.8,8.1,0,0,0,0,0,0,0.024497721026515,5.14034129940766,3.87202970573111
9.7,"eps_greedy_SVM","SVM",14,25,184,184,0,2600,2325,275,0.645134069613582,0.0689655172413793,1.27280311457175,760,275,485,5,1.8,93.39,8.5,0,0,0,0,0,0,0.00449091800780148,2.89526961224542,2.83976041658935
9.7,"eps_greedy_SVM","SVM",14,26,84,84,0,2700,2425,275,0.721059595495906,0.129310344827586,1.26173526140156,767,275,492,7,1.8,96.98,8.8,0,0,0,0,0,0,3.67750347192511e-07,0.326587671709642,0.326587671709642
9.7,"eps_greedy_SVM","SVM",14,27,0,0,0,2784,2509,275,0.792185348202947,0.189655172413793,1.26173526140156,745,275,470,-22,1.7,100,9.1,0,0,0,0,0,0,0,0,0
9.7,"eps_greedy_SVM","SVM",15,0,2684,2432,252,100,88,12,0.827126170840029,0.291338582677165,1.2737617475235,34,12,22,0,1.8,3.59,7.3,0,0,0,0,0,0,0.161743916048587,342.932497219046,17.3584365477819
9.7,"eps_greedy_SVM","SVM",15,1,2584,2353,231,200,167,33,0.816944682862521,0.338582677165354,1.24343408686817,79,33,46,45,1.4,7.18,5.1,0,0,0,0,0,0,0.291405110760001,301.007232797872,33.3028424602988
9.7,"eps_greedy_SVM","SVM",15,2,2484,2287,197,300,233,67,0.775497257155649,0.220472440944882,1.23332486664973,159,67,92,80,1.4,10.78,3.5,0,0,0,0,0,0,0.240885760962878,473.923851635937,24.9030780951669
9.7,"eps_greedy_SVM","SVM",15,3,2384,2201,183,400,319,81,0.80607281909667,0.291338582677165,1.22321564643129,192,81,111,33,1.4,14.37,3.9,0,0,0,0,0,0,0.220720972793863,225.91288936293,24.0020793129981
9.7,"eps_greedy_SVM","SVM",15,4,2284,2135,149,500,385,115,0.801663121493696,0.307086614173228,1.22321564643129,274,115,159,82,1.4,17.96,3.3,0,0,0,0,0,0,0.212999407257111,186.588030986987,22.6290973542516
9.7,"eps_greedy_SVM","SVM",15,5,2184,2053,131,600,467,133,0.814388426565159,0.31496062992126,1.23332486664973,313,133,180,39,1.4,21.55,3.5,0,0,0,0,0,0,0.220678225846521,267.298673119702,22.5641008921963
9.7,"eps_greedy_SVM","SVM",15,6,2084,1976,108,700,544,156,0.81089301041162,0.299212598425197,1.25354330708661,365,156,209,52,1.3,25.14,3.5,0,0,0,0,0,0,0.206980982437985,169.257759561531,22.6844245681779
9.7,"eps_greedy_SVM","SVM",15,7,1984,1902,82,800,618,182,0.809251035563687,0.322834645669291,1.25354330708661,440,182,258,75,1.4,28.74,3.4,0,0,0,0,0,0,0.182747320019793,170.380591781492,20.6936747617152
9.7,"eps_greedy_SVM","SVM",15,8,1884,1810,74,900,710,190,0.844466420370447,0.299212598425197,1.28387096774194,455,190,265,15,1.4,32.33,3.7,0,0,0,0,0,0,0.179455054724736,79.6040348807818,21.5082550636202
9.7,"eps_greedy_SVM","SVM",15,9,1784,1730,54,1000,790,210,0.849970767872029,0.338582677165354,1.28387096774194,505,210,295,50,1.4,35.92,3.8,0,0,0,0,0,0,0.165568287777769,81.2498120382233,19.1182578089246
9.7,"eps_greedy_SVM","SVM",15,10,1684,1639,45,1100,881,219,0.806122575910248,0.275590551181102,1.25354330708661,551,219,332,46,1.5,39.51,4,0,0,0,0,0,0,0.20467754932937,254.527750819953,21.2961177959505
9.7,"eps_greedy_SVM","SVM",15,11,1584,1539,45,1200,981,219,0.826485551865258,0.291338582677165,1.26365252730505,541,219,322,-10,1.5,43.1,4.5,0,0,0,0,0,0,0.131906734500098,64.5148111421038,16.0516166952219
9.7,"eps_greedy_SVM","SVM",15,12,1484,1446,38,1300,1074,226,0.822262442313201,0.259842519685039,1.2737617475235,573,226,347,32,1.5,46.7,4.8,0,0,0,0,0,0,0.169643920497505,144.267498531406,17.8236462980217
9.7,"eps_greedy_SVM","SVM",15,13,1384,1355,29,1400,1165,235,0.815738080133351,0.228346456692913,1.28387096774194,600,235,365,27,1.6,50.29,5,0,0,0,0,0,0,0.0902259735637174,28.1430088627786,12.7650628839591
9.7,"eps_greedy_SVM","SVM",15,14,1284,1260,24,1500,1260,240,0.791954323245144,0.275590551181102,1.25354330708661,641,240,401,41,1.7,53.88,5.2,0,0,0,0,0,0,0.153856869973746,84.9086989926256,16.3918597714673
9.7,"eps_greedy_SVM","SVM",15,15,1184,1162,22,1600,1358,242,0.794485701135703,0.196850393700787,1.2737617475235,631,242,389,-10,1.6,57.47,5.6,0,0,0,0,0,0,0.117816370132494,40.0093605989585,14.4390672903011
9.7,"eps_greedy_SVM","SVM",15,16,1084,1064,20,1700,1456,244,0.791867248821389,0.244094488188976,1.26365252730505,661,244,417,30,1.7,61.06,6,0,0,0,0,0,0,0.100984407281677,38.7479150745556,12.3197204747957
9.7,"eps_greedy_SVM","SVM",15,17,984,966,18,1800,1554,246,0.771118657561169,0.188976377952756,1.25354330708661,662,246,416,1,1.7,64.66,6.3,0,0,0,0,0,0,0.0624226820200509,16.9053547406257,9.21466784567015
9.7,"eps_greedy_SVM","SVM",15,18,884,868,16,1900,1652,248,0.766006144966477,0.165354330708661,1.26365252730505,675,248,427,13,1.7,68.25,6.7,0,0,0,0,0,0,0.0308136371915195,11.9707860803774,4.80244496943442
9.7,"eps_greedy_SVM","SVM",15,19,784,772,12,2000,1748,252,0.813791344802285,0.204724409448819,1.28387096774194,678,252,426,3,1.7,71.84,6.9,0,0,0,0,0,0,0.0317021063995384,9.65516843667545,6.26879028031574
9.7,"eps_greedy_SVM","SVM",15,20,684,679,5,2100,1841,259,0.819382766727621,0.291338582677165,1.28387096774194,731,259,472,53,1.8,75.43,7.1,0,0,0,0,0,0,0.119044328049542,45.3908853705966,13.0802584991637
9.7,"eps_greedy_SVM","SVM",15,21,584,582,2,2200,1938,262,0.834788720130363,0.251968503937008,1.28387096774194,745,262,483,14,1.8,79.02,7.4,0,0,0,0,0,0,0.0314533176702124,8.00487655797505,6.09036669853332
9.7,"eps_greedy_SVM","SVM",15,22,484,482,2,2300,2038,262,0.824856016220719,0.244094488188976,1.28387096774194,738,262,476,-7,1.8,82.61,7.8,0,0,0,0,0,0,0.00547246729408996,1.83103716299717,1.48686210764087
9.7,"eps_greedy_SVM","SVM",15,23,384,383,1,2400,2137,263,0.786966202684382,0.165354330708661,1.2737617475235,781,263,518,43,2,86.21,8.1,0,0,0,0,0,0,0.0439838950096374,12.2202344414195,8.24871912008395
9.7,"eps_greedy_SVM","SVM",15,24,284,283,1,2500,2237,263,0.747334900672964,0.133858267716535,1.2737617475235,758,263,495,-23,1.9,89.8,8.5,0,0,0,0,0,0,0.00218299690681923,1.24622490720014,1.16470887607546
9.7,"eps_greedy_SVM","SVM",15,25,184,184,0,2600,2336,264,0.797974897687554,0.267716535433071,1.28387096774194,763,264,499,5,1.9,93.39,8.8,0,0,0,0,0,0,0.00031843062346607,0.605439868567565,0.597402789504275
9.7,"eps_greedy_SVM","SVM",15,26,84,84,0,2700,2436,264,0.759435135773904,0.173228346456693,1.28268876611418,761,264,497,-2,1.9,96.98,9.2,0,0,0,0,0,0,1.0000000994736e-07,0.00970430227086568,0.00970430227086568
9.7,"eps_greedy_SVM","SVM",15,27,0,0,0,2784,2520,264,0.730653928922398,0.125984251968504,1.2737617475235,756,264,492,-5,1.9,100,9.5,0,0,0,0,0,0,0,0,0
9.7,"eps_greedy_SVM","SVM",16,0,2684,2427,257,100,93,7,0.863193641079226,0.291338582677165,1.28387096774194,19,7,12,0,1.7,3.59,13.3,0,0,0,0,0,0,0.136914011540247,212.745548522229,14.4964889186559
9.7,"eps_greedy_SVM","SVM",16,1,2584,2355,229,200,165,35,0.740978467738935,0.125984251968504,1.24343408686817,92,35,57,73,1.6,7.18,4.7,0,0,0,0,0,0,0.220155986799158,407.260252924582,26.2402332517175
9.7,"eps_greedy_SVM","SVM",16,2,2484,2258,226,300,262,38,0.842569441852948,0.307086614173228,1.26365252730505,107,38,69,15,1.8,10.78,6.9,0,0,0,0,0,0,0.169169870519323,233.062609660168,19.5507950727142
9.7,"eps_greedy_SVM","SVM",16,3,2384,2183,201,400,337,63,0.837214364792094,0.338582677165354,1.24343408686817,161,63,98,54,1.6,14.37,5.3,0,0,0,0,0,0,0.177592507543195,204.662084329632,18.4740727909917
9.7,"eps_greedy_SVM","SVM",16,4,2284,2110,174,500,410,90,0.835298727469497,0.330708661417323,1.26365252730505,224,90,134,63,1.5,17.96,4.6,0,0,0,0,0,0,0.205763655826221,200.644068792181,20.8931278914877
9.7,"eps_greedy_SVM","SVM",16,5,2184,2026,158,600,494,106,0.856488910450171,0.307086614173228,1.28387096774194,260,106,154,36,1.5,21.55,4.7,0,0,0,0,0,0,0.210026447832761,151.177048029384,21.7023779887006
9.7,"eps_greedy_SVM","SVM",16,6,2084,1962,122,700,558,142,0.85056163003321,0.307086614173228,1.2737617475235,349,142,207,89,1.5,25.14,3.9,0,0,0,0,0,0,0.235354018571816,155.172298482825,23.984309091116
9.7,"eps_greedy_SVM","SVM",16,7,1984,1884,100,800,636,164,0.853814481720589,0.31496062992126,1.2737617475235,391,164,227,42,1.4,28.74,3.9,0,0,0,0,0,0,0.220364821791927,114.175901811638,22.826981067753
9.7,"eps_greedy_SVM","SVM",16,8,1884,1802,82,900,718,182,0.853907775746041,0.330708661417323,1.2737617475235,435,182,253,44,1.4,32.33,3.9,0,0,0,0,0,0,0.194146884456752,93.5229474824126,20.7678112584611
9.7,"eps_greedy_SVM","SVM",16,9,1784,1716,68,1000,804,196,0.845399360624952,0.307086614173228,1.2737617475235,466,196,270,31,1.4,35.92,4.1,0,0,0,0,0,0,0.176760138844255,83.5576378778622,19.403089731898
9.7,"eps_greedy_SVM","SVM",16,10,1684,1631,53,1100,889,211,0.819668868405684,0.228346456692913,1.25354330708661,512,211,301,46,1.4,39.51,4.2,0,0,0,0,0,0,0.195670155760042,101.623501075873,21.9054102048554
9.7,"eps_greedy_SVM","SVM",16,11,1584,1536,48,1200,984,216,0.82491199263601,0.251968503937008,1.24343408686817,531,216,315,19,1.5,43.1,4.6,0,0,0,0,0,0,0.175774991271799,151.179206235111,17.9162789140472
9.7,"eps_greedy_SVM","SVM",16,12,1484,1444,40,1300,1076,224,0.824091005212042,0.244094488188976,1.24343408686817,555,224,331,24,1.5,46.7,4.8,0,0,0,0,0,0,0.154426471997075,68.1453768513741,16.5544212201572
9.7,"eps_greedy_SVM","SVM",16,13,1384,1353,31,1400,1167,233,0.838153524648299,0.322834645669291,1.24343408686817,583,233,350,28,1.5,50.29,5,0,0,0,0,0,0,0.114748115840806,38.9561992325372,13.897631623565
9.7,"eps_greedy_SVM","SVM",16,14,1284,1258,26,1500,1262,238,0.8396648878606,0.322834645669291,1.25354330708661,612,238,374,29,1.6,53.88,5.3,0,0,0,0,0,0,0.103427963730733,33.7374153944778,12.3084993898424
9.7,"eps_greedy_SVM","SVM",16,15,1184,1159,25,1600,1361,239,0.834686096702383,0.299212598425197,1.25354330708661,620,239,381,8,1.6,57.47,5.7,0,0,0,0,0,0,0.0153036176342309,3.93947995785365,2.94896721219195
9.7,"eps_greedy_SVM","SVM",16,16,1084,1062,22,1700,1458,242,0.825614807627728,0.291338582677165,1.24343408686817,637,242,395,17,1.6,61.06,6,0,0,0,0,0,0,0.0606978196273934,19.2787238665584,8.90516701471062
9.7,"eps_greedy_SVM","SVM",16,17,984,966,18,1800,1554,246,0.795941087932733,0.21259842519685,1.23332486664973,661,246,415,24,1.7,64.66,6.3,0,0,0,0,0,0,0.0662102817099534,20.3938106397429,10.2704875570114
9.7,"eps_greedy_SVM","SVM",16,18,884,866,18,1900,1654,246,0.828111977708952,0.322834645669291,1.24343408686817,649,246,403,-12,1.6,68.25,6.7,0,0,0,0,0,0,0.0153849196145395,4.47170590453428,2.93793591364471
9.7,"eps_greedy_SVM","SVM",16,19,784,766,18,2000,1754,246,0.795344006169849,0.244094488188976,1.24343408686817,649,246,403,0,1.6,71.84,7.1,0,0,0,0,0,0,0.00599359611743608,1.7880789018196,1.1403554138583
9.7,"eps_greedy_SVM","SVM",16,20,684,668,16,2100,1852,248,0.806271846350954,0.236220472440945,1.21310642621285,669,248,421,20,1.7,75.43,7.5,0,0,0,0,0,0,0.0180098775197718,6.26053356658052,4.65739913432484
9.7,"eps_greedy_SVM","SVM",16,21,584,570,14,2200,1950,250,0.822181587491138,0.330708661417323,1.22321564643129,670,250,420,1,1.7,79.02,7.8,0,0,0,0,0,0,0.00976307645668456,4.8624092949306,3.93772305235869
9.7,"eps_greedy_SVM","SVM",16,22,484,472,12,2300,2048,252,0.761378761304122,0.165354330708661,1.21310642621285,681,252,429,11,1.7,82.61,8.1,0,0,0,0,0,0,0.00560782571677033,1.86083194345161,1.40350884781869
9.7,"eps_greedy_SVM","SVM",16,23,384,373,11,2400,2147,253,0.819488499956464,0.283464566929134,1.20299720599441,666,253,413,-15,1.6,86.21,8.5,0,0,0,0,0,0,0.00410498618419351,1.18605183115626,0.814368951598822
9.7,"eps_greedy_SVM","SVM",16,24,284,275,9,2500,2245,255,0.816148573845328,0.31496062992126,1.21310642621285,679,255,424,13,1.7,89.8,8.8,0,0,0,0,0,0,0.00180810063651998,0.761893527616009,0.652037941828641
9.7,"eps_greedy_SVM","SVM",16,25,184,180,4,2600,2340,260,0.82802179348435,0.283464566929134,1.24343408686817,702,260,442,23,1.7,93.39,9,0,0,0,0,0,0,0.00466638771168955,2.2320498765616,2.15221502991862
9.7,"eps_greedy_SVM","SVM",16,26,84,84,0,2700,2436,264,0.82027838937195,0.220472440944882,1.2737617475235,742,264,478,40,1.8,96.98,9.2,0,0,0,0,0,0,2.0395552302109e-06,0.759848099434136,0.759848099434136
9.7,"eps_greedy_SVM","SVM",16,27,0,0,0,2784,2520,264,0.798889179136968,0.21259842519685,1.28387096774194,737,264,473,-5,1.8,100,9.5,0,0,0,0,0,0,0,0,0
9.7,"eps_greedy_SVM","SVM",17,0,2684,2431,253,100,92,8,0.636701382544614,0.215384615384615,1.0863523573201,28,8,20,0,2.5,3.59,11.5,0,0,0,0,0,0,0.135437630161132,215.42530165862,17.1118446789687
9.7,"eps_greedy_SVM","SVM",17,1,2584,2354,230,200,169,31,0.792569584018518,0.315384615384615,1.24436724565757,88,31,57,60,1.8,7.18,5.5,0,0,0,0,0,0,0.199079010800832,324.128899048004,20.6702945891729
9.7,"eps_greedy_SVM","SVM",17,2,2484,2275,209,300,248,52,0.81212619526159,0.284615384615385,1.26411910669975,126,52,74,38,1.4,10.78,4.8,0,0,0,0,0,0,0.229610404474913,120.837515530016,26.1889283911516
9.7,"eps_greedy_SVM","SVM",17,3,2384,2212,172,400,311,89,0.828905536268959,0.253846153846154,1.27399503722084,202,89,113,76,1.3,14.37,3.5,0,0,0,0,0,0,0.258199887218717,142.235121487819,28.9693082154639
9.7,"eps_greedy_SVM","SVM",17,4,2284,2146,138,500,377,123,0.78344600767404,0.307692307692308,1.21473945409429,273,123,150,71,1.2,17.96,3.1,0,0,0,0,0,0,0.254091439934692,195.702867795217,27.6562263409988
9.7,"eps_greedy_SVM","SVM",17,5,2184,2052,132,600,471,129,0.813112857055853,0.307692307692308,1.23449131513648,289,129,160,16,1.2,21.55,3.7,0,0,0,0,0,0,0.256515363053236,149.103632898762,31.4515983142035
9.7,"eps_greedy_SVM","SVM",17,6,2084,1980,104,700,543,157,0.828357390827702,0.315384615384615,1.25424317617866,349,157,192,60,1.2,25.14,3.5,0,0,0,0,0,0,0.239803607924104,93.6290817758468,25.2233316045223
9.7,"eps_greedy_SVM","SVM",17,7,1984,1901,83,800,622,178,0.833607406053965,0.346153846153846,1.25424317617866,400,178,222,51,1.2,28.74,3.5,0,0,0,0,0,0,0.212619794943528,86.4255891108435,22.8597258249939
9.7,"eps_greedy_SVM","SVM",17,8,1884,1818,66,900,705,195,0.824873622023269,0.323076923076923,1.24436724565757,437,195,242,37,1.2,32.33,3.6,0,0,0,0,0,0,0.150583851625992,41.3318970219254,19.1234483516745
9.7,"eps_greedy_SVM","SVM",17,9,1784,1735,49,1000,788,212,0.819264267007738,0.261538461538462,1.24436724565757,498,212,286,61,1.3,35.92,3.7,0,0,0,0,0,0,0.185072151517133,83.1777413875484,20.1613763257055
9.7,"eps_greedy_SVM","SVM",17,10,1684,1643,41,1100,880,220,0.818569949448813,0.3,1.23449131513648,519,220,299,21,1.4,39.51,4,0,0,0,0,0,0,0.146819149209298,49.0444300618541,17.2962467790075
9.7,"eps_greedy_SVM","SVM",17,11,1584,1546,38,1200,977,223,0.813051952006825,0.292307692307692,1.23449131513648,536,223,313,17,1.4,43.1,4.4,0,0,0,0,0,0,0.0822449864221218,25.0215158899765,11.2582918460317
9.7,"eps_greedy_SVM","SVM",17,12,1484,1457,27,1300,1066,234,0.803928375662346,0.269230769230769,1.2048635235732,589,234,355,53,1.5,46.7,4.6,0,0,0,0,0,0,0.161868933179189,87.8520562307077,18.1442870363713
9.7,"eps_greedy_SVM","SVM",17,13,1384,1364,20,1400,1159,241,0.804464340093797,0.284615384615385,1.21473945409429,612,241,371,23,1.5,50.29,4.8,0,0,0,0,0,0,0.130994222265995,54.6457317178558,15.0225563086991
9.7,"eps_greedy_SVM","SVM",17,14,1284,1265,19,1500,1258,242,0.791930081003719,0.238461538461538,1.19498759305211,604,242,362,-8,1.5,53.88,5.2,0,0,0,0,0,0,0.0931506132393041,30.4082913245857,11.1186066021579
9.7,"eps_greedy_SVM","SVM",17,15,1184,1165,19,1600,1358,242,0.802728546196484,0.261538461538462,1.2048635235732,612,242,370,8,1.5,57.47,5.6,0,0,0,0,0,0,0.0648301261528377,20.751932517346,7.87410751672446
9.7,"eps_greedy_SVM","SVM",17,16,1084,1067,17,1700,1456,244,0.770010353858339,0.238461538461538,1.22461538461538,625,244,381,13,1.6,61.06,6,0,0,0,0,0,0,0.1066820290693,34.7227987321093,13.6989461103755
9.7,"eps_greedy_SVM","SVM",17,17,984,968,16,1800,1555,245,0.775376088677755,0.215384615384615,1.22461538461538,620,245,375,-5,1.5,64.66,6.3,0,0,0,0,0,0,0.0816504499323699,32.0720845952418,9.87048447409805
9.7,"eps_greedy_SVM","SVM",17,18,884,868,16,1900,1655,245,0.785809123576349,0.192307692307692,1.22461538461538,647,245,402,27,1.6,68.25,6.8,0,0,0,0,0,0,0.0252050082262073,7.24055582228758,3.8084271085763
9.7,"eps_greedy_SVM","SVM",17,19,784,768,16,2000,1755,245,0.779079115658692,0.207692307692308,1.22461538461538,640,245,395,-7,1.6,71.84,7.2,0,0,0,0,0,0,0.00556083868709682,1.66553951539263,1.06048822328582
9.7,"eps_greedy_SVM","SVM",17,20,684,668,16,2100,1855,245,0.790462269322131,0.253846153846154,1.22461538461538,635,245,390,-5,1.6,75.43,7.6,0,0,0,0,0,0,0.000796303668726113,0.301679440280407,0.226382150161347
9.7,"eps_greedy_SVM","SVM",17,21,584,569,15,2200,1954,246,0.790568853157931,0.215384615384615,1.22461538461538,648,246,402,13,1.6,79.02,7.9,0,0,0,0,0,0,0.000212352055783975,0.0809783335536406,0.0610834043376026
9.7,"eps_greedy_SVM","SVM",17,22,484,472,12,2300,2051,249,0.811230891040871,0.292307692307692,1.24436724565757,647,249,398,-1,1.6,82.61,8.2,0,0,0,0,0,0,0.00151684204310541,0.524078182051458,0.31792002217408
9.7,"eps_greedy_SVM","SVM",17,23,384,376,8,2400,2147,253,0.810268591266219,0.261538461538462,1.25424317617866,673,253,420,26,1.7,86.21,8.5,0,0,0,0,0,0,0.0079572268191344,3.28710385798218,2.56588071806541
9.7,"eps_greedy_SVM","SVM",17,24,284,283,1,2500,2240,260,0.762019611425789,0.146153846153846,1.26411910669975,697,260,437,24,1.7,89.8,8.6,0,0,0,0,0,0,0.0146488389283587,4.50808991205112,3.54595511227356
9.7,"eps_greedy_SVM","SVM",17,25,184,183,1,2600,2340,260,0.792076253121386,0.230769230769231,1.26411910669975,685,260,425,-12,1.6,93.39,9,0,0,0,0,0,0,8.02311937496489e-05,0.0660058516806814,0.0642649297005619
9.7,"eps_greedy_SVM","SVM",17,26,84,84,0,2700,2439,261,0.820768621718743,0.284615384615385,1.26411910669975,686,261,425,1,1.6,96.98,9.3,0,0,0,0,0,0,0.000240511158332269,0.839587282963987,0.839587282963987
9.7,"eps_greedy_SVM","SVM",17,27,0,0,0,2784,2523,261,0.779943967354896,0.153846153846154,1.26411910669975,701,261,440,15,1.7,100,9.7,0,0,0,0,0,0,0,0,0
9.7,"eps_greedy_SVM","SVM",18,0,2684,2431,253,100,92,8,0.773378403069616,0.238461538461538,1.28387096774194,25,8,17,0,2.1,3.59,11.5,0,0,0,0,0,0,0.121809788316647,197.373894645677,14.6894910163861
9.7,"eps_greedy_SVM","SVM",18,1,2584,2350,234,200,173,27,0.764358365308487,0.238461538461538,1.25424317617866,74,27,47,49,1.7,7.18,6.4,0,0,0,0,0,0,0.187743533478671,299.145531584283,23.8705232876863
9.7,"eps_greedy_SVM","SVM",18,2,2484,2275,209,300,248,52,0.777111882575069,0.269230769230769,1.22461538461538,129,52,77,55,1.5,10.78,4.8,0,0,0,0,0,0,0.195357899122087,341.375274027332,22.1168834899885
9.7,"eps_greedy_SVM","SVM",18,3,2384,2201,183,400,322,78,0.76317071685243,0.238461538461538,1.23449131513648,184,78,106,55,1.4,14.37,4.1,0,0,0,0,0,0,0.200589999196741,270.524751074255,21.4544662836846
9.7,"eps_greedy_SVM","SVM",18,4,2284,2115,169,500,408,92,0.757549180827093,0.215384615384615,1.22461538461538,223,92,131,39,1.4,17.96,4.4,0,0,0,0,0,0,0.182720787651585,231.512986482318,20.4247405023202
9.7,"eps_greedy_SVM","SVM",18,5,2184,2028,156,600,495,105,0.765070954382122,0.230769230769231,1.22461538461538,243,105,138,20,1.3,21.55,4.7,0,0,0,0,0,0,0.170729754459844,207.40406021777,17.5775798900992
9.7,"eps_greedy_SVM","SVM",18,6,2084,1957,127,700,566,134,0.785924843169502,0.238461538461538,1.22461538461538,313,134,179,70,1.3,25.14,4.2,0,0,0,0,0,0,0.189852400763525,211.152391565883,20.0081180014583
9.7,"eps_greedy_SVM","SVM",18,7,1984,1881,103,800,642,158,0.787739813630553,0.207692307692308,1.22461538461538,376,158,218,63,1.4,28.74,4.1,0,0,0,0,0,0,0.182782790353657,178.539614786501,19.1864057050544
9.7,"eps_greedy_SVM","SVM",18,8,1884,1806,78,900,717,183,0.796278701504358,0.207692307692308,1.22461538461538,447,183,264,71,1.4,32.33,3.9,0,0,0,0,0,0,0.186524005290889,159.507587574464,20.3503831903538
9.7,"eps_greedy_SVM","SVM",18,9,1784,1734,50,1000,789,211,0.799214324867535,0.230769230769231,1.22461538461538,496,211,285,49,1.4,35.92,3.7,0,0,0,0,0,0,0.165399881259893,116.01662768716,18.4648786067355
9.7,"eps_greedy_SVM","SVM",18,10,1684,1643,41,1100,880,220,0.798270296607593,0.215384615384615,1.22461538461538,533,220,313,37,1.4,39.51,4,0,0,0,0,0,0,0.17238411111164,133.12682080553,18.7145459950117
9.7,"eps_greedy_SVM","SVM",18,11,1584,1547,37,1200,976,224,0.796668493818141,0.223076923076923,1.22461538461538,550,224,326,17,1.5,43.1,4.4,0,0,0,0,0,0,0.129427230009508,77.62763103514,14.183803247033
9.7,"eps_greedy_SVM","SVM",18,12,1484,1453,31,1300,1070,230,0.79071807052805,0.184615384615385,1.22461538461538,569,230,339,19,1.5,46.7,4.7,0,0,0,0,0,0,0.124008845016719,67.4640101448414,14.6376365333594
9.7,"eps_greedy_SVM","SVM",18,13,1384,1362,22,1400,1161,239,0.795986357269021,0.184615384615385,1.22461538461538,605,239,366,36,1.5,50.29,4.9,0,0,0,0,0,0,0.153956519646387,155.046852127772,15.8807003639243
9.7,"eps_greedy_SVM","SVM",18,14,1284,1264,20,1500,1259,241,0.785815214081251,0.153846153846154,1.21473945409429,602,241,361,-3,1.5,53.88,5.2,0,0,0,0,0,0,0.0725557264393282,33.8034405540184,8.65532397453038
9.7,"eps_greedy_SVM","SVM",18,15,1184,1164,20,1600,1359,241,0.817638102198676,0.253846153846154,1.22461538461538,602,241,361,0,1.5,57.47,5.6,0,0,0,0,0,0,0.0766092386586833,33.0645818719867,9.0930731801446
9.7,"eps_greedy_SVM","SVM",18,16,1084,1066,18,1700,1457,243,0.810043242584814,0.238461538461538,1.22461538461538,614,243,371,12,1.5,61.06,6,0,0,0,0,0,0,0.0740936861663789,29.5778094832895,9.78285406053096
9.7,"eps_greedy_SVM","SVM",18,17,984,967,17,1800,1556,244,0.784825507034537,0.169230769230769,1.22461538461538,615,244,371,1,1.5,64.66,6.4,0,0,0,0,0,0,0.0634408710307209,19.9130581662581,9.78902410483493
9.7,"eps_greedy_SVM","SVM",18,18,884,868,16,1900,1655,245,0.804409525549672,0.230769230769231,1.22461538461538,613,245,368,-2,1.5,68.25,6.8,0,0,0,0,0,0,0.054957643484196,16.8651410293549,7.00581949867552
9.7,"eps_greedy_SVM","SVM",18,19,784,768,16,2000,1755,245,0.807911565868814,0.246153846153846,1.22461538461538,624,245,379,11,1.5,71.84,7.2,0,0,0,0,0,0,0.0338100010696711,9.55953062505589,4.52398952295426
9.7,"eps_greedy_SVM","SVM",18,20,684,668,16,2100,1855,245,0.800158353127478,0.238461538461538,1.22461538461538,628,245,383,4,1.6,75.43,7.6,0,0,0,0,0,0,0.00409528375259334,1.09814976103324,0.829099273736784
9.7,"eps_greedy_SVM","SVM",18,21,584,569,15,2200,1954,246,0.796607588769113,0.207692307692308,1.19498759305211,634,246,388,6,1.6,79.02,7.9,0,0,0,0,0,0,0.013426324314513,4.92169158533479,3.90126385692735
9.7,"eps_greedy_SVM","SVM",18,22,484,470,14,2300,2053,247,0.77905475363908,0.138461538461538,1.19498759305211,627,247,380,-7,1.5,82.61,8.3,0,0,0,0,0,0,0.015752897863817,4.55900058141836,2.97244192105772
9.7,"eps_greedy_SVM","SVM",18,23,384,371,13,2400,2152,248,0.81105731165114,0.246153846153846,1.2048635235732,637,248,389,10,1.6,86.21,8.7,0,0,0,0,0,0,0.00103729220628241,0.38902923629214,0.328439977956114
9.7,"eps_greedy_SVM","SVM",18,24,284,273,11,2500,2250,250,0.809093123819969,0.238461538461538,1.2048635235732,639,250,389,2,1.6,89.8,9,0,0,0,0,0,0,0.000463591325631864,0.428241464055883,0.411177843166817
9.7,"eps_greedy_SVM","SVM",18,25,184,174,10,2600,2349,251,0.808295267677694,0.230769230769231,1.2048635235732,635,251,384,-4,1.5,93.39,9.4,0,0,0,0,0,0,0.000284657806335076,0.10263785586314,0.0957523230782062
9.7,"eps_greedy_SVM","SVM",18,26,84,80,4,2700,2443,257,0.772513551373412,0.138461538461538,1.23449131513648,681,257,424,46,1.6,96.98,9.5,0,0,0,0,0,0,2.07253264091412e-05,1.4921400620563,1.4921400620563
9.7,"eps_greedy_SVM","SVM",18,27,0,0,0,2784,2523,261,0.81415433339424,0.276923076923077,1.27399503722084,719,261,458,38,1.8,100,9.7,0,0,0,0,0,0,0,0,0
9.7,"eps_greedy_SVM","SVM",19,0,2684,2402,282,100,95,5,0.539699826937997,0.0961538461538462,1.03697270471464,29,5,24,0,4.8,3.59,19,0,0,0,0,0,0,0.0664652664963044,149.2360632263,7.84466165408695
9.7,"eps_greedy_SVM","SVM",19,1,2584,2309,275,200,188,12,0.333644148713972,0,0.80241935483871,46,12,34,17,2.8,7.18,15.7,0,0,0,0,0,0,0.0618329727930566,156.011000291048,6.21216698651145
9.7,"eps_greedy_SVM","SVM",19,2,2484,2228,256,300,269,31,0.701072686041658,0.134615384615385,1.25918114143921,96,31,65,50,2.1,10.78,8.7,0,0,0,0,0,0,0.116017227912615,253.882352671797,11.9475826521389
9.7,"eps_greedy_SVM","SVM",19,3,2384,2146,238,400,351,49,0.690241391657222,0.125,1.25918114143921,138,49,89,42,1.8,14.37,7.2,0,0,0,0,0,0,0.150572196857767,240.136584288512,16.1334291591338
9.7,"eps_greedy_SVM","SVM",19,4,2284,2069,215,500,428,72,0.69517962642478,0.144230769230769,1.27152605459057,182,72,110,44,1.5,17.96,5.9,0,0,0,0,0,0,0.16469612744199,183.344056316748,17.1371776394012
9.7,"eps_greedy_SVM","SVM",19,5,2184,1998,186,600,499,101,0.715678522408548,0.144230769230769,1.27152605459057,246,101,145,64,1.4,21.55,4.9,0,0,0,0,0,0,0.18413762358198,227.252239562742,19.0271195685655
9.7,"eps_greedy_SVM","SVM",19,6,2084,1928,156,700,569,131,0.710829802470612,0.144230769230769,1.27152605459057,320,131,189,74,1.4,25.14,4.3,0,0,0,0,0,0,0.190117761379902,178.054795948491,19.9914308549401
9.7,"eps_greedy_SVM","SVM",19,7,1984,1861,123,800,636,164,0.722451811183388,0.144230769230769,1.27152605459057,392,164,228,72,1.4,28.74,3.9,0,0,0,0,0,0,0.199400855033709,188.582346973958,20.7398466345948
9.7,"eps_greedy_SVM","SVM",19,8,1884,1788,96,900,709,191,0.745874858268191,0.163461538461538,1.27152605459057,455,191,264,63,1.4,32.33,3.7,0,0,0,0,0,0,0.200887376517829,212.600580285118,20.8759848819148
9.7,"eps_greedy_SVM","SVM",19,9,1784,1706,78,1000,791,209,0.753938652503434,0.221153846153846,1.27152605459057,498,209,289,43,1.4,35.92,3.8,0,0,0,0,0,0,0.179167369899555,131.231895515379,19.6197587321476
9.7,"eps_greedy_SVM","SVM",19,10,1684,1617,67,1100,880,220,0.781747926239782,0.201923076923077,1.27152605459057,539,220,319,41,1.4,39.51,4,0,0,0,0,0,0,0.178781782699711,125.285495218392,19.1241298072698
9.7,"eps_greedy_SVM","SVM",19,11,1584,1535,49,1200,962,238,0.779651787312766,0.192307692307692,1.27152605459057,599,238,361,60,1.5,43.1,4,0,0,0,0,0,0,0.199772406954725,111.116680072588,22.8360438242794
9.7,"eps_greedy_SVM","SVM",19,12,1484,1451,33,1300,1046,254,0.765321955003881,0.201923076923077,1.25918114143921,646,254,392,47,1.5,46.7,4.1,0,0,0,0,0,0,0.172325791877002,68.013945200305,20.2082429939266
9.7,"eps_greedy_SVM","SVM",19,13,1384,1357,27,1400,1140,260,0.748992958166738,0.163461538461538,1.25918114143921,670,260,410,24,1.6,50.29,4.4,0,0,0,0,0,0,0.174698747021408,110.046370323004,18.2237806469363
9.7,"eps_greedy_SVM","SVM",19,14,1284,1263,21,1500,1234,266,0.793757832547594,0.211538461538462,1.27152605459057,676,266,410,6,1.5,53.88,4.6,0,0,0,0,0,0,0.149276689454217,66.5862733458884,16.1536350754158
9.7,"eps_greedy_SVM","SVM",19,15,1184,1169,15,1600,1328,272,0.759361759264787,0.221153846153846,1.25918114143921,720,272,448,44,1.6,57.47,4.9,0,0,0,0,0,0,0.142718660511066,57.9858968305949,15.5732084840009
9.7,"eps_greedy_SVM","SVM",19,16,1084,1069,15,1700,1428,272,0.756556961269919,0.144230769230769,1.25918114143921,700,272,428,-20,1.6,61.06,5.2,0,0,0,0,0,0,0.0719945169481103,22.131167061237,9.14514036634263
9.7,"eps_greedy_SVM","SVM",19,17,984,970,14,1800,1527,273,0.774325654950174,0.163461538461538,1.25918114143921,719,273,446,19,1.6,64.66,5.6,0,0,0,0,0,0,0.0593380252846262,16.4382903544809,7.71952326682851
9.7,"eps_greedy_SVM","SVM",19,18,884,876,8,1900,1621,279,0.761748821388079,0.125,1.25918114143921,751,279,472,32,1.7,68.25,5.8,0,0,0,0,0,0,0.0243892612336028,6.91939384106763,4.40910678689639
9.7,"eps_greedy_SVM","SVM",19,19,784,779,5,2000,1718,282,0.798494658948504,0.25,1.27152605459057,761,282,479,10,1.7,71.84,6.1,0,0,0,0,0,0,0.0142100565693397,4.74852993365067,3.51973770769581
9.7,"eps_greedy_SVM","SVM",19,20,684,680,4,2100,1817,283,0.8058721728233,0.221153846153846,1.27152605459057,766,283,483,5,1.7,75.43,6.4,0,0,0,0,0,0,0.0150458771588927,4.29797916080281,2.80642008571874
9.7,"eps_greedy_SVM","SVM",19,21,584,583,1,2200,1914,286,0.790341349883631,0.182692307692308,1.25918114143921,773,286,487,7,1.7,79.02,6.7,0,0,0,0,0,0,0.0352689371966446,9.7659343236655,7.62703207260973
9.7,"eps_greedy_SVM","SVM",19,22,484,483,1,2300,2014,286,0.783799307751985,0.221153846153846,1.27152605459057,788,286,502,15,1.8,82.61,7,0,0,0,0,0,0,0.0293387865773093,8.41217203322963,4.74607403775844
9.7,"eps_greedy_SVM","SVM",19,23,384,384,0,2400,2113,287,0.781501760458319,0.201923076923077,1.25918114143921,791,287,504,3,1.8,86.21,7.4,0,0,0,0,0,0,0.037853605827596,13.5240783218997,11.8921160843976
9.7,"eps_greedy_SVM","SVM",19,24,284,284,0,2500,2213,287,0.808475562451515,0.240384615384615,1.27035522028616,781,287,494,-10,1.7,89.8,7.7,0,0,0,0,0,0,0.00240943495976758,1.07174196458095,0.979393289826895
9.7,"eps_greedy_SVM","SVM",19,25,184,184,0,2600,2313,287,0.780211254997915,0.201923076923077,1.25918114143921,776,287,489,-5,1.7,93.39,8.1,0,0,0,0,0,0,0.00036107015539483,0.238629944002434,0.230699517235077
9.7,"eps_greedy_SVM","SVM",19,26,84,84,0,2700,2413,287,0.798636390762071,0.221153846153846,1.27152605459057,813,287,526,37,1.8,96.98,8.4,0,0,0,0,0,0,1.0000000994736e-07,0.0126299945309145,0.0126299945309145
9.7,"eps_greedy_SVM","SVM",19,27,0,0,0,2784,2497,287,0.759704899445009,0.153846153846154,1.27152605459057,796,287,509,-17,1.8,100,8.7,0,0,0,0,0,0,0,0,0
9.7,"eps_greedy_SVM","SVM",20,0,2684,2422,262,100,87,13,0.765702211541051,0.224137931034483,1.23959955506118,35,13,22,0,1.7,3.59,6.7,0,0,0,0,0,0,0.174472292659374,339.95836062059,23.2259032970569
9.7,"eps_greedy_SVM","SVM",20,1,2584,2345,239,200,164,36,0.77146058920422,0.146551724137931,1.27280311457175,96,36,60,61,1.7,7.18,4.6,0,0,0,0,0,0,0.192208265607504,420.597792413362,19.8853484504894
9.7,"eps_greedy_SVM","SVM",20,2,2484,2260,224,300,249,51,0.769975427321577,0.181034482758621,1.28387096774194,135,51,84,39,1.6,10.78,4.9,0,0,0,0,0,0,0.186461909327444,365.289166921828,19.6409729549735
9.7,"eps_greedy_SVM","SVM",20,3,2384,2180,204,400,329,71,0.7951016660816,0.181034482758621,1.27280311457175,178,71,107,43,1.5,14.37,4.6,0,0,0,0,0,0,0.190821988435985,290.118352937799,19.7343368155394
9.7,"eps_greedy_SVM","SVM",20,4,2284,2113,171,500,396,104,0.785373855750273,0.206896551724138,1.28387096774194,248,104,144,70,1.4,17.96,3.8,0,0,0,0,0,0,0.211370410682791,342.700798327852,21.9725124527573
9.7,"eps_greedy_SVM","SVM",20,5,2184,2038,146,600,471,129,0.791429265789972,0.198275862068966,1.28387096774194,313,129,184,65,1.4,21.55,3.7,0,0,0,0,0,0,0.215114166549344,282.661325908858,21.9826026036747
9.7,"eps_greedy_SVM","SVM",20,6,2084,1952,132,700,557,143,0.787054788971998,0.181034482758621,1.28387096774194,339,143,196,26,1.4,25.14,3.9,0,0,0,0,0,0,0.184740355621642,166.21958589532,19.2411601651356
9.7,"eps_greedy_SVM","SVM",20,7,1984,1872,112,800,637,163,0.791145734885099,0.189655172413793,1.28387096774194,388,163,225,49,1.4,28.74,3.9,0,0,0,0,0,0,0.166959195967497,116.819600667264,17.6060409072495
9.7,"eps_greedy_SVM","SVM",20,8,1884,1800,84,900,709,191,0.80358734102017,0.189655172413793,1.26173526140156,456,191,265,68,1.4,32.33,3.7,0,0,0,0,0,0,0.196810498075503,178.995950818968,20.5703967496873
9.7,"eps_greedy_SVM","SVM",20,9,1784,1729,55,1000,780,220,0.807448761915052,0.206896551724138,1.25066740823137,519,220,299,63,1.4,35.92,3.5,0,0,0,0,0,0,0.188857995628256,144.16058817992,19.7672019364353
9.7,"eps_greedy_SVM","SVM",20,10,1684,1647,37,1100,862,238,0.806598169200448,0.189655172413793,1.25066740823137,572,238,334,53,1.4,39.51,3.6,0,0,0,0,0,0,0.198763987586377,148.53405057689,20.6079516758478
9.7,"eps_greedy_SVM","SVM",20,11,1584,1561,23,1200,948,252,0.803357816001949,0.206896551724138,1.25066740823137,614,252,362,42,1.4,43.1,3.8,0,0,0,0,0,0,0.186562264328588,123.867233104521,20.4432994446323
9.7,"eps_greedy_SVM","SVM",20,12,1484,1463,21,1300,1046,254,0.807266492047636,0.181034482758621,1.25066740823137,624,254,370,10,1.5,46.7,4.1,0,0,0,0,0,0,0.147979354993886,76.0893660117928,15.9560054272366
9.7,"eps_greedy_SVM","SVM",20,13,1384,1367,17,1400,1142,258,0.809143196608433,0.189655172413793,1.25066740823137,642,258,384,18,1.5,50.29,4.4,0,0,0,0,0,0,0.105304814207785,50.8017473800616,13.1393423786176
9.7,"eps_greedy_SVM","SVM",20,14,1284,1268,16,1500,1241,259,0.807151729538526,0.21551724137931,1.25066740823137,648,259,389,6,1.5,53.88,4.8,0,0,0,0,0,0,0.114060727325194,63.3161354218934,13.8668587831661
9.7,"eps_greedy_SVM","SVM",20,15,1184,1169,15,1600,1340,260,0.802689493154756,0.198275862068966,1.22853170189099,644,260,384,-4,1.5,57.47,5.2,0,0,0,0,0,0,0.107641314167344,56.6431095532056,14.3013727288691
9.7,"eps_greedy_SVM","SVM",20,16,1084,1069,15,1700,1440,260,0.79944913995625,0.21551724137931,1.26173526140156,664,260,404,20,1.6,61.06,5.5,0,0,0,0,0,0,0.0529644986750117,17.5575966861991,6.93752246625658
9.7,"eps_greedy_SVM","SVM",20,17,984,972,12,1800,1537,263,0.80313504171954,0.224137931034483,1.26173526140156,672,263,409,8,1.6,64.66,5.8,0,0,0,0,0,0,0.0819285090033327,34.4137367012153,11.6382538214083
9.7,"eps_greedy_SVM","SVM",20,18,884,873,11,1900,1636,264,0.807604028839139,0.206896551724138,1.26173526140156,680,264,416,8,1.6,68.25,6.2,0,0,0,0,0,0,0.0142215624369747,5.16773644503127,3.25964029695403
9.7,"eps_greedy_SVM","SVM",20,19,784,774,10,2000,1735,265,0.805389787486838,0.21551724137931,1.25066740823137,701,265,436,21,1.6,71.84,6.5,0,0,0,0,0,0,0.016878890529636,5.44843189073638,2.6484682496328
9.7,"eps_greedy_SVM","SVM",20,20,684,679,5,2100,1830,270,0.80378986309507,0.181034482758621,1.27280311457175,722,270,452,21,1.7,75.43,6.8,0,0,0,0,0,0,0.0677254088796011,21.5888056967143,10.3021172140182
9.7,"eps_greedy_SVM","SVM",20,21,584,581,3,2200,1928,272,0.8148813220641,0.224137931034483,1.27280311457175,722,272,450,0,1.7,79.02,7.1,0,0,0,0,0,0,0.0381608955653356,9.91742575784559,5.75082021417026
9.7,"eps_greedy_SVM","SVM",20,22,484,483,1,2300,2026,274,0.786089433748272,0.181034482758621,1.27280311457175,737,274,463,15,1.7,82.61,7.4,0,0,0,0,0,0,0.0366452106280414,13.074907115671,9.29524195354214
9.7,"eps_greedy_SVM","SVM",20,23,384,384,0,2400,2125,275,0.822462398401419,0.21551724137931,1.27280311457175,759,275,484,22,1.8,86.21,7.7,0,0,0,0,0,0,0.00295862637635164,1.52063310051602,1.37241077229473
9.7,"eps_greedy_SVM","SVM",20,24,284,284,0,2500,2225,275,0.774214889422943,0.172413793103448,1.27280311457175,760,275,485,1,1.8,89.8,8.1,0,0,0,0,0,0,0.00453910379781547,1.28134616104267,1.08802276909748
9.7,"eps_greedy_SVM","SVM",20,25,184,184,0,2600,2325,275,0.814341263197682,0.21551724137931,1.27280311457175,749,275,474,-11,1.7,93.39,8.5,0,0,0,0,0,0,0.000219974466614258,0.151632223063197,0.145180830985304
9.7,"eps_greedy_SVM","SVM",20,26,84,84,0,2700,2425,275,0.804228660924036,0.198275862068966,1.27280311457175,726,275,451,-23,1.6,96.98,8.8,0,0,0,0,0,0,1.44089276269774e-06,0.00834670458562186,0.00834670458562186
9.7,"eps_greedy_SVM","SVM",20,27,0,0,0,2784,2509,275,0.786778008802954,0.172413793103448,1.27280311457175,723,275,448,-3,1.6,100,9.1,0,0,0,0,0,0,0,0,0
9.7,"eps_greedy_SVM","SVM",21,0,2684,2427,257,100,88,12,0.748416762327329,0.163934426229508,1.27334743521946,31,12,19,0,1.6,3.59,7.3,0,0,0,0,0,0,0.235434060533499,337.705542630389,27.4013953029033
9.7,"eps_greedy_SVM","SVM",21,1,2584,2352,232,200,163,37,0.780926339141763,0.286885245901639,1.24177683765204,91,37,54,60,1.5,7.18,4.4,0,0,0,0,0,0,0.225064993382655,436.595557134309,25.8883839024754
9.7,"eps_greedy_SVM","SVM",21,2,2484,2275,209,300,240,60,0.688234383665895,0.122950819672131,1.12601797990481,146,60,86,55,1.4,10.78,4,0,0,0,0,0,0,0.217821098006353,444.493270788905,23.8699395486355
9.7,"eps_greedy_SVM","SVM",21,3,2384,2183,201,400,332,68,0.834956340044628,0.30327868852459,1.28387096774194,161,68,93,15,1.4,14.37,4.9,0,0,0,0,0,0,0.219336494606082,232.043555950101,22.3454576493401
9.7,"eps_greedy_SVM","SVM",21,4,2284,2110,174,500,405,95,0.834479111581174,0.344262295081967,1.28387096774194,229,95,134,68,1.4,17.96,4.3,0,0,0,0,0,0,0.220902514824464,244.908502984088,22.309770339297
9.7,"eps_greedy_SVM","SVM",21,5,2184,2049,135,600,466,134,0.828126813790613,0.336065573770492,1.28387096774194,311,134,177,82,1.3,21.55,3.5,0,0,0,0,0,0,0.256470547166041,230.823802148414,26.1307707966074
9.7,"eps_greedy_SVM","SVM",21,6,2084,1978,106,700,537,163,0.829519804981234,0.344262295081967,1.27334743521946,383,163,220,72,1.3,25.14,3.3,0,0,0,0,0,0,0.248935470385762,194.922377433002,25.5982061698347
9.7,"eps_greedy_SVM","SVM",21,7,1984,1899,85,800,616,184,0.8304355677084,0.311475409836066,1.27334743521946,425,184,241,42,1.3,28.74,3.3,0,0,0,0,0,0,0.231189271866086,157.289301341655,24.1413659796266
9.7,"eps_greedy_SVM","SVM",21,8,1884,1814,70,900,701,199,0.828171957023642,0.311475409836066,1.27334743521946,475,199,276,50,1.4,32.33,3.5,0,0,0,0,0,0,0.209469716189962,122.984080731978,22.3902261313161
9.7,"eps_greedy_SVM","SVM",21,9,1784,1721,63,1000,794,206,0.819949439579006,0.278688524590164,1.28387096774194,502,206,296,27,1.4,35.92,3.9,0,0,0,0,0,0,0.175688875639523,114.899652202226,18.9128887377894
9.7,"eps_greedy_SVM","SVM",21,10,1684,1623,61,1100,892,208,0.826340431569306,0.319672131147541,1.27334743521946,502,208,294,0,1.4,39.51,4.3,0,0,0,0,0,0,0.132563988782492,62.9632852074798,14.9538497974008
9.7,"eps_greedy_SVM","SVM",21,11,1584,1530,54,1200,985,215,0.806225896738077,0.262295081967213,1.25230037017451,534,215,319,32,1.5,43.1,4.6,0,0,0,0,0,0,0.12310308336753,58.0826311213238,14.1284229603527
9.7,"eps_greedy_SVM","SVM",21,12,1484,1435,49,1300,1080,220,0.799493105983412,0.254098360655738,1.24177683765204,552,220,332,18,1.5,46.7,4.9,0,0,0,0,0,0,0.153488463283493,90.7536752239104,17.3602761649683
9.7,"eps_greedy_SVM","SVM",21,13,1384,1340,44,1400,1175,225,0.816163857037829,0.319672131147541,1.24177683765204,570,225,345,18,1.5,50.29,5.2,0,0,0,0,0,0,0.147238323328588,81.577179593812,16.0992470720923
9.7,"eps_greedy_SVM","SVM",21,14,1284,1246,38,1500,1269,231,0.790696624575973,0.245901639344262,1.24177683765204,577,231,346,7,1.5,53.88,5.5,0,0,0,0,0,0,0.143476619680793,77.1507410579919,15.0283519535479
9.7,"eps_greedy_SVM","SVM",21,15,1184,1147,37,1600,1368,232,0.811836555700297,0.262295081967213,1.24177683765204,586,232,354,9,1.5,57.47,5.9,0,0,0,0,0,0,0.133356475192176,67.7744257435271,13.6843323017501
9.7,"eps_greedy_SVM","SVM",21,16,1084,1050,34,1700,1465,235,0.800350827410967,0.237704918032787,1.24177683765204,600,235,365,14,1.6,61.06,6.2,0,0,0,0,0,0,0.10863190326663,33.5216594637775,12.1890984227895
9.7,"eps_greedy_SVM","SVM",21,17,984,964,20,1800,1551,249,0.809598741148697,0.254098360655738,1.24177683765204,660,249,411,60,1.7,64.66,6.2,0,0,0,0,0,0,0.0977916808104515,26.033946658059,11.0698876164322
9.7,"eps_greedy_SVM","SVM",21,18,884,864,20,1900,1651,249,0.774838451716084,0.163934426229508,1.24177683765204,640,249,391,-20,1.6,68.25,6.6,0,0,0,0,0,0,0.0573926254285041,14.8552069921844,7.61368726284283
9.7,"eps_greedy_SVM","SVM",21,19,784,767,17,2000,1748,252,0.780345926145665,0.204918032786885,1.24177683765204,650,252,398,10,1.6,71.84,6.9,0,0,0,0,0,0,0.0203937584742057,8.28054959399602,6.90481874854944
9.7,"eps_greedy_SVM","SVM",21,20,684,672,12,2100,1843,257,0.770743315576986,0.172131147540984,1.24177683765204,664,257,407,14,1.6,75.43,7.2,0,0,0,0,0,0,0.0623517705498623,22.7613028932565,9.76913217812198
9.7,"eps_greedy_SVM","SVM",21,21,584,574,10,2200,1941,259,0.77492228914886,0.188524590163934,1.23125330512956,690,259,431,26,1.7,79.02,7.5,0,0,0,0,0,0,0.094504740492189,26.8421353657691,12.1240396217161
9.7,"eps_greedy_SVM","SVM",21,22,484,475,9,2300,2040,260,0.703350917697437,0.131147540983607,1.23125330512956,690,260,430,0,1.7,82.61,7.8,0,0,0,0,0,0,0.0628123661684677,23.7762786119919,12.6642739914573
9.7,"eps_greedy_SVM","SVM",21,23,384,377,7,2400,2138,262,0.767118958868069,0.163934426229508,1.23125330512956,712,262,450,22,1.7,86.21,8.2,0,0,0,0,0,0,0.0350383178404662,9.61728137519653,5.63746604524422
9.7,"eps_greedy_SVM","SVM",21,24,284,278,6,2500,2237,263,0.777895293495504,0.155737704918033,1.24177683765204,718,263,455,6,1.7,89.8,8.5,0,0,0,0,0,0,0.0174054708234105,4.15946459479349,2.68407779872318
9.7,"eps_greedy_SVM","SVM",21,25,184,181,3,2600,2334,266,0.770601436844616,0.221311475409836,1.25230037017451,725,266,459,7,1.7,93.39,8.8,0,0,0,0,0,0,0.0137583812692951,3.59017091050271,3.04427626569484
9.7,"eps_greedy_SVM","SVM",21,26,84,84,0,2700,2431,269,0.781164953373488,0.180327868852459,1.27334743521946,743,269,474,18,1.8,96.98,9,0,0,0,0,0,0,1.12417061879899e-07,0.988071749781633,0.988071749781633
9.7,"eps_greedy_SVM","SVM",21,27,0,0,0,2784,2515,269,0.785840502508674,0.163934426229508,1.28387096774194,746,269,477,3,1.8,100,9.3,0,0,0,0,0,0,0,0,0
9.7,"eps_greedy_SVM","SVM",22,0,2684,2424,260,100,93,7,0.604743384427669,0.193548387096774,1.10785639958377,24,7,17,0,2.4,3.59,13.3,0,0,0,0,0,0,0.0892993244461188,198.282328035358,9.20064411196073
9.7,"eps_greedy_SVM","SVM",22,1,2584,2347,237,200,170,30,0.650372403975699,0.0967741935483871,1.18033298647242,94,30,64,70,2.1,7.18,5.7,0,0,0,0,0,0,0.223888488458912,318.312801234868,27.9154923459503
9.7,"eps_greedy_SVM","SVM",22,2,2484,2259,225,300,258,42,0.609274511299222,0.282258064516129,0.962903225806452,121,42,79,27,1.9,10.78,6.1,0,0,0,0,0,0,0.193989796061322,275.869329940141,22.6990349763394
9.7,"eps_greedy_SVM","SVM",22,3,2384,2178,206,400,339,61,0.711602989399837,0.25,1.21139438085328,173,61,112,52,1.8,14.37,5.6,0,0,0,0,0,0,0.174911036505723,270.146871069809,20.3547326214865
9.7,"eps_greedy_SVM","SVM",22,4,2284,2102,182,500,415,85,0.743416202750452,0.25,1.22174817898023,215,85,130,42,1.5,17.96,4.9,0,0,0,0,0,0,0.184617148103338,245.679251609275,20.7663314762938
9.7,"eps_greedy_SVM","SVM",22,5,2184,2027,157,600,490,110,0.821538422430668,0.298387096774194,1.24245577523413,272,110,162,57,1.5,21.55,4.5,0,0,0,0,0,0,0.202976724320842,228.843664627236,22.1013990939587
9.7,"eps_greedy_SVM","SVM",22,6,2084,1948,136,700,569,131,0.837400543989427,0.290322580645161,1.25280957336108,316,131,185,44,1.4,25.14,4.3,0,0,0,0,0,0,0.188828169334161,166.271348755201,20.0930095615042
9.7,"eps_greedy_SVM","SVM",22,7,1984,1870,114,800,647,153,0.837775489971784,0.306451612903226,1.25280957336108,372,153,219,56,1.4,28.74,4.2,0,0,0,0,0,0,0.183872991518491,141.791911722064,19.2027323953602
9.7,"eps_greedy_SVM","SVM",22,8,1884,1796,88,900,721,179,0.841817280561275,0.282258064516129,1.24131170914276,434,179,255,62,1.4,32.33,4,0,0,0,0,0,0,0.194442891334554,157.748624573364,20.0882638005686
9.7,"eps_greedy_SVM","SVM",22,9,1784,1718,66,1000,799,201,0.837330638806277,0.274193548387097,1.23210197710718,493,201,292,59,1.5,35.92,4,0,0,0,0,0,0,0.188426508272904,116.057643880588,19.9100013625254
9.7,"eps_greedy_SVM","SVM",22,10,1684,1638,46,1100,879,221,0.830975622156137,0.225806451612903,1.23210197710718,549,221,328,56,1.5,39.51,4,0,0,0,0,0,0,0.185725306399594,116.882874964724,19.540276356781
9.7,"eps_greedy_SVM","SVM",22,11,1584,1551,33,1200,966,234,0.83330791326674,0.258064516129032,1.23210197710718,592,234,358,43,1.5,43.1,4.1,0,0,0,0,0,0,0.180939657273983,104.118604277534,19.1342863031792
9.7,"eps_greedy_SVM","SVM",22,12,1484,1454,30,1300,1063,237,0.817477566791232,0.25,1.23210197710718,593,237,356,1,1.5,46.7,4.5,0,0,0,0,0,0,0.152476523103178,78.2332761318673,16.5935165592037
9.7,"eps_greedy_SVM","SVM",22,13,1384,1357,27,1400,1160,240,0.828973791911339,0.290322580645161,1.24245577523413,599,240,359,6,1.5,50.29,4.8,0,0,0,0,0,0,0.100222026047916,36.90741364709,12.1137517757252
9.7,"eps_greedy_SVM","SVM",22,14,1284,1263,21,1500,1254,246,0.838906682935514,0.314516129032258,1.24245577523413,626,246,380,27,1.5,53.88,5.1,0,0,0,0,0,0,0.107581902890824,52.3817094692555,12.3321622032851
9.7,"eps_greedy_SVM","SVM",22,15,1184,1166,18,1600,1351,249,0.819098096037015,0.274193548387097,1.22174817898023,655,249,406,29,1.6,57.47,5.4,0,0,0,0,0,0,0.127620606291787,61.316952833969,14.4832202939611
9.7,"eps_greedy_SVM","SVM",22,16,1084,1067,17,1700,1450,250,0.778228983959941,0.17741935483871,1.22174817898023,644,250,394,-11,1.6,61.06,5.8,0,0,0,0,0,0,0.0804207679537634,29.1249455208632,10.2217361485315
9.7,"eps_greedy_SVM","SVM",22,17,984,967,17,1800,1550,250,0.824315564706783,0.330645161290323,1.22174817898023,637,250,387,-7,1.5,64.66,6.2,0,0,0,0,0,0,0.0538182729194797,18.3712184610822,6.65353897660544
9.7,"eps_greedy_SVM","SVM",22,18,884,867,17,1900,1650,250,0.82058516993315,0.282258064516129,1.22174817898023,678,250,428,41,1.7,68.25,6.6,0,0,0,0,0,0,0.0190919578911769,5.65801309542349,3.00990219057991
9.7,"eps_greedy_SVM","SVM",22,19,784,768,16,2000,1749,251,0.796340781412853,0.225806451612903,1.22174817898023,657,251,406,-21,1.6,71.84,7,0,0,0,0,0,0,0.0116850265818272,3.46502589604344,1.97236379608484
9.7,"eps_greedy_SVM","SVM",22,20,684,669,15,2100,1848,252,0.823292407026112,0.274193548387097,1.22174817898023,659,252,407,2,1.6,75.43,7.3,0,0,0,0,0,0,0.0105710845097267,3.1459364255414,1.77433491328864
9.7,"eps_greedy_SVM","SVM",22,21,584,571,13,2200,1946,254,0.785880424006714,0.17741935483871,1.22174817898023,686,254,432,27,1.7,79.02,7.7,0,0,0,0,0,0,0.0542840954436534,14.7203745995077,9.66258105064835
9.7,"eps_greedy_SVM","SVM",22,22,484,471,13,2300,2046,254,0.793290373420782,0.233870967741935,1.22174817898023,675,254,421,-11,1.7,82.61,8.1,0,0,0,0,0,0,0.0241121019770803,6.92927567746924,3.93105678555168
9.7,"eps_greedy_SVM","SVM",22,23,384,371,13,2400,2146,254,0.785060626858844,0.201612903225806,1.22174817898023,678,254,424,3,1.7,86.21,8.4,0,0,0,0,0,0,0.0105099223074202,3.05568554099031,2.24481661801365
9.7,"eps_greedy_SVM","SVM",22,24,284,271,13,2500,2246,254,0.812908309819774,0.233870967741935,1.22174817898023,682,254,428,4,1.7,89.8,8.8,0,0,0,0,0,0,0.00382041448204939,0.96756304946862,0.744215076617371
9.7,"eps_greedy_SVM","SVM",22,25,184,173,11,2600,2344,256,0.804964539007105,0.25,1.22174817898023,696,256,440,14,1.7,93.39,9.2,0,0,0,0,0,0,0.00220302845499815,0.781177956805409,0.690319473618015
9.7,"eps_greedy_SVM","SVM",22,26,84,80,4,2700,2437,263,0.759901115940926,0.17741935483871,1.27351716961498,708,263,445,12,1.7,96.98,9.3,0,0,0,0,0,0,6.28740134839804e-05,2.41180823306634,2.41180823306634
9.7,"eps_greedy_SVM","SVM",22,27,0,0,0,2784,2517,267,0.704301075268819,0.137096774193548,1.27351716961498,730,267,463,22,1.7,100,9.4,0,0,0,0,0,0,0,0,0
9.7,"eps_greedy_SVM","SVM",23,0,2684,2445,239,100,86,14,0.578093423407817,0.123188405797101,1.1164095371669,33,14,19,0,1.4,3.59,6.1,0,0,0,0,0,0,0.180977851696623,294.994491374387,36.1257215369034
9.7,"eps_greedy_SVM","SVM",23,1,2584,2362,222,200,169,31,0.721675616375082,0.115942028985507,1.26526414212249,88,31,57,55,1.8,7.18,5.5,0,0,0,0,0,0,0.206287503934465,337.996846039285,22.8287967584523
9.7,"eps_greedy_SVM","SVM",23,2,2484,2277,207,300,254,46,0.739563485189681,0.202898550724638,1.20014025245442,126,46,80,38,1.7,10.78,5.5,0,0,0,0,0,0,0.176997543163837,286.978000173766,19.9821431155444
9.7,"eps_greedy_SVM","SVM",23,3,2384,2194,190,400,337,63,0.758640799122359,0.289855072463768,1.20014025245442,163,63,100,37,1.6,14.37,5.3,0,0,0,0,0,0,0.177844728777952,242.380325526535,18.9761389370779
9.7,"eps_greedy_SVM","SVM",23,4,2284,2129,155,500,402,98,0.755592124256601,0.246376811594203,1.21874707807387,233,98,135,70,1.4,17.96,4.1,0,0,0,0,0,0,0.2039642171109,271.650961228474,22.0812925884595
9.7,"eps_greedy_SVM","SVM",23,5,2184,2044,140,600,487,113,0.760736763092562,0.253623188405797,1.21874707807387,275,113,162,42,1.4,21.55,4.3,0,0,0,0,0,0,0.184601400142083,195.456030611058,19.1282459957345
9.7,"eps_greedy_SVM","SVM",23,6,2084,1958,126,700,573,127,0.764668860788734,0.289855072463768,1.21874707807387,299,127,172,24,1.4,25.14,4.5,0,0,0,0,0,0,0.168633576616636,147.25525391938,17.4726594793179
9.7,"eps_greedy_SVM","SVM",23,7,1984,1884,100,800,647,153,0.773000750620712,0.268115942028986,1.21874707807387,355,153,202,56,1.3,28.74,4.2,0,0,0,0,0,0,0.1775977420566,160.869165344068,18.6377764986327
9.7,"eps_greedy_SVM","SVM",23,8,1884,1809,75,900,722,178,0.781823430914032,0.246376811594203,1.20014025245442,419,178,241,64,1.4,32.33,4.1,0,0,0,0,0,0,0.177501195258401,107.921762310824,18.9711709910979
9.7,"eps_greedy_SVM","SVM",23,9,1784,1731,53,1000,800,200,0.779490732721299,0.282608695652174,1.19083683964469,475,200,275,56,1.4,35.92,4,0,0,0,0,0,0,0.17123961339298,127.683399265547,18.56477357204
9.7,"eps_greedy_SVM","SVM",23,10,1684,1649,35,1100,882,218,0.782758819793298,0.268115942028986,1.20014025245442,520,218,302,45,1.4,39.51,4,0,0,0,0,0,0,0.170556702118749,94.3877217725758,18.4026912054673
9.7,"eps_greedy_SVM","SVM",23,11,1584,1560,24,1200,971,229,0.788094000808371,0.289855072463768,1.20014025245442,549,229,320,29,1.4,43.1,4.2,0,0,0,0,0,0,0.161469133419544,104.214134039337,17.2805281283418
9.7,"eps_greedy_SVM","SVM",23,12,1484,1468,16,1300,1063,237,0.767509671459101,0.260869565217391,1.19083683964469,585,237,348,36,1.5,46.7,4.5,0,0,0,0,0,0,0.181352523471616,125.618505361567,19.0015283989172
9.7,"eps_greedy_SVM","SVM",23,13,1384,1368,16,1400,1163,237,0.769778855592133,0.253623188405797,1.20014025245442,589,237,352,4,1.5,50.29,4.9,0,0,0,0,0,0,0.148239020337973,80.9890259901208,15.6498366694129
9.7,"eps_greedy_SVM","SVM",23,14,1284,1269,15,1500,1262,238,0.747699058837125,0.188405797101449,1.20014025245442,588,238,350,-1,1.5,53.88,5.3,0,0,0,0,0,0,0.139789593351714,61.7070483113866,14.9568129145366
9.7,"eps_greedy_SVM","SVM",23,15,1184,1169,15,1600,1362,238,0.761360355678743,0.231884057971014,1.20014025245442,588,238,350,0,1.5,57.47,5.7,0,0,0,0,0,0,0.0973608034564018,29.9495779018466,11.2316589677704
9.7,"eps_greedy_SVM","SVM",23,16,1084,1070,14,1700,1461,239,0.778947976211106,0.260869565217391,1.20014025245442,597,239,358,9,1.5,61.06,6.1,0,0,0,0,0,0,0.0699984616817843,20.2528743080867,8.7084234586527
9.7,"eps_greedy_SVM","SVM",23,17,984,971,13,1800,1560,240,0.767480801431964,0.239130434782609,1.20014025245442,609,240,369,12,1.5,64.66,6.5,0,0,0,0,0,0,0.100146585310874,24.1757614231555,11.8402700495455
9.7,"eps_greedy_SVM","SVM",23,18,884,871,13,1900,1660,240,0.780841849991348,0.297101449275362,1.20014025245442,619,240,379,10,1.6,68.25,6.9,0,0,0,0,0,0,0.0288780470070845,6.07551885958715,5.40779674360077
9.7,"eps_greedy_SVM","SVM",23,19,784,771,13,2000,1760,240,0.737375137132635,0.188405797101449,1.20944366526414,618,240,378,-1,1.6,71.84,7.3,0,0,0,0,0,0,0.00059810917939764,1.35916361858163,1.32639654924922
9.7,"eps_greedy_SVM","SVM",23,20,684,677,7,2100,1854,246,0.79757491772043,0.304347826086957,1.20944366526414,638,246,392,20,1.6,75.43,7.5,0,0,0,0,0,0,0.0215752171110312,7.59212332875678,3.27434787787786
9.7,"eps_greedy_SVM","SVM",23,21,584,580,4,2200,1951,249,0.778924880189387,0.210144927536232,1.23735390369331,644,249,395,6,1.6,79.02,7.8,0,0,0,0,0,0,0.118460226593573,42.1604490317947,13.7799656184966
9.7,"eps_greedy_SVM","SVM",23,22,484,480,4,2300,2051,249,0.783082164097235,0.217391304347826,1.24665731650304,651,249,402,7,1.6,82.61,8.2,0,0,0,0,0,0,0.0714247054774754,23.1674967698855,8.49204828193765
9.7,"eps_greedy_SVM","SVM",23,23,384,381,3,2400,2150,250,0.819458398290894,0.311594202898551,1.24665731650304,647,250,397,-4,1.6,86.21,8.6,0,0,0,0,0,0,0.0440883441726081,11.4672844274803,7.97367329138287
9.7,"eps_greedy_SVM","SVM",23,24,284,281,3,2500,2250,250,0.800161672151972,0.289855072463768,1.23735390369331,649,250,399,2,1.6,89.8,9,0,0,0,0,0,0,0.0199792575590095,4.91572442139596,3.38228277909865
9.7,"eps_greedy_SVM","SVM",23,25,184,184,0,2600,2347,253,0.805104220797968,0.268115942028986,1.25596072931276,672,253,419,23,1.7,93.39,9.3,0,0,0,0,0,0,0.00507181586859922,1.99203913089553,1.80679658542001
9.7,"eps_greedy_SVM","SVM",23,26,84,84,0,2700,2447,253,0.793030775448932,0.246376811594203,1.26526414212249,661,253,408,-11,1.6,96.98,9.7,0,0,0,0,0,0,8.22081545434933e-05,0.118458667038733,0.118458667038733
9.7,"eps_greedy_SVM","SVM",23,27,0,0,0,2784,2531,253,0.775142906634333,0.217391304347826,1.25596072931276,672,253,419,11,1.7,100,10,0,0,0,0,0,0,0,0,0
9.7,"eps_greedy_SVM","SVM",24,0,2684,2448,236,100,86,14,0.835474588176653,0.340425531914894,1.27476549988561,38,14,24,0,1.7,3.59,6.1,0,0,0,0,0,0,0.316951063565,329.056064919568,36.5525314066679
9.7,"eps_greedy_SVM","SVM",24,1,2584,2367,217,200,167,33,0.827402397299073,0.340425531914894,1.25655456417296,83,33,50,45,1.5,7.18,5.1,0,0,0,0,0,0,0.225779598947048,300.612766077936,24.6854756451264
9.7,"eps_greedy_SVM","SVM",24,2,2484,2294,190,300,240,60,0.699448258672647,0.184397163120567,1.201921757035,150,60,90,67,1.5,10.78,4,0,0,0,0,0,0,0.232268209078676,424.366150317629,26.4814034046856
9.7,"eps_greedy_SVM","SVM",24,3,2384,2202,182,400,332,68,0.846549067591148,0.333333333333333,1.27476549988561,166,68,98,16,1.4,14.37,4.9,0,0,0,0,0,0,0.219536152553454,203.241305014554,23.1701603697196
9.7,"eps_greedy_SVM","SVM",24,4,2284,2127,157,500,407,93,0.843705390524101,0.340425531914894,1.28387096774194,226,93,133,60,1.4,17.96,4.4,0,0,0,0,0,0,0.225275070834044,213.701039730453,22.992177000773
9.7,"eps_greedy_SVM","SVM",24,5,2184,2041,143,600,493,107,0.82321052273809,0.297872340425532,1.27476549988561,268,107,161,42,1.5,21.55,4.6,0,0,0,0,0,0,0.198350952756296,173.032362366923,23.8492357241057
9.7,"eps_greedy_SVM","SVM",24,6,2084,1959,125,700,575,125,0.816214623977526,0.290780141843972,1.25655456417296,302,125,177,34,1.4,25.14,4.6,0,0,0,0,0,0,0.194559818065817,165.57645002041,20.1674809415368
9.7,"eps_greedy_SVM","SVM",24,7,1984,1889,95,800,645,155,0.811529920920856,0.283687943262411,1.24744909631663,372,155,217,70,1.4,28.74,4.2,0,0,0,0,0,0,0.202254618190981,128.552722884844,21.1810422058172
9.7,"eps_greedy_SVM","SVM",24,8,1884,1817,67,900,717,183,0.815319602111803,0.312056737588652,1.24744909631663,433,183,250,61,1.4,32.33,3.9,0,0,0,0,0,0,0.191663672902311,116.167669409194,21.0304332197681
9.7,"eps_greedy_SVM","SVM",24,9,1784,1734,50,1000,800,200,0.812560895475045,0.319148936170213,1.24744909631663,484,200,284,51,1.4,35.92,4,0,0,0,0,0,0,0.166126804686218,109.955594725479,18.5317213380334
9.7,"eps_greedy_SVM","SVM",24,10,1684,1648,36,1100,886,214,0.810844492783177,0.326241134751773,1.26566003202928,507,214,293,23,1.4,39.51,4.1,0,0,0,0,0,0,0.176210571060808,134.182049141945,18.8036631905658
9.7,"eps_greedy_SVM","SVM",24,11,1584,1553,31,1200,981,219,0.804607663199876,0.276595744680851,1.24744909631663,535,219,316,28,1.4,43.1,4.5,0,0,0,0,0,0,0.149483640719171,90.4802123428141,16.3036805545486
9.7,"eps_greedy_SVM","SVM",24,12,1484,1458,26,1300,1076,224,0.803440735957221,0.283687943262411,1.24744909631663,554,224,330,19,1.5,46.7,4.8,0,0,0,0,0,0,0.136087200799736,90.4252378042139,15.076550788766
9.7,"eps_greedy_SVM","SVM",24,13,1384,1367,17,1400,1167,233,0.789386626787212,0.26241134751773,1.22923816060398,586,233,353,32,1.5,50.29,5,0,0,0,0,0,0,0.143797122473521,75.4072458769762,16.0697024203191
9.7,"eps_greedy_SVM","SVM",24,14,1284,1272,12,1500,1262,238,0.779790632859769,0.290780141843972,1.19281628917868,603,238,365,17,1.5,53.88,5.3,0,0,0,0,0,0,0.151157523344981,111.643763924871,15.9358373922252
9.7,"eps_greedy_SVM","SVM",24,15,1184,1172,12,1600,1362,238,0.766172705231914,0.24113475177305,1.19281628917868,607,238,369,4,1.6,57.47,5.7,0,0,0,0,0,0,0.117100673562483,65.9975804577889,12.4352447361671
9.7,"eps_greedy_SVM","SVM",24,16,1084,1072,12,1700,1462,238,0.797050959599396,0.312056737588652,1.19281628917868,608,238,370,1,1.6,61.06,6.1,0,0,0,0,0,0,0.0863510340746622,43.7224164266791,9.56715462658705
9.7,"eps_greedy_SVM","SVM",24,17,984,973,11,1800,1561,239,0.742596243174047,0.163120567375887,1.17460535346603,621,239,382,13,1.6,64.66,6.5,0,0,0,0,0,0,0.129635250964821,57.9890093883626,14.3525794594919
9.7,"eps_greedy_SVM","SVM",24,18,884,874,10,1900,1660,240,0.771027349149168,0.26241134751773,1.18371082132235,622,240,382,1,1.6,68.25,6.9,0,0,0,0,0,0,0.0824082264591829,35.3761581534607,9.97884668771145
9.7,"eps_greedy_SVM","SVM",24,19,784,775,9,2000,1759,241,0.782945868171216,0.283687943262411,1.18371082132235,636,241,395,14,1.6,71.84,7.3,0,0,0,0,0,0,0.0666354954889755,27.3211445332396,7.58262633220903
9.7,"eps_greedy_SVM","SVM",24,20,684,676,8,2100,1858,242,0.735390750685431,0.184397163120567,1.18371082132235,643,242,401,7,1.7,75.43,7.7,0,0,0,0,0,0,0.0432214127869282,14.8650117579423,5.7624239074871
9.7,"eps_greedy_SVM","SVM",24,21,584,577,7,2200,1957,243,0.756752316860401,0.219858156028369,1.19281628917868,634,243,391,-9,1.6,79.02,8.1,0,0,0,0,0,0,0.0306880208780177,10.411815980001,4.13510298809992
9.7,"eps_greedy_SVM","SVM",24,22,484,480,4,2300,2054,246,0.754344821335508,0.212765957446809,1.22013269274766,649,246,403,15,1.6,82.61,8.3,0,0,0,0,0,0,0.029024452982624,8.66705656168565,4.02014346411993
9.7,"eps_greedy_SVM","SVM",24,23,384,384,0,2400,2150,250,0.784158112976685,0.184397163120567,1.27476549988561,672,250,422,23,1.7,86.21,8.6,0,0,0,0,0,0,0.0424664368637256,12.9258297675243,9.39665223635542
9.7,"eps_greedy_SVM","SVM",24,24,284,284,0,2500,2250,250,0.781405071035282,0.269503546099291,1.26566003202928,664,250,414,-8,1.7,89.8,9,0,0,0,0,0,0,0.0077432157737087,2.45373132199252,2.05643221430165
9.7,"eps_greedy_SVM","SVM",24,25,184,184,0,2600,2350,250,0.776726032673962,0.26241134751773,1.28387096774194,654,250,404,-10,1.6,93.39,9.4,0,0,0,0,0,0,0.0094584736786486,2.00897701871705,1.60223555314206
9.7,"eps_greedy_SVM","SVM",24,26,84,84,0,2700,2450,250,0.786599596673693,0.212765957446809,1.27476549988561,671,250,421,17,1.7,96.98,9.8,0,0,0,0,0,0,1.76356999750487e-06,0.24657236037763,0.24657236037763
9.7,"eps_greedy_SVM","SVM",24,27,0,0,0,2784,2534,250,0.759363741417988,0.219858156028369,1.27476549988561,675,250,425,4,1.7,100,10.1,0,0,0,0,0,0,0,0,0
9.7,"eps_greedy_SVM","SVM",25,0,2684,2430,254,100,88,12,0.813943217665624,0.336,1.20170322580645,29,12,17,0,1.4,3.59,7.3,0,0,0,0,0,0,0.32114626399617,316.509080911727,35.3364925230176
9.7,"eps_greedy_SVM","SVM",25,1,2584,2369,215,200,149,51,0.810182965299692,0.224,1.25305806451613,110,51,59,81,1.2,7.18,2.9,0,0,0,0,0,0,0.371944189240449,453.190663566255,45.8658905367454
9.7,"eps_greedy_SVM","SVM",25,2,2484,2287,197,300,231,69,0.653577287066246,0.264,1.15034838709677,165,69,96,55,1.4,10.78,3.3,0,0,0,0,0,0,0.259517915603166,497.497934048285,28.2916309209648
9.7,"eps_greedy_SVM","SVM",25,3,2384,2208,176,400,310,90,0.810359621451109,0.288,1.23251612903226,216,90,126,51,1.4,14.37,3.4,0,0,0,0,0,0,0.234562423295925,395.395215095232,24.6390800070023
9.7,"eps_greedy_SVM","SVM",25,4,2284,2135,149,500,383,117,0.735974763406935,0.12,1.23251612903226,285,117,168,69,1.4,17.96,3.3,0,0,0,0,0,0,0.289256600437107,361.202154621306,48.9956478850013
9.7,"eps_greedy_SVM","SVM",25,5,2184,2037,147,600,481,119,0.825041009463731,0.248,1.26332903225806,287,119,168,2,1.4,21.55,4,0,0,0,0,0,0,0.216707333009514,240.165576649583,24.7886468272041
9.7,"eps_greedy_SVM","SVM",25,6,2084,1969,115,700,549,151,0.833085173501586,0.288,1.25305806451613,359,151,208,72,1.4,25.14,3.6,0,0,0,0,0,0,0.224368225940953,177.108376863998,23.4121985774354
9.7,"eps_greedy_SVM","SVM",25,7,1984,1898,86,800,620,180,0.834321766561523,0.304,1.25305806451613,417,180,237,58,1.3,28.74,3.4,0,0,0,0,0,0,0.216855211354139,148.221451661213,22.8269717626532
9.7,"eps_greedy_SVM","SVM",25,8,1884,1819,65,900,699,201,0.827829652996855,0.296,1.25305806451613,474,201,273,57,1.4,32.33,3.5,0,0,0,0,0,0,0.205934777867449,116.251185714616,22.5260806858095
9.7,"eps_greedy_SVM","SVM",25,9,1784,1730,54,1000,788,212,0.811993690851741,0.304,1.25305806451613,517,212,305,43,1.4,35.92,3.7,0,0,0,0,0,0,0.185693576326962,92.0063224176316,20.1540141781501
9.7,"eps_greedy_SVM","SVM",25,10,1684,1636,48,1100,882,218,0.818454258675085,0.304,1.25305806451613,535,218,317,18,1.5,39.51,4,0,0,0,0,0,0,0.157742358180742,65.7565863262553,17.9286317811872
9.7,"eps_greedy_SVM","SVM",25,11,1584,1545,39,1200,973,227,0.813974763406939,0.304,1.24278709677419,579,227,352,44,1.6,43.1,4.3,0,0,0,0,0,0,0.152651686198937,55.4134811347966,17.2056176823411
9.7,"eps_greedy_SVM","SVM",25,12,1484,1455,29,1300,1063,237,0.811735015772872,0.28,1.24278709677419,595,237,358,16,1.5,46.7,4.5,0,0,0,0,0,0,0.117414650632305,48.7246317160465,14.0822725568662
9.7,"eps_greedy_SVM","SVM",25,13,1384,1358,26,1400,1160,240,0.800561514195587,0.288,1.22224516129032,620,240,380,25,1.6,50.29,4.8,0,0,0,0,0,0,0.0941323720150169,42.736701106314,11.727105384788
9.7,"eps_greedy_SVM","SVM",25,14,1284,1260,24,1500,1258,242,0.810757097791795,0.28,1.22224516129032,612,242,370,-8,1.5,53.88,5.2,0,0,0,0,0,0,0.120665750238214,45.6411559628166,14.5139826143057
9.7,"eps_greedy_SVM","SVM",25,15,1184,1161,23,1600,1357,243,0.797671924290217,0.256,1.24278709677419,640,243,397,28,1.6,57.47,5.6,0,0,0,0,0,0,0.123121817878066,47.7030888476825,14.2923308303079
9.7,"eps_greedy_SVM","SVM",25,16,1084,1064,20,1700,1454,246,0.788555205047314,0.208,1.24278709677419,658,246,412,18,1.7,61.06,5.9,0,0,0,0,0,0,0.0816756614226862,25.9009746233177,12.0127862668226
9.7,"eps_greedy_SVM","SVM",25,17,984,964,20,1800,1554,246,0.791457413249207,0.24,1.24278709677419,644,246,398,-14,1.6,64.66,6.3,0,0,0,0,0,0,0.0510810229777698,12.8342534671166,7.12720367206007
9.7,"eps_greedy_SVM","SVM",25,18,884,866,18,1900,1652,248,0.790908517350153,0.264,1.24278709677419,665,248,417,21,1.7,68.25,6.7,0,0,0,0,0,0,0.0396809283423295,10.9453510870387,6.35856489901066
9.7,"eps_greedy_SVM","SVM",25,19,784,768,16,2000,1750,250,0.793772870662458,0.216,1.23251612903226,652,250,402,-13,1.6,71.84,7,0,0,0,0,0,0,0.0298290007253666,11.4065146832726,4.4844216264745
9.7,"eps_greedy_SVM","SVM",25,20,684,670,14,2100,1848,252,0.774479495268144,0.192,1.21197419354839,672,252,420,20,1.7,75.43,7.3,0,0,0,0,0,0,0.031741210818348,9.45160852344501,7.06675404227674
9.7,"eps_greedy_SVM","SVM",25,21,584,571,13,2200,1947,253,0.790700315457412,0.224,1.21197419354839,670,253,417,-2,1.6,79.02,7.7,0,0,0,0,0,0,0.00950407112748238,3.00166415778221,2.09027793764228
9.7,"eps_greedy_SVM","SVM",25,22,484,472,12,2300,2046,254,0.788750788643535,0.232,1.22224516129032,690,254,436,20,1.7,82.61,8.1,0,0,0,0,0,0,0.0166598622848685,4.4046332631318,2.47813213997504
9.7,"eps_greedy_SVM","SVM",25,23,384,377,7,2400,2141,259,0.786870662460565,0.208,1.28387096774194,702,259,443,12,1.7,86.21,8.3,0,0,0,0,0,0,0.00526739917958342,6.94055891970805,6.5873011938565
9.7,"eps_greedy_SVM","SVM",25,24,284,284,0,2500,2234,266,0.779305993690852,0.168,1.28387096774194,750,266,484,48,1.8,89.8,8.4,0,0,0,0,0,0,0.0207106156622701,36.7116409360105,36.1996085070076
9.7,"eps_greedy_SVM","SVM",25,25,184,184,0,2600,2334,266,0.798082018927447,0.2,1.28387096774194,733,266,467,-17,1.8,93.39,8.8,0,0,0,0,0,0,0.000272370889930171,0.473093613267801,0.468585801038884
9.7,"eps_greedy_SVM","SVM",25,26,84,84,0,2700,2434,266,0.800750788643533,0.224,1.28387096774194,767,266,501,34,1.9,96.98,9.2,0,0,0,0,0,0,1.0000000994736e-07,0.0027391812672811,0.0027391812672811
9.7,"eps_greedy_SVM","SVM",25,27,0,0,0,2784,2518,266,0.751520504731866,0.184,1.2736,738,266,472,-29,1.8,100,9.5,0,0,0,0,0,0,0,0,0
9.7,"eps_greedy_SVM","SVM",26,0,2684,2422,262,100,90,10,0.831068691212756,0.361344537815126,1.24071564109515,28,10,18,0,1.8,3.59,9,0,0,0,0,0,0,0.226464990463438,241.189537199361,24.6187433604977
9.7,"eps_greedy_SVM","SVM",26,1,2584,2359,225,200,153,47,0.784395076712008,0.100840336134454,1.26229330441854,108,47,61,80,1.3,7.18,3.3,0,0,0,0,0,0,0.301124733218281,476.074642514822,37.5963595375363
9.7,"eps_greedy_SVM","SVM",26,2,2484,2275,209,300,237,63,0.790885585003236,0.327731092436975,1.17598265112497,148,63,85,40,1.3,10.78,3.8,0,0,0,0,0,0,0.2139720367496,485.259928125248,21.4823500477978
9.7,"eps_greedy_SVM","SVM",26,3,2384,2206,178,400,306,94,0.762793029299637,0.26890756302521,1.16519381946327,229,94,135,81,1.4,14.37,3.3,0,0,0,0,0,0,0.261692961780862,321.133670129645,27.2953392595532
9.7,"eps_greedy_SVM","SVM",26,4,2284,2118,166,500,394,106,0.788484624619083,0.319327731092437,1.19756031444836,262,106,156,33,1.5,17.96,3.7,0,0,0,0,0,0,0.237170165780875,162.178968475231,25.4871951624872
9.7,"eps_greedy_SVM","SVM",26,5,2184,2038,146,600,474,126,0.809690909330769,0.327731092436975,1.25150447275684,306,126,180,44,1.4,21.55,3.8,0,0,0,0,0,0,0.21788419490578,237.500721696528,22.8437264419768
9.7,"eps_greedy_SVM","SVM",26,6,2084,1971,113,700,541,159,0.79828634750604,0.252100840336134,1.24071564109515,381,159,222,75,1.4,25.14,3.4,0,0,0,0,0,0,0.235269182391954,190.871472720366,34.2912403659289
9.7,"eps_greedy_SVM","SVM",26,7,1984,1891,93,800,621,179,0.793820825033316,0.319327731092437,1.20834914611006,440,179,261,59,1.5,28.74,3.5,0,0,0,0,0,0,0.216084527354471,206.466346694271,22.8523430506318
9.7,"eps_greedy_SVM","SVM",26,8,1884,1814,70,900,698,202,0.799539596058208,0.327731092436975,1.20834914611006,489,202,287,49,1.4,32.33,3.5,0,0,0,0,0,0,0.18156198085571,134.982279281476,20.3930212213042
9.7,"eps_greedy_SVM","SVM",26,9,1784,1727,57,1000,785,215,0.786446446710556,0.285714285714286,1.21913797777175,527,215,312,38,1.5,35.92,3.7,0,0,0,0,0,0,0.172520465502134,148.096809894455,18.8206254628995
9.7,"eps_greedy_SVM","SVM",26,10,1684,1637,47,1100,875,225,0.776018099547514,0.302521008403361,1.17598265112497,558,225,333,31,1.5,39.51,3.9,0,0,0,0,0,0,0.175748205909283,163.872227655122,18.825509196594
9.7,"eps_greedy_SVM","SVM",26,11,1584,1538,46,1200,974,226,0.764303523607248,0.235294117647059,1.19756031444836,570,226,344,12,1.5,43.1,4.3,0,0,0,0,0,0,0.132646935571062,81.2300566845659,15.9907041765093
9.7,"eps_greedy_SVM","SVM",26,12,1484,1441,43,1300,1071,229,0.772983918842264,0.252100840336134,1.20834914611006,576,229,347,6,1.5,46.7,4.7,0,0,0,0,0,0,0.125392543091083,82.7174767502944,13.6463229554898
9.7,"eps_greedy_SVM","SVM",26,13,1384,1344,40,1400,1168,232,0.760148015250057,0.218487394957983,1.17598265112497,584,232,352,8,1.5,50.29,5,0,0,0,0,0,0,0.132774198557331,87.8583908188883,16.4803274015768
9.7,"eps_greedy_SVM","SVM",26,14,1284,1245,39,1500,1267,233,0.768835006530086,0.294117647058824,1.18677148278666,592,233,359,8,1.5,53.88,5.4,0,0,0,0,0,0,0.102006577491684,60.9104683550454,11.4757685089544
9.7,"eps_greedy_SVM","SVM",26,15,1184,1153,31,1600,1359,241,0.758624328852424,0.19327731092437,1.18677148278666,622,241,381,30,1.6,57.47,5.6,0,0,0,0,0,0,0.11398664994961,57.9904122997895,14.0001192640668
9.7,"eps_greedy_SVM","SVM",26,16,1084,1065,19,1700,1447,253,0.770213579937472,0.243697478991597,1.18677148278666,669,253,416,47,1.6,61.06,5.7,0,0,0,0,0,0,0.0831308906226876,35.8796221798814,10.6718701331956
9.7,"eps_greedy_SVM","SVM",26,17,984,974,10,1800,1538,262,0.784421460892051,0.226890756302521,1.18677148278666,689,262,427,20,1.6,64.66,5.9,0,0,0,0,0,0,0.0600190526726107,23.2213969255234,7.55675323089054
9.7,"eps_greedy_SVM","SVM",26,18,884,876,8,1900,1636,264,0.800298141234517,0.319327731092437,1.22992680943345,714,264,450,25,1.7,68.25,6.2,0,0,0,0,0,0,0.0192137762878864,6.37486449632422,2.99547839972263
9.7,"eps_greedy_SVM","SVM",26,19,784,778,6,2000,1734,266,0.80151840956163,0.302521008403361,1.26229330441854,721,266,455,7,1.7,71.84,6.5,0,0,0,0,0,0,0.0323879964065265,11.6473278736587,4.68094941693409
9.7,"eps_greedy_SVM","SVM",26,20,684,680,4,2100,1832,268,0.804829624157358,0.277310924369748,1.26229330441854,730,268,462,9,1.7,75.43,6.8,0,0,0,0,0,0,0.0710444905761499,28.7191267951285,8.54187358228111
9.7,"eps_greedy_SVM","SVM",26,21,584,583,1,2200,1929,271,0.774619738005097,0.184873949579832,1.26229330441854,732,271,461,2,1.7,79.02,7.1,0,0,0,0,0,0,0.0122704257028354,3.80822727673745,2.3689010181834
9.7,"eps_greedy_SVM","SVM",26,22,484,484,0,2300,2028,272,0.805278155218136,0.260504201680672,1.26229330441854,753,272,481,21,1.8,82.61,7.5,0,0,0,0,0,0,0.0280851558510684,8.30090414585032,3.86078782957255
9.7,"eps_greedy_SVM","SVM",26,23,384,384,0,2400,2128,272,0.791848607574902,0.218487394957983,1.26229330441854,751,272,479,-2,1.8,86.21,7.8,0,0,0,0,0,0,0.00479782676988489,1.24135521726623,0.872631500843049
9.7,"eps_greedy_SVM","SVM",26,24,284,284,0,2500,2228,272,0.793992322203611,0.210084033613445,1.26229330441854,740,272,468,-11,1.7,89.8,8.2,0,0,0,0,0,0,0.000485305740254954,0.196835154025615,0.1761171587155
9.7,"eps_greedy_SVM","SVM",26,25,184,184,0,2600,2328,272,0.795377491656007,0.19327731092437,1.26229330441854,743,272,471,3,1.7,93.39,8.6,0,0,0,0,0,0,0.00282006658011772,0.85225167805034,0.711292555868968
9.7,"eps_greedy_SVM","SVM",26,26,84,84,0,2700,2428,272,0.829591177130197,0.336134453781513,1.26229330441854,735,272,463,-8,1.7,96.98,8.9,0,0,0,0,0,0,1.51994864038061e-07,0.00105592202235032,0.00105592202235032
9.7,"eps_greedy_SVM","SVM",26,27,0,0,0,2784,2512,272,0.823509623629676,0.302521008403361,1.26229330441854,732,272,460,-3,1.7,100,9.2,0,0,0,0,0,0,0,0,0
9.7,"eps_greedy_SVM","SVM",27,0,2684,2437,247,100,90,10,0.811328583452874,0.328358208955224,1.2263842079923,28,10,18,0,1.8,3.59,9,0,0,0,0,0,0,0.162386059357641,310.308061663603,17.4113007074869
9.7,"eps_greedy_SVM","SVM",27,1,2584,2377,207,200,150,50,0.773807689115978,0.238805970149254,1.21680308136736,110,50,60,82,1.2,7.18,3,0,0,0,0,0,0,0.30475031290135,424.519679057486,33.8857340699386
9.7,"eps_greedy_SVM","SVM",27,2,2484,2306,178,300,221,79,0.728290635780596,0.186567164179104,1.1784785748676,176,79,97,66,1.2,10.78,2.8,0,0,0,0,0,0,0.316759379601448,416.281572894698,46.2287749942866
9.7,"eps_greedy_SVM","SVM",27,3,2384,2222,162,400,305,95,0.779302455158682,0.261194029850746,1.19764082811748,213,95,118,37,1.2,14.37,3.2,0,0,0,0,0,0,0.249873675640518,318.741902418931,26.2506798397636
9.7,"eps_greedy_SVM","SVM",27,4,2284,2148,136,500,379,121,0.77215985205032,0.246268656716418,1.15931632161772,271,121,150,58,1.2,17.96,3.1,0,0,0,0,0,0,0.22575886440217,249.424687619223,23.2747304900496
9.7,"eps_greedy_SVM","SVM",27,5,2184,2075,109,600,452,148,0.774916126278859,0.253731343283582,1.14973519499278,327,148,179,56,1.2,21.55,3.1,0,0,0,0,0,0,0.220496040319298,185.54610431261,22.8389323910538
9.7,"eps_greedy_SVM","SVM",27,6,2084,1991,93,700,536,164,0.772711106896027,0.276119402985075,1.14973519499278,363,164,199,36,1.2,25.14,3.3,0,0,0,0,0,0,0.214572513283221,194.341816471665,22.6285361009037
9.7,"eps_greedy_SVM","SVM",27,7,1984,1906,78,800,621,179,0.779711450689369,0.283582089552239,1.19764082811748,406,179,227,43,1.3,28.74,3.5,0,0,0,0,0,0,0.156450735911335,99.3317372811053,18.2607129811856
9.7,"eps_greedy_SVM","SVM",27,8,1884,1821,63,900,706,194,0.791198890377345,0.276119402985075,1.21680308136736,446,194,252,40,1.3,32.33,3.6,0,0,0,0,0,0,0.160046092382218,119.970447084118,18.1926267928026
9.7,"eps_greedy_SVM","SVM",27,9,1784,1733,51,1000,794,206,0.790131945514683,0.238805970149254,1.25512758786712,482,206,276,36,1.3,35.92,3.9,0,0,0,0,0,0,0.154812770900119,105.94174135951,17.395219558885
9.7,"eps_greedy_SVM","SVM",27,10,1684,1640,44,1100,887,213,0.809402155228624,0.238805970149254,1.274289841117,504,213,291,22,1.4,39.51,4.2,0,0,0,0,0,0,0.109930918522542,56.2654239328558,13.7908673310767
9.7,"eps_greedy_SVM","SVM",27,11,1584,1547,37,1200,980,220,0.825554514955016,0.26865671641791,1.274289841117,524,220,304,20,1.4,43.1,4.5,0,0,0,0,0,0,0.107029287821047,61.1465733159294,14.0336019421384
9.7,"eps_greedy_SVM","SVM",27,12,1484,1459,25,1300,1068,232,0.817202707668968,0.17910447761194,1.26470871449206,551,232,319,27,1.4,46.7,4.6,0,0,0,0,0,0,0.115498920020319,41.2357053999388,16.2667826128961
9.7,"eps_greedy_SVM","SVM",27,13,1384,1366,18,1400,1161,239,0.817013028582273,0.208955223880597,1.274289841117,573,239,334,22,1.4,50.29,4.9,0,0,0,0,0,0,0.103883482053037,48.0839251591492,12.3586783089596
9.7,"eps_greedy_SVM","SVM",27,14,1284,1267,17,1500,1260,240,0.821126693774976,0.216417910447761,1.26470871449206,577,240,337,4,1.4,53.88,5.2,0,0,0,0,0,0,0.051702979261265,20.5579581689896,6.80475846659626
9.7,"eps_greedy_SVM","SVM",27,15,1184,1168,16,1600,1359,241,0.812193994285923,0.208955223880597,1.26470871449206,585,241,344,8,1.4,57.47,5.6,0,0,0,0,0,0,0.0314967767727043,13.411181223698,4.24572218671549
9.7,"eps_greedy_SVM","SVM",27,16,1084,1069,15,1700,1458,242,0.809295460742366,0.223880597014925,1.26470871449206,588,242,346,3,1.4,61.06,6,0,0,0,0,0,0,0.10404321105695,42.2733290738204,12.3317533838238
9.7,"eps_greedy_SVM","SVM",27,17,984,970,14,1800,1557,243,0.789805934584434,0.17910447761194,1.25512758786712,596,243,353,8,1.5,64.66,6.4,0,0,0,0,0,0,0.0950883792530547,28.3891052477705,12.3919353332903
9.7,"eps_greedy_SVM","SVM",27,18,884,871,13,1900,1656,244,0.80122817208636,0.186567164179104,1.26470871449206,604,244,360,8,1.5,68.25,6.8,0,0,0,0,0,0,0.045491811319907,14.6259334078749,7.15634973154469
9.7,"eps_greedy_SVM","SVM",27,19,784,771,13,2000,1756,244,0.807659478619619,0.194029850746269,1.26470871449206,603,244,359,-1,1.5,71.84,7.2,0,0,0,0,0,0,0.0149044818980682,4.23300631554477,2.41095429891709
9.7,"eps_greedy_SVM","SVM",27,20,684,671,13,2100,1856,244,0.79281709008572,0.171641791044776,1.26470871449206,601,244,357,-2,1.5,75.43,7.6,0,0,0,0,0,0,0.0142918838619103,4.69116130470878,2.1926124541429
9.7,"eps_greedy_SVM","SVM",27,21,584,571,13,2200,1956,244,0.788744917193232,0.186567164179104,1.26470871449206,598,244,354,-3,1.5,79.02,8,0,0,0,0,0,0,0.0156418275233927,5.02695630795978,2.20540124922831
9.7,"eps_greedy_SVM","SVM",27,22,484,473,11,2300,2054,246,0.800392398610608,0.216417910447761,1.24554646124218,613,246,367,15,1.5,82.61,8.3,0,0,0,0,0,0,0.029606845799814,9.44902139729173,7.25589375473428
9.7,"eps_greedy_SVM","SVM",27,23,384,374,10,2400,2153,247,0.788033620618126,0.194029850746269,1.24554646124218,613,247,366,0,1.5,86.21,8.7,0,0,0,0,0,0,0.002223800517297,0.93682803875914,0.762365805222713
9.7,"eps_greedy_SVM","SVM",27,24,284,276,8,2500,2251,249,0.80314274536769,0.208955223880597,1.24554646124218,631,249,382,18,1.5,89.8,9,0,0,0,0,0,0,0.00207181261039107,0.601799648306608,0.461864066104017
9.7,"eps_greedy_SVM","SVM",27,25,184,179,5,2600,2348,252,0.791418206821342,0.164179104477612,1.25397185343998,651,252,399,20,1.6,93.39,9.3,0,0,0,0,0,0,0.00121213637181321,0.354241369082413,0.309028803943988
9.7,"eps_greedy_SVM","SVM",27,26,84,84,0,2700,2443,257,0.777595343378427,0.164179104477612,1.274289841117,679,257,422,28,1.6,96.98,9.5,0,0,0,0,0,0,6.48549579484701e-06,1.54965694454872,1.54965694454872
9.7,"eps_greedy_SVM","SVM",27,27,0,0,0,2784,2527,257,0.800718409540858,0.17910447761194,1.27311646188945,659,257,402,-20,1.6,100,9.8,0,0,0,0,0,0,0,0,0
9.7,"eps_greedy_SVM","SVM",28,0,2684,2438,246,100,90,10,0.807831360772542,0.274074074074074,1.26485065710872,25,10,15,0,1.5,3.59,9,0,0,0,0,0,0,0.140317912229411,268.599981941457,14.8527207654497
9.7,"eps_greedy_SVM","SVM",28,1,2584,2360,224,200,168,32,0.81762939409998,0.281481481481481,1.28387096774194,77,32,45,52,1.4,7.18,5.2,0,0,0,0,0,0,0.196934088850966,306.584090833972,23.0099447025239
9.7,"eps_greedy_SVM","SVM",28,2,2484,2280,204,300,248,52,0.82732732732733,0.340740740740741,1.27436081242533,124,52,72,47,1.4,10.78,4.8,0,0,0,0,0,0,0.2088187985612,205.896436966052,22.0188586942585
9.7,"eps_greedy_SVM","SVM",28,3,2384,2213,171,400,315,85,0.838762291703476,0.348148148148148,1.27436081242533,197,85,112,73,1.3,14.37,3.7,0,0,0,0,0,0,0.245422689660471,163.558355959192,25.1689309811799
9.7,"eps_greedy_SVM","SVM",28,4,2284,2140,144,500,388,112,0.83810869693223,0.348148148148148,1.27436081242533,261,112,149,64,1.3,17.96,3.5,0,0,0,0,0,0,0.244132173881026,222.742352630104,24.6923923175458
9.7,"eps_greedy_SVM","SVM",28,5,2184,2068,116,600,460,140,0.835394217747162,0.311111111111111,1.26485065710872,318,140,178,57,1.3,21.55,3.3,0,0,0,0,0,0,0.224681461005917,139.358494477406,23.9125965971397
9.7,"eps_greedy_SVM","SVM",28,6,2084,1988,96,700,540,160,0.835482541364902,0.318518518518519,1.27436081242533,364,160,204,46,1.3,25.14,3.4,0,0,0,0,0,0,0.209630698230281,114.719262583867,22.3816903403886
9.7,"eps_greedy_SVM","SVM",28,7,1984,1903,81,800,625,175,0.832927044691756,0.311111111111111,1.27436081242533,408,175,233,44,1.3,28.74,3.6,0,0,0,0,0,0,0.156247441986734,56.9278818443801,18.9683349828536
9.7,"eps_greedy_SVM","SVM",28,8,1884,1825,59,900,703,197,0.848731084025198,0.348148148148148,1.26485065710872,474,197,277,66,1.4,32.33,3.6,0,0,0,0,0,0,0.176919649741325,91.1777344947705,19.7359630721762
9.7,"eps_greedy_SVM","SVM",28,9,1784,1738,46,1000,790,210,0.839445327680627,0.303703703703704,1.27436081242533,505,210,295,31,1.4,35.92,3.8,0,0,0,0,0,0,0.17696628932473,89.3556779778929,19.4163391984504
9.7,"eps_greedy_SVM","SVM",28,10,1684,1646,38,1100,882,218,0.83296826238003,0.274074074074074,1.26485065710872,521,218,303,16,1.4,39.51,4,0,0,0,0,0,0,0.161435328143738,80.8297412480576,18.0830702411883
9.7,"eps_greedy_SVM","SVM",28,11,1584,1557,27,1200,971,229,0.832503091326624,0.266666666666667,1.25534050179211,568,229,339,47,1.5,43.1,4.2,0,0,0,0,0,0,0.157356290400223,97.4808257500465,17.1857270730896
9.7,"eps_greedy_SVM","SVM",28,12,1484,1462,22,1300,1066,234,0.825708061002186,0.251851851851852,1.2363201911589,570,234,336,2,1.4,46.7,4.6,0,0,0,0,0,0,0.0989866454307206,46.2735230545897,11.6210228481775
9.7,"eps_greedy_SVM","SVM",28,13,1384,1364,20,1400,1164,236,0.822275216392869,0.266666666666667,1.2363201911589,591,236,355,21,1.5,50.29,4.9,0,0,0,0,0,0,0.0946096114100291,40.4263198103663,11.3352114925816
9.7,"eps_greedy_SVM","SVM",28,14,1284,1267,17,1500,1261,239,0.810893246187368,0.214814814814815,1.2363201911589,617,239,378,26,1.6,53.88,5.3,0,0,0,0,0,0,0.103477495494595,47.349362356872,11.6844322589085
9.7,"eps_greedy_SVM","SVM",28,15,1184,1168,16,1600,1360,240,0.806818583289177,0.259259259259259,1.22681003584229,612,240,372,-5,1.6,57.47,5.7,0,0,0,0,0,0,0.0925100896405532,33.1379431606743,11.8446521816812
9.7,"eps_greedy_SVM","SVM",28,16,1084,1069,15,1700,1459,241,0.783948654536894,0.207407407407407,1.22681003584229,633,241,392,21,1.6,61.06,6.1,0,0,0,0,0,0,0.102948799710778,48.9101270115559,11.8723590055342
9.7,"eps_greedy_SVM","SVM",28,17,984,969,15,1800,1559,241,0.815804039333457,0.266666666666667,1.22681003584229,613,241,372,-20,1.5,64.66,6.5,0,0,0,0,0,0,0.0180971719880994,5.10127443397568,3.01764383558928
9.7,"eps_greedy_SVM","SVM",28,18,884,870,14,1900,1658,242,0.814108225872938,0.259259259259259,1.21729988052569,627,242,385,14,1.6,68.25,6.9,0,0,0,0,0,0,0.0116183480102057,3.25443421502634,2.01011786513906
9.7,"eps_greedy_SVM","SVM",28,19,784,771,13,2000,1757,243,0.801265971854213,0.22962962962963,1.21729988052569,629,243,386,2,1.6,71.84,7.2,0,0,0,0,0,0,0.00585809572988857,1.74245477202769,1.07717814494181
9.7,"eps_greedy_SVM","SVM",28,20,684,674,10,2100,1854,246,0.800842018489083,0.266666666666667,1.21729988052569,638,246,392,9,1.6,75.43,7.5,0,0,0,0,0,0,0.0130138695635456,4.06921758819156,2.40626538392571
9.7,"eps_greedy_SVM","SVM",28,21,584,574,10,2200,1954,246,0.780527586409945,0.2,1.21729988052569,632,246,386,-6,1.6,79.02,7.9,0,0,0,0,0,0,0.00868209407745528,2.58628290293303,1.49534635662542
9.7,"eps_greedy_SVM","SVM",28,22,484,476,8,2300,2052,248,0.790084201848916,0.222222222222222,1.19827956989247,644,248,396,12,1.6,82.61,8.3,0,0,0,0,0,0,0.0412631472210052,11.9296397392445,8.04673825201371
9.7,"eps_greedy_SVM","SVM",28,23,384,376,8,2400,2152,248,0.809856915739276,0.288888888888889,1.19827956989247,646,248,398,2,1.6,86.21,8.7,0,0,0,0,0,0,0.00391346472616836,1.21186803964017,0.893157550764282
9.7,"eps_greedy_SVM","SVM",28,24,284,276,8,2500,2252,248,0.801837131248905,0.303703703703704,1.19827956989247,654,248,406,8,1.6,89.8,9.1,0,0,0,0,0,0,0.00412282885589636,1.05988017940032,0.741946152749459
9.7,"eps_greedy_SVM","SVM",28,25,184,178,6,2600,2350,250,0.763928634516875,0.155555555555556,1.19827956989247,651,250,401,-3,1.6,93.39,9.4,0,0,0,0,0,0,0.0013448904075796,0.426956294613725,0.36909091144288
9.7,"eps_greedy_SVM","SVM",28,26,84,83,1,2700,2445,255,0.828404875463695,0.266666666666667,1.28387096774194,694,255,439,43,1.7,96.98,9.6,0,0,0,0,0,0,0.001411485563347,1.36798568820879,1.36798568820879
9.7,"eps_greedy_SVM","SVM",28,27,0,0,0,2784,2528,256,0.826714950244357,0.274074074074074,1.28387096774194,702,256,446,8,1.7,100,9.9,0,0,0,0,0,0,0,0,0
9.7,"eps_greedy_SVM","SVM",29,0,2684,2427,257,100,90,10,0.817000940542466,0.314516129032258,1.27351716961498,32,10,22,0,2.2,3.59,9,0,0,0,0,0,0,0.142093667269999,272.12437717291,14.9902647398781
9.7,"eps_greedy_SVM","SVM",29,1,2584,2345,239,200,172,28,0.813289610818783,0.338709677419355,1.23210197710718,75,28,47,43,1.7,7.18,6.1,0,0,0,0,0,0,0.182104917385831,303.659482458203,19.830455150637
9.7,"eps_greedy_SVM","SVM",29,2,2484,2270,214,300,247,53,0.834928442512524,0.258064516129032,1.27351716961498,146,53,93,71,1.8,10.78,4.7,0,0,0,0,0,0,0.204394379444041,311.954344144268,22.3096082361965
9.7,"eps_greedy_SVM","SVM",29,3,2384,2178,206,400,339,61,0.847384275146802,0.338709677419355,1.27351716961498,173,61,112,27,1.8,14.37,5.6,0,0,0,0,0,0,0.173733127807494,211.85218023283,20.0900255599209
9.7,"eps_greedy_SVM","SVM",29,4,2284,2098,186,500,419,81,0.783865883728623,0.233870967741935,1.23210197710718,214,81,133,41,1.6,17.96,5.2,0,0,0,0,0,0,0.175220480378421,274.272900597908,21.4557461816108
9.7,"eps_greedy_SVM","SVM",29,5,2184,2001,183,600,516,84,0.840215816365439,0.330645161290323,1.28387096774194,222,84,138,8,1.6,21.55,6.1,0,0,0,0,0,0,0.175354719759659,163.328402734337,17.9318283855948
9.7,"eps_greedy_SVM","SVM",29,6,2084,1939,145,700,578,122,0.836720557207862,0.298387096774194,1.28387096774194,305,122,183,83,1.5,25.14,4.7,0,0,0,0,0,0,0.201502205371293,124.683737438895,20.8882132535817
9.7,"eps_greedy_SVM","SVM",29,7,1984,1875,109,800,642,158,0.843005668674856,0.379032258064516,1.28387096774194,394,158,236,89,1.5,28.74,4.1,0,0,0,0,0,0,0.215828077696888,112.50092038568,22.4889152748183
9.7,"eps_greedy_SVM","SVM",29,8,1884,1795,89,900,722,178,0.831668318970997,0.32258064516129,1.27351716961498,447,178,269,53,1.5,32.33,4.1,0,0,0,0,0,0,0.198149634722971,95.9584078476815,21.0313120683737
9.7,"eps_greedy_SVM","SVM",29,9,1784,1707,77,1000,810,190,0.830314700424517,0.314516129032258,1.27351716961498,472,190,282,25,1.5,35.92,4.3,0,0,0,0,0,0,0.157053392323672,53.2903155216776,17.6045530464169
9.7,"eps_greedy_SVM","SVM",29,10,1684,1624,60,1100,893,207,0.820515264749999,0.298387096774194,1.25280957336108,527,207,320,55,1.5,39.51,4.3,0,0,0,0,0,0,0.179028979598638,106.545123561652,18.8079356504948
9.7,"eps_greedy_SVM","SVM",29,11,1584,1529,55,1200,988,212,0.786210884872523,0.209677419354839,1.23210197710718,547,212,335,20,1.6,43.1,4.7,0,0,0,0,0,0,0.166823543804119,100.136196258255,17.6410714251088
9.7,"eps_greedy_SVM","SVM",29,12,1484,1432,52,1300,1085,215,0.821315996847917,0.362903225806452,1.23210197710718,559,215,344,12,1.6,46.7,5,0,0,0,0,0,0,0.154628022247759,93.3470487184764,16.4032763802349
9.7,"eps_greedy_SVM","SVM",29,13,1384,1335,49,1400,1182,218,0.776576679630902,0.258064516129032,1.23210197710718,588,218,370,29,1.7,50.29,5.4,0,0,0,0,0,0,0.146050829935636,78.9415824968153,15.5370359161158
9.7,"eps_greedy_SVM","SVM",29,14,1284,1235,49,1500,1282,218,0.775852207732785,0.17741935483871,1.23210197710718,586,218,368,-2,1.7,53.88,5.9,0,0,0,0,0,0,0.127846172262713,60.2725987554507,13.6349859031854
9.7,"eps_greedy_SVM","SVM",29,15,1184,1135,49,1600,1382,218,0.760193446706834,0.169354838709677,1.23210197710718,597,218,379,11,1.7,57.47,6.3,0,0,0,0,0,0,0.112572604377289,43.5787439891809,12.1507122616808
9.7,"eps_greedy_SVM","SVM",29,16,1084,1037,47,1700,1480,220,0.794319886118107,0.298387096774194,1.23210197710718,611,220,391,14,1.8,61.06,6.7,0,0,0,0,0,0,0.0868448511717541,25.7744220253475,10.4198294523057
9.7,"eps_greedy_SVM","SVM",29,17,984,943,41,1800,1574,226,0.748487506037269,0.137096774193548,1.23210197710718,607,226,381,-4,1.7,64.66,7,0,0,0,0,0,0,0.0940978246041182,25.8601759694935,11.7023425082038
9.7,"eps_greedy_SVM","SVM",29,18,884,854,30,1900,1663,237,0.759602430158366,0.129032258064516,1.23210197710718,631,237,394,24,1.7,68.25,7,0,0,0,0,0,0,0.0607103503058001,12.9463074474896,9.33874664973723
9.7,"eps_greedy_SVM","SVM",29,19,784,762,22,2000,1755,245,0.832716896718267,0.32258064516129,1.23210197710718,657,245,412,26,1.7,71.84,7.2,0,0,0,0,0,0,0.00912485184538305,3.28232525516264,2.9098641702667
9.7,"eps_greedy_SVM","SVM",29,20,684,671,13,2100,1846,254,0.807817941483011,0.161290322580645,1.24245577523413,681,254,427,24,1.7,75.43,7.3,0,0,0,0,0,0,0.0649336276558669,33.1127449483287,24.7427880942169
9.7,"eps_greedy_SVM","SVM",29,21,584,574,10,2200,1943,257,0.849112839675651,0.395161290322581,1.23210197710718,700,257,443,19,1.7,79.02,7.6,0,0,0,0,0,0,0.0782483123182385,23.5803828737234,10.4432426068991
9.7,"eps_greedy_SVM","SVM",29,22,484,475,9,2300,2042,258,0.773996542870953,0.145161290322581,1.24245577523413,695,258,437,-5,1.7,82.61,7.9,0,0,0,0,0,0,0.0401206927363522,11.4220317496829,5.67054400690919
9.7,"eps_greedy_SVM","SVM",29,23,384,380,4,2400,2137,263,0.826044129235621,0.233870967741935,1.27351716961498,704,263,441,9,1.7,86.21,8.1,0,0,0,0,0,0,0.037239228626651,11.162235101925,6.71725976006622
9.7,"eps_greedy_SVM","SVM",29,24,284,282,2,2500,2235,265,0.823152596659806,0.258064516129032,1.26316337148803,729,265,464,25,1.8,89.8,8.4,0,0,0,0,0,0,0.0474316042640808,11.0001369981903,6.19941305271773
9.7,"eps_greedy_SVM","SVM",29,25,184,183,1,2600,2334,266,0.836536261725011,0.266129032258065,1.27351716961498,723,266,457,-6,1.7,93.39,8.8,0,0,0,0,0,0,0.0104700691848719,2.63763849353643,2.28084695573034
9.7,"eps_greedy_SVM","SVM",29,26,84,84,0,2700,2433,267,0.774949795368467,0.120967741935484,1.27351716961498,734,267,467,11,1.7,96.98,9.1,0,0,0,0,0,0,1.03745007544866e-06,0.334144187720193,0.334144187720193
9.7,"eps_greedy_SVM","SVM",29,27,0,0,0,2784,2517,267,0.835322453544834,0.282258064516129,1.26316337148803,725,267,458,-9,1.7,100,9.4,0,0,0,0,0,0,0,0,0
9.7,"eps_greedy_SVM","SVM",30,0,2684,2426,258,100,90,10,0.241501824467063,0,0.469708890637293,31,10,21,0,2.1,3.59,9,0,0,0,0,0,0,0.103110124657613,270.453518887238,10.3559915365574
9.7,"eps_greedy_SVM","SVM",30,1,2584,2345,239,200,171,29,0.790717623711681,0.235772357723577,1.24211906635195,69,29,40,38,1.4,7.18,5.9,0,0,0,0,0,0,0.340355970549391,324.745157565124,41.3451180462517
9.7,"eps_greedy_SVM","SVM",30,2,2484,2269,215,300,247,53,0.771621535112993,0.203252032520325,1.24211906635195,141,53,88,72,1.7,10.78,4.7,0,0,0,0,0,0,0.210511424304115,361.924652557228,23.7341451362674
9.7,"eps_greedy_SVM","SVM",30,3,2384,2174,210,400,342,58,0.802611868638378,0.24390243902439,1.24211906635195,154,58,96,13,1.7,14.37,5.9,0,0,0,0,0,0,0.218706518254559,222.530264085757,27.6124349502007
9.7,"eps_greedy_SVM","SVM",30,4,2284,2091,193,500,425,75,0.826688432238665,0.227642276422764,1.27343299239444,197,75,122,43,1.6,17.96,5.7,0,0,0,0,0,0,0.179162642677824,159.094680481289,18.8109275960912
9.7,"eps_greedy_SVM","SVM",30,5,2184,2019,165,600,497,103,0.822264899814361,0.24390243902439,1.27343299239444,265,103,162,68,1.6,21.55,4.8,0,0,0,0,0,0,0.188481088608515,173.812009388277,19.433419770981
9.7,"eps_greedy_SVM","SVM",30,6,2084,1950,134,700,566,134,0.833339734972162,0.333333333333333,1.27343299239444,339,134,205,74,1.5,25.14,4.2,0,0,0,0,0,0,0.203934582825055,275.795965576169,20.7698173482349
9.7,"eps_greedy_SVM","SVM",30,7,1984,1888,96,800,628,172,0.833307726778066,0.32520325203252,1.27343299239444,421,172,249,82,1.4,28.74,3.7,0,0,0,0,0,0,0.200901108759039,134.847844750374,21.6989247536058
9.7,"eps_greedy_SVM","SVM",30,8,1884,1806,78,900,710,190,0.840400742590112,0.32520325203252,1.26299501704694,455,190,265,34,1.4,32.33,3.7,0,0,0,0,0,0,0.184419546473058,126.123296074349,20.1432395737467
9.7,"eps_greedy_SVM","SVM",30,9,1784,1723,61,1000,793,207,0.828423276358748,0.260162601626016,1.26299501704694,506,207,299,51,1.4,35.92,3.8,0,0,0,0,0,0,0.190213086822401,131.800187972878,21.2813355128936
9.7,"eps_greedy_SVM","SVM",30,10,1684,1640,44,1100,876,224,0.824691120926954,0.24390243902439,1.26299501704694,558,224,334,52,1.5,39.51,3.9,0,0,0,0,0,0,0.19777073065589,195.696460480784,20.333233757414
9.7,"eps_greedy_SVM","SVM",30,11,1584,1556,28,1200,960,240,0.815773638051339,0.227642276422764,1.26299501704694,594,240,354,36,1.5,43.1,4,0,0,0,0,0,0,0.175400187819793,97.1499515447488,19.2324719512224
9.7,"eps_greedy_SVM","SVM",30,12,1484,1465,19,1300,1051,249,0.821925612956918,0.219512195121951,1.26299501704694,613,249,364,19,1.5,46.7,4.2,0,0,0,0,0,0,0.153767572856673,88.2291738466798,18.4005472206639
9.7,"eps_greedy_SVM","SVM",30,13,1384,1370,14,1400,1146,254,0.805358171691955,0.203252032520325,1.26299501704694,648,254,394,35,1.6,50.29,4.5,0,0,0,0,0,0,0.11817563366564,49.4672409856184,13.7370855348649
9.7,"eps_greedy_SVM","SVM",30,14,1284,1271,13,1500,1245,255,0.80939120414827,0.203252032520325,1.26299501704694,652,255,397,4,1.6,53.88,4.9,0,0,0,0,0,0,0.0997032727566122,39.4735124036629,11.2119232628379
9.7,"eps_greedy_SVM","SVM",30,15,1184,1174,10,1600,1342,258,0.815895269188923,0.24390243902439,1.26299501704694,666,258,408,14,1.6,57.47,5.2,0,0,0,0,0,0,0.149137757875205,131.780195366318,15.4353618662081
9.7,"eps_greedy_SVM","SVM",30,16,1084,1076,8,1700,1440,260,0.814397285705151,0.235772357723577,1.26299501704694,684,260,424,18,1.6,61.06,5.5,0,0,0,0,0,0,0.0718429454964734,25.7316995403169,9.30886447888759
9.7,"eps_greedy_SVM","SVM",30,17,984,977,7,1800,1539,261,0.795352410217032,0.203252032520325,1.27343299239444,694,261,433,10,1.7,64.66,5.9,0,0,0,0,0,0,0.119801464169019,76.818705168645,12.8245551882134
9.7,"eps_greedy_SVM","SVM",30,18,884,878,6,1900,1638,262,0.783624607899633,0.195121951219512,1.27343299239444,702,262,440,8,1.7,68.25,6.3,0,0,0,0,0,0,0.110149463481483,65.7898122409399,11.6892167438188
9.7,"eps_greedy_SVM","SVM",30,19,784,779,5,2000,1737,263,0.797068049420665,0.203252032520325,1.26299501704694,704,263,441,2,1.7,71.84,6.6,0,0,0,0,0,0,0.112631965781744,70.789831233213,11.803603475442
9.7,"eps_greedy_SVM","SVM",30,20,684,680,4,2100,1836,264,0.777619870686904,0.16260162601626,1.26299501704694,717,264,453,13,1.7,75.43,7,0,0,0,0,0,0,0.0104757962940588,2.90934621695937,1.90066178463413
9.7,"eps_greedy_SVM","SVM",30,21,584,583,1,2200,1933,267,0.814608539786194,0.260162601626016,1.26299501704694,709,267,442,-8,1.7,79.02,7.2,0,0,0,0,0,0,0.0098687233010394,4.37921153189987,3.3363309229894
9.7,"eps_greedy_SVM","SVM",30,22,484,484,0,2300,2032,268,0.768747199283025,0.16260162601626,1.26299501704694,728,268,460,19,1.7,82.61,7.6,0,0,0,0,0,0,0.0123179715219011,3.98723398651542,2.63131897170245
9.7,"eps_greedy_SVM","SVM",30,23,384,384,0,2400,2132,268,0.781185583509386,0.195121951219512,1.27343299239444,739,268,471,11,1.8,86.21,8,0,0,0,0,0,0,0.00315171406066211,0.924531088735859,0.729980338169751
9.7,"eps_greedy_SVM","SVM",30,24,284,284,0,2500,2232,268,0.783336534152755,0.211382113821138,1.27343299239444,726,268,458,-13,1.7,89.8,8.3,0,0,0,0,0,0,0.00115152328184038,0.306564919751578,0.2438131549395
9.7,"eps_greedy_SVM","SVM",30,25,184,184,0,2600,2332,268,0.80608155687857,0.260162601626016,1.26299501704694,720,268,452,-6,1.7,93.39,8.7,0,0,0,0,0,0,1.00223157375729e-06,0.0015313000986119,0.00150375893142798
9.7,"eps_greedy_SVM","SVM",30,26,84,84,0,2700,2432,268,0.814646949619111,0.260162601626016,1.26299501704694,711,268,443,-9,1.7,96.98,9.1,0,0,0,0,0,0,7.76090695949785e-05,0.0289408263428685,0.0289408263428685
9.7,"eps_greedy_SVM","SVM",30,27,0,0,0,2784,2516,268,0.780410985212225,0.211382113821138,1.26299501704694,730,268,462,19,1.7,100,9.4,0,0,0,0,0,0,0,0,0
9.7,"eps_greedy_SVM","SVM",31,0,2684,2415,269,100,94,6,0.543657008613942,0.120689655172414,0.896496106785317,24,6,18,0,3,3.59,15.7,0,0,0,0,0,0,0.165014375208597,199.218822142307,20.017441568775
9.7,"eps_greedy_SVM","SVM",31,1,2584,2327,257,200,182,18,0.829550671023136,0.28448275862069,1.27280311457175,48,18,30,24,1.7,7.18,10.1,0,0,0,0,0,0,0.177270179643092,113.629491851409,20.6491967547754
9.7,"eps_greedy_SVM","SVM",31,2,2484,2251,233,300,258,42,0.830286501228631,0.241379310344828,1.27280311457175,122,42,80,74,1.9,10.78,6.1,0,0,0,0,0,0,0.19719300730407,121.40908555614,20.1029397558076
9.7,"eps_greedy_SVM","SVM",31,3,2384,2189,195,400,320,80,0.679245537763617,0.224137931034483,1.12892102335929,202,80,122,80,1.5,14.37,4,0,0,0,0,0,0,0.248464275941885,358.497714189598,31.1231035159276
9.7,"eps_greedy_SVM","SVM",31,4,2284,2099,185,500,410,90,0.833391839710519,0.224137931034483,1.27280311457175,226,90,136,24,1.5,17.96,4.6,0,0,0,0,0,0,0.226983230726621,168.354653439286,29.3324477823213
9.7,"eps_greedy_SVM","SVM",31,5,2184,2025,159,600,484,116,0.828625820214396,0.25,1.27280311457175,275,116,159,49,1.4,21.55,4.2,0,0,0,0,0,0,0.236113181017037,139.992535190132,24.5931995882348
9.7,"eps_greedy_SVM","SVM",31,6,2084,1955,129,700,554,146,0.828787837874317,0.258620689655172,1.27280311457175,341,146,195,66,1.3,25.14,3.8,0,0,0,0,0,0,0.244546379593625,141.66233478274,24.8406832026622
9.7,"eps_greedy_SVM","SVM",31,7,1984,1886,98,800,623,177,0.822482650608908,0.21551724137931,1.27280311457175,412,177,235,71,1.3,28.74,3.5,0,0,0,0,0,0,0.229943962017009,93.4064128723296,24.562938158316
9.7,"eps_greedy_SVM","SVM",31,8,1884,1807,77,900,702,198,0.81674452515323,0.21551724137931,1.26173526140156,457,198,259,45,1.3,32.33,3.5,0,0,0,0,0,0,0.200048081471439,108.047195452137,21.7010280903609
9.7,"eps_greedy_SVM","SVM",31,9,1784,1724,60,1000,785,215,0.802081926930024,0.21551724137931,1.26173526140156,520,215,305,63,1.4,35.92,3.7,0,0,0,0,0,0,0.188171393380567,89.0980430884386,20.9861866556868
9.7,"eps_greedy_SVM","SVM",31,10,1684,1632,52,1100,877,223,0.807070720708547,0.232758620689655,1.26173526140156,533,223,310,13,1.4,39.51,3.9,0,0,0,0,0,0,0.131007980935687,46.0475088814548,16.0899288262382
9.7,"eps_greedy_SVM","SVM",31,11,1584,1538,46,1200,971,229,0.808231847271344,0.189655172413793,1.26173526140156,548,229,319,15,1.4,43.1,4.2,0,0,0,0,0,0,0.06663723813696,19.4305640639133,10.849844074646
9.7,"eps_greedy_SVM","SVM",31,12,1484,1444,40,1300,1065,235,0.812862852050869,0.224137931034483,1.23959955506118,576,235,341,28,1.5,46.7,4.5,0,0,0,0,0,0,0.0714859406870267,25.5200073339926,10.0845677363078
9.7,"eps_greedy_SVM","SVM",31,13,1384,1356,28,1400,1153,247,0.828362541517023,0.301724137931034,1.25066740823137,607,247,360,31,1.5,50.29,4.7,0,0,0,0,0,0,0.127220462448006,33.0300984291467,16.2174375698626
9.7,"eps_greedy_SVM","SVM",31,14,1284,1262,22,1500,1247,253,0.808663894364482,0.232758620689655,1.23959955506118,620,253,367,13,1.5,53.88,4.9,0,0,0,0,0,0,0.0778636720629874,20.7252740662028,11.5624655799677
9.7,"eps_greedy_SVM","SVM",31,15,1184,1165,19,1600,1344,256,0.799091350957248,0.181034482758621,1.23959955506118,655,256,399,35,1.6,57.47,5.2,0,0,0,0,0,0,0.12898113737862,48.7574899967055,15.2260892187465
9.7,"eps_greedy_SVM","SVM",31,16,1084,1066,18,1700,1443,257,0.808417492506677,0.267241379310345,1.23959955506118,661,257,404,6,1.6,61.06,5.6,0,0,0,0,0,0,0.138742267141772,37.0395029085087,16.9168039481922
9.7,"eps_greedy_SVM","SVM",31,17,984,966,18,1800,1543,257,0.798267761185964,0.232758620689655,1.23959955506118,659,257,402,-2,1.6,64.66,6,0,0,0,0,0,0,0.0806573914804276,17.9869782176871,10.4803629324549
9.7,"eps_greedy_SVM","SVM",31,18,884,867,17,1900,1642,258,0.799368131126291,0.275862068965517,1.23959955506118,661,258,403,2,1.6,68.25,6.4,0,0,0,0,0,0,0.0425750309676034,8.64504421852038,6.81284240272166
9.7,"eps_greedy_SVM","SVM",31,19,784,768,16,2000,1741,259,0.775355763778246,0.21551724137931,1.23959955506118,669,259,410,8,1.6,71.84,6.7,0,0,0,0,0,0,0.00363571119501454,2.26096541145148,2.14341279293406
9.7,"eps_greedy_SVM","SVM",31,20,684,671,13,2100,1838,262,0.814489779385951,0.293103448275862,1.25066740823137,670,262,408,1,1.6,75.43,7,0,0,0,0,0,0,0.000219441739769241,0.476029809582091,0.467047017421313
9.7,"eps_greedy_SVM","SVM",31,21,584,580,4,2200,1929,271,0.770333216320575,0.181034482758621,1.28387096774194,715,271,444,45,1.6,79.02,7.1,0,0,0,0,0,0,0.155626965632097,49.0390839905005,19.8178941777097
9.7,"eps_greedy_SVM","SVM",31,22,484,482,2,2300,2027,273,0.809440228984958,0.224137931034483,1.28387096774194,719,273,446,4,1.6,82.61,7.4,0,0,0,0,0,0,0.0789448967360244,22.526575024157,10.385397665361
9.7,"eps_greedy_SVM","SVM",31,23,384,382,2,2400,2127,273,0.80485647935625,0.206896551724138,1.28387096774194,727,273,454,8,1.7,86.21,7.8,0,0,0,0,0,0,0.0210673386935546,5.40178127183089,3.82151195255326
9.7,"eps_greedy_SVM","SVM",31,24,284,282,2,2500,2227,273,0.831616396187187,0.241379310344828,1.28387096774194,728,273,455,1,1.7,89.8,8.2,0,0,0,0,0,0,0.00414824563815866,1.24027751374681,1.08597612450107
9.7,"eps_greedy_SVM","SVM",31,25,184,183,1,2600,2326,274,0.746941916668917,0.155172413793103,1.28387096774194,727,274,453,-1,1.7,93.39,8.5,0,0,0,0,0,0,0.000166083737867494,0.650133582744311,0.647476021866295
9.7,"eps_greedy_SVM","SVM",31,26,84,84,0,2700,2425,275,0.796060270569483,0.163793103448276,1.27280311457175,738,275,463,11,1.7,96.98,8.8,0,0,0,0,0,0,8.52157974032157e-06,4.63450827409415,4.63450827409415
9.7,"eps_greedy_SVM","SVM",31,27,0,0,0,2784,2509,275,0.811094159263353,0.21551724137931,1.28387096774194,750,275,475,12,1.7,100,9.1,0,0,0,0,0,0,0,0,0
9.7,"eps_greedy_SVM","SVM",32,0,2684,2442,242,100,95,5,0.66098434302998,0.243055555555556,1.15905017921147,23,5,18,0,3.6,3.59,19,0,0,0,0,0,0,0.057320014186431,147.551207981347,5.78019368799974
9.7,"eps_greedy_SVM","SVM",32,1,2584,2370,214,200,167,33,0.690452361889512,0.243055555555556,1.20362903225806,90,33,57,67,1.7,7.18,5.1,0,0,0,0,0,0,0.170127908882338,409.09726948646,17.5327898321514
9.7,"eps_greedy_SVM","SVM",32,2,2484,2280,204,300,257,43,0.74778711858375,0.340277777777778,1.21254480286738,115,43,72,25,1.7,10.78,6,0,0,0,0,0,0,0.166005840090845,208.334355247881,18.1753535212865
9.7,"eps_greedy_SVM","SVM",32,3,2384,2215,169,400,322,78,0.747881638644241,0.347222222222222,1.18579749103943,191,78,113,76,1.4,14.37,4.1,0,0,0,0,0,0,0.206951806846197,194.602994961724,24.4185674893039
9.7,"eps_greedy_SVM","SVM",32,4,2284,2141,143,500,396,104,0.773374254959516,0.361111111111111,1.21254480286738,251,104,147,60,1.4,17.96,3.8,0,0,0,0,0,0,0.199487815774786,218.412271199699,21.1001903911561
9.7,"eps_greedy_SVM","SVM",32,5,2184,2062,122,600,475,125,0.780396539453778,0.333333333333333,1.2214605734767,303,125,178,52,1.4,21.55,3.8,0,0,0,0,0,0,0.195041548634253,170.245904277154,20.6132085388943
9.7,"eps_greedy_SVM","SVM",32,6,2084,1987,97,700,550,150,0.778828618450305,0.305555555555556,1.20362903225806,356,150,206,53,1.4,25.14,3.7,0,0,0,0,0,0,0.208644524162462,217.575374415354,21.7928640248898
9.7,"eps_greedy_SVM","SVM",32,7,1984,1904,80,800,633,167,0.770071612845832,0.284722222222222,1.21254480286738,411,167,244,55,1.5,28.74,3.8,0,0,0,0,0,0,0.19498701087747,138.210780107494,20.8577604002792
9.7,"eps_greedy_SVM","SVM",32,8,1884,1817,67,900,720,180,0.766001690241081,0.236111111111111,1.2214605734767,441,180,261,30,1.4,32.33,4,0,0,0,0,0,0,0.195455300834493,90.1183196250021,21.543762092995
9.7,"eps_greedy_SVM","SVM",32,9,1784,1726,58,1000,811,189,0.784783382261364,0.319444444444444,1.2214605734767,470,189,281,29,1.5,35.92,4.3,0,0,0,0,0,0,0.141516138182943,86.6421446430142,16.3047640766603
9.7,"eps_greedy_SVM","SVM",32,10,1684,1631,53,1100,906,194,0.766557690596919,0.263888888888889,1.23929211469534,491,194,297,21,1.5,39.51,4.7,0,0,0,0,0,0,0.131990811234895,92.517831042518,15.0292638331979
9.7,"eps_greedy_SVM","SVM",32,11,1584,1532,52,1200,1005,195,0.758356685348278,0.222222222222222,1.23929211469534,502,195,307,11,1.6,43.1,5.2,0,0,0,0,0,0,0.0465569058193313,15.6625275164139,6.36350557888793
9.7,"eps_greedy_SVM","SVM",32,12,1484,1434,50,1300,1103,197,0.772568054443551,0.277777777777778,1.27495519713262,512,197,315,10,1.6,46.7,5.6,0,0,0,0,0,0,0.0819784065842891,49.5599889836514,9.57313191156347
9.7,"eps_greedy_SVM","SVM",32,13,1384,1338,46,1400,1199,201,0.805739035672986,0.3125,1.24820788530466,517,201,316,5,1.6,50.29,6,0,0,0,0,0,0,0.118903120384596,49.6048505346482,14.9783425913047
9.7,"eps_greedy_SVM","SVM",32,14,1284,1256,28,1500,1281,219,0.796965350057822,0.298611111111111,1.24820788530466,557,219,338,40,1.5,53.88,5.8,0,0,0,0,0,0,0.146133795658398,77.287914151338,15.6914078202704
9.7,"eps_greedy_SVM","SVM",32,15,1184,1168,16,1600,1369,231,0.778778578418288,0.270833333333333,1.23929211469534,589,231,358,32,1.5,57.47,5.9,0,0,0,0,0,0,0.122585970658762,47.0074675479916,14.0967149934987
9.7,"eps_greedy_SVM","SVM",32,16,1084,1071,13,1700,1466,234,0.775303576194284,0.229166666666667,1.23929211469534,613,234,379,24,1.6,61.06,6.3,0,0,0,0,0,0,0.0658485323119974,21.9914122890518,9.12926402797719
9.7,"eps_greedy_SVM","SVM",32,17,984,972,12,1800,1565,235,0.777533137621208,0.277777777777778,1.2214605734767,627,235,392,14,1.7,64.66,6.7,0,0,0,0,0,0,0.0553128501689661,20.076718901283,7.97472762034865
9.7,"eps_greedy_SVM","SVM",32,18,884,873,11,1900,1664,236,0.753664042344986,0.25,1.20362903225806,616,236,380,-11,1.6,68.25,7.1,0,0,0,0,0,0,0.0621578225711831,25.5510310328148,8.74282865608825
9.7,"eps_greedy_SVM","SVM",32,19,784,774,10,2000,1763,237,0.752218441419803,0.256944444444444,1.20362903225806,637,237,400,21,1.7,71.84,7.4,0,0,0,0,0,0,0.0419291453337981,15.4060975596113,6.74589081772884
9.7,"eps_greedy_SVM","SVM",32,20,684,674,10,2100,1863,237,0.781247219998223,0.229166666666667,1.20362903225806,638,237,401,1,1.7,75.43,7.9,0,0,0,0,0,0,0.0241617111544193,7.75182398065481,3.18563928702593
9.7,"eps_greedy_SVM","SVM",32,21,584,574,10,2200,1963,237,0.777399697535806,0.256944444444444,1.20362903225806,630,237,393,-8,1.7,79.02,8.3,0,0,0,0,0,0,0.0137324502088689,4.20534827008829,1.89534002422565
9.7,"eps_greedy_SVM","SVM",32,22,484,476,8,2300,2061,239,0.761481407348099,0.229166666666667,1.21254480286738,649,239,410,19,1.7,82.61,8.6,0,0,0,0,0,0,0.0299776109026311,10.0695279815537,3.91774564353494
9.7,"eps_greedy_SVM","SVM",32,23,384,381,3,2400,2156,244,0.790165465705897,0.25,1.2660394265233,649,244,405,0,1.7,86.21,8.8,0,0,0,0,0,0,0.0178129375708851,6.26860422972638,5.06474487555469
9.7,"eps_greedy_SVM","SVM",32,24,284,284,0,2500,2253,247,0.782181300596033,0.284722222222222,1.2660394265233,690,247,443,41,1.8,89.8,9.1,0,0,0,0,0,0,0.00830897737809491,2.30176312471127,1.75772088479496
9.7,"eps_greedy_SVM","SVM",32,25,184,184,0,2600,2353,247,0.777605417667468,0.256944444444444,1.2660394265233,669,247,422,-21,1.7,93.39,9.5,0,0,0,0,0,0,0.00364239717050107,0.778292445807859,0.706076792682053
9.7,"eps_greedy_SVM","SVM",32,26,84,84,0,2700,2453,247,0.748726759185125,0.208333333333333,1.2660394265233,666,247,419,-3,1.7,96.98,9.9,0,0,0,0,0,0,6.83155765597792e-11,0.0201525214125028,0.0201525214125028
9.7,"eps_greedy_SVM","SVM",32,27,0,0,0,2784,2537,247,0.761826127568715,0.236111111111111,1.25712365591398,667,247,420,1,1.7,100,10.3,0,0,0,0,0,0,0,0,0
9.7,"eps_greedy_SVM","SVM",33,0,2684,2435,249,100,90,10,0.80047701439453,0.242424242424242,1.24496578690127,24,10,14,0,1.4,3.59,9,0,0,0,0,0,0,0.254338670694675,194.491031219239,36.5558894136463
9.7,"eps_greedy_SVM","SVM",33,1,2584,2373,211,200,152,48,0.672770528440634,0.196969696969697,1.07961876832845,109,48,61,85,1.3,7.18,3.2,0,0,0,0,0,0,0.260985147158441,557.047689856263,29.0717495869852
9.7,"eps_greedy_SVM","SVM",33,2,2484,2289,195,300,236,64,0.722766923797853,0.21969696969697,1.15742913000977,140,64,76,31,1.2,10.78,3.7,0,0,0,0,0,0,0.240540159107763,421.011863404226,25.1069279541738
9.7,"eps_greedy_SVM","SVM",33,3,2384,2210,174,400,315,85,0.733184341431762,0.25,1.15742913000977,193,85,108,53,1.3,14.37,3.7,0,0,0,0,0,0,0.23302063350033,273.382896347099,24.0507809571466
9.7,"eps_greedy_SVM","SVM",33,4,2284,2130,154,500,395,105,0.816733953331891,0.287878787878788,1.2644183773216,235,105,130,42,1.2,17.96,3.8,0,0,0,0,0,0,0.249896608305642,129.940334770875,26.3199029399746
9.7,"eps_greedy_SVM","SVM",33,5,2184,2063,121,600,462,138,0.806430682719337,0.25,1.24496578690127,310,138,172,75,1.2,21.55,3.3,0,0,0,0,0,0,0.243492882023907,128.679606558985,26.1987093301268
9.7,"eps_greedy_SVM","SVM",33,6,2084,1986,98,700,539,161,0.814727368851078,0.265151515151515,1.2644183773216,362,161,201,52,1.2,25.14,3.3,0,0,0,0,0,0,0.236716819567019,110.400600328803,24.4940330749938
9.7,"eps_greedy_SVM","SVM",33,7,1984,1905,79,800,620,180,0.812564583183137,0.257575757575758,1.2644183773216,410,180,230,48,1.3,28.74,3.4,0,0,0,0,0,0,0.208045823493344,83.8125527127599,23.0747102755611
9.7,"eps_greedy_SVM","SVM",33,8,1884,1820,64,900,705,195,0.803240573859118,0.25,1.25469208211144,450,195,255,40,1.3,32.33,3.6,0,0,0,0,0,0,0.162577903054206,59.1536455878405,18.6799518185323
9.7,"eps_greedy_SVM","SVM",33,9,1784,1729,55,1000,796,204,0.796313651983752,0.25,1.2644183773216,487,204,283,37,1.4,35.92,3.9,0,0,0,0,0,0,0.169956384425575,80.7238665515558,19.3386190516993
9.7,"eps_greedy_SVM","SVM",33,10,1684,1631,53,1100,894,206,0.788539639055099,0.227272727272727,1.2644183773216,500,206,294,13,1.4,39.51,4.3,0,0,0,0,0,0,0.0378718446658921,12.0204832761627,8.4655455861259
9.7,"eps_greedy_SVM","SVM",33,11,1584,1537,47,1200,988,212,0.796764232331236,0.21969696969697,1.2644183773216,500,212,288,0,1.4,43.1,4.7,0,0,0,0,0,0,0.0827056966182338,33.3789802353284,12.7856951128112
9.7,"eps_greedy_SVM","SVM",33,12,1484,1449,35,1300,1076,224,0.807241727344811,0.257575757575758,1.2644183773216,533,224,309,33,1.4,46.7,4.8,0,0,0,0,0,0,0.154326324669707,63.3873713049119,17.9858270933262
9.7,"eps_greedy_SVM","SVM",33,13,1384,1362,22,1400,1163,237,0.798133996587596,0.265151515151515,1.2644183773216,578,237,341,45,1.4,50.29,4.9,0,0,0,0,0,0,0.138356550972808,39.9469561178895,16.3460736839365
9.7,"eps_greedy_SVM","SVM",33,14,1284,1265,19,1500,1260,240,0.801576430442402,0.257575757575758,1.2644183773216,585,240,345,7,1.4,53.88,5.2,0,0,0,0,0,0,0.107870338725942,34.8190320758525,13.3653400382992
9.7,"eps_greedy_SVM","SVM",33,15,1184,1165,19,1600,1360,240,0.781558647538023,0.242424242424242,1.2644183773216,586,240,346,1,1.4,57.47,5.7,0,0,0,0,0,0,0.059990909501459,17.1744015317538,7.73441847843649
9.7,"eps_greedy_SVM","SVM",33,16,1084,1066,18,1700,1459,241,0.778626871410376,0.25,1.2644183773216,621,241,380,35,1.6,61.06,6.1,0,0,0,0,0,0,0.115109566101182,36.8338892468903,13.6541798390967
9.7,"eps_greedy_SVM","SVM",33,17,984,968,16,1800,1557,243,0.76287458246221,0.196969696969697,1.2644183773216,635,243,392,14,1.6,64.66,6.4,0,0,0,0,0,0,0.0792556948466701,19.1360320014859,10.5163202635605
9.7,"eps_greedy_SVM","SVM",33,18,884,868,16,1900,1657,243,0.757503664720159,0.242424242424242,1.2644183773216,619,243,376,-16,1.5,68.25,6.8,0,0,0,0,0,0,0.0483478678669701,10.1058763976245,6.83872530282823
9.7,"eps_greedy_SVM","SVM",33,19,784,768,16,2000,1757,243,0.778771057121569,0.242424242424242,1.2644183773216,623,243,380,4,1.6,71.84,7.2,0,0,0,0,0,0,0.00492223638205319,2.03581244426656,1.86640114664815
9.7,"eps_greedy_SVM","SVM",33,20,684,670,14,2100,1855,245,0.770312162064728,0.242424242424242,1.2644183773216,636,245,391,13,1.6,75.43,7.6,0,0,0,0,0,0,0.000516485476860819,0.305407314461636,0.269666046244681
9.7,"eps_greedy_SVM","SVM",33,21,584,577,7,2200,1948,252,0.776860596448225,0.212121212121212,1.28387096774194,674,252,422,38,1.7,79.02,7.7,0,0,0,0,0,0,0.0953817039419794,27.1836890604698,11.9703051996027
9.7,"eps_greedy_SVM","SVM",33,22,484,480,4,2300,2045,255,0.793952610962922,0.257575757575758,1.28387096774194,684,255,429,10,1.7,82.61,8,0,0,0,0,0,0,0.0688398135891488,17.7206341000176,8.79848256575533
9.7,"eps_greedy_SVM","SVM",33,23,384,382,2,2400,2143,257,0.787692548001828,0.25,1.27414467253177,675,257,418,-9,1.6,86.21,8.3,0,0,0,0,0,0,0.03656122946892,7.47598665955277,5.30145802464533
9.7,"eps_greedy_SVM","SVM",33,24,284,282,2,2500,2243,257,0.752096700550308,0.189393939393939,1.27414467253177,696,257,439,21,1.7,89.8,8.7,0,0,0,0,0,0,0.0201450881669247,5.20777773921261,4.15089101688833
9.7,"eps_greedy_SVM","SVM",33,25,184,183,1,2600,2342,258,0.763715665777518,0.204545454545455,1.27414467253177,696,258,438,0,1.7,93.39,9.1,0,0,0,0,0,0,0.021574037921945,7.35631115956324,6.59046733672284
9.7,"eps_greedy_SVM","SVM",33,26,84,84,0,2700,2441,259,0.794108812150039,0.25,1.27414467253177,728,259,469,32,1.8,96.98,9.4,0,0,0,0,0,0,3.29369399447017e-05,1.27204751226357,1.27204751226357
9.7,"eps_greedy_SVM","SVM",33,27,0,0,0,2784,2525,259,0.769927666834874,0.204545454545455,1.27414467253177,730,259,471,2,1.8,100,9.7,0,0,0,0,0,0,0,0,0
9.7,"eps_greedy_SVM","SVM",34,0,2684,2419,265,100,93,7,0.560822131050223,0.151260504201681,1.02493900786121,25,7,18,0,2.6,3.59,13.3,0,0,0,0,0,0,0.0981832472085971,197.67858377182,11.5211136319976
9.7,"eps_greedy_SVM","SVM",34,1,2584,2343,241,200,169,31,0.803925965990797,0.243697478991597,1.26229330441854,79,31,48,54,1.5,7.18,5.5,0,0,0,0,0,0,0.222857884812345,273.813631008021,25.874679268937
9.7,"eps_greedy_SVM","SVM",34,2,2484,2267,217,300,245,55,0.815515217075846,0.235294117647059,1.26229330441854,129,55,74,50,1.3,10.78,4.5,0,0,0,0,0,0,0.206089170755988,313.21916054392,21.6169215967882
9.7,"eps_greedy_SVM","SVM",34,3,2384,2194,190,400,318,82,0.816742081447969,0.327731092436975,1.26229330441854,188,82,106,59,1.3,14.37,3.9,0,0,0,0,0,0,0.221852760858209,351.04095721061,22.7375301662991
9.7,"eps_greedy_SVM","SVM",34,4,2284,2123,161,500,389,111,0.762423650778996,0.243697478991597,1.25150447275684,262,111,151,74,1.4,17.96,3.5,0,0,0,0,0,0,0.229692133142695,285.473876209809,26.5190167252389
9.7,"eps_greedy_SVM","SVM",34,5,2184,2035,149,600,477,123,0.807534002612039,0.26890756302521,1.26229330441854,287,123,164,25,1.3,21.55,3.9,0,0,0,0,0,0,0.229693399402991,186.844857520705,23.3088440458115
9.7,"eps_greedy_SVM","SVM",34,6,2084,1964,120,700,548,152,0.801096262680902,0.226890756302521,1.26229330441854,361,152,209,74,1.4,25.14,3.6,0,0,0,0,0,0,0.232350106760403,159.680267559629,23.8398860249326
9.7,"eps_greedy_SVM","SVM",34,7,1984,1904,80,800,608,192,0.803457646794988,0.226890756302521,1.26229330441854,450,192,258,89,1.3,28.74,3.2,0,0,0,0,0,0,0.238710418559941,204.826754554733,24.8499136672519
9.7,"eps_greedy_SVM","SVM",34,8,1884,1823,61,900,689,211,0.802059285252568,0.226890756302521,1.25150447275684,499,211,288,49,1.4,32.33,3.3,0,0,0,0,0,0,0.218638891956977,150.064621694385,23.2039913571685
9.7,"eps_greedy_SVM","SVM",34,9,1784,1729,55,1000,783,217,0.798213791010916,0.218487394957983,1.25150447275684,505,217,288,6,1.3,35.92,3.6,0,0,0,0,0,0,0.148417227580589,81.2704168440171,19.4449125184233
9.7,"eps_greedy_SVM","SVM",34,10,1684,1638,46,1100,874,226,0.80959856470061,0.210084033613445,1.26229330441854,537,226,311,32,1.4,39.51,3.9,0,0,0,0,0,0,0.159463075191964,78.9376971021145,18.3419516233555
9.7,"eps_greedy_SVM","SVM",34,11,1584,1552,32,1200,960,240,0.815719694471201,0.201680672268908,1.26229330441854,580,240,340,43,1.4,43.1,4,0,0,0,0,0,0,0.156288791923666,80.6462574659077,18.0621783778392
9.7,"eps_greedy_SVM","SVM",34,12,1484,1461,23,1300,1051,249,0.811524609843944,0.201680672268908,1.26229330441854,606,249,357,26,1.4,46.7,4.2,0,0,0,0,0,0,0.155208206822423,62.1896044739603,18.6342573973931
9.7,"eps_greedy_SVM","SVM",34,13,1384,1363,21,1400,1149,251,0.809539200295509,0.226890756302521,1.27308213608024,613,251,362,7,1.4,50.29,4.6,0,0,0,0,0,0,0.111349938638134,44.2617105508626,13.3228006208309
9.7,"eps_greedy_SVM","SVM",34,14,1284,1265,19,1500,1247,253,0.812639341450873,0.176470588235294,1.26229330441854,649,253,396,36,1.6,53.88,4.9,0,0,0,0,0,0,0.140745384297846,77.2409975709642,15.4522278037696
9.7,"eps_greedy_SVM","SVM",34,15,1184,1167,17,1600,1345,255,0.803187208949521,0.19327731092437,1.26229330441854,653,255,398,4,1.6,57.47,5.3,0,0,0,0,0,0,0.113204771179273,47.5993617488236,13.6038483086915
9.7,"eps_greedy_SVM","SVM",34,16,1084,1067,17,1700,1445,255,0.792679709246343,0.210084033613445,1.26229330441854,650,255,395,-3,1.5,61.06,5.7,0,0,0,0,0,0,0.0744001951141766,27.0489200276649,9.21624960297004
9.7,"eps_greedy_SVM","SVM",34,17,984,967,17,1800,1545,255,0.798187406830871,0.201680672268908,1.26229330441854,658,255,403,8,1.6,64.66,6.1,0,0,0,0,0,0,0.0314303797348127,9.55538282391979,4.69643682297311
9.7,"eps_greedy_SVM","SVM",34,18,884,868,16,1900,1644,256,0.799420867248005,0.201680672268908,1.27308213608024,650,256,394,-8,1.5,68.25,6.4,0,0,0,0,0,0,0.013902097776513,4.88334101558645,2.43454144670542
9.7,"eps_greedy_SVM","SVM",34,19,784,773,11,2000,1739,261,0.821207603920693,0.260504201680672,1.27308213608024,669,261,408,19,1.6,71.84,6.7,0,0,0,0,0,0,0.107110461216938,40.4335194173672,12.4512302055434
9.7,"eps_greedy_SVM","SVM",34,20,684,676,8,2100,1836,264,0.803820429270612,0.218487394957983,1.27308213608024,689,264,425,20,1.6,75.43,7,0,0,0,0,0,0,0.0683803013628779,18.3105999859558,9.81615453558923
9.7,"eps_greedy_SVM","SVM",34,21,584,582,2,2200,1930,270,0.808866403704343,0.235294117647059,1.27308213608024,714,270,444,25,1.6,79.02,7.1,0,0,0,0,0,0,0.0363327994390309,9.36006921794234,6.26714144035575
9.7,"eps_greedy_SVM","SVM",34,22,484,483,1,2300,2029,271,0.789698296901181,0.184873949579832,1.27308213608024,718,271,447,4,1.6,82.61,7.5,0,0,0,0,0,0,0.00580227590049868,2.43140329751984,1.98873199208106
9.7,"eps_greedy_SVM","SVM",34,23,384,384,0,2400,2128,272,0.797336517024396,0.226890756302521,1.27308213608024,742,272,470,24,1.7,86.21,7.8,0,0,0,0,0,0,0.0266697671848244,8.688157378036,6.93614579167932
9.7,"eps_greedy_SVM","SVM",34,24,284,284,0,2500,2228,272,0.794078070788758,0.201680672268908,1.27308213608024,750,272,478,8,1.8,89.8,8.2,0,0,0,0,0,0,0.00360150992918195,1.59948335764657,1.37319387146156
9.7,"eps_greedy_SVM","SVM",34,25,184,184,0,2600,2328,272,0.811419073123758,0.226890756302521,1.27308213608024,741,272,469,-9,1.7,93.39,8.6,0,0,0,0,0,0,0.000595307463328712,0.200386129068027,0.18261632447738
9.7,"eps_greedy_SVM","SVM",34,26,84,84,0,2700,2428,272,0.818226191575535,0.260504201680672,1.27308213608024,745,272,473,4,1.7,96.98,8.9,0,0,0,0,0,0,1.4149970477785e-06,0.0116713330438682,0.0116713330438682
9.7,"eps_greedy_SVM","SVM",34,27,0,0,0,2784,2512,272,0.809756869780883,0.277310924369748,1.27308213608024,713,272,441,-32,1.6,100,9.2,0,0,0,0,0,0,0,0,0
9.7,"eps_greedy_SVM","SVM",35,0,2684,2441,243,100,92,8,0.736797400524457,0.135714285714286,1.27470046082949,26,8,18,0,2.2,3.59,11.5,0,0,0,0,0,0,0.137982529761683,221.928344076295,15.1554750128756
9.7,"eps_greedy_SVM","SVM",35,1,2584,2358,226,200,175,25,0.692669022916434,0.114285714285714,1.16465437788018,74,25,49,48,2,7.18,7,0,0,0,0,0,0,0.164479436151296,266.497569808055,19.6668498724212
9.7,"eps_greedy_SVM","SVM",35,2,2484,2263,221,300,270,30,0.745946870368257,0.142857142857143,1.27470046082949,101,30,71,27,2.4,10.78,9,0,0,0,0,0,0,0.113561965103869,224.483458233069,11.7917942540329
9.7,"eps_greedy_SVM","SVM",35,3,2384,2176,208,400,357,43,0.78514992589215,0.228571428571429,1.26552995391705,138,43,95,37,2.2,14.37,8.3,0,0,0,0,0,0,0.127971162640933,163.56212852852,13.1270950382076
9.7,"eps_greedy_SVM","SVM",35,4,2284,2110,174,500,423,77,0.792908448295516,0.235714285714286,1.27470046082949,222,77,145,84,1.9,17.96,5.5,0,0,0,0,0,0,0.193238964178805,155.92023838509,19.7349022049569
9.7,"eps_greedy_SVM","SVM",35,5,2184,2029,155,600,504,96,0.79546231900581,0.221428571428571,1.27470046082949,263,96,167,41,1.7,21.55,5.2,0,0,0,0,0,0,0.182386927288539,155.957445506615,18.5945341522362
9.7,"eps_greedy_SVM","SVM",35,6,2084,1957,127,700,576,124,0.790719416258119,0.25,1.27470046082949,335,124,211,72,1.7,25.14,4.6,0,0,0,0,0,0,0.190744904739806,102.496483571464,20.1700675587911
9.7,"eps_greedy_SVM","SVM",35,7,1984,1895,89,800,638,162,0.79161441112758,0.214285714285714,1.27470046082949,418,162,256,83,1.6,28.74,3.9,0,0,0,0,0,0,0.201682781610292,119.119242946954,21.9022022411221
9.7,"eps_greedy_SVM","SVM",35,8,1884,1808,76,900,725,175,0.792726028959069,0.235714285714286,1.27470046082949,452,175,277,34,1.6,32.33,4.1,0,0,0,0,0,0,0.171537077288085,90.2371021302258,18.3357656043271
9.7,"eps_greedy_SVM","SVM",35,9,1784,1722,62,1000,811,189,0.788456276365289,0.185714285714286,1.27470046082949,496,189,307,44,1.6,35.92,4.3,0,0,0,0,0,0,0.197106692006294,74.6637199912995,21.2584951154276
9.7,"eps_greedy_SVM","SVM",35,10,1684,1645,39,1100,888,212,0.80360848249914,0.228571428571429,1.27470046082949,547,212,335,51,1.6,39.51,4.2,0,0,0,0,0,0,0.18662805496557,97.4015799883164,21.2607562055413
9.7,"eps_greedy_SVM","SVM",35,11,1584,1558,26,1200,975,225,0.804155740508489,0.207142857142857,1.27470046082949,581,225,356,34,1.6,43.1,4.3,0,0,0,0,0,0,0.126486294779935,50.6879831270396,15.1868093900454
9.7,"eps_greedy_SVM","SVM",35,12,1484,1464,20,1300,1069,231,0.805877322996233,0.242857142857143,1.27470046082949,589,231,358,8,1.5,46.7,4.6,0,0,0,0,0,0,0.105398605710554,43.0976739631844,14.4893293052603
9.7,"eps_greedy_SVM","SVM",35,13,1384,1366,18,1400,1167,233,0.81571656595598,0.228571428571429,1.27470046082949,608,233,375,19,1.6,50.29,5,0,0,0,0,0,0,0.144858129279874,136.757580780007,15.3664919045945
9.7,"eps_greedy_SVM","SVM",35,14,1284,1274,10,1500,1259,241,0.822181051191434,0.242857142857143,1.26552995391705,635,241,394,27,1.6,53.88,5.2,0,0,0,0,0,0,0.122094832214884,49.3902261847473,15.9802325224738
9.7,"eps_greedy_SVM","SVM",35,15,1184,1175,9,1600,1358,242,0.831085395051877,0.257142857142857,1.27470046082949,639,242,397,4,1.6,57.47,5.6,0,0,0,0,0,0,0.0636136150771758,22.875138932326,9.24602005576431
9.7,"eps_greedy_SVM","SVM",35,16,1084,1079,5,1700,1454,246,0.816816782578953,0.228571428571429,1.27470046082949,658,246,412,19,1.7,61.06,5.9,0,0,0,0,0,0,0.0892540884756443,35.8233724776553,13.2450911320766
9.7,"eps_greedy_SVM","SVM",35,17,984,981,3,1800,1552,248,0.829437920419565,0.278571428571429,1.27470046082949,677,248,429,19,1.7,64.66,6.3,0,0,0,0,0,0,0.104181416897856,54.6084647843639,11.5585074772324
9.7,"eps_greedy_SVM","SVM",35,18,884,882,2,1900,1651,249,0.813641546003886,0.264285714285714,1.26552995391705,705,249,456,28,1.8,68.25,6.6,0,0,0,0,0,0,0.105164175141157,33.0931112309884,13.9232649929162
9.7,"eps_greedy_SVM","SVM",35,19,784,782,2,2000,1751,249,0.829107285372247,0.335714285714286,1.27470046082949,677,249,428,-28,1.7,71.84,7,0,0,0,0,0,0,0.0433428636806752,13.0620607543929,5.57241241647936
9.7,"eps_greedy_SVM","SVM",35,20,684,682,2,2100,1851,249,0.802496864667655,0.278571428571429,1.27470046082949,680,249,431,3,1.7,75.43,7.4,0,0,0,0,0,0,0.023888097051969,6.70299113455409,3.28070213167831
9.7,"eps_greedy_SVM","SVM",35,21,584,582,2,2200,1951,249,0.779130087789312,0.2,1.27470046082949,677,249,428,-3,1.7,79.02,7.8,0,0,0,0,0,0,0.00795746210009101,2.41170805984621,1.65802360775785
9.7,"eps_greedy_SVM","SVM",35,22,484,482,2,2300,2051,249,0.826581917683274,0.25,1.27470046082949,683,249,434,6,1.7,82.61,8.2,0,0,0,0,0,0,0.00553284108464095,1.41644625984015,0.923211134036818
9.7,"eps_greedy_SVM","SVM",35,23,384,382,2,2400,2151,249,0.790531296317411,0.264285714285714,1.27470046082949,676,249,427,-7,1.7,86.21,8.6,0,0,0,0,0,0,0.00114292097430238,0.355818257237938,0.304047716213981
9.7,"eps_greedy_SVM","SVM",35,24,284,283,1,2500,2250,250,0.764183103408971,0.207142857142857,1.26552995391705,694,250,444,18,1.8,89.8,9,0,0,0,0,0,0,0.0597821303389686,16.1769677971582,12.9774760064391
9.7,"eps_greedy_SVM","SVM",35,25,184,184,0,2600,2349,251,0.786136130429825,0.228571428571429,1.27470046082949,711,251,460,17,1.8,93.39,9.4,0,0,0,0,0,0,0.00330157757503822,2.6155447098983,2.52388059881484
9.7,"eps_greedy_SVM","SVM",35,26,84,84,0,2700,2449,251,0.827545319803905,0.3,1.27470046082949,721,251,470,10,1.9,96.98,9.8,0,0,0,0,0,0,1.0000000994736e-07,0.0176985265651663,0.0176985265651663
9.7,"eps_greedy_SVM","SVM",35,27,0,0,0,2784,2533,251,0.741848135902406,0.164285714285714,1.24718894009217,692,251,441,-29,1.8,100,10.1,0,0,0,0,0,0,0,0,0
9.7,"eps_greedy_SVM","SVM",36,0,2684,2439,245,100,91,9,0.693267934353062,0.313868613138686,1.09644454909348,24,9,15,0,1.7,3.59,10.1,0,0,0,0,0,0,0.130595800046316,241.561598015512,13.7280291621433
9.7,"eps_greedy_SVM","SVM",36,1,2584,2371,213,200,159,41,0.739481147426657,0.153284671532847,1.28387096774194,105,41,64,81,1.6,7.18,3.9,0,0,0,0,0,0,0.264117388228074,491.067304172092,31.9644047795842
9.7,"eps_greedy_SVM","SVM",36,2,2484,2283,201,300,247,53,0.705338462968995,0.182481751824818,1.20890040028255,131,53,78,26,1.5,10.78,4.7,0,0,0,0,0,0,0.214714043108981,414.765422643583,23.435908355722
9.7,"eps_greedy_SVM","SVM",36,3,2384,2189,195,400,341,59,0.738475754335398,0.218978102189781,1.23701436307982,152,59,93,21,1.6,14.37,5.8,0,0,0,0,0,0,0.17639157791356,318.623275370808,18.5906453047579
9.7,"eps_greedy_SVM","SVM",36,4,2284,2107,177,500,423,77,0.796957087730725,0.313868613138686,1.25575700494467,195,77,118,43,1.5,17.96,5.5,0,0,0,0,0,0,0.188885462699142,215.302713979473,20.8004338533036
9.7,"eps_greedy_SVM","SVM",36,5,2184,2042,142,600,488,112,0.79022734669209,0.299270072992701,1.25575700494467,280,112,168,85,1.5,21.55,4.4,0,0,0,0,0,0,0.197345915919324,185.558538501151,21.1063446618316
9.7,"eps_greedy_SVM","SVM",36,6,2084,1969,115,700,561,139,0.803012692361348,0.328467153284672,1.25575700494467,339,139,200,59,1.4,25.14,4,0,0,0,0,0,0,0.195480731573108,191.309445888329,20.8067970583918
9.7,"eps_greedy_SVM","SVM",36,7,1984,1892,92,800,638,162,0.811212748151938,0.328467153284672,1.27449964680951,398,162,236,59,1.5,28.74,3.9,0,0,0,0,0,0,0.193217556736188,212.309718558706,20.3128469193633
9.7,"eps_greedy_SVM","SVM",36,8,1884,1809,75,900,721,179,0.829414431168354,0.35036496350365,1.26512832587709,431,179,252,33,1.4,32.33,4,0,0,0,0,0,0,0.188327502090981,214.136518368526,20.2076688167888
9.7,"eps_greedy_SVM","SVM",36,9,1784,1720,64,1000,810,190,0.812834162443635,0.357664233576642,1.26512832587709,466,190,276,35,1.5,35.92,4.3,0,0,0,0,0,0,0.181691093759612,136.819700238055,21.0990685814403
9.7,"eps_greedy_SVM","SVM",36,10,1684,1625,59,1100,905,195,0.826328513645453,0.364963503649635,1.27449964680951,490,195,295,24,1.5,39.51,4.6,0,0,0,0,0,0,0.154184897706455,91.6558561203918,17.7008072899062
9.7,"eps_greedy_SVM","SVM",36,11,1584,1541,43,1200,989,211,0.830123436700918,0.343065693430657,1.27449964680951,530,211,319,40,1.5,43.1,4.7,0,0,0,0,0,0,0.154809352664174,84.7280309803033,16.9628601743254
9.7,"eps_greedy_SVM","SVM",36,12,1484,1448,36,1300,1082,218,0.819988144497656,0.35036496350365,1.27449964680951,557,218,339,27,1.6,46.7,5,0,0,0,0,0,0,0.124466104861467,47.7886318969248,14.3256538964761
9.7,"eps_greedy_SVM","SVM",36,13,1384,1355,29,1400,1175,225,0.823806313636157,0.328467153284672,1.26512832587709,570,225,345,13,1.5,50.29,5.2,0,0,0,0,0,0,0.106451736404024,49.6130110384141,11.9238811918169
9.7,"eps_greedy_SVM","SVM",36,14,1284,1265,19,1500,1265,235,0.814507880422153,0.277372262773723,1.27449964680951,622,235,387,52,1.6,53.88,5.4,0,0,0,0,0,0,0.136660178248815,57.9918207580958,15.9739443974698
9.7,"eps_greedy_SVM","SVM",36,15,1184,1172,12,1600,1358,242,0.796840857315549,0.240875912408759,1.25575700494467,655,242,413,33,1.7,57.47,5.6,0,0,0,0,0,0,0.0740433350579676,25.0637773084189,9.81318129237837
9.7,"eps_greedy_SVM","SVM",36,16,1084,1072,12,1700,1458,242,0.8100213863964,0.284671532846715,1.26512832587709,645,242,403,-10,1.7,61.06,6,0,0,0,0,0,0,0.0281964826394931,7.92723020453097,4.4948271807313
9.7,"eps_greedy_SVM","SVM",36,17,984,972,12,1800,1558,242,0.821365474917482,0.313868613138686,1.27449964680951,649,242,407,4,1.7,64.66,6.4,0,0,0,0,0,0,0.0191990673852068,6.59157505878031,3.00067826033482
9.7,"eps_greedy_SVM","SVM",36,18,884,876,8,1900,1654,246,0.791546561904325,0.197080291970803,1.27332607439072,681,246,435,32,1.8,68.25,6.7,0,0,0,0,0,0,0.0883976707136168,31.3809701375897,24.027001666129
9.7,"eps_greedy_SVM","SVM",36,19,784,780,4,2000,1750,250,0.825933330233857,0.299270072992701,1.27449964680951,689,250,439,8,1.8,71.84,7,0,0,0,0,0,0,0.0666865024418359,18.6824300766255,10.1454681192694
9.7,"eps_greedy_SVM","SVM",36,20,684,682,2,2100,1848,252,0.821708354642246,0.306569343065693,1.27449964680951,699,252,447,10,1.8,75.43,7.3,0,0,0,0,0,0,0.0569166764826036,17.5589288133782,8.6162661682935
9.7,"eps_greedy_SVM","SVM",36,21,584,583,1,2200,1947,253,0.817622855548842,0.240875912408759,1.27332607439072,698,253,445,-1,1.8,79.02,7.7,0,0,0,0,0,0,0.0141225719606913,4.30219046043775,2.77133769702516
9.7,"eps_greedy_SVM","SVM",36,22,484,483,1,2300,2047,253,0.845134594820776,0.35036496350365,1.27449964680951,685,253,432,-13,1.7,82.61,8.1,0,0,0,0,0,0,0.00653087619186511,1.80139072034162,1.11978080555003
9.7,"eps_greedy_SVM","SVM",36,23,384,384,0,2400,2146,254,0.815408666139761,0.248175182481752,1.27449964680951,710,254,456,25,1.8,86.21,8.4,0,0,0,0,0,0,0.0037727590894227,1.72668314778246,1.4561080460823
9.7,"eps_greedy_SVM","SVM",36,24,284,284,0,2500,2246,254,0.824486261564931,0.321167883211679,1.27449964680951,705,254,451,-5,1.8,89.8,8.8,0,0,0,0,0,0,0.00253282481432898,0.70675174033401,0.545600202988718
9.7,"eps_greedy_SVM","SVM",36,25,184,184,0,2600,2346,254,0.805081593751454,0.240875912408759,1.27449964680951,709,254,455,4,1.8,93.39,9.2,0,0,0,0,0,0,0.000910732142890793,0.376827522471346,0.335579715042492
9.7,"eps_greedy_SVM","SVM",36,26,84,84,0,2700,2446,254,0.753306755311733,0.197080291970803,1.27449964680951,710,254,456,1,1.8,96.98,9.6,0,0,0,0,0,0,2.20562707350562e-05,0.0423305097397753,0.0423305097397753
9.7,"eps_greedy_SVM","SVM",36,27,0,0,0,2784,2530,254,0.820900553256781,0.299270072992701,1.27449964680951,714,254,460,4,1.8,100,10,0,0,0,0,0,0,0,0,0
9.7,"eps_greedy_SVM","SVM",37,0,2684,2439,245,100,90,10,0.803266413964159,0.286764705882353,1.27443074003795,30,10,20,0,2,3.59,9,0,0,0,0,0,0,0.153870694419222,260.736389695063,16.8521763068293
9.7,"eps_greedy_SVM","SVM",37,1,2584,2372,212,200,157,43,0.671697318545556,0.183823529411765,1.18946869070209,109,43,66,79,1.5,7.18,3.7,0,0,0,0,0,0,0.243104284793965,507.536618617534,27.6036353139922
9.7,"eps_greedy_SVM","SVM",37,2,2484,2291,193,300,238,62,0.6968447283448,0.183823529411765,1.19890891840607,160,62,98,51,1.6,10.78,3.8,0,0,0,0,0,0,0.212712259681423,459.674670457714,21.7013250687099
9.7,"eps_greedy_SVM","SVM",37,3,2384,2215,169,400,314,86,0.749625625906691,0.147058823529412,1.19890891840607,209,86,123,49,1.4,14.37,3.7,0,0,0,0,0,0,0.227785472642234,437.595413865377,23.746599759969
9.7,"eps_greedy_SVM","SVM",37,4,2284,2133,151,500,396,104,0.787548551640228,0.213235294117647,1.26499051233397,260,104,156,51,1.5,17.96,3.8,0,0,0,0,0,0,0.239699753530296,300.336080032748,24.8011463202126
9.7,"eps_greedy_SVM","SVM",37,5,2184,2055,129,600,474,126,0.823412419860551,0.257352941176471,1.26499051233397,316,126,190,56,1.5,21.55,3.8,0,0,0,0,0,0,0.228147582486446,238.445337117591,23.6631676784024
9.7,"eps_greedy_SVM","SVM",37,6,2084,1986,98,700,543,157,0.810730497449578,0.257352941176471,1.25555028462998,382,157,225,66,1.4,25.14,3.5,0,0,0,0,0,0,0.228008817230042,282.475170156023,23.3155559437688
9.7,"eps_greedy_SVM","SVM",37,7,1984,1914,70,800,615,185,0.812924095652577,0.257352941176471,1.246110056926,439,185,254,57,1.4,28.74,3.3,0,0,0,0,0,0,0.226849688961325,226.022158729375,23.5072591241553
9.7,"eps_greedy_SVM","SVM",37,8,1884,1831,53,900,698,202,0.806483691328554,0.264705882352941,1.246110056926,476,202,274,37,1.4,32.33,3.5,0,0,0,0,0,0,0.208864256084679,192.976671207997,21.697577581376
9.7,"eps_greedy_SVM","SVM",37,9,1784,1747,37,1000,782,218,0.795802330478728,0.220588235294118,1.23666982922201,534,218,316,58,1.4,35.92,3.6,0,0,0,0,0,0,0.207210193930256,180.933604137369,21.6214242403365
9.7,"eps_greedy_SVM","SVM",37,10,1684,1657,27,1100,872,228,0.789841592961762,0.213235294117647,1.246110056926,568,228,340,34,1.5,39.51,3.8,0,0,0,0,0,0,0.19772252055125,176.873560366362,20.5951855106753
9.7,"eps_greedy_SVM","SVM",37,11,1584,1560,24,1200,969,231,0.798294258037341,0.213235294117647,1.246110056926,586,231,355,18,1.5,43.1,4.2,0,0,0,0,0,0,0.169174685283703,134.442503381133,17.681671438005
9.7,"eps_greedy_SVM","SVM",37,12,1484,1466,18,1300,1063,237,0.81621156815949,0.25,1.27443074003795,589,237,352,3,1.5,46.7,4.5,0,0,0,0,0,0,0.111163213226327,46.55630999927,13.1351377435101
9.7,"eps_greedy_SVM","SVM",37,13,1384,1368,16,1400,1161,239,0.796533529879737,0.198529411764706,1.27443074003795,601,239,362,12,1.5,50.29,4.9,0,0,0,0,0,0,0.0767572228606332,30.0384496191664,9.3550424503882
9.7,"eps_greedy_SVM","SVM",37,14,1284,1271,13,1500,1258,242,0.7853374046516,0.198529411764706,1.246110056926,604,242,362,3,1.5,53.88,5.2,0,0,0,0,0,0,0.0828772617597456,43.006093227428,11.0736330030726
9.7,"eps_greedy_SVM","SVM",37,15,1184,1171,13,1600,1358,242,0.805302073096546,0.220588235294118,1.26499051233397,607,242,365,3,1.5,57.47,5.6,0,0,0,0,0,0,0.0604545615765362,27.4566401621019,7.24171687367587
9.7,"eps_greedy_SVM","SVM",37,16,1084,1073,11,1700,1456,244,0.784208432776457,0.220588235294118,1.26499051233397,615,244,371,8,1.5,61.06,6,0,0,0,0,0,0,0.0397171998782993,16.2321927581765,5.22026150817181
9.7,"eps_greedy_SVM","SVM",37,17,984,976,8,1800,1553,247,0.80794609013056,0.227941176470588,1.246110056926,640,247,393,25,1.6,64.66,6.3,0,0,0,0,0,0,0.101643085246152,44.2066605442915,15.6716077342659
9.7,"eps_greedy_SVM","SVM",37,18,884,876,8,1900,1653,247,0.796948851139501,0.227941176470588,1.246110056926,638,247,391,-2,1.6,68.25,6.7,0,0,0,0,0,0,0.0735020250731438,33.0298454736729,8.93404269903862
9.7,"eps_greedy_SVM","SVM",37,19,784,777,7,2000,1752,248,0.772017876362959,0.183823529411765,1.25555028462998,639,248,391,1,1.6,71.84,7.1,0,0,0,0,0,0,0.048503208773389,16.1876209480324,7.72088495570306
9.7,"eps_greedy_SVM","SVM",37,20,684,678,6,2100,1851,249,0.770350741728675,0.205882352941176,1.246110056926,665,249,416,26,1.7,75.43,7.4,0,0,0,0,0,0,0.0382338035439983,12.1042696833385,5.26667878133018
9.7,"eps_greedy_SVM","SVM",37,21,584,579,5,2200,1950,250,0.807010154897283,0.257352941176471,1.246110056926,672,250,422,7,1.7,79.02,7.8,0,0,0,0,0,0,0.0327900256909736,10.3743780327218,4.4333532133506
9.7,"eps_greedy_SVM","SVM",37,22,484,482,2,2300,2047,253,0.781517618980766,0.227941176470588,1.27443074003795,680,253,427,8,1.7,82.61,8.1,0,0,0,0,0,0,0.0238049605166103,7.50548991594149,4.35807322304484
9.7,"eps_greedy_SVM","SVM",37,23,384,383,1,2400,2146,254,0.818124385792507,0.272058823529412,1.27443074003795,681,254,427,1,1.7,86.21,8.4,0,0,0,0,0,0,0.0170457748317518,4.4834203519847,2.42612508605494
9.7,"eps_greedy_SVM","SVM",37,24,284,284,0,2500,2245,255,0.802160840469843,0.257352941176471,1.27443074003795,704,255,449,23,1.8,89.8,8.8,0,0,0,0,0,0,0.00559989037920479,1.50252265979109,1.18133253142692
9.7,"eps_greedy_SVM","SVM",37,25,184,184,0,2600,2345,255,0.784407319013525,0.205882352941176,1.27443074003795,696,255,441,-8,1.7,93.39,9.2,0,0,0,0,0,0,0.0024921932191072,0.897203877488346,0.812717452731145
9.7,"eps_greedy_SVM","SVM",37,26,84,84,0,2700,2445,255,0.805003743740932,0.169117647058824,1.27443074003795,681,255,426,-15,1.7,96.98,9.6,0,0,0,0,0,0,5.27153370067787e-07,0.0644130385577928,0.0644130385577928
9.7,"eps_greedy_SVM","SVM",37,27,0,0,0,2784,2529,255,0.814731620571859,0.272058823529412,1.27443074003795,705,255,450,24,1.8,100,9.9,0,0,0,0,0,0,0,0,0
9.7,"eps_greedy_SVM","SVM",38,0,2684,2422,262,100,91,9,0.794619010212096,0.183333333333333,1.26247311827957,28,9,19,0,2.1,3.59,10.1,0,0,0,0,0,0,0.136276218808001,241.070226121318,16.2414332089668
9.7,"eps_greedy_SVM","SVM",38,1,2584,2346,238,200,167,33,0.816961246399575,0.241666666666667,1.25177419354839,80,33,47,52,1.4,7.18,5.1,0,0,0,0,0,0,0.226541149240315,266.847072005757,25.5364459088918
9.7,"eps_greedy_SVM","SVM",38,2,2484,2280,204,300,233,67,0.805047132757255,0.191666666666667,1.27317204301075,166,67,99,86,1.5,10.78,3.5,0,0,0,0,0,0,0.231987089492384,492.055680485523,23.3620224315218
9.7,"eps_greedy_SVM","SVM",38,3,2384,2201,183,400,312,88,0.81849960722702,0.316666666666667,1.26247311827957,219,88,131,53,1.5,14.37,3.5,0,0,0,0,0,0,0.234796872651655,350.405178980349,23.7856863309654
9.7,"eps_greedy_SVM","SVM",38,4,2284,2137,147,500,376,124,0.81934406912804,0.3,1.26247311827957,303,124,179,84,1.4,17.96,3,0,0,0,0,0,0,0.252398685162684,221.92089341139,26.0376696428151
9.7,"eps_greedy_SVM","SVM",38,5,2184,2065,119,600,448,152,0.820096884001034,0.266666666666667,1.27317204301075,355,152,203,52,1.3,21.55,2.9,0,0,0,0,0,0,0.247978714536945,222.419814749724,25.8458157868924
9.7,"eps_greedy_SVM","SVM",38,6,2084,1993,91,700,520,180,0.818159203980089,0.258333333333333,1.27317204301075,434,180,254,79,1.4,25.14,2.9,0,0,0,0,0,0,0.250817678968212,186.460867954562,25.9652947200762
9.7,"eps_greedy_SVM","SVM",38,7,1984,1913,71,800,600,200,0.808974862529449,0.216666666666667,1.27317204301075,486,200,286,52,1.4,28.74,3,0,0,0,0,0,0,0.238748707612962,220.325325856364,25.0074988497314
9.7,"eps_greedy_SVM","SVM",38,8,1884,1828,56,900,685,215,0.811266038229896,0.233333333333333,1.27317204301075,539,215,324,53,1.5,32.33,3.2,0,0,0,0,0,0,0.220700982319815,243.98087839221,22.9944484893451
9.7,"eps_greedy_SVM","SVM",38,9,1784,1740,44,1000,773,227,0.792969363707778,0.183333333333333,1.26247311827957,569,227,342,30,1.5,35.92,3.4,0,0,0,0,0,0,0.201255612793784,196.753109045998,21.7278484729039
9.7,"eps_greedy_SVM","SVM",38,10,1684,1650,34,1100,863,237,0.753345116522649,0.108333333333333,1.22924340085942,567,237,330,-2,1.4,39.51,3.6,0,0,0,0,0,0,0.244038978304665,197.194841318319,30.8243337711309
9.7,"eps_greedy_SVM","SVM",38,11,1584,1558,26,1200,955,245,0.828980099502479,0.25,1.27317204301075,603,245,358,36,1.5,43.1,3.9,0,0,0,0,0,0,0.165074892428845,83.6961107951256,18.7258472511302
9.7,"eps_greedy_SVM","SVM",38,12,1484,1467,17,1300,1046,254,0.820489656978268,0.225,1.26247311827957,618,254,364,15,1.4,46.7,4.1,0,0,0,0,0,0,0.142233327318709,72.1858237731774,16.3340962346262
9.7,"eps_greedy_SVM","SVM",38,13,1384,1371,13,1400,1142,258,0.821746530505367,0.225,1.26247311827957,628,258,370,10,1.4,50.29,4.4,0,0,0,0,0,0,0.109184102018248,49.2169675015535,12.75258399476
9.7,"eps_greedy_SVM","SVM",38,14,1284,1273,11,1500,1240,260,0.823114689709343,0.208333333333333,1.26247311827957,652,260,392,24,1.5,53.88,4.8,0,0,0,0,0,0,0.0812299603680605,37.372153322366,10.092695043457
9.7,"eps_greedy_SVM","SVM",38,15,1184,1176,8,1600,1337,263,0.818329405603556,0.225,1.26247311827957,649,263,386,-3,1.5,57.47,5.1,0,0,0,0,0,0,0.0439833395415433,13.8300097505614,5.79050738017859
9.7,"eps_greedy_SVM","SVM",38,16,1084,1080,4,1700,1433,267,0.80334511652264,0.2,1.27317204301075,678,267,411,29,1.5,61.06,5.4,0,0,0,0,0,0,0.1557432067953,57.986191825285,19.8530156285766
9.7,"eps_greedy_SVM","SVM",38,17,984,981,3,1800,1532,268,0.809118879287763,0.208333333333333,1.27317204301075,687,268,419,9,1.6,64.66,5.7,0,0,0,0,0,0,0.0952037646427435,42.7797334142363,11.4420615420868
9.7,"eps_greedy_SVM","SVM",38,18,884,881,3,1900,1632,268,0.823114689709337,0.225,1.27317204301075,701,268,433,14,1.6,68.25,6.1,0,0,0,0,0,0,0.0484436710166054,16.0852861006523,5.92827566512754
9.7,"eps_greedy_SVM","SVM",38,19,784,781,3,2000,1732,268,0.816732128829527,0.191666666666667,1.27317204301075,670,268,402,-31,1.5,71.84,6.5,0,0,0,0,0,0,0.0352584921855557,10.8819452944295,4.59612174746114
9.7,"eps_greedy_SVM","SVM",38,20,684,682,2,2100,1831,269,0.806919350615335,0.216666666666667,1.27317204301075,699,269,430,29,1.6,75.43,6.8,0,0,0,0,0,0,0.0375939290857514,11.1278632596841,5.46045807069351
9.7,"eps_greedy_SVM","SVM",38,21,584,582,2,2200,1931,269,0.817681330191138,0.233333333333333,1.27317204301075,692,269,423,-7,1.6,79.02,7.2,0,0,0,0,0,0,0.0178596452726564,5.16620644842414,2.67044356026586
9.7,"eps_greedy_SVM","SVM",38,22,484,483,1,2300,2030,270,0.822244042943169,0.241666666666667,1.27317204301075,696,270,426,4,1.6,82.61,7.5,0,0,0,0,0,0,0.00470116265193994,1.31272563673079,0.975967449937077
9.7,"eps_greedy_SVM","SVM",38,23,384,383,1,2400,2130,270,0.816142969363699,0.216666666666667,1.27317204301075,692,270,422,-4,1.6,86.21,7.9,0,0,0,0,0,0,0.00109890496574026,0.334517055016809,0.261101063006187
9.7,"eps_greedy_SVM","SVM",38,24,284,284,0,2500,2229,271,0.780354804922755,0.1,1.26247311827957,705,271,434,13,1.6,89.8,8.2,0,0,0,0,0,0,0.0513996376222008,45.0732917081455,43.3293536883886
9.7,"eps_greedy_SVM","SVM",38,25,184,184,0,2600,2329,271,0.818466876145585,0.225,1.28387096774194,701,271,430,-4,1.6,93.39,8.6,0,0,0,0,0,0,0.00188134200112026,1.05860392242275,1.0001831551927
9.7,"eps_greedy_SVM","SVM",38,26,84,84,0,2700,2429,271,0.80481801518722,0.166666666666667,1.28387096774194,697,271,426,-4,1.6,96.98,9,0,0,0,0,0,0,1.35320186028204e-06,0.025772680409058,0.025772680409058
9.7,"eps_greedy_SVM","SVM",38,27,0,0,0,2784,2513,271,0.82249934537837,0.241666666666667,1.28387096774194,706,271,435,9,1.6,100,9.3,0,0,0,0,0,0,0,0,0
9.7,"eps_greedy_SVM","SVM",39,0,2684,2423,261,100,91,9,0.794512448671969,0.371900826446281,1.18837643295121,21,9,12,0,1.3,3.59,10.1,0,0,0,0,0,0,0.274954271881792,239.951204332016,30.5045505041809
9.7,"eps_greedy_SVM","SVM",39,1,2584,2362,222,200,152,48,0.782291179375227,0.198347107438017,1.24142895227939,102,48,54,81,1.1,7.18,3.2,0,0,0,0,0,0,0.251776565418975,571.980202463192,25.7280342607508
9.7,"eps_greedy_SVM","SVM",39,2,2484,2280,204,300,234,66,0.824016321014606,0.289256198347107,1.28387096774194,148,66,82,46,1.2,10.78,3.5,0,0,0,0,0,0,0.237868511828503,404.984697420139,24.6258050507721
9.7,"eps_greedy_SVM","SVM",39,3,2384,2194,190,400,320,80,0.838095794999746,0.28099173553719,1.28387096774194,192,80,112,44,1.4,14.37,4,0,0,0,0,0,0,0.214958482754519,221.985976781006,21.9305793904236
9.7,"eps_greedy_SVM","SVM",39,4,2284,2127,157,500,387,113,0.828687821612346,0.305785123966942,1.2732604638763,267,113,154,75,1.4,17.96,3.4,0,0,0,0,0,0,0.24056366985591,146.386706531495,25.4161093647099
9.7,"eps_greedy_SVM","SVM",39,5,2184,2062,122,600,452,148,0.824990903893128,0.297520661157025,1.2732604638763,341,148,193,74,1.3,21.55,3.1,0,0,0,0,0,0,0.239223996175667,344.172972349205,24.4046069227656
9.7,"eps_greedy_SVM","SVM",39,6,2084,1990,94,700,524,176,0.775365143718493,0.148760330578512,1.24142895227939,424,176,248,83,1.4,25.14,3,0,0,0,0,0,0,0.305225796029705,303.690607470848,40.4776260116004
9.7,"eps_greedy_SVM","SVM",39,7,1984,1912,72,800,602,198,0.710665835022612,0.12396694214876,1.15654492135431,482,198,284,58,1.4,28.74,3,0,0,0,0,0,0,0.286939357988886,344.114501195493,37.7254472251639
9.7,"eps_greedy_SVM","SVM",39,8,1884,1813,71,900,701,199,0.792524299599781,0.264462809917355,1.25203945614503,476,199,277,-6,1.4,32.33,3.5,0,0,0,0,0,0,0.249505518475174,110.569378585556,26.1731556585268
9.7,"eps_greedy_SVM","SVM",39,9,1784,1721,63,1000,793,207,0.804381724621869,0.322314049586777,1.25203945614503,486,207,279,10,1.3,35.92,3.8,0,0,0,0,0,0,0.170202322648544,55.3747823074865,19.9112376882638
9.7,"eps_greedy_SVM","SVM",39,10,1684,1628,56,1100,886,214,0.800496387546139,0.289256198347107,1.24142895227939,507,214,293,21,1.4,39.51,4.1,0,0,0,0,0,0,0.150047784408079,85.7057720047697,16.7284288006046
9.7,"eps_greedy_SVM","SVM",39,11,1584,1533,51,1200,981,219,0.809650969385108,0.297520661157025,1.25203945614503,524,219,305,17,1.4,43.1,4.5,0,0,0,0,0,0,0.115581056854128,44.9816533341212,13.8407385722365
9.7,"eps_greedy_SVM","SVM",39,12,1484,1448,36,1300,1066,234,0.801600914808455,0.247933884297521,1.23081844841376,594,234,360,70,1.5,46.7,4.6,0,0,0,0,0,0,0.193326618084963,81.6011425387186,20.2111645337479
9.7,"eps_greedy_SVM","SVM",39,13,1384,1359,25,1400,1155,245,0.795272623317211,0.256198347107438,1.23081844841376,621,245,376,27,1.5,50.29,4.7,0,0,0,0,0,0,0.159605810028397,51.0122469296598,17.5153030198356
9.7,"eps_greedy_SVM","SVM",39,14,1284,1261,23,1500,1253,247,0.799788190654392,0.272727272727273,1.23081844841376,639,247,392,18,1.6,53.88,5.1,0,0,0,0,0,0,0.0984060438448075,25.6079420646138,12.8508597904284
9.7,"eps_greedy_SVM","SVM",39,15,1184,1163,21,1600,1351,249,0.773526430687664,0.181818181818182,1.23081844841376,652,249,403,13,1.6,57.47,5.4,0,0,0,0,0,0,0.112611441771904,37.6870766977256,13.2363271148459
9.7,"eps_greedy_SVM","SVM",39,16,1084,1065,19,1700,1449,251,0.802432558864809,0.28099173553719,1.23081844841376,659,251,408,7,1.6,61.06,5.8,0,0,0,0,0,0,0.128748475322452,39.4512333347544,14.2155254923388
9.7,"eps_greedy_SVM","SVM",39,17,984,966,18,1800,1548,252,0.798605696761786,0.272727272727273,1.22020794454812,678,252,426,19,1.7,64.66,6.1,0,0,0,0,0,0,0.133591002145925,37.299208695799,14.1550811297959
9.7,"eps_greedy_SVM","SVM",39,18,884,866,18,1900,1648,252,0.783642600966788,0.256198347107438,1.23081844841376,676,252,424,-2,1.7,68.25,6.5,0,0,0,0,0,0,0.104134052996237,21.142757058286,11.9142301997108
9.7,"eps_greedy_SVM","SVM",39,19,784,767,17,2000,1747,253,0.797683091636785,0.214876033057851,1.24142895227939,667,253,414,-9,1.6,71.84,6.9,0,0,0,0,0,0,5.34827978309119e-06,2.95239121145753,2.95234420036509
9.7,"eps_greedy_SVM","SVM",39,20,684,669,15,2100,1845,255,0.743964083372318,0.148760330578512,1.23081844841376,691,255,436,24,1.7,75.43,7.2,0,0,0,0,0,0,2.17659234906652e-09,0.036926204970954,0.0369261694094689
9.7,"eps_greedy_SVM","SVM",39,21,584,571,13,2200,1943,257,0.725297572638915,0.115702479338843,1.25203945614503,688,257,431,-3,1.7,79.02,7.6,0,0,0,0,0,0,2.68534005792784e-10,2.61749882806645e-06,2.61026818789203e-06
9.7,"eps_greedy_SVM","SVM",39,22,484,476,8,2300,2038,262,0.792849160559283,0.165289256198347,1.26264996001066,684,262,422,-4,1.6,82.61,7.8,0,0,0,0,0,0,0.01375679283957,5.22438357442724,2.4652306677943
9.7,"eps_greedy_SVM","SVM",39,23,384,380,4,2400,2134,266,0.793908207287284,0.198347107438017,1.2732604638763,711,266,445,27,1.7,86.21,8,0,0,0,0,0,0,0.0807295625937633,23.6569894870879,13.1661210036421
9.7,"eps_greedy_SVM","SVM",39,24,284,281,3,2500,2233,267,0.784617183845315,0.148760330578512,1.28387096774194,730,267,463,19,1.7,89.8,8.4,0,0,0,0,0,0,0.0239780561073098,5.75165433812444,4.04052505041547
9.7,"eps_greedy_SVM","SVM",39,25,184,183,1,2600,2331,269,0.788567493112945,0.214876033057851,1.2732604638763,742,269,473,12,1.8,93.39,8.7,0,0,0,0,0,0,0.0346688318714783,8.23399081552417,6.75548694068759
9.7,"eps_greedy_SVM","SVM",39,26,84,83,1,2700,2431,269,0.765554342741309,0.190082644628099,1.26264996001066,734,269,465,-8,1.7,96.98,9,0,0,0,0,0,0,0.00449985347551377,3.24018961888521,3.24018961888521
9.7,"eps_greedy_SVM","SVM",39,27,0,0,0,2784,2514,270,0.758511357139146,0.140495867768595,1.28387096774194,726,270,456,-8,1.7,100,9.3,0,0,0,0,0,0,0,0,0
9.7,"eps_greedy_SVM","SVM",40,0,2684,2425,259,100,91,9,0.782299468663982,0.195121951219512,1.27343299239444,30,9,21,0,2.3,3.59,10.1,0,0,0,0,0,0,0.101268160697945,243.000099294373,10.6367515153145
9.7,"eps_greedy_SVM","SVM",40,1,2584,2337,247,200,179,21,0.749791946738372,0.308943089430894,1.24211906635195,61,21,40,31,1.9,7.18,8.5,0,0,0,0,0,0,0.12459852109303,260.206465969329,13.1545312984596
9.7,"eps_greedy_SVM","SVM",40,2,2484,2272,212,300,244,56,0.749695922156079,0.211382113821138,1.27343299239444,143,56,87,82,1.6,10.78,4.4,0,0,0,0,0,0,0.20643450096463,442.233354817623,21.6070774037345
9.7,"eps_greedy_SVM","SVM",40,3,2384,2184,200,400,332,68,0.747833045259599,0.211382113821138,1.23168109100446,169,68,101,26,1.5,14.37,4.9,0,0,0,0,0,0,0.180309668047076,361.20036833353,19.4166928813643
9.7,"eps_greedy_SVM","SVM",40,4,2284,2098,186,500,418,82,0.764253248831703,0.260162601626016,1.23168109100446,204,82,122,35,1.5,17.96,5.1,0,0,0,0,0,0,0.17325371250803,259.056540030578,18.5409381855517
9.7,"eps_greedy_SVM","SVM",40,5,2184,2015,169,600,501,99,0.776416362588828,0.292682926829268,1.23168109100446,248,99,149,44,1.5,21.55,5.1,0,0,0,0,0,0,0.170440898814164,242.806200627814,17.3492433862853
9.7,"eps_greedy_SVM","SVM",40,6,2084,1933,151,700,583,117,0.79082004993279,0.292682926829268,1.23168109100446,292,117,175,44,1.5,25.14,5,0,0,0,0,0,0,0.171881481807717,204.349624308117,17.4874811988197
9.7,"eps_greedy_SVM","SVM",40,7,1984,1871,113,800,645,155,0.797375328083997,0.268292682926829,1.23168109100446,383,155,228,91,1.5,28.74,4.2,0,0,0,0,0,0,0.196835267673301,157.2882433397,20.3055685623276
9.7,"eps_greedy_SVM","SVM",40,8,1884,1807,77,900,709,191,0.796696754369124,0.219512195121951,1.23168109100446,467,191,276,84,1.4,32.33,3.7,0,0,0,0,0,0,0.208746189605269,169.935281570451,21.8415651250237
9.7,"eps_greedy_SVM","SVM",40,9,1784,1724,60,1000,792,208,0.804698802893547,0.292682926829268,1.23168109100446,503,208,295,36,1.4,35.92,3.8,0,0,0,0,0,0,0.198964620606763,136.575513058543,20.8604742568043
9.7,"eps_greedy_SVM","SVM",40,10,1684,1640,44,1100,876,224,0.80363613084951,0.300813008130081,1.23168109100446,540,224,316,37,1.4,39.51,3.9,0,0,0,0,0,0,0.19136565687253,135.54063736147,19.8244159085252
9.7,"eps_greedy_SVM","SVM",40,11,1584,1553,31,1200,963,237,0.805716663465858,0.268292682926829,1.23168109100446,585,237,348,45,1.5,43.1,4.1,0,0,0,0,0,0,0.160973477907712,81.8908440563016,17.6709870480495
9.7,"eps_greedy_SVM","SVM",40,12,1484,1459,25,1300,1057,243,0.80999935983613,0.260162601626016,1.23168109100446,598,243,355,13,1.5,46.7,4.3,0,0,0,0,0,0,0.149827703970781,79.3358585748956,15.9862407781695
9.7,"eps_greedy_SVM","SVM",40,13,1384,1361,23,1400,1155,245,0.814838998783705,0.292682926829268,1.23168109100446,608,245,363,10,1.5,50.29,4.7,0,0,0,0,0,0,0.127750031038104,74.398144033148,14.0313773457187
9.7,"eps_greedy_SVM","SVM",40,14,1284,1264,20,1500,1252,248,0.806401638819555,0.252032520325203,1.23168109100446,610,248,362,2,1.5,53.88,5,0,0,0,0,0,0,0.0952525803409058,39.7681008779201,11.1612916497392
9.7,"eps_greedy_SVM","SVM",40,15,1184,1165,19,1600,1351,249,0.804154663593896,0.252032520325203,1.23168109100446,629,249,380,19,1.5,57.47,5.4,0,0,0,0,0,0,0.0783501226139652,37.4681444228153,9.17791461991973
9.7,"eps_greedy_SVM","SVM",40,16,1084,1067,17,1700,1449,251,0.799551885282636,0.276422764227642,1.21080514030947,625,251,374,-4,1.5,61.06,5.8,0,0,0,0,0,0,0.0835870788694114,28.7642287550284,11.1001791268715
9.7,"eps_greedy_SVM","SVM",40,17,984,968,16,1800,1548,252,0.78964855002881,0.260162601626016,1.21080514030947,636,252,384,11,1.5,64.66,6.1,0,0,0,0,0,0,0.0751803279322643,31.7609303972978,9.10151271111679
9.7,"eps_greedy_SVM","SVM",40,18,884,869,15,1900,1647,253,0.800774598297171,0.235772357723577,1.22124311565696,650,253,397,14,1.6,68.25,6.5,0,0,0,0,0,0,0.0336379237764904,10.0963557759778,4.50519180780886
9.7,"eps_greedy_SVM","SVM",40,19,784,769,15,2000,1747,253,0.783406952179764,0.24390243902439,1.21080514030947,647,253,394,-3,1.6,71.84,6.9,0,0,0,0,0,0,0.0102443003707313,3.13102836306096,1.7696369605883
9.7,"eps_greedy_SVM","SVM",40,20,684,670,14,2100,1846,254,0.794609820113957,0.227642276422764,1.22124311565696,647,254,393,0,1.5,75.43,7.3,0,0,0,0,0,0,0.00946951349369002,2.93908094693978,1.51875276723516
9.7,"eps_greedy_SVM","SVM",40,21,584,572,12,2200,1944,256,0.799980795083554,0.227642276422764,1.21080514030947,663,256,407,16,1.6,79.02,7.6,0,0,0,0,0,0,0.00598156879240923,2.00649101369988,1.20296411287461
9.7,"eps_greedy_SVM","SVM",40,22,484,476,8,2300,2040,260,0.799122975481731,0.268292682926829,1.22124311565696,677,260,417,14,1.6,82.61,7.8,0,0,0,0,0,0,0.0329549164625247,11.2674144950732,7.4823247363915
9.7,"eps_greedy_SVM","SVM",40,23,384,376,8,2400,2140,260,0.799487868894441,0.227642276422764,1.22124311565696,679,260,419,2,1.6,86.21,8.2,0,0,0,0,0,0,0.0139746260486611,3.93887951843457,1.9781413657183
9.7,"eps_greedy_SVM","SVM",40,24,284,276,8,2500,2240,260,0.802163753921008,0.252032520325203,1.22124311565696,687,260,427,8,1.6,89.8,8.6,0,0,0,0,0,0,0.00543217654329942,1.3709287930085,0.869656509548798
9.7,"eps_greedy_SVM","SVM",40,25,184,181,3,2600,2335,265,0.804218679982076,0.276422764227642,1.26299501704694,701,265,436,14,1.6,93.39,8.8,0,0,0,0,0,0,0.0034999703444272,3.74994261569447,3.63475587732952
9.7,"eps_greedy_SVM","SVM",40,26,84,84,0,2700,2432,268,0.816477818321495,0.252032520325203,1.27343299239444,723,268,455,22,1.7,96.98,9.1,0,0,0,0,0,0,1.29562329993199e-05,0.0838119580517551,0.0838119580517551
9.7,"eps_greedy_SVM","SVM",40,27,0,0,0,2784,2516,268,0.816170539658156,0.235772357723577,1.27343299239444,729,268,461,6,1.7,100,9.4,0,0,0,0,0,0,0,0,0
9.7,"eps_greedy_SVM","SVM",41,0,2684,2434,250,100,90,10,0.762802288866574,0.229007633587786,1.25331421421844,25,10,15,0,1.5,3.59,9,0,0,0,0,0,0,0.275599388802569,254.117600872716,38.7418938212861
9.7,"eps_greedy_SVM","SVM",41,1,2584,2359,225,200,165,35,0.720327603101821,0.320610687022901,1.1466633834031,82,35,47,57,1.3,7.18,4.7,0,0,0,0,0,0,0.199137322556957,389.540750469199,21.2939446672604
9.7,"eps_greedy_SVM","SVM",41,2,2484,2295,189,300,229,71,0.721488973034438,0.198473282442748,1.16626446688008,165,71,94,83,1.3,10.78,3.2,0,0,0,0,0,0,0.25729611062772,485.384552398207,29.4947069819414
9.7,"eps_greedy_SVM","SVM",41,3,2384,2216,168,400,308,92,0.808567522773735,0.305343511450382,1.27407042600345,215,92,123,50,1.3,14.37,3.3,0,0,0,0,0,0,0.232283204292038,399.6804749723,23.9363328852255
9.7,"eps_greedy_SVM","SVM",41,4,2284,2142,142,500,382,118,0.806154050882514,0.282442748091603,1.26426988426496,274,118,156,59,1.3,17.96,3.2,0,0,0,0,0,0,0.232936644544934,223.680783167352,25.2558534304794
9.7,"eps_greedy_SVM","SVM",41,5,2184,2065,119,600,459,141,0.779369956811541,0.251908396946565,1.20546663383403,329,141,188,55,1.3,21.55,3.3,0,0,0,0,0,0,0.237971011735591,340.657947550596,30.3463187613941
9.7,"eps_greedy_SVM","SVM",41,6,2084,1976,108,700,548,152,0.812130266994103,0.297709923664122,1.26426988426496,364,152,212,35,1.4,25.14,3.6,0,0,0,0,0,0,0.181174241954187,114.12589272354,19.9896400701016
9.7,"eps_greedy_SVM","SVM",41,7,1984,1902,82,800,622,178,0.804200287922957,0.282442748091603,1.24466880078798,424,178,246,60,1.4,28.74,3.5,0,0,0,0,0,0,0.210666170141755,160.154252070624,24.2118545003561
9.7,"eps_greedy_SVM","SVM",41,8,1884,1827,57,900,697,203,0.809317574188548,0.259541984732824,1.25446934252647,482,203,279,58,1.4,32.33,3.4,0,0,0,0,0,0,0.224276809345251,192.495156370289,23.963367475366
9.7,"eps_greedy_SVM","SVM",41,9,1784,1735,49,1000,789,211,0.806444393365672,0.244274809160305,1.27407042600345,499,211,288,17,1.4,35.92,3.7,0,0,0,0,0,0,0.19294259983601,109.306722738213,23.7411993178305
9.7,"eps_greedy_SVM","SVM",41,10,1684,1649,35,1100,875,225,0.808386058721765,0.251908396946565,1.26426988426496,553,225,328,54,1.5,39.51,3.9,0,0,0,0,0,0,0.152092021028744,74.1970140226105,17.1481012898582
9.7,"eps_greedy_SVM","SVM",41,11,1584,1556,28,1200,968,232,0.801538815160716,0.236641221374046,1.26426988426496,563,232,331,10,1.4,43.1,4.2,0,0,0,0,0,0,0.113661886705476,52.9229310111646,13.3771686626152
9.7,"eps_greedy_SVM","SVM",41,12,1484,1458,26,1300,1066,234,0.792344636527503,0.221374045801527,1.25446934252647,579,234,345,16,1.5,46.7,4.6,0,0,0,0,0,0,0.084185376821957,40.2009636980737,10.6586500549578
9.7,"eps_greedy_SVM","SVM",41,13,1384,1363,21,1400,1161,239,0.810291431267459,0.236641221374046,1.24466880078798,592,239,353,13,1.5,50.29,4.9,0,0,0,0,0,0,0.0586888715849459,25.7208087664352,10.9839307541805
9.7,"eps_greedy_SVM","SVM",41,14,1284,1271,13,1500,1253,247,0.799814906666985,0.198473282442748,1.26426988426496,613,247,366,21,1.5,53.88,5.1,0,0,0,0,0,0,0.0588705652061349,23.3384419641957,7.35405664574626
9.7,"eps_greedy_SVM","SVM",41,15,1184,1172,12,1600,1352,248,0.807605763298286,0.206106870229008,1.25446934252647,623,248,375,10,1.5,57.47,5.5,0,0,0,0,0,0,0.0312831143123208,11.1331006815646,4.02349252966919
9.7,"eps_greedy_SVM","SVM",41,16,1084,1073,11,1700,1451,249,0.806523027788187,0.206106870229008,1.26426988426496,619,249,370,-4,1.5,61.06,5.8,0,0,0,0,0,0,0.0136890217847946,4.21653752248046,1.79831694824721
9.7,"eps_greedy_SVM","SVM",41,17,984,978,6,1800,1546,254,0.81376949226358,0.206106870229008,1.26426988426496,644,254,390,25,1.5,64.66,6.1,0,0,0,0,0,0,0.0228018357205096,11.6594719513623,9.09024991467133
9.7,"eps_greedy_SVM","SVM",41,18,884,882,2,1900,1642,258,0.792834589467824,0.16793893129771,1.26426988426496,667,258,409,23,1.6,68.25,6.4,0,0,0,0,0,0,0.0101765280903604,3.00952083382323,1.84880603635605
9.7,"eps_greedy_SVM","SVM",41,19,784,782,2,2000,1742,258,0.810878165035506,0.198473282442748,1.26426988426496,658,258,400,-9,1.6,71.84,6.8,0,0,0,0,0,0,0.000953194127982891,0.326004939839668,0.243654019970739
9.7,"eps_greedy_SVM","SVM",41,20,684,682,2,2100,1842,258,0.82610904779763,0.236641221374046,1.27407042600345,660,258,402,2,1.6,75.43,7.1,0,0,0,0,0,0,0.00107659404752638,0.340486569449712,0.260522418682465
9.7,"eps_greedy_SVM","SVM",41,21,584,583,1,2200,1941,259,0.784825975974156,0.152671755725191,1.25446934252647,682,259,423,22,1.6,79.02,7.5,0,0,0,0,0,0,0.10623964566159,25.1514362881628,17.4093472740278
9.7,"eps_greedy_SVM","SVM",41,22,484,484,0,2300,2040,260,0.789658968558327,0.221374045801527,1.26426988426496,678,260,418,-4,1.6,82.61,7.8,0,0,0,0,0,0,0.00161513115564706,1.75194885436093,1.65498462839287
9.7,"eps_greedy_SVM","SVM",41,23,384,384,0,2400,2140,260,0.797879290112625,0.213740458015267,1.26426988426496,678,260,418,0,1.6,86.21,8.2,0,0,0,0,0,0,0.00270969796882629,0.86106911081876,0.633794101398215
9.7,"eps_greedy_SVM","SVM",41,24,284,284,0,2500,2240,260,0.781928599944348,0.206106870229008,1.27407042600345,686,260,426,8,1.6,89.8,8.6,0,0,0,0,0,0,0.000131520776047171,0.0428782537970767,0.0362007335679443
9.7,"eps_greedy_SVM","SVM",41,25,184,184,0,2600,2340,260,0.799143489674691,0.198473282442748,1.26426988426496,685,260,425,-1,1.6,93.39,9,0,0,0,0,0,0,0.000608912297391775,0.149044746361712,0.122541842163769
9.7,"eps_greedy_SVM","SVM",41,26,84,84,0,2700,2440,260,0.803516773327201,0.244274809160305,1.26426988426496,685,260,425,0,1.6,96.98,9.4,0,0,0,0,0,0,1.0000000994736e-07,0.00110818065619228,0.00110818065619228
9.7,"eps_greedy_SVM","SVM",41,27,0,0,0,2784,2524,260,0.80591209881322,0.213740458015267,1.27407042600345,679,260,419,-6,1.6,100,9.7,0,0,0,0,0,0,0,0,0
9.7,"eps_greedy_SVM","SVM",42,0,2684,2432,252,100,91,9,0.805310920275293,0.253846153846154,1.26411910669975,24,9,15,0,1.7,3.59,10.1,0,0,0,0,0,0,0.333956263968903,234.246726062803,42.0935745459345
9.7,"eps_greedy_SVM","SVM",42,1,2584,2357,227,200,166,34,0.786308544978382,0.261538461538462,1.23449131513648,84,34,50,60,1.5,7.18,4.9,0,0,0,0,0,0,0.201863070292062,377.19554760985,21.6041705457099
9.7,"eps_greedy_SVM","SVM",42,2,2484,2269,215,300,254,46,0.765722638406727,0.2,1.24436724565757,120,46,74,36,1.6,10.78,5.5,0,0,0,0,0,0,0.171125799726127,299.23924629648,19.0326604003554
9.7,"eps_greedy_SVM","SVM",42,3,2384,2191,193,400,332,68,0.788062610390404,0.176923076923077,1.24436724565757,172,68,104,52,1.5,14.37,4.9,0,0,0,0,0,0,0.171998242434588,354.230279828612,17.7165556568365
9.7,"eps_greedy_SVM","SVM",42,4,2284,2123,161,500,400,100,0.778524879712531,0.2,1.25424317617866,244,100,144,72,1.4,17.96,4,0,0,0,0,0,0,0.204196023521425,183.296734838432,21.3896880090762
9.7,"eps_greedy_SVM","SVM",42,5,2184,2050,134,600,473,127,0.793617150861809,0.246153846153846,1.27399503722084,313,127,186,69,1.5,21.55,3.7,0,0,0,0,0,0,0.207804510251439,314.544142073505,21.0023980692245
9.7,"eps_greedy_SVM","SVM",42,6,2084,1976,108,700,547,153,0.792057981606678,0.238461538461538,1.26411910669975,376,153,223,63,1.5,25.14,3.6,0,0,0,0,0,0,0.212146883603806,125.801815962934,21.8894784131966
9.7,"eps_greedy_SVM","SVM",42,7,1984,1893,91,800,630,170,0.806474206711738,0.276923076923077,1.27399503722084,421,170,251,45,1.5,28.74,3.7,0,0,0,0,0,0,0.201307683988645,90.4656864222861,21.1857236796055
9.7,"eps_greedy_SVM","SVM",42,8,1884,1820,64,900,703,197,0.786692246787261,0.192307692307692,1.25424317617866,483,197,286,62,1.5,32.33,3.6,0,0,0,0,0,0,0.208567337793221,283.984012200083,21.4494449174424
9.7,"eps_greedy_SVM","SVM",42,9,1784,1729,55,1000,794,206,0.800609050490288,0.253846153846154,1.25424317617866,511,206,305,28,1.5,35.92,3.9,0,0,0,0,0,0,0.186026773076148,247.356682574838,19.191203351159
9.7,"eps_greedy_SVM","SVM",42,10,1684,1634,50,1100,889,211,0.803696936476036,0.215384615384615,1.26411910669975,542,211,331,31,1.6,39.51,4.2,0,0,0,0,0,0,0.0873838459104773,43.4603243212697,12.1838372022218
9.7,"eps_greedy_SVM","SVM",42,11,1584,1545,39,1200,978,222,0.802825994274927,0.215384615384615,1.27399503722084,572,222,350,30,1.6,43.1,4.4,0,0,0,0,0,0,0.140254575723905,68.5288755684891,17.3055700671085
9.7,"eps_greedy_SVM","SVM",42,12,1484,1451,33,1300,1072,228,0.788641208356175,0.246153846153846,1.28387096774194,600,228,372,28,1.6,46.7,4.7,0,0,0,0,0,0,0.148567535876624,82.1915593355563,16.8181248416297
9.7,"eps_greedy_SVM","SVM",42,13,1384,1355,29,1400,1168,232,0.772824167123457,0.176923076923077,1.25424317617866,613,232,381,13,1.6,50.29,5,0,0,0,0,0,0,0.113120768307507,55.9241784192668,26.13261705723
9.7,"eps_greedy_SVM","SVM",42,14,1284,1259,25,1500,1264,236,0.796047262318048,0.253846153846154,1.28387096774194,652,236,416,39,1.8,53.88,5.4,0,0,0,0,0,0,0.0927832930004749,34.1766998592844,11.157504605879
9.7,"eps_greedy_SVM","SVM",42,15,1184,1161,23,1600,1362,238,0.788488945733604,0.176923076923077,1.28387096774194,665,238,427,13,1.8,57.47,5.7,0,0,0,0,0,0,0.0569867481361514,17.2357345796414,7.3857704351202
9.7,"eps_greedy_SVM","SVM",42,16,1084,1061,23,1700,1462,238,0.788744746939523,0.169230769230769,1.28387096774194,649,238,411,-16,1.7,61.06,6.1,0,0,0,0,0,0,0.0414520052778767,12.9928502655209,5.49107531784053
9.7,"eps_greedy_SVM","SVM",42,17,984,961,23,1800,1562,238,0.787946890797249,0.215384615384615,1.28387096774194,663,238,425,14,1.8,64.66,6.6,0,0,0,0,0,0,0.0141654008232244,4.11737995428984,2.36082049129714
9.7,"eps_greedy_SVM","SVM",42,18,884,866,18,1900,1657,243,0.751677934100738,0.192307692307692,1.26411910669975,686,243,443,23,1.8,68.25,6.8,0,0,0,0,0,0,0.105159915351618,32.0120572208697,15.1947818383523
9.7,"eps_greedy_SVM","SVM",42,19,784,774,10,2000,1749,251,0.747512028747185,0.146153846153846,1.25424317617866,688,251,437,2,1.7,71.84,7,0,0,0,0,0,0,0.0838554252266715,30.618241887851,20.5470251187443
9.7,"eps_greedy_SVM","SVM",42,20,684,681,3,2100,1842,258,0.747231865521654,0.130769230769231,1.27399503722084,726,258,468,38,1.8,75.43,7.1,0,0,0,0,0,0,0.0333583119326602,8.846367828661,5.77784145206862
9.7,"eps_greedy_SVM","SVM",42,21,584,583,1,2200,1940,260,0.815037456605154,0.238461538461538,1.26411910669975,710,260,450,-16,1.7,79.02,7.5,0,0,0,0,0,0,0.0142926710605638,5.25874217087397,3.89069944341536
9.7,"eps_greedy_SVM","SVM",42,22,484,483,1,2300,2040,260,0.760734514891286,0.153846153846154,1.26411910669975,717,260,457,7,1.8,82.61,7.8,0,0,0,0,0,0,0.0311138662914564,8.6828851402803,4.13209465526375
9.7,"eps_greedy_SVM","SVM",42,23,384,384,0,2400,2139,261,0.791814361410563,0.169230769230769,1.26411910669975,717,261,456,0,1.7,86.21,8.2,0,0,0,0,0,0,0.000916506101096499,1.08642405330434,1.04258473563489
9.7,"eps_greedy_SVM","SVM",42,24,284,284,0,2500,2239,261,0.757597904866315,0.138461538461538,1.26411910669975,711,261,450,-6,1.7,89.8,8.6,0,0,0,0,0,0,7.72700307443145e-05,0.0480605332308506,0.0458319258960275
9.7,"eps_greedy_SVM","SVM",42,25,184,184,0,2600,2339,261,0.786716608806872,0.207692307692308,1.26411910669975,732,261,471,21,1.8,93.39,9,0,0,0,0,0,0,9.86104045759046e-06,0.0125801472219963,0.0124210100757698
9.7,"eps_greedy_SVM","SVM",42,26,84,84,0,2700,2439,261,0.7976490651075,0.184615384615385,1.26411910669975,718,261,457,-14,1.8,96.98,9.3,0,0,0,0,0,0,1.0000000994736e-07,0.000373350472063496,0.000373350472063496
9.7,"eps_greedy_SVM","SVM",42,27,0,0,0,2784,2523,261,0.818100980571291,0.276923076923077,1.27399503722084,722,261,461,4,1.8,100,9.7,0,0,0,0,0,0,0,0,0
9.7,"eps_greedy_SVM","SVM",43,0,2684,2427,257,100,94,6,0.693502964426876,0.3125,1.07323588709677,17,6,11,0,1.8,3.59,15.7,0,0,0,0,0,0,0.155994664695032,158.932127789945,18.3103245129903
9.7,"eps_greedy_SVM","SVM",43,1,2584,2358,226,200,163,37,0.756169713438732,0.21875,1.14344758064516,83,37,46,66,1.2,7.18,4.4,0,0,0,0,0,0,0.231734010962652,152.481323891049,27.4286737279196
9.7,"eps_greedy_SVM","SVM",43,2,2484,2281,203,300,240,60,0.794441699604736,0.2734375,1.21365927419355,137,60,77,54,1.3,10.78,4,0,0,0,0,0,0,0.230186568480043,93.9634207945789,24.1714788261315
9.7,"eps_greedy_SVM","SVM",43,3,2384,2211,173,400,310,90,0.807256669960473,0.265625,1.21365927419355,213,90,123,76,1.4,14.37,3.4,0,0,0,0,0,0,0.232753296247537,99.7448392322213,25.3077694477433
9.7,"eps_greedy_SVM","SVM",43,4,2284,2138,146,500,383,117,0.803236166007912,0.2890625,1.21365927419355,281,117,164,68,1.4,17.96,3.3,0,0,0,0,0,0,0.167097267054918,69.287303635121,20.9051685538117
9.7,"eps_greedy_SVM","SVM",43,5,2184,2066,118,600,455,145,0.784492341897236,0.1796875,1.24375,349,145,204,68,1.4,21.55,3.1,0,0,0,0,0,0,0.282337265924085,187.051044998965,38.7604915093523
9.7,"eps_greedy_SVM","SVM",43,6,2084,1977,107,700,544,156,0.774277420948618,0.3046875,1.1835685483871,365,156,209,16,1.3,25.14,3.5,0,0,0,0,0,0,0.209316213343913,125.013759669913,24.5322533303269
9.7,"eps_greedy_SVM","SVM",43,7,1984,1894,90,800,627,173,0.774141551383397,0.265625,1.1835685483871,406,173,233,41,1.3,28.74,3.6,0,0,0,0,0,0,0.135997047033743,80.3654510736221,17.7985873018764
9.7,"eps_greedy_SVM","SVM",43,8,1884,1821,63,900,700,200,0.782861907114625,0.3515625,1.1835685483871,464,200,264,58,1.3,32.33,3.5,0,0,0,0,0,0,0.218863931630564,128.38711454719,22.3771543102193
9.7,"eps_greedy_SVM","SVM",43,9,1784,1723,61,1000,798,202,0.842582756917,0.3125,1.27384072580645,478,202,276,14,1.4,35.92,4,0,0,0,0,0,0,0.158777625637998,43.5862396175382,19.0009481105775
9.7,"eps_greedy_SVM","SVM",43,10,1684,1640,44,1100,881,219,0.839859189723322,0.3203125,1.27384072580645,538,219,319,60,1.5,39.51,4,0,0,0,0,0,0,0.174515215760573,60.3373456980371,20.5723815848182
9.7,"eps_greedy_SVM","SVM",43,11,1584,1544,40,1200,977,223,0.843274456521738,0.3203125,1.28387096774194,547,223,324,9,1.5,43.1,4.4,0,0,0,0,0,0,0.0888116473645048,24.9189583221969,12.9803092723465
9.7,"eps_greedy_SVM","SVM",43,12,1484,1453,31,1300,1068,232,0.844719614624506,0.3125,1.28387096774194,566,232,334,19,1.4,46.7,4.6,0,0,0,0,0,0,0.0949378459975706,27.7831510547103,13.6330100799319
9.7,"eps_greedy_SVM","SVM",43,13,1384,1364,20,1400,1157,243,0.827692687747039,0.25,1.27384072580645,601,243,358,35,1.5,50.29,4.8,0,0,0,0,0,0,0.121655010166157,37.7521889012409,15.1939518100261
9.7,"eps_greedy_SVM","SVM",43,14,1284,1264,20,1500,1257,243,0.836925642292493,0.3125,1.27384072580645,613,243,370,12,1.5,53.88,5.2,0,0,0,0,0,0,0.0782950988764412,23.45739578291,9.85174539727598
9.7,"eps_greedy_SVM","SVM",43,15,1184,1165,19,1600,1356,244,0.807306077075105,0.1953125,1.25378024193548,604,244,360,-9,1.5,57.47,5.6,0,0,0,0,0,0,0.109827461997441,48.4145198538704,38.912565273908
9.7,"eps_greedy_SVM","SVM",43,16,1084,1065,19,1700,1456,244,0.823919219367592,0.2578125,1.27384072580645,626,244,382,22,1.6,61.06,6,0,0,0,0,0,0,0.0216112023997701,5.98157502515213,3.8915008280132
9.7,"eps_greedy_SVM","SVM",43,17,984,966,18,1800,1555,245,0.834912302371541,0.2734375,1.26381048387097,609,245,364,-17,1.5,64.66,6.3,0,0,0,0,0,0,0.054706376545567,13.9098194275353,7.39396120132012
9.7,"eps_greedy_SVM","SVM",43,18,884,866,18,1900,1655,245,0.795899209486164,0.203125,1.27384072580645,632,245,387,23,1.6,68.25,6.8,0,0,0,0,0,0,0.0497637155482293,10.9056503801322,6.71602114762322
9.7,"eps_greedy_SVM","SVM",43,19,784,766,18,2000,1755,245,0.82633399209486,0.2421875,1.26381048387097,625,245,380,-7,1.6,71.84,7.2,0,0,0,0,0,0,0.00795570048381692,2.42970737124587,2.20147105303374
9.7,"eps_greedy_SVM","SVM",43,20,684,667,17,2100,1854,246,0.840347084980241,0.296875,1.26381048387097,624,246,378,-1,1.5,75.43,7.5,0,0,0,0,0,0,0.0106478005274134,5.85784313782946,4.58490925080504
9.7,"eps_greedy_SVM","SVM",43,21,584,572,12,2200,1949,251,0.830644762845859,0.2734375,1.25378024193548,625,251,374,1,1.5,79.02,7.8,0,0,0,0,0,0,0.0247899283498293,7.42053490022259,5.07491754446275
9.7,"eps_greedy_SVM","SVM",43,22,484,472,12,2300,2049,251,0.826889822134397,0.2265625,1.25378024193548,639,251,388,14,1.5,82.61,8.2,0,0,0,0,0,0,0.00551202671732774,1.72078920152562,1.30425929052785
9.7,"eps_greedy_SVM","SVM",43,23,384,374,10,2400,2147,253,0.808565958498026,0.203125,1.27384072580645,649,253,396,10,1.6,86.21,8.5,0,0,0,0,0,0,0.00943238859369951,3.17656287893953,2.43004289734971
9.7,"eps_greedy_SVM","SVM",43,24,284,278,6,2500,2243,257,0.845911561264824,0.328125,1.28387096774194,676,257,419,27,1.6,89.8,8.7,0,0,0,0,0,0,0.00815892744579675,3.19101290053106,2.83086186388442
9.7,"eps_greedy_SVM","SVM",43,25,184,183,1,2600,2338,262,0.825839920948618,0.296875,1.27384072580645,697,262,435,21,1.7,93.39,8.9,0,0,0,0,0,0,0.00875902223182169,5.14181601557778,4.87978636402364
9.7,"eps_greedy_SVM","SVM",43,26,84,84,0,2700,2437,263,0.820324851778659,0.21875,1.27384072580645,698,263,435,1,1.7,96.98,9.3,0,0,0,0,0,0,4.33917323395736e-07,0.46379909426284,0.46379909426284
9.7,"eps_greedy_SVM","SVM",43,27,0,0,0,2784,2521,263,0.836894762845849,0.3125,1.27384072580645,713,263,450,15,1.7,100,9.6,0,0,0,0,0,0,0,0,0
9.7,"eps_greedy_SVM","SVM",44,0,2684,2423,261,100,85,15,0.776097162686262,0.339130434782609,1.21688639551192,40,15,25,0,1.7,3.59,5.7,0,0,0,0,0,0,0.382452316419856,395.370687774786,39.6791289312108
9.7,"eps_greedy_SVM","SVM",44,1,2584,2363,221,200,145,55,0.730264679866643,0,1.25037868162693,128,55,73,88,1.3,7.18,2.6,0,0,0,0,0,0,0.370666299704661,591.765618379087,44.7066277817087
9.7,"eps_greedy_SVM","SVM",44,2,2484,2263,221,300,245,55,0.788065591617339,0.156521739130435,1.28387096774194,131,55,76,3,1.4,10.78,4.5,0,0,0,0,0,0,0.229390192091471,426.741153108724,23.8007947299055
9.7,"eps_greedy_SVM","SVM",44,3,2384,2183,201,400,325,75,0.647016397904335,0.147826086956522,1.08291725105189,178,75,103,47,1.4,14.37,4.3,0,0,0,0,0,0,0.315014683188525,393.740364390229,36.4331688631233
9.7,"eps_greedy_SVM","SVM",44,4,2284,2096,188,500,412,88,0.726998707219165,0.147826086956522,1.18339410939691,216,88,128,38,1.5,17.96,4.7,0,0,0,0,0,0,0.253314912200581,288.280829185777,53.6084058580744
9.7,"eps_greedy_SVM","SVM",44,5,2184,2009,175,600,499,101,0.804157311015865,0.208695652173913,1.2615427769986,248,101,147,32,1.5,21.55,4.9,0,0,0,0,0,0,0.234701243630352,281.377029158111,29.2276171161793
9.7,"eps_greedy_SVM","SVM",44,6,2084,1931,153,700,577,123,0.80459277403552,0.260869565217391,1.28387096774194,310,123,187,62,1.5,25.14,4.7,0,0,0,0,0,0,0.223146259958432,235.663922015656,26.975414664354
9.7,"eps_greedy_SVM","SVM",44,7,1984,1854,130,800,654,146,0.82369190991359,0.226086956521739,1.2615427769986,362,146,216,52,1.5,28.74,4.5,0,0,0,0,0,0,0.210999740215579,248.843914538712,23.7551085127449
9.7,"eps_greedy_SVM","SVM",44,8,1884,1771,113,900,737,163,0.83152344015786,0.252173913043478,1.27270687237027,414,163,251,52,1.5,32.33,4.5,0,0,0,0,0,0,0.208895818201797,209.185558657842,21.6160413618846
9.7,"eps_greedy_SVM","SVM",44,9,1784,1696,88,1000,812,188,0.84375722936654,0.243478260869565,1.27270687237027,469,188,281,55,1.5,35.92,4.3,0,0,0,0,0,0,0.215471432898976,152.47196334771,22.1410492443053
9.7,"eps_greedy_SVM","SVM",44,10,1684,1621,63,1100,887,213,0.842396407430091,0.234782608695652,1.28387096774194,531,213,318,62,1.5,39.51,4.2,0,0,0,0,0,0,0.2034468321209,148.626622436528,21.1797317548806
9.7,"eps_greedy_SVM","SVM",44,11,1584,1532,52,1200,976,224,0.856562563788533,0.269565217391304,1.28387096774194,582,224,358,51,1.6,43.1,4.4,0,0,0,0,0,0,0.182594767114993,110.223779947457,19.915611825249
9.7,"eps_greedy_SVM","SVM",44,12,1484,1444,40,1300,1064,236,0.852976797985986,0.295652173913043,1.28387096774194,587,236,351,5,1.5,46.7,4.5,0,0,0,0,0,0,0.172745819264368,117.240934169457,18.4377666891759
9.7,"eps_greedy_SVM","SVM",44,13,1384,1355,29,1400,1153,247,0.834517248418045,0.182608695652174,1.28387096774194,624,247,377,37,1.5,50.29,4.7,0,0,0,0,0,0,0.150099251063801,83.3145240092534,17.3870808101511
9.7,"eps_greedy_SVM","SVM",44,14,1284,1262,22,1500,1246,254,0.855507926787785,0.278260869565217,1.28387096774194,660,254,406,36,1.6,53.88,4.9,0,0,0,0,0,0,0.112592578392515,55.0145650238332,12.8991198295065
9.7,"eps_greedy_SVM","SVM",44,15,1184,1164,20,1600,1344,256,0.85722256242771,0.252173913043478,1.28387096774194,639,256,383,-21,1.5,57.47,5.2,0,0,0,0,0,0,0.0904574449256821,39.8679786790639,10.7575272012747
9.7,"eps_greedy_SVM","SVM",44,16,1084,1068,16,1700,1440,260,0.850329999319592,0.243478260869565,1.28387096774194,704,260,444,65,1.7,61.06,5.5,0,0,0,0,0,0,0.120701021680735,65.4296763531537,13.5731645807194
9.7,"eps_greedy_SVM","SVM",44,17,984,971,13,1800,1537,263,0.841661563584408,0.208695652173913,1.28387096774194,698,263,435,-6,1.7,64.66,5.8,0,0,0,0,0,0,0.10252214771588,50.7081582747688,11.6449656193548
9.7,"eps_greedy_SVM","SVM",44,18,884,877,7,1900,1631,269,0.847499489691781,0.226086956521739,1.27270687237027,721,269,452,23,1.7,68.25,6.1,0,0,0,0,0,0,0.102834226190983,55.8103166922671,11.9441101396879
9.7,"eps_greedy_SVM","SVM",44,19,784,779,5,2000,1729,271,0.818139756412878,0.208695652173913,1.27270687237027,741,271,470,20,1.7,71.84,6.4,0,0,0,0,0,0,0.0956147330539248,47.9724995918871,11.0264413953495
9.7,"eps_greedy_SVM","SVM",44,20,684,684,0,2100,1824,276,0.829699938763017,0.173913043478261,1.28387096774194,749,276,473,8,1.7,75.43,6.6,0,0,0,0,0,0,0.0984560145624089,37.4878334485201,12.3512397712781
9.7,"eps_greedy_SVM","SVM",44,21,584,584,0,2200,1924,276,0.824998298972583,0.191304347826087,1.28387096774194,778,276,502,29,1.8,79.02,7,0,0,0,0,0,0,0.0619293872379649,20.9458116894147,7.38225993843723
9.7,"eps_greedy_SVM","SVM",44,22,484,484,0,2300,2024,276,0.787194665578012,0.147826086956522,1.28387096774194,774,276,498,-4,1.8,82.61,7.3,0,0,0,0,0,0,0.0364718350317466,9.26965533594366,4.48756560769608
9.7,"eps_greedy_SVM","SVM",44,23,384,384,0,2400,2124,276,0.787623324487997,0.156521739130435,1.28387096774194,774,276,498,0,1.8,86.21,7.7,0,0,0,0,0,0,0.0555846152040791,14.0777200445824,6.30870532313112
9.7,"eps_greedy_SVM","SVM",44,24,284,284,0,2500,2224,276,0.831516636048176,0.226086956521739,1.28387096774194,760,276,484,-14,1.8,89.8,8.1,0,0,0,0,0,0,0.0104962671838534,2.74373033358967,2.02749081528338
9.7,"eps_greedy_SVM","SVM",44,25,184,184,0,2600,2324,276,0.766367285840652,0.156521739130435,1.28387096774194,755,276,479,-5,1.7,93.39,8.4,0,0,0,0,0,0,0.0011804704085365,0.409529061921889,0.37021833961843
9.7,"eps_greedy_SVM","SVM",44,26,84,84,0,2700,2424,276,0.752861128121388,0.147826086956522,1.28387096774194,786,276,510,31,1.8,96.98,8.8,0,0,0,0,0,0,2.41109001388708e-07,0.0566230593201534,0.0566230593201534
9.7,"eps_greedy_SVM","SVM",44,27,0,0,0,2784,2508,276,0.824903041437033,0.165217391304348,1.28387096774194,756,276,480,-30,1.7,100,9.1,0,0,0,0,0,0,0,0,0
9.7,"eps_greedy_SVM","SVM",45,0,2684,2430,254,100,92,8,0.688291139240504,0.170542635658915,1.18434608652163,28,8,20,0,2.5,3.59,11.5,0,0,0,0,0,0,0.105727759475022,209.413794092438,12.0371304990085
9.7,"eps_greedy_SVM","SVM",45,1,2584,2335,249,200,187,13,0.708713570797758,0.178294573643411,1.25401350337584,43,13,30,15,2.3,7.18,14.4,0,0,0,0,0,0,0.0920660549760946,189.465999940561,10.4968479727383
9.7,"eps_greedy_SVM","SVM",45,2,2484,2251,233,300,271,29,0.761437788244527,0.232558139534884,1.24406101525381,85,29,56,42,1.9,10.78,9.3,0,0,0,0,0,0,0.120358608409013,227.622181782213,12.9324119381972
9.7,"eps_greedy_SVM","SVM",45,3,2384,2180,204,400,342,58,0.804386223138055,0.255813953488372,1.2739184796199,149,58,91,64,1.6,14.37,5.9,0,0,0,0,0,0,0.176876434391051,268.882022231493,18.6613992165003
9.7,"eps_greedy_SVM","SVM",45,4,2284,2096,188,500,426,74,0.815603228338725,0.255813953488372,1.26396599149787,182,74,108,33,1.5,17.96,5.8,0,0,0,0,0,0,0.177616754406115,218.214070467382,19.0718734626415
9.7,"eps_greedy_SVM","SVM",45,5,2184,2028,156,600,494,106,0.820478853890682,0.271317829457364,1.28387096774194,255,106,149,73,1.4,21.55,4.7,0,0,0,0,0,0,0.193305097851452,168.086571351259,20.4971136440805
9.7,"eps_greedy_SVM","SVM",45,6,2084,1961,123,700,561,139,0.822944264547147,0.286821705426357,1.2739184796199,326,139,187,71,1.3,25.14,4,0,0,0,0,0,0,0.208708047912324,191.945123856632,21.7306747671101
9.7,"eps_greedy_SVM","SVM",45,7,1984,1898,86,800,624,176,0.823005593170438,0.286821705426357,1.2739184796199,412,176,236,86,1.3,28.74,3.5,0,0,0,0,0,0,0.223955738462127,179.025323053208,23.5216379456355
9.7,"eps_greedy_SVM","SVM",45,8,1884,1808,76,900,714,186,0.821196398783237,0.310077519379845,1.25401350337584,445,186,259,33,1.4,32.33,3.8,0,0,0,0,0,0,0.18209997539329,136.150419923195,20.5580546814403
9.7,"eps_greedy_SVM","SVM",45,9,1784,1718,66,1000,804,196,0.81643729761554,0.263565891472868,1.24406101525381,473,196,277,28,1.4,35.92,4.1,0,0,0,0,0,0,0.162180613595252,129.763567080642,17.6565634173083
9.7,"eps_greedy_SVM","SVM",45,10,1684,1629,55,1100,893,207,0.801693896575406,0.24031007751938,1.23410852713178,493,207,286,20,1.4,39.51,4.3,0,0,0,0,0,0,0.163635424187806,134.600741981488,17.4973744740233
9.7,"eps_greedy_SVM","SVM",45,11,1584,1539,45,1200,983,217,0.797155578451572,0.255813953488372,1.23410852713178,551,217,334,58,1.5,43.1,4.5,0,0,0,0,0,0,0.1659026409995,106.171820285546,18.1934726246662
9.7,"eps_greedy_SVM","SVM",45,12,1484,1445,39,1300,1077,223,0.810267638112059,0.271317829457364,1.23410852713178,560,223,337,9,1.5,46.7,4.8,0,0,0,0,0,0,0.142690376361492,91.091463136798,16.2180870369445
9.7,"eps_greedy_SVM","SVM",45,13,1384,1353,31,1400,1169,231,0.802638357374153,0.232558139534884,1.22415603900975,584,231,353,24,1.5,50.29,5.1,0,0,0,0,0,0,0.1323725087077,79.1874902149126,14.7713581909346
9.7,"eps_greedy_SVM","SVM",45,14,1284,1264,20,1500,1258,242,0.799510597586101,0.255813953488372,1.22415603900975,621,242,379,37,1.6,53.88,5.2,0,0,0,0,0,0,0.157440045918642,84.8416654880502,17.0010577157947
9.7,"eps_greedy_SVM","SVM",45,15,1184,1166,18,1600,1356,244,0.776555293886756,0.209302325581395,1.22415603900975,644,244,400,23,1.6,57.47,5.6,0,0,0,0,0,0,0.139615946358706,69.8386521946463,15.0666931142302
9.7,"eps_greedy_SVM","SVM",45,16,1084,1067,17,1700,1455,245,0.78485918948091,0.217054263565891,1.23410852713178,641,245,396,-3,1.6,61.06,5.9,0,0,0,0,0,0,0.105892334430635,40.1850846681548,11.7928844506078
9.7,"eps_greedy_SVM","SVM",45,17,984,968,16,1800,1554,246,0.802619958787165,0.263565891472868,1.23410852713178,653,246,407,12,1.7,64.66,6.3,0,0,0,0,0,0,0.068057465317518,21.3914585751086,8.55193480112376
9.7,"eps_greedy_SVM","SVM",45,18,884,869,15,1900,1653,247,0.80605436169169,0.271317829457364,1.23410852713178,648,247,401,-5,1.6,68.25,6.7,0,0,0,0,0,0,0.0318608781553294,8.30113919631541,4.42351393466752
9.7,"eps_greedy_SVM","SVM",45,19,784,772,12,2000,1750,250,0.79987243646354,0.232558139534884,1.22415603900975,654,250,404,6,1.6,71.84,7,0,0,0,0,0,0,0.0260436028392693,8.43213913879353,4.54623427499864
9.7,"eps_greedy_SVM","SVM",45,20,684,673,11,2100,1849,251,0.797952850554401,0.217054263565891,1.23410852713178,656,251,405,2,1.6,75.43,7.4,0,0,0,0,0,0,0.0355772366851515,12.3211499550095,4.82176345733539
9.7,"eps_greedy_SVM","SVM",45,21,584,575,9,2200,1947,253,0.787993082131279,0.178294573643411,1.24406101525381,657,253,404,1,1.6,79.02,7.7,0,0,0,0,0,0,0.017167476244339,5.82568130136591,3.67864190866466
9.7,"eps_greedy_SVM","SVM",45,22,484,475,9,2300,2047,253,0.764025856147572,0.209302325581395,1.23410852713178,667,253,414,10,1.6,82.61,8.1,0,0,0,0,0,0,0.00777229676211557,2.16748597435789,1.23354959430187
9.7,"eps_greedy_SVM","SVM",45,23,384,377,7,2400,2145,255,0.801148071828073,0.271317829457364,1.24406101525381,672,255,417,5,1.6,86.21,8.4,0,0,0,0,0,0,0.00761167027289083,1.92458297475284,1.08248710437192
9.7,"eps_greedy_SVM","SVM",45,24,284,278,6,2500,2244,256,0.811690462172496,0.302325581395349,1.24406101525381,680,256,424,8,1.7,89.8,8.8,0,0,0,0,0,0,0.000636598396274422,0.206972964771124,0.162000373945614
9.7,"eps_greedy_SVM","SVM",45,25,184,181,3,2600,2341,259,0.784846923756249,0.248062015503876,1.26396599149787,687,259,428,7,1.7,93.39,9,0,0,0,0,0,0,0.00606087064159506,1.39701089260548,1.11823007517826
9.7,"eps_greedy_SVM","SVM",45,26,84,84,0,2700,2438,262,0.794168874497104,0.248062015503876,1.28387096774194,725,262,463,38,1.8,96.98,9.3,0,0,0,0,0,0,4.74065290561757e-05,0.215274436681446,0.215274436681446
9.7,"eps_greedy_SVM","SVM",45,27,0,0,0,2784,2522,262,0.804987243646349,0.201550387596899,1.28387096774194,706,262,444,-19,1.7,100,9.6,0,0,0,0,0,0,0,0,0
9.7,"eps_greedy_SVM","SVM",46,0,2684,2441,243,100,90,10,0.737109532882962,0.152173913043478,1.23735390369331,31,10,21,0,2.1,3.59,9,0,0,0,0,0,0,0.111225731593695,275.388039189252,12.931796511949
9.7,"eps_greedy_SVM","SVM",46,1,2584,2363,221,200,168,32,0.674011201570534,0.260869565217391,1.14326607414525,76,32,44,45,1.4,7.18,5.2,0,0,0,0,0,0,0.274461502570209,368.490344249191,35.5943447751682
9.7,"eps_greedy_SVM","SVM",46,2,2484,2283,201,300,248,52,0.69063456319649,0.239130434782609,1.20014025245442,137,52,85,61,1.6,10.78,4.8,0,0,0,0,0,0,0.198178350041711,399.743440944641,20.480652195942
9.7,"eps_greedy_SVM","SVM",46,3,2384,2202,182,400,329,71,0.748403487499283,0.231884057971014,1.23735390369331,182,71,111,45,1.6,14.37,4.6,0,0,0,0,0,0,0.179094152298306,302.859187269152,18.6928865094011
9.7,"eps_greedy_SVM","SVM",46,4,2284,2115,169,500,416,84,0.740735608291476,0.231884057971014,1.23735390369331,208,84,124,26,1.5,17.96,5,0,0,0,0,0,0,0.166812975298527,254.620610895129,18.3586021760553
9.7,"eps_greedy_SVM","SVM",46,5,2184,2027,157,600,504,96,0.759143137594552,0.239130434782609,1.23735390369331,233,96,137,25,1.4,21.55,5.2,0,0,0,0,0,0,0.149914766307055,198.318805472475,15.5587346601251
9.7,"eps_greedy_SVM","SVM",46,6,2084,1951,133,700,580,120,0.797355505514175,0.260869565217391,1.25596072931276,288,120,168,55,1.4,25.14,4.8,0,0,0,0,0,0,0.169664168809211,214.013858255167,17.3833938284351
9.7,"eps_greedy_SVM","SVM",46,7,1984,1887,97,800,644,156,0.808897742363877,0.297101449275362,1.25596072931276,373,156,217,85,1.4,28.74,4.1,0,0,0,0,0,0,0.198272166816447,216.768852128159,20.4562056018884
9.7,"eps_greedy_SVM","SVM",46,8,1884,1818,66,900,713,187,0.808048963566024,0.318840579710145,1.24665731650304,458,187,271,85,1.4,32.33,3.8,0,0,0,0,0,0,0.198641416468223,163.905704303269,20.9383817985064
9.7,"eps_greedy_SVM","SVM",46,9,1784,1730,54,1000,801,199,0.810993706334083,0.297101449275362,1.24665731650304,485,199,286,27,1.4,35.92,4,0,0,0,0,0,0,0.184127984462695,146.967636852651,19.5634562742268
9.7,"eps_greedy_SVM","SVM",46,10,1684,1643,41,1100,888,212,0.817674230613776,0.311594202898551,1.24665731650304,512,212,300,27,1.4,39.51,4.2,0,0,0,0,0,0,0.178989963422717,155.209082218777,18.6697540056906
9.7,"eps_greedy_SVM","SVM",46,11,1584,1550,34,1200,981,219,0.82079219354466,0.297101449275362,1.23735390369331,541,219,322,29,1.5,43.1,4.5,0,0,0,0,0,0,0.152104309230478,80.0634149275045,16.5605675001579
9.7,"eps_greedy_SVM","SVM",46,12,1484,1458,26,1300,1073,227,0.827761418095731,0.311594202898551,1.24665731650304,566,227,339,25,1.5,46.7,4.7,0,0,0,0,0,0,0.128320450011557,65.717982829035,14.6586509015038
9.7,"eps_greedy_SVM","SVM",46,13,1384,1365,19,1400,1166,234,0.83124891737398,0.297101449275362,1.24665731650304,592,234,358,26,1.5,50.29,5,0,0,0,0,0,0,0.136884559576601,108.150872014942,14.6683688333083
9.7,"eps_greedy_SVM","SVM",46,14,1284,1267,17,1500,1264,236,0.831139211270857,0.318840579710145,1.23735390369331,590,236,354,-2,1.5,53.88,5.4,0,0,0,0,0,0,0.107614927014679,64.2757436331413,11.9213512171862
9.7,"eps_greedy_SVM","SVM",46,15,1184,1168,16,1600,1363,237,0.82627172469542,0.326086956521739,1.23735390369331,592,237,355,2,1.5,57.47,5.8,0,0,0,0,0,0,0.0799301792844942,34.2299085697326,10.3409715659333
9.7,"eps_greedy_SVM","SVM",46,16,1084,1069,15,1700,1462,238,0.822253016917835,0.304347826086957,1.21874707807387,604,238,366,12,1.5,61.06,6.1,0,0,0,0,0,0,0.0748693212158894,33.7018465014643,10.0037547095288
9.7,"eps_greedy_SVM","SVM",46,17,984,969,15,1800,1562,238,0.813632426814479,0.304347826086957,1.23735390369331,611,238,373,7,1.6,64.66,6.6,0,0,0,0,0,0,0.0566247328976908,22.721313744968,6.66511826042889
9.7,"eps_greedy_SVM","SVM",46,18,884,870,14,1900,1661,239,0.799740169755759,0.210144927536232,1.21874707807387,626,239,387,15,1.6,68.25,6.9,0,0,0,0,0,0,0.0380682516086018,13.4247566873035,4.84978616088375
9.7,"eps_greedy_SVM","SVM",46,19,784,770,14,2000,1761,239,0.802061319937641,0.260869565217391,1.20014025245442,608,239,369,-18,1.5,71.84,7.4,0,0,0,0,0,0,0.00651484903379869,1.77740568467526,1.09015244699568
9.7,"eps_greedy_SVM","SVM",46,20,684,671,13,2100,1860,240,0.820376465153878,0.297101449275362,1.20014025245442,633,240,393,25,1.6,75.43,7.8,0,0,0,0,0,0,0.0223112014337614,7.13203931298703,2.92360070601546
9.7,"eps_greedy_SVM","SVM",46,21,584,571,13,2200,1960,240,0.812367919625844,0.304347826086957,1.20944366526414,623,240,383,-10,1.6,79.02,8.2,0,0,0,0,0,0,0.0123720757095577,4.14794574374507,1.89186379385614
9.7,"eps_greedy_SVM","SVM",46,22,484,472,12,2300,2059,241,0.802043997921361,0.260869565217391,1.20014025245442,629,241,388,6,1.6,82.61,8.5,0,0,0,0,0,0,0.018937427489847,6.54765280273933,3.48274943296192
9.7,"eps_greedy_SVM","SVM",46,23,384,373,11,2400,2158,242,0.80842427391882,0.27536231884058,1.21874707807387,649,242,407,20,1.7,86.21,8.9,0,0,0,0,0,0,0.0103042862760398,2.64832617022941,1.52539756266518
9.7,"eps_greedy_SVM","SVM",46,24,284,273,11,2500,2258,242,0.808482013973094,0.27536231884058,1.20944366526414,649,242,407,0,1.7,89.8,9.3,0,0,0,0,0,0,0.00170556674590683,0.560300049919364,0.430338818984657
9.7,"eps_greedy_SVM","SVM",46,25,184,176,8,2600,2355,245,0.805288988971647,0.246376811594203,1.24665731650304,658,245,413,9,1.7,93.39,9.6,0,0,0,0,0,0,0.01165396479842,4.74032905949672,4.23741089221742
9.7,"eps_greedy_SVM","SVM",46,26,84,81,3,2700,2450,250,0.798868294936198,0.239130434782609,1.28387096774194,670,250,420,12,1.7,96.98,9.8,0,0,0,0,0,0,4.39530345904664e-07,0.752539666209909,0.752539666209909
9.7,"eps_greedy_SVM","SVM",46,27,0,0,0,2784,2531,253,0.83126623939027,0.268115942028986,1.28387096774194,693,253,440,23,1.7,100,10,0,0,0,0,0,0,0,0,0
9.7,"eps_greedy_SVM","SVM",47,0,2684,2418,266,100,90,10,0.739572701911955,0.217391304347826,1.21688639551192,27,10,17,0,1.7,3.59,9,0,0,0,0,0,0,0.189042816077575,287.325670790385,21.2535804457923
9.7,"eps_greedy_SVM","SVM",47,1,2584,2350,234,200,158,42,0.80511669048106,0.304347826086957,1.2615427769986,103,42,61,76,1.5,7.18,3.8,0,0,0,0,0,0,0.25957961151089,398.445995799392,30.1509413838011
9.7,"eps_greedy_SVM","SVM",47,2,2484,2277,207,300,231,69,0.764795536504055,0.11304347826087,1.27270687237027,167,69,98,64,1.4,10.78,3.3,0,0,0,0,0,0,0.26150861178155,462.049166405519,33.0527531710095
9.7,"eps_greedy_SVM","SVM",47,3,2384,2193,191,400,315,85,0.807246376811599,0.208695652173913,1.28387096774194,203,85,118,36,1.4,14.37,3.7,0,0,0,0,0,0,0.218745288986395,377.209917738332,22.7731858001591
9.7,"eps_greedy_SVM","SVM",47,4,2284,2107,177,500,401,99,0.784704361434309,0.2,1.28387096774194,242,99,143,39,1.4,17.96,4.1,0,0,0,0,0,0,0.199194707173917,389.984443930819,20.8310420758141
9.7,"eps_greedy_SVM","SVM",47,5,2184,2014,170,600,494,106,0.816431924882631,0.252173913043478,1.28387096774194,259,106,153,17,1.4,21.55,4.7,0,0,0,0,0,0,0.1702820461937,200.52890869958,17.6931436245107
9.7,"eps_greedy_SVM","SVM",47,6,2084,1938,146,700,570,130,0.825399741443834,0.260869565217391,1.28387096774194,314,130,184,55,1.4,25.14,4.4,0,0,0,0,0,0,0.182313604918538,238.231168378141,18.8533249658107
9.7,"eps_greedy_SVM","SVM",47,7,1984,1860,124,800,648,152,0.83857930189835,0.260869565217391,1.28387096774194,368,152,216,54,1.4,28.74,4.3,0,0,0,0,0,0,0.183048859679768,231.164945008547,18.8775727632306
9.7,"eps_greedy_SVM","SVM",47,8,1884,1797,87,900,711,189,0.84103558549364,0.252173913043478,1.28387096774194,449,189,260,81,1.4,32.33,3.8,0,0,0,0,0,0,0.199294440269509,207.663924474872,20.6058836949403
9.7,"eps_greedy_SVM","SVM",47,9,1784,1716,68,1000,792,208,0.842988364972446,0.252173913043478,1.28387096774194,495,208,287,46,1.4,35.92,3.8,0,0,0,0,0,0,0.192867483623368,185.682297405484,19.9131571532689
9.7,"eps_greedy_SVM","SVM",47,10,1684,1635,49,1100,873,227,0.83694631557461,0.234782608695652,1.28387096774194,548,227,321,53,1.4,39.51,3.8,0,0,0,0,0,0,0.195129394645996,206.156151840504,20.0928831945943
9.7,"eps_greedy_SVM","SVM",47,11,1584,1549,35,1200,959,241,0.843614343063213,0.260869565217391,1.28387096774194,582,241,341,34,1.4,43.1,4,0,0,0,0,0,0,0.177730227174107,176.458720682674,18.8832323561642
9.7,"eps_greedy_SVM","SVM",47,12,1484,1459,25,1300,1049,251,0.838572497788666,0.226086956521739,1.28387096774194,629,251,378,47,1.5,46.7,4.2,0,0,0,0,0,0,0.147468563760676,108.882263560237,16.0621276406876
9.7,"eps_greedy_SVM","SVM",47,13,1384,1372,12,1400,1136,264,0.839552289582911,0.252173913043478,1.28387096774194,674,264,410,45,1.6,50.29,4.3,0,0,0,0,0,0,0.175136739023117,155.938667195725,18.3308071543786
9.7,"eps_greedy_SVM","SVM",47,14,1284,1275,9,1500,1233,267,0.838422807375657,0.252173913043478,1.28387096774194,681,267,414,7,1.6,53.88,4.6,0,0,0,0,0,0,0.160605705791013,138.35355958749,16.6735914182938
9.7,"eps_greedy_SVM","SVM",47,15,1184,1176,8,1600,1332,268,0.829550248350006,0.234782608695652,1.28387096774194,684,268,416,3,1.6,57.47,5,0,0,0,0,0,0,0.136165291024166,100.463158895351,14.4647335237033
9.7,"eps_greedy_SVM","SVM",47,16,1084,1077,7,1700,1431,269,0.80961420698102,0.243478260869565,1.28387096774194,705,269,436,21,1.6,61.06,5.3,0,0,0,0,0,0,0.15382093711338,112.971487402716,16.2396534860678
9.7,"eps_greedy_SVM","SVM",47,17,984,977,7,1800,1531,269,0.818582023542223,0.217391304347826,1.28387096774194,687,269,418,-18,1.6,64.66,5.7,0,0,0,0,0,0,0.125982312743126,81.6631470804286,13.4254626958053
9.7,"eps_greedy_SVM","SVM",47,18,884,878,6,1900,1630,270,0.838817445737229,0.260869565217391,1.28387096774194,708,270,438,21,1.6,68.25,6,0,0,0,0,0,0,0.109580230033821,58.847361236125,12.6775704194356
9.7,"eps_greedy_SVM","SVM",47,19,784,780,4,2000,1728,272,0.807940395999186,0.234782608695652,1.28387096774194,719,272,447,11,1.6,71.84,6.4,0,0,0,0,0,0,0.101866310311999,52.158188369033,11.248561325136
9.7,"eps_greedy_SVM","SVM",47,20,684,682,2,2100,1826,274,0.796584336939514,0.182608695652174,1.28387096774194,726,274,452,7,1.6,75.43,6.7,0,0,0,0,0,0,0.0609181940125948,20.179205101857,8.16294723541965
9.7,"eps_greedy_SVM","SVM",47,21,584,582,2,2200,1926,274,0.821276450976393,0.234782608695652,1.28387096774194,708,274,434,-18,1.6,79.02,7,0,0,0,0,0,0,0.0620085895439454,22.140802692869,7.35117701652862
9.7,"eps_greedy_SVM","SVM",47,22,484,482,2,2300,2026,274,0.811791522079337,0.226086956521739,1.28387096774194,715,274,441,7,1.6,82.61,7.4,0,0,0,0,0,0,0.0181084522720509,4.92558929296929,2.6715003806032
9.7,"eps_greedy_SVM","SVM",47,23,384,383,1,2400,2125,275,0.782111995645371,0.165217391304348,1.28387096774194,749,275,474,34,1.7,86.21,7.7,0,0,0,0,0,0,0.0881021671449563,24.0653923884994,11.0929989942941
9.7,"eps_greedy_SVM","SVM",47,24,284,283,1,2500,2225,275,0.787160645029599,0.173913043478261,1.28387096774194,744,275,469,-5,1.7,89.8,8.1,0,0,0,0,0,0,0.0334981647696948,8.2022416213523,4.90861271491588
9.7,"eps_greedy_SVM","SVM",47,25,184,184,0,2600,2324,276,0.792447438252705,0.208695652173913,1.28387096774194,761,276,485,17,1.8,93.39,8.4,0,0,0,0,0,0,0.00926227326874637,2.87066400997802,2.53652289179153
9.7,"eps_greedy_SVM","SVM",47,26,84,84,0,2700,2424,276,0.831026740151052,0.243478260869565,1.28387096774194,759,276,483,-2,1.8,96.98,8.8,0,0,0,0,0,0,9.00046649487699e-08,0.115280087596646,0.115280087596646
9.7,"eps_greedy_SVM","SVM",47,27,0,0,0,2784,2508,276,0.786425801183916,0.191304347826087,1.28387096774194,771,276,495,12,1.8,100,9.1,0,0,0,0,0,0,0,0,0
9.7,"eps_greedy_SVM","SVM",48,0,2684,2433,251,100,90,10,0.727035751263784,0.161538461538462,1.18511166253102,31,10,21,0,2.1,3.59,9,0,0,0,0,0,0,0.218589558783406,281.898055738114,31.1060903501541
9.7,"eps_greedy_SVM","SVM",48,1,2584,2342,242,200,181,19,0.766593580607834,0.146153846153846,1.27399503722084,70,19,51,39,2.7,7.18,9.5,0,0,0,0,0,0,0.113327024716623,224.193102724863,11.743306459731
9.7,"eps_greedy_SVM","SVM",48,2,2484,2260,224,300,263,37,0.766794567269628,0.238461538461538,1.26411910669975,113,37,76,43,2.1,10.78,7.1,0,0,0,0,0,0,0.138999648106103,276.842910776923,14.2594480972288
9.7,"eps_greedy_SVM","SVM",48,3,2384,2198,186,400,325,75,0.74969242950241,0.223076923076923,1.2048635235732,189,75,114,76,1.5,14.37,4.3,0,0,0,0,0,0,0.204250089959798,359.749809411161,22.5613917437485
9.7,"eps_greedy_SVM","SVM",48,4,2284,2119,165,500,404,96,0.613496558864734,0.130769230769231,1.11392682754228,224,96,128,35,1.3,17.96,4.2,0,0,0,0,0,0,0.257856969997609,285.893093288861,33.7717271305226
9.7,"eps_greedy_SVM","SVM",48,5,2184,2026,158,600,497,103,0.77566234240819,0.269230769230769,1.22461538461538,243,103,140,19,1.4,21.55,4.8,0,0,0,0,0,0,0.205719823377309,210.178703012776,21.5318964143628
9.7,"eps_greedy_SVM","SVM",48,6,2084,1952,132,700,571,129,0.781740666301241,0.276923076923077,1.22461538461538,296,129,167,53,1.3,25.14,4.4,0,0,0,0,0,0,0.215493152626328,157.104699042936,22.4461107352479
9.7,"eps_greedy_SVM","SVM",48,7,1984,1886,98,800,637,163,0.784767647237961,0.330769230769231,1.19498759305211,371,163,208,75,1.3,28.74,3.9,0,0,0,0,0,0,0.214483831042085,130.496328603119,22.666366581807
9.7,"eps_greedy_SVM","SVM",48,8,1884,1809,75,900,714,186,0.787770266155069,0.338461538461538,1.2048635235732,427,186,241,56,1.3,32.33,3.8,0,0,0,0,0,0,0.220925196042085,123.313752111513,23.1235375893749
9.7,"eps_greedy_SVM","SVM",48,9,1784,1719,65,1000,804,196,0.774687861623734,0.261538461538462,1.19498759305211,451,196,255,24,1.3,35.92,4.1,0,0,0,0,0,0,0.182046115303934,109.181731236783,20.1654200772681
9.7,"eps_greedy_SVM","SVM",48,10,1684,1627,57,1100,896,204,0.766203788294055,0.292307692307692,1.19498759305211,496,204,292,45,1.4,39.51,4.4,0,0,0,0,0,0,0.136511440901324,71.6260010812202,16.3807925021548
9.7,"eps_greedy_SVM","SVM",48,11,1584,1530,54,1200,993,207,0.75090443997808,0.269230769230769,1.18511166253102,503,207,296,7,1.4,43.1,4.8,0,0,0,0,0,0,0.110662659334947,78.0891003790514,13.3001678976062
9.7,"eps_greedy_SVM","SVM",48,12,1484,1435,49,1300,1088,212,0.77962726109995,0.246153846153846,1.2048635235732,508,212,296,5,1.4,46.7,5.1,0,0,0,0,0,0,0.119568781727509,67.2247399771762,14.3194601360616
9.7,"eps_greedy_SVM","SVM",48,13,1384,1346,38,1400,1177,223,0.772787624094041,0.223076923076923,1.2048635235732,542,223,319,34,1.4,50.29,5.3,0,0,0,0,0,0,0.161124625199387,64.096208595436,18.2890760180879
9.7,"eps_greedy_SVM","SVM",48,14,1284,1254,30,1500,1269,231,0.778975577075343,0.230769230769231,1.2048635235732,572,231,341,30,1.5,53.88,5.5,0,0,0,0,0,0,0.139303278335473,51.1637457577725,15.1883868031441
9.7,"eps_greedy_SVM","SVM",48,15,1184,1166,18,1600,1357,243,0.789372068944519,0.246153846153846,1.2048635235732,600,243,357,28,1.5,57.47,5.6,0,0,0,0,0,0,0.119180117261538,50.9842810325631,13.7909605905822
9.7,"eps_greedy_SVM","SVM",48,16,1084,1069,15,1700,1454,246,0.782879590718075,0.261538461538462,1.2048635235732,605,246,359,5,1.5,61.06,5.9,0,0,0,0,0,0,0.108623138565881,42.1009839205989,12.0850388870641
9.7,"eps_greedy_SVM","SVM",48,17,984,970,14,1800,1553,247,0.782270540227789,0.269230769230769,1.2048635235732,607,247,360,2,1.5,64.66,6.3,0,0,0,0,0,0,0.0590223034294408,19.6442379573483,6.94005834852474
9.7,"eps_greedy_SVM","SVM",48,18,884,870,14,1900,1653,247,0.790462269322131,0.238461538461538,1.2048635235732,607,247,360,0,1.5,68.25,6.7,0,0,0,0,0,0,0.0283592480187327,9.61256975222878,4.13340857248412
9.7,"eps_greedy_SVM","SVM",48,19,784,770,14,2000,1753,247,0.777982824776178,0.230769230769231,1.2048635235732,616,247,369,9,1.5,71.84,7.1,0,0,0,0,0,0,0.0248431954632786,8.10883680211997,3.52905797585761
9.7,"eps_greedy_SVM","SVM",48,20,684,670,14,2100,1853,247,0.785096534502714,0.230769230769231,1.2048635235732,597,247,350,-19,1.4,75.43,7.5,0,0,0,0,0,0,0.00829884179124989,2.54394469454214,1.31253034984351
9.7,"eps_greedy_SVM","SVM",48,21,584,571,13,2200,1952,248,0.80116328643645,0.276923076923077,1.2048635235732,610,248,362,13,1.5,79.02,7.9,0,0,0,0,0,0,0.00865037233671097,2.45585536464501,1.37135191810839
9.7,"eps_greedy_SVM","SVM",48,22,484,472,12,2300,2051,249,0.785224435105674,0.223076923076923,1.2048635235732,615,249,366,5,1.5,82.61,8.2,0,0,0,0,0,0,0.00297116597231684,0.845937119665347,0.534466687738395
9.7,"eps_greedy_SVM","SVM",48,23,384,377,7,2400,2146,254,0.801175467446255,0.238461538461538,1.22348774613968,629,254,375,14,1.5,86.21,8.4,0,0,0,0,0,0,0.0169522713064843,5.06481666046522,2.78995264390011
9.7,"eps_greedy_SVM","SVM",48,24,284,280,4,2500,2243,257,0.78973749923869,0.238461538461538,1.25424317617866,654,257,397,25,1.5,89.8,8.7,0,0,0,0,0,0,0.0198631217057529,5.21960136227086,3.57795639594191
9.7,"eps_greedy_SVM","SVM",48,25,184,183,1,2600,2340,260,0.801187648456059,0.253846153846154,1.28387096774194,651,260,391,-3,1.5,93.39,9,0,0,0,0,0,0,0.00247656287942584,0.936546177776069,0.831092055673251
9.7,"eps_greedy_SVM","SVM",48,26,84,84,0,2700,2439,261,0.772288202692005,0.2,1.27399503722084,675,261,414,24,1.6,96.98,9.3,0,0,0,0,0,0,4.57693615874707e-05,2.01817284118597,2.01817284118597
9.7,"eps_greedy_SVM","SVM",48,27,0,0,0,2784,2523,261,0.808782508069921,0.238461538461538,1.27399503722084,676,261,415,1,1.6,100,9.7,0,0,0,0,0,0,0,0,0
9.7,"eps_greedy_SVM","SVM",49,0,2684,2429,255,100,91,9,0.816957122065906,0.409448818897638,1.22321564643129,36,9,27,0,3,3.59,10.1,0,0,0,0,0,0,0.116513086902038,247.608142451059,11.9244095099573
9.7,"eps_greedy_SVM","SVM",49,1,2584,2371,213,200,149,51,0.648816409797119,0.165354330708661,1.12212344424689,121,51,70,85,1.4,7.18,2.9,0,0,0,0,0,0,0.271759419077579,577.385441959989,29.7039078959773
9.7,"eps_greedy_SVM","SVM",49,2,2484,2286,198,300,234,66,0.766839571593836,0.141732283464567,1.28387096774194,153,66,87,32,1.3,10.78,3.5,0,0,0,0,0,0,0.260789591217596,452.249619282338,28.2054899210933
9.7,"eps_greedy_SVM","SVM",49,3,2384,2201,183,400,319,81,0.769022651789381,0.141732283464567,1.28387096774194,196,81,115,43,1.4,14.37,3.9,0,0,0,0,0,0,0.215642606126021,342.498524938599,23.4713930819654
9.7,"eps_greedy_SVM","SVM",49,4,2284,2114,170,500,406,94,0.791941884041746,0.173228346456693,1.2737617475235,223,94,129,27,1.4,17.96,4.3,0,0,0,0,0,0,0.203215597564639,242.15498278421,22.7362912870076
9.7,"eps_greedy_SVM","SVM",49,5,2184,2037,147,600,483,117,0.82032192658382,0.244094488188976,1.2737617475235,285,117,168,62,1.4,21.55,4.1,0,0,0,0,0,0,0.200861721163679,213.940757243298,21.1255843811364
9.7,"eps_greedy_SVM","SVM",49,6,2084,1965,119,700,555,145,0.830372802925699,0.267716535433071,1.26365252730505,345,145,200,60,1.4,25.14,3.8,0,0,0,0,0,0,0.198236952246671,194.018097770129,21.1437973075362
9.7,"eps_greedy_SVM","SVM",49,7,1984,1878,106,800,642,158,0.833513701782535,0.267716535433071,1.26365252730505,369,158,211,24,1.3,28.74,4.1,0,0,0,0,0,0,0.183789894565729,153.568296132763,19.3882323951127
9.7,"eps_greedy_SVM","SVM",49,8,1884,1794,90,900,726,174,0.84192882287818,0.283464566929134,1.26365252730505,402,174,228,33,1.3,32.33,4.2,0,0,0,0,0,0,0.182137994235077,150.202988963375,19.2501202147819
9.7,"eps_greedy_SVM","SVM",49,9,1784,1707,77,1000,813,187,0.84578497593014,0.267716535433071,1.26365252730505,436,187,249,34,1.3,35.92,4.3,0,0,0,0,0,0,0.1815827954698,148.290331928006,18.8918252796651
9.7,"eps_greedy_SVM","SVM",49,10,1684,1622,62,1100,898,202,0.839011829682425,0.259842519685039,1.26365252730505,482,202,280,46,1.4,39.51,4.4,0,0,0,0,0,0,0.161214444414244,106.412232457226,17.0689577591766
9.7,"eps_greedy_SVM","SVM",49,11,1584,1530,54,1200,990,210,0.839795499496211,0.259842519685039,1.26365252730505,500,210,290,18,1.4,43.1,4.7,0,0,0,0,0,0,0.160518683289994,109.692667997108,16.5062812851266
9.7,"eps_greedy_SVM","SVM",49,12,1484,1437,47,1300,1083,217,0.839540495826643,0.236220472440945,1.26365252730505,547,217,330,47,1.5,46.7,5,0,0,0,0,0,0,0.147523049026951,73.1516231035709,15.7715820431647
9.7,"eps_greedy_SVM","SVM",49,13,1384,1348,36,1400,1172,228,0.823108308143941,0.236220472440945,1.26365252730505,566,228,338,19,1.5,50.29,5.1,0,0,0,0,0,0,0.150430650562336,72.161060913157,15.8657144513005
9.7,"eps_greedy_SVM","SVM",49,14,1284,1254,30,1500,1266,234,0.809431404012882,0.196850393700787,1.26365252730505,610,234,376,44,1.6,53.88,5.4,0,0,0,0,0,0,0.138173027578695,62.3836650143683,14.8738619612597
9.7,"eps_greedy_SVM","SVM",49,15,1184,1155,29,1600,1365,235,0.796258287619255,0.196850393700787,1.26365252730505,597,235,362,-13,1.5,57.47,5.8,0,0,0,0,0,0,0.128015998755051,49.493151533821,13.6952204081009
9.7,"eps_greedy_SVM","SVM",49,16,1084,1055,29,1700,1465,235,0.789174161286704,0.181102362204724,1.26365252730505,596,235,361,-1,1.5,61.06,6.2,0,0,0,0,0,0,0.102850706032052,29.6913400714633,11.4862298111172
9.7,"eps_greedy_SVM","SVM",49,17,984,956,28,1800,1564,236,0.843489942904052,0.267716535433071,1.26365252730505,593,236,357,-3,1.5,64.66,6.6,0,0,0,0,0,0,0.0667127796367415,14.6303212625712,7.84066156031404
9.7,"eps_greedy_SVM","SVM",49,18,884,857,27,1900,1663,237,0.814643430234722,0.236220472440945,1.26365252730505,612,237,375,19,1.6,68.25,7,0,0,0,0,0,0,0.021305689163688,5.17832147881784,4.24769427206986
9.7,"eps_greedy_SVM","SVM",49,19,784,761,23,2000,1759,241,0.834459081240435,0.236220472440945,1.26365252730505,613,241,372,1,1.5,71.84,7.3,0,0,0,0,0,0,0.00120590537682575,0.847349461136182,0.771855871159193
9.7,"eps_greedy_SVM","SVM",49,20,684,667,17,2100,1853,247,0.811881927081393,0.220472440944882,1.26365252730505,628,247,381,15,1.5,75.43,7.5,0,0,0,0,0,0,0.0127694731103289,4.17558255947826,2.41061362174872
9.7,"eps_greedy_SVM","SVM",49,21,584,575,9,2200,1945,255,0.821055839584034,0.236220472440945,1.28387096774194,667,255,412,39,1.6,79.02,7.6,0,0,0,0,0,0,0.0600731725148857,16.922169224326,9.83155779153207
9.7,"eps_greedy_SVM","SVM",49,22,484,480,4,2300,2040,260,0.828867659315098,0.259842519685039,1.28387096774194,711,260,451,44,1.7,82.61,7.8,0,0,0,0,0,0,0.0444959073111365,10.9831744055162,7.56793488398971
9.7,"eps_greedy_SVM","SVM",49,23,384,382,2,2400,2138,262,0.805693423393165,0.228346456692913,1.28387096774194,718,262,456,7,1.7,86.21,8.2,0,0,0,0,0,0,0.0188812986341102,4.84941288258494,3.69791504941728
9.7,"eps_greedy_SVM","SVM",49,24,284,283,1,2500,2237,263,0.807590401910662,0.244094488188976,1.28387096774194,702,263,439,-16,1.7,89.8,8.5,0,0,0,0,0,0,0.0595106245541219,15.0256691908993,10.6377426696826
9.7,"eps_greedy_SVM","SVM",49,25,184,183,1,2600,2337,263,0.774844198977498,0.133858267716535,1.28387096774194,706,263,443,4,1.7,93.39,8.9,0,0,0,0,0,0,0.016740238778038,4.62274258481533,4.04496136268644
9.7,"eps_greedy_SVM","SVM",49,26,84,84,0,2700,2436,264,0.80706795536814,0.251968503937008,1.28268876611418,707,264,443,1,1.7,96.98,9.2,0,0,0,0,0,0,4.25802908473176e-06,1.56739576993154,1.56739576993154
9.7,"eps_greedy_SVM","SVM",49,27,0,0,0,2784,2520,264,0.815439539251907,0.244094488188976,1.28268876611418,697,264,433,-10,1.6,100,9.5,0,0,0,0,0,0,0,0,0
9.7,"eps_greedy_SVM","SVM",50,0,2684,2444,240,100,95,5,0.74104975228219,0.273972602739726,1.13437914273089,17,5,12,0,2.4,3.59,19,0,0,0,0,0,0,0.110065147574643,152.015886393198,16.386038047989
9.7,"eps_greedy_SVM","SVM",50,1,2584,2364,220,200,175,25,0.730317144708942,0.178082191780822,1.25749005744587,81,25,56,64,2.2,7.18,7,0,0,0,0,0,0,0.144159733189535,275.75254937386,49.7497079812103
9.7,"eps_greedy_SVM","SVM",50,2,2484,2275,209,300,264,36,0.799941778075589,0.280821917808219,1.26628369421122,106,36,70,25,1.9,10.78,7.3,0,0,0,0,0,0,0.173016498372858,213.169564290762,18.8199221432477
9.7,"eps_greedy_SVM","SVM",50,3,2384,2192,192,400,347,53,0.813074666871711,0.315068493150685,1.26628369421122,155,53,102,49,1.9,14.37,6.5,0,0,0,0,0,0,0.140534062710268,248.838116996396,14.3237716972237
9.7,"eps_greedy_SVM","SVM",50,4,2284,2116,168,500,423,77,0.792213641506725,0.294520547945205,1.26628369421122,214,77,137,59,1.8,17.96,5.5,0,0,0,0,0,0,0.169169900648008,188.805788483444,17.5926859242136
9.7,"eps_greedy_SVM","SVM",50,5,2184,2040,144,600,499,101,0.793779042304256,0.267123287671233,1.26628369421122,277,101,176,63,1.7,21.55,4.9,0,0,0,0,0,0,0.184619048032282,209.390827852327,18.9718188914942
9.7,"eps_greedy_SVM","SVM",50,6,2084,1971,113,700,568,132,0.817941140929998,0.253424657534247,1.26628369421122,351,132,219,74,1.7,25.14,4.3,0,0,0,0,0,0,0.204128488095761,151.387969065303,21.3059768928076
9.7,"eps_greedy_SVM","SVM",50,7,1984,1900,84,800,639,161,0.828975843394002,0.294520547945205,1.26628369421122,409,161,248,58,1.5,28.74,4,0,0,0,0,0,0,0.212132859911622,158.284022517914,21.7920378969003
9.7,"eps_greedy_SVM","SVM",50,8,1884,1825,59,900,714,186,0.833265590842679,0.301369863013699,1.26628369421122,482,186,296,73,1.6,32.33,3.8,0,0,0,0,0,0,0.207349855694224,203.366092307281,21.5132606122888
9.7,"eps_greedy_SVM","SVM",50,9,1784,1741,43,1000,798,202,0.83204073337654,0.294520547945205,1.26628369421122,509,202,307,27,1.5,35.92,4,0,0,0,0,0,0,0.177744498263701,115.045873251134,19.2919789251209
9.7,"eps_greedy_SVM","SVM",50,10,1684,1651,33,1100,888,212,0.81876503608661,0.246575342465753,1.25749005744587,555,212,343,46,1.6,39.51,4.2,0,0,0,0,0,0,0.186808474280273,93.3367434727159,20.4931593522014
9.7,"eps_greedy_SVM","SVM",50,11,1584,1556,28,1200,983,217,0.812201338005735,0.273972602739726,1.25749005744587,575,217,358,20,1.6,43.1,4.5,0,0,0,0,0,0,0.165073458204518,68.1322745222104,18.4926551159299
9.7,"eps_greedy_SVM","SVM",50,12,1484,1459,25,1300,1080,220,0.825603365886351,0.315068493150685,1.25749005744587,577,220,357,2,1.6,46.7,4.9,0,0,0,0,0,0,0.121700829018367,42.4859988886404,13.7140076167865
9.7,"eps_greedy_SVM","SVM",50,13,1384,1360,24,1400,1179,221,0.821895837681672,0.294520547945205,1.25749005744587,581,221,360,4,1.6,50.29,5.3,0,0,0,0,0,0,0.0933166220426805,39.4325213456859,10.957976597713
9.7,"eps_greedy_SVM","SVM",50,14,1284,1264,20,1500,1275,225,0.764239654623147,0.226027397260274,1.25749005744587,627,225,402,46,1.8,53.88,5.7,0,0,0,0,0,0,0.164682725547547,68.9046825310047,18.4815687153889
9.7,"eps_greedy_SVM","SVM",50,15,1184,1166,18,1600,1373,227,0.802160802364032,0.273972602739726,1.25749005744587,607,227,380,-20,1.7,57.47,6,0,0,0,0,0,0,0.127237669627743,63.3103211359039,14.6504189332776
9.7,"eps_greedy_SVM","SVM",50,16,1084,1068,16,1700,1471,229,0.78209620898375,0.232876712328767,1.25749005744587,642,229,413,35,1.8,61.06,6.4,0,0,0,0,0,0,0.10443904928546,31.8915183862265,12.3572328199683
9.7,"eps_greedy_SVM","SVM",50,17,984,973,11,1800,1566,234,0.787039579923316,0.23972602739726,1.25517636828773,637,234,403,-5,1.7,64.66,6.7,0,0,0,0,0,0,0.0195448161176198,6.0934286387378,4.78115248025888
9.7,"eps_greedy_SVM","SVM",50,18,884,873,11,1900,1666,234,0.793257242038425,0.246575342465753,1.25749005744587,647,234,413,10,1.8,68.25,7.1,0,0,0,0,0,0,0.0222354730745667,6.04082699183472,3.9658401309019
9.7,"eps_greedy_SVM","SVM",50,19,784,775,9,2000,1764,236,0.800183453988198,0.246575342465753,1.26628369421122,651,236,415,4,1.8,71.84,7.5,0,0,0,0,0,0,0.0434737045295215,14.3300517712526,7.48042518280116
9.7,"eps_greedy_SVM","SVM",50,20,684,678,6,2100,1861,239,0.779684942492112,0.267123287671233,1.27507733097658,708,239,469,57,2,75.43,7.8,0,0,0,0,0,0,0.0954143346716975,27.02449070712,12.7990987643022
9.7,"eps_greedy_SVM","SVM",50,21,584,583,1,2200,1956,244,0.776691456756485,0.212328767123288,1.25749005744587,689,244,445,-19,1.8,79.02,8,0,0,0,0,0,0,0.0579667868224214,13.4045628360465,8.29294227773529
9.7,"eps_greedy_SVM","SVM",50,22,484,484,0,2300,2055,245,0.769523568894101,0.184931506849315,1.26628369421122,723,245,478,34,2,82.61,8.4,0,0,0,0,0,0,0.00555806981345351,3.11114985841321,2.74775297813573
9.7,"eps_greedy_SVM","SVM",50,23,384,384,0,2400,2155,245,0.798920148081422,0.315068493150685,1.25749005744587,698,245,453,-25,1.8,86.21,8.8,0,0,0,0,0,0,0.00207286071663459,0.731752081309482,0.620367569244943
9.7,"eps_greedy_SVM","SVM",50,24,284,284,0,2500,2255,245,0.807730333622597,0.280821917808219,1.26628369421122,700,245,455,2,1.9,89.8,9.2,0,0,0,0,0,0,0.000129683756151695,0.111560403140327,0.107372237862909
9.7,"eps_greedy_SVM","SVM",50,25,184,184,0,2600,2355,245,0.781211894848998,0.184931506849315,1.26628369421122,686,245,441,-14,1.8,93.39,9.6,0,0,0,0,0,0,1.54209502236173e-07,0.00066637228322372,0.000657524371500082
9.7,"eps_greedy_SVM","SVM",50,26,84,84,0,2700,2455,245,0.7685568652437,0.226027397260274,1.26628369421122,682,245,437,-4,1.8,96.98,10,0,0,0,0,0,0,1.0000000994736e-07,0.000602288618535805,0.000602288618535805
9.7,"eps_greedy_SVM","SVM",50,27,0,0,0,2784,2539,245,0.727395063220215,0.171232876712329,1.26628369421122,689,245,444,7,1.8,100,10.4,0,0,0,0,0,0,0,0,0
9.7,"eps_greedy_SVM","SVM",51,0,2684,2433,251,100,91,9,0.778190440473737,0.297709923664122,1.2348682590495,31,9,22,0,2.4,3.59,10.1,0,0,0,0,0,0,0.106481288983141,257.439326638764,10.9947105225871
9.7,"eps_greedy_SVM","SVM",51,1,2584,2367,217,200,157,43,0.72138614340499,0.213740458015267,1.28387096774194,107,43,64,76,1.5,7.18,3.7,0,0,0,0,0,0,0.288273627431952,448.554484474303,34.547578896696
9.7,"eps_greedy_SVM","SVM",51,2,2484,2290,194,300,234,66,0.746942330724279,0.190839694656489,1.24466880078798,168,66,102,61,1.5,10.78,3.5,0,0,0,0,0,0,0.241451591634337,478.760523688243,25.1182423390604
9.7,"eps_greedy_SVM","SVM",51,3,2384,2195,189,400,329,71,0.770006411729824,0.259541984732824,1.20546663383403,191,71,120,23,1.7,14.37,4.6,0,0,0,0,0,0,0.198882550879318,337.282740113725,20.6031794498116
9.7,"eps_greedy_SVM","SVM",51,4,2284,2119,165,500,405,95,0.760709403467163,0.282442748091603,1.21526717557252,248,95,153,57,1.6,17.96,4.3,0,0,0,0,0,0,0.199124020495526,234.996811250794,21.3151016422657
9.7,"eps_greedy_SVM","SVM",51,5,2184,2042,142,600,482,118,0.773932084054137,0.290076335877863,1.21526717557252,306,118,188,58,1.6,21.55,4.1,0,0,0,0,0,0,0.197398522445728,285.118896666728,20.0928896084455
9.7,"eps_greedy_SVM","SVM",51,6,2084,1960,124,700,564,136,0.759209300637534,0.282442748091603,1.21526717557252,359,136,223,53,1.6,25.14,4.1,0,0,0,0,0,0,0.194623388380333,208.949297155168,20.172583718768
9.7,"eps_greedy_SVM","SVM",51,7,1984,1891,93,800,633,167,0.780482936330301,0.274809160305344,1.20546663383403,444,167,277,85,1.7,28.74,3.8,0,0,0,0,0,0,0.20498774725326,202.458830441488,21.5590890463126
9.7,"eps_greedy_SVM","SVM",51,8,1884,1806,78,900,718,182,0.777482730671045,0.312977099236641,1.22506771731101,471,182,289,27,1.6,32.33,3.9,0,0,0,0,0,0,0.196862529912088,171.327190139866,20.3799282211714
9.7,"eps_greedy_SVM","SVM",51,9,1784,1713,71,1000,811,189,0.803589358947984,0.320610687022901,1.2348682590495,499,189,310,28,1.6,35.92,4.3,0,0,0,0,0,0,0.165730242406665,106.236584967639,17.743274542423
9.7,"eps_greedy_SVM","SVM",51,10,1684,1622,62,1100,902,198,0.784741292749897,0.244274809160305,1.2348682590495,522,198,324,23,1.6,39.51,4.6,0,0,0,0,0,0,0.164967070894443,101.579774284045,17.9341531724726
9.7,"eps_greedy_SVM","SVM",51,11,1584,1531,53,1200,993,207,0.79136473064685,0.305343511450382,1.2348682590495,557,207,350,35,1.7,43.1,4.8,0,0,0,0,0,0,0.156348294717267,118.999664446313,16.3404170887587
9.7,"eps_greedy_SVM","SVM",51,12,1484,1436,48,1300,1088,212,0.781323719771106,0.236641221374046,1.2348682590495,564,212,352,7,1.7,46.7,5.1,0,0,0,0,0,0,0.123203465610871,64.118343797381,13.5602525805785
9.7,"eps_greedy_SVM","SVM",51,13,1384,1339,45,1400,1185,215,0.797256263534184,0.305343511450382,1.2348682590495,590,215,375,26,1.7,50.29,5.5,0,0,0,0,0,0,0.141268625588073,94.4177782837132,14.6238404399092
9.7,"eps_greedy_SVM","SVM",51,14,1284,1239,45,1500,1285,215,0.77275861651806,0.229007633587786,1.22506771731101,571,215,356,-19,1.7,53.88,6,0,0,0,0,0,0,0.0867520601102865,32.8219765948012,10.2639336893203
9.7,"eps_greedy_SVM","SVM",51,15,1184,1140,44,1600,1384,216,0.768273430033503,0.244274809160305,1.2348682590495,582,216,366,11,1.7,57.47,6.4,0,0,0,0,0,0,0.0561790081391198,16.7889938616689,8.18191796326578
9.7,"eps_greedy_SVM","SVM",51,16,1084,1047,37,1700,1477,223,0.764102781239031,0.221374045801527,1.2348682590495,597,223,374,15,1.7,61.06,6.6,0,0,0,0,0,0,0.051996309001493,14.8321729718391,7.28170748801497
9.7,"eps_greedy_SVM","SVM",51,17,984,949,35,1800,1575,225,0.756257485392139,0.206106870229008,1.2348682590495,594,225,369,-3,1.6,64.66,7,0,0,0,0,0,0,0.0413812536706148,9.49909111426556,5.53446463690054
9.7,"eps_greedy_SVM","SVM",51,18,884,852,32,1900,1672,228,0.830452087441474,0.251908396946565,1.26426988426496,603,228,375,9,1.6,68.25,7.3,0,0,0,0,0,0,0.0274982229346173,9.21394117188214,6.95895195460113
9.7,"eps_greedy_SVM","SVM",51,19,784,767,17,2000,1757,243,0.789828335006833,0.221374045801527,1.28268876611418,658,243,415,55,1.7,71.84,7.2,0,0,0,0,0,0,0.139796921195245,53.7039237190092,26.3441527384976
9.7,"eps_greedy_SVM","SVM",51,20,684,673,11,2100,1851,249,0.796554602533236,0.229007633587786,1.28387096774194,683,249,434,25,1.7,75.43,7.4,0,0,0,0,0,0,0.0971179269517399,33.8757525675048,11.9612657453673
9.7,"eps_greedy_SVM","SVM",51,21,584,580,4,2200,1944,256,0.790040043067463,0.198473282442748,1.28387096774194,686,256,430,3,1.7,79.02,7.6,0,0,0,0,0,0,0.0718897071748895,22.3739280782807,10.2182884356814
9.7,"eps_greedy_SVM","SVM",51,22,484,481,3,2300,2043,257,0.809341769395482,0.259541984732824,1.28387096774194,713,257,456,27,1.8,82.61,7.9,0,0,0,0,0,0,0.0671983798017322,19.4272780240848,10.2004732466485
9.7,"eps_greedy_SVM","SVM",51,23,384,383,1,2400,2141,259,0.829460083957367,0.244274809160305,1.28387096774194,703,259,444,-10,1.7,86.21,8.3,0,0,0,0,0,0,0.0904317732434981,27.4136248122904,10.4968156386629
9.7,"eps_greedy_SVM","SVM",51,24,284,283,1,2500,2241,259,0.833766830790818,0.320610687022901,1.28387096774194,711,259,452,8,1.7,89.8,8.7,0,0,0,0,0,0,0.0122684589089268,3.12403937446755,2.65886821131863
9.7,"eps_greedy_SVM","SVM",51,25,184,184,0,2600,2340,260,0.839857974135321,0.290076335877863,1.28387096774194,728,260,468,17,1.8,93.39,9,0,0,0,0,0,0,6.16325352780416e-06,0.573738281928957,0.573644780806912
9.7,"eps_greedy_SVM","SVM",51,26,84,84,0,2700,2440,260,0.756826072754989,0.16793893129771,1.28387096774194,715,260,455,-13,1.8,96.98,9.4,0,0,0,0,0,0,1.19815379009519e-12,6.64057589966295e-05,6.64057589966295e-05
9.7,"eps_greedy_SVM","SVM",51,27,0,0,0,2784,2524,260,0.823054402922778,0.236641221374046,1.28387096774194,725,260,465,10,1.8,100,9.7,0,0,0,0,0,0,0,0,0
9.7,"eps_greedy_SVM","SVM",52,0,2684,2434,250,100,91,9,0.768083291279157,0.234848484848485,1.2352394916911,24,9,15,0,1.7,3.59,10.1,0,0,0,0,0,0,0.101463488778387,262.590362951463,10.2203890817432
9.7,"eps_greedy_SVM","SVM",52,1,2584,2355,229,200,170,30,0.75049864225122,0.28030303030303,1.16715542521994,85,30,55,61,1.8,7.18,5.7,0,0,0,0,0,0,0.182356638928328,340.998310156318,23.0723030063597
9.7,"eps_greedy_SVM","SVM",52,2,2484,2273,211,300,252,48,0.791970057433968,0.295454545454545,1.21578690127077,125,48,77,40,1.6,10.78,5.2,0,0,0,0,0,0,0.216065188360902,267.471281682875,25.4793299871123
9.7,"eps_greedy_SVM","SVM",52,3,2384,2201,183,400,324,76,0.7788191190253,0.265151515151515,1.21578690127077,187,76,111,62,1.5,14.37,4.3,0,0,0,0,0,0,0.217659086733571,251.260931130951,23.512740667115
9.7,"eps_greedy_SVM","SVM",52,4,2284,2130,154,500,395,105,0.789945449739258,0.272727272727273,1.21578690127077,258,105,153,71,1.5,17.96,3.8,0,0,0,0,0,0,0.227494555831789,224.993270228652,23.130881735804
9.7,"eps_greedy_SVM","SVM",52,5,2184,2053,131,600,472,128,0.808479321365906,0.287878787878788,1.25469208211144,302,128,174,44,1.4,21.55,3.7,0,0,0,0,0,0,0.236848419404777,178.927741432956,23.9726966995812
9.7,"eps_greedy_SVM","SVM",52,6,2084,1983,101,700,542,158,0.809620791579542,0.287878787878788,1.25469208211144,373,158,215,71,1.4,25.14,3.4,0,0,0,0,0,0,0.242132225703022,131.114945132307,24.6966499669943
9.7,"eps_greedy_SVM","SVM",52,7,1984,1918,66,800,607,193,0.821744406795946,0.348484848484849,1.24496578690127,452,193,259,79,1.3,28.74,3.1,0,0,0,0,0,0,0.242055166833962,107.905762033553,25.7491954179273
9.7,"eps_greedy_SVM","SVM",52,8,1884,1834,50,900,691,209,0.814613221829709,0.310606060606061,1.24496578690127,496,209,287,44,1.4,32.33,3.3,0,0,0,0,0,0,0.211691471587702,83.7220984994301,23.3400335339701
9.7,"eps_greedy_SVM","SVM",52,9,1784,1742,42,1000,783,217,0.807998702328592,0.318181818181818,1.22551319648094,521,217,304,25,1.4,35.92,3.6,0,0,0,0,0,0,0.187402181283445,81.4713886475804,21.351127740903
9.7,"eps_greedy_SVM","SVM",52,10,1684,1646,38,1100,879,221,0.803138442313697,0.28030303030303,1.22551319648094,536,221,315,15,1.4,39.51,4,0,0,0,0,0,0,0.147897275579017,60.1344323130668,17.0756783974759
9.7,"eps_greedy_SVM","SVM",52,11,1584,1549,35,1200,976,224,0.815904885492511,0.348484848484849,1.22551319648094,545,224,321,9,1.4,43.1,4.4,0,0,0,0,0,0,0.104575681811581,36.2984958748048,12.845181699048
9.7,"eps_greedy_SVM","SVM",52,12,1484,1454,30,1300,1071,229,0.8149736861077,0.303030303030303,1.22551319648094,568,229,339,23,1.5,46.7,4.7,0,0,0,0,0,0,0.0815857883036164,23.904876499879,12.1390754577063
9.7,"eps_greedy_SVM","SVM",52,13,1384,1360,24,1400,1165,235,0.810678153461657,0.272727272727273,1.22551319648094,583,235,348,15,1.5,50.29,5,0,0,0,0,0,0,0.07889822935017,25.8294534248701,9.91008681765979
9.7,"eps_greedy_SVM","SVM",52,14,1284,1261,23,1500,1264,236,0.817178525941412,0.303030303030303,1.22551319648094,594,236,358,11,1.5,53.88,5.4,0,0,0,0,0,0,0.0809477133534046,31.6488009246079,10.17228986516
9.7,"eps_greedy_SVM","SVM",52,15,1184,1163,21,1600,1362,238,0.790912695551866,0.234848484848485,1.22551319648094,593,238,355,-1,1.5,57.47,5.7,0,0,0,0,0,0,0.130704812220691,43.8735301527407,15.8008148004642
9.7,"eps_greedy_SVM","SVM",52,16,1084,1064,20,1700,1461,239,0.795082065700617,0.25,1.22551319648094,612,239,373,19,1.6,61.06,6.1,0,0,0,0,0,0,0.0914630644907205,24.5698995494573,10.9477701870644
9.7,"eps_greedy_SVM","SVM",52,17,984,965,19,1800,1560,240,0.79137228750631,0.28030303030303,1.22551319648094,620,240,380,8,1.6,64.66,6.5,0,0,0,0,0,0,0.0866540445061658,19.8264502014873,11.972105942465
9.7,"eps_greedy_SVM","SVM",52,18,884,865,19,1900,1660,240,0.813913320356617,0.310606060606061,1.22551319648094,601,240,361,-19,1.5,68.25,6.9,0,0,0,0,0,0,0.0318493448051055,6.16978474260518,4.95175715818185
9.7,"eps_greedy_SVM","SVM",52,19,784,765,19,2000,1760,240,0.789104366423955,0.234848484848485,1.22551319648094,618,240,378,17,1.6,71.84,7.3,0,0,0,0,0,0,0.000128972782582351,1.05063590440924,1.04717996775899
9.7,"eps_greedy_SVM","SVM",52,20,684,669,15,2100,1856,244,0.805145026794506,0.257575757575758,1.21578690127077,650,244,406,32,1.7,75.43,7.6,0,0,0,0,0,0,0.0119953426418839,9.439372038505,8.54844934895358
9.7,"eps_greedy_SVM","SVM",52,21,584,571,13,2200,1954,246,0.783679379040198,0.212121212121212,1.21578690127077,649,246,403,-1,1.6,79.02,7.9,0,0,0,0,0,0,0.0427711850809139,11.6397511358614,8.07100325844091
9.7,"eps_greedy_SVM","SVM",52,22,484,472,12,2300,2053,247,0.807944632686895,0.295454545454545,1.21578690127077,647,247,400,-2,1.6,82.61,8.3,0,0,0,0,0,0,0.0239204663189161,7.19522956940357,5.05734358577406
9.7,"eps_greedy_SVM","SVM",52,23,384,373,11,2400,2152,248,0.811393074279665,0.272727272727273,1.21578690127077,637,248,389,-10,1.6,86.21,8.7,0,0,0,0,0,0,0.00669430716342095,2.13952366250292,1.73918784696113
9.7,"eps_greedy_SVM","SVM",52,24,284,273,11,2500,2252,248,0.806550837478666,0.265151515151515,1.21578690127077,645,248,397,8,1.6,89.8,9.1,0,0,0,0,0,0,0.00138102485186015,0.439551742496895,0.366111441461693
9.7,"eps_greedy_SVM","SVM",52,25,184,176,8,2600,2349,251,0.807181649965146,0.287878787878788,1.2352394916911,660,251,409,15,1.6,93.39,9.4,0,0,0,0,0,0,0.00101024278932148,0.41553135897187,0.378404529090015
9.7,"eps_greedy_SVM","SVM",52,26,84,83,1,2700,2442,258,0.833705813087255,0.265151515151515,1.27414467253177,686,258,428,26,1.7,96.98,9.5,0,0,0,0,0,0,1.0000000994736e-07,3.2273291583595,3.2273291583595
9.7,"eps_greedy_SVM","SVM",52,27,0,0,0,2784,2525,259,0.791195059236297,0.212121212121212,1.2644183773216,688,259,429,2,1.7,100,9.7,0,0,0,0,0,0,0,0,0
9.7,"eps_greedy_SVM","SVM",53,0,2684,2423,261,100,83,17,0.802316095132735,0.327433628318584,1.21570082786183,42,17,25,0,1.5,3.59,4.9,0,0,0,0,0,0,0.235855484723852,441.858175829896,24.3194199804165
9.7,"eps_greedy_SVM","SVM",53,1,2584,2352,232,200,154,46,0.676811393805305,0.0884955752212389,1.22706251784185,125,46,79,83,1.7,7.18,3.3,0,0,0,0,0,0,0.260029948091717,580.683235379111,27.9263373184013
9.7,"eps_greedy_SVM","SVM",53,2,2484,2261,223,300,245,55,0.78988523230088,0.185840707964602,1.23842420782187,146,55,91,21,1.7,10.78,4.5,0,0,0,0,0,0,0.202241649767804,424.755493870543,23.1936204861083
9.7,"eps_greedy_SVM","SVM",53,3,2384,2177,207,400,329,71,0.773561946902647,0.221238938053097,1.20433913788182,184,71,113,38,1.6,14.37,4.6,0,0,0,0,0,0,0.198284429081163,369.018540128984,21.228993082924
9.7,"eps_greedy_SVM","SVM",53,4,2284,2100,184,500,406,94,0.801680033185835,0.238938053097345,1.24978589780188,248,94,154,64,1.6,17.96,4.3,0,0,0,0,0,0,0.206611938792479,361.883222991994,21.1219185392988
9.7,"eps_greedy_SVM","SVM",53,5,2184,2027,157,600,479,121,0.803761061946895,0.274336283185841,1.22706251784185,304,121,183,56,1.5,21.55,4,0,0,0,0,0,0,0.2150052959835,334.688980879633,21.8161322375004
9.7,"eps_greedy_SVM","SVM",53,6,2084,1957,127,700,549,151,0.806554203539816,0.230088495575221,1.23842420782187,379,151,228,75,1.5,25.14,3.6,0,0,0,0,0,0,0.225444696472766,214.703000359168,23.3066751592896
9.7,"eps_greedy_SVM","SVM",53,7,1984,1889,95,800,617,183,0.811041205752205,0.274336283185841,1.23842420782187,446,183,263,67,1.4,28.74,3.4,0,0,0,0,0,0,0.232593473145238,317.769019770271,23.6928137242116
9.7,"eps_greedy_SVM","SVM",53,8,1884,1806,78,900,700,200,0.809720685840701,0.238938053097345,1.23842420782187,494,200,294,48,1.5,32.33,3.5,0,0,0,0,0,0,0.217868647386257,238.198587746318,22.5767802465546
9.7,"eps_greedy_SVM","SVM",53,9,1784,1720,64,1000,786,214,0.801106194690258,0.247787610619469,1.22706251784185,526,214,312,32,1.5,35.92,3.7,0,0,0,0,0,0,0.1909649601214,162.692476200708,20.3191790018208
9.7,"eps_greedy_SVM","SVM",53,10,1684,1627,57,1100,879,221,0.813461006637161,0.256637168141593,1.23842420782187,543,221,322,17,1.5,39.51,4,0,0,0,0,0,0,0.189997144698454,230.588164675076,19.5188536866087
9.7,"eps_greedy_SVM","SVM",53,11,1584,1537,47,1200,969,231,0.817256637168134,0.300884955752212,1.24978589780188,581,231,350,38,1.5,43.1,4.2,0,0,0,0,0,0,0.163788676050646,147.859051260267,18.1114468098259
9.7,"eps_greedy_SVM","SVM",53,12,1484,1442,42,1300,1064,236,0.819365320796452,0.265486725663717,1.22706251784185,590,236,354,9,1.5,46.7,4.5,0,0,0,0,0,0,0.158131515122431,156.185167695265,16.7184915216273
9.7,"eps_greedy_SVM","SVM",53,13,1384,1347,37,1400,1159,241,0.815327710176984,0.238938053097345,1.20433913788182,610,241,369,20,1.5,50.29,4.8,0,0,0,0,0,0,0.156148499550259,134.204575736344,16.5923877087689
9.7,"eps_greedy_SVM","SVM",53,14,1284,1258,26,1500,1248,252,0.800767422566365,0.194690265486726,1.20433913788182,650,252,398,40,1.6,53.88,5,0,0,0,0,0,0,0.166636927271105,99.3923257454268,17.8897151493903
9.7,"eps_greedy_SVM","SVM",53,15,1184,1160,24,1600,1346,254,0.782307798672561,0.185840707964602,1.21570082786183,662,254,408,12,1.6,57.47,5.3,0,0,0,0,0,0,0.0939463256394946,38.0754025873738,12.3345434705802
9.7,"eps_greedy_SVM","SVM",53,16,1084,1061,23,1700,1445,255,0.797393528761056,0.238938053097345,1.20433913788182,670,255,415,8,1.6,61.06,5.7,0,0,0,0,0,0,0.0954771912647557,45.3014625023238,11.3772967084767
9.7,"eps_greedy_SVM","SVM",53,17,984,962,22,1800,1544,256,0.789339048672561,0.194690265486726,1.23842420782187,677,256,421,7,1.6,64.66,6,0,0,0,0,0,0,0.0523861501801874,18.9010034996179,7.2937490987711
9.7,"eps_greedy_SVM","SVM",53,18,884,866,18,1900,1640,260,0.80967920353982,0.176991150442478,1.2611475877819,675,260,415,-2,1.6,68.25,6.3,0,0,0,0,0,0,0.126914902821229,56.3278969851223,16.3249681768393
9.7,"eps_greedy_SVM","SVM",53,19,784,773,11,2000,1733,267,0.838246681415928,0.230088495575221,1.27250927776192,712,267,445,37,1.7,71.84,6.5,0,0,0,0,0,0,0.046817440034633,16.2739133157859,9.35770522603531
9.7,"eps_greedy_SVM","SVM",53,20,684,681,3,2100,1825,275,0.80689988938053,0.150442477876106,1.27250927776192,741,275,466,29,1.7,75.43,6.6,0,0,0,0,0,0,0.0363833743570398,11.5842051857449,5.52015852081511
9.7,"eps_greedy_SVM","SVM",53,21,584,582,2,2200,1924,276,0.835253042035396,0.256637168141593,1.28387096774194,733,276,457,-8,1.7,79.02,7,0,0,0,0,0,0,0.058706188335265,19.9008855247975,8.66700431166466
9.7,"eps_greedy_SVM","SVM",53,22,484,482,2,2300,2024,276,0.811227876106193,0.194690265486726,1.27250927776192,749,276,473,16,1.7,82.61,7.3,0,0,0,0,0,0,0.00992529575435887,2.93445777828041,1.89950808924715
9.7,"eps_greedy_SVM","SVM",53,23,384,383,1,2400,2123,277,0.816537610619468,0.238938053097345,1.28387096774194,750,277,473,1,1.7,86.21,7.7,0,0,0,0,0,0,0.00961161791578972,3.42713570367018,2.82868508096522
9.7,"eps_greedy_SVM","SVM",53,24,284,283,1,2500,2223,277,0.790210176991148,0.150442477876106,1.28387096774194,751,277,474,1,1.7,89.8,8,0,0,0,0,0,0,0.00161613182289716,0.714580393278621,0.652945993638704
9.7,"eps_greedy_SVM","SVM",53,25,184,184,0,2600,2322,278,0.82018113938053,0.176991150442478,1.28387096774194,768,278,490,17,1.8,93.39,8.4,0,0,0,0,0,0,0.000217445044828486,0.17865967466797,0.174098164424171
9.7,"eps_greedy_SVM","SVM",53,26,84,84,0,2700,2422,278,0.774391592920352,0.132743362831858,1.28387096774194,748,278,470,-20,1.7,96.98,8.7,0,0,0,0,0,0,1.0000000994736e-07,0.00912400329847292,0.00912400329847292
9.7,"eps_greedy_SVM","SVM",53,27,0,0,0,2784,2506,278,0.808759679203538,0.185840707964602,1.28387096774194,755,278,477,7,1.7,100,9,0,0,0,0,0,0,0,0,0
9.7,"eps_greedy_SVM","SVM",54,0,2684,2421,263,100,92,8,0.199620319455355,0.00833333333333333,0.588440860215054,26,8,18,0,2.2,3.59,11.5,0,0,0,0,0,0,0.0861441520016099,216.310347292137,8.68634787055599
9.7,"eps_greedy_SVM","SVM",54,1,2584,2338,246,200,175,25,0.845908614820622,0.283333333333333,1.27317204301075,82,25,57,56,2.3,7.18,7,0,0,0,0,0,0,0.173981755168131,314.422915239996,19.3218891407677
9.7,"eps_greedy_SVM","SVM",54,2,2484,2267,217,300,246,54,0.794383346425768,0.3,1.2410752688172,131,54,77,49,1.4,10.78,4.6,0,0,0,0,0,0,0.271856879813755,335.301598485573,31.0578599651445
9.7,"eps_greedy_SVM","SVM",54,3,2384,2207,177,400,306,94,0.803037444357152,0.241666666666667,1.27317204301075,217,94,123,86,1.3,14.37,3.3,0,0,0,0,0,0,0.291903476016292,318.610706558694,32.9951227223685
9.7,"eps_greedy_SVM","SVM",54,4,2284,2126,158,500,387,113,0.793061010735791,0.216666666666667,1.27317204301075,268,113,155,51,1.4,17.96,3.4,0,0,0,0,0,0,0.246823127599486,345.795305690037,25.4458086661389
9.7,"eps_greedy_SVM","SVM",54,5,2184,2039,145,600,474,126,0.805204241948154,0.25,1.27317204301075,318,126,192,50,1.5,21.55,3.8,0,0,0,0,0,0,0.209674063186994,179.529444874192,21.7848132101517
9.7,"eps_greedy_SVM","SVM",54,6,2084,1962,122,700,551,149,0.804994763026971,0.25,1.27317204301075,358,149,209,40,1.4,25.14,3.7,0,0,0,0,0,0,0.196678416719996,147.15059014981,20.8609037604004
9.7,"eps_greedy_SVM","SVM",54,7,1984,1879,105,800,634,166,0.81730819586279,0.266666666666667,1.27317204301075,404,166,238,46,1.4,28.74,3.8,0,0,0,0,0,0,0.191171953966662,181.447235856952,20.2185532854716
9.7,"eps_greedy_SVM","SVM",54,8,1884,1811,73,900,702,198,0.824927991620838,0.308333333333333,1.27317204301075,486,198,288,82,1.5,32.33,3.5,0,0,0,0,0,0,0.197420355926376,131.248965107382,22.4593229890243
9.7,"eps_greedy_SVM","SVM",54,9,1784,1727,57,1000,786,214,0.835185912542542,0.341666666666667,1.27317204301075,525,214,311,39,1.5,35.92,3.7,0,0,0,0,0,0,0.203649363915779,228.095954207387,20.9254432671962
9.7,"eps_greedy_SVM","SVM",54,10,1684,1638,46,1100,875,225,0.837640743650171,0.308333333333333,1.27317204301075,577,225,352,52,1.6,39.51,3.9,0,0,0,0,0,0,0.202035689722186,302.017383994054,20.3352638069813
9.7,"eps_greedy_SVM","SVM",54,11,1584,1547,37,1200,966,234,0.824535218643627,0.333333333333333,1.26247311827957,597,234,363,20,1.6,43.1,4.1,0,0,0,0,0,0,0.193550550941309,242.230613058362,19.686007688197
9.7,"eps_greedy_SVM","SVM",54,12,1484,1454,30,1300,1059,241,0.812647289866455,0.275,1.23037634408602,623,241,382,26,1.6,46.7,4.4,0,0,0,0,0,0,0.150369387418939,74.0260558791608,17.1392284312175
9.7,"eps_greedy_SVM","SVM",54,13,1384,1358,26,1400,1155,245,0.795280178057085,0.225,1.2410752688172,627,245,382,4,1.6,50.29,4.7,0,0,0,0,0,0,0.102137589023754,54.1290130336134,12.5784516248694
9.7,"eps_greedy_SVM","SVM",54,14,1284,1258,26,1500,1255,245,0.783876669285153,0.141666666666667,1.26247311827957,647,245,402,20,1.6,53.88,5.1,0,0,0,0,0,0,0.0765364282658431,30.7483517593297,10.2044017198928
9.7,"eps_greedy_SVM","SVM",54,15,1184,1162,22,1600,1351,249,0.808470803875357,0.283333333333333,1.25177419354839,663,249,414,16,1.7,57.47,5.4,0,0,0,0,0,0,0.115482679733769,49.3057016020841,14.2162185505943
9.7,"eps_greedy_SVM","SVM",54,16,1084,1062,22,1700,1451,249,0.813491751767477,0.291666666666667,1.26247311827957,682,249,433,19,1.7,61.06,5.8,0,0,0,0,0,0,0.0352743975972804,11.7436915723525,5.42727488057375
9.7,"eps_greedy_SVM","SVM",54,17,984,964,20,1800,1549,251,0.765933490442526,0.2,1.27317204301075,690,251,439,8,1.7,64.66,6.2,0,0,0,0,0,0,0.0652548874399983,24.7648805332255,12.7463863242828
9.7,"eps_greedy_SVM","SVM",54,18,884,866,18,1900,1647,253,0.802899973815129,0.258333333333333,1.2410752688172,717,253,464,27,1.8,68.25,6.5,0,0,0,0,0,0,0.110874621177239,73.1290635192615,11.7262487809774
9.7,"eps_greedy_SVM","SVM",54,19,784,767,17,2000,1746,254,0.837732390678185,0.291666666666667,1.23037634408602,705,254,451,-12,1.8,71.84,6.9,0,0,0,0,0,0,0.0416621336638851,13.6664399935806,5.75298320369909
9.7,"eps_greedy_SVM","SVM",54,20,684,669,15,2100,1844,256,0.843735271013349,0.308333333333333,1.2410752688172,743,256,487,38,1.9,75.43,7.2,0,0,0,0,0,0,0.0506883877892086,17.3926848947697,6.70071379663614
9.7,"eps_greedy_SVM","SVM",54,21,584,572,12,2200,1941,259,0.816378633150042,0.25,1.26247311827957,747,259,488,4,1.9,79.02,7.5,0,0,0,0,0,0,0.0336010445116207,11.759511724557,5.62232068927809
9.7,"eps_greedy_SVM","SVM",54,22,484,481,3,2300,2032,268,0.788694684472375,0.258333333333333,1.28387096774194,796,268,528,49,2,82.61,7.6,0,0,0,0,0,0,0.0363441450619412,11.7045484249215,8.23397167402318
9.7,"eps_greedy_SVM","SVM",54,23,384,382,2,2400,2131,269,0.817772977219169,0.25,1.28387096774194,788,269,519,-8,1.9,86.21,7.9,0,0,0,0,0,0,0.00524978262947594,1.55977673978962,1.25513342893627
9.7,"eps_greedy_SVM","SVM",54,24,284,284,0,2500,2229,271,0.790940036658812,0.2,1.28387096774194,762,271,491,-26,1.8,89.8,8.2,0,0,0,0,0,0,0.00500529459205766,11.4072867723925,11.2322287606602
9.7,"eps_greedy_SVM","SVM",54,25,184,184,0,2600,2329,271,0.79020686043467,0.191666666666667,1.28387096774194,763,271,492,1,1.8,93.39,8.6,0,0,0,0,0,0,0.00652696835077964,2.03973292826011,1.79207291208811
9.7,"eps_greedy_SVM","SVM",54,26,84,84,0,2700,2429,271,0.766941607750719,0.141666666666667,1.27317204301075,800,271,529,37,2,96.98,9,0,0,0,0,0,0,4.31484525436739e-07,0.0518315641712542,0.0518315641712542
9.7,"eps_greedy_SVM","SVM",54,27,0,0,0,2784,2513,271,0.790907305577377,0.175,1.28387096774194,774,271,503,-26,1.9,100,9.3,0,0,0,0,0,0,0,0,0
9.7,"eps_greedy_SVM","SVM",55,0,2684,2420,264,100,91,9,0.381994017946162,0.0254237288135593,0.826899945325314,33,9,24,0,2.7,3.59,10.1,0,0,0,0,0,0,0.0998685057353668,244.754137602156,10.0712576361394
9.7,"eps_greedy_SVM","SVM",55,1,2584,2337,247,200,174,26,0.583981389165838,0.0423728813559322,1.2077091306725,77,26,51,44,2,7.18,6.7,0,0,0,0,0,0,0.159465051980973,333.299046214175,17.569733636792
9.7,"eps_greedy_SVM","SVM",55,2,2484,2244,240,300,267,33,0.737002326354272,0.194915254237288,1.25123018042646,91,33,58,14,1.8,10.78,8.1,0,0,0,0,0,0,0.140430260708519,253.945914710397,15.0193329311763
9.7,"eps_greedy_SVM","SVM",55,3,2384,2166,218,400,345,55,0.763396477234966,0.161016949152542,1.26211044286495,144,55,89,53,1.6,14.37,6.3,0,0,0,0,0,0,0.166460176913006,221.082016151302,18.4774837799664
9.7,"eps_greedy_SVM","SVM",55,4,2284,2096,188,500,415,85,0.796962445995352,0.23728813559322,1.26211044286495,209,85,124,65,1.5,17.96,4.9,0,0,0,0,0,0,0.184155979807116,205.656326906235,19.6076342724819
9.7,"eps_greedy_SVM","SVM",55,5,2184,2027,157,600,484,116,0.802871385842477,0.245762711864407,1.27299070530344,281,116,165,72,1.4,21.55,4.2,0,0,0,0,0,0,0.194609964731746,299.664241697667,19.9338665061543
9.7,"eps_greedy_SVM","SVM",55,6,2084,1960,124,700,551,149,0.798451312728486,0.23728813559322,1.26211044286495,355,149,206,74,1.4,25.14,3.7,0,0,0,0,0,0,0.205064834144307,182.468952925646,21.7210186040541
9.7,"eps_greedy_SVM","SVM",55,7,1984,1899,85,800,612,188,0.799727484214031,0.23728813559322,1.25123018042646,429,188,241,74,1.3,28.74,3.3,0,0,0,0,0,0,0.219442591172277,226.665051488541,23.3409797761966
9.7,"eps_greedy_SVM","SVM",55,8,1884,1820,64,900,691,209,0.80277168494517,0.26271186440678,1.26211044286495,483,209,274,54,1.3,32.33,3.3,0,0,0,0,0,0,0.19584333752186,146.538241050856,21.0321811363628
9.7,"eps_greedy_SVM","SVM",55,9,1784,1738,46,1000,773,227,0.803077434363582,0.271186440677966,1.25123018042646,528,227,301,45,1.3,35.92,3.4,0,0,0,0,0,0,0.193644795392695,169.679442556429,21.0314654739443
9.7,"eps_greedy_SVM","SVM",55,10,1684,1649,35,1100,862,238,0.807351279494853,0.26271186440678,1.26211044286495,562,238,324,34,1.4,39.51,3.6,0,0,0,0,0,0,0.181773509460173,166.403025025521,19.0793544720861
9.7,"eps_greedy_SVM","SVM",55,11,1584,1556,28,1200,955,245,0.814004652708545,0.23728813559322,1.27299070530344,587,245,342,25,1.4,43.1,3.9,0,0,0,0,0,0,0.146454292724293,92.4507548213396,15.7763539044696
9.7,"eps_greedy_SVM","SVM",55,12,1484,1468,16,1300,1043,257,0.777314722499172,0.144067796610169,1.27299070530344,625,257,368,38,1.4,46.7,4.1,0,0,0,0,0,0,0.20497516419566,217.217598262879,21.0776098689443
9.7,"eps_greedy_SVM","SVM",55,13,1384,1372,12,1400,1139,261,0.801289464938522,0.220338983050847,1.27299070530344,651,261,390,26,1.5,50.29,4.4,0,0,0,0,0,0,0.180980933231048,177.359402888493,18.4805051025107
9.7,"eps_greedy_SVM","SVM",55,14,1284,1277,7,1500,1234,266,0.802067131937524,0.194915254237288,1.27299070530344,674,266,408,23,1.5,53.88,4.6,0,0,0,0,0,0,0.134180668097933,64.5524911037028,15.2284885547206
9.7,"eps_greedy_SVM","SVM",55,15,1184,1177,7,1600,1334,266,0.800877367896315,0.194915254237288,1.27299070530344,672,266,406,-2,1.5,57.47,5,0,0,0,0,0,0,0.111355011150833,48.0826552252369,12.3469027447429
9.7,"eps_greedy_SVM","SVM",55,16,1084,1078,6,1700,1433,267,0.796430707876375,0.211864406779661,1.27299070530344,665,267,398,-7,1.5,61.06,5.4,0,0,0,0,0,0,0.101296779658331,52.3328517742557,11.3246369425832
9.7,"eps_greedy_SVM","SVM",55,17,984,979,5,1800,1532,268,0.805270854104357,0.194915254237288,1.27299070530344,679,268,411,14,1.5,64.66,5.7,0,0,0,0,0,0,0.0777933921605467,33.8936133194626,9.22802764652858
9.7,"eps_greedy_SVM","SVM",55,18,884,881,3,1900,1630,270,0.792263210368897,0.186440677966102,1.28387096774194,689,270,419,10,1.6,68.25,6,0,0,0,0,0,0,0.073227711815682,33.9547879177417,10.5475397233675
9.7,"eps_greedy_SVM","SVM",55,19,784,781,3,2000,1730,270,0.763369890329016,0.152542372881356,1.28387096774194,709,270,439,20,1.6,71.84,6.4,0,0,0,0,0,0,0.0514763736358624,19.5117730743345,6.20811389935629
9.7,"eps_greedy_SVM","SVM",55,20,684,682,2,2100,1829,271,0.77691591890994,0.169491525423729,1.28387096774194,703,271,432,-6,1.6,75.43,6.7,0,0,0,0,0,0,0.0321731786933102,11.2618170887441,4.07187037689245
9.7,"eps_greedy_SVM","SVM",55,21,584,582,2,2200,1929,271,0.779887005649721,0.169491525423729,1.28387096774194,709,271,438,6,1.6,79.02,7.1,0,0,0,0,0,0,0.0133757325293369,3.60738559791317,1.89025833753563
9.7,"eps_greedy_SVM","SVM",55,22,484,482,2,2300,2029,271,0.757480890661352,0.144067796610169,1.28387096774194,711,271,440,2,1.6,82.61,7.5,0,0,0,0,0,0,0.00490891341144223,1.12946977460884,0.840530534714657
9.7,"eps_greedy_SVM","SVM",55,23,384,383,1,2400,2128,272,0.76223994682619,0.161016949152542,1.27299070530344,724,272,452,13,1.7,86.21,7.8,0,0,0,0,0,0,0.0547705341688097,16.7010913169896,13.1231761854313
9.7,"eps_greedy_SVM","SVM",55,24,284,283,1,2500,2228,272,0.746673313393157,0.161016949152542,1.27299070530344,718,272,446,-6,1.6,89.8,8.2,0,0,0,0,0,0,0.00356387662464215,1.43145771291368,1.35300040650561
9.7,"eps_greedy_SVM","SVM",55,25,184,184,0,2600,2327,273,0.725982053838487,0.0932203389830508,1.27299070530344,723,273,450,5,1.6,93.39,8.5,0,0,0,0,0,0,0.030248096969214,7.21108262776309,5.6935390811895
9.7,"eps_greedy_SVM","SVM",55,26,84,84,0,2700,2427,273,0.737500830840814,0.144067796610169,1.27299070530344,734,273,461,11,1.7,96.98,8.9,0,0,0,0,0,0,0.0145327913322587,3.07497938058509,3.07497938058509
9.7,"eps_greedy_SVM","SVM",55,27,0,0,0,2784,2511,273,0.709690927218348,0.0932203389830508,1.27299070530344,718,273,445,-16,1.6,100,9.2,0,0,0,0,0,0,0,0,0
9.7,"eps_greedy_SVM","SVM",56,0,2684,2428,256,100,88,12,0.704525958645411,0.276422764227642,1.15861526357199,37,12,25,0,2.1,3.59,7.3,0,0,0,0,0,0,0.197792706980171,294.137606099077,23.3239294884207
9.7,"eps_greedy_SVM","SVM",56,1,2584,2349,235,200,167,33,0.682856411241279,0.113821138211382,1.25255704169945,97,33,64,60,1.9,7.18,5.1,0,0,0,0,0,0,0.182937687509725,415.029281517488,18.9217235644562
9.7,"eps_greedy_SVM","SVM",56,2,2484,2256,228,300,260,40,0.805652647077659,0.284552845528455,1.27343299239444,119,40,79,22,2,10.78,6.5,0,0,0,0,0,0,0.173135356237688,252.397428829373,18.7984669016594
9.7,"eps_greedy_SVM","SVM",56,3,2384,2179,205,400,337,63,0.813129761218878,0.260162601626016,1.27343299239444,163,63,100,44,1.6,14.37,5.3,0,0,0,0,0,0,0.197110134755652,222.000992735398,22.3643732706359
9.7,"eps_greedy_SVM","SVM",56,4,2284,2107,177,500,409,91,0.827981563280203,0.284552845528455,1.28387096774194,227,91,136,64,1.5,17.96,4.5,0,0,0,0,0,0,0.189744269161215,280.379763112834,20.1162141635357
9.7,"eps_greedy_SVM","SVM",56,5,2184,2039,145,600,477,123,0.796133410153003,0.154471544715447,1.26299501704694,306,123,183,79,1.5,21.55,3.9,0,0,0,0,0,0,0.220312609388537,387.96651636322,27.7055248256383
9.7,"eps_greedy_SVM","SVM",56,6,2084,1946,138,700,570,130,0.818065424748744,0.276422764227642,1.26299501704694,326,130,196,20,1.5,25.14,4.4,0,0,0,0,0,0,0.19792712098395,245.018931429598,20.8551571977268
9.7,"eps_greedy_SVM","SVM",56,7,1984,1859,125,800,657,143,0.815114269252932,0.252032520325203,1.26299501704694,358,143,215,32,1.5,28.74,4.6,0,0,0,0,0,0,0.199709667060333,183.25835735531,20.4433157834479
9.7,"eps_greedy_SVM","SVM",56,8,1884,1784,100,900,732,168,0.817278023173934,0.252032520325203,1.26299501704694,420,168,252,62,1.5,32.33,4.4,0,0,0,0,0,0,0.198148549841468,211.555719514532,20.2277979591477
9.7,"eps_greedy_SVM","SVM",56,9,1784,1708,76,1000,808,192,0.815082261058833,0.235772357723577,1.26299501704694,485,192,293,65,1.5,35.92,4.2,0,0,0,0,0,0,0.191750977093074,143.778399670765,20.260621241224
9.7,"eps_greedy_SVM","SVM",56,10,1684,1632,52,1100,884,216,0.819256129569174,0.268292682926829,1.25255704169945,535,216,319,50,1.5,39.51,4.1,0,0,0,0,0,0,0.17866794606193,118.581131755882,19.1219368278566
9.7,"eps_greedy_SVM","SVM",56,11,1584,1543,41,1200,973,227,0.811292490877668,0.252032520325203,1.25255704169945,570,227,343,35,1.5,43.1,4.3,0,0,0,0,0,0,0.181453192064519,138.996450966532,18.9950254895614
9.7,"eps_greedy_SVM","SVM",56,12,1484,1450,34,1300,1066,234,0.819832277062929,0.276422764227642,1.25255704169945,591,234,357,21,1.5,46.7,4.6,0,0,0,0,0,0,0.166116325372657,116.046334908167,17.3643696040381
9.7,"eps_greedy_SVM","SVM",56,13,1384,1359,25,1400,1157,243,0.797196082197048,0.195121951219512,1.25255704169945,624,243,381,33,1.6,50.29,4.8,0,0,0,0,0,0,0.164499808022665,94.7969212460459,17.4361299303267
9.7,"eps_greedy_SVM","SVM",56,14,1284,1260,24,1500,1256,244,0.804065040650411,0.219512195121951,1.25255704169945,637,244,393,13,1.6,53.88,5.1,0,0,0,0,0,0,0.151512719747052,75.0759118841379,16.143948601602
9.7,"eps_greedy_SVM","SVM",56,15,1184,1163,21,1600,1353,247,0.796792778951418,0.235772357723577,1.25255704169945,651,247,404,14,1.6,57.47,5.5,0,0,0,0,0,0,0.131982211863228,61.3011797859831,13.8618554978248
9.7,"eps_greedy_SVM","SVM",56,16,1084,1064,20,1700,1452,248,0.790858459765706,0.268292682926829,1.25255704169945,639,248,391,-12,1.6,61.06,5.9,0,0,0,0,0,0,0.104274833080661,36.2626725330852,11.6048440113805
9.7,"eps_greedy_SVM","SVM",56,17,984,965,19,1800,1551,249,0.789360476281936,0.227642276422764,1.25255704169945,668,249,419,29,1.7,64.66,6.2,0,0,0,0,0,0,0.0671644280490521,18.8328572045279,8.65997192620566
9.7,"eps_greedy_SVM","SVM",56,18,884,867,17,1900,1649,251,0.784796107803604,0.203252032520325,1.25255704169945,654,251,403,-14,1.6,68.25,6.6,0,0,0,0,0,0,0.024059465643307,6.42617483902355,4.39257964876338
9.7,"eps_greedy_SVM","SVM",56,19,784,769,15,2000,1747,253,0.80726586006018,0.227642276422764,1.25255704169945,657,253,404,3,1.6,71.84,6.9,0,0,0,0,0,0,0.00386600408215808,1.75988606947389,1.48242037906363
9.7,"eps_greedy_SVM","SVM",56,20,684,672,12,2100,1844,256,0.830574227002119,0.300813008130081,1.26299501704694,685,256,429,28,1.7,75.43,7.2,0,0,0,0,0,0,0.0202273761532883,5.96460597859687,3.71800226260039
9.7,"eps_greedy_SVM","SVM",56,21,584,574,10,2200,1942,258,0.831924972793041,0.284552845528455,1.27343299239444,694,258,436,9,1.7,79.02,7.5,0,0,0,0,0,0,0.0348240137272476,9.53499952952055,5.80578326301458
9.7,"eps_greedy_SVM","SVM",56,22,484,475,9,2300,2041,259,0.820843735996419,0.219512195121951,1.28387096774194,677,259,418,-17,1.6,82.61,7.9,0,0,0,0,0,0,0.0138017194110811,4.29411427195249,3.15253792022956
9.7,"eps_greedy_SVM","SVM",56,23,384,381,3,2400,2135,265,0.806670507649956,0.195121951219512,1.28387096774194,718,265,453,41,1.7,86.21,8.1,0,0,0,0,0,0,0.00193285252852691,1.74974914094572,1.63444028929744
9.7,"eps_greedy_SVM","SVM",56,24,284,283,1,2500,2233,267,0.81575443313488,0.16260162601626,1.28387096774194,747,267,480,29,1.8,89.8,8.4,0,0,0,0,0,0,0.0199275633893268,7.41959784020283,6.51371663889052
9.7,"eps_greedy_SVM","SVM",56,25,184,184,0,2600,2332,268,0.82503680942321,0.211382113821138,1.28387096774194,737,268,469,-10,1.8,93.39,8.7,0,0,0,0,0,0,0.000223744709659907,2.49729076812971,2.49352112102025
9.7,"eps_greedy_SVM","SVM",56,26,84,84,0,2700,2432,268,0.792452467831763,0.16260162601626,1.28387096774194,741,268,473,4,1.8,96.98,9.1,0,0,0,0,0,0,1.75991577975322e-07,0.00866078523901896,0.00866078523901896
9.7,"eps_greedy_SVM","SVM",56,27,0,0,0,2784,2516,268,0.809845720504444,0.203252032520325,1.28387096774194,761,268,493,20,1.8,100,9.4,0,0,0,0,0,0,0,0,0
9.7,"eps_greedy_SVM","SVM",57,0,2684,2427,257,100,87,13,0.832501689276997,0.347107438016529,1.25203945614503,29,13,16,0,1.2,3.59,6.7,0,0,0,0,0,0,0.390895398796882,375.440420310307,42.1692469753851
9.7,"eps_greedy_SVM","SVM",57,1,2584,2370,214,200,144,56,0.776417693227295,0.140495867768595,1.2732604638763,128,56,72,99,1.3,7.18,2.6,0,0,0,0,0,0,0.308696970989314,659.105508374176,32.2679281472512
9.7,"eps_greedy_SVM","SVM",57,2,2484,2290,194,300,224,76,0.746556473829199,0.223140495867769,1.23081844841376,176,76,100,48,1.3,10.78,2.9,0,0,0,0,0,0,0.254631850545713,576.417867131944,26.1168054210619
9.7,"eps_greedy_SVM","SVM",57,3,2384,2206,178,400,308,92,0.830052237642286,0.231404958677686,1.2732604638763,211,92,119,35,1.3,14.37,3.3,0,0,0,0,0,0,0.263435909586156,257.102405366518,27.9699883073207
9.7,"eps_greedy_SVM","SVM",57,4,2284,2128,156,500,386,114,0.841883673787625,0.297520661157025,1.2732604638763,274,114,160,63,1.4,17.96,3.4,0,0,0,0,0,0,0.247472845176356,209.944373478177,25.4505668689834
9.7,"eps_greedy_SVM","SVM",57,5,2184,2058,126,600,456,144,0.840428296689026,0.28099173553719,1.26264996001066,345,144,201,71,1.4,21.55,3.2,0,0,0,0,0,0,0.250862545156556,235.19209998386,25.8840310784768
9.7,"eps_greedy_SVM","SVM",57,6,2084,1986,98,700,528,172,0.831325692603566,0.256198347107438,1.2732604638763,398,172,226,53,1.3,25.14,3.1,0,0,0,0,0,0,0.248833709653935,216.569182451483,26.7616454379608
9.7,"eps_greedy_SVM","SVM",57,7,1984,1908,76,800,606,194,0.829902801600913,0.272727272727273,1.2732604638763,463,194,269,65,1.4,28.74,3.1,0,0,0,0,0,0,0.240499911347383,209.22859595021,25.1407918403107
9.7,"eps_greedy_SVM","SVM",57,8,1884,1819,65,900,695,205,0.833365819429284,0.297520661157025,1.26264996001066,498,205,293,35,1.4,32.33,3.4,0,0,0,0,0,0,0.186861035214917,78.106059391182,20.5307114765597
9.7,"eps_greedy_SVM","SVM",57,9,1784,1734,50,1000,780,220,0.821203025105255,0.247933884297521,1.25203945614503,541,220,321,43,1.5,35.92,3.5,0,0,0,0,0,0,0.194657662754673,132.776200096011,20.7529985248534
9.7,"eps_greedy_SVM","SVM",57,10,1684,1642,42,1100,872,228,0.837543531368574,0.289256198347107,1.2732604638763,548,228,320,7,1.4,39.51,3.8,0,0,0,0,0,0,0.159986069088321,67.7906924950008,17.7900400902316
9.7,"eps_greedy_SVM","SVM",57,11,1584,1551,33,1200,963,237,0.828629346639639,0.256198347107438,1.24142895227939,592,237,355,44,1.5,43.1,4.1,0,0,0,0,0,0,0.178884204798065,96.6074362834209,20.080719483938
9.7,"eps_greedy_SVM","SVM",57,12,1484,1452,32,1300,1062,238,0.845171266697851,0.31404958677686,1.26264996001066,590,238,352,-2,1.5,46.7,4.5,0,0,0,0,0,0,0.126420617669704,59.9489179270398,14.7786571086535
9.7,"eps_greedy_SVM","SVM",57,13,1384,1359,25,1400,1155,245,0.831150267685429,0.272727272727273,1.24142895227939,625,245,380,35,1.6,50.29,4.7,0,0,0,0,0,0,0.144496129435169,92.8465916408216,17.6285742092328
9.7,"eps_greedy_SVM","SVM",57,14,1284,1261,23,1500,1253,247,0.808682883725767,0.231404958677686,1.23081844841376,624,247,377,-1,1.5,53.88,5.1,0,0,0,0,0,0,0.0948242237554502,37.5079740758764,12.1164034338701
9.7,"eps_greedy_SVM","SVM",57,15,1184,1162,22,1600,1352,248,0.815673891574414,0.247933884297521,1.23081844841376,633,248,385,9,1.6,57.47,5.5,0,0,0,0,0,0,0.0997241140683657,39.8951649890688,12.0087616812358
9.7,"eps_greedy_SVM","SVM",57,16,1084,1064,20,1700,1450,250,0.816531524507521,0.247933884297521,1.24142895227939,644,250,394,11,1.6,61.06,5.8,0,0,0,0,0,0,0.058498076421114,20.2951779051479,7.06214324859366
9.7,"eps_greedy_SVM","SVM",57,17,984,967,17,1800,1547,253,0.80503144654088,0.214876033057851,1.24142895227939,644,253,391,0,1.5,64.66,6.1,0,0,0,0,0,0,0.0547412865332375,20.9848573538732,8.08019413319275
9.7,"eps_greedy_SVM","SVM",57,18,884,869,15,1900,1645,255,0.820910650241696,0.247933884297521,1.24142895227939,657,255,402,13,1.6,68.25,6.5,0,0,0,0,0,0,0.0179361784977531,5.46376848139943,2.48465965052652
9.7,"eps_greedy_SVM","SVM",57,19,784,772,12,2000,1742,258,0.825309267633453,0.28099173553719,1.25203945614503,664,258,406,7,1.6,71.84,6.8,0,0,0,0,0,0,0.0363027779683294,13.0661622451988,4.75913881868635
9.7,"eps_greedy_SVM","SVM",57,20,684,674,10,2100,1840,260,0.806220437652682,0.214876033057851,1.27208803250993,673,260,413,9,1.6,75.43,7.1,0,0,0,0,0,0,0.0291685811313155,10.3900385120186,4.14325351314536
9.7,"eps_greedy_SVM","SVM",57,21,584,580,4,2200,1934,266,0.818662612401891,0.206611570247934,1.2732604638763,711,266,445,38,1.7,79.02,7.3,0,0,0,0,0,0,0.0672635842817283,29.2351674798754,20.2091125353326
9.7,"eps_greedy_SVM","SVM",57,22,484,484,0,2300,2030,270,0.754587036748276,0.15702479338843,1.28268876611418,743,270,473,32,1.8,82.61,7.5,0,0,0,0,0,0,0.0233463194341088,6.87731764218756,4.32904374934675
9.7,"eps_greedy_SVM","SVM",57,23,384,384,0,2400,2130,270,0.842819273351005,0.264462809917355,1.28268876611418,713,270,443,-30,1.6,86.21,7.9,0,0,0,0,0,0,0.0112970226548454,2.97473435751009,1.96842584332918
9.7,"eps_greedy_SVM","SVM",57,24,284,284,0,2500,2230,270,0.799021518789962,0.173553719008264,1.2732604638763,733,270,463,20,1.7,89.8,8.3,0,0,0,0,0,0,0.00497166115237636,1.27975178521209,1.01964547491255
9.7,"eps_greedy_SVM","SVM",57,25,184,184,0,2600,2330,270,0.774364571963205,0.173553719008264,1.27208803250993,739,270,469,6,1.7,93.39,8.6,0,0,0,0,0,0,0.00096058072100786,0.40294163113294,0.374695265672965
9.7,"eps_greedy_SVM","SVM",57,26,84,84,0,2700,2430,270,0.822989760382556,0.223140495867769,1.2732604638763,754,270,484,15,1.8,96.98,9,0,0,0,0,0,0,1.18423751336005e-06,0.048543126887888,0.048543126887888
9.7,"eps_greedy_SVM","SVM",57,27,0,0,0,2784,2514,270,0.836172618119446,0.247933884297521,1.27208803250993,725,270,455,-29,1.7,100,9.3,0,0,0,0,0,0,0,0,0
9.7,"eps_greedy_SVM","SVM",58,0,2684,2431,253,100,93,7,0.821530104886216,0.297709923664122,1.24466880078798,19,7,12,0,1.7,3.59,13.3,0,0,0,0,0,0,0.163107538100949,208.449810174953,17.9130090682015
9.7,"eps_greedy_SVM","SVM",58,1,2584,2365,219,200,159,41,0.691371989208936,0.213740458015267,1.24466880078798,105,41,64,86,1.6,7.18,3.9,0,0,0,0,0,0,0.244690508996086,530.929067195736,26.7625264211623
9.7,"eps_greedy_SVM","SVM",58,2,2484,2283,201,300,241,59,0.796215869636218,0.251908396946565,1.22506771731101,149,59,90,44,1.5,10.78,4.1,0,0,0,0,0,0,0.269921118613112,279.287975668228,29.1746763532251
9.7,"eps_greedy_SVM","SVM",58,3,2384,2211,173,400,313,87,0.838581676969792,0.229007633587786,1.28387096774194,213,87,126,64,1.4,14.37,3.6,0,0,0,0,0,0,0.264338229499184,291.102618663472,31.7235638643792
9.7,"eps_greedy_SVM","SVM",58,4,2284,2123,161,500,401,99,0.814598178100912,0.229007633587786,1.26426988426496,252,99,153,39,1.5,17.96,4.1,0,0,0,0,0,0,0.227374049717714,272.270397981137,24.962812199044
9.7,"eps_greedy_SVM","SVM",58,5,2184,2037,147,600,487,113,0.835877862595418,0.305343511450382,1.28387096774194,293,113,180,41,1.6,21.55,4.3,0,0,0,0,0,0,0.216190273308721,255.480809457369,22.1395156239177
9.7,"eps_greedy_SVM","SVM",58,6,2084,1967,117,700,557,143,0.826121145401092,0.251908396946565,1.27407042600345,369,143,226,76,1.6,25.14,3.9,0,0,0,0,0,0,0.21612689616737,192.752753382892,22.3674899631617
9.7,"eps_greedy_SVM","SVM",58,7,1984,1889,95,800,635,165,0.845090187633827,0.305343511450382,1.28387096774194,414,165,249,45,1.5,28.74,3.8,0,0,0,0,0,0,0.212877419537093,146.873088217531,22.1049918299343
9.7,"eps_greedy_SVM","SVM",58,8,1884,1806,78,900,718,182,0.822207570680243,0.206106870229008,1.26426988426496,470,182,288,56,1.6,32.33,3.9,0,0,0,0,0,0,0.204063947563561,163.019109327841,21.5986129198891
9.7,"eps_greedy_SVM","SVM",58,9,1784,1725,59,1000,799,201,0.840825782412496,0.312977099236641,1.26426988426496,515,201,314,45,1.6,35.92,4,0,0,0,0,0,0,0.201749241624191,155.596698308831,21.2473425449682
9.7,"eps_greedy_SVM","SVM",58,10,1684,1635,49,1100,889,211,0.84569506780706,0.290076335877863,1.26426988426496,539,211,328,24,1.6,39.51,4.2,0,0,0,0,0,0,0.167755475563025,109.160870177579,18.1843903976215
9.7,"eps_greedy_SVM","SVM",58,11,1584,1551,33,1200,973,227,0.811235044337711,0.183206106870229,1.26426988426496,592,227,365,53,1.6,43.1,4.3,0,0,0,0,0,0,0.187721515567312,141.038526398945,20.4726768939092
9.7,"eps_greedy_SVM","SVM",58,12,1484,1457,27,1300,1067,233,0.80565804914046,0.229007633587786,1.26426988426496,615,233,382,23,1.6,46.7,4.6,0,0,0,0,0,0,0.163636469114521,125.4613853711,17.6357271945258
9.7,"eps_greedy_SVM","SVM",58,13,1384,1361,23,1400,1163,237,0.840716903981314,0.312977099236641,1.26426988426496,629,237,392,14,1.7,50.29,4.9,0,0,0,0,0,0,0.113073445941304,67.6438305722811,12.8777426565485
9.7,"eps_greedy_SVM","SVM",58,14,1284,1264,20,1500,1260,240,0.775728578168663,0.152671755725191,1.24466880078798,636,240,396,7,1.6,53.88,5.2,0,0,0,0,0,0,0.14498022076366,93.5435050425005,17.8308660134827
9.7,"eps_greedy_SVM","SVM",58,15,1184,1165,19,1600,1359,241,0.753130254896501,0.16030534351145,1.24466880078798,660,241,419,24,1.7,57.47,5.6,0,0,0,0,0,0,0.137548307026725,81.9433277204724,15.2997420795521
9.7,"eps_greedy_SVM","SVM",58,16,1084,1066,18,1700,1458,242,0.745206324627087,0.137404580152672,1.24466880078798,654,242,412,-6,1.7,61.06,6,0,0,0,0,0,0,0.12674186274428,72.2042705555519,14.3525550671068
9.7,"eps_greedy_SVM","SVM",58,17,984,967,17,1800,1557,243,0.730834371710959,0.129770992366412,1.24466880078798,666,243,423,12,1.7,64.66,6.4,0,0,0,0,0,0,0.0955132979408577,43.5300898611004,10.6272956862908
9.7,"eps_greedy_SVM","SVM",58,18,884,867,17,1900,1657,243,0.779545372061788,0.213740458015267,1.24466880078798,663,243,420,-3,1.7,68.25,6.8,0,0,0,0,0,0,0.0876856294749347,40.8165188579178,9.92139125417506
9.7,"eps_greedy_SVM","SVM",58,19,784,768,16,2000,1756,244,0.762451458366094,0.16793893129771,1.24466880078798,671,244,427,8,1.8,71.84,7.2,0,0,0,0,0,0,0.067060447715805,27.7385412034842,8.17707606826911
9.7,"eps_greedy_SVM","SVM",58,20,684,668,16,2100,1856,244,0.779732884915494,0.206106870229008,1.24466880078798,660,244,416,-11,1.7,75.43,7.6,0,0,0,0,0,0,0.050765528272035,18.990586148072,6.08629846723591
9.7,"eps_greedy_SVM","SVM",58,21,584,572,12,2200,1952,248,0.75017239084937,0.145038167938931,1.26426988426496,682,248,434,22,1.8,79.02,7.9,0,0,0,0,0,0,0.101879862771478,41.1271613094803,17.5249987364601
9.7,"eps_greedy_SVM","SVM",58,22,484,472,12,2300,2052,248,0.749682437909045,0.16030534351145,1.25446934252647,687,248,439,5,1.8,82.61,8.3,0,0,0,0,0,0,0.0515947542448389,14.5542194087615,7.23060926570043
9.7,"eps_greedy_SVM","SVM",58,23,384,374,10,2400,2150,250,0.822764060439624,0.259541984732824,1.28268876611418,719,250,469,32,1.9,86.21,8.6,0,0,0,0,0,0,0.0416197785403399,9.40510019993742,6.44308169132059
9.7,"eps_greedy_SVM","SVM",58,24,284,282,2,2500,2242,258,0.696404592250273,0.145038167938931,1.28268876611418,711,258,453,-8,1.8,89.8,8.7,0,0,0,0,0,0,0.00607355889491309,2.51501956393332,2.33735365405413
9.7,"eps_greedy_SVM","SVM",58,25,184,184,0,2600,2340,260,0.752228983438379,0.16793893129771,1.28268876611418,718,260,458,7,1.8,93.39,9,0,0,0,0,0,0,1.72443525588511e-06,0.350940814361154,0.350913691922996
9.7,"eps_greedy_SVM","SVM",58,26,84,84,0,2700,2440,260,0.711472157365624,0.114503816793893,1.28268876611418,726,260,466,8,1.8,96.98,9.4,0,0,0,0,0,0,1.21921785271505e-08,0.0384486108992941,0.0384486108992941
9.7,"eps_greedy_SVM","SVM",58,27,0,0,0,2784,2524,260,0.780712790796141,0.206106870229008,1.2728972488156,738,260,478,12,1.8,100,9.7,0,0,0,0,0,0,0,0,0
9.7,"eps_greedy_SVM","SVM",59,0,2684,2426,258,100,92,8,0.297779179810724,0,0.708696774193548,38,8,30,0,3.8,3.59,11.5,0,0,0,0,0,0,0.125352943111851,225.886476013563,13.3841682326891
9.7,"eps_greedy_SVM","SVM",59,1,2584,2326,258,200,192,8,0.695331230283912,0.08,1.16061935483871,39,8,31,1,3.9,7.18,24,0,0,0,0,0,0,0.099400762402215,172.67767316733,10.9440365450809
9.7,"eps_greedy_SVM","SVM",59,2,2484,2234,250,300,284,16,0.666138801261832,0.336,1.0989935483871,51,16,35,12,2.2,10.78,17.8,0,0,0,0,0,0,0.0738987346307361,138.743484191452,8.01171537934883
9.7,"eps_greedy_SVM","SVM",59,3,2384,2169,215,400,349,51,0.724927444794958,0.128,1.20170322580645,133,51,82,82,1.6,14.37,6.8,0,0,0,0,0,0,0.230914064696381,308.206402293027,32.3618718705787
9.7,"eps_greedy_SVM","SVM",59,4,2284,2082,202,500,436,64,0.796725552050468,0.216,1.24278709677419,161,64,97,28,1.5,17.96,6.8,0,0,0,0,0,0,0.191439491434286,225.805499097614,20.8593356767587
9.7,"eps_greedy_SVM","SVM",59,5,2184,2000,184,600,518,82,0.778529968454256,0.248,1.24278709677419,213,82,131,52,1.6,21.55,6.3,0,0,0,0,0,0,0.173792371139745,196.467542587741,18.0531379683032
9.7,"eps_greedy_SVM","SVM",59,6,2084,1930,154,700,588,112,0.773716088328074,0.2,1.24278709677419,284,112,172,71,1.5,25.14,5.2,0,0,0,0,0,0,0.187649055211281,186.222334691775,21.7409049241526
9.7,"eps_greedy_SVM","SVM",59,7,1984,1847,137,800,671,129,0.803501577287063,0.312,1.24278709677419,318,129,189,34,1.5,28.74,5.2,0,0,0,0,0,0,0.178295830245803,158.036721769969,18.9016185643233
9.7,"eps_greedy_SVM","SVM",59,8,1884,1777,107,900,741,159,0.810264984227127,0.288,1.24278709677419,395,159,236,77,1.5,32.33,4.7,0,0,0,0,0,0,0.188369660173402,164.724145116984,19.8868273121973
9.7,"eps_greedy_SVM","SVM",59,9,1784,1687,97,1000,831,169,0.820965299684542,0.272,1.24278709677419,406,169,237,11,1.4,35.92,4.9,0,0,0,0,0,0,0.170884098900094,110.435585680625,20.2922106003364
9.7,"eps_greedy_SVM","SVM",59,10,1684,1596,88,1100,922,178,0.812195583596211,0.24,1.24278709677419,431,178,253,25,1.4,39.51,5.2,0,0,0,0,0,0,0.155120791552481,110.117663019459,16.6612390125833
9.7,"eps_greedy_SVM","SVM",59,11,1584,1514,70,1200,1004,196,0.828321766561509,0.256,1.24278709677419,499,196,303,68,1.5,43.1,5.1,0,0,0,0,0,0,0.167982273707947,162.748776584251,17.2935044010886
9.7,"eps_greedy_SVM","SVM",59,12,1484,1426,58,1300,1092,208,0.805848580441637,0.2,1.24278709677419,529,208,321,30,1.5,46.7,5.2,0,0,0,0,0,0,0.158087716996717,108.34926836879,17.7065732877553
9.7,"eps_greedy_SVM","SVM",59,13,1384,1343,41,1400,1175,225,0.836914826498421,0.224,1.24278709677419,566,225,341,37,1.5,50.29,5.2,0,0,0,0,0,0,0.158642343241543,111.118324287098,16.9020851467347
9.7,"eps_greedy_SVM","SVM",59,14,1284,1252,32,1500,1266,234,0.799974763406939,0.192,1.24278709677419,600,234,366,34,1.6,53.88,5.4,0,0,0,0,0,0,0.13846051233071,71.8294491319585,15.2762835434837
9.7,"eps_greedy_SVM","SVM",59,15,1184,1155,29,1600,1363,237,0.785223974763406,0.208,1.24278709677419,614,237,377,14,1.6,57.47,5.8,0,0,0,0,0,0,0.1224911054632,53.5601045895552,14.2595212972359
9.7,"eps_greedy_SVM","SVM",59,16,1084,1056,28,1700,1462,238,0.806542586750788,0.2,1.24278709677419,626,238,388,12,1.6,61.06,6.1,0,0,0,0,0,0,0.115681871237815,55.9431826055532,12.5300327163259
9.7,"eps_greedy_SVM","SVM",59,17,984,957,27,1800,1561,239,0.795987381703468,0.192,1.24278709677419,626,239,387,0,1.6,64.66,6.5,0,0,0,0,0,0,0.0763045561556315,26.4550864537531,8.77452730734056
9.7,"eps_greedy_SVM","SVM",59,18,884,858,26,1900,1660,240,0.810776025236589,0.232,1.23251612903226,633,240,393,7,1.6,68.25,6.9,0,0,0,0,0,0,0.06815641965496,21.9534216752388,7.81359041475478
9.7,"eps_greedy_SVM","SVM",59,19,784,759,25,2000,1759,241,0.784252365930598,0.184,1.23251612903226,646,241,405,13,1.7,71.84,7.3,0,0,0,0,0,0,0.0414594944310837,11.7398943361719,5.5655719262823
9.7,"eps_greedy_SVM","SVM",59,20,684,663,21,2100,1855,245,0.807924290220816,0.232,1.23251612903226,635,245,390,-11,1.6,75.43,7.6,0,0,0,0,0,0,0.0387682065249831,11.5382925333021,5.07917999670584
9.7,"eps_greedy_SVM","SVM",59,21,584,567,17,2200,1951,249,0.791293375394321,0.2,1.24278709677419,655,249,406,20,1.6,79.02,7.8,0,0,0,0,0,0,0.0298410940539786,8.79949717975955,4.45067144989877
9.7,"eps_greedy_SVM","SVM",59,22,484,469,15,2300,2049,251,0.816731861198741,0.216,1.25305806451613,665,251,414,10,1.6,82.61,8.2,0,0,0,0,0,0,0.0244162546641479,7.03446287495937,3.35682707312332
9.7,"eps_greedy_SVM","SVM",59,23,384,375,9,2400,2143,257,0.824731861198741,0.216,1.26332903225806,697,257,440,32,1.7,86.21,8.3,0,0,0,0,0,0,0.0168887227127582,4.93625683402899,3.25539408232864
9.7,"eps_greedy_SVM","SVM",59,24,284,280,4,2500,2238,262,0.784447949526824,0.184,1.2736,700,262,438,3,1.7,89.8,8.5,0,0,0,0,0,0,0.0169259845907985,4.13113433842585,3.23233200371863
9.7,"eps_greedy_SVM","SVM",59,25,184,184,0,2600,2334,266,0.788441640378553,0.208,1.2736,723,266,457,23,1.7,93.39,8.8,0,0,0,0,0,0,0.00138880630737506,0.796714125081281,0.796336035239613
9.7,"eps_greedy_SVM","SVM",59,26,84,84,0,2700,2434,266,0.791356466876979,0.224,1.2736,727,266,461,4,1.7,96.98,9.2,0,0,0,0,0,0,1.0433549668991e-11,0.0574573089609348,0.0574573089609348
9.7,"eps_greedy_SVM","SVM",59,27,0,0,0,2784,2518,266,0.818138801261838,0.232,1.2736,732,266,466,5,1.8,100,9.5,0,0,0,0,0,0,0,0,0
9.7,"eps_greedy_SVM","SVM",60,0,2684,2437,247,100,91,9,0.818141671082847,0.288888888888889,1.28387096774194,29,9,20,0,2.2,3.59,10.1,0,0,0,0,0,0,0.152747984904713,254.340124493772,16.9268705776358
9.7,"eps_greedy_SVM","SVM",60,1,2584,2361,223,200,167,33,0.805328858270037,0.192592592592593,1.28387096774194,84,33,51,55,1.5,7.18,5.1,0,0,0,0,0,0,0.243256424212487,283.761129135937,28.9597290643022
9.7,"eps_greedy_SVM","SVM",60,2,2484,2271,213,300,257,43,0.827150680091854,0.251851851851852,1.28387096774194,119,43,76,35,1.8,10.78,6,0,0,0,0,0,0,0.190563277961768,167.619836874358,20.4206466089372
9.7,"eps_greedy_SVM","SVM",60,3,2384,2199,185,400,329,71,0.826467644114703,0.303703703703704,1.28387096774194,176,71,105,57,1.5,14.37,4.6,0,0,0,0,0,0,0.207629939726416,244.234287381904,21.2818484449432
9.7,"eps_greedy_SVM","SVM",60,4,2284,2134,150,500,394,106,0.831637519872818,0.296296296296296,1.27436081242533,258,106,152,82,1.4,17.96,3.7,0,0,0,0,0,0,0.241734462071219,164.366838243164,24.8275816056708
9.7,"eps_greedy_SVM","SVM",60,5,2184,2056,128,600,472,128,0.837213684272512,0.296296296296296,1.27436081242533,323,128,195,65,1.5,21.55,3.7,0,0,0,0,0,0,0.227435388128063,135.325565644752,23.4322265062357
9.7,"eps_greedy_SVM","SVM",60,6,2084,1979,105,700,549,151,0.84631101689926,0.318518518518519,1.27436081242533,372,151,221,49,1.5,25.14,3.6,0,0,0,0,0,0,0.207577829960983,102.853696931127,22.4370094037059
9.7,"eps_greedy_SVM","SVM",60,7,1984,1906,78,800,622,178,0.843537655302368,0.318518518518519,1.27436081242533,456,178,278,84,1.6,28.74,3.5,0,0,0,0,0,0,0.200320393457793,109.695389975699,21.4803318699653
9.7,"eps_greedy_SVM","SVM",60,8,1884,1822,62,900,706,194,0.824954366130839,0.244444444444444,1.26485065710872,495,194,301,39,1.6,32.33,3.6,0,0,0,0,0,0,0.202032133853844,137.316473082627,22.0522378537354
9.7,"eps_greedy_SVM","SVM",60,9,1784,1730,54,1000,798,202,0.831484425602078,0.251851851851852,1.26485065710872,532,202,330,37,1.6,35.92,4,0,0,0,0,0,0,0.191707398789451,116.853859076953,25.0494436429697
9.7,"eps_greedy_SVM","SVM",60,10,1684,1638,46,1100,890,210,0.827515751045169,0.222222222222222,1.26485065710872,567,210,357,35,1.7,39.51,4.2,0,0,0,0,0,0,0.16058360995889,71.1621212769103,18.375898758584
9.7,"eps_greedy_SVM","SVM",60,11,1584,1553,31,1200,975,225,0.805670376258616,0.2,1.24583034647551,594,225,369,27,1.6,43.1,4.3,0,0,0,0,0,0,0.203382163386148,186.290865087989,30.6144521990719
9.7,"eps_greedy_SVM","SVM",60,12,1484,1457,27,1300,1071,229,0.840622975917093,0.237037037037037,1.26485065710872,605,229,376,11,1.6,46.7,4.7,0,0,0,0,0,0,0.151363623687288,71.6853392816738,17.9141462764838
9.7,"eps_greedy_SVM","SVM",60,13,1384,1365,19,1400,1163,237,0.823270329152681,0.237037037037037,1.26485065710872,629,237,392,24,1.7,50.29,4.9,0,0,0,0,0,0,0.132041589993878,57.3965036743779,15.0414648829047
9.7,"eps_greedy_SVM","SVM",60,14,1284,1266,18,1500,1262,238,0.842377671789436,0.266666666666667,1.26485065710872,656,238,418,27,1.8,53.88,5.3,0,0,0,0,0,0,0.0800694567410883,29.7119735968874,9.45139373794868
9.7,"eps_greedy_SVM","SVM",60,15,1184,1175,9,1600,1353,247,0.835176352823421,0.251851851851852,1.27436081242533,672,247,425,16,1.7,57.47,5.5,0,0,0,0,0,0,0.0817035922482806,35.5645903864098,11.0168566656449
9.7,"eps_greedy_SVM","SVM",60,16,1084,1079,5,1700,1449,251,0.834722958252381,0.237037037037037,1.27436081242533,703,251,452,31,1.8,61.06,5.8,0,0,0,0,0,0,0.0644075429927024,23.2712501094351,9.58928201197134
9.7,"eps_greedy_SVM","SVM",60,17,984,980,4,1800,1548,252,0.805841135252913,0.214814814814815,1.27436081242533,698,252,446,-5,1.8,64.66,6.1,0,0,0,0,0,0,0.0550731428417677,20.4412783353249,9.64285110794998
9.7,"eps_greedy_SVM","SVM",60,18,884,880,4,1900,1648,252,0.815115115115124,0.237037037037037,1.27436081242533,702,252,450,4,1.8,68.25,6.5,0,0,0,0,0,0,0.0601489267362141,22.0055967738928,6.98046440368323
9.7,"eps_greedy_SVM","SVM",60,19,784,781,3,2000,1747,253,0.839457104162997,0.259259259259259,1.27436081242533,711,253,458,9,1.8,71.84,6.9,0,0,0,0,0,0,0.051056159660737,17.5145880628023,6.49944371831892
9.7,"eps_greedy_SVM","SVM",60,20,684,682,2,2100,1846,254,0.848101042218696,0.303703703703704,1.27436081242533,716,254,462,5,1.8,75.43,7.3,0,0,0,0,0,0,0.0300803605718653,10.0706373212329,4.16499839032275
9.7,"eps_greedy_SVM","SVM",60,21,584,582,2,2200,1946,254,0.817117117117123,0.244444444444444,1.27436081242533,706,254,452,-10,1.8,79.02,7.7,0,0,0,0,0,0,0.0136342773355653,3.79167796254826,1.94590466516558
9.7,"eps_greedy_SVM","SVM",60,22,484,483,1,2300,2045,255,0.806694930224355,0.207407407407407,1.27436081242533,714,255,459,8,1.8,82.61,8,0,0,0,0,0,0,0.0501489676880092,13.4849400031244,9.06063396964716
9.7,"eps_greedy_SVM","SVM",60,23,384,383,1,2400,2145,255,0.814750044161815,0.259259259259259,1.27436081242533,710,255,455,-4,1.8,86.21,8.4,0,0,0,0,0,0,0.0121770978417459,3.38167268202364,2.33418885983227
9.7,"eps_greedy_SVM","SVM",60,24,284,284,0,2500,2244,256,0.834993817346767,0.281481481481481,1.27436081242533,707,256,451,-3,1.8,89.8,8.8,0,0,0,0,0,0,0.0065570724381569,6.67312066240471,6.42020028592786
9.7,"eps_greedy_SVM","SVM",60,25,184,184,0,2600,2344,256,0.74415003238533,0.155555555555556,1.27436081242533,730,256,474,23,1.9,93.39,9.2,0,0,0,0,0,0,0.000183881556444339,0.258569796053134,0.254813199031699
9.7,"eps_greedy_SVM","SVM",60,26,84,84,0,2700,2444,256,0.804251310133669,0.222222222222222,1.27436081242533,723,256,467,-7,1.8,96.98,9.5,0,0,0,0,0,0,6.09595318681446e-07,0.00819095727346689,0.00819095727346689
9.7,"eps_greedy_SVM","SVM",60,27,0,0,0,2784,2528,256,0.799252193369849,0.214814814814815,1.27436081242533,705,256,449,-18,1.8,100,9.9,0,0,0,0,0,0,0,0,0
9.7,"eps_greedy_SVM","SVM",61,0,2684,2420,264,100,91,9,0.787411100033237,0.254237288135593,1.27299070530344,31,9,22,0,2.4,3.59,10.1,0,0,0,0,0,0,0.0921401997378673,246.140572584944,9.22668708265654
9.7,"eps_greedy_SVM","SVM",61,1,2584,2343,241,200,168,32,0.803562645397145,0.355932203389831,1.26211044286495,89,32,57,58,1.8,7.18,5.2,0,0,0,0,0,0,0.192091469574891,328.358495564868,20.7348453098108
9.7,"eps_greedy_SVM","SVM",61,2,2484,2280,204,300,231,69,0.788035892323033,0.152542372881356,1.26211044286495,172,69,103,83,1.5,10.78,3.3,0,0,0,0,0,0,0.250732668683132,480.56478613152,26.1595028764896
9.7,"eps_greedy_SVM","SVM",61,3,2384,2189,195,400,322,78,0.835068128946499,0.322033898305085,1.26211044286495,192,78,114,20,1.5,14.37,4.1,0,0,0,0,0,0,0.206824427914654,245.132257357557,21.9172659307069
9.7,"eps_greedy_SVM","SVM",61,4,2284,2124,160,500,387,113,0.825716184779003,0.279661016949153,1.25123018042646,274,113,161,82,1.4,17.96,3.4,0,0,0,0,0,0,0.229697924445832,364.367378058663,23.6523197340429
9.7,"eps_greedy_SVM","SVM",61,5,2184,2049,135,600,462,138,0.819062811565311,0.271186440677966,1.25123018042646,337,138,199,63,1.4,21.55,3.3,0,0,0,0,0,0,0.226910649921254,269.770020185617,23.9042589132579
9.7,"eps_greedy_SVM","SVM",61,6,2084,1976,108,700,535,165,0.823482884679302,0.279661016949153,1.26211044286495,395,165,230,58,1.4,25.14,3.2,0,0,0,0,0,0,0.23195861343626,297.235856533909,23.6896909074923
9.7,"eps_greedy_SVM","SVM",61,7,1984,1900,84,800,611,189,0.809777334662686,0.26271186440678,1.24034991798797,453,189,264,58,1.4,28.74,3.2,0,0,0,0,0,0,0.228143083384023,182.603984537204,24.463132630709
9.7,"eps_greedy_SVM","SVM",61,8,1884,1805,79,900,706,194,0.806972416085087,0.271186440677966,1.24034991798797,477,194,283,24,1.5,32.33,3.6,0,0,0,0,0,0,0.201083531908729,211.896189856448,20.904944807948
9.7,"eps_greedy_SVM","SVM",61,9,1784,1729,55,1000,782,218,0.806334330342316,0.254237288135593,1.24034991798797,537,218,319,60,1.5,35.92,3.6,0,0,0,0,0,0,0.20683435923298,269.084206730165,21.3243724559735
9.7,"eps_greedy_SVM","SVM",61,10,1684,1641,43,1100,870,230,0.831671651711538,0.271186440677966,1.27299070530344,573,230,343,36,1.5,39.51,3.8,0,0,0,0,0,0,0.164695340249359,107.454934889639,18.0714152133956
9.7,"eps_greedy_SVM","SVM",61,11,1584,1555,29,1200,956,244,0.838032568959792,0.254237288135593,1.27299070530344,603,244,359,30,1.5,43.1,3.9,0,0,0,0,0,0,0.177739158062333,126.838631301488,20.1702803810446
9.7,"eps_greedy_SVM","SVM",61,12,1484,1459,25,1300,1052,248,0.838889996676641,0.288135593220339,1.27299070530344,625,248,377,22,1.5,46.7,4.2,0,0,0,0,0,0,0.161353388965344,114.946477217494,17.2094866522697
9.7,"eps_greedy_SVM","SVM",61,13,1384,1360,24,1400,1151,249,0.835613160518449,0.288135593220339,1.27299070530344,623,249,374,-2,1.5,50.29,4.6,0,0,0,0,0,0,0.144002458513297,113.355399477087,15.2208232707241
9.7,"eps_greedy_SVM","SVM",61,14,1284,1261,23,1500,1250,250,0.844659355267536,0.338983050847458,1.27299070530344,644,250,394,21,1.6,53.88,5,0,0,0,0,0,0,0.0800478105939094,34.1954937312527,9.78772321484492
9.7,"eps_greedy_SVM","SVM",61,15,1184,1161,23,1600,1350,250,0.829112662013964,0.271186440677966,1.27299070530344,626,250,376,-18,1.5,57.47,5.4,0,0,0,0,0,0,0.067116137574367,27.5677454270018,8.1348122764034
9.7,"eps_greedy_SVM","SVM",61,16,1084,1066,18,1700,1445,255,0.823270189431709,0.254237288135593,1.26211044286495,660,255,405,34,1.6,61.06,5.7,0,0,0,0,0,0,0.0701803836874159,31.4520339132307,10.667843045163
9.7,"eps_greedy_SVM","SVM",61,17,984,968,16,1800,1543,257,0.845682951146565,0.305084745762712,1.26211044286495,663,257,406,3,1.6,64.66,6,0,0,0,0,0,0,0.0311568378941941,12.584277006351,5.94655700318985
9.7,"eps_greedy_SVM","SVM",61,18,884,869,15,1900,1642,258,0.846081754735797,0.279661016949153,1.26211044286495,656,258,398,-7,1.5,68.25,6.4,0,0,0,0,0,0,0.0602918305968074,26.9757188767496,6.75896351485225
9.7,"eps_greedy_SVM","SVM",61,19,784,773,11,2000,1738,262,0.835320704553011,0.279661016949153,1.27299070530344,679,262,417,23,1.6,71.84,6.6,0,0,0,0,0,0,0.0701987704631368,30.2584000134477,8.83533634186647
9.7,"eps_greedy_SVM","SVM",61,20,684,681,3,2100,1830,270,0.786108341641743,0.194915254237288,1.27299070530344,732,270,462,53,1.7,75.43,6.8,0,0,0,0,0,0,0.0797801402668971,31.0987489357549,10.0890843195657
9.7,"eps_greedy_SVM","SVM",61,21,584,582,2,2200,1929,271,0.830269192422736,0.288135593220339,1.27299070530344,739,271,468,7,1.7,79.02,7.1,0,0,0,0,0,0,0.0616733818982477,21.1636290760007,8.02129413697941
9.7,"eps_greedy_SVM","SVM",61,22,484,482,2,2300,2029,271,0.825496842804921,0.23728813559322,1.27299070530344,739,271,468,0,1.7,82.61,7.5,0,0,0,0,0,0,0.0462940580899163,15.5241113849543,5.68610548480262
9.7,"eps_greedy_SVM","SVM",61,23,384,382,2,2400,2129,271,0.826095048188769,0.228813559322034,1.27299070530344,747,271,476,8,1.8,86.21,7.9,0,0,0,0,0,0,0.00721064969173945,2.01090218554422,1.39793922103209
9.7,"eps_greedy_SVM","SVM",61,24,284,283,1,2500,2228,272,0.811213027583917,0.23728813559322,1.27299070530344,761,272,489,14,1.8,89.8,8.2,0,0,0,0,0,0,0.000762041645660992,1.23431967034046,1.19337733966775
9.7,"eps_greedy_SVM","SVM",61,25,184,183,1,2600,2328,272,0.851379195746097,0.313559322033898,1.28387096774194,759,272,487,-2,1.8,93.39,8.6,0,0,0,0,0,0,0.00897278237494355,2.61005230249806,2.23584750609582
9.7,"eps_greedy_SVM","SVM",61,26,84,84,0,2700,2427,273,0.789491525423731,0.220338983050847,1.27299070530344,746,273,473,-13,1.7,96.98,8.9,0,0,0,0,0,0,5.53219212446127e-06,0.690157178894954,0.690157178894954
9.7,"eps_greedy_SVM","SVM",61,27,0,0,0,2784,2511,273,0.811950814223997,0.254237288135593,1.27299070530344,764,273,491,18,1.8,100,9.2,0,0,0,0,0,0,0,0,0
9.7,"eps_greedy_SVM","SVM",62,0,2684,2437,247,100,88,12,0.809722923124976,0.265151515151515,1.27414467253177,31,12,19,0,1.6,3.59,7.3,0,0,0,0,0,0,0.159328260749906,310.770574882515,17.8558029650458
9.7,"eps_greedy_SVM","SVM",62,1,2584,2367,217,200,158,42,0.760303270612549,0.212121212121212,1.25469208211144,103,42,61,72,1.5,7.18,3.8,0,0,0,0,0,0,0.215296860549848,505.014553808273,21.8800785692597
9.7,"eps_greedy_SVM","SVM",62,2,2484,2287,197,300,238,62,0.742292072188968,0.136363636363636,1.22551319648094,156,62,94,53,1.5,10.78,3.8,0,0,0,0,0,0,0.226629144538139,419.923767000088,26.5909163498195
9.7,"eps_greedy_SVM","SVM",62,3,2384,2195,189,400,330,70,0.8113329969,0.242424242424242,1.2644183773216,174,70,104,18,1.5,14.37,4.7,0,0,0,0,0,0,0.195457257195718,284.266299888335,19.9028149107402
9.7,"eps_greedy_SVM","SVM",62,4,2284,2137,147,500,388,112,0.803613053613044,0.242424242424242,1.25469208211144,263,112,151,89,1.3,17.96,3.5,0,0,0,0,0,0,0.247387395344824,219.37161977798,25.584942044186
9.7,"eps_greedy_SVM","SVM",62,5,2184,2065,119,600,460,140,0.809224280873755,0.25,1.25469208211144,323,140,183,60,1.3,21.55,3.3,0,0,0,0,0,0,0.250695711665947,143.706957052093,26.4817005213391
9.7,"eps_greedy_SVM","SVM",62,6,2084,1998,86,700,527,173,0.807494052339401,0.25,1.25469208211144,392,173,219,69,1.3,25.14,3,0,0,0,0,0,0,0.253026218558469,224.352411820754,25.767411065814
9.7,"eps_greedy_SVM","SVM",62,7,1984,1911,73,800,614,186,0.807313820200407,0.257575757575758,1.25469208211144,427,186,241,35,1.3,28.74,3.3,0,0,0,0,0,0,0.224163843963937,125.592907394414,23.6318574809353
9.7,"eps_greedy_SVM","SVM",62,8,1884,1825,59,900,700,200,0.813171364717748,0.28030303030303,1.25469208211144,478,200,278,51,1.4,32.33,3.5,0,0,0,0,0,0,0.193958745791079,101.86975876634,21.3446106092962
9.7,"eps_greedy_SVM","SVM",62,9,1784,1736,48,1000,789,211,0.804508206570054,0.242424242424242,1.24496578690127,519,211,308,41,1.5,35.92,3.7,0,0,0,0,0,0,0.174223929481681,92.9776321166713,19.4423132234723
9.7,"eps_greedy_SVM","SVM",62,10,1684,1649,35,1100,876,224,0.804640376805315,0.242424242424242,1.24496578690127,540,224,316,21,1.4,39.51,3.9,0,0,0,0,0,0,0.0843443382159598,31.12003733341,12.8325539824662
9.7,"eps_greedy_SVM","SVM",62,11,1584,1556,28,1200,969,231,0.810990555835908,0.265151515151515,1.24496578690127,561,231,330,21,1.4,43.1,4.2,0,0,0,0,0,0,0.0771406849044845,26.8632730336381,10.1089835150675
9.7,"eps_greedy_SVM","SVM",62,12,1484,1460,24,1300,1065,235,0.804520222045988,0.234848484848485,1.22551319648094,579,235,344,18,1.5,46.7,4.5,0,0,0,0,0,0,0.0781970193538591,28.2538900892357,10.3052636267569
9.7,"eps_greedy_SVM","SVM",62,13,1384,1362,22,1400,1163,237,0.800489029870463,0.21969696969697,1.2352394916911,586,237,349,7,1.5,50.29,4.9,0,0,0,0,0,0,0.0529656382049974,18.8435794369175,6.59479249724042
9.7,"eps_greedy_SVM","SVM",62,14,1284,1262,22,1500,1263,237,0.807433974959736,0.227272727272727,1.24496578690127,587,237,350,1,1.5,53.88,5.3,0,0,0,0,0,0,0.0160620265464634,5.23716648612946,2.3807607736112
9.7,"eps_greedy_SVM","SVM",62,15,1184,1166,18,1600,1359,241,0.787422199793326,0.181818181818182,1.2352394916911,610,241,369,23,1.5,57.47,5.6,0,0,0,0,0,0,0.109441887930436,47.2703614706319,13.2430030972168
9.7,"eps_greedy_SVM","SVM",62,16,1084,1069,15,1700,1456,244,0.778590824982567,0.204545454545455,1.22551319648094,621,244,377,11,1.5,61.06,6,0,0,0,0,0,0,0.0864488795627935,32.9741059232234,11.6319303427597
9.7,"eps_greedy_SVM","SVM",62,17,984,969,15,1800,1556,244,0.78960901641313,0.212121212121212,1.2352394916911,639,244,395,18,1.6,64.66,6.4,0,0,0,0,0,0,0.0640096153811237,23.961585086809,8.07013482975156
9.7,"eps_greedy_SVM","SVM",62,18,884,869,15,1900,1656,244,0.799125273352067,0.242424242424242,1.2352394916911,632,244,388,-7,1.6,68.25,6.8,0,0,0,0,0,0,0.0421907774403693,15.5893117628024,5.56043146916918
9.7,"eps_greedy_SVM","SVM",62,19,784,769,15,2000,1756,244,0.786815418258705,0.212121212121212,1.2352394916911,626,244,382,-6,1.6,71.84,7.2,0,0,0,0,0,0,0.0128462883922255,4.32905936582735,2.05372684013767
9.7,"eps_greedy_SVM","SVM",62,20,684,671,13,2100,1854,246,0.792294475284159,0.21969696969697,1.24496578690127,640,246,394,14,1.6,75.43,7.5,0,0,0,0,0,0,0.0159787985590175,5.177582098,2.77418630280421
9.7,"eps_greedy_SVM","SVM",62,21,584,577,7,2200,1948,252,0.79026385985149,0.204545454545455,1.28387096774194,684,252,432,44,1.7,79.02,7.7,0,0,0,0,0,0,0.0176712891031236,10.1886126244876,8.88106546976614
9.7,"eps_greedy_SVM","SVM",62,22,484,482,2,2300,2043,257,0.800471006656576,0.151515151515152,1.28387096774194,692,257,435,8,1.7,82.61,7.9,0,0,0,0,0,0,0.00610278800344872,3.11665263019217,2.60274817403025
9.7,"eps_greedy_SVM","SVM",62,23,384,382,2,2400,2143,257,0.809566721937858,0.204545454545455,1.28387096774194,683,257,426,-9,1.7,86.21,8.3,0,0,0,0,0,0,0.00266070267235587,0.898405635892969,0.747086980593995
9.7,"eps_greedy_SVM","SVM",62,24,284,283,1,2500,2242,258,0.787512315862834,0.257575757575758,1.28387096774194,706,258,448,23,1.7,89.8,8.7,0,0,0,0,0,0,0.0274404059715345,8.277694396871,7.05922751516567
9.7,"eps_greedy_SVM","SVM",62,25,184,184,0,2600,2341,259,0.767031937135033,0.174242424242424,1.28387096774194,714,259,455,8,1.8,93.39,9,0,0,0,0,0,0,0.00219025690786624,3.05476153002454,3.00490657312682
9.7,"eps_greedy_SVM","SVM",62,26,84,84,0,2700,2441,259,0.786484992670559,0.196969696969697,1.28387096774194,687,259,428,-27,1.7,96.98,9.4,0,0,0,0,0,0,2.45434194542563e-06,0.124553358314633,0.124553358314633
9.7,"eps_greedy_SVM","SVM",62,27,0,0,0,2784,2525,259,0.815832792636913,0.287878787878788,1.27414467253177,705,259,446,18,1.7,100,9.7,0,0,0,0,0,0,0,0,0
9.7,"eps_greedy_SVM","SVM",63,0,2684,2440,244,100,90,10,0.784125249895392,0.197080291970803,1.27449964680951,29,10,19,0,1.9,3.59,9,0,0,0,0,0,0,0.148661039876177,261.450411279427,16.9584806385719
9.7,"eps_greedy_SVM","SVM",63,1,2584,2354,230,200,176,24,0.778842577525687,0.18978102189781,1.27449964680951,70,24,46,41,1.9,7.18,7.3,0,0,0,0,0,0,0.20364319801227,248.12270511992,31.2500960823015
9.7,"eps_greedy_SVM","SVM",63,2,2484,2261,223,300,269,31,0.720210144590639,0.218978102189781,1.19952907935013,93,31,62,23,2,10.78,8.7,0,0,0,0,0,0,0.13926800874867,198.926141209864,15.3830096729146
9.7,"eps_greedy_SVM","SVM",63,3,2384,2186,198,400,344,56,0.622797433632435,0.284671532846715,1.06833058629621,134,56,78,41,1.4,14.37,6.1,0,0,0,0,0,0,0.181322535496105,217.896639322253,21.8248739564162
9.7,"eps_greedy_SVM","SVM",63,4,2284,2109,175,500,421,79,0.711510298014785,0.306569343065693,1.15267247468802,197,79,118,63,1.5,17.96,5.3,0,0,0,0,0,0,0.163639776370186,271.068794236474,16.790629059611
9.7,"eps_greedy_SVM","SVM",63,5,2184,2030,154,600,500,100,0.747059370496074,0.306569343065693,1.19015775841771,247,100,147,50,1.5,21.55,5,0,0,0,0,0,0,0.165262374581968,178.987057699823,17.3254657695584
9.7,"eps_greedy_SVM","SVM",63,6,2084,1955,129,700,575,125,0.764244037379698,0.335766423357664,1.18078643748528,307,125,182,60,1.5,25.14,4.6,0,0,0,0,0,0,0.172876797502412,175.422574867659,18.1716410287514
9.7,"eps_greedy_SVM","SVM",63,7,1984,1887,97,800,643,157,0.773565716676747,0.313868613138686,1.19015775841771,381,157,224,74,1.4,28.74,4.1,0,0,0,0,0,0,0.183502680299746,113.900376837397,20.9351787325634
9.7,"eps_greedy_SVM","SVM",63,8,1884,1807,77,900,723,177,0.774844251243667,0.299270072992701,1.19015775841771,434,177,257,53,1.5,32.33,4.1,0,0,0,0,0,0,0.173393042902948,128.154864813443,18.6465199278696
9.7,"eps_greedy_SVM","SVM",63,9,1784,1719,65,1000,811,189,0.78146357338788,0.321167883211679,1.18078643748528,475,189,286,41,1.5,35.92,4.3,0,0,0,0,0,0,0.165208846863032,128.203882588236,17.72066728088
9.7,"eps_greedy_SVM","SVM",63,10,1684,1625,59,1100,905,195,0.779051792273001,0.291970802919708,1.19015775841771,494,195,299,19,1.5,39.51,4.6,0,0,0,0,0,0,0.156983047861584,130.110417502368,16.5580638886708
9.7,"eps_greedy_SVM","SVM",63,11,1584,1534,50,1200,996,204,0.794475568366729,0.321167883211679,1.18078643748528,512,204,308,18,1.5,43.1,4.9,0,0,0,0,0,0,0.141526644202147,114.917248722259,15.4764842819174
9.7,"eps_greedy_SVM","SVM",63,12,1484,1449,35,1300,1081,219,0.794975359151996,0.284671532846715,1.19015775841771,562,219,343,50,1.6,46.7,4.9,0,0,0,0,0,0,0.148930335200252,102.125768722203,16.4315432247454
9.7,"eps_greedy_SVM","SVM",63,13,1384,1358,26,1400,1172,228,0.800856618159853,0.291970802919708,1.19015775841771,590,228,362,28,1.6,50.29,5.1,0,0,0,0,0,0,0.141693325232385,84.0930803176051,15.2354775618743
9.7,"eps_greedy_SVM","SVM",63,14,1284,1261,23,1500,1269,231,0.791203682179566,0.306569343065693,1.19015775841771,615,231,384,25,1.7,53.88,5.5,0,0,0,0,0,0,0.123782636148342,72.9843979398877,13.7755420526931
9.7,"eps_greedy_SVM","SVM",63,15,1184,1162,22,1600,1368,232,0.781202054953755,0.248175182481752,1.19015775841771,610,232,378,-5,1.6,57.47,5.9,0,0,0,0,0,0,0.119330362964187,62.3429273816923,14.9385674040941
9.7,"eps_greedy_SVM","SVM",63,16,1084,1063,21,1700,1467,233,0.774989539262645,0.248175182481752,1.19015775841771,612,233,379,2,1.6,61.06,6.3,0,0,0,0,0,0,0.0955332480122548,42.3547256586232,10.8106012282886
9.7,"eps_greedy_SVM","SVM",63,17,984,963,21,1800,1567,233,0.801153005718548,0.321167883211679,1.19015775841771,625,233,392,13,1.7,64.66,6.7,0,0,0,0,0,0,0.0590340882700748,20.3311986544415,6.91833894463245
9.7,"eps_greedy_SVM","SVM",63,18,884,863,21,1900,1667,233,0.795707610767598,0.299270072992701,1.19015775841771,614,233,381,-11,1.6,68.25,7.2,0,0,0,0,0,0,0.0360343276970511,11.4518914590311,4.83896835373898
9.7,"eps_greedy_SVM","SVM",63,19,784,763,21,2000,1767,233,0.778476451717897,0.27007299270073,1.19015775841771,619,233,386,5,1.7,71.84,7.6,0,0,0,0,0,0,0.0159760475702567,4.4160943841589,2.52244167856867
9.7,"eps_greedy_SVM","SVM",63,20,684,665,19,2100,1865,235,0.802501278534571,0.299270072992701,1.19015775841771,633,235,398,14,1.7,75.43,7.9,0,0,0,0,0,0,0.019186589222129,4.83734344899244,2.98762254793182
9.7,"eps_greedy_SVM","SVM",63,21,584,565,19,2200,1965,235,0.789791482635181,0.240875912408759,1.19015775841771,634,235,399,1,1.7,79.02,8.4,0,0,0,0,0,0,0.0227046338786832,7.29028955603123,3.18406087923282
9.7,"eps_greedy_SVM","SVM",63,22,484,468,16,2300,2062,238,0.7777558231438,0.240875912408759,1.18078643748528,627,238,389,-7,1.6,82.61,8.7,0,0,0,0,0,0,0.0447908886145345,12.7562277797031,9.56051623569964
9.7,"eps_greedy_SVM","SVM",63,23,384,369,15,2400,2161,239,0.754073876051886,0.182481751824818,1.18078643748528,634,239,395,7,1.7,86.21,9,0,0,0,0,0,0,0.0183445678159577,5.14699149371641,3.64739110220359
9.7,"eps_greedy_SVM","SVM",63,24,284,273,11,2500,2257,243,0.796590961922921,0.313868613138686,1.19952907935013,645,243,402,11,1.7,89.8,9.3,0,0,0,0,0,0,0.00245609784645339,1.35407426595676,1.23314744535407
9.7,"eps_greedy_SVM","SVM",63,25,184,174,10,2600,2356,244,0.764476498210055,0.255474452554745,1.19952907935013,645,244,401,0,1.6,93.39,9.7,0,0,0,0,0,0,4.96361794515617e-05,0.0559224122847552,0.0547264896616082
9.7,"eps_greedy_SVM","SVM",63,26,84,78,6,2700,2452,248,0.797538239806596,0.233576642335766,1.21827172121498,663,248,415,18,1.7,96.98,9.9,0,0,0,0,0,0,8.32251219295458e-05,1.98347871548544,1.98347871548544
9.7,"eps_greedy_SVM","SVM",63,27,0,0,0,2784,2530,254,0.824579245897066,0.328467153284672,1.27449964680951,702,254,448,39,1.8,100,10,0,0,0,0,0,0,0,0,0
9.7,"eps_greedy_SVM","SVM",64,0,2684,2432,252,100,87,13,0.702390348404555,0.0873015873015873,1.26349206349206,41,13,28,0,2.2,3.59,6.7,0,0,0,0,0,0,0.136793573205549,352.852810366913,13.8177979763039
9.7,"eps_greedy_SVM","SVM",64,1,2584,2335,249,200,184,16,0.761059119780507,0.349206349206349,1.22273425499232,47,16,31,6,1.9,7.18,11.5,0,0,0,0,0,0,0.1149943881563,229.617106680398,12.4911422724361
9.7,"eps_greedy_SVM","SVM",64,2,2484,2268,216,300,251,49,0.670970045476756,0.0714285714285714,1.23292370711726,124,49,75,77,1.5,10.78,5.1,0,0,0,0,0,0,0.210481762605453,408.713256624062,22.8260468512947
9.7,"eps_greedy_SVM","SVM",64,3,2384,2175,209,400,344,56,0.740300171634029,0.222222222222222,1.21254480286738,143,56,87,19,1.6,14.37,6.1,0,0,0,0,0,0,0.145074261395788,325.112332379912,15.5371945371902
9.7,"eps_greedy_SVM","SVM",64,4,2284,2091,193,500,428,72,0.771532554089775,0.174603174603175,1.23292370711726,192,72,120,49,1.7,17.96,5.9,0,0,0,0,0,0,0.163194863713045,278.130635950767,16.8514626528834
9.7,"eps_greedy_SVM","SVM",64,5,2184,2012,172,600,507,93,0.791345635860235,0.325396825396825,1.24311315924219,237,93,144,45,1.5,21.55,5.5,0,0,0,0,0,0,0.169119525342736,264.158670596902,17.5384228585858
9.7,"eps_greedy_SVM","SVM",64,6,2084,1934,150,700,585,115,0.787762618859696,0.30952380952381,1.23292370711726,294,115,179,57,1.6,25.14,5.1,0,0,0,0,0,0,0.1718065541958,218.990775504496,17.7446781955062
9.7,"eps_greedy_SVM","SVM",64,7,1984,1864,120,800,655,145,0.786797960436476,0.285714285714286,1.23292370711726,357,145,212,63,1.5,28.74,4.5,0,0,0,0,0,0,0.184641148906379,286.752734903823,18.8481678941576
9.7,"eps_greedy_SVM","SVM",64,8,1884,1784,100,900,735,165,0.796770273486925,0.285714285714286,1.23292370711726,397,165,232,40,1.4,32.33,4.5,0,0,0,0,0,0,0.186278617133071,257.260045828997,19.0596301202243
9.7,"eps_greedy_SVM","SVM",64,9,1784,1707,77,1000,812,188,0.790982322947594,0.261904761904762,1.21254480286738,471,188,283,74,1.5,35.92,4.3,0,0,0,0,0,0,0.188417971445167,224.640452670816,19.6555754861607
9.7,"eps_greedy_SVM","SVM",64,10,1684,1621,63,1100,898,202,0.77837285927262,0.198412698412698,1.21254480286738,502,202,300,31,1.5,39.51,4.4,0,0,0,0,0,0,0.175277465045193,183.63711506812,18.8230343564336
9.7,"eps_greedy_SVM","SVM",64,11,1584,1537,47,1200,982,218,0.786259255083248,0.238095238095238,1.20235535074245,550,218,332,48,1.5,43.1,4.5,0,0,0,0,0,0,0.179311356805258,199.211827006119,18.6177835755809
9.7,"eps_greedy_SVM","SVM",64,12,1484,1442,42,1300,1077,223,0.767128951027925,0.222222222222222,1.21254480286738,564,223,341,14,1.5,46.7,4.8,0,0,0,0,0,0,0.161405950818694,146.782531866957,17.0465439702984
9.7,"eps_greedy_SVM","SVM",64,13,1384,1345,39,1400,1174,226,0.76861352275717,0.182539682539683,1.22273425499232,564,226,338,0,1.5,50.29,5.2,0,0,0,0,0,0,0.145594825537467,136.255434171165,15.1355482933722
9.7,"eps_greedy_SVM","SVM",64,14,1284,1248,36,1500,1271,229,0.793093296250356,0.23015873015873,1.22273425499232,590,229,361,26,1.6,53.88,5.6,0,0,0,0,0,0,0.130401222214122,99.1607860632408,13.9979415846261
9.7,"eps_greedy_SVM","SVM",64,15,1184,1156,28,1600,1363,237,0.788915197754976,0.182539682539683,1.20235535074245,605,237,368,15,1.6,57.47,5.8,0,0,0,0,0,0,0.116677182076518,56.1336364492733,13.9793687854803
9.7,"eps_greedy_SVM","SVM",64,16,1084,1066,18,1700,1453,247,0.800597587101136,0.253968253968254,1.20235535074245,634,247,387,29,1.6,61.06,5.9,0,0,0,0,0,0,0.11364746644883,63.9152257287913,12.8211747037129
9.7,"eps_greedy_SVM","SVM",64,17,984,971,13,1800,1548,252,0.783747384773432,0.158730158730159,1.21254480286738,658,252,406,24,1.6,64.66,6.1,0,0,0,0,0,0,0.11794415240359,63.8467560971675,13.5509432584737
9.7,"eps_greedy_SVM","SVM",64,18,884,872,12,1900,1647,253,0.795899575299731,0.253968253968254,1.21254480286738,641,253,388,-17,1.5,68.25,6.5,0,0,0,0,0,0,0.0834464520499126,38.5239825717973,9.61120455998415
9.7,"eps_greedy_SVM","SVM",64,19,784,772,12,2000,1747,253,0.787136217286178,0.222222222222222,1.21254480286738,643,253,390,2,1.5,71.84,6.9,0,0,0,0,0,0,0.0686229640089564,29.749269464972,7.69249774399335
9.7,"eps_greedy_SVM","SVM",64,20,684,673,11,2100,1846,254,0.782043572493454,0.222222222222222,1.21254480286738,648,254,394,5,1.6,75.43,7.3,0,0,0,0,0,0,0.0754256453708608,33.7579650791218,8.92155227813645
9.7,"eps_greedy_SVM","SVM",64,21,584,573,11,2200,1946,254,0.810588692198795,0.277777777777778,1.21254480286738,665,254,411,17,1.6,79.02,7.7,0,0,0,0,0,0,0.0352025726106463,11.5295015780119,4.23656453204675
9.7,"eps_greedy_SVM","SVM",64,22,484,473,11,2300,2046,254,0.80387366733065,0.285714285714286,1.20235535074245,656,254,402,-9,1.6,82.61,8.1,0,0,0,0,0,0,0.0167129832210057,4.43096090113979,2.25513757118151
9.7,"eps_greedy_SVM","SVM",64,23,384,373,11,2400,2146,254,0.802407887648615,0.23015873015873,1.20235535074245,646,254,392,-10,1.5,86.21,8.4,0,0,0,0,0,0,0.00796420930025399,2.28605108410033,1.32423556618394
9.7,"eps_greedy_SVM","SVM",64,24,284,276,8,2500,2243,257,0.785977374375165,0.198412698412698,1.21254480286738,668,257,411,22,1.6,89.8,8.7,0,0,0,0,0,0,0.0115542886212753,2.86241713731963,2.02528397762487
9.7,"eps_greedy_SVM","SVM",64,25,184,181,3,2600,2338,262,0.818694328560146,0.198412698412698,1.25330261136713,701,262,439,33,1.7,93.39,8.9,0,0,0,0,0,0,0.00369954161093469,2.3330209814321,2.17655039651751
9.7,"eps_greedy_SVM","SVM",64,26,84,84,0,2700,2435,265,0.817936382656187,0.253968253968254,1.273681515617,728,265,463,27,1.7,96.98,9.2,0,0,0,0,0,0,6.58283514246723e-05,0.040194178377729,0.040194178377729
9.7,"eps_greedy_SVM","SVM",64,27,0,0,0,2784,2519,265,0.829029954523245,0.246031746031746,1.26349206349206,713,265,448,-15,1.7,100,9.5,0,0,0,0,0,0,0,0,0
9.7,"eps_greedy_SVM","SVM",65,0,2684,2426,258,100,89,11,0.736524744940737,0.237704918032787,1.23125330512956,33,11,22,0,2,3.59,8.1,0,0,0,0,0,0,0.284674171325104,295.796788473807,44.7831666242257
9.7,"eps_greedy_SVM","SVM",65,1,2584,2349,235,200,166,34,0.755523597012814,0.229508196721311,1.19968270756214,86,34,52,53,1.5,7.18,4.9,0,0,0,0,0,0,0.277917138309849,317.800766610953,32.2618905094558
9.7,"eps_greedy_SVM","SVM",65,2,2484,2281,203,300,234,66,0.694844642788045,0.245901639344262,1.17863564251719,155,66,89,69,1.3,10.78,3.5,0,0,0,0,0,0,0.235679897709828,312.25190467571,26.6053998754452
9.7,"eps_greedy_SVM","SVM",65,3,2384,2204,180,400,311,89,0.750854496910908,0.188524590163934,1.27334743521946,213,89,124,58,1.4,14.37,3.5,0,0,0,0,0,0,0.23367684020686,347.006583066341,23.8364909263638
9.7,"eps_greedy_SVM","SVM",65,4,2284,2113,171,500,402,98,0.764906940449624,0.237704918032787,1.27334743521946,239,98,141,26,1.4,17.96,4.1,0,0,0,0,0,0,0.195195063204724,218.681105157207,20.2531271609454
9.7,"eps_greedy_SVM","SVM",65,5,2184,2028,156,600,487,113,0.788516851323982,0.270491803278689,1.27334743521946,263,113,150,24,1.3,21.55,4.3,0,0,0,0,0,0,0.180422399001814,179.807733675504,18.6986627007739
9.7,"eps_greedy_SVM","SVM",65,6,2084,1951,133,700,564,136,0.815248094310661,0.336065573770492,1.26282390269699,331,136,195,68,1.4,25.14,4.1,0,0,0,0,0,0,0.183824512565403,189.223041076452,19.1187622010905
9.7,"eps_greedy_SVM","SVM",65,7,1984,1878,106,800,637,163,0.812320233197043,0.295081967213115,1.26282390269699,393,163,230,62,1.4,28.74,3.9,0,0,0,0,0,0,0.186117076277509,138.863168183092,20.2766440057126
9.7,"eps_greedy_SVM","SVM",65,8,1884,1805,79,900,710,190,0.825076421044488,0.319672131147541,1.26282390269699,448,190,258,55,1.4,32.33,3.7,0,0,0,0,0,0,0.182079389523104,134.070057308568,19.8544898944996
9.7,"eps_greedy_SVM","SVM",65,9,1784,1716,68,1000,799,201,0.823425468522275,0.270491803278689,1.26282390269699,486,201,285,38,1.4,35.92,4,0,0,0,0,0,0,0.168808532913318,135.16065762774,17.7900199036231
9.7,"eps_greedy_SVM","SVM",65,10,1684,1628,56,1100,887,213,0.820516954508527,0.286885245901639,1.25230037017451,513,213,300,27,1.4,39.51,4.2,0,0,0,0,0,0,0.160724827197062,115.457049177696,17.3035352469516
9.7,"eps_greedy_SVM","SVM",65,11,1584,1541,43,1200,974,226,0.805813158607527,0.254098360655738,1.23125330512956,563,226,337,50,1.5,43.1,4.3,0,0,0,0,0,0,0.171994072136731,113.292405880081,18.7420060253092
9.7,"eps_greedy_SVM","SVM",65,12,1484,1441,43,1300,1074,226,0.819317434316602,0.286885245901639,1.24177683765204,563,226,337,0,1.5,46.7,4.8,0,0,0,0,0,0,0.143311810115469,79.4638448939715,15.1676887974516
9.7,"eps_greedy_SVM","SVM",65,13,1384,1348,36,1400,1167,233,0.804890946847074,0.262295081967213,1.25230037017451,603,233,370,40,1.6,50.29,5,0,0,0,0,0,0,0.138079055759874,65.7943819013889,15.1162152860768
9.7,"eps_greedy_SVM","SVM",65,14,1284,1256,28,1500,1259,241,0.814738620680768,0.286885245901639,1.25230037017451,620,241,379,17,1.6,53.88,5.2,0,0,0,0,0,0,0.127058189292508,58.5824892252803,13.7811088445556
9.7,"eps_greedy_SVM","SVM",65,15,1184,1159,25,1600,1356,244,0.811965536366104,0.262295081967213,1.25230037017451,650,244,406,30,1.7,57.47,5.6,0,0,0,0,0,0,0.127966544575882,66.2329978441965,13.4629577069378
9.7,"eps_greedy_SVM","SVM",65,16,1084,1059,25,1700,1456,244,0.819762417613605,0.262295081967213,1.26282390269699,647,244,403,-3,1.7,61.06,6,0,0,0,0,0,0,0.094990651713585,34.1862142660819,10.5356339021584
9.7,"eps_greedy_SVM","SVM",65,17,984,959,25,1800,1556,244,0.810462911609556,0.270491803278689,1.26282390269699,647,244,403,0,1.7,64.66,6.4,0,0,0,0,0,0,0.0614200979957779,17.0855339640615,7.80832461926322
9.7,"eps_greedy_SVM","SVM",65,18,884,862,22,1900,1653,247,0.816021978305456,0.278688524590164,1.26282390269699,648,247,401,1,1.6,68.25,6.7,0,0,0,0,0,0,0.0400701771194808,10.2479353298409,5.38187392159181
9.7,"eps_greedy_SVM","SVM",65,19,784,768,16,2000,1747,253,0.828913595851982,0.286885245901639,1.25230037017451,664,253,411,16,1.6,71.84,6.9,0,0,0,0,0,0,0.0100371304230084,3.84480875213064,2.42307917859361
9.7,"eps_greedy_SVM","SVM",65,20,684,671,13,2100,1844,256,0.826340431569305,0.295081967213115,1.24177683765204,668,256,412,4,1.6,75.43,7.2,0,0,0,0,0,0,0.0305244827720512,9.96012722993811,4.58551936531075
9.7,"eps_greedy_SVM","SVM",65,21,584,571,13,2200,1944,256,0.814254943184015,0.262295081967213,1.24177683765204,678,256,422,10,1.6,79.02,7.6,0,0,0,0,0,0,0.015802609516354,4.27058852131171,2.07436451937464
9.7,"eps_greedy_SVM","SVM",65,22,484,474,10,2300,2041,259,0.812752318427464,0.237704918032787,1.22072977260709,687,259,428,9,1.7,82.61,7.9,0,0,0,0,0,0,0.0281036876386125,10.000912911579,7.2759140707663
9.7,"eps_greedy_SVM","SVM",65,23,384,374,10,2400,2141,259,0.814854703279978,0.221311475409836,1.22072977260709,699,259,440,12,1.7,86.21,8.3,0,0,0,0,0,0,0.0113440422858615,3.04816438851525,1.96401961860573
9.7,"eps_greedy_SVM","SVM",65,24,284,274,10,2500,2241,259,0.813384323689876,0.204918032786885,1.22072977260709,683,259,424,-16,1.6,89.8,8.7,0,0,0,0,0,0,0.0105135346751936,2.61012013192469,1.66418976972467
9.7,"eps_greedy_SVM","SVM",65,25,184,176,8,2600,2339,261,0.806722472301401,0.204918032786885,1.26282390269699,699,261,438,16,1.7,93.39,9,0,0,0,0,0,0,0.00318647643786193,0.983919717361453,0.865121480039603
9.7,"eps_greedy_SVM","SVM",65,26,84,83,1,2700,2432,268,0.8142678412506,0.213114754098361,1.28387096774194,734,268,466,35,1.7,96.98,9.1,0,0,0,0,0,0,1.34737195285159e-05,0.907689894500506,0.907689894500506
9.7,"eps_greedy_SVM","SVM",65,27,0,0,0,2784,2515,269,0.814403270949686,0.213114754098361,1.28387096774194,740,269,471,6,1.8,100,9.3,0,0,0,0,0,0,0,0,0
9.7,"eps_greedy_SVM","SVM",66,0,2684,2426,258,100,94,6,0.177855730119043,0,0.485242570485141,18,6,12,0,2,3.59,15.7,0,0,0,0,0,0,0.0623247039385188,167.212402614507,6.2326156229163
9.7,"eps_greedy_SVM","SVM",66,1,2584,2348,236,200,172,28,0.80813772685997,0.31496062992126,1.25354330708661,68,28,40,50,1.4,7.18,6.1,0,0,0,0,0,0,0.183316546772733,319.417660421744,20.6622222333757
9.7,"eps_greedy_SVM","SVM",66,2,2484,2264,220,300,256,44,0.8422957793783,0.346456692913386,1.2737617475235,110,44,66,42,1.5,10.78,5.8,0,0,0,0,0,0,0.176550197841256,159.686836472013,18.8544264067713
9.7,"eps_greedy_SVM","SVM",66,3,2384,2185,199,400,335,65,0.849709544600766,0.401574803149606,1.28387096774194,170,65,105,60,1.6,14.37,5.2,0,0,0,0,0,0,0.158405524641856,109.851431053867,17.1870833718499
9.7,"eps_greedy_SVM","SVM",66,4,2284,2122,162,500,398,102,0.799044669179387,0.181102362204724,1.25354330708661,252,102,150,82,1.5,17.96,3.9,0,0,0,0,0,0,0.267871219223274,309.787807603458,42.7764297310847
9.7,"eps_greedy_SVM","SVM",66,5,2184,2034,150,600,486,114,0.82568944284808,0.31496062992126,1.24343408686817,274,114,160,22,1.4,21.55,4.3,0,0,0,0,0,0,0.202041273661775,212.986415222237,20.7991046265022
9.7,"eps_greedy_SVM","SVM",66,6,2084,1968,116,700,552,148,0.821771093779157,0.330708661417323,1.24343408686817,348,148,200,74,1.4,25.14,3.7,0,0,0,0,0,0,0.216650088904501,251.688758546299,21.9999329416663
9.7,"eps_greedy_SVM","SVM",66,7,1984,1903,81,800,617,183,0.806222089537389,0.330708661417323,1.24343408686817,442,183,259,94,1.4,28.74,3.4,0,0,0,0,0,0,0.233993733152275,242.89080353597,23.967461902601
9.7,"eps_greedy_SVM","SVM",66,8,1884,1807,77,900,713,187,0.829159980594842,0.275590551181102,1.26365252730505,454,187,267,12,1.4,32.33,3.8,0,0,0,0,0,0,0.197673299200944,94.3052676937527,21.3869221877964
9.7,"eps_greedy_SVM","SVM",66,9,1784,1720,64,1000,800,200,0.830453657747752,0.251968503937008,1.26365252730505,484,200,284,30,1.4,35.92,4,0,0,0,0,0,0,0.19202916093445,107.49503162577,20.3109466600437
9.7,"eps_greedy_SVM","SVM",66,10,1684,1628,56,1100,892,208,0.826871167170456,0.236220472440945,1.25354330708661,512,208,304,28,1.5,39.51,4.3,0,0,0,0,0,0,0.193914683475085,122.471291600424,24.8565029063586
9.7,"eps_greedy_SVM","SVM",66,11,1584,1541,43,1200,979,221,0.831137813934398,0.259842519685039,1.25354330708661,556,221,335,44,1.5,43.1,4.4,0,0,0,0,0,0,0.175264152264602,106.657888533773,19.3793801776656
9.7,"eps_greedy_SVM","SVM",66,12,1484,1456,28,1300,1064,236,0.808728589021161,0.204724409448819,1.25354330708661,590,236,354,34,1.5,46.7,4.5,0,0,0,0,0,0,0.174868361567231,94.855603866911,18.5290021302731
9.7,"eps_greedy_SVM","SVM",66,13,1384,1360,24,1400,1160,240,0.798771006704732,0.165354330708661,1.25354330708661,618,240,378,28,1.6,50.29,4.8,0,0,0,0,0,0,0.155011728564889,70.8277764392196,16.6237086289484
9.7,"eps_greedy_SVM","SVM",66,14,1284,1262,22,1500,1258,242,0.83738851363959,0.275590551181102,1.25354330708661,623,242,381,5,1.6,53.88,5.2,0,0,0,0,0,0,0.136457829903343,65.8889673163002,14.3367622131957
9.7,"eps_greedy_SVM","SVM",66,15,1184,1163,21,1600,1357,243,0.784123844708985,0.149606299212598,1.25354330708661,639,243,396,16,1.6,57.47,5.6,0,0,0,0,0,0,0.140089536001888,59.8125722840824,15.4782220594039
9.7,"eps_greedy_SVM","SVM",66,16,1084,1064,20,1700,1456,244,0.799654190145663,0.204724409448819,1.25354330708661,647,244,403,8,1.7,61.06,6,0,0,0,0,0,0,0.131021460983087,46.3472978439067,14.2756277213932
9.7,"eps_greedy_SVM","SVM",66,17,984,964,20,1800,1556,244,0.756160515480585,0.149606299212598,1.25354330708661,646,244,402,-1,1.6,64.66,6.4,0,0,0,0,0,0,0.0983932416382964,25.8097735859141,10.9001864870186
9.7,"eps_greedy_SVM","SVM",66,18,884,866,18,1900,1654,246,0.8283016755607,0.291338582677165,1.25354330708661,659,246,413,13,1.7,68.25,6.7,0,0,0,0,0,0,0.0862382918566349,20.8857732482885,10.1326748316761
9.7,"eps_greedy_SVM","SVM",66,19,784,770,14,2000,1750,250,0.754555858242837,0.15748031496063,1.26365252730505,665,250,415,6,1.7,71.84,7,0,0,0,0,0,0,0.0496382395698896,11.8426204662259,7.83354636451933
9.7,"eps_greedy_SVM","SVM",66,20,684,672,12,2100,1848,252,0.808454926546505,0.21259842519685,1.26365252730505,668,252,416,3,1.7,75.43,7.3,0,0,0,0,0,0,1.5045627896558e-05,1.05133861672157,1.05102056826056
9.7,"eps_greedy_SVM","SVM",66,21,584,579,5,2200,1941,259,0.810482516699631,0.204724409448819,1.28387096774194,706,259,447,38,1.7,79.02,7.5,0,0,0,0,0,0,0.0847663847499659,27.6515179485304,12.4627035018625
9.7,"eps_greedy_SVM","SVM",66,22,484,481,3,2300,2039,261,0.735996566779864,0.110236220472441,1.2737617475235,714,261,453,8,1.7,82.61,7.8,0,0,0,0,0,0,0.0517685923507326,14.0125019879218,7.59180731995123
9.7,"eps_greedy_SVM","SVM",66,23,384,383,1,2400,2137,263,0.729434886989836,0.118110236220472,1.2737617475235,717,263,454,3,1.7,86.21,8.1,0,0,0,0,0,0,0.0230589607350578,5.46323260773911,3.98707214761221
9.7,"eps_greedy_SVM","SVM",66,24,284,283,1,2500,2237,263,0.785983505616302,0.188976377952756,1.2737617475235,730,263,467,13,1.8,89.8,8.5,0,0,0,0,0,0,0.00090344796580861,0.615585853877221,0.615125612261592
9.7,"eps_greedy_SVM","SVM",66,25,184,183,1,2600,2337,263,0.784863977310896,0.204724409448819,1.2737617475235,717,263,454,-13,1.7,93.39,8.9,0,0,0,0,0,0,0.00264122470283549,0.756290125695903,0.750733247552065
9.7,"eps_greedy_SVM","SVM",66,26,84,84,0,2700,2436,264,0.783539202149496,0.15748031496063,1.28387096774194,726,264,462,9,1.8,96.98,9.2,0,0,0,0,0,0,4.11999307424398e-14,1.36873154601901,1.36873154601901
9.7,"eps_greedy_SVM","SVM",66,27,0,0,0,2784,2520,264,0.773724670672089,0.181102362204724,1.2737617475235,738,264,474,12,1.8,100,9.5,0,0,0,0,0,0,0,0,0
9.7,"eps_greedy_SVM","SVM",67,0,2684,2436,248,100,88,12,0.71672856607106,0.213740458015267,1.2348682590495,38,12,26,0,2.2,3.59,7.3,0,0,0,0,0,0,0.202705450024683,337.766827033392,28.9195432961104
9.7,"eps_greedy_SVM","SVM",67,1,2584,2338,246,200,186,14,0.776986728928999,0.206106870229008,1.27407042600345,48,14,34,10,2.4,7.18,13.3,0,0,0,0,0,0,0.13566175805526,217.419339144643,16.1027174148097
9.7,"eps_greedy_SVM","SVM",67,2,2484,2251,233,300,273,27,0.796494114515913,0.274809160305344,1.27407042600345,87,27,60,39,2.2,10.78,10.1,0,0,0,0,0,0,0.122087746402007,196.399868510248,13.1338444449763
9.7,"eps_greedy_SVM","SVM",67,3,2384,2177,207,400,347,53,0.77722263219656,0.297709923664122,1.25446934252647,160,53,107,73,2,14.37,6.5,0,0,0,0,0,0,0.170566976121284,222.806748366482,21.9769130514647
9.7,"eps_greedy_SVM","SVM",67,4,2284,2092,192,500,432,68,0.775069258779834,0.274809160305344,1.26426988426496,191,68,123,31,1.8,17.96,6.4,0,0,0,0,0,0,0.151647886918064,200.091815774689,16.3515840157373
9.7,"eps_greedy_SVM","SVM",67,5,2184,2013,171,600,511,89,0.760322280156298,0.259541984732824,1.26426988426496,236,89,147,45,1.7,21.55,5.7,0,0,0,0,0,0,0.154149503509424,204.967976351883,16.5050029001342
9.7,"eps_greedy_SVM","SVM",67,6,2084,1929,155,700,595,105,0.72507591246174,0.213740458015267,1.22506771731101,277,105,172,41,1.6,25.14,5.7,0,0,0,0,0,0,0.154343242724307,229.297199506941,17.469150403792
9.7,"eps_greedy_SVM","SVM",67,7,1984,1854,130,800,670,130,0.783041579463103,0.244274809160305,1.24466880078798,327,130,197,50,1.5,28.74,5.2,0,0,0,0,0,0,0.17220688852531,176.83388821898,19.5113465830371
9.7,"eps_greedy_SVM","SVM",67,8,1884,1781,103,900,743,157,0.78361621562768,0.229007633587786,1.24466880078798,388,157,231,61,1.5,32.33,4.7,0,0,0,0,0,0,0.177424543381631,179.38023860222,18.5617371541786
9.7,"eps_greedy_SVM","SVM",67,9,1784,1693,91,1000,831,169,0.812136315795837,0.290076335877863,1.25446934252647,424,169,255,36,1.5,35.92,4.9,0,0,0,0,0,0,0.181601661174283,194.310587878895,18.7188004935137
9.7,"eps_greedy_SVM","SVM",67,10,1684,1622,62,1100,902,198,0.819050096175944,0.297709923664122,1.25446934252647,485,198,287,61,1.4,39.51,4.6,0,0,0,0,0,0,0.185697158199696,142.948731297241,19.3055085272686
9.7,"eps_greedy_SVM","SVM",67,11,1584,1543,41,1200,981,219,0.824602896166266,0.282442748091603,1.25446934252647,550,219,331,65,1.5,43.1,4.5,0,0,0,0,0,0,0.17626968084037,119.553459273378,18.8820888817666
9.7,"eps_greedy_SVM","SVM",67,12,1484,1461,23,1300,1063,237,0.81865692406334,0.259541984732824,1.25446934252647,594,237,357,44,1.5,46.7,4.5,0,0,0,0,0,0,0.177145824547772,128.515235130875,18.6179716920294
9.7,"eps_greedy_SVM","SVM",67,13,1384,1365,19,1400,1159,241,0.822975768500257,0.282442748091603,1.25446934252647,607,241,366,13,1.5,50.29,4.8,0,0,0,0,0,0,0.140383427387737,80.6689962725595,15.6124141787541
9.7,"eps_greedy_SVM","SVM",67,14,1284,1268,16,1500,1256,244,0.827935785920803,0.290076335877863,1.24466880078798,626,244,382,19,1.6,53.88,5.1,0,0,0,0,0,0,0.128459555548677,76.5415844920807,14.5038927007438
9.7,"eps_greedy_SVM","SVM",67,15,1184,1170,14,1600,1354,246,0.81780404301907,0.251908396946565,1.2348682590495,628,246,382,2,1.6,57.47,5.5,0,0,0,0,0,0,0.107557642278993,55.0839091165426,12.3990092373689
9.7,"eps_greedy_SVM","SVM",67,16,1084,1072,12,1700,1452,248,0.802923990757419,0.251908396946565,1.22506771731101,638,248,390,10,1.6,61.06,5.9,0,0,0,0,0,0,0.109470105362159,56.9050664640683,12.2320476591604
9.7,"eps_greedy_SVM","SVM",67,17,984,973,11,1800,1551,249,0.809226842162555,0.305343511450382,1.22506771731101,644,249,395,6,1.6,64.66,6.2,0,0,0,0,0,0,0.0913409732871663,48.8563273757017,10.7343718938172
9.7,"eps_greedy_SVM","SVM",67,18,884,873,11,1900,1651,249,0.80649278377952,0.274809160305344,1.22506771731101,651,249,402,7,1.6,68.25,6.6,0,0,0,0,0,0,0.0853107899333374,40.3931686463315,9.48256750081151
9.7,"eps_greedy_SVM","SVM",67,19,784,773,11,2000,1751,249,0.813303734530176,0.274809160305344,1.22506771731101,659,249,410,8,1.6,71.84,7,0,0,0,0,0,0,0.0650964392169237,28.2015172053855,7.35710964693581
9.7,"eps_greedy_SVM","SVM",67,20,684,673,11,2100,1851,249,0.817114479621575,0.305343511450382,1.22506771731101,645,249,396,-14,1.6,75.43,7.4,0,0,0,0,0,0,0.0428486364277501,14.07627790576,5.14861545869529
9.7,"eps_greedy_SVM","SVM",67,21,584,573,11,2200,1951,249,0.803450236508135,0.259541984732824,1.22506771731101,653,249,404,8,1.6,79.02,7.8,0,0,0,0,0,0,0.015559275982112,4.68943015469104,2.39915093558151
9.7,"eps_greedy_SVM","SVM",67,22,484,477,7,2300,2047,253,0.75049902614291,0.152671755725191,1.21526717557252,687,253,434,34,1.7,82.61,8.1,0,0,0,0,0,0,0.0940273129430143,27.5656922859209,15.099934839923
9.7,"eps_greedy_SVM","SVM",67,23,384,377,7,2400,2147,253,0.756003435719372,0.145038167938931,1.22506771731101,675,253,422,-12,1.7,86.21,8.5,0,0,0,0,0,0,0.0294574609396248,8.05063426808065,4.36063385571409
9.7,"eps_greedy_SVM","SVM",67,24,284,280,4,2500,2244,256,0.815541791171163,0.290076335877863,1.2348682590495,699,256,443,24,1.7,89.8,8.8,0,0,0,0,0,0,0.0180492083970647,6.83295452577031,5.56946460364355
9.7,"eps_greedy_SVM","SVM",67,25,184,184,0,2600,2340,260,0.814307835617761,0.297709923664122,1.27407042600345,719,260,459,20,1.8,93.39,9,0,0,0,0,0,0,0.00391975063539463,1.83742527770087,1.7082254302609
9.7,"eps_greedy_SVM","SVM",67,26,84,84,0,2700,2440,260,0.784160607783598,0.213740458015267,1.27407042600345,719,260,459,0,1.8,96.98,9.4,0,0,0,0,0,0,1.51080720313022e-06,0.106749899696465,0.106749899696465
9.7,"eps_greedy_SVM","SVM",67,27,0,0,0,2784,2524,260,0.771911784275533,0.183206106870229,1.27407042600345,717,260,457,-2,1.8,100,9.7,0,0,0,0,0,0,0,0,0
9.7,"eps_greedy_SVM","SVM",68,0,2684,2419,265,100,91,9,0.786807062669132,0.239316239316239,1.28387096774194,30,9,21,0,2.3,3.59,10.1,0,0,0,0,0,0,0.115505013093837,252.477713992681,11.9586933277076
9.7,"eps_greedy_SVM","SVM",68,1,2584,2338,246,200,172,28,0.731244808831013,0.239316239316239,1.26192445547284,73,28,45,43,1.6,7.18,6.1,0,0,0,0,0,0,0.154185677270698,341.657343770957,15.9972946906098
9.7,"eps_greedy_SVM","SVM",68,2,2484,2276,208,300,234,66,0.737614875545907,0.196581196581197,1.2509511993383,160,66,94,87,1.4,10.78,3.5,0,0,0,0,0,0,0.225764374598704,460.320260028659,23.12063240752
9.7,"eps_greedy_SVM","SVM",68,3,2384,2210,174,400,300,100,0.764253945288424,0.188034188034188,1.27289771160739,229,100,129,69,1.3,14.37,3,0,0,0,0,0,0,0.259086824535974,459.661808572392,29.1836260868825
9.7,"eps_greedy_SVM","SVM",68,4,2284,2125,159,500,385,115,0.778675347640866,0.205128205128205,1.26192445547284,276,115,161,47,1.4,17.96,3.3,0,0,0,0,0,0,0.226860610476233,359.593103650501,23.2735220374918
9.7,"eps_greedy_SVM","SVM",68,5,2184,2041,143,600,469,131,0.774401843367359,0.222222222222222,1.2509511993383,309,131,178,33,1.4,21.55,3.6,0,0,0,0,0,0,0.203725408855845,241.325213387466,21.0053859126748
9.7,"eps_greedy_SVM","SVM",68,6,2084,1970,114,700,540,160,0.776223776223783,0.222222222222222,1.26192445547284,376,160,216,67,1.4,25.14,3.4,0,0,0,0,0,0,0.22240418098799,221.62867716521,23.2155774284287
9.7,"eps_greedy_SVM","SVM",68,7,1984,1885,99,800,625,175,0.777248613455519,0.213675213675214,1.26192445547284,416,175,241,40,1.4,28.74,3.6,0,0,0,0,0,0,0.209534907562053,267.349145059847,21.5821898074316
9.7,"eps_greedy_SVM","SVM",68,8,1884,1810,74,900,700,200,0.792527395975676,0.239316239316239,1.26192445547284,474,200,274,58,1.4,32.33,3.5,0,0,0,0,0,0,0.206002642993571,194.411467289129,25.9905180793361
9.7,"eps_greedy_SVM","SVM",68,9,1784,1729,55,1000,781,219,0.796425796425801,0.222222222222222,1.2509511993383,518,219,299,44,1.4,35.92,3.6,0,0,0,0,0,0,0.203056045621199,231.942889141635,21.3577063606843
9.7,"eps_greedy_SVM","SVM",68,10,1684,1640,44,1100,870,230,0.793712991988862,0.239316239316239,1.23997794320375,556,230,326,38,1.4,39.51,3.8,0,0,0,0,0,0,0.188983732305553,179.056284284221,19.7833786539227
9.7,"eps_greedy_SVM","SVM",68,11,1584,1555,29,1200,955,245,0.795963614929137,0.247863247863248,1.2290046870692,604,245,359,48,1.5,43.1,3.9,0,0,0,0,0,0,0.17933691348579,158.612908176952,18.9992051062204
9.7,"eps_greedy_SVM","SVM",68,12,1484,1458,26,1300,1052,248,0.798086970500767,0.256410256410256,1.2290046870692,607,248,359,3,1.4,46.7,4.2,0,0,0,0,0,0,0.137349493149743,86.3715533924598,14.8274053906656
9.7,"eps_greedy_SVM","SVM",68,13,1384,1361,23,1400,1149,251,0.785621466655957,0.230769230769231,1.21803143093466,635,251,384,28,1.5,50.29,4.6,0,0,0,0,0,0,0.157084493817906,126.678396445628,17.1587908795163
9.7,"eps_greedy_SVM","SVM",68,14,1284,1261,23,1500,1249,251,0.784080861667075,0.222222222222222,1.20705817480011,646,251,395,11,1.6,53.88,5,0,0,0,0,0,0,0.13374792354327,90.0178804594422,14.2391692922782
9.7,"eps_greedy_SVM","SVM",68,15,1184,1163,21,1600,1347,253,0.785989872196772,0.213675213675214,1.21803143093466,652,253,399,6,1.6,57.47,5.3,0,0,0,0,0,0,0.107757889238617,57.0369243924497,12.1128049694523
9.7,"eps_greedy_SVM","SVM",68,16,1084,1065,19,1700,1445,255,0.795173217587009,0.256410256410256,1.21803143093466,650,255,395,-2,1.5,61.06,5.7,0,0,0,0,0,0,0.070890459941098,30.0819922671773,8.29674266287549
9.7,"eps_greedy_SVM","SVM",68,17,984,965,19,1800,1545,255,0.778635157945502,0.213675213675214,1.21803143093466,650,255,395,0,1.5,64.66,6.1,0,0,0,0,0,0,0.07287471657794,30.0167023834308,8.29580569890415
9.7,"eps_greedy_SVM","SVM",68,18,884,866,18,1900,1644,256,0.784134447927551,0.290598290598291,1.2290046870692,663,256,407,13,1.6,68.25,6.4,0,0,0,0,0,0,0.0409253485601244,13.7150808772699,5.1554640240972
9.7,"eps_greedy_SVM","SVM",68,19,784,769,15,2000,1741,259,0.778266752404683,0.205128205128205,1.23997794320375,662,259,403,-1,1.6,71.84,6.7,0,0,0,0,0,0,0.0186731546805783,6.09444314719613,3.05030184811609
9.7,"eps_greedy_SVM","SVM",68,20,684,672,12,2100,1838,262,0.801107895935483,0.239316239316239,1.26192445547284,693,262,431,31,1.6,75.43,7,0,0,0,0,0,0,0.0409402398322353,14.7398470528324,5.48682891637432
9.7,"eps_greedy_SVM","SVM",68,21,584,578,6,2200,1932,268,0.824786324786324,0.256410256410256,1.28387096774194,713,268,445,20,1.7,79.02,7.2,0,0,0,0,0,0,0.0138282851999375,4.82255277643785,2.92846230285407
9.7,"eps_greedy_SVM","SVM",68,22,484,482,2,2300,2028,272,0.811684484098275,0.264957264957265,1.28387096774194,737,272,465,24,1.7,82.61,7.5,0,0,0,0,0,0,0.00356425779453326,1.19839141602921,0.926063016281251
9.7,"eps_greedy_SVM","SVM",68,23,384,383,1,2400,2127,273,0.794938777697393,0.205128205128205,1.27289771160739,741,273,468,4,1.7,86.21,7.8,0,0,0,0,0,0,0.0200665571992527,8.69244466030541,6.93934857254097
9.7,"eps_greedy_SVM","SVM",68,24,284,284,0,2500,2226,274,0.792962784342087,0.230769230769231,1.27289771160739,729,274,455,-12,1.7,89.8,8.1,0,0,0,0,0,0,0.00731601198535686,3.65475223015123,3.22325810878741
9.7,"eps_greedy_SVM","SVM",68,25,184,184,0,2600,2326,274,0.820794148380353,0.282051282051282,1.27289771160739,727,274,453,-2,1.7,93.39,8.5,0,0,0,0,0,0,0.000230378093789842,0.161475634123806,0.155500458680977
9.7,"eps_greedy_SVM","SVM",68,26,84,84,0,2700,2426,274,0.808422420491379,0.239316239316239,1.27289771160739,748,274,474,21,1.7,96.98,8.9,0,0,0,0,0,0,1.30026465977303e-05,0.0292178855420841,0.0292178855420841
9.7,"eps_greedy_SVM","SVM",68,27,0,0,0,2784,2510,274,0.783317257455182,0.179487179487179,1.27289771160739,739,274,465,-9,1.7,100,9.2,0,0,0,0,0,0,0,0,0
9.7,"eps_greedy_SVM","SVM",69,0,2684,2422,262,100,89,11,0.30977733466268,0.00847457627118644,0.761618370694368,34,11,23,0,2.1,3.59,8.1,0,0,0,0,0,0,0.117674086450739,298.946632966351,11.8844061056355
9.7,"eps_greedy_SVM","SVM",69,1,2584,2343,241,200,168,32,0.780784313725495,0.23728813559322,1.26211044286495,81,32,49,47,1.5,7.18,5.2,0,0,0,0,0,0,0.247450462957599,333.050614141016,28.0648216349053
9.7,"eps_greedy_SVM","SVM",69,2,2484,2269,215,300,242,58,0.757620471917583,0.245762711864407,1.26211044286495,139,58,81,58,1.4,10.78,4.2,0,0,0,0,0,0,0.22468154487254,336.14094446833,23.8874038574126
9.7,"eps_greedy_SVM","SVM",69,3,2384,2200,184,400,311,89,0.753220338983054,0.245762711864407,1.25123018042646,205,89,116,66,1.3,14.37,3.5,0,0,0,0,0,0,0.243891943549772,360.87195927063,26.71295634875
9.7,"eps_greedy_SVM","SVM",69,4,2284,2116,168,500,395,105,0.765702891326027,0.245762711864407,1.25123018042646,252,105,147,47,1.4,17.96,3.8,0,0,0,0,0,0,0.205324949344996,220.627872622428,22.0890485757708
9.7,"eps_greedy_SVM","SVM",69,5,2184,2040,144,600,471,129,0.793506148222005,0.228813559322034,1.27299070530344,303,129,174,51,1.3,21.55,3.7,0,0,0,0,0,0,0.212295582834283,270.948346009538,22.0136204866647
9.7,"eps_greedy_SVM","SVM",69,6,2084,1955,129,700,556,144,0.797082087072122,0.211864406779661,1.26211044286495,347,144,203,44,1.4,25.14,3.9,0,0,0,0,0,0,0.185787138950682,166.551535138011,19.4587567170066
9.7,"eps_greedy_SVM","SVM",69,7,1984,1886,98,800,625,175,0.792482552342975,0.23728813559322,1.26211044286495,416,175,241,69,1.4,28.74,3.6,0,0,0,0,0,0,0.216392803892498,221.605094602035,22.196932684696
9.7,"eps_greedy_SVM","SVM",69,8,1884,1809,75,900,702,198,0.800112994350287,0.245762711864407,1.26211044286495,470,198,272,54,1.4,32.33,3.5,0,0,0,0,0,0,0.208588207146029,160.38536937402,22.314029358986
9.7,"eps_greedy_SVM","SVM",69,9,1784,1732,52,1000,779,221,0.794782319707547,0.23728813559322,1.26211044286495,534,221,313,64,1.4,35.92,3.5,0,0,0,0,0,0,0.188800445084233,146.997782379027,20.207488271861
9.7,"eps_greedy_SVM","SVM",69,10,1684,1641,43,1100,870,230,0.800618145563312,0.220338983050847,1.27299070530344,549,230,319,15,1.4,39.51,3.8,0,0,0,0,0,0,0.168139245972912,118.925659918446,17.89210358524
9.7,"eps_greedy_SVM","SVM",69,11,1584,1545,39,1200,966,234,0.802924559654372,0.254237288135593,1.26211044286495,577,234,343,28,1.5,43.1,4.1,0,0,0,0,0,0,0.149751881064918,77.5004166650965,16.2900011407879
9.7,"eps_greedy_SVM","SVM",69,12,1484,1452,32,1300,1059,241,0.795028248587577,0.245762711864407,1.21858939311099,596,241,355,19,1.5,46.7,4.4,0,0,0,0,0,0,0.155153105784702,105.644671667797,16.8281055638896
9.7,"eps_greedy_SVM","SVM",69,13,1384,1365,19,1400,1146,254,0.780910601528755,0.177966101694915,1.24034991798797,642,254,388,46,1.5,50.29,4.5,0,0,0,0,0,0,0.152985849913671,98.5310941844514,16.8040295743052
9.7,"eps_greedy_SVM","SVM",69,14,1284,1268,16,1500,1243,257,0.796031904287147,0.228813559322034,1.22946965554948,645,257,388,3,1.5,53.88,4.8,0,0,0,0,0,0,0.143783016804286,106.961820144116,15.1957881953243
9.7,"eps_greedy_SVM","SVM",69,15,1184,1169,15,1600,1342,258,0.784852110335668,0.203389830508475,1.24034991798797,665,258,407,20,1.6,57.47,5.2,0,0,0,0,0,0,0.0833117996782026,36.6383991792158,10.21257992573
9.7,"eps_greedy_SVM","SVM",69,16,1084,1072,12,1700,1439,261,0.789790628115661,0.177966101694915,1.24034991798797,674,261,413,9,1.6,61.06,5.5,0,0,0,0,0,0,0.0940836123749474,38.27915828755,12.1494300857339
9.7,"eps_greedy_SVM","SVM",69,17,984,972,12,1800,1539,261,0.801415752741783,0.245762711864407,1.24034991798797,678,261,417,4,1.6,64.66,5.9,0,0,0,0,0,0,0.0425296678955477,14.9121491881968,6.02065229032565
9.7,"eps_greedy_SVM","SVM",69,18,884,872,12,1900,1639,261,0.809857095380533,0.254237288135593,1.24034991798797,668,261,407,-10,1.6,68.25,6.3,0,0,0,0,0,0,0.0132514450855632,4.36811565532382,2.2049010985199
9.7,"eps_greedy_SVM","SVM",69,19,784,773,11,2000,1738,262,0.79863742107013,0.245762711864407,1.25123018042646,665,262,403,-3,1.5,71.84,6.6,0,0,0,0,0,0,0.0156746170099594,5.79606003024853,2.2681703789362
9.7,"eps_greedy_SVM","SVM",69,20,684,675,9,2100,1836,264,0.803203722166839,0.245762711864407,1.26211044286495,685,264,421,20,1.6,75.43,7,0,0,0,0,0,0,0.0313512537432836,13.2847617843454,3.97871958754631
9.7,"eps_greedy_SVM","SVM",69,21,584,579,5,2200,1932,268,0.821734795613164,0.194915254237288,1.27299070530344,725,268,457,40,1.7,79.02,7.2,0,0,0,0,0,0,0.077254891150313,20.0708850310294,10.7470857230411
9.7,"eps_greedy_SVM","SVM",69,22,484,483,1,2300,2028,272,0.785649717514126,0.186440677966102,1.27299070530344,734,272,462,9,1.7,82.61,7.5,0,0,0,0,0,0,0.0217450410529755,7.12108421654436,4.56123661037305
9.7,"eps_greedy_SVM","SVM",69,23,384,384,0,2400,2127,273,0.800212695247592,0.177966101694915,1.28387096774194,762,273,489,28,1.8,86.21,7.8,0,0,0,0,0,0,0.111272697516425,27.4089634148123,13.164590583228
9.7,"eps_greedy_SVM","SVM",69,24,284,284,0,2500,2227,273,0.817846460618147,0.228813559322034,1.28387096774194,752,273,479,-10,1.8,89.8,8.2,0,0,0,0,0,0,0.0307231984828104,8.04221317036698,5.21681685461052
9.7,"eps_greedy_SVM","SVM",69,25,184,184,0,2600,2327,273,0.800651379195748,0.245762711864407,1.28387096774194,766,273,493,14,1.8,93.39,8.5,0,0,0,0,0,0,0.0146747794221191,4.13582146259838,3.45179782094529
9.7,"eps_greedy_SVM","SVM",69,26,84,84,0,2700,2427,273,0.824320372216687,0.279661016949153,1.26211044286495,759,273,486,-7,1.8,96.98,8.9,0,0,0,0,0,0,0.000135610714649657,0.112933902049044,0.112933902049044
9.7,"eps_greedy_SVM","SVM",69,27,0,0,0,2784,2511,273,0.818963110667998,0.254237288135593,1.28387096774194,746,273,473,-13,1.7,100,9.2,0,0,0,0,0,0,0,0,0
9.7,"eps_greedy_SVM","SVM",70,0,2684,2451,233,100,89,11,0.756597984298055,0.312925170068027,1.1615975422427,30,11,19,0,1.7,3.59,8.1,0,0,0,0,0,0,0.210631559955811,276.928108231933,39.908437797539
9.7,"eps_greedy_SVM","SVM",70,1,2584,2374,210,200,166,34,0.827977418896933,0.26530612244898,1.26640333552776,86,34,52,56,1.5,7.18,4.9,0,0,0,0,0,0,0.21859542599506,257.685876857428,28.612786865823
9.7,"eps_greedy_SVM","SVM",70,2,2484,2293,191,300,247,53,0.747431235736663,0.183673469387755,1.24893570331358,140,53,87,54,1.6,10.78,4.7,0,0,0,0,0,0,0.200439897716996,359.493862932745,21.477684069939
9.7,"eps_greedy_SVM","SVM",70,3,2384,2198,186,400,342,58,0.841260741856943,0.319727891156463,1.26640333552776,159,58,101,19,1.7,14.37,5.9,0,0,0,0,0,0,0.179789631500698,200.973153967565,18.2815954980278
9.7,"eps_greedy_SVM","SVM",70,4,2284,2125,159,500,415,85,0.842925934418722,0.360544217687075,1.26640333552776,218,85,133,59,1.6,17.96,4.9,0,0,0,0,0,0,0.193199113141245,197.654481727539,19.4790334909498
9.7,"eps_greedy_SVM","SVM",70,5,2184,2062,122,600,478,122,0.844421877900452,0.353741496598639,1.26640333552776,300,122,178,82,1.5,21.55,3.9,0,0,0,0,0,0,0.2259445136336,151.875658791517,22.9419904513957
9.7,"eps_greedy_SVM","SVM",70,6,2084,1990,94,700,550,150,0.835025824133838,0.319727891156463,1.26640333552776,360,150,210,60,1.4,25.14,3.7,0,0,0,0,0,0,0.227928865581873,142.182793853011,23.188784052973
9.7,"eps_greedy_SVM","SVM",70,7,1984,1909,75,800,631,169,0.842794902872878,0.346938775510204,1.26640333552776,404,169,235,44,1.4,28.74,3.7,0,0,0,0,0,0,0.209242652276162,146.092319155021,22.068496406036
9.7,"eps_greedy_SVM","SVM",70,8,1884,1820,64,900,720,180,0.836412574660692,0.306122448979592,1.26640333552776,439,180,259,35,1.4,32.33,4,0,0,0,0,0,0,0.165441023117797,97.9734637315279,18.3537870619784
9.7,"eps_greedy_SVM","SVM",70,9,1784,1729,55,1000,811,189,0.822796213188327,0.272108843537415,1.25766951942067,471,189,282,32,1.5,35.92,4.3,0,0,0,0,0,0,0.157367014361345,100.197080251512,17.2872998443261
9.7,"eps_greedy_SVM","SVM",70,10,1684,1641,43,1100,899,201,0.803785719745365,0.224489795918367,1.26640333552776,499,201,298,28,1.5,39.51,4.5,0,0,0,0,0,0,0.159310730686179,95.4926151466831,17.7156871475211
9.7,"eps_greedy_SVM","SVM",70,11,1584,1543,41,1200,997,203,0.822217490527508,0.292517006802721,1.26640333552776,514,203,311,15,1.5,43.1,4.9,0,0,0,0,0,0,0.0831305107210811,35.8800489919379,10.9462465860476
9.7,"eps_greedy_SVM","SVM",70,12,1484,1452,32,1300,1088,212,0.798276935172136,0.238095238095238,1.25766951942067,521,212,309,7,1.5,46.7,5.1,0,0,0,0,0,0,0.18433573040063,97.1101699234087,33.6225859009797
9.7,"eps_greedy_SVM","SVM",70,13,1384,1354,30,1400,1186,214,0.800302464484982,0.210884353741497,1.27513715163485,544,214,330,23,1.5,50.29,5.5,0,0,0,0,0,0,0.124099719377918,97.9580648544264,13.5311008134365
9.7,"eps_greedy_SVM","SVM",70,14,1284,1262,22,1500,1278,222,0.82398641639641,0.306122448979592,1.26640333552776,572,222,350,28,1.6,53.88,5.8,0,0,0,0,0,0,0.1218506503954,57.217669793224,13.6360625723715
9.7,"eps_greedy_SVM","SVM",70,15,1184,1174,10,1600,1366,234,0.80418973367838,0.251700680272109,1.26640333552776,619,234,385,47,1.6,57.47,5.8,0,0,0,0,0,0,0.15281498167969,92.2260006157612,16.5773227023102
9.7,"eps_greedy_SVM","SVM",70,16,1084,1077,7,1700,1463,237,0.784436728142295,0.204081632653061,1.26640333552776,628,237,391,9,1.6,61.06,6.2,0,0,0,0,0,0,0.126109950988713,62.3147882139997,13.8812547267308
9.7,"eps_greedy_SVM","SVM",70,17,984,977,7,1800,1563,237,0.739569342985979,0.142857142857143,1.27513715163485,624,237,387,-4,1.6,64.66,6.6,0,0,0,0,0,0,0.092895241055267,33.0988350908264,11.2880105950917
9.7,"eps_greedy_SVM","SVM",70,18,884,880,4,1900,1660,240,0.770694794771832,0.17687074829932,1.27513715163485,646,240,406,22,1.7,68.25,6.9,0,0,0,0,0,0,0.103904579104566,51.5208178539852,12.1544596333704
9.7,"eps_greedy_SVM","SVM",70,19,784,781,3,2000,1759,241,0.717594260818286,0.136054421768707,1.27513715163485,667,241,426,21,1.8,71.84,7.3,0,0,0,0,0,0,0.113492183318542,57.4001441196918,12.9591246845203
9.7,"eps_greedy_SVM","SVM",70,20,684,681,3,2100,1859,241,0.794116683591561,0.238095238095238,1.27513715163485,671,241,430,4,1.8,75.43,7.7,0,0,0,0,0,0,0.0731932863876244,28.3482551195496,8.75912069886632
9.7,"eps_greedy_SVM","SVM",70,21,584,582,2,2200,1958,242,0.736801301580014,0.17687074829932,1.27513715163485,669,242,427,-2,1.8,79.02,8.1,0,0,0,0,0,0,0.0703310048308814,26.226257605042,8.3222670236874
9.7,"eps_greedy_SVM","SVM",70,22,484,483,1,2300,2057,243,0.801361636147235,0.299319727891156,1.26640333552776,675,243,432,6,1.8,82.61,8.5,0,0,0,0,0,0,0.0761331041443761,26.0974150940496,10.4128193857592
9.7,"eps_greedy_SVM","SVM",70,23,384,383,1,2400,2157,243,0.775788646116548,0.224489795918367,1.26640333552776,673,243,430,-2,1.8,86.21,8.9,0,0,0,0,0,0,0.0574623616934413,15.6021256581883,6.82591081658155
9.7,"eps_greedy_SVM","SVM",70,24,284,283,1,2500,2257,243,0.725221388715997,0.197278911564626,1.26640333552776,669,243,426,-4,1.8,89.8,9.3,0,0,0,0,0,0,0.0233761873151866,5.41845565204671,3.51973534319038
9.7,"eps_greedy_SVM","SVM",70,25,184,184,0,2600,2356,244,0.739105272927785,0.183673469387755,1.27513715163485,688,244,444,19,1.8,93.39,9.7,0,0,0,0,0,0,0.014787353655131,3.71008116613706,2.99166485164805
9.7,"eps_greedy_SVM","SVM",70,26,84,84,0,2700,2456,244,0.792511547154969,0.26530612244898,1.27513715163485,687,244,443,-1,1.8,96.98,10.1,0,0,0,0,0,0,1.02434335559235e-05,0.7565450376836,0.7565450376836
9.7,"eps_greedy_SVM","SVM",70,27,0,0,0,2784,2540,244,0.75390637796049,0.163265306122449,1.27513715163485,691,244,447,4,1.8,100,10.4,0,0,0,0,0,0,0,0,0
9.7,"eps_greedy_SVM","SVM",71,0,2684,2429,255,100,92,8,0.832466650197633,0.2890625,1.28387096774194,25,8,17,0,2.1,3.59,11.5,0,0,0,0,0,0,0.164010624339156,225.173331902042,19.5649737162104
9.7,"eps_greedy_SVM","SVM",71,1,2584,2351,233,200,170,30,0.826735424901185,0.3046875,1.28387096774194,79,30,49,54,1.6,7.18,5.7,0,0,0,0,0,0,0.173790273506007,357.77627173498,17.5967125175347
9.7,"eps_greedy_SVM","SVM",71,2,2484,2287,197,300,234,66,0.815476778656129,0.296875,1.28387096774194,163,66,97,84,1.5,10.78,3.5,0,0,0,0,0,0,0.261190158837613,371.542914611824,26.977869645743
9.7,"eps_greedy_SVM","SVM",71,3,2384,2219,165,400,302,98,0.82966279644269,0.265625,1.28387096774194,228,98,130,65,1.3,14.37,3.1,0,0,0,0,0,0,0.26846939776587,276.89950069628,27.8725307069799
9.7,"eps_greedy_SVM","SVM",71,4,2284,2150,134,500,371,129,0.830755928853758,0.2734375,1.28387096774194,301,129,172,73,1.3,17.96,2.9,0,0,0,0,0,0,0.272223524596616,206.679180207597,27.7753167879945
9.7,"eps_greedy_SVM","SVM",71,5,2184,2076,108,600,445,155,0.833584486166008,0.28125,1.28387096774194,367,155,212,66,1.4,21.55,2.9,0,0,0,0,0,0,0.258272366533521,188.080601877974,26.8444637835022
9.7,"eps_greedy_SVM","SVM",71,6,2084,2001,83,700,520,180,0.835869565217391,0.28125,1.28387096774194,416,180,236,49,1.3,25.14,2.9,0,0,0,0,0,0,0.240448089604695,178.302475904318,25.5992256636866
9.7,"eps_greedy_SVM","SVM",71,7,1984,1913,71,800,608,192,0.835221096837943,0.296875,1.28387096774194,461,192,269,45,1.4,28.74,3.2,0,0,0,0,0,0,0.222288474686967,199.854935525253,23.5720641383632
9.7,"eps_greedy_SVM","SVM",71,8,1884,1825,59,900,696,204,0.826327816205536,0.296875,1.28387096774194,494,204,290,33,1.4,32.33,3.4,0,0,0,0,0,0,0.22229035408647,180.102472399526,23.7016784897773
9.7,"eps_greedy_SVM","SVM",71,9,1784,1731,53,1000,790,210,0.827346837944665,0.25,1.28387096774194,512,210,302,18,1.4,35.92,3.8,0,0,0,0,0,0,0.169534073338449,112.959788569065,19.185391301645
9.7,"eps_greedy_SVM","SVM",71,10,1684,1635,49,1100,886,214,0.819744318181819,0.25,1.28387096774194,532,214,318,20,1.5,39.51,4.1,0,0,0,0,0,0,0.120703239488077,52.0861823830855,19.7204129617501
9.7,"eps_greedy_SVM","SVM",71,11,1584,1552,32,1200,969,231,0.821121541501977,0.2578125,1.28387096774194,581,231,350,49,1.5,43.1,4.2,0,0,0,0,0,0,0.176210099755518,106.633076573185,19.3539322419165
9.7,"eps_greedy_SVM","SVM",71,12,1484,1457,27,1300,1064,236,0.826648962450593,0.2890625,1.28387096774194,589,236,353,8,1.5,46.7,4.5,0,0,0,0,0,0,0.0949918920868245,39.4937478285285,13.8980481603248
9.7,"eps_greedy_SVM","SVM",71,13,1384,1363,21,1400,1158,242,0.833349802371543,0.2734375,1.28387096774194,604,242,362,15,1.5,50.29,4.8,0,0,0,0,0,0,0.103281216574516,42.9951377452279,13.2126612347472
9.7,"eps_greedy_SVM","SVM",71,14,1284,1275,9,1500,1246,254,0.81923171936759,0.234375,1.28387096774194,632,254,378,28,1.5,53.88,4.9,0,0,0,0,0,0,0.0799772353373174,24.9663371560392,13.5611969075197
9.7,"eps_greedy_SVM","SVM",71,15,1184,1176,8,1600,1345,255,0.823561017786563,0.25,1.28387096774194,636,255,381,4,1.5,57.47,5.3,0,0,0,0,0,0,0.0591948587501847,19.1273573510281,7.57223082314792
9.7,"eps_greedy_SVM","SVM",71,16,1084,1078,6,1700,1443,257,0.805095108695652,0.203125,1.28387096774194,660,257,403,24,1.6,61.06,5.6,0,0,0,0,0,0,0.0562967917345864,14.9922898417719,8.45631421425171
9.7,"eps_greedy_SVM","SVM",71,17,984,980,4,1800,1541,259,0.791996047430831,0.1640625,1.28387096774194,662,259,403,2,1.6,64.66,5.9,0,0,0,0,0,0,0.0684290650893122,21.9268511395343,9.18784520639147
9.7,"eps_greedy_SVM","SVM",71,18,884,881,3,1900,1640,260,0.808708003952571,0.2421875,1.28387096774194,675,260,415,13,1.6,68.25,6.3,0,0,0,0,0,0,0.0524450846466819,17.4372661979146,7.3161779554858
9.7,"eps_greedy_SVM","SVM",71,19,784,782,2,2000,1739,261,0.800364377470358,0.1953125,1.28387096774194,690,261,429,15,1.6,71.84,6.7,0,0,0,0,0,0,0.0868330972151653,37.0437675591102,11.3696815069159
9.7,"eps_greedy_SVM","SVM",71,20,684,682,2,2100,1839,261,0.809992588932809,0.2265625,1.28387096774194,676,261,415,-14,1.6,75.43,7,0,0,0,0,0,0,0.0699436351499569,27.8545628457813,8.13589987368861
9.7,"eps_greedy_SVM","SVM",71,21,584,582,2,2200,1939,261,0.75331645256917,0.125,1.28387096774194,690,261,429,14,1.6,79.02,7.4,0,0,0,0,0,0,0.0219070049530581,6.35580036079108,3.11681741662408
9.7,"eps_greedy_SVM","SVM",71,22,484,482,2,2300,2039,261,0.806762598814232,0.28125,1.28387096774194,691,261,430,1,1.6,82.61,7.8,0,0,0,0,0,0,0.0117741385546053,3.32126141385853,2.10625600834803
9.7,"eps_greedy_SVM","SVM",71,23,384,383,1,2400,2138,262,0.731101778656125,0.1640625,1.26381048387097,702,262,440,11,1.7,86.21,8.2,0,0,0,0,0,0,0.0773408529163262,22.3796187884477,17.9280860363572
9.7,"eps_greedy_SVM","SVM",71,24,284,283,1,2500,2238,262,0.745411314229249,0.1484375,1.27384072580645,710,262,448,8,1.7,89.8,8.5,0,0,0,0,0,0,0.013856140552098,4.06448043471514,3.18015379804976
9.7,"eps_greedy_SVM","SVM",71,25,184,184,0,2600,2337,263,0.761227766798418,0.171875,1.27384072580645,717,263,454,7,1.7,93.39,8.9,0,0,0,0,0,0,0.00289985835376464,1.39677204771468,1.3693549952846
9.7,"eps_greedy_SVM","SVM",71,26,84,84,0,2700,2437,263,0.776321640316205,0.171875,1.27384072580645,705,263,442,-12,1.7,96.98,9.3,0,0,0,0,0,0,8.91085168116667e-12,0.0652160381447053,0.0652160381447053
9.7,"eps_greedy_SVM","SVM",71,27,0,0,0,2784,2521,263,0.763938982213439,0.15625,1.27384072580645,706,263,443,1,1.7,100,9.6,0,0,0,0,0,0,0,0,0
9.7,"eps_greedy_SVM","SVM",72,0,2684,2435,249,100,92,8,0.765082451128004,0.402985074626866,1.16889744824266,23,8,15,0,1.9,3.59,11.5,0,0,0,0,0,0,0.183956310791592,237.801719544191,20.7890209908655
9.7,"eps_greedy_SVM","SVM",72,1,2584,2375,209,200,152,48,0.773647647386584,0.134328358208955,1.25512758786712,115,48,67,92,1.4,7.18,3.2,0,0,0,0,0,0,0.33090442912303,522.321260196031,36.4864162253734
9.7,"eps_greedy_SVM","SVM",72,2,2484,2287,197,300,240,60,0.77710336324731,0.201492537313433,1.25512758786712,151,60,91,36,1.5,10.78,4,0,0,0,0,0,0,0.222986817159295,413.372835934722,25.0096112801513
9.7,"eps_greedy_SVM","SVM",72,3,2384,2203,181,400,324,76,0.834048581556084,0.291044776119403,1.274289841117,195,76,119,44,1.6,14.37,4.3,0,0,0,0,0,0,0.225483639126325,329.808780605576,23.38494050646
9.7,"eps_greedy_SVM","SVM",72,4,2284,2133,151,500,394,106,0.809206548670471,0.208955223880597,1.274289841117,274,106,168,79,1.6,17.96,3.7,0,0,0,0,0,0,0.235762901611918,328.100908054374,23.9926789820149
9.7,"eps_greedy_SVM","SVM",72,5,2184,2048,136,600,479,121,0.805922729482061,0.238805970149254,1.274289841117,327,121,206,53,1.7,21.55,4,0,0,0,0,0,0,0.21828905318815,220.264259129591,22.1203269547774
9.7,"eps_greedy_SVM","SVM",72,6,2084,1965,119,700,562,138,0.80409706827262,0.216417910447761,1.274289841117,361,138,223,34,1.6,25.14,4.1,0,0,0,0,0,0,0.208066852752161,212.617177893786,21.3180826946378
9.7,"eps_greedy_SVM","SVM",72,7,1984,1894,90,800,633,167,0.821174113546647,0.23134328358209,1.274289841117,421,167,254,60,1.5,28.74,3.8,0,0,0,0,0,0,0.211514021000599,220.398589193411,21.5457811551195
9.7,"eps_greedy_SVM","SVM",72,8,1884,1817,67,900,710,190,0.814630185055663,0.23134328358209,1.274289841117,483,190,293,62,1.5,32.33,3.7,0,0,0,0,0,0,0.212760433995716,179.916157323582,21.807448044979
9.7,"eps_greedy_SVM","SVM",72,9,1784,1738,46,1000,789,211,0.83752207983119,0.26865671641791,1.274289841117,549,211,338,66,1.6,35.92,3.7,0,0,0,0,0,0,0.200260136980508,148.516361940894,20.619017386943
9.7,"eps_greedy_SVM","SVM",72,10,1684,1655,29,1100,872,228,0.830557300866602,0.246268656716418,1.274289841117,589,228,361,40,1.6,39.51,3.8,0,0,0,0,0,0,0.200650905904339,183.53596914504,20.6202797855846
9.7,"eps_greedy_SVM","SVM",72,11,1584,1562,22,1200,965,235,0.818583808518967,0.23134328358209,1.274289841117,617,235,382,28,1.6,43.1,4.1,0,0,0,0,0,0,0.18650541185464,186.821105002373,19.1763403028521
9.7,"eps_greedy_SVM","SVM",72,12,1484,1466,18,1300,1061,239,0.797535357367259,0.253731343283582,1.26470871449206,634,239,395,17,1.7,46.7,4.4,0,0,0,0,0,0,0.157727856714274,101.472673231405,17.0476748830805
9.7,"eps_greedy_SVM","SVM",72,13,1384,1368,16,1400,1159,241,0.806308015126911,0.238805970149254,1.274289841117,647,241,406,13,1.7,50.29,4.8,0,0,0,0,0,0,0.130569250425247,80.181541147727,14.0859385680218
9.7,"eps_greedy_SVM","SVM",72,14,1284,1271,13,1500,1256,244,0.818109610802227,0.238805970149254,1.274289841117,660,244,416,13,1.7,53.88,5.1,0,0,0,0,0,0,0.122843234375806,73.6563313282495,14.3129999425101
9.7,"eps_greedy_SVM","SVM",72,15,1184,1175,9,1600,1352,248,0.79813403198464,0.238805970149254,1.274289841117,688,248,440,28,1.8,57.47,5.5,0,0,0,0,0,0,0.150855320691134,163.437765267798,15.3530662979942
9.7,"eps_greedy_SVM","SVM",72,16,1084,1078,6,1700,1449,251,0.763161950375211,0.17910447761194,1.28387096774194,702,251,451,14,1.8,61.06,5.8,0,0,0,0,0,0,0.140809694670603,98.1992990414328,15.1407104002976
9.7,"eps_greedy_SVM","SVM",72,17,984,979,5,1800,1548,252,0.760862091449033,0.194029850746269,1.28387096774194,712,252,460,10,1.8,64.66,6.1,0,0,0,0,0,0,0.136639728309188,98.8081362015257,14.1530505123803
9.7,"eps_greedy_SVM","SVM",72,18,884,880,4,1900,1647,253,0.809941555131414,0.246268656716418,1.28387096774194,716,253,463,4,1.8,68.25,6.5,0,0,0,0,0,0,0.10230290957819,54.4280342226211,11.1466563013982
9.7,"eps_greedy_SVM","SVM",72,19,784,781,3,2000,1746,254,0.792662975827774,0.246268656716418,1.28387096774194,746,254,492,30,1.9,71.84,6.9,0,0,0,0,0,0,0.0936114205249535,44.5053803002103,10.1875332170336
9.7,"eps_greedy_SVM","SVM",72,20,684,681,3,2100,1846,254,0.749030858416418,0.156716417910448,1.28387096774194,721,254,467,-25,1.8,75.43,7.3,0,0,0,0,0,0,0.0922756064100048,45.0499640012752,9.82497044163072
9.7,"eps_greedy_SVM","SVM",72,21,584,582,2,2200,1945,255,0.804310457245151,0.261194029850746,1.274289841117,742,255,487,21,1.9,79.02,7.6,0,0,0,0,0,0,0.0481248973391074,14.8797059232139,6.29537177693693
9.7,"eps_greedy_SVM","SVM",72,22,484,483,1,2300,2044,256,0.705861083778883,0.201492537313433,1.28387096774194,736,256,480,-6,1.9,82.61,8,0,0,0,0,0,0,0.0215575162858642,5.62008235353534,3.05318319176769
9.7,"eps_greedy_SVM","SVM",72,23,384,383,1,2400,2144,256,0.803136817896224,0.253731343283582,1.28387096774194,729,256,473,-7,1.8,86.21,8.4,0,0,0,0,0,0,0.0225099507522602,5.68167674880651,3.125079733352
9.7,"eps_greedy_SVM","SVM",72,24,284,284,0,2500,2243,257,0.781187391082715,0.201492537313433,1.274289841117,742,257,485,13,1.9,89.8,8.7,0,0,0,0,0,0,0.0172784815014045,7.63988286709638,6.65004536202066
9.7,"eps_greedy_SVM","SVM",72,25,184,184,0,2600,2343,257,0.780505731864904,0.208955223880597,1.28387096774194,732,257,475,-10,1.8,93.39,9.1,0,0,0,0,0,0,0.00480154174310003,1.34480704480391,1.24961930669756
9.7,"eps_greedy_SVM","SVM",72,26,84,84,0,2700,2443,257,0.809538487072187,0.238805970149254,1.274289841117,730,257,473,-2,1.8,96.98,9.5,0,0,0,0,0,0,5.27335517162324e-10,0.002649950056988,0.002649950056988
9.7,"eps_greedy_SVM","SVM",72,27,0,0,0,2784,2527,257,0.764003651322422,0.17910447761194,1.274289841117,724,257,467,-6,1.8,100,9.8,0,0,0,0,0,0,0,0,0
9.7,"eps_greedy_SVM","SVM",73,0,2684,2422,262,100,94,6,0.777895141156136,0.268292682926829,1.16905323891949,17,6,11,0,1.8,3.59,15.7,0,0,0,0,0,0,0.100766834096552,132.63394313404,23.6452244156541
9.7,"eps_greedy_SVM","SVM",73,1,2584,2342,242,200,174,26,0.812553613725114,0.292682926829268,1.28387096774194,76,26,50,59,1.9,7.18,6.7,0,0,0,0,0,0,0.167497760614745,218.505874065802,17.4743407572327
9.7,"eps_greedy_SVM","SVM",73,2,2484,2271,213,300,245,55,0.830542218808016,0.333333333333333,1.26299501704694,130,55,75,54,1.4,10.78,4.5,0,0,0,0,0,0,0.215016784483895,139.948271799718,23.1127509614138
9.7,"eps_greedy_SVM","SVM",73,3,2384,2195,189,400,321,79,0.834684079124262,0.292682926829268,1.26299501704694,199,79,120,69,1.5,14.37,4.1,0,0,0,0,0,0,0.210490160147484,307.814813413696,21.6211912281357
9.7,"eps_greedy_SVM","SVM",73,4,2284,2120,164,500,396,104,0.805294155303757,0.276422764227642,1.22124311565696,264,104,160,65,1.5,17.96,3.8,0,0,0,0,0,0,0.211369793537714,214.266154467311,22.2635687965414
9.7,"eps_greedy_SVM","SVM",73,5,2184,2059,125,600,457,143,0.771954420331609,0.227642276422764,1.20036716496197,340,143,197,76,1.4,21.55,3.2,0,0,0,0,0,0,0.278484041651639,255.421527276602,45.1232891196763
9.7,"eps_greedy_SVM","SVM",73,6,2084,1976,108,700,540,160,0.710684335189809,0.138211382113821,1.16905323891949,386,160,226,46,1.4,25.14,3.4,0,0,0,0,0,0,0.251261590575441,341.280556595189,26.8545633759599
9.7,"eps_greedy_SVM","SVM",73,7,1984,1880,104,800,636,164,0.810229818833626,0.268292682926829,1.26299501704694,406,164,242,20,1.5,28.74,3.9,0,0,0,0,0,0,0.240705194493161,240.069467172233,31.4964706928833
9.7,"eps_greedy_SVM","SVM",73,8,1884,1784,100,900,732,168,0.846725561743801,0.300813008130081,1.28387096774194,409,168,241,3,1.4,32.33,4.4,0,0,0,0,0,0,0.199926802042726,165.063398639961,20.9894160536127
9.7,"eps_greedy_SVM","SVM",73,9,1784,1705,79,1000,811,189,0.841098521221436,0.341463414634146,1.27343299239444,471,189,282,62,1.5,35.92,4.3,0,0,0,0,0,0,0.180108219224561,142.305672443015,19.6727571100809
9.7,"eps_greedy_SVM","SVM",73,10,1684,1620,64,1100,896,204,0.846571922412148,0.284552845528455,1.27343299239444,503,204,299,32,1.5,39.51,4.4,0,0,0,0,0,0,0.14098094214333,88.9671083210449,15.9719991143233
9.7,"eps_greedy_SVM","SVM",73,11,1584,1536,48,1200,980,220,0.837840087062288,0.276422764227642,1.28387096774194,533,220,313,30,1.4,43.1,4.5,0,0,0,0,0,0,0.136646229735243,86.3844838364542,16.2150147979146
9.7,"eps_greedy_SVM","SVM",73,12,1484,1452,32,1300,1064,236,0.842398053901796,0.268292682926829,1.28387096774194,593,236,357,60,1.5,46.7,4.5,0,0,0,0,0,0,0.157274069945628,97.4513051432597,18.0742100974884
9.7,"eps_greedy_SVM","SVM",73,13,1384,1360,24,1400,1156,244,0.824223801293128,0.227642276422764,1.28387096774194,623,244,379,30,1.6,50.29,4.7,0,0,0,0,0,0,0.153378564181811,96.7514722455235,17.2960254336031
9.7,"eps_greedy_SVM","SVM",73,14,1284,1269,15,1500,1247,253,0.780775878624926,0.146341463414634,1.28387096774194,667,253,414,44,1.6,53.88,4.9,0,0,0,0,0,0,0.163161264610169,92.0848094821329,18.0177380136719
9.7,"eps_greedy_SVM","SVM",73,15,1184,1173,11,1600,1343,257,0.805755073298761,0.219512195121951,1.28387096774194,690,257,433,23,1.7,57.47,5.2,0,0,0,0,0,0,0.135752070227115,69.8436933298562,14.7320875565702
9.7,"eps_greedy_SVM","SVM",73,16,1084,1076,8,1700,1440,260,0.811362908904676,0.235772357723577,1.28387096774194,703,260,443,13,1.7,61.06,5.5,0,0,0,0,0,0,0.0914723307904674,36.5287947392774,10.7694590529013
9.7,"eps_greedy_SVM","SVM",73,17,984,979,5,1800,1537,263,0.777261378912999,0.186991869918699,1.28387096774194,707,263,444,4,1.7,64.66,5.8,0,0,0,0,0,0,0.100359333609112,47.6327855046535,11.2939650947003
9.7,"eps_greedy_SVM","SVM",73,18,884,879,5,1900,1637,263,0.780410985212212,0.16260162601626,1.28387096774194,695,263,432,-12,1.6,68.25,6.2,0,0,0,0,0,0,0.0641766510325839,22.6332471936086,7.70184701154628
9.7,"eps_greedy_SVM","SVM",73,19,784,779,5,2000,1737,263,0.759522437744061,0.154471544715447,1.28387096774194,713,263,450,18,1.7,71.84,6.6,0,0,0,0,0,0,0.0525048849432385,17.6648847855457,6.52793097453684
9.7,"eps_greedy_SVM","SVM",73,20,684,680,4,2100,1836,264,0.789181230394983,0.211382113821138,1.27343299239444,710,264,446,-3,1.7,75.43,7,0,0,0,0,0,0,0.0973761346128881,35.4135354568794,12.1044253334524
9.7,"eps_greedy_SVM","SVM",73,21,584,582,2,2200,1934,266,0.74155943921644,0.195121951219512,1.27343299239444,723,266,457,13,1.7,79.02,7.3,0,0,0,0,0,0,0.0907146022954719,30.8695929025429,12.1503204210737
9.7,"eps_greedy_SVM","SVM",73,22,484,482,2,2300,2034,266,0.793355098905324,0.227642276422764,1.27343299239444,725,266,459,2,1.7,82.61,7.6,0,0,0,0,0,0,0.0405707248455211,10.9428261564985,5.86512155923293
9.7,"eps_greedy_SVM","SVM",73,23,384,382,2,2400,2134,266,0.717790154279496,0.16260162601626,1.27343299239444,710,266,444,-15,1.7,86.21,8,0,0,0,0,0,0,0.00880167402870065,2.65106960101295,2.0725125181564
9.7,"eps_greedy_SVM","SVM",73,24,284,283,1,2500,2233,267,0.703463286601369,0.138211382113821,1.28387096774194,756,267,489,46,1.8,89.8,8.4,0,0,0,0,0,0,0.022009208899075,5.25026457923316,3.55044703807408
9.7,"eps_greedy_SVM","SVM",73,25,184,183,1,2600,2333,267,0.787343960053776,0.227642276422764,1.27343299239444,745,267,478,-11,1.8,93.39,8.7,0,0,0,0,0,0,0.00326379788151153,0.829741515056613,0.792316718674043
9.7,"eps_greedy_SVM","SVM",73,26,84,84,0,2700,2432,268,0.762332757185837,0.219512195121951,1.28387096774194,749,268,481,4,1.8,96.98,9.1,0,0,0,0,0,0,2.27353140372262e-09,1.45580262224297,1.45580262224297
9.7,"eps_greedy_SVM","SVM",73,27,0,0,0,2784,2516,268,0.786153255233344,0.219512195121951,1.27343299239444,755,268,487,6,1.8,100,9.4,0,0,0,0,0,0,0,0,0
9.7,"eps_greedy_SVM","SVM",74,0,2684,2436,248,100,90,10,0.760651629072687,0.330827067669173,1.22595197671598,32,10,22,0,2.2,3.59,9,0,0,0,0,0,0,0.116712668439825,276.505814757635,12.2512360675907
9.7,"eps_greedy_SVM","SVM",74,1,2584,2367,217,200,159,41,0.724985081752007,0.233082706766917,1.23560514188698,108,41,67,76,1.6,7.18,3.9,0,0,0,0,0,0,0.227274307676053,456.076088770502,24.689874137081
9.7,"eps_greedy_SVM","SVM",74,2,2484,2289,195,300,237,63,0.771792576679798,0.285714285714286,1.23560514188698,160,63,97,52,1.5,10.78,3.8,0,0,0,0,0,0,0.21059705929519,512.398870793695,21.4213853037609
9.7,"eps_greedy_SVM","SVM",74,3,2384,2199,185,400,327,73,0.7467955603294,0.233082706766917,1.24525830705797,190,73,117,30,1.6,14.37,4.5,0,0,0,0,0,0,0.195730988072305,309.497734427557,20.5156460735945
9.7,"eps_greedy_SVM","SVM",74,4,2284,2110,174,500,416,84,0.799277956796759,0.345864661654135,1.24525830705797,221,84,137,31,1.6,17.96,5,0,0,0,0,0,0,0.176520156097056,279.916170778505,17.9779549786674
9.7,"eps_greedy_SVM","SVM",74,5,2184,2039,145,600,487,113,0.807512829693284,0.345864661654135,1.24525830705797,286,113,173,65,1.5,21.55,4.3,0,0,0,0,0,0,0.193387869755661,274.005701068155,19.7842613540405
9.7,"eps_greedy_SVM","SVM",74,6,2084,1972,112,700,554,146,0.802064685523342,0.315789473684211,1.23560514188698,354,146,208,68,1.4,25.14,3.8,0,0,0,0,0,0,0.218760869645467,343.571417472651,22.5352436291081
9.7,"eps_greedy_SVM","SVM",74,7,1984,1907,77,800,619,181,0.80541234037475,0.323308270676692,1.23560514188698,428,181,247,74,1.4,28.74,3.4,0,0,0,0,0,0,0.22687477702931,294.127336231002,23.4498045821184
9.7,"eps_greedy_SVM","SVM",74,8,1884,1820,64,900,706,194,0.799982098102407,0.315789473684211,1.23560514188698,465,194,271,37,1.4,32.33,3.6,0,0,0,0,0,0,0.208387100250502,269.927744171686,21.6072987345796
9.7,"eps_greedy_SVM","SVM",74,9,1784,1723,61,1000,803,197,0.805066237021129,0.300751879699248,1.24525830705797,489,197,292,24,1.5,35.92,4.1,0,0,0,0,0,0,0.173945936772922,172.777629523055,18.0807336196547
9.7,"eps_greedy_SVM","SVM",74,10,1684,1629,55,1100,897,203,0.806546127222822,0.278195488721804,1.25491147222896,491,203,288,2,1.4,39.51,4.4,0,0,0,0,0,0,0.163629285276987,167.8958071494,17.1158934855811
9.7,"eps_greedy_SVM","SVM",74,11,1584,1537,47,1200,989,211,0.820766201217332,0.285714285714286,1.24525830705797,532,211,321,41,1.5,43.1,4.7,0,0,0,0,0,0,0.153606695176024,144.876741872858,16.0417626499641
9.7,"eps_greedy_SVM","SVM",74,12,1484,1448,36,1300,1078,222,0.82623224728488,0.315789473684211,1.24525830705797,555,222,333,23,1.5,46.7,4.9,0,0,0,0,0,0,0.136875843405597,101.175048738867,15.0068655777383
9.7,"eps_greedy_SVM","SVM",74,13,1384,1354,30,1400,1172,228,0.799958228905597,0.225563909774436,1.24525830705797,599,228,371,44,1.6,50.29,5.1,0,0,0,0,0,0,0.145807496767287,114.215370761393,15.6827794936419
9.7,"eps_greedy_SVM","SVM",74,14,1284,1261,23,1500,1265,235,0.815986394557822,0.270676691729323,1.24525830705797,637,235,402,38,1.7,53.88,5.4,0,0,0,0,0,0,0.144855159491154,119.039672335591,15.0746253129659
9.7,"eps_greedy_SVM","SVM",74,15,1184,1166,18,1600,1360,240,0.812740183792814,0.300751879699248,1.24525830705797,649,240,409,12,1.7,57.47,5.7,0,0,0,0,0,0,0.130131985625244,97.7089592419293,14.0022468302118
9.7,"eps_greedy_SVM","SVM",74,16,1084,1066,18,1700,1460,240,0.805680868838762,0.293233082706767,1.24525830705797,641,240,401,-8,1.7,61.06,6.1,0,0,0,0,0,0,0.0939216184281916,53.4679889545101,10.3303719186641
9.7,"eps_greedy_SVM","SVM",74,17,984,966,18,1800,1560,240,0.802792696025777,0.263157894736842,1.24525830705797,649,240,409,8,1.7,64.66,6.5,0,0,0,0,0,0,0.0559321695527003,22.406777601143,6.54411253534624
9.7,"eps_greedy_SVM","SVM",74,18,884,867,17,1900,1659,241,0.800369972550423,0.24812030075188,1.24525830705797,652,241,411,3,1.7,68.25,6.9,0,0,0,0,0,0,0.0407227132914718,15.1830669657567,5.48976996101131
9.7,"eps_greedy_SVM","SVM",74,19,784,768,16,2000,1758,242,0.807113020646855,0.240601503759398,1.24525830705797,654,242,412,2,1.7,71.84,7.3,0,0,0,0,0,0,0.0478464487670507,17.3707241817178,5.59487389439192
9.7,"eps_greedy_SVM","SVM",74,20,684,669,15,2100,1857,243,0.809547678720612,0.255639097744361,1.24525830705797,642,243,399,-12,1.6,75.43,7.6,0,0,0,0,0,0,0.0371500124654213,11.8938179410716,4.68691410227722
9.7,"eps_greedy_SVM","SVM",74,21,584,569,15,2200,1957,243,0.819638381668458,0.300751879699248,1.24525830705797,643,243,400,1,1.6,79.02,8.1,0,0,0,0,0,0,0.012958467240861,3.66897748981716,1.90750951725301
9.7,"eps_greedy_SVM","SVM",74,22,484,469,15,2300,2057,243,0.785720253013487,0.240601503759398,1.24525830705797,660,243,417,17,1.7,82.61,8.5,0,0,0,0,0,0,0.00378360480170923,1.15268328237636,0.747659691500409
9.7,"eps_greedy_SVM","SVM",74,23,384,372,12,2400,2154,246,0.79356128416279,0.233082706766917,1.24525830705797,677,246,431,17,1.8,86.21,8.8,0,0,0,0,0,0,0.011634632593701,3.2078580583063,1.84083449178088
9.7,"eps_greedy_SVM","SVM",74,24,284,272,12,2500,2254,246,0.799343597087961,0.255639097744361,1.24525830705797,677,246,431,0,1.8,89.8,9.2,0,0,0,0,0,0,0.00534724505163122,1.29598404542833,0.872162542634892
9.7,"eps_greedy_SVM","SVM",74,25,184,176,8,2600,2350,250,0.825474400286438,0.285714285714286,1.27421780257094,708,250,458,31,1.8,93.39,9.4,0,0,0,0,0,0,0.00123294715453214,2.55574072659844,2.52042302750708
9.7,"eps_greedy_SVM","SVM",74,26,84,84,0,2700,2442,258,0.798502207900709,0.233082706766917,1.27421780257094,735,258,477,27,1.8,96.98,9.5,0,0,0,0,0,0,1.80562759963507e-06,0.00974030191338814,0.00974030191338814
9.7,"eps_greedy_SVM","SVM",74,27,0,0,0,2784,2526,258,0.792284282133912,0.24812030075188,1.27421780257094,729,258,471,-6,1.8,100,9.8,0,0,0,0,0,0,0,0,0
9.7,"eps_greedy_SVM","SVM",75,0,2684,2447,237,100,84,16,0.798775910849364,0.326086956521739,1.20014025245442,36,16,20,0,1.2,3.59,5.2,0,0,0,0,0,0,0.38505500568569,426.791505983714,40.9887309005556
9.7,"eps_greedy_SVM","SVM",75,1,2584,2381,203,200,150,50,0.733009989029395,0.159420289855072,1.25134746676249,115,50,65,79,1.3,7.18,3,0,0,0,0,0,0,0.584943698741731,605.417592159261,66.8872254511961
9.7,"eps_greedy_SVM","SVM",75,2,2484,2300,184,300,231,69,0.748403487499282,0.13768115942029,1.27456755493221,170,69,101,55,1.5,10.78,3.3,0,0,0,0,0,0,0.27391654946917,512.437217986454,30.8960764204994
9.7,"eps_greedy_SVM","SVM",75,3,2384,2214,170,400,317,83,0.737733125469137,0.202898550724638,1.22805049088359,199,83,116,29,1.4,14.37,3.8,0,0,0,0,0,0,0.236899311962168,361.769283339595,28.3100298232742
9.7,"eps_greedy_SVM","SVM",75,4,2284,2130,154,500,401,99,0.800103932097698,0.268115942028986,1.27456755493221,237,99,138,38,1.4,17.96,4.1,0,0,0,0,0,0,0.222408794145642,218.890013045398,23.4870205763632
9.7,"eps_greedy_SVM","SVM",75,5,2184,2063,121,600,468,132,0.803937871701604,0.231884057971014,1.27456755493221,311,132,179,74,1.4,21.55,3.5,0,0,0,0,0,0,0.234367156695263,242.732052124405,24.3074516701294
9.7,"eps_greedy_SVM","SVM",75,6,2084,1988,96,700,543,157,0.799867197875167,0.27536231884058,1.27456755493221,372,157,215,61,1.4,25.14,3.5,0,0,0,0,0,0,0.223557062435234,196.17623481177,23.0904246413947
9.7,"eps_greedy_SVM","SVM",75,7,1984,1911,73,800,620,180,0.803019804838619,0.297101449275362,1.27456755493221,437,180,257,65,1.4,28.74,3.4,0,0,0,0,0,0,0.219220691473818,168.829536977512,22.743292704535
9.7,"eps_greedy_SVM","SVM",75,8,1884,1833,51,900,698,202,0.813135862347715,0.311594202898551,1.23735390369331,490,202,288,53,1.4,32.33,3.5,0,0,0,0,0,0,0.213395462197104,179.558574707216,22.4640322573298
9.7,"eps_greedy_SVM","SVM",75,9,1784,1746,38,1000,785,215,0.809353888792655,0.304347826086957,1.23735390369331,513,215,298,23,1.4,35.92,3.7,0,0,0,0,0,0,0.187679833123577,153.27015108068,19.9969885961743
9.7,"eps_greedy_SVM","SVM",75,10,1684,1649,35,1100,882,218,0.801697557595706,0.326086956521739,1.21874707807387,534,218,316,21,1.4,39.51,4,0,0,0,0,0,0,0.16970174229262,145.970972794702,17.9546750348376
9.7,"eps_greedy_SVM","SVM",75,11,1584,1553,31,1200,978,222,0.789341185980715,0.297101449275362,1.22805049088359,550,222,328,16,1.5,43.1,4.4,0,0,0,0,0,0,0.174955887210658,114.007180619923,19.563806272095
9.7,"eps_greedy_SVM","SVM",75,12,1484,1454,30,1300,1077,223,0.769709567526992,0.22463768115942,1.23735390369331,561,223,338,11,1.5,46.7,4.8,0,0,0,0,0,0,0.155766756496534,90.0251555917497,16.7639938721006
9.7,"eps_greedy_SVM","SVM",75,13,1384,1355,29,1400,1176,224,0.791795138287429,0.289855072463768,1.23735390369331,579,224,355,18,1.6,50.29,5.2,0,0,0,0,0,0,0.131839671619901,68.9976352057354,13.9193652236059
9.7,"eps_greedy_SVM","SVM",75,14,1284,1265,19,1500,1266,234,0.792395634851897,0.268115942028986,1.22805049088359,614,234,380,35,1.6,53.88,5.4,0,0,0,0,0,0,0.138146653566677,60.1393753921928,15.3889726865474
9.7,"eps_greedy_SVM","SVM",75,15,1184,1169,15,1600,1362,238,0.804388244124949,0.333333333333333,1.22805049088359,630,238,392,16,1.6,57.47,5.7,0,0,0,0,0,0,0.112473300987769,44.0630492643213,12.2444668596005
9.7,"eps_greedy_SVM","SVM",75,16,1084,1069,15,1700,1462,238,0.812841388070906,0.340579710144928,1.21874707807387,619,238,381,-11,1.6,61.06,6.1,0,0,0,0,0,0,0.0932305627618824,31.2906618906467,10.3256399954742
9.7,"eps_greedy_SVM","SVM",75,17,984,971,13,1800,1560,240,0.805649864310871,0.311594202898551,1.23621453545787,617,240,377,-2,1.6,64.66,6.5,0,0,0,0,0,0,0.0656929160293582,18.7245911187396,8.3477983283952
9.7,"eps_greedy_SVM","SVM",75,18,884,871,13,1900,1660,240,0.783440152433741,0.268115942028986,1.23735390369331,630,240,390,13,1.6,68.25,6.9,0,0,0,0,0,0,0.0196066565616753,5.02517397133547,3.77847657825824
9.7,"eps_greedy_SVM","SVM",75,19,784,771,13,2000,1760,240,0.808222183728851,0.318840579710145,1.23735390369331,640,240,400,10,1.7,71.84,7.3,0,0,0,0,0,0,0.00371979362621583,1.79813497947938,1.53791204068118
9.7,"eps_greedy_SVM","SVM",75,20,684,676,8,2100,1855,245,0.821092441826894,0.340579710144928,1.25596072931276,656,245,411,16,1.7,75.43,7.6,0,0,0,0,0,0,0.036838197184899,14.9552089551812,8.38243073325215
9.7,"eps_greedy_SVM","SVM",75,21,584,579,5,2200,1952,248,0.816126797159193,0.27536231884058,1.27456755493221,667,248,419,11,1.7,79.02,7.9,0,0,0,0,0,0,0.102707134285323,35.6657617706501,11.8708180171971
9.7,"eps_greedy_SVM","SVM",75,22,484,479,5,2300,2052,248,0.789087129741903,0.304347826086957,1.26526414212249,659,248,411,-8,1.7,82.61,8.3,0,0,0,0,0,0,0.0532451901844225,13.0275282766878,7.07643756746261
9.7,"eps_greedy_SVM","SVM",75,23,384,382,2,2400,2149,251,0.806755586350252,0.282608695652174,1.26526414212249,677,251,426,18,1.7,86.21,8.6,0,0,0,0,0,0,0.100716347343431,29.4746514092865,12.3441407588607
9.7,"eps_greedy_SVM","SVM",75,24,284,282,2,2500,2249,251,0.787903458629252,0.195652173913043,1.27456755493221,677,251,426,0,1.7,89.8,9,0,0,0,0,0,0,0.0513956907442641,11.0307300497323,6.73191395880308
9.7,"eps_greedy_SVM","SVM",75,25,184,183,1,2600,2348,252,0.822553265200071,0.36231884057971,1.27456755493221,689,252,437,12,1.7,93.39,9.3,0,0,0,0,0,0,0.0155639865266773,3.94284180674238,3.2723539813192
9.7,"eps_greedy_SVM","SVM",75,26,84,84,0,2700,2447,253,0.818297823199955,0.253623188405797,1.27456755493221,707,253,454,18,1.8,96.98,9.7,0,0,0,0,0,0,4.69137420540605e-05,2.72063047286094,2.72063047286094
9.7,"eps_greedy_SVM","SVM",75,27,0,0,0,2784,2531,253,0.807558173104684,0.202898550724638,1.28387096774194,688,253,435,-19,1.7,100,10,0,0,0,0,0,0,0,0,0
9.7,"eps_greedy_SVM","SVM",76,0,2684,2429,255,100,89,11,0.828050473186118,0.336,1.24278709677419,26,11,15,0,1.4,3.59,8.1,0,0,0,0,0,0,0.266906762598003,267.228984115867,30.2130044306382
9.7,"eps_greedy_SVM","SVM",76,1,2584,2363,221,200,155,45,0.754277602523664,0.104,1.25305806451613,102,45,57,76,1.3,7.18,3.4,0,0,0,0,0,0,0.276954024681501,494.715204691856,33.3645286285984
9.7,"eps_greedy_SVM","SVM",76,2,2484,2271,213,300,247,53,0.794946372239762,0.24,1.22224516129032,127,53,74,25,1.4,10.78,4.7,0,0,0,0,0,0,0.209282047526348,277.177457814279,23.6182806508831
9.7,"eps_greedy_SVM","SVM",76,3,2384,2191,193,400,327,73,0.817558359621454,0.28,1.25305806451613,173,73,100,46,1.4,14.37,4.5,0,0,0,0,0,0,0.205546982195737,185.764800656345,21.5203513948212
9.7,"eps_greedy_SVM","SVM",76,4,2284,2123,161,500,395,105,0.822018927444795,0.312,1.23251612903226,244,105,139,71,1.3,17.96,3.8,0,0,0,0,0,0,0.233420811529533,165.836619006977,24.1136566852178
9.7,"eps_greedy_SVM","SVM",76,5,2184,2056,128,600,462,138,0.82230283911672,0.312,1.23251612903226,316,138,178,72,1.3,21.55,3.3,0,0,0,0,0,0,0.251275448472697,161.523374782285,26.108837987686
9.7,"eps_greedy_SVM","SVM",76,6,2084,1984,100,700,534,166,0.815602523659307,0.312,1.23251612903226,393,166,227,77,1.4,25.14,3.2,0,0,0,0,0,0,0.251340701489267,193.227768790601,26.1032725193957
9.7,"eps_greedy_SVM","SVM",76,7,1984,1895,89,800,623,177,0.819337539432179,0.328,1.23251612903226,418,177,241,25,1.4,28.74,3.5,0,0,0,0,0,0,0.206570078688572,122.692749982298,22.4222038099067
9.7,"eps_greedy_SVM","SVM",76,8,1884,1815,69,900,703,197,0.810365930599377,0.256,1.23251612903226,470,197,273,52,1.4,32.33,3.6,0,0,0,0,0,0,0.194421837333242,123.920570512472,21.1450318006838
9.7,"eps_greedy_SVM","SVM",76,9,1784,1720,64,1000,798,202,0.810574132492122,0.232,1.24278709677419,488,202,286,18,1.4,35.92,4,0,0,0,0,0,0,0.177578857408622,79.9024549539901,19.279547086596
9.7,"eps_greedy_SVM","SVM",76,10,1684,1631,53,1100,887,213,0.812794952681397,0.256,1.23251612903226,523,213,310,35,1.5,39.51,4.2,0,0,0,0,0,0,0.158577449289893,71.0277360711814,17.4815318144082
9.7,"eps_greedy_SVM","SVM",76,11,1584,1543,41,1200,975,225,0.808460567823349,0.224,1.24278709677419,559,225,334,36,1.5,43.1,4.3,0,0,0,0,0,0,0.160229758727117,64.1255173265081,17.6421080584397
9.7,"eps_greedy_SVM","SVM",76,12,1484,1447,37,1300,1071,229,0.808712933753948,0.24,1.23251612903226,582,229,353,23,1.5,46.7,4.7,0,0,0,0,0,0,0.147883412086321,54.5205348906875,16.436924234704
9.7,"eps_greedy_SVM","SVM",76,13,1384,1357,27,1400,1161,239,0.803312302839118,0.264,1.22224516129032,599,239,360,17,1.5,50.29,4.9,0,0,0,0,0,0,0.139317401275998,64.836702152555,15.5891173669374
9.7,"eps_greedy_SVM","SVM",76,14,1284,1259,25,1500,1259,241,0.775520504731866,0.2,1.21197419354839,617,241,376,18,1.6,53.88,5.2,0,0,0,0,0,0,0.12941904845923,57.6757543099239,14.3954963300518
9.7,"eps_greedy_SVM","SVM",76,15,1184,1160,24,1600,1358,242,0.782586750788651,0.208,1.21197419354839,627,242,385,10,1.6,57.47,5.6,0,0,0,0,0,0,0.130204497526545,53.1345578180579,14.2938140565445
9.7,"eps_greedy_SVM","SVM",76,16,1084,1062,22,1700,1456,244,0.768201892744488,0.216,1.21197419354839,637,244,393,10,1.6,61.06,6,0,0,0,0,0,0,0.111132325495838,35.0975548855631,13.9737884124374
9.7,"eps_greedy_SVM","SVM",76,17,984,962,22,1800,1556,244,0.743646687697166,0.152,1.21197419354839,641,244,397,4,1.6,64.66,6.4,0,0,0,0,0,0,0.0930131901326822,24.1386347888971,10.6721253659145
9.7,"eps_greedy_SVM","SVM",76,18,884,862,22,1900,1656,244,0.777451104100953,0.248,1.21197419354839,643,244,399,2,1.6,68.25,6.8,0,0,0,0,0,0,0.0483026964880217,10.3276890005927,6.68222222109761
9.7,"eps_greedy_SVM","SVM",76,19,784,764,20,2000,1754,246,0.788700315457416,0.24,1.21197419354839,643,246,397,0,1.6,71.84,7.1,0,0,0,0,0,0,0.0130537685534202,3.78764003451578,3.18365589101916
9.7,"eps_greedy_SVM","SVM",76,20,684,673,11,2100,1845,255,0.77939432176657,0.248,1.22224516129032,675,255,420,32,1.6,75.43,7.2,0,0,0,0,0,0,0.00547663408248702,2.13913521320648,1.85435716530498
9.7,"eps_greedy_SVM","SVM",76,21,584,581,3,2200,1937,263,0.728971608832811,0.096,1.26332903225806,710,263,447,35,1.7,79.02,7.4,0,0,0,0,0,0,0.255622544690946,81.9827635434384,42.6277591431859
9.7,"eps_greedy_SVM","SVM",76,22,484,481,3,2300,2037,263,0.781186119873817,0.216,1.24278709677419,700,263,437,-10,1.7,82.61,7.7,0,0,0,0,0,0,0.0679980494612694,21.8362618846557,8.47816916712332
9.7,"eps_greedy_SVM","SVM",76,23,384,383,1,2400,2135,265,0.777854889589908,0.208,1.24278709677419,720,265,455,20,1.7,86.21,8.1,0,0,0,0,0,0,0.038983859772401,9.93259093960937,6.00702007655867
9.7,"eps_greedy_SVM","SVM",76,24,284,284,0,2500,2234,266,0.759779179810731,0.176,1.24278709677419,723,266,457,3,1.7,89.8,8.4,0,0,0,0,0,0,0.0105386407207574,3.27269425024394,2.92905282342404
9.7,"eps_greedy_SVM","SVM",76,25,184,184,0,2600,2334,266,0.797331230283917,0.248,1.24278709677419,716,266,450,-7,1.7,93.39,8.8,0,0,0,0,0,0,1.74596384772306e-05,0.848275492778789,0.847876410480486
9.7,"eps_greedy_SVM","SVM",76,26,84,84,0,2700,2434,266,0.757829652996847,0.168,1.24278709677419,713,266,447,-3,1.7,96.98,9.2,0,0,0,0,0,0,2.38041405646833e-10,0.305734246964069,0.305734246964069
9.7,"eps_greedy_SVM","SVM",76,27,0,0,0,2784,2518,266,0.757179810725559,0.176,1.25305806451613,723,266,457,10,1.7,100,9.5,0,0,0,0,0,0,0,0,0
9.7,"eps_greedy_SVM","SVM",77,0,2684,2424,260,100,92,8,0.799334229562776,0.276422764227642,1.25255704169945,23,8,15,0,1.9,3.59,11.5,0,0,0,0,0,0,0.148833112605967,189.436924653875,18.1917845060971
9.7,"eps_greedy_SVM","SVM",77,1,2584,2346,238,200,170,30,0.63601561999872,0.105691056910569,1.15861526357199,86,30,56,63,1.9,7.18,5.7,0,0,0,0,0,0,0.200023864796682,366.357004978071,41.6097556397914
9.7,"eps_greedy_SVM","SVM",77,2,2484,2262,222,300,254,46,0.750035209013513,0.235772357723577,1.22124311565696,130,46,84,44,1.8,10.78,5.5,0,0,0,0,0,0,0.185194428693892,299.334884243052,19.605407559744
9.7,"eps_greedy_SVM","SVM",77,3,2384,2193,191,400,323,77,0.74910056974586,0.235772357723577,1.20036716496197,184,77,107,54,1.4,14.37,4.2,0,0,0,0,0,0,0.191751476612718,431.477935011457,19.365404391855
9.7,"eps_greedy_SVM","SVM",77,4,2284,2125,159,500,391,109,0.759586454132264,0.24390243902439,1.20036716496197,258,109,149,74,1.4,17.96,3.6,0,0,0,0,0,0,0.216582999777718,285.599852091982,22.6535634283435
9.7,"eps_greedy_SVM","SVM",77,5,2184,2055,129,600,461,139,0.768888035337058,0.235772357723577,1.23168109100446,323,139,184,65,1.3,21.55,3.3,0,0,0,0,0,0,0.207885296980738,172.954121565989,22.2660589982319
9.7,"eps_greedy_SVM","SVM",77,6,2084,1976,108,700,540,160,0.779060239421293,0.227642276422764,1.25255704169945,364,160,204,41,1.3,25.14,3.4,0,0,0,0,0,0,0.221882225109775,305.016230393146,23.5649706085506
9.7,"eps_greedy_SVM","SVM",77,7,1984,1896,88,800,620,180,0.786070033928691,0.24390243902439,1.24211906635195,416,180,236,52,1.3,28.74,3.4,0,0,0,0,0,0,0.209206123430645,174.951493512605,22.4371125497131
9.7,"eps_greedy_SVM","SVM",77,8,1884,1820,64,900,696,204,0.778957813200189,0.235772357723577,1.25255704169945,475,204,271,59,1.3,32.33,3.4,0,0,0,0,0,0,0.232698968413902,157.576064400509,25.0407745873374
9.7,"eps_greedy_SVM","SVM",77,9,1784,1725,59,1000,791,209,0.790941681070366,0.235772357723577,1.25255704169945,498,209,289,23,1.4,35.92,3.8,0,0,0,0,0,0,0.171100137714998,86.073224649079,19.3792130468292
9.7,"eps_greedy_SVM","SVM",77,10,1684,1643,41,1100,873,227,0.797624991997961,0.24390243902439,1.25255704169945,540,227,313,42,1.4,39.51,3.8,0,0,0,0,0,0,0.147547430781646,60.7458471481438,16.7567168375434
9.7,"eps_greedy_SVM","SVM",77,11,1584,1557,27,1200,959,241,0.787523205940727,0.235772357723577,1.25255704169945,579,241,338,39,1.4,43.1,4,0,0,0,0,0,0,0.162127795815791,80.5859775394666,17.7573990162092
9.7,"eps_greedy_SVM","SVM",77,12,1484,1465,19,1300,1051,249,0.789187632033804,0.24390243902439,1.25255704169945,605,249,356,26,1.4,46.7,4.2,0,0,0,0,0,0,0.176456345937179,124.759322929651,18.5057966279581
9.7,"eps_greedy_SVM","SVM",77,13,1384,1368,16,1400,1148,252,0.788784328788173,0.24390243902439,1.25255704169945,611,252,359,6,1.4,50.29,4.6,0,0,0,0,0,0,0.109811268622187,36.9551381785585,12.8762017919675
9.7,"eps_greedy_SVM","SVM",77,14,1284,1274,10,1500,1242,258,0.764554125856225,0.211382113821138,1.25255704169945,656,258,398,45,1.5,53.88,4.8,0,0,0,0,0,0,0.0847446931830552,27.8737605085372,11.6211789483679
9.7,"eps_greedy_SVM","SVM",77,15,1184,1176,8,1600,1340,260,0.775500928237632,0.203252032520325,1.24211906635195,671,260,411,15,1.6,57.47,5.2,0,0,0,0,0,0,0.0557312009035041,19.102914794561,8.08063658870196
9.7,"eps_greedy_SVM","SVM",77,16,1084,1079,5,1700,1437,263,0.758030855899109,0.170731707317073,1.26299501704694,692,263,429,21,1.6,61.06,5.5,0,0,0,0,0,0,0.132959800888193,102.538105820711,14.0244998407176
9.7,"eps_greedy_SVM","SVM",77,17,984,982,2,1800,1534,266,0.774847961078047,0.186991869918699,1.25255704169945,693,266,427,1,1.6,64.66,5.8,0,0,0,0,0,0,0.0561802612464535,21.072814299139,7.81793619755149
9.7,"eps_greedy_SVM","SVM",77,18,884,884,0,1900,1632,268,0.774310223417197,0.211382113821138,1.25255704169945,706,268,438,13,1.6,68.25,6.1,0,0,0,0,0,0,0.0486494815143561,17.1082549284276,7.04305528760187
9.7,"eps_greedy_SVM","SVM",77,19,784,784,0,2000,1732,268,0.779540362332765,0.203252032520325,1.25255704169945,711,268,443,5,1.7,71.84,6.5,0,0,0,0,0,0,0.0331622260241657,11.1366807369978,4.20788358400208
9.7,"eps_greedy_SVM","SVM",77,20,684,684,0,2100,1832,268,0.752435823570839,0.195121951219512,1.25255704169945,698,268,430,-13,1.6,75.43,6.8,0,0,0,0,0,0,0.0211620622816891,6.22405575196853,2.79765363350715
9.7,"eps_greedy_SVM","SVM",77,21,584,584,0,2200,1932,268,0.78943729594777,0.203252032520325,1.25255704169945,695,268,427,-3,1.6,79.02,7.2,0,0,0,0,0,0,0.00278494503624664,0.594573086349992,0.566754538768385
9.7,"eps_greedy_SVM","SVM",77,22,484,484,0,2300,2032,268,0.781672108059671,0.252032520325203,1.25255704169945,689,268,421,-6,1.6,82.61,7.6,0,0,0,0,0,0,0.002722611233053,0.511955225053194,0.479688074575745
9.7,"eps_greedy_SVM","SVM",77,23,384,384,0,2400,2132,268,0.785993214262856,0.235772357723577,1.25255704169945,703,268,435,14,1.6,86.21,8,0,0,0,0,0,0,1.0567332857373e-05,0.303954204605769,0.30316256304048
9.7,"eps_greedy_SVM","SVM",77,24,284,284,0,2500,2232,268,0.776755649446262,0.195121951219512,1.26299501704694,712,268,444,9,1.7,89.8,8.3,0,0,0,0,0,0,9.85388527435695e-08,5.65034309711054e-05,5.17509756623332e-05
9.7,"eps_greedy_SVM","SVM",77,25,184,184,0,2600,2332,268,0.790205492606114,0.24390243902439,1.26299501704694,706,268,438,-6,1.6,93.39,8.7,0,0,0,0,0,0,8.34403920511301e-09,1.67309210066866e-05,1.65454704636634e-05
9.7,"eps_greedy_SVM","SVM",77,26,84,84,0,2700,2432,268,0.792177197362526,0.24390243902439,1.26299501704694,719,268,451,13,1.7,96.98,9.1,0,0,0,0,0,0,9.77290117321425e-13,4.02176447332377e-07,4.02176447332377e-07
9.7,"eps_greedy_SVM","SVM",77,27,0,0,0,2784,2516,268,0.781928173612447,0.195121951219512,1.26299501704694,725,268,457,6,1.7,100,9.4,0,0,0,0,0,0,0,0,0
9.7,"eps_greedy_SVM","SVM",78,0,2684,2428,256,100,90,10,0.80617665615142,0.256,1.26332903225806,27,10,17,0,1.7,3.59,9,0,0,0,0,0,0,0.15119121312521,247.609384627756,15.8808772611779
9.7,"eps_greedy_SVM","SVM",78,1,2584,2360,224,200,158,42,0.75454889589906,0.144,1.22224516129032,100,42,58,73,1.4,7.18,3.8,0,0,0,0,0,0,0.254107950380779,500.313120476732,34.8209628437668
9.7,"eps_greedy_SVM","SVM",78,2,2484,2278,206,300,240,60,0.787741324921147,0.288,1.25305806451613,158,60,98,58,1.6,10.78,4,0,0,0,0,0,0,0.251796764548396,299.415448431484,29.6519795990198
9.7,"eps_greedy_SVM","SVM",78,3,2384,2199,185,400,319,81,0.80023974763407,0.224,1.26332903225806,212,81,131,54,1.6,14.37,3.9,0,0,0,0,0,0,0.227903806924352,275.500962033862,23.9543644417787
9.7,"eps_greedy_SVM","SVM",78,4,2284,2122,162,500,396,104,0.801621451104109,0.248,1.25305806451613,273,104,169,61,1.6,17.96,3.8,0,0,0,0,0,0,0.224208719346012,228.304436703307,22.7749806779245
9.7,"eps_greedy_SVM","SVM",78,5,2184,2054,130,600,464,136,0.781501577287073,0.168,1.26332903225806,332,136,196,59,1.4,21.55,3.4,0,0,0,0,0,0,0.237646269902486,264.331308961224,26.1323846448432
9.7,"eps_greedy_SVM","SVM",78,6,2084,1971,113,700,547,153,0.79201261829654,0.24,1.26332903225806,396,153,243,64,1.6,25.14,3.6,0,0,0,0,0,0,0.223502772708707,157.563074260497,22.6265875925431
9.7,"eps_greedy_SVM","SVM",78,7,1984,1900,84,800,618,182,0.792965299684557,0.232,1.26332903225806,470,182,288,74,1.6,28.74,3.4,0,0,0,0,0,0,0.239319616171745,215.646810464773,24.1623486554068
9.7,"eps_greedy_SVM","SVM",78,8,1884,1835,49,900,683,217,0.797406940063107,0.24,1.26332903225806,539,217,322,69,1.5,32.33,3.1,0,0,0,0,0,0,0.231867881010108,152.042041716211,24.3086478506913
9.7,"eps_greedy_SVM","SVM",78,9,1784,1743,41,1000,775,225,0.798479495268143,0.208,1.26332903225806,543,225,318,4,1.4,35.92,3.4,0,0,0,0,0,0,0.199013177109771,133.282651821324,21.396960284019
9.7,"eps_greedy_SVM","SVM",78,10,1684,1647,37,1100,871,229,0.781621451104106,0.16,1.26332903225806,559,229,330,16,1.4,39.51,3.8,0,0,0,0,0,0,0.149990145002979,70.4263659049097,16.9078019501532
9.7,"eps_greedy_SVM","SVM",78,11,1584,1553,31,1200,965,235,0.78823974763407,0.192,1.25305806451613,584,235,349,25,1.5,43.1,4.1,0,0,0,0,0,0,0.13514428558383,56.1020216450264,17.7053227116527
9.7,"eps_greedy_SVM","SVM",78,12,1484,1463,21,1300,1055,245,0.79372239747635,0.208,1.21197419354839,612,245,367,28,1.5,46.7,4.3,0,0,0,0,0,0,0.165926664602589,110.479059414349,18.2856348398773
9.7,"eps_greedy_SVM","SVM",78,13,1384,1364,20,1400,1154,246,0.791741324921139,0.248,1.21197419354839,622,246,376,10,1.5,50.29,4.7,0,0,0,0,0,0,0.160443350124946,94.9086390217047,16.9160160312993
9.7,"eps_greedy_SVM","SVM",78,14,1284,1264,20,1500,1254,246,0.762012618296536,0.168,1.22224516129032,622,246,376,0,1.5,53.88,5.1,0,0,0,0,0,0,0.126779337679143,51.1607947215096,14.3836287063592
9.7,"eps_greedy_SVM","SVM",78,15,1184,1166,18,1600,1352,248,0.732119873817039,0.112,1.21197419354839,635,248,387,13,1.6,57.47,5.5,0,0,0,0,0,0,0.162578449154583,69.8717507528556,17.3339197164101
9.7,"eps_greedy_SVM","SVM",78,16,1084,1066,18,1700,1452,248,0.733943217665616,0.168,1.22224516129032,636,248,388,1,1.6,61.06,5.9,0,0,0,0,0,0,0.127797183806435,42.2095928124556,14.0376581380963
9.7,"eps_greedy_SVM","SVM",78,17,984,967,17,1800,1551,249,0.711968454258678,0.112,1.22224516129032,650,249,401,14,1.6,64.66,6.2,0,0,0,0,0,0,0.0808595912071718,18.1995125127421,10.1447185101358
9.7,"eps_greedy_SVM","SVM",78,18,884,869,15,1900,1649,251,0.757974763406951,0.224,1.22224516129032,661,251,410,11,1.6,68.25,6.6,0,0,0,0,0,0,0.0486448400455376,17.9716485710195,7.85799029433258
9.7,"eps_greedy_SVM","SVM",78,19,784,772,12,2000,1746,254,0.763747634069406,0.2,1.21197419354839,672,254,418,11,1.6,71.84,6.9,0,0,0,0,0,0,0.0627655685797394,20.5771973245554,10.2466166733552
9.7,"eps_greedy_SVM","SVM",78,20,684,672,12,2100,1846,254,0.719406940063097,0.128,1.19143225806452,676,254,422,4,1.7,75.43,7.3,0,0,0,0,0,0,0.0468728788808348,16.0228677581615,6.27432260265099
9.7,"eps_greedy_SVM","SVM",78,21,584,573,11,2200,1945,255,0.771703470031548,0.192,1.22224516129032,672,255,417,-4,1.6,79.02,7.6,0,0,0,0,0,0,0.0213396403399283,6.76087213176689,2.87642647599747
9.7,"eps_greedy_SVM","SVM",78,22,484,475,9,2300,2043,257,0.741097791798116,0.152,1.21197419354839,685,257,428,13,1.7,82.61,7.9,0,0,0,0,0,0,0.0154871707168753,4.84907020887354,2.55527812420844
9.7,"eps_greedy_SVM","SVM",78,23,384,379,5,2400,2139,261,0.773981072555213,0.176,1.2736,706,261,445,21,1.7,86.21,8.2,0,0,0,0,0,0,0.020936466743896,6.93745952476675,5.23690102989952
9.7,"eps_greedy_SVM","SVM",78,24,284,284,0,2500,2234,266,0.798921135646694,0.2,1.26332903225806,712,266,446,6,1.7,89.8,8.4,0,0,0,0,0,0,0.0140988260378978,3.41406951000609,2.29491556889736
9.7,"eps_greedy_SVM","SVM",78,25,184,184,0,2600,2334,266,0.735167192429032,0.136,1.26332903225806,721,266,455,9,1.7,93.39,8.8,0,0,0,0,0,0,0.00329310173810465,0.980575478664564,0.935428191159582
9.7,"eps_greedy_SVM","SVM",78,26,84,84,0,2700,2434,266,0.747659305993699,0.128,1.26332903225806,717,266,451,-4,1.7,96.98,9.2,0,0,0,0,0,0,1.9113763453875e-09,0.00567338328603624,0.00567338328603624
9.7,"eps_greedy_SVM","SVM",78,27,0,0,0,2784,2518,266,0.78620820189275,0.184,1.26332903225806,724,266,458,7,1.7,100,9.5,0,0,0,0,0,0,0,0,0
9.7,"eps_greedy_SVM","SVM",79,0,2684,2418,266,100,94,6,0.735333693917131,0.176470588235294,1.24071564109515,22,6,16,0,2.7,3.59,15.7,0,0,0,0,0,0,0.0768711902233321,175.662636585931,7.88273962682642
9.7,"eps_greedy_SVM","SVM",79,1,2584,2345,239,200,167,33,0.79633391818266,0.176470588235294,1.26229330441854,75,33,42,53,1.3,7.18,5.1,0,0,0,0,0,0,0.291474184209006,290.667714760028,32.6048951635649
9.7,"eps_greedy_SVM","SVM",79,2,2484,2276,208,300,236,64,0.674471986596837,0.26890756302521,1.12203849281648,148,64,84,73,1.3,10.78,3.7,0,0,0,0,0,0,0.237798912277254,408.912700904223,26.5758550044491
9.7,"eps_greedy_SVM","SVM",79,3,2384,2210,174,400,302,98,0.751177394034539,0.151260504201681,1.26229330441854,228,98,130,80,1.3,14.37,3.1,0,0,0,0,0,0,0.267658894127118,450.663897010303,33.497873597096
9.7,"eps_greedy_SVM","SVM",79,4,2284,2119,165,500,393,107,0.799011912457298,0.159663865546218,1.24071564109515,247,107,140,19,1.3,17.96,3.7,0,0,0,0,0,0,0.237877818961025,209.351748343325,29.2494621845829
9.7,"eps_greedy_SVM","SVM",79,5,2184,2048,136,600,464,136,0.813054892286592,0.184873949579832,1.25150447275684,317,136,181,70,1.3,21.55,3.4,0,0,0,0,0,0,0.231893568314612,221.961143382429,24.0440646237175
9.7,"eps_greedy_SVM","SVM",79,6,2084,1979,105,700,533,167,0.805522208883561,0.218487394957983,1.25150447275684,385,167,218,68,1.3,25.14,3.2,0,0,0,0,0,0,0.232210373831371,209.384512743769,24.1379510034981
9.7,"eps_greedy_SVM","SVM",79,7,1984,1902,82,800,610,190,0.791096658443603,0.201680672268908,1.21913797777175,436,190,246,51,1.3,28.74,3.2,0,0,0,0,0,0,0.22471173345922,165.337369861368,23.5041304540195
9.7,"eps_greedy_SVM","SVM",79,8,1884,1815,69,900,697,203,0.785133833753288,0.159663865546218,1.21913797777175,481,203,278,45,1.4,32.33,3.4,0,0,0,0,0,0,0.216727949767713,130.166809574797,22.7759013413073
9.7,"eps_greedy_SVM","SVM",79,9,1784,1725,59,1000,787,213,0.777277944144698,0.168067226890756,1.21913797777175,519,213,306,38,1.4,35.92,3.7,0,0,0,0,0,0,0.193118667206849,118.815305106474,20.6944026444023
9.7,"eps_greedy_SVM","SVM",79,10,1684,1630,54,1100,882,218,0.787851404297991,0.210084033613445,1.22992680943345,543,218,325,24,1.5,39.51,4,0,0,0,0,0,0,0.147392657510473,75.9586828844496,16.6830645604396
9.7,"eps_greedy_SVM","SVM",79,11,1584,1534,50,1200,978,222,0.78938828278565,0.210084033613445,1.22992680943345,547,222,325,4,1.5,43.1,4.4,0,0,0,0,0,0,0.137651082830825,77.2172859905716,15.6354009754228
9.7,"eps_greedy_SVM","SVM",79,12,1484,1442,42,1300,1070,230,0.786901573816348,0.201680672268908,1.20834914611006,571,230,341,24,1.5,46.7,4.7,0,0,0,0,0,0,0.100847689935997,33.2027708489495,13.2737039847734
9.7,"eps_greedy_SVM","SVM",79,13,1384,1361,23,1400,1151,249,0.783920161471191,0.184873949579832,1.19756031444836,618,249,369,47,1.5,50.29,4.6,0,0,0,0,0,0,0.0811911936932929,32.3838791099882,11.2352223797829
9.7,"eps_greedy_SVM","SVM",79,14,1284,1265,19,1500,1247,253,0.778854398902426,0.19327731092437,1.20834914611006,647,253,394,29,1.6,53.88,4.9,0,0,0,0,0,0,0.114297914555974,52.1718286580149,13.3678022723635
9.7,"eps_greedy_SVM","SVM",79,15,1184,1167,17,1600,1345,255,0.74307745076053,0.159663865546218,1.20834914611006,655,255,400,8,1.6,57.47,5.3,0,0,0,0,0,0,0.133662079334703,64.9036955197671,15.1774847278711
9.7,"eps_greedy_SVM","SVM",79,16,1084,1068,16,1700,1444,256,0.753024286637737,0.19327731092437,1.20834914611006,668,256,412,13,1.6,61.06,5.6,0,0,0,0,0,0,0.113871372007623,39.7134574737339,13.2644312384785
9.7,"eps_greedy_SVM","SVM",79,17,984,968,16,1800,1544,256,0.738671292692907,0.142857142857143,1.20834914611006,668,256,412,0,1.6,64.66,6,0,0,0,0,0,0,0.0879534699226483,31.9760520544748,10.2433366924241
9.7,"eps_greedy_SVM","SVM",79,18,884,870,14,1900,1642,258,0.741527380182848,0.201680672268908,1.20834914611006,673,258,415,5,1.6,68.25,6.4,0,0,0,0,0,0,0.0911069029384578,42.7615054833917,11.8985987204832
9.7,"eps_greedy_SVM","SVM",79,19,784,770,14,2000,1742,258,0.757437040750371,0.210084033613445,1.20834914611006,672,258,414,-1,1.6,71.84,6.8,0,0,0,0,0,0,0.0290778697960143,9.9502924294846,3.95537833671069
9.7,"eps_greedy_SVM","SVM",79,20,684,671,13,2100,1841,259,0.749957125707435,0.19327731092437,1.21913797777175,682,259,423,10,1.6,75.43,7.1,0,0,0,0,0,0,0.0296647758284468,11.5579609753149,3.73813686279465
9.7,"eps_greedy_SVM","SVM",79,21,584,574,10,2200,1938,262,0.744357083492746,0.126050420168067,1.21913797777175,689,262,427,7,1.6,79.02,7.4,0,0,0,0,0,0,0.0154875940849412,4.88892847034861,2.23749744200455
9.7,"eps_greedy_SVM","SVM",79,22,484,477,7,2300,2035,265,0.743070854715518,0.168067226890756,1.25150447275684,701,265,436,12,1.6,82.61,7.7,0,0,0,0,0,0,0.0582733081489996,17.673723857768,7.68885207659302
9.7,"eps_greedy_SVM","SVM",79,23,384,383,1,2400,2129,271,0.764468424732532,0.168067226890756,1.27308213608024,725,271,454,24,1.7,86.21,7.9,0,0,0,0,0,0,0.0152475373907553,5.29474986094393,3.53795318072923
9.7,"eps_greedy_SVM","SVM",79,24,284,283,1,2500,2229,271,0.754884371330954,0.134453781512605,1.27308213608024,722,271,451,-3,1.7,89.8,8.2,0,0,0,0,0,0,0.0188239811883179,4.45463290759323,2.60305345998666
9.7,"eps_greedy_SVM","SVM",79,25,184,184,0,2600,2328,272,0.692485785523002,0.134453781512605,1.27308213608024,746,272,474,24,1.7,93.39,8.6,0,0,0,0,0,0,0.0032522220624438,18.4368680748635,18.419499859356
9.7,"eps_greedy_SVM","SVM",79,26,84,84,0,2700,2428,272,0.702742635515747,0.134453781512605,1.27308213608024,726,272,454,-20,1.7,96.98,8.9,0,0,0,0,0,0,8.05662742068298e-10,0.0479601030136957,0.0479601030136957
9.7,"eps_greedy_SVM","SVM",79,27,0,0,0,2784,2512,272,0.724760233763837,0.126050420168067,1.27308213608024,748,272,476,22,1.8,100,9.2,0,0,0,0,0,0,0,0,0
9.7,"eps_greedy_SVM","SVM",80,0,2684,2447,237,100,88,12,0.628747706060501,0.0985915492957746,1.10304407087687,33,12,21,0,1.8,3.59,7.3,0,0,0,0,0,0,0.296795177911918,325.744583928941,80.1635641707819
9.7,"eps_greedy_SVM","SVM",80,1,2584,2363,221,200,172,28,0.820273358777759,0.26056338028169,1.26578827805543,90,28,62,57,2.2,7.18,6.1,0,0,0,0,0,0,0.183671927544871,234.93893917896,19.6119269601216
9.7,"eps_greedy_SVM","SVM",80,2,2484,2291,193,300,244,56,0.758891478366602,0.366197183098592,1.18441617446615,139,56,83,49,1.5,10.78,4.4,0,0,0,0,0,0,0.247441892638725,384.574666500236,29.3926803871683
9.7,"eps_greedy_SVM","SVM",80,3,2384,2225,159,400,310,90,0.808130960020718,0.323943661971831,1.24770558836892,222,90,132,83,1.5,14.37,3.4,0,0,0,0,0,0,0.236462037505504,382.493090745703,24.0822989983242
9.7,"eps_greedy_SVM","SVM",80,4,2284,2152,132,500,383,117,0.822277389356116,0.295774647887324,1.28387096774194,279,117,162,57,1.4,17.96,3.3,0,0,0,0,0,0,0.237286963691034,434.452010890508,23.928126303152
9.7,"eps_greedy_SVM","SVM",80,5,2184,2079,105,600,456,144,0.825469202103101,0.309859154929577,1.27482962289868,341,144,197,62,1.4,21.55,3.2,0,0,0,0,0,0,0.23666253826612,306.169030025853,24.1268959352647
9.7,"eps_greedy_SVM","SVM",80,6,2084,1997,87,700,538,162,0.811784375316645,0.345070422535211,1.21154020899591,394,162,232,53,1.4,25.14,3.3,0,0,0,0,0,0,0.223521945642118,260.447573202272,22.9901872822465
9.7,"eps_greedy_SVM","SVM",80,7,1984,1919,65,800,616,184,0.781070917913555,0.352112676056338,1.13920945024989,450,184,266,56,1.4,28.74,3.3,0,0,0,0,0,0,0.21676229626811,295.589694960073,22.3925070257688
9.7,"eps_greedy_SVM","SVM",80,8,1884,1832,52,900,703,197,0.769604035081791,0.295774647887324,1.21154020899591,494,197,297,44,1.5,32.33,3.6,0,0,0,0,0,0,0.21697661362051,376.381199661592,22.3553054847105
9.7,"eps_greedy_SVM","SVM",80,9,1784,1736,48,1000,799,201,0.786705846590336,0.338028169014085,1.20249886415266,513,201,312,19,1.6,35.92,4,0,0,0,0,0,0,0.199077914489407,282.21883442099,20.2887330522284
9.7,"eps_greedy_SVM","SVM",80,10,1684,1643,41,1100,892,208,0.779438421094113,0.183098591549296,1.25674693321218,523,208,315,10,1.5,39.51,4.3,0,0,0,0,0,0,0.241038514587855,200.289736187512,36.9352985568041
9.7,"eps_greedy_SVM","SVM",80,11,1584,1545,39,1200,990,210,0.814390740928382,0.309859154929577,1.25674693321218,546,210,336,23,1.6,43.1,4.7,0,0,0,0,0,0,0.138252766999148,82.4643883693122,15.8334937963927
9.7,"eps_greedy_SVM","SVM",80,12,1484,1450,34,1300,1085,215,0.826077166435869,0.316901408450704,1.25674693321218,547,215,332,1,1.5,46.7,5,0,0,0,0,0,0,0.0842016183172779,36.837603669122,10.5519417288161
9.7,"eps_greedy_SVM","SVM",80,13,1384,1359,25,1400,1176,224,0.817965346033032,0.28169014084507,1.25674693321218,594,224,370,47,1.7,50.29,5.2,0,0,0,0,0,0,0.0712658767211586,24.6495269522415,11.7069881346684
9.7,"eps_greedy_SVM","SVM",80,14,1284,1269,15,1500,1266,234,0.809239931998071,0.232394366197183,1.25674693321218,604,234,370,10,1.6,53.88,5.4,0,0,0,0,0,0,0.121636450840402,65.8140942363978,14.3587443244859
9.7,"eps_greedy_SVM","SVM",80,15,1184,1171,13,1600,1364,236,0.81087805811689,0.274647887323944,1.25674693321218,629,236,393,25,1.7,57.47,5.8,0,0,0,0,0,0,0.104390683300955,45.9129601788549,12.8854904856704
9.7,"eps_greedy_SVM","SVM",80,16,1084,1072,12,1700,1463,237,0.800582069555626,0.288732394366197,1.22962289868242,631,237,394,2,1.7,61.06,6.2,0,0,0,0,0,0,0.107215305046691,52.7176854198615,12.3400286598579
9.7,"eps_greedy_SVM","SVM",80,17,984,972,12,1800,1563,237,0.818483241575758,0.316901408450704,1.23866424352567,642,237,405,11,1.7,64.66,6.6,0,0,0,0,0,0,0.0601132976789353,21.2674057339234,7.63514548642953
9.7,"eps_greedy_SVM","SVM",80,18,884,872,12,1900,1663,237,0.795189200752079,0.267605633802817,1.23866424352567,624,237,387,-18,1.6,68.25,7,0,0,0,0,0,0,0.0375551425828457,12.9840379901449,5.32176665569414
9.7,"eps_greedy_SVM","SVM",80,19,784,772,12,2000,1763,237,0.803030814784797,0.295774647887324,1.22962289868242,644,237,407,20,1.7,71.84,7.4,0,0,0,0,0,0,0.0250158369732634,8.79521956896702,3.35274662727114
9.7,"eps_greedy_SVM","SVM",80,20,684,672,12,2100,1863,237,0.75819344524381,0.161971830985915,1.24770558836892,631,237,394,-13,1.7,75.43,7.9,0,0,0,0,0,0,0.014080259137158,4.66698342587281,2.05653852895504
9.7,"eps_greedy_SVM","SVM",80,21,584,574,10,2200,1961,239,0.792537800745323,0.232394366197183,1.22962289868242,646,239,407,15,1.7,79.02,8.2,0,0,0,0,0,0,0.0133392344490791,4.2219939507695,2.65576083606828
9.7,"eps_greedy_SVM","SVM",80,22,484,474,10,2300,2061,239,0.81091746321253,0.274647887323944,1.22962289868242,654,239,415,8,1.7,82.61,8.6,0,0,0,0,0,0,0.0136557460306488,3.94184739276515,1.91241795609241
9.7,"eps_greedy_SVM","SVM",80,23,384,376,8,2400,2159,241,0.761531619774601,0.169014084507042,1.22962289868242,642,241,401,-12,1.7,86.21,9,0,0,0,0,0,0,0.0107409405474811,3.0405696804546,1.94679464459041
9.7,"eps_greedy_SVM","SVM",80,24,284,278,6,2500,2257,243,0.783868679704122,0.204225352112676,1.26578827805543,674,243,431,32,1.8,89.8,9.3,0,0,0,0,0,0,0.00189829808117414,0.999710095323662,0.912922444774146
9.7,"eps_greedy_SVM","SVM",80,25,184,183,1,2600,2352,248,0.814767903986667,0.253521126760563,1.28387096774194,696,248,448,22,1.8,93.39,9.5,0,0,0,0,0,0,0.000147188687872366,0.0904085947352777,0.0850500626213126
9.7,"eps_greedy_SVM","SVM",80,26,84,84,0,2700,2451,249,0.81532520462503,0.295774647887324,1.28387096774194,697,249,448,1,1.8,96.98,9.8,0,0,0,0,0,0,0.000115374303629994,1.88076247607662,1.88076247607662
9.7,"eps_greedy_SVM","SVM",80,27,0,0,0,2784,2535,249,0.773454475855931,0.211267605633803,1.27482962289868,726,249,477,29,1.9,100,10.2,0,0,0,0,0,0,0,0,0
9.7,"eps_greedy_SVM","SVM",81,0,2684,2421,263,100,91,9,0.741778029893278,0.210084033613445,1.22992680943345,27,9,18,0,2,3.59,10.1,0,0,0,0,0,0,0.176936451814861,254.362498496935,19.6488516224982
9.7,"eps_greedy_SVM","SVM",81,1,2584,2346,238,200,166,34,0.770371885017745,0.19327731092437,1.27308213608024,92,34,58,65,1.7,7.18,4.9,0,0,0,0,0,0,0.227424842036245,306.379452559428,25.2395349759287
9.7,"eps_greedy_SVM","SVM",81,2,2484,2272,212,300,240,60,0.788834215004687,0.252100840336134,1.27308213608024,142,60,82,50,1.4,10.78,4,0,0,0,0,0,0,0.274884318971834,287.804965761914,34.0782373688023
9.7,"eps_greedy_SVM","SVM",81,3,2384,2198,186,400,314,86,0.776901969579042,0.184873949579832,1.27308213608024,206,86,120,64,1.4,14.37,3.7,0,0,0,0,0,0,0.234483623521797,306.334673891483,24.4627863006334
9.7,"eps_greedy_SVM","SVM",81,4,2284,2120,164,500,392,108,0.783682703850774,0.210084033613445,1.27308213608024,258,108,150,52,1.4,17.96,3.6,0,0,0,0,0,0,0.217351135555761,205.611465767239,22.9469633262034
9.7,"eps_greedy_SVM","SVM",81,5,2184,2049,135,600,463,137,0.772080260675702,0.218487394957983,1.27308213608024,330,137,193,72,1.4,21.55,3.4,0,0,0,0,0,0,0.221298735816105,218.180212099918,23.4337310211045
9.7,"eps_greedy_SVM","SVM",81,6,2084,1973,111,700,539,161,0.786815825231195,0.235294117647059,1.27308213608024,388,161,227,58,1.4,25.14,3.3,0,0,0,0,0,0,0.215987570352666,194.20998407596,22.8884597005078
9.7,"eps_greedy_SVM","SVM",81,7,1984,1893,91,800,619,181,0.790476630212526,0.201680672268908,1.27308213608024,443,181,262,55,1.4,28.74,3.4,0,0,0,0,0,0,0.229249234275273,296.553288709645,23.5936424562399
9.7,"eps_greedy_SVM","SVM",81,8,1884,1814,70,900,698,202,0.796993522683801,0.243697478991597,1.24071564109515,493,202,291,50,1.4,32.33,3.5,0,0,0,0,0,0,0.18226373675901,136.735968019536,20.2768865801468
9.7,"eps_greedy_SVM","SVM",81,9,1784,1723,61,1000,789,211,0.785371291373693,0.226890756302521,1.25150447275684,524,211,313,31,1.5,35.92,3.7,0,0,0,0,0,0,0.196056894459021,219.200921968521,20.6033028591935
9.7,"eps_greedy_SVM","SVM",81,10,1684,1630,54,1100,882,218,0.782317322533409,0.210084033613445,1.24071564109515,541,218,323,17,1.5,39.51,4,0,0,0,0,0,0,0.138828143570512,98.4215636901238,15.3542756863757
9.7,"eps_greedy_SVM","SVM",81,11,1584,1534,50,1200,978,222,0.766361489650806,0.201680672268908,1.26229330441854,549,222,327,8,1.5,43.1,4.4,0,0,0,0,0,0,0.180160106121572,163.200080097287,19.9154292157413
9.7,"eps_greedy_SVM","SVM",81,12,1484,1435,49,1300,1077,223,0.76432331174228,0.176470588235294,1.21913797777175,565,223,342,16,1.5,46.7,4.8,0,0,0,0,0,0,0.152313615856242,107.739599765978,16.5726030592001
9.7,"eps_greedy_SVM","SVM",81,13,1384,1337,47,1400,1175,225,0.774989116525731,0.226890756302521,1.26229330441854,585,225,360,20,1.6,50.29,5.2,0,0,0,0,0,0,0.139024075759143,103.438435200397,14.8557609328884
9.7,"eps_greedy_SVM","SVM",81,14,1284,1242,42,1500,1270,230,0.725123016239465,0.109243697478992,1.26229330441854,596,230,366,11,1.6,53.88,5.5,0,0,0,0,0,0,0.13928271375915,77.1088290159133,16.5431445339061
9.7,"eps_greedy_SVM","SVM",81,15,1184,1151,33,1600,1361,239,0.802521008403362,0.226890756302521,1.27308213608024,643,239,404,47,1.7,57.47,5.7,0,0,0,0,0,0,0.101616664404109,39.8528949882639,12.8547254259094
9.7,"eps_greedy_SVM","SVM",81,16,1084,1058,26,1700,1454,246,0.797686107410003,0.218487394957983,1.27308213608024,649,246,403,6,1.6,61.06,5.9,0,0,0,0,0,0,0.0396462304717489,12.1170481372422,6.52558242901524
9.7,"eps_greedy_SVM","SVM",81,17,984,964,20,1800,1548,252,0.79698692663879,0.168067226890756,1.27308213608024,668,252,416,19,1.7,64.66,6.1,0,0,0,0,0,0,0.0467464023646722,15.0408090266295,8.00128944383765
9.7,"eps_greedy_SVM","SVM",81,18,884,872,12,1900,1640,260,0.829327335329741,0.26890756302521,1.26229330441854,692,260,432,24,1.7,68.25,6.3,0,0,0,0,0,0,0.0327049051341771,9.33580027897347,5.44114218003978
9.7,"eps_greedy_SVM","SVM",81,19,784,777,7,2000,1735,265,0.800898381330557,0.19327731092437,1.27308213608024,712,265,447,20,1.7,71.84,6.5,0,0,0,0,0,0,0.157113242852465,46.3432811338339,21.948212163116
9.7,"eps_greedy_SVM","SVM",81,20,684,678,6,2100,1834,266,0.826121657454194,0.243697478991597,1.27308213608024,743,266,477,31,1.8,75.43,6.9,0,0,0,0,0,0,0.0775733785662441,22.0038443974202,11.3411958920683
9.7,"eps_greedy_SVM","SVM",81,21,584,582,2,2200,1930,270,0.815976940226643,0.19327731092437,1.27308213608024,714,270,444,-29,1.6,79.02,7.1,0,0,0,0,0,0,0.0241005612731849,7.37191589541383,5.68080309006741
9.7,"eps_greedy_SVM","SVM",81,22,484,483,1,2300,2029,271,0.772482619421397,0.201680672268908,1.27308213608024,734,271,463,20,1.7,82.61,7.5,0,0,0,0,0,0,0.0091429167789114,2.78175064758075,2.33370068738237
9.7,"eps_greedy_SVM","SVM",81,23,384,383,1,2400,2129,271,0.79735630515943,0.184873949579832,1.27308213608024,725,271,454,-9,1.7,86.21,7.9,0,0,0,0,0,0,0.000867474950548537,0.568973371614617,0.53330302608494
9.7,"eps_greedy_SVM","SVM",81,24,284,284,0,2500,2228,272,0.759521390973975,0.151260504201681,1.26229330441854,746,272,474,21,1.7,89.8,8.2,0,0,0,0,0,0,0.0302824893653706,9.90774504973965,7.70628362827219
9.7,"eps_greedy_SVM","SVM",81,25,184,184,0,2600,2328,272,0.71687136393019,0.117647058823529,1.28387096774194,736,272,464,-10,1.7,93.39,8.6,0,0,0,0,0,0,0.000379333035073851,0.368916493778104,0.360456124198719
9.7,"eps_greedy_SVM","SVM",81,26,84,84,0,2700,2428,272,0.788900175454799,0.184873949579832,1.28387096774194,752,272,480,16,1.8,96.98,8.9,0,0,0,0,0,0,1.84898545763044e-06,0.0438810373152917,0.0438810373152917
9.7,"eps_greedy_SVM","SVM",81,27,0,0,0,2784,2512,272,0.813160429006772,0.226890756302521,1.27308213608024,742,272,470,-10,1.7,100,9.2,0,0,0,0,0,0,0,0,0
9.7,"eps_greedy_SVM","SVM",82,0,2684,2444,240,100,95,5,0.763053245597657,0.328767123287671,1.21352187361909,13,5,8,0,1.6,3.59,19,0,0,0,0,0,0,0.245282543459732,214.833384539519,35.657194959074
9.7,"eps_greedy_SVM","SVM",82,1,2584,2368,216,200,171,29,0.736562269995937,0.39041095890411,1.14317277949624,67,29,38,54,1.3,7.18,5.9,0,0,0,0,0,0,0.22059324424156,249.119879337292,31.2592197180162
9.7,"eps_greedy_SVM","SVM",82,2,2484,2291,193,300,248,52,0.722303391152463,0.226027397260274,1.16076005302696,127,52,75,60,1.4,10.78,4.8,0,0,0,0,0,0,0.21447326963055,219.49435104743,30.3821894532828
9.7,"eps_greedy_SVM","SVM",82,3,2384,2198,186,400,341,59,0.827432413133981,0.342465753424658,1.24869642068051,146,59,87,19,1.5,14.37,5.8,0,0,0,0,0,0,0.173223125244845,107.935581964541,18.1801093851581
9.7,"eps_greedy_SVM","SVM",82,4,2284,2134,150,500,405,95,0.82539464578001,0.36986301369863,1.24869642068051,231,95,136,85,1.4,17.96,4.3,0,0,0,0,0,0,0.206906993045756,115.014741741321,21.8163059541252
9.7,"eps_greedy_SVM","SVM",82,5,2184,2059,125,600,480,120,0.822236381013063,0.363013698630137,1.25749005744587,286,120,166,55,1.4,21.55,4,0,0,0,0,0,0,0.220576151223938,98.0447907686389,22.6580492523497
9.7,"eps_greedy_SVM","SVM",82,6,2084,1985,99,700,554,146,0.823598554338636,0.349315068493151,1.25749005744587,355,146,209,69,1.4,25.14,3.8,0,0,0,0,0,0,0.202071577848893,77.6526153348651,22.1148486478545
9.7,"eps_greedy_SVM","SVM",82,7,1984,1899,85,800,640,160,0.820182135755961,0.342465753424658,1.24869642068051,388,160,228,33,1.4,28.74,4,0,0,0,0,0,0,0.154923654990354,50.2868408274032,17.7497277092224
9.7,"eps_greedy_SVM","SVM",82,8,1884,1817,67,900,722,178,0.838192483879124,0.356164383561644,1.25749005744587,438,178,260,50,1.5,32.33,4.1,0,0,0,0,0,0,0.116700660748801,29.1650254905628,15.8896903932823
9.7,"eps_greedy_SVM","SVM",82,9,1784,1738,46,1000,801,199,0.832106644989068,0.321917808219178,1.24869642068051,486,199,287,48,1.4,35.92,4,0,0,0,0,0,0,0.150034210879217,58.2293472457476,18.3860599767112
9.7,"eps_greedy_SVM","SVM",82,10,1684,1647,37,1100,892,208,0.828465028396911,0.335616438356164,1.25749005744587,526,208,318,40,1.5,39.51,4.3,0,0,0,0,0,0,0.182526554069817,105.385977282671,19.6922263625776
9.7,"eps_greedy_SVM","SVM",82,11,1584,1558,26,1200,981,219,0.791334820006363,0.246575342465753,1.25749005744587,572,219,353,46,1.6,43.1,4.5,0,0,0,0,0,0,0.202960109184559,122.705341412001,21.6212086887818
9.7,"eps_greedy_SVM","SVM",82,12,1484,1462,22,1300,1077,223,0.825460557392527,0.36986301369863,1.25749005744587,581,223,358,9,1.6,46.7,4.8,0,0,0,0,0,0,0.161651720758482,92.5593380490513,17.1490795937126
9.7,"eps_greedy_SVM","SVM",82,13,1384,1363,21,1400,1176,224,0.821906822950417,0.308219178082192,1.25749005744587,606,224,382,25,1.7,50.29,5.2,0,0,0,0,0,0,0.146698968776285,77.4737471242263,15.5832150228325
9.7,"eps_greedy_SVM","SVM",82,14,1284,1265,19,1500,1274,226,0.805313574496591,0.267123287671233,1.25749005744587,617,226,391,11,1.7,53.88,5.6,0,0,0,0,0,0,0.118816824967309,47.683672943901,13.0172992142222
9.7,"eps_greedy_SVM","SVM",82,15,1184,1166,18,1600,1373,227,0.824142325141978,0.363013698630137,1.25749005744587,633,227,406,16,1.8,57.47,6,0,0,0,0,0,0,0.112988199889207,43.3401719269458,12.1087991652288
9.7,"eps_greedy_SVM","SVM",82,16,1084,1067,17,1700,1472,228,0.799408992540995,0.308219178082192,1.25749005744587,607,228,379,-26,1.7,61.06,6.5,0,0,0,0,0,0,0.0655223565522151,17.9503526055323,8.81810697230098
9.7,"eps_greedy_SVM","SVM",82,17,984,967,17,1800,1572,228,0.812382594940178,0.321917808219178,1.25749005744587,634,228,406,27,1.8,64.66,6.9,0,0,0,0,0,0,0.0526836703635976,11.7312555906997,6.7820353915069
9.7,"eps_greedy_SVM","SVM",82,18,884,868,16,1900,1671,229,0.809586844042132,0.315068493150685,1.25749005744587,642,229,413,8,1.8,68.25,7.3,0,0,0,0,0,0,0.0204132985158696,5.40632935123615,4.4066318758532
9.7,"eps_greedy_SVM","SVM",82,19,784,770,14,2000,1769,231,0.808004965341473,0.315068493150685,1.24869642068051,664,231,433,22,1.9,71.84,7.7,0,0,0,0,0,0,0.000962745599820071,0.571323702385126,0.529828005359059
9.7,"eps_greedy_SVM","SVM",82,20,684,679,5,2100,1860,240,0.773917676395952,0.226027397260274,1.28387096774194,680,240,440,16,1.8,75.43,7.8,0,0,0,0,0,0,0.10093189794867,35.4427179983171,15.5215963439152
9.7,"eps_greedy_SVM","SVM",82,21,584,579,5,2200,1960,240,0.811948676824374,0.280821917808219,1.27390322662025,669,240,429,-11,1.8,79.02,8.2,0,0,0,0,0,0,0.0431510055098576,10.2005684784676,7.25247476982614
9.7,"eps_greedy_SVM","SVM",82,22,484,483,1,2300,2056,244,0.772775208445473,0.198630136986301,1.26511768712632,695,244,451,26,1.8,82.61,8.4,0,0,0,0,0,0,0.0491189842088147,12.900555750398,9.06936800549642
9.7,"eps_greedy_SVM","SVM",82,23,384,383,1,2400,2156,244,0.810152585382998,0.315068493150685,1.27390322662025,703,244,459,8,1.9,86.21,8.8,0,0,0,0,0,0,0.0114457405829373,3.37730789707189,2.7041187873476
9.7,"eps_greedy_SVM","SVM",82,24,284,283,1,2500,2256,244,0.80821917808219,0.26027397260274,1.27390322662025,699,244,455,-4,1.9,89.8,9.2,0,0,0,0,0,0,0.000526784944539031,0.250390144617096,0.233654642633142
9.7,"eps_greedy_SVM","SVM",82,25,184,183,1,2600,2356,244,0.832485636761098,0.321917808219178,1.27390322662025,694,244,450,-5,1.8,93.39,9.7,0,0,0,0,0,0,6.61790639629976e-06,0.00845141467882058,0.00827733549006209
9.7,"eps_greedy_SVM","SVM",82,26,84,84,0,2700,2455,245,0.732772352275597,0.150684931506849,1.27390322662025,703,245,458,9,1.9,96.98,10,0,0,0,0,0,0,1.0000000994736e-07,2.11293975434442,2.11293975434442
9.7,"eps_greedy_SVM","SVM",82,27,0,0,0,2784,2539,245,0.785408267513262,0.23972602739726,1.27390322662025,672,245,427,-31,1.7,100,10.4,0,0,0,0,0,0,0,0,0
9.7,"eps_greedy_SVM","SVM",83,0,2684,2440,244,100,86,14,0.698818474758323,0.157894736842105,1.22595197671598,44,14,30,0,2.1,3.59,6.1,0,0,0,0,0,0,0.1873124449128,377.657739718033,25.1587842167094
9.7,"eps_greedy_SVM","SVM",83,1,2584,2356,228,200,170,30,0.770509607351728,0.180451127819549,1.27421780257094,92,30,62,48,2.1,7.18,5.7,0,0,0,0,0,0,0.206419901836118,315.133960064627,24.6909889155187
9.7,"eps_greedy_SVM","SVM",83,2,2484,2266,218,300,260,40,0.763313044516066,0.120300751879699,1.25491147222896,140,40,100,48,2.5,10.78,6.5,0,0,0,0,0,0,0.18347839065079,297.772589371719,26.176798739353
9.7,"eps_greedy_SVM","SVM",83,3,2384,2180,204,400,346,54,0.782981262680521,0.240601503759398,1.25491147222896,166,54,112,26,2.1,14.37,6.4,0,0,0,0,0,0,0.153567197185053,272.528307765588,16.596017147112
9.7,"eps_greedy_SVM","SVM",83,4,2284,2099,185,500,427,73,0.809947487767051,0.308270676691729,1.27421780257094,193,73,120,27,1.6,17.96,5.8,0,0,0,0,0,0,0.169001554487007,234.391671415954,18.7197809386507
9.7,"eps_greedy_SVM","SVM",83,5,2184,2033,151,600,493,107,0.810371166010274,0.285714285714286,1.26456463739995,273,107,166,80,1.6,21.55,4.6,0,0,0,0,0,0,0.192163625987034,228.967457685937,19.8710579867011
9.7,"eps_greedy_SVM","SVM",83,6,2084,1963,121,700,563,137,0.824286907745564,0.308270676691729,1.26456463739995,340,137,203,67,1.5,25.14,4.1,0,0,0,0,0,0,0.198083836781397,183.716005517126,20.5923927086039
9.7,"eps_greedy_SVM","SVM",83,7,1984,1892,92,800,634,166,0.83469387755103,0.323308270676692,1.26456463739995,407,166,241,67,1.5,28.74,3.8,0,0,0,0,0,0,0.208210785717137,160.341452160696,22.1716521655117
9.7,"eps_greedy_SVM","SVM",83,8,1884,1818,66,900,708,192,0.833255758443739,0.285714285714286,1.26456463739995,460,192,268,53,1.4,32.33,3.7,0,0,0,0,0,0,0.210583832400378,155.941786444555,21.8506400565434
9.7,"eps_greedy_SVM","SVM",83,9,1784,1739,45,1000,787,213,0.831006086645193,0.285714285714286,1.26456463739995,524,213,311,64,1.5,35.92,3.7,0,0,0,0,0,0,0.210884592081033,194.926955410351,21.8374547216236
9.7,"eps_greedy_SVM","SVM",83,10,1684,1652,32,1100,874,226,0.829937940088326,0.263157894736842,1.26456463739995,566,226,340,42,1.5,39.51,3.9,0,0,0,0,0,0,0.184998902075321,114.82773233137,19.476422560533
9.7,"eps_greedy_SVM","SVM",83,11,1584,1561,23,1200,965,235,0.823576799140718,0.263157894736842,1.26456463739995,597,235,362,31,1.5,43.1,4.1,0,0,0,0,0,0,0.17946053726512,137.514202798935,18.7506311938686
9.7,"eps_greedy_SVM","SVM",83,12,1484,1463,21,1300,1063,237,0.815073397780175,0.225563909774436,1.26456463739995,607,237,370,10,1.6,46.7,4.5,0,0,0,0,0,0,0.120394721951642,51.7453541071599,13.7634704642361
9.7,"eps_greedy_SVM","SVM",83,13,1384,1366,18,1400,1160,240,0.811290130087136,0.24812030075188,1.27421780257094,609,240,369,2,1.5,50.29,4.8,0,0,0,0,0,0,0.100160584512718,47.0963321418172,11.8598680815935
9.7,"eps_greedy_SVM","SVM",83,14,1284,1268,16,1500,1258,242,0.79996419620481,0.233082706766917,1.25375593680333,624,242,382,15,1.6,53.88,5.2,0,0,0,0,0,0,0.113267898242905,56.7854082920815,13.6631012774572
9.7,"eps_greedy_SVM","SVM",83,15,1184,1169,15,1600,1357,243,0.808312447786145,0.240601503759398,1.26456463739995,641,243,398,17,1.6,57.47,5.6,0,0,0,0,0,0,0.076237586875055,34.0355281313669,9.51682019860005
9.7,"eps_greedy_SVM","SVM",83,16,1084,1071,13,1700,1455,245,0.788053467000846,0.195488721804511,1.25491147222896,649,245,404,8,1.6,61.06,5.9,0,0,0,0,0,0,0.0989919335467553,48.4772139765882,13.2315668550861
9.7,"eps_greedy_SVM","SVM",83,17,984,971,13,1800,1555,245,0.814530373552939,0.293233082706767,1.25491147222896,670,245,425,21,1.7,64.66,6.3,0,0,0,0,0,0,0.10229785666865,61.6160986708901,11.0395382798305
9.7,"eps_greedy_SVM","SVM",83,18,884,871,13,1900,1655,245,0.810603890679087,0.270676691729323,1.25491147222896,673,245,428,3,1.7,68.25,6.8,0,0,0,0,0,0,0.0529774198258443,20.5044122220926,6.23776626271969
9.7,"eps_greedy_SVM","SVM",83,19,784,773,11,2000,1753,247,0.790094283327374,0.210526315789474,1.26456463739995,667,247,420,-6,1.7,71.84,7.1,0,0,0,0,0,0,0.0364747312140077,12.5639535558846,6.52916116915742
9.7,"eps_greedy_SVM","SVM",83,20,684,681,3,2100,1845,255,0.75123523093449,0.195488721804511,1.27421780257094,708,255,453,41,1.8,75.43,7.2,0,0,0,0,0,0,0.0425441570431287,13.0965673347857,6.56033045180305
9.7,"eps_greedy_SVM","SVM",83,21,584,583,1,2200,1943,257,0.787331423797603,0.233082706766917,1.27421780257094,708,257,451,0,1.8,79.02,7.6,0,0,0,0,0,0,0.0261584430158941,6.81807213092671,3.68892735702513
9.7,"eps_greedy_SVM","SVM",83,22,484,483,1,2300,2043,257,0.808079723117331,0.285714285714286,1.27421780257094,715,257,458,7,1.8,82.61,7.9,0,0,0,0,0,0,0.020964641322104,5.25843163717148,2.98775168043338
9.7,"eps_greedy_SVM","SVM",83,23,384,383,1,2400,2143,257,0.775486334884844,0.218045112781955,1.27421780257094,711,257,454,-4,1.8,86.21,8.3,0,0,0,0,0,0,0.0246294818776281,6.71317137817056,3.42423468270002
9.7,"eps_greedy_SVM","SVM",83,24,284,284,0,2500,2242,258,0.681423797589212,0.0827067669172932,1.27304448967723,718,258,460,7,1.8,89.8,8.7,0,0,0,0,0,0,0.0279414262286542,10.2292849792482,9.26503180164271
9.7,"eps_greedy_SVM","SVM",83,25,184,184,0,2600,2342,258,0.758228905597332,0.203007518796992,1.27421780257094,730,258,472,12,1.8,93.39,9.1,0,0,0,0,0,0,0.00429351995323756,1.3384030971654,1.24246961201378
9.7,"eps_greedy_SVM","SVM",83,26,84,84,0,2700,2442,258,0.772281895214233,0.218045112781955,1.27421780257094,734,258,476,4,1.8,96.98,9.5,0,0,0,0,0,0,1.66339259608844e-08,0.0687327892951445,0.0687327892951445
9.7,"eps_greedy_SVM","SVM",83,27,0,0,0,2784,2526,258,0.731865377730045,0.157894736842105,1.27421780257094,727,258,469,-7,1.8,100,9.8,0,0,0,0,0,0,0,0,0
9.7,"eps_greedy_SVM","SVM",84,0,2684,2427,257,100,91,9,0.695293375394325,0.272,1.15034838709677,32,9,23,0,2.6,3.59,10.1,0,0,0,0,0,0,0.0922055348330751,245.980510832636,9.22759395485429
9.7,"eps_greedy_SVM","SVM",84,1,2584,2361,223,200,157,43,0.718410094637229,0.128,1.26332903225806,105,43,62,73,1.4,7.18,3.7,0,0,0,0,0,0,0.235327540469272,534.641277425301,24.4193744231107
9.7,"eps_greedy_SVM","SVM",84,2,2484,2269,215,300,249,51,0.730113564668772,0.096,1.23251612903226,140,51,89,35,1.7,10.78,4.9,0,0,0,0,0,0,0.22414224548165,395.544459457355,24.0698138905021
9.7,"eps_greedy_SVM","SVM",84,3,2384,2176,208,400,342,58,0.722706624605679,0.208,1.21197419354839,151,58,93,11,1.6,14.37,5.9,0,0,0,0,0,0,0.187085950906821,204.790521695676,22.2448912670142
9.7,"eps_greedy_SVM","SVM",84,4,2284,2089,195,500,429,71,0.726561514195589,0.248,1.20170322580645,202,71,131,51,1.8,17.96,6,0,0,0,0,0,0,0.153896151801758,255.873839277896,15.7651849114926
9.7,"eps_greedy_SVM","SVM",84,5,2184,2017,167,600,501,99,0.743110410094636,0.232,1.22224516129032,265,99,166,63,1.7,21.55,5.1,0,0,0,0,0,0,0.184272978162027,184.550848389029,20.0432015900379
9.7,"eps_greedy_SVM","SVM",84,6,2084,1938,146,700,580,120,0.760952681388017,0.296,1.23251612903226,321,120,201,56,1.7,25.14,4.8,0,0,0,0,0,0,0.180246393387156,190.615418870925,18.8354609071217
9.7,"eps_greedy_SVM","SVM",84,7,1984,1856,128,800,662,138,0.792908517350161,0.264,1.26332903225806,368,138,230,47,1.7,28.74,4.8,0,0,0,0,0,0,0.166024840090085,104.440371309918,22.8011070404404
9.7,"eps_greedy_SVM","SVM",84,8,1884,1783,101,900,735,165,0.822082018927446,0.304,1.2736,422,165,257,54,1.6,32.33,4.5,0,0,0,0,0,0,0.183170135434467,191.723209287113,19.7854023978769
9.7,"eps_greedy_SVM","SVM",84,9,1784,1707,77,1000,811,189,0.795312302839119,0.2,1.2736,481,189,292,59,1.5,35.92,4.3,0,0,0,0,0,0,0.205668931292073,180.126414826717,32.0273066552514
9.7,"eps_greedy_SVM","SVM",84,10,1684,1612,72,1100,906,194,0.818315457413253,0.2,1.28387096774194,500,194,306,19,1.6,39.51,4.7,0,0,0,0,0,0,0.164185362952768,118.37444956815,17.6844673152831
9.7,"eps_greedy_SVM","SVM",84,11,1584,1535,49,1200,983,217,0.833230283911676,0.264,1.2736,573,217,356,73,1.6,43.1,4.5,0,0,0,0,0,0,0.155020741774954,94.3075104865116,17.2616213403176
9.7,"eps_greedy_SVM","SVM",84,12,1484,1449,35,1300,1069,231,0.82286435331231,0.248,1.2736,605,231,374,32,1.6,46.7,4.6,0,0,0,0,0,0,0.155896261603604,118.805813194391,16.693894756718
9.7,"eps_greedy_SVM","SVM",84,13,1384,1356,28,1400,1162,238,0.82174132492114,0.272,1.28387096774194,626,238,388,21,1.6,50.29,4.9,0,0,0,0,0,0,0.137949501323302,95.2953361952166,14.9293062609731
9.7,"eps_greedy_SVM","SVM",84,14,1284,1264,20,1500,1254,246,0.832656151419565,0.272,1.28387096774194,652,246,406,26,1.7,53.88,5.1,0,0,0,0,0,0,0.119461493128365,69.9674844607782,12.9726874688327
9.7,"eps_greedy_SVM","SVM",84,15,1184,1169,15,1600,1349,251,0.820536277602524,0.2,1.28387096774194,667,251,416,15,1.7,57.47,5.4,0,0,0,0,0,0,0.111007803087908,60.4692625594834,12.7078201958209
9.7,"eps_greedy_SVM","SVM",84,16,1084,1077,7,1700,1441,259,0.807564668769717,0.216,1.28387096774194,707,259,448,40,1.7,61.06,5.6,0,0,0,0,0,0,0.111761958893044,55.6955532452577,13.7493727987003
9.7,"eps_greedy_SVM","SVM",84,17,984,981,3,1800,1537,263,0.816694006309153,0.256,1.28387096774194,729,263,466,22,1.8,64.66,5.8,0,0,0,0,0,0,0.0939096294682451,41.4837070111672,10.9821305348057
9.7,"eps_greedy_SVM","SVM",84,18,884,881,3,1900,1637,263,0.795129337539432,0.16,1.28387096774194,706,263,443,-23,1.7,68.25,6.2,0,0,0,0,0,0,0.0607075659142574,21.3840430099122,6.90426879159957
9.7,"eps_greedy_SVM","SVM",84,19,784,781,3,2000,1737,263,0.810050473186121,0.208,1.28387096774194,710,263,447,4,1.7,71.84,6.6,0,0,0,0,0,0,0.0408921045023848,13.2700704288163,5.13989363496977
9.7,"eps_greedy_SVM","SVM",84,20,684,681,3,2100,1837,263,0.845962145110411,0.304,1.28387096774194,715,263,452,5,1.7,75.43,7,0,0,0,0,0,0,0.0267032121727107,7.50135696449551,3.37747739715467
9.7,"eps_greedy_SVM","SVM",84,21,584,582,2,2200,1936,264,0.827899053627764,0.256,1.2736,719,264,455,4,1.7,79.02,7.3,0,0,0,0,0,0,0.0579511393029482,19.8542136882711,10.7728837701725
9.7,"eps_greedy_SVM","SVM",84,22,484,482,2,2300,2036,264,0.833274447949531,0.288,1.28387096774194,742,264,478,23,1.8,82.61,7.7,0,0,0,0,0,0,0.00513903417241263,1.30160144455959,0.941080544027825
9.7,"eps_greedy_SVM","SVM",84,23,384,382,2,2400,2136,264,0.822315457413253,0.24,1.28387096774194,724,264,460,-18,1.7,86.21,8.1,0,0,0,0,0,0,0.00314943960520888,0.925739687350518,0.699728268853925
9.7,"eps_greedy_SVM","SVM",84,24,284,284,0,2500,2234,266,0.834561514195585,0.32,1.28387096774194,742,266,476,18,1.8,89.8,8.4,0,0,0,0,0,0,0.00669606253836235,7.67860839286555,7.35443949864255
9.7,"eps_greedy_SVM","SVM",84,25,184,184,0,2600,2334,266,0.812858044164039,0.208,1.28387096774194,753,266,487,11,1.8,93.39,8.8,0,0,0,0,0,0,0.00020145388326897,0.178522553810175,0.17376501510135
9.7,"eps_greedy_SVM","SVM",84,26,84,84,0,2700,2434,266,0.788334384858045,0.176,1.28387096774194,752,266,486,-1,1.8,96.98,9.2,0,0,0,0,0,0,1.0000000994736e-07,0.013536452579784,0.013536452579784
9.7,"eps_greedy_SVM","SVM",84,27,0,0,0,2784,2518,266,0.804706624605677,0.224,1.28387096774194,732,266,466,-20,1.8,100,9.5,0,0,0,0,0,0,0,0,0
9.7,"eps_greedy_SVM","SVM",85,0,2684,2448,236,100,95,5,0.798047733976935,0.24,1.26675268817204,20,5,15,0,3,3.59,19,0,0,0,0,0,0,0.0889799910533154,141.366193397645,10.5577811974073
9.7,"eps_greedy_SVM","SVM",85,1,2584,2363,221,200,180,20,0.797114507910957,0.3,1.22395698924731,60,20,40,40,2,7.18,9,0,0,0,0,0,0,0.119323945505185,211.828355536638,13.2849436812561
9.7,"eps_greedy_SVM","SVM",85,2,2484,2281,203,300,262,38,0.814808259587007,0.406666666666667,1.22395698924731,99,38,61,39,1.6,10.78,6.9,0,0,0,0,0,0,0.148204740112538,175.358348306892,16.0486009401286
9.7,"eps_greedy_SVM","SVM",85,3,2384,2209,175,400,334,66,0.821662644140512,0.366666666666667,1.2410752688172,163,66,97,64,1.5,14.37,5.1,0,0,0,0,0,0,0.184329312537082,187.749039203462,19.0363101076267
9.7,"eps_greedy_SVM","SVM",85,4,2284,2142,142,500,401,99,0.803663180477338,0.346666666666667,1.22395698924731,236,99,137,73,1.4,17.96,4.1,0,0,0,0,0,0,0.211621634393193,177.203015695426,24.9109407919476
9.7,"eps_greedy_SVM","SVM",85,5,2184,2061,123,600,482,118,0.82413515687851,0.373333333333333,1.24963440860215,280,118,162,44,1.4,21.55,4.1,0,0,0,0,0,0,0.201033730928323,115.943101193874,21.1788368021556
9.7,"eps_greedy_SVM","SVM",85,6,2084,1993,91,700,550,150,0.815789755966738,0.346666666666667,1.24963440860215,351,150,201,71,1.3,25.14,3.7,0,0,0,0,0,0,0.214844166361502,143.082684757408,22.7671916169798
9.7,"eps_greedy_SVM","SVM",85,7,1984,1908,76,800,635,165,0.811161169214256,0.32,1.2410752688172,389,165,224,38,1.4,28.74,3.8,0,0,0,0,0,0,0.157785367859299,91.2767631761919,18.1415618408281
9.7,"eps_greedy_SVM","SVM",85,8,1884,1819,65,900,724,176,0.793467417538207,0.353333333333333,1.22395698924731,409,176,233,20,1.3,32.33,4.1,0,0,0,0,0,0,0.173255906732791,152.379257481979,19.491901161422
9.7,"eps_greedy_SVM","SVM",85,9,1784,1724,60,1000,819,181,0.801571466881193,0.306666666666667,1.2410752688172,428,181,247,19,1.4,35.92,4.5,0,0,0,0,0,0,0.170976131216418,126.516894555489,19.0909882118221
9.7,"eps_greedy_SVM","SVM",85,10,1684,1630,54,1100,913,187,0.802617323679266,0.306666666666667,1.24963440860215,441,187,254,13,1.4,39.51,4.9,0,0,0,0,0,0,0.138183715236454,84.7632668017833,15.879896864949
9.7,"eps_greedy_SVM","SVM",85,11,1584,1534,50,1200,1009,191,0.804231697506027,0.28,1.23251612903226,457,191,266,16,1.4,43.1,5.3,0,0,0,0,0,0,0.113271024542538,76.315963056597,13.21797599159
9.7,"eps_greedy_SVM","SVM",85,12,1484,1442,42,1300,1101,199,0.821314025207819,0.36,1.21539784946237,489,199,290,32,1.5,46.7,5.5,0,0,0,0,0,0,0.13772231785774,95.6858395984248,15.2463877549051
9.7,"eps_greedy_SVM","SVM",85,13,1384,1358,26,1400,1185,215,0.803319924912835,0.286666666666667,1.21539784946237,535,215,320,46,1.5,50.29,5.5,0,0,0,0,0,0,0.155063955986269,63.1628373455165,18.2078204636213
9.7,"eps_greedy_SVM","SVM",85,14,1284,1265,19,1500,1278,222,0.80859211584874,0.346666666666667,1.21539784946237,557,222,335,22,1.5,53.88,5.8,0,0,0,0,0,0,0.12275316064483,51.7316209845187,14.0787588473903
9.7,"eps_greedy_SVM","SVM",85,15,1184,1169,15,1600,1374,226,0.788747653526402,0.26,1.22395698924731,572,226,346,15,1.5,57.47,6.1,0,0,0,0,0,0,0.0794269489253385,27.4925322640354,9.73377212280447
9.7,"eps_greedy_SVM","SVM",85,16,1084,1071,13,1700,1472,228,0.797377312952524,0.28,1.22395698924731,587,228,359,15,1.6,61.06,6.5,0,0,0,0,0,0,0.077355623100817,35.7277912261521,9.29580937696688
9.7,"eps_greedy_SVM","SVM",85,17,984,972,12,1800,1571,229,0.753027621346195,0.18,1.21539784946237,583,229,354,-4,1.5,64.66,6.9,0,0,0,0,0,0,0.084872570194698,27.651120013509,11.1291540047858
9.7,"eps_greedy_SVM","SVM",85,18,884,873,11,1900,1670,230,0.779190131402515,0.273333333333333,1.19827956989247,604,230,374,21,1.6,68.25,7.3,0,0,0,0,0,0,0.0578594932979621,20.4495875305087,8.21562007421571
9.7,"eps_greedy_SVM","SVM",85,19,784,773,11,2000,1770,230,0.773193885760249,0.253333333333333,1.20683870967742,609,230,379,5,1.6,71.84,7.7,0,0,0,0,0,0,0.0143974524315186,4.27158076390518,2.43603545930309
9.7,"eps_greedy_SVM","SVM",85,20,684,673,11,2100,1870,230,0.776808795923833,0.266666666666667,1.20683870967742,590,230,360,-19,1.6,75.43,8.1,0,0,0,0,0,0,0.0215893669041163,6.54968216948346,3.33988267402057
9.7,"eps_greedy_SVM","SVM",85,21,584,575,9,2200,1968,232,0.793279699651374,0.293333333333333,1.21539784946237,602,232,370,12,1.6,79.02,8.5,0,0,0,0,0,0,0.00666200618600238,1.89099238436946,1.05835688008647
9.7,"eps_greedy_SVM","SVM",85,22,484,476,8,2300,2067,233,0.775269509251804,0.26,1.20683870967742,621,233,388,19,1.7,82.61,8.9,0,0,0,0,0,0,0.00210296980655636,0.71655743022525,0.539382908303471
9.7,"eps_greedy_SVM","SVM",85,23,384,378,6,2400,2165,235,0.776889246446761,0.253333333333333,1.18972043010753,628,235,393,7,1.7,86.21,9.2,0,0,0,0,0,0,0.00502941674601107,1.33573523546707,0.938906307319045
9.7,"eps_greedy_SVM","SVM",85,24,284,281,3,2500,2262,238,0.74726736390453,0.193333333333333,1.23251612903226,637,238,399,9,1.7,89.8,9.5,0,0,0,0,0,0,0.0043771371829133,1.62267653217584,1.34182503812759
9.7,"eps_greedy_SVM","SVM",85,25,184,184,0,2600,2359,241,0.813220702601228,0.306666666666667,1.24963440860215,636,241,395,-1,1.6,93.39,9.8,0,0,0,0,0,0,0.00044784921897408,0.199597966378038,0.185502741863364
9.7,"eps_greedy_SVM","SVM",85,26,84,84,0,2700,2459,241,0.809568248860283,0.28,1.2581935483871,655,241,414,19,1.7,96.98,10.2,0,0,0,0,0,0,5.41797073205932e-07,0.0392769138631989,0.0392769138631989
9.7,"eps_greedy_SVM","SVM",85,27,0,0,0,2784,2543,241,0.749852507374633,0.173333333333333,1.24963440860215,654,241,413,-1,1.7,100,10.6,0,0,0,0,0,0,0,0,0
9.7,"eps_greedy_SVM","SVM",86,0,2684,2439,245,100,91,9,0.739457901343624,0.328467153284672,1.19952907935013,23,9,14,0,1.6,3.59,10.1,0,0,0,0,0,0,0.213160326387336,233.116954659509,27.2201570336294
9.7,"eps_greedy_SVM","SVM",86,1,2584,2365,219,200,165,35,0.75006392672835,0.240875912408759,1.26512832587709,84,35,49,61,1.4,7.18,4.7,0,0,0,0,0,0,0.250905920172711,372.344289687072,29.3070718805815
9.7,"eps_greedy_SVM","SVM",86,2,2484,2287,197,300,243,57,0.744496489841463,0.226277372262774,1.26512832587709,147,57,90,63,1.6,10.78,4.3,0,0,0,0,0,0,0.21111750219078,387.278753659419,23.5371470088266
9.7,"eps_greedy_SVM","SVM",86,3,2384,2205,179,400,325,75,0.794028081268312,0.284671532846715,1.25575700494467,187,75,112,40,1.5,14.37,4.3,0,0,0,0,0,0,0.208582430172515,265.436752363158,21.8079315963469
9.7,"eps_greedy_SVM","SVM",86,4,2284,2114,170,500,416,84,0.80437839973965,0.27007299270073,1.25575700494467,223,84,139,36,1.7,17.96,5,0,0,0,0,0,0,0.186046332040847,215.493228787404,18.9761228483433
9.7,"eps_greedy_SVM","SVM",86,5,2184,2046,138,600,484,116,0.824956994746391,0.299270072992701,1.25575700494467,281,116,165,58,1.4,21.55,4.2,0,0,0,0,0,0,0.201838097331493,212.91887143366,20.6314790478242
9.7,"eps_greedy_SVM","SVM",86,6,2084,1980,104,700,550,150,0.832477102608219,0.35036496350365,1.25575700494467,369,150,219,88,1.5,25.14,3.7,0,0,0,0,0,0,0.214570852561077,225.998189486572,22.1732797424779
9.7,"eps_greedy_SVM","SVM",86,7,1984,1904,80,800,626,174,0.832058673113589,0.328467153284672,1.25575700494467,419,174,245,50,1.4,28.74,3.6,0,0,0,0,0,0,0.210002067695784,190.398873517013,21.8929265392004
9.7,"eps_greedy_SVM","SVM",86,8,1884,1817,67,900,713,187,0.834638988330477,0.313868613138686,1.25575700494467,461,187,274,42,1.5,32.33,3.8,0,0,0,0,0,0,0.20083792733491,222.106731061774,21.0808378971901
9.7,"eps_greedy_SVM","SVM",86,9,1784,1725,59,1000,805,195,0.83759705239668,0.35036496350365,1.25575700494467,479,195,284,18,1.5,35.92,4.1,0,0,0,0,0,0,0.166539023375175,112.947372768044,18.5940262614098
9.7,"eps_greedy_SVM","SVM",86,10,1684,1632,52,1100,898,202,0.836731135803623,0.313868613138686,1.25575700494467,488,202,286,9,1.4,39.51,4.4,0,0,0,0,0,0,0.147826113716739,91.6699145479029,15.8438064464608
9.7,"eps_greedy_SVM","SVM",86,11,1584,1543,41,1200,987,213,0.817640290111125,0.291970802919708,1.25575700494467,550,213,337,62,1.6,43.1,4.6,0,0,0,0,0,0,0.174748936495647,122.992465473583,18.1008718506228
9.7,"eps_greedy_SVM","SVM",86,12,1484,1450,34,1300,1080,220,0.792551954995593,0.211678832116788,1.25575700494467,576,220,356,26,1.6,46.7,4.9,0,0,0,0,0,0,0.159463651320688,104.843627353559,16.757236604237
9.7,"eps_greedy_SVM","SVM",86,13,1384,1353,31,1400,1177,223,0.806156725091831,0.204379562043796,1.25575700494467,583,223,360,7,1.6,50.29,5.3,0,0,0,0,0,0,0.118783436149784,50.3035445787793,13.4237717727634
9.7,"eps_greedy_SVM","SVM",86,14,1284,1260,24,1500,1270,230,0.796864103398588,0.226277372262774,1.25575700494467,620,230,390,37,1.7,53.88,5.5,0,0,0,0,0,0,0.138245954299039,66.9224357094262,14.5168252375859
9.7,"eps_greedy_SVM","SVM",86,15,1184,1162,22,1600,1368,232,0.821016783671962,0.255474452554745,1.25575700494467,617,232,385,-3,1.7,57.47,5.9,0,0,0,0,0,0,0.127651874192271,56.926877916915,13.3895836686238
9.7,"eps_greedy_SVM","SVM",86,16,1084,1062,22,1700,1468,232,0.800432377144461,0.248175182481752,1.25575700494467,624,232,392,7,1.7,61.06,6.3,0,0,0,0,0,0,0.117626873658477,49.5894007919884,12.4090047531478
9.7,"eps_greedy_SVM","SVM",86,17,984,962,22,1800,1568,232,0.790500488167755,0.226277372262774,1.25575700494467,618,232,386,-6,1.7,64.66,6.8,0,0,0,0,0,0,0.0891136599286879,26.0813476909808,9.88776542414578
9.7,"eps_greedy_SVM","SVM",86,18,884,864,20,1900,1666,234,0.797648658701019,0.226277372262774,1.25575700494467,626,234,392,8,1.7,68.25,7.1,0,0,0,0,0,0,0.034362271874178,7.05795840175287,5.20296480459505
9.7,"eps_greedy_SVM","SVM",86,19,784,766,18,2000,1764,236,0.815763168906049,0.277372262773723,1.25575700494467,620,236,384,-6,1.6,71.84,7.5,0,0,0,0,0,0,0.00158414386313892,1.82347668897495,1.78055627879939
9.7,"eps_greedy_SVM","SVM",86,20,684,669,15,2100,1861,239,0.822992700729935,0.291970802919708,1.25575700494467,634,239,395,14,1.7,75.43,7.8,0,0,0,0,0,0,6.01734307009666e-05,0.104806015726997,0.102223410022727
9.7,"eps_greedy_SVM","SVM",86,21,584,579,5,2200,1951,249,0.75154586452183,0.153284671532847,1.26512832587709,691,249,442,57,1.8,79.02,7.8,0,0,0,0,0,0,0.135185433408017,38.8206803815735,18.8677852787365
9.7,"eps_greedy_SVM","SVM",86,22,484,483,1,2300,2047,253,0.779603886745081,0.182481751824818,1.27449964680951,710,253,457,19,1.8,82.61,8.1,0,0,0,0,0,0,0.0794490953109312,21.7008867090007,10.020265586223
9.7,"eps_greedy_SVM","SVM",86,23,384,383,1,2400,2147,253,0.810341020038123,0.262773722627737,1.27449964680951,695,253,442,-15,1.7,86.21,8.5,0,0,0,0,0,0,0.0404310628656338,9.8314612773549,5.85968137403249
9.7,"eps_greedy_SVM","SVM",86,24,284,283,1,2500,2247,253,0.823091496582827,0.284671532846715,1.27449964680951,706,253,453,11,1.8,89.8,8.9,0,0,0,0,0,0,0.00687562655184374,1.91560372451702,1.59555140808467
9.7,"eps_greedy_SVM","SVM",86,25,184,183,1,2600,2347,253,0.771246919893995,0.167883211678832,1.27449964680951,701,253,448,-5,1.8,93.39,9.3,0,0,0,0,0,0,0.00101303662080873,0.609473557087074,0.578144354056969
9.7,"eps_greedy_SVM","SVM",86,26,84,84,0,2700,2446,254,0.798723790041379,0.182481751824818,1.27332607439072,706,254,452,5,1.8,96.98,9.6,0,0,0,0,0,0,6.02432363985689e-07,0.90132819924644,0.90132819924644
9.7,"eps_greedy_SVM","SVM",86,27,0,0,0,2784,2530,254,0.801060021386399,0.262773722627737,1.27449964680951,705,254,451,-1,1.8,100,10,0,0,0,0,0,0,0,0,0
9.7,"eps_greedy_SVM","SVM",87,0,2684,2439,245,100,95,5,0.838964040513903,0.24822695035461,1.28387096774194,22,5,17,0,3.4,3.59,19,0,0,0,0,0,0,0.0934053779978661,139.012605601764,10.7074727457377
9.7,"eps_greedy_SVM","SVM",87,1,2584,2360,224,200,174,26,0.802489067137971,0.226950354609929,1.28387096774194,74,26,48,52,1.8,7.18,6.7,0,0,0,0,0,0,0.181592200439514,234.094677820179,19.7893989938907
9.7,"eps_greedy_SVM","SVM",87,2,2484,2293,191,300,241,59,0.822740353023816,0.283687943262411,1.28387096774194,149,59,90,75,1.5,10.78,4.1,0,0,0,0,0,0,0.239006361364685,181.702655770776,25.4321880883764
9.7,"eps_greedy_SVM","SVM",87,3,2384,2217,167,400,317,83,0.8299854983799,0.283687943262411,1.28387096774194,206,83,123,57,1.5,14.37,3.8,0,0,0,0,0,0,0.219612686517376,146.661911254807,23.8648929569613
9.7,"eps_greedy_SVM","SVM",87,4,2284,2143,141,500,391,109,0.838176647859881,0.312056737588652,1.28387096774194,271,109,162,65,1.5,17.96,3.6,0,0,0,0,0,0,0.227948811443076,134.403823782072,25.5542426776687
9.7,"eps_greedy_SVM","SVM",87,5,2184,2069,115,600,465,135,0.840703101987176,0.319148936170213,1.28387096774194,327,135,192,56,1.4,21.55,3.4,0,0,0,0,0,0,0.201269684143158,93.0652693400286,22.9904135014208
9.7,"eps_greedy_SVM","SVM",87,6,2084,1996,88,700,538,162,0.82992318673102,0.304964539007092,1.28387096774194,406,162,244,79,1.5,25.14,3.3,0,0,0,0,0,0,0.209098620106312,178.607912113858,22.7339231960505
9.7,"eps_greedy_SVM","SVM",87,7,1984,1908,76,800,626,174,0.804165816962364,0.283687943262411,1.21102722489133,440,174,266,34,1.5,28.74,3.6,0,0,0,0,0,0,0.208095614172221,183.470609014981,24.9487123797528
9.7,"eps_greedy_SVM","SVM",87,8,1884,1824,60,900,710,190,0.792156662814686,0.226950354609929,1.22923816060398,469,190,279,29,1.5,32.33,3.7,0,0,0,0,0,0,0.210968034433044,259.17562933976,31.7920293141152
9.7,"eps_greedy_SVM","SVM",87,9,1784,1730,54,1000,804,196,0.819245235991218,0.269503546099291,1.23834362846031,490,196,294,21,1.5,35.92,4.1,0,0,0,0,0,0,0.182313907011463,123.757222296153,19.1654522900275
9.7,"eps_greedy_SVM","SVM",87,10,1684,1643,41,1100,891,209,0.829124464686299,0.312056737588652,1.23834362846031,527,209,318,37,1.5,39.51,4.3,0,0,0,0,0,0,0.183178073554247,94.1282356860774,19.8518251871598
9.7,"eps_greedy_SVM","SVM",87,11,1584,1559,25,1200,975,225,0.809388666077548,0.283687943262411,1.23834362846031,587,225,362,60,1.6,43.1,4.3,0,0,0,0,0,0,0.17135827706075,109.425558847352,18.449633531166
9.7,"eps_greedy_SVM","SVM",87,12,1484,1462,22,1300,1072,228,0.812781818593805,0.297872340425532,1.23834362846031,597,228,369,10,1.6,46.7,4.7,0,0,0,0,0,0,0.1412645139547,79.4203397966043,15.1138134091647
9.7,"eps_greedy_SVM","SVM",87,13,1384,1363,21,1400,1171,229,0.809909818049995,0.24822695035461,1.23834362846031,605,229,376,8,1.6,50.29,5.1,0,0,0,0,0,0,0.121281382015998,70.279381475079,13.1505766868311
9.7,"eps_greedy_SVM","SVM",87,14,1284,1266,18,1500,1268,232,0.792938390773355,0.234042553191489,1.22013269274766,610,232,378,5,1.6,53.88,5.5,0,0,0,0,0,0,0.112017766860019,55.6515639709581,13.9639209733131
9.7,"eps_greedy_SVM","SVM",87,15,1184,1167,17,1600,1367,233,0.790853782883565,0.24113475177305,1.22013269274766,611,233,378,1,1.6,57.47,5.9,0,0,0,0,0,0,0.102814901518955,52.0423833624828,12.3582535963894
9.7,"eps_greedy_SVM","SVM",87,16,1084,1068,16,1700,1466,234,0.804041193664611,0.283687943262411,1.22013269274766,618,234,384,7,1.6,61.06,6.3,0,0,0,0,0,0,0.0931545103869307,45.7264800491396,10.6246922394757
9.7,"eps_greedy_SVM","SVM",87,17,984,968,16,1800,1566,234,0.79933383182653,0.26241134751773,1.22013269274766,614,234,380,-4,1.6,64.66,6.7,0,0,0,0,0,0,0.0490282567137784,17.5842635176064,6.13253844250761
9.7,"eps_greedy_SVM","SVM",87,18,884,869,15,1900,1665,235,0.802981895633658,0.283687943262411,1.22013269274766,614,235,379,0,1.6,68.25,7.1,0,0,0,0,0,0,0.0423788566005653,14.571064235448,5.087830225466
9.7,"eps_greedy_SVM","SVM",87,19,784,769,15,2000,1765,235,0.78255500419188,0.234042553191489,1.22013269274766,620,235,385,6,1.6,71.84,7.5,0,0,0,0,0,0,0.0242360113560604,7.5662896676466,3.31323265426436
9.7,"eps_greedy_SVM","SVM",87,20,684,670,14,2100,1864,236,0.797181247592508,0.226950354609929,1.22013269274766,620,236,384,0,1.6,75.43,7.9,0,0,0,0,0,0,0.00599598864804541,1.52259517579281,1.03688763464788
9.7,"eps_greedy_SVM","SVM",87,21,584,571,13,2200,1963,237,0.803927899757556,0.283687943262411,1.22013269274766,620,237,383,0,1.6,79.02,8.3,0,0,0,0,0,0,0.00936225661847629,2.50201647479567,1.32097411477549
9.7,"eps_greedy_SVM","SVM",87,22,484,474,10,2300,2060,240,0.734586363945354,0.163120567375887,1.21102722489133,647,240,407,27,1.7,82.61,8.6,0,0,0,0,0,0,0.0557473346464053,16.0621855416564,9.45501742055068
9.7,"eps_greedy_SVM","SVM",87,23,384,375,9,2400,2159,241,0.773525479799707,0.205673758865248,1.22013269274766,652,241,411,5,1.7,86.21,9,0,0,0,0,0,0,0.00711398848738935,3.80137371582218,3.36081050727168
9.7,"eps_greedy_SVM","SVM",87,24,284,276,8,2500,2258,242,0.740681576144841,0.148936170212766,1.21102722489133,658,242,416,6,1.7,89.8,9.3,0,0,0,0,0,0,0.0139368513642346,3.37411953874022,1.9987871337516
9.7,"eps_greedy_SVM","SVM",87,25,184,181,3,2600,2353,247,0.739559966465009,0.127659574468085,1.23834362846031,689,247,442,31,1.8,93.39,9.5,0,0,0,0,0,0,0.0105654816846707,3.88647149567605,3.61438144101982
9.7,"eps_greedy_SVM","SVM",87,26,84,84,0,2700,2450,250,0.75461672671244,0.170212765957447,1.26566003202928,692,250,442,3,1.8,96.98,9.8,0,0,0,0,0,0,4.45583269332134e-07,0.26607512945201,0.26607512945201
9.7,"eps_greedy_SVM","SVM",87,27,0,0,0,2784,2534,250,0.742137402850479,0.141843971631206,1.26566003202928,698,250,448,6,1.8,100,10.1,0,0,0,0,0,0,0,0,0
9.7,"eps_greedy_SVM","SVM",88,0,2684,2437,247,100,91,9,0.296543602425955,0,0.884444444444444,30,9,21,0,2.3,3.59,10.1,0,0,0,0,0,0,0.10722181476408,231.407978443099,11.0637891066331
9.7,"eps_greedy_SVM","SVM",88,1,2584,2337,247,200,191,9,0.695701583936878,0.103703703703704,1.26485065710872,33,9,24,3,2.7,7.18,21.2,0,0,0,0,0,0,0.0572853092526618,134.185033222805,6.89061047046328
9.7,"eps_greedy_SVM","SVM",88,2,2484,2246,238,300,282,18,0.633892716245656,0.155555555555556,1.22681003584229,68,18,50,35,2.8,10.78,15.7,0,0,0,0,0,0,0.0917912061307338,189.363436049637,9.61379776934611
9.7,"eps_greedy_SVM","SVM",88,3,2384,2160,224,400,368,32,0.645969498910679,0.162962962962963,1.17925925925926,97,32,65,29,2,14.37,11.5,0,0,0,0,0,0,0.116180948326665,195.933815915621,13.9490483977925
9.7,"eps_greedy_SVM","SVM",88,4,2284,2070,214,500,458,42,0.749991167638234,0.259259259259259,1.16974910394265,125,42,83,28,2,17.96,10.9,0,0,0,0,0,0,0.106406019026318,176.028825357959,11.1885642291536
9.7,"eps_greedy_SVM","SVM",88,5,2184,2004,180,600,524,76,0.75267620561739,0.237037037037037,1.19827956989247,203,76,127,78,1.7,21.55,6.9,0,0,0,0,0,0,0.152318873367963,207.044852116707,15.7457782598678
9.7,"eps_greedy_SVM","SVM",88,6,2084,1924,160,700,604,96,0.740269681446161,0.244444444444444,1.17925925925926,253,96,157,50,1.6,25.14,6.3,0,0,0,0,0,0,0.15421588904244,169.484327415009,16.0753875897308
9.7,"eps_greedy_SVM","SVM",88,7,1984,1840,144,800,688,112,0.766678443149041,0.288888888888889,1.19827956989247,285,112,173,32,1.5,28.74,6.1,0,0,0,0,0,0,0.164296637588249,174.657687922809,16.9205072920706
9.7,"eps_greedy_SVM","SVM",88,8,1884,1768,116,900,760,140,0.774992639698534,0.296296296296296,1.18876941457587,343,140,203,58,1.4,32.33,5.4,0,0,0,0,0,0,0.177268830827187,152.886004780339,18.3816671499292
9.7,"eps_greedy_SVM","SVM",88,9,1784,1691,93,1000,837,163,0.772549019607854,0.281481481481481,1.19827956989247,409,163,246,66,1.5,35.92,5.1,0,0,0,0,0,0,0.165901539545051,121.589806340379,17.7896038000092
9.7,"eps_greedy_SVM","SVM",88,10,1684,1620,64,1100,908,192,0.775222281104642,0.296296296296296,1.19827956989247,475,192,283,66,1.5,39.51,4.7,0,0,0,0,0,0,0.180547004154441,157.018473311618,19.1059147177807
9.7,"eps_greedy_SVM","SVM",88,11,1584,1529,55,1200,999,201,0.767867867867879,0.303703703703704,1.17925925925926,512,201,311,37,1.5,43.1,5,0,0,0,0,0,0,0.167198965879801,127.221135898516,18.0303149356774
9.7,"eps_greedy_SVM","SVM",88,12,1484,1434,50,1300,1094,206,0.763098392510164,0.274074074074074,1.18876941457587,521,206,315,9,1.5,46.7,5.3,0,0,0,0,0,0,0.144714992284132,86.3590790897978,15.4507358774916
9.7,"eps_greedy_SVM","SVM",88,13,1384,1343,41,1400,1185,215,0.776653123711957,0.244444444444444,1.20778972520908,549,215,334,28,1.6,50.29,5.5,0,0,0,0,0,0,0.139213105789221,76.5338122169298,18.8852222540685
9.7,"eps_greedy_SVM","SVM",88,14,1284,1249,35,1500,1279,221,0.793416946358133,0.266666666666667,1.20778972520908,576,221,355,27,1.6,53.88,5.8,0,0,0,0,0,0,0.138633455002696,77.5954176885644,15.0968628665256
9.7,"eps_greedy_SVM","SVM",88,15,1184,1170,14,1600,1358,242,0.756073720779615,0.185185185185185,1.18876941457587,635,242,393,59,1.6,57.47,5.6,0,0,0,0,0,0,0.142649428794016,85.0726622968884,15.4169154960481
9.7,"eps_greedy_SVM","SVM",88,16,1084,1072,12,1700,1456,244,0.780562915857042,0.251851851851852,1.18876941457587,656,244,412,21,1.7,61.06,6,0,0,0,0,0,0,0.109812655061197,55.8915778551398,12.0781650183394
9.7,"eps_greedy_SVM","SVM",88,17,984,973,11,1800,1555,245,0.777748336571875,0.22962962962963,1.18876941457587,652,245,407,-4,1.7,64.66,6.3,0,0,0,0,0,0,0.103327009741337,51.9405514549047,11.2443517146411
9.7,"eps_greedy_SVM","SVM",88,18,884,873,11,1900,1655,245,0.760307366189727,0.177777777777778,1.18876941457587,653,245,408,1,1.7,68.25,6.8,0,0,0,0,0,0,0.0899887216545713,43.5503268552429,9.80548759396578
9.7,"eps_greedy_SVM","SVM",88,19,784,773,11,2000,1755,245,0.740063593004777,0.214814814814815,1.18876941457587,642,245,397,-11,1.6,71.84,7.2,0,0,0,0,0,0,0.0757717898472839,31.6788881070005,8.5943928561062
9.7,"eps_greedy_SVM","SVM",88,20,684,674,10,2100,1854,246,0.7607843137255,0.22962962962963,1.20778972520908,657,246,411,15,1.7,75.43,7.5,0,0,0,0,0,0,0.0304230932471596,9.52457125525692,3.87976340382478
9.7,"eps_greedy_SVM","SVM",88,21,584,574,10,2200,1954,246,0.750161926632525,0.192592592592593,1.18876941457587,645,246,399,-12,1.6,79.02,7.9,0,0,0,0,0,0,0.0137905854094923,3.34262654481112,1.91582148398655
9.7,"eps_greedy_SVM","SVM",88,22,484,476,8,2300,2052,248,0.747694753577112,0.222222222222222,1.20778972520908,670,248,422,25,1.7,82.61,8.3,0,0,0,0,0,0,0.0336044654532402,10.1196497984373,5.09962716310399
9.7,"eps_greedy_SVM","SVM",88,23,384,377,7,2400,2151,249,0.726762056173819,0.17037037037037,1.22681003584229,680,249,431,10,1.7,86.21,8.6,0,0,0,0,0,0,0.0367127254813213,10.5951184005262,5.19065930380883
9.7,"eps_greedy_SVM","SVM",88,24,284,277,7,2500,2251,249,0.806485897662374,0.311111111111111,1.22568037650911,678,249,429,-2,1.7,89.8,9,0,0,0,0,0,0,0.00528591853366638,1.16651761178188,0.89348669002321
9.7,"eps_greedy_SVM","SVM",88,25,184,178,6,2600,2350,250,0.72755696873344,0.17037037037037,1.2363201911589,685,250,435,7,1.7,93.39,9.4,0,0,0,0,0,0,0.0147147671925624,3.31769861396135,2.55351306843869
9.7,"eps_greedy_SVM","SVM",88,26,84,84,0,2700,2444,256,0.747700641818297,0.162962962962963,1.27436081242533,692,256,436,7,1.7,96.98,9.5,0,0,0,0,0,0,6.01346712217033e-06,1.24513960581506,1.24513960581506
9.7,"eps_greedy_SVM","SVM",88,27,0,0,0,2784,2528,256,0.750927397986228,0.2,1.26485065710872,700,256,444,8,1.7,100,9.9,0,0,0,0,0,0,0,0,0
9.7,"eps_greedy_SVM","SVM",89,0,2684,2437,247,100,89,11,0.69630624179497,0.195488721804511,1.21629881154499,33,11,22,0,2,3.59,8.1,0,0,0,0,0,0,0.129434996114944,292.172427764419,15.586278279601
9.7,"eps_greedy_SVM","SVM",89,1,2584,2342,242,200,184,16,0.703526673827431,0.24812030075188,1.21629881154499,49,16,33,16,2.1,7.18,11.5,0,0,0,0,0,0,0.112755837368007,235.161668793361,12.3657309934936
9.7,"eps_greedy_SVM","SVM",89,2,2484,2265,219,300,261,39,0.627527151211367,0.195488721804511,1.12942032500606,105,39,66,56,1.7,10.78,6.7,0,0,0,0,0,0,0.140094057744901,313.977534774417,14.5894063441708
9.7,"eps_greedy_SVM","SVM",89,3,2384,2181,203,400,345,55,0.706593865616424,0.150375939849624,1.21629881154499,156,55,101,51,1.8,14.37,6.3,0,0,0,0,0,0,0.178618053484933,292.326407426988,22.8580258907266
9.7,"eps_greedy_SVM","SVM",89,4,2284,2091,193,500,435,65,0.724251103950354,0.218045112781955,1.21629881154499,172,65,107,16,1.6,17.96,6.7,0,0,0,0,0,0,0.152507325245909,233.443406723393,16.1898979036113
9.7,"eps_greedy_SVM","SVM",89,5,2184,2017,167,600,509,91,0.734473087480613,0.225563909774436,1.21629881154499,233,91,142,61,1.6,21.55,5.6,0,0,0,0,0,0,0.169089676430495,282.167268110755,17.1376187666902
9.7,"eps_greedy_SVM","SVM",89,6,2084,1930,154,700,596,104,0.752225802601746,0.225563909774436,1.22595197671598,267,104,163,34,1.6,25.14,5.7,0,0,0,0,0,0,0.159098925487375,188.776658672913,16.3309038252885
9.7,"eps_greedy_SVM","SVM",89,7,1984,1853,131,800,673,127,0.761146914906319,0.293233082706767,1.23560514188698,330,127,203,63,1.6,28.74,5.3,0,0,0,0,0,0,0.165640187861463,181.341795910384,17.1470776099725
9.7,"eps_greedy_SVM","SVM",89,8,1884,1767,117,900,759,141,0.780683852488368,0.308270676691729,1.23560514188698,359,141,218,29,1.5,32.33,5.4,0,0,0,0,0,0,0.152185229470629,135.661138692553,16.1232537861602
9.7,"eps_greedy_SVM","SVM",89,9,1784,1687,97,1000,839,161,0.780134860961936,0.300751879699248,1.21629881154499,395,161,234,36,1.5,35.92,5.2,0,0,0,0,0,0,0.159392372441908,135.729299295707,16.6548153749766
9.7,"eps_greedy_SVM","SVM",89,10,1684,1608,76,1100,918,182,0.795261964434898,0.300751879699248,1.22595197671598,465,182,283,70,1.6,39.51,5,0,0,0,0,0,0,0.166743200419124,111.694478230844,17.7027376135963
9.7,"eps_greedy_SVM","SVM",89,11,1584,1531,53,1200,995,205,0.802142260412941,0.285714285714286,1.206645646374,527,205,322,62,1.6,43.1,4.9,0,0,0,0,0,0,0.162165301142314,104.879820437782,17.1009751832996
9.7,"eps_greedy_SVM","SVM",89,12,1484,1437,47,1300,1089,211,0.778452082587425,0.233082706766917,1.206645646374,547,211,336,20,1.6,46.7,5.2,0,0,0,0,0,0,0.143285163426015,79.9636988599298,16.3648259838313
9.7,"eps_greedy_SVM","SVM",89,13,1384,1349,35,1400,1177,223,0.797463897839841,0.293233082706767,1.206645646374,590,223,367,43,1.6,50.29,5.3,0,0,0,0,0,0,0.135102586788582,72.9583629264484,15.0605333976285
9.7,"eps_greedy_SVM","SVM",89,14,1284,1256,28,1500,1270,230,0.792391693519516,0.263157894736842,1.19699248120301,614,230,384,24,1.7,53.88,5.5,0,0,0,0,0,0,0.148977812397325,136.878809150361,15.2510294919358
9.7,"eps_greedy_SVM","SVM",89,15,1184,1162,22,1600,1364,236,0.79510681465569,0.293233082706767,1.19699248120301,632,236,396,18,1.7,57.47,5.8,0,0,0,0,0,0,0.136702181990238,108.007269592277,14.1901266123536
9.7,"eps_greedy_SVM","SVM",89,16,1084,1062,22,1700,1464,236,0.802464494569759,0.308270676691729,1.19699248120301,631,236,395,-1,1.7,61.06,6.2,0,0,0,0,0,0,0.0757340653319229,30.9299101286107,8.58801065321919
9.7,"eps_greedy_SVM","SVM",89,17,984,962,22,1800,1564,236,0.792284282133908,0.255639097744361,1.206645646374,636,236,400,5,1.7,64.66,6.6,0,0,0,0,0,0,0.0413580036753002,13.0722998698251,5.39718106746071
9.7,"eps_greedy_SVM","SVM",89,18,884,862,22,1900,1664,236,0.801843895452922,0.315789473684211,1.19699248120301,638,236,402,2,1.7,68.25,7.1,0,0,0,0,0,0,0.0923321181855856,54.7337549886701,9.77243507030209
9.7,"eps_greedy_SVM","SVM",89,19,784,762,22,2000,1764,236,0.79825754863349,0.300751879699248,1.19699248120301,635,236,399,-3,1.7,71.84,7.5,0,0,0,0,0,0,0.0622056787159513,28.8982995357843,7.02047321457688
9.7,"eps_greedy_SVM","SVM",89,20,684,664,20,2100,1862,238,0.779609738632302,0.233082706766917,1.19699248120301,630,238,392,-5,1.6,75.43,7.8,0,0,0,0,0,0,0.0190887659924017,6.64148095545313,3.79577267966088
9.7,"eps_greedy_SVM","SVM",89,21,584,565,19,2200,1961,239,0.759553646019813,0.218045112781955,1.21629881154499,657,239,418,27,1.7,79.02,8.2,0,0,0,0,0,0,0.0101070175999186,3.09269328146327,1.77467556977498
9.7,"eps_greedy_SVM","SVM",89,22,484,468,16,2300,2058,242,0.810401002506267,0.278195488721804,1.26456463739995,675,242,433,18,1.8,82.61,8.5,0,0,0,0,0,0,0.0464923969246277,15.0807490206311,7.3567933448396
9.7,"eps_greedy_SVM","SVM",89,23,384,380,4,2400,2146,254,0.815831244778613,0.270676691729323,1.27421780257094,705,254,451,30,1.8,86.21,8.4,0,0,0,0,0,0,0.00243364221150142,1.99204335272679,1.75608800884245
9.7,"eps_greedy_SVM","SVM",89,24,284,283,1,2500,2243,257,0.821834347774201,0.270676691729323,1.27421780257094,715,257,458,10,1.8,89.8,8.7,0,0,0,0,0,0,0.000896443930527302,2.90220878937607,2.84637610916963
9.7,"eps_greedy_SVM","SVM",89,25,184,183,1,2600,2343,257,0.822437044993438,0.24812030075188,1.27421780257094,711,257,454,-4,1.8,93.39,9.1,0,0,0,0,0,0,4.14460037400928e-06,0.0100956017734508,0.0099973960191654
9.7,"eps_greedy_SVM","SVM",89,26,84,84,0,2700,2442,258,0.804433703305883,0.195488721804511,1.26456463739995,713,258,455,2,1.8,96.98,9.5,0,0,0,0,0,0,1.29765271951498e-06,0.705743197479619,0.705743197479619
9.7,"eps_greedy_SVM","SVM",89,27,0,0,0,2784,2526,258,0.780128893662731,0.218045112781955,1.27421780257094,704,258,446,-9,1.7,100,9.8,0,0,0,0,0,0,0,0,0
9.7,"eps_greedy_SVM","SVM",90,0,2684,2418,266,100,93,7,0.824858757062151,0.279661016949153,1.26211044286495,23,7,16,0,2.3,3.59,13.3,0,0,0,0,0,0,0.0978941574623581,203.531775235108,11.4816408242051
9.7,"eps_greedy_SVM","SVM",90,1,2584,2344,240,200,167,33,0.819853772017287,0.211864406779661,1.26211044286495,87,33,54,64,1.6,7.18,5.1,0,0,0,0,0,0,0.183400684646219,383.801938862464,19.3175156600585
9.7,"eps_greedy_SVM","SVM",90,2,2484,2262,222,300,249,51,0.82227318045863,0.23728813559322,1.25123018042646,137,51,86,50,1.7,10.78,4.9,0,0,0,0,0,0,0.199051488299394,177.169388612968,21.4608645016938
9.7,"eps_greedy_SVM","SVM",90,3,2384,2192,192,400,319,81,0.816869391824534,0.245762711864407,1.24034991798797,197,81,116,60,1.4,14.37,3.9,0,0,0,0,0,0,0.209522915534088,166.182116972608,22.213795166059
9.7,"eps_greedy_SVM","SVM",90,4,2284,2135,149,500,376,124,0.808667331339322,0.26271186440678,1.24034991798797,286,124,162,89,1.3,17.96,3,0,0,0,0,0,0,0.226952399804584,241.347928585744,24.0359467505941
9.7,"eps_greedy_SVM","SVM",90,5,2184,2063,121,600,448,152,0.80498504486541,0.23728813559322,1.24034991798797,357,152,205,71,1.3,21.55,2.9,0,0,0,0,0,0,0.239379924257703,182.649367112174,25.1531091892556
9.7,"eps_greedy_SVM","SVM",90,6,2084,1977,107,700,534,166,0.805948820206055,0.203389830508475,1.26211044286495,400,166,234,43,1.4,25.14,3.2,0,0,0,0,0,0,0.205065726014152,124.636990786235,22.6040159759855
9.7,"eps_greedy_SVM","SVM",90,7,1984,1901,83,800,610,190,0.809099368560991,0.23728813559322,1.25123018042646,451,190,261,51,1.4,28.74,3.2,0,0,0,0,0,0,0.199448584537774,145.42526309413,22.5032337986671
9.7,"eps_greedy_SVM","SVM",90,8,1884,1828,56,900,683,217,0.815942173479568,0.220338983050847,1.22833754721104,514,217,297,63,1.4,32.33,3.1,0,0,0,0,0,0,0.225604799687107,214.367887146166,24.9976034564659
9.7,"eps_greedy_SVM","SVM",90,9,1784,1734,50,1000,777,223,0.815659687603861,0.220338983050847,1.26211044286495,535,223,312,21,1.4,35.92,3.5,0,0,0,0,0,0,0.193727685495411,125.024106143469,20.3875994691215
9.7,"eps_greedy_SVM","SVM",90,10,1684,1650,34,1100,861,239,0.807637088733806,0.203389830508475,1.22946965554948,596,239,357,61,1.5,39.51,3.6,0,0,0,0,0,0,0.195573377193307,156.987344678595,20.6482867027284
9.7,"eps_greedy_SVM","SVM",90,11,1584,1557,27,1200,954,246,0.819408441342647,0.23728813559322,1.22946965554948,611,246,365,15,1.5,43.1,3.9,0,0,0,0,0,0,0.168319851423298,125.505546267308,18.0222414054511
9.7,"eps_greedy_SVM","SVM",90,12,1484,1460,24,1300,1051,249,0.82075772681955,0.211864406779661,1.22946965554948,606,249,357,-5,1.4,46.7,4.2,0,0,0,0,0,0,0.135510217568652,88.0121895152025,15.0704874381659
9.7,"eps_greedy_SVM","SVM",90,13,1384,1362,22,1400,1149,251,0.818464606181464,0.228813559322034,1.24034991798797,626,251,375,20,1.5,50.29,4.6,0,0,0,0,0,0,0.120583899848601,47.0910504956117,13.9779777856067
9.7,"eps_greedy_SVM","SVM",90,14,1284,1264,20,1500,1247,253,0.797314722499179,0.169491525423729,1.21858939311099,640,253,387,14,1.5,53.88,4.9,0,0,0,0,0,0,0.12847870880059,48.3034815186089,15.4779335109495
9.7,"eps_greedy_SVM","SVM",90,15,1184,1166,18,1600,1345,255,0.778271851113336,0.152542372881356,1.21858939311099,638,255,383,-2,1.5,57.47,5.3,0,0,0,0,0,0,0.118029912112451,45.8175586895215,15.6244663407687
9.7,"eps_greedy_SVM","SVM",90,16,1084,1066,18,1700,1445,255,0.812502492522443,0.220338983050847,1.21858939311099,665,255,410,27,1.6,61.06,5.7,0,0,0,0,0,0,0.0869414348142449,30.5634836338643,9.90137673281795
9.7,"eps_greedy_SVM","SVM",90,17,984,966,18,1800,1545,255,0.789651046859431,0.152542372881356,1.21858939311099,659,255,404,-6,1.6,64.66,6.1,0,0,0,0,0,0,0.0562688093113631,15.7068359740473,6.62076983366726
9.7,"eps_greedy_SVM","SVM",90,18,884,868,16,1900,1643,257,0.777008973080767,0.152542372881356,1.21858939311099,661,257,404,2,1.6,68.25,6.4,0,0,0,0,0,0,0.0595865838854868,15.9874687863507,7.2684421247893
9.7,"eps_greedy_SVM","SVM",90,19,784,770,14,2000,1741,259,0.797700232635437,0.177966101694915,1.21858939311099,659,259,400,-2,1.5,71.84,6.7,0,0,0,0,0,0,0.021534336689179,7.61040050020581,3.31985485928824
9.7,"eps_greedy_SVM","SVM",90,20,684,671,13,2100,1840,260,0.786128281821212,0.169491525423729,1.21858939311099,669,260,409,10,1.6,75.43,7.1,0,0,0,0,0,0,0.00413514868027593,1.2706280784379,0.821729422540422
9.7,"eps_greedy_SVM","SVM",90,21,584,575,9,2200,1936,264,0.800870721169833,0.228813559322034,1.21858939311099,688,264,424,19,1.6,79.02,7.3,0,0,0,0,0,0,0.0258266971951864,8.38825114594199,4.27002284830492
9.7,"eps_greedy_SVM","SVM",90,22,484,475,9,2300,2036,264,0.819793951478906,0.254237288135593,1.21858939311099,701,264,437,13,1.7,82.61,7.7,0,0,0,0,0,0,0.014636651511686,4.25004548557684,2.07973750039794
9.7,"eps_greedy_SVM","SVM",90,23,384,376,8,2400,2135,265,0.780677966101703,0.169491525423729,1.22946965554948,683,265,418,-18,1.6,86.21,8.1,0,0,0,0,0,0,0.00946703482842574,2.7828833489873,1.58319834068502
9.7,"eps_greedy_SVM","SVM",90,24,284,282,2,2500,2229,271,0.745875706214694,0.11864406779661,1.25123018042646,719,271,448,36,1.7,89.8,8.2,0,0,0,0,0,0,0.00166136935696001,3.27799898170308,3.18826396873572
9.7,"eps_greedy_SVM","SVM",90,25,184,184,0,2600,2327,273,0.826188102359594,0.245762711864407,1.25123018042646,735,273,462,16,1.7,93.39,8.5,0,0,0,0,0,0,0.00476230405428071,1.11152830459345,0.899956349527052
9.7,"eps_greedy_SVM","SVM",90,26,84,84,0,2700,2427,273,0.802286473911603,0.152542372881356,1.25123018042646,720,273,447,-15,1.6,96.98,8.9,0,0,0,0,0,0,6.82476637015626e-07,0.0194745926028679,0.0194745926028679
9.7,"eps_greedy_SVM","SVM",90,27,0,0,0,2784,2511,273,0.809132602193424,0.228813559322034,1.28387096774194,732,273,459,12,1.7,100,9.2,0,0,0,0,0,0,0,0,0
9.7,"eps_greedy_SVM","SVM",91,0,2684,2431,253,100,94,6,0.86156970177587,0.371212121212121,1.27414467253177,20,6,14,0,2.3,3.59,15.7,0,0,0,0,0,0,0.0766689241228643,157.99534934362,8.01789491374241
9.7,"eps_greedy_SVM","SVM",91,1,2584,2366,218,200,159,41,0.817797322951954,0.303030303030303,1.25469208211144,102,41,61,82,1.5,7.18,3.9,0,0,0,0,0,0,0.275151516400541,373.531690804515,31.9894631523213
9.7,"eps_greedy_SVM","SVM",91,2,2484,2291,193,300,234,66,0.769014490663975,0.242424242424242,1.17688172043011,165,66,99,63,1.5,10.78,3.5,0,0,0,0,0,0,0.22409204458391,476.292750199379,23.66372482494
9.7,"eps_greedy_SVM","SVM",91,3,2384,2202,182,400,323,77,0.794102804412088,0.340909090909091,1.18660801564027,193,77,116,28,1.5,14.37,4.2,0,0,0,0,0,0,0.213988031237635,293.851068911403,22.3519855830766
9.7,"eps_greedy_SVM","SVM",91,4,2284,2125,159,500,400,100,0.799263451325311,0.325757575757576,1.20606060606061,243,100,143,50,1.4,17.96,4,0,0,0,0,0,0,0.211067888640469,211.409438882403,21.765843062385
9.7,"eps_greedy_SVM","SVM",91,5,2184,2051,133,600,474,126,0.797190781726863,0.318181818181818,1.20606060606061,311,126,185,68,1.5,21.55,3.8,0,0,0,0,0,0,0.217592247655551,275.973351914945,22.0381119770801
9.7,"eps_greedy_SVM","SVM",91,6,2084,1980,104,700,545,155,0.798746785860185,0.318181818181818,1.19633431085044,388,155,233,77,1.5,25.14,3.5,0,0,0,0,0,0,0.233482327068199,233.705018245334,23.7479521757426
9.7,"eps_greedy_SVM","SVM",91,7,1984,1911,73,800,614,186,0.789687117006703,0.310606060606061,1.19633431085044,454,186,268,66,1.4,28.74,3.3,0,0,0,0,0,0,0.242083490201166,187.592059817884,24.8200642943284
9.7,"eps_greedy_SVM","SVM",91,8,1884,1826,58,900,699,201,0.785559801023716,0.257575757575758,1.19633431085044,503,201,302,49,1.5,32.33,3.5,0,0,0,0,0,0,0.22701146617165,174.402640822739,23.7703910740914
9.7,"eps_greedy_SVM","SVM",91,9,1784,1732,52,1000,793,207,0.790594285439646,0.303030303030303,1.22551319648094,522,207,315,19,1.5,35.92,3.8,0,0,0,0,0,0,0.18860578550561,123.38056769171,19.9004589623503
9.7,"eps_greedy_SVM","SVM",91,10,1684,1640,44,1100,885,215,0.790143705092157,0.272727272727273,1.21578690127077,534,215,319,12,1.5,39.51,4.1,0,0,0,0,0,0,0.187151603182438,153.862869885892,19.4154281467334
9.7,"eps_greedy_SVM","SVM",91,11,1584,1548,36,1200,977,223,0.798542522769325,0.325757575757576,1.21578690127077,561,223,338,27,1.5,43.1,4.4,0,0,0,0,0,0,0.156440721586254,73.2362400585272,17.1064577670731
9.7,"eps_greedy_SVM","SVM",91,12,1484,1456,28,1300,1069,231,0.789338668204646,0.265151515151515,1.21578690127077,613,231,382,52,1.7,46.7,4.6,0,0,0,0,0,0,0.122768879641662,39.6180226850887,14.5584633926121
9.7,"eps_greedy_SVM","SVM",91,13,1384,1358,26,1400,1167,233,0.798842909667655,0.303030303030303,1.21578690127077,595,233,362,-18,1.6,50.29,5,0,0,0,0,0,0,0.114762820964054,48.1081912884957,12.8250320613412
9.7,"eps_greedy_SVM","SVM",91,14,1284,1260,24,1500,1265,235,0.793261721096773,0.310606060606061,1.20606060606061,593,235,358,-2,1.5,53.88,5.4,0,0,0,0,0,0,0.117455472586098,42.7164274768767,13.7076924043639
9.7,"eps_greedy_SVM","SVM",91,15,1184,1160,24,1600,1365,235,0.794727609160602,0.333333333333333,1.20606060606061,629,235,394,36,1.7,57.47,5.8,0,0,0,0,0,0,0.0373677985868545,9.73638703179345,5.83862446441937
9.7,"eps_greedy_SVM","SVM",91,16,1084,1062,22,1700,1463,237,0.800801432244732,0.378787878787879,1.17688172043011,619,237,382,-10,1.6,61.06,6.2,0,0,0,0,0,0,0.0289641192487523,8.08116852079621,4.84448894808626
9.7,"eps_greedy_SVM","SVM",91,17,984,965,19,1800,1560,240,0.771699949535009,0.25,1.14770283479961,638,240,398,19,1.7,64.66,6.5,0,0,0,0,0,0,0.103505894242971,34.6387963945194,13.7869115314227
9.7,"eps_greedy_SVM","SVM",91,18,884,865,19,1900,1660,240,0.778993343426339,0.303030303030303,1.15742913000977,633,240,393,-5,1.6,68.25,6.9,0,0,0,0,0,0,0.0266412833951356,7.98691454521799,5.05590738429981
9.7,"eps_greedy_SVM","SVM",91,19,784,766,18,2000,1759,241,0.776914666089929,0.287878787878788,1.15742913000977,644,241,403,11,1.7,71.84,7.3,0,0,0,0,0,0,0.0137610959921873,3.68245838978454,2.23231851447963
9.7,"eps_greedy_SVM","SVM",91,20,684,666,18,2100,1859,241,0.78062144041526,0.303030303030303,1.15742913000977,633,241,392,-11,1.6,75.43,7.7,0,0,0,0,0,0,0.0049389268484076,1.39066696615908,0.95826493993179
9.7,"eps_greedy_SVM","SVM",91,21,584,567,17,2200,1958,242,0.79035397592099,0.348484848484849,1.15742913000977,649,242,407,16,1.7,79.02,8.1,0,0,0,0,0,0,0.00147260921712299,0.531198033690511,0.409002956947005
9.7,"eps_greedy_SVM","SVM",91,22,484,470,14,2300,2055,245,0.79208420445534,0.28030303030303,1.19633431085044,650,245,405,1,1.7,82.61,8.4,0,0,0,0,0,0,0.0213214167611183,6.42809530317555,3.25142559726512
9.7,"eps_greedy_SVM","SVM",91,23,384,374,10,2400,2151,249,0.789723163434501,0.295454545454545,1.21578690127077,669,249,420,19,1.7,86.21,8.6,0,0,0,0,0,0,0.0117772702579657,7.07836160079771,6.30264493735201
9.7,"eps_greedy_SVM","SVM",91,24,284,274,10,2500,2251,249,0.752679451133055,0.204545454545455,1.20606060606061,669,249,420,0,1.7,89.8,9,0,0,0,0,0,0,0.00125104049566676,0.404212369217153,0.31883176745461
9.7,"eps_greedy_SVM","SVM",91,25,184,179,5,2600,2346,254,0.831675197654575,0.318181818181818,1.27414467253177,693,254,439,24,1.7,93.39,9.2,0,0,0,0,0,0,0.00303659610886304,3.26583415574062,3.19081881560823
9.7,"eps_greedy_SVM","SVM",91,26,84,84,0,2700,2441,259,0.792078196717366,0.234848484848485,1.27414467253177,714,259,455,21,1.8,96.98,9.4,0,0,0,0,0,0,1.0000000994736e-07,0.10619623294454,0.10619623294454
9.7,"eps_greedy_SVM","SVM",91,27,0,0,0,2784,2525,259,0.762808497344577,0.181818181818182,1.27414467253177,712,259,453,-2,1.7,100,9.7,0,0,0,0,0,0,0,0,0
9.7,"eps_greedy_SVM","SVM",92,0,2684,2429,255,100,88,12,0.767342840438245,0.193548387096774,1.27351716961498,31,12,19,0,1.6,3.59,7.3,0,0,0,0,0,0,0.389886460611818,315.974945358259,49.9160449786512
9.7,"eps_greedy_SVM","SVM",92,1,2584,2355,229,200,162,38,0.792839167238619,0.25,1.26316337148803,93,38,55,62,1.4,7.18,4.3,0,0,0,0,0,0,0.263347705699484,336.455102786849,34.718901552035
9.7,"eps_greedy_SVM","SVM",92,2,2484,2287,197,300,230,70,0.813181575535733,0.290322580645161,1.27351716961498,159,70,89,66,1.3,10.78,3.3,0,0,0,0,0,0,0.278623848490269,387.87639217917,29.3250473332146
9.7,"eps_greedy_SVM","SVM",92,3,2384,2221,163,400,296,104,0.798253641424543,0.290322580645161,1.24245577523413,239,104,135,80,1.3,14.37,2.8,0,0,0,0,0,0,0.283192483531712,254.022708529077,31.2021207948743
9.7,"eps_greedy_SVM","SVM",92,4,2284,2145,139,500,372,128,0.787907674318106,0.233870967741935,1.23210197710718,304,128,176,65,1.4,17.96,2.9,0,0,0,0,0,0,0.267156238687611,301.145177374495,27.8827107944857
9.7,"eps_greedy_SVM","SVM",92,5,2184,2058,126,600,459,141,0.787126007270147,0.25,1.21139438085328,347,141,206,43,1.5,21.55,3.3,0,0,0,0,0,0,0.238654967085788,415.553922723087,25.2906490046452
9.7,"eps_greedy_SVM","SVM",92,6,2084,1983,101,700,534,166,0.791136022776391,0.25,1.19068678459938,411,166,245,64,1.5,25.14,3.2,0,0,0,0,0,0,0.252703907574711,208.782068168726,25.872580876575
9.7,"eps_greedy_SVM","SVM",92,7,1984,1915,69,800,602,198,0.785480057957767,0.266129032258065,1.18033298647242,478,198,280,67,1.4,28.74,3,0,0,0,0,0,0,0.252479560612504,265.03647461125,25.7635295837911
9.7,"eps_greedy_SVM","SVM",92,8,1884,1838,46,900,679,221,0.780840895803161,0.274193548387097,1.18033298647242,527,221,306,49,1.4,32.33,3.1,0,0,0,0,0,0,0.242457010139169,233.486413419095,24.7935434329762
9.7,"eps_greedy_SVM","SVM",92,9,1784,1746,38,1000,771,229,0.799219603955371,0.290322580645161,1.21139438085328,557,229,328,30,1.4,35.92,3.4,0,0,0,0,0,0,0.223446571083965,156.448032888379,22.9269047926028
9.7,"eps_greedy_SVM","SVM",92,10,1684,1655,29,1100,862,238,0.798863723022963,0.306451612903226,1.21139438085328,584,238,346,27,1.5,39.51,3.6,0,0,0,0,0,0,0.195679935499982,105.393682960042,20.5568174031487
9.7,"eps_greedy_SVM","SVM",92,11,1584,1559,25,1200,958,242,0.780345204504446,0.274193548387097,1.20104058272633,590,242,348,6,1.4,43.1,4,0,0,0,0,0,0,0.16629162035447,77.7146494965385,17.8147835979175
9.7,"eps_greedy_SVM","SVM",92,12,1484,1460,24,1300,1057,243,0.79071659167748,0.290322580645161,1.20104058272633,611,243,368,21,1.5,46.7,4.3,0,0,0,0,0,0,0.154916201216579,82.8017015089899,16.6554894079306
9.7,"eps_greedy_SVM","SVM",92,13,1384,1361,23,1400,1156,244,0.782397874882443,0.233870967741935,1.20104058272633,607,244,363,-4,1.5,50.29,4.7,0,0,0,0,0,0,0.123527741756512,60.7829067453218,13.9325727850633
9.7,"eps_greedy_SVM","SVM",92,14,1284,1262,22,1500,1255,245,0.778400569409502,0.217741935483871,1.20104058272633,596,245,351,-11,1.4,53.88,5.1,0,0,0,0,0,0,0.0751929415664765,28.1107873174458,10.0105755400353
9.7,"eps_greedy_SVM","SVM",92,15,1184,1164,20,1600,1353,247,0.750826152164527,0.185483870967742,1.19068678459938,614,247,367,18,1.5,57.47,5.5,0,0,0,0,0,0,0.140287498218932,46.9288694168698,15.5642410003846
9.7,"eps_greedy_SVM","SVM",92,16,1084,1066,18,1700,1451,249,0.772350593558565,0.225806451612903,1.21139438085328,635,249,386,21,1.6,61.06,5.8,0,0,0,0,0,0,0.10545380567197,32.8046107604802,12.2769356888285
9.7,"eps_greedy_SVM","SVM",92,17,984,966,18,1800,1551,249,0.784361575027337,0.258064516129032,1.22174817898023,615,249,366,-20,1.5,64.66,6.2,0,0,0,0,0,0,0.0736153967614998,16.4935662444962,8.66289739316851
9.7,"eps_greedy_SVM","SVM",92,18,884,866,18,1900,1651,249,0.787605811027234,0.298387096774194,1.22174817898023,627,249,378,12,1.5,68.25,6.6,0,0,0,0,0,0,0.0126703250039137,3.49067409932843,3.13301315826037
9.7,"eps_greedy_SVM","SVM",92,19,784,767,17,2000,1750,250,0.767952922036664,0.217741935483871,1.20104058272633,642,250,392,15,1.6,71.84,7,0,0,0,0,0,0,0.00125953931833527,1.28758868003269,1.21282424143003
9.7,"eps_greedy_SVM","SVM",92,20,684,669,15,2100,1848,252,0.78027529932129,0.241935483870968,1.22174817898023,652,252,400,10,1.6,75.43,7.3,0,0,0,0,0,0,0.000573573737356075,0.456821141491634,0.418860134539145
9.7,"eps_greedy_SVM","SVM",92,21,584,576,8,2200,1941,259,0.80387783115992,0.330645161290323,1.24245577523413,667,259,408,15,1.6,79.02,7.5,0,0,0,0,0,0,0.0193164080031704,7.07428343402257,3.37490619510208
9.7,"eps_greedy_SVM","SVM",92,22,484,476,8,2300,2041,259,0.789490073463993,0.233870967741935,1.24245577523413,674,259,415,7,1.6,82.61,7.9,0,0,0,0,0,0,0.0262661027492427,8.6885316022368,3.34598660566083
9.7,"eps_greedy_SVM","SVM",92,23,384,378,6,2400,2139,261,0.766510333257071,0.225806451612903,1.23210197710718,675,261,414,1,1.6,86.21,8.2,0,0,0,0,0,0,0.0619168707349861,16.768621365968,9.34823837342335
9.7,"eps_greedy_SVM","SVM",92,24,284,280,4,2500,2237,263,0.80224459188083,0.306451612903226,1.24245577523413,714,263,451,39,1.7,89.8,8.5,0,0,0,0,0,0,0.0412636742258841,10.6913472607132,7.53214541810822
9.7,"eps_greedy_SVM","SVM",92,25,184,183,1,2600,2334,266,0.744547395714178,0.17741935483871,1.25280957336108,728,266,462,14,1.7,93.39,8.8,0,0,0,0,0,0,0.0376185937426566,9.15499553014724,7.74384056337492
9.7,"eps_greedy_SVM","SVM",92,26,84,83,1,2700,2434,266,0.817966903073286,0.274193548387097,1.25280957336108,743,266,477,15,1.8,96.98,9.2,0,0,0,0,0,0,1.02734591073088e-06,1.26628698202085,1.26628698202085
9.7,"eps_greedy_SVM","SVM",92,27,0,0,0,2784,2517,267,0.798361676707598,0.266129032258065,1.27351716961498,730,267,463,-13,1.7,100,9.4,0,0,0,0,0,0,0,0,0
9.7,"eps_greedy_SVM","SVM",93,0,2684,2429,255,100,88,12,0.782181804316327,0.233870967741935,1.28387096774194,34,12,22,0,1.8,3.59,7.3,0,0,0,0,0,0,0.121333132909158,320.06511618321,12.1943916960147
9.7,"eps_greedy_SVM","SVM",93,1,2584,2336,248,200,181,19,0.684899209435933,0.153225806451613,1.16997918834547,65,19,46,31,2.4,7.18,9.5,0,0,0,0,0,0,0.134927177539034,262.383322077591,15.9201599340521
9.7,"eps_greedy_SVM","SVM",93,2,2484,2244,240,300,273,27,0.771003330028729,0.233870967741935,1.22174817898023,84,27,57,19,2.1,10.78,10.1,0,0,0,0,0,0,0.100935105124812,219.92851464946,10.4582880849969
9.7,"eps_greedy_SVM","SVM",93,3,2384,2172,212,400,345,55,0.800897328351004,0.233870967741935,1.22174817898023,147,55,92,63,1.7,14.37,6.3,0,0,0,0,0,0,0.171276607283254,249.445519309458,19.4171556699909
9.7,"eps_greedy_SVM","SVM",93,4,2284,2095,189,500,422,78,0.793315793487385,0.258064516129032,1.22174817898023,190,78,112,43,1.4,17.96,5.4,0,0,0,0,0,0,0.174546934918673,226.750355019257,18.0325856286753
9.7,"eps_greedy_SVM","SVM",93,5,2184,2021,163,600,496,104,0.806445257886581,0.241935483870968,1.22174817898023,253,104,149,63,1.4,21.55,4.8,0,0,0,0,0,0,0.185893239019984,243.534153534531,19.1748008192018
9.7,"eps_greedy_SVM","SVM",93,6,2084,1954,130,700,563,137,0.811440300973596,0.266129032258065,1.22174817898023,323,137,186,70,1.4,25.14,4.1,0,0,0,0,0,0,0.205321308234675,266.297714463274,20.9778189783734
9.7,"eps_greedy_SVM","SVM",93,7,1984,1876,108,800,641,159,0.808205597498672,0.282258064516129,1.22174817898023,380,159,221,57,1.4,28.74,4,0,0,0,0,0,0,0.201816922366989,221.538832410415,20.9764945094767
9.7,"eps_greedy_SVM","SVM",93,8,1884,1792,92,900,725,175,0.794377081267959,0.225806451612903,1.23210197710718,421,175,246,41,1.4,32.33,4.1,0,0,0,0,0,0,0.202874801543406,217.516715024371,20.9108533314409
9.7,"eps_greedy_SVM","SVM",93,9,1784,1707,77,1000,810,190,0.801704415465577,0.258064516129032,1.23210197710718,458,190,268,37,1.4,35.92,4.3,0,0,0,0,0,0,0.183344484118263,147.133761548892,19.3730006197774
9.7,"eps_greedy_SVM","SVM",93,10,1684,1620,64,1100,897,203,0.7893502630977,0.258064516129032,1.19068678459938,498,203,295,40,1.5,39.51,4.4,0,0,0,0,0,0,0.170835984499469,147.103970446328,18.0917681859739
9.7,"eps_greedy_SVM","SVM",93,11,1584,1524,60,1200,993,207,0.780885380919708,0.233870967741935,1.20104058272633,514,207,307,16,1.5,43.1,4.8,0,0,0,0,0,0,0.145379112932418,112.004285451582,15.4387820069934
9.7,"eps_greedy_SVM","SVM",93,12,1484,1431,53,1300,1086,214,0.782556750298694,0.241935483870968,1.20104058272633,544,214,330,30,1.5,46.7,5.1,0,0,0,0,0,0,0.126732597460204,78.7342494332585,13.9366097644261
9.7,"eps_greedy_SVM","SVM",93,13,1384,1334,50,1400,1183,217,0.766268842624377,0.193548387096774,1.20104058272633,537,217,320,-7,1.5,50.29,5.5,0,0,0,0,0,0,0.127255942771933,85.3478617854925,13.6069691612389
9.7,"eps_greedy_SVM","SVM",93,14,1284,1238,46,1500,1279,221,0.775032410584922,0.193548387096774,1.20104058272633,567,221,346,30,1.6,53.88,5.8,0,0,0,0,0,0,0.131433789203735,99.8124785695801,13.7293345337721
9.7,"eps_greedy_SVM","SVM",93,15,1184,1152,32,1600,1365,235,0.772687409441016,0.201612903225806,1.20104058272633,606,235,371,39,1.6,57.47,5.8,0,0,0,0,0,0,0.112355559371288,51.7674668948675,13.3798403905925
9.7,"eps_greedy_SVM","SVM",93,16,1084,1062,22,1700,1455,245,0.804462492691736,0.225806451612903,1.20104058272633,628,245,383,22,1.6,61.06,5.9,0,0,0,0,0,0,0.101201686352432,51.3829152466933,11.4921348653401
9.7,"eps_greedy_SVM","SVM",93,17,984,963,21,1800,1554,246,0.803585500394016,0.217741935483871,1.20104058272633,629,246,383,1,1.6,64.66,6.3,0,0,0,0,0,0,0.0589565778242015,18.9984808800627,6.90687571675014
9.7,"eps_greedy_SVM","SVM",93,18,884,864,20,1900,1653,247,0.814217443249708,0.25,1.20104058272633,639,247,392,10,1.6,68.25,6.7,0,0,0,0,0,0,0.0454630508325379,16.7679249378844,6.01273902722415
9.7,"eps_greedy_SVM","SVM",93,19,784,765,19,2000,1752,248,0.817515696891133,0.25,1.20104058272633,649,248,401,10,1.6,71.84,7.1,0,0,0,0,0,0,0.0180344685697547,5.49956056186647,2.89959688897136
9.7,"eps_greedy_SVM","SVM",93,20,684,666,18,2100,1851,249,0.824124914207283,0.282258064516129,1.20104058272633,650,249,401,1,1.6,75.43,7.4,0,0,0,0,0,0,0.0289361075816957,9.15162455951081,4.04955312891869
9.7,"eps_greedy_SVM","SVM",93,21,584,566,18,2200,1951,249,0.829361447927001,0.258064516129032,1.20104058272633,645,249,396,-5,1.6,79.02,7.8,0,0,0,0,0,0,0.00162773909113468,0.451497347708867,0.31920127761195
9.7,"eps_greedy_SVM","SVM",93,22,484,468,16,2300,2049,251,0.789833244363103,0.185483870967742,1.20104058272633,650,251,399,5,1.6,82.61,8.2,0,0,0,0,0,0,0.00185637965060432,0.609576994596296,0.461503369264554
9.7,"eps_greedy_SVM","SVM",93,23,384,374,10,2400,2143,257,0.750012710033301,0.153225806451613,1.20104058272633,678,257,421,28,1.6,86.21,8.3,0,0,0,0,0,0,0.00845147252298827,2.94589951419339,2.07847828323136
9.7,"eps_greedy_SVM","SVM",93,24,284,275,9,2500,2242,258,0.763154884465798,0.153225806451613,1.20104058272633,692,258,434,14,1.7,89.8,8.7,0,0,0,0,0,0,0.00817561302396312,1.91617390558448,1.24821836376009
9.7,"eps_greedy_SVM","SVM",93,25,184,179,5,2600,2338,262,0.814280993416201,0.25,1.22174817898023,693,262,431,1,1.6,93.39,8.9,0,0,0,0,0,0,0.00356100681186406,1.70756139192752,1.57946085858899
9.7,"eps_greedy_SVM","SVM",93,26,84,84,0,2700,2433,267,0.787844124151607,0.153225806451613,1.26316337148803,740,267,473,47,1.8,96.98,9.1,0,0,0,0,0,0,1.88339987550475e-07,0.017642169353638,0.017642169353638
9.7,"eps_greedy_SVM","SVM",93,27,0,0,0,2784,2517,267,0.827277002465747,0.201612903225806,1.26316337148803,721,267,454,-19,1.7,100,9.4,0,0,0,0,0,0,0,0,0
9.7,"eps_greedy_SVM","SVM",94,0,2684,2446,238,100,88,12,0.260326739627943,0,0.600960878517502,35,12,23,0,1.9,3.59,7.3,0,0,0,0,0,0,0.128698506851522,316.090406405842,13.3020200204671
9.7,"eps_greedy_SVM","SVM",94,1,2584,2362,222,200,172,28,0.782453039675531,0.25531914893617,1.23834362846031,90,28,62,55,2.2,7.18,6.1,0,0,0,0,0,0,0.232224664353515,370.233781302664,27.5585271068226
9.7,"eps_greedy_SVM","SVM",94,2,2484,2285,199,300,249,51,0.808833525932976,0.326241134751773,1.26566003202928,136,51,85,46,1.7,10.78,4.9,0,0,0,0,0,0,0.172372000239135,404.304826236478,17.4040857748731
9.7,"eps_greedy_SVM","SVM",94,3,2384,2209,175,400,325,75,0.818718419323412,0.319148936170213,1.26566003202928,188,75,113,52,1.5,14.37,4.3,0,0,0,0,0,0,0.199463672818495,288.200634932084,20.5179024173578
9.7,"eps_greedy_SVM","SVM",94,4,2284,2139,145,500,395,105,0.809904153354636,0.347517730496454,1.24744909631663,254,105,149,66,1.4,17.96,3.8,0,0,0,0,0,0,0.214932543547569,324.064582979724,21.918657993059
9.7,"eps_greedy_SVM","SVM",94,5,2184,2062,122,600,472,128,0.819058301044571,0.326241134751773,1.25655456417296,305,128,177,51,1.4,21.55,3.7,0,0,0,0,0,0,0.212399931861495,204.974970315979,21.7692823068952
9.7,"eps_greedy_SVM","SVM",94,6,2084,1990,94,700,544,156,0.817676115378518,0.297872340425532,1.23834362846031,363,156,207,58,1.3,25.14,3.5,0,0,0,0,0,0,0.223783996660168,248.868590077075,24.036303260062
9.7,"eps_greedy_SVM","SVM",94,7,1984,1913,71,800,621,179,0.79182811048422,0.24822695035461,1.25655456417296,424,179,245,61,1.4,28.74,3.5,0,0,0,0,0,0,0.225649212333307,299.68648963538,23.5744254779399
9.7,"eps_greedy_SVM","SVM",94,8,1884,1821,63,900,713,187,0.813818457843339,0.333333333333333,1.25655456417296,445,187,258,21,1.4,32.33,3.8,0,0,0,0,0,0,0.197943555743839,157.57118604498,20.6739820566869
9.7,"eps_greedy_SVM","SVM",94,9,1784,1736,48,1000,798,202,0.817681780073869,0.283687943262411,1.25655456417296,501,202,299,56,1.5,35.92,4,0,0,0,0,0,0,0.181240275725934,151.568878763012,19.3508841433032
9.7,"eps_greedy_SVM","SVM",94,10,1684,1646,38,1100,888,212,0.818809054449055,0.312056737588652,1.25655456417296,523,212,311,22,1.5,39.51,4.2,0,0,0,0,0,0,0.164143046972881,135.403846748299,17.9275653421135
9.7,"eps_greedy_SVM","SVM",94,11,1584,1556,28,1200,978,222,0.82906781773277,0.347517730496454,1.24744909631663,557,222,335,34,1.5,43.1,4.4,0,0,0,0,0,0,0.15346893854149,136.951354873655,16.6664166344377
9.7,"eps_greedy_SVM","SVM",94,12,1484,1458,26,1300,1076,224,0.819721070400839,0.312056737588652,1.24744909631663,585,224,361,28,1.6,46.7,4.8,0,0,0,0,0,0,0.129601939824936,104.504762848552,14.0838102322405
9.7,"eps_greedy_SVM","SVM",94,13,1384,1362,22,1400,1172,228,0.825391430448879,0.319148936170213,1.25655456417296,578,228,350,-7,1.5,50.29,5.1,0,0,0,0,0,0,0.149447340210755,134.064631908027,15.6766080542953
9.7,"eps_greedy_SVM","SVM",94,14,1284,1264,20,1500,1270,230,0.814022386876041,0.290780141843972,1.25655456417296,600,230,370,22,1.6,53.88,5.5,0,0,0,0,0,0,0.113184253794419,60.2022704033046,12.5808343199257
9.7,"eps_greedy_SVM","SVM",94,15,1184,1169,15,1600,1365,235,0.819092289216692,0.283687943262411,1.25655456417296,611,235,376,11,1.6,57.47,5.8,0,0,0,0,0,0,0.108898838027403,56.5961295333391,12.4889982613534
9.7,"eps_greedy_SVM","SVM",94,16,1084,1070,14,1700,1464,236,0.82434346180863,0.319148936170213,1.25655456417296,628,236,392,17,1.7,61.06,6.2,0,0,0,0,0,0,0.0895810135543172,45.5864625430501,10.0638220041302
9.7,"eps_greedy_SVM","SVM",94,17,984,970,14,1800,1564,236,0.789902114064313,0.24113475177305,1.25655456417296,627,236,391,-1,1.7,64.66,6.6,0,0,0,0,0,0,0.10170659417287,70.1065766063283,10.8695628947153
9.7,"eps_greedy_SVM","SVM",94,18,884,870,14,1900,1664,236,0.800041918745617,0.276595744680851,1.25655456417296,637,236,401,10,1.7,68.25,7.1,0,0,0,0,0,0,0.0366877264167593,14.0781911418894,4.74060038625726
9.7,"eps_greedy_SVM","SVM",94,19,784,770,14,2000,1764,236,0.819590782407728,0.297872340425532,1.25655456417296,625,236,389,-12,1.6,71.84,7.5,0,0,0,0,0,0,0.0627243545420445,29.1319099483417,7.38906225667701
9.7,"eps_greedy_SVM","SVM",94,20,684,671,13,2100,1863,237,0.804335757822951,0.24113475177305,1.25655456417296,629,237,392,4,1.7,75.43,7.9,0,0,0,0,0,0,0.0179504143881061,5.81203397649604,2.65395946833171
9.7,"eps_greedy_SVM","SVM",94,21,584,574,10,2200,1960,240,0.807785557292735,0.283687943262411,1.24744909631663,649,240,409,20,1.7,79.02,8.2,0,0,0,0,0,0,0.0211611720005207,6.71040569217869,3.26490470269684
9.7,"eps_greedy_SVM","SVM",94,22,484,477,7,2300,2057,243,0.822083248362907,0.283687943262411,1.25655456417296,655,243,412,6,1.7,82.61,8.5,0,0,0,0,0,0,0.0215381721334991,6.43516738754758,3.21476493038713
9.7,"eps_greedy_SVM","SVM",94,23,384,382,2,2400,2152,248,0.783416037885485,0.198581560283688,1.26566003202928,677,248,429,22,1.7,86.21,8.7,0,0,0,0,0,0,0.0134019942806293,4.8307801189274,3.71450877364978
9.7,"eps_greedy_SVM","SVM",94,24,284,284,0,2500,2250,250,0.796422178415249,0.24113475177305,1.26566003202928,689,250,439,12,1.8,89.8,9,0,0,0,0,0,0,0.00341177344529391,1.07870651990536,0.786760483755899
9.7,"eps_greedy_SVM","SVM",94,25,184,184,0,2600,2350,250,0.814617179888068,0.269503546099291,1.27476549988561,673,250,423,-16,1.7,93.39,9.4,0,0,0,0,0,0,0.000345819066693234,0.177436157682287,0.162137406865282
9.7,"eps_greedy_SVM","SVM",94,26,84,84,0,2700,2450,250,0.806709265175723,0.24822695035461,1.26566003202928,682,250,432,9,1.7,96.98,9.8,0,0,0,0,0,0,3.84815829352581e-05,0.0450503027349681,0.0450503027349681
9.7,"eps_greedy_SVM","SVM",94,27,0,0,0,2784,2534,250,0.747348922574948,0.212765957446809,1.27476549988561,686,250,436,4,1.7,100,10.1,0,0,0,0,0,0,0,0,0
9.7,"eps_greedy_SVM","SVM",95,0,2684,2432,252,100,90,10,0.796802938867625,0.201550387596899,1.2528587948092,26,10,16,0,1.6,3.59,9,0,0,0,0,0,0,0.360838188384106,333.848696285554,45.720362701881
9.7,"eps_greedy_SVM","SVM",95,1,2584,2353,231,200,169,31,0.80997326072024,0.255813953488372,1.28387096774194,78,31,47,52,1.5,7.18,5.5,0,0,0,0,0,0,0.251404497077217,355.321608440281,30.619539971576
9.7,"eps_greedy_SVM","SVM",95,2,2484,2292,192,300,230,70,0.7890172701403,0.193798449612403,1.26396599149787,165,70,95,87,1.4,10.78,3.3,0,0,0,0,0,0,0.36295174066589,495.493394295625,43.3087490365548
9.7,"eps_greedy_SVM","SVM",95,3,2384,2205,179,400,317,83,0.763271514081049,0.178294573643411,1.2739184796199,199,83,116,34,1.4,14.37,3.8,0,0,0,0,0,0,0.259048044040847,339.874355290388,30.0879171304343
9.7,"eps_greedy_SVM","SVM",95,4,2284,2117,167,500,405,95,0.805661858502598,0.193798449612403,1.28387096774194,228,95,133,29,1.4,17.96,4.3,0,0,0,0,0,0,0.20691501929245,279.460188716143,22.2425801810735
9.7,"eps_greedy_SVM","SVM",95,5,2184,2033,151,600,489,111,0.808605632420762,0.255813953488372,1.28387096774194,263,111,152,35,1.4,21.55,4.4,0,0,0,0,0,0,0.186394450041145,231.522983966394,20.4281105863044
9.7,"eps_greedy_SVM","SVM",95,6,2084,1956,128,700,566,134,0.810224708075751,0.232558139534884,1.28387096774194,326,134,192,63,1.4,25.14,4.2,0,0,0,0,0,0,0.194647585951269,228.995729477573,19.9327885602695
9.7,"eps_greedy_SVM","SVM",95,7,1984,1885,99,800,637,163,0.819080561279558,0.248062015503876,1.28387096774194,378,163,215,52,1.3,28.74,3.9,0,0,0,0,0,0,0.193253040259748,126.965085896993,20.5538907804336
9.7,"eps_greedy_SVM","SVM",95,8,1884,1821,63,900,701,199,0.821668629182603,0.24031007751938,1.2739184796199,464,199,265,86,1.3,32.33,3.5,0,0,0,0,0,0,0.207866212212644,146.865266944506,23.2439804748931
9.7,"eps_greedy_SVM","SVM",95,9,1784,1742,42,1000,780,220,0.825955499950927,0.255813953488372,1.2739184796199,520,220,300,56,1.4,35.92,3.5,0,0,0,0,0,0,0.172237802665668,116.188844390112,19.3917171716035
9.7,"eps_greedy_SVM","SVM",95,10,1684,1650,34,1100,872,228,0.830174909233625,0.27906976744186,1.2739184796199,540,228,312,20,1.4,39.51,3.8,0,0,0,0,0,0,0.12576660700014,66.9554896037841,14.9214179006006
9.7,"eps_greedy_SVM","SVM",95,11,1584,1561,23,1200,961,239,0.830800461191237,0.263565891472868,1.2739184796199,576,239,337,36,1.4,43.1,4,0,0,0,0,0,0,0.13388600860449,76.5091781642551,15.3972089441705
9.7,"eps_greedy_SVM","SVM",95,12,1484,1471,13,1300,1051,249,0.83476842311843,0.27906976744186,1.2739184796199,625,249,376,49,1.5,46.7,4.2,0,0,0,0,0,0,0.152440872306981,87.7150404024832,17.7624761543985
9.7,"eps_greedy_SVM","SVM",95,13,1384,1372,12,1400,1150,250,0.8293163085075,0.286821705426357,1.2739184796199,620,250,370,-5,1.5,50.29,4.6,0,0,0,0,0,0,0.111400430567957,56.6306365995585,12.8046286309185
9.7,"eps_greedy_SVM","SVM",95,14,1284,1276,8,1500,1246,254,0.808427779413201,0.248062015503876,1.2739184796199,643,254,389,23,1.5,53.88,4.9,0,0,0,0,0,0,0.109151907752685,54.3927173000047,14.8320985479431
9.7,"eps_greedy_SVM","SVM",95,15,1184,1177,7,1600,1345,255,0.81126729467176,0.27906976744186,1.26396599149787,662,255,407,19,1.6,57.47,5.3,0,0,0,0,0,0,0.131113488737985,70.0168904975864,15.3517712950907
9.7,"eps_greedy_SVM","SVM",95,16,1084,1078,6,1700,1444,256,0.810948385830626,0.263565891472868,1.2739184796199,682,256,426,20,1.7,61.06,5.6,0,0,0,0,0,0,0.0960673504636628,47.0788443786453,11.0186822881235
9.7,"eps_greedy_SVM","SVM",95,17,984,978,6,1800,1544,256,0.82740285546069,0.286821705426357,1.2739184796199,669,256,413,-13,1.6,64.66,6,0,0,0,0,0,0,0.0776977836740319,37.3621850551534,8.84952330083003
9.7,"eps_greedy_SVM","SVM",95,18,884,880,4,1900,1642,258,0.799663919144335,0.170542635658915,1.2739184796199,671,258,413,2,1.6,68.25,6.4,0,0,0,0,0,0,0.0561810697917986,20.0711486546193,6.37794203142017
9.7,"eps_greedy_SVM","SVM",95,19,784,781,3,2000,1741,259,0.819571190265912,0.232558139534884,1.2739184796199,690,259,431,19,1.7,71.84,6.7,0,0,0,0,0,0,0.0248524908578315,7.75446787070273,3.85911538473427
9.7,"eps_greedy_SVM","SVM",95,20,684,681,3,2100,1841,259,0.823152781866346,0.248062015503876,1.27157456337405,703,259,444,13,1.7,75.43,7.1,0,0,0,0,0,0,0.0218927024560989,6.97898651003149,3.13526023541083
9.7,"eps_greedy_SVM","SVM",95,21,584,582,2,2200,1940,260,0.78148611519968,0.13953488372093,1.28387096774194,691,260,431,-12,1.7,79.02,7.5,0,0,0,0,0,0,0.0107870159432081,3.39319986531574,2.20466125093398
9.7,"eps_greedy_SVM","SVM",95,22,484,482,2,2300,2040,260,0.811475811990964,0.232558139534884,1.2739184796199,688,260,428,-3,1.6,82.61,7.8,0,0,0,0,0,0,0.00761707711934456,2.01552044709341,1.28401822040857
9.7,"eps_greedy_SVM","SVM",95,23,384,383,1,2400,2139,261,0.820730301246189,0.271317829457364,1.2739184796199,699,261,438,11,1.7,86.21,8.2,0,0,0,0,0,0,0.00154174156194799,0.438071958159506,0.31761937249828
9.7,"eps_greedy_SVM","SVM",95,24,284,283,1,2500,2239,261,0.806011431655373,0.201550387596899,1.28387096774194,698,261,437,-1,1.7,89.8,8.6,0,0,0,0,0,0,8.6475512274784e-05,0.052514360130246,0.0494008866666591
9.7,"eps_greedy_SVM","SVM",95,25,184,184,0,2600,2338,262,0.802656755961135,0.224806201550388,1.2739184796199,714,262,452,16,1.7,93.39,8.9,0,0,0,0,0,0,0.000389423751543682,5.07118180305906,5.06308655837
9.7,"eps_greedy_SVM","SVM",95,26,84,84,0,2700,2438,262,0.807011088215088,0.286821705426357,1.28387096774194,717,262,455,3,1.7,96.98,9.3,0,0,0,0,0,0,2.41187146028297e-07,0.0199729368077327,0.0199729368077327
9.7,"eps_greedy_SVM","SVM",95,27,0,0,0,2784,2522,262,0.806722843685601,0.255813953488372,1.28387096774194,707,262,445,-10,1.7,100,9.6,0,0,0,0,0,0,0,0,0
9.7,"eps_greedy_SVM","SVM",96,0,2684,2417,267,100,87,13,0.586449944484265,0,1.05157367312063,42,13,29,0,2.2,3.59,6.7,0,0,0,0,0,0,0.283322643444898,379.647163594453,40.3289123658754
9.7,"eps_greedy_SVM","SVM",96,1,2584,2328,256,200,176,24,0.754051243130803,0.117117117117117,1.28387096774194,71,24,47,29,2,7.18,7.3,0,0,0,0,0,0,0.18371003957705,317.669067102656,19.5356933877868
9.7,"eps_greedy_SVM","SVM",96,2,2484,2238,246,300,266,34,0.711423592078815,0.0990990990990991,1.27230456262714,117,34,83,46,2.4,10.78,7.8,0,0,0,0,0,0,0.131403624055241,280.716461621948,13.8033923212711
9.7,"eps_greedy_SVM","SVM",96,3,2384,2145,239,400,359,41,0.743685963654763,0.108108108108108,1.27230456262714,129,41,88,12,2.1,14.37,8.8,0,0,0,0,0,0,0.147157195687276,217.311989532968,20.4300013076978
9.7,"eps_greedy_SVM","SVM",96,4,2284,2051,233,500,453,47,0.758724403030178,0.153153153153153,1.27230456262714,142,47,95,13,2,17.96,9.6,0,0,0,0,0,0,0.114107182920794,143.554752713137,11.98147470793
9.7,"eps_greedy_SVM","SVM",96,5,2184,1982,202,600,522,78,0.782251830613772,0.198198198198198,1.27230456262714,216,78,138,74,1.8,21.55,6.7,0,0,0,0,0,0,0.155611769747551,163.41847784547,16.1566793421579
9.7,"eps_greedy_SVM","SVM",96,6,2084,1914,170,700,590,110,0.780783123216825,0.225225225225225,1.26073815751235,283,110,173,67,1.6,25.14,5.4,0,0,0,0,0,0,0.165095798588708,244.458944863495,16.6084852939587
9.7,"eps_greedy_SVM","SVM",96,7,1984,1853,131,800,651,149,0.78889263678656,0.216216216216216,1.26073815751235,372,149,223,89,1.5,28.74,4.4,0,0,0,0,0,0,0.19836230427732,239.150640808279,19.9988111774688
9.7,"eps_greedy_SVM","SVM",96,8,1884,1785,99,900,719,181,0.792272771991969,0.225225225225225,1.26073815751235,445,181,264,73,1.5,32.33,4,0,0,0,0,0,0,0.210746763207681,172.952255149673,21.9093460722778
9.7,"eps_greedy_SVM","SVM",96,9,1784,1708,76,1000,796,204,0.79866762238058,0.252252252252252,1.23646574751547,485,204,281,40,1.4,35.92,3.9,0,0,0,0,0,0,0.191741237889184,126.27538033633,20.8018851767331
9.7,"eps_greedy_SVM","SVM",96,10,1684,1627,57,1100,877,223,0.798976823937832,0.243243243243243,1.23760534728277,555,223,332,70,1.5,39.51,3.9,0,0,0,0,0,0,0.163038504332696,86.6596256056151,18.4054844388853
9.7,"eps_greedy_SVM","SVM",96,11,1584,1541,43,1200,963,237,0.797198914983637,0.225225225225225,1.23760534728277,582,237,345,27,1.5,43.1,4.1,0,0,0,0,0,0,0.143228252266378,68.2727950731909,17.0946334148464
9.7,"eps_greedy_SVM","SVM",96,12,1484,1445,39,1300,1059,241,0.804978145071758,0.243243243243243,1.23760534728277,581,241,340,-1,1.4,46.7,4.4,0,0,0,0,0,0,0.141555035134458,67.9770350045118,15.3073772330117
9.7,"eps_greedy_SVM","SVM",96,13,1384,1356,28,1400,1148,252,0.805322483169606,0.261261261261261,1.23760534728277,633,252,381,52,1.5,50.29,4.6,0,0,0,0,0,0,0.148394161523698,63.7534611291955,16.5012261030891
9.7,"eps_greedy_SVM","SVM",96,14,1284,1263,21,1500,1241,259,0.799103315483981,0.216216216216216,1.23760534728277,648,259,389,15,1.5,53.88,4.8,0,0,0,0,0,0,0.147906445495124,66.3658334066218,15.935068253742
9.7,"eps_greedy_SVM","SVM",96,15,1184,1164,20,1600,1340,260,0.794219336341032,0.207207207207207,1.23760534728277,650,260,390,2,1.5,57.47,5.2,0,0,0,0,0,0,0.0964596502464274,29.5226886154772,11.6224113836116
9.7,"eps_greedy_SVM","SVM",96,16,1084,1065,19,1700,1439,261,0.786903908588785,0.198198198198198,1.23760534728277,665,261,404,15,1.5,61.06,5.5,0,0,0,0,0,0,0.0478331496931701,11.8434154375431,6.75729433680495
9.7,"eps_greedy_SVM","SVM",96,17,984,965,19,1800,1539,261,0.810178353080079,0.216216216216216,1.23760534728277,658,261,397,-7,1.5,64.66,5.9,0,0,0,0,0,0,0.041870209146891,9.01874598839215,5.58299481424168
9.7,"eps_greedy_SVM","SVM",96,18,884,866,18,1900,1638,262,0.78717797360544,0.207207207207207,1.24917175239756,665,262,403,7,1.5,68.25,6.3,0,0,0,0,0,0,0.00727779192745591,2.62928580326864,2.24396797478944
9.7,"eps_greedy_SVM","SVM",96,19,784,767,17,2000,1737,263,0.795385869488842,0.207207207207207,1.27230456262714,657,263,394,-8,1.5,71.84,6.6,0,0,0,0,0,0,0.00274840535701334,1.50852897016549,1.40894426228018
9.7,"eps_greedy_SVM","SVM",96,20,684,670,14,2100,1834,266,0.812490337451341,0.243243243243243,1.21447253705318,669,266,403,12,1.5,75.43,6.9,0,0,0,0,0,0,0.00382255090138721,1.09944568170336,0.687745716362748
9.7,"eps_greedy_SVM","SVM",96,21,584,572,12,2200,1932,268,0.741029641185655,0.162162162162162,1.20290613193839,694,268,426,25,1.6,79.02,7.2,0,0,0,0,0,0,0.0320721908015102,14.5285713667352,11.949737415297
9.7,"eps_greedy_SVM","SVM",96,22,484,472,12,2300,2032,268,0.77633483717728,0.18018018018018,1.20290613193839,683,268,415,-11,1.5,82.61,7.6,0,0,0,0,0,0,0.0100950384454363,2.81730920351069,1.94003990215999
9.7,"eps_greedy_SVM","SVM",96,23,384,375,9,2400,2129,271,0.789265084116891,0.225225225225225,1.20290613193839,692,271,421,9,1.6,86.21,7.9,0,0,0,0,0,0,0.0211977931840005,6.39880568401242,4.69506351829102
9.7,"eps_greedy_SVM","SVM",96,24,284,276,8,2500,2228,272,0.775997526387553,0.18018018018018,1.20290613193839,694,272,422,2,1.6,89.8,8.2,0,0,0,0,0,0,0.0108463012162527,3.06239531339374,2.27818975027015
9.7,"eps_greedy_SVM","SVM",96,25,184,178,6,2600,2326,274,0.807163637896878,0.207207207207207,1.20290613193839,709,274,435,15,1.6,93.39,8.5,0,0,0,0,0,0,0.00702283514840471,2.13848650702492,1.87814228333879
9.7,"eps_greedy_SVM","SVM",96,26,84,83,1,2700,2421,279,0.753840423887231,0.162162162162162,1.24917175239756,739,279,460,30,1.6,96.98,8.7,0,0,0,0,0,0,1.79183321489251e-06,1.23513083715763,1.23513083715763
9.7,"eps_greedy_SVM","SVM",96,27,0,0,0,2784,2504,280,0.770080532951047,0.144144144144144,1.27230456262714,743,280,463,4,1.7,100,8.9,0,0,0,0,0,0,0,0,0
9.7,"eps_greedy_SVM","SVM",97,0,2684,2427,257,100,93,7,0.358392108569368,0.0236220472440945,0.839065278130556,30,7,23,0,3.3,3.59,13.3,0,0,0,0,0,0,0.0864886972139012,183.30506632351,9.24332181100024
9.7,"eps_greedy_SVM","SVM",97,1,2584,2327,257,200,193,7,0.636445622022373,0.094488188976378,1.19288798577597,30,7,23,0,3.3,7.18,27.6,0,0,0,0,0,0,0.0517428041491193,114.13894791573,5.46615970170108
9.7,"eps_greedy_SVM","SVM",97,2,2484,2234,250,300,286,14,0.588871888644253,0.259842519685039,1.03114046228092,46,14,32,16,2.3,10.78,20.4,0,0,0,0,0,0,0.0928741459856336,121.855174321636,11.2814273086565
9.7,"eps_greedy_SVM","SVM",97,3,2384,2169,215,400,351,49,0.660359990546207,0.149606299212598,1.22321564643129,129,49,80,83,1.6,14.37,7.2,0,0,0,0,0,0,0.173997051442134,258.162836597046,19.3051451448224
9.7,"eps_greedy_SVM","SVM",97,4,2284,2081,203,500,439,61,0.7432921595701,0.204724409448819,1.24343408686817,162,61,101,33,1.7,17.96,7.2,0,0,0,0,0,0,0.158104354002569,217.427930289808,16.9472542949975
9.7,"eps_greedy_SVM","SVM",97,5,2184,2015,169,600,505,95,0.741413839857697,0.275590551181102,1.20299720599441,234,95,139,72,1.5,21.55,5.3,0,0,0,0,0,0,0.209724360847822,258.041287019825,24.6975635083037
9.7,"eps_greedy_SVM","SVM",97,6,2084,1933,151,700,587,113,0.762261944745056,0.228346456692913,1.21310642621285,272,113,159,38,1.4,25.14,5.2,0,0,0,0,0,0,0.187736962191373,161.411578191642,20.7562304323281
9.7,"eps_greedy_SVM","SVM",97,7,1984,1862,122,800,658,142,0.794317771889891,0.291338582677165,1.25354330708661,341,142,199,69,1.4,28.74,4.6,0,0,0,0,0,0,0.206758116849037,133.726214242341,22.6486660400236
9.7,"eps_greedy_SVM","SVM",97,8,1884,1798,86,900,722,178,0.798640395069104,0.299212598425197,1.26365252730505,427,178,249,86,1.4,32.33,4.1,0,0,0,0,0,0,0.208891552513013,131.973942205795,23.9802958564186
9.7,"eps_greedy_SVM","SVM",97,9,1784,1718,66,1000,802,198,0.802272642459978,0.283464566929134,1.25354330708661,488,198,290,61,1.5,35.92,4.1,0,0,0,0,0,0,0.199217511564637,167.911707461888,22.2875652512439
9.7,"eps_greedy_SVM","SVM",97,10,1684,1633,51,1100,887,213,0.812012538717019,0.267716535433071,1.26365252730505,523,213,310,35,1.5,39.51,4.2,0,0,0,0,0,0,0.163546152017112,107.216777244807,18.7621156773326
9.7,"eps_greedy_SVM","SVM",97,11,1584,1544,40,1200,976,224,0.816366259904712,0.291338582677165,1.26365252730505,553,224,329,30,1.5,43.1,4.4,0,0,0,0,0,0,0.101779002245734,55.7028102542411,12.6088865363838
9.7,"eps_greedy_SVM","SVM",97,12,1484,1455,29,1300,1065,235,0.822685375228577,0.283464566929134,1.26365252730505,591,235,356,38,1.5,46.7,4.5,0,0,0,0,0,0,0.134679969991707,78.729414432616,15.9812023752728
9.7,"eps_greedy_SVM","SVM",97,13,1384,1359,25,1400,1161,239,0.838209501063555,0.291338582677165,1.2737617475235,603,239,364,12,1.5,50.29,4.9,0,0,0,0,0,0,0.124593861789972,93.8764190797301,14.030415383818
9.7,"eps_greedy_SVM","SVM",97,14,1284,1268,16,1500,1252,248,0.837326317622618,0.299212598425197,1.28387096774194,621,248,373,18,1.5,53.88,5,0,0,0,0,0,0,0.145475781525007,83.4312199152092,16.3236955159428
9.7,"eps_greedy_SVM","SVM",97,15,1184,1172,12,1600,1348,252,0.840759537759202,0.291338582677165,1.28387096774194,662,252,410,41,1.6,57.47,5.3,0,0,0,0,0,0,0.105265095470302,52.9107001316252,12.2654430706703
9.7,"eps_greedy_SVM","SVM",97,16,1084,1078,6,1700,1442,258,0.819731064422636,0.251968503937008,1.28387096774194,679,258,421,17,1.6,61.06,5.6,0,0,0,0,0,0,0.120682937762869,72.1508968789638,13.5772322005428
9.7,"eps_greedy_SVM","SVM",97,17,984,979,5,1800,1541,259,0.834962868977871,0.244094488188976,1.28387096774194,676,259,417,-3,1.6,64.66,5.9,0,0,0,0,0,0,0.0897281505192999,46.4179045240198,10.1157300741677
9.7,"eps_greedy_SVM","SVM",97,18,884,879,5,1900,1641,259,0.837842544563449,0.299212598425197,1.28387096774194,689,259,430,13,1.7,68.25,6.3,0,0,0,0,0,0,0.0684020533339747,32.3548134806699,7.99821648572257
9.7,"eps_greedy_SVM","SVM",97,19,784,780,4,2000,1740,260,0.832269781443198,0.275590551181102,1.28387096774194,696,260,436,7,1.7,71.84,6.7,0,0,0,0,0,0,0.0571376123586945,22.8047823174714,6.81472120749123
9.7,"eps_greedy_SVM","SVM",97,20,684,681,3,2100,1839,261,0.819301911905562,0.275590551181102,1.28387096774194,688,261,427,-8,1.6,75.43,7,0,0,0,0,0,0,0.0526880227085879,17.8417775998328,7.32749829852761
9.7,"eps_greedy_SVM","SVM",97,21,584,582,2,2200,1938,262,0.818368971651056,0.259842519685039,1.28387096774194,710,262,448,22,1.7,79.02,7.4,0,0,0,0,0,0,0.0447883795714797,14.7351623536799,6.71213661915718
9.7,"eps_greedy_SVM","SVM",97,22,484,482,2,2300,2038,262,0.813013894590188,0.267716535433071,1.28387096774194,708,262,446,-2,1.7,82.61,7.8,0,0,0,0,0,0,0.0118693892638643,3.34094040949912,1.94422662205994
9.7,"eps_greedy_SVM","SVM",97,23,384,382,2,2400,2138,262,0.84332201365825,0.299212598425197,1.28387096774194,715,262,453,7,1.7,86.21,8.2,0,0,0,0,0,0,0.0160415260425171,4.15752659109023,2.35688207236114
9.7,"eps_greedy_SVM","SVM",97,24,284,283,1,2500,2237,263,0.806806732096882,0.21259842519685,1.28387096774194,716,263,453,1,1.7,89.8,8.5,0,0,0,0,0,0,0.00926753880276381,2.32914265576225,1.84873485770117
9.7,"eps_greedy_SVM","SVM",97,25,184,184,0,2600,2336,264,0.77802863504621,0.196850393700787,1.28387096774194,719,264,455,3,1.7,93.39,8.8,0,0,0,0,0,0,0.00889067130603165,2.23420070124041,1.80684309501474
9.7,"eps_greedy_SVM","SVM",97,26,84,84,0,2700,2436,264,0.800114440671219,0.236220472440945,1.28387096774194,718,264,454,-1,1.7,96.98,9.2,0,0,0,0,0,0,5.13688760241647e-06,0.14680560722046,0.14680560722046
9.7,"eps_greedy_SVM","SVM",97,27,0,0,0,2784,2520,264,0.763823064770932,0.149606299212598,1.28387096774194,731,264,467,13,1.8,100,9.5,0,0,0,0,0,0,0,0,0
9.7,"eps_greedy_SVM","SVM",98,0,2684,2425,259,100,91,9,0.761833429357924,0.16260162601626,1.27343299239444,26,9,17,0,1.9,3.59,10.1,0,0,0,0,0,0,0.261088956334049,266.914342631572,33.0053885701966
9.7,"eps_greedy_SVM","SVM",98,1,2584,2345,239,200,171,29,0.609500032008196,0.292682926829268,1.00204563335956,80,29,51,54,1.8,7.18,5.9,0,0,0,0,0,0,0.178433801207762,345.103796466781,19.4440390019215
9.7,"eps_greedy_SVM","SVM",98,2,2484,2280,204,300,236,64,0.661987068689587,0.146341463414634,1.09397087531133,158,64,94,78,1.5,10.78,3.7,0,0,0,0,0,0,0.464450214886611,454.603578791848,53.0777434540831
9.7,"eps_greedy_SVM","SVM",98,3,2384,2186,198,400,330,70,0.671499903975418,0.24390243902439,1.09598741148702,168,70,98,10,1.4,14.37,4.7,0,0,0,0,0,0,0.223128810773591,314.356375181196,27.2678987879419
9.7,"eps_greedy_SVM","SVM",98,4,2284,2106,178,500,410,90,0.745586070033933,0.252032520325203,1.20036716496197,220,90,130,52,1.4,17.96,4.6,0,0,0,0,0,0,0.187854305391045,251.921310735154,19.5398083263759
9.7,"eps_greedy_SVM","SVM",98,5,2184,2028,156,600,488,112,0.736079636386919,0.276422764227642,1.16905323891949,277,112,165,57,1.5,21.55,4.4,0,0,0,0,0,0,0.18150438656143,217.013845179637,18.7350220803821
9.7,"eps_greedy_SVM","SVM",98,6,2084,1964,120,700,552,148,0.744677037321564,0.284552845528455,1.21080514030947,351,148,203,74,1.4,25.14,3.7,0,0,0,0,0,0,0.207493044600106,201.006944534387,21.8364188788191
9.7,"eps_greedy_SVM","SVM",98,7,1984,1882,102,800,634,166,0.753856987388778,0.300813008130081,1.22124311565696,398,166,232,47,1.4,28.74,3.8,0,0,0,0,0,0,0.195189418007009,210.25540654006,20.3128630470436
9.7,"eps_greedy_SVM","SVM",98,8,1884,1805,79,900,711,189,0.721957621151024,0.235772357723577,1.20036716496197,461,189,272,63,1.4,32.33,3.8,0,0,0,0,0,0,0.20543208584776,235.633941688622,21.3635192650627
9.7,"eps_greedy_SVM","SVM",98,9,1784,1707,77,1000,809,191,0.739600537737666,0.308943089430894,1.20036716496197,462,191,271,1,1.4,35.92,4.2,0,0,0,0,0,0,0.181475864735949,233.38423670821,18.5118390245519
9.7,"eps_greedy_SVM","SVM",98,10,1684,1617,67,1100,899,201,0.747852250176057,0.292682926829268,1.22124311565696,518,201,317,56,1.6,39.51,4.5,0,0,0,0,0,0,0.167165161601841,155.315768581315,17.5833538417458
9.7,"eps_greedy_SVM","SVM",98,11,1584,1522,62,1200,994,206,0.786134050316895,0.292682926829268,1.27343299239444,522,206,316,4,1.5,43.1,4.8,0,0,0,0,0,0,0.153647430068176,154.44514619558,16.1878766469991
9.7,"eps_greedy_SVM","SVM",98,12,1484,1443,41,1300,1073,227,0.793579156264014,0.276422764227642,1.26299501704694,577,227,350,55,1.5,46.7,4.7,0,0,0,0,0,0,0.138724624518815,68.5569481131567,15.8634631809651
9.7,"eps_greedy_SVM","SVM",98,13,1384,1356,28,1400,1160,240,0.800166442609317,0.268292682926829,1.26299501704694,612,240,372,35,1.6,50.29,4.8,0,0,0,0,0,0,0.106998983174319,45.714715526173,13.8053833789361
9.7,"eps_greedy_SVM","SVM",98,14,1284,1267,17,1500,1249,251,0.804442737340768,0.260162601626016,1.25255704169945,646,251,395,34,1.6,53.88,5,0,0,0,0,0,0,0.139979358977732,84.209440386483,15.2978750562285
9.7,"eps_greedy_SVM","SVM",98,15,1184,1169,15,1600,1347,253,0.789213238589086,0.24390243902439,1.25255704169945,649,253,396,3,1.6,57.47,5.3,0,0,0,0,0,0,0.133869449486006,76.3015087403241,16.2563359180767
9.7,"eps_greedy_SVM","SVM",98,16,1084,1072,12,1700,1444,256,0.81232315472762,0.268292682926829,1.26299501704694,676,256,420,27,1.6,61.06,5.6,0,0,0,0,0,0,0.116483776232154,62.1246398690571,12.7572822161265
9.7,"eps_greedy_SVM","SVM",98,17,984,973,11,1800,1543,257,0.808623007489927,0.284552845528455,1.26299501704694,691,257,434,15,1.7,64.66,6,0,0,0,0,0,0,0.0671130424436598,26.0221318444292,8.27098807894208
9.7,"eps_greedy_SVM","SVM",98,18,884,873,11,1900,1643,257,0.808699827155761,0.252032520325203,1.26299501704694,681,257,424,-10,1.6,68.25,6.4,0,0,0,0,0,0,0.0606085841330485,20.7970723650028,6.82654643938853
9.7,"eps_greedy_SVM","SVM",98,19,784,775,9,2000,1741,259,0.785986812624042,0.211382113821138,1.26299501704694,696,259,437,15,1.7,71.84,6.7,0,0,0,0,0,0,0.0425363957582436,13.7015527419493,5.51033120972748
9.7,"eps_greedy_SVM","SVM",98,20,684,682,2,2100,1834,266,0.794622623391586,0.170731707317073,1.28387096774194,739,266,473,43,1.8,75.43,6.9,0,0,0,0,0,0,0.128148733759903,48.3622063673756,15.1974788659325
9.7,"eps_greedy_SVM","SVM",98,21,584,582,2,2200,1934,266,0.821189424492677,0.252032520325203,1.27343299239444,737,266,471,-2,1.8,79.02,7.3,0,0,0,0,0,0,0.0782416040928605,24.1480437805055,10.1573624213005
9.7,"eps_greedy_SVM","SVM",98,22,484,483,1,2300,2033,267,0.826630817489285,0.260162601626016,1.27343299239444,728,267,461,-9,1.7,82.61,7.6,0,0,0,0,0,0,0.0591877525175656,17.2348974799305,7.42199144966326
9.7,"eps_greedy_SVM","SVM",98,23,384,383,1,2400,2133,267,0.82058767044364,0.276422764227642,1.27343299239444,738,267,471,10,1.8,86.21,8,0,0,0,0,0,0,0.013291958448501,3.47844909108795,2.17453343045698
9.7,"eps_greedy_SVM","SVM",98,24,284,283,1,2500,2233,267,0.814813392228416,0.284552845528455,1.27343299239444,766,267,499,28,1.9,89.8,8.4,0,0,0,0,0,0,0.0132294588001017,3.00063531538535,1.9904481505873
9.7,"eps_greedy_SVM","SVM",98,25,184,184,0,2600,2332,268,0.806247999487867,0.260162601626016,1.28387096774194,732,268,464,-34,1.7,93.39,8.7,0,0,0,0,0,0,0.0115984397535349,3.81027395743209,3.27041170867895
9.7,"eps_greedy_SVM","SVM",98,26,84,84,0,2700,2432,268,0.82045323602843,0.308943089430894,1.28387096774194,768,268,500,36,1.9,96.98,9.1,0,0,0,0,0,0,0.000168933430639068,0.186783510738046,0.186783510738046
9.7,"eps_greedy_SVM","SVM",98,27,0,0,0,2784,2516,268,0.772568977658284,0.203252032520325,1.27343299239444,768,268,500,0,1.9,100,9.4,0,0,0,0,0,0,0,0,0
9.7,"eps_greedy_SVM","SVM",99,0,2684,2414,270,100,88,12,0.767962788304902,0.247706422018349,1.20142053862089,34,12,22,0,1.8,3.59,7.3,0,0,0,0,0,0,0.181262453422215,327.208543495195,19.6643653784944
9.7,"eps_greedy_SVM","SVM",99,1,2584,2350,234,200,152,48,0.783674869244625,0.211009174311927,1.22497780408405,109,48,61,75,1.3,7.18,3.2,0,0,0,0,0,0,0.262842715330032,447.572189128727,28.1360213126974
9.7,"eps_greedy_SVM","SVM",99,2,2484,2281,203,300,221,79,0.739189459544427,0.201834862385321,1.14252737496301,172,79,93,63,1.2,10.78,2.8,0,0,0,0,0,0,0.263672863416591,391.371391515799,28.3753985067868
9.7,"eps_greedy_SVM","SVM",99,3,2384,2201,183,400,301,99,0.715939295207065,0.211009174311927,1.15430600769458,227,99,128,55,1.3,14.37,3,0,0,0,0,0,0,0.216980538747457,250.717688390633,24.3044911983388
9.7,"eps_greedy_SVM","SVM",99,4,2284,2125,159,500,377,123,0.75142187544657,0.229357798165138,1.17786327315774,279,123,156,52,1.3,17.96,3.1,0,0,0,0,0,0,0.237315143106474,379.699508936628,24.5855914584281
9.7,"eps_greedy_SVM","SVM",99,5,2184,2054,130,600,448,152,0.753711880876854,0.201834862385321,1.17677868450842,357,152,205,78,1.3,21.55,2.9,0,0,0,0,0,0,0.238851537870197,288.299044314791,27.4919675302239
9.7,"eps_greedy_SVM","SVM",99,6,2084,1979,105,700,523,177,0.786854439966853,0.238532110091743,1.21319917135247,415,177,238,58,1.3,25.14,3,0,0,0,0,0,0,0.224778585454729,227.78364147407,24.184194850505
9.7,"eps_greedy_SVM","SVM",99,7,1984,1898,86,800,604,196,0.802616536625801,0.26605504587156,1.26031370227878,445,196,249,30,1.3,28.74,3.1,0,0,0,0,0,0,0.203658076952852,217.945015284445,21.8160086145959
9.7,"eps_greedy_SVM","SVM",99,8,1884,1810,74,900,692,208,0.814334505130188,0.256880733944954,1.26031370227878,480,208,272,35,1.3,32.33,3.3,0,0,0,0,0,0,0.176742736330159,182.320264475569,19.2726644351768
9.7,"eps_greedy_SVM","SVM",99,9,1784,1731,53,1000,771,229,0.82080082311584,0.247706422018349,1.26031370227878,542,229,313,62,1.4,35.92,3.4,0,0,0,0,0,0,0.190593100074611,191.819918019571,21.2041143720821
9.7,"eps_greedy_SVM","SVM",99,10,1684,1643,41,1100,859,241,0.823751750550177,0.211009174311927,1.27209233501036,555,241,314,13,1.3,39.51,3.6,0,0,0,0,0,0,0.178717703764657,94.5174739614689,21.0116626966926
9.7,"eps_greedy_SVM","SVM",99,11,1584,1549,35,1200,953,247,0.828510388979397,0.211009174311927,1.26031370227878,583,247,336,28,1.4,43.1,3.9,0,0,0,0,0,0,0.118188002958486,45.8889734692063,14.5949645910984
9.7,"eps_greedy_SVM","SVM",99,12,1484,1457,27,1300,1045,255,0.818707308011094,0.220183486238532,1.26031370227878,609,255,354,26,1.4,46.7,4.1,0,0,0,0,0,0,0.16950578438573,111.125871568028,18.5619526395412
9.7,"eps_greedy_SVM","SVM",99,13,1384,1360,24,1400,1142,258,0.825873846065911,0.201834862385321,1.26031370227878,636,258,378,27,1.5,50.29,4.4,0,0,0,0,0,0,0.129721530045519,53.3210822243662,14.4195895716805
9.7,"eps_greedy_SVM","SVM",99,14,1284,1261,23,1500,1241,259,0.819664751779135,0.229357798165138,1.26031370227878,637,259,378,1,1.5,53.88,4.8,0,0,0,0,0,0,0.16252663662146,144.718779029766,16.4943745430715
9.7,"eps_greedy_SVM","SVM",99,15,1184,1163,21,1600,1339,261,0.805524593443658,0.192660550458716,1.26031370227878,665,261,404,28,1.5,57.47,5.1,0,0,0,0,0,0,0.1081218027485,43.6290826373554,11.7717202121753
9.7,"eps_greedy_SVM","SVM",99,16,1084,1063,21,1700,1439,261,0.814656034753783,0.220183486238532,1.26031370227878,642,261,381,-23,1.5,61.06,5.5,0,0,0,0,0,0,0.0900060981997867,34.6793393240032,10.3486057727876
9.7,"eps_greedy_SVM","SVM",99,17,984,964,20,1800,1538,262,0.811840864271632,0.229357798165138,1.27209233501036,662,262,400,20,1.5,64.66,5.9,0,0,0,0,0,0,0.0975647477573172,57.3087656172484,10.9300614407076
9.7,"eps_greedy_SVM","SVM",99,18,884,866,18,1900,1636,264,0.812326731258399,0.211009174311927,1.26031370227878,661,264,397,-1,1.5,68.25,6.2,0,0,0,0,0,0,0.0484908054093722,17.3599939208344,6.45531462917118
9.7,"eps_greedy_SVM","SVM",99,19,784,767,17,2000,1735,265,0.805403126696967,0.211009174311927,1.26031370227878,665,265,400,4,1.5,71.84,6.5,0,0,0,0,0,0,0.0597213367598586,24.03065860579,7.36358986474225
9.7,"eps_greedy_SVM","SVM",99,20,684,667,17,2100,1835,265,0.800687358884226,0.192660550458716,1.27209233501036,660,265,395,-5,1.5,75.43,6.9,0,0,0,0,0,0,0.0172646294572222,5.82618135189421,2.98092887495199
9.7,"eps_greedy_SVM","SVM",99,21,584,569,15,2200,1933,267,0.78646145931579,0.192660550458716,1.26031370227878,686,267,419,26,1.6,79.02,7.2,0,0,0,0,0,0,0.069032999241644,23.034308200682,11.6923030695482
9.7,"eps_greedy_SVM","SVM",99,22,484,469,15,2300,2033,267,0.800523021521054,0.174311926605505,1.26031370227878,684,267,417,-2,1.6,82.61,7.6,0,0,0,0,0,0,0.0198646456300045,6.54446675157255,3.5291307189567
9.7,"eps_greedy_SVM","SVM",99,23,384,370,14,2400,2132,268,0.789655320243509,0.155963302752294,1.26031370227878,678,268,410,-6,1.5,86.21,8,0,0,0,0,0,0,0.00925365888567022,2.3815142964578,1.38459187891826
9.7,"eps_greedy_SVM","SVM",99,24,284,276,8,2500,2226,274,0.797050501586216,0.201834862385321,1.27209233501036,715,274,441,37,1.6,89.8,8.1,0,0,0,0,0,0,0.0245688478865481,7.66494949541428,6.97854248599324
9.7,"eps_greedy_SVM","SVM",99,25,184,184,0,2600,2318,282,0.775908142559093,0.18348623853211,1.27209233501036,756,282,474,41,1.7,93.39,8.2,0,0,0,0,0,0,0.00346090119587602,1.56358616739561,1.43203900917666
9.7,"eps_greedy_SVM","SVM",99,26,84,84,0,2700,2418,282,0.764654605733233,0.201834862385321,1.27209233501036,740,282,458,-16,1.6,96.98,8.6,0,0,0,0,0,0,2.77578204877038e-06,0.193137199682853,0.193137199682853
9.7,"eps_greedy_SVM","SVM",99,27,0,0,0,2784,2502,282,0.774050415844982,0.119266055045872,1.27209233501036,754,282,472,14,1.7,100,8.9,0,0,0,0,0,0,0,0,0
9.7,"eps_greedy_SVM","SVM",100,0,2684,2444,240,100,91,9,0.705976064219049,0.316901408450704,1.21154020899591,27,9,18,0,2,3.59,10.1,0,0,0,0,0,0,0.157552225466152,249.602709762908,22.4595881814727
9.7,"eps_greedy_SVM","SVM",100,1,2584,2372,212,200,163,37,0.739250852838851,0.246478873239437,1.26578827805543,94,37,57,67,1.5,7.18,4.4,0,0,0,0,0,0,0.259368596918628,326.419659714386,34.3503855456336
9.7,"eps_greedy_SVM","SVM",100,2,2484,2285,199,300,250,50,0.847496650566869,0.387323943661972,1.28387096774194,115,50,65,21,1.3,10.78,5,0,0,0,0,0,0,0.198158900738797,196.320901937647,21.967879245009
9.7,"eps_greedy_SVM","SVM",100,3,2384,2216,168,400,319,81,0.847158892604226,0.373239436619718,1.28387096774194,191,81,110,76,1.4,14.37,3.9,0,0,0,0,0,0,0.211339830315288,161.121262912866,24.0384239160576
9.7,"eps_greedy_SVM","SVM",100,4,2284,2143,141,500,392,108,0.851369608538522,0.330985915492958,1.28387096774194,267,108,159,76,1.5,17.96,3.6,0,0,0,0,0,0,0.241770541708212,139.519967091221,25.1395259744242
9.7,"eps_greedy_SVM","SVM",100,5,2184,2074,110,600,461,139,0.849151664583826,0.316901408450704,1.28387096774194,332,139,193,65,1.4,21.55,3.3,0,0,0,0,0,0,0.238265120116838,106.738423687937,25.7785629731346
9.7,"eps_greedy_SVM","SVM",100,6,2084,1991,93,700,544,156,0.848887087513086,0.345070422535211,1.27482962289868,382,156,226,50,1.4,25.14,3.5,0,0,0,0,0,0,0.223362794570152,168.87882615265,23.4613158744895
9.7,"eps_greedy_SVM","SVM",100,7,1984,1907,77,800,628,172,0.833355850530842,0.316901408450704,1.27482962289868,431,172,259,49,1.5,28.74,3.7,0,0,0,0,0,0,0.197606774938102,101.482189568772,22.3972815940343
9.7,"eps_greedy_SVM","SVM",100,8,1884,1815,69,900,720,180,0.829139505297167,0.288732394366197,1.27482962289868,460,180,280,29,1.6,32.33,4,0,0,0,0,0,0,0.151925928002128,80.2577774881659,18.4756574257497
9.7,"eps_greedy_SVM","SVM",100,9,1784,1720,64,1000,815,185,0.829612366444869,0.330985915492958,1.27482962289868,469,185,284,9,1.5,35.92,4.4,0,0,0,0,0,0,0.145106386892472,94.5305409152296,18.6940681077558
9.7,"eps_greedy_SVM","SVM",100,10,1684,1638,46,1100,897,203,0.839626890037264,0.302816901408451,1.28387096774194,508,203,305,39,1.5,39.51,4.4,0,0,0,0,0,0,0.167839925686217,156.340973471051,18.3484173347355
9.7,"eps_greedy_SVM","SVM",100,11,1584,1553,31,1200,982,218,0.832562119318628,0.295774647887324,1.28387096774194,574,218,356,66,1.6,43.1,4.5,0,0,0,0,0,0,0.120814525394043,47.0231227968013,15.612931913366
9.7,"eps_greedy_SVM","SVM",100,12,1484,1462,22,1300,1073,227,0.814154310354528,0.267605633802817,1.26578827805543,589,227,362,15,1.6,46.7,4.7,0,0,0,0,0,0,0.14412575271527,43.3104191305083,17.8695922865697
9.7,"eps_greedy_SVM","SVM",100,13,1384,1369,15,1400,1166,234,0.808119701421957,0.267605633802817,1.26578827805543,615,234,381,26,1.6,50.29,5,0,0,0,0,0,0,0.0933616411382183,32.8600381793756,12.6509889268347
9.7,"eps_greedy_SVM","SVM",100,14,1284,1275,9,1500,1260,240,0.800846646626355,0.23943661971831,1.26578827805543,634,240,394,19,1.6,53.88,5.2,0,0,0,0,0,0,0.107226748710797,37.8069598246235,16.993585367678
9.7,"eps_greedy_SVM","SVM",100,15,1184,1176,8,1600,1359,241,0.803239098861753,0.267605633802817,1.27482962289868,669,241,428,35,1.8,57.47,5.6,0,0,0,0,0,0,0.0615717783363638,20.1101374392948,7.8539418911077
9.7,"eps_greedy_SVM","SVM",100,16,1084,1077,7,1700,1458,242,0.817593812274126,0.302816901408451,1.26578827805543,656,242,414,-13,1.7,61.06,6,0,0,0,0,0,0,0.111226655855955,70.4620272508075,11.9514802061417
9.7,"eps_greedy_SVM","SVM",100,17,984,978,6,1800,1557,243,0.77755260580268,0.23943661971831,1.26578827805543,683,243,440,27,1.8,64.66,6.4,0,0,0,0,0,0,0.0315993084786059,9.67697922403679,5.11589952135334
9.7,"eps_greedy_SVM","SVM",100,18,884,880,4,1900,1655,245,0.793128877179942,0.23943661971831,1.28387096774194,700,245,455,17,1.9,68.25,6.8,0,0,0,0,0,0,0.0276622313618042,10.5272382753162,7.91810201262746
9.7,"eps_greedy_SVM","SVM",100,19,784,780,4,2000,1755,245,0.812155909075551,0.309859154929577,1.26578827805543,709,245,464,9,1.9,71.84,7.2,0,0,0,0,0,0,0.0168048102665998,5.26588543535216,3.28039735629836
9.7,"eps_greedy_SVM","SVM",100,20,684,681,3,2100,1854,246,0.772756442733141,0.267605633802817,1.25674693321218,715,246,469,6,1.9,75.43,7.5,0,0,0,0,0,0,0.109987633145549,31.8753375322655,14.3954136499128
9.7,"eps_greedy_SVM","SVM",100,21,584,582,2,2200,1953,247,0.743728960493576,0.183098591549296,1.25558970767515,712,247,465,-3,1.9,79.02,7.9,0,0,0,0,0,0,0.0242762762940041,10.0401368483229,8.53242172230567
9.7,"eps_greedy_SVM","SVM",100,22,484,484,0,2300,2051,249,0.76865268348701,0.246478873239437,1.27482962289868,723,249,474,11,1.9,82.61,8.2,0,0,0,0,0,0,0.010501020972492,4.16303148085693,3.6341855197352
9.7,"eps_greedy_SVM","SVM",100,23,384,384,0,2400,2151,249,0.744767566228704,0.204225352112676,1.27482962289868,738,249,489,15,2,86.21,8.6,0,0,0,0,0,0,0.00295017305214161,0.815062953541374,0.662216886682506
9.7,"eps_greedy_SVM","SVM",100,24,284,284,0,2500,2251,249,0.788974454239421,0.28169014084507,1.27482962289868,726,249,477,-12,1.9,89.8,9,0,0,0,0,0,0,0.00038502888740373,0.170369512855253,0.155349735497451
9.7,"eps_greedy_SVM","SVM",100,25,184,184,0,2600,2351,249,0.800069803312274,0.316901408450704,1.27482962289868,732,249,483,6,1.9,93.39,9.4,0,0,0,0,0,0,0.000177839853559455,0.178704924821783,0.174747972919345
9.7,"eps_greedy_SVM","SVM",100,26,84,84,0,2700,2451,249,0.788985712838176,0.288732394366197,1.27482962289868,743,249,494,11,2,96.98,9.8,0,0,0,0,0,0,1.0000000994736e-07,1.50279098282884e-05,1.50279098282884e-05
9.7,"eps_greedy_SVM","SVM",100,27,0,0,0,2784,2535,249,0.800728431339432,0.316901408450704,1.27482962289868,721,249,472,-22,1.9,100,10.2,0,0,0,0,0,0,0,0,0
