"Imb.R","Policy","Inducer","Repetition","Iteration","Nu","Nu_majority","Nu_minority","Nl","Nl_majority","Nl_minority","AUC","PRBEP","LIFT","SV_total","SV_minority","SV_majority","SV.diff","SV.R","Data_Efficiency","Imb.R.Empirical","tr.alpha","tr.beta","tr.alpha_minority","tr.beta_minority","tr.alpha_majority","tr.beta_majority","Quantile","Nu_minority.est","Qt_minority.est"
8.7,"random_instances_SVM","SVM",1,0,3812,3438,374,100,92,8,0.891300313427912,0.540178571428571,1.76398863933142,23,8,15,0,1.9,2.56,11.5,0,0,0,0,0,0,0.649057055194634,442.015649889589,76.7469440673465
8.7,"random_instances_SVM","SVM",1,1,3712,3352,360,200,178,22,0.896225977400204,0.611607142857143,1.71423633969717,52,22,30,29,1.4,5.11,8.1,0,0,0,0,0,0,0.405592387696947,354.163591661314,47.1885395799846
8.7,"random_instances_SVM","SVM",1,2,3612,3261,351,300,269,31,0.896751793962394,0.598214285714286,1.71281262275763,72,31,41,20,1.3,7.67,8.7,0,0,0,0,0,0,0.682509936347822,371.111095026315,74.6243623839542
8.7,"random_instances_SVM","SVM",1,3,3512,3172,340,400,358,42,0.893068500494886,0.611607142857143,1.71124411302983,91,42,49,19,1.2,10.22,8.5,0,0,0,0,0,0,0.737996819236055,333.404789505221,82.3406920826973
8.7,"random_instances_SVM","SVM",1,4,3412,3081,331,500,449,51,0.901247010062689,0.620535714285714,1.7159582841401,109,51,58,18,1.1,12.78,8.8,0,0,0,0,0,0,0.668488582998043,335.877238876864,74.4927107070746
8.7,"random_instances_SVM","SVM",1,5,3312,2995,317,600,535,65,0.906489710491595,0.611607142857143,1.74482044198895,141,65,76,32,1.2,15.34,8.2,0,0,0,0,0,0,0.76469651992778,369.763792499,82.0885651102685
8.7,"random_instances_SVM","SVM",1,6,3212,2905,307,700,625,75,0.909095595513036,0.611607142857143,1.74642857142857,155,75,80,14,1.1,17.89,8.3,0,0,0,0,0,0,0.790258378954777,352.772170887965,85.0357464333497
8.7,"random_instances_SVM","SVM",1,7,3112,2810,302,800,720,80,0.906559303860119,0.607142857142857,1.74321527138914,167,80,87,12,1.1,20.45,9,0,0,0,0,0,0,0.780941911458026,326.38723719582,84.6281397447645
8.7,"random_instances_SVM","SVM",1,8,3012,2715,297,900,815,85,0.912737648465854,0.625,1.74963891806723,180,85,95,13,1.1,23.01,9.6,0,0,0,0,0,0,0.664887231500965,275.41008093145,75.5190721823622
8.7,"random_instances_SVM","SVM",1,9,2912,2621,291,1000,909,91,0.916902940448698,0.633928571428571,1.76731502168485,192,91,101,12,1.1,25.56,10,0,0,0,0,0,0,0.625115730502254,252.181793651832,72.7216736665698
8.7,"random_instances_SVM","SVM",1,10,2812,2532,280,1100,998,102,0.918642774661829,0.633928571428571,1.7704619921363,211,102,109,19,1.1,28.12,9.8,0,0,0,0,0,0,0.695605833672079,266.328307438235,79.4308169981801
8.7,"random_instances_SVM","SVM",1,11,2712,2444,268,1200,1086,114,0.926877989937318,0.651785714285714,1.77862080315997,240,114,126,29,1.1,30.67,9.5,0,0,0,0,0,0,0.683337707602132,258.265431191549,77.5028458568292
8.7,"random_instances_SVM","SVM",1,12,2612,2351,261,1300,1179,121,0.9260918426262,0.651785714285714,1.77534827178341,251,121,130,11,1.1,33.23,9.7,0,0,0,0,0,0,0.697408890820942,251.528770342057,79.2367037500645
8.7,"random_instances_SVM","SVM",1,13,2512,2260,252,1400,1270,130,0.924264372319371,0.638392857142857,1.78174238445378,270,130,140,19,1.1,35.79,9.8,0,0,0,0,0,0,0.691478709523443,243.829649826395,78.5712962607377
8.7,"random_instances_SVM","SVM",1,14,2412,2170,242,1500,1360,140,0.925884351286709,0.651785714285714,1.78174238445378,289,140,149,19,1.1,38.34,9.7,0,0,0,0,0,0,0.656422082408847,228.106369342459,76.8516749941312
8.7,"random_instances_SVM","SVM",1,15,2312,2081,231,1600,1449,151,0.92637279363247,0.647321428571429,1.78338152188198,311,151,160,22,1.1,40.9,9.6,0,0,0,0,0,0,0.740617528089707,236.253187152253,83.8529237978202
8.7,"random_instances_SVM","SVM",1,16,2212,1990,222,1700,1540,160,0.926947583305846,0.65625,1.78338152188198,330,160,170,19,1.1,43.46,9.6,0,0,0,0,0,0,0.711863025681257,226.695179949006,81.992445486454
8.7,"random_instances_SVM","SVM",1,17,2112,1907,205,1800,1623,177,0.925457769712975,0.65625,1.77534827178341,363,176,187,33,1.1,46.01,9.2,0,0,0,0,0,0,0.686160788073977,209.967911653563,81.4355611446818
8.7,"random_instances_SVM","SVM",1,18,2012,1823,189,1900,1707,193,0.927630629330258,0.651785714285714,1.77534827178341,389,190,199,26,1,48.57,8.8,0,0,0,0,0,0,0.625563381697602,186.844838159553,75.8430011851325
8.7,"random_instances_SVM","SVM",1,19,1912,1730,182,2000,1800,200,0.927731153084794,0.651785714285714,1.77534827178341,402,196,206,13,1.1,51.12,9,0,0,0,0,0,0,0.644484233407572,186.752980795349,76.9863377494927
8.7,"random_instances_SVM","SVM",1,20,1812,1640,172,2100,1890,210,0.928488947542068,0.665178571428571,1.76883920387587,424,207,217,22,1,53.68,9,0,0,0,0,0,0,0.614108259993271,171.344179532208,75.0150095242986
8.7,"random_instances_SVM","SVM",1,21,1712,1546,166,2200,1984,216,0.928090718822173,0.660714285714286,1.7704619921363,436,213,223,12,1,56.24,9.2,0,0,0,0,0,0,0.582591163644537,166.806386064263,73.6980646329282
8.7,"random_instances_SVM","SVM",1,22,1612,1459,153,2300,2071,229,0.929733895579023,0.647321428571429,1.77862080315997,470,229,241,34,1.1,58.79,9,0,0,0,0,0,0,0.594255468614515,159.334792546981,75.9990413004523
8.7,"random_instances_SVM","SVM",1,23,1512,1367,145,2400,2163,237,0.930584481194332,0.651785714285714,1.77371651785714,485,236,249,15,1.1,61.35,9.1,0,0,0,0,0,0,0.594618812421,152.899009663338,77.5301901330539
8.7,"random_instances_SVM","SVM",1,24,1412,1275,137,2500,2255,245,0.930081862421652,0.651785714285714,1.76731502168485,504,245,259,19,1.1,63.91,9.2,0,0,0,0,0,0,0.557343564963067,144.501016345973,76.9333185908522
8.7,"random_instances_SVM","SVM",1,25,1312,1187,125,2600,2343,257,0.928763454717924,0.647321428571429,1.76894238358327,532,257,275,28,1.1,66.46,9.1,0,0,0,0,0,0,0.524684881711906,134.551135341324,73.684519978922
8.7,"random_instances_SVM","SVM",1,26,1212,1097,115,2700,2433,267,0.928699016413734,0.651785714285714,1.7656906512605,554,267,287,22,1.1,69.02,9.1,0,0,0,0,0,0,0.5,123.062065316109,72.5210768319975
8.7,"random_instances_SVM","SVM",1,27,1112,1007,105,2800,2523,277,0.930540663147484,0.651785714285714,1.76894238358327,575,276,299,21,1.1,71.57,9.1,0,0,0,0,0,0,0.464015163423287,110.064940885663,68.937407808781
8.7,"random_instances_SVM","SVM",1,28,1012,916,96,2900,2614,286,0.929945253216767,0.642857142857143,1.77057274522712,593,286,307,18,1.1,74.13,9.1,0,0,0,0,0,0,0.357676180305498,94.8594016656902,62.6205613960642
8.7,"random_instances_SVM","SVM",1,29,912,822,90,3000,2708,292,0.929718430386018,0.642857142857143,1.77057274522712,603,292,311,10,1.1,76.69,9.3,0,0,0,0,0,0,0.32990174493428,87.7296500212933,63.1308835287311
8.7,"random_instances_SVM","SVM",1,30,812,733,79,3100,2797,303,0.931127051715612,0.638392857142857,1.76894238358327,622,303,319,19,1.1,79.24,9.2,0,0,0,0,0,0,0.265841288930739,76.4395439414562,58.6714673359064
8.7,"random_instances_SVM","SVM",1,31,712,643,69,3200,2887,313,0.930043199439136,0.642857142857143,1.77057274522712,644,313,331,22,1.1,81.8,9.2,0,0,0,0,0,0,0.175460903291912,67.2191977552611,53.9320534843239
8.7,"random_instances_SVM","SVM",1,32,612,554,58,3300,2976,324,0.927957975915548,0.638392857142857,1.76731502168485,664,324,340,20,1,84.36,9.2,0,0,0,0,0,0,0.132822727384678,57.0940220741256,44.6170198870065
8.7,"random_instances_SVM","SVM",1,33,512,464,48,3400,3066,334,0.929708120257348,0.642857142857143,1.76731502168485,685,334,351,21,1.1,86.91,9.2,0,0,0,0,0,0,0.0897128233568231,49.8513668561702,43.2696656294246
8.7,"random_instances_SVM","SVM",1,34,412,378,34,3500,3152,348,0.929697810128678,0.638392857142857,1.76894238358327,717,348,369,32,1.1,89.47,9.1,0,0,0,0,0,0,0.0655109831790042,41.1132104756279,37.2149432164424
8.7,"random_instances_SVM","SVM",1,35,312,290,22,3600,3240,360,0.930708202738378,0.638392857142857,1.76245085190039,741,360,381,24,1.1,92.02,9,0,0,0,0,0,0,0.0490954936064261,33.7164022318483,31.8439599278204
8.7,"random_instances_SVM","SVM",1,36,212,199,13,3700,3331,369,0.930458182118119,0.638392857142857,1.76731502168485,755,368,387,14,1.1,94.58,9,0,0,0,0,0,0,0.0158261645779619,20.1068898192534,19.7365224216444
8.7,"random_instances_SVM","SVM",1,37,112,103,9,3800,3427,373,0.929465832233594,0.642857142857143,1.76731502168485,763,373,390,8,1,97.14,9.2,0,0,0,0,0,0,0.000367339697459191,10.5311154671403,10.5295341506687
8.7,"random_instances_SVM","SVM",1,38,12,12,0,3900,3518,382,0.928883309963717,0.638392857142857,1.76731502168485,788,382,406,25,1.1,99.69,9.2,0,0,0,0,0,0,0.000130372947954929,0.741483672234459,0.741483672234459
8.7,"random_instances_SVM","SVM",1,39,0,0,0,3912,3530,382,0.92862942304521,0.638392857142857,1.7656906512605,785,382,403,-3,1.1,100,9.2,0,0,0,0,0,0,0,0,0
8.7,"random_instances_SVM","SVM",2,0,3812,3426,386,100,87,13,0.918857704747778,0.579710144927536,1.77878920961925,30,13,17,0,1.3,2.56,6.7,0,0,0,0,0,0,0.70659886270428,488.667041672181,75.5993051321643
8.7,"random_instances_SVM","SVM",2,1,3712,3342,370,200,171,29,0.923315738738216,0.579710144927536,1.79944802207912,57,27,30,27,1.1,5.11,5.9,0,0,0,0,0,0,0.809610287623083,464.387773644915,85.521919024113
8.7,"random_instances_SVM","SVM",2,2,3612,3247,365,300,266,34,0.922378004822632,0.594202898550725,1.79240398217098,72,34,38,15,1.1,7.67,7.8,0,0,0,0,0,0,0.812334345961696,419.628944793987,86.1909799971519
8.7,"random_instances_SVM","SVM",2,3,3512,3156,356,400,357,43,0.922255091246068,0.599033816425121,1.75760002135212,92,43,49,20,1.1,10.22,8.3,0,0,0,0,0,0,0.778192893385309,366.502026342041,82.836205655276
8.7,"random_instances_SVM","SVM",2,4,3412,3066,346,500,447,53,0.921560422380774,0.603864734299517,1.76305413469736,115,53,62,23,1.2,12.78,8.4,0,0,0,0,0,0,0.748668038187683,360.486645990249,80.6719062536476
8.7,"random_instances_SVM","SVM",2,5,3312,2979,333,600,534,66,0.923324025046764,0.599033816425121,1.78534695785748,139,66,73,24,1.1,15.34,8.1,0,0,0,0,0,0,0.846191165727891,378.207895083271,89.445943842724
8.7,"random_instances_SVM","SVM",2,6,3212,2892,320,700,621,79,0.921989929373042,0.589371980676328,1.7820620508513,162,78,84,23,1.1,17.89,7.9,0,0,0,0,0,0,0.738290900723723,352.237373023878,79.8471799534447
8.7,"random_instances_SVM","SVM",2,7,3112,2798,314,800,715,85,0.923453843880436,0.589371980676328,1.77336906523739,178,85,93,16,1.1,20.45,8.4,0,0,0,0,0,0,0.792170652864282,333.978586971446,85.3588413945075
8.7,"random_instances_SVM","SVM",2,8,3012,2706,306,900,807,93,0.927298691039477,0.599033816425121,1.78910912190963,196,93,103,18,1.1,23.01,8.7,0,0,0,0,0,0,0.80672846084714,327.951862409768,86.7481172204908
8.7,"random_instances_SVM","SVM",2,9,2912,2614,298,1000,899,101,0.929573282731625,0.618357487922705,1.78910912190963,211,101,110,15,1.1,25.56,8.9,0,0,0,0,0,0,0.811742278431253,311.640838559325,87.6049988802459
8.7,"random_instances_SVM","SVM",2,10,2812,2524,288,1100,989,111,0.929339885041298,0.623188405797101,1.79240398217098,232,111,121,21,1.1,28.12,8.9,0,0,0,0,0,0,0.731903083363881,298.659599003593,80.3699642476046
8.7,"random_instances_SVM","SVM",2,11,2712,2436,276,1200,1077,123,0.932608833757329,0.613526570048309,1.78910912190963,260,123,137,28,1.1,30.67,8.8,0,0,0,0,0,0,0.792965237206275,297.003995928619,85.7634329600314
8.7,"random_instances_SVM","SVM",2,12,2612,2347,265,1300,1166,134,0.93431719436643,0.618357487922705,1.794055967408,278,134,144,18,1.1,33.23,8.7,0,0,0,0,0,0,0.774116830936799,282.417042077309,85.7967297800423
8.7,"random_instances_SVM","SVM",2,13,2512,2263,249,1400,1250,150,0.930900473148231,0.603864734299517,1.78255560864257,310,150,160,32,1.1,35.79,8.3,0,0,0,0,0,0,0.754699284165859,273.13392920582,84.5458126842505
8.7,"random_instances_SVM","SVM",2,14,2412,2173,239,1500,1340,160,0.93602693602695,0.608695652173913,1.78418948179439,333,160,173,23,1.1,38.34,8.4,0,0,0,0,0,0,0.730007969956049,254.613087641188,84.0759047890378
8.7,"random_instances_SVM","SVM",2,15,2312,2083,229,1600,1430,170,0.937814016567113,0.618357487922705,1.78746623015398,352,170,182,19,1.1,40.9,8.4,0,0,0,0,0,0,0.74532924503724,251.473325512112,86.3520352446937
8.7,"random_instances_SVM","SVM",2,16,2212,1991,221,1700,1522,178,0.938842899876553,0.613526570048309,1.79240398217098,375,178,197,23,1.1,43.46,8.6,0,0,0,0,0,0,0.734362192816333,238.369202141174,86.1342653898212
8.7,"random_instances_SVM","SVM",2,17,2112,1898,214,1800,1615,185,0.938236618302267,0.613526570048309,1.794055967408,388,185,203,13,1.1,46.01,8.7,0,0,0,0,0,0,0.68530249620699,220.996480053398,82.8482718805952
8.7,"random_instances_SVM","SVM",2,18,2012,1807,205,1900,1706,194,0.937834732338444,0.623188405797101,1.79240398217098,404,194,210,16,1.1,48.57,8.8,0,0,0,0,0,0,0.646639943354712,202.929368207894,80.4444423526733
8.7,"random_instances_SVM","SVM",2,19,1912,1718,194,2000,1795,205,0.939418798319558,0.623188405797101,1.79075503646521,427,205,222,23,1.1,51.12,8.8,0,0,0,0,0,0,0.676858866180617,194.796108182882,81.9716943974549
8.7,"random_instances_SVM","SVM",2,20,1812,1629,183,2100,1884,216,0.939659101266998,0.623188405797101,1.794055967408,448,216,232,21,1.1,53.68,8.7,0,0,0,0,0,0,0.649665173299954,188.611973674176,81.0980897502714
8.7,"random_instances_SVM","SVM",2,21,1712,1539,173,2200,1974,226,0.940178376601694,0.613526570048309,1.78910912190963,474,226,248,26,1.1,56.24,8.7,0,0,0,0,0,0,0.544520470571549,167.198741184482,73.5702501043804
8.7,"random_instances_SVM","SVM",2,22,1612,1447,165,2300,2066,234,0.940189425013071,0.613526570048309,1.79240398217098,488,234,254,14,1.1,58.79,8.8,0,0,0,0,0,0,0.622788164069051,170.867466755869,81.4269248985482
8.7,"random_instances_SVM","SVM",2,23,1512,1357,155,2400,2156,244,0.94021428393867,0.599033816425121,1.78910912190963,507,244,263,19,1.1,61.35,8.8,0,0,0,0,0,0,0.581126694902373,158.453451573038,79.1064469088837
8.7,"random_instances_SVM","SVM",2,24,1412,1269,143,2500,2244,256,0.940794325535935,0.603864734299517,1.794055967408,527,256,271,20,1.1,63.91,8.8,0,0,0,0,0,0,0.543336924117505,144.203900325042,76.1862234780411
8.7,"random_instances_SVM","SVM",2,25,1312,1182,130,2600,2331,269,0.942218189552088,0.618357487922705,1.78582635287861,558,269,289,31,1.1,66.46,8.7,0,0,0,0,0,0,0.480896048185057,130.471363512007,72.2775382138368
8.7,"random_instances_SVM","SVM",2,26,1212,1091,121,2700,2422,278,0.941697533165967,0.618357487922705,1.79075503646521,572,278,294,14,1.1,69.02,8.7,0,0,0,0,0,0,0.400196218745434,114.961072873514,68.3591021251319
8.7,"random_instances_SVM","SVM",2,27,1112,998,114,2800,2515,285,0.940783277124561,0.608695652173913,1.78746623015398,586,285,301,14,1.1,71.57,8.8,0,0,0,0,0,0,0.412106329246415,108.996383410804,69.4127015224922
8.7,"random_instances_SVM","SVM",2,28,1012,906,106,2900,2607,293,0.9413301734877,0.608695652173913,1.794055967408,602,293,309,16,1.1,74.13,8.9,0,0,0,0,0,0,0.354800197458555,98.7159545926862,65.5551910803014
8.7,"random_instances_SVM","SVM",2,29,912,823,89,3000,2690,310,0.941030485329112,0.603864734299517,1.79240398217098,636,308,328,34,1.1,76.69,8.7,0,0,0,0,0,0,0.280926702637434,86.2446188694848,60.4965727015369
8.7,"random_instances_SVM","SVM",2,30,812,733,79,3100,2780,320,0.941036009534797,0.603864734299517,1.79240398217098,657,320,337,21,1.1,79.24,8.7,0,0,0,0,0,0,0.224671038333183,78.8447040994367,58.126751587863
8.7,"random_instances_SVM","SVM",2,31,712,640,72,3200,2873,327,0.941642291109084,0.608695652173913,1.78910912190963,672,327,345,15,1.1,81.8,8.8,0,0,0,0,0,0,0.169136777327738,67.2787965197689,51.2283086771035
8.7,"random_instances_SVM","SVM",2,32,612,550,62,3300,2963,337,0.942169852752315,0.603864734299517,1.78746623015398,694,337,357,22,1.1,84.36,8.8,0,0,0,0,0,0,0.127351880601019,55.4365881507241,43.9359202979966
8.7,"random_instances_SVM","SVM",2,33,512,461,51,3400,3052,348,0.942167090649471,0.618357487922705,1.79240398217098,707,347,360,13,1,86.91,8.8,0,0,0,0,0,0,0.101324752566164,46.6906426906947,38.3959886670079
8.7,"random_instances_SVM","SVM",2,34,412,369,43,3500,3144,356,0.942512353504988,0.618357487922705,1.79240398217098,730,356,374,23,1.1,89.47,8.8,0,0,0,0,0,0,0.0709648813109901,40.5380902614066,35.9672273379917
8.7,"random_instances_SVM","SVM",2,35,312,281,31,3600,3232,368,0.943155923467673,0.628019323671498,1.794055967408,755,368,387,25,1.1,92.02,8.8,0,0,0,0,0,0,0.0491367215164351,28.208323749478,26.4263095301026
8.7,"random_instances_SVM","SVM",2,36,212,190,22,3700,3323,377,0.943745632424898,0.632850241545894,1.79240398217098,776,377,399,21,1.1,94.58,8.8,0,0,0,0,0,0,0.0165409619028309,21.1072448609331,20.7886299185956
8.7,"random_instances_SVM","SVM",2,37,112,103,9,3800,3410,390,0.943796731327513,0.628019323671498,1.78418948179439,792,389,403,16,1,97.14,8.7,0,0,0,0,0,0,0.000698913501367309,9.62224293991155,9.61736062113928
8.7,"random_instances_SVM","SVM",2,38,12,12,0,3900,3501,399,0.943991459578024,0.628019323671498,1.78582635287861,810,396,414,18,1,99.69,8.8,0,0,0,0,0,0,0.000608775383077525,0.437006433493384,0.437006433493384
8.7,"random_instances_SVM","SVM",2,39,0,0,0,3912,3513,399,0.944140613131607,0.628019323671498,1.78582635287861,814,398,416,4,1,100,8.8,0,0,0,0,0,0,0,0,0
8.7,"random_instances_SVM","SVM",3,0,3812,3422,390,100,84,16,0.880196469248293,0.475,1.68527956003666,42,16,26,0,1.6,2.56,5.2,0,0,0,0,0,0,0.545189454700446,556.848945402155,68.4373209448846
8.7,"random_instances_SVM","SVM",3,1,3712,3338,374,200,168,32,0.894703872437369,0.55,1.69114364135407,75,32,43,33,1.3,5.11,5.2,0,0,0,0,0,0,0.658321768255992,498.629597438509,77.1238562176858
8.7,"random_instances_SVM","SVM",3,2,3612,3250,362,300,256,44,0.913522209567208,0.57,1.73010082493126,97,44,53,22,1.2,7.67,5.8,0,0,0,0,0,0,0.825583117104148,499.230977295282,87.9458395515321
8.7,"random_instances_SVM","SVM",3,3,3512,3160,352,400,346,54,0.91276765375856,0.555,1.75284926470588,135,54,81,38,1.5,10.22,6.4,0,0,0,0,0,0,0.640475179673994,447.701688907041,73.1562133719133
8.7,"random_instances_SVM","SVM",3,4,3412,3068,344,500,438,62,0.924011958997732,0.58,1.76345906163753,153,62,91,18,1.5,12.78,7.1,0,0,0,0,0,0,0.483212795533741,396.255894900332,60.5294092603403
8.7,"random_instances_SVM","SVM",3,5,3312,2980,332,600,526,74,0.933712984054681,0.615,1.77408839779006,173,74,99,20,1.3,15.34,7.1,0,0,0,0,0,0,0.487630231441003,390.419579744945,55.6934615120093
8.7,"random_instances_SVM","SVM",3,6,3212,2889,323,700,617,83,0.935435649202744,0.62,1.76022038567493,191,83,108,18,1.3,17.89,7.4,0,0,0,0,0,0,0.61659842168014,361.417450315547,73.021412126963
8.7,"random_instances_SVM","SVM",3,7,3112,2796,316,800,710,90,0.936926252847389,0.61,1.76434065934066,203,90,113,12,1.3,20.45,7.9,0,0,0,0,0,0,0.609267518623825,329.406250842655,74.0521645458471
8.7,"random_instances_SVM","SVM",3,8,3012,2707,305,900,799,101,0.942639521640105,0.615,1.78309392265193,222,101,121,19,1.2,23.01,7.9,0,0,0,0,0,0,0.626497095135899,316.278690387561,72.953565659796
8.7,"random_instances_SVM","SVM",3,9,2912,2614,298,1000,892,108,0.944877562642381,0.635,1.78473732718894,239,108,131,17,1.2,25.56,8.3,0,0,0,0,0,0,0.674891564668191,315.984412136934,77.220105348318
8.7,"random_instances_SVM","SVM",3,10,2812,2528,284,1100,978,122,0.941378132118458,0.64,1.77981617647059,267,122,145,28,1.2,28.12,8,0,0,0,0,0,0,0.642852102742622,311.7276806279,73.6181143582616
8.7,"random_instances_SVM","SVM",3,11,2712,2437,275,1200,1069,131,0.943015375854218,0.64,1.78145354185833,282,131,151,15,1.2,30.67,8.2,0,0,0,0,0,0,0.709155417176616,302.207015627956,80.3247618838555
8.7,"random_instances_SVM","SVM",3,12,2612,2346,266,1300,1160,140,0.942216685649213,0.63,1.77981617647059,306,140,166,24,1.2,33.23,8.3,0,0,0,0,0,0,0.661625326060399,285.9483602369,76.3984423280619
8.7,"random_instances_SVM","SVM",3,13,2512,2257,255,1400,1249,151,0.941749715261973,0.64,1.77981617647059,322,151,171,16,1.1,35.79,8.3,0,0,0,0,0,0,0.777775586507857,300.838128543052,86.6937690150896
8.7,"random_instances_SVM","SVM",3,14,2412,2166,246,1500,1340,160,0.94188781321186,0.64,1.78145354185833,345,160,185,23,1.2,38.34,8.4,0,0,0,0,0,0,0.642950744215298,275.457703082882,75.6195022479877
8.7,"random_instances_SVM","SVM",3,15,2312,2075,237,1600,1431,169,0.940052676537601,0.64,1.78309392265193,358,169,189,13,1.1,40.9,8.5,0,0,0,0,0,0,0.741317584809918,265.173156722295,83.9419145196034
8.7,"random_instances_SVM","SVM",3,16,2212,1989,223,1700,1517,183,0.941921981776779,0.655,1.78145354185833,392,183,209,34,1.1,43.46,8.3,0,0,0,0,0,0,0.744889925015125,255.119793786387,84.7751635589784
8.7,"random_instances_SVM","SVM",3,17,2112,1900,212,1800,1606,194,0.941140375854228,0.655,1.76757798165138,411,194,217,19,1.1,46.01,8.3,0,0,0,0,0,0,0.743099388724587,242.959543326602,85.0191574038527
8.7,"random_instances_SVM","SVM",3,18,2012,1810,202,1900,1696,204,0.942596810933956,0.65,1.77245630174793,435,204,231,24,1.1,48.57,8.3,0,0,0,0,0,0,0.761046586103121,234.094217627525,86.5730107547228
8.7,"random_instances_SVM","SVM",3,19,1912,1717,195,2000,1789,211,0.941847949886123,0.65,1.76595783684693,448,211,237,13,1.1,51.12,8.5,0,0,0,0,0,0,0.661273651457058,216.834361877847,79.6924713696722
8.7,"random_instances_SVM","SVM",3,20,1812,1630,182,2100,1876,224,0.940882687927124,0.64,1.78145354185833,477,224,253,29,1.1,53.68,8.4,0,0,0,0,0,0,0.671533719372027,208.226100643439,82.9925381995126
8.7,"random_instances_SVM","SVM",3,21,1712,1538,174,2200,1968,232,0.941597380410041,0.65,1.77245630174793,487,232,255,10,1.1,56.24,8.5,0,0,0,0,0,0,0.691244687680894,198.963627783769,83.9242169917133
8.7,"random_instances_SVM","SVM",3,22,1612,1445,167,2300,2061,239,0.941993166287033,0.635,1.77818181818182,502,239,263,15,1.1,58.79,8.6,0,0,0,0,0,0,0.57193355865463,175.597702604541,74.195298028872
8.7,"random_instances_SVM","SVM",3,23,1512,1358,154,2400,2148,252,0.941627277904342,0.64,1.77981617647059,527,252,275,25,1.1,61.35,8.5,0,0,0,0,0,0,0.627260687699469,171.740505893387,81.3756689516676
8.7,"random_instances_SVM","SVM",3,24,1412,1273,139,2500,2233,267,0.941728359908895,0.64,1.78145354185833,558,267,291,31,1.1,63.91,8.4,0,0,0,0,0,0,0.650525315872999,166.379777713548,84.5948862910327
8.7,"random_instances_SVM","SVM",3,25,1312,1183,129,2600,2323,277,0.941503416856504,0.64,1.77818181818182,586,277,309,28,1.1,66.46,8.4,0,0,0,0,0,0,0.612629769972253,157.553870118287,81.8637282970413
8.7,"random_instances_SVM","SVM",3,26,1212,1091,121,2700,2415,285,0.941719817767667,0.64,1.78309392265193,598,285,313,12,1.1,69.02,8.5,0,0,0,0,0,0,0.586206526942013,147.356581900537,80.2538280688112
8.7,"random_instances_SVM","SVM",3,27,1112,1000,112,2800,2506,294,0.940988041002292,0.635,1.78473732718894,607,294,313,9,1.1,71.57,8.5,0,0,0,0,0,0,0.578646815055716,135.602537648213,80.0952415870552
8.7,"random_instances_SVM","SVM",3,28,1012,909,103,2900,2597,303,0.940489749430539,0.625,1.77492208982585,630,303,327,23,1.1,74.13,8.6,0,0,0,0,0,0,0.469748027808966,115.483632999665,73.1292129976723
8.7,"random_instances_SVM","SVM",3,29,912,816,96,3000,2690,310,0.940498291571769,0.64,1.78309392265193,642,310,332,12,1.1,76.69,8.7,0,0,0,0,0,0,0.407944716159611,104.756848844977,70.4903337460026
8.7,"random_instances_SVM","SVM",3,30,812,726,86,3100,2780,320,0.940253416856504,0.645,1.78145354185833,660,320,340,18,1.1,79.24,8.7,0,0,0,0,0,0,0.349572068996579,94.2904988938501,68.6580057600283
8.7,"random_instances_SVM","SVM",3,31,712,638,74,3200,2868,332,0.939834851936231,0.65,1.77572350230415,686,332,354,26,1.1,81.8,8.6,0,0,0,0,0,0,0.272212267016748,82.827216298986,64.3153853102554
8.7,"random_instances_SVM","SVM",3,32,612,551,61,3300,2955,345,0.939367881548989,0.645,1.77572350230415,710,345,365,24,1.1,84.36,8.6,0,0,0,0,0,0,0.166966032593796,68.5780112485291,56.8182828259267
8.7,"random_instances_SVM","SVM",3,33,512,464,48,3400,3042,358,0.940111047836003,0.64,1.76920110192837,733,357,376,23,1.1,86.91,8.5,0,0,0,0,0,0,0.105721823442141,52.9799382722272,44.49881076576
8.7,"random_instances_SVM","SVM",3,34,412,372,40,3500,3134,366,0.93949316628703,0.64,1.77981617647059,750,366,384,17,1,89.47,8.6,0,0,0,0,0,0,0.07070601642174,41.8043162995121,37.0327911858008
8.7,"random_instances_SVM","SVM",3,35,312,283,29,3600,3223,377,0.93962129840548,0.63,1.77408839779006,770,375,395,20,1.1,92.02,8.5,0,0,0,0,0,0,0.0607370964262463,31.993797464026,29.2967863914807
8.7,"random_instances_SVM","SVM",3,36,212,195,17,3700,3311,389,0.93995159453304,0.645,1.77245630174793,793,387,406,23,1,94.58,8.5,0,0,0,0,0,0,0.0233090532197977,21.8407104313327,21.2818787003346
8.7,"random_instances_SVM","SVM",3,37,112,101,11,3800,3405,395,0.940595102505705,0.64,1.77572350230415,805,393,412,12,1,97.14,8.6,0,0,0,0,0,0,0.00101678678286337,12.8131518089092,12.8081880263318
8.7,"random_instances_SVM","SVM",3,38,12,12,0,3900,3494,406,0.940270501138963,0.65,1.77245630174793,827,401,426,22,1.1,99.69,8.6,0,0,0,0,0,0,0.00054929438793637,0.787943351900174,0.787943351900174
8.7,"random_instances_SVM","SVM",3,39,0,0,0,3912,3506,406,0.940219248291583,0.645,1.77245630174793,825,401,424,-2,1.1,100,8.6,0,0,0,0,0,0,0,0,0
8.7,"random_instances_SVM","SVM",4,0,3812,3425,387,100,91,9,0.925849560901107,0.604761904761905,1.76679821099711,23,9,14,0,1.6,2.56,10.1,0,0,0,0,0,0,0.407202147833007,312.242198637218,45.6804154176481
8.7,"random_instances_SVM","SVM",4,1,3712,3341,371,200,175,25,0.926725031364218,0.614285714285714,1.76517282165856,54,25,29,31,1.2,5.11,7,0,0,0,0,0,0,0.74285001907382,474.714972700859,78.5891721994889
8.7,"random_instances_SVM","SVM",4,2,3612,3248,364,300,268,32,0.928358697430843,0.619047619047619,1.77211134453782,70,32,38,16,1.2,7.67,8.4,0,0,0,0,0,0,0.778265808336319,392.248544049666,82.7233617794118
8.7,"random_instances_SVM","SVM",4,3,3512,3161,351,400,355,45,0.929326896852672,0.619047619047619,1.7770111915734,95,45,50,25,1.1,10.22,7.9,0,0,0,0,0,0,0.771098553023252,398.596231136286,82.4979003514396
8.7,"random_instances_SVM","SVM",4,4,3412,3069,343,500,447,53,0.925541373479511,0.642857142857143,1.77048406139315,111,53,58,16,1.1,12.78,8.4,0,0,0,0,0,0,0.648615204069142,339.612709270437,72.8809058484924
8.7,"random_instances_SVM","SVM",4,5,3312,2983,329,600,533,67,0.930655102820033,0.638095238095238,1.77048406139315,145,67,78,34,1.2,15.34,8,0,0,0,0,0,0,0.782256206008151,379.517866918549,84.9506031667316
8.7,"random_instances_SVM","SVM",4,6,3212,2892,320,700,624,76,0.931241477117747,0.628571428571429,1.7737416217637,162,76,86,17,1.1,17.89,8.2,0,0,0,0,0,0,0.803095125244564,382.504070772504,87.1748059336985
8.7,"random_instances_SVM","SVM",4,7,3112,2804,308,800,712,88,0.931313751159094,0.628571428571429,1.75176933158585,187,88,99,25,1.1,20.45,8.1,0,0,0,0,0,0,0.754706077567527,345.653875978039,83.718834688787
8.7,"random_instances_SVM","SVM",4,8,3012,2713,299,900,803,97,0.928846888125219,0.628571428571429,1.74803522144829,205,97,108,18,1.1,23.01,8.3,0,0,0,0,0,0,0.77167820559835,335.368954718945,85.2323955641159
8.7,"random_instances_SVM","SVM",4,9,2912,2619,293,1000,897,103,0.929026891398023,0.638095238095238,1.75125740618828,221,103,118,16,1.1,25.56,8.7,0,0,0,0,0,0,0.71825162351495,316.499715638828,81.5008949119778
8.7,"random_instances_SVM","SVM",4,10,2812,2526,286,1100,990,110,0.928852342769869,0.628571428571429,1.74106813996317,233,110,123,12,1.1,28.12,9,0,0,0,0,0,0,0.720525140073234,299.301192479184,82.4326693851914
8.7,"random_instances_SVM","SVM",4,11,2712,2430,282,1200,1086,114,0.930734195167187,0.623809523809524,1.74803522144829,245,114,131,12,1.1,30.67,9.5,0,0,0,0,0,0,0.804635811877704,306.8964322794,88.5275111684434
8.7,"random_instances_SVM","SVM",4,12,2612,2341,271,1300,1175,125,0.930543282605136,0.623809523809524,1.75337793519612,268,125,143,23,1.1,33.23,9.4,0,0,0,0,0,0,0.785775308801671,292.250304507136,87.8050074547795
8.7,"random_instances_SVM","SVM",4,13,2512,2257,255,1400,1259,141,0.93055282823324,0.623809523809524,1.75176933158585,297,141,156,29,1.1,35.79,8.9,0,0,0,0,0,0,0.684367535163314,271.483099438618,80.2577107822432
8.7,"random_instances_SVM","SVM",4,14,2412,2175,237,1500,1341,159,0.934421534937004,0.614285714285714,1.76885976408912,337,159,178,40,1.1,38.34,8.4,0,0,0,0,0,0,0.761334918926699,273.116055023618,86.5894115256725
8.7,"random_instances_SVM","SVM",4,15,2312,2085,227,1600,1431,169,0.936644302623689,0.628571428571429,1.7737416217637,355,169,186,18,1.1,40.9,8.5,0,0,0,0,0,0,0.774270886157645,254.820267655291,87.2875638553477
8.7,"random_instances_SVM","SVM",4,16,2212,1996,216,1700,1520,180,0.93873888616156,0.647619047619048,1.77903712449167,376,180,196,21,1.1,43.46,8.4,0,0,0,0,0,0,0.756126934188465,243.978605217446,87.1040957635804
8.7,"random_instances_SVM","SVM",4,17,2112,1906,206,1800,1610,190,0.937568864888446,0.647619047619048,1.78559578670178,399,190,209,23,1.1,46.01,8.5,0,0,0,0,0,0,0.638430034645548,230.519157106734,77.7739991095883
8.7,"random_instances_SVM","SVM",4,18,2012,1815,197,1900,1701,199,0.938616156657387,0.638095238095238,1.77903712449167,421,199,222,22,1.1,48.57,8.5,0,0,0,0,0,0,0.721607813246416,226.925704391548,85.6138650176
8.7,"random_instances_SVM","SVM",4,19,1912,1728,184,2000,1788,212,0.940658921071279,0.661904761904762,1.78559578670178,449,212,237,28,1.1,51.12,8.4,0,0,0,0,0,0,0.706088661988952,217.552366893733,83.9038004768142
8.7,"random_instances_SVM","SVM",4,20,1812,1636,176,2100,1880,220,0.940477554137338,0.652380952380952,1.78067226890756,463,220,243,14,1.1,53.68,8.5,0,0,0,0,0,0,0.653222157117564,200.586618955906,80.0234335760161
8.7,"random_instances_SVM","SVM",4,21,1712,1543,169,2200,1973,227,0.940473463153868,0.652380952380952,1.7737416217637,480,227,253,17,1.1,56.24,8.7,0,0,0,0,0,0,0.562328633946771,174.392377152124,76.0055804948634
8.7,"random_instances_SVM","SVM",4,22,1612,1451,161,2300,2065,235,0.942842142584388,0.647619047619048,1.78067226890756,493,235,258,13,1.1,58.79,8.8,0,0,0,0,0,0,0.594995738780647,169.967471003772,80.29949815383
8.7,"random_instances_SVM","SVM",4,23,1512,1363,149,2400,2153,247,0.944141711667464,0.657142857142857,1.78923319327731,509,247,262,16,1.1,61.35,8.7,0,0,0,0,0,0,0.480382051810276,153.089344323814,69.1778181813428
8.7,"random_instances_SVM","SVM",4,24,1412,1274,138,2500,2242,258,0.944470354006416,0.657142857142857,1.79252828203104,537,258,279,28,1.1,63.91,8.7,0,0,0,0,0,0,0.565985835089767,155.092551614923,77.2298324784996
8.7,"random_instances_SVM","SVM",4,25,1312,1190,122,2600,2326,274,0.945119456717373,0.661904761904762,1.78267922553637,567,274,293,30,1.1,66.46,8.5,0,0,0,0,0,0,0.51116108408819,142.021933990378,72.8806075287016
8.7,"random_instances_SVM","SVM",4,26,1212,1102,110,2700,2414,286,0.945270823105853,0.661904761904762,1.79087922197398,594,286,308,27,1.1,69.02,8.4,0,0,0,0,0,0,0.476754993283798,128.802411166085,71.8846611407182
8.7,"random_instances_SVM","SVM",4,27,1112,1009,103,2800,2507,293,0.944687176130455,0.666666666666667,1.78923319327731,609,293,316,15,1.1,71.57,8.6,0,0,0,0,0,0,0.383724069145552,111.138615939973,63.3521122994894
8.7,"random_instances_SVM","SVM",4,28,1012,917,95,2900,2599,301,0.943907161948376,0.652380952380952,1.79252828203104,627,301,326,18,1.1,74.13,8.6,0,0,0,0,0,0,0.375817503008428,103.25698881193,61.3489044401631
8.7,"random_instances_SVM","SVM",4,29,912,831,81,3000,2685,315,0.943459881088725,0.666666666666667,1.78559578670178,649,315,334,22,1.1,76.69,8.5,0,0,0,0,0,0,0.399221882649402,97.0291352009053,64.5154292831156
8.7,"random_instances_SVM","SVM",4,30,812,735,77,3100,2781,319,0.943154420989449,0.666666666666667,1.78559578670178,660,319,341,11,1.1,79.24,8.7,0,0,0,0,0,0,0.288390012406724,84.8341935648467,58.9992132410576
8.7,"random_instances_SVM","SVM",4,31,712,642,70,3200,2874,326,0.943157148311763,0.666666666666667,1.78067226890756,679,326,353,19,1.1,81.8,8.8,0,0,0,0,0,0,0.219161819655277,71.5347882220562,53.4568172061114
8.7,"random_instances_SVM","SVM",4,32,612,557,55,3300,2959,341,0.943414880270527,0.661904761904762,1.78923319327731,708,341,367,29,1.1,84.36,8.7,0,0,0,0,0,0,0.146332667222195,60.5848978947892,48.6468633137869
8.7,"random_instances_SVM","SVM",4,33,512,466,46,3400,3050,350,0.943742158948322,0.661904761904762,1.7839515916864,725,350,375,17,1.1,86.91,8.7,0,0,0,0,0,0,0.108212080950685,50.6891321832321,42.5667953057954
8.7,"random_instances_SVM","SVM",4,34,412,380,32,3500,3136,364,0.943473517700298,0.661904761904762,1.77903712449167,751,364,387,26,1.1,89.47,8.6,0,0,0,0,0,0,0.0761528306767924,38.5457737042254,33.8783593310116
8.7,"random_instances_SVM","SVM",4,35,312,288,24,3600,3228,372,0.942838051600915,0.671428571428571,1.78231042186884,767,372,395,16,1.1,92.02,8.7,0,0,0,0,0,0,0.0449253103215183,27.9332535139724,26.3653282279921
8.7,"random_instances_SVM","SVM",4,36,212,195,17,3700,3321,379,0.942887143402585,0.666666666666667,1.78231042186884,778,379,399,11,1.1,94.58,8.8,0,0,0,0,0,0,0.00859914546900075,17.9811505791704,17.6854929422295
8.7,"random_instances_SVM","SVM",4,37,112,100,12,3800,3416,384,0.943080783286947,0.671428571428571,1.77048406139315,793,384,409,15,1.1,97.14,8.9,0,0,0,0,0,0,0.000940392738964159,11.2967617500178,11.2911143791823
8.7,"random_instances_SVM","SVM",4,38,12,11,1,3900,3505,395,0.943694430807812,0.666666666666667,1.7770111915734,809,395,414,16,1,99.69,8.9,0,0,0,0,0,0,0.000288142279678548,0.684967325975328,0.684967325975328
8.7,"random_instances_SVM","SVM",4,39,0,0,0,3912,3516,396,0.943849888179764,0.666666666666667,1.7737416217637,813,396,417,4,1.1,100,8.9,0,0,0,0,0,0,0,0,0
8.7,"random_instances_SVM","SVM",5,0,3812,3412,400,100,88,12,0.914375065822582,0.556701030927835,1.77488716803649,34,12,22,0,1.8,2.56,7.3,0,0,0,0,0,0,0.296610892390413,447.695517156522,33.7145039555752
8.7,"random_instances_SVM","SVM",5,1,3712,3328,384,200,172,28,0.912758755865531,0.561855670103093,1.75068416119963,61,28,33,27,1.2,5.11,6.1,0,0,0,0,0,0,0.519387386930965,418.395518925094,57.0295330802741
8.7,"random_instances_SVM","SVM",5,2,3612,3240,372,300,260,40,0.917060626981999,0.572164948453608,1.76836783959558,88,40,48,27,1.2,7.67,6.5,0,0,0,0,0,0,0.709504355660913,433.878872696002,76.1287189008492
8.7,"random_instances_SVM","SVM",5,3,3512,3154,358,400,346,54,0.918175222626592,0.587628865979381,1.74664310620163,115,54,61,27,1.1,10.22,6.4,0,0,0,0,0,0,0.808966720660591,461.740117786308,84.8805638003051
8.7,"random_instances_SVM","SVM",5,4,3412,3064,348,500,436,64,0.920626747955126,0.597938144329897,1.77162150627377,132,64,68,17,1.1,12.78,6.8,0,0,0,0,0,0,0.738958749975511,401.683999404593,79.5702405114148
8.7,"random_instances_SVM","SVM",5,5,3312,2977,335,600,523,77,0.919412687082398,0.597938144329897,1.75588460411804,156,76,80,24,1.1,15.34,6.8,0,0,0,0,0,0,0.808896707955101,400.608732747748,85.7266504949653
8.7,"random_instances_SVM","SVM",5,6,3212,2888,324,700,612,88,0.92103923610706,0.603092783505155,1.77162150627377,177,86,91,21,1.1,17.89,7,0,0,0,0,0,0,0.785231121808102,369.627570613168,83.6438284045992
8.7,"random_instances_SVM","SVM",5,7,3112,2798,314,800,702,98,0.923119229554056,0.608247422680412,1.77162150627377,198,97,101,21,1,20.45,7.2,0,0,0,0,0,0,0.792567112634646,355.914821503822,84.4211617835087
8.7,"random_instances_SVM","SVM",5,8,3012,2708,304,900,792,108,0.922776952151383,0.61340206185567,1.75427665118387,218,106,112,20,1.1,23.01,7.3,0,0,0,0,0,0,0.749256352358725,327.895155931014,80.6168485691094
8.7,"random_instances_SVM","SVM",5,9,2912,2618,294,1000,882,118,0.922725756813379,0.61340206185567,1.76999317768344,236,116,120,18,1,25.56,7.5,0,0,0,0,0,0,0.76924819670667,325.877838812253,82.9259080975114
8.7,"random_instances_SVM","SVM",5,10,2812,2527,285,1100,973,127,0.920694033256503,0.603092783505155,1.76559456506247,256,125,131,20,1,28.12,7.7,0,0,0,0,0,0,0.775925872341379,320.842719812611,83.0609879076149
8.7,"random_instances_SVM","SVM",5,11,2712,2435,277,1200,1065,135,0.921112372304213,0.603092783505155,1.77162150627377,276,134,142,20,1.1,30.67,7.9,0,0,0,0,0,0,0.804198102309218,317.421422014463,85.7876881085434
8.7,"random_instances_SVM","SVM",5,12,2612,2348,264,1300,1152,148,0.923490761435582,0.603092783505155,1.76072619769557,306,146,160,30,1.1,33.23,7.8,0,0,0,0,0,0,0.788408721545479,305.395315764708,85.0732700049409
8.7,"random_instances_SVM","SVM",5,13,2512,2256,256,1400,1244,156,0.925225552032022,0.597938144329897,1.76189622810575,318,155,163,12,1.1,35.79,8,0,0,0,0,0,0,0.774562215604672,296.018969690099,84.0078351070163
8.7,"random_instances_SVM","SVM",5,14,2412,2169,243,1500,1331,169,0.925436184279822,0.603092783505155,1.76234600100532,334,163,171,16,1,38.34,7.9,0,0,0,0,0,0,0.761455059682177,272.66484402776,82.3705679545079
8.7,"random_instances_SVM","SVM",5,15,2312,2082,230,1600,1418,182,0.92768877915209,0.608247422680412,1.76836783959558,362,177,185,28,1,40.9,7.8,0,0,0,0,0,0,0.746333290575947,263.777442227855,82.3611721516291
8.7,"random_instances_SVM","SVM",5,16,2212,1993,219,1700,1507,193,0.928812151140339,0.608247422680412,1.76999317768344,389,188,201,27,1.1,43.46,7.8,0,0,0,0,0,0,0.713634047001221,247.853117916375,79.6742865956613
8.7,"random_instances_SVM","SVM",5,17,2112,1905,207,1800,1595,205,0.930027674737005,0.603092783505155,1.7759954601343,404,197,207,15,1.1,46.01,7.8,0,0,0,0,0,0,0.71020915424221,236.481822919297,79.5544165125497
8.7,"random_instances_SVM","SVM",5,18,2012,1816,196,1900,1684,216,0.932635711527443,0.61340206185567,1.79347237398451,426,207,219,22,1.1,48.57,7.8,0,0,0,0,0,0,0.678107221359492,217.103249805234,77.6092818969793
8.7,"random_instances_SVM","SVM",5,19,1912,1725,187,2000,1775,225,0.933399253425704,0.608247422680412,1.78089701154222,447,220,227,21,1,51.12,7.9,0,0,0,0,0,0,0.671169956280039,205.951001476829,78.5212489066694
8.7,"random_instances_SVM","SVM",5,20,1812,1633,179,2100,1867,233,0.932056472845999,0.61340206185567,1.77926015767132,456,222,234,9,1.1,53.68,8,0,0,0,0,0,0,0.634994969007841,195.182935253888,77.2502071171286
8.7,"random_instances_SVM","SVM",5,21,1712,1544,168,2200,1956,244,0.929024246112084,0.61340206185567,1.77325283362761,472,232,240,16,1,56.24,8,0,0,0,0,0,0,0.626411986952397,176.58063718466,75.7152765906308
8.7,"random_instances_SVM","SVM",5,22,1612,1457,155,2300,2043,257,0.929698561849825,0.61340206185567,1.76674548377944,497,244,253,25,1,58.79,7.9,0,0,0,0,0,0,0.600473199811391,166.527673777773,75.6221819826523
8.7,"random_instances_SVM","SVM",5,23,1512,1371,141,2400,2129,271,0.931620581110974,0.61340206185567,1.76836783959558,529,257,272,32,1.1,61.35,7.9,0,0,0,0,0,0,0.566145292626339,154.862175704888,73.4049691968036
8.7,"random_instances_SVM","SVM",5,24,1412,1278,134,2500,2222,278,0.932082801876971,0.608247422680412,1.76836783959558,538,263,275,9,1,63.91,8,0,0,0,0,0,0,0.532037044847789,147.130151926678,71.8943755568949
8.7,"random_instances_SVM","SVM",5,25,1312,1191,121,2600,2309,291,0.931507951367363,0.608247422680412,1.76999317768344,562,275,287,24,1,66.46,7.9,0,0,0,0,0,0,0.495286938786342,134.483977680715,70.574956930721
8.7,"random_instances_SVM","SVM",5,26,1212,1102,110,2700,2398,302,0.932236387890994,0.608247422680412,1.76028571967056,586,285,301,24,1.1,69.02,7.9,0,0,0,0,0,0,0.452060267565617,124.489116441908,67.7972463059228
8.7,"random_instances_SVM","SVM",5,27,1112,1010,102,2800,2490,310,0.93271762406825,0.608247422680412,1.76999317768344,599,293,306,13,1,71.57,8,0,0,0,0,0,0,0.438063745599831,114.786141850427,66.9082914250944
8.7,"random_instances_SVM","SVM",5,28,1012,919,93,2900,2581,319,0.931167136688642,0.603092783505155,1.76234600100532,618,304,314,19,1,74.13,8.1,0,0,0,0,0,0,0.403966025873002,107.325503729341,64.3660345259915
8.7,"random_instances_SVM","SVM",5,29,912,830,82,3000,2670,330,0.9323826602853,0.623711340206186,1.75749550742457,640,314,326,22,1,76.69,8.1,0,0,0,0,0,0,0.337525121291854,93.012867809127,60.6693239444023
8.7,"random_instances_SVM","SVM",5,30,812,740,72,3100,2760,340,0.93162058111098,0.623711340206186,1.75749550742457,662,324,338,22,1,79.24,8.1,0,0,0,0,0,0,0.290024827057416,80.77311937356,56.6184878701903
8.7,"random_instances_SVM","SVM",5,31,712,651,61,3200,2849,351,0.931177375756246,0.618556701030928,1.76072619769557,690,337,353,28,1,81.8,8.1,0,0,0,0,0,0,0.20417392396727,66.5196249008118,50.5114174959216
8.7,"random_instances_SVM","SVM",5,32,612,560,52,3300,2940,360,0.930620077933949,0.618556701030928,1.75910936923121,702,344,358,12,1,84.36,8.2,0,0,0,0,0,0,0.154397015297495,58.1959627717076,45.8374258705397
8.7,"random_instances_SVM","SVM",5,33,512,470,42,3400,3030,370,0.931727359958832,0.61340206185567,1.76999317768344,721,354,367,19,1,86.91,8.2,0,0,0,0,0,0,0.110138783011918,51.4516202797122,42.9044094326037
8.7,"random_instances_SVM","SVM",5,34,412,377,35,3500,3123,377,0.933096469569511,0.618556701030928,1.77325283362761,741,362,379,20,1,89.47,8.3,0,0,0,0,0,0,0.075550843137112,41.9659648554604,36.6303453455842
8.7,"random_instances_SVM","SVM",5,35,312,286,26,3600,3214,386,0.933228114724383,0.623711340206186,1.77325283362761,760,373,387,19,1,92.02,8.3,0,0,0,0,0,0,0.0555773433970952,28.3498583692746,26.363854271925
8.7,"random_instances_SVM","SVM",5,36,212,193,19,3700,3307,393,0.933305639093364,0.618556701030928,1.76189622810575,780,379,401,20,1.1,94.58,8.4,0,0,0,0,0,0,0.0143830678778851,19.1749183210361,18.8694685085754
8.7,"random_instances_SVM","SVM",5,37,112,104,8,3800,3396,404,0.933949237628297,0.628865979381443,1.77162150627377,795,390,405,15,1,97.14,8.4,0,0,0,0,0,0,0.000781392186674469,7.9260852763285,7.92143864802735
8.7,"random_instances_SVM","SVM",5,38,12,12,0,3900,3488,412,0.934329545853486,0.623711340206186,1.76836783959558,814,398,416,19,1,99.69,8.5,0,0,0,0,0,0,0.00111254437389564,0.49429313242685,0.49429313242685
8.7,"random_instances_SVM","SVM",5,39,0,0,0,3912,3500,412,0.934221304281703,0.623711340206186,1.77162150627377,815,398,417,1,1,100,8.5,0,0,0,0,0,0,0,0,0
8.7,"random_instances_SVM","SVM",6,0,3812,3396,416,100,91,9,0.894834643218441,0.524861878453039,1.74300481197647,23,9,14,0,1.6,2.56,10.1,0,0,0,0,0,0,0.282126655902208,341.67125683949,32.0732791941071
8.7,"random_instances_SVM","SVM",6,1,3712,3312,400,200,175,25,0.904077503696224,0.530386740331492,1.73819873253169,56,25,31,33,1.2,5.11,7,0,0,0,0,0,0,0.755837203754532,498.394689564211,80.9061949761295
8.7,"random_instances_SVM","SVM",6,2,3612,3219,393,300,268,32,0.911697144191125,0.574585635359116,1.74492371635663,70,32,38,14,1.2,7.67,8.4,0,0,0,0,0,0,0.575077756664727,395.122580040627,63.2315590698376
8.7,"random_instances_SVM","SVM",6,3,3512,3127,385,400,360,40,0.907779939304353,0.569060773480663,1.74139983516987,88,40,48,18,1.2,10.22,9,0,0,0,0,0,0,0.721825692310339,381.400303530551,79.1447734703775
8.7,"random_instances_SVM","SVM",6,4,3412,3037,375,500,450,50,0.919780561823997,0.569060773480663,1.76799642508937,111,50,61,23,1.2,12.78,9,0,0,0,0,0,0,0.576852290595589,333.880853535045,64.9057217370815
8.7,"random_instances_SVM","SVM",6,5,3312,2955,357,600,532,68,0.927018909034321,0.591160220994475,1.75483805565411,150,68,82,39,1.2,15.34,7.8,0,0,0,0,0,0,0.792325029806532,399.582161938333,85.1416850751178
8.7,"random_instances_SVM","SVM",6,6,3212,2864,348,700,623,77,0.925005057972152,0.596685082872928,1.7728848944675,164,77,87,14,1.1,17.89,8.1,0,0,0,0,0,0,0.781950939530883,374.627000390894,84.5258333982892
8.7,"random_instances_SVM","SVM",6,7,3112,2771,341,800,716,84,0.924342074546738,0.585635359116022,1.77792898927527,181,84,97,17,1.2,20.45,8.5,0,0,0,0,0,0,0.812704502855085,374.090527760619,86.6357610689935
8.7,"random_instances_SVM","SVM",6,8,3012,2678,334,900,809,91,0.919206287448457,0.585635359116022,1.78120325997375,197,91,106,16,1.2,23.01,8.9,0,0,0,0,0,0,0.798663602208685,339.655372410993,85.3857454947966
8.7,"random_instances_SVM","SVM",6,9,2912,2588,324,1000,899,101,0.923454984047942,0.580110497237569,1.77629636394076,212,101,111,15,1.1,25.56,8.9,0,0,0,0,0,0,0.695604263182666,302.719276663556,76.3841369182741
8.7,"random_instances_SVM","SVM",6,10,2812,2493,319,1100,994,106,0.926701424013704,0.569060773480663,1.77304009196287,229,106,123,17,1.2,28.12,9.4,0,0,0,0,0,0,0.716951593127735,292.298847901797,80.4302454591527
8.7,"random_instances_SVM","SVM",6,11,2712,2404,308,1200,1083,117,0.923395844681358,0.585635359116022,1.76979573680832,247,117,130,18,1.1,30.67,9.3,0,0,0,0,0,0,0.73659131861919,289.729633219701,81.9425454465706
8.7,"random_instances_SVM","SVM",6,12,2612,2313,299,1300,1174,126,0.922645708505184,0.580110497237569,1.76799642508937,263,126,137,16,1.1,33.23,9.3,0,0,0,0,0,0,0.728704773234144,273.785853744458,81.4590183351833
8.7,"random_instances_SVM","SVM",6,13,2512,2227,285,1400,1260,140,0.921034938915272,0.602209944751381,1.76799642508937,290,140,150,27,1.1,35.79,9,0,0,0,0,0,0,0.766517142675111,270.552140554865,84.8373615493293
8.7,"random_instances_SVM","SVM",6,14,2412,2137,275,1500,1350,150,0.919777449225751,0.596685082872928,1.75483805565411,311,150,161,21,1.1,38.34,9,0,0,0,0,0,0,0.733291263405571,245.17464997634,82.2327800133293
8.7,"random_instances_SVM","SVM",6,15,2312,2052,260,1600,1435,165,0.924724924130428,0.591160220994475,1.77629636394076,341,165,176,30,1.1,40.9,8.7,0,0,0,0,0,0,0.74326873035222,240.382417870099,82.9620782576625
8.7,"random_instances_SVM","SVM",6,16,2212,1968,244,1700,1519,181,0.923140611625564,0.591160220994475,1.77956461852023,363,178,185,22,1,43.46,8.4,0,0,0,0,0,0,0.716242383067589,227.168243570329,80.7119289340169
8.7,"random_instances_SVM","SVM",6,17,2112,1878,234,1800,1609,191,0.923321142323565,0.596685082872928,1.7497395131819,384,189,195,21,1,46.01,8.4,0,0,0,0,0,0,0.707751016344959,218.331446619832,80.4955562848227
8.7,"random_instances_SVM","SVM",6,18,2012,1784,228,1900,1703,197,0.925475060306597,0.596685082872928,1.76962291674079,399,197,202,15,1,48.57,8.6,0,0,0,0,0,0,0.729912188795593,212.579640460924,82.9654629399014
8.7,"random_instances_SVM","SVM",6,19,1912,1693,219,2000,1794,206,0.925745856353599,0.596685082872928,1.77956461852023,425,206,219,26,1.1,51.12,8.7,0,0,0,0,0,0,0.726770773577083,208.610439187944,83.5796566461166
8.7,"random_instances_SVM","SVM",6,20,1812,1606,206,2100,1881,219,0.924983269784459,0.596685082872928,1.76962291674079,439,216,223,14,1,53.68,8.6,0,0,0,0,0,0,0.631459557094278,184.22273706875,79.0227489670822
8.7,"random_instances_SVM","SVM",6,21,1712,1518,194,2200,1969,231,0.925222939849044,0.602209944751381,1.77956461852023,467,228,239,28,1,56.24,8.5,0,0,0,0,0,0,0.609488450331953,174.17931286291,77.334210787803
8.7,"random_instances_SVM","SVM",6,22,1612,1432,180,2300,2055,245,0.924460353279909,0.596685082872928,1.75644947719282,491,239,252,24,1.1,58.79,8.4,0,0,0,0,0,0,0.61400951434534,168.160075199522,78.379837743517
8.7,"random_instances_SVM","SVM",6,23,1512,1342,170,2400,2145,255,0.924002801338426,0.591160220994475,1.75968121496135,513,250,263,22,1.1,61.35,8.4,0,0,0,0,0,0,0.565169229918588,156.392840792592,76.5296314780308
8.7,"random_instances_SVM","SVM",6,24,1412,1252,160,2500,2235,265,0.929138588436706,0.596685082872928,1.76962291674079,533,261,272,20,1,63.91,8.4,0,0,0,0,0,0,0.547936052186028,149.712216640446,75.9476075516962
8.7,"random_instances_SVM","SVM",6,25,1312,1165,147,2600,2322,278,0.930623297797846,0.596685082872928,1.77792898927527,561,274,287,28,1,66.46,8.4,0,0,0,0,0,0,0.51108275279808,138.488534430424,73.0786587188361
8.7,"random_instances_SVM","SVM",6,26,1212,1077,135,2700,2410,290,0.931149326900641,0.596685082872928,1.76962291674079,581,283,298,20,1.1,69.02,8.3,0,0,0,0,0,0,0.473453999057362,130.959092046918,72.2744570980568
8.7,"random_instances_SVM","SVM",6,27,1112,987,125,2800,2500,300,0.93160065364564,0.602209944751381,1.78120325997375,602,293,309,21,1.1,71.57,8.3,0,0,0,0,0,0,0.450370325205905,118.333295111965,69.9632490276005
8.7,"random_instances_SVM","SVM",6,28,1012,898,114,2900,2589,311,0.931264493035571,0.591160220994475,1.76962291674079,625,304,321,23,1.1,74.13,8.3,0,0,0,0,0,0,0.411110333782182,106.482859328308,66.1594318323456
8.7,"random_instances_SVM","SVM",6,29,912,813,99,3000,2674,326,0.931971052836364,0.602209944751381,1.76637292056679,650,316,334,25,1.1,76.69,8.2,0,0,0,0,0,0,0.34915961490298,92.2180265027106,62.2548537952001
8.7,"random_instances_SVM","SVM",6,30,812,732,80,3100,2755,345,0.932837911446587,0.613259668508287,1.76799642508937,684,332,352,34,1.1,79.24,8,0,0,0,0,0,0,0.277936392351952,79.297446527964,57.1265588954308
8.7,"random_instances_SVM","SVM",6,31,712,639,73,3200,2848,352,0.934237024356088,0.607734806629834,1.76292486697049,701,342,359,17,1,81.8,8.1,0,0,0,0,0,0,0.211404618954149,69.2849961694115,53.4199155001531
8.7,"random_instances_SVM","SVM",6,32,612,551,61,3300,2936,364,0.934749046766795,0.613259668508287,1.77125240377278,724,353,371,23,1.1,84.36,8.1,0,0,0,0,0,0,0.115002252627404,56.8013083954495,45.8737133882583
8.7,"random_instances_SVM","SVM",6,33,512,461,51,3400,3026,374,0.936518558867019,0.607734806629834,1.77792898927527,745,364,381,21,1,86.91,8.1,0,0,0,0,0,0,0.0861561737516081,49.5403180399856,42.0552653061357
8.7,"random_instances_SVM","SVM",6,34,412,373,39,3500,3114,386,0.93694809742433,0.607734806629834,1.76313484005246,768,374,394,23,1.1,89.47,8.1,0,0,0,0,0,0,0.0640358497903109,40.0372030209929,35.6318146379866
8.7,"random_instances_SVM","SVM",6,35,312,285,27,3600,3202,398,0.937296708427364,0.61878453038674,1.76313484005246,784,384,400,16,1,92.02,8,0,0,0,0,0,0,0.042693494595853,26.6888320188388,24.8194585731147
8.7,"random_instances_SVM","SVM",6,36,212,193,19,3700,3294,406,0.938090420978916,0.624309392265193,1.77956461852023,807,393,414,23,1.1,94.58,8.1,0,0,0,0,0,0,0.0146472371145027,19.3319841582683,18.8790066560776
8.7,"random_instances_SVM","SVM",6,37,112,101,11,3800,3386,414,0.937790055248623,0.635359116022099,1.77125240377278,826,403,423,19,1,97.14,8.2,0,0,0,0,0,0,0.00166020396559032,11.356768987821,11.349400671359
8.7,"random_instances_SVM","SVM",6,38,12,10,2,3900,3477,423,0.938227375301536,0.629834254143646,1.77956461852023,840,410,430,14,1,99.69,8.2,0,0,0,0,0,0,0.000125566300024274,1.54412701294111,1.54412701294111
8.7,"random_instances_SVM","SVM",6,39,0,0,0,3912,3487,425,0.938373667418881,0.629834254143646,1.77956461852023,845,412,433,5,1.1,100,8.2,0,0,0,0,0,0,0,0,0
8.7,"random_instances_SVM","SVM",7,0,3812,3423,389,100,95,5,0.835378981305163,0.424528301886792,1.66670724284845,28,5,23,0,4.6,2.56,19,0,0,0,0,0,0,0.0821781270840772,211.908162702491,9.8099240710381
8.7,"random_instances_SVM","SVM",7,1,3712,3339,373,200,179,21,0.911908213605655,0.570754716981132,1.75174332666725,55,21,34,27,1.6,5.11,8.5,0,0,0,0,0,0,0.259894007192217,379.22521979777,29.9647681391373
8.7,"random_instances_SVM","SVM",7,2,3612,3247,365,300,271,29,0.919282553661048,0.566037735849057,1.74370780682015,70,29,41,15,1.4,7.67,9.3,0,0,0,0,0,0,0.561406008897972,379.483979304082,63.0141418432506
8.7,"random_instances_SVM","SVM",7,3,3512,3157,355,400,361,39,0.924650012982506,0.575471698113208,1.77398413497422,96,39,57,26,1.5,10.22,9.3,0,0,0,0,0,0,0.74865032984356,372.856984116529,82.9557081629664
8.7,"random_instances_SVM","SVM",7,4,3412,3066,346,500,452,48,0.923189479833815,0.584905660377358,1.76910160983209,112,48,64,16,1.3,12.78,9.4,0,0,0,0,0,0,0.703428776702546,367.457359599145,79.1346119577125
8.7,"random_instances_SVM","SVM",7,5,3312,2981,331,600,537,63,0.922878440366965,0.575471698113208,1.78247209734252,146,63,83,34,1.3,15.34,8.5,0,0,0,0,0,0,0.832756891328738,394.243127078218,89.7905751193185
8.7,"random_instances_SVM","SVM",7,6,3212,2893,319,700,625,75,0.924814999134488,0.556603773584906,1.78575776019477,161,75,86,15,1.1,17.89,8.3,0,0,0,0,0,0,0.849641468195378,380.579554196369,90.9228714117057
8.7,"random_instances_SVM","SVM",7,7,3112,2798,314,800,720,80,0.926862450233675,0.580188679245283,1.78575776019477,171,80,91,10,1.1,20.45,9,0,0,0,0,0,0,0.793976571515873,333.530640235828,87.473835313938
8.7,"random_instances_SVM","SVM",7,8,3012,2709,303,900,809,91,0.927204593647203,0.584905660377358,1.78411341603252,195,91,104,24,1.1,23.01,8.9,0,0,0,0,0,0,0.792949498653359,323.231906913117,86.8263744959357
8.7,"random_instances_SVM","SVM",7,9,2912,2618,294,1000,900,100,0.926297169811301,0.570754716981132,1.78411341603252,215,100,115,20,1.1,25.56,9,0,0,0,0,0,0,0.776282654283574,306.704520771869,86.8477253250152
8.7,"random_instances_SVM","SVM",7,10,2812,2525,287,1100,993,107,0.923374751168404,0.584905660377358,1.78083379578246,233,107,126,18,1.2,28.12,9.3,0,0,0,0,0,0,0.739480987741262,289.79968236122,84.8810886707448
8.7,"random_instances_SVM","SVM",7,11,2712,2438,274,1200,1080,120,0.923931917517733,0.580188679245283,1.78411341603252,257,120,137,24,1.1,30.67,9,0,0,0,0,0,0,0.737193723370225,270.608827833513,84.1189716534117
8.7,"random_instances_SVM","SVM",7,12,2612,2347,265,1300,1171,129,0.92203457676994,0.580188679245283,1.78575776019477,275,129,146,18,1.1,33.23,9.1,0,0,0,0,0,0,0.75241502072774,259.996959941728,86.2176309828792
8.7,"random_instances_SVM","SVM",7,13,2512,2262,250,1400,1256,144,0.926596038168575,0.594339622641509,1.77235363485017,304,144,160,29,1.1,35.79,8.7,0,0,0,0,0,0,0.706504508462024,245.136434416616,82.2923107978139
8.7,"random_instances_SVM","SVM",7,14,2412,2170,242,1500,1348,152,0.922579572009678,0.575471698113208,1.77561763786094,325,152,173,21,1.1,38.34,8.9,0,0,0,0,0,0,0.711607788361287,226.801453165968,84.3173880639683
8.7,"random_instances_SVM","SVM",7,15,2312,2082,230,1600,1436,164,0.924528301886779,0.589622641509434,1.77561763786094,350,164,186,25,1.1,40.9,8.8,0,0,0,0,0,0,0.724571178978631,226.696395658403,85.9070712057163
8.7,"random_instances_SVM","SVM",7,16,2212,1993,219,1700,1525,175,0.926850279124101,0.580188679245283,1.77235363485017,372,175,197,22,1.1,43.46,8.7,0,0,0,0,0,0,0.639433411911238,215.203808074271,79.0177810184445
8.7,"random_instances_SVM","SVM",7,17,2112,1905,207,1800,1613,187,0.928239137960865,0.580188679245283,1.77725415181289,394,187,207,22,1.1,46.01,8.6,0,0,0,0,0,0,0.685845345009373,211.786714593005,83.3624611267178
8.7,"random_instances_SVM","SVM",7,18,2012,1812,200,1900,1706,194,0.929315604985261,0.584905660377358,1.77398413497422,410,194,216,16,1.1,48.57,8.8,0,0,0,0,0,0,0.726426339065669,206.921091533369,85.8607894911187
8.7,"random_instances_SVM","SVM",7,19,1912,1726,186,2000,1792,208,0.929665862471845,0.584905660377358,1.77235363485017,436,208,228,26,1.1,51.12,8.6,0,0,0,0,0,0,0.713182913435721,201.338684654355,85.5407289766482
8.7,"random_instances_SVM","SVM",7,20,1812,1637,175,2100,1881,219,0.930172992037365,0.584905660377358,1.78247209734252,458,219,239,22,1.1,53.68,8.6,0,0,0,0,0,0,0.625630776044662,185.7442490678,79.0822895532935
8.7,"random_instances_SVM","SVM",7,21,1712,1543,169,2200,1975,225,0.93003099575902,0.584905660377358,1.78083379578246,473,225,248,15,1.1,56.24,8.8,0,0,0,0,0,0,0.678192062147753,182.490142572159,84.3607229830955
8.7,"random_instances_SVM","SVM",7,22,1612,1454,158,2300,2064,236,0.929272329929008,0.584905660377358,1.7707261292167,497,236,261,24,1.1,58.79,8.7,0,0,0,0,0,0,0.549363816223909,156.06992531203,77.7846109093277
8.7,"random_instances_SVM","SVM",7,23,1512,1364,148,2400,2154,246,0.928780076164081,0.580188679245283,1.77398413497422,515,246,269,18,1.1,61.35,8.8,0,0,0,0,0,0,0.518943229332574,146.407722435547,77.08640332534
8.7,"random_instances_SVM","SVM",7,24,1412,1280,132,2500,2238,262,0.929769993075971,0.584905660377358,1.77725415181289,544,262,282,29,1.1,63.91,8.5,0,0,0,0,0,0,0.467990958754011,136.562255438887,74.9374124524308
8.7,"random_instances_SVM","SVM",7,25,1312,1192,120,2600,2326,274,0.93083699368182,0.589622641509434,1.76586149699357,564,274,290,20,1.1,66.46,8.5,0,0,0,0,0,0,0.447981513266353,126.479485655462,74.8052474211848
8.7,"random_instances_SVM","SVM",7,26,1212,1098,114,2700,2420,280,0.929659100744308,0.580188679245283,1.77398413497422,576,280,296,12,1.1,69.02,8.6,0,0,0,0,0,0,0.385186751680993,111.956114056238,68.9134048045724
8.7,"random_instances_SVM","SVM",7,27,1112,1005,107,2800,2513,287,0.930589514453845,0.589622641509434,1.77398413497422,595,287,308,19,1.1,71.57,8.8,0,0,0,0,0,0,0.33431331359911,99.6607530040344,65.7512892013825
8.7,"random_instances_SVM","SVM",7,28,1012,915,97,2900,2603,297,0.930628732473581,0.580188679245283,1.77235363485017,611,297,314,16,1.1,74.13,8.8,0,0,0,0,0,0,0.300268721936391,92.0685853909454,64.9266334964655
8.7,"random_instances_SVM","SVM",7,29,912,828,84,3000,2690,310,0.931422559286803,0.589622641509434,1.77398413497422,632,307,325,21,1.1,76.69,8.7,0,0,0,0,0,0,0.244648786058416,80.5834153784696,58.6659566116033
8.7,"random_instances_SVM","SVM",7,30,812,739,73,3100,2779,321,0.932549063095008,0.594339622641509,1.77235363485017,650,317,333,18,1.1,79.24,8.7,0,0,0,0,0,0,0.185737155777876,71.3256931817815,55.1301917391641
8.7,"random_instances_SVM","SVM",7,31,712,648,64,3200,2870,330,0.932271832265858,0.584905660377358,1.77398413497422,667,326,341,17,1,81.8,8.7,0,0,0,0,0,0,0.157157174390258,64.4160845616912,52.1279357464412
8.7,"random_instances_SVM","SVM",7,32,612,560,52,3300,2958,342,0.932327278431688,0.589622641509434,1.77235363485017,682,338,344,15,1,84.36,8.6,0,0,0,0,0,0,0.103587960848984,50.8911253005111,42.2606360021972
8.7,"random_instances_SVM","SVM",7,33,512,467,45,3400,3051,349,0.932623442097951,0.594339622641509,1.78083379578246,697,343,354,15,1,86.91,8.7,0,0,0,0,0,0,0.0828326548477067,45.2143802400033,38.8692648240274
8.7,"random_instances_SVM","SVM",7,34,412,378,34,3500,3140,360,0.933254987450215,0.584905660377358,1.78411341603252,718,352,366,21,1,89.47,8.7,0,0,0,0,0,0,0.0611350585443326,33.3764501550008,29.8444775066492
8.7,"random_instances_SVM","SVM",7,35,312,287,25,3600,3231,369,0.932588281114762,0.589622641509434,1.78247209734252,734,360,374,16,1,92.02,8.8,0,0,0,0,0,0,0.038012594619214,23.8456696203794,22.3965161416617
8.7,"random_instances_SVM","SVM",7,36,212,194,18,3700,3324,376,0.932735686775126,0.584905660377358,1.78411341603252,745,364,381,11,1,94.58,8.8,0,0,0,0,0,0,0.0106189934704434,15.4131234182947,15.0839354778336
8.7,"random_instances_SVM","SVM",7,37,112,103,9,3800,3415,385,0.932929072182772,0.584905660377358,1.77725415181289,764,373,391,19,1,97.14,8.9,0,0,0,0,0,0,0.000691662581658088,8.04459620414414,8.04109305423288
8.7,"random_instances_SVM","SVM",7,38,12,12,0,3900,3506,394,0.933372641509414,0.589622641509434,1.7791985030407,782,381,401,18,1.1,99.69,8.9,0,0,0,0,0,0,0.000228002374225227,0.496660514010123,0.496660514010123
8.7,"random_instances_SVM","SVM",7,39,0,0,0,3912,3518,394,0.933130571663472,0.589622641509434,1.78411341603252,780,381,399,-2,1,100,8.9,0,0,0,0,0,0,0,0,0
8.7,"random_instances_SVM","SVM",8,0,3812,3428,384,100,89,11,0.908722280313421,0.578199052132701,1.7600454277415,32,11,21,0,1.9,2.56,8.1,0,0,0,0,0,0,0.290900071072158,386.018460423964,33.7053799950705
8.7,"random_instances_SVM","SVM",8,1,3712,3343,369,200,174,26,0.920794687597601,0.578199052132701,1.78108861648665,59,26,33,27,1.3,5.11,6.7,0,0,0,0,0,0,0.766636747299943,398.705977656871,82.1022642205324
8.7,"random_instances_SVM","SVM",8,2,3612,3247,365,300,270,30,0.9167805103274,0.582938388625592,1.77911819617981,65,30,35,6,1.2,7.67,9,0,0,0,0,0,0,0.718977770012774,359.078097956058,78.4336408953929
8.7,"random_instances_SVM","SVM",8,3,3512,3160,352,400,357,43,0.916489903447897,0.568720379146919,1.78435367352879,95,43,52,30,1.2,10.22,8.3,0,0,0,0,0,0,0.738348201805149,367.28242906474,80.3971905539637
8.7,"random_instances_SVM","SVM",8,4,3412,3069,343,500,448,52,0.917388883607856,0.568720379146919,1.77223306384165,116,52,64,21,1.2,12.78,8.6,0,0,0,0,0,0,0.706143710486215,349.325088466317,78.7846709735677
8.7,"random_instances_SVM","SVM",8,5,3312,2978,334,600,539,61,0.922398457339165,0.559241706161137,1.77423050882767,136,61,75,20,1.2,15.34,8.8,0,0,0,0,0,0,0.665470734552012,324.694976482935,76.1687438676703
8.7,"random_instances_SVM","SVM",8,6,3212,2888,324,700,629,71,0.918733279919597,0.578199052132701,1.77223306384165,152,71,81,16,1.1,17.89,8.9,0,0,0,0,0,0,0.798075310947326,350.180292193074,86.6344400294611
8.7,"random_instances_SVM","SVM",8,7,3112,2799,313,800,718,82,0.919135240837066,0.559241706161137,1.77386345304482,179,82,97,27,1.2,20.45,8.8,0,0,0,0,0,0,0.728814380437933,321.1694102004,82.3310271838521
8.7,"random_instances_SVM","SVM",8,8,3012,2709,303,900,808,92,0.919689295074632,0.563981042654028,1.77223306384165,198,92,106,19,1.2,23.01,8.8,0,0,0,0,0,0,0.733894577920168,312.862479187615,82.7647891812771
8.7,"random_instances_SVM","SVM",8,9,2912,2620,292,1000,897,103,0.921191216610778,0.582938388625592,1.77386345304482,217,103,114,19,1.1,25.56,8.7,0,0,0,0,0,0,0.784091043314082,324.057275098242,86.608801897118
8.7,"random_instances_SVM","SVM",8,10,2812,2526,286,1100,991,109,0.915212047963718,0.568720379146919,1.77549684480637,232,109,123,15,1.1,28.12,9.1,0,0,0,0,0,0,0.791272332738767,320.938167003183,88.1311432506815
8.7,"random_instances_SVM","SVM",8,11,2712,2438,274,1200,1079,121,0.919878053748691,0.563981042654028,1.77549684480637,258,121,137,26,1.1,30.67,8.9,0,0,0,0,0,0,0.714248913786715,291.683115535241,81.4846927508802
8.7,"random_instances_SVM","SVM",8,12,2612,2342,270,1300,1175,125,0.914482814812807,0.57345971563981,1.77223306384165,266,125,141,8,1.1,33.23,9.4,0,0,0,0,0,0,0.598991912080115,254.789887999292,72.804623010002
8.7,"random_instances_SVM","SVM",8,13,2512,2261,251,1400,1256,144,0.911283423186076,0.57345971563981,1.74827888401052,302,144,158,36,1.1,35.79,8.7,0,0,0,0,0,0,0.743961593251874,264.82942774626,85.5326404194328
8.7,"random_instances_SVM","SVM",8,14,2412,2170,242,1500,1347,153,0.910681839785974,0.592417061611374,1.74667201003624,325,153,172,23,1.1,38.34,8.8,0,0,0,0,0,0,0.654277491262824,260.650853602437,78.5318490605068
8.7,"random_instances_SVM","SVM",8,15,2312,2080,232,1600,1437,163,0.91649805130433,0.592417061611374,1.7685893375849,338,163,175,13,1.1,40.9,8.8,0,0,0,0,0,0,0.718464314862085,246.737810934563,83.8140177086393
8.7,"random_instances_SVM","SVM",8,16,2212,1994,218,1700,1523,177,0.917804424286043,0.597156398104265,1.75150151789809,369,177,192,31,1.1,43.46,8.6,0,0,0,0,0,0,0.717171421118285,242.507283105891,83.0157678565694
8.7,"random_instances_SVM","SVM",8,17,2112,1901,211,1800,1616,184,0.914482814812809,0.592417061611374,1.74667201003624,385,184,201,16,1.1,46.01,8.8,0,0,0,0,0,0,0.733961642629525,231.640091515521,85.0737094028665
8.7,"random_instances_SVM","SVM",8,18,2012,1810,202,1900,1707,193,0.917837015711793,0.597156398104265,1.76371271257318,407,193,214,22,1.1,48.57,8.8,0,0,0,0,0,0,0.721758125049147,223.075025933198,83.9919139938848
8.7,"random_instances_SVM","SVM",8,19,1912,1722,190,2000,1795,205,0.923097815016488,0.601895734597156,1.77223306384165,424,205,219,17,1.1,51.12,8.8,0,0,0,0,0,0,0.741174805472391,214.327846727232,86.2348540742888
8.7,"random_instances_SVM","SVM",8,20,1812,1627,185,2100,1890,210,0.921753418704755,0.592417061611374,1.77713324742831,442,210,232,18,1.1,53.68,9,0,0,0,0,0,0,0.679902702198932,199.303060399824,82.9764907821214
8.7,"random_instances_SVM","SVM",8,21,1712,1536,176,2200,1981,219,0.920992952104188,0.606635071090047,1.7685893375849,456,219,237,14,1.1,56.24,9,0,0,0,0,0,0,0.636483236301369,184.412814416654,80.738384894242
8.7,"random_instances_SVM","SVM",8,22,1612,1445,167,2300,2072,228,0.921107022094282,0.597156398104265,1.77713324742831,473,228,245,17,1.1,58.79,9.1,0,0,0,0,0,0,0.592339914987688,174.495402840404,76.913614784474
8.7,"random_instances_SVM","SVM",8,23,1512,1353,159,2400,2164,236,0.923491628077523,0.606635071090047,1.76533526336672,490,236,254,17,1.1,61.35,9.2,0,0,0,0,0,0,0.57298521881415,160.420890038465,78.1658488114896
8.7,"random_instances_SVM","SVM",8,24,1412,1262,150,2500,2255,245,0.924089137549406,0.616113744075829,1.76371271257318,507,245,262,17,1.1,63.91,9.2,0,0,0,0,0,0,0.546655369932123,150.517885564314,76.5098136069903
8.7,"random_instances_SVM","SVM",8,25,1312,1174,138,2600,2343,257,0.925206751857033,0.601895734597156,1.76696080228326,531,257,274,24,1.1,66.46,9.1,0,0,0,0,0,0,0.589421162872107,147.461415444218,80.7352579868241
8.7,"random_instances_SVM","SVM",8,26,1212,1088,124,2700,2429,271,0.927814065916148,0.601895734597156,1.77223306384165,558,271,287,27,1.1,69.02,9,0,0,0,0,0,0,0.53699313909522,134.428564427986,76.9773689333639
8.7,"random_instances_SVM","SVM",8,27,1112,1002,110,2800,2515,285,0.928232322546471,0.592417061611374,1.77223306384165,586,285,301,28,1.1,71.57,8.8,0,0,0,0,0,0,0.507881974369199,124.144486768421,77.8575794910051
8.7,"random_instances_SVM","SVM",8,28,1012,910,102,2900,2607,293,0.929127228778222,0.606635071090047,1.77386345304482,603,293,310,17,1.1,74.13,8.9,0,0,0,0,0,0,0.421265536865427,110.438104010979,71.9649744687278
8.7,"random_instances_SVM","SVM",8,29,912,819,93,3000,2698,302,0.930020777033903,0.601895734597156,1.77386345304482,617,302,315,14,1,76.69,8.9,0,0,0,0,0,0,0.411830245330389,102.696134348892,72.0670372638858
8.7,"random_instances_SVM","SVM",8,30,812,728,84,3100,2789,311,0.930922473146021,0.597156398104265,1.77060566892536,634,310,324,17,1,79.24,9,0,0,0,0,0,0,0.378455040932708,94.4629469936938,69.6032283371905
8.7,"random_instances_SVM","SVM",8,31,712,635,77,3200,2882,318,0.931666644033726,0.601895734597156,1.77223306384165,646,317,329,12,1,81.8,9.1,0,0,0,0,0,0,0.283102062867008,82.5799895829059,62.7574222155524
8.7,"random_instances_SVM","SVM",8,32,612,543,69,3300,2974,326,0.931966756745737,0.597156398104265,1.77223306384165,662,325,337,16,1,84.36,9.1,0,0,0,0,0,0,0.18871860151872,73.1748925789271,59.0344396917936
8.7,"random_instances_SVM","SVM",8,33,512,454,58,3400,3063,337,0.932367359687111,0.611374407582938,1.77386345304482,685,335,350,23,1,86.91,9.1,0,0,0,0,0,0,0.124885203781576,59.3844380898341,50.2230350883926
8.7,"random_instances_SVM","SVM",8,34,412,367,45,3500,3150,350,0.932666114423061,0.606635071090047,1.77549684480637,703,347,356,18,1,89.47,9,0,0,0,0,0,0,0.0915816557256879,48.4073250911833,42.7187487531609
8.7,"random_instances_SVM","SVM",8,35,312,278,34,3600,3239,361,0.932992028680449,0.616113744075829,1.77386345304482,728,356,372,25,1,92.02,9,0,0,0,0,0,0,0.0603521350277622,35.7728322117308,33.3752768588642
8.7,"random_instances_SVM","SVM",8,36,212,186,26,3700,3331,369,0.932351063974249,0.616113744075829,1.77386345304482,740,363,377,12,1,94.58,9,0,0,0,0,0,0,0.0218170067948028,24.1419857857166,23.6770314644703
8.7,"random_instances_SVM","SVM",8,37,112,97,15,3800,3420,380,0.93254932848083,0.616113744075829,1.77713324742831,765,375,390,25,1,97.14,9,0,0,0,0,0,0,0.000981295875428258,11.518298623646,11.5117335664912
8.7,"random_instances_SVM","SVM",8,38,12,12,0,3900,3505,395,0.933470036257958,0.616113744075829,1.77549684480637,793,388,405,28,1,99.69,8.9,0,0,0,0,0,0,0.00719567023034018,1.04130796120668,1.04130796120668
8.7,"random_instances_SVM","SVM",8,39,0,0,0,3912,3517,395,0.933106098670541,0.616113744075829,1.76898126005478,799,389,410,6,1.1,100,8.9,0,0,0,0,0,0,0,0,0
8.7,"random_instances_SVM","SVM",9,0,3812,3417,395,100,91,9,0.907555008636557,0.569306930693069,1.74029292330155,26,9,17,0,1.9,2.56,10.1,0,0,0,0,0,0,0.2185421421063,294.060743148403,23.4529229963418
8.7,"random_instances_SVM","SVM",9,1,3712,3333,379,200,175,25,0.916947966176328,0.574257425742574,1.76706666058311,55,25,30,29,1.2,5.11,7,0,0,0,0,0,0,0.592748900480967,346.890004935166,66.6261633735481
8.7,"random_instances_SVM","SVM",9,2,3612,3241,371,300,267,33,0.916173216523477,0.594059405940594,1.75329426324985,73,33,40,18,1.2,7.67,8.1,0,0,0,0,0,0,0.575932062897468,318.466630744428,65.0470041550173
8.7,"random_instances_SVM","SVM",9,3,3512,3147,365,400,361,39,0.919225645483592,0.574257425742574,1.7621942341293,85,39,46,12,1.2,10.22,9.3,0,0,0,0,0,0,0.697862525320365,323.667590419167,77.3921970076581
8.7,"random_instances_SVM","SVM",9,4,3412,3060,352,500,448,52,0.922025469365647,0.594059405940594,1.76138070845476,113,52,61,28,1.2,12.78,8.6,0,0,0,0,0,0,0.451879043008078,309.495269057892,51.5460994960123
8.7,"random_instances_SVM","SVM",9,5,3312,2972,340,600,536,64,0.929294568567469,0.599009900990099,1.78561177218639,135,64,71,22,1.1,15.34,8.4,0,0,0,0,0,0,0.634952609269053,304.886488407195,73.0529227485845
8.7,"random_instances_SVM","SVM",9,6,3212,2884,328,700,624,76,0.928720209535209,0.594059405940594,1.78491581877082,162,76,86,27,1.1,17.89,8.2,0,0,0,0,0,0,0.570891223062609,326.57526059356,66.3693858563777
8.7,"random_instances_SVM","SVM",9,7,3112,2797,315,800,711,89,0.935592761100515,0.603960396039604,1.79053986355397,190,89,101,28,1.1,20.45,8,0,0,0,0,0,0,0.769161765788037,334.178601512212,85.4455607632214
8.7,"random_instances_SVM","SVM",9,8,3012,2708,304,900,800,100,0.934638788850382,0.599009900990099,1.78725145241797,213,100,113,23,1.1,23.01,8,0,0,0,0,0,0,0.709569313333388,321.001346238333,80.0172726896319
8.7,"random_instances_SVM","SVM",9,9,2912,2618,294,1000,890,110,0.933396931483346,0.613861386138614,1.77835965414723,232,110,122,19,1.1,25.56,8.1,0,0,0,0,0,0,0.758503095892231,326.381513378481,83.4635635342909
8.7,"random_instances_SVM","SVM",9,10,2812,2527,285,1100,981,119,0.932273615046801,0.603960396039604,1.7694678558765,246,119,127,14,1.1,28.12,8.2,0,0,0,0,0,0,0.736843708460112,309.520088920138,81.8379384409345
8.7,"random_instances_SVM","SVM",9,11,2712,2433,279,1200,1075,125,0.931446650936479,0.618811881188119,1.77272354650368,261,125,136,15,1.1,30.67,8.6,0,0,0,0,0,0,0.705634663075801,290.547897725273,79.9091414981445
8.7,"random_instances_SVM","SVM",9,12,2612,2352,260,1300,1156,144,0.931462174153568,0.594059405940594,1.77672813152875,298,144,154,37,1.1,33.23,8,0,0,0,0,0,0,0.733436853514511,295.353066337323,82.1437538723343
8.7,"random_instances_SVM","SVM",9,13,2512,2260,252,1400,1248,152,0.93057170597334,0.599009900990099,1.78163170502883,315,152,163,17,1.1,35.79,8.2,0,0,0,0,0,0,0.694925399246065,270.166217691809,79.6344745831579
8.7,"random_instances_SVM","SVM",9,14,2412,2171,241,1500,1337,163,0.929843525971758,0.599009900990099,1.77835965414723,337,163,174,22,1.1,38.34,8.2,0,0,0,0,0,0,0.738551468634948,272.813413927471,84.2604317272565
8.7,"random_instances_SVM","SVM",9,15,2312,2084,228,1600,1424,176,0.934483556679504,0.608910891089109,1.78163170502883,360,174,186,23,1.1,40.9,8.1,0,0,0,0,0,0,0.702554594956092,250.984983092163,81.4452819886521
8.7,"random_instances_SVM","SVM",9,16,2212,1994,218,1700,1514,186,0.933679171794038,0.608910891089109,1.78725145241797,382,185,197,22,1.1,43.46,8.1,0,0,0,0,0,0,0.674488744639939,236.555120095139,79.6213062674568
8.7,"random_instances_SVM","SVM",9,17,2112,1904,208,1800,1604,196,0.93582702055839,0.603960396039604,1.78397509778476,396,195,201,14,1,46.01,8.2,0,0,0,0,0,0,0.665762320443679,223.325658511338,80.3532544521424
8.7,"random_instances_SVM","SVM",9,18,2012,1814,198,1900,1694,206,0.936179820946745,0.613861386138614,1.78561177218639,418,205,213,22,1,48.57,8.2,0,0,0,0,0,0,0.682202941028489,213.753344006514,82.6205897268615
8.7,"random_instances_SVM","SVM",9,19,1912,1723,189,2000,1785,215,0.937121092382899,0.613861386138614,1.78889414676762,445,215,230,27,1.1,51.12,8.3,0,0,0,0,0,0,0.66235205783365,207.531350355029,81.7498992629555
8.7,"random_instances_SVM","SVM",9,20,1812,1636,176,2100,1872,228,0.937331361414361,0.618811881188119,1.78397509778476,464,226,238,19,1.1,53.68,8.2,0,0,0,0,0,0,0.618064678032993,193.982217908568,79.1268131956686
8.7,"random_instances_SVM","SVM",9,21,1712,1546,166,2200,1962,238,0.937162017227951,0.618811881188119,1.79218861112631,488,238,250,24,1.1,56.24,8.2,0,0,0,0,0,0,0.557148367451739,173.294075817168,75.1256832945765
8.7,"random_instances_SVM","SVM",9,22,1612,1459,153,2300,2049,251,0.936625760637639,0.628712871287129,1.78561177218639,510,250,260,22,1,58.79,8.2,0,0,0,0,0,0,0.538826515826999,159.647861222673,74.2091831560717
8.7,"random_instances_SVM","SVM",9,23,1512,1368,144,2400,2140,260,0.938350248935957,0.628712871287129,1.78397509778476,534,259,275,24,1.1,61.35,8.2,0,0,0,0,0,0,0.501458040437095,145.450701353758,72.1833539611315
8.7,"random_instances_SVM","SVM",9,24,1412,1276,136,2500,2232,268,0.938031317384875,0.618811881188119,1.78397509778476,543,267,276,9,1,63.91,8.3,0,0,0,0,0,0,0.5,133.647994365615,70.9104949064137
8.7,"random_instances_SVM","SVM",9,25,1312,1187,125,2600,2321,279,0.936656807071819,0.633663366336634,1.78725145241797,566,277,289,23,1,66.46,8.3,0,0,0,0,0,0,0.461049902873786,126.473717415253,69.6878599177946
8.7,"random_instances_SVM","SVM",9,26,1212,1096,116,2700,2412,288,0.936816272847357,0.643564356435644,1.79218861112631,583,286,297,17,1,69.02,8.4,0,0,0,0,0,0,0.391095455135262,112.114467746239,66.7617731016981
8.7,"random_instances_SVM","SVM",9,27,1112,1011,101,2800,2497,303,0.93692070176231,0.638613861386139,1.78889414676762,612,299,313,29,1,71.57,8.2,0,0,0,0,0,0,0.369837060988403,103.918682766839,64.6555281449543
8.7,"random_instances_SVM","SVM",9,28,1012,920,92,2900,2588,312,0.937125325987564,0.638613861386139,1.78397509778476,632,307,325,20,1.1,74.13,8.3,0,0,0,0,0,0,0.303128778256988,90.3751688967831,58.8324526971242
8.7,"random_instances_SVM","SVM",9,29,912,830,82,3000,2678,322,0.937301726181745,0.638613861386139,1.79218861112631,642,316,326,10,1,76.69,8.3,0,0,0,0,0,0,0.25703891267785,79.5730023023268,53.9973986376675
8.7,"random_instances_SVM","SVM",9,30,812,739,73,3100,2769,331,0.938612732424901,0.643564356435644,1.79384039786467,663,324,339,21,1,79.24,8.4,0,0,0,0,0,0,0.246810696374399,75.2979655466797,53.0407239821421
8.7,"random_instances_SVM","SVM",9,31,712,651,61,3200,2857,343,0.938578863587618,0.643564356435644,1.78725145241797,687,337,350,24,1,81.8,8.3,0,0,0,0,0,0,0.173502691464519,64.8636679701942,49.23946853473
8.7,"random_instances_SVM","SVM",9,32,612,558,54,3300,2950,350,0.939191325061815,0.648514851485149,1.78725145241797,702,345,357,15,1,84.36,8.4,0,0,0,0,0,0,0.140672019630615,56.4519260290011,45.3404673894047
8.7,"random_instances_SVM","SVM",9,33,512,465,47,3400,3043,357,0.939484854984933,0.643564356435644,1.79053986355397,717,352,365,15,1,86.91,8.5,0,0,0,0,0,0,0.0950029053634248,51.0903608412216,43.0382105297184
8.7,"random_instances_SVM","SVM",9,34,412,374,38,3500,3134,366,0.940572891382643,0.643564356435644,1.78561177218639,738,360,378,21,1.1,89.47,8.6,0,0,0,0,0,0,0.0693494852368523,42.5498413914525,37.5421166820322
8.7,"random_instances_SVM","SVM",9,35,312,288,24,3600,3220,380,0.94006062521874,0.653465346534653,1.79053986355397,765,373,392,27,1.1,92.02,8.5,0,0,0,0,0,0,0.0481695427724775,27.8141177706192,25.6628538889454
8.7,"random_instances_SVM","SVM",9,36,212,196,16,3700,3312,388,0.940111428474663,0.653465346534653,1.79053986355397,783,382,401,18,1,94.58,8.5,0,0,0,0,0,0,0.0124202323607135,17.5915527887122,17.1647853773692
8.7,"random_instances_SVM","SVM",9,37,112,103,9,3800,3405,395,0.940695665917792,0.653465346534653,1.79053986355397,794,389,405,11,1,97.14,8.6,0,0,0,0,0,0,0.0014401362274164,10.2150970233277,10.2044469852435
8.7,"random_instances_SVM","SVM",9,38,12,12,0,3900,3496,404,0.940396491188462,0.653465346534653,1.78725145241797,812,397,415,18,1,99.69,8.7,0,0,0,0,0,0,0.000464611882389109,0.447640854704395,0.447640854704395
8.7,"random_instances_SVM","SVM",9,39,0,0,0,3912,3508,404,0.940369678358946,0.653465346534653,1.78889414676762,813,397,416,1,1,100,8.7,0,0,0,0,0,0,0,0,0
8.7,"random_instances_SVM","SVM",10,0,3812,3411,401,100,89,11,0.897027159858188,0.541237113402062,1.67580850162406,28,11,17,0,1.5,2.56,8.1,0,0,0,0,0,0,0.535637693659268,405.021371525579,58.2543814328756
8.7,"random_instances_SVM","SVM",10,1,3712,3327,385,200,173,27,0.927343576301535,0.597938144329897,1.78089701154222,58,27,31,30,1.1,5.11,6.4,0,0,0,0,0,0,0.807394829251626,473.692363851648,84.8525933267147
8.7,"random_instances_SVM","SVM",10,2,3612,3235,377,300,265,35,0.92478819757305,0.587628865979381,1.76674548377944,74,35,39,16,1.1,7.67,7.6,0,0,0,0,0,0,0.800228716456835,431.66203638102,84.4157236460714
8.7,"random_instances_SVM","SVM",10,3,3512,3142,370,400,358,42,0.925158266730639,0.587628865979381,1.77112081568746,91,42,49,17,1.2,10.22,8.5,0,0,0,0,0,0,0.808213325822864,384.533058522753,86.0310930828863
8.7,"random_instances_SVM","SVM",10,4,3412,3049,363,500,451,49,0.923906175035407,0.551546391752577,1.77112081568746,108,49,59,17,1.2,12.78,9.2,0,0,0,0,0,0,0.576843659323433,298.588127587762,66.1830634660792
8.7,"random_instances_SVM","SVM",10,5,3312,2967,345,600,533,67,0.925866225119077,0.551546391752577,1.78034540326916,144,67,77,36,1.1,15.34,8,0,0,0,0,0,0,0.707520427398243,348.651120257467,78.70075130366
8.7,"random_instances_SVM","SVM",10,6,3212,2878,334,700,622,78,0.923375206244084,0.582474226804124,1.78253687987697,164,78,86,20,1.1,17.89,8,0,0,0,0,0,0,0.831650149396158,379.753994238738,88.5489742605314
8.7,"random_instances_SVM","SVM",10,7,3112,2785,327,800,715,85,0.922130428168563,0.597938144329897,1.74540069487954,180,85,95,16,1.1,20.45,8.4,0,0,0,0,0,0,0.776525811651267,342.778047367077,83.960879579099
8.7,"random_instances_SVM","SVM",10,8,3012,2694,318,900,806,94,0.927725347250664,0.603092783505155,1.78852713765919,200,94,106,20,1.1,23.01,8.6,0,0,0,0,0,0,0.668139137007014,316.485867825941,76.827224380482
8.7,"random_instances_SVM","SVM",10,9,2912,2599,313,1000,901,99,0.930819008390184,0.603092783505155,1.79944802207912,212,99,113,12,1.1,25.56,9.1,0,0,0,0,0,0,0.69414787086563,314.43406042925,80.4697009186425
8.7,"random_instances_SVM","SVM",10,10,2812,2508,304,1100,992,108,0.933302713645458,0.608247422680412,1.79944802207912,239,108,131,27,1.2,28.12,9.2,0,0,0,0,0,0,0.764208226339341,312.598906089514,84.7274560266228
8.7,"random_instances_SVM","SVM",10,11,2712,2417,295,1200,1083,117,0.932337315843057,0.618556701030928,1.79017251681067,254,117,137,15,1.2,30.67,9.3,0,0,0,0,0,0,0.700011457495379,280.515235037322,81.525500885489
8.7,"random_instances_SVM","SVM",10,12,2612,2329,283,1300,1171,129,0.935356378061484,0.623711340206186,1.78089701154222,279,129,150,25,1.2,33.23,9.1,0,0,0,0,0,0,0.721540525407795,283.64648114696,81.6786607745845
8.7,"random_instances_SVM","SVM",10,13,2512,2242,270,1400,1258,142,0.93632323858783,0.623711340206186,1.78852713765919,304,142,162,25,1.1,35.79,8.9,0,0,0,0,0,0,0.799900519562578,286.940021981859,88.2592270555498
8.7,"random_instances_SVM","SVM",10,14,2412,2155,257,1500,1345,155,0.936661127818671,0.608247422680412,1.78688478032433,323,155,168,19,1.1,38.34,8.7,0,0,0,0,0,0,0.764371609975641,273.695418400777,85.8761427516775
8.7,"random_instances_SVM","SVM",10,15,2312,2065,247,1600,1435,165,0.93540025977977,0.623711340206186,1.77436759995086,343,165,178,20,1.1,40.9,8.7,0,0,0,0,0,0,0.816285355214014,275.661279221435,89.3472012554462
8.7,"random_instances_SVM","SVM",10,16,2212,1974,238,1700,1526,174,0.935730835390903,0.608247422680412,1.78688478032433,359,174,185,16,1.1,43.46,8.8,0,0,0,0,0,0,0.746410492959447,250.749932687965,86.199217194862
8.7,"random_instances_SVM","SVM",10,17,2112,1883,229,1800,1617,183,0.936339328551204,0.592783505154639,1.79347237398451,377,183,194,18,1.1,46.01,8.8,0,0,0,0,0,0,0.740112828096298,237.093725379524,85.5441740917892
8.7,"random_instances_SVM","SVM",10,18,2012,1790,222,1900,1710,190,0.936731338567938,0.61340206185567,1.79017251681067,393,190,203,16,1.1,48.57,9,0,0,0,0,0,0,0.763372038384476,243.110904506805,88.7734409460963
8.7,"random_instances_SVM","SVM",10,19,1912,1701,211,2000,1799,201,0.937193559333941,0.603092783505155,1.79347237398451,417,201,216,24,1.1,51.12,9,0,0,0,0,0,0,0.668118624851765,218.861368706412,82.9738320234605
8.7,"random_instances_SVM","SVM",10,20,1812,1607,205,2100,1893,207,0.936116994511866,0.597938144329897,1.79017251681067,431,207,224,14,1.1,53.68,9.1,0,0,0,0,0,0,0.743043434376352,220.915601174033,87.9936662194688
8.7,"random_instances_SVM","SVM",10,21,1712,1517,195,2200,1983,217,0.937266695531096,0.603092783505155,1.78688478032433,450,217,233,19,1.1,56.24,9.1,0,0,0,0,0,0,0.683915473578994,199.177827765705,83.6717392496557
8.7,"random_instances_SVM","SVM",10,22,1612,1426,186,2300,2074,226,0.938501234539016,0.597938144329897,1.78524543648917,470,226,244,20,1.1,58.79,9.2,0,0,0,0,0,0,0.665280060459176,183.190984419068,83.1777269667748
8.7,"random_instances_SVM","SVM",10,23,1512,1338,174,2400,2162,238,0.939691891828648,0.618556701030928,1.79017251681067,490,238,252,20,1.1,61.35,9.1,0,0,0,0,0,0,0.633813175931859,169.232407029573,82.1159491904559
8.7,"random_instances_SVM","SVM",10,24,1412,1250,162,2500,2250,250,0.94054319716349,0.628865979381443,1.78852713765919,514,250,264,24,1.1,63.91,9,0,0,0,0,0,0,0.618753166880363,161.452568286439,79.682404527962
8.7,"random_instances_SVM","SVM",10,25,1312,1158,154,2600,2342,258,0.939238447406303,0.634020618556701,1.79017251681067,534,258,276,20,1.1,66.46,9.1,0,0,0,0,0,0,0.581354888527086,146.437294360891,79.7133927303922
8.7,"random_instances_SVM","SVM",10,26,1212,1072,140,2700,2428,272,0.939351077149916,0.623711340206186,1.79182092612633,560,272,288,26,1.1,69.02,8.9,0,0,0,0,0,0,0.5792935510452,135.885321492988,79.9789748158694
8.7,"random_instances_SVM","SVM",10,27,1112,983,129,2800,2517,283,0.939716758135675,0.639175257731959,1.79182092612633,584,283,301,24,1.1,71.57,8.9,0,0,0,0,0,0,0.569139836155415,130.309589314932,78.1367434115591
8.7,"random_instances_SVM","SVM",10,28,1012,895,117,2900,2605,295,0.939817686087747,0.628865979381443,1.79347237398451,604,294,310,20,1.1,74.13,8.8,0,0,0,0,0,0,0.512731682557459,115.131021539205,74.7467405749603
8.7,"random_instances_SVM","SVM",10,29,912,805,107,3000,2695,305,0.93967580186527,0.623711340206186,1.79779411764706,622,302,320,18,1.1,76.69,8.8,0,0,0,0,0,0,0.452041939503818,106.293499575054,71.5055957600549
8.7,"random_instances_SVM","SVM",10,30,812,717,95,3100,2783,317,0.940689469557794,0.634020618556701,1.79944802207912,643,313,330,21,1.1,79.24,8.8,0,0,0,0,0,0,0.392499107225635,96.7685456033059,70.2007568586918
8.7,"random_instances_SVM","SVM",10,31,712,628,84,3200,2872,328,0.940354505774838,0.623711340206186,1.80110497237569,664,324,340,21,1,81.8,8.8,0,0,0,0,0,0,0.291373888114314,82.1232411208132,63.9498163201254
8.7,"random_instances_SVM","SVM",10,32,612,539,73,3300,2961,339,0.940709947692997,0.623711340206186,1.79944802207912,680,332,348,16,1,84.36,8.7,0,0,0,0,0,0,0.232542195294748,72.1972837027106,59.7905473190604
8.7,"random_instances_SVM","SVM",10,33,512,449,63,3400,3051,349,0.94090448997742,0.618556701030928,1.79779411764706,698,342,356,18,1,86.91,8.7,0,0,0,0,0,0,0.145369252247476,61.6798209751047,54.1707887632144
8.7,"random_instances_SVM","SVM",10,34,412,364,48,3500,3136,364,0.941469101419431,0.634020618556701,1.79449541284404,721,354,367,23,1,89.47,8.6,0,0,0,0,0,0,0.0819801014726312,49.1851220698864,44.3658192302304
8.7,"random_instances_SVM","SVM",10,35,312,275,37,3600,3225,375,0.941249692827978,0.628865979381443,1.78852713765919,745,365,380,24,1,92.02,8.6,0,0,0,0,0,0,0.0596958444287001,39.3455470010679,37.1660122526979
8.7,"random_instances_SVM","SVM",10,36,212,190,22,3700,3310,390,0.94176603437987,0.628865979381443,1.79347237398451,775,380,395,30,1,94.58,8.5,0,0,0,0,0,0,0.0159466195645258,24.7685908865935,24.3399168172782
8.7,"random_instances_SVM","SVM",10,37,112,101,11,3800,3399,401,0.942819195618853,0.618556701030928,1.79779411764706,807,394,413,32,1,97.14,8.5,0,0,0,0,0,0,0.00113373607870198,11.2122152446757,11.2047977441807
8.7,"random_instances_SVM","SVM",10,38,12,11,1,3900,3489,411,0.942643668745689,0.623711340206186,1.80110497237569,832,404,428,25,1.1,99.69,8.5,0,0,0,0,0,0,0.000260105681365868,1.47604058135268,1.47604058135268
8.7,"random_instances_SVM","SVM",10,39,0,0,0,3912,3500,412,0.94270217770341,0.623711340206186,1.80276497695853,834,405,429,2,1.1,100,8.5,0,0,0,0,0,0,0,0,0
8.7,"random_instances_SVM","SVM",11,0,3812,3410,402,100,94,6,0.898734213580625,0.55050505050505,1.7026113671275,17,6,11,0,1.8,2.56,15.7,0,0,0,0,0,0,0.198603767043443,202.592988885481,22.2717265784433
8.7,"random_instances_SVM","SVM",11,1,3712,3326,386,200,178,22,0.911797152411485,0.55050505050505,1.79035990075548,51,22,29,34,1.3,5.11,8.1,0,0,0,0,0,0,0.667170340099801,419.531118154927,72.96784143047
8.7,"random_instances_SVM","SVM",11,2,3612,3238,374,300,266,34,0.911084680709254,0.545454545454545,1.78216228216228,71,34,37,20,1.1,7.67,7.8,0,0,0,0,0,0,0.867727370830783,476.030962423118,89.8692831723388
8.7,"random_instances_SVM","SVM",11,3,3512,3148,364,400,356,44,0.905759816595988,0.545454545454545,1.78291199285674,93,44,49,22,1.1,10.22,8.1,0,0,0,0,0,0,0.880036794470811,459.036362253,91.1337811256305
8.7,"random_instances_SVM","SVM",11,4,3412,3060,352,500,444,56,0.911557267785934,0.535353535353535,1.78871434937611,117,56,61,24,1.1,12.78,7.9,0,0,0,0,0,0,0.829230516632403,446.763674941709,87.2625747757576
8.7,"random_instances_SVM","SVM",11,5,3312,2967,345,600,537,63,0.915672653727258,0.545454545454545,1.78543230469836,130,63,67,13,1.1,15.34,8.5,0,0,0,0,0,0,0.817831221362901,400.655940383347,86.3069819734122
8.7,"random_instances_SVM","SVM",11,6,3212,2878,334,700,626,74,0.917269969317747,0.575757575757576,1.78707182012967,150,72,78,20,1.1,17.89,8.5,0,0,0,0,0,0,0.746187563610371,352.195984440605,80.356419686952
8.7,"random_instances_SVM","SVM",11,7,3112,2794,318,800,710,90,0.920332448489442,0.555555555555556,1.78707182012967,172,84,88,22,1,20.45,7.9,0,0,0,0,0,0,0.74549302813285,359.848610908318,80.4070508616281
8.7,"random_instances_SVM","SVM",11,8,3012,2699,313,900,805,95,0.920200296480156,0.560606060606061,1.78707182012967,188,91,97,16,1.1,23.01,8.5,0,0,0,0,0,0,0.7406983932946,334.735057693202,81.0092989017779
8.7,"random_instances_SVM","SVM",11,9,2912,2606,306,1000,898,102,0.920022178554598,0.570707070707071,1.78707182012967,206,100,106,18,1.1,25.56,8.8,0,0,0,0,0,0,0.76701027082119,330.833155248324,83.354551926394
8.7,"random_instances_SVM","SVM",11,10,2812,2512,300,1100,992,108,0.917404994196807,0.560606060606061,1.77800038957064,218,106,112,12,1.1,28.12,9.2,0,0,0,0,0,0,0.789253383569677,321.216506790169,85.6515327213302
8.7,"random_instances_SVM","SVM",11,11,2712,2428,284,1200,1076,124,0.921908217556678,0.570707070707071,1.78871434937611,248,122,126,30,1,30.67,8.7,0,0,0,0,0,0,0.743996242921257,299.32867076947,81.1619743273616
8.7,"random_instances_SVM","SVM",11,12,2612,2335,277,1300,1169,131,0.920493329196397,0.560606060606061,1.79035990075548,263,129,134,15,1,33.23,8.9,0,0,0,0,0,0,0.746797264817663,283.680566204318,81.8841136816436
8.7,"random_instances_SVM","SVM",11,13,2512,2248,264,1400,1256,144,0.918763861596623,0.560606060606061,1.79614325068871,280,138,142,17,1,35.79,8.7,0,0,0,0,0,0,0.693952238604423,267.828170440913,77.7216386185154
8.7,"random_instances_SVM","SVM",11,14,2412,2160,252,1500,1344,156,0.921918272600863,0.560606060606061,1.78707182012967,303,148,155,23,1,38.34,8.6,0,0,0,0,0,0,0.692251672899645,256.272910162629,78.0209608400928
8.7,"random_instances_SVM","SVM",11,15,2312,2074,238,1600,1430,170,0.922978361544914,0.565656565656566,1.78216228216228,323,161,162,20,1,40.9,8.4,0,0,0,0,0,0,0.691020965136123,248.148214558826,78.1233916623344
8.7,"random_instances_SVM","SVM",11,16,2212,1982,230,1700,1522,178,0.924647498879577,0.575757575757576,1.77149352629682,347,170,177,24,1,43.46,8.6,0,0,0,0,0,0,0.681611750320562,237.367290518539,77.6096653121094
8.7,"random_instances_SVM","SVM",11,17,2112,1893,219,1800,1611,189,0.927810528493116,0.580808080808081,1.77800038957064,374,182,192,27,1.1,46.01,8.5,0,0,0,0,0,0,0.704379298051715,235.163296977437,80.1829992212317
8.7,"random_instances_SVM","SVM",11,18,2012,1805,207,1900,1699,201,0.9272014801025,0.585858585858586,1.77800038957064,393,192,201,19,1,48.57,8.5,0,0,0,0,0,0,0.659261650887528,221.830936252525,76.4107150997721
8.7,"random_instances_SVM","SVM",11,19,1912,1715,197,2000,1789,211,0.927408326725729,0.570707070707071,1.77963458110517,407,201,206,14,1,51.12,8.5,0,0,0,0,0,0,0.616949577291619,206.109278004529,74.8266990100124
8.7,"random_instances_SVM","SVM",11,20,1812,1624,188,2100,1880,220,0.926738948070002,0.565656565656566,1.77800038957064,425,208,217,18,1,53.68,8.5,0,0,0,0,0,0,0.620682661600811,188.459887884816,75.5562410265219
8.7,"random_instances_SVM","SVM",11,21,1712,1537,175,2200,1967,233,0.925802392525942,0.575757575757576,1.77800038957064,451,222,229,26,1,56.24,8.4,0,0,0,0,0,0,0.593887961851572,173.661217760787,73.3841861058051
8.7,"random_instances_SVM","SVM",11,22,1612,1449,163,2300,2055,245,0.928428195493044,0.575757575757576,1.76568619281727,478,236,242,27,1,58.79,8.4,0,0,0,0,0,0,0.566908201710883,160.814601392615,71.404721116285
8.7,"random_instances_SVM","SVM",11,23,1512,1365,147,2400,2139,261,0.928275933395388,0.565656565656566,1.77055481283422,514,251,263,36,1,61.35,8.2,0,0,0,0,0,0,0.55496660124479,153.84454411064,71.5395103829007
8.7,"random_instances_SVM","SVM",11,24,1412,1279,133,2500,2225,275,0.930640305213684,0.570707070707071,1.77800038957064,539,265,274,25,1,63.91,8.1,0,0,0,0,0,0,0.519897437147547,145.217529334286,69.7645867496859
8.7,"random_instances_SVM","SVM",11,25,1312,1196,116,2600,2308,292,0.931822491122832,0.570707070707071,1.77963458110517,564,276,288,25,1,66.46,7.9,0,0,0,0,0,0,0.48490184063618,132.882967548698,68.1546855504414
8.7,"random_instances_SVM","SVM",11,26,1212,1104,108,2700,2400,300,0.930717872697392,0.575757575757576,1.78455522971652,587,288,299,23,1,69.02,8,0,0,0,0,0,0,0.446470740887876,122.458927169832,66.4798109822314
8.7,"random_instances_SVM","SVM",11,27,1112,1014,98,2800,2490,310,0.932231875064637,0.575757575757576,1.78455522971652,602,296,306,15,1,71.57,8,0,0,0,0,0,0,0.408878739700801,112.1031468464,63.1617193077494
8.7,"random_instances_SVM","SVM",11,28,1012,925,87,2900,2579,321,0.934366417301571,0.580808080808081,1.78455522971652,629,308,321,27,1,74.13,8,0,0,0,0,0,0,0.379270304069538,101.81470804959,61.4766847073801
8.7,"random_instances_SVM","SVM",11,29,912,832,80,3000,2672,328,0.934564645315498,0.590909090909091,1.78455522971652,651,319,332,22,1,76.69,8.1,0,0,0,0,0,0,0.304495814792604,89.9619857316711,58.043941679599
8.7,"random_instances_SVM","SVM",11,30,812,741,71,3100,2763,337,0.933346548534262,0.580808080808081,1.77218365810822,669,327,342,18,1,79.24,8.2,0,0,0,0,0,0,0.247566008601613,79.7251087489475,55.1992700044812
8.7,"random_instances_SVM","SVM",11,31,712,648,64,3200,2856,344,0.93182249112283,0.590909090909091,1.77963458110517,688,335,353,19,1.1,81.8,8.3,0,0,0,0,0,0,0.18736398146074,67.7420125547728,50.3603371135458
8.7,"random_instances_SVM","SVM",11,32,612,553,59,3300,2951,349,0.932737500143639,0.585858585858586,1.78127177943185,698,341,357,10,1,84.36,8.5,0,0,0,0,0,0,0.171944655636214,61.0004694850559,46.6455770258332
8.7,"random_instances_SVM","SVM",11,33,512,458,54,3400,3046,354,0.933375277231929,0.590909090909091,1.78127177943185,715,348,367,17,1.1,86.91,8.6,0,0,0,0,0,0,0.129765745830682,53.517049914678,43.52811781315
8.7,"random_instances_SVM","SVM",11,34,412,373,39,3500,3131,369,0.933198595741253,0.595959595959596,1.78291199285674,742,362,380,27,1,89.47,8.5,0,0,0,0,0,0,0.0763913643768995,39.8854221559708,33.8461512033209
8.7,"random_instances_SVM","SVM",11,35,312,284,28,3600,3220,380,0.934024545799285,0.595959595959596,1.78127177943185,762,372,390,20,1,92.02,8.5,0,0,0,0,0,0,0.052051298519421,31.8343488491358,29.1905863526567
8.7,"random_instances_SVM","SVM",11,36,212,194,18,3700,3310,390,0.934301777731802,0.601010101010101,1.77963458110517,787,383,404,25,1.1,94.58,8.5,0,0,0,0,0,0,0.0279196480837625,18.50275617925,17.6918265520149
8.7,"random_instances_SVM","SVM",11,37,112,103,9,3800,3401,399,0.935394904678175,0.595959595959596,1.77800038957064,801,391,410,14,1,97.14,8.5,0,0,0,0,0,0,0.00228746512050222,11.3686226201404,11.3547256815022
8.7,"random_instances_SVM","SVM",11,38,12,12,0,3900,3492,408,0.934291722687621,0.595959595959596,1.78455522971652,812,398,414,11,1,99.69,8.6,0,0,0,0,0,0,0.00112986337604524,0.655277936975535,0.655277936975535
8.7,"random_instances_SVM","SVM",11,39,0,0,0,3912,3504,408,0.934258684685299,0.595959595959596,1.78291199285674,812,398,414,0,1,100,8.6,0,0,0,0,0,0,0,0,0
8.7,"random_instances_SVM","SVM",12,0,3812,3429,383,100,83,17,0.886604715672676,0.519417475728155,1.67817134321989,40,17,23,0,1.4,2.56,4.9,0,0,0,0,0,0,0.755082958750557,602.92772327674,80.8889930204038
8.7,"random_instances_SVM","SVM",12,1,3712,3344,368,200,168,32,0.907331484049934,0.563106796116505,1.72007212712851,67,32,35,27,1.1,5.11,5.2,0,0,0,0,0,0,0.875801257433397,553.429795557241,91.091245013775
8.7,"random_instances_SVM","SVM",12,2,3612,3259,353,300,253,47,0.920185852981957,0.587378640776699,1.78197765293272,98,45,53,31,1.2,7.67,5.4,0,0,0,0,0,0,0.842727295352736,528.54895754632,87.9398055768551
8.7,"random_instances_SVM","SVM",12,3,3512,3169,343,400,343,57,0.926765603328698,0.601941747572815,1.7699858247078,117,55,62,19,1.1,10.22,6,0,0,0,0,0,0,0.842749326907664,460.429358767801,87.9202969696025
8.7,"random_instances_SVM","SVM",12,4,3412,3081,331,500,431,69,0.930410540915393,0.606796116504854,1.78414743755173,143,67,76,26,1.1,12.78,6.2,0,0,0,0,0,0,0.865670262164173,478.870095909268,89.9003706408367
8.7,"random_instances_SVM","SVM",12,5,3312,2988,324,600,524,76,0.932636615811371,0.601941747572815,1.77707312728244,160,75,85,17,1.1,15.34,6.9,0,0,0,0,0,0,0.853965068127309,469.562366085905,89.015410676441
8.7,"random_instances_SVM","SVM",12,6,3212,2901,311,700,611,89,0.935930651872391,0.616504854368932,1.77707312728244,187,88,99,27,1.1,17.89,6.9,0,0,0,0,0,0,0.855033370389312,449.304236140442,89.1453204604044
8.7,"random_instances_SVM","SVM",12,7,3112,2807,305,800,705,95,0.936063800277381,0.616504854368932,1.79071283750592,198,95,103,11,1.1,20.45,7.4,0,0,0,0,0,0,0.800181654099037,402.423065990267,85.4834284615185
8.7,"random_instances_SVM","SVM",12,8,3012,2718,294,900,794,106,0.934427184466005,0.611650485436893,1.78197765293272,218,105,113,20,1.1,23.01,7.5,0,0,0,0,0,0,0.765768062484803,360.984877432702,83.0009063547997
8.7,"random_instances_SVM","SVM",12,9,2912,2630,282,1000,882,118,0.937323162274608,0.606796116504854,1.78742410869507,241,116,125,23,1.1,25.56,7.5,0,0,0,0,0,0,0.75895529601943,354.580027787619,82.2847447763804
8.7,"random_instances_SVM","SVM",12,10,2812,2537,275,1100,975,125,0.938991678224672,0.601941747572815,1.78906696173615,255,125,130,14,1,28.12,7.8,0,0,0,0,0,0,0.804152946824323,351.836987121037,86.7228909019996
8.7,"random_instances_SVM","SVM",12,11,2712,2444,268,1200,1068,132,0.938230235783616,0.611650485436893,1.79401369066261,276,132,144,21,1.1,30.67,8.1,0,0,0,0,0,0,0.735965642771902,314.071110442938,80.9329298225257
8.7,"random_instances_SVM","SVM",12,12,2612,2353,259,1300,1159,141,0.935303744798874,0.587378640776699,1.79236174435445,293,141,152,17,1.1,33.23,8.2,0,0,0,0,0,0,0.741676483933924,289.872776496185,81.8710521486564
8.7,"random_instances_SVM","SVM",12,13,2512,2257,255,1400,1255,145,0.941059639389713,0.645631067961165,1.77870496670144,303,145,158,10,1.1,35.79,8.7,0,0,0,0,0,0,0.742979404354882,268.571495501721,84.0030048862912
8.7,"random_instances_SVM","SVM",12,14,2412,2168,244,1500,1344,156,0.94071567267682,0.645631067961165,1.78526240436669,323,156,167,20,1.1,38.34,8.6,0,0,0,0,0,0,0.719331445006372,251.140580776503,82.3779046212712
8.7,"random_instances_SVM","SVM",12,15,2312,2077,235,1600,1435,165,0.941414701803029,0.635922330097087,1.78526240436669,344,165,179,21,1.1,40.9,8.7,0,0,0,0,0,0,0.669205734587722,238.4509173624,78.7554713256454
8.7,"random_instances_SVM","SVM",12,16,2212,1989,223,1700,1523,177,0.943640776699006,0.650485436893204,1.77707312728244,370,177,193,26,1.1,43.46,8.6,0,0,0,0,0,0,0.729942459667724,237.802234604789,83.3616949008659
8.7,"random_instances_SVM","SVM",12,17,2112,1894,218,1800,1618,182,0.945264909847412,0.655339805825243,1.78526240436669,379,182,197,9,1.1,46.01,8.9,0,0,0,0,0,0,0.681031403851861,219.602797348343,80.4032668718431
8.7,"random_instances_SVM","SVM",12,18,2012,1810,202,1900,1702,198,0.944957004160864,0.635922330097087,1.78197765293272,410,198,212,31,1.1,48.57,8.6,0,0,0,0,0,0,0.685986848327325,220.726423304168,82.6452789261533
8.7,"random_instances_SVM","SVM",12,19,1912,1722,190,2000,1790,210,0.944492371705941,0.62621359223301,1.78033980582524,438,210,228,28,1.1,51.12,8.5,0,0,0,0,0,0,0.633727709492834,200.591861395058,79.1349899483019
8.7,"random_instances_SVM","SVM",12,20,1812,1633,179,2100,1879,221,0.946241331484029,0.635922330097087,1.79401369066261,462,221,241,24,1.1,53.68,8.5,0,0,0,0,0,0,0.557578425305329,184.366998291325,73.8867081813988
8.7,"random_instances_SVM","SVM",12,21,1712,1538,174,2200,1974,226,0.947106796116483,0.640776699029126,1.78906696173615,472,226,246,10,1.1,56.24,8.7,0,0,0,0,0,0,0.600521145620055,177.442137451537,78.7875659290258
8.7,"random_instances_SVM","SVM",12,22,1612,1447,165,2300,2065,235,0.946703190013846,0.635922330097087,1.78033980582524,493,235,258,21,1.1,58.79,8.8,0,0,0,0,0,0,0.562578489011303,165.62278630469,79.4987352664151
8.7,"random_instances_SVM","SVM",12,23,1512,1352,160,2400,2160,240,0.946848821081809,0.635922330097087,1.79236174435445,503,240,263,10,1.1,61.35,9,0,0,0,0,0,0,0.500497189245452,152.926220989388,73.8368815160908
8.7,"random_instances_SVM","SVM",12,24,1412,1266,146,2500,2246,254,0.948116504854347,0.660194174757282,1.78578427006324,528,254,274,25,1.1,63.91,8.8,0,0,0,0,0,0,0.516402456060889,143.130595510428,75.1549936554147
8.7,"random_instances_SVM","SVM",12,25,1312,1173,139,2600,2339,261,0.947331484049911,0.635922330097087,1.78414743755173,535,261,274,7,1,66.46,9,0,0,0,0,0,0,0.478376870870852,130.357248300689,72.8152412377591
8.7,"random_instances_SVM","SVM",12,26,1212,1081,131,2700,2431,269,0.94659361997224,0.631067961165049,1.79071283750592,556,269,287,21,1.1,69.02,9,0,0,0,0,0,0,0.487021750371924,126.962145607891,72.8338776381211
8.7,"random_instances_SVM","SVM",12,27,1112,995,117,2800,2517,283,0.946565880721198,0.645631067961165,1.79071283750592,582,283,299,26,1.1,71.57,8.9,0,0,0,0,0,0,0.45303024267244,115.727506373006,70.4004739499459
8.7,"random_instances_SVM","SVM",12,28,1012,909,103,2900,2603,297,0.948424410540892,0.66504854368932,1.79071283750592,613,297,316,31,1.1,74.13,8.8,0,0,0,0,0,0,0.374088862675414,106.63297292025,67.9890375325281
8.7,"random_instances_SVM","SVM",12,29,912,823,89,3000,2689,311,0.947732316227441,0.655339805825243,1.79236174435445,644,311,333,31,1.1,76.69,8.6,0,0,0,0,0,0,0.316562037088321,92.6197154967451,66.0264553637552
8.7,"random_instances_SVM","SVM",12,30,812,734,78,3100,2778,322,0.948493758668496,0.660194174757282,1.78906696173615,663,322,341,19,1.1,79.24,8.6,0,0,0,0,0,0,0.217667920308947,79.5971460134751,61.0158052938811
8.7,"random_instances_SVM","SVM",12,31,712,642,70,3200,2870,330,0.948377253814127,0.650485436893204,1.79071283750592,677,330,347,14,1.1,81.8,8.7,0,0,0,0,0,0,0.162010280391756,68.1287709671694,54.0532955863488
8.7,"random_instances_SVM","SVM",12,32,612,549,63,3300,2963,337,0.948058252427164,0.66504854368932,1.79071283750592,692,337,355,15,1.1,84.36,8.8,0,0,0,0,0,0,0.121028992063844,60.6544693771445,50.5742806930254
8.7,"random_instances_SVM","SVM",12,33,512,460,52,3400,3052,348,0.948446601941729,0.66504854368932,1.78414743755173,711,348,363,19,1,86.91,8.8,0,0,0,0,0,0,0.0950090732088605,51.3932798092661,44.8222967000864
8.7,"random_instances_SVM","SVM",12,34,412,374,38,3500,3138,362,0.948840499306499,0.660194174757282,1.79071283750592,745,362,383,34,1.1,89.47,8.7,0,0,0,0,0,0,0.0747751498799275,43.1546657329653,39.3214214324668
8.7,"random_instances_SVM","SVM",12,35,312,283,29,3600,3229,371,0.948832177531185,0.655339805825243,1.78197765293272,763,371,392,18,1.1,92.02,8.7,0,0,0,0,0,0,0.0352051007506011,31.8277099089296,30.5833211274681
8.7,"random_instances_SVM","SVM",12,36,212,188,24,3700,3324,376,0.94880166435504,0.660194174757282,1.78197765293272,774,376,398,11,1.1,94.58,8.8,0,0,0,0,0,0,0.00959859175122619,22.5010036390298,22.2120073532431
8.7,"random_instances_SVM","SVM",12,37,112,99,13,3800,3413,387,0.94840221914006,0.669902912621359,1.78197765293272,790,387,403,16,1,97.14,8.8,0,0,0,0,0,0,0.00134448168134371,12.8283215715876,12.8222269679469
8.7,"random_instances_SVM","SVM",12,38,12,11,1,3900,3501,399,0.948262135922308,0.669902912621359,1.77707312728244,817,399,418,27,1,99.69,8.8,0,0,0,0,0,0,0.00174762394046136,0.546727862697727,0.546727862697727
8.7,"random_instances_SVM","SVM",12,39,0,0,0,3912,3512,400,0.948327323162251,0.669902912621359,1.77870496670144,820,400,420,3,1.1,100,8.8,0,0,0,0,0,0,0,0,0
8.7,"random_instances_SVM","SVM",13,0,3812,3427,385,100,90,10,0.875036325859933,0.507109004739337,1.74295760805469,24,10,14,0,1.4,2.56,9,0,0,0,0,0,0,0.369456367874115,345.579456557964,41.32063982017
8.7,"random_instances_SVM","SVM",13,1,3712,3343,369,200,174,26,0.91186735289724,0.563981042654028,1.75519236130471,58,26,32,34,1.2,5.11,6.7,0,0,0,0,0,0,0.659588755642542,402.443408614895,71.0432069287937
8.7,"random_instances_SVM","SVM",13,2,3612,3251,361,300,266,34,0.904439223780879,0.57345971563981,1.74186906225429,74,34,40,16,1.2,7.67,7.8,0,0,0,0,0,0,0.690676735945546,363.324308380365,75.2854767013908
8.7,"random_instances_SVM","SVM",13,3,3512,3162,350,400,355,45,0.913380138241959,0.559241706161137,1.7685893375849,98,45,53,24,1.2,10.22,7.9,0,0,0,0,0,0,0.746850565390919,380.935463652194,81.0971380804808
8.7,"random_instances_SVM","SVM",13,4,3412,3070,342,500,447,53,0.915938565162459,0.563981042654028,1.770986942998,115,53,62,17,1.2,12.78,8.4,0,0,0,0,0,0,0.681202281962072,365.903310685535,75.3457786743956
8.7,"random_instances_SVM","SVM",13,5,3312,2978,334,600,539,61,0.913993943426696,0.563981042654028,1.77223306384165,132,61,71,17,1.2,15.34,8.8,0,0,0,0,0,0,0.799847021299533,372.03542722885,86.7418363020499
8.7,"random_instances_SVM","SVM",13,6,3212,2887,325,700,630,70,0.917220494574885,0.563981042654028,1.76209314167091,148,70,78,16,1.1,17.89,9,0,0,0,0,0,0,0.805901245693845,366.120538671334,86.646643010956
8.7,"random_instances_SVM","SVM",13,7,3112,2797,315,800,720,80,0.922356360080938,0.587677725118483,1.7685893375849,165,80,85,17,1.1,20.45,9,0,0,0,0,0,0,0.714398434525257,328.530448430615,79.5008673238857
8.7,"random_instances_SVM","SVM",13,8,3012,2706,306,900,811,89,0.922532896970356,0.587677725118483,1.77060566892536,185,89,96,20,1.1,23.01,9.1,0,0,0,0,0,0,0.764339199250148,334.075631688507,84.463236512387
8.7,"random_instances_SVM","SVM",13,9,2912,2612,300,1000,905,95,0.923211885006583,0.592417061611374,1.77060566892536,198,95,103,13,1.1,25.56,9.5,0,0,0,0,0,0,0.772293731166168,316.95713289225,84.7233559204943
8.7,"random_instances_SVM","SVM",13,10,2812,2520,292,1100,997,103,0.920045084805608,0.601895734597156,1.76209314167091,218,103,115,20,1.1,28.12,9.7,0,0,0,0,0,0,0.751118159492054,304.59371604491,83.2065791403541
8.7,"random_instances_SVM","SVM",13,11,2712,2428,284,1200,1089,111,0.924702942734135,0.606635071090047,1.77060566892536,232,111,121,14,1.1,30.67,9.8,0,0,0,0,0,0,0.768085615888266,297.378653919192,85.462597314133
8.7,"random_instances_SVM","SVM",13,12,2612,2335,277,1300,1182,118,0.926536210431964,0.611374407582938,1.77549684480637,252,118,134,20,1.1,33.23,10,0,0,0,0,0,0,0.670416390432314,270.623261960319,78.1040617799437
8.7,"random_instances_SVM","SVM",13,13,2512,2244,268,1400,1273,127,0.926826817311466,0.616113744075829,1.76898126005478,270,127,143,18,1.1,35.79,10,0,0,0,0,0,0,0.666781457799099,258.248270383578,78.6946874606699
8.7,"random_instances_SVM","SVM",13,14,2412,2156,256,1500,1361,139,0.925164654598772,0.611374407582938,1.77223306384165,292,139,153,22,1.1,38.34,9.8,0,0,0,0,0,0,0.665372573312469,239.350668052377,79.07628364894
8.7,"random_instances_SVM","SVM",13,15,2312,2069,243,1600,1448,152,0.926515840790884,0.606635071090047,1.78403288732948,317,152,165,25,1.1,40.9,9.5,0,0,0,0,0,0,0.629771278320537,231.884513647901,75.7480774313765
8.7,"random_instances_SVM","SVM",13,16,2212,1977,235,1700,1540,160,0.927698637949988,0.601895734597156,1.79091983240102,334,160,174,17,1.1,43.46,9.6,0,0,0,0,0,0,0.657562161988852,226.406505223225,78.7265592659851
8.7,"random_instances_SVM","SVM",13,17,2112,1882,230,1800,1635,165,0.926976194679434,0.606635071090047,1.77060566892536,347,165,182,13,1.1,46.01,9.9,0,0,0,0,0,0,0.663729089538204,219.547595416946,80.0021619730822
8.7,"random_instances_SVM","SVM",13,18,2012,1791,221,1900,1726,174,0.926378685207547,0.606635071090047,1.77911819617981,365,174,191,18,1.1,48.57,9.9,0,0,0,0,0,0,0.671256869912246,211.65124982798,81.704633789775
8.7,"random_instances_SVM","SVM",13,19,1912,1704,208,2000,1813,187,0.927591357840258,0.611374407582938,1.78075341511012,386,187,199,21,1.1,51.12,9.7,0,0,0,0,0,0,0.658962414736038,199.664711211623,80.1770845055474
8.7,"random_instances_SVM","SVM",13,20,1812,1619,193,2100,1898,202,0.92632300818858,0.611374407582938,1.78403288732948,417,202,215,31,1.1,53.68,9.4,0,0,0,0,0,0,0.665490463790613,191.420814793753,82.1664794765775
8.7,"random_instances_SVM","SVM",13,21,1712,1526,186,2200,1991,209,0.926663860182766,0.616113744075829,1.78239164272292,429,209,220,12,1.1,56.24,9.5,0,0,0,0,0,0,0.651324936262551,179.442249333107,80.8323815502883
8.7,"random_instances_SVM","SVM",13,22,1612,1435,177,2300,2082,218,0.925550319803351,0.62085308056872,1.78239164272292,447,218,229,18,1.1,58.79,9.6,0,0,0,0,0,0,0.603961767791234,160.439895020487,76.660794082599
8.7,"random_instances_SVM","SVM",13,23,1512,1342,170,2400,2175,225,0.924719238447004,0.630331753554502,1.77713324742831,464,225,239,17,1.1,61.35,9.7,0,0,0,0,0,0,0.602243319301307,157.622771586785,78.40595931343
8.7,"random_instances_SVM","SVM",13,24,1412,1261,151,2500,2256,244,0.928980567362389,0.616113744075829,1.78271965001823,499,244,255,35,1,63.91,9.2,0,0,0,0,0,0,0.56892565558623,147.140474906209,77.0531849324105
8.7,"random_instances_SVM","SVM",13,25,1312,1169,143,2600,2348,252,0.929773625388707,0.625592417061611,1.79256892985258,517,252,265,18,1.1,66.46,9.3,0,0,0,0,0,0,0.560783467179685,136.084219370249,78.3309746560866
8.7,"random_instances_SVM","SVM",13,26,1212,1073,139,2700,2444,256,0.928839337850856,0.625592417061611,1.79256892985258,526,256,270,9,1.1,69.02,9.5,0,0,0,0,0,0,0.541965878728583,128.654520823057,77.257916754789
8.7,"random_instances_SVM","SVM",13,27,1112,982,130,2800,2535,265,0.928228248618245,0.616113744075829,1.78927376637859,544,265,279,18,1.1,71.57,9.6,0,0,0,0,0,0,0.5,123.449901672436,75.1448506109923
8.7,"random_instances_SVM","SVM",13,28,1012,893,119,2900,2624,276,0.927264085606797,0.616113744075829,1.78763072343426,566,276,290,22,1.1,74.13,9.5,0,0,0,0,0,0,0.518214784601018,117.424604048917,76.8852771833712
8.7,"random_instances_SVM","SVM",13,29,912,806,106,3000,2711,289,0.929354010782318,0.62085308056872,1.78403288732948,595,289,306,29,1.1,76.69,9.4,0,0,0,0,0,0,0.445872937586962,104.272065775546,70.9288762433199
8.7,"random_instances_SVM","SVM",13,30,812,719,93,3100,2798,302,0.929821154551243,0.616113744075829,1.78403288732948,624,302,322,29,1.1,79.24,9.3,0,0,0,0,0,0,0.350127809998624,92.849829304357,68.568624537481
8.7,"random_instances_SVM","SVM",13,31,712,627,85,3200,2890,310,0.929893127283081,0.625592417061611,1.78567715727171,635,310,325,11,1,81.8,9.3,0,0,0,0,0,0,0.296309456402399,86.6595944689871,68.6157656613106
8.7,"random_instances_SVM","SVM",13,32,612,538,74,3300,2979,321,0.931753554502353,0.630331753554502,1.7774859776512,661,321,340,26,1.1,84.36,9.3,0,0,0,0,0,0,0.235449650789527,75.485052467307,63.057699471478
8.7,"random_instances_SVM","SVM",13,33,512,447,65,3400,3070,330,0.932114776137626,0.639810426540284,1.77911819617981,680,330,350,19,1.1,86.91,9.3,0,0,0,0,0,0,0.135701645650188,62.8494550222889,55.1803423487491
8.7,"random_instances_SVM","SVM",13,34,412,358,54,3500,3159,341,0.931905647822469,0.630331753554502,1.78763072343426,699,341,358,19,1,89.47,9.3,0,0,0,0,0,0,0.0781909434917206,51.2732627555873,46.5678763415329
8.7,"random_instances_SVM","SVM",13,35,312,272,40,3600,3245,355,0.932410814921425,0.62085308056872,1.79091983240102,730,355,375,31,1.1,92.02,9.1,0,0,0,0,0,0,0.0553818015288528,41.8359736215279,39.5750892013742
8.7,"random_instances_SVM","SVM",13,36,212,183,29,3700,3334,366,0.934162604054901,0.635071090047393,1.78763072343426,751,366,385,21,1.1,94.58,9.1,0,0,0,0,0,0,0.0162493918866076,30.3638583845132,29.9904256892139
8.7,"random_instances_SVM","SVM",13,37,112,97,15,3800,3420,380,0.934969241841947,0.625592417061611,1.78927376637859,779,380,399,28,1.1,97.14,9,0,0,0,0,0,0,0.000663580074784694,15.5652967251214,15.5609223810119
8.7,"random_instances_SVM","SVM",13,38,12,10,2,3900,3507,393,0.934108285012005,0.635071090047393,1.78763072343426,794,389,405,15,1,99.69,8.9,0,0,0,0,0,0,0.00029897663635038,1.68224988626322,1.68224988626322
8.7,"random_instances_SVM","SVM",13,39,0,0,0,3912,3517,395,0.934216923097802,0.635071090047393,1.78435367352879,795,390,405,1,1,100,8.9,0,0,0,0,0,0,0,0,0
8.7,"random_instances_SVM","SVM",14,0,3812,3414,398,100,87,13,0.89815955386652,0.533333333333333,1.7636517328825,32,13,19,0,1.5,2.56,6.7,0,0,0,0,0,0,0.696650548181584,532.295199723732,75.8883714316644
8.7,"random_instances_SVM","SVM",14,1,3712,3330,382,200,171,29,0.908512063367246,0.543589743589744,1.74528036066498,65,29,36,33,1.2,5.11,5.9,0,0,0,0,0,0,0.624583232569332,465.274473631003,67.4216660649919
8.7,"random_instances_SVM","SVM",14,2,3612,3245,367,300,256,44,0.906882744361432,0.569230769230769,1.74087730451367,97,44,53,32,1.2,7.67,5.8,0,0,0,0,0,0,0.74409562732962,492.077476660762,79.9343229540344
8.7,"random_instances_SVM","SVM",14,3,3512,3161,351,400,340,60,0.914550299218085,0.594871794871795,1.75330832920529,126,60,66,29,1.1,10.22,5.7,0,0,0,0,0,0,0.73615560258232,483.758945434909,78.0829333029684
8.7,"random_instances_SVM","SVM",14,4,3412,3072,340,500,429,71,0.919623174478359,0.58974358974359,1.77339566510837,146,71,75,20,1.1,12.78,6,0,0,0,0,0,0,0.700796565972586,411.709070240949,75.60555498263
8.7,"random_instances_SVM","SVM",14,5,3312,2984,328,600,517,83,0.914749777952481,0.57948717948718,1.73928016937191,174,82,92,28,1.1,15.34,6.2,0,0,0,0,0,0,0.788768592682802,437.192251401719,83.6063798135323
8.7,"random_instances_SVM","SVM",14,6,3212,2895,317,700,606,94,0.915847639016268,0.574358974358974,1.74247737556561,193,93,100,19,1.1,17.89,6.4,0,0,0,0,0,0,0.813738760758977,422.251940957064,85.8663720620818
8.7,"random_instances_SVM","SVM",14,7,3112,2803,309,800,698,102,0.918440862563498,0.574358974358974,1.7472952853598,210,102,108,17,1.1,20.45,6.8,0,0,0,0,0,0,0.795822204900905,399.569263215249,84.5127073543597
8.7,"random_instances_SVM","SVM",14,8,3012,2710,302,900,791,109,0.916900362556224,0.558974358974359,1.73768596206726,228,109,119,18,1.1,23.01,7.3,0,0,0,0,0,0,0.761856760346425,367.932258087069,82.0952254157988
8.7,"random_instances_SVM","SVM",14,9,2912,2615,297,1000,886,114,0.917067808209193,0.574358974358974,1.75169683257919,236,114,122,8,1.1,25.56,7.8,0,0,0,0,0,0,0.820920393365867,374.149289608835,87.4508866339331
8.7,"random_instances_SVM","SVM",14,10,2812,2524,288,1100,977,123,0.920506996316191,0.569230769230769,1.75492279359683,254,123,131,18,1.1,28.12,7.9,0,0,0,0,0,0,0.776851382399589,339.1925275767,83.8251946111222
8.7,"random_instances_SVM","SVM",14,11,2712,2432,280,1200,1069,131,0.924368438678478,0.58974358974359,1.77935520361991,272,131,141,18,1.1,30.67,8.2,0,0,0,0,0,0,0.711650830391982,307.778333255246,78.3252090400473
8.7,"random_instances_SVM","SVM",14,12,2612,2342,270,1300,1159,141,0.923173022321221,0.574358974358974,1.78099214492959,292,141,151,20,1.1,33.23,8.2,0,0,0,0,0,0,0.765707186693946,304.965656339964,83.2474292508505
8.7,"random_instances_SVM","SVM",14,13,2512,2254,258,1400,1247,153,0.927841115916066,0.58974358974359,1.78263210086415,319,153,166,27,1.1,35.79,8.2,0,0,0,0,0,0,0.711567126279238,285.304417525028,80.260109830057
8.7,"random_instances_SVM","SVM",14,14,2412,2170,242,1500,1331,169,0.929917442012826,0.61025641025641,1.78427507975895,350,169,181,31,1.1,38.34,7.9,0,0,0,0,0,0,0.697400727442001,286.749758732083,78.6747650348973
8.7,"random_instances_SVM","SVM",14,15,2312,2077,235,1600,1424,176,0.93133126574352,0.615384615384615,1.76959639994375,369,176,193,19,1.1,40.9,8.1,0,0,0,0,0,0,0.672717084296886,266.041968424827,77.1383006367609
8.7,"random_instances_SVM","SVM",14,16,2212,1982,230,1700,1519,181,0.931987943912977,0.605128205128205,1.75929928657201,382,181,201,13,1.1,43.46,8.4,0,0,0,0,0,0,0.687560608293337,257.41105398679,79.0304034582186
8.7,"random_instances_SVM","SVM",14,17,2112,1896,216,1800,1605,195,0.931645772361258,0.605128205128205,1.77013574660633,412,195,217,30,1.1,46.01,8.2,0,0,0,0,0,0,0.683055351634848,247.419558926903,80.2397851017718
8.7,"random_instances_SVM","SVM",14,18,2012,1805,207,1900,1696,204,0.930125657042167,0.6,1.77339566510837,423,204,219,11,1.1,48.57,8.3,0,0,0,0,0,0,0.696163718583498,238.317602106751,81.2972594487661
8.7,"random_instances_SVM","SVM",14,19,1912,1717,195,2000,1784,216,0.931388051660602,0.605128205128205,1.77503013115916,451,216,235,28,1.1,51.12,8.3,0,0,0,0,0,0,0.710789467742669,228.311252155915,83.6333573089482
8.7,"random_instances_SVM","SVM",14,20,1812,1628,184,2100,1873,227,0.929136999665085,0.6,1.77013574660633,474,227,247,23,1.1,53.68,8.3,0,0,0,0,0,0,0.707637835143464,223.024153345192,83.4332320123855
8.7,"random_instances_SVM","SVM",14,21,1712,1538,174,2200,1963,237,0.929905793619573,0.605128205128205,1.77176420635482,487,237,250,13,1.1,56.24,8.3,0,0,0,0,0,0,0.685801940034382,206.834266513811,82.6819915146042
8.7,"random_instances_SVM","SVM",14,22,1612,1454,158,2300,2047,253,0.930333872071499,0.605128205128205,1.77176420635482,522,253,269,35,1.1,58.79,8.1,0,0,0,0,0,0,0.695915224459432,197.469204561634,83.3528216339392
8.7,"random_instances_SVM","SVM",14,23,1512,1363,149,2400,2138,262,0.929853375849952,0.605128205128205,1.7641592293526,541,262,279,19,1.1,61.35,8.2,0,0,0,0,0,0,0.649449174190735,185.53564117847,80.5671762548302
8.7,"random_instances_SVM","SVM",14,24,1412,1274,138,2500,2227,273,0.930290190596816,0.594871794871795,1.7641592293526,557,273,284,16,1,63.91,8.2,0,0,0,0,0,0,0.637215299242149,172.798080541246,79.4846684298867
8.7,"random_instances_SVM","SVM",14,25,1312,1185,127,2600,2316,284,0.930510054019404,0.6,1.7641592293526,581,282,299,24,1.1,66.46,8.2,0,0,0,0,0,0,0.599685607930345,157.057214531647,77.3029709219086
8.7,"random_instances_SVM","SVM",14,26,1212,1094,118,2700,2407,293,0.931222062056799,0.61025641025641,1.75929928657201,602,293,309,21,1.1,69.02,8.2,0,0,0,0,0,0,0.61562952544267,149.736762625435,79.4754613294004
8.7,"random_instances_SVM","SVM",14,27,1112,1000,112,2800,2501,299,0.932731985031796,0.6,1.76091628959276,617,299,318,15,1.1,71.57,8.4,0,0,0,0,0,0,0.615768871096407,144.802236274276,81.2788608275706
8.7,"random_instances_SVM","SVM",14,28,1012,912,100,2900,2589,311,0.932375252988523,0.605128205128205,1.76091628959276,641,311,330,24,1.1,74.13,8.3,0,0,0,0,0,0,0.5,122.913040353467,74.620447550678
8.7,"random_instances_SVM","SVM",14,29,912,824,88,3000,2677,323,0.933825477948115,0.61025641025641,1.75929928657201,659,321,338,18,1.1,76.69,8.3,0,0,0,0,0,0,0.462587778261363,111.090757964388,72.4541237080277
8.7,"random_instances_SVM","SVM",14,30,812,738,74,3100,2763,337,0.933036299305446,0.615384615384615,1.76091628959276,678,332,346,19,1,79.24,8.2,0,0,0,0,0,0,0.389118156432046,95.3205859562387,65.6896953684069
8.7,"random_instances_SVM","SVM",14,31,712,646,66,3200,2855,345,0.93265772652483,0.605128205128205,1.76091628959276,705,342,363,27,1.1,81.8,8.3,0,0,0,0,0,0,0.267229898827106,81.4005803478503,62.4720927584244
8.7,"random_instances_SVM","SVM",14,32,612,553,59,3300,2948,352,0.93220635128641,0.61025641025641,1.75929928657201,712,349,363,7,1,84.36,8.4,0,0,0,0,0,0,0.175055613491003,67.6767650305004,54.473219363447
8.7,"random_instances_SVM","SVM",14,33,512,463,49,3400,3038,362,0.933609982673006,0.615384615384615,1.75768525052929,737,360,377,25,1,86.91,8.4,0,0,0,0,0,0,0.10187285795888,54.3209877945451,46.3538360945428
8.7,"random_instances_SVM","SVM",14,34,412,370,42,3500,3131,369,0.933729378703818,0.625641025641026,1.76091628959276,752,366,386,15,1.1,89.47,8.5,0,0,0,0,0,0,0.0657616457154182,43.6128895951699,38.9765445489297
8.7,"random_instances_SVM","SVM",14,35,312,277,35,3600,3224,376,0.932826628226962,0.615384615384615,1.76091628959276,764,372,392,12,1.1,92.02,8.6,0,0,0,0,0,0,0.051105402127672,34.3148830998698,31.5427024840645
8.7,"random_instances_SVM","SVM",14,36,212,185,27,3700,3316,384,0.931919509602632,0.615384615384615,1.76091628959276,778,379,399,14,1.1,94.58,8.6,0,0,0,0,0,0,0.0241295621965601,25.1734821514326,24.5465562895611
8.7,"random_instances_SVM","SVM",14,37,112,99,13,3800,3402,398,0.93324305828564,0.620512820512821,1.76253626778006,801,390,411,23,1.1,97.14,8.5,0,0,0,0,0,0,0.0016956498185033,13.0504616636066,13.0385398624962
8.7,"random_instances_SVM","SVM",14,38,12,11,1,3900,3490,410,0.933385751102944,0.615384615384615,1.76091628959276,816,397,419,15,1.1,99.69,8.5,0,0,0,0,0,0,0.00204454889371372,1.42751125181175,1.42751125181175
8.7,"random_instances_SVM","SVM",14,39,0,0,0,3912,3501,411,0.933457097511597,0.615384615384615,1.75768525052929,821,399,422,5,1.1,100,8.5,0,0,0,0,0,0,0,0,0
8.7,"random_instances_SVM","SVM",15,0,3812,3411,401,100,88,12,0.912040533828636,0.575129533678757,1.76540197225472,29,12,17,0,1.4,2.56,7.3,0,0,0,0,0,0,0.368483395418629,434.906486859486,41.6095247714058
8.7,"random_instances_SVM","SVM",15,1,3712,3327,385,200,172,28,0.916459226647944,0.580310880829015,1.76984913136239,65,28,37,36,1.3,5.11,6.1,0,0,0,0,0,0,0.807578663549793,514.305687442546,84.716790689519
8.7,"random_instances_SVM","SVM",15,2,3612,3235,377,300,264,36,0.925875583011775,0.601036269430052,1.77589960545705,80,36,44,15,1.2,7.67,7.3,0,0,0,0,0,0,0.482036747183596,386.525270564144,54.0131271110861
8.7,"random_instances_SVM","SVM",15,3,3512,3144,368,400,355,45,0.908662224952185,0.585492227979275,1.71395915879305,101,45,56,21,1.2,10.22,7.9,0,0,0,0,0,0,0.579438024300126,340.932886134908,69.2102547810694
8.7,"random_instances_SVM","SVM",15,4,3412,3057,355,500,442,58,0.926103350682878,0.626943005181347,1.76940637106781,128,58,70,27,1.2,12.78,7.6,0,0,0,0,0,0,0.543955663015524,365.176740563858,61.7439340765241
8.7,"random_instances_SVM","SVM",15,5,3312,2966,346,600,533,67,0.925054149926966,0.647668393782383,1.76053413593417,154,67,87,26,1.3,15.34,8,0,0,0,0,0,0,0.550573350091351,350.984844944375,63.9289333474319
8.7,"random_instances_SVM","SVM",15,6,3212,2877,335,700,622,78,0.934638025739229,0.647668393782383,1.78244067214382,169,78,91,15,1.2,17.89,8,0,0,0,0,0,0,0.526012684082483,329.618029567387,62.616683226231
8.7,"random_instances_SVM","SVM",15,7,3112,2781,331,800,718,82,0.934426422225424,0.642487046632124,1.78683680897529,177,82,95,8,1.2,20.45,8.8,0,0,0,0,0,0,0.610605831170093,301.740758421295,72.1349740231131
8.7,"random_instances_SVM","SVM",15,8,3012,2692,320,900,807,93,0.932098783573688,0.61139896373057,1.76822392554847,203,93,110,26,1.2,23.01,8.7,0,0,0,0,0,0,0.618928108845693,303.890204452676,73.8107786150292
8.7,"random_instances_SVM","SVM",15,9,2912,2601,311,1000,898,102,0.932949606035409,0.626943005181347,1.78244067214382,222,102,120,19,1.2,25.56,8.8,0,0,0,0,0,0,0.616404345116852,287.515588815659,72.6049444420083
8.7,"random_instances_SVM","SVM",15,10,2812,2510,302,1100,989,111,0.931569774789207,0.616580310880829,1.78080089231664,242,111,131,20,1.2,28.12,8.9,0,0,0,0,0,0,0.663280094344185,294.090287688962,78.095332558077
8.7,"random_instances_SVM","SVM",15,11,2712,2416,296,1200,1083,117,0.932501418037438,0.606217616580311,1.77753036726188,254,117,137,12,1.2,30.67,9.3,0,0,0,0,0,0,0.672774373840034,283.457767081173,78.6880917550208
8.7,"random_instances_SVM","SVM",15,12,2612,2325,287,1300,1174,126,0.932472028660522,0.616580310880829,1.77916412679061,269,126,143,15,1.1,33.23,9.3,0,0,0,0,0,0,0.698459405408078,271.519845090702,81.2558465944928
8.7,"random_instances_SVM","SVM",15,13,2512,2243,269,1400,1256,144,0.93371519930406,0.632124352331606,1.78408347460662,306,144,162,37,1.1,35.79,8.7,0,0,0,0,0,0,0.695545488146794,269.221777675244,80.8951846052073
8.7,"random_instances_SVM","SVM",15,14,2412,2151,261,1500,1348,152,0.9341207727055,0.642487046632124,1.77916412679061,326,152,174,20,1.1,38.34,8.9,0,0,0,0,0,0,0.524424781856817,245.259735364998,64.628746701588
8.7,"random_instances_SVM","SVM",15,15,2312,2070,242,1600,1429,171,0.936144231306156,0.626943005181347,1.77264704207709,361,171,190,35,1.1,40.9,8.4,0,0,0,0,0,0,0.653027364990901,248.901806807792,77.523898060014
8.7,"random_instances_SVM","SVM",15,16,2212,1976,236,1700,1523,177,0.936471922858768,0.626943005181347,1.77753036726188,372,177,195,11,1.1,43.46,8.6,0,0,0,0,0,0,0.739566447997652,254.652275417435,84.9815729327042
8.7,"random_instances_SVM","SVM",15,17,2112,1886,226,1800,1613,187,0.936269136158049,0.621761658031088,1.78080089231664,393,187,206,21,1.1,46.01,8.6,0,0,0,0,0,0,0.716278496014595,241.882180365983,82.9983806605154
8.7,"random_instances_SVM","SVM",15,18,2012,1795,217,1900,1704,196,0.935278714155987,0.626943005181347,1.78080089231664,410,196,214,17,1.1,48.57,8.7,0,0,0,0,0,0,0.740256514625743,231.28542430419,85.3364852190916
8.7,"random_instances_SVM","SVM",15,19,1912,1706,206,2000,1793,207,0.936852515289828,0.626943005181347,1.78244067214382,435,207,228,25,1.1,51.12,8.7,0,0,0,0,0,0,0.670526020052766,222.655499856733,80.0093259866091
8.7,"random_instances_SVM","SVM",15,20,1812,1616,196,2100,1883,217,0.937978128425705,0.632124352331606,1.78244067214382,457,217,240,22,1.1,53.68,8.7,0,0,0,0,0,0,0.699974640494655,205.993255521771,82.0344934641261
8.7,"random_instances_SVM","SVM",15,21,1712,1526,186,2200,1973,227,0.937834120478817,0.637305699481865,1.78244067214382,470,227,243,13,1.1,56.24,8.7,0,0,0,0,0,0,0.670059211150982,190.233252754515,82.8442699758453
8.7,"random_instances_SVM","SVM",15,22,1612,1435,177,2300,2064,236,0.936327914911884,0.637305699481865,1.78080089231664,491,236,255,21,1.1,58.79,8.7,0,0,0,0,0,0,0.65335637011665,183.928586774976,82.4002298797544
8.7,"random_instances_SVM","SVM",15,23,1512,1349,163,2400,2150,250,0.936589480366432,0.632124352331606,1.78244067214382,524,250,274,33,1.1,61.35,8.6,0,0,0,0,0,0,0.66393034422657,177.134169886064,82.4772674939103
8.7,"random_instances_SVM","SVM",15,24,1412,1261,151,2500,2238,262,0.937371237792393,0.632124352331606,1.78408347460662,549,262,287,25,1.1,63.91,8.5,0,0,0,0,0,0,0.597542509033387,162.686122710594,77.3667098164061
8.7,"random_instances_SVM","SVM",15,25,1312,1173,139,2600,2326,274,0.938292594758703,0.632124352331606,1.79177282225975,567,274,293,18,1.1,66.46,8.5,0,0,0,0,0,0,0.623341337670857,148.124030366059,80.7344079757225
8.7,"random_instances_SVM","SVM",15,26,1212,1077,135,2700,2422,278,0.938182384595269,0.637305699481865,1.79177282225975,572,278,294,5,1.1,69.02,8.7,0,0,0,0,0,0,0.552746787785728,137.443323104892,76.3512667184871
8.7,"random_instances_SVM","SVM",15,27,1112,983,129,2800,2516,284,0.938050132399147,0.637305699481865,1.78683680897529,584,284,300,12,1.1,71.57,8.9,0,0,0,0,0,0,0.510671454973876,124.490759516329,77.166190191169
8.7,"random_instances_SVM","SVM",15,28,1012,895,117,2900,2604,296,0.93759459705695,0.637305699481865,1.79012445719788,611,296,315,27,1.1,74.13,8.8,0,0,0,0,0,0,0.45154605099746,113.524045233019,74.7425324100985
8.7,"random_instances_SVM","SVM",15,29,912,803,109,3000,2696,304,0.937770933318447,0.637305699481865,1.79177282225975,630,304,326,19,1.1,76.69,8.9,0,0,0,0,0,0,0.418207918806988,104.165349822835,72.7222138689986
8.7,"random_instances_SVM","SVM",15,30,812,711,101,3100,2788,312,0.937654845279628,0.632124352331606,1.79177282225975,643,312,331,13,1.1,79.24,8.9,0,0,0,0,0,0,0.359365031604134,94.7803553206908,69.2414365522234
8.7,"random_instances_SVM","SVM",15,31,712,629,83,3200,2870,330,0.937838528885354,0.642487046632124,1.78356121445838,679,329,350,36,1.1,81.8,8.7,0,0,0,0,0,0,0.294281900760565,85.0366694588201,64.5151090039853
8.7,"random_instances_SVM","SVM",15,32,612,543,69,3300,2956,344,0.939131661469647,0.652849740932642,1.79012445719788,707,344,363,28,1.1,84.36,8.6,0,0,0,0,0,0,0.173427052993429,73.0139839669802,58.8015500863775
8.7,"random_instances_SVM","SVM",15,33,512,450,62,3400,3049,351,0.939622464064138,0.647668393782383,1.79342422578257,723,351,372,16,1.1,86.91,8.7,0,0,0,0,0,0,0.150480329564934,64.3879036176021,53.8112576433346
8.7,"random_instances_SVM","SVM",15,34,412,361,51,3500,3138,362,0.940060365780186,0.642487046632124,1.79012445719788,737,361,376,14,1,89.47,8.7,0,0,0,0,0,0,0.108922808992789,51.7239442462012,45.0687052018909
8.7,"random_instances_SVM","SVM",15,35,312,275,37,3600,3224,376,0.939656261847591,0.647668393782383,1.78847912221884,767,371,396,30,1.1,92.02,8.6,0,0,0,0,0,0,0.0558552873405288,37.4668429197007,34.7866658687877
8.7,"random_instances_SVM","SVM",15,36,212,186,26,3700,3313,387,0.938964142021224,0.642487046632124,1.79342422578257,785,382,403,18,1.1,94.58,8.6,0,0,0,0,0,0,0.0201698467762192,24.1905325049648,23.7265219002246
8.7,"random_instances_SVM","SVM",15,37,112,94,18,3800,3405,395,0.939390287986501,0.647668393782383,1.79012445719788,801,392,409,16,1,97.14,8.6,0,0,0,0,0,0,0.000896107817618551,13.1405439829863,13.1356055787306
8.7,"random_instances_SVM","SVM",15,38,12,9,3,3900,3490,410,0.93870698497321,0.642487046632124,1.79177282225975,826,404,422,25,1,99.69,8.5,0,0,0,0,0,0,0.000687296686076986,2.05197140752076,2.05197140752076
8.7,"random_instances_SVM","SVM",15,39,0,0,0,3912,3499,413,0.938617347373616,0.642487046632124,1.78847912221884,831,407,424,5,1,100,8.5,0,0,0,0,0,0,0,0,0
8.7,"random_instances_SVM","SVM",16,0,3812,3417,395,100,93,7,0.897584833019978,0.568627450980392,1.73206831119545,23,7,16,0,2.3,2.56,13.3,0,0,0,0,0,0,0.342362663425692,267.415636606286,40.3163616014308
8.7,"random_instances_SVM","SVM",16,1,3712,3333,379,200,177,23,0.899420270391271,0.583333333333333,1.68584356819651,54,23,31,31,1.3,5.11,7.7,0,0,0,0,0,0,0.742706053859774,459.467077267271,81.0976479483835
8.7,"random_instances_SVM","SVM",16,2,3612,3245,367,300,265,35,0.902927466648772,0.598039215686274,1.70652995143011,76,35,41,22,1.2,7.67,7.6,0,0,0,0,0,0,0.831453882131662,481.474973986964,88.2919172417094
8.7,"random_instances_SVM","SVM",16,3,3512,3157,355,400,353,47,0.904372593786386,0.593137254901961,1.68322880622837,100,47,53,24,1.1,10.22,7.5,0,0,0,0,0,0,0.787085977746996,402.370094930779,85.0122342051745
8.7,"random_instances_SVM","SVM",16,4,3412,3064,348,500,446,54,0.907753883516888,0.612745098039216,1.69204152249135,117,54,63,17,1.2,12.78,8.3,0,0,0,0,0,0,0.686777430865242,368.979448449631,76.4114579384222
8.7,"random_instances_SVM","SVM",16,5,3312,2975,337,600,535,65,0.911775897573651,0.612745098039216,1.71847967128028,138,65,73,21,1.1,15.34,8.2,0,0,0,0,0,0,0.718879487568956,358.923687273663,79.7909377796847
8.7,"random_instances_SVM","SVM",16,6,3212,2884,328,700,626,74,0.912439005282488,0.607843137254902,1.72006060934033,157,74,83,19,1.1,17.89,8.5,0,0,0,0,0,0,0.861167626706108,388.035774684266,91.2006736194731
8.7,"random_instances_SVM","SVM",16,7,3112,2792,320,800,718,82,0.913474236726663,0.617647058823529,1.72729238754325,174,82,92,17,1.1,20.45,8.8,0,0,0,0,0,0,0.811467323226418,351.31581355612,87.7283939127731
8.7,"random_instances_SVM","SVM",16,8,3012,2701,311,900,809,91,0.913647707941633,0.598039215686274,1.7137542459697,191,90,101,17,1.1,23.01,8.9,0,0,0,0,0,0,0.70685403405353,313.917526695746,79.0487563837801
8.7,"random_instances_SVM","SVM",16,9,2912,2609,303,1000,901,99,0.914943146208264,0.607843137254902,1.72888143297798,208,98,110,17,1.1,25.56,9.1,0,0,0,0,0,0,0.755634997350862,322.003419870917,83.3589722678482
8.7,"random_instances_SVM","SVM",16,10,2812,2518,294,1100,992,108,0.914702524845564,0.617647058823529,1.71690163668773,232,108,124,24,1.1,28.12,9.2,0,0,0,0,0,0,0.7573275989336,322.562486950135,85.0936814594591
8.7,"random_instances_SVM","SVM",16,11,2712,2435,277,1200,1075,125,0.922458366908413,0.617647058823529,1.77298555116619,261,124,137,29,1.1,30.67,8.6,0,0,0,0,0,0,0.726627713194911,308.994267810582,83.0743200892379
8.7,"random_instances_SVM","SVM",16,12,2612,2348,264,1300,1162,138,0.924450487957745,0.612745098039216,1.77625372729737,288,137,151,27,1.1,33.23,8.4,0,0,0,0,0,0,0.735791143909253,309.9818311825,83.2444689332599
8.7,"random_instances_SVM","SVM",16,13,2512,2258,254,1400,1252,148,0.924891160802224,0.617647058823529,1.77135596885813,304,147,157,16,1.1,35.79,8.5,0,0,0,0,0,0,0.763527340040984,300.088952100283,85.1861146878262
8.7,"random_instances_SVM","SVM",16,14,2412,2167,245,1500,1343,157,0.927929704987021,0.607843137254902,1.77135596885813,320,156,164,16,1.1,38.34,8.6,0,0,0,0,0,0,0.770586734335333,298.361356700912,86.0445344641413
8.7,"random_instances_SVM","SVM",16,15,2312,2075,237,1600,1435,165,0.927753435849229,0.612745098039216,1.76254325259516,338,165,173,18,1,40.9,8.7,0,0,0,0,0,0,0.795420808157402,285.734968786924,88.0570226179379
8.7,"random_instances_SVM","SVM",16,16,2212,1984,228,1700,1526,174,0.927072141642049,0.617647058823529,1.76416472752855,358,174,184,20,1.1,43.46,8.8,0,0,0,0,0,0,0.738904908371817,269.049588421023,83.8996669283137
8.7,"random_instances_SVM","SVM",16,17,2112,1894,218,1800,1616,184,0.926617479183458,0.607843137254902,1.76254325259516,379,184,195,21,1.1,46.01,8.8,0,0,0,0,0,0,0.750469546420358,260.12085157822,84.7431450263461
8.7,"random_instances_SVM","SVM",16,18,2012,1808,204,1900,1702,198,0.927987062404874,0.612745098039216,1.76972937935505,407,196,211,28,1.1,48.57,8.6,0,0,0,0,0,0,0.727397262350678,238.188804936708,82.761560395007
8.7,"random_instances_SVM","SVM",16,19,1912,1718,194,2000,1792,208,0.926818929626649,0.617647058823529,1.76578918860362,422,206,216,15,1,51.12,8.6,0,0,0,0,0,0,0.656090898858702,218.292689427808,77.4790012728447
8.7,"random_instances_SVM","SVM",16,20,1812,1628,184,2100,1882,218,0.926481779926587,0.617647058823529,1.76416472752855,444,217,227,22,1,53.68,8.6,0,0,0,0,0,0,0.66446455600028,206.416887105814,79.9863730434116
8.7,"random_instances_SVM","SVM",16,21,1712,1535,177,2200,1975,225,0.926997996687264,0.612745098039216,1.77135596885813,458,224,234,14,1,56.24,8.8,0,0,0,0,0,0,0.651193677543254,193.652402651122,79.0388462827003
8.7,"random_instances_SVM","SVM",16,22,1612,1445,167,2300,2065,235,0.927444265377388,0.622549019607843,1.77461813454664,478,233,245,20,1.1,58.79,8.8,0,0,0,0,0,0,0.611741701698378,178.151075766148,75.4590326270848
8.7,"random_instances_SVM","SVM",16,23,1512,1359,153,2400,2151,249,0.929145402453223,0.637254901960784,1.77461813454664,505,245,260,27,1.1,61.35,8.6,0,0,0,0,0,0,0.605874718396969,174.075921656047,75.3301210259745
8.7,"random_instances_SVM","SVM",16,24,1412,1272,140,2500,2238,262,0.929191568179787,0.637254901960784,1.77461813454664,531,258,273,26,1.1,63.91,8.5,0,0,0,0,0,0,0.576503567407789,161.306631801308,74.5294272045145
8.7,"random_instances_SVM","SVM",16,25,1312,1187,125,2600,2323,277,0.927858357955059,0.622549019607843,1.77298555116619,556,272,284,25,1,66.46,8.4,0,0,0,0,0,0,0.571997730028055,150.054696811227,74.754701773994
8.7,"random_instances_SVM","SVM",16,26,1212,1095,117,2700,2415,285,0.92778001611604,0.622549019607843,1.76578918860362,573,279,294,17,1.1,69.02,8.5,0,0,0,0,0,0,0.531176031141258,135.521582094924,71.7722471353896
8.7,"random_instances_SVM","SVM",16,27,1112,1001,111,2800,2509,291,0.928252865072974,0.627450980392157,1.76416472752855,592,287,305,19,1.1,71.57,8.6,0,0,0,0,0,0,0.500713844061296,124.144258700457,70.944118141
8.7,"random_instances_SVM","SVM",16,28,1012,910,102,2900,2600,300,0.928361984063036,0.627450980392157,1.76741664407699,607,295,312,15,1.1,74.13,8.7,0,0,0,0,0,0,0.475674867151582,111.083539300836,67.9140145330558
8.7,"random_instances_SVM","SVM",16,29,912,821,91,3000,2689,311,0.9289271644731,0.627450980392157,1.76578918860362,630,306,324,23,1.1,76.69,8.6,0,0,0,0,0,0,0.394792926964951,96.1841141705735,63.9502104417426
8.7,"random_instances_SVM","SVM",16,30,812,729,83,3100,2781,319,0.928557838660583,0.637254901960784,1.76578918860362,644,313,331,14,1.1,79.24,8.7,0,0,0,0,0,0,0.356890768885662,90.62073692521,62.0164178263886
8.7,"random_instances_SVM","SVM",16,31,712,638,74,3200,2872,328,0.92871452233862,0.637254901960784,1.76092475557716,665,323,342,21,1.1,81.8,8.8,0,0,0,0,0,0,0.293529896038001,83.355776836002,61.0647631437904
8.7,"random_instances_SVM","SVM",16,32,612,546,66,3300,2964,336,0.93050239502194,0.632352941176471,1.76741664407699,684,330,354,19,1.1,84.36,8.8,0,0,0,0,0,0,0.273478837292107,77.4590556528984,59.775236808295
8.7,"random_instances_SVM","SVM",16,33,512,456,56,3400,3054,346,0.930183431820221,0.627450980392157,1.76092475557716,697,340,357,13,1.1,86.91,8.8,0,0,0,0,0,0,0.191673568829158,64.1065809440108,52.8719862512924
8.7,"random_instances_SVM","SVM",16,34,412,372,40,3500,3138,362,0.93008830244427,0.632352941176471,1.76578918860362,724,352,372,27,1.1,89.47,8.7,0,0,0,0,0,0,0.0999462487578612,50.4544252577459,44.4400748611475
8.7,"random_instances_SVM","SVM",16,35,312,282,30,3600,3228,372,0.930605918166358,0.637254901960784,1.77625372729737,740,362,378,16,1,92.02,8.7,0,0,0,0,0,0,0.0604366189344352,38.4379865053142,35.1030434748528
8.7,"random_instances_SVM","SVM",16,36,212,193,19,3700,3317,383,0.931459284627096,0.642156862745098,1.77298555116619,762,374,388,22,1,94.58,8.7,0,0,0,0,0,0,0.0262343420714971,23.834019091206,23.2282522334428
8.7,"random_instances_SVM","SVM",16,37,112,106,6,3800,3404,396,0.931891563703111,0.637254901960784,1.76254325259516,788,384,404,26,1.1,97.14,8.6,0,0,0,0,0,0,0.00152717687007209,13.5101327984209,13.5014424112445
8.7,"random_instances_SVM","SVM",16,38,12,12,0,3900,3498,402,0.931378144865256,0.642156862745098,1.77461813454664,802,392,410,14,1,99.69,8.7,0,0,0,0,0,0,0.000175358235769699,1.08083001153285,1.08083001153285
8.7,"random_instances_SVM","SVM",16,39,0,0,0,3912,3510,402,0.931491460739551,0.647058823529412,1.76810577441986,804,394,410,2,1,100,8.7,0,0,0,0,0,0,0,0,0
8.7,"random_instances_SVM","SVM",17,0,3812,3410,402,100,92,8,0.865674281076056,0.418367346938776,1.72600116403507,33,8,25,0,3.1,2.56,11.5,0,0,0,0,0,0,0.340341623501196,310.881095736015,46.3713393623594
8.7,"random_instances_SVM","SVM",17,1,3712,3326,386,200,176,24,0.922564935064938,0.576530612244898,1.78108630756811,59,24,35,26,1.5,5.11,7.3,0,0,0,0,0,0,0.598172886332927,415.101167605351,67.1297337925137
8.7,"random_instances_SVM","SVM",17,2,3612,3232,380,300,270,30,0.92824965213358,0.61734693877551,1.78436941596915,82,30,52,23,1.7,7.67,9,0,0,0,0,0,0,0.386662536648134,323.821957391497,47.681044174072
8.7,"random_instances_SVM","SVM",17,3,3512,3140,372,400,362,38,0.939540816326526,0.61734693877551,1.79356719646384,95,38,57,13,1.5,10.22,9.5,0,0,0,0,0,0,0.383141112819194,323.027069426614,44.4635424859601
8.7,"random_instances_SVM","SVM",17,4,3412,3053,359,500,449,51,0.940865607606675,0.627551020408163,1.79191566129214,121,51,70,26,1.4,12.78,8.8,0,0,0,0,0,0,0.38790118789315,324.241306623915,45.1010527444733
8.7,"random_instances_SVM","SVM",17,5,3312,2965,347,600,537,63,0.940624999999999,0.612244897959184,1.79026716482361,147,63,84,26,1.3,15.34,8.5,0,0,0,0,0,0,0.635010546491688,327.737582531851,71.7762791367342
8.7,"random_instances_SVM","SVM",17,6,3212,2876,336,700,626,74,0.936501333487938,0.612244897959184,1.79191566129214,168,74,94,21,1.3,17.89,8.5,0,0,0,0,0,0,0.799483177177579,367.596111446095,86.4363722965732
8.7,"random_instances_SVM","SVM",17,7,3112,2790,322,800,712,88,0.933708256029683,0.622448979591837,1.77944927971188,199,88,111,31,1.3,20.45,8.1,0,0,0,0,0,0,0.869078389032451,363.469083876194,92.6262114868672
8.7,"random_instances_SVM","SVM",17,8,3012,2699,313,900,803,97,0.931734114100186,0.627551020408163,1.78436941596915,217,97,120,18,1.2,23.01,8.3,0,0,0,0,0,0,0.692839870016824,327.843508630749,79.2493736836227
8.7,"random_instances_SVM","SVM",17,9,2912,2607,305,1000,895,105,0.931565978664193,0.622448979591837,1.77781525833474,233,105,128,16,1.2,25.56,8.5,0,0,0,0,0,0,0.753533809339708,322.77178331426,84.6307565941073
8.7,"random_instances_SVM","SVM",17,10,2812,2518,294,1100,984,116,0.935059137291279,0.627551020408163,1.76702864632091,257,116,141,24,1.2,28.12,8.5,0,0,0,0,0,0,0.711714691831243,297.147791527004,81.9659337953478
8.7,"random_instances_SVM","SVM",17,11,2712,2425,287,1200,1077,123,0.935746173469386,0.637755102040816,1.78108630756811,278,123,155,21,1.3,30.67,8.8,0,0,0,0,0,0,0.707507130713932,293.106819282347,81.7034594737626
8.7,"random_instances_SVM","SVM",17,12,2612,2333,279,1300,1169,131,0.934914192949905,0.627551020408163,1.77618423516195,288,131,157,10,1.2,33.23,8.9,0,0,0,0,0,0,0.737372000817605,292.320585949848,84.6137094221147
8.7,"random_instances_SVM","SVM",17,13,2512,2245,267,1400,1257,143,0.937489853896101,0.637755102040816,1.77618423516195,313,143,170,25,1.2,35.79,8.8,0,0,0,0,0,0,0.745210421770258,277.761785826131,85.532842366068
8.7,"random_instances_SVM","SVM",17,14,2412,2153,259,1500,1349,151,0.936824559369199,0.637755102040816,1.78108630756811,329,151,178,16,1.2,38.34,8.9,0,0,0,0,0,0,0.746308123366503,268.505639712778,85.54296858106
8.7,"random_instances_SVM","SVM",17,15,2312,2061,251,1600,1441,159,0.937778293135435,0.627551020408163,1.78108630756811,344,159,185,15,1.2,40.9,9.1,0,0,0,0,0,0,0.700475295673063,255.983177260237,82.6631195531352
8.7,"random_instances_SVM","SVM",17,16,2212,1970,242,1700,1532,168,0.935833140074212,0.642857142857143,1.78108630756811,357,168,189,13,1.1,43.46,9.1,0,0,0,0,0,0,0.728411115653271,247.907073116754,84.5932373631805
8.7,"random_instances_SVM","SVM",17,17,2112,1880,232,1800,1622,178,0.93520698051948,0.647959183673469,1.78108630756811,377,178,199,20,1.1,46.01,9.1,0,0,0,0,0,0,0.708340646536984,235.239169658788,83.0922352930505
8.7,"random_instances_SVM","SVM",17,18,2012,1792,220,1900,1710,190,0.937395640074209,0.658163265306122,1.77944927971188,404,190,214,27,1.1,48.57,9,0,0,0,0,0,0,0.740037535959115,225.638637816517,87.1903994717442
8.7,"random_instances_SVM","SVM",17,19,1912,1708,204,2000,1794,206,0.935241767161406,0.658163265306122,1.79356719646384,438,206,232,34,1.1,51.12,8.7,0,0,0,0,0,0,0.720767918090166,217.20979112863,85.3239164092368
8.7,"random_instances_SVM","SVM",17,20,1812,1617,195,2100,1885,215,0.935435992578847,0.668367346938776,1.79026716482361,449,215,234,11,1.1,53.68,8.8,0,0,0,0,0,0,0.724198670756217,208.705697670876,85.656071965269
8.7,"random_instances_SVM","SVM",17,21,1712,1526,186,2200,1976,224,0.935762117346938,0.663265306122449,1.79191566129214,471,224,247,22,1.1,56.24,8.8,0,0,0,0,0,0,0.729028252251434,198.950865323644,87.0440806940527
8.7,"random_instances_SVM","SVM",17,22,1612,1434,178,2300,2068,232,0.936128826530612,0.658163265306122,1.78108630756811,485,232,253,14,1.1,58.79,8.9,0,0,0,0,0,0,0.733569526721087,191.058489547495,88.2466033993635
8.7,"random_instances_SVM","SVM",17,23,1512,1344,168,2400,2158,242,0.936940514842301,0.647959183673469,1.78108630756811,504,242,262,19,1.1,61.35,8.9,0,0,0,0,0,0,0.698499978758273,177.751927496219,86.6957178976719
8.7,"random_instances_SVM","SVM",17,24,1412,1257,155,2500,2245,255,0.936837604359925,0.63265306122449,1.78862169867947,525,255,270,21,1.1,63.91,8.8,0,0,0,0,0,0,0.664108222607357,163.359882670421,84.8688889575974
8.7,"random_instances_SVM","SVM",17,25,1312,1172,140,2600,2330,270,0.937024582560295,0.637755102040816,1.79026716482361,555,270,285,30,1.1,66.46,8.6,0,0,0,0,0,0,0.622234563900073,150.716088537691,81.8819865323122
8.7,"random_instances_SVM","SVM",17,26,1212,1079,133,2700,2423,277,0.936431760204081,0.647959183673469,1.78862169867947,574,277,297,19,1.1,69.02,8.7,0,0,0,0,0,0,0.574322939849454,137.613007487273,78.1196482709803
8.7,"random_instances_SVM","SVM",17,27,1112,991,121,2800,2511,289,0.937508696660482,0.647959183673469,1.79026716482361,592,289,303,18,1,71.57,8.7,0,0,0,0,0,0,0.563826006598412,132.97623366861,77.5975477434551
8.7,"random_instances_SVM","SVM",17,28,1012,903,109,2900,2599,301,0.936807166048237,0.647959183673469,1.7702768607443,617,301,316,25,1,74.13,8.6,0,0,0,0,0,0,0.5,118.006655967918,74.403841749623
8.7,"random_instances_SVM","SVM",17,29,912,814,98,3000,2688,312,0.937588416048239,0.647959183673469,1.7702768607443,644,312,332,27,1.1,76.69,8.6,0,0,0,0,0,0,0.480140101509211,107.966140392748,72.7769989397404
8.7,"random_instances_SVM","SVM",17,30,812,725,87,3100,2777,323,0.937214459647499,0.653061224489796,1.77618423516195,668,323,345,24,1.1,79.24,8.6,0,0,0,0,0,0,0.428325968669069,97.2553481372016,69.0039562475097
8.7,"random_instances_SVM","SVM",17,31,712,637,75,3200,2865,335,0.936695558905384,0.653061224489796,1.77944927971188,686,334,352,18,1.1,81.8,8.6,0,0,0,0,0,0,0.327656906180998,83.665116469972,65.3330614027063
8.7,"random_instances_SVM","SVM",17,32,612,544,68,3300,2958,342,0.936014320500929,0.647959183673469,1.78272635020859,699,341,358,13,1,84.36,8.6,0,0,0,0,0,0,0.206194521932624,74.5635690664365,62.1305414949374
8.7,"random_instances_SVM","SVM",17,33,512,456,56,3400,3046,354,0.937904394712432,0.653061224489796,1.78272635020859,727,353,374,28,1.1,86.91,8.6,0,0,0,0,0,0,0.131321311964593,64.1827317925253,55.4878387772007
8.7,"random_instances_SVM","SVM",17,34,412,366,46,3500,3136,364,0.936137523191096,0.653061224489796,1.78108630756811,746,363,383,19,1.1,89.47,8.6,0,0,0,0,0,0,0.0673071721814599,48.6147862840661,44.3284842273037
8.7,"random_instances_SVM","SVM",17,35,312,282,30,3600,3220,380,0.936520176252321,0.647959183673469,1.78108630756811,781,378,403,35,1.1,92.02,8.5,0,0,0,0,0,0,0.0468560228949192,31.6229996585311,29.8814306825815
8.7,"random_instances_SVM","SVM",17,36,212,191,21,3700,3311,389,0.93661004174397,0.647959183673469,1.78108630756811,791,387,404,10,1,94.58,8.5,0,0,0,0,0,0,0.0156946420679911,21.4996274159109,21.1782463505294
8.7,"random_instances_SVM","SVM",17,37,112,102,10,3800,3400,400,0.936946312615955,0.647959183673469,1.77781525833474,814,398,416,23,1,97.14,8.5,0,0,0,0,0,0,0.000484400470738631,10.2914999041463,10.288273830806
8.7,"random_instances_SVM","SVM",17,38,12,9,3,3900,3493,407,0.93706081864564,0.647959183673469,1.79191566129214,827,403,424,13,1.1,99.69,8.6,0,0,0,0,0,0,0.000111096555225967,2.15271120029658,2.15271120029658
8.7,"random_instances_SVM","SVM",17,39,0,0,0,3912,3502,410,0.937357954545454,0.647959183673469,1.78697925451172,828,406,422,1,1,100,8.5,0,0,0,0,0,0,0,0,0
8.7,"random_instances_SVM","SVM",18,0,3812,3418,394,100,89,11,0.905183484287965,0.577114427860697,1.74985622346981,28,11,17,0,1.5,2.56,8.1,0,0,0,0,0,0,0.6138522508259,407.531231802674,65.8651464313482
8.7,"random_instances_SVM","SVM",18,1,3712,3334,378,200,173,27,0.910413743249557,0.567164179104478,1.75630136609769,56,26,30,28,1.2,5.11,6.4,0,0,0,0,0,0,0.898823426204226,441.970571125917,92.7077610384468
8.7,"random_instances_SVM","SVM",18,2,3612,3242,370,300,265,35,0.913086986718839,0.557213930348259,1.75630136609769,77,35,42,21,1.2,7.67,7.6,0,0,0,0,0,0,0.827704550357329,441.760449061357,86.6300863988779
8.7,"random_instances_SVM","SVM",18,3,3512,3155,357,400,352,48,0.915499425947189,0.557213930348259,1.73933266755134,100,48,52,23,1.1,10.22,7.3,0,0,0,0,0,0,0.779811699986932,407.062476391382,83.3540653462029
8.7,"random_instances_SVM","SVM",18,4,3412,3067,345,500,440,60,0.918583719578741,0.572139303482587,1.78720721461563,127,60,67,27,1.1,12.78,7.3,0,0,0,0,0,0,0.815514319180276,401.68326561698,86.2674542362408
8.7,"random_instances_SVM","SVM",18,5,3312,2974,338,600,533,67,0.920715510765263,0.582089552238806,1.7750112863729,144,67,77,17,1.1,15.34,8,0,0,0,0,0,0,0.786842075567386,387.899450290226,84.0657561351321
8.7,"random_instances_SVM","SVM",18,6,3212,2887,325,700,620,80,0.922449008518664,0.577114427860697,1.77338581816194,171,80,91,27,1.1,17.89,7.8,0,0,0,0,0,0,0.765256248363692,372.759700954274,82.5422433294449
8.7,"random_instances_SVM","SVM",18,7,3112,2795,317,800,712,88,0.922490113534894,0.562189054726368,1.77585803700392,187,88,99,16,1.1,20.45,8.1,0,0,0,0,0,0,0.813540493162134,366.618409427611,87.0409960082368
8.7,"random_instances_SVM","SVM",18,8,3012,2702,310,900,805,95,0.92425762923276,0.572139303482587,1.7677118992195,202,95,107,15,1.1,23.01,8.5,0,0,0,0,0,0,0.81777922034336,352.998208495249,87.6092355590974
8.7,"random_instances_SVM","SVM",18,9,2912,2611,301,1000,896,104,0.926118694277901,0.582089552238806,1.79214425112009,217,104,113,15,1.1,25.56,8.6,0,0,0,0,0,0,0.811672388865799,336.517257590053,86.7994551776266
8.7,"random_instances_SVM","SVM",18,10,2812,2521,291,1100,986,114,0.927008830491424,0.592039800995025,1.78720721461563,241,114,127,24,1.1,28.12,8.6,0,0,0,0,0,0,0.784734828269235,325.900258668449,84.7580850339479
8.7,"random_instances_SVM","SVM",18,11,2712,2433,279,1200,1074,126,0.925996796643577,0.582089552238806,1.77259058891376,264,126,138,23,1.1,30.67,8.5,0,0,0,0,0,0,0.797803285823178,322.123950480618,86.8286069317583
8.7,"random_instances_SVM","SVM",18,12,2612,2340,272,1300,1167,133,0.925129339059703,0.587064676616915,1.77259058891376,279,133,146,15,1.1,33.23,8.8,0,0,0,0,0,0,0.82450174887046,312.441827520516,88.8596046247274
8.7,"random_instances_SVM","SVM",18,13,2512,2252,260,1400,1255,145,0.924352595994381,0.601990049751244,1.76363811119197,302,145,157,23,1.1,35.79,8.7,0,0,0,0,0,0,0.787609200253955,287.535402891656,87.6574416308047
8.7,"random_instances_SVM","SVM",18,14,2412,2165,247,1500,1342,158,0.925580076823865,0.582089552238806,1.77096136962248,327,158,169,25,1.1,38.34,8.5,0,0,0,0,0,0,0.772242441191904,273.357637610473,85.6515657590664
8.7,"random_instances_SVM","SVM",18,15,2312,2077,235,1600,1430,170,0.926291618828944,0.592039800995025,1.77422280860889,346,168,178,19,1.1,40.9,8.4,0,0,0,0,0,0,0.797225408145537,263.14305689405,87.5134352087598
8.7,"random_instances_SVM","SVM",18,16,2212,1987,225,1700,1520,180,0.9260350668311,0.587064676616915,1.77422280860889,369,178,191,23,1.1,43.46,8.4,0,0,0,0,0,0,0.742969424575706,249.469867338501,84.2708693051254
8.7,"random_instances_SVM","SVM",18,17,2112,1893,219,1800,1614,186,0.924134314184074,0.582089552238806,1.77259058891376,386,186,200,17,1.1,46.01,8.7,0,0,0,0,0,0,0.760530621443321,242.218038611031,85.9248415913238
8.7,"random_instances_SVM","SVM",18,18,2012,1803,209,1900,1704,196,0.923723264021774,0.567164179104478,1.77827117854255,404,196,208,18,1.1,48.57,8.7,0,0,0,0,0,0,0.754745790806748,228.698714649,86.1692800545386
8.7,"random_instances_SVM","SVM",18,19,1912,1711,201,2000,1796,204,0.922708395345213,0.572139303482587,1.77259058891376,421,204,217,17,1.1,51.12,8.8,0,0,0,0,0,0,0.731234628797184,214.061760026939,85.9301396531808
8.7,"random_instances_SVM","SVM",18,20,1812,1624,188,2100,1883,217,0.922011027483662,0.582089552238806,1.77585803700392,446,217,229,25,1.1,53.68,8.7,0,0,0,0,0,0,0.704527781687681,195.227260379684,84.5656001412027
8.7,"random_instances_SVM","SVM",18,21,1712,1532,180,2200,1975,225,0.922325693469983,0.587064676616915,1.76933514246947,462,225,237,16,1.1,56.24,8.8,0,0,0,0,0,0,0.688806339842344,183.963780137688,83.8309311527081
8.7,"random_instances_SVM","SVM",18,22,1612,1444,168,2300,2063,237,0.922801944692501,0.592039800995025,1.7677118992195,485,237,248,23,1,58.79,8.7,0,0,0,0,0,0,0.638685557511353,171.456082316409,80.6287023364229
8.7,"random_instances_SVM","SVM",18,23,1512,1349,163,2400,2158,242,0.922979121486595,0.587064676616915,1.76526208735329,498,242,256,13,1.1,61.35,8.9,0,0,0,0,0,0,0.688896023459272,167.319684017322,85.1693533708827
8.7,"random_instances_SVM","SVM",18,24,1412,1263,149,2500,2244,256,0.923959972218692,0.577114427860697,1.75307287093942,527,256,271,29,1.1,63.91,8.8,0,0,0,0,0,0,0.644780610263531,153.58537043577,82.1356306092856
8.7,"random_instances_SVM","SVM",18,25,1312,1170,142,2600,2337,263,0.924448980170389,0.572139303482587,1.76688905701905,537,262,275,10,1,66.46,8.9,0,0,0,0,0,0,0.559528098191871,138.349813552009,76.5829996392833
8.7,"random_instances_SVM","SVM",18,26,1212,1080,132,2700,2427,273,0.925214383920866,0.582089552238806,1.76363811119197,558,272,286,21,1.1,69.02,8.9,0,0,0,0,0,0,0.545681906354127,134.939371021419,77.8453491855938
8.7,"random_instances_SVM","SVM",18,27,1112,992,120,2800,2515,285,0.926008135958401,0.587064676616915,1.76039910639639,576,280,296,18,1.1,71.57,8.8,0,0,0,0,0,0,0.475763070524062,120.251263286167,72.9777031870127
8.7,"random_instances_SVM","SVM",18,28,1012,907,105,2900,2600,300,0.923601366387453,0.572139303482587,1.75146307032331,605,294,311,29,1.1,74.13,8.7,0,0,0,0,0,0,0.430063372351545,106.538983110837,69.248757882577
8.7,"random_instances_SVM","SVM",18,29,912,818,94,3000,2689,311,0.923774290938488,0.577114427860697,1.76201712028095,623,304,319,18,1,76.69,8.6,0,0,0,0,0,0,0.383442137288571,95.6767514064016,67.6771666729383
8.7,"random_instances_SVM","SVM",18,30,812,722,90,3100,2785,315,0.923893353744115,0.582089552238806,1.75792007703418,633,309,324,10,1,79.24,8.8,0,0,0,0,0,0,0.26211339905907,85.2553977303359,62.4868698697429
8.7,"random_instances_SVM","SVM",18,31,712,635,77,3200,2872,328,0.925540389221997,0.587064676616915,1.76526208735329,657,320,337,24,1.1,81.8,8.8,0,0,0,0,0,0,0.201880365195588,75.3566345193898,59.7659564318792
8.7,"random_instances_SVM","SVM",18,32,612,546,66,3300,2961,339,0.924349761165693,0.582089552238806,1.75468563347018,682,333,349,25,1,84.36,8.7,0,0,0,0,0,0,0.122570184353349,61.6455837751777,50.4904266503133
8.7,"random_instances_SVM","SVM",18,33,512,457,55,3400,3050,350,0.924928066221613,0.582089552238806,1.75630136609769,705,344,361,23,1,86.91,8.7,0,0,0,0,0,0,0.0985349760478341,54.519810983153,45.9480099094008
8.7,"random_instances_SVM","SVM",18,34,412,369,43,3500,3138,362,0.92436110048051,0.572139303482587,1.75792007703418,729,357,372,24,1,89.47,8.7,0,0,0,0,0,0,0.0807943822969246,43.7779289388157,38.4760373847667
8.7,"random_instances_SVM","SVM",18,35,312,278,34,3600,3229,371,0.923486555824866,0.577114427860697,1.75630136609769,751,365,386,22,1.1,92.02,8.7,0,0,0,0,0,0,0.0575945305046937,32.8459662218082,30.3320923691644
8.7,"random_instances_SVM","SVM",18,36,212,188,24,3700,3319,381,0.924208019730408,0.592039800995025,1.75468563347018,767,375,392,16,1,94.58,8.7,0,0,0,0,0,0,0.0191475675749868,21.6610309319323,21.1472170775702
8.7,"random_instances_SVM","SVM",18,37,112,98,14,3800,3409,391,0.924704114753865,0.582089552238806,1.75307287093942,787,383,404,20,1.1,97.14,8.7,0,0,0,0,0,0,0.000502729531617831,12.2523790392357,12.2494150344267
8.7,"random_instances_SVM","SVM",18,38,12,11,1,3900,3496,404,0.926056328046384,0.587064676616915,1.75792007703418,809,395,414,22,1,99.69,8.7,0,0,0,0,0,0,0.000368760539436458,0.66113283576934,0.66113283576934
8.7,"random_instances_SVM","SVM",18,39,0,0,0,3912,3507,405,0.926081841504732,0.592039800995025,1.75792007703418,810,397,413,1,1,100,8.7,0,0,0,0,0,0,0,0,0
8.7,"random_instances_SVM","SVM",19,0,3812,3396,416,100,94,6,0.817523800176664,0.451086956521739,1.61660989781607,21,6,15,0,2.5,2.56,15.7,0,0,0,0,0,0,0.163894700627114,253.31235034679,18.7508529398677
8.7,"random_instances_SVM","SVM",19,1,3712,3312,400,200,178,22,0.91586974923939,0.516304347826087,1.76848225703325,53,22,31,32,1.4,5.11,8.1,0,0,0,0,0,0,0.523299863905063,421.242917927414,59.753519569622
8.7,"random_instances_SVM","SVM",19,2,3612,3221,391,300,269,31,0.907820320934335,0.576086956521739,1.77337206972551,79,31,48,26,1.5,7.67,8.7,0,0,0,0,0,0,0.342918450538503,345.750576351365,40.0206971518402
8.7,"random_instances_SVM","SVM",19,3,3512,3131,381,400,359,41,0.912196977132209,0.576086956521739,1.74894101662404,103,41,62,24,1.5,10.22,8.8,0,0,0,0,0,0,0.530358778435391,365.477269510592,64.1269631390441
8.7,"random_instances_SVM","SVM",19,4,3412,3042,370,500,448,52,0.922146432427132,0.570652173913043,1.77825287723785,121,52,69,18,1.3,12.78,8.6,0,0,0,0,0,0,0.5,373.369843849456,61.4629998851956
8.7,"random_instances_SVM","SVM",19,5,3312,2955,357,600,535,65,0.926569094121108,0.565217391304348,1.77988880444782,148,65,83,27,1.3,15.34,8.2,0,0,0,0,0,0,0.699010898063079,379.573387671936,78.5556268053232
8.7,"random_instances_SVM","SVM",19,6,3212,2869,343,700,621,79,0.925152124840525,0.53804347826087,1.78316970546985,170,79,91,22,1.2,17.89,7.9,0,0,0,0,0,0,0.661916240104297,342.279962303844,74.7316756190002
8.7,"random_instances_SVM","SVM",19,7,3112,2776,336,800,714,86,0.926759250171756,0.565217391304348,1.77173913043478,190,86,104,20,1.2,20.45,8.3,0,0,0,0,0,0,0.799383743787007,354.663430488931,86.4969672857112
8.7,"random_instances_SVM","SVM",19,8,3012,2686,326,900,804,96,0.92688193149475,0.559782608695652,1.77173913043478,211,96,115,21,1.2,23.01,8.4,0,0,0,0,0,0,0.794307883602147,341.230574991502,86.3348963445487
8.7,"random_instances_SVM","SVM",19,9,2912,2595,317,1000,895,105,0.92845531946217,0.570652173913043,1.78316970546985,228,105,123,17,1.2,25.56,8.5,0,0,0,0,0,0,0.809198874840057,338.985597002021,88.0865263698632
8.7,"random_instances_SVM","SVM",19,10,2812,2501,311,1100,989,111,0.929967366768093,0.570652173913043,1.77988880444782,241,111,130,13,1.2,28.12,8.9,0,0,0,0,0,0,0.753006125980233,313.857107911601,83.7594005637057
8.7,"random_instances_SVM","SVM",19,11,2712,2412,300,1200,1078,122,0.930997889881264,0.559782608695652,1.78316970546985,264,122,142,23,1.2,30.67,8.8,0,0,0,0,0,0,0.771946204232505,306.099899304113,85.2403964741304
8.7,"random_instances_SVM","SVM",19,12,2612,2323,289,1300,1167,133,0.931316861321045,0.576086956521739,1.78316970546985,286,133,153,22,1.2,33.23,8.8,0,0,0,0,0,0,0.757810381922519,307.557176557916,83.6046469248063
8.7,"random_instances_SVM","SVM",19,13,2512,2233,279,1400,1257,143,0.929702068407115,0.554347826086957,1.78152774441509,306,143,163,20,1.1,35.79,8.8,0,0,0,0,0,0,0.713276210449637,283.673360520602,80.0660162816437
8.7,"random_instances_SVM","SVM",19,14,2412,2141,271,1500,1349,151,0.92799833153402,0.543478260869565,1.77336308930777,318,151,167,12,1.1,38.34,8.9,0,0,0,0,0,0,0.764591476353719,266.469103170922,85.236744579638
8.7,"random_instances_SVM","SVM",19,15,2312,2056,256,1600,1434,166,0.928200755716957,0.576086956521739,1.77825287723785,353,166,187,35,1.1,40.9,8.6,0,0,0,0,0,0,0.74079062365215,255.801736046206,84.0696858605642
8.7,"random_instances_SVM","SVM",19,16,2212,1964,248,1700,1526,174,0.929465906860348,0.576086956521739,1.77825287723785,370,174,196,17,1.1,43.46,8.8,0,0,0,0,0,0,0.660148294800332,238.088816736261,77.8305209431699
8.7,"random_instances_SVM","SVM",19,17,2112,1872,240,1800,1618,182,0.93126472175877,0.565217391304348,1.77661995448557,382,182,200,12,1.1,46.01,8.9,0,0,0,0,0,0,0.76324441997897,242.718433633035,85.4539963011692
8.7,"random_instances_SVM","SVM",19,18,2012,1783,229,1900,1707,193,0.928924575522632,0.554347826086957,1.76848225703325,407,193,214,25,1.1,48.57,8.8,0,0,0,0,0,0,0.745216108159529,230.423294525473,85.7432413927736
8.7,"random_instances_SVM","SVM",19,19,1912,1697,215,2000,1793,207,0.931011691530092,0.565217391304348,1.76848225703325,432,207,225,25,1.1,51.12,8.7,0,0,0,0,0,0,0.713729502094284,215.081865896705,82.2735817115161
8.7,"random_instances_SVM","SVM",19,20,1812,1604,208,2100,1886,214,0.930163656884879,0.570652173913043,1.77010919563217,447,214,233,15,1.1,53.68,8.8,0,0,0,0,0,0,0.73775291033701,203.572380826869,85.5899840135684
8.7,"random_instances_SVM","SVM",19,21,1712,1514,198,2200,1976,224,0.92919447443322,0.570652173913043,1.77010919563217,464,224,240,17,1.1,56.24,8.8,0,0,0,0,0,0,0.684394118255804,191.358935543248,82.1390770599602
8.7,"random_instances_SVM","SVM",19,22,1612,1426,186,2300,2064,236,0.927926256256755,0.570652173913043,1.76848225703325,491,236,255,27,1.1,58.79,8.7,0,0,0,0,0,0,0.694276799518543,186.809635711213,83.4325412025234
8.7,"random_instances_SVM","SVM",19,23,1512,1341,171,2400,2149,251,0.930534767886936,0.592391304347826,1.77010919563217,522,251,271,31,1.1,61.35,8.6,0,0,0,0,0,0,0.727904878305319,182.600538949909,85.259009925783
8.7,"random_instances_SVM","SVM",19,24,1412,1256,156,2500,2234,266,0.931215649229562,0.581521739130435,1.77010919563217,554,266,288,32,1.1,63.91,8.4,0,0,0,0,0,0,0.635107529672791,169.097806259559,82.6024513065398
8.7,"random_instances_SVM","SVM",19,25,1312,1166,146,2600,2324,276,0.93107916625773,0.581521739130435,1.77173913043478,574,276,298,20,1.1,66.46,8.4,0,0,0,0,0,0,0.602059201267217,154.233689200566,80.5827325487553
8.7,"random_instances_SVM","SVM",19,26,1212,1078,134,2700,2412,288,0.928955245853371,0.570652173913043,1.77010919563217,593,288,305,19,1.1,69.02,8.4,0,0,0,0,0,0,0.566479867722433,137.80896877426,78.6154665244632
8.7,"random_instances_SVM","SVM",19,27,1112,993,119,2800,2497,303,0.930436622828542,0.570652173913043,1.77010919563217,627,303,324,34,1.1,71.57,8.2,0,0,0,0,0,0,0.52065867043784,126.523798653411,75.8532057106598
8.7,"random_instances_SVM","SVM",19,28,1012,909,103,2900,2581,319,0.930369148100898,0.576086956521739,1.77337206972551,655,316,339,28,1.1,74.13,8.1,0,0,0,0,0,0,0.457463625476054,110.226076312778,69.4548645068947
8.7,"random_instances_SVM","SVM",19,29,912,821,91,3000,2669,331,0.931091434390034,0.581521739130435,1.77173913043478,671,326,345,16,1.1,76.69,8.1,0,0,0,0,0,0,0.397578923126018,99.6893678017517,66.7112400943481
8.7,"random_instances_SVM","SVM",19,30,812,731,81,3100,2759,341,0.931240185494164,0.581521739130435,1.77337206972551,692,336,356,21,1.1,79.24,8.1,0,0,0,0,0,0,0.311962069760264,88.0763978690294,63.6287286230731
8.7,"random_instances_SVM","SVM",19,31,712,642,70,3200,2848,352,0.93154995583473,0.581521739130435,1.77010919563217,713,345,368,21,1.1,81.8,8.1,0,0,0,0,0,0,0.231630858549663,75.645554178742,58.3313917390067
8.7,"random_instances_SVM","SVM",19,32,612,550,62,3300,2940,360,0.93139967121406,0.58695652173913,1.77337206972551,728,353,375,15,1.1,84.36,8.2,0,0,0,0,0,0,0.191329016799325,68.0475949727304,55.164074496706
8.7,"random_instances_SVM","SVM",19,33,512,459,53,3400,3031,369,0.930660516243015,0.58695652173913,1.77337206972551,744,361,383,16,1.1,86.91,8.2,0,0,0,0,0,0,0.111365178287099,56.475149269018,47.2026758157187
8.7,"random_instances_SVM","SVM",19,34,412,370,42,3500,3120,380,0.931234051428024,0.58695652173913,1.77010919563217,768,373,395,24,1.1,89.47,8.2,0,0,0,0,0,0,0.0799995046773828,44.3978288479438,38.6830604637435
8.7,"random_instances_SVM","SVM",19,35,312,278,34,3600,3212,388,0.930629845912277,0.576086956521739,1.77173913043478,776,379,397,8,1,92.02,8.3,0,0,0,0,0,0,0.0601087968948179,35.0314199598193,32.076145673733
8.7,"random_instances_SVM","SVM",19,36,212,189,23,3700,3301,399,0.930798532731399,0.576086956521739,1.766858306384,788,384,404,12,1.1,94.58,8.3,0,0,0,0,0,0,0.0276422241410701,23.2833099333628,22.4700207789153
8.7,"random_instances_SVM","SVM",19,37,112,102,10,3800,3388,412,0.930648248110727,0.581521739130435,1.76848225703325,805,394,411,17,1,97.14,8.2,0,0,0,0,0,0,0.00194630411154065,10.8384655573042,10.8249109996707
8.7,"random_instances_SVM","SVM",19,38,12,11,1,3900,3479,421,0.930956484934754,0.592391304347826,1.77825287723785,827,404,423,22,1,99.69,8.3,0,0,0,0,0,0,0.0010548089458796,0.516522845826665,0.516522845826665
8.7,"random_instances_SVM","SVM",19,39,0,0,0,3912,3490,422,0.931209515163435,0.58695652173913,1.78152774441509,829,405,424,2,1,100,8.3,0,0,0,0,0,0,0,0,0
8.7,"random_instances_SVM","SVM",20,0,3812,3410,402,100,86,14,0.89801215950409,0.589473684210526,1.72526897353882,32,14,18,0,1.3,2.56,6.1,0,0,0,0,0,0,0.787886458988797,473.946215214795,86.4329500119651
8.7,"random_instances_SVM","SVM",20,1,3712,3326,386,200,170,30,0.920823150742091,0.573684210526316,1.79162547252108,63,30,33,31,1.1,5.11,5.7,0,0,0,0,0,0,0.801273094365021,479.163776056496,84.6603367438572
8.7,"random_instances_SVM","SVM",20,2,3612,3241,371,300,255,45,0.920039339572034,0.589473684210526,1.75209412676125,101,45,56,38,1.2,7.67,5.7,0,0,0,0,0,0,0.786656217376588,509.134336865177,84.1198539260564
8.7,"random_instances_SVM","SVM",20,3,3512,3154,358,400,342,58,0.921899028431796,0.589473684210526,1.76156490582482,124,58,66,23,1.1,10.22,5.9,0,0,0,0,0,0,0.787698556616035,475.294532408842,84.422811960136
8.7,"random_instances_SVM","SVM",20,4,3412,3059,353,500,437,63,0.91658520593672,0.589473684210526,1.73623426117999,141,63,78,17,1.2,12.78,6.9,0,0,0,0,0,0,0.83951793296193,477.625987360009,89.6472681686909
8.7,"random_instances_SVM","SVM",20,5,3312,2968,344,600,528,72,0.905212493294404,0.605263157894737,1.72368178957052,162,72,90,21,1.2,15.34,7.3,0,0,0,0,0,0,0.797241866421809,427.367986936361,86.892186446492
8.7,"random_instances_SVM","SVM",20,6,3212,2880,332,700,616,84,0.907699529117256,0.605263157894737,1.73155959752322,186,84,102,24,1.2,17.89,7.3,0,0,0,0,0,0,0.819343460550588,399.815986628298,88.4933853647381
8.7,"random_instances_SVM","SVM",20,7,3112,2790,322,800,706,94,0.914901353042874,0.605263157894737,1.74422797324804,207,94,113,21,1.2,20.45,7.5,0,0,0,0,0,0,0.814107988144024,390.111941015119,87.8549221420036
8.7,"random_instances_SVM","SVM",20,8,3012,2701,311,900,795,105,0.914728497347572,0.610526315789474,1.74422797324804,228,105,123,21,1.2,23.01,7.6,0,0,0,0,0,0,0.836881436042343,378.92332384714,89.3266728767638
8.7,"random_instances_SVM","SVM",20,9,2912,2610,302,1000,886,114,0.917893544733864,0.615789473684211,1.74422797324804,246,114,132,18,1.2,25.56,7.8,0,0,0,0,0,0,0.808566875418477,341.946834065856,87.5097345978856
8.7,"random_instances_SVM","SVM",20,10,2812,2523,289,1100,973,127,0.918106634082369,0.610526315789474,1.73782713664896,273,127,146,27,1.1,28.12,7.7,0,0,0,0,0,0,0.730008856920325,318.50340210794,82.2676924369955
8.7,"random_instances_SVM","SVM",20,11,2712,2430,282,1200,1066,134,0.918985813911907,0.626315789473684,1.73782713664896,285,134,151,12,1.1,30.67,8,0,0,0,0,0,0,0.706581816211675,306.486446031795,80.9246622221123
8.7,"random_instances_SVM","SVM",20,12,2612,2338,274,1300,1158,142,0.918403171007934,0.631578947368421,1.74262334769767,301,142,159,16,1.1,33.23,8.2,0,0,0,0,0,0,0.800209255863955,305.203008412683,88.2594758020759
8.7,"random_instances_SVM","SVM",20,13,2512,2245,267,1400,1251,149,0.919645943851717,0.621052631578947,1.75209412676125,313,148,165,12,1.1,35.79,8.4,0,0,0,0,0,0,0.809889276125621,290.234769166718,88.7181356985823
8.7,"random_instances_SVM","SVM",20,14,2412,2158,254,1500,1338,162,0.920110866066644,0.615789473684211,1.748876323039,339,161,178,26,1.1,38.34,8.3,0,0,0,0,0,0,0.684939665951747,262.249706046358,79.1370553725727
8.7,"random_instances_SVM","SVM",20,15,2312,2067,245,1600,1429,171,0.922000357632487,0.615789473684211,1.75209412676125,358,171,187,19,1.1,40.9,8.4,0,0,0,0,0,0,0.742071700704986,258.101912432811,85.3939589725146
8.7,"random_instances_SVM","SVM",20,16,2212,1978,234,1700,1518,182,0.921045180902429,0.615789473684211,1.74102167182663,379,182,197,21,1.1,43.46,8.3,0,0,0,0,0,0,0.656689140750068,236.752041049852,79.1182865115296
8.7,"random_instances_SVM","SVM",20,17,2112,1888,224,1800,1608,192,0.919562496274662,0.615789473684211,1.73942293750906,399,192,207,20,1.1,46.01,8.4,0,0,0,0,0,0,0.706998835099837,226.273383652023,85.2389442042619
8.7,"random_instances_SVM","SVM",20,18,2012,1798,214,1900,1698,202,0.921243368897897,0.621052631578947,1.74102167182663,424,202,222,25,1.1,48.57,8.4,0,0,0,0,0,0,0.714240913897162,210.37857246403,85.7265909652035
8.7,"random_instances_SVM","SVM",20,19,1912,1713,199,2000,1783,217,0.92603266376589,0.631578947368421,1.74262334769767,453,217,236,29,1.1,51.12,8.2,0,0,0,0,0,0,0.687439627502818,208.709840866103,83.8718823540575
8.7,"random_instances_SVM","SVM",20,20,1812,1624,188,2100,1872,228,0.927025093878537,0.621052631578947,1.74567031694727,476,228,248,23,1.1,53.68,8.2,0,0,0,0,0,0,0.666128739434011,196.536030846935,82.5399663567409
8.7,"random_instances_SVM","SVM",20,21,1712,1531,181,2200,1965,235,0.926220420814218,0.605263157894737,1.74567031694727,499,235,264,23,1.1,56.24,8.4,0,0,0,0,0,0,0.656150732502381,184.829284113848,82.3061892753343
8.7,"random_instances_SVM","SVM",20,22,1612,1442,170,2300,2054,246,0.92585682779998,0.615789473684211,1.74567031694727,512,246,266,13,1.1,58.79,8.3,0,0,0,0,0,0,0.61806286283399,177.700694609851,79.5552954329134
8.7,"random_instances_SVM","SVM",20,23,1512,1351,161,2400,2145,255,0.927057876855229,0.615789473684211,1.76156490582482,522,255,267,10,1,61.35,8.4,0,0,0,0,0,0,0.662388350430938,171.834802593662,82.6743985893768
8.7,"random_instances_SVM","SVM",20,24,1412,1262,150,2500,2234,266,0.929695416343815,0.626315789473684,1.77103568488839,546,266,280,24,1.1,63.91,8.4,0,0,0,0,0,0,0.621738618500511,158.394044354292,79.3790219914638
8.7,"random_instances_SVM","SVM",20,25,1312,1174,138,2600,2322,278,0.930702747809513,0.610526315789474,1.77103568488839,570,276,294,24,1.1,66.46,8.4,0,0,0,0,0,0,0.601814132437273,145.514532461984,77.5465101340352
8.7,"random_instances_SVM","SVM",20,26,1212,1081,131,2700,2415,285,0.930061989628672,0.610526315789474,1.76778309409888,590,283,307,20,1.1,69.02,8.5,0,0,0,0,0,0,0.593488651584187,135.288418542534,77.2563930539313
8.7,"random_instances_SVM","SVM",20,27,1112,990,122,2800,2506,294,0.930123085176147,0.615789473684211,1.76940789473684,601,292,309,11,1.1,71.57,8.5,0,0,0,0,0,0,0.56514850442619,126.776131924957,76.1901928039478
8.7,"random_instances_SVM","SVM",20,28,1012,900,112,2900,2596,304,0.930117124634925,0.615789473684211,1.77266647281186,623,301,322,22,1.1,74.13,8.5,0,0,0,0,0,0,0.510018272650595,113.447222852459,73.6381062352965
8.7,"random_instances_SVM","SVM",20,29,912,810,102,3000,2686,314,0.929449544018608,0.615789473684211,1.7661612747465,644,312,332,21,1.1,76.69,8.6,0,0,0,0,0,0,0.427424138448964,98.7857107916318,69.5046090123947
8.7,"random_instances_SVM","SVM",20,30,812,719,93,3100,2777,323,0.929813137032852,0.621052631578947,1.76940789473684,663,319,344,19,1.1,79.24,8.6,0,0,0,0,0,0,0.315629523364035,87.4636046714781,66.2029763351411
8.7,"random_instances_SVM","SVM",20,31,712,625,87,3200,2871,329,0.930465816296131,0.615789473684211,1.7661612747465,671,325,346,8,1.1,81.8,8.7,0,0,0,0,0,0,0.227313281417322,77.634613639183,60.8161513524776
8.7,"random_instances_SVM","SVM",20,32,612,535,77,3300,2961,339,0.930410681289873,0.621052631578947,1.77103568488839,689,333,356,18,1.1,84.36,8.7,0,0,0,0,0,0,0.154464244951492,67.1852825527555,55.1535445009178
8.7,"random_instances_SVM","SVM",20,33,512,445,67,3400,3051,349,0.930589497526389,0.626315789473684,1.77103568488839,707,343,364,18,1.1,86.91,8.7,0,0,0,0,0,0,0.113608317452773,58.5059764394885,50.3713219496166
8.7,"random_instances_SVM","SVM",20,34,412,356,56,3500,3140,360,0.932200333790319,0.626315789473684,1.77266647281186,732,356,376,25,1.1,89.47,8.7,0,0,0,0,0,0,0.0846695792646582,48.4034736193199,42.8083342800341
8.7,"random_instances_SVM","SVM",20,35,312,270,42,3600,3226,374,0.932091553913102,0.621052631578947,1.76778309409888,754,367,387,22,1.1,92.02,8.6,0,0,0,0,0,0,0.0619065528237261,35.4051745743928,32.7484848529902
8.7,"random_instances_SVM","SVM",20,36,212,181,31,3700,3315,385,0.933265780532882,0.626315789473684,1.77266647281186,769,376,393,15,1,94.58,8.6,0,0,0,0,0,0,0.0266547042249397,26.4316557561205,25.7688335918722
8.7,"random_instances_SVM","SVM",20,37,112,94,18,3800,3402,398,0.93367556774155,0.626315789473684,1.76940789473684,791,388,403,22,1,97.14,8.5,0,0,0,0,0,0,0.00159185555469576,13.4991922048322,13.4899196622202
8.7,"random_instances_SVM","SVM",20,38,12,9,3,3900,3487,413,0.93274721344698,0.621052631578947,1.77103568488839,821,403,418,30,1,99.69,8.4,0,0,0,0,0,0,0.00106451069210257,2.47709564335505,2.47709564335505
8.7,"random_instances_SVM","SVM",20,39,0,0,0,3912,3496,416,0.932890266436191,0.621052631578947,1.77103568488839,824,404,420,3,1,100,8.4,0,0,0,0,0,0,0,0,0
8.7,"random_instances_SVM","SVM",21,0,3812,3418,394,100,87,13,0.88999636772365,0.517587939698492,1.7302920130607,30,13,17,0,1.3,2.56,6.7,0,0,0,0,0,0,0.392420183688337,426.693800661515,42.8765365072936
8.7,"random_instances_SVM","SVM",21,1,3712,3334,378,200,171,29,0.913803508149739,0.5678391959799,1.73879479892588,65,29,36,35,1.2,5.11,5.9,0,0,0,0,0,0,0.72627442596966,483.602400899464,77.7718004846076
8.7,"random_instances_SVM","SVM",21,2,3612,3243,369,300,262,38,0.918514027164839,0.577889447236181,1.7345551285841,89,38,51,24,1.3,7.67,6.9,0,0,0,0,0,0,0.573200339466808,408.356263275126,63.1604445636634
8.7,"random_instances_SVM","SVM",21,3,3512,3156,356,400,349,51,0.928060907840286,0.587939698492462,1.76582269735478,113,51,62,24,1.2,10.22,6.8,0,0,0,0,0,0,0.644620130060992,412.841177898153,70.0048978928616
8.7,"random_instances_SVM","SVM",21,4,3412,3063,349,500,442,58,0.918905855401082,0.577889447236181,1.74358926987881,129,58,71,16,1.2,12.78,7.6,0,0,0,0,0,0,0.568691588436085,390.744269202595,63.7303037920505
8.7,"random_instances_SVM","SVM",21,5,3312,2972,340,600,533,67,0.918499726864239,0.582914572864322,1.76652849500961,152,67,85,23,1.3,15.34,8,0,0,0,0,0,0,0.553512118063337,352.184904744387,64.8539978913304
8.7,"random_instances_SVM","SVM",21,6,3212,2883,329,700,622,78,0.924124035087204,0.603015075376884,1.76490185735306,176,78,98,24,1.3,17.89,8,0,0,0,0,0,0,0.60823738171342,354.626959096134,70.6714498874865
8.7,"random_instances_SVM","SVM",21,7,3112,2793,319,800,712,88,0.933274797436224,0.623115577889447,1.77232066496235,192,88,104,16,1.2,20.45,8.1,0,0,0,0,0,0,0.798119277378913,376.142967510673,85.9195078332202
8.7,"random_instances_SVM","SVM",21,8,3012,2702,310,900,803,97,0.934804929599607,0.633165829145729,1.76327821259009,216,97,119,24,1.2,23.01,8.3,0,0,0,0,0,0,0.747359504502837,354.425030095993,81.8210472063321
8.7,"random_instances_SVM","SVM",21,9,2912,2607,305,1000,898,102,0.933309118157647,0.64321608040201,1.75681339787849,224,102,122,8,1.2,25.56,8.8,0,0,0,0,0,0,0.737858298820881,331.828271723852,82.0308452984731
8.7,"random_instances_SVM","SVM",21,10,2812,2515,297,1100,990,110,0.933916880932824,0.633165829145729,1.76744271817805,247,110,137,23,1.2,28.12,9,0,0,0,0,0,0,0.688108255447221,307.473223787253,78.6704478053228
8.7,"random_instances_SVM","SVM",21,11,2712,2426,286,1200,1079,121,0.933469281524284,0.618090452261307,1.77069169376293,267,121,146,20,1.2,30.67,8.9,0,0,0,0,0,0,0.566258938659392,271.565048718526,66.5965548965796
8.7,"random_instances_SVM","SVM",21,12,2612,2339,273,1300,1166,134,0.931327096495558,0.597989949748744,1.76906571424616,293,134,159,26,1.2,33.23,8.7,0,0,0,0,0,0,0.712691203355166,288.481332430773,80.3268845678567
8.7,"random_instances_SVM","SVM",21,13,2512,2256,256,1400,1249,151,0.931304216014612,0.618090452261307,1.77069169376293,317,151,166,24,1.1,35.79,8.3,0,0,0,0,0,0,0.731141166098536,276.484464484121,81.8960167355006
8.7,"random_instances_SVM","SVM",21,14,2412,2164,248,1500,1341,159,0.931275615413422,0.623115577889447,1.76582269735478,329,159,170,12,1.1,38.34,8.4,0,0,0,0,0,0,0.70791784257298,267.941585336734,80.0945003439917
8.7,"random_instances_SVM","SVM",21,15,2312,2070,242,1600,1435,165,0.931741805212735,0.633165829145729,1.76906571424616,350,165,185,21,1.1,40.9,8.7,0,0,0,0,0,0,0.722616005459587,258.757613052904,82.4115260942062
8.7,"random_instances_SVM","SVM",21,16,2212,1977,235,1700,1528,172,0.932073572186478,0.633165829145729,1.76003986876531,366,172,194,16,1.1,43.46,8.9,0,0,0,0,0,0,0.738215417248917,259.889593117215,84.4327165974999
8.7,"random_instances_SVM","SVM",21,17,2112,1885,227,1800,1620,180,0.930983889281339,0.64321608040201,1.75423576021783,384,180,204,18,1.1,46.01,9,0,0,0,0,0,0,0.749209290675935,245.263724136546,85.5751381671293
8.7,"random_instances_SVM","SVM",21,18,2012,1795,217,1900,1710,190,0.931071121114952,0.64321608040201,1.76165755246822,400,190,210,16,1.1,48.57,9,0,0,0,0,0,0,0.702728249670037,224.80162685048,81.2486699192547
8.7,"random_instances_SVM","SVM",21,19,1912,1708,204,2000,1797,203,0.931999210623398,0.648241206030151,1.76582269735478,434,203,231,34,1.1,51.12,8.9,0,0,0,0,0,0,0.67906389236134,216.147498633054,79.3491655921983
8.7,"random_instances_SVM","SVM",21,20,1812,1622,190,2100,1883,217,0.931644563168713,0.638190954773869,1.76652849500961,449,217,232,15,1.1,53.68,8.7,0,0,0,0,0,0,0.696201070995029,201.304952668949,81.9506680607771
8.7,"random_instances_SVM","SVM",21,21,1712,1531,181,2200,1974,226,0.932010650863878,0.638190954773869,1.76165755246822,474,226,248,25,1.1,56.24,8.7,0,0,0,0,0,0,0.635986009533553,178.892305200975,79.4989362840981
8.7,"random_instances_SVM","SVM",21,22,1612,1441,171,2300,2064,236,0.930118721095516,0.648241206030151,1.76490185735306,492,236,256,18,1.1,58.79,8.7,0,0,0,0,0,0,0.578107577431041,165.156833670219,75.6708850107373
8.7,"random_instances_SVM","SVM",21,23,1512,1357,155,2400,2148,252,0.932348137957858,0.658291457286432,1.76906571424616,520,252,268,28,1.1,61.35,8.5,0,0,0,0,0,0,0.594866912597815,158.839680122185,78.9100827202213
8.7,"random_instances_SVM","SVM",21,24,1412,1270,142,2500,2235,265,0.932822907937522,0.653266331658292,1.77395263610872,545,265,280,25,1.1,63.91,8.4,0,0,0,0,0,0,0.554026895561929,146.692455527968,77.1836337610916
8.7,"random_instances_SVM","SVM",21,25,1312,1181,131,2600,2324,276,0.932589813037867,0.633165829145729,1.77069169376293,567,276,291,22,1.1,66.46,8.4,0,0,0,0,0,0,0.516925309112809,137.069327923361,75.0256249363455
8.7,"random_instances_SVM","SVM",21,26,1212,1092,120,2700,2413,287,0.932708505532785,0.633165829145729,1.76003986876531,590,287,303,23,1.1,69.02,8.4,0,0,0,0,0,0,0.533170791766742,129.99416528099,76.9457955068975
8.7,"random_instances_SVM","SVM",21,27,1112,999,113,2800,2506,294,0.933146094730911,0.633165829145729,1.76652849500961,606,294,312,16,1.1,71.57,8.5,0,0,0,0,0,0,0.48978387717671,121.546358326543,74.2063651514297
8.7,"random_instances_SVM","SVM",21,28,1012,912,100,2900,2593,307,0.932276636454898,0.633165829145729,1.76165755246822,633,307,326,27,1.1,74.13,8.4,0,0,0,0,0,0,0.420287538446489,107.5256097973,70.7305271591811
8.7,"random_instances_SVM","SVM",21,29,912,823,89,3000,2682,318,0.931861927737719,0.628140703517588,1.76652849500961,653,318,335,20,1.1,76.69,8.4,0,0,0,0,0,0,0.354929389867246,92.1434466385932,65.1501436835229
8.7,"random_instances_SVM","SVM",21,30,812,731,81,3100,2774,326,0.931809016625527,0.638190954773869,1.76490185735306,665,325,340,12,1,79.24,8.5,0,0,0,0,0,0,0.298042233437453,83.7542734203572,61.9109332162166
8.7,"random_instances_SVM","SVM",21,31,712,639,73,3200,2866,334,0.931810446655583,0.638190954773869,1.76490185735306,680,332,348,15,1,81.8,8.6,0,0,0,0,0,0,0.188524294130795,70.6097288202155,55.3553751986121
8.7,"random_instances_SVM","SVM",21,32,612,548,64,3300,2957,343,0.931851917527302,0.638190954773869,1.75842515328938,697,341,356,17,1,84.36,8.6,0,0,0,0,0,0,0.151949966463384,61.8977732536373,50.6223976619669
8.7,"random_instances_SVM","SVM",21,33,512,460,52,3400,3045,355,0.933000231664865,0.633165829145729,1.76327821259009,719,352,367,22,1,86.91,8.6,0,0,0,0,0,0,0.110653935713955,52.5000084348638,44.8122575104718
8.7,"random_instances_SVM","SVM",21,34,412,369,43,3500,3136,364,0.932332407627205,0.628140703517588,1.76165755246822,739,361,378,20,1,89.47,8.6,0,0,0,0,0,0,0.0846113778412856,43.0783476677568,38.0388214559062
8.7,"random_instances_SVM","SVM",21,35,312,284,28,3600,3221,379,0.933686646093298,0.648241206030151,1.76490185735306,767,374,393,28,1.1,92.02,8.5,0,0,0,0,0,0,0.0556846397562743,32.2199812096813,30.2464906292662
8.7,"random_instances_SVM","SVM",21,36,212,190,22,3700,3315,385,0.933616574620396,0.648241206030151,1.75842515328938,783,382,401,16,1,94.58,8.6,0,0,0,0,0,0,0.0152294346642469,22.5909306258539,22.251646264254
8.7,"random_instances_SVM","SVM",21,37,112,101,11,3800,3404,396,0.933683786033181,0.64321608040201,1.76327821259009,799,391,408,16,1,97.14,8.6,0,0,0,0,0,0,0.00072155651227343,11.1450749757741,11.1419080357595
8.7,"random_instances_SVM","SVM",21,38,12,10,2,3900,3495,405,0.934331589650011,0.638190954773869,1.76744271817805,820,400,420,21,1.1,99.69,8.6,0,0,0,0,0,0,0.000124572381226059,1.95231033092908,1.95231033092908
8.7,"random_instances_SVM","SVM",21,39,0,0,0,3912,3505,407,0.934350180040781,0.628140703517588,1.76744271817805,822,401,421,2,1,100,8.6,0,0,0,0,0,0,0,0,0
8.7,"random_instances_SVM","SVM",22,0,3812,3413,399,100,92,8,0.845322228673242,0.412060301507538,1.65781904916286,31,8,23,0,2.9,2.56,11.5,0,0,0,0,0,0,0.171624429982717,328.657608016088,20.2736806113329
8.7,"random_instances_SVM","SVM",22,1,3712,3329,383,200,176,24,0.863083202008903,0.472361809045226,1.66687816965009,66,24,42,35,1.8,5.11,7.3,0,0,0,0,0,0,0.391137987559322,425.845401895734,53.3159614795911
8.7,"random_instances_SVM","SVM",22,2,3612,3238,374,300,267,33,0.878118538051661,0.532663316582915,1.68938442211055,82,33,49,16,1.5,7.67,8.1,0,0,0,0,0,0,0.45507132731914,397.67391618745,57.9709585437204
8.7,"random_instances_SVM","SVM",22,3,3512,3149,363,400,356,44,0.901460918708491,0.532663316582915,1.75585107859741,99,44,55,17,1.2,10.22,8.1,0,0,0,0,0,0,0.548634487007684,403.986836672259,67.9006643419498
8.7,"random_instances_SVM","SVM",22,4,3412,3060,352,500,445,55,0.913457440875401,0.57286432160804,1.74841025403515,130,55,75,31,1.4,12.78,8.1,0,0,0,0,0,0,0.299170211838498,335.675609916429,40.4301333864164
8.7,"random_instances_SVM","SVM",22,5,3312,2971,341,600,534,66,0.916241709400716,0.57286432160804,1.77395263610872,149,66,83,19,1.3,15.34,8.1,0,0,0,0,0,0,0.290040328708645,303.502102802658,37.8004464904872
8.7,"random_instances_SVM","SVM",22,6,3212,2881,331,700,624,76,0.915829860743673,0.542713567839196,1.78300341486438,168,76,92,19,1.2,17.89,8.2,0,0,0,0,0,0,0.607535946942889,340.381987799191,72.1399372734802
8.7,"random_instances_SVM","SVM",22,7,3112,2790,322,800,715,85,0.918902995340954,0.557788944723618,1.77809155972701,193,85,108,25,1.3,20.45,8.4,0,0,0,0,0,0,0.689016248905869,330.422913879515,80.3162107487155
8.7,"random_instances_SVM","SVM",22,8,3012,2695,317,900,810,90,0.922689714937806,0.587939698492462,1.7813631173346,203,90,113,10,1.3,23.01,9,0,0,0,0,0,0,0.669499397474622,303.675359938985,78.6968877877005
8.7,"random_instances_SVM","SVM",22,9,2912,2604,308,1000,901,99,0.921997580389132,0.587939698492462,1.75585107859741,222,99,123,19,1.2,25.56,9.1,0,0,0,0,0,0,0.66766574062463,287.936650745093,78.6852479883253
8.7,"random_instances_SVM","SVM",22,10,2812,2513,299,1100,992,108,0.92168869389633,0.582914572864322,1.76906571424616,235,108,127,13,1.2,28.12,9.2,0,0,0,0,0,0,0.695445392287259,284.465876826568,79.8709566019568
8.7,"random_instances_SVM","SVM",22,11,2712,2422,290,1200,1083,117,0.919590839799434,0.57286432160804,1.76165755246822,256,117,139,21,1.2,30.67,9.3,0,0,0,0,0,0,0.73912583460359,284.828818246465,84.5473832084217
8.7,"random_instances_SVM","SVM",22,12,2612,2330,282,1300,1175,125,0.922146303515287,0.577889447236181,1.77232066496235,272,125,147,16,1.2,33.23,9.4,0,0,0,0,0,0,0.725279564239049,276.139176699902,83.3259439083824
8.7,"random_instances_SVM","SVM",22,13,2512,2241,271,1400,1264,136,0.922479500519089,0.5678391959799,1.77395263610872,294,136,158,22,1.2,35.79,9.3,0,0,0,0,0,0,0.763740467861512,267.06255478373,86.4788001503491
8.7,"random_instances_SVM","SVM",22,14,2412,2150,262,1500,1355,145,0.92085641640185,0.577889447236181,1.77232066496235,314,145,169,20,1.2,38.34,9.3,0,0,0,0,0,0,0.723281967815883,250.219140679864,83.1336329258957
8.7,"random_instances_SVM","SVM",22,15,2312,2056,256,1600,1449,151,0.922286446461082,0.587939698492462,1.77069169376293,327,151,176,13,1.2,40.9,9.6,0,0,0,0,0,0,0.725241125679339,238.110485283315,83.515682856136
8.7,"random_instances_SVM","SVM",22,16,2212,1962,250,1700,1543,157,0.920590430810833,0.587939698492462,1.77395263610872,341,157,184,14,1.2,43.46,9.8,0,0,0,0,0,0,0.749523597377008,237.702171381881,85.6572957806367
8.7,"random_instances_SVM","SVM",22,17,2112,1871,241,1800,1634,166,0.921312595990746,0.582914572864322,1.77395263610872,353,166,187,12,1.1,46.01,9.8,0,0,0,0,0,0,0.691121314854823,219.513314482693,81.9422048182653
8.7,"random_instances_SVM","SVM",22,18,2012,1782,230,1900,1723,177,0.924028223073231,0.603015075376884,1.76744271817805,374,177,197,21,1.1,48.57,9.7,0,0,0,0,0,0,0.707312644184303,215.401414467208,83.8768219125022
8.7,"random_instances_SVM","SVM",22,19,1912,1696,216,2000,1809,191,0.926071736027881,0.608040201005025,1.77395263610872,405,191,214,31,1.1,51.12,9.5,0,0,0,0,0,0,0.682874366266029,205.46387855791,82.7506318926418
8.7,"random_instances_SVM","SVM",22,20,1812,1604,208,2100,1901,199,0.927205749864865,0.603015075376884,1.77232066496235,418,199,219,13,1.1,53.68,9.6,0,0,0,0,0,0,0.664472029513835,199.666484205346,81.012964315316
8.7,"random_instances_SVM","SVM",22,21,1712,1515,197,2200,1990,210,0.924900541409385,0.597989949748744,1.76906571424616,442,210,232,24,1.1,56.24,9.5,0,0,0,0,0,0,0.614429662170087,183.670122770288,77.2959817211523
8.7,"random_instances_SVM","SVM",22,22,1612,1432,180,2300,2073,227,0.923433330568613,0.592964824120603,1.76420564360263,475,227,248,33,1.1,58.79,9.1,0,0,0,0,0,0,0.655947223622336,177.556408912044,81.8297521603842
8.7,"random_instances_SVM","SVM",22,23,1512,1340,172,2400,2165,235,0.92545253301225,0.597989949748744,1.77232066496235,490,235,255,15,1.1,61.35,9.2,0,0,0,0,0,0,0.652166108344783,167.589316704755,82.1288755618952
8.7,"random_instances_SVM","SVM",22,24,1412,1249,163,2500,2256,244,0.92606172581748,0.608040201005025,1.76906571424616,510,244,266,20,1.1,63.91,9.2,0,0,0,0,0,0,0.621430652311985,158.208464953166,80.7846879134649
8.7,"random_instances_SVM","SVM",22,25,1312,1162,150,2600,2343,257,0.9267309798852,0.608040201005025,1.77558761549684,538,257,281,28,1.1,66.46,9.1,0,0,0,0,0,0,0.586493522927576,147.769377847783,80.9868456584072
8.7,"random_instances_SVM","SVM",22,26,1212,1071,141,2700,2434,266,0.927305851969013,0.608040201005025,1.77069169376293,554,266,288,16,1.1,69.02,9.2,0,0,0,0,0,0,0.525166245609444,133.482528092213,75.4308935499999
8.7,"random_instances_SVM","SVM",22,27,1112,981,131,2800,2524,276,0.928638639984212,0.628140703517588,1.76906571424616,576,276,300,22,1.1,71.57,9.1,0,0,0,0,0,0,0.524946723059497,126.891132648823,75.3924080705376
8.7,"random_instances_SVM","SVM",22,28,1012,893,119,2900,2612,288,0.929033328280559,0.628140703517588,1.76906571424616,596,288,308,20,1.1,74.13,9.1,0,0,0,0,0,0,0.434676589525548,112.970869650847,74.496939493368
8.7,"random_instances_SVM","SVM",22,29,912,802,110,3000,2703,297,0.929262133090034,0.623115577889447,1.77232066496235,617,297,320,21,1.1,76.69,9.1,0,0,0,0,0,0,0.393521132422518,104.171205193614,72.978812924332
8.7,"random_instances_SVM","SVM",22,30,812,712,100,3100,2793,307,0.929396555915603,0.633165829145729,1.76906571424616,637,307,330,20,1.1,79.24,9.1,0,0,0,0,0,0,0.340145225236062,92.2325336366995,68.681310232943
8.7,"random_instances_SVM","SVM",22,31,712,623,89,3200,2882,318,0.930437617798727,0.618090452261307,1.77232066496235,658,318,340,21,1.1,81.8,9.1,0,0,0,0,0,0,0.263679129430102,80.7154980819585,64.4257225179679
8.7,"random_instances_SVM","SVM",22,32,612,534,78,3300,2971,329,0.931282765563735,0.633165829145729,1.77069169376293,681,329,352,23,1.1,84.36,9,0,0,0,0,0,0,0.204404600533809,72.610611960184,60.6569876088827
8.7,"random_instances_SVM","SVM",22,33,512,448,64,3400,3057,343,0.930933838229282,0.623115577889447,1.76744271817805,701,340,361,20,1.1,86.91,8.9,0,0,0,0,0,0,0.120272620547543,57.924375666156,49.6374235033357
8.7,"random_instances_SVM","SVM",22,34,412,360,52,3500,3145,355,0.931272755353317,0.623115577889447,1.77558761549684,731,353,378,30,1.1,89.47,8.9,0,0,0,0,0,0,0.0790100791667859,49.797256932483,44.9788708333886
8.7,"random_instances_SVM","SVM",22,35,312,276,36,3600,3229,371,0.930123011185692,0.618090452261307,1.77232066496235,762,368,394,31,1.1,92.02,8.7,0,0,0,0,0,0,0.0559611189241115,37.4592506564925,35.2866419873399
8.7,"random_instances_SVM","SVM",22,36,212,186,26,3700,3319,381,0.93028031449221,0.618090452261307,1.76582269735478,779,375,404,17,1.1,94.58,8.7,0,0,0,0,0,0,0.0214326121003807,27.8947784682195,27.3996704074077
8.7,"random_instances_SVM","SVM",22,37,112,101,11,3800,3404,396,0.930849466455782,0.618090452261307,1.77232066496235,799,389,410,20,1.1,97.14,8.6,0,0,0,0,0,0,0.000669759958099626,12.2697467543053,12.2650625756632
8.7,"random_instances_SVM","SVM",22,38,12,11,1,3900,3494,406,0.930998189581939,0.628140703517588,1.77232066496235,817,397,420,18,1.1,99.69,8.6,0,0,0,0,0,0,0.000579280353078987,1.06519992897942,1.06519992897942
8.7,"random_instances_SVM","SVM",22,39,0,0,0,3912,3505,407,0.9309610088004,0.628140703517588,1.77232066496235,817,397,420,0,1.1,100,8.6,0,0,0,0,0,0,0,0,0
8.7,"random_instances_SVM","SVM",23,0,3812,3427,385,100,84,16,0.897494114861201,0.585365853658537,1.75394548063128,32,15,17,0,1.1,2.56,5.2,0,0,0,0,0,0,0.957209950854811,501.075429093022,96.9466611522504
8.7,"random_instances_SVM","SVM",23,1,3712,3343,369,200,168,32,0.907328216628832,0.604878048780488,1.77311463639015,58,27,31,26,1.1,5.11,5.2,0,0,0,0,0,0,0.896121809330741,510.126095628418,92.2689103375413
8.7,"random_instances_SVM","SVM",23,2,3612,3252,360,300,259,41,0.914356952821388,0.604878048780488,1.75879509947173,76,36,40,18,1.1,7.67,6.3,0,0,0,0,0,0,0.849305746056516,425.702781696489,87.9887365244513
8.7,"random_instances_SVM","SVM",23,3,3512,3157,355,400,354,46,0.911142065161372,0.604878048780488,1.74517575322812,98,46,52,22,1.1,10.22,7.7,0,0,0,0,0,0,0.892067596499916,450.82790708221,91.9416274764931
8.7,"random_instances_SVM","SVM",23,4,3412,3070,342,500,441,59,0.911045952835315,0.590243902439024,1.76271520803443,118,56,62,20,1.1,12.78,7.5,0,0,0,0,0,0,0.789682449799396,362.618940252294,83.7532698067998
8.7,"random_instances_SVM","SVM",23,5,3312,2978,334,600,533,67,0.912489030658437,0.595121951219512,1.75394548063128,138,67,71,20,1.1,15.34,8,0,0,0,0,0,0,0.823875539615152,394.377471454662,87.0697479195298
8.7,"random_instances_SVM","SVM",23,6,3212,2884,328,700,627,73,0.913284394979871,0.609756097560976,1.75233487872069,153,73,80,15,1.1,17.89,8.6,0,0,0,0,0,0,0.826694754660752,359.972943893494,87.7715596322486
8.7,"random_instances_SVM","SVM",23,7,3112,2792,320,800,719,81,0.914539426947668,0.595121951219512,1.75948086820318,169,81,88,16,1.1,20.45,8.9,0,0,0,0,0,0,0.830458298253844,347.383458515432,88.2280081360333
8.7,"random_instances_SVM","SVM",23,8,3012,2704,308,900,807,93,0.914434957028043,0.604878048780488,1.75786814513425,190,91,99,21,1.1,23.01,8.7,0,0,0,0,0,0,0.781211459917523,321.303903048512,84.2381078722801
8.7,"random_instances_SVM","SVM",23,9,2912,2613,299,1000,898,102,0.918051009179426,0.614634146341463,1.75786814513425,212,102,110,22,1.1,25.56,8.8,0,0,0,0,0,0,0.803428048213597,320.254877422564,87.3186812845458
8.7,"random_instances_SVM","SVM",23,10,2812,2525,287,1100,986,114,0.91738240169381,0.6,1.75786814513425,239,114,125,27,1.1,28.12,8.6,0,0,0,0,0,0,0.75538435881568,302.012880817093,82.6348677748682
8.7,"random_instances_SVM","SVM",23,11,2712,2433,279,1200,1078,122,0.918571965845303,0.6,1.76758907496909,254,122,132,15,1.1,30.67,8.8,0,0,0,0,0,0,0.771183026068407,302.816116133261,84.3503318476821
8.7,"random_instances_SVM","SVM",23,12,2612,2346,266,1300,1165,135,0.917496622139267,0.614634146341463,1.75233487872069,273,132,141,19,1.1,33.23,8.6,0,0,0,0,0,0,0.757899024157943,289.66135892475,84.0062749307002
8.7,"random_instances_SVM","SVM",23,13,2512,2256,256,1400,1255,145,0.918786477413605,0.609756097560976,1.75948086820318,291,141,150,18,1.1,35.79,8.7,0,0,0,0,0,0,0.729461636158262,274.011837697477,82.3530154241078
8.7,"random_instances_SVM","SVM",23,14,2412,2170,242,1500,1341,159,0.918714044935996,0.609756097560976,1.75948086820318,315,154,161,24,1,38.34,8.4,0,0,0,0,0,0,0.721357020144598,258.336588709502,81.8593132343143
8.7,"random_instances_SVM","SVM",23,15,2312,2075,237,1600,1436,164,0.919414689863633,0.619512195121951,1.75394548063128,330,160,170,15,1.1,40.9,8.8,0,0,0,0,0,0,0.70100100100298,239.581404345877,80.7490438103629
8.7,"random_instances_SVM","SVM",23,16,2212,1986,226,1700,1525,175,0.920460781992173,0.614634146341463,1.75717558280555,351,171,180,21,1.1,43.46,8.7,0,0,0,0,0,0,0.670028753298691,222.690847425419,79.275163972423
8.7,"random_instances_SVM","SVM",23,17,2112,1894,218,1800,1617,183,0.921713028095444,0.614634146341463,1.75394548063128,366,179,187,15,1,46.01,8.8,0,0,0,0,0,0,0.677733472921507,217.794863407795,79.7973053330577
8.7,"random_instances_SVM","SVM",23,18,2012,1807,205,1900,1704,196,0.922352384003567,0.619512195121951,1.76109655311429,392,193,199,26,1,48.57,8.7,0,0,0,0,0,0,0.645665504391434,198.991667696646,78.1572484590002
8.7,"random_instances_SVM","SVM",23,19,1912,1714,198,2000,1797,203,0.922734047443275,0.619512195121951,1.75948086820318,406,197,209,14,1.1,51.12,8.9,0,0,0,0,0,0,0.656145430299308,191.654893172545,78.1815023420939
8.7,"random_instances_SVM","SVM",23,20,1812,1626,186,2100,1885,215,0.924848518616541,0.624390243902439,1.77373358348968,427,209,218,21,1,53.68,8.8,0,0,0,0,0,0,0.621459929546063,180.129914338658,76.9314230198086
8.7,"random_instances_SVM","SVM",23,21,1712,1529,183,2200,1982,218,0.924586647351342,0.609756097560976,1.77311463639015,440,214,226,13,1.1,56.24,9.1,0,0,0,0,0,0,0.615566188938682,169.627787138904,77.3991665496765
8.7,"random_instances_SVM","SVM",23,22,1612,1440,172,2300,2071,229,0.92612165870374,0.604878048780488,1.754651552005,460,225,235,20,1,58.79,9,0,0,0,0,0,0,0.590595580866139,159.335666190734,76.2130306311822
8.7,"random_instances_SVM","SVM",23,23,1512,1353,159,2400,2158,242,0.92598375840983,0.609756097560976,1.76271520803443,486,237,249,26,1.1,61.35,8.9,0,0,0,0,0,0,0.569993083466336,151.612775613639,75.3436279504638
8.7,"random_instances_SVM","SVM",23,24,1412,1269,143,2500,2242,258,0.93163209873104,0.619512195121951,1.77474733863361,521,253,268,35,1.1,63.91,8.7,0,0,0,0,0,0,0.574723034714208,146.902054365374,75.9010670555157
8.7,"random_instances_SVM","SVM",23,25,1312,1187,125,2600,2324,276,0.931375799194884,0.619512195121951,1.76823450436339,551,268,283,30,1.1,66.46,8.4,0,0,0,0,0,0,0.506638890567747,129.278021527056,70.2595217567798
8.7,"random_instances_SVM","SVM",23,26,1212,1098,114,2700,2413,287,0.932217130280953,0.629268292682927,1.76985822750789,573,279,294,22,1.1,69.02,8.4,0,0,0,0,0,0,0.471578124532667,118.901098105927,68.8946865105917
8.7,"random_instances_SVM","SVM",23,27,1112,1007,105,2800,2504,296,0.931952473151229,0.614634146341463,1.76823450436339,586,286,300,13,1,71.57,8.5,0,0,0,0,0,0,0.44036782079324,112.106128678138,68.3420441475539
8.7,"random_instances_SVM","SVM",23,28,1012,916,96,2900,2595,305,0.931885612402666,0.624390243902439,1.76823450436339,602,294,308,16,1,74.13,8.5,0,0,0,0,0,0,0.413891107340444,99.4237164811724,64.2340027362486
8.7,"random_instances_SVM","SVM",23,29,912,819,93,3000,2692,308,0.931275508072044,0.619512195121951,1.76661375779661,611,299,312,9,1,76.69,8.7,0,0,0,0,0,0,0.356237158919224,88.1110848218662,60.3801005980662
8.7,"random_instances_SVM","SVM",23,30,812,729,83,3100,2782,318,0.93019459263696,0.614634146341463,1.76985822750789,624,307,317,13,1,79.24,8.7,0,0,0,0,0,0,0.293898528811436,79.2026212014352,58.2661502122009
8.7,"random_instances_SVM","SVM",23,31,712,642,70,3200,2869,331,0.930861807190315,0.609756097560976,1.76271520803443,649,318,331,25,1,81.8,8.7,0,0,0,0,0,0,0.226929481207461,69.6326975921632,54.3809597796873
8.7,"random_instances_SVM","SVM",23,32,612,550,62,3300,2961,339,0.93041606886657,0.614634146341463,1.77148493543759,671,327,344,22,1.1,84.36,8.7,0,0,0,0,0,0,0.176072964326242,59.639287478108,49.6214433801035
8.7,"random_instances_SVM","SVM",23,33,512,455,57,3400,3056,344,0.929514841693249,0.614634146341463,1.77311463639015,686,336,350,15,1,86.91,8.9,0,0,0,0,0,0,0.114312818335578,50.7440118742997,44.7306779163883
8.7,"random_instances_SVM","SVM",23,34,412,361,51,3500,3150,350,0.928436712122691,0.619512195121951,1.7643368411605,702,343,359,16,1,89.47,9,0,0,0,0,0,0,0.0627557720949411,42.970383601316,38.4676620299775
8.7,"random_instances_SVM","SVM",23,35,312,276,36,3600,3235,365,0.928259809725455,0.614634146341463,1.77474733863361,726,357,369,24,1,92.02,8.9,0,0,0,0,0,0,0.0539547955156981,33.4592013534715,31.1604991351148
8.7,"random_instances_SVM","SVM",23,36,212,189,23,3700,3322,378,0.929282222005543,0.619512195121951,1.77474733863361,749,368,381,23,1,94.58,8.8,0,0,0,0,0,0,0.0146434125912111,22.0016779413868,21.616314176467
8.7,"random_instances_SVM","SVM",23,37,112,98,14,3800,3413,387,0.929694529955009,0.624390243902439,1.76823450436339,770,378,392,21,1,97.14,8.8,0,0,0,0,0,0,0.00100660526566719,13.526817648199,13.5206818132355
8.7,"random_instances_SVM","SVM",23,38,12,10,2,3900,3501,399,0.92781267846945,0.624390243902439,1.77311463639015,794,389,405,24,1,99.69,8.8,0,0,0,0,0,0,0.000400876444695289,0.737680266161341,0.737680266161341
8.7,"random_instances_SVM","SVM",23,39,0,0,0,3912,3511,401,0.928738978423482,0.624390243902439,1.77474733863361,798,391,407,4,1,100,8.8,0,0,0,0,0,0,0,0,0
8.7,"random_instances_SVM","SVM",24,0,3812,3436,376,100,86,14,0.886230842911903,0.560185185185185,1.71544221817446,31,14,17,0,1.2,2.56,6.1,0,0,0,0,0,0,0.525731502636804,485.66316279636,56.9019325893044
8.7,"random_instances_SVM","SVM",24,1,3712,3351,361,200,171,29,0.887587803320562,0.583333333333333,1.69791666666667,59,28,31,28,1.1,5.11,5.9,0,0,0,0,0,0,0.818886718438523,453.038348731573,86.0152764452909
8.7,"random_instances_SVM","SVM",24,2,3612,3262,350,300,260,40,0.896164591315459,0.569444444444444,1.7427358297524,78,38,40,19,1.1,7.67,6.5,0,0,0,0,0,0,0.822382376159604,423.065881244711,86.9477558193068
8.7,"random_instances_SVM","SVM",24,3,3512,3176,336,400,346,54,0.896620902511709,0.564814814814815,1.71500457456542,102,49,53,24,1.1,10.22,6.4,0,0,0,0,0,0,0.819458425406199,409.411221771799,86.2013401614995
8.7,"random_instances_SVM","SVM",24,4,3412,3082,330,500,440,60,0.902546296296299,0.583333333333333,1.72961942658912,123,59,64,21,1.1,12.78,7.3,0,0,0,0,0,0,0.774552617767007,391.449845329047,82.9232910192707
8.7,"random_instances_SVM","SVM",24,5,3312,2993,319,600,529,71,0.906702320136234,0.574074074074074,1.73316035816036,148,71,77,25,1.1,15.34,7.5,0,0,0,0,0,0,0.825085890998327,424.430736608073,87.2924129389886
8.7,"random_instances_SVM","SVM",24,6,3212,2905,307,700,617,83,0.903722328650507,0.587962962962963,1.7312091503268,168,82,86,20,1,17.89,7.4,0,0,0,0,0,0,0.789879268919353,381.12390323635,84.5678002855461
8.7,"random_instances_SVM","SVM",24,7,3112,2817,295,800,705,95,0.905861536824192,0.592592592592593,1.74113257691915,198,95,103,30,1.1,20.45,7.4,0,0,0,0,0,0,0.80284064193159,350.400957314777,86.543697449128
8.7,"random_instances_SVM","SVM",24,8,3012,2723,289,900,799,101,0.909446839080459,0.587962962962963,1.75295616717635,209,101,108,11,1.1,23.01,7.9,0,0,0,0,0,0,0.822441674146214,352.535357305025,87.6263379030287
8.7,"random_instances_SVM","SVM",24,9,2912,2627,285,1000,895,105,0.909315134099625,0.583333333333333,1.75779413267914,221,105,116,12,1.1,25.56,8.5,0,0,0,0,0,0,0.780975463757082,328.164026212284,84.796832563155
8.7,"random_instances_SVM","SVM",24,10,2812,2534,278,1100,988,112,0.910900915283098,0.587962962962963,1.7610343061956,235,112,123,14,1.1,28.12,8.8,0,0,0,0,0,0,0.795552312069593,315.01473039067,85.5011832361487
8.7,"random_instances_SVM","SVM",24,11,2712,2443,269,1200,1079,121,0.916235632183907,0.606481481481482,1.76612491055913,254,121,133,19,1.1,30.67,8.9,0,0,0,0,0,0,0.743754963719044,297.926280137363,83.2208220948288
8.7,"random_instances_SVM","SVM",24,12,2612,2351,261,1300,1171,129,0.915945615155387,0.606481481481482,1.76612491055913,271,129,142,17,1.1,33.23,9.1,0,0,0,0,0,0,0.742624170062957,279.866540845205,82.6484594593963
8.7,"random_instances_SVM","SVM",24,13,2512,2263,249,1400,1259,141,0.914833439761603,0.597222222222222,1.74946335479914,292,141,151,21,1.1,35.79,8.9,0,0,0,0,0,0,0.734125660806802,266.746728217366,82.0254507267924
8.7,"random_instances_SVM","SVM",24,14,2412,2174,238,1500,1348,152,0.91132130693912,0.606481481481482,1.75779413267914,316,152,164,24,1.1,38.34,8.9,0,0,0,0,0,0,0.66274508398324,240.748250450761,78.4412837976274
8.7,"random_instances_SVM","SVM",24,15,2312,2084,228,1600,1438,162,0.913030810983393,0.606481481481482,1.76775117659096,335,162,173,19,1.1,40.9,8.9,0,0,0,0,0,0,0.654045947475254,233.06488744146,78.2888036227832
8.7,"random_instances_SVM","SVM",24,16,2212,1992,220,1700,1530,170,0.913705300127711,0.611111111111111,1.76612491055913,356,170,186,21,1.1,43.46,9,0,0,0,0,0,0,0.676665346786964,225.985752932278,80.1493389273238
8.7,"random_instances_SVM","SVM",24,17,2112,1904,208,1800,1618,182,0.913625478927205,0.601851851851852,1.76471485208905,376,182,194,20,1.1,46.01,8.9,0,0,0,0,0,0,0.651448906152848,221.374058174563,77.953626737194
8.7,"random_instances_SVM","SVM",24,18,2012,1814,198,1900,1708,192,0.915644955300125,0.611111111111111,1.76612491055913,399,192,207,23,1.1,48.57,8.9,0,0,0,0,0,0,0.721337464210326,220.59858115567,85.730037123496
8.7,"random_instances_SVM","SVM",24,19,1912,1723,189,2000,1799,201,0.916089293316304,0.611111111111111,1.76288133863891,415,201,214,16,1.1,51.12,9,0,0,0,0,0,0,0.607136546039332,191.17384274372,78.103176295418
8.7,"random_instances_SVM","SVM",24,20,1812,1637,175,2100,1885,215,0.91616379310345,0.606481481481482,1.76126401630989,443,215,228,28,1.1,53.68,8.8,0,0,0,0,0,0,0.663203057860339,197.009566195846,82.7764524089424
8.7,"random_instances_SVM","SVM",24,21,1712,1547,165,2200,1975,225,0.916248935717327,0.611111111111111,1.76126401630989,463,224,239,20,1.1,56.24,8.8,0,0,0,0,0,0,0.612932079490976,179.651982830859,76.5616492922374
8.7,"random_instances_SVM","SVM",24,22,1612,1457,155,2300,2065,235,0.917374414644529,0.62037037037037,1.76450163398693,479,233,246,16,1.1,58.79,8.8,0,0,0,0,0,0,0.616345248000217,169.980639995267,78.8403912393475
8.7,"random_instances_SVM","SVM",24,23,1512,1364,148,2400,2158,242,0.9200311302682,0.625,1.76126401630989,492,242,250,13,1,61.35,8.9,0,0,0,0,0,0,0.577430827960726,159.513208957885,76.4427762790583
8.7,"random_instances_SVM","SVM",24,24,1412,1274,138,2500,2248,252,0.921538420604512,0.625,1.76288133863891,516,252,264,24,1,63.91,8.9,0,0,0,0,0,0,0.582901870387586,149.570880692069,76.5892955337618
8.7,"random_instances_SVM","SVM",24,25,1312,1181,131,2600,2341,259,0.921334876543209,0.625,1.76450163398693,523,257,266,7,1,66.46,9,0,0,0,0,0,0,0.55704553708376,142.19651897135,74.9784124887203
8.7,"random_instances_SVM","SVM",24,26,1212,1092,120,2700,2430,270,0.921388090676883,0.625,1.76126401630989,552,270,282,29,1,69.02,9,0,0,0,0,0,0,0.518642296060726,129.618740732575,73.4150796873187
8.7,"random_instances_SVM","SVM",24,27,1112,999,113,2800,2523,277,0.920975681140911,0.625,1.76450163398693,568,277,291,16,1.1,71.57,9.1,0,0,0,0,0,0,0.47514921026019,119.444206563935,71.413183386488
8.7,"random_instances_SVM","SVM",24,28,1012,908,104,2900,2614,286,0.920717592592591,0.62037037037037,1.76775117659096,588,286,302,20,1.1,74.13,9.1,0,0,0,0,0,0,0.440862042072381,106.564564811489,69.7143422189329
8.7,"random_instances_SVM","SVM",24,29,912,815,97,3000,2707,293,0.920140219242231,0.62037037037037,1.77282475490196,605,293,312,17,1.1,76.69,9.2,0,0,0,0,0,0,0.388659134582642,95.6330135580295,66.1641830498016
8.7,"random_instances_SVM","SVM",24,30,812,724,88,3100,2798,302,0.919558854831841,0.62037037037037,1.76450163398693,616,302,314,11,1,79.24,9.3,0,0,0,0,0,0,0.340201362757786,88.0655017436786,63.5014706357306
8.7,"random_instances_SVM","SVM",24,31,712,637,75,3200,2885,315,0.919098552575562,0.62037037037037,1.76450163398693,637,313,324,21,1,81.8,9.2,0,0,0,0,0,0,0.226468981969616,71.6683374980489,55.3961103335552
8.7,"random_instances_SVM","SVM",24,32,612,547,65,3300,2975,325,0.920615155385266,0.62962962962963,1.76612491055913,656,321,335,19,1,84.36,9.2,0,0,0,0,0,0,0.149465600487688,60.2148061286049,48.9539332670708
8.7,"random_instances_SVM","SVM",24,33,512,459,53,3400,3063,337,0.921188537675605,0.62037037037037,1.76126401630989,682,333,349,26,1,86.91,9.1,0,0,0,0,0,0,0.0926279097231299,49.1351455900882,42.4906026872543
8.7,"random_instances_SVM","SVM",24,34,412,370,42,3500,3152,348,0.920519369944657,0.625,1.76612491055913,707,344,363,25,1.1,89.47,9.1,0,0,0,0,0,0,0.0641724618694281,37.5441371058009,33.4555827571339
8.7,"random_instances_SVM","SVM",24,35,312,284,28,3600,3238,362,0.920145540655598,0.62037037037037,1.76450163398693,728,357,371,21,1,92.02,8.9,0,0,0,0,0,0,0.0374197160672392,27.5806783981444,25.6691112646929
8.7,"random_instances_SVM","SVM",24,36,212,194,18,3700,3328,372,0.919260855683274,0.62037037037037,1.75964965882473,746,367,379,18,1,94.58,8.9,0,0,0,0,0,0,0.0166020792876761,18.3572195938782,17.9229184224703
8.7,"random_instances_SVM","SVM",24,37,112,102,10,3800,3420,380,0.920282567049807,0.615740740740741,1.76612491055913,759,373,386,13,1,97.14,9,0,0,0,0,0,0,0.0008448120737581,8.89529784428451,8.89043747800347
8.7,"random_instances_SVM","SVM",24,38,12,10,2,3900,3512,388,0.920060398041719,0.611111111111111,1.76450163398693,774,378,396,15,1,99.69,9.1,0,0,0,0,0,0,0.000144248092183339,1.2663653788775,1.2663653788775
8.7,"random_instances_SVM","SVM",24,39,0,0,0,3912,3522,390,0.920204076202638,0.611111111111111,1.76450163398693,776,379,397,2,1,100,9,0,0,0,0,0,0,0,0,0
8.7,"random_instances_SVM","SVM",25,0,3812,3411,401,100,88,12,0.873513999629693,0.481865284974093,1.69067596284711,34,12,22,0,1.8,2.56,7.3,0,0,0,0,0,0,0.229091724399752,438.617826080053,26.4656192305619
8.7,"random_instances_SVM","SVM",25,1,3712,3327,385,200,172,28,0.913811243787826,0.585492227979275,1.73870799068308,63,28,35,29,1.2,5.11,6.1,0,0,0,0,0,0,0.694953239678696,518.832842525404,74.6110703686356
8.7,"random_instances_SVM","SVM",25,2,3612,3242,370,300,257,43,0.918153524227132,0.601036269430052,1.74030460040823,98,43,55,35,1.3,7.67,6,0,0,0,0,0,0,0.629939974552953,476.127766181657,69.6132264828445
8.7,"random_instances_SVM","SVM",25,3,3512,3157,355,400,342,58,0.932067924727937,0.616580310880829,1.76984913136239,124,58,66,26,1.1,10.22,5.9,0,0,0,0,0,0,0.689926217073421,448.122829104297,74.0615523321755
8.7,"random_instances_SVM","SVM",25,4,3412,3066,346,500,433,67,0.933659359487909,0.658031088082902,1.75569307048247,147,67,80,23,1.2,12.78,6.5,0,0,0,0,0,0,0.648140435116659,448.794947494803,71.9632759927836
8.7,"random_instances_SVM","SVM",25,5,3312,2976,336,600,523,77,0.924773481377417,0.642487046632124,1.7264477714482,170,77,93,23,1.2,15.34,6.8,0,0,0,0,0,0,0.781632715199519,446.537820662805,85.0234734627459
8.7,"random_instances_SVM","SVM",25,6,3212,2887,325,700,612,88,0.923885922194579,0.642487046632124,1.74511207168007,187,88,99,17,1.1,17.89,7,0,0,0,0,0,0,0.807801904963081,429.041956150183,87.2261258752115
8.7,"random_instances_SVM","SVM",25,7,3112,2794,318,800,705,95,0.928232611040411,0.642487046632124,1.73870799068308,207,95,112,20,1.2,20.45,7.4,0,0,0,0,0,0,0.766627971799745,420.816312178845,83.7366386793438
8.7,"random_instances_SVM","SVM",25,8,3012,2700,312,900,799,101,0.939161050846572,0.658031088082902,1.77753036726188,216,101,115,9,1.1,23.01,7.9,0,0,0,0,0,0,0.795853388712348,394.851619230767,86.5480724138611
8.7,"random_instances_SVM","SVM",25,9,2912,2605,307,1000,894,106,0.937390340887394,0.652849740932642,1.77589960545705,231,106,125,15,1.2,25.56,8.4,0,0,0,0,0,0,0.63281105018353,353.353503405396,72.8911697812709
8.7,"random_instances_SVM","SVM",25,10,2812,2515,297,1100,984,116,0.937288947537035,0.652849740932642,1.77753036726188,250,116,134,19,1.2,28.12,8.5,0,0,0,0,0,0,0.633538550939081,329.599894634277,73.6309017169728
8.7,"random_instances_SVM","SVM",25,11,2712,2426,286,1200,1073,127,0.937606352807716,0.658031088082902,1.77427183313308,274,127,147,24,1.2,30.67,8.4,0,0,0,0,0,0,0.669233852931122,329.632087954274,76.1287643498833
8.7,"random_instances_SVM","SVM",25,12,2612,2339,273,1300,1160,140,0.938724618599354,0.652849740932642,1.77916412679061,299,140,159,25,1.1,33.23,8.3,0,0,0,0,0,0,0.642406731469821,308.269411699923,74.0347901186855
8.7,"random_instances_SVM","SVM",25,13,2512,2255,257,1400,1244,156,0.936366121101857,0.647668393782383,1.77916412679061,330,156,174,31,1.1,35.79,8,0,0,0,0,0,0,0.782778536843757,333.262146452725,86.9002748305111
8.7,"random_instances_SVM","SVM",25,14,2412,2166,246,1500,1333,167,0.936421960917995,0.652849740932642,1.77753036726188,355,167,188,25,1.1,38.34,8,0,0,0,0,0,0,0.745455584422034,314.296486424411,83.9015068512573
8.7,"random_instances_SVM","SVM",25,15,2312,2071,241,1600,1428,172,0.935818009222375,0.647668393782383,1.77916412679061,374,172,202,19,1.2,40.9,8.3,0,0,0,0,0,0,0.76968087083154,303.903044003563,86.2545528295421
8.7,"random_instances_SVM","SVM",25,16,2212,1980,232,1700,1519,181,0.935142053553311,0.642487046632124,1.78244067214382,385,181,204,11,1.1,43.46,8.4,0,0,0,0,0,0,0.774827287867445,288.819648377032,87.0540181709076
8.7,"random_instances_SVM","SVM",25,17,2112,1890,222,1800,1609,191,0.934502834605394,0.642487046632124,1.76822392554847,408,191,217,23,1.1,46.01,8.4,0,0,0,0,0,0,0.7589860203796,269.707058282521,85.6390114393204
8.7,"random_instances_SVM","SVM",25,18,2012,1804,208,1900,1695,205,0.935751883124316,0.637305699481865,1.77916412679061,422,205,217,14,1.1,48.57,8.3,0,0,0,0,0,0,0.736682776140677,254.924733382942,83.6741520663132
8.7,"random_instances_SVM","SVM",25,19,1912,1713,199,2000,1786,214,0.936809900693286,0.632124352331606,1.77753036726188,439,212,227,17,1.1,51.12,8.3,0,0,0,0,0,0,0.720231689935953,241.256656570083,83.1170938738362
8.7,"random_instances_SVM","SVM",25,20,1812,1625,187,2100,1874,226,0.935381576975177,0.632124352331606,1.7714773274354,458,224,234,19,1,53.68,8.3,0,0,0,0,0,0,0.649062822109566,219.930122282428,78.7364470298084
8.7,"random_instances_SVM","SVM",25,21,1712,1540,172,2200,1959,241,0.935607875177431,0.642487046632124,1.7714773274354,492,239,253,34,1.1,56.24,8.1,0,0,0,0,0,0,0.635477114117773,199.343103962853,77.2968417438651
8.7,"random_instances_SVM","SVM",25,22,1612,1448,164,2300,2051,249,0.935625508803583,0.647668393782383,1.76822392554847,503,247,256,11,1,58.79,8.2,0,0,0,0,0,0,0.651226634567428,196.387372236475,79.1943182193253
8.7,"random_instances_SVM","SVM",25,23,1512,1366,146,2400,2133,267,0.938238224411392,0.652849740932642,1.78080089231664,541,263,278,38,1.1,61.35,8,0,0,0,0,0,0,0.631866149860438,181.464827618515,77.7019282141433
8.7,"random_instances_SVM","SVM",25,24,1412,1279,133,2500,2220,280,0.937785628006895,0.652849740932642,1.77753036726188,564,275,289,23,1.1,63.91,7.9,0,0,0,0,0,0,0.625231968602507,170.755181090304,76.8468809467458
8.7,"random_instances_SVM","SVM",25,25,1312,1189,123,2600,2310,290,0.936192723778062,0.647668393782383,1.77264704207709,588,286,302,24,1.1,66.46,8,0,0,0,0,0,0,0.592388115272165,152.97422596069,74.8183055472225
8.7,"random_instances_SVM","SVM",25,26,1212,1098,114,2700,2401,299,0.936871618384822,0.652849740932642,1.78080089231664,604,296,308,16,1,69.02,8,0,0,0,0,0,0,0.561275854119063,139.556111463645,73.6251361590631
8.7,"random_instances_SVM","SVM",25,27,1112,1003,109,2800,2496,304,0.936921580325562,0.663212435233161,1.77916412679061,624,302,322,20,1.1,71.57,8.2,0,0,0,0,0,0,0.534561269987453,131.857014670937,71.7034630347033
8.7,"random_instances_SVM","SVM",25,28,1012,913,99,2900,2586,314,0.936260319344957,0.658031088082902,1.77589960545705,638,311,327,14,1.1,74.13,8.2,0,0,0,0,0,0,0.512732341135715,118.977538357918,71.0341296801085
8.7,"random_instances_SVM","SVM",25,29,912,819,93,3000,2680,320,0.936233868905734,0.658031088082902,1.77916412679061,655,317,338,17,1.1,76.69,8.4,0,0,0,0,0,0,0.486151881143931,108.741007367709,69.1560584469701
8.7,"random_instances_SVM","SVM",25,30,812,734,78,3100,2765,335,0.936867209978269,0.652849740932642,1.77916412679061,676,329,347,21,1.1,79.24,8.3,0,0,0,0,0,0,0.434568931899141,97.514332047628,67.8214462835595
8.7,"random_instances_SVM","SVM",25,31,712,644,68,3200,2855,345,0.935615222521654,0.652849740932642,1.77916412679061,697,340,357,21,1.1,81.8,8.3,0,0,0,0,0,0,0.270992054393468,80.2120552247772,59.9767208565674
8.7,"random_instances_SVM","SVM",25,32,612,555,57,3300,2944,356,0.934831995626844,0.647668393782383,1.76660170176356,715,349,366,18,1,84.36,8.3,0,0,0,0,0,0,0.189211941525046,68.3843870044082,54.1140846648841
8.7,"random_instances_SVM","SVM",25,33,512,462,50,3400,3037,363,0.934987759324497,0.647668393782383,1.76822392554847,733,358,375,18,1,86.91,8.4,0,0,0,0,0,0,0.130450883032529,55.3206230712097,46.1402065247996
8.7,"random_instances_SVM","SVM",25,34,412,373,39,3500,3126,374,0.934836404033383,0.658031088082902,1.77916412679061,754,369,385,21,1,89.47,8.4,0,0,0,0,0,0,0.0866053534836206,45.0512461709108,39.1715421568647
8.7,"random_instances_SVM","SVM",25,35,312,284,28,3600,3215,385,0.933862146188624,0.663212435233161,1.77474272343067,776,380,396,22,1,92.02,8.4,0,0,0,0,0,0,0.0603155850423318,31.8396212060572,29.1493164698617
8.7,"random_instances_SVM","SVM",25,36,212,189,23,3700,3310,390,0.934614514237668,0.663212435233161,1.77474272343067,794,387,407,18,1.1,94.58,8.5,0,0,0,0,0,0,0.0190742143345246,24.6629179142174,24.2006500102153
8.7,"random_instances_SVM","SVM",25,37,112,98,14,3800,3401,399,0.93526401946751,0.658031088082902,1.77474272343067,817,397,420,23,1.1,97.14,8.5,0,0,0,0,0,0,0.000434025082141751,13.0726081325837,13.0698960060426
8.7,"random_instances_SVM","SVM",25,38,12,9,3,3900,3490,410,0.934721785463413,0.663212435233161,1.77310852202788,835,407,428,18,1.1,99.69,8.5,0,0,0,0,0,0,0.000375996159681154,1.95495857740445,1.95495857740445
8.7,"random_instances_SVM","SVM",25,39,0,0,0,3912,3499,413,0.935250794247898,0.658031088082902,1.77310852202788,841,409,432,6,1.1,100,8.5,0,0,0,0,0,0,0,0,0
8.7,"random_instances_SVM","SVM",26,0,3812,3410,402,100,88,12,0.902382133408902,0.536458333333333,1.76807851239669,29,12,17,0,1.4,2.56,7.3,0,0,0,0,0,0,0.72513446404959,479.946993405817,77.3368638548639
8.7,"random_instances_SVM","SVM",26,1,3712,3326,386,200,172,28,0.907029478458048,0.557291666666667,1.75581797235023,61,28,33,32,1.2,5.11,6.1,0,0,0,0,0,0,0.780942696121543,495.910207311931,81.9606545565452
8.7,"random_instances_SVM","SVM",26,2,3612,3240,372,300,258,42,0.917311803193501,0.567708333333333,1.78234346224678,88,42,46,27,1.1,7.67,6.1,0,0,0,0,0,0,0.862296735809304,516.1221181205,89.4359711515119
8.7,"random_instances_SVM","SVM",26,3,3512,3152,360,400,346,54,0.914593962585036,0.552083333333333,1.76807851239669,110,52,58,22,1.1,10.22,6.4,0,0,0,0,0,0,0.838301071534395,462.476289775713,87.5699066566783
8.7,"random_instances_SVM","SVM",26,4,3412,3066,346,500,432,68,0.917561295351475,0.552083333333333,1.79944802207912,132,64,68,22,1.1,12.78,6.4,0,0,0,0,0,0,0.817188394311824,424.111757666895,85.5782299647197
8.7,"random_instances_SVM","SVM",26,5,3312,2975,337,600,523,77,0.918045516817841,0.5625,1.79007589696412,151,74,77,19,1,15.34,6.8,0,0,0,0,0,0,0.781579077653503,405.986810300789,82.8277066516135
8.7,"random_instances_SVM","SVM",26,6,3212,2890,322,700,608,92,0.917199605536661,0.5625,1.77862202925046,174,85,89,23,1,17.89,6.6,0,0,0,0,0,0,0.773828448988015,374.151199147723,82.4476373223078
8.7,"random_instances_SVM","SVM",26,7,3112,2795,317,800,703,97,0.915884235638703,0.5625,1.76645642201835,188,92,96,14,1,20.45,7.2,0,0,0,0,0,0,0.782115484077833,360.405556261042,83.2353540487982
8.7,"random_instances_SVM","SVM",26,8,3012,2704,308,900,794,106,0.915798611111112,0.546875,1.77092863677951,208,100,108,20,1.1,23.01,7.5,0,0,0,0,0,0,0.767289704619661,345.244250054725,82.6513913424463
8.7,"random_instances_SVM","SVM",26,9,2912,2612,300,1000,886,114,0.915919666477706,0.557291666666667,1.77580275229358,225,108,117,17,1.1,25.56,7.8,0,0,0,0,0,0,0.77991628222161,342.179546034957,84.33680841805
8.7,"random_instances_SVM","SVM",26,10,2812,2523,289,1100,975,125,0.916539706160244,0.552083333333333,1.77580275229358,243,118,125,18,1.1,28.12,7.8,0,0,0,0,0,0,0.743162389665386,310.657360014617,81.9721067806765
8.7,"random_instances_SVM","SVM",26,11,2712,2432,280,1200,1066,134,0.916682905801213,0.552083333333333,1.77906709558824,256,124,132,13,1.1,30.67,8,0,0,0,0,0,0,0.739475630047173,294.854969868256,81.6746837996114
8.7,"random_instances_SVM","SVM",26,12,2612,2340,272,1300,1158,142,0.915565358087683,0.546875,1.76807851239669,261,128,133,5,1,33.23,8.2,0,0,0,0,0,0,0.72323364173032,269.738216805646,80.6247969157793
8.7,"random_instances_SVM","SVM",26,13,2512,2250,262,1400,1248,152,0.915432492441419,0.552083333333333,1.76930987202925,284,140,144,23,1,35.79,8.2,0,0,0,0,0,0,0.679940577175318,247.061645917187,77.6189281588659
8.7,"random_instances_SVM","SVM",26,14,2412,2161,251,1500,1337,163,0.917035737906276,0.546875,1.76483730522456,302,148,154,18,1,38.34,8.2,0,0,0,0,0,0,0.686093790438371,241.453787508559,78.3835229931291
8.7,"random_instances_SVM","SVM",26,15,2312,2068,244,1600,1430,170,0.917933319161,0.5625,1.78070377184913,329,161,168,27,1,40.9,8.4,0,0,0,0,0,0,0.67072014716137,230.328225532092,78.4454650058267
8.7,"random_instances_SVM","SVM",26,16,2212,1981,231,1700,1517,183,0.919580853174603,0.546875,1.7774334251607,357,174,183,28,1.1,43.46,8.3,0,0,0,0,0,0,0.65478062811656,217.940706608811,76.9505933740057
8.7,"random_instances_SVM","SVM",26,17,2112,1887,225,1800,1611,189,0.919536564625851,0.552083333333333,1.76807851239669,371,180,191,14,1.1,46.01,8.5,0,0,0,0,0,0,0.643801173694848,207.422348869339,76.5666243365029
8.7,"random_instances_SVM","SVM",26,18,2012,1796,216,1900,1702,198,0.920437098450493,0.557291666666667,1.76322115384615,387,190,197,16,1,48.57,8.6,0,0,0,0,0,0,0.630227839708956,191.20789228047,76.5384469228722
8.7,"random_instances_SVM","SVM",26,19,1912,1706,206,2000,1792,208,0.920958227040811,0.557291666666667,1.77580275229358,407,200,207,20,1,51.12,8.6,0,0,0,0,0,0,0.638768215844553,188.096048056541,77.8887056079879
8.7,"random_instances_SVM","SVM",26,20,1812,1621,191,2100,1877,223,0.921717037509442,0.567708333333333,1.77906709558824,436,212,224,29,1.1,53.68,8.4,0,0,0,0,0,0,0.60110042103484,179.391148276577,75.5822390238036
8.7,"random_instances_SVM","SVM",26,21,1712,1534,178,2200,1964,236,0.921815948601651,0.578125,1.78070377184913,455,223,232,19,1,56.24,8.3,0,0,0,0,0,0,0.579521530638824,168.919897634435,74.1690856935176
8.7,"random_instances_SVM","SVM",26,22,1612,1446,166,2300,2052,248,0.921190003779283,0.5625,1.7774334251607,474,232,242,19,1,58.79,8.3,0,0,0,0,0,0,0.602252009764314,164.817000431728,76.2618700184238
8.7,"random_instances_SVM","SVM",26,23,1512,1356,156,2400,2142,258,0.921526596749803,0.5625,1.7774334251607,498,242,256,24,1.1,61.35,8.3,0,0,0,0,0,0,0.575616718964914,154.843572384193,74.2648942206849
8.7,"random_instances_SVM","SVM",26,24,1412,1271,141,2500,2227,273,0.924302012471643,0.578125,1.7774334251607,528,257,271,30,1.1,63.91,8.2,0,0,0,0,0,0,0.556677911420488,148.073587818652,73.8219194826224
8.7,"random_instances_SVM","SVM",26,25,1312,1185,127,2600,2313,287,0.92292759117535,0.572916666666667,1.76645642201835,553,269,284,25,1.1,66.46,8.1,0,0,0,0,0,0,0.5,132.821402509888,69.8587661697368
8.7,"random_instances_SVM","SVM",26,26,1212,1097,115,2700,2401,299,0.923764644746782,0.572916666666667,1.78514908256881,576,283,293,23,1,69.02,8,0,0,0,0,0,0,0.477175818037451,120.067601394868,69.3111359410077
8.7,"random_instances_SVM","SVM",26,27,1112,1006,106,2800,2492,308,0.923841411564622,0.588541666666667,1.78234346224678,602,294,308,26,1,71.57,8.1,0,0,0,0,0,0,0.46193421618082,111.375615233703,68.5338746351594
8.7,"random_instances_SVM","SVM",26,28,1012,918,94,2900,2580,320,0.92402151832955,0.583333333333333,1.78070377184913,625,307,318,23,1,74.13,8.1,0,0,0,0,0,0,0.40779995938799,103.417553617641,67.9006162261775
8.7,"random_instances_SVM","SVM",26,29,912,823,89,3000,2675,325,0.924631224017378,0.588541666666667,1.77580275229358,628,308,320,3,1,76.69,8.2,0,0,0,0,0,0,0.370877328702656,92.8748512576535,63.3930240526212
8.7,"random_instances_SVM","SVM",26,30,812,728,84,3100,2770,330,0.92496634070294,0.588541666666667,1.7774334251607,642,316,326,14,1,79.24,8.4,0,0,0,0,0,0,0.331823306080978,85.3913106957326,60.9358040228027
8.7,"random_instances_SVM","SVM",26,31,712,636,76,3200,2862,338,0.924802473072553,0.588541666666667,1.77906709558824,662,323,339,20,1,81.8,8.5,0,0,0,0,0,0,0.269874188098623,74.9946940662657,58.0764919166102
8.7,"random_instances_SVM","SVM",26,32,612,547,65,3300,2951,349,0.925046060090697,0.583333333333333,1.7774334251607,676,332,344,14,1,84.36,8.5,0,0,0,0,0,0,0.174991659084466,63.5024809954137,51.6663068960852
8.7,"random_instances_SVM","SVM",26,33,512,464,48,3400,3034,366,0.924960435563107,0.578125,1.77580275229358,711,347,364,35,1,86.91,8.3,0,0,0,0,0,0,0.0990514912094067,54.4236257380878,46.0853510829385
8.7,"random_instances_SVM","SVM",26,34,412,377,35,3500,3121,379,0.925388558201049,0.583333333333333,1.78398617511521,736,358,378,25,1.1,89.47,8.2,0,0,0,0,0,0,0.0746154353358216,42.8625442295248,37.8557140602461
8.7,"random_instances_SVM","SVM",26,35,312,286,26,3600,3212,388,0.924736040249424,0.578125,1.79172421731123,750,367,383,14,1,92.02,8.3,0,0,0,0,0,0,0.0546659699587062,32.8114794594714,30.2124832116066
8.7,"random_instances_SVM","SVM",26,36,212,195,17,3700,3303,397,0.925193688586536,0.583333333333333,1.77699771689498,769,377,392,19,1,94.58,8.3,0,0,0,0,0,0,0.0182284917817781,21.4632939758821,20.8378448254103
8.7,"random_instances_SVM","SVM",26,37,112,104,8,3800,3394,406,0.925781249999991,0.578125,1.78351283226398,787,386,401,18,1,97.14,8.4,0,0,0,0,0,0,0.00203430800307406,11.0205241628675,11.006206763057
8.7,"random_instances_SVM","SVM",26,38,12,12,0,3900,3486,414,0.926101603835968,0.578125,1.79172421731123,798,391,407,11,1,99.69,8.4,0,0,0,0,0,0,0.0011184565691372,0.187231516903108,0.187231516903108
8.7,"random_instances_SVM","SVM",26,39,0,0,0,3912,3498,414,0.926135558390012,0.578125,1.7867883379247,798,391,407,0,1,100,8.4,0,0,0,0,0,0,0,0,0
8.7,"random_instances_SVM","SVM",27,0,3812,3405,407,100,86,14,0.855345124910353,0.432432432432432,1.71506289699838,37,14,23,0,1.6,2.56,6.1,0,0,0,0,0,0,0.364922117690811,482.172054330704,43.7506726299466
8.7,"random_instances_SVM","SVM",27,1,3712,3321,391,200,170,30,0.915160162986245,0.535135135135135,1.76216216216216,67,30,37,30,1.2,5.11,5.7,0,0,0,0,0,0,0.601854391389646,476.986319015774,64.9376326660891
8.7,"random_instances_SVM","SVM",27,2,3612,3229,383,300,262,38,0.915195263021347,0.589189189189189,1.77346842718062,83,38,45,16,1.2,7.67,6.9,0,0,0,0,0,0,0.612512071291943,452.805432915969,68.3141014089777
8.7,"random_instances_SVM","SVM",27,3,3512,3143,369,400,348,52,0.920548781418344,0.551351351351351,1.78972127601382,115,52,63,32,1.2,10.22,6.7,0,0,0,0,0,0,0.762686007883033,480.649332327769,82.0610926121303
8.7,"random_instances_SVM","SVM",27,4,3412,3051,361,500,440,60,0.919416423764247,0.589189189189189,1.78479543763947,132,60,72,17,1.2,12.78,7.3,0,0,0,0,0,0,0.5571664586025,393.672873122713,63.9320251262365
8.7,"random_instances_SVM","SVM",27,5,3312,2965,347,600,526,74,0.921926839318152,0.610810810810811,1.77835850556439,158,74,84,26,1.1,15.34,7.1,0,0,0,0,0,0,0.707377041891532,414.45606591929,76.2510802537718
8.7,"random_instances_SVM","SVM",27,6,3212,2874,338,700,617,83,0.920966929662582,0.589189189189189,1.78327562585627,177,83,94,19,1.1,17.89,7.4,0,0,0,0,0,0,0.823495521927179,422.531673140965,87.7451114843382
8.7,"random_instances_SVM","SVM",27,7,3112,2781,331,800,710,90,0.922450287667678,0.6,1.76377734287908,191,90,101,14,1.1,20.45,7.9,0,0,0,0,0,0,0.690802734473725,381.22135210149,77.2786153940684
8.7,"random_instances_SVM","SVM",27,8,3012,2688,324,900,803,97,0.913528774398344,0.583783783783784,1.74429692365176,207,97,110,16,1.1,23.01,8.3,0,0,0,0,0,0,0.729354194860706,347.811308571197,81.4786870448477
8.7,"random_instances_SVM","SVM",27,9,2912,2599,313,1000,892,108,0.92042058998581,0.594594594594595,1.77026778388324,226,108,118,19,1.1,25.56,8.3,0,0,0,0,0,0,0.700146419827413,324.73464572942,79.482657215191
8.7,"random_instances_SVM","SVM",27,10,2812,2506,306,1100,985,115,0.917908648343438,0.605405405405405,1.75081429175265,245,115,130,19,1.1,28.12,8.6,0,0,0,0,0,0,0.725282222891334,307.807912538976,80.889533641042
8.7,"random_instances_SVM","SVM",27,11,2712,2418,294,1200,1073,127,0.923104979626728,0.6,1.75892289348172,263,127,136,18,1.1,30.67,8.4,0,0,0,0,0,0,0.736434830940336,309.021636472454,80.8237850751558
8.7,"random_instances_SVM","SVM",27,12,2612,2330,282,1300,1161,139,0.921372869198959,0.6,1.76701660338024,286,139,147,23,1.1,33.23,8.4,0,0,0,0,0,0,0.805816724955556,308.931490200817,86.0558851009814
8.7,"random_instances_SVM","SVM",27,13,2512,2243,269,1400,1248,152,0.922315991881223,0.594594594594595,1.76864069952305,310,152,158,24,1,35.79,8.2,0,0,0,0,0,0,0.813856930983306,297.827564510329,87.1923736723998
8.7,"random_instances_SVM","SVM",27,14,2412,2156,256,1500,1335,165,0.925406321058494,0.594594594594595,1.77189786471554,336,165,171,26,1,38.34,8.1,0,0,0,0,0,0,0.808899360800127,288.623411469131,87.9280941338887
8.7,"random_instances_SVM","SVM",27,15,2312,2067,245,1600,1424,176,0.926610404871269,0.605405405405405,1.78163356726893,360,176,184,24,1,40.9,8.1,0,0,0,0,0,0,0.781915870783269,270.931802456439,85.9659177525305
8.7,"random_instances_SVM","SVM",27,16,2212,1980,232,1700,1511,189,0.926131213087729,0.6,1.77672548581639,383,187,196,23,1,43.46,8,0,0,0,0,0,0,0.755098007302257,250.516957495904,84.1383136563073
8.7,"random_instances_SVM","SVM",27,17,2112,1887,225,1800,1604,196,0.926657713614231,0.594594594594595,1.77835850556439,391,191,200,8,1,46.01,8.2,0,0,0,0,0,0,0.724331349364903,237.706554982462,82.1842697207373
8.7,"random_instances_SVM","SVM",27,18,2012,1797,215,1900,1694,206,0.926637874463958,0.589189189189189,1.77026778388324,410,200,210,19,1.1,48.57,8.2,0,0,0,0,0,0,0.691132326943741,215.988249071534,79.5595784948556
8.7,"random_instances_SVM","SVM",27,19,1912,1707,205,2000,1784,216,0.927761075587159,0.6,1.76701660338024,440,214,226,30,1.1,51.12,8.3,0,0,0,0,0,0,0.667850626748851,212.028688839429,79.3326444063823
8.7,"random_instances_SVM","SVM",27,20,1812,1614,198,2100,1877,223,0.924846246585373,0.6,1.76701660338024,455,222,233,15,1,53.68,8.4,0,0,0,0,0,0,0.68725566325894,204.703169729133,82.9150522568131
8.7,"random_instances_SVM","SVM",27,21,1712,1532,180,2200,1959,241,0.92654020480107,0.589189189189189,1.77509546243491,479,236,243,24,1,56.24,8.1,0,0,0,0,0,0,0.648757070575937,185.941350918667,78.8114343048298
8.7,"random_instances_SVM","SVM",27,22,1612,1446,166,2300,2045,255,0.926952248691377,0.6,1.78327562585627,507,248,259,28,1,58.79,8,0,0,0,0,0,0,0.649037763753634,176.267313353853,78.9100291138782
8.7,"random_instances_SVM","SVM",27,23,1512,1357,155,2400,2134,266,0.926831687701249,0.605405405405405,1.77835850556439,527,256,271,20,1.1,61.35,8,0,0,0,0,0,0,0.61370121957739,164.991696461517,77.3755140643884
8.7,"random_instances_SVM","SVM",27,24,1412,1266,146,2500,2225,275,0.926735544126846,0.610810810810811,1.77672548581639,547,267,280,20,1,63.91,8.1,0,0,0,0,0,0,0.566834897653696,154.209460370381,74.493061858918
8.7,"random_instances_SVM","SVM",27,25,1312,1176,136,2600,2315,285,0.928282997848219,0.621621621621622,1.78163356726893,561,274,287,14,1,66.46,8.1,0,0,0,0,0,0,0.559955161563575,146.541582912605,75.0960078498643
8.7,"random_instances_SVM","SVM",27,26,1212,1084,128,2700,2407,293,0.928279945671255,0.621621621621622,1.76701660338024,574,281,293,13,1,69.02,8.2,0,0,0,0,0,0,0.529956847480745,136.045868602974,73.0489240170456
8.7,"random_instances_SVM","SVM",27,27,1112,997,115,2800,2494,306,0.930111251850387,0.610810810810811,1.77999452994853,611,298,313,37,1.1,71.57,8.2,0,0,0,0,0,0,0.5,125.971313478731,71.1491356013927
8.7,"random_instances_SVM","SVM",27,28,1012,911,101,2900,2580,320,0.931701436049265,0.605405405405405,1.77346842718062,645,315,330,34,1,74.13,8.1,0,0,0,0,0,0,0.487620041739048,116.512097194626,71.74212117697
8.7,"random_instances_SVM","SVM",27,29,912,818,94,3000,2673,327,0.932485845529327,0.610810810810811,1.77346842718062,659,322,337,14,1,76.69,8.2,0,0,0,0,0,0,0.445073719335449,105.53204883544,69.3325178403851
8.7,"random_instances_SVM","SVM",27,30,812,725,87,3100,2766,334,0.932430906343949,0.605405405405405,1.77835850556439,675,329,346,16,1.1,79.24,8.3,0,0,0,0,0,0,0.371550237322939,95.1560017333478,68.6066327916358
8.7,"random_instances_SVM","SVM",27,31,712,640,72,3200,2851,349,0.932191310452185,0.616216216216216,1.77835850556439,698,342,356,23,1,81.8,8.2,0,0,0,0,0,0,0.276979735456835,82.6499184183618,63.3410398580543
8.7,"random_instances_SVM","SVM",27,32,612,549,63,3300,2942,358,0.932704076182342,0.616216216216216,1.77835850556439,709,348,361,11,1,84.36,8.2,0,0,0,0,0,0,0.196728927372932,72.9003758155026,57.8023479172336
8.7,"random_instances_SVM","SVM",27,33,512,461,51,3400,3030,370,0.932324080150167,0.610810810810811,1.77999452994853,734,359,375,25,1,86.91,8.2,0,0,0,0,0,0,0.141107126642115,63.2585128218769,53.9641947389161
8.7,"random_instances_SVM","SVM",27,34,412,372,40,3500,3119,381,0.933737238085061,0.616216216216216,1.78327562585627,755,370,385,21,1,89.47,8.2,0,0,0,0,0,0,0.0780567067476395,50.8177313138444,45.1343868748267
8.7,"random_instances_SVM","SVM",27,35,312,284,28,3600,3207,393,0.933631937979758,0.610810810810811,1.78163356726893,779,382,397,24,1,92.02,8.2,0,0,0,0,0,0,0.0535830170039595,36.7052102118611,33.7900830203613
8.7,"random_instances_SVM","SVM",27,36,212,194,18,3700,3297,403,0.934069925374269,0.610810810810811,1.77835850556439,796,391,405,17,1,94.58,8.2,0,0,0,0,0,0,0.0186738259885176,24.7990484382908,24.0886344371034
8.7,"random_instances_SVM","SVM",27,37,112,102,10,3800,3389,411,0.934050086224,0.6,1.78163356726893,808,399,409,12,1,97.14,8.2,0,0,0,0,0,0,0.00118427029213118,15.2252787980876,15.2169636480665
8.7,"random_instances_SVM","SVM",27,38,12,12,0,3900,3479,421,0.933676194545756,0.605405405405405,1.77026778388324,833,409,424,25,1,99.69,8.3,0,0,0,0,0,0,0.000524777609766233,0.59591083547809,0.59591083547809
8.7,"random_instances_SVM","SVM",27,39,0,0,0,3912,3491,421,0.933709768492373,0.605405405405405,1.77353095030514,835,409,426,2,1,100,8.3,0,0,0,0,0,0,0,0,0
8.7,"random_instances_SVM","SVM",28,0,3812,3424,388,100,89,11,0.906384048303665,0.584541062801932,1.72438389100381,26,11,15,0,1.4,2.56,8.1,0,0,0,0,0,0,0.376779011708992,433.854934481663,42.1197810542578
8.7,"random_instances_SVM","SVM",28,1,3712,3340,372,200,173,27,0.896669732600829,0.599033816425121,1.71805006587615,66,27,39,40,1.4,5.11,6.4,0,0,0,0,0,0,0.582895126293346,425.179002582179,69.693888067028
8.7,"random_instances_SVM","SVM",28,2,3612,3248,364,300,265,35,0.900959278317772,0.599033816425121,1.72121115155394,78,35,43,12,1.2,7.67,7.6,0,0,0,0,0,0,0.534079802575438,403.57739721234,61.4980160526815
8.7,"random_instances_SVM","SVM",28,3,3512,3154,358,400,359,41,0.913631806166671,0.623188405797101,1.74889903114741,92,41,51,14,1.2,10.22,8.8,0,0,0,0,0,0,0.561260579641889,327.762516629986,63.6744615929851
8.7,"random_instances_SVM","SVM",28,4,3412,3062,350,500,451,49,0.917443508091591,0.623188405797101,1.75598309400957,108,49,59,16,1.2,12.78,9.2,0,0,0,0,0,0,0.714689019762866,352.958847891003,79.3350892699382
8.7,"random_instances_SVM","SVM",28,5,3312,2970,342,600,543,57,0.92225785334893,0.632850241545894,1.77500200176155,124,57,67,16,1.2,15.34,9.5,0,0,0,0,0,0,0.731111627187026,346.568669600291,79.7749495057025
8.7,"random_instances_SVM","SVM",28,6,3212,2885,327,700,628,72,0.927342884684994,0.632850241545894,1.77663794830695,154,72,82,30,1.1,17.89,8.7,0,0,0,0,0,0,0.834220882839526,361.671591914219,88.3023055706559
8.7,"random_instances_SVM","SVM",28,7,3112,2793,319,800,720,80,0.927276594216728,0.632850241545894,1.77336906523739,171,80,91,17,1.1,20.45,9,0,0,0,0,0,0,0.823048392129376,353.136249848338,87.443359988805
8.7,"random_instances_SVM","SVM",28,8,3012,2704,308,900,809,91,0.931441845305687,0.642512077294686,1.7820620508513,192,91,101,21,1.1,23.01,8.9,0,0,0,0,0,0,0.755217123948281,317.607516679806,83.0991695906164
8.7,"random_instances_SVM","SVM",28,9,2912,2609,303,1000,904,96,0.93027347580262,0.628019323671498,1.78042412617221,199,96,103,7,1.1,25.56,9.4,0,0,0,0,0,0,0.685631324774896,293.44750442597,77.2775234626566
8.7,"random_instances_SVM","SVM",28,10,2812,2521,291,1100,992,108,0.931314788574858,0.628019323671498,1.77878920961925,228,108,120,29,1.1,28.12,9.2,0,0,0,0,0,0,0.653625537861342,289.79011571629,76.0260408902978
8.7,"random_instances_SVM","SVM",28,11,2712,2432,280,1200,1081,119,0.929761105725033,0.632850241545894,1.79240398217098,258,119,139,30,1.2,30.67,9.1,0,0,0,0,0,0,0.647141710446677,273.874500392016,76.1662936186997
8.7,"random_instances_SVM","SVM",28,12,2612,2339,273,1300,1174,126,0.928650740381687,0.623188405797101,1.78582635287861,277,126,151,19,1.2,33.23,9.3,0,0,0,0,0,0,0.643156393719225,262.262663975095,77.043670225001
8.7,"random_instances_SVM","SVM",28,13,2512,2252,260,1400,1261,139,0.928063793527306,0.632850241545894,1.78418948179439,298,139,159,21,1.1,35.79,9.1,0,0,0,0,0,0,0.578630161410602,252.96571253029,71.2531159626329
8.7,"random_instances_SVM","SVM",28,14,2412,2169,243,1500,1344,156,0.928515397342324,0.632850241545894,1.78582635287861,336,156,180,38,1.2,38.34,8.6,0,0,0,0,0,0,0.668953237824572,263.083366605857,80.817020944638
8.7,"random_instances_SVM","SVM",28,15,2312,2077,235,1600,1436,164,0.928685266667239,0.628019323671498,1.79075503646521,348,164,184,12,1.1,40.9,8.8,0,0,0,0,0,0,0.646037383060537,239.454340953421,79.2524456245817
8.7,"random_instances_SVM","SVM",28,16,2212,1985,227,1700,1528,172,0.929830158296133,0.628019323671498,1.79240398217098,366,172,194,18,1.1,43.46,8.9,0,0,0,0,0,0,0.705885135966816,240.683890457266,84.5943670921561
8.7,"random_instances_SVM","SVM",28,17,2112,1896,216,1800,1617,183,0.929668575279753,0.628019323671498,1.7755283678051,387,183,204,21,1.1,46.01,8.8,0,0,0,0,0,0,0.728490501944347,236.337124191997,86.1387830847511
8.7,"random_instances_SVM","SVM",28,18,2012,1806,206,1900,1707,193,0.927119154354613,0.628019323671498,1.79075503646521,415,193,222,28,1.2,48.57,8.8,0,0,0,0,0,0,0.684143259532146,213.266641135217,82.7230585925664
8.7,"random_instances_SVM","SVM",28,19,1912,1715,197,2000,1798,202,0.928728079261322,0.623188405797101,1.78910912190963,429,202,227,14,1.1,51.12,8.9,0,0,0,0,0,0,0.640017147624297,202.206282608557,80.0168631498171
8.7,"random_instances_SVM","SVM",28,20,1812,1627,185,2100,1886,214,0.930668456509326,0.632850241545894,1.78534695785748,449,214,235,20,1.1,53.68,8.8,0,0,0,0,0,0,0.637523000496087,194.044560809609,81.9785807733563
8.7,"random_instances_SVM","SVM",28,21,1712,1535,177,2200,1978,222,0.930198899025826,0.628019323671498,1.794055967408,467,222,245,18,1.1,56.24,8.9,0,0,0,0,0,0,0.570838264681095,174.386763925161,77.2244626813571
8.7,"random_instances_SVM","SVM",28,22,1612,1444,168,2300,2069,231,0.929149299945054,0.632850241545894,1.79075503646521,481,231,250,14,1.1,58.79,9,0,0,0,0,0,0,0.601766377274011,168.470085457214,80.5054552572711
8.7,"random_instances_SVM","SVM",28,23,1512,1354,158,2400,2159,241,0.928458774234017,0.628019323671498,1.7820620508513,512,241,271,31,1.1,61.35,9,0,0,0,0,0,0,0.529685882507044,154.535766819015,77.3859127226568
8.7,"random_instances_SVM","SVM",28,24,1412,1267,145,2500,2246,254,0.932035697417174,0.628019323671498,1.77878920961925,536,254,282,24,1.1,63.91,8.8,0,0,0,0,0,0,0.532429275339621,148.736315223438,76.6095894574011
8.7,"random_instances_SVM","SVM",28,25,1312,1177,135,2600,2336,264,0.931480514745502,0.628019323671498,1.78534695785748,559,264,295,23,1.1,66.46,8.8,0,0,0,0,0,0,0.5,136.254381656558,73.9895623718612
8.7,"random_instances_SVM","SVM",28,26,1212,1082,130,2700,2431,269,0.930690553332077,0.623188405797101,1.78534695785748,565,269,296,6,1.1,69.02,9,0,0,0,0,0,0,0.477626436219176,128.081430215097,72.3507594490902
8.7,"random_instances_SVM","SVM",28,27,1112,997,115,2800,2516,284,0.932436202329576,0.632850241545894,1.7820620508513,598,284,314,33,1.1,71.57,8.9,0,0,0,0,0,0,0.491115499214171,119.993774295856,73.6062238890669
8.7,"random_instances_SVM","SVM",28,28,1012,909,103,2900,2604,296,0.932726223128212,0.632850241545894,1.7820620508513,617,296,321,19,1.1,74.13,8.8,0,0,0,0,0,0,0.479368695411193,113.450258207532,72.7486224474355
8.7,"random_instances_SVM","SVM",28,29,912,817,95,3000,2696,304,0.932129608913879,0.632850241545894,1.78042412617221,630,304,326,13,1.1,76.69,8.9,0,0,0,0,0,0,0.397592607321875,101.02949878746,70.3571005303716
8.7,"random_instances_SVM","SVM",28,30,812,730,82,3100,2783,317,0.932676505277015,0.632850241545894,1.78042412617221,661,317,344,31,1.1,79.24,8.8,0,0,0,0,0,0,0.341933388935031,92.3003108245804,67.3582291003344
8.7,"random_instances_SVM","SVM",28,31,712,642,70,3200,2871,329,0.932669600019908,0.618357487922705,1.78370299196626,680,329,351,19,1.1,81.8,8.7,0,0,0,0,0,0,0.268857671102505,79.4121756769725,61.6513445712641
8.7,"random_instances_SVM","SVM",28,32,612,550,62,3300,2963,337,0.932682029482704,0.628019323671498,1.78534695785748,700,337,363,20,1.1,84.36,8.8,0,0,0,0,0,0,0.165350374691689,69.4952424088364,57.188698184867
8.7,"random_instances_SVM","SVM",28,33,512,458,54,3400,3055,345,0.933529995055856,0.632850241545894,1.78746623015398,710,345,365,10,1.1,86.91,8.9,0,0,0,0,0,0,0.13533956011441,59.9996847002969,51.0628341492432
8.7,"random_instances_SVM","SVM",28,34,412,370,42,3500,3143,357,0.932934761892944,0.632850241545894,1.78582635287861,733,357,376,23,1.1,89.47,8.8,0,0,0,0,0,0,0.0719804710643923,46.0465526787494,40.9407594652012
8.7,"random_instances_SVM","SVM",28,35,312,284,28,3600,3229,371,0.933176445891806,0.628019323671498,1.794055967408,763,370,393,30,1.1,92.02,8.7,0,0,0,0,0,0,0.0535665023670268,31.793947302362,29.0471546574233
8.7,"random_instances_SVM","SVM",28,36,212,195,17,3700,3318,382,0.934767417130031,0.628019323671498,1.79075503646521,777,379,398,14,1.1,94.58,8.7,0,0,0,0,0,0,0.0206550846837531,19.745364293073,19.2755576439986
8.7,"random_instances_SVM","SVM",28,37,112,103,9,3800,3410,390,0.935561521697721,0.642512077294686,1.78582635287861,790,387,403,13,1,97.14,8.7,0,0,0,0,0,0,0.000525735877443303,11.5096464859001,11.507515912318
8.7,"random_instances_SVM","SVM",28,38,12,11,1,3900,3502,398,0.936366674676786,0.642512077294686,1.794055967408,809,394,415,19,1.1,99.69,8.8,0,0,0,0,0,0,0.000429971604354946,0.933893415927794,0.933893415927794
8.7,"random_instances_SVM","SVM",28,39,0,0,0,3912,3513,399,0.936210615866093,0.642512077294686,1.78582635287861,812,395,417,3,1.1,100,8.8,0,0,0,0,0,0,0,0,0
8.7,"random_instances_SVM","SVM",29,0,3812,3411,401,100,87,13,0.906131897203331,0.520833333333333,1.76520737327189,35,13,22,0,1.7,2.56,6.7,0,0,0,0,0,0,0.414230258737418,509.352499160239,45.7212500793063
8.7,"random_instances_SVM","SVM",29,1,3712,3327,385,200,171,29,0.912171378968258,0.536458333333333,1.75389194139194,69,29,40,34,1.4,5.11,5.9,0,0,0,0,0,0,0.575935990498877,515.958985320383,66.7095074316844
8.7,"random_instances_SVM","SVM",29,2,3612,3233,379,300,265,35,0.904093147675737,0.557291666666667,1.74161305147059,85,35,50,16,1.4,7.67,7.6,0,0,0,0,0,0,0.580359192906303,389.204801185954,69.9212564856104
8.7,"random_instances_SVM","SVM",29,3,3512,3146,366,400,352,48,0.920014880952385,0.578125,1.76195952161914,110,48,62,25,1.3,10.22,7.3,0,0,0,0,0,0,0.745363005685262,448.793038353845,81.754074616139
8.7,"random_instances_SVM","SVM",29,4,3412,3056,356,500,442,58,0.91285194633408,0.583333333333333,1.75258739650414,129,58,71,19,1.2,12.78,7.6,0,0,0,0,0,0,0.689977094324483,410.131271976964,78.1661059136392
8.7,"random_instances_SVM","SVM",29,5,3312,2970,342,600,528,72,0.921663891250952,0.604166666666667,1.76358195211786,154,72,82,25,1.1,15.34,7.3,0,0,0,0,0,0,0.774474915541087,456.870877680478,83.3520783794649
8.7,"random_instances_SVM","SVM",29,6,3212,2878,334,700,620,80,0.919905635865461,0.59375,1.74776376146789,173,80,93,19,1.2,17.89,7.8,0,0,0,0,0,0,0.691495363562173,405.861198435952,76.5998687107394
8.7,"random_instances_SVM","SVM",29,7,3112,2787,325,800,711,89,0.921672748960692,0.578125,1.73841743119266,192,89,103,19,1.2,20.45,8,0,0,0,0,0,0,0.833687321258544,403.543897857345,89.7296307428131
8.7,"random_instances_SVM","SVM",29,8,3012,2694,318,900,804,96,0.919932208994705,0.583333333333333,1.74776376146789,210,96,114,18,1.2,23.01,8.4,0,0,0,0,0,0,0.774445459592746,364.642643506783,85.5458924554924
8.7,"random_instances_SVM","SVM",29,9,2912,2603,309,1000,895,105,0.922341506046862,0.59375,1.74616177818515,229,105,124,19,1.2,25.56,8.5,0,0,0,0,0,0,0.743466804398564,334.827759129789,84.6668050647405
8.7,"random_instances_SVM","SVM",29,10,2812,2509,303,1100,989,111,0.923056027966739,0.59375,1.75549954170486,243,111,132,14,1.2,28.12,8.9,0,0,0,0,0,0,0.761394475525243,329.947275435873,84.9615024060269
8.7,"random_instances_SVM","SVM",29,11,2712,2418,294,1200,1080,120,0.925645431783822,0.583333333333333,1.76195952161914,266,120,146,23,1.2,30.67,9,0,0,0,0,0,0,0.752612973185821,318.929636035451,85.8233172069727
8.7,"random_instances_SVM","SVM",29,12,2612,2330,282,1300,1168,132,0.927254582388511,0.59375,1.76195952161914,286,132,154,20,1.2,33.23,8.8,0,0,0,0,0,0,0.755517968599882,301.349872355767,85.1010307479446
8.7,"random_instances_SVM","SVM",29,13,2512,2241,271,1400,1257,143,0.926379145408162,0.598958333333333,1.75420119705341,299,143,156,13,1.1,35.79,8.8,0,0,0,0,0,0,0.782578676503863,299.601927494204,87.7868866902201
8.7,"random_instances_SVM","SVM",29,14,2412,2155,257,1500,1343,157,0.927644321617545,0.598958333333333,1.77296270718232,326,157,169,27,1.1,38.34,8.6,0,0,0,0,0,0,0.716259576453571,280.649629084364,81.8224636300517
8.7,"random_instances_SVM","SVM",29,15,2312,2062,250,1600,1436,164,0.92664635298564,0.598958333333333,1.76195952161914,343,164,179,17,1.1,40.9,8.8,0,0,0,0,0,0,0.75654867947168,267.332542200004,85.897041551428
8.7,"random_instances_SVM","SVM",29,16,2212,1968,244,1700,1530,170,0.926928323412707,0.604166666666667,1.75420119705341,357,170,187,14,1.1,43.46,9,0,0,0,0,0,0,0.754319330732577,261.324091488205,86.7664311431169
8.7,"random_instances_SVM","SVM",29,17,2112,1880,232,1800,1618,182,0.929979804421778,0.609375,1.76520737327189,384,182,202,27,1.1,46.01,8.9,0,0,0,0,0,0,0.737374797731675,238.392605316871,85.990673611088
8.7,"random_instances_SVM","SVM",29,18,2012,1787,225,1900,1711,189,0.926853032879812,0.604166666666667,1.75581797235023,397,189,208,13,1.1,48.57,9.1,0,0,0,0,0,0,0.666684501410413,217.576586528871,82.1477452427469
8.7,"random_instances_SVM","SVM",29,19,1912,1705,207,2000,1793,207,0.929209183673485,0.614583333333333,1.75872359963269,433,207,226,36,1.1,51.12,8.7,0,0,0,0,0,0,0.666687504875906,211.418313575929,82.0420697575148
8.7,"random_instances_SVM","SVM",29,20,1812,1617,195,2100,1881,219,0.929231327947864,0.614583333333333,1.76034007352941,453,219,234,20,1.1,53.68,8.6,0,0,0,0,0,0,0.646464883300214,199.644223562446,81.2854071303639
8.7,"random_instances_SVM","SVM",29,21,1712,1531,181,2200,1967,233,0.931695247543475,0.609375,1.76520737327189,480,233,247,27,1.1,56.24,8.4,0,0,0,0,0,0,0.722951463260486,196.534945393172,85.8408438191479
8.7,"random_instances_SVM","SVM",29,22,1612,1437,175,2300,2061,239,0.930009330120955,0.604166666666667,1.76195952161914,493,239,254,13,1.1,58.79,8.6,0,0,0,0,0,0,0.655525279301755,176.77877536462,84.2474113010417
8.7,"random_instances_SVM","SVM",29,23,1512,1348,164,2400,2150,250,0.930638227513241,0.609375,1.76195952161914,515,250,265,22,1.1,61.35,8.6,0,0,0,0,0,0,0.598090929623924,164.536211034863,79.0510758872182
8.7,"random_instances_SVM","SVM",29,24,1412,1265,147,2500,2233,267,0.932645975056696,0.598958333333333,1.75581797235023,546,266,280,31,1.1,63.91,8.4,0,0,0,0,0,0,0.611273161615503,153.042975352382,81.0442114631683
8.7,"random_instances_SVM","SVM",29,25,1312,1177,135,2600,2321,279,0.931710010393056,0.59375,1.76034007352941,575,279,296,29,1.1,66.46,8.3,0,0,0,0,0,0,0.59209191526481,146.177373496918,80.495015370883
8.7,"random_instances_SVM","SVM",29,26,1212,1089,123,2700,2409,291,0.931315842309155,0.59375,1.7509765625,596,290,306,21,1.1,69.02,8.3,0,0,0,0,0,0,0.516230977885297,136.166191126368,75.8796208592525
8.7,"random_instances_SVM","SVM",29,27,1112,998,114,2800,2500,300,0.931358654572948,0.598958333333333,1.76358195211786,613,299,314,17,1.1,71.57,8.3,0,0,0,0,0,0,0.510261906752272,127.525009596236,76.7704283918783
8.7,"random_instances_SVM","SVM",29,28,1012,905,107,2900,2593,307,0.92972588340893,0.59375,1.74616177818515,629,307,322,16,1,74.13,8.4,0,0,0,0,0,0,0.420504327597996,112.992331299789,73.1528552534025
8.7,"random_instances_SVM","SVM",29,29,912,818,94,3000,2680,320,0.930283919123215,0.59375,1.75258739650414,650,318,332,21,1,76.69,8.4,0,0,0,0,0,0,0.372815499980655,99.0372308200693,67.943592903393
8.7,"random_instances_SVM","SVM",29,30,812,734,78,3100,2764,336,0.93019534202571,0.59375,1.74936868686869,678,331,347,28,1,79.24,8.2,0,0,0,0,0,0,0.267947466044376,80.1074037201567,58.6190792589371
8.7,"random_instances_SVM","SVM",29,31,712,641,71,3200,2857,343,0.929652069160998,0.59375,1.75420119705341,694,339,355,16,1,81.8,8.3,0,0,0,0,0,0,0.172757664886264,67.776043330846,52.0704874683453
8.7,"random_instances_SVM","SVM",29,32,612,554,58,3300,2944,356,0.930371019935751,0.588541666666667,1.74776376146789,715,349,366,21,1,84.36,8.3,0,0,0,0,0,0,0.145979070757855,59.5991622828606,46.5487575052254
8.7,"random_instances_SVM","SVM",29,33,512,461,51,3400,3037,363,0.929926658163274,0.588541666666667,1.75581797235023,732,359,373,17,1,86.91,8.4,0,0,0,0,0,0,0.101840760992558,51.2281290344233,42.1523960289745
8.7,"random_instances_SVM","SVM",29,34,412,367,45,3500,3131,369,0.929950278722608,0.59375,1.74776376146789,745,364,381,13,1,89.47,8.5,0,0,0,0,0,0,0.074405049842955,42.8250552833732,37.3346468071842
8.7,"random_instances_SVM","SVM",29,35,312,282,30,3600,3216,384,0.929610733182172,0.588541666666667,1.75258739650414,774,377,397,29,1.1,92.02,8.4,0,0,0,0,0,0,0.0493271422903266,28.7589568332623,26.2469214277939
8.7,"random_instances_SVM","SVM",29,36,212,191,21,3700,3307,393,0.930044760959949,0.59375,1.75581797235023,795,388,407,21,1,94.58,8.4,0,0,0,0,0,0,0.0184885873800475,18.8383773579978,18.3246823504584
8.7,"random_instances_SVM","SVM",29,37,112,104,8,3800,3394,406,0.931910785147404,0.598958333333333,1.7509765625,811,395,416,16,1.1,97.14,8.4,0,0,0,0,0,0,0.00222186079683958,9.9447460995605,9.93217262988256
8.7,"random_instances_SVM","SVM",29,38,12,12,0,3900,3486,414,0.932084986772499,0.59375,1.75258739650414,827,404,423,16,1,99.69,8.4,0,0,0,0,0,0,0.000509456166286754,0.218280459341359,0.218280459341359
8.7,"random_instances_SVM","SVM",29,39,0,0,0,3912,3498,414,0.932020030234328,0.59375,1.74616177818515,827,404,423,0,1,100,8.4,0,0,0,0,0,0,0,0,0
8.7,"random_instances_SVM","SVM",30,0,3812,3413,399,100,89,11,0.895785018552878,0.510204081632653,1.76646059883808,30,11,19,0,1.7,2.56,8.1,0,0,0,0,0,0,0.556675881395441,413.890762576428,60.690153567206
8.7,"random_instances_SVM","SVM",30,1,3712,3329,383,200,173,27,0.90624710111317,0.520408163265306,1.78697925451172,61,27,34,31,1.3,5.11,6.4,0,0,0,0,0,0,0.886784096848099,537.585344656803,91.638503375199
8.7,"random_instances_SVM","SVM",30,2,3612,3235,377,300,267,33,0.911375231910947,0.551020408163265,1.78862169867947,74,33,41,13,1.2,7.67,8.1,0,0,0,0,0,0,0.767722815533308,461.648027428387,81.4217477717438
8.7,"random_instances_SVM","SVM",30,3,3512,3150,362,400,352,48,0.910085227272728,0.545918367346939,1.76865126215776,102,48,54,28,1.1,10.22,7.3,0,0,0,0,0,0,0.805937386969104,453.792983786029,85.414840558102
8.7,"random_instances_SVM","SVM",30,4,3412,3055,357,500,447,53,0.896789482838585,0.561224489795918,1.708959407939,116,53,63,14,1.2,12.78,8.4,0,0,0,0,0,0,0.697724805323385,392.351935460924,77.3473306911493
8.7,"random_instances_SVM","SVM",30,5,3312,2963,349,600,539,61,0.908679267161404,0.561224489795918,1.76434772804149,131,61,70,15,1.1,15.34,8.8,0,0,0,0,0,0,0.734884231727572,375.034665254971,80.7344786690085
8.7,"random_instances_SVM","SVM",30,6,3212,2868,344,700,634,66,0.911944863172541,0.556122448979592,1.79191566129214,143,66,77,12,1.2,17.89,9.6,0,0,0,0,0,0,0.830872400262997,387.640515488531,88.8173736879088
8.7,"random_instances_SVM","SVM",30,7,3112,2773,339,800,729,71,0.909561978200371,0.561224489795918,1.785339824003,158,71,87,15,1.2,20.45,10.3,0,0,0,0,0,0,0.707660954121876,341.947365032794,79.1270577930652
8.7,"random_instances_SVM","SVM",30,8,3012,2681,331,900,821,79,0.909928687384046,0.556122448979592,1.7719054503126,173,79,94,15,1.2,23.01,10.4,0,0,0,0,0,0,0.699042858190836,322.019474818846,78.3372277917641
8.7,"random_instances_SVM","SVM",30,9,2912,2593,319,1000,909,91,0.904686050556583,0.571428571428571,1.7702768607443,196,91,105,23,1.2,25.56,10,0,0,0,0,0,0,0.774284613703172,321.446003693585,85.7866117702782
8.7,"random_instances_SVM","SVM",30,10,2812,2503,309,1100,999,101,0.90542091836735,0.581632653061224,1.7719054503126,220,101,119,24,1.2,28.12,9.9,0,0,0,0,0,0,0.712212351490751,296.65640543478,79.6833813810897
8.7,"random_instances_SVM","SVM",30,11,2712,2414,298,1200,1088,112,0.900336270871984,0.566326530612245,1.78436941596915,245,112,133,25,1.2,30.67,9.7,0,0,0,0,0,0,0.673128908609009,284.882994515961,78.8815366738276
8.7,"random_instances_SVM","SVM",30,12,2612,2326,286,1300,1176,124,0.89980287569573,0.561224489795918,1.77517163547447,266,124,142,21,1.1,33.23,9.5,0,0,0,0,0,0,0.735457687009408,276.877799974744,83.0348157358978
8.7,"random_instances_SVM","SVM",30,13,2512,2236,276,1400,1266,134,0.901368274582554,0.576530612244898,1.7702768607443,287,134,153,21,1.1,35.79,9.4,0,0,0,0,0,0,0.78363705332279,287.214727049991,86.156077775864
8.7,"random_instances_SVM","SVM",30,14,2412,2151,261,1500,1351,149,0.905715155380337,0.571428571428571,1.77618423516195,316,149,167,29,1.1,38.34,9.1,0,0,0,0,0,0,0.796452978053365,278.449595441535,87.538264453588
8.7,"random_instances_SVM","SVM",30,15,2312,2066,246,1600,1436,164,0.910676600185526,0.561224489795918,1.78436941596915,339,164,175,23,1.1,40.9,8.8,0,0,0,0,0,0,0.794261554097466,265.124790338431,87.1029622788872
8.7,"random_instances_SVM","SVM",30,16,2212,1975,237,1700,1527,173,0.910946196660482,0.566326530612245,1.78108630756811,361,173,188,22,1.1,43.46,8.8,0,0,0,0,0,0,0.768380064361525,254.697138704631,85.1354261251437
8.7,"random_instances_SVM","SVM",30,17,2112,1883,229,1800,1619,181,0.910592532467526,0.571428571428571,1.79356719646384,377,181,196,16,1.1,46.01,8.9,0,0,0,0,0,0,0.717219946788862,231.771271667592,81.212924504009
8.7,"random_instances_SVM","SVM",30,18,2012,1794,218,1900,1708,192,0.91318123840445,0.566326530612245,1.78862169867947,399,192,207,22,1.1,48.57,8.9,0,0,0,0,0,0,0.783226927015593,237.19035651231,85.9915003777266
8.7,"random_instances_SVM","SVM",30,19,1912,1703,209,2000,1799,201,0.916320732838591,0.566326530612245,1.78862169867947,420,201,219,21,1.1,51.12,9,0,0,0,0,0,0,0.740456242671274,216.577287068052,83.0938509308919
8.7,"random_instances_SVM","SVM",30,20,1812,1609,203,2100,1893,207,0.916178687384043,0.556122448979592,1.79191566129214,426,207,219,6,1.1,53.68,9.1,0,0,0,0,0,0,0.731351204786812,204.72358067526,84.3140620047458
8.7,"random_instances_SVM","SVM",30,21,1712,1518,194,2200,1984,216,0.913659554730981,0.571428571428571,1.79026716482361,449,216,233,23,1.1,56.24,9.2,0,0,0,0,0,0,0.654347526032298,185.796134933514,78.4695360820865
8.7,"random_instances_SVM","SVM",30,22,1612,1425,187,2300,2077,223,0.911320153061218,0.571428571428571,1.79356719646384,466,223,243,17,1.1,58.79,9.3,0,0,0,0,0,0,0.687787818400758,180.254851860788,81.9131597978991
8.7,"random_instances_SVM","SVM",30,23,1512,1343,169,2400,2159,241,0.91541338126159,0.566326530612245,1.79191566129214,497,241,256,31,1.1,61.35,9,0,0,0,0,0,0,0.62973261850593,166.137858676279,78.419665364501
8.7,"random_instances_SVM","SVM",30,24,1412,1259,153,2500,2243,257,0.917552759740259,0.566326530612245,1.79356719646384,520,254,266,23,1,63.91,8.7,0,0,0,0,0,0,0.561895583847787,146.409863711296,72.6027122011205
8.7,"random_instances_SVM","SVM",30,25,1312,1168,144,2600,2334,266,0.916259856215212,0.571428571428571,1.79356719646384,538,263,275,18,1,66.46,8.8,0,0,0,0,0,0,0.54311292016183,138.731455024778,74.1578615679339
8.7,"random_instances_SVM","SVM",30,26,1212,1079,133,2700,2423,277,0.91728606215213,0.566326530612245,1.78697925451172,557,271,286,19,1.1,69.02,8.7,0,0,0,0,0,0,0.523128377600579,131.422868068151,73.1055645509417
8.7,"random_instances_SVM","SVM",30,27,1112,985,127,2800,2517,283,0.916801948051946,0.576530612244898,1.78697925451172,573,280,293,16,1,71.57,8.9,0,0,0,0,0,0,0.500485469922303,120.984250553764,72.1798554717537
8.7,"random_instances_SVM","SVM",30,28,1012,896,116,2900,2606,294,0.915858360389606,0.581632653061224,1.78862169867947,587,288,299,14,1,74.13,8.9,0,0,0,0,0,0,0.467263525470303,110.155919901995,68.9372353079299
8.7,"random_instances_SVM","SVM",30,29,912,809,103,3000,2693,307,0.915987360853428,0.576530612244898,1.78697925451172,609,298,311,22,1,76.69,8.8,0,0,0,0,0,0,0.446236056960041,102.63322817428,67.0725470057216
8.7,"random_instances_SVM","SVM",30,30,812,720,92,3100,2782,318,0.915108998144707,0.586734693877551,1.79026716482361,631,309,322,22,1,79.24,8.7,0,0,0,0,0,0,0.402654894581384,95.7214438954272,67.715277967295
8.7,"random_instances_SVM","SVM",30,31,712,635,77,3200,2867,333,0.914961154916505,0.576530612244898,1.78370339886642,649,320,329,18,1,81.8,8.6,0,0,0,0,0,0,0.305439901604554,79.2490109194108,61.1163712110597
8.7,"random_instances_SVM","SVM",30,32,612,545,67,3300,2957,343,0.91681934137291,0.586734693877551,1.79026716482361,670,330,340,21,1,84.36,8.6,0,0,0,0,0,0,0.207757769688993,69.0630785616938,55.3990949956201
8.7,"random_instances_SVM","SVM",30,33,512,453,59,3400,3049,351,0.916364216140996,0.581632653061224,1.78108630756811,691,339,352,21,1,86.91,8.7,0,0,0,0,0,0,0.144569206264848,58.7505584325841,50.1526944629814
8.7,"random_instances_SVM","SVM",30,34,412,368,44,3500,3134,366,0.916407699443408,0.581632653061224,1.77944927971188,716,351,365,25,1,89.47,8.6,0,0,0,0,0,0,0.0780604540373333,45.2215673651759,40.3048029022509
8.7,"random_instances_SVM","SVM",30,35,312,276,36,3600,3226,374,0.915488752319102,0.581632653061224,1.78272635020859,736,360,376,20,1,92.02,8.6,0,0,0,0,0,0,0.0424124791249786,32.7313814328075,30.7226371920943
8.7,"random_instances_SVM","SVM",30,36,212,187,25,3700,3315,385,0.915590213358063,0.581632653061224,1.78272635020859,752,369,383,16,1,94.58,8.6,0,0,0,0,0,0,0.0178912818036313,22.0211847995292,21.6336601620286
8.7,"random_instances_SVM","SVM",30,37,112,100,12,3800,3402,398,0.916158395176246,0.576530612244898,1.77455620194916,766,377,389,14,1,97.14,8.5,0,0,0,0,0,0,0.000713990479270381,11.226423702398,11.220873079191
8.7,"random_instances_SVM","SVM",30,38,12,10,2,3900,3492,408,0.91662511595547,0.581632653061224,1.78108630756811,787,387,400,21,1,99.69,8.6,0,0,0,0,0,0,0.000353439096835122,1.32579811120145,1.32579811120145
8.7,"random_instances_SVM","SVM",30,39,0,0,0,3912,3502,410,0.916790352504635,0.581632653061224,1.78108630756811,792,389,403,5,1,100,8.5,0,0,0,0,0,0,0,0,0
8.7,"random_instances_SVM","SVM",31,0,3812,3393,419,100,93,7,0.90400400400401,0.572222222222222,1.74267281105991,20,7,13,0,1.9,2.56,13.3,0,0,0,0,0,0,0.237837734096459,282.155498849517,26.4060794932687
8.7,"random_instances_SVM","SVM",31,1,3712,3309,403,200,177,23,0.922660160160161,0.522222222222222,1.77945415516713,52,23,29,32,1.3,5.11,7.7,0,0,0,0,0,0,0.748818063445003,436.345163895251,79.7946742615329
8.7,"random_instances_SVM","SVM",31,2,3612,3219,393,300,267,33,0.910014702202218,0.572222222222222,1.74785539215686,72,33,39,20,1.2,7.67,8.1,0,0,0,0,0,0,0.732049961941333,374.635760520713,81.4637375449618
8.7,"random_instances_SVM","SVM",31,3,3512,3128,384,400,358,42,0.915490490490506,0.544444444444444,1.75461773700306,92,42,50,20,1.2,10.22,8.5,0,0,0,0,0,0,0.607527191477727,358.130305006155,68.0061002351462
8.7,"random_instances_SVM","SVM",31,4,3412,3039,373,500,447,53,0.914498873873882,0.583333333333333,1.76620752984389,112,53,59,20,1.1,12.78,8.4,0,0,0,0,0,0,0.703567027626306,361.467466771518,77.0489327020476
8.7,"random_instances_SVM","SVM",31,5,3312,2949,363,600,537,63,0.923063688688709,0.555555555555556,1.77781862745098,137,63,74,25,1.2,15.34,8.5,0,0,0,0,0,0,0.71222188516638,355.464036987381,77.3698222840757
8.7,"random_instances_SVM","SVM",31,6,3212,2862,350,700,624,76,0.923905155155172,0.555555555555556,1.79109883364027,158,76,82,21,1.1,17.89,8.2,0,0,0,0,0,0,0.810379809890749,361.278911171144,86.8900033779318
8.7,"random_instances_SVM","SVM",31,7,3112,2772,340,800,714,86,0.926298173173188,0.561111111111111,1.782890314696,179,86,93,21,1.1,20.45,8.3,0,0,0,0,0,0,0.721034683342164,334.974899532397,78.5448220719473
8.7,"random_instances_SVM","SVM",31,8,3012,2685,327,900,801,99,0.927281969469484,0.555555555555556,1.78780637254902,205,99,106,26,1.1,23.01,8.1,0,0,0,0,0,0,0.808886947407315,359.081426583893,86.3776025724955
8.7,"random_instances_SVM","SVM",31,9,2912,2586,326,1000,900,100,0.919270833333353,0.588888888888889,1.75461773700306,210,100,110,5,1.1,25.56,9,0,0,0,0,0,0,0.701958861340669,289.11768920413,78.0949371796483
8.7,"random_instances_SVM","SVM",31,10,2812,2500,312,1100,986,114,0.918626438938953,0.594444444444444,1.75107427869859,236,114,122,26,1.1,28.12,8.6,0,0,0,0,0,0,0.670708533251676,287.378854587056,76.2523705400061
8.7,"random_instances_SVM","SVM",31,11,2712,2406,306,1200,1080,120,0.921512137137131,0.594444444444444,1.75268817204301,251,120,131,15,1.1,30.67,9,0,0,0,0,0,0,0.62398256384931,275.413377193833,72.1047448022853
8.7,"random_instances_SVM","SVM",31,12,2612,2324,288,1300,1162,138,0.92662819069071,0.577777777777778,1.77130647130647,288,138,150,37,1.1,33.23,8.4,0,0,0,0,0,0,0.785780519179885,303.301974414418,85.4806579336334
8.7,"random_instances_SVM","SVM",31,13,2512,2236,276,1400,1250,150,0.926227790290317,0.577777777777778,1.7578431372549,310,150,160,22,1.1,35.79,8.3,0,0,0,0,0,0,0.761034955208951,284.904464670065,84.2241298554767
8.7,"random_instances_SVM","SVM",31,14,2412,2143,269,1500,1343,157,0.926833083083101,0.605555555555556,1.75140415140415,330,157,173,20,1.1,38.34,8.6,0,0,0,0,0,0,0.632283212884387,249.913280884355,73.0601312054516
8.7,"random_instances_SVM","SVM",31,15,2312,2054,258,1600,1432,168,0.930264639639654,0.605555555555556,1.76620752984389,352,168,184,22,1.1,40.9,8.5,0,0,0,0,0,0,0.709606956270049,255.787300837345,81.1689909694402
8.7,"random_instances_SVM","SVM",31,16,2212,1961,251,1700,1525,175,0.933033033033042,0.6,1.76620752984389,365,175,190,13,1.1,43.46,8.7,0,0,0,0,0,0,0.750548987977005,252.144277171588,84.836454489203
8.7,"random_instances_SVM","SVM",31,17,2112,1869,243,1800,1617,183,0.933189439439449,0.6,1.7645871559633,383,183,200,18,1.1,46.01,8.8,0,0,0,0,0,0,0.748373094206993,237.944380612155,84.596878412723
8.7,"random_instances_SVM","SVM",31,18,2012,1775,237,1900,1711,189,0.933746246246264,0.611111111111111,1.77271889400922,396,189,207,13,1.1,48.57,9.1,0,0,0,0,0,0,0.711090784293848,226.935135027722,82.0070411500715
8.7,"random_instances_SVM","SVM",31,19,1912,1691,221,2000,1795,205,0.931784909909921,0.6,1.76783088235294,427,205,222,31,1.1,51.12,8.8,0,0,0,0,0,0,0.729857636669596,223.813760234737,83.242444231419
8.7,"random_instances_SVM","SVM",31,20,1812,1603,209,2100,1883,217,0.930716654154165,0.605555555555556,1.76783088235294,450,217,233,23,1.1,53.68,8.7,0,0,0,0,0,0,0.638744951523631,199.019165684934,77.1550954922073
8.7,"random_instances_SVM","SVM",31,21,1712,1513,199,2200,1973,227,0.93003628628629,0.594444444444444,1.76783088235294,473,227,246,23,1.1,56.24,8.7,0,0,0,0,0,0,0.685465336909407,191.717970656821,81.3846707386419
8.7,"random_instances_SVM","SVM",31,22,1612,1424,188,2300,2062,238,0.933915165165179,0.605555555555556,1.76135531135531,493,238,255,20,1.1,58.79,8.7,0,0,0,0,0,0,0.697827778683712,187.226329398196,83.0404549997705
8.7,"random_instances_SVM","SVM",31,23,1512,1334,178,2400,2152,248,0.934115365365381,0.622222222222222,1.77271889400922,511,248,263,18,1.1,61.35,8.7,0,0,0,0,0,0,0.683594435886797,178.761990983597,81.6766412892689
8.7,"random_instances_SVM","SVM",31,24,1412,1241,171,2500,2245,255,0.933990240240252,0.622222222222222,1.76945722171113,526,255,271,15,1.1,63.91,8.8,0,0,0,0,0,0,0.625654482757666,164.474600599751,80.2668716383843
8.7,"random_instances_SVM","SVM",31,25,1312,1156,156,2600,2330,270,0.936242492492518,0.611111111111111,1.76945722171113,559,270,289,33,1.1,66.46,8.6,0,0,0,0,0,0,0.63997342480074,158.10814147267,82.1516078730557
8.7,"random_instances_SVM","SVM",31,26,1212,1070,142,2700,2416,284,0.936918168168198,0.605555555555556,1.76783088235294,588,284,304,29,1.1,69.02,8.5,0,0,0,0,0,0,0.606412068586045,146.057883061834,80.4768405878877
8.7,"random_instances_SVM","SVM",31,27,1112,989,123,2800,2497,303,0.937080830830852,0.605555555555556,1.76620752984389,623,303,320,35,1.1,71.57,8.2,0,0,0,0,0,0,0.581924010937799,133.877004114283,79.4985669952118
8.7,"random_instances_SVM","SVM",31,28,1012,903,109,2900,2583,317,0.935863988989008,0.594444444444444,1.76296975252062,650,316,334,27,1.1,74.13,8.1,0,0,0,0,0,0,0.471990614570881,112.306600787206,72.9399106140839
8.7,"random_instances_SVM","SVM",31,29,912,811,101,3000,2675,325,0.936076701701722,0.588888888888889,1.76945722171113,665,324,341,15,1.1,76.69,8.2,0,0,0,0,0,0,0.368431648495837,99.7764180747071,68.670825074528
8.7,"random_instances_SVM","SVM",31,30,812,720,92,3100,2766,334,0.935657532532543,0.6,1.77945415516713,684,333,351,19,1.1,79.24,8.3,0,0,0,0,0,0,0.318246175211875,88.9326698716665,66.3445250738667
8.7,"random_instances_SVM","SVM",31,31,712,629,83,3200,2857,343,0.935540227727739,0.6,1.77455657492355,703,341,362,19,1.1,81.8,8.3,0,0,0,0,0,0,0.237204623890221,78.3028093805095,62.1861172270865
8.7,"random_instances_SVM","SVM",31,32,612,540,72,3300,2946,354,0.935401026026035,0.6,1.77108655616943,727,352,375,24,1.1,84.36,8.3,0,0,0,0,0,0,0.153957970283784,66.1518181211041,54.6545523171077
8.7,"random_instances_SVM","SVM",31,33,512,455,57,3400,3031,369,0.936549049049067,0.6,1.77945415516713,743,362,381,16,1.1,86.91,8.2,0,0,0,0,0,0,0.102510505360557,54.4352310856311,46.7290898485334
8.7,"random_instances_SVM","SVM",31,34,412,370,42,3500,3116,384,0.93757663913916,0.6,1.77781862745098,766,375,391,23,1,89.47,8.1,0,0,0,0,0,0,0.0642175832070881,43.511029665123,39.3590799986607
8.7,"random_instances_SVM","SVM",31,35,312,284,28,3600,3202,398,0.93746559059061,0.611111111111111,1.77945415516713,792,390,402,26,1,92.02,8,0,0,0,0,0,0,0.0407247138887319,32.1128818949272,30.5406751130272
8.7,"random_instances_SVM","SVM",31,36,212,191,21,3700,3295,405,0.936821196196204,0.611111111111111,1.77618610345883,804,395,409,12,1,94.58,8.1,0,0,0,0,0,0,0.0100740635439597,23.3517000095836,22.965970866543
8.7,"random_instances_SVM","SVM",31,37,112,104,8,3800,3382,418,0.938158470970989,0.611111111111111,1.77781862745098,829,406,423,25,1,97.14,8.1,0,0,0,0,0,0,0.00166525980696273,10.6682123021796,10.657116962962
8.7,"random_instances_SVM","SVM",31,38,12,12,0,3900,3474,426,0.938641766766786,0.616666666666667,1.77455657492355,841,413,428,12,1,99.69,8.2,0,0,0,0,0,0,0.000863339272942655,0.277941814194874,0.277941814194874
8.7,"random_instances_SVM","SVM",31,39,0,0,0,3912,3486,426,0.938652715215235,0.616666666666667,1.77781862745098,842,414,428,1,1,100,8.2,0,0,0,0,0,0,0,0,0
8.7,"random_instances_SVM","SVM",32,0,3812,3432,380,100,94,6,0.189717741935484,0,0.221248428990364,23,6,17,0,2.8,2.56,15.7,0,0,0,0,0,0,0.0665416712521658,237.620195604712,6.69775328286609
8.7,"random_instances_SVM","SVM",32,1,3712,3347,365,200,179,21,0.910017804775871,0.554545454545455,1.76025331222398,49,21,28,26,1.3,5.11,8.5,0,0,0,0,0,0,0.578504177423878,420.844718156313,62.4953330380041
8.7,"random_instances_SVM","SVM",32,2,3612,3255,357,300,271,29,0.914428414327611,0.55,1.78145053475936,69,29,40,20,1.4,7.67,9.3,0,0,0,0,0,0,0.686348859270231,417.835041617467,74.3417559123545
8.7,"random_instances_SVM","SVM",32,3,3512,3165,347,400,361,39,0.91993087557604,0.572727272727273,1.77492507492508,86,39,47,17,1.2,10.22,9.3,0,0,0,0,0,0,0.631428129025202,370.697934361048,70.0638635189022
8.7,"random_instances_SVM","SVM",32,4,3412,3072,340,500,454,46,0.919684750733137,0.581818181818182,1.77818181818182,99,46,53,13,1.2,12.78,9.9,0,0,0,0,0,0,0.54459332956703,321.385622702858,61.371984168926
8.7,"random_instances_SVM","SVM",32,5,3312,2982,330,600,544,56,0.919606200251363,0.572727272727273,1.79126871288785,125,56,69,26,1.2,15.34,9.7,0,0,0,0,0,0,0.715314841161428,366.864098051262,79.0692831882092
8.7,"random_instances_SVM","SVM",32,6,3212,2894,318,700,632,68,0.921289798910768,0.581818181818182,1.7651667637029,149,68,81,24,1.2,17.89,9.3,0,0,0,0,0,0,0.584116959570685,325.79676001728,67.098085218279
8.7,"random_instances_SVM","SVM",32,7,3112,2805,307,800,721,79,0.915953602848776,0.595454545454545,1.77165038817931,176,79,97,27,1.2,20.45,9.1,0,0,0,0,0,0,0.755073696981203,348.360345750933,81.9892945524784
8.7,"random_instances_SVM","SVM",32,8,3012,2710,302,900,816,84,0.91136887306243,0.577272727272727,1.76835760924159,184,84,100,8,1.2,23.01,9.7,0,0,0,0,0,0,0.761255741728034,328.618713977211,82.7603272774845
8.7,"random_instances_SVM","SVM",32,9,2912,2616,296,1000,910,90,0.900505341432769,0.568181818181818,1.74555462885738,200,90,110,16,1.2,25.56,10.1,0,0,0,0,0,0,0.730358287535609,299.646334038596,81.6884682592167
8.7,"random_instances_SVM","SVM",32,10,2812,2528,284,1100,998,102,0.906587767071643,0.586363636363636,1.75359865940511,226,102,124,26,1.2,28.12,9.8,0,0,0,0,0,0,0.801028112225101,313.200966064642,87.7152687847062
8.7,"random_instances_SVM","SVM",32,11,2712,2435,277,1200,1091,109,0.915259740259755,0.613636363636364,1.76998743192292,240,109,131,14,1.2,30.67,10,0,0,0,0,0,0,0.678572905916289,285.661075269082,77.7791871545088
8.7,"random_instances_SVM","SVM",32,12,2612,2342,270,1300,1184,116,0.914971721826575,0.609090909090909,1.76348610067618,249,116,133,9,1.1,33.23,10.2,0,0,0,0,0,0,0.719485122144195,270.300911551393,81.7736106267342
8.7,"random_instances_SVM","SVM",32,13,2512,2253,259,1400,1273,127,0.91714495182238,0.577272727272727,1.75855147612277,279,127,152,30,1.2,35.79,10,0,0,0,0,0,0,0.741448682016446,265.014497170203,83.4232856349214
8.7,"random_instances_SVM","SVM",32,14,2412,2162,250,1500,1364,136,0.91901314411396,0.581818181818182,1.76510695187166,294,136,158,15,1.2,38.34,10,0,0,0,0,0,0,0.72677678333414,252.65122715659,82.1171149933221
8.7,"random_instances_SVM","SVM",32,15,2312,2074,238,1600,1452,148,0.919881126937585,0.6,1.7651667637029,320,148,172,26,1.2,40.9,9.8,0,0,0,0,0,0,0.574383978133195,220.546845993821,68.4951574483775
8.7,"random_instances_SVM","SVM",32,16,2212,1983,229,1700,1543,157,0.92157781734395,0.6,1.76998743192292,333,157,176,13,1.1,43.46,9.8,0,0,0,0,0,0,0.754745425512095,237.330209619398,86.151757782021
8.7,"random_instances_SVM","SVM",32,17,2112,1888,224,1800,1638,162,0.921082949308762,0.604545454545454,1.75855147612277,347,162,185,14,1.1,46.01,10.1,0,0,0,0,0,0,0.645899076006156,213.179941357416,76.6771333260277
8.7,"random_instances_SVM","SVM",32,18,2012,1794,218,1900,1732,168,0.919278906577301,0.604545454545454,1.76017076845806,361,168,193,14,1.1,48.57,10.3,0,0,0,0,0,0,0.673676220902769,204.884894142653,80.2132243905785
8.7,"random_instances_SVM","SVM",32,19,1912,1709,203,2000,1817,183,0.923402806870555,0.609090909090909,1.75532181317305,384,183,201,23,1.1,51.12,9.9,0,0,0,0,0,0,0.611950127099345,186.309804294704,74.8783267248063
8.7,"random_instances_SVM","SVM",32,20,1812,1629,183,2100,1897,203,0.922341066191876,0.604545454545454,1.76835760924159,418,203,215,34,1.1,53.68,9.3,0,0,0,0,0,0,0.662535598964103,188.699190272073,80.8058960395864
8.7,"random_instances_SVM","SVM",32,21,1712,1538,174,2200,1988,212,0.923699989526605,0.604545454545454,1.77327874331551,437,212,225,19,1.1,56.24,9.4,0,0,0,0,0,0,0.666590147414327,182.742960598662,80.8332264863056
8.7,"random_instances_SVM","SVM",32,22,1612,1448,164,2300,2078,222,0.923889819857565,0.609090909090909,1.76348610067618,457,222,235,20,1.1,58.79,9.4,0,0,0,0,0,0,0.655841659473211,176.577530516175,81.0158038839572
8.7,"random_instances_SVM","SVM",32,23,1512,1357,155,2400,2169,231,0.924845517385842,0.609090909090909,1.76025331222398,476,231,245,19,1.1,61.35,9.4,0,0,0,0,0,0,0.656149651864099,165.153839529379,80.9189710893927
8.7,"random_instances_SVM","SVM",32,24,1412,1269,143,2500,2257,243,0.924240678676162,0.613636363636364,1.75855147612277,498,242,256,22,1.1,63.91,9.3,0,0,0,0,0,0,0.623650282321657,151.112025120332,78.3430912847157
8.7,"random_instances_SVM","SVM",32,25,1312,1177,135,2600,2349,251,0.922854262672816,0.613636363636364,1.75693516042781,520,251,269,22,1.1,66.46,9.4,0,0,0,0,0,0,0.647820456449299,145.228858942714,80.8201453288638
8.7,"random_instances_SVM","SVM",32,26,1212,1085,127,2700,2441,259,0.923421135316299,0.618181818181818,1.75693516042781,530,258,272,10,1.1,69.02,9.4,0,0,0,0,0,0,0.593966049326857,134.32652588402,78.9360959792096
8.7,"random_instances_SVM","SVM",32,27,1112,1002,110,2800,2524,276,0.925434645999163,0.613636363636364,1.75532181317305,557,271,286,27,1.1,71.57,9.1,0,0,0,0,0,0,0.477394603795415,117.164912441554,73.0638407409155
8.7,"random_instances_SVM","SVM",32,28,1012,913,99,2900,2613,287,0.925833944281524,0.618181818181818,1.76017076845806,581,282,299,24,1.1,74.13,9.1,0,0,0,0,0,0,0.394908753116672,103.219516974018,66.637553139403
8.7,"random_instances_SVM","SVM",32,29,912,823,89,3000,2703,297,0.926032938835361,0.622727272727273,1.76510695187166,599,291,308,18,1.1,76.69,9.1,0,0,0,0,0,0,0.367529165065652,98.4357858694243,68.2957254914676
8.7,"random_instances_SVM","SVM",32,30,812,735,77,3100,2791,309,0.925830016757439,0.627272727272727,1.76025331222398,621,304,317,22,1,79.24,9,0,0,0,0,0,0,0.273200454923,83.9310964862501,62.1513852245006
8.7,"random_instances_SVM","SVM",32,31,712,644,68,3200,2882,318,0.925054985337248,0.622727272727273,1.75371142618849,638,312,326,17,1,81.8,9.1,0,0,0,0,0,0,0.227844631330345,74.8166388839796,57.6531136033651
8.7,"random_instances_SVM","SVM",32,32,612,554,58,3300,2972,328,0.925017019271053,0.627272727272727,1.75693516042781,660,324,336,22,1,84.36,9.1,0,0,0,0,0,0,0.183628256517164,65.6464747190659,52.7370093888033
8.7,"random_instances_SVM","SVM",32,33,512,462,50,3400,3064,336,0.926772622538753,0.627272727272727,1.76017076845806,683,334,349,23,1,86.91,9.1,0,0,0,0,0,0,0.111550142928294,56.6776636243496,49.4450921109971
8.7,"random_instances_SVM","SVM",32,34,412,374,38,3500,3152,348,0.924264243820698,0.627272727272727,1.75693516042781,706,345,361,23,1,89.47,9.1,0,0,0,0,0,0,0.0699149242234902,46.3784257394298,41.6949087411032
8.7,"random_instances_SVM","SVM",32,35,312,285,27,3600,3241,359,0.924675324675329,0.618181818181818,1.75855147612277,728,356,372,22,1,92.02,9,0,0,0,0,0,0,0.0518932118881868,33.8604527156333,31.647463531071
8.7,"random_instances_SVM","SVM",32,36,212,194,18,3700,3332,368,0.924924067867621,0.627272727272727,1.7618682235196,750,365,385,22,1.1,94.58,9.1,0,0,0,0,0,0,0.0200320976688564,20.8116943202494,20.2663797830081
8.7,"random_instances_SVM","SVM",32,37,112,101,11,3800,3425,375,0.926548753665695,0.618181818181818,1.76510695187166,763,372,391,13,1.1,97.14,9.1,0,0,0,0,0,0,0.000614194316101637,12.3533825769352,12.3501659263816
8.7,"random_instances_SVM","SVM",32,38,12,11,1,3900,3515,385,0.925235651445331,0.627272727272727,1.76673078531404,778,381,397,15,1,99.69,9.1,0,0,0,0,0,0,0.00063842626680982,1.07067551753549,1.07067551753549
8.7,"random_instances_SVM","SVM",32,39,0,0,0,3912,3526,386,0.92561531210725,0.627272727272727,1.76348610067618,776,382,394,-2,1,100,9.1,0,0,0,0,0,0,0,0,0
8.7,"random_instances_SVM","SVM",33,0,3812,3422,390,100,89,11,0.914733044532049,0.55609756097561,1.78517702596381,27,11,16,0,1.5,2.56,8.1,0,0,0,0,0,0,0.404179822711031,400.493228006006,46.7048926603172
8.7,"random_instances_SVM","SVM",33,1,3712,3338,374,200,173,27,0.920591717624771,0.614634146341463,1.74197359588275,61,27,34,34,1.3,5.11,6.4,0,0,0,0,0,0,0.691728667061809,506.379193433428,74.3663219777376
8.7,"random_instances_SVM","SVM",33,2,3612,3243,369,300,268,32,0.903160563301809,0.536585365853659,1.75555904593085,79,32,47,18,1.5,7.67,8.4,0,0,0,0,0,0,0.448737857369252,433.114193057832,52.4629755369752
8.7,"random_instances_SVM","SVM",33,3,3512,3152,360,400,359,41,0.915308325556134,0.580487804878049,1.72446632356232,96,41,55,17,1.3,10.22,8.8,0,0,0,0,0,0,0.473579632513888,373.400925551162,55.5018543897539
8.7,"random_instances_SVM","SVM",33,4,3412,3066,346,500,445,55,0.921949826579937,0.590243902439024,1.74752077191102,123,55,68,27,1.2,12.78,8.1,0,0,0,0,0,0,0.574050599155112,387.017010474039,63.8689128023627
8.7,"random_instances_SVM","SVM",33,5,3312,2976,336,600,535,65,0.921986042818742,0.595121951219512,1.75394548063128,141,65,76,18,1.2,15.34,8.2,0,0,0,0,0,0,0.721609765574709,374.715892126367,79.896678652302
8.7,"random_instances_SVM","SVM",33,6,3212,2886,326,700,625,75,0.916724937666287,0.619512195121951,1.73640602582496,168,75,93,27,1.2,17.89,8.3,0,0,0,0,0,0,0.70563427478324,361.980315881414,79.6378455536373
8.7,"random_instances_SVM","SVM",33,7,3112,2794,318,800,717,83,0.921791032302101,0.624390243902439,1.74517575322812,181,83,98,13,1.2,20.45,8.6,0,0,0,0,0,0,0.666200838386177,347.108668532776,75.6638280189096
8.7,"random_instances_SVM","SVM",33,8,3012,2704,308,900,807,93,0.927318187516539,0.614634146341463,1.73878316805146,199,93,106,18,1.1,23.01,8.7,0,0,0,0,0,0,0.733376047503184,332.324549238458,82.7711555790229
8.7,"random_instances_SVM","SVM",33,9,2912,2608,304,1000,903,97,0.927509019236394,0.629268292682927,1.74037691980953,208,97,111,9,1.1,25.56,9.3,0,0,0,0,0,0,0.636969595838693,297.684717986727,75.6314802812928
8.7,"random_instances_SVM","SVM",33,10,2812,2520,292,1100,991,109,0.927158000306445,0.629268292682927,1.74912253247189,234,109,125,26,1.1,28.12,9.1,0,0,0,0,0,0,0.675797029595925,286.060162330739,80.1123177775396
8.7,"random_instances_SVM","SVM",33,11,2712,2426,286,1200,1085,115,0.930012118510674,0.629268292682927,1.75717558280555,244,115,129,10,1.1,30.67,9.4,0,0,0,0,0,0,0.689413051598261,289.407105882663,81.2004164179769
8.7,"random_instances_SVM","SVM",33,12,2612,2335,277,1300,1176,124,0.92503795740413,0.648780487804878,1.75879509947173,267,124,143,23,1.2,33.23,9.5,0,0,0,0,0,0,0.650200993084946,265.700123496384,79.3224877197647
8.7,"random_instances_SVM","SVM",33,13,2512,2244,268,1400,1267,133,0.929406192976835,0.634146341463415,1.74197359588275,280,133,147,13,1.1,35.79,9.5,0,0,0,0,0,0,0.702320401047568,261.779873460738,82.0129109040751
8.7,"random_instances_SVM","SVM",33,14,2412,2156,256,1500,1355,145,0.929592845899903,0.639024390243902,1.74517575322812,304,145,159,24,1.1,38.34,9.3,0,0,0,0,0,0,0.661370459542852,248.013340940558,79.1889494282427
8.7,"random_instances_SVM","SVM",33,15,2312,2065,247,1600,1446,154,0.930726692760931,0.639024390243902,1.75879509947173,322,154,168,18,1.1,40.9,9.4,0,0,0,0,0,0,0.602385848183859,233.391263855983,73.8772853043992
8.7,"random_instances_SVM","SVM",33,16,2212,1973,239,1700,1538,162,0.933752141633351,0.653658536585366,1.7643368411605,340,162,178,18,1.1,43.46,9.5,0,0,0,0,0,0,0.647093673324317,229.567528744743,78.6998972065838
8.7,"random_instances_SVM","SVM",33,17,2112,1879,233,1800,1632,168,0.931382763856193,0.653658536585366,1.75394548063128,357,168,189,17,1.1,46.01,9.7,0,0,0,0,0,0,0.655350740128323,225.059551637637,80.1925342575807
8.7,"random_instances_SVM","SVM",33,18,2012,1785,227,1900,1726,174,0.933011101670123,0.653658536585366,1.75233487872069,367,174,193,10,1.1,48.57,9.9,0,0,0,0,0,0,0.679652559474216,220.679611930095,81.6822397180088
8.7,"random_instances_SVM","SVM",33,19,1912,1699,213,2000,1812,188,0.93262943823042,0.648780487804878,1.75233487872069,398,188,210,31,1.1,51.12,9.6,0,0,0,0,0,0,0.641125940756246,205.227122073365,79.0754405902511
8.7,"random_instances_SVM","SVM",33,20,1812,1611,201,2100,1900,200,0.932646153417561,0.64390243902439,1.75948086820318,423,200,223,25,1.1,53.68,9.5,0,0,0,0,0,0,0.629935213951401,195.264094374406,79.6342022263751
8.7,"random_instances_SVM","SVM",33,21,1712,1523,189,2200,1988,212,0.93334819127746,0.658536585365854,1.75394548063128,443,212,231,20,1.1,56.24,9.4,0,0,0,0,0,0,0.635638665974307,186.920735114597,81.3084907659168
8.7,"random_instances_SVM","SVM",33,22,1612,1436,176,2300,2075,225,0.935259294340517,0.653658536585366,1.75233487872069,467,225,242,24,1.1,58.79,9.2,0,0,0,0,0,0,0.550039039129912,163.42912664597,72.5938517349875
8.7,"random_instances_SVM","SVM",33,23,1512,1346,166,2400,2165,235,0.935660458831888,0.648780487804878,1.75555904593085,485,235,250,18,1.1,61.35,9.2,0,0,0,0,0,0,0.564806978736661,161.941679964184,74.9028794623617
8.7,"random_instances_SVM","SVM",33,24,1412,1262,150,2500,2249,251,0.936712122689474,0.653658536585366,1.76271520803443,522,251,271,37,1.1,63.91,9,0,0,0,0,0,0,0.473449451017918,148.315833648745,68.4555653214976
8.7,"random_instances_SVM","SVM",33,25,1312,1173,139,2600,2338,262,0.935278795392181,0.653658536585366,1.74752077191102,542,262,280,20,1.1,66.46,8.9,0,0,0,0,0,0,0.463528695277798,135.144235528221,71.6267394918675
8.7,"random_instances_SVM","SVM",33,26,1212,1083,129,2700,2428,272,0.936993495006338,0.64390243902439,1.75394548063128,565,272,293,23,1.1,69.02,8.9,0,0,0,0,0,0,0.430565994373889,124.818460569045,69.7045546637675
8.7,"random_instances_SVM","SVM",33,27,1112,996,116,2800,2515,285,0.937536738588403,0.648780487804878,1.76271520803443,589,285,304,24,1.1,71.57,8.8,0,0,0,0,0,0,0.408105575177166,113.551209637101,67.7478034602568
8.7,"random_instances_SVM","SVM",33,28,1012,910,102,2900,2601,299,0.93876948364001,0.653658536585366,1.77311463639015,617,299,318,28,1.1,74.13,8.7,0,0,0,0,0,0,0.385122380832871,103.819701305478,66.8153002531235
8.7,"random_instances_SVM","SVM",33,29,912,820,92,3000,2691,309,0.938862810101546,0.658536585365854,1.77474733863361,641,309,332,24,1.1,76.69,8.7,0,0,0,0,0,0,0.352169711536963,93.806283859565,62.9592616064269
8.7,"random_instances_SVM","SVM",33,30,812,728,84,3100,2783,317,0.93946316390634,0.653658536585366,1.77148493543759,653,317,336,12,1.1,79.24,8.8,0,0,0,0,0,0,0.264594384735799,80.8899711095551,57.5580894268143
8.7,"random_instances_SVM","SVM",33,31,712,638,74,3200,2873,327,0.940089983424108,0.658536585365854,1.77638305046645,675,327,348,22,1.1,81.8,8.8,0,0,0,0,0,0,0.208080958004731,68.9813692406237,53.2643626242637
8.7,"random_instances_SVM","SVM",33,32,612,544,68,3300,2967,333,0.939886615313899,0.658536585365854,1.76985822750789,690,333,357,15,1.1,84.36,8.9,0,0,0,0,0,0,0.171989982546993,62.5379779580099,49.6068251177824
8.7,"random_instances_SVM","SVM",33,33,512,452,60,3400,3059,341,0.939176219860432,0.668292682926829,1.77311463639015,702,341,361,12,1.1,86.91,9,0,0,0,0,0,0,0.124112231353702,53.1463538620429,43.0960722774967
8.7,"random_instances_SVM","SVM",33,34,412,361,51,3500,3150,350,0.939176219860432,0.653658536585366,1.76661375779661,722,350,372,20,1.1,89.47,9,0,0,0,0,0,0,0.0887930289095878,45.389687713909,40.0927040595744
8.7,"random_instances_SVM","SVM",33,35,312,273,39,3600,3238,362,0.939594099538941,0.648780487804878,1.76596146071958,745,362,383,23,1.1,92.02,8.9,0,0,0,0,0,0,0.0627001115281859,32.8420455670557,30.3283461338619
8.7,"random_instances_SVM","SVM",33,36,212,184,28,3700,3327,373,0.939493808416097,0.658536585365854,1.76985822750789,762,373,389,17,1,94.58,8.9,0,0,0,0,0,0,0.011597367651531,22.9145074170033,22.70192147284
8.7,"random_instances_SVM","SVM",33,37,112,95,17,3800,3416,384,0.939176219860429,0.658536585365854,1.76823450436339,785,384,401,23,1,97.14,8.9,0,0,0,0,0,0,0.000860197962322216,13.0340929981608,13.0298402687366
8.7,"random_instances_SVM","SVM",33,38,12,10,2,3900,3501,399,0.939922831552702,0.668292682926829,1.77148493543759,821,399,422,36,1.1,99.69,8.8,0,0,0,0,0,0,8.34791596574484e-05,1.36613442740792,1.36613442740792
8.7,"random_instances_SVM","SVM",33,39,0,0,0,3912,3511,401,0.940042623727207,0.668292682926829,1.77148493543759,822,401,421,1,1,100,8.8,0,0,0,0,0,0,0,0,0
8.7,"random_instances_SVM","SVM",34,0,3812,3408,404,100,92,8,0.892712124226213,0.5,1.70054634424438,28,8,20,0,2.5,2.56,11.5,0,0,0,0,0,0,0.156338876969005,312.260875318506,16.9257936909768
8.7,"random_instances_SVM","SVM",34,1,3712,3324,388,200,176,24,0.892636062581184,0.530927835051546,1.73133395813808,55,24,31,27,1.3,5.11,7.3,0,0,0,0,0,0,0.434130445604415,417.274555668526,47.917581450533
8.7,"random_instances_SVM","SVM",34,2,3612,3236,376,300,264,36,0.900368021344085,0.577319587628866,1.72342109726908,79,36,43,24,1.2,7.67,7.3,0,0,0,0,0,0,0.647828540347869,446.263684976001,70.8240681535891
8.7,"random_instances_SVM","SVM",34,3,3512,3147,365,400,353,47,0.890196239044211,0.56701030927835,1.72842415316642,114,47,67,35,1.4,10.22,7.5,0,0,0,0,0,0,0.803158082987624,451.862492447748,88.4644916007604
8.7,"random_instances_SVM","SVM",34,4,3412,3060,352,500,440,60,0.906842037515948,0.561855670103093,1.72207548777371,132,60,72,18,1.2,12.78,7.3,0,0,0,0,0,0,0.711917597770664,428.202731315099,79.6948698451566
8.7,"random_instances_SVM","SVM",34,5,3312,2967,345,600,533,67,0.900907766479046,0.551546391752577,1.7082645098821,151,67,84,19,1.3,15.34,8,0,0,0,0,0,0,0.638523584019722,400.823600345077,75.1040801611215
8.7,"random_instances_SVM","SVM",34,6,3212,2876,336,700,624,76,0.900722000538282,0.54639175257732,1.71596847466308,164,76,88,13,1.2,17.89,8.2,0,0,0,0,0,0,0.598322592425685,344.152021267151,70.8610749570049
8.7,"random_instances_SVM","SVM",34,7,3112,2789,323,800,711,89,0.902284189709446,0.54639175257732,1.71281701740933,190,89,101,26,1.1,20.45,8,0,0,0,0,0,0,0.678903776730341,349.538512633328,78.1450005259695
8.7,"random_instances_SVM","SVM",34,8,3012,2697,315,900,803,97,0.901671308377313,0.54639175257732,1.71754855613146,213,97,116,23,1.2,23.01,8.3,0,0,0,0,0,0,0.747433051823433,335.456459150096,84.0660480927893
8.7,"random_instances_SVM","SVM",34,9,2912,2603,309,1000,897,103,0.903805422610198,0.572164948453608,1.69274567294051,225,103,122,12,1.2,25.56,8.7,0,0,0,0,0,0,0.702931335902384,308.867264821584,80.5418628936734
8.7,"random_instances_SVM","SVM",34,10,2812,2514,298,1100,986,114,0.90691809916098,0.56701030927835,1.73451948519997,246,114,132,21,1.2,28.12,8.6,0,0,0,0,0,0,0.665757541698871,303.828430800404,77.1613039290961
8.7,"random_instances_SVM","SVM",34,11,2712,2422,290,1200,1078,122,0.906660659747008,0.572164948453608,1.73771675614043,265,122,143,19,1.2,30.67,8.8,0,0,0,0,0,0,0.74654097793501,302.682673247174,84.8443240032741
8.7,"random_instances_SVM","SVM",34,12,2612,2331,281,1300,1169,131,0.908178967199882,0.56701030927835,1.72049560200511,282,131,151,17,1.2,33.23,8.9,0,0,0,0,0,0,0.723960832489008,288.058039435548,83.848752732638
8.7,"random_instances_SVM","SVM",34,13,2512,2244,268,1400,1256,144,0.910981546274735,0.56701030927835,1.74985089886683,302,144,158,20,1.1,35.79,8.7,0,0,0,0,0,0,0.714796616252054,272.738678477891,83.2328377974666
8.7,"random_instances_SVM","SVM",34,14,2412,2158,254,1500,1342,158,0.912242414313628,0.561855670103093,1.74824553106971,327,158,169,25,1.1,38.34,8.5,0,0,0,0,0,0,0.755226742843355,267.987772228207,86.1999384970706
8.7,"random_instances_SVM","SVM",34,15,2312,2066,246,1600,1434,166,0.912533496378294,0.56701030927835,1.75468474112889,346,166,180,19,1.1,40.9,8.6,0,0,0,0,0,0,0.699870096773656,244.903045213969,82.4596234257311
8.7,"random_instances_SVM","SVM",34,16,2212,1975,237,1700,1525,175,0.91260955802333,0.577319587628866,1.75468474112889,361,175,186,15,1.1,43.46,8.7,0,0,0,0,0,0,0.68458734178407,235.93369379328,81.7404754466324
8.7,"random_instances_SVM","SVM",34,17,2112,1883,229,1800,1617,183,0.91320634939209,0.572164948453608,1.7514592177077,376,183,193,15,1.1,46.01,8.8,0,0,0,0,0,0,0.723446956177856,227.633912349703,83.7975693872132
8.7,"random_instances_SVM","SVM",34,18,2012,1793,219,1900,1707,193,0.913023508899209,0.56701030927835,1.75468474112889,400,193,207,24,1.1,48.57,8.8,0,0,0,0,0,0,0.716152386333059,218.739977285567,84.7956344144332
8.7,"random_instances_SVM","SVM",34,19,1912,1705,207,2000,1795,205,0.913672958329915,0.572164948453608,1.75307049573687,420,204,216,20,1.1,51.12,8.8,0,0,0,0,0,0,0.66270648801186,205.737071414874,80.229881624885
8.7,"random_instances_SVM","SVM",34,20,1812,1613,199,2100,1887,213,0.913936248639663,0.572164948453608,1.74985089886683,433,211,222,13,1.1,53.68,8.9,0,0,0,0,0,0,0.639904445223396,193.322788275358,79.3400070879132
8.7,"random_instances_SVM","SVM",34,21,1712,1525,187,2200,1975,225,0.915170787647575,0.572164948453608,1.74985089886683,455,222,233,22,1,56.24,8.8,0,0,0,0,0,0,0.618133344894654,183.360478190651,76.942356345324
8.7,"random_instances_SVM","SVM",34,22,1612,1434,178,2300,2066,234,0.916007465742996,0.572164948453608,1.75307049573687,479,232,247,24,1.1,58.79,8.8,0,0,0,0,0,0,0.64642802591303,174.463732499943,80.5213447863946
8.7,"random_instances_SVM","SVM",34,23,1512,1341,171,2400,2159,241,0.915849491557146,0.577319587628866,1.74985089886683,491,240,251,12,1,61.35,9,0,0,0,0,0,0,0.622004185809048,164.238736207119,79.3801262606564
8.7,"random_instances_SVM","SVM",34,24,1412,1249,163,2500,2251,249,0.913950875879084,0.577319587628866,1.7514592177077,508,248,260,17,1,63.91,9,0,0,0,0,0,0,0.616755128664271,158.80285879477,80.1374973322593
8.7,"random_instances_SVM","SVM",34,25,1312,1164,148,2600,2336,264,0.915931404097962,0.582474226804124,1.75307049573687,539,262,277,31,1.1,66.46,8.8,0,0,0,0,0,0,0.61007653468619,149.116710804201,80.0885509063449
8.7,"random_instances_SVM","SVM",34,26,1212,1081,131,2700,2419,281,0.916615958903302,0.582474226804124,1.74985089886683,572,277,295,33,1.1,69.02,8.6,0,0,0,0,0,0,0.536098789186545,131.639606893197,74.9246921043418
8.7,"random_instances_SVM","SVM",34,27,1112,992,120,2800,2508,292,0.917326842739614,0.587628865979381,1.75307049573687,595,290,305,23,1.1,71.57,8.6,0,0,0,0,0,0,0.516468393051581,121.217473345022,74.4655562354499
8.7,"random_instances_SVM","SVM",34,28,1012,901,111,2900,2599,301,0.916740290438459,0.577319587628866,1.74824553106971,613,298,315,18,1.1,74.13,8.6,0,0,0,0,0,0,0.477399308894591,111.030860069601,72.060413452506
8.7,"random_instances_SVM","SVM",34,29,912,807,105,3000,2693,307,0.91722884023543,0.582474226804124,1.74824553106971,624,304,320,11,1.1,76.69,8.8,0,0,0,0,0,0,0.437594597451203,100.729384818556,67.67918361602
8.7,"random_instances_SVM","SVM",34,30,812,714,98,3100,2786,314,0.918438512936324,0.592783505154639,1.75307049573687,639,312,327,15,1,79.24,8.9,0,0,0,0,0,0,0.429517945478558,96.0856898524714,70.0075086726262
8.7,"random_instances_SVM","SVM",34,31,712,625,87,3200,2875,325,0.918207402553325,0.592783505154639,1.74824553106971,661,323,338,22,1,81.8,8.8,0,0,0,0,0,0,0.367662752097853,86.5131694636057,67.6904553346988
8.7,"random_instances_SVM","SVM",34,32,612,532,80,3300,2968,332,0.918451677451805,0.597938144329897,1.7514592177077,672,328,344,11,1,84.36,8.9,0,0,0,0,0,0,0.279399019958302,78.0399803990768,64.2863085288042
8.7,"random_instances_SVM","SVM",34,33,512,443,69,3400,3057,343,0.919140620428978,0.587628865979381,1.7514592177077,692,338,354,20,1,86.91,8.9,0,0,0,0,0,0,0.145259437483371,65.6351746006459,56.8398470073016
8.7,"random_instances_SVM","SVM",34,34,412,358,54,3500,3142,358,0.920174766256704,0.592783505154639,1.74824553106971,714,347,367,22,1.1,89.47,8.8,0,0,0,0,0,0,0.0819531711522677,52.1601486129923,46.7542210826257
8.7,"random_instances_SVM","SVM",34,35,312,270,42,3600,3230,370,0.919443404285185,0.587628865979381,1.74219223771983,730,356,374,16,1.1,92.02,8.7,0,0,0,0,0,0,0.0512278791210122,38.7974696314073,36.2298821528429
8.7,"random_instances_SVM","SVM",34,36,212,183,29,3700,3317,383,0.92038686122844,0.582474226804124,1.74379499046842,759,369,390,29,1.1,94.58,8.7,0,0,0,0,0,0,0.0300459943418941,26.8894621458011,26.2655750061125
8.7,"random_instances_SVM","SVM",34,37,112,95,17,3800,3405,395,0.920651614262133,0.592783505154639,1.75468474112889,783,380,403,24,1.1,97.14,8.6,0,0,0,0,0,0,0.00121606988985862,13.8054710386271,13.7975909369424
8.7,"random_instances_SVM","SVM",34,38,12,9,3,3900,3491,409,0.920936845431026,0.587628865979381,1.76234600100532,806,393,413,23,1.1,99.69,8.5,0,0,0,0,0,0,0.000330201687718138,1.73748555418069,1.73748555418069
8.7,"random_instances_SVM","SVM",34,39,0,0,0,3912,3500,412,0.921333243619589,0.587628865979381,1.76396878737825,811,394,417,5,1.1,100,8.5,0,0,0,0,0,0,0,0,0
8.7,"random_instances_SVM","SVM",35,0,3812,3433,379,100,91,9,0.877318651618951,0.440366972477064,1.77795628461506,36,9,27,0,3,2.56,10.1,0,0,0,0,0,0,0.0972761610448968,347.746257061292,9.86904056021919
8.7,"random_instances_SVM","SVM",35,1,3712,3348,364,200,176,24,0.898359392320604,0.559633027522936,1.72006933581364,65,24,41,29,1.7,5.11,7.3,0,0,0,0,0,0,0.407737680690655,368.718516819439,55.4954949199332
8.7,"random_instances_SVM","SVM",35,2,3612,3263,349,300,261,39,0.931914517372058,0.63302752293578,1.77803215217574,87,39,48,22,1.2,7.67,6.7,0,0,0,0,0,0,0.644870610307351,431.316991301186,71.6177501206894
8.7,"random_instances_SVM","SVM",35,3,3512,3174,338,400,350,50,0.933127289618968,0.642201834862385,1.77640242518016,107,50,57,20,1.1,10.22,7,0,0,0,0,0,0,0.5,363.306939441391,56.3014280657929
8.7,"random_instances_SVM","SVM",35,4,3412,3083,329,500,441,59,0.934022022571539,0.665137614678899,1.7453311549579,134,59,75,27,1.3,12.78,7.5,0,0,0,0,0,0,0.658972610587683,351.171931571149,75.7982272874358
8.7,"random_instances_SVM","SVM",35,5,3312,2987,325,600,537,63,0.931018464754374,0.646788990825688,1.75173016927488,144,63,81,10,1.3,15.34,8.5,0,0,0,0,0,0,0.575029967463212,308.347137770575,68.1757107938737
8.7,"random_instances_SVM","SVM",35,6,3212,2894,318,700,630,70,0.934238447651505,0.642201834862385,1.7698005218416,158,70,88,14,1.3,17.89,9,0,0,0,0,0,0,0.5279404079515,296.833532212279,63.4826009786363
8.7,"random_instances_SVM","SVM",35,7,3112,2798,314,800,726,74,0.93268916079854,0.660550458715596,1.74831354560173,170,74,96,12,1.3,20.45,9.8,0,0,0,0,0,0,0.506329973688872,256.585860131884,64.7666854564119
8.7,"random_instances_SVM","SVM",35,8,3012,2707,305,900,817,83,0.93211510647057,0.669724770642202,1.74831354560173,187,83,104,17,1.3,23.01,9.8,0,0,0,0,0,0,0.550953945072427,251.968081906782,68.5600808997444
8.7,"random_instances_SVM","SVM",35,9,2912,2617,295,1000,907,93,0.93322494483798,0.674311926605505,1.7698005218416,212,93,119,25,1.3,25.56,9.8,0,0,0,0,0,0,0.529395817768384,259.414930849194,67.3278740097565
8.7,"random_instances_SVM","SVM",35,10,2812,2524,288,1100,1000,100,0.934334783205397,0.669724770642202,1.75979522530285,225,100,125,13,1.2,28.12,10,0,0,0,0,0,0,0.479587047071488,237.094238495367,62.3120605141048
8.7,"random_instances_SVM","SVM",35,11,2712,2433,279,1200,1091,109,0.934365135503205,0.68348623853211,1.75314759227159,235,109,126,10,1.2,30.67,10,0,0,0,0,0,0,0.539560743544142,227.424770117277,67.8128689108297
8.7,"random_instances_SVM","SVM",35,12,2612,2346,266,1300,1178,122,0.934254283632975,0.701834862385321,1.76141715638608,265,122,143,30,1.2,33.23,9.7,0,0,0,0,0,0,0.59862584922417,240.470555536866,72.6764245512399
8.7,"random_instances_SVM","SVM",35,13,2512,2261,251,1400,1263,137,0.930247780323249,0.660550458715596,1.74670811534865,296,137,159,31,1.2,35.79,9.2,0,0,0,0,0,0,0.660808090447423,244.824550267777,78.4502466952487
8.7,"random_instances_SVM","SVM",35,14,2412,2177,235,1500,1347,153,0.933599729732566,0.669724770642202,1.75656030760928,324,153,171,28,1.1,38.34,8.8,0,0,0,0,0,0,0.727376267767586,247.384353452547,83.2071083910275
8.7,"random_instances_SVM","SVM",35,15,2312,2087,225,1600,1437,163,0.935420867600621,0.678899082568807,1.75656030760928,345,163,182,21,1.1,40.9,8.8,0,0,0,0,0,0,0.685470599035981,233.766954788846,82.8311626866533
8.7,"random_instances_SVM","SVM",35,16,2212,2003,209,1700,1521,179,0.936896253206769,0.68348623853211,1.7533372611733,374,179,195,29,1.1,43.46,8.5,0,0,0,0,0,0,0.684815322717112,225.194853942859,82.393811491001
8.7,"random_instances_SVM","SVM",35,17,2112,1914,198,1800,1610,190,0.940578118896536,0.692660550458716,1.76480706961684,398,190,208,24,1.1,46.01,8.5,0,0,0,0,0,0,0.646636439369407,209.022710588656,79.3329854269931
8.7,"random_instances_SVM","SVM",35,18,2012,1825,187,1900,1699,201,0.938619735855816,0.68348623853211,1.77142568301868,421,201,220,23,1.1,48.57,8.5,0,0,0,0,0,0,0.596004750566328,191.994601607174,75.3613402055145
8.7,"random_instances_SVM","SVM",35,19,1912,1736,176,2000,1788,212,0.937041416370167,0.674311926605505,1.76156889150745,436,212,224,15,1.1,51.12,8.4,0,0,0,0,0,0,0.538617987154578,180.657029545725,71.7811003042845
8.7,"random_instances_SVM","SVM",35,20,1812,1653,159,2100,1871,229,0.937471627199869,0.669724770642202,1.76643062717858,470,229,241,34,1.1,53.68,8.2,0,0,0,0,0,0,0.590169679435868,181.625314485662,76.6529309411904
8.7,"random_instances_SVM","SVM",35,21,1712,1561,151,2200,1963,237,0.937426758585726,0.669724770642202,1.76805717471742,489,237,252,19,1.1,56.24,8.3,0,0,0,0,0,0,0.627616302881711,174.097036067083,80.0720396126043
8.7,"random_instances_SVM","SVM",35,22,1612,1470,142,2300,2054,246,0.938565629585822,0.678899082568807,1.76805717471742,508,246,262,19,1.1,58.79,8.3,0,0,0,0,0,0,0.57566918425919,163.941089733838,75.7467326210753
8.7,"random_instances_SVM","SVM",35,23,1512,1379,133,2400,2145,255,0.940205973332194,0.674311926605505,1.76643062717858,527,255,272,19,1.1,61.35,8.4,0,0,0,0,0,0,0.55048352279247,149.643445789834,76.3563968930426
8.7,"random_instances_SVM","SVM",35,24,1412,1289,123,2500,2235,265,0.940960821781849,0.688073394495413,1.77631912413199,544,265,279,17,1.1,63.91,8.4,0,0,0,0,0,0,0.5,139.134779360966,70.9652887649893
8.7,"random_instances_SVM","SVM",35,25,1312,1197,115,2600,2327,273,0.940731200050661,0.692660550458716,1.76318649379533,563,273,290,19,1.1,66.46,8.5,0,0,0,0,0,0,0.506871996011067,131.330887774333,72.817018198553
8.7,"random_instances_SVM","SVM",35,26,1212,1107,105,2700,2417,283,0.940504217649714,0.688073394495413,1.77142568301868,587,283,304,24,1.1,69.02,8.5,0,0,0,0,0,0,0.510666994626817,122.338923785419,73.2567792178327
8.7,"random_instances_SVM","SVM",35,27,1112,1012,100,2800,2512,288,0.939754647860546,0.68348623853211,1.76805717471742,596,288,308,9,1.1,71.57,8.7,0,0,0,0,0,0,0.466041912611804,112.525081407614,71.0879008268609
8.7,"random_instances_SVM","SVM",35,28,1012,923,89,2900,2601,299,0.939522386799112,0.678899082568807,1.7681783398784,615,299,316,19,1.1,74.13,8.7,0,0,0,0,0,0,0.36054089121973,98.6761251737779,64.5571756538405
8.7,"random_instances_SVM","SVM",35,29,912,829,83,3000,2695,305,0.937561364428148,0.669724770642202,1.76141715638608,627,305,322,12,1.1,76.69,8.8,0,0,0,0,0,0,0.348179761138794,90.5019206538298,64.7191062999372
8.7,"random_instances_SVM","SVM",35,30,812,734,78,3100,2790,310,0.938300376896347,0.674311926605505,1.75995425457664,640,310,330,13,1.1,79.24,9,0,0,0,0,0,0,0.271241871932161,79.2635365441176,57.8380326368836
8.7,"random_instances_SVM","SVM",35,31,712,643,69,3200,2881,319,0.937284234752573,0.674311926605505,1.76643062717858,657,319,338,17,1.1,81.8,9,0,0,0,0,0,0,0.233819433472433,69.4327774858776,54.6890185302739
8.7,"random_instances_SVM","SVM",35,32,612,550,62,3300,2974,326,0.936748450713133,0.674311926605505,1.75494730457199,672,326,346,15,1.1,84.36,9.1,0,0,0,0,0,0,0.170365938520056,60.9132287898504,49.5176667219717
8.7,"random_instances_SVM","SVM",35,33,512,461,51,3400,3063,337,0.93644228840488,0.68348623853211,1.7533372611733,697,337,360,25,1.1,86.91,9.1,0,0,0,0,0,0,0.108690689158197,51.2346533782672,43.3845265217498
8.7,"random_instances_SVM","SVM",35,34,412,370,42,3500,3154,346,0.937603593712047,0.68348623853211,1.74692652164433,708,346,362,11,1,89.47,9.1,0,0,0,0,0,0,0.0745784881501717,40.6344971452009,36.576106674146
8.7,"random_instances_SVM","SVM",35,35,312,280,32,3600,3244,356,0.93585899642105,0.678899082568807,1.75012602076822,732,356,376,24,1.1,92.02,9.1,0,0,0,0,0,0,0.0371878379770671,27.5908631679257,26.3269133621305
8.7,"random_instances_SVM","SVM",35,36,212,187,25,3700,3337,363,0.935814127806907,0.68348623853211,1.76141715638608,746,363,383,14,1.1,94.58,9.2,0,0,0,0,0,0,0.0112799852422745,19.9964971011431,19.7322090836303
8.7,"random_instances_SVM","SVM",35,37,112,98,14,3800,3426,374,0.936466042377067,0.68348623853211,1.76643062717858,777,374,403,31,1.1,97.14,9.2,0,0,0,0,0,0,0.000435670598172582,11.2968369225706,11.2945200209064
8.7,"random_instances_SVM","SVM",35,38,12,11,1,3900,3513,387,0.938098468132708,0.688073394495413,1.7698005218416,795,387,408,18,1.1,99.69,9.1,0,0,0,0,0,0,0.000229815517065065,0.341869902672816,0.341869902672816
8.7,"random_instances_SVM","SVM",35,39,0,0,0,3912,3524,388,0.93821063966806,0.688073394495413,1.77142568301868,798,388,410,3,1.1,100,9.1,0,0,0,0,0,0,0,0,0
8.7,"random_instances_SVM","SVM",36,0,3812,3413,399,100,91,9,0.892885050734876,0.505050505050505,1.75663139182846,24,9,15,0,1.7,2.56,10.1,0,0,0,0,0,0,0.651123089206591,353.962972401427,75.7077147022456
8.7,"random_instances_SVM","SVM",36,1,3712,3329,383,200,175,25,0.903066501189359,0.555555555555556,1.7417146673345,55,25,30,31,1.2,5.11,7,0,0,0,0,0,0,0.912390564964672,528.462567580435,94.3941112906497
8.7,"random_instances_SVM","SVM",36,2,3612,3237,375,300,267,33,0.909017650911861,0.595959595959596,1.7251559714795,74,33,41,19,1.2,7.67,8.1,0,0,0,0,0,0,0.724308709454285,415.626554429431,80.2984062526457
8.7,"random_instances_SVM","SVM",36,3,3512,3151,361,400,353,47,0.909495983728067,0.585858585858586,1.73423573975045,107,47,60,33,1.3,10.22,7.5,0,0,0,0,0,0,0.77616323747894,460.438041038511,83.3455342211604
8.7,"random_instances_SVM","SVM",36,4,3412,3062,350,500,442,58,0.919635777570924,0.560606060606061,1.74597624597625,128,58,70,21,1.2,12.78,7.6,0,0,0,0,0,0,0.699107483653805,387.336992409199,77.0652943162258
8.7,"random_instances_SVM","SVM",36,5,3312,2968,344,600,536,64,0.917506981073527,0.560606060606061,1.75239527629233,137,64,73,9,1.1,15.34,8.4,0,0,0,0,0,0,0.772744533582562,387.839053251246,83.3051123508979
8.7,"random_instances_SVM","SVM",36,6,3212,2877,335,700,627,73,0.923518461061115,0.601010101010101,1.75985752845257,162,73,89,25,1.2,17.89,8.6,0,0,0,0,0,0,0.710305189173238,357.323991477964,79.0446591782203
8.7,"random_instances_SVM","SVM",36,7,3112,2789,323,800,715,85,0.92738821663736,0.595959595959596,1.75824298026133,185,85,100,23,1.2,20.45,8.4,0,0,0,0,0,0,0.825499390419992,363.641793678722,88.5025189725835
8.7,"random_instances_SVM","SVM",36,8,3012,2694,318,900,810,90,0.926951540432764,0.606060606060606,1.75663139182846,196,90,106,11,1.2,23.01,9,0,0,0,0,0,0,0.588202937416838,293.795200627765,68.2166415069344
8.7,"random_instances_SVM","SVM",36,9,2912,2606,306,1000,898,102,0.927794727709395,0.606060606060606,1.76147504456328,221,102,119,25,1.2,25.56,8.8,0,0,0,0,0,0,0.715223771325587,305.790447792837,79.7308651419884
8.7,"random_instances_SVM","SVM",36,10,2812,2510,302,1100,994,106,0.926230450121228,0.601010101010101,1.7647190133378,228,106,122,7,1.2,28.12,9.4,0,0,0,0,0,0,0.730301523956838,279.293786091008,82.5125105696885
8.7,"random_instances_SVM","SVM",36,11,2712,2421,291,1200,1083,117,0.925477758242256,0.616161616161616,1.75562252357832,255,117,138,27,1.2,30.67,9.3,0,0,0,0,0,0,0.657229382918043,268.465196716361,77.4321219373657
8.7,"random_instances_SVM","SVM",36,12,2612,2334,278,1300,1170,130,0.926888337297888,0.611111111111111,1.76309553678459,280,130,150,25,1.2,33.23,9,0,0,0,0,0,0,0.701346297011954,266.303399351816,80.7502751724712
8.7,"random_instances_SVM","SVM",36,13,2512,2249,263,1400,1255,145,0.928436814102335,0.616161616161616,1.76568619281727,309,145,164,29,1.1,35.79,8.7,0,0,0,0,0,0,0.716216308439508,265.322905423672,82.0342416329738
8.7,"random_instances_SVM","SVM",36,14,2412,2164,248,1500,1340,160,0.930901736362482,0.601010101010101,1.76147504456328,337,160,177,28,1.1,38.34,8.4,0,0,0,0,0,0,0.718002933637481,256.091912932233,81.9457797497444
8.7,"random_instances_SVM","SVM",36,15,2312,2072,240,1600,1432,168,0.931846910515849,0.606060606060606,1.75562252357832,349,168,181,12,1.1,40.9,8.5,0,0,0,0,0,0,0.739008883117422,253.166184204479,82.9039820506048
8.7,"random_instances_SVM","SVM",36,16,2212,1983,229,1700,1521,179,0.931134438813615,0.601010101010101,1.76406926406926,375,179,196,26,1.1,43.46,8.5,0,0,0,0,0,0,0.736429707628001,241.305663416842,85.0566260793096
8.7,"random_instances_SVM","SVM",36,17,2112,1891,221,1800,1613,187,0.93018639179048,0.621212121212121,1.75502275502276,389,187,202,14,1.1,46.01,8.6,0,0,0,0,0,0,0.703252926399507,228.616243876862,83.7819216080194
8.7,"random_instances_SVM","SVM",36,18,2012,1798,214,1900,1706,194,0.929091828409227,0.626262626262626,1.76147504456328,408,194,214,19,1.1,48.57,8.8,0,0,0,0,0,0,0.734546445543403,218.457323394807,86.6531090257817
8.7,"random_instances_SVM","SVM",36,19,1912,1709,203,2000,1795,205,0.931426035094971,0.631313131313131,1.77055481283422,428,205,223,20,1.1,51.12,8.8,0,0,0,0,0,0,0.593873192825914,200.356833452029,75.8723337087951
8.7,"random_instances_SVM","SVM",36,20,1812,1620,192,2100,1884,216,0.929801427241693,0.621212121212121,1.76147504456328,449,216,233,21,1.1,53.68,8.7,0,0,0,0,0,0,0.664213107635766,201.039376610201,83.4879110401728
8.7,"random_instances_SVM","SVM",36,21,1712,1526,186,2200,1978,222,0.930523953988113,0.626262626262626,1.74597624597625,466,222,244,17,1.1,56.24,8.9,0,0,0,0,0,0,0.629015683032652,189.953012227723,80.0772004691641
8.7,"random_instances_SVM","SVM",36,22,1612,1437,175,2300,2067,233,0.931533767711234,0.626262626262626,1.77545035609552,487,233,254,21,1.1,58.79,8.9,0,0,0,0,0,0,0.614495797970505,176.248657664202,79.6468774166109
8.7,"random_instances_SVM","SVM",36,23,1512,1346,166,2400,2158,242,0.931885694257698,0.631313131313131,1.77963458110517,505,242,263,18,1.1,61.35,8.9,0,0,0,0,0,0,0.6387546446017,174.83291782222,81.8158728803527
8.7,"random_instances_SVM","SVM",36,24,1412,1260,152,2500,2244,256,0.932562255087843,0.626262626262626,1.78127177943185,532,256,276,27,1.1,63.91,8.8,0,0,0,0,0,0,0.604317130305161,159.175167024557,79.1227009621871
8.7,"random_instances_SVM","SVM",36,25,1312,1167,145,2600,2337,263,0.93191442295537,0.631313131313131,1.77963458110517,544,263,281,12,1.1,66.46,8.9,0,0,0,0,0,0,0.590640804210769,150.348435895266,77.1855713320772
8.7,"random_instances_SVM","SVM",36,26,1212,1079,133,2700,2425,275,0.932069557922792,0.636363636363636,1.78291199285674,567,275,292,23,1.1,69.02,8.8,0,0,0,0,0,0,0.620036075333968,142.237150128952,80.2550749397906
8.7,"random_instances_SVM","SVM",36,27,1112,984,128,2800,2520,280,0.932315188287879,0.631313131313131,1.78127177943185,577,280,297,10,1.1,71.57,9,0,0,0,0,0,0,0.595524159566786,134.296971861649,78.2823880354927
8.7,"random_instances_SVM","SVM",36,28,1012,895,117,2900,2609,291,0.929252709116182,0.631313131313131,1.76730608840701,603,291,312,26,1.1,74.13,9,0,0,0,0,0,0,0.545804815210931,118.045528124616,74.4328620022821
8.7,"random_instances_SVM","SVM",36,29,912,806,106,3000,2698,302,0.930002528125388,0.621212121212121,1.77545035609552,623,302,321,20,1.1,76.69,8.9,0,0,0,0,0,0,0.431988424474032,100.248735237177,68.3027991843508
8.7,"random_instances_SVM","SVM",36,30,812,724,88,3100,2780,320,0.930844278967139,0.616161616161616,1.77381550309727,663,320,343,40,1.1,79.24,8.7,0,0,0,0,0,0,0.35661964785845,93.8374380390957,68.3798104119698
8.7,"random_instances_SVM","SVM",36,31,712,638,74,3200,2866,334,0.931240734994994,0.621212121212121,1.77963458110517,681,331,350,18,1.1,81.8,8.6,0,0,0,0,0,0,0.270306810068127,78.3855020349467,60.2379390988597
8.7,"random_instances_SVM","SVM",36,32,612,545,67,3300,2959,341,0.931559623539136,0.616161616161616,1.78291199285674,688,336,352,7,1,84.36,8.7,0,0,0,0,0,0,0.206695044934113,68.5896907962321,54.6633162932769
8.7,"random_instances_SVM","SVM",36,33,512,455,57,3400,3049,351,0.931723377115861,0.616161616161616,1.78127177943185,713,348,365,25,1,86.91,8.7,0,0,0,0,0,0,0.153991317165129,61.7453264643999,52.3954293297708
8.7,"random_instances_SVM","SVM",36,34,412,365,47,3500,3139,361,0.93147056457636,0.626262626262626,1.77800038957064,729,358,371,16,1,89.47,8.7,0,0,0,0,0,0,0.0936228880311057,48.6397320830487,42.9225961508646
8.7,"random_instances_SVM","SVM",36,35,312,280,32,3600,3224,376,0.933145447650567,0.626262626262626,1.79366010333752,761,373,388,32,1,92.02,8.6,0,0,0,0,0,0,0.0570046276356177,36.3537312017827,34.0470158155162
8.7,"random_instances_SVM","SVM",36,36,212,189,23,3700,3315,385,0.935291481366568,0.631313131313131,1.79200848261622,772,381,391,11,1,94.58,8.6,0,0,0,0,0,0,0.0143533793708906,26.7429817739784,26.36523481815
8.7,"random_instances_SVM","SVM",36,37,112,98,14,3800,3406,394,0.935228278231692,0.636363636363636,1.79035990075548,799,391,408,27,1,97.14,8.6,0,0,0,0,0,0,0.00114405194761181,14.5526070522082,14.5466859225231
8.7,"random_instances_SVM","SVM",36,38,12,7,5,3900,3497,403,0.935412141896784,0.636363636363636,1.79366010333752,818,401,417,19,1,99.69,8.7,0,0,0,0,0,0,0.000187583556840508,3.74227790727087,3.74227790727087
8.7,"random_instances_SVM","SVM",36,39,0,0,0,3912,3504,408,0.935380540329347,0.636363636363636,1.79200848261622,822,404,418,4,1,100,8.6,0,0,0,0,0,0,0,0,0
8.7,"random_instances_SVM","SVM",37,0,3812,3417,395,100,89,11,0.900808656036458,0.505,1.75769585253456,33,11,22,0,2,2.56,8.1,0,0,0,0,0,0,0.26322907211477,405.478133580062,30.8796965028928
8.7,"random_instances_SVM","SVM",37,1,3712,3333,379,200,173,27,0.93193621867882,0.62,1.77492208982585,63,27,36,30,1.3,5.11,6.4,0,0,0,0,0,0,0.762018951035058,452.990602949061,80.4029159653198
8.7,"random_instances_SVM","SVM",37,2,3612,3242,370,300,264,36,0.93314635535308,0.635,1.7732967032967,80,36,44,17,1.2,7.67,7.3,0,0,0,0,0,0,0.6653820842265,427.087025989472,71.5536201261912
8.7,"random_instances_SVM","SVM",37,3,3512,3152,360,400,354,46,0.938090831435084,0.645,1.79120879120879,102,46,56,22,1.2,10.22,7.7,0,0,0,0,0,0,0.716223176574896,397.788091260875,76.6637662309001
8.7,"random_instances_SVM","SVM",37,4,3412,3066,346,500,440,60,0.942972665148071,0.63,1.78716253443526,130,60,70,28,1.2,12.78,7.3,0,0,0,0,0,0,0.743525460943885,430.998716722948,80.6208782887217
8.7,"random_instances_SVM","SVM",37,5,3312,2975,337,600,531,69,0.944424829157183,0.64,1.79045078196872,149,69,80,19,1.2,15.34,7.7,0,0,0,0,0,0,0.729232083157401,413.170911921723,79.4277117505426
8.7,"random_instances_SVM","SVM",37,6,3212,2882,330,700,624,76,0.942047266514808,0.635,1.79944802207912,170,76,94,21,1.2,17.89,8.2,0,0,0,0,0,0,0.698438425969923,357.08527888856,77.6468077048832
8.7,"random_instances_SVM","SVM",37,7,3112,2790,322,800,716,84,0.942146924829158,0.64,1.80276497695853,193,84,109,23,1.3,20.45,8.5,0,0,0,0,0,0,0.655428009223359,336.785202003034,74.7590020434841
8.7,"random_instances_SVM","SVM",37,8,3012,2693,319,900,813,87,0.938673120728928,0.63,1.79120879120879,198,87,111,5,1.3,23.01,9.3,0,0,0,0,0,0,0.569462784386863,288.877263895207,69.8161968554613
8.7,"random_instances_SVM","SVM",37,9,2912,2603,309,1000,903,97,0.937144077448748,0.645,1.79120879120879,222,97,125,24,1.3,25.56,9.3,0,0,0,0,0,0,0.616830531635218,286.465566323988,74.6822455361965
8.7,"random_instances_SVM","SVM",37,10,2812,2515,297,1100,991,109,0.942297835990891,0.645,1.79944802207912,248,109,139,26,1.3,28.12,9.1,0,0,0,0,0,0,0.623326251263423,286.204543146768,74.7438859787039
8.7,"random_instances_SVM","SVM",37,11,2712,2429,283,1200,1077,123,0.944886104783602,0.635,1.79614325068871,272,123,149,24,1.2,30.67,8.8,0,0,0,0,0,0,0.600319482294617,276.654087206412,71.2730232598402
8.7,"random_instances_SVM","SVM",37,12,2612,2335,277,1300,1171,129,0.946520501138957,0.645,1.79944802207912,286,129,157,14,1.2,33.23,9.1,0,0,0,0,0,0,0.737737058344885,284.292188075894,83.0515961484733
8.7,"random_instances_SVM","SVM",37,13,2512,2249,263,1400,1257,143,0.946190205011392,0.63,1.79209944751381,315,143,172,29,1.2,35.79,8.8,0,0,0,0,0,0,0.764207734246731,280.285182097175,85.3215823828227
8.7,"random_instances_SVM","SVM",37,14,2412,2161,251,1500,1345,155,0.946392369020505,0.63,1.79045078196872,334,155,179,19,1.2,38.34,8.7,0,0,0,0,0,0,0.74869435150235,267.559062725118,84.2551486912798
8.7,"random_instances_SVM","SVM",37,15,2312,2075,237,1600,1431,169,0.94446184510251,0.63,1.78716253443526,365,169,196,31,1.2,40.9,8.5,0,0,0,0,0,0,0.715313377547693,249.578036296484,82.773131615673
8.7,"random_instances_SVM","SVM",37,16,2212,1986,226,1700,1520,180,0.945680523918002,0.635,1.79375115207373,391,180,211,26,1.2,43.46,8.4,0,0,0,0,0,0,0.731614973495991,248.067466951976,84.1898043528052
8.7,"random_instances_SVM","SVM",37,17,2112,1896,216,1800,1610,190,0.946124715261964,0.645,1.78880514705882,407,190,217,16,1.1,46.01,8.5,0,0,0,0,0,0,0.76519683024411,238.690783943829,86.8957911421779
8.7,"random_instances_SVM","SVM",37,18,2012,1805,207,1900,1701,199,0.945708997722102,0.65,1.79045078196872,422,199,223,15,1.1,48.57,8.5,0,0,0,0,0,0,0.719534667962527,221.870827882518,84.5586288301096
8.7,"random_instances_SVM","SVM",37,19,1912,1716,196,2000,1790,210,0.94666571753987,0.645,1.78880514705882,441,210,231,19,1.1,51.12,8.5,0,0,0,0,0,0,0.670859736685298,204.556046992491,80.4411057903794
8.7,"random_instances_SVM","SVM",37,20,1812,1625,187,2100,1881,219,0.945946753986339,0.645,1.79209944751381,457,219,238,16,1.1,53.68,8.6,0,0,0,0,0,0,0.738835458006402,201.191787228409,86.1795806964828
8.7,"random_instances_SVM","SVM",37,21,1712,1534,178,2200,1972,228,0.944515945330303,0.66,1.79045078196872,478,228,250,21,1.1,56.24,8.6,0,0,0,0,0,0,0.668796257232945,181.916970575705,82.8274361491056
8.7,"random_instances_SVM","SVM",37,22,1612,1444,168,2300,2062,238,0.946405182232351,0.66,1.78880514705882,494,238,256,16,1.1,58.79,8.7,0,0,0,0,0,0,0.655136706447375,176.215778681622,83.0328229128599
8.7,"random_instances_SVM","SVM",37,23,1512,1354,158,2400,2152,248,0.947179669703879,0.67,1.79209944751381,517,248,269,23,1.1,61.35,8.7,0,0,0,0,0,0,0.600504986937913,164.250841708577,79.0641939127291
8.7,"random_instances_SVM","SVM",37,24,1412,1264,148,2500,2242,258,0.948470956719822,0.655,1.78552293577982,540,258,282,23,1.1,63.91,8.7,0,0,0,0,0,0,0.609502764824411,158.385722732088,81.0606568433721
8.7,"random_instances_SVM","SVM",37,25,1312,1177,135,2600,2329,271,0.947232346241464,0.635,1.79045078196872,563,271,292,23,1.1,66.46,8.6,0,0,0,0,0,0,0.599008696962672,146.608138741404,81.4360558754771
8.7,"random_instances_SVM","SVM",37,26,1212,1086,126,2700,2420,280,0.946022209567203,0.645,1.79045078196872,584,280,304,21,1.1,69.02,8.6,0,0,0,0,0,0,0.510589212685616,128.552914433124,76.6258162321434
8.7,"random_instances_SVM","SVM",37,27,1112,995,117,2800,2511,289,0.944897494305245,0.645,1.78388634280477,604,289,315,20,1.1,71.57,8.7,0,0,0,0,0,0,0.470677683138078,118.21726247002,76.1603810158409
8.7,"random_instances_SVM","SVM",37,28,1012,907,105,2900,2599,301,0.945115318906613,0.65,1.78880514705882,627,301,326,23,1.1,74.13,8.6,0,0,0,0,0,0,0.420889097694455,109.592210096597,74.7775874936472
8.7,"random_instances_SVM","SVM",37,29,912,816,96,3000,2690,310,0.945555239179961,0.645,1.79045078196872,646,310,336,19,1.1,76.69,8.7,0,0,0,0,0,0,0.345522182392411,98.7701845373657,70.2419804731095
8.7,"random_instances_SVM","SVM",37,30,812,726,86,3100,2780,320,0.945647779043284,0.635,1.79209944751381,660,320,340,14,1.1,79.24,8.7,0,0,0,0,0,0,0.230683791572085,87.1852960362783,66.7620832019291
8.7,"random_instances_SVM","SVM",37,31,712,636,76,3200,2870,330,0.945455580865607,0.63,1.79779411764706,684,330,354,24,1.1,81.8,8.7,0,0,0,0,0,0,0.191419667312925,75.8974903654597,60.6230103968328
8.7,"random_instances_SVM","SVM",37,32,612,545,67,3300,2961,339,0.945501138952165,0.63,1.79449541284404,704,339,365,20,1.1,84.36,8.7,0,0,0,0,0,0,0.174005849339141,69.2962117364689,56.1922961045084
8.7,"random_instances_SVM","SVM",37,33,512,455,57,3400,3051,349,0.94541998861048,0.635,1.79779411764706,724,349,375,20,1.1,86.91,8.7,0,0,0,0,0,0,0.105707461128376,58.9371247883679,50.7109460213534
8.7,"random_instances_SVM","SVM",37,34,412,369,43,3500,3137,363,0.945740318906607,0.625,1.79944802207912,748,363,385,24,1.1,89.47,8.6,0,0,0,0,0,0,0.0673378863672053,42.6540475504234,38.1547088655435
8.7,"random_instances_SVM","SVM",37,35,312,281,31,3600,3225,375,0.945509681093394,0.62,1.80110497237569,770,374,396,22,1.1,92.02,8.6,0,0,0,0,0,0,0.0561033238231704,32.5607693271584,29.8833835070663
8.7,"random_instances_SVM","SVM",37,36,212,187,25,3700,3319,381,0.945760250569476,0.63,1.80276497695853,782,380,402,12,1.1,94.58,8.7,0,0,0,0,0,0,0.0168808789930339,22.6123614653525,22.1904497133194
8.7,"random_instances_SVM","SVM",37,37,112,100,12,3800,3406,394,0.945872722095673,0.63,1.79449541284404,809,392,417,27,1.1,97.14,8.6,0,0,0,0,0,0,0.00155277241133656,13.1408372735886,13.1320613779476
8.7,"random_instances_SVM","SVM",37,38,12,12,0,3900,3494,406,0.945787300683372,0.63,1.79779411764706,835,404,431,26,1.1,99.69,8.6,0,0,0,0,0,0,0.000767852293805043,0.288400400688553,0.288400400688553
8.7,"random_instances_SVM","SVM",37,39,0,0,0,3912,3506,406,0.945802961275627,0.63,1.80110497237569,835,404,431,0,1.1,100,8.6,0,0,0,0,0,0,0,0,0
8.7,"random_instances_SVM","SVM",38,0,3812,3418,394,100,91,9,0.90675520360593,0.551724137931034,1.75836189870832,23,9,14,0,1.6,2.56,10.1,0,0,0,0,0,0,0.345760198404571,319.15800283929,38.7181480056156
8.7,"random_instances_SVM","SVM",38,1,3712,3334,378,200,175,25,0.930413450271034,0.600985221674877,1.80110497237569,59,25,34,36,1.4,5.11,7,0,0,0,0,0,0,0.531466624645224,361.736647802101,59.8188107502361
8.7,"random_instances_SVM","SVM",38,2,3612,3243,369,300,266,34,0.924735639677512,0.571428571428571,1.79223253408813,79,34,45,20,1.3,7.67,7.8,0,0,0,0,0,0,0.579942626541639,391.033399045178,64.6122844369729
8.7,"random_instances_SVM","SVM",38,3,3512,3153,359,400,356,44,0.93044717149208,0.625615763546798,1.79058374610828,106,44,62,27,1.4,10.22,8.1,0,0,0,0,0,0,0.588176832440796,381.48637311134,65.2353889708837
8.7,"random_instances_SVM","SVM",38,4,3412,3060,352,500,449,51,0.931110355505989,0.625615763546798,1.78565553396303,118,51,67,12,1.3,12.78,8.8,0,0,0,0,0,0,0.565988006514433,370.162354366392,63.9082902205981
8.7,"random_instances_SVM","SVM",38,5,3312,2970,342,600,539,61,0.93431527655618,0.596059113300493,1.7889379889887,140,61,79,22,1.3,15.34,8.8,0,0,0,0,0,0,0.752186333461901,379.10640122714,82.0649594891778
8.7,"random_instances_SVM","SVM",38,6,3212,2882,330,700,627,73,0.936230360901383,0.596059113300493,1.79388436130848,164,73,91,24,1.2,17.89,8.6,0,0,0,0,0,0,0.730582891387582,369.580088063036,80.9741628570139
8.7,"random_instances_SVM","SVM",38,7,3112,2791,321,800,718,82,0.936747419624081,0.586206896551724,1.78729525437989,184,82,102,20,1.2,20.45,8.8,0,0,0,0,0,0,0.715764463878231,348.005426054312,80.0500427058269
8.7,"random_instances_SVM","SVM",38,8,3012,2697,315,900,812,88,0.935926869911964,0.610837438423645,1.78729525437989,200,88,112,16,1.3,23.01,9.2,0,0,0,0,0,0,0.589648645008052,292.567126292513,69.6398415664562
8.7,"random_instances_SVM","SVM",38,9,2912,2608,304,1000,901,99,0.938537454441242,0.620689655172414,1.7889379889887,226,99,127,26,1.3,25.56,9.1,0,0,0,0,0,0,0.604864958003059,285.099843707625,72.0598414028329
8.7,"random_instances_SVM","SVM",38,10,2812,2512,300,1100,997,103,0.9376396269309,0.61576354679803,1.7889379889887,231,103,128,5,1.2,28.12,9.7,0,0,0,0,0,0,0.61634399340258,276.000372383176,74.6810454448487
8.7,"random_instances_SVM","SVM",38,11,2712,2423,289,1200,1086,114,0.936849988338076,0.610837438423645,1.7889379889887,256,114,142,25,1.2,30.67,9.5,0,0,0,0,0,0,0.555811887297592,262.262700385269,67.8567832760105
8.7,"random_instances_SVM","SVM",38,12,2612,2334,278,1300,1175,125,0.938326696809692,0.635467980295567,1.79223253408813,272,125,147,16,1.2,33.23,9.4,0,0,0,0,0,0,0.587858940943166,245.990451105184,70.7391002699571
8.7,"random_instances_SVM","SVM",38,13,2512,2242,270,1400,1267,133,0.938021800769406,0.630541871921182,1.79223253408813,287,133,154,15,1.2,35.79,9.5,0,0,0,0,0,0,0.626063011382444,239.493532806023,77.0615329958728
8.7,"random_instances_SVM","SVM",38,14,2412,2153,259,1500,1356,144,0.937624171371247,0.605911330049261,1.79223253408813,306,144,162,19,1.1,38.34,9.4,0,0,0,0,0,0,0.625224846993741,240.051563966659,75.1310361285331
8.7,"random_instances_SVM","SVM",38,15,2312,2064,248,1600,1445,155,0.938436290778092,0.610837438423645,1.79388436130848,335,155,180,29,1.2,40.9,9.3,0,0,0,0,0,0,0.615538108292585,227.494376054391,75.0378002235043
8.7,"random_instances_SVM","SVM",38,16,2212,1973,239,1700,1536,164,0.938509353423693,0.61576354679803,1.79058374610828,351,164,187,16,1.1,43.46,9.4,0,0,0,0,0,0,0.611885441497095,220.420214761598,73.9605814557813
8.7,"random_instances_SVM","SVM",38,17,2112,1882,230,1800,1627,173,0.937666322897556,0.605911330049261,1.78401881944977,367,173,194,16,1.1,46.01,9.4,0,0,0,0,0,0,0.650310228441703,217.153031594769,79.2118515013565
8.7,"random_instances_SVM","SVM",38,18,2012,1790,222,1900,1719,181,0.937492096588826,0.600985221674877,1.7889379889887,381,181,200,14,1.1,48.57,9.5,0,0,0,0,0,0,0.69167059759136,215.184865409261,82.7285314617421
8.7,"random_instances_SVM","SVM",38,19,1912,1703,209,2000,1806,194,0.939310232423528,0.605911330049261,1.78729525437989,408,194,214,27,1.1,51.12,9.3,0,0,0,0,0,0,0.667703263156353,200.468493878319,81.8525145845736
8.7,"random_instances_SVM","SVM",38,20,1812,1616,196,2100,1893,207,0.939942505318118,0.61576354679803,1.78729525437989,430,207,223,22,1.1,53.68,9.1,0,0,0,0,0,0,0.619175678312615,186.352620114793,78.9140236345169
8.7,"random_instances_SVM","SVM",38,21,1712,1524,188,2200,1985,215,0.939207663709507,0.61576354679803,1.78565553396303,451,215,236,21,1.1,56.24,9.2,0,0,0,0,0,0,0.539366733750195,164.630130985226,71.838277704033
8.7,"random_instances_SVM","SVM",38,22,1612,1430,182,2300,2079,221,0.938444721083352,0.610837438423645,1.7889379889887,460,221,239,9,1.1,58.79,9.4,0,0,0,0,0,0,0.599970432676025,164.324005033555,77.6037155259715
8.7,"random_instances_SVM","SVM",38,23,1512,1340,172,2400,2169,231,0.936540877145164,0.61576354679803,1.7889379889887,481,231,250,21,1.1,61.35,9.4,0,0,0,0,0,0,0.547207185657528,150.449714868849,75.2462477505924
8.7,"random_instances_SVM","SVM",38,24,1412,1254,158,2500,2255,245,0.93770847442386,0.625615763546798,1.79058374610828,516,245,271,35,1.1,63.91,9.2,0,0,0,0,0,0,0.467325978427443,139.984816084392,67.4208893656975
8.7,"random_instances_SVM","SVM",38,25,1312,1161,151,2600,2348,252,0.939096664690228,0.635467980295567,1.78729525437989,529,252,277,13,1.1,66.46,9.3,0,0,0,0,0,0,0.5,134.813389132428,72.1539129954093
8.7,"random_instances_SVM","SVM",38,26,1212,1071,141,2700,2438,262,0.940161693254917,0.635467980295567,1.79058374610828,544,262,282,15,1.1,69.02,9.3,0,0,0,0,0,0,0.476337062477811,125.280749229502,70.6777825854646
8.7,"random_instances_SVM","SVM",38,27,1112,987,125,2800,2522,278,0.939363624356838,0.635467980295567,1.79058374610828,578,278,300,34,1.1,71.57,9.1,0,0,0,0,0,0,0.431257229215882,114.230484460583,68.8885554765267
8.7,"random_instances_SVM","SVM",38,28,1012,900,112,2900,2609,291,0.939852582061996,0.630541871921182,1.79388436130848,600,291,309,22,1.1,74.13,9,0,0,0,0,0,0,0.402219341745819,104.196805260467,66.9318779950304
8.7,"random_instances_SVM","SVM",38,29,912,809,103,3000,2700,300,0.940164503356667,0.630541871921182,1.79058374610828,619,300,319,19,1.1,76.69,9,0,0,0,0,0,0,0.379255497770671,98.496162110984,66.8816705257391
8.7,"random_instances_SVM","SVM",38,30,812,720,92,3100,2789,311,0.93887888180431,0.625615763546798,1.79223253408813,638,310,328,19,1.1,79.24,9,0,0,0,0,0,0,0.346225448351352,88.911312153489,65.3079739759679
8.7,"random_instances_SVM","SVM",38,31,712,632,80,3200,2877,323,0.939807620433934,0.630541871921182,1.79058374610828,661,322,339,23,1.1,81.8,8.9,0,0,0,0,0,0,0.266886786674505,78.7263855691617,60.7002643256301
8.7,"random_instances_SVM","SVM",38,32,612,542,70,3300,2967,333,0.940127972033867,0.635467980295567,1.79058374610828,679,332,347,18,1,84.36,8.9,0,0,0,0,0,0,0.221975384611031,71.4653120238036,58.1668740146523
8.7,"random_instances_SVM","SVM",38,33,512,453,59,3400,3056,344,0.941228126870474,0.635467980295567,1.79223253408813,699,342,357,20,1,86.91,8.9,0,0,0,0,0,0,0.159613552519467,61.6281977386311,52.2664012152306
8.7,"random_instances_SVM","SVM",38,34,412,364,48,3500,3145,355,0.941274493549411,0.630541871921182,1.7889379889887,723,353,370,24,1,89.47,8.9,0,0,0,0,0,0,0.0931844169776977,49.0310861594388,43.8205662880866
8.7,"random_instances_SVM","SVM",38,35,312,274,38,3600,3235,365,0.941136798563476,0.635467980295567,1.79058374610828,742,362,380,19,1,92.02,8.9,0,0,0,0,0,0,0.0611765519731085,39.3973000099742,36.6009870326686
8.7,"random_instances_SVM","SVM",38,36,212,182,30,3700,3327,373,0.942593836322814,0.630541871921182,1.7889379889887,761,371,390,19,1.1,94.58,8.9,0,0,0,0,0,0,0.0256774735215422,27.186749883591,26.6841790946298
8.7,"random_instances_SVM","SVM",38,37,112,96,16,3800,3413,387,0.943868217468153,0.635467980295567,1.78729525437989,787,383,404,26,1.1,97.14,8.8,0,0,0,0,0,0,0.00102783500801304,15.2136334895909,15.2080352618653
8.7,"random_instances_SVM","SVM",38,38,12,10,2,3900,3499,401,0.943368019355977,0.640394088669951,1.79058374610828,812,397,415,25,1,99.69,8.7,0,0,0,0,0,0,0.00124873779766039,1.29092338365539,1.29092338365539
8.7,"random_instances_SVM","SVM",38,39,0,0,0,3912,3509,403,0.943396120373515,0.640394088669951,1.79388436130848,816,398,418,4,1.1,100,8.7,0,0,0,0,0,0,0,0,0
8.7,"random_instances_SVM","SVM",39,0,3812,3413,399,100,90,10,0.870981146994559,0.49746192893401,1.69295188191537,30,10,20,0,2,2.56,9,0,0,0,0,0,0,0.176498268652868,377.576770250191,19.3456102049907
8.7,"random_instances_SVM","SVM",39,1,3712,3329,383,200,174,26,0.892997001642017,0.50253807106599,1.72320342324957,64,26,38,34,1.5,5.11,6.7,0,0,0,0,0,0,0.609194082839783,534.272003072425,73.2764456772845
8.7,"random_instances_SVM","SVM",39,2,3612,3242,370,300,261,39,0.92785760252565,0.568527918781726,1.77302393038434,90,39,51,26,1.3,7.67,6.7,0,0,0,0,0,0,0.487706824862144,450.666821946319,55.3562961629751
8.7,"random_instances_SVM","SVM",39,3,3512,3154,358,400,349,51,0.934007266472923,0.583756345177665,1.78211636079656,116,51,65,26,1.3,10.22,6.8,0,0,0,0,0,0,0.682003604621947,453.11037392561,74.0453285691919
8.7,"random_instances_SVM","SVM",39,4,3412,3061,351,500,442,58,0.934191958398136,0.614213197969543,1.75909881093109,128,58,70,12,1.2,12.78,7.6,0,0,0,0,0,0,0.746424779721,436.776766290183,79.4751373092128
8.7,"random_instances_SVM","SVM",39,5,3312,2974,338,600,529,71,0.935317424817398,0.598984771573604,1.78117951424075,151,71,80,23,1.1,15.34,7.5,0,0,0,0,0,0,0.762293847862355,426.936740248003,81.777061630885
8.7,"random_instances_SVM","SVM",39,6,3212,2887,325,700,616,84,0.936429905085664,0.593908629441624,1.79779411764706,180,84,96,29,1.1,17.89,7.3,0,0,0,0,0,0,0.806162440444728,422.151384643638,85.7229487829996
8.7,"random_instances_SVM","SVM",39,7,3112,2793,319,800,710,90,0.942464136579678,0.609137055837564,1.79779411764706,198,90,108,18,1.2,20.45,7.9,0,0,0,0,0,0,0.630355922199974,361.274164938196,72.054393853661
8.7,"random_instances_SVM","SVM",39,8,3012,2704,308,900,799,101,0.941068846800934,0.629441624365482,1.79449541284404,211,101,110,13,1.1,23.01,7.9,0,0,0,0,0,0,0.715693452678669,359.264801239543,77.9352280362705
8.7,"random_instances_SVM","SVM",39,9,2912,2611,301,1000,892,108,0.937165786975178,0.619289340101523,1.80110497237569,227,108,119,16,1.1,25.56,8.3,0,0,0,0,0,0,0.793263916251492,355.428241689031,85.6867429547871
8.7,"random_instances_SVM","SVM",39,10,2812,2517,295,1100,986,114,0.937738620524465,0.598984771573604,1.77723385021904,241,114,127,14,1.1,28.12,8.6,0,0,0,0,0,0,0.739430317321077,319.103152114891,82.1798900004957
8.7,"random_instances_SVM","SVM",39,11,2712,2434,278,1200,1069,131,0.941262196160139,0.614213197969543,1.79779411764706,271,131,140,30,1.1,30.67,8.2,0,0,0,0,0,0,0.608502199159118,295.931883614702,69.1833162275618
8.7,"random_instances_SVM","SVM",39,12,2612,2342,270,1300,1161,139,0.941667652652205,0.629441624365482,1.79120879120879,290,139,151,19,1.1,33.23,8.4,0,0,0,0,0,0,0.793950442574108,320.593081482785,86.2715158389456
8.7,"random_instances_SVM","SVM",39,13,2512,2255,257,1400,1248,152,0.938644765282535,0.619289340101523,1.79944802207912,312,152,160,22,1.1,35.79,8.2,0,0,0,0,0,0,0.803231570347714,316.972106171476,86.9878890788434
8.7,"random_instances_SVM","SVM",39,14,2412,2165,247,1500,1338,162,0.93729997720209,0.614213197969543,1.79944802207912,332,162,170,20,1,38.34,8.3,0,0,0,0,0,0,0.77469865104447,289.639062734856,86.3611485799571
8.7,"random_instances_SVM","SVM",39,15,2312,2074,238,1600,1429,171,0.940624431855894,0.614213197969543,1.79449541284404,352,171,181,20,1.1,40.9,8.4,0,0,0,0,0,0,0.723450641374391,250.658415072124,82.9617385143325
8.7,"random_instances_SVM","SVM",39,16,2212,1978,234,1700,1525,175,0.939458564077995,0.634517766497462,1.79361388570493,367,175,192,15,1.1,43.46,8.7,0,0,0,0,0,0,0.750459586030262,244.734958374562,86.7131290389738
8.7,"random_instances_SVM","SVM",39,17,2112,1887,225,1800,1616,184,0.942863821449077,0.639593908629442,1.78702577225881,379,184,195,12,1.1,46.01,8.8,0,0,0,0,0,0,0.727317727533468,239.71022713056,85.2837817676517
8.7,"random_instances_SVM","SVM",39,18,2012,1797,215,1900,1706,194,0.943341423224429,0.654822335025381,1.7919623075413,404,194,210,25,1.1,48.57,8.8,0,0,0,0,0,0,0.713971789435168,231.378324652669,84.2832283088752
8.7,"random_instances_SVM","SVM",39,19,1912,1702,210,2000,1801,199,0.941856673294411,0.644670050761421,1.79361388570493,416,199,217,12,1.1,51.12,9.1,0,0,0,0,0,0,0.605752723133604,204.953829230322,74.7918417846195
8.7,"random_instances_SVM","SVM",39,20,1812,1613,199,2100,1890,210,0.941187165065521,0.624365482233503,1.79031376815993,442,210,232,26,1.1,53.68,9,0,0,0,0,0,0,0.73838165540466,212.935660511199,85.68115767512
8.7,"random_instances_SVM","SVM",39,21,1712,1524,188,2200,1979,221,0.940481584194987,0.619289340101523,1.78866825918185,456,221,235,14,1.1,56.24,9,0,0,0,0,0,0,0.65919999164774,196.378428251902,79.7736548022423
8.7,"random_instances_SVM","SVM",39,22,1612,1432,180,2300,2071,229,0.941969219936335,0.639593908629442,1.78702577225881,473,229,244,17,1.1,58.79,9,0,0,0,0,0,0,0.652928821840463,182.631525705631,81.06991500301
8.7,"random_instances_SVM","SVM",39,23,1512,1344,168,2400,2159,241,0.943943114887031,0.619289340101523,1.79031376815993,497,241,256,24,1.1,61.35,9,0,0,0,0,0,0,0.676937654541521,175.466893491097,82.2097902507204
8.7,"random_instances_SVM","SVM",39,24,1412,1266,146,2500,2237,263,0.946355653160104,0.624365482233503,1.78211636079656,543,263,280,46,1.1,63.91,8.5,0,0,0,0,0,0,0.591636367984999,160.778024714671,77.244174950948
8.7,"random_instances_SVM","SVM",39,25,1312,1176,136,2600,2327,273,0.94574097534651,0.634517766497462,1.78702577225881,567,273,294,24,1.1,66.46,8.5,0,0,0,0,0,0,0.59163128325228,150.122544041694,78.5841293201806
8.7,"random_instances_SVM","SVM",39,26,1212,1085,127,2700,2418,282,0.945507224628665,0.639593908629442,1.78866825918185,583,282,301,16,1.1,69.02,8.6,0,0,0,0,0,0,0.567504169864319,139.207419471424,78.4694215895792
8.7,"random_instances_SVM","SVM",39,27,1112,995,117,2800,2508,292,0.945740975346511,0.644670050761421,1.79031376815993,605,292,313,22,1.1,71.57,8.6,0,0,0,0,0,0,0.50059916736683,123.264596522521,73.7993529427195
8.7,"random_instances_SVM","SVM",39,28,1012,911,101,2900,2592,308,0.946817382973133,0.629441624365482,1.79944802207912,638,308,330,33,1.1,74.13,8.4,0,0,0,0,0,0,0.465679947037848,112.987903650077,74.7828136086614
8.7,"random_instances_SVM","SVM",39,29,912,825,87,3000,2678,322,0.946309480178802,0.629441624365482,1.78702577225881,665,322,343,27,1.1,76.69,8.3,0,0,0,0,0,0,0.352092018881645,99.1562677583099,70.0588466827819
8.7,"random_instances_SVM","SVM",39,30,812,733,79,3100,2770,330,0.947597994938284,0.629441624365482,1.7919623075413,677,330,347,12,1.1,79.24,8.4,0,0,0,0,0,0,0.295231422156618,90.248073841935,67.3684376168233
8.7,"random_instances_SVM","SVM",39,31,712,643,69,3200,2860,340,0.947215624936869,0.634517766497462,1.78866825918185,702,340,362,25,1.1,81.8,8.4,0,0,0,0,0,0,0.217479932068477,76.2540287166089,59.2911601961131
8.7,"random_instances_SVM","SVM",39,32,612,556,56,3300,2947,353,0.948341091356127,0.639593908629442,1.79031376815993,731,353,378,29,1.1,84.36,8.3,0,0,0,0,0,0,0.180171911983996,68.8262847680804,56.1034764929121
8.7,"random_instances_SVM","SVM",39,33,512,466,46,3400,3037,363,0.948456523809384,0.624365482233503,1.80276497695853,749,363,386,18,1.1,86.91,8.4,0,0,0,0,0,0,0.107897125225818,55.9925849274554,47.5397638873677
8.7,"random_instances_SVM","SVM",39,34,412,370,42,3500,3133,367,0.948840336716464,0.639593908629442,1.79779411764706,757,367,390,8,1.1,89.47,8.5,0,0,0,0,0,0,0.0862751909889272,47.4711976299502,42.0799974409842
8.7,"random_instances_SVM","SVM",39,35,312,280,32,3600,3223,377,0.948854765773121,0.624365482233503,1.79944802207912,775,377,398,18,1.1,92.02,8.5,0,0,0,0,0,0,0.0619665087275303,36.5404117045519,33.7598700923026
8.7,"random_instances_SVM","SVM",39,36,212,189,23,3700,3314,386,0.949082744868304,0.624365482233503,1.78630136986301,786,384,402,11,1,94.58,8.6,0,0,0,0,0,0,0.0247829220650268,25.9055797325425,25.1578290287299
8.7,"random_instances_SVM","SVM",39,37,112,101,11,3800,3402,398,0.949922515965749,0.634517766497462,1.79944802207912,810,393,417,24,1.1,97.14,8.5,0,0,0,0,0,0,0.00182435427823536,13.3454434088377,13.3337626898609
8.7,"random_instances_SVM","SVM",39,38,12,9,3,3900,3494,406,0.949961474418723,0.629441624365482,1.79449541284404,823,399,424,13,1.1,99.69,8.6,0,0,0,0,0,0,0.00643453653651705,2.3454375829281,2.3454375829281
8.7,"random_instances_SVM","SVM",39,39,0,0,0,3912,3503,409,0.950032176796343,0.639593908629442,1.80276497695853,829,402,427,6,1.1,100,8.6,0,0,0,0,0,0,0,0,0
8.7,"random_instances_SVM","SVM",40,0,3812,3413,399,100,92,8,0.902326086894346,0.557788944723618,1.72123289257347,20,8,12,0,1.5,2.56,11.5,0,0,0,0,0,0,0.256292674406765,287.34660918553,28.3491076034404
8.7,"random_instances_SVM","SVM",40,1,3712,3329,383,200,176,24,0.891898307702418,0.557788944723618,1.72869874233044,53,24,29,33,1.2,5.11,7.3,0,0,0,0,0,0,0.860322741485616,456.326102976513,89.9870854721845
8.7,"random_instances_SVM","SVM",40,2,3612,3240,372,300,265,35,0.900498508478637,0.577889447236181,1.75423576021783,77,35,42,24,1.2,7.67,7.6,0,0,0,0,0,0,0.768674579326895,416.136183488379,81.9581765282479
8.7,"random_instances_SVM","SVM",40,3,3512,3151,361,400,354,46,0.901631092285546,0.582914572864322,1.75423576021783,100,46,54,23,1.2,10.22,7.7,0,0,0,0,0,0,0.723032784934202,377.873693514456,77.9353066277574
8.7,"random_instances_SVM","SVM",40,4,3412,3067,345,500,438,62,0.905650906782048,0.582914572864322,1.76165755246822,132,62,70,32,1.1,12.78,7.1,0,0,0,0,0,0,0.716220539529393,375.58335285941,77.2636898645527
8.7,"random_instances_SVM","SVM",40,5,3312,2975,337,600,530,70,0.907611477993253,0.592964824120603,1.76327821259009,148,70,78,16,1.1,15.34,7.6,0,0,0,0,0,0,0.822341098160297,400.651268905635,86.836052374388
8.7,"random_instances_SVM","SVM",40,6,3212,2882,330,700,623,77,0.908372253984773,0.582914572864322,1.76327821259009,160,77,83,12,1.1,17.89,8.1,0,0,0,0,0,0,0.872922701705967,396.65393611899,91.091948499663
8.7,"random_instances_SVM","SVM",40,7,3112,2793,319,800,712,88,0.909404735687535,0.577889447236181,1.75423576021783,181,87,94,21,1.1,20.45,8.1,0,0,0,0,0,0,0.834550227654134,363.954653355712,88.4794376744084
8.7,"random_instances_SVM","SVM",40,8,3012,2702,310,900,803,97,0.908193500227359,0.577889447236181,1.75585107859741,199,95,104,18,1.1,23.01,8.3,0,0,0,0,0,0,0.79575123784048,337.209694482557,85.3238395555963
8.7,"random_instances_SVM","SVM",40,9,2912,2612,300,1000,893,107,0.906355911601245,0.587939698492462,1.75746937452238,220,106,114,21,1.1,25.56,8.3,0,0,0,0,0,0,0.827785030817321,336.05542541705,87.4429594587398
8.7,"random_instances_SVM","SVM",40,10,2812,2520,292,1100,985,115,0.906807801099963,0.592964824120603,1.75423576021783,237,115,122,17,1.1,28.12,8.6,0,0,0,0,0,0,0.791589997369995,314.531790124951,84.7817459506886
8.7,"random_instances_SVM","SVM",40,11,2712,2426,286,1200,1079,121,0.908621079215068,0.597989949748744,1.76652849500961,251,121,130,14,1.1,30.67,8.9,0,0,0,0,0,0,0.801963030341976,308.136367307399,86.2319476651321
8.7,"random_instances_SVM","SVM",40,12,2612,2337,275,1300,1168,132,0.907600037752775,0.582914572864322,1.75746937452238,270,132,138,19,1,33.23,8.8,0,0,0,0,0,0,0.791443936447949,288.508752812289,85.8897514578385
8.7,"random_instances_SVM","SVM",40,13,2512,2253,259,1400,1252,148,0.907348352462357,0.592964824120603,1.74940758840072,301,148,153,31,1,35.79,8.5,0,0,0,0,0,0,0.737376256992593,268.440024640445,81.7009877706185
8.7,"random_instances_SVM","SVM",40,14,2412,2162,250,1500,1343,157,0.909659281038082,0.587939698492462,1.75423576021783,317,156,161,16,1,38.34,8.6,0,0,0,0,0,0,0.719458995449116,260.334285313128,80.5926910616091
8.7,"random_instances_SVM","SVM",40,15,2312,2069,243,1600,1436,164,0.907894623944991,0.582914572864322,1.75423576021783,332,164,168,15,1,40.9,8.8,0,0,0,0,0,0,0.743421794031142,253.330588025979,83.0089612145409
8.7,"random_instances_SVM","SVM",40,16,2212,1979,233,1700,1526,174,0.906887882783285,0.592964824120603,1.74680029984175,359,173,186,27,1.1,43.46,8.8,0,0,0,0,0,0,0.717425614763564,237.055615601308,82.8126982496308
8.7,"random_instances_SVM","SVM",40,17,2112,1887,225,1800,1618,182,0.905412091762161,0.587939698492462,1.74519330784558,373,181,192,14,1.1,46.01,8.9,0,0,0,0,0,0,0.685161361452495,226.408584913644,81.3469491184681
8.7,"random_instances_SVM","SVM",40,18,2012,1793,219,1900,1712,188,0.908764082220992,0.592964824120603,1.74519330784558,389,188,201,16,1.1,48.57,9.1,0,0,0,0,0,0,0.705260574444332,217.445288979575,83.4652297100678
8.7,"random_instances_SVM","SVM",40,19,1912,1703,209,2000,1802,198,0.910099730296323,0.577889447236181,1.76327821259009,409,198,211,20,1.1,51.12,9.1,0,0,0,0,0,0,0.658872687595578,207.155651555338,80.4661100049559
8.7,"random_instances_SVM","SVM",40,20,1812,1613,199,2100,1892,208,0.909087269014384,0.587939698492462,1.75746937452238,429,208,221,20,1.1,53.68,9.1,0,0,0,0,0,0,0.687948587850803,200.505984328212,82.3434888645324
8.7,"random_instances_SVM","SVM",40,21,1712,1524,188,2200,1981,219,0.909324654004218,0.587939698492462,1.75746937452238,450,219,231,21,1.1,56.24,9,0,0,0,0,0,0,0.657122636179851,184.186871791698,80.3739188632642
8.7,"random_instances_SVM","SVM",40,22,1612,1440,172,2300,2065,235,0.912871128551116,0.587939698492462,1.76165755246822,471,229,242,21,1.1,58.79,8.8,0,0,0,0,0,0,0.593346735054253,163.509284379813,74.9500095787082
8.7,"random_instances_SVM","SVM",40,23,1512,1357,155,2400,2148,252,0.917255600712725,0.582914572864322,1.76652849500961,497,242,255,26,1.1,61.35,8.5,0,0,0,0,0,0,0.576256591128987,154.519097024523,73.5958940664102
8.7,"random_instances_SVM","SVM",40,24,1412,1268,144,2500,2237,263,0.919480727484889,0.587939698492462,1.75681339787849,522,255,267,25,1,63.91,8.5,0,0,0,0,0,0,0.549743459767984,144.943314574001,72.3353814531467
8.7,"random_instances_SVM","SVM",40,25,1312,1173,139,2600,2332,268,0.918166529860459,0.592964824120603,1.76490185735306,535,262,273,13,1,66.46,8.7,0,0,0,0,0,0,0.548762248426289,136.388073529193,72.4190272065666
8.7,"random_instances_SVM","SVM",40,26,1212,1080,132,2700,2425,275,0.917521586303749,0.587939698492462,1.76327821259009,557,271,286,22,1.1,69.02,8.8,0,0,0,0,0,0,0.519352845307717,128.061692732345,72.3677965517263
8.7,"random_instances_SVM","SVM",40,27,1112,989,123,2800,2516,284,0.917806162285536,0.587939698492462,1.75842515328938,580,281,299,23,1.1,71.57,8.9,0,0,0,0,0,0,0.5,120.11888585015,73.5181581892812
8.7,"random_instances_SVM","SVM",40,28,1012,899,113,2900,2606,294,0.916537725622989,0.592964824120603,1.75842515328938,595,290,305,15,1.1,74.13,8.9,0,0,0,0,0,0,0.423578626726401,108.783854713731,68.0225966457322
8.7,"random_instances_SVM","SVM",40,29,912,813,99,3000,2692,308,0.917504425943024,0.587939698492462,1.76165755246822,614,300,314,19,1,76.69,8.7,0,0,0,0,0,0,0.380690202881629,94.6614050456024,64.8315396641902
8.7,"random_instances_SVM","SVM",40,30,812,722,90,3100,2783,317,0.917477255371903,0.582914572864322,1.75585107859741,628,310,318,14,1,79.24,8.8,0,0,0,0,0,0,0.345652538282703,87.2633888194031,63.3749697167084
8.7,"random_instances_SVM","SVM",40,31,712,630,82,3200,2875,325,0.917035376083598,0.582914572864322,1.75101402328447,648,319,329,20,1,81.8,8.8,0,0,0,0,0,0,0.328913989564492,81.3895888952493,62.7878894946112
8.7,"random_instances_SVM","SVM",40,32,612,543,69,3300,2962,338,0.917839052976891,0.592964824120603,1.75423576021783,672,331,341,24,1,84.36,8.8,0,0,0,0,0,0,0.192519110536099,64.5888622178951,53.2199625979049
8.7,"random_instances_SVM","SVM",40,33,512,456,56,3400,3049,351,0.920699113095355,0.592964824120603,1.75746937452238,698,344,354,26,1,86.91,8.7,0,0,0,0,0,0,0.122386264092462,54.1406997166169,46.7371787137577
8.7,"random_instances_SVM","SVM",40,34,412,371,41,3500,3134,366,0.922938540168111,0.582914572864322,1.75746937452238,726,357,369,28,1,89.47,8.6,0,0,0,0,0,0,0.0636792268751278,39.7372931409732,35.0555536178168
8.7,"random_instances_SVM","SVM",40,35,312,281,31,3600,3224,376,0.921218214006869,0.597989949748744,1.75585107859741,746,367,379,20,1,92.02,8.6,0,0,0,0,0,0,0.0464079156348427,28.0577412523075,25.7675743909118
8.7,"random_instances_SVM","SVM",40,36,212,188,24,3700,3317,383,0.920844976161408,0.592964824120603,1.75423576021783,755,373,382,9,1,94.58,8.7,0,0,0,0,0,0,0.0177515020292836,19.4688880861406,18.9746820977356
8.7,"random_instances_SVM","SVM",40,37,112,100,12,3800,3405,395,0.921717294497531,0.592964824120603,1.75585107859741,776,382,394,21,1,97.14,8.6,0,0,0,0,0,0,0.00121250172616616,7.94853949094543,7.94063877065856
8.7,"random_instances_SVM","SVM",40,38,12,9,3,3900,3496,404,0.923923830878922,0.597989949748744,1.75262341117351,797,390,407,21,1,99.69,8.7,0,0,0,0,0,0,0.000447645783487096,1.52007047407536,1.52007047407536
8.7,"random_instances_SVM","SVM",40,39,0,0,0,3912,3505,407,0.923968161810759,0.603015075376884,1.75423576021783,797,391,406,0,1,100,8.6,0,0,0,0,0,0,0,0,0
8.7,"random_instances_SVM","SVM",41,0,3812,3423,389,100,90,10,0.880097115536009,0.516908212560386,1.69825686235223,28,10,18,0,1.8,2.56,9,0,0,0,0,0,0,0.367270340324376,346.0675698736,43.4052475384897
8.7,"random_instances_SVM","SVM",41,1,3712,3339,373,200,174,26,0.913716050303421,0.560386473429952,1.74794287837766,54,26,28,26,1.1,5.11,6.7,0,0,0,0,0,0,0.767605298986555,451.145534988312,81.3169396206233
8.7,"random_instances_SVM","SVM",41,2,3612,3245,367,300,268,32,0.913281019105464,0.560386473429952,1.75598309400957,69,32,37,15,1.2,7.67,8.4,0,0,0,0,0,0,0.823708860452577,425.507314328671,86.8179831838451
8.7,"random_instances_SVM","SVM",41,3,3512,3158,354,400,355,45,0.912562872365997,0.565217391304348,1.75051091965538,98,45,53,29,1.2,10.22,7.9,0,0,0,0,0,0,0.79478060371657,429.46386834682,83.5607609783478
8.7,"random_instances_SVM","SVM",41,4,3412,3064,348,500,449,51,0.912742409050869,0.555555555555556,1.74568414322251,112,51,61,14,1.2,12.78,8.8,0,0,0,0,0,0,0.73938487961472,373.543636024909,79.0773601676778
8.7,"random_instances_SVM","SVM",41,5,3312,2975,337,600,538,62,0.911851630883626,0.560386473429952,1.74568414322251,132,62,70,20,1.1,15.34,8.7,0,0,0,0,0,0,0.833040119297316,385.465635729806,87.5518608880287
8.7,"random_instances_SVM","SVM",41,6,3212,2885,327,700,628,72,0.91239714619534,0.555555555555556,1.74729010839566,153,72,81,21,1.1,17.89,8.7,0,0,0,0,0,0,0.81997741611869,369.298830297544,85.7072568199082
8.7,"random_instances_SVM","SVM",41,7,3112,2798,314,800,715,85,0.915986498841305,0.570048309178744,1.74889903114741,178,85,93,25,1.1,20.45,8.4,0,0,0,0,0,0,0.87476472046356,382.768659473926,90.9898993209036
8.7,"random_instances_SVM","SVM",41,8,3012,2706,306,900,807,93,0.918197562168038,0.565217391304348,1.74248105305146,192,93,99,14,1.1,23.01,8.7,0,0,0,0,0,0,0.819761928309838,358.405904993962,86.6461635711898
8.7,"random_instances_SVM","SVM",41,9,2912,2615,297,1000,898,102,0.919795438663375,0.570048309178744,1.74568414322251,214,101,113,22,1.1,25.56,8.8,0,0,0,0,0,0,0.843956460526172,343.493141812818,88.6911067752901
8.7,"random_instances_SVM","SVM",41,10,2812,2525,287,1100,988,112,0.920256709838343,0.584541062801932,1.74889903114741,234,112,122,20,1.1,28.12,8.8,0,0,0,0,0,0,0.838118972866153,337.648243914878,88.4590757127698
8.7,"random_instances_SVM","SVM",41,11,2712,2434,278,1200,1079,121,0.921691622265874,0.589371980676328,1.74729010839566,251,121,130,17,1.1,30.67,8.9,0,0,0,0,0,0,0.851937747154598,323.829266199179,89.8113236959769
8.7,"random_instances_SVM","SVM",41,12,2612,2346,266,1300,1167,133,0.921564565535034,0.608695652173913,1.74729010839566,277,133,144,26,1.1,33.23,8.8,0,0,0,0,0,0,0.787395574462478,293.269179267389,84.8650559824726
8.7,"random_instances_SVM","SVM",41,13,2512,2263,249,1400,1250,150,0.92389301823265,0.603864734299517,1.74889903114741,308,150,158,31,1.1,35.79,8.3,0,0,0,0,0,0,0.739420341866057,270.006391881399,82.4031471975834
8.7,"random_instances_SVM","SVM",41,14,2412,2177,235,1500,1336,164,0.927152299588732,0.603864734299517,1.75598309400957,344,164,180,36,1.1,38.34,8.1,0,0,0,0,0,0,0.794824233301482,266.121100840505,88.0010332083708
8.7,"random_instances_SVM","SVM",41,15,2312,2087,225,1600,1426,174,0.928732222415582,0.608695652173913,1.77011218908452,363,174,189,19,1.1,40.9,8.2,0,0,0,0,0,0,0.781138795965692,253.838146538802,86.9256081668923
8.7,"random_instances_SVM","SVM",41,16,2212,1999,213,1700,1514,186,0.929469703874966,0.603864734299517,1.77878920961925,387,186,201,24,1.1,43.46,8.1,0,0,0,0,0,0,0.731183458277558,242.841560531694,83.6864695248637
8.7,"random_instances_SVM","SVM",41,17,2112,1905,207,1800,1608,192,0.930776178520247,0.603864734299517,1.77173913043478,402,192,210,15,1.1,46.01,8.4,0,0,0,0,0,0,0.753195349076864,235.084996743198,86.5256529613697
8.7,"random_instances_SVM","SVM",41,18,2012,1815,197,1900,1698,202,0.933286930005565,0.603864734299517,1.76143516854979,425,202,223,23,1.1,48.57,8.4,0,0,0,0,0,0,0.682031339388796,214.874902322564,80.9549715941651
8.7,"random_instances_SVM","SVM",41,19,1912,1727,185,2000,1786,214,0.932496968592147,0.584541062801932,1.76630101155684,444,214,230,19,1.1,51.12,8.3,0,0,0,0,0,0,0.7058226382586,209.658360718814,82.9365667816385
8.7,"random_instances_SVM","SVM",41,20,1812,1640,172,2100,1873,227,0.932988622898402,0.599033816425121,1.76143516854979,468,227,241,24,1.1,53.68,8.3,0,0,0,0,0,0,0.743692096890744,207.286424702689,85.6819700134567
8.7,"random_instances_SVM","SVM",41,21,1712,1546,166,2200,1967,233,0.931455655819903,0.599033816425121,1.76630101155684,486,233,253,18,1.1,56.24,8.4,0,0,0,0,0,0,0.729417906807267,196.08334431039,85.2061763565137
8.7,"random_instances_SVM","SVM",41,22,1612,1450,162,2300,2063,237,0.929621619531378,0.608695652173913,1.76792893875643,491,237,254,5,1.1,58.79,8.7,0,0,0,0,0,0,0.68616834010607,179.453092690131,84.7237724249255
8.7,"random_instances_SVM","SVM",41,23,1512,1355,157,2400,2158,242,0.92964647845697,0.608695652173913,1.76467607962348,501,242,259,10,1.1,61.35,8.9,0,0,0,0,0,0,0.670823488605901,176.436367126339,83.0248898568057
8.7,"random_instances_SVM","SVM",41,24,1412,1265,147,2500,2248,252,0.928856517043565,0.599033816425121,1.75981917298232,525,252,273,24,1.1,63.91,8.9,0,0,0,0,0,0,0.635167153546743,160.351984332535,81.1286797465915
8.7,"random_instances_SVM","SVM",41,25,1312,1176,136,2600,2337,263,0.928472584748228,0.599033816425121,1.76305413469736,547,263,284,22,1.1,66.46,8.9,0,0,0,0,0,0,0.614297502209542,151.272757335068,80.1285452398434
8.7,"random_instances_SVM","SVM",41,26,1212,1085,127,2700,2428,272,0.930455774590316,0.608695652173913,1.75981917298232,564,272,292,17,1.1,69.02,8.9,0,0,0,0,0,0,0.648674991133598,146.302702701472,83.1320754563496
8.7,"random_instances_SVM","SVM",41,27,1112,999,113,2800,2514,286,0.933894592631283,0.599033816425121,1.76305413469736,587,286,301,23,1.1,71.57,8.8,0,0,0,0,0,0,0.609116917775029,132.261978095676,81.2148625348986
8.7,"random_instances_SVM","SVM",41,28,1012,912,100,2900,2601,299,0.934187375532759,0.603864734299517,1.75820613982651,615,299,316,28,1.1,74.13,8.7,0,0,0,0,0,0,0.537613700702588,115.284204213428,75.9684246973515
8.7,"random_instances_SVM","SVM",41,29,912,821,91,3000,2692,308,0.932770416773719,0.599033816425121,1.76467607962348,631,308,323,16,1,76.69,8.7,0,0,0,0,0,0,0.421465176997044,98.3906369736528,70.8048427510823
8.7,"random_instances_SVM","SVM",41,30,812,731,81,3100,2782,318,0.930921188919562,0.603864734299517,1.76305413469736,649,317,332,18,1,79.24,8.7,0,0,0,0,0,0,0.305922415563748,90.5559139844314,68.631100748754
8.7,"random_instances_SVM","SVM",41,31,712,640,72,3200,2873,327,0.931983217463131,0.608695652173913,1.76792893875643,672,327,345,23,1.1,81.8,8.8,0,0,0,0,0,0,0.230965660216984,78.2650184269222,62.5027713448079
8.7,"random_instances_SVM","SVM",41,32,612,554,58,3300,2959,341,0.931839588115241,0.603864734299517,1.76143516854979,694,340,354,22,1,84.36,8.7,0,0,0,0,0,0,0.189107266693258,67.6207918152839,56.0285792312387
8.7,"random_instances_SVM","SVM",41,33,512,463,49,3400,3050,350,0.931668337738911,0.608695652173913,1.76630101155684,710,348,362,16,1,86.91,8.7,0,0,0,0,0,0,0.106682835400178,56.8633022684097,49.7939701569045
8.7,"random_instances_SVM","SVM",41,34,412,371,41,3500,3142,358,0.932447250740957,0.603864734299517,1.76792893875643,733,356,377,23,1.1,89.47,8.8,0,0,0,0,0,0,0.0658945841176941,46.3933425104615,42.3991284448468
8.7,"random_instances_SVM","SVM",41,35,312,282,30,3600,3231,369,0.932324337164396,0.599033816425121,1.76630101155684,751,367,384,18,1,92.02,8.8,0,0,0,0,0,0,0.0478799934649031,32.9651057876695,30.8514178168667
8.7,"random_instances_SVM","SVM",41,36,212,190,22,3700,3323,377,0.931813348138232,0.599033816425121,1.76630101155684,759,372,387,8,1,94.58,8.8,0,0,0,0,0,0,0.0156255957770039,21.5141274141884,21.1458510247158
8.7,"random_instances_SVM","SVM",41,37,112,100,12,3800,3413,387,0.930389484122078,0.599033816425121,1.76467607962348,783,384,399,24,1,97.14,8.8,0,0,0,0,0,0,0.000717654123365298,10.9997553434967,10.9957918481229
8.7,"random_instances_SVM","SVM",41,38,12,9,3,3900,3504,396,0.930464060898869,0.594202898550725,1.76467607962348,802,392,410,19,1,99.69,8.8,0,0,0,0,0,0,0.000483482185754821,2.99049979054862,2.99049979054862
8.7,"random_instances_SVM","SVM",41,39,0,0,0,3912,3513,399,0.930392246224921,0.594202898550725,1.76630101155684,807,394,413,5,1,100,8.8,0,0,0,0,0,0,0,0,0
8.7,"random_instances_SVM","SVM",42,0,3812,3415,397,100,91,9,0.83546412300684,0.32,1.74868202764977,33,9,24,0,2.7,2.56,10.1,0,0,0,0,0,0,0.160213703157086,336.610007476141,21.571556131723
8.7,"random_instances_SVM","SVM",42,1,3712,3331,381,200,175,25,0.899914578587712,0.525,1.76508287292818,57,25,32,24,1.3,5.11,7,0,0,0,0,0,0,0.432141955399301,401.878432885653,53.1369934189189
8.7,"random_instances_SVM","SVM",42,2,3612,3238,374,300,268,32,0.900213553530756,0.52,1.77082720588235,80,32,48,23,1.5,7.67,8.4,0,0,0,0,0,0,0.382220043819982,336.255726862722,57.7164603250838
8.7,"random_instances_SVM","SVM",42,3,3512,3147,365,400,359,41,0.906852220956726,0.53,1.77082720588235,95,41,54,15,1.3,10.22,8.8,0,0,0,0,0,0,0.628829789284823,368.158658705492,78.9686679657654
8.7,"random_instances_SVM","SVM",42,4,3412,3057,355,500,449,51,0.9212485763098,0.585,1.7732967032967,118,51,67,23,1.3,12.78,8.8,0,0,0,0,0,0,0.538141964642616,323.485569225274,65.6707660498262
8.7,"random_instances_SVM","SVM",42,5,3312,2970,342,600,536,64,0.927978359908886,0.605,1.76595783684693,143,64,79,25,1.2,15.34,8.4,0,0,0,0,0,0,0.718091286199132,347.906150838672,80.9032997276844
8.7,"random_instances_SVM","SVM",42,6,3212,2881,331,700,625,75,0.929631264236912,0.59,1.7765504587156,164,75,89,21,1.2,17.89,8.3,0,0,0,0,0,0,0.683531289865948,339.695002922451,78.3914920135058
8.7,"random_instances_SVM","SVM",42,7,3112,2789,323,800,717,83,0.927599658314359,0.61,1.78716253443526,183,83,100,19,1.2,20.45,8.6,0,0,0,0,0,0,0.575796155850402,287.701242130017,68.8476100165625
8.7,"random_instances_SVM","SVM",42,8,3012,2698,314,900,808,92,0.930723234624153,0.615,1.78552293577982,207,92,115,24,1.2,23.01,8.8,0,0,0,0,0,0,0.714714134888566,310.439879584292,81.3451223168845
8.7,"random_instances_SVM","SVM",42,9,2912,2604,308,1000,902,98,0.931064920273357,0.605,1.78716253443526,217,98,119,10,1.2,25.56,9.2,0,0,0,0,0,0,0.726626950405838,299.329947632982,83.3386716587958
8.7,"random_instances_SVM","SVM",42,10,2812,2514,298,1100,992,108,0.932820330296132,0.62,1.79209944751381,234,108,126,17,1.2,28.12,9.2,0,0,0,0,0,0,0.640316515047158,283.957663863392,74.992829830667
8.7,"random_instances_SVM","SVM",42,11,2712,2425,287,1200,1081,119,0.935673405466974,0.61,1.79209944751381,254,119,135,20,1.1,30.67,9.1,0,0,0,0,0,0,0.627267295150787,270.132628601024,72.9441913764641
8.7,"random_instances_SVM","SVM",42,12,2612,2336,276,1300,1170,130,0.937306378132124,0.615,1.78716253443526,276,130,146,22,1.1,33.23,9,0,0,0,0,0,0,0.730360031269376,269.709556506051,81.2084139869061
8.7,"random_instances_SVM","SVM",42,13,2512,2249,263,1400,1257,143,0.936722665148071,0.61,1.78880514705882,301,143,158,25,1.1,35.79,8.8,0,0,0,0,0,0,0.570022366167768,236.234877192195,68.7152803439426
8.7,"random_instances_SVM","SVM",42,14,2412,2162,250,1500,1344,156,0.938621867881558,0.625,1.78880514705882,323,156,167,22,1.1,38.34,8.6,0,0,0,0,0,0,0.736877045406447,255.639133569332,82.8978044123935
8.7,"random_instances_SVM","SVM",42,15,2312,2069,243,1600,1437,163,0.937471526195904,0.63,1.78552293577982,342,163,179,19,1.1,40.9,8.8,0,0,0,0,0,0,0.683400761794183,245.963640985405,79.3615589248523
8.7,"random_instances_SVM","SVM",42,16,2212,1982,230,1700,1524,176,0.93916856492028,0.62,1.78880514705882,364,176,188,22,1.1,43.46,8.7,0,0,0,0,0,0,0.713789319782192,242.007238530711,81.6842083662323
8.7,"random_instances_SVM","SVM",42,17,2112,1889,223,1800,1617,183,0.93916144646925,0.62,1.78880514705882,383,183,200,19,1.1,46.01,8.8,0,0,0,0,0,0,0.709951124381845,231.621490582732,81.8345543471296
8.7,"random_instances_SVM","SVM",42,18,2012,1799,213,1900,1707,193,0.938889521640094,0.62,1.78062214089661,404,193,211,21,1.1,48.57,8.8,0,0,0,0,0,0,0.685413819077656,219.306031198854,82.0736664700467
8.7,"random_instances_SVM","SVM",42,19,1912,1709,203,2000,1797,203,0.938539293849661,0.605,1.78716253443526,419,203,216,15,1.1,51.12,8.9,0,0,0,0,0,0,0.643018106275228,203.004640538878,78.6105618380909
8.7,"random_instances_SVM","SVM",42,20,1812,1621,191,2100,1885,215,0.939235478359913,0.605,1.78880514705882,444,215,229,25,1.1,53.68,8.8,0,0,0,0,0,0,0.734627112959927,207.580209823998,84.973236578094
8.7,"random_instances_SVM","SVM",42,21,1712,1529,183,2200,1977,223,0.938153473804106,0.61,1.78552293577982,468,223,245,24,1.1,56.24,8.9,0,0,0,0,0,0,0.689842850213483,193.830160608257,82.2681369745553
8.7,"random_instances_SVM","SVM",42,22,1612,1441,171,2300,2065,235,0.938414009111621,0.625,1.78716253443526,491,235,256,23,1.1,58.79,8.8,0,0,0,0,0,0,0.63985734424093,183.382326122587,79.6286309714592
8.7,"random_instances_SVM","SVM",42,23,1512,1346,166,2400,2160,240,0.938112186788159,0.625,1.78716253443526,498,240,258,7,1.1,61.35,9,0,0,0,0,0,0,0.664942582833521,176.304446543889,82.9502792670341
8.7,"random_instances_SVM","SVM",42,24,1412,1258,154,2500,2248,252,0.93929384965832,0.625,1.78880514705882,521,252,269,23,1.1,63.91,8.9,0,0,0,0,0,0,0.649113312671585,166.143606648265,81.1029155309471
8.7,"random_instances_SVM","SVM",42,25,1312,1170,142,2600,2336,264,0.939988610478362,0.63,1.79779411764706,546,264,282,25,1.1,66.46,8.8,0,0,0,0,0,0,0.604609279650264,152.78769157584,80.0866767669443
8.7,"random_instances_SVM","SVM",42,26,1212,1084,128,2700,2422,278,0.940959567198181,0.625,1.79614325068871,576,278,298,30,1.1,69.02,8.7,0,0,0,0,0,0,0.580437411532076,145.369758499027,78.9093427425533
8.7,"random_instances_SVM","SVM",42,27,1112,992,120,2800,2514,286,0.939965831435083,0.625,1.79944802207912,594,286,308,18,1.1,71.57,8.8,0,0,0,0,0,0,0.535393062396226,134.866554642167,77.4226630128254
8.7,"random_instances_SVM","SVM",42,28,1012,899,113,2900,2607,293,0.9399131548975,0.62,1.79779411764706,606,293,313,12,1.1,74.13,8.9,0,0,0,0,0,0,0.510027226309884,124.796125434124,76.1792752305326
8.7,"random_instances_SVM","SVM",42,29,912,812,100,3000,2694,306,0.940056947608204,0.62,1.79944802207912,632,306,326,26,1.1,76.69,8.8,0,0,0,0,0,0,0.5,113.472992864251,75.8725623718164
8.7,"random_instances_SVM","SVM",42,30,812,725,87,3100,2781,319,0.940726082004559,0.635,1.79944802207912,656,319,337,24,1.1,79.24,8.7,0,0,0,0,0,0,0.379764444169081,98.3533445879753,71.1855937229211
8.7,"random_instances_SVM","SVM",42,31,712,636,76,3200,2870,330,0.940552391799551,0.63,1.79944802207912,676,329,347,20,1.1,81.8,8.7,0,0,0,0,0,0,0.31574805337583,86.4084062327944,66.0593952354986
8.7,"random_instances_SVM","SVM",42,32,612,548,64,3300,2958,342,0.94175398633258,0.63,1.79614325068871,695,338,357,19,1.1,84.36,8.6,0,0,0,0,0,0,0.223524752051874,75.7114454334834,60.3730284525681
8.7,"random_instances_SVM","SVM",42,33,512,454,58,3400,3052,348,0.94177107061504,0.63,1.79944802207912,710,345,365,15,1.1,86.91,8.8,0,0,0,0,0,0,0.179675150122646,67.7873053934876,56.576773602204
8.7,"random_instances_SVM","SVM",42,34,412,365,47,3500,3141,359,0.942109908883833,0.625,1.79614325068871,731,355,376,21,1.1,89.47,8.7,0,0,0,0,0,0,0.112469329645269,52.5251962608913,46.4192726277801
8.7,"random_instances_SVM","SVM",42,35,312,280,32,3600,3226,374,0.942052961275628,0.635,1.79285059578368,755,367,388,24,1.1,92.02,8.6,0,0,0,0,0,0,0.0506078831677014,36.4098656414151,34.3905082538137
8.7,"random_instances_SVM","SVM",42,36,212,192,20,3700,3314,386,0.942445899772215,0.635,1.79944802207912,777,379,398,22,1.1,94.58,8.6,0,0,0,0,0,0,0.0125746809428024,24.5040423369146,24.0671277659149
8.7,"random_instances_SVM","SVM",42,37,112,97,15,3800,3409,391,0.942692198177683,0.635,1.80110497237569,786,385,401,9,1,97.14,8.7,0,0,0,0,0,0,0.00170027559507171,15.6784318631105,15.666046088524
8.7,"random_instances_SVM","SVM",42,38,12,9,3,3900,3497,403,0.942400341685655,0.635,1.79944802207912,814,396,418,28,1.1,99.69,8.7,0,0,0,0,0,0,0.00211341142010405,2.65377665433075,2.65377665433075
8.7,"random_instances_SVM","SVM",42,39,0,0,0,3912,3506,406,0.942290717539868,0.63,1.79449541284404,814,396,418,0,1.1,100,8.6,0,0,0,0,0,0,0,0,0
8.7,"random_instances_SVM","SVM",43,0,3812,3422,390,100,93,7,0.917403176463824,0.583732057416268,1.7789552769979,19,7,12,0,1.7,2.56,13.3,0,0,0,0,0,0,0.820616908890698,611.355629772365,85.1710831185143
8.7,"random_instances_SVM","SVM",43,1,3712,3338,374,200,177,23,0.914790358317612,0.569377990430622,1.7445793296163,51,23,28,32,1.2,5.11,7.7,0,0,0,0,0,0,0.850744646494423,490.406204542965,88.06540282395
8.7,"random_instances_SVM","SVM",43,2,3612,3243,369,300,272,28,0.90808302955442,0.569377990430622,1.70474023144337,63,28,35,12,1.2,7.67,9.7,0,0,0,0,0,0,0.712381455449433,363.190894781096,78.8764273908567
8.7,"random_instances_SVM","SVM",43,3,3512,3155,357,400,360,40,0.921440172215932,0.598086124401914,1.7703612901525,88,40,48,25,1.2,10.22,9,0,0,0,0,0,0,0.67581259588263,348.944584432928,72.7398073489184
8.7,"random_instances_SVM","SVM",43,4,3412,3072,340,500,443,57,0.920555538818418,0.593301435406699,1.76663406381348,117,57,60,29,1.1,12.78,7.8,0,0,0,0,0,0,0.841628983171027,391.953375915291,88.1738729786884
8.7,"random_instances_SVM","SVM",43,5,3312,2981,331,600,534,66,0.920878717582843,0.598086124401914,1.7445793296163,139,66,73,22,1.1,15.34,8.1,0,0,0,0,0,0,0.805171874574892,402.01936663045,85.6324913843592
8.7,"random_instances_SVM","SVM",43,6,3212,2890,322,700,625,75,0.924482982447008,0.607655502392344,1.7531733164617,155,75,80,16,1.1,17.89,8.3,0,0,0,0,0,0,0.802790062055536,369.313282392132,85.5485447825713
8.7,"random_instances_SVM","SVM",43,7,3112,2796,316,800,719,81,0.92266715599949,0.602870813397129,1.7531733164617,169,80,89,14,1.1,20.45,8.9,0,0,0,0,0,0,0.791261031060601,354.709856427729,85.0177608465127
8.7,"random_instances_SVM","SVM",43,8,3012,2709,303,900,806,94,0.923236827041844,0.583732057416268,1.75156490057504,188,91,97,19,1.1,23.01,8.6,0,0,0,0,0,0,0.812794444882544,346.076073379498,86.3062473542479
8.7,"random_instances_SVM","SVM",43,9,2912,2618,294,1000,897,103,0.923549050593899,0.593301435406699,1.76711589823655,210,102,108,22,1.1,25.56,8.7,0,0,0,0,0,0,0.777016904765549,317.213476700621,83.8235378822271
8.7,"random_instances_SVM","SVM",43,10,2812,2532,280,1100,983,117,0.925351183025978,0.583732057416268,1.75853766572084,236,113,123,26,1.1,28.12,8.4,0,0,0,0,0,0,0.79963667789922,326.879908607882,85.8506366067981
8.7,"random_instances_SVM","SVM",43,11,2712,2443,269,1200,1072,128,0.92761891198307,0.607655502392344,1.76663406381348,266,128,138,30,1.1,30.67,8.4,0,0,0,0,0,0,0.720999505491973,298.621347973093,80.0454528909846
8.7,"random_instances_SVM","SVM",43,12,2612,2355,257,1300,1160,140,0.92882535474346,0.602870813397129,1.76873710548264,282,138,144,16,1,33.23,8.3,0,0,0,0,0,0,0.76137352317868,283.774142416037,84.3273756353372
8.7,"random_instances_SVM","SVM",43,13,2512,2268,244,1400,1247,153,0.93199962752276,0.617224880382775,1.76873710548264,316,153,163,34,1.1,35.79,8.2,0,0,0,0,0,0,0.714625228692065,273.723052785857,82.6881239374802
8.7,"random_instances_SVM","SVM",43,14,2412,2177,235,1500,1338,162,0.932224209376002,0.607655502392344,1.78386951809458,333,162,171,17,1.1,38.34,8.3,0,0,0,0,0,0,0.691182129521548,249.924908805392,81.9039382495595
8.7,"random_instances_SVM","SVM",43,15,2312,2086,226,1600,1429,171,0.932011952136662,0.593301435406699,1.78222842378171,359,171,188,26,1.1,40.9,8.4,0,0,0,0,0,0,0.719393385002773,246.484279276494,84.1940257256396
8.7,"random_instances_SVM","SVM",43,16,2212,1995,217,1700,1520,180,0.932209145959013,0.602870813397129,1.77244491916809,372,180,192,13,1.1,43.46,8.4,0,0,0,0,0,0,0.737843547339162,244.438637560606,85.5518238007561
8.7,"random_instances_SVM","SVM",43,17,2112,1902,210,1800,1613,187,0.931866795572977,0.61244019138756,1.78222842378171,388,187,201,16,1.1,46.01,8.6,0,0,0,0,0,0,0.753559858302322,232.94525984582,86.8373231150241
8.7,"random_instances_SVM","SVM",43,18,2012,1812,200,1900,1703,197,0.931943482059458,0.602870813397129,1.7789552769979,409,197,212,21,1.1,48.57,8.6,0,0,0,0,0,0,0.670490441899048,214.551619374036,83.1004737231815
8.7,"random_instances_SVM","SVM",43,19,1912,1720,192,2000,1795,205,0.932184496731212,0.593301435406699,1.77198846045595,429,205,224,20,1.1,51.12,8.8,0,0,0,0,0,0,0.615040157064597,205.880743609389,81.0075467392624
8.7,"random_instances_SVM","SVM",43,20,1812,1627,185,2100,1888,212,0.932962316808283,0.598086124401914,1.77361862463301,442,212,230,13,1.1,53.68,8.9,0,0,0,0,0,0,0.620528623260065,194.502191390911,81.9109499118799
8.7,"random_instances_SVM","SVM",43,21,1712,1538,174,2200,1977,223,0.932917126557329,0.588516746411483,1.78059034618632,463,223,240,21,1.1,56.24,8.9,0,0,0,0,0,0,0.582932641112909,180.6164604937,79.3704739641334
8.7,"random_instances_SVM","SVM",43,22,1612,1446,166,2300,2069,231,0.933504599819765,0.588516746411483,1.78222842378171,482,231,251,19,1.1,58.79,9,0,0,0,0,0,0,0.59465761448893,176.757634120858,81.0271492484958
8.7,"random_instances_SVM","SVM",43,23,1512,1354,158,2400,2161,239,0.934100289491463,0.588516746411483,1.78059034618632,498,239,259,16,1.1,61.35,9,0,0,0,0,0,0,0.545577598970584,162.529248922337,77.2065073442613
8.7,"random_instances_SVM","SVM",43,24,1412,1265,147,2500,2250,250,0.934408404838892,0.598086124401914,1.78222842378171,520,250,270,22,1.1,63.91,9,0,0,0,0,0,0,0.520285753294251,153.456289206979,76.0885352693578
8.7,"random_instances_SVM","SVM",43,25,1312,1176,136,2600,2339,261,0.932261183217688,0.583732057416268,1.78222842378171,541,261,280,21,1.1,66.46,9,0,0,0,0,0,0,0.517572753608074,144.519243762594,76.5018890074756
8.7,"random_instances_SVM","SVM",43,26,1212,1092,120,2700,2423,277,0.931050632252671,0.583732057416268,1.7789552769979,572,277,295,31,1.1,69.02,8.7,0,0,0,0,0,0,0.450605551124862,128.590914751038,71.5922452883323
8.7,"random_instances_SVM","SVM",43,27,1112,1007,105,2800,2508,292,0.93215984750342,0.593301435406699,1.78386951809458,603,292,311,31,1.1,71.57,8.6,0,0,0,0,0,0,0.453556970199394,121.497976922178,71.7784455767203
8.7,"random_instances_SVM","SVM",43,28,1012,916,96,2900,2599,301,0.934052360437418,0.602870813397129,1.7855136374661,624,301,323,21,1.1,74.13,8.6,0,0,0,0,0,0,0.441755713768901,113.179615146722,69.6904711823583
8.7,"random_instances_SVM","SVM",43,29,912,827,85,3000,2688,312,0.933411480514761,0.602870813397129,1.77688796771989,635,309,326,11,1.1,76.69,8.6,0,0,0,0,0,0,0.357454122760831,96.893670982145,64.2478319103571
8.7,"random_instances_SVM","SVM",43,30,812,737,75,3100,2778,322,0.933096518159611,0.602870813397129,1.77361862463301,661,319,342,26,1.1,79.24,8.6,0,0,0,0,0,0,0.279761763070196,84.8355102340748,59.5154680491662
8.7,"random_instances_SVM","SVM",43,31,712,644,68,3200,2871,329,0.933582655707781,0.602870813397129,1.78059034618632,672,326,346,11,1.1,81.8,8.7,0,0,0,0,0,0,0.231712421381667,73.8712558184832,55.1741642660206
8.7,"random_instances_SVM","SVM",43,32,612,553,59,3300,2962,338,0.933916789684552,0.602870813397129,1.78059034618632,690,335,355,18,1.1,84.36,8.8,0,0,0,0,0,0,0.150668274913085,62.7826180125389,51.0047839079846
8.7,"random_instances_SVM","SVM",43,33,512,464,48,3400,3051,349,0.934227643835069,0.598086124401914,1.7855136374661,709,345,364,19,1.1,86.91,8.7,0,0,0,0,0,0,0.0955942259463202,51.1777814219648,43.6143331677318
8.7,"random_instances_SVM","SVM",43,34,412,374,38,3500,3141,359,0.934328979549334,0.61244019138756,1.7855136374661,731,354,377,22,1.1,89.47,8.7,0,0,0,0,0,0,0.0700995996192892,43.0190139394967,38.032375515039
8.7,"random_instances_SVM","SVM",43,35,312,289,23,3600,3226,374,0.935371094124424,0.607655502392344,1.78059034618632,758,368,390,27,1.1,92.02,8.6,0,0,0,0,0,0,0.0500123669123325,29.8580113593824,27.5494245666315
8.7,"random_instances_SVM","SVM",43,36,212,197,15,3700,3318,382,0.935516250688099,0.602870813397129,1.77525179095403,769,374,395,11,1.1,94.58,8.7,0,0,0,0,0,0,0.0135603341304126,18.829327764921,18.384559859484
8.7,"random_instances_SVM","SVM",43,37,112,107,5,3800,3408,392,0.935736724336705,0.607655502392344,1.7789552769979,783,383,400,14,1,97.14,8.7,0,0,0,0,0,0,0.00105833984499821,8.35139721360027,8.34576069919127
8.7,"random_instances_SVM","SVM",43,38,12,11,1,3900,3504,396,0.935895574915825,0.61244019138756,1.78222842378171,797,388,409,14,1.1,99.69,8.8,0,0,0,0,0,0,0.000310151519664986,0.835206323175039,0.835206323175039
8.7,"random_instances_SVM","SVM",43,39,0,0,0,3912,3515,397,0.935805194413912,0.61244019138756,1.78059034618632,799,389,410,2,1.1,100,8.9,0,0,0,0,0,0,0,0,0
8.7,"random_instances_SVM","SVM",44,0,3812,3403,409,100,85,15,0.910045281663098,0.5,1.7748656453036,37,15,22,0,1.5,2.56,5.7,0,0,0,0,0,0,0.714286760749304,670.433591407082,74.8602076343814
8.7,"random_instances_SVM","SVM",44,1,3712,3319,393,200,169,31,0.919992071063108,0.527472527472527,1.78791612798966,68,31,37,31,1.2,5.11,5.5,0,0,0,0,0,0,0.908030908803428,708.120845368167,92.4150908998511
8.7,"random_instances_SVM","SVM",44,2,3612,3231,381,300,257,43,0.928187370690199,0.543956043956044,1.77002069813717,96,43,53,28,1.2,7.67,6,0,0,0,0,0,0,0.691558924426748,530.104288497325,73.5139423601925
8.7,"random_instances_SVM","SVM",44,3,3512,3146,366,400,342,58,0.926220622669326,0.521978021978022,1.78627433172888,118,56,62,22,1.1,10.22,5.9,0,0,0,0,0,0,0.825617716005425,507.03680293045,86.3358770894184
8.7,"random_instances_SVM","SVM",44,4,3412,3056,356,500,432,68,0.928486254444543,0.538461538461538,1.78791612798966,135,65,70,17,1.1,12.78,6.4,0,0,0,0,0,0,0.786822343297898,481.363765683003,82.6470782766827
8.7,"random_instances_SVM","SVM",44,5,3312,2964,348,600,524,76,0.929497503623773,0.532967032967033,1.78956094503473,159,75,84,24,1.1,15.34,6.9,0,0,0,0,0,0,0.836150680070264,487.047736877233,87.768340157257
8.7,"random_instances_SVM","SVM",44,6,3212,2874,338,700,614,86,0.929128931947418,0.532967032967033,1.78627433172888,175,83,92,16,1.1,17.89,7.1,0,0,0,0,0,0,0.811633056069284,442.350624319631,85.6637758883307
8.7,"random_instances_SVM","SVM",44,7,3112,2779,333,800,709,91,0.92922339779724,0.56043956043956,1.78791612798966,192,91,101,17,1.1,20.45,7.8,0,0,0,0,0,0,0.82340620620487,413.66881565653,86.9159847313113
8.7,"random_instances_SVM","SVM",44,8,3012,2687,325,900,801,99,0.930459196947357,0.554945054945055,1.79120879120879,209,99,110,17,1.1,23.01,8.1,0,0,0,0,0,0,0.729664820463574,361.569514494466,79.6943636411333
8.7,"random_instances_SVM","SVM",44,9,2912,2596,316,1000,892,108,0.929404586394436,0.56043956043956,1.78299976833432,235,108,127,26,1.2,25.56,8.3,0,0,0,0,0,0,0.653716989960988,343.731672896426,72.4308730087457
8.7,"random_instances_SVM","SVM",44,10,2812,2503,309,1100,985,115,0.928184273449209,0.576923076923077,1.78956094503473,243,115,128,8,1.1,28.12,8.6,0,0,0,0,0,0,0.789046534780035,351.204675396765,85.6897460697445
8.7,"random_instances_SVM","SVM",44,11,2712,2410,302,1200,1078,122,0.929875367023052,0.571428571428571,1.7846355479383,261,122,139,18,1.1,30.67,8.8,0,0,0,0,0,0,0.706750928740932,322.398937541879,78.5580869889808
8.7,"random_instances_SVM","SVM",44,12,2612,2319,293,1300,1169,131,0.929029820236132,0.56043956043956,1.77803813833226,281,131,150,20,1.1,33.23,8.9,0,0,0,0,0,0,0.767660300913496,326.615205134842,84.6481462339451
8.7,"random_instances_SVM","SVM",44,13,2512,2232,280,1400,1256,144,0.929076278850806,0.587912087912088,1.77640541276905,302,144,158,21,1.1,35.79,8.7,0,0,0,0,0,0,0.73786376622832,308.736607951132,81.6464079726013
8.7,"random_instances_SVM","SVM",44,14,2412,2139,273,1500,1349,151,0.927722784543537,0.593406593406593,1.77640541276905,323,151,172,21,1.1,38.34,8.9,0,0,0,0,0,0,0.803527068707765,307.500369182367,88.0461849958113
8.7,"random_instances_SVM","SVM",44,15,2312,2052,260,1600,1436,164,0.929599712576052,0.565934065934066,1.77640541276905,344,164,180,21,1.1,40.9,8.8,0,0,0,0,0,0,0.750866790005403,282.613839489337,83.8192459628869
8.7,"random_instances_SVM","SVM",44,16,2212,1965,247,1700,1523,177,0.928967875416596,0.56043956043956,1.78627433172888,367,177,190,23,1.1,43.46,8.6,0,0,0,0,0,0,0.741628621885852,274.296708813647,84.5327921527
8.7,"random_instances_SVM","SVM",44,17,2112,1876,236,1800,1612,188,0.929935763222139,0.571428571428571,1.79120879120879,389,188,201,22,1.1,46.01,8.6,0,0,0,0,0,0,0.743147169028293,263.630995165896,84.8211529131647
8.7,"random_instances_SVM","SVM",44,18,2012,1790,222,1900,1698,202,0.930663614851902,0.576923076923077,1.7846355479383,420,202,218,31,1.1,48.57,8.4,0,0,0,0,0,0,0.731304355770864,246.497227909543,84.3598028098946
8.7,"random_instances_SVM","SVM",44,19,1912,1703,209,2000,1785,215,0.929996159421207,0.576923076923077,1.78131261004189,437,211,226,17,1.1,51.12,8.3,0,0,0,0,0,0,0.706048096545306,235.737350682724,82.2850402487524
8.7,"random_instances_SVM","SVM",44,20,1812,1617,195,2100,1871,229,0.930084430789071,0.571428571428571,1.77477568303256,456,223,233,19,1,53.68,8.2,0,0,0,0,0,0,0.678228782169344,213.977471422389,81.1549074082069
8.7,"random_instances_SVM","SVM",44,21,1712,1525,187,2200,1963,237,0.929897047709917,0.576923076923077,1.77967386799034,474,230,244,18,1.1,56.24,8.3,0,0,0,0,0,0,0.670861165577957,205.036283176626,80.8733371678784
8.7,"random_instances_SVM","SVM",44,22,1612,1437,175,2300,2051,249,0.92927759951437,0.576923076923077,1.77141642887499,499,243,256,25,1.1,58.79,8.2,0,0,0,0,0,0,0.698928576269536,200.319664355562,82.264580143888
8.7,"random_instances_SVM","SVM",44,23,1512,1349,163,2400,2139,261,0.93068839277973,0.593406593406593,1.76816014867485,522,255,267,23,1,61.35,8.2,0,0,0,0,0,0,0.639771425732461,181.628565503098,79.5363956748976
8.7,"random_instances_SVM","SVM",44,24,1412,1262,150,2500,2226,274,0.930200577325737,0.587912087912088,1.77141642887499,543,265,278,21,1,63.91,8.1,0,0,0,0,0,0,0.610052127903182,167.83663607751,78.3078512405192
8.7,"random_instances_SVM","SVM",44,25,1312,1171,141,2600,2317,283,0.930352342133647,0.598901098901099,1.76978679094594,565,275,290,22,1.1,66.46,8.2,0,0,0,0,0,0,0.563650516116498,151.509499061904,75.6029855681686
8.7,"random_instances_SVM","SVM",44,26,1212,1085,127,2700,2403,297,0.929578031889198,0.587912087912088,1.77304907074492,592,287,305,27,1.1,69.02,8.1,0,0,0,0,0,0,0.550239839595106,140.2614527973,75.7898396698473
8.7,"random_instances_SVM","SVM",44,27,1112,995,117,2800,2493,307,0.930807636557373,0.582417582417582,1.76653649380922,614,300,314,22,1,71.57,8.1,0,0,0,0,0,0,0.511602517132579,129.421262213237,73.6792258981206
8.7,"random_instances_SVM","SVM",44,28,1012,907,105,2900,2581,319,0.932435236691175,0.598901098901099,1.76816014867485,641,311,330,27,1.1,74.13,8.1,0,0,0,0,0,0,0.426379957076857,114.256920585377,67.8585749609865
8.7,"random_instances_SVM","SVM",44,29,912,822,90,3000,2666,334,0.934214601632887,0.587912087912088,1.76653649380922,658,322,336,17,1,76.69,8,0,0,0,0,0,0,0.363267541238953,99.6722041867712,64.898836884416
8.7,"random_instances_SVM","SVM",44,30,812,729,83,3100,2759,341,0.933991600282488,0.604395604395604,1.77640541276905,682,331,351,24,1.1,79.24,8.1,0,0,0,0,0,0,0.276718638403276,89.0294476383259,62.0472595117338
8.7,"random_instances_SVM","SVM",44,31,712,637,75,3200,2851,349,0.931851406766873,0.604395604395604,1.76978679094594,697,341,356,15,1,81.8,8.2,0,0,0,0,0,0,0.219107429749367,74.4853245738423,56.6714970885702
8.7,"random_instances_SVM","SVM",44,32,612,547,65,3300,2941,359,0.932566869432729,0.598901098901099,1.77640541276905,722,350,372,25,1.1,84.36,8.2,0,0,0,0,0,0,0.163888617698238,63.4209766822981,49.8119483325564
8.7,"random_instances_SVM","SVM",44,33,512,456,56,3400,3032,368,0.933951336149779,0.593406593406593,1.77640541276905,743,359,384,21,1.1,86.91,8.2,0,0,0,0,0,0,0.129385563544655,55.3695899082824,45.5540541328346
8.7,"random_instances_SVM","SVM",44,34,412,370,42,3500,3118,382,0.933973016836622,0.593406593406593,1.77967386799034,755,367,388,12,1.1,89.47,8.2,0,0,0,0,0,0,0.0902470828696597,43.0222469265325,37.4367044798166
8.7,"random_instances_SVM","SVM",44,35,312,281,31,3600,3207,393,0.934615694339501,0.598901098901099,1.78131261004189,775,375,400,20,1.1,92.02,8.2,0,0,0,0,0,0,0.0535039727834328,31.230528292543,28.6970243598573
8.7,"random_instances_SVM","SVM",44,36,212,190,22,3700,3298,402,0.935270760806292,0.587912087912088,1.77640541276905,794,384,410,19,1.1,94.58,8.2,0,0,0,0,0,0,0.0209522606266896,20.8093813391522,20.172701358567
8.7,"random_instances_SVM","SVM",44,37,112,104,8,3800,3384,416,0.935489116295223,0.593406593406593,1.79120879120879,817,396,421,23,1.1,97.14,8.1,0,0,0,0,0,0,0.00202768135567298,9.76090434651642,9.74951974917641
8.7,"random_instances_SVM","SVM",44,38,12,11,1,3900,3477,423,0.935132933582784,0.598901098901099,1.7846355479383,821,402,419,4,1,99.69,8.2,0,0,0,0,0,0,0.00029707947777821,0.988203740493279,0.988203740493279
8.7,"random_instances_SVM","SVM",44,39,0,0,0,3912,3488,424,0.935106607034474,0.598901098901099,1.77314894088496,826,404,422,5,1,100,8.2,0,0,0,0,0,0,0,0,0
8.7,"random_instances_SVM","SVM",45,0,3812,3420,392,100,90,10,0.914674545617339,0.622549019607843,1.7585795608566,22,10,12,0,1.2,2.56,9,0,0,0,0,0,0,0.417457345513292,305.371835393403,45.7179714656499
8.7,"random_instances_SVM","SVM",45,1,3712,3336,376,200,174,26,0.920239614110488,0.573529411764706,1.772025187019,57,26,31,35,1.2,5.11,6.7,0,0,0,0,0,0,0.56978230686739,387.684301693945,63.2704455664527
8.7,"random_instances_SVM","SVM",45,2,3612,3245,367,300,265,35,0.919798941266009,0.607843137254902,1.77135596885813,75,35,40,18,1.1,7.67,7.6,0,0,0,0,0,0,0.61881444168645,389.613542588657,67.3659320147578
8.7,"random_instances_SVM","SVM",45,3,3512,3155,357,400,355,45,0.905175597636324,0.607843137254902,1.72570626046562,98,45,53,23,1.2,10.22,7.9,0,0,0,0,0,0,0.466040267215928,317.371171994636,54.8464844312705
8.7,"random_instances_SVM","SVM",45,4,3412,3065,347,500,445,55,0.87884714388038,0.612745098039216,1.60834914611006,121,55,66,23,1.2,12.78,8.1,0,0,0,0,0,0,0.291609382424081,335.913482592093,34.5053699388075
8.7,"random_instances_SVM","SVM",45,5,3312,2975,337,600,535,65,0.897317631390461,0.612745098039216,1.6744160899654,139,65,74,18,1.1,15.34,8.2,0,0,0,0,0,0,0.602341877982233,334.178675302169,66.9286163377566
8.7,"random_instances_SVM","SVM",45,6,3212,2885,327,700,625,75,0.907090775808048,0.612745098039216,1.72729238754325,163,75,88,24,1.2,17.89,8.3,0,0,0,0,0,0,0.770721566700086,348.512323364596,82.3821732751723
8.7,"random_instances_SVM","SVM",45,7,3112,2797,315,800,713,87,0.91810479899723,0.617647058823529,1.75373053633218,182,87,95,19,1.1,20.45,8.2,0,0,0,0,0,0,0.736022610083779,332.023433243755,79.330850909502
8.7,"random_instances_SVM","SVM",45,8,3012,2704,308,900,806,94,0.918549668725943,0.617647058823529,1.76416472752855,195,94,101,13,1.1,23.01,8.6,0,0,0,0,0,0,0.741013819373945,319.335287447907,80.3719557143926
8.7,"random_instances_SVM","SVM",45,9,2912,2610,302,1000,900,100,0.924148312292959,0.627450980392157,1.76486748545572,211,100,111,16,1.1,25.56,9,0,0,0,0,0,0,0.746170931035006,298.719785401763,81.4966450718264
8.7,"random_instances_SVM","SVM",45,10,2812,2519,293,1100,991,109,0.922444377294303,0.622549019607843,1.77461813454664,228,109,119,17,1.1,28.12,9.1,0,0,0,0,0,0,0.642616788831559,268.643162681473,71.602434601113
8.7,"random_instances_SVM","SVM",45,11,2712,2428,284,1200,1082,118,0.923026345241298,0.612745098039216,1.78509081051776,247,118,129,19,1.1,30.67,9.2,0,0,0,0,0,0,0.764192187591982,284.348320625841,83.8315982017725
8.7,"random_instances_SVM","SVM",45,12,2612,2340,272,1300,1170,130,0.923571940191607,0.622549019607843,1.77135596885813,268,130,138,21,1.1,33.23,9,0,0,0,0,0,0,0.722293915743665,266.495602600931,79.6597995385746
8.7,"random_instances_SVM","SVM",45,13,2512,2253,259,1400,1257,143,0.92524509803922,0.627450980392157,1.76972937935505,292,143,149,24,1,35.79,8.8,0,0,0,0,0,0,0.66688443288634,249.997984848119,76.7738112849692
8.7,"random_instances_SVM","SVM",45,14,2412,2165,247,1500,1345,155,0.925172352045845,0.612745098039216,1.77853400313293,320,155,165,28,1.1,38.34,8.7,0,0,0,0,0,0,0.720344395160506,247.834622274612,81.4033623103427
8.7,"random_instances_SVM","SVM",45,15,2312,2069,243,1600,1441,159,0.923507587966699,0.622549019607843,1.76254325259516,328,159,169,8,1.1,40.9,9.1,0,0,0,0,0,0,0.682998451032657,227.138189569932,78.5813452111608
8.7,"random_instances_SVM","SVM",45,16,2212,1980,232,1700,1530,170,0.923219401916023,0.622549019607843,1.76416472752855,349,170,179,21,1.1,43.46,9,0,0,0,0,0,0,0.729152447186138,222.2013451015,84.1103917846357
8.7,"random_instances_SVM","SVM",45,17,2112,1889,223,1800,1621,179,0.922427589757369,0.627450980392157,1.76810577441986,372,179,193,23,1.1,46.01,9.1,0,0,0,0,0,0,0.702211091437657,212.907078543443,82.1705355986044
8.7,"random_instances_SVM","SVM",45,18,2012,1800,212,1900,1710,190,0.922419195988903,0.612745098039216,1.76254325259516,388,190,198,16,1,48.57,9,0,0,0,0,0,0,0.684342940053909,199.873381171894,80.5085047242276
8.7,"random_instances_SVM","SVM",45,19,1912,1711,201,2000,1799,201,0.924053182917006,0.622549019607843,1.78180637480383,412,200,212,24,1.1,51.12,9,0,0,0,0,0,0,0.697133537310344,197.955723849605,81.717755663027
8.7,"random_instances_SVM","SVM",45,20,1812,1620,192,2100,1890,210,0.924514840182652,0.622549019607843,1.77853400313293,431,208,223,19,1.1,53.68,9,0,0,0,0,0,0,0.655673786984352,183.976447178806,79.7716228674591
8.7,"random_instances_SVM","SVM",45,21,1712,1530,182,2200,1980,220,0.926284526367628,0.632352941176471,1.76810577441986,450,219,231,19,1.1,56.24,9,0,0,0,0,0,0,0.629569510569354,175.713821707559,78.3729374030094
8.7,"random_instances_SVM","SVM",45,22,1612,1438,174,2300,2072,228,0.925723542841799,0.632352941176471,1.77461813454664,469,228,241,19,1.1,58.79,9.1,0,0,0,0,0,0,0.671883397370828,171.840297889719,81.9434974699051
8.7,"random_instances_SVM","SVM",45,23,1512,1346,166,2400,2164,236,0.9281801190796,0.637254901960784,1.76972937935505,485,236,249,16,1.1,61.35,9.2,0,0,0,0,0,0,0.636007399335691,160.805774133114,79.9460401175592
8.7,"random_instances_SVM","SVM",45,24,1412,1258,154,2500,2252,248,0.93108995881458,0.642156862745098,1.77298555116619,518,248,270,33,1.1,63.91,9.1,0,0,0,0,0,0,0.630972917736581,154.697313323511,80.4659670358267
8.7,"random_instances_SVM","SVM",45,25,1312,1167,145,2600,2343,257,0.930603120243535,0.637254901960784,1.77298555116619,538,257,281,20,1.1,66.46,9.1,0,0,0,0,0,0,0.574275213945319,141.382142407342,76.8582343670957
8.7,"random_instances_SVM","SVM",45,26,1212,1080,132,2700,2430,270,0.930689855851021,0.642156862745098,1.77625372729737,556,270,286,18,1.1,69.02,9,0,0,0,0,0,0,0.55602847710002,132.573716968849,77.4914104916041
8.7,"random_instances_SVM","SVM",45,27,1112,991,121,2800,2519,281,0.931255036261084,0.632352941176471,1.76092475557716,577,281,296,21,1.1,71.57,9,0,0,0,0,0,0,0.479235101988888,117.969813284966,72.989123021345
8.7,"random_instances_SVM","SVM",45,28,1012,904,108,2900,2606,294,0.931259233145317,0.647058823529412,1.77461813454664,603,294,309,26,1.1,74.13,8.9,0,0,0,0,0,0,0.392653449447346,102.746831751542,66.3515006996829
8.7,"random_instances_SVM","SVM",45,29,912,818,94,3000,2692,308,0.929818302891938,0.642156862745098,1.7560870502047,625,305,320,22,1,76.69,8.7,0,0,0,0,0,0,0.307120569562432,87.3495674575823,58.8257588842565
8.7,"random_instances_SVM","SVM",45,30,812,732,80,3100,2778,322,0.930211411048442,0.637254901960784,1.76092475557716,648,317,331,23,1,79.24,8.6,0,0,0,0,0,0,0.247057630011215,77.69930478284,55.3134422300229
8.7,"random_instances_SVM","SVM",45,31,712,640,72,3200,2870,330,0.928227683767577,0.637254901960784,1.7553439038909,666,325,341,18,1,81.8,8.7,0,0,0,0,0,0,0.195941808956776,69.8133745800596,52.5852428104479
8.7,"random_instances_SVM","SVM",45,32,612,553,59,3300,2957,343,0.929864468618503,0.647058823529412,1.76416472752855,691,337,354,25,1.1,84.36,8.6,0,0,0,0,0,0,0.143580743844836,58.9451816659225,46.4484234771975
8.7,"random_instances_SVM","SVM",45,33,512,466,46,3400,3044,356,0.93183700420808,0.647058823529412,1.77298555116619,710,347,363,19,1,86.91,8.6,0,0,0,0,0,0,0.110281915732499,49.3182951713865,40.439402249819
8.7,"random_instances_SVM","SVM",45,34,412,372,40,3500,3138,362,0.932083221416425,0.642156862745098,1.76648514584569,718,352,366,8,1,89.47,8.7,0,0,0,0,0,0,0.0782645787557083,43.068996433932,37.5459821585942
8.7,"random_instances_SVM","SVM",45,35,312,283,29,3600,3227,373,0.932754722893728,0.651960784313726,1.76486748545572,754,368,386,36,1,92.02,8.7,0,0,0,0,0,0,0.0513073857412274,33.8734737665167,31.5107646231051
8.7,"random_instances_SVM","SVM",45,36,212,189,23,3700,3321,379,0.932501510878328,0.642156862745098,1.76810577441986,765,373,392,11,1.1,94.58,8.8,0,0,0,0,0,0,0.0210238561888965,24.939318079055,24.3727815125651
8.7,"random_instances_SVM","SVM",45,37,112,102,10,3800,3408,392,0.932533686990783,0.651960784313726,1.76810577441986,793,386,407,28,1.1,97.14,8.7,0,0,0,0,0,0,0.00146522463749186,11.6437223022282,11.6310619973342
8.7,"random_instances_SVM","SVM",45,38,12,12,0,3900,3498,402,0.932120993374523,0.642156862745098,1.76810577441986,804,394,410,11,1,99.69,8.7,0,0,0,0,0,0,0.00177812468157356,0.507734499950123,0.507734499950123
8.7,"random_instances_SVM","SVM",45,39,0,0,0,3912,3510,402,0.932111200644646,0.642156862745098,1.76486748545572,808,396,412,4,1,100,8.7,0,0,0,0,0,0,0,0,0
8.7,"random_instances_SVM","SVM",46,0,3812,3417,395,100,89,11,0.898758542141231,0.535,1.74707182320442,25,11,14,0,1.3,2.56,8.1,0,0,0,0,0,0,0.744770888691527,390.068000991904,81.0780867842172
8.7,"random_instances_SVM","SVM",46,1,3712,3333,379,200,173,27,0.895552391799552,0.55,1.74868202764977,57,27,30,32,1.1,5.11,6.4,0,0,0,0,0,0,0.88952262214985,458.247066197373,92.3272347538609
8.7,"random_instances_SVM","SVM",46,2,3612,3240,372,300,266,34,0.894441913439645,0.515,1.75446182152714,73,34,39,16,1.1,7.67,7.8,0,0,0,0,0,0,0.877777445008371,424.164691261613,91.9166119194341
8.7,"random_instances_SVM","SVM",46,3,3512,3152,360,400,354,46,0.895330296127569,0.51,1.74225895316804,94,44,50,21,1.1,10.22,7.7,0,0,0,0,0,0,0.8765765981127,403.311404734453,91.8265275187013
8.7,"random_instances_SVM","SVM",46,4,3412,3066,346,500,440,60,0.892880125284735,0.51,1.73806629834254,117,55,62,23,1.1,12.78,7.3,0,0,0,0,0,0,0.843624698523886,396.294598354633,88.6249220037909
8.7,"random_instances_SVM","SVM",46,5,3312,2977,335,600,529,71,0.899335136674267,0.525,1.74386029411765,144,68,76,27,1.1,15.34,7.5,0,0,0,0,0,0,0.769048246215146,386.518351468776,82.6528639330895
8.7,"random_instances_SVM","SVM",46,6,3212,2888,324,700,618,82,0.895802961275631,0.54,1.70747714808044,165,80,85,21,1.1,17.89,7.5,0,0,0,0,0,0,0.800909412156866,368.325485040635,86.1305469107665
8.7,"random_instances_SVM","SVM",46,7,3112,2794,318,800,712,88,0.901013667425979,0.555,1.74546458141674,181,86,95,16,1.1,20.45,8.1,0,0,0,0,0,0,0.773851064208305,328.243750241227,84.4128655568709
8.7,"random_instances_SVM","SVM",46,8,3012,2702,310,900,804,96,0.902981207289303,0.545,1.74868202764977,197,95,102,16,1.1,23.01,8.4,0,0,0,0,0,0,0.779365386145174,321.139743683483,84.6509204638666
8.7,"random_instances_SVM","SVM",46,9,2912,2610,302,1000,896,104,0.902608200455586,0.555,1.74546458141674,218,104,114,21,1.1,25.56,8.6,0,0,0,0,0,0,0.796063231573457,312.730694294234,86.7135881945267
8.7,"random_instances_SVM","SVM",46,10,2812,2523,289,1100,983,117,0.90161446469249,0.56,1.73646734130635,247,117,130,29,1.1,28.12,8.4,0,0,0,0,0,0,0.756566605504778,302.91420106691,83.0493086562205
8.7,"random_instances_SVM","SVM",46,11,2712,2433,279,1200,1073,127,0.905375854214132,0.555,1.76022038567493,266,127,139,19,1.1,30.67,8.4,0,0,0,0,0,0,0.770950597202616,293.138978730029,84.8923294371111
8.7,"random_instances_SVM","SVM",46,12,2612,2339,273,1300,1167,133,0.904185649202743,0.555,1.75446182152714,277,133,144,11,1.1,33.23,8.8,0,0,0,0,0,0,0.706223537634015,265.56298383222,79.730289181261
8.7,"random_instances_SVM","SVM",46,13,2512,2252,260,1400,1254,146,0.905660592255133,0.57,1.75446182152714,304,146,158,27,1.1,35.79,8.6,0,0,0,0,0,0,0.738174159735381,267.353791888021,82.2888733623734
8.7,"random_instances_SVM","SVM",46,14,2412,2166,246,1500,1340,160,0.907035876993172,0.565,1.74066055045872,329,159,170,25,1.1,38.34,8.4,0,0,0,0,0,0,0.73037956793475,247.470667766451,82.9552406349851
8.7,"random_instances_SVM","SVM",46,15,2312,2083,229,1600,1423,177,0.908277334851945,0.575,1.76345906163753,361,175,186,32,1.1,40.9,8,0,0,0,0,0,0,0.707294449233778,239.659277379142,80.9059285997827
8.7,"random_instances_SVM","SVM",46,16,2212,1992,220,1700,1514,186,0.909938781321189,0.575,1.76183823529412,375,183,192,14,1,43.46,8.1,0,0,0,0,0,0,0.683748471756888,225.136210147735,79.5989338883756
8.7,"random_instances_SVM","SVM",46,17,2112,1903,209,1800,1603,197,0.916022209567203,0.575,1.76508287292818,395,193,202,20,1,46.01,8.1,0,0,0,0,0,0,0.688666837578397,214.428880880591,80.8527367158616
8.7,"random_instances_SVM","SVM",46,18,2012,1812,200,1900,1694,206,0.914779328018233,0.58,1.75284926470588,417,204,213,22,1,48.57,8.2,0,0,0,0,0,0,0.708582419495593,207.27554564695,82.9108885122118
8.7,"random_instances_SVM","SVM",46,19,1912,1723,189,2000,1783,217,0.917497152619599,0.58,1.76670967741935,443,215,228,26,1.1,51.12,8.2,0,0,0,0,0,0,0.657953000091624,197.783669931501,78.5940950385122
8.7,"random_instances_SVM","SVM",46,20,1812,1632,180,2100,1874,226,0.917380410022786,0.575,1.76670967741935,458,223,235,15,1.1,53.68,8.3,0,0,0,0,0,0,0.687217989254411,188.455835262841,82.0239442101287
8.7,"random_instances_SVM","SVM",46,21,1712,1541,171,2200,1965,235,0.91762528473805,0.585,1.76022038567493,473,231,242,15,1,56.24,8.4,0,0,0,0,0,0,0.623662367359647,173.072229230953,77.8557413763762
8.7,"random_instances_SVM","SVM",46,22,1612,1449,163,2300,2057,243,0.916768223234634,0.58,1.76183823529412,493,240,253,20,1.1,58.79,8.5,0,0,0,0,0,0,0.603993263100079,164.423179935916,76.9506710376289
8.7,"random_instances_SVM","SVM",46,23,1512,1357,155,2400,2149,251,0.91817482915718,0.59,1.76508287292818,511,250,261,18,1,61.35,8.6,0,0,0,0,0,0,0.604600544078147,149.808402512306,78.1991364180321
8.7,"random_instances_SVM","SVM",46,24,1412,1267,145,2500,2239,261,0.91931093394078,0.585,1.76345906163753,522,256,266,11,1,63.91,8.6,0,0,0,0,0,0,0.550856272959982,139.226731592926,74.0361436766345
8.7,"random_instances_SVM","SVM",46,25,1312,1174,138,2600,2332,268,0.917947038724379,0.6,1.75860550458716,551,266,285,29,1.1,66.46,8.7,0,0,0,0,0,0,0.574313158905292,134.678801053748,76.9233261960231
8.7,"random_instances_SVM","SVM",46,26,1212,1084,128,2700,2422,278,0.918505125284746,0.595,1.75699358386801,567,276,291,16,1.1,69.02,8.7,0,0,0,0,0,0,0.501402734771049,122.15288835098,73.2269677644702
8.7,"random_instances_SVM","SVM",46,27,1112,999,113,2800,2507,293,0.922491457858775,0.6,1.75699358386801,597,290,307,30,1.1,71.57,8.6,0,0,0,0,0,0,0.454814253733259,113.842356059917,71.1800193396369
8.7,"random_instances_SVM","SVM",46,28,1012,913,99,2900,2593,307,0.923841116173124,0.59,1.76920110192837,621,304,317,24,1,74.13,8.4,0,0,0,0,0,0,0.40513899852635,103.784910365528,67.5589086315155
8.7,"random_instances_SVM","SVM",46,29,912,822,90,3000,2684,316,0.923986332574036,0.6,1.77245630174793,633,309,324,12,1,76.69,8.5,0,0,0,0,0,0,0.321718237345155,88.9185187480879,61.1924609947874
8.7,"random_instances_SVM","SVM",46,30,812,732,80,3100,2774,326,0.924403473804104,0.595,1.76757798165138,653,320,333,20,1,79.24,8.5,0,0,0,0,0,0,0.262543634944873,80.4558896096158,56.792669874604
8.7,"random_instances_SVM","SVM",46,31,712,644,68,3200,2862,338,0.926691343963558,0.595,1.78473732718894,675,332,343,22,1,81.8,8.5,0,0,0,0,0,0,0.21234474634621,71.2524769303582,52.758447816424
8.7,"random_instances_SVM","SVM",46,32,612,555,57,3300,2951,349,0.927277904328023,0.6,1.7765504587156,697,342,355,22,1,84.36,8.5,0,0,0,0,0,0,0.148389982520646,61.5669386754339,49.4214010114449
8.7,"random_instances_SVM","SVM",46,33,512,466,46,3400,3040,360,0.928414009111623,0.6,1.78145354185833,723,354,369,26,1,86.91,8.4,0,0,0,0,0,0,0.0976816129518128,52.3412042851704,43.9587559863158
8.7,"random_instances_SVM","SVM",46,34,412,378,34,3500,3128,372,0.928633257403194,0.595,1.78145354185833,739,363,376,16,1,89.47,8.4,0,0,0,0,0,0,0.0769718766341734,40.5221059977111,34.8227275777239
8.7,"random_instances_SVM","SVM",46,35,312,284,28,3600,3222,378,0.928869589977225,0.595,1.77408839779006,753,369,384,14,1,92.02,8.5,0,0,0,0,0,0,0.0560794305449281,34.5725359022544,31.6653631101414
8.7,"random_instances_SVM","SVM",46,36,212,189,23,3700,3317,383,0.928496583143512,0.605,1.78309392265193,764,375,389,11,1,94.58,8.7,0,0,0,0,0,0,0.0285076523435721,26.2049809258296,25.4569914805711
8.7,"random_instances_SVM","SVM",46,37,112,95,17,3800,3411,389,0.929362186788159,0.605,1.77981617647059,783,384,399,19,1,97.14,8.8,0,0,0,0,0,0,0.00104839309785537,16.1488384435381,16.1426011322497
8.7,"random_instances_SVM","SVM",46,38,12,11,1,3900,3495,405,0.929313781321187,0.605,1.76920110192837,804,393,411,21,1,99.69,8.6,0,0,0,0,0,0,0.000260270534301772,1.70275876101244,1.70275876101244
8.7,"random_instances_SVM","SVM",46,39,0,0,0,3912,3506,406,0.929258257403192,0.605,1.77082720588235,807,394,413,3,1,100,8.6,0,0,0,0,0,0,0,0,0
8.7,"random_instances_SVM","SVM",47,0,3812,3410,402,100,88,12,0.903229520975051,0.557291666666667,1.74001377410468,28,12,16,0,1.3,2.56,7.3,0,0,0,0,0,0,0.5,361.483256160904,56.2647559067461
8.7,"random_instances_SVM","SVM",47,1,3712,3326,386,200,172,28,0.9172158446712,0.552083333333333,1.77417506874427,63,28,35,35,1.2,5.11,6.1,0,0,0,0,0,0,0.669354142326718,446.201398492006,72.273520643851
8.7,"random_instances_SVM","SVM",47,2,3612,3238,374,300,260,40,0.928654100529095,0.578125,1.78234346224678,91,40,51,28,1.3,7.67,6.5,0,0,0,0,0,0,0.437884540047939,441.686583543329,48.1693171506564
8.7,"random_instances_SVM","SVM",47,3,3512,3151,361,400,347,53,0.926095698696138,0.588541666666667,1.76034007352941,118,53,65,27,1.2,10.22,6.5,0,0,0,0,0,0,0.540099379010553,433.516628320051,60.6081088960235
8.7,"random_instances_SVM","SVM",47,4,3412,3060,352,500,438,62,0.920183177437635,0.588541666666667,1.75872359963269,148,62,86,30,1.4,12.78,7.1,0,0,0,0,0,0,0.608828195013684,429.252752200169,70.6786077769702
8.7,"random_instances_SVM","SVM",47,5,3312,2970,342,600,528,72,0.92079435941043,0.609375,1.74776376146789,158,72,86,10,1.2,15.34,7.3,0,0,0,0,0,0,0.690527609929872,407.146431695907,76.1385837962802
8.7,"random_instances_SVM","SVM",47,6,3212,2882,330,700,616,84,0.931157879818594,0.604166666666667,1.7867883379247,184,84,100,26,1.2,17.89,7.3,0,0,0,0,0,0,0.810302934485096,408.946596456227,87.40834104325
8.7,"random_instances_SVM","SVM",47,7,3112,2794,318,800,704,96,0.930992535903241,0.598958333333333,1.77133164673413,202,96,106,18,1.1,20.45,7.3,0,0,0,0,0,0,0.699494165415383,368.021832817895,77.0687704039173
8.7,"random_instances_SVM","SVM",47,8,3012,2701,311,900,797,103,0.928193499622064,0.59375,1.76807851239669,220,103,117,18,1.1,23.01,7.7,0,0,0,0,0,0,0.757906097594411,338.909953347805,82.6823623774
8.7,"random_instances_SVM","SVM",47,9,2912,2608,304,1000,890,110,0.929082223167039,0.59375,1.76483730522456,236,110,126,16,1.1,25.56,8.1,0,0,0,0,0,0,0.729070817881498,317.251628791657,80.7583208696705
8.7,"random_instances_SVM","SVM",47,10,2812,2519,293,1100,979,121,0.922565901360546,0.588541666666667,1.76807851239669,253,121,132,17,1.1,28.12,8.1,0,0,0,0,0,0,0.762670849389977,314.84625144682,83.55523826922
8.7,"random_instances_SVM","SVM",47,11,2712,2430,282,1200,1068,132,0.92331880668934,0.59375,1.77296270718232,279,132,147,26,1.1,30.67,8.1,0,0,0,0,0,0,0.79325610918531,309.771707436869,85.7860049506503
8.7,"random_instances_SVM","SVM",47,12,2612,2339,273,1300,1159,141,0.923673115079363,0.59375,1.75872359963269,293,141,152,14,1.1,33.23,8.2,0,0,0,0,0,0,0.718099773727265,276.869253974817,80.2031738117098
8.7,"random_instances_SVM","SVM",47,13,2512,2249,263,1400,1249,151,0.924774423658348,0.59375,1.74456272893773,315,151,164,22,1.1,35.79,8.3,0,0,0,0,0,0,0.770995602350415,274.715831000915,85.9095128342492
8.7,"random_instances_SVM","SVM",47,14,2412,2159,253,1500,1339,161,0.92659615929704,0.604166666666667,1.76520737327189,333,161,172,18,1.1,38.34,8.3,0,0,0,0,0,0,0.734455868887743,260.324010089588,83.7613205576682
8.7,"random_instances_SVM","SVM",47,15,2312,2069,243,1600,1429,171,0.925887542516998,0.604166666666667,1.76520737327189,355,171,184,22,1.1,40.9,8.4,0,0,0,0,0,0,0.760335845763688,256.710183165189,85.8771139214862
8.7,"random_instances_SVM","SVM",47,16,2212,1974,238,1700,1524,176,0.927526218820852,0.609375,1.76645642201835,370,176,194,15,1.1,43.46,8.7,0,0,0,0,0,0,0.718419533191957,245.315548597608,83.0027127550209
8.7,"random_instances_SVM","SVM",47,17,2112,1883,229,1800,1615,185,0.928730867346928,0.604166666666667,1.75711009174312,385,185,200,15,1.1,46.01,8.7,0,0,0,0,0,0,0.7301614311083,231.913036178681,84.298890270829
8.7,"random_instances_SVM","SVM",47,18,2012,1792,220,1900,1706,194,0.926959325396824,0.609375,1.76195952161914,403,194,209,18,1.1,48.57,8.8,0,0,0,0,0,0,0.687496684311433,219.612338721702,81.9156832942444
8.7,"random_instances_SVM","SVM",47,19,1912,1704,208,2000,1794,206,0.929752456538173,0.609375,1.76807851239669,422,206,216,19,1,51.12,8.7,0,0,0,0,0,0,0.641569385750085,203.707634613585,79.2272620377367
8.7,"random_instances_SVM","SVM",47,20,1812,1612,200,2100,1886,214,0.929275616496587,0.598958333333333,1.76970358455882,438,214,224,16,1,53.68,8.8,0,0,0,0,0,0,0.617420508102403,189.882389884143,78.3749976374921
8.7,"random_instances_SVM","SVM",47,21,1712,1524,188,2200,1974,226,0.926842698885113,0.59375,1.76970358455882,462,226,236,24,1,56.24,8.7,0,0,0,0,0,0,0.590825330118212,181.237589248688,75.4027170101662
8.7,"random_instances_SVM","SVM",47,22,1612,1435,177,2300,2063,237,0.927028710789876,0.588541666666667,1.76970358455882,486,237,249,24,1.1,58.79,8.7,0,0,0,0,0,0,0.621333340273068,174.521866491815,79.4464347301554
8.7,"random_instances_SVM","SVM",47,23,1512,1347,165,2400,2151,249,0.929418816137561,0.588541666666667,1.77296270718232,509,249,260,23,1,61.35,8.6,0,0,0,0,0,0,0.562629181533665,163.887380091938,77.0173188448699
8.7,"random_instances_SVM","SVM",47,24,1412,1262,150,2500,2236,264,0.929032029478452,0.598958333333333,1.77459677419355,539,263,276,30,1,63.91,8.5,0,0,0,0,0,0,0.512536494435965,147.714015757836,73.057191490881
8.7,"random_instances_SVM","SVM",47,25,1312,1170,142,2600,2328,272,0.929030553193494,0.59375,1.76970358455882,552,271,281,13,1,66.46,8.6,0,0,0,0,0,0,0.507056409085388,138.954359084935,72.2503055419223
8.7,"random_instances_SVM","SVM",47,26,1212,1082,130,2700,2416,284,0.928965596655324,0.588541666666667,1.77296270718232,575,282,293,23,1,69.02,8.5,0,0,0,0,0,0,0.489807669441422,126.604300902469,70.774658403
8.7,"random_instances_SVM","SVM",47,27,1112,994,118,2800,2504,296,0.930915769085405,0.59375,1.77459677419355,599,292,307,24,1.1,71.57,8.5,0,0,0,0,0,0,0.490198845116473,122.481696116085,70.8645454659021
8.7,"random_instances_SVM","SVM",47,28,1012,904,108,2900,2594,306,0.933639514833705,0.604166666666667,1.76970358455882,623,302,321,24,1.1,74.13,8.5,0,0,0,0,0,0,0.433313232727515,109.321275743159,66.6980591093726
8.7,"random_instances_SVM","SVM",47,29,912,812,100,3000,2686,314,0.934390943877543,0.609375,1.77459677419355,633,309,324,10,1,76.69,8.6,0,0,0,0,0,0,0.399146793162262,98.9041373657851,65.9388914383253
8.7,"random_instances_SVM","SVM",47,30,812,721,91,3100,2777,323,0.935264904572935,0.609375,1.77133164673413,653,319,334,20,1,79.24,8.6,0,0,0,0,0,0,0.355056366887379,88.6321735970389,62.817354625436
8.7,"random_instances_SVM","SVM",47,31,712,627,85,3200,2871,329,0.937479332010566,0.625,1.77459677419355,667,327,340,14,1,81.8,8.7,0,0,0,0,0,0,0.266716532301874,77.2467718264543,58.8728875965042
8.7,"random_instances_SVM","SVM",47,32,612,532,80,3300,2966,334,0.93716340702946,0.619791666666667,1.77417506874427,680,333,347,13,1,84.36,8.9,0,0,0,0,0,0,0.244017043059796,73.7389672160418,58.7829422273348
8.7,"random_instances_SVM","SVM",47,33,512,446,66,3400,3052,348,0.938701695956147,0.619791666666667,1.78843060661765,712,347,365,32,1.1,86.91,8.8,0,0,0,0,0,0,0.161283562137918,62.9541453972853,52.7055093028511
8.7,"random_instances_SVM","SVM",47,34,412,357,55,3500,3141,359,0.937907454648511,0.614583333333333,1.79337557603687,726,355,371,14,1,89.47,8.7,0,0,0,0,0,0,0.0979165858487246,50.2256024641015,44.5627296128788
8.7,"random_instances_SVM","SVM",47,35,312,268,44,3600,3230,370,0.93795469576718,0.619791666666667,1.78351283226398,752,366,386,26,1.1,92.02,8.7,0,0,0,0,0,0,0.0527026790015658,39.5827175831314,36.9308063419026
8.7,"random_instances_SVM","SVM",47,36,212,180,32,3700,3318,382,0.938583593159467,0.625,1.78398617511521,769,376,393,17,1,94.58,8.7,0,0,0,0,0,0,0.022294323101686,27.3815673218167,26.7909368185879
8.7,"random_instances_SVM","SVM",47,37,112,96,16,3800,3402,398,0.939441314720317,0.625,1.77580275229358,793,389,404,24,1,97.14,8.5,0,0,0,0,0,0,0.00262326731788214,15.3843078192162,15.3680348664097
8.7,"random_instances_SVM","SVM",47,38,12,11,1,3900,3487,413,0.940412710222963,0.630208333333333,1.78843060661765,828,405,423,35,1,99.69,8.4,0,0,0,0,0,0,0.000860260269014841,0.556645980055213,0.556645980055213
8.7,"random_instances_SVM","SVM",47,39,0,0,0,3912,3498,414,0.940579530423266,0.635416666666667,1.7867883379247,829,406,423,1,1,100,8.4,0,0,0,0,0,0,0,0,0
8.7,"random_instances_SVM","SVM",48,0,3812,3422,390,100,90,10,0.914812760055477,0.611650485436893,1.71525211399937,27,10,17,0,1.7,2.56,9,0,0,0,0,0,0,0.170828659946224,372.542819513071,17.956769387119
8.7,"random_instances_SVM","SVM",48,1,3712,3338,374,200,174,26,0.927442441054097,0.62621359223301,1.73585843346763,57,26,31,30,1.2,5.11,6.7,0,0,0,0,0,0,0.613685911493577,412.242482629507,66.8753182663396
8.7,"random_instances_SVM","SVM",48,2,3612,3251,361,300,261,39,0.928454923717052,0.631067961165049,1.75577209921312,83,39,44,26,1.1,7.67,6.7,0,0,0,0,0,0,0.753977548891933,413.105983940451,81.1532874322993
8.7,"random_instances_SVM","SVM",48,3,3512,3162,350,400,350,50,0.926690707350892,0.621359223300971,1.75577209921312,105,50,55,22,1.1,10.22,7,0,0,0,0,0,0,0.779860158007418,417.717970980153,83.9225174151068
8.7,"random_instances_SVM","SVM",48,4,3412,3074,338,500,438,62,0.9274507628294,0.635922330097087,1.75900854547895,131,62,69,26,1.1,12.78,7.1,0,0,0,0,0,0,0.744375754160717,403.967239071824,80.6892729989947
8.7,"random_instances_SVM","SVM",48,5,3312,2984,328,600,528,72,0.929375866851593,0.631067961165049,1.75254754072053,148,71,77,17,1.1,15.34,7.3,0,0,0,0,0,0,0.772451077814122,381.656005959879,83.6343949138387
8.7,"random_instances_SVM","SVM",48,6,3212,2895,317,700,617,83,0.929866851595005,0.62621359223301,1.75254754072053,173,82,91,25,1.1,17.89,7.4,0,0,0,0,0,0,0.78845929648616,378.530349771333,85.3382220218489
8.7,"random_instances_SVM","SVM",48,7,3112,2802,310,800,710,90,0.928894590846047,0.621359223300971,1.75415833809252,188,90,98,15,1.1,20.45,7.9,0,0,0,0,0,0,0.822977493709434,369.287239886079,88.7759464406132
8.7,"random_instances_SVM","SVM",48,8,3012,2713,299,900,799,101,0.928228848821082,0.62621359223301,1.739902376227,211,101,110,23,1.1,23.01,7.9,0,0,0,0,0,0,0.787142248557788,343.961955283139,86.4482928517498
8.7,"random_instances_SVM","SVM",48,9,2912,2623,289,1000,889,111,0.928485436893204,0.621359223300971,1.7438283987269,234,111,123,23,1.1,25.56,8,0,0,0,0,0,0,0.738488524107205,318.573118536674,82.5630495768729
8.7,"random_instances_SVM","SVM",48,10,2812,2533,279,1100,979,121,0.925220527045768,0.62621359223301,1.7327546865912,255,121,134,21,1.1,28.12,8.1,0,0,0,0,0,0,0.729122145444988,302.476836365316,82.5550442445529
8.7,"random_instances_SVM","SVM",48,11,2712,2441,271,1200,1071,129,0.919456310679601,0.631067961165049,1.71609512781687,280,129,151,25,1.2,30.67,8.3,0,0,0,0,0,0,0.544010863607975,269.987824468693,65.2447368441944
8.7,"random_instances_SVM","SVM",48,12,2612,2347,265,1300,1165,135,0.916027739251043,0.621359223300971,1.72480627059767,288,135,153,8,1.1,33.23,8.6,0,0,0,0,0,0,0.709969158107932,276.151743345693,81.8043332393492
8.7,"random_instances_SVM","SVM",48,13,2512,2257,255,1400,1255,145,0.921237170596393,0.631067961165049,1.72639011473963,305,145,160,17,1.1,35.79,8.7,0,0,0,0,0,0,0.709683471409392,261.124090557468,81.7245252037137
8.7,"random_instances_SVM","SVM",48,14,2412,2166,246,1500,1346,154,0.92197780859917,0.640776699029126,1.73830173006672,320,154,166,15,1.1,38.34,8.7,0,0,0,0,0,0,0.596689109477089,238.99391400016,72.3104299871962
8.7,"random_instances_SVM","SVM",48,15,2312,2075,237,1600,1437,163,0.924719833564493,0.635922330097087,1.74222855615926,348,163,185,28,1.1,40.9,8.8,0,0,0,0,0,0,0.645916824267757,230.916594184577,78.8774335842767
8.7,"random_instances_SVM","SVM",48,16,2212,1984,228,1700,1528,172,0.923173370319002,0.611650485436893,1.74543118218161,363,172,191,15,1.1,43.46,8.9,0,0,0,0,0,0,0.6206708480545,209.709796271084,79.5699264025998
8.7,"random_instances_SVM","SVM",48,17,2112,1892,220,1800,1620,180,0.92378502080444,0.621359223300971,1.7367040262707,383,180,203,20,1.1,46.01,9,0,0,0,0,0,0,0.572498468003177,195.690416101379,75.8513287232356
8.7,"random_instances_SVM","SVM",48,18,2012,1806,206,1900,1706,194,0.925137309292649,0.62621359223301,1.74703691463992,408,194,214,25,1.1,48.57,8.8,0,0,0,0,0,0,0.653371086121616,200.571569138211,81.6182050562244
8.7,"random_instances_SVM","SVM",48,19,1912,1716,196,2000,1796,204,0.92683495145631,0.631067961165049,1.75025725918303,427,204,223,19,1.1,51.12,8.8,0,0,0,0,0,0,0.616490223681064,192.417064561383,78.7443734370305
8.7,"random_instances_SVM","SVM",48,20,1812,1625,187,2100,1887,213,0.926740638002759,0.640776699029126,1.74543118218161,448,213,235,21,1.1,53.68,8.9,0,0,0,0,0,0,0.646682885438886,187.604497897241,80.5969758171646
8.7,"random_instances_SVM","SVM",48,21,1712,1531,181,2200,1981,219,0.925364771151169,0.631067961165049,1.75025725918303,455,219,236,7,1.1,56.24,9,0,0,0,0,0,0,0.578053165295845,167.366390503639,76.5223503063647
8.7,"random_instances_SVM","SVM",48,22,1612,1440,172,2300,2072,228,0.924757281553392,0.635922330097087,1.74703691463992,474,228,246,19,1.1,58.79,9.1,0,0,0,0,0,0,0.590648506620179,162.699499603343,78.4981978656677
8.7,"random_instances_SVM","SVM",48,23,1512,1348,164,2400,2164,236,0.926252427184457,0.631067961165049,1.74864560424824,489,236,253,15,1.1,61.35,9.2,0,0,0,0,0,0,0.551144380661082,155.969656497416,75.6987198603203
8.7,"random_instances_SVM","SVM",48,24,1412,1259,153,2500,2253,247,0.931809986130363,0.635922330097087,1.74543118218161,516,247,269,27,1.1,63.91,9.1,0,0,0,0,0,0,0.546294351616314,143.98430210971,74.2257793471694
8.7,"random_instances_SVM","SVM",48,25,1312,1171,141,2600,2341,259,0.93254091539527,0.635922330097087,1.75900854547895,543,259,284,27,1.1,66.46,9,0,0,0,0,0,0,0.515467902669844,136.830892897241,73.244790871772
8.7,"random_instances_SVM","SVM",48,26,1212,1084,128,2700,2428,272,0.933450762829388,0.640776699029126,1.75900854547895,565,272,293,22,1.1,69.02,8.9,0,0,0,0,0,0,0.481740217712981,123.519495121634,69.029762764862
8.7,"random_instances_SVM","SVM",48,27,1112,997,115,2800,2515,285,0.93384743411926,0.645631067961165,1.75900854547895,589,285,304,24,1.1,71.57,8.8,0,0,0,0,0,0,0.468385390644007,114.350909364,70.9757433067683
8.7,"random_instances_SVM","SVM",48,28,1012,910,102,2900,2602,298,0.933841886269052,0.640776699029126,1.75900854547895,614,298,316,25,1.1,74.13,8.7,0,0,0,0,0,0,0.342036668463313,97.3206059667943,64.8175658752325
8.7,"random_instances_SVM","SVM",48,29,912,819,93,3000,2693,307,0.933600554785,0.640776699029126,1.75415833809252,634,307,327,20,1.1,76.69,8.8,0,0,0,0,0,0,0.285544260411802,86.0395596210268,60.9752830087181
8.7,"random_instances_SVM","SVM",48,30,812,728,84,3100,2784,316,0.934651872399424,0.645631067961165,1.75254754072053,653,316,337,19,1.1,79.24,8.8,0,0,0,0,0,0,0.228435756980427,80.5835820773429,60.1433803765476
8.7,"random_instances_SVM","SVM",48,31,712,634,78,3200,2878,322,0.935278779472936,0.635922330097087,1.75577209921312,660,322,338,7,1,81.8,8.9,0,0,0,0,0,0,0.215185182246449,73.8934542038451,57.0593557516778
8.7,"random_instances_SVM","SVM",48,32,612,546,66,3300,2966,334,0.935470180305121,0.645631067961165,1.75738883226948,688,334,354,28,1.1,84.36,8.9,0,0,0,0,0,0,0.186428420393572,65.4105006052682,53.5856943617182
8.7,"random_instances_SVM","SVM",48,33,512,459,53,3400,3053,347,0.93582385575588,0.640776699029126,1.75738883226948,714,347,367,26,1.1,86.91,8.8,0,0,0,0,0,0,0.133920898960022,56.0424074479999,48.3137292991496
8.7,"random_instances_SVM","SVM",48,34,412,368,44,3500,3144,356,0.93628016643549,0.640776699029126,1.75254754072053,737,356,381,23,1.1,89.47,8.8,0,0,0,0,0,0,0.0910642072858006,46.5580240440282,42.1493765239261
8.7,"random_instances_SVM","SVM",48,35,312,280,32,3600,3232,368,0.935606102635217,0.645631067961165,1.75900854547895,758,368,390,21,1.1,92.02,8.8,0,0,0,0,0,0,0.0597931510442271,34.2871515505499,32.2516416138792
8.7,"random_instances_SVM","SVM",48,36,212,193,19,3700,3319,381,0.936482662968089,0.645631067961165,1.74933480462389,775,380,395,17,1,94.58,8.7,0,0,0,0,0,0,0.0128096033619861,20.3061287236089,20.082819085761
8.7,"random_instances_SVM","SVM",48,37,112,105,7,3800,3407,393,0.937281553398052,0.650485436893204,1.75254754072053,800,390,410,25,1.1,97.14,8.7,0,0,0,0,0,0,0.000510236521312831,11.1994416064832,11.1973932960378
8.7,"random_instances_SVM","SVM",48,38,12,12,0,3900,3500,400,0.937402219140078,0.655339805825243,1.75415833809252,821,399,422,21,1.1,99.69,8.8,0,0,0,0,0,0,0.000247290215652402,1.11110714758041,1.11110714758041
8.7,"random_instances_SVM","SVM",48,39,0,0,0,3912,3512,400,0.937051317614421,0.650485436893204,1.75254754072053,819,399,420,-2,1.1,100,8.8,0,0,0,0,0,0,0,0,0
8.7,"random_instances_SVM","SVM",49,0,3812,3421,391,100,90,10,0.869816550821141,0.521951219512195,1.69255738880918,31,10,21,0,2.1,2.56,9,0,0,0,0,0,0,0.543555033684984,392.245797248581,64.4605945477831
8.7,"random_instances_SVM","SVM",49,1,3712,3337,375,200,174,26,0.914042150130244,0.595121951219512,1.76985822750789,63,26,37,32,1.4,5.11,6.7,0,0,0,0,0,0,0.477816465184251,438.046464379371,53.191228737926
8.7,"random_instances_SVM","SVM",49,2,3612,3247,365,300,264,36,0.91706481313814,0.609756097560976,1.75948086820318,86,36,50,23,1.4,7.67,7.3,0,0,0,0,0,0,0.542461551935427,408.73787043243,60.4902645336333
8.7,"random_instances_SVM","SVM",49,3,3512,3154,358,400,357,43,0.896062180496177,0.614634146341463,1.68790324383537,102,43,59,16,1.4,10.22,8.3,0,0,0,0,0,0,0.705224169289016,380.604180826595,80.4774200636062
8.7,"random_instances_SVM","SVM",49,4,3412,3061,351,500,450,50,0.909864746277399,0.624390243902439,1.7157126874021,111,50,61,9,1.2,12.78,9,0,0,0,0,0,0,0.508869443019108,313.083841773051,60.656992353557
8.7,"random_instances_SVM","SVM",49,5,3312,2977,335,600,534,66,0.932364781100689,0.639024390243902,1.75233487872069,146,66,80,35,1.2,15.34,8.1,0,0,0,0,0,0,0.809945372106663,364.657917236441,87.1006395177175
8.7,"random_instances_SVM","SVM",49,6,3212,2886,326,700,625,75,0.93116128762658,0.629268292682927,1.7890243902439,166,75,91,20,1.2,17.89,8.3,0,0,0,0,0,0,0.818741966454174,358.952249339507,88.4626634387563
8.7,"random_instances_SVM","SVM",49,7,3112,2796,316,800,715,85,0.931593096627711,0.614634146341463,1.80276497695853,181,85,96,15,1.1,20.45,8.4,0,0,0,0,0,0,0.796099941182579,355.95335147414,85.8287119842525
8.7,"random_instances_SVM","SVM",49,8,3012,2707,305,900,804,96,0.934841414662006,0.609756097560976,1.79449541284404,203,96,107,22,1.1,23.01,8.4,0,0,0,0,0,0,0.824859743117198,356.431998410231,88.1823462601389
8.7,"random_instances_SVM","SVM",49,9,2912,2619,293,1000,892,108,0.933696424342886,0.609756097560976,1.79614325068871,228,107,121,25,1.1,25.56,8.3,0,0,0,0,0,0,0.790531837826566,341.997476704665,85.4353920136569
8.7,"random_instances_SVM","SVM",49,10,2812,2525,287,1100,986,114,0.933064033096074,0.614634146341463,1.79944802207912,235,113,122,7,1.1,28.12,8.6,0,0,0,0,0,0,0.789410583716382,325.075503389946,85.4702725421088
8.7,"random_instances_SVM","SVM",49,11,2712,2434,278,1200,1077,123,0.934735551810117,0.629268292682927,1.79614325068871,257,123,134,22,1.1,30.67,8.8,0,0,0,0,0,0,0.765020029042295,310.149316475406,83.6975252303264
8.7,"random_instances_SVM","SVM",49,12,2612,2345,267,1300,1166,134,0.93771364098564,0.619512195121951,1.79067022684946,276,134,142,19,1.1,33.23,8.7,0,0,0,0,0,0,0.786278144478933,309.638385656608,85.1326888986956
8.7,"random_instances_SVM","SVM",49,13,2512,2255,257,1400,1256,144,0.940636012870695,0.639024390243902,1.79120879120879,300,144,156,24,1.1,35.79,8.7,0,0,0,0,0,0,0.763035533703403,280.716790910732,83.9168230733286
8.7,"random_instances_SVM","SVM",49,14,2412,2167,245,1500,1344,156,0.940602582496415,0.648780487804878,1.79614325068871,324,156,168,24,1.1,38.34,8.6,0,0,0,0,0,0,0.722394974183721,261.061305680494,81.49289159324
8.7,"random_instances_SVM","SVM",49,15,2312,2081,231,1600,1430,170,0.93896170829213,0.639024390243902,1.79944802207912,352,170,182,28,1.1,40.9,8.4,0,0,0,0,0,0,0.766301668956253,263.636134393644,84.3906526638303
8.7,"random_instances_SVM","SVM",49,16,2212,1995,217,1700,1516,184,0.938039587134882,0.639024390243902,1.7890243902439,373,181,192,21,1.1,43.46,8.2,0,0,0,0,0,0,0.690464816424655,236.112902901759,78.3930500408622
8.7,"random_instances_SVM","SVM",49,17,2112,1906,206,1800,1605,195,0.937645387304819,0.624390243902439,1.79779411764706,398,190,208,25,1.1,46.01,8.2,0,0,0,0,0,0,0.690427399759204,228.686336452896,77.718073550616
8.7,"random_instances_SVM","SVM",49,18,2012,1813,199,1900,1698,202,0.939440876990154,0.639024390243902,1.79449541284404,409,199,210,11,1.1,48.57,8.4,0,0,0,0,0,0,0.65810981742323,207.446283997978,77.8746256778571
8.7,"random_instances_SVM","SVM",49,19,1912,1727,185,2000,1784,216,0.941190399910854,0.639024390243902,1.80276497695853,439,212,227,30,1.1,51.12,8.3,0,0,0,0,0,0,0.689640548255165,206.277494458463,79.6880453994539
8.7,"random_instances_SVM","SVM",49,20,1812,1640,172,2100,1871,229,0.941555348163423,0.64390243902439,1.79944802207912,466,225,241,27,1.1,53.68,8.2,0,0,0,0,0,0,0.660369332270265,194.593116679721,77.9839651376702
8.7,"random_instances_SVM","SVM",49,21,1712,1546,166,2200,1965,235,0.942646014124338,0.648780487804878,1.80110497237569,483,234,249,17,1.1,56.24,8.4,0,0,0,0,0,0,0.653663315954665,182.048405522044,79.5350490267405
8.7,"random_instances_SVM","SVM",49,22,1612,1458,154,2300,2053,247,0.94218356061345,0.64390243902439,1.79449541284404,500,245,255,17,1,58.79,8.3,0,0,0,0,0,0,0.63285900461846,168.053820185676,78.4327880019686
8.7,"random_instances_SVM","SVM",49,23,1512,1371,141,2400,2140,260,0.942580546308036,0.634146341463415,1.80276497695853,529,256,273,29,1.1,61.35,8.2,0,0,0,0,0,0,0.582371835018133,152.128192052456,74.0052535359846
8.7,"random_instances_SVM","SVM",49,24,1412,1290,122,2500,2221,279,0.941648674624955,0.629268292682927,1.79779411764706,557,271,286,28,1.1,63.91,8,0,0,0,0,0,0,0.538768486279403,139.976119041772,72.8768781775175
8.7,"random_instances_SVM","SVM",49,25,1312,1196,116,2600,2315,285,0.942275494142721,0.639024390243902,1.80110497237569,570,278,292,13,1.1,66.46,8.1,0,0,0,0,0,0,0.514896852198522,130.430112237158,71.3192274187025
8.7,"random_instances_SVM","SVM",49,26,1212,1100,112,2700,2411,289,0.942424537894725,0.634146341463415,1.80276497695853,578,282,296,8,1,69.02,8.3,0,0,0,0,0,0,0.492728659385381,122.044783428619,70.1628941810819
8.7,"random_instances_SVM","SVM",49,27,1112,1009,103,2800,2502,298,0.942650192921124,0.64390243902439,1.79614325068871,603,294,309,25,1.1,71.57,8.4,0,0,0,0,0,0,0.419724670111911,112.457077395636,69.0664089353738
8.7,"random_instances_SVM","SVM",49,28,1012,917,95,2900,2594,306,0.9428911702024,0.64390243902439,1.79231909446166,615,302,313,12,1,74.13,8.5,0,0,0,0,0,0,0.363866465670499,101.209520377084,65.1677451375925
8.7,"random_instances_SVM","SVM",49,29,912,826,86,3000,2685,315,0.94244821774317,0.648780487804878,1.78353321654763,638,311,327,23,1.1,76.69,8.5,0,0,0,0,0,0,0.345209078022896,94.241072809393,63.0306826013546
8.7,"random_instances_SVM","SVM",49,30,812,733,79,3100,2778,322,0.943275619506622,0.648780487804878,1.78025466284075,657,320,337,19,1.1,79.24,8.6,0,0,0,0,0,0,0.283607120032256,80.5006621242518,58.8094564908924
8.7,"random_instances_SVM","SVM",49,31,712,640,72,3200,2871,329,0.944061233302223,0.648780487804878,1.78353321654763,673,328,345,16,1.1,81.8,8.7,0,0,0,0,0,0,0.255250660874107,75.795713493481,58.041670546642
8.7,"random_instances_SVM","SVM",49,32,612,548,64,3300,2963,337,0.944927637169003,0.653658536585366,1.78025466284075,689,336,353,16,1.1,84.36,8.8,0,0,0,0,0,0,0.207154494281962,67.7492150766508,52.9399200974381
8.7,"random_instances_SVM","SVM",49,33,512,456,56,3400,3055,345,0.945140755805044,0.658536585365854,1.78517702596381,706,345,361,17,1,86.91,8.9,0,0,0,0,0,0,0.138845505789074,57.9696653240345,49.2299771444167
8.7,"random_instances_SVM","SVM",49,34,412,367,45,3500,3144,356,0.944608655681073,0.648780487804878,1.79397100146117,725,354,371,19,1,89.47,8.8,0,0,0,0,0,0,0.0767753288303664,46.5040437053649,41.4202874169954
8.7,"random_instances_SVM","SVM",49,35,312,283,29,3600,3228,372,0.944706160939395,0.648780487804878,1.79067022684946,755,369,386,30,1,92.02,8.7,0,0,0,0,0,0,0.0469379417672736,30.7584110044281,28.3041092381893
8.7,"random_instances_SVM","SVM",49,36,212,188,24,3700,3323,377,0.94441643102896,0.653658536585366,1.78025466284075,768,374,394,13,1.1,94.58,8.8,0,0,0,0,0,0,0.0196128282163463,22.2871683619858,21.7397796854407
8.7,"random_instances_SVM","SVM",49,37,112,100,12,3800,3411,389,0.944511150422758,0.648780487804878,1.78189243161981,789,386,403,21,1,97.14,8.8,0,0,0,0,0,0,0.00134407985401791,12.3938655928905,12.3834586864204
8.7,"random_instances_SVM","SVM",49,38,12,9,3,3900,3502,398,0.944288281260886,0.648780487804878,1.78517702596381,812,396,416,23,1.1,99.69,8.8,0,0,0,0,0,0,0.000321210686221333,2.1657649139557,2.1657649139557
8.7,"random_instances_SVM","SVM",49,39,0,0,0,3912,3511,401,0.944530651474422,0.653658536585366,1.78025466284075,815,398,417,3,1,100,8.8,0,0,0,0,0,0,0,0,0
8.7,"random_instances_SVM","SVM",50,0,3812,3431,381,100,95,5,0.856103372434023,0.490909090909091,1.67165479681609,24,5,19,0,3.8,2.56,19,0,0,0,0,0,0,0.0714586583893139,207.385456297345,7.70051916671777
8.7,"random_instances_SVM","SVM",50,1,3712,3346,366,200,180,20,0.907145475492258,0.595454545454545,1.75864135864136,45,20,25,21,1.2,5.11,9,0,0,0,0,0,0,0.557847703531255,347.692802346359,64.6135599915058
8.7,"random_instances_SVM","SVM",50,2,3612,3254,358,300,272,28,0.91592218265606,0.613636363636364,1.76998743192292,63,28,35,18,1.2,7.67,9.7,0,0,0,0,0,0,0.349900399587009,310.457623356258,40.9381997775958
8.7,"random_instances_SVM","SVM",50,3,3512,3167,345,400,359,41,0.917701351068293,0.65,1.77002502085071,91,41,50,28,1.2,10.22,8.8,0,0,0,0,0,0,0.594675705569223,352.048466170967,66.4524992159767
8.7,"random_instances_SVM","SVM",50,4,3412,3074,338,500,452,48,0.91547706325933,0.627272727272727,1.76998743192292,109,48,61,18,1.3,12.78,9.4,0,0,0,0,0,0,0.334868218915015,280.774684691356,39.5240998253558
8.7,"random_instances_SVM","SVM",50,5,3312,2985,327,600,541,59,0.914575041893598,0.627272727272727,1.75864135864136,128,59,69,19,1.2,15.34,9.2,0,0,0,0,0,0,0.561824750533407,300.639914585824,62.8102227460017
8.7,"random_instances_SVM","SVM",50,6,3212,2894,318,700,632,68,0.917772046501889,0.636363636363636,1.76835760924159,148,68,80,20,1.2,17.89,9.3,0,0,0,0,0,0,0.632095165830821,312.875236194764,70.6414921327053
8.7,"random_instances_SVM","SVM",50,7,3112,2803,309,800,723,77,0.921072475911193,0.645454545454546,1.77654445002511,167,77,90,19,1.2,20.45,9.4,0,0,0,0,0,0,0.594234532842388,285.835244605944,67.377762771699
8.7,"random_instances_SVM","SVM",50,8,3012,2714,298,900,812,88,0.924807551319657,0.654545454545455,1.77002502085071,186,88,98,19,1.1,23.01,9.2,0,0,0,0,0,0,0.553710957439607,272.244260553362,63.8303805210707
8.7,"random_instances_SVM","SVM",50,9,2912,2618,294,1000,908,92,0.928901340594896,0.659090909090909,1.77981467568244,198,92,106,12,1.2,25.56,9.9,0,0,0,0,0,0,0.5,246.089411314317,61.0104447347027
8.7,"random_instances_SVM","SVM",50,10,2812,2521,291,1100,1005,95,0.925030111018022,0.659090909090909,1.77327874331551,210,95,115,12,1.2,28.12,10.6,0,0,0,0,0,0,0.573408819763862,242.189551726567,72.173792622852
8.7,"random_instances_SVM","SVM",50,11,2712,2435,277,1200,1091,109,0.926997800586515,0.659090909090909,1.77981467568244,241,109,132,31,1.2,30.67,10,0,0,0,0,0,0,0.554319581631245,239.526904321123,70.2423228227087
8.7,"random_instances_SVM","SVM",50,12,2612,2348,264,1300,1178,122,0.930370234604111,0.663636363636364,1.78637620444072,262,122,140,21,1.1,33.23,9.7,0,0,0,0,0,0,0.634933359884835,232.21152156857,77.8465756824967
8.7,"random_instances_SVM","SVM",50,13,2512,2259,253,1400,1267,133,0.931149193548392,0.663636363636364,1.78473129080864,281,133,148,19,1.1,35.79,9.5,0,0,0,0,0,0,0.548790107282286,219.27717708561,67.3417037064246
8.7,"random_instances_SVM","SVM",50,14,2412,2166,246,1500,1360,140,0.932488479262678,0.663636363636364,1.77981467568244,290,140,150,9,1.1,38.34,9.7,0,0,0,0,0,0,0.652266912670634,233.297275448603,79.3632200778981
8.7,"random_instances_SVM","SVM",50,15,2312,2073,239,1600,1453,147,0.936075617930464,0.663636363636364,1.77818181818182,311,147,164,21,1.1,40.9,9.9,0,0,0,0,0,0,0.622834257719284,211.469996908179,78.6116069583681
8.7,"random_instances_SVM","SVM",50,16,2212,1979,233,1700,1547,153,0.933425848345217,0.663636363636364,1.77654445002511,318,153,165,7,1.1,43.46,10.1,0,0,0,0,0,0,0.450810779650598,185.662655888021,60.9544986273516
8.7,"random_instances_SVM","SVM",50,17,2112,1892,220,1800,1634,166,0.932556556346891,0.65,1.78637620444072,346,166,180,28,1.1,46.01,9.8,0,0,0,0,0,0,0.512130120146208,183.915536800794,67.7149717040371
8.7,"random_instances_SVM","SVM",50,18,2012,1804,208,1900,1722,178,0.934198261416007,0.654545454545455,1.78637620444072,372,178,194,26,1.1,48.57,9.7,0,0,0,0,0,0,0.639129473963169,196.092160117156,79.5370628933721
8.7,"random_instances_SVM","SVM",50,19,1912,1712,200,2000,1814,186,0.934169459572692,0.636363636363636,1.78308940369658,387,186,201,15,1.1,51.12,9.8,0,0,0,0,0,0,0.556591788378448,173.842305483078,71.7403744489033
8.7,"random_instances_SVM","SVM",50,20,1812,1623,189,2100,1903,197,0.934368454126525,0.645454545454546,1.78637620444072,409,197,212,22,1.1,53.68,9.7,0,0,0,0,0,0,0.577810320299842,169.882120826905,73.6696150560018
8.7,"random_instances_SVM","SVM",50,21,1712,1532,180,2200,1994,206,0.935193234185174,0.654545454545455,1.77818181818182,426,206,220,17,1.1,56.24,9.7,0,0,0,0,0,0,0.575846612129994,157.803972403774,75.2263644288517
8.7,"random_instances_SVM","SVM",50,22,1612,1438,174,2300,2088,212,0.935261311269379,0.654545454545455,1.77818181818182,439,212,227,13,1.1,58.79,9.8,0,0,0,0,0,0,0.575888086843331,151.58754036697,76.1972429087542
8.7,"random_instances_SVM","SVM",50,23,1512,1353,159,2400,2173,227,0.935603005865109,0.654545454545455,1.77818181818182,473,227,246,34,1.1,61.35,9.6,0,0,0,0,0,0,0.493021688260602,141.422924015297,71.1332329910168
8.7,"random_instances_SVM","SVM",50,24,1412,1271,141,2500,2255,245,0.936143695014666,0.65,1.78145053475936,508,245,263,35,1.1,63.91,9.2,0,0,0,0,0,0,0.467941245653237,133.166965224292,67.9705077775198
8.7,"random_instances_SVM","SVM",50,25,1312,1183,129,2600,2343,257,0.935297968160876,0.65,1.77168023932192,530,257,273,22,1.1,66.46,9.1,0,0,0,0,0,0,0.445532465762002,122.71048026548,66.3562501206419
8.7,"random_instances_SVM","SVM",50,26,1212,1085,127,2700,2441,259,0.93583734813574,0.65,1.78473129080864,535,259,276,5,1.1,69.02,9.4,0,0,0,0,0,0,0.431963396897132,115.717172908554,67.6926057482938
8.7,"random_instances_SVM","SVM",50,27,1112,995,117,2800,2531,269,0.935266547968165,0.654545454545455,1.78145053475936,560,269,291,25,1.1,71.57,9.4,0,0,0,0,0,0,0.418772455886377,105.950106344959,68.0831822818888
8.7,"random_instances_SVM","SVM",50,28,1012,908,104,2900,2618,282,0.936177733556771,0.654545454545455,1.77981467568244,582,282,300,22,1.1,74.13,9.3,0,0,0,0,0,0,0.34443932005122,92.8592722065633,62.0578377210841
8.7,"random_instances_SVM","SVM",50,29,912,821,91,3000,2705,295,0.936315196899883,0.663636363636364,1.78145053475936,608,295,313,26,1.1,76.69,9.2,0,0,0,0,0,0,0.283014551755307,83.2472271637381,56.2015467192812
8.7,"random_instances_SVM","SVM",50,30,812,728,84,3100,2798,302,0.936687002513622,0.659090909090909,1.78145053475936,621,302,319,13,1.1,79.24,9.3,0,0,0,0,0,0,0.235898136566858,75.2688099440581,57.5482852927535
8.7,"random_instances_SVM","SVM",50,31,712,640,72,3200,2886,314,0.936612379555937,0.659090909090909,1.78308940369658,648,314,334,27,1.1,81.8,9.2,0,0,0,0,0,0,0.198543346796086,69.7656392844876,54.9439374878119
8.7,"random_instances_SVM","SVM",50,32,612,551,61,3300,2975,325,0.936163332635115,0.659090909090909,1.76355326574705,668,325,343,20,1.1,84.36,9.2,0,0,0,0,0,0,0.154404318250184,62.2747287702827,50.8770353705108
8.7,"random_instances_SVM","SVM",50,33,512,461,51,3400,3065,335,0.935957792207801,0.659090909090909,1.79457059069962,690,335,355,22,1.1,86.91,9.1,0,0,0,0,0,0,0.100669289518432,50.4194197144722,42.8615743753363
8.7,"random_instances_SVM","SVM",50,34,412,373,39,3500,3153,347,0.936730205278598,0.654545454545455,1.77981467568244,710,347,363,20,1,89.47,9.1,0,0,0,0,0,0,0.0720594358725923,42.8510388469439,37.7417717360795
8.7,"random_instances_SVM","SVM",50,35,312,282,30,3600,3244,356,0.93727482195225,0.663636363636364,1.78470127489376,737,356,381,27,1.1,92.02,9.1,0,0,0,0,0,0,0.0487295145745559,32.9129151598161,30.4082640089852
8.7,"random_instances_SVM","SVM",50,36,212,194,18,3700,3332,368,0.93700120444073,0.663636363636364,1.78306693306693,760,368,392,23,1.1,94.58,9.1,0,0,0,0,0,0,0.0215057347470044,21.7285404944515,21.2159968621859
8.7,"random_instances_SVM","SVM",50,37,112,101,11,3800,3425,375,0.936605833682454,0.663636363636364,1.78306693306693,775,375,400,15,1.1,97.14,9.1,0,0,0,0,0,0,0.00138747289418997,10.5455981184128,10.5333555509761
8.7,"random_instances_SVM","SVM",50,38,12,10,2,3900,3516,384,0.936579650188528,0.654545454545455,1.78962232620321,797,383,414,22,1.1,99.69,9.2,0,0,0,0,0,0,0.000545711878179007,0.912082016312445,0.912082016312445
8.7,"random_instances_SVM","SVM",50,39,0,0,0,3912,3526,386,0.936647727272734,0.659090909090909,1.79291813159216,804,385,419,7,1.1,100,9.1,0,0,0,0,0,0,0,0,0
8.7,"random_instances_SVM","SVM",51,0,3812,3421,391,100,90,10,0.882079926453187,0.492682926829268,1.70603124648758,35,10,25,0,2.5,2.56,9,0,0,0,0,0,0,0.281765652677818,372.651202437565,32.2397542202664
8.7,"random_instances_SVM","SVM",51,1,3712,3337,375,200,174,26,0.926687189201991,0.604878048780488,1.77638305046645,62,26,36,27,1.4,5.11,6.7,0,0,0,0,0,0,0.318959485565636,383.229555399232,34.968248477292
8.7,"random_instances_SVM","SVM",51,2,3612,3246,366,300,265,35,0.921561198478921,0.575609756097561,1.7643368411605,78,35,43,16,1.2,7.67,7.6,0,0,0,0,0,0,0.611405519201346,388.6488459703,68.5163774214331
8.7,"random_instances_SVM","SVM",51,3,3512,3154,358,400,357,43,0.92319092922511,0.575609756097561,1.76271520803443,96,43,53,18,1.2,10.22,8.3,0,0,0,0,0,0,0.781042922537297,418.933050151001,83.6898422097893
8.7,"random_instances_SVM","SVM",51,4,3412,3066,346,500,445,55,0.927897647337412,0.609756097560976,1.77698814052361,119,55,64,23,1.2,12.78,8.1,0,0,0,0,0,0,0.791783530377277,422.809020050987,83.1952327589199
8.7,"random_instances_SVM","SVM",51,5,3312,2978,334,600,533,67,0.928421389867811,0.604878048780488,1.77698814052361,144,67,77,25,1.1,15.34,8,0,0,0,0,0,0,0.786556291049515,408.277596403263,83.3862187701056
8.7,"random_instances_SVM","SVM",51,6,3212,2888,324,700,623,77,0.926295775236457,0.6,1.77148493543759,158,77,81,14,1.1,17.89,8.1,0,0,0,0,0,0,0.821986927440877,384.489809292183,86.901111298555
8.7,"random_instances_SVM","SVM",51,7,3112,2800,312,800,711,89,0.931484447911302,0.604878048780488,1.76661375779661,186,89,97,28,1.1,20.45,8,0,0,0,0,0,0,0.824379616435897,394.128811675095,86.6398334686169
8.7,"random_instances_SVM","SVM",51,8,3012,2707,305,900,804,96,0.933378835787224,0.614634146341463,1.76271520803443,203,96,107,17,1.1,23.01,8.4,0,0,0,0,0,0,0.783182083311373,347.007559202454,83.4593783882558
8.7,"random_instances_SVM","SVM",51,9,2912,2618,294,1000,893,107,0.930637545096189,0.624390243902439,1.76271520803443,225,107,118,22,1.1,25.56,8.3,0,0,0,0,0,0,0.756670294933816,321.530135721859,82.1431368640035
8.7,"random_instances_SVM","SVM",51,10,2812,2527,285,1100,984,116,0.931060996503746,0.614634146341463,1.76109655311429,243,116,127,18,1.1,28.12,8.5,0,0,0,0,0,0,0.743135974014927,311.975997951754,81.8499781471219
8.7,"random_instances_SVM","SVM",51,11,2712,2440,272,1200,1071,129,0.93472719421655,0.629268292682927,1.76499597963013,270,129,141,27,1.1,30.67,8.3,0,0,0,0,0,0,0.704484492745975,304.718564658686,77.6555108489572
8.7,"random_instances_SVM","SVM",51,12,2612,2351,261,1300,1160,140,0.938407321251968,0.64390243902439,1.77535937045897,296,140,156,26,1.1,33.23,8.3,0,0,0,0,0,0,0.78821521943972,314.434758642469,86.7815878442046
8.7,"random_instances_SVM","SVM",51,13,2512,2259,253,1400,1252,148,0.937735927901829,0.639024390243902,1.78025466284075,310,148,162,14,1.1,35.79,8.5,0,0,0,0,0,0,0.659128914676288,284.382838355877,75.3125504635534
8.7,"random_instances_SVM","SVM",51,14,2412,2169,243,1500,1342,158,0.935755178225685,0.629268292682927,1.78410498312133,334,158,176,24,1.1,38.34,8.5,0,0,0,0,0,0,0.714050337294602,264.088646090247,82.811392867186
8.7,"random_instances_SVM","SVM",51,15,2312,2078,234,1600,1433,167,0.936483681798558,0.634146341463415,1.7890243902439,349,167,182,15,1.1,40.9,8.6,0,0,0,0,0,0,0.64028240131738,241.630893298727,76.6579558908465
8.7,"random_instances_SVM","SVM",51,16,2212,1986,226,1700,1525,175,0.93917343399591,0.648780487804878,1.79397100146117,367,175,192,18,1.1,43.46,8.7,0,0,0,0,0,0,0.730032711475974,243.030871388153,84.2266378624573
8.7,"random_instances_SVM","SVM",51,17,2112,1893,219,1800,1618,182,0.939159504673291,0.64390243902439,1.79067022684946,384,182,202,17,1.1,46.01,8.9,0,0,0,0,0,0,0.688445821350523,224.310222068359,81.5039656695932
8.7,"random_instances_SVM","SVM",51,18,2012,1803,209,1900,1708,192,0.936824950202676,0.639024390243902,1.78574177668382,402,192,210,18,1.1,48.57,8.9,0,0,0,0,0,0,0.665769364144663,210.321002376796,81.9288961032236
8.7,"random_instances_SVM","SVM",51,19,1912,1714,198,2000,1797,203,0.935074034349714,0.624390243902439,1.7890243902439,425,203,222,23,1.1,51.12,8.9,0,0,0,0,0,0,0.582449736869233,192.582497065665,76.7548564165405
8.7,"random_instances_SVM","SVM",51,20,1812,1623,189,2100,1888,212,0.93299717234751,0.609756097560976,1.79067022684946,448,212,236,23,1.1,53.68,8.9,0,0,0,0,0,0,0.655454353759296,187.935740059443,83.1520435619254
8.7,"random_instances_SVM","SVM",51,21,1712,1533,179,2200,1978,222,0.933484698639107,0.614634146341463,1.79067022684946,464,222,242,16,1.1,56.24,8.9,0,0,0,0,0,0,0.588702173526247,179.015326047883,76.8241041602735
8.7,"random_instances_SVM","SVM",51,22,1612,1438,174,2300,2073,227,0.934094802969734,0.619512195121951,1.79067022684946,473,227,246,9,1.1,58.79,9.1,0,0,0,0,0,0,0.665545446324282,175.689511434165,83.3347365666622
8.7,"random_instances_SVM","SVM",51,23,1512,1349,163,2400,2162,238,0.936730230808876,0.624390243902439,1.7890243902439,498,238,260,25,1.1,61.35,9.1,0,0,0,0,0,0,0.638204211755957,170.369844503121,81.8580893064484
8.7,"random_instances_SVM","SVM",51,24,1412,1260,152,2500,2251,249,0.937501915281859,0.639024390243902,1.79231909446166,517,249,268,19,1.1,63.91,9,0,0,0,0,0,0,0.522737270139509,152.293656410007,73.930589944303
8.7,"random_instances_SVM","SVM",51,25,1312,1174,138,2600,2337,263,0.939170648131383,0.64390243902439,1.7890243902439,542,263,279,25,1.1,66.46,8.9,0,0,0,0,0,0,0.565106553602153,150.708909823443,78.8588262949814
8.7,"random_instances_SVM","SVM",51,26,1212,1082,130,2700,2429,271,0.939071749940801,0.64390243902439,1.79231909446166,565,271,294,23,1.1,69.02,9,0,0,0,0,0,0,0.56656002830786,143.257294307358,78.9401599498456
8.7,"random_instances_SVM","SVM",51,27,1112,996,116,2800,2515,285,0.940187488682427,0.653658536585366,1.7873815762951,588,285,303,23,1.1,71.57,8.8,0,0,0,0,0,0,0.489934860722779,125.710152887994,74.1868616587632
8.7,"random_instances_SVM","SVM",51,28,1012,906,106,2900,2605,295,0.939112144976394,0.64390243902439,1.79397100146117,610,295,315,22,1.1,74.13,8.8,0,0,0,0,0,0,0.456570616858683,114.300513784267,75.0786604734506
8.7,"random_instances_SVM","SVM",51,29,912,815,97,3000,2696,304,0.938476967865057,0.634146341463415,1.7873815762951,624,304,320,14,1.1,76.69,8.9,0,0,0,0,0,0,0.408126906956418,104.21984336235,70.6209208966694
8.7,"random_instances_SVM","SVM",51,30,812,729,83,3100,2782,318,0.938541042749094,0.634146341463415,1.7873815762951,653,318,335,29,1.1,79.24,8.7,0,0,0,0,0,0,0.330197289759651,89.8667129925265,64.052400097148
8.7,"random_instances_SVM","SVM",51,31,712,636,76,3200,2875,325,0.938293100806508,0.634146341463415,1.7873815762951,667,325,342,14,1.1,81.8,8.8,0,0,0,0,0,0,0.272478468273307,81.986933345613,63.4846103388842
8.7,"random_instances_SVM","SVM",51,32,612,543,69,3300,2968,332,0.936958671699797,0.624390243902439,1.79397100146117,679,332,347,12,1,84.36,8.9,0,0,0,0,0,0,0.172729094983177,66.901294457649,52.4403747700185
8.7,"random_instances_SVM","SVM",51,33,512,451,61,3400,3060,340,0.937061748687163,0.624390243902439,1.7873815762951,701,340,361,22,1.1,86.91,9,0,0,0,0,0,0,0.132555594602946,60.4124844302631,50.4536321470601
8.7,"random_instances_SVM","SVM",51,34,412,364,48,3500,3147,353,0.937474056636626,0.624390243902439,1.78025466284075,721,353,368,20,1,89.47,8.9,0,0,0,0,0,0,0.0980461530148146,51.24226280305,45.3958323714386
8.7,"random_instances_SVM","SVM",51,35,312,275,37,3600,3236,364,0.93895613656308,0.639024390243902,1.79067022684946,739,362,377,18,1,92.02,8.9,0,0,0,0,0,0,0.0553933999551948,39.078089338607,36.5741256662009
8.7,"random_instances_SVM","SVM",51,36,212,184,28,3700,3327,373,0.939112144976391,0.634146341463415,1.78410498312133,761,371,390,22,1.1,94.58,8.9,0,0,0,0,0,0,0.0230207587617687,27.2216396579978,26.7466338080013
8.7,"random_instances_SVM","SVM",51,37,112,96,16,3800,3415,385,0.940103912746724,0.648780487804878,1.79067022684946,788,385,403,27,1,97.14,8.9,0,0,0,0,0,0,0.000814209483434171,14.4609238702092,14.4563191426821
8.7,"random_instances_SVM","SVM",51,38,12,10,2,3900,3501,399,0.940725160535445,0.648780487804878,1.78353321654763,817,398,419,29,1.1,99.69,8.8,0,0,0,0,0,0,0.000359747585162054,1.41714983014467,1.41714983014467
8.7,"random_instances_SVM","SVM",51,39,0,0,0,3912,3511,401,0.940870025490662,0.648780487804878,1.78353321654763,820,400,420,3,1.1,100,8.8,0,0,0,0,0,0,0,0,0
8.7,"random_instances_SVM","SVM",52,0,3812,3410,402,100,89,11,0.906750445983799,0.559585492227979,1.74961104212164,24,11,13,0,1.2,2.56,8.1,0,0,0,0,0,0,0.757039661687439,449.164763787727,80.5137498137845
8.7,"random_instances_SVM","SVM",52,1,3712,3326,386,200,173,27,0.918373944553996,0.564766839378238,1.77310852202788,58,27,31,34,1.1,5.11,6.4,0,0,0,0,0,0,0.83396096694579,542.895658920808,86.9911159647654
8.7,"random_instances_SVM","SVM",52,2,3612,3238,374,300,261,39,0.915157277250563,0.590673575129534,1.7108142796026,86,39,47,28,1.2,7.67,6.7,0,0,0,0,0,0,0.750309703077662,522.433540180893,78.9696934552607
8.7,"random_instances_SVM","SVM",52,3,3512,3146,366,400,353,47,0.914321149477311,0.569948186528497,1.70621237326673,104,47,57,18,1.2,10.22,7.5,0,0,0,0,0,0,0.777690181314769,441.902756557531,82.817412810159
8.7,"random_instances_SVM","SVM",52,4,3412,3060,352,500,439,61,0.916637032378281,0.595854922279793,1.70621237326673,128,61,67,24,1.1,12.78,7.2,0,0,0,0,0,0,0.852727619812469,455.843936519241,89.621554545775
8.7,"random_instances_SVM","SVM",52,5,3312,2970,342,600,529,71,0.916296115606048,0.590673575129534,1.71395915879305,154,71,83,26,1.2,15.34,7.5,0,0,0,0,0,0,0.838385814019065,425.399365130727,88.3604279066644
8.7,"random_instances_SVM","SVM",52,6,3212,2880,332,700,619,81,0.918309287924796,0.595854922279793,1.7108142796026,169,81,88,15,1.1,17.89,7.6,0,0,0,0,0,0,0.776384751107202,397.668051023874,83.0588072808072
8.7,"random_instances_SVM","SVM",52,7,3112,2786,326,800,713,87,0.915728900631584,0.616580310880829,1.71711562133226,188,87,101,19,1.2,20.45,8.2,0,0,0,0,0,0,0.836315951446951,376.977396255884,88.7491956280149
8.7,"random_instances_SVM","SVM",52,8,3012,2694,318,900,805,95,0.922204849834984,0.601036269430052,1.77589960545705,201,95,106,13,1.1,23.01,8.5,0,0,0,0,0,0,0.727530935316731,332.433127809615,80.0487044826596
8.7,"random_instances_SVM","SVM",52,9,2912,2603,309,1000,896,104,0.922689774554096,0.621761658031088,1.77916412679061,217,104,113,16,1.1,25.56,8.6,0,0,0,0,0,0,0.774326270267307,340.09602397856,83.7095614149573
8.7,"random_instances_SVM","SVM",52,10,2812,2515,297,1100,984,116,0.924476648670578,0.601036269430052,1.77264704207709,247,116,131,30,1.1,28.12,8.5,0,0,0,0,0,0,0.648421127258282,291.267676308202,73.3969183402292
8.7,"random_instances_SVM","SVM",52,11,2712,2422,290,1200,1077,123,0.926259114380517,0.606217616580311,1.76540197225472,263,123,140,16,1.1,30.67,8.8,0,0,0,0,0,0,0.734015187869036,291.949703229714,82.2552536271832
8.7,"random_instances_SVM","SVM",52,12,2612,2331,281,1300,1168,132,0.925362738384584,0.606217616580311,1.75606122107877,278,132,146,15,1.1,33.23,8.8,0,0,0,0,0,0,0.763318713650078,284.578710155418,85.0976001578318
8.7,"random_instances_SVM","SVM",52,13,2512,2242,270,1400,1257,143,0.925662510029122,0.61139896373057,1.76540197225472,309,143,166,31,1.2,35.79,8.8,0,0,0,0,0,0,0.66221610101292,265.706635810499,78.3044887050568
8.7,"random_instances_SVM","SVM",52,14,2412,2162,250,1500,1337,163,0.925505276862623,0.606217616580311,1.76053413593417,349,163,186,40,1.1,38.34,8.2,0,0,0,0,0,0,0.769841797146162,279.816789574756,86.9152448303678
8.7,"random_instances_SVM","SVM",52,15,2312,2074,238,1600,1425,175,0.92803717168392,0.601036269430052,1.75891748383505,365,174,191,16,1.1,40.9,8.1,0,0,0,0,0,0,0.771593859722677,268.053278510308,86.1256328763886
8.7,"random_instances_SVM","SVM",52,16,2212,1982,230,1700,1517,183,0.927950473022021,0.606217616580311,1.76053413593417,394,183,211,29,1.2,43.46,8.3,0,0,0,0,0,0,0.77796021733236,258.972708051238,87.718538027586
8.7,"random_instances_SVM","SVM",52,17,2112,1893,219,1800,1606,194,0.928695493726831,0.606217616580311,1.76540197225472,408,194,214,14,1.1,46.01,8.3,0,0,0,0,0,0,0.750989343088925,243.716202888669,85.5795049060154
8.7,"random_instances_SVM","SVM",52,18,2012,1806,206,1900,1693,207,0.930095897536862,0.606217616580311,1.76377637191195,425,207,218,17,1.1,48.57,8.2,0,0,0,0,0,0,0.743232170369891,232.843864467016,85.8980749271275
8.7,"random_instances_SVM","SVM",52,19,1912,1719,193,2000,1780,220,0.929879885616534,0.61139896373057,1.7540852929454,450,218,232,25,1.1,51.12,8.1,0,0,0,0,0,0,0.735549641736974,234.290594240193,84.8881165177615
8.7,"random_instances_SVM","SVM",52,20,1812,1631,181,2100,1868,232,0.929888702429614,0.61139896373057,1.75891748383505,474,231,243,24,1.1,53.68,8.1,0,0,0,0,0,0,0.703903856980833,211.392467936267,84.0795474669792
8.7,"random_instances_SVM","SVM",52,21,1712,1541,171,2200,1958,242,0.929832862613474,0.621761658031088,1.76215376255416,499,242,257,25,1.1,56.24,8.1,0,0,0,0,0,0,0.665969101303734,191.774563368225,81.6598436114494
8.7,"random_instances_SVM","SVM",52,22,1612,1452,160,2300,2047,253,0.931317026147721,0.616580310880829,1.76215376255416,521,252,269,22,1.1,58.79,8.1,0,0,0,0,0,0,0.666138675661998,181.908315442554,82.5679320416512
8.7,"random_instances_SVM","SVM",52,23,1512,1369,143,2400,2130,270,0.931499240284599,0.626943005181347,1.76215376255416,550,268,282,29,1.1,61.35,7.9,0,0,0,0,0,0,0.604593082763486,167.511498846767,78.5242627097457
8.7,"random_instances_SVM","SVM",52,24,1412,1281,131,2500,2218,282,0.930751280642093,0.61139896373057,1.76377637191195,566,275,291,16,1.1,63.91,7.9,0,0,0,0,0,0,0.546490839203084,148.830833931343,74.1365418207861
8.7,"random_instances_SVM","SVM",52,25,1312,1195,117,2600,2304,296,0.931383152245781,0.616580310880829,1.76053413593417,590,286,304,24,1.1,66.46,7.8,0,0,0,0,0,0,0.513921493191793,134.882527899385,71.9298255456386
8.7,"random_instances_SVM","SVM",52,26,1212,1103,109,2700,2396,304,0.93112893413546,0.61139896373057,1.75891748383505,606,294,312,16,1.1,69.02,7.9,0,0,0,0,0,0,0.5,125.609449867677,69.8175675256408
8.7,"random_instances_SVM","SVM",52,27,1112,1013,99,2800,2486,314,0.931860729620662,0.61139896373057,1.76053413593417,619,303,316,13,1,71.57,7.9,0,0,0,0,0,0,0.470387094065548,117.764023708704,69.9414178426629
8.7,"random_instances_SVM","SVM",52,28,1012,926,86,2900,2573,327,0.932477906535894,0.61139896373057,1.76215376255416,651,317,334,32,1.1,74.13,7.9,0,0,0,0,0,0,0.407248282780805,105.498988190757,68.2462538336819
8.7,"random_instances_SVM","SVM",52,29,912,838,74,3000,2661,339,0.932082619416379,0.616580310880829,1.76053413593417,677,328,349,26,1.1,76.69,7.8,0,0,0,0,0,0,0.31210799315388,88.9557029525966,62.4412577471597
8.7,"random_instances_SVM","SVM",52,30,812,746,66,3100,2753,347,0.932608689263172,0.626943005181347,1.76053413593417,693,337,356,16,1.1,79.24,7.9,0,0,0,0,0,0,0.262858884237963,80.6920782965705,59.5843470791123
8.7,"random_instances_SVM","SVM",52,31,712,656,56,3200,2843,357,0.93249113175551,0.632124352331606,1.76053413593417,712,345,367,19,1.1,81.8,8,0,0,0,0,0,0,0.232580696383632,71.9817075790056,56.364728686458
8.7,"random_instances_SVM","SVM",52,32,612,564,48,3300,2935,365,0.932128172950598,0.621761658031088,1.75891748383505,724,354,370,12,1,84.36,8,0,0,0,0,0,0,0.147201143102871,60.4967886062365,50.6636229507512
8.7,"random_instances_SVM","SVM",52,33,512,473,39,3400,3026,374,0.932107600386757,0.621761658031088,1.76377637191195,747,364,383,23,1.1,86.91,8.1,0,0,0,0,0,0,0.0842958046345698,51.4335213121272,44.9099219752475
8.7,"random_instances_SVM","SVM",52,34,412,381,31,3500,3118,382,0.932482314942435,0.632124352331606,1.76053413593417,758,369,389,11,1.1,89.47,8.2,0,0,0,0,0,0,0.0696777296504325,43.3251478914255,39.2199255311954
8.7,"random_instances_SVM","SVM",52,35,312,288,24,3600,3211,389,0.932113478262144,0.621761658031088,1.76215376255416,771,377,394,13,1,92.02,8.3,0,0,0,0,0,0,0.0384615259906368,31.1966903823399,29.6190124201445
8.7,"random_instances_SVM","SVM",52,36,212,195,17,3700,3304,396,0.932042943757546,0.626943005181347,1.76215376255416,789,385,404,18,1,94.58,8.3,0,0,0,0,0,0,0.0128234128814891,20.6049052673301,20.2156631163718
8.7,"random_instances_SVM","SVM",52,37,112,103,9,3800,3396,404,0.932098783573687,0.626943005181347,1.76540197225472,800,392,408,11,1,97.14,8.4,0,0,0,0,0,0,0.00109164172068348,10.5286922292464,10.5218612922249
8.7,"random_instances_SVM","SVM",52,38,12,11,1,3900,3488,412,0.93188277165335,0.621761658031088,1.75730379807007,815,402,413,15,1,99.69,8.5,0,0,0,0,0,0,0.000268302150186214,1.24110635071333,1.24110635071333
8.7,"random_instances_SVM","SVM",52,39,0,0,0,3912,3499,413,0.931516873910749,0.626943005181347,1.76215376255416,821,403,418,6,1,100,8.5,0,0,0,0,0,0,0,0,0
8.7,"random_instances_SVM","SVM",53,0,3812,3416,396,100,83,17,0.909802532776505,0.533678756476684,1.75121914050594,38,17,21,0,1.2,2.56,4.9,0,0,0,0,0,0,0.918703796895496,718.127182779799,94.1830576139833
8.7,"random_instances_SVM","SVM",53,1,3712,3332,380,200,167,33,0.915714205943127,0.544041450777202,1.74672046990282,65,31,34,27,1.1,5.11,5.1,0,0,0,0,0,0,0.882116571406665,624.505522648734,91.0638479245212
8.7,"random_instances_SVM","SVM",53,2,3612,3242,370,300,257,43,0.918444479058608,0.575129533678757,1.7201121832961,93,43,50,28,1.2,7.67,6,0,0,0,0,0,0,0.888158001588159,571.375413629986,91.62700658863
8.7,"random_instances_SVM","SVM",53,3,3512,3150,362,400,349,51,0.919185091356894,0.580310880829015,1.74350663279168,110,51,59,17,1.2,10.22,6.8,0,0,0,0,0,0,0.817349069626188,522.918417778537,85.8310735528631
8.7,"random_instances_SVM","SVM",53,4,3412,3059,353,500,440,60,0.925165829559252,0.595854922279793,1.76377637191195,130,60,70,20,1.2,12.78,7.3,0,0,0,0,0,0,0.917543769996757,528.992203059696,94.3556527460217
8.7,"random_instances_SVM","SVM",53,5,3312,2968,344,600,531,69,0.927734461101696,0.595854922279793,1.77310852202788,148,69,79,18,1.1,15.34,7.7,0,0,0,0,0,0,0.863534229551249,483.433240218216,90.1172995538832
8.7,"random_instances_SVM","SVM",53,6,3212,2877,335,700,622,78,0.921689066270118,0.580310880829015,1.75606122107877,165,78,87,17,1.1,17.89,8,0,0,0,0,0,0,0.776107679352151,403.318126878231,83.564259824309
8.7,"random_instances_SVM","SVM",53,7,3112,2789,323,800,710,90,0.924522202204795,0.580310880829015,1.75283019767292,192,90,102,27,1.1,20.45,7.9,0,0,0,0,0,0,0.818210684777072,379.083414110194,87.4354626794207
8.7,"random_instances_SVM","SVM",53,8,3012,2694,318,900,805,95,0.919443717873741,0.559585492227979,1.73737971872687,202,95,107,10,1.1,23.01,8.5,0,0,0,0,0,0,0.745651743452,359.65784361822,82.0394569980923
8.7,"random_instances_SVM","SVM",53,9,2912,2601,311,1000,898,102,0.919928642592866,0.55440414507772,1.73393569061716,222,102,120,20,1.2,25.56,8.8,0,0,0,0,0,0,0.64779076006101,327.321485950491,74.3882048546062
8.7,"random_instances_SVM","SVM",53,10,2812,2513,299,1100,986,114,0.921462768067866,0.585492227979275,1.72782492650656,240,114,126,18,1.1,28.12,8.6,0,0,0,0,0,0,0.725228478217753,328.838247390336,81.8037654964853
8.7,"random_instances_SVM","SVM",53,11,2712,2426,286,1200,1073,127,0.92605632767981,0.595854922279793,1.76377637191195,265,127,138,25,1.1,30.67,8.4,0,0,0,0,0,0,0.7795665592937,324.307879230348,85.3505272894963
8.7,"random_instances_SVM","SVM",53,12,2612,2336,276,1300,1163,137,0.926799878915779,0.595854922279793,1.75444422179601,285,137,148,20,1.1,33.23,8.5,0,0,0,0,0,0,0.733422360934302,307.597249465964,82.3247278457217
8.7,"random_instances_SVM","SVM",53,13,2512,2246,266,1400,1253,147,0.928472134462285,0.61139896373057,1.76540197225472,306,147,159,21,1.1,35.79,8.5,0,0,0,0,0,0,0.638037867289919,280.370663093696,73.9706332244917
8.7,"random_instances_SVM","SVM",53,14,2412,2156,256,1500,1343,157,0.928104767250839,0.621761658031088,1.75891748383505,325,157,168,19,1.1,38.34,8.6,0,0,0,0,0,0,0.670147770995585,280.355706133867,76.6283881940797
8.7,"random_instances_SVM","SVM",53,15,2312,2068,244,1600,1431,169,0.930790956300948,0.621761658031088,1.7540852929454,352,169,183,27,1.1,40.9,8.5,0,0,0,0,0,0,0.702631769797387,270.113232644896,80.7555415742807
8.7,"random_instances_SVM","SVM",53,16,2212,1975,237,1700,1524,176,0.929234788793259,0.621761658031088,1.76377637191195,370,176,194,18,1.1,43.46,8.7,0,0,0,0,0,0,0.748660585691975,267.507699968989,84.6096660346345
8.7,"random_instances_SVM","SVM",53,17,2112,1881,231,1800,1618,182,0.930705727107885,0.621761658031088,1.76053413593417,384,182,202,14,1.1,46.01,8.9,0,0,0,0,0,0,0.713637961812632,251.898872585512,82.891570368671
8.7,"random_instances_SVM","SVM",53,18,2012,1795,217,1900,1704,196,0.932407372031313,0.632124352331606,1.76215376255416,413,196,217,29,1.1,48.57,8.7,0,0,0,0,0,0,0.773289197564568,250.445009348054,87.0634391650873
8.7,"random_instances_SVM","SVM",53,19,1912,1704,208,2000,1795,205,0.933095083451138,0.632124352331606,1.75730379807007,429,205,224,16,1.1,51.12,8.8,0,0,0,0,0,0,0.688208032259319,235.009716131536,80.5805688501439
8.7,"random_instances_SVM","SVM",53,20,1812,1616,196,2100,1883,217,0.931278819957749,0.632124352331606,1.75891748383505,452,217,235,23,1.1,53.68,8.7,0,0,0,0,0,0,0.650020429487441,217.013454349874,78.7724802805759
8.7,"random_instances_SVM","SVM",53,21,1712,1523,189,2200,1976,224,0.931634431418432,0.637305699481865,1.76053413593417,468,224,244,16,1.1,56.24,8.8,0,0,0,0,0,0,0.691240924953284,212.14267201664,83.4646946170619
8.7,"random_instances_SVM","SVM",53,22,1612,1438,174,2300,2061,239,0.934405849661589,0.647668393782383,1.77474272343067,499,239,260,31,1.1,58.79,8.6,0,0,0,0,0,0,0.688269658462738,202.575872827588,83.2367455589373
8.7,"random_instances_SVM","SVM",53,23,1512,1351,161,2400,2148,252,0.935250794247916,0.647668393782383,1.76984913136239,519,252,267,20,1.1,61.35,8.5,0,0,0,0,0,0,0.651919240027981,189.785214455027,81.0237562241873
8.7,"random_instances_SVM","SVM",53,24,1412,1260,152,2500,2239,261,0.937876735075343,0.652849740932642,1.76822392554847,545,261,284,26,1.1,63.91,8.6,0,0,0,0,0,0,0.587894016480161,171.716795666257,78.2326270862181
8.7,"random_instances_SVM","SVM",53,25,1312,1172,140,2600,2327,273,0.938163281500274,0.647668393782383,1.76336616751125,563,273,290,18,1.1,66.46,8.5,0,0,0,0,0,0,0.564380966100979,158.292929942343,76.878991387202
8.7,"random_instances_SVM","SVM",53,26,1212,1083,129,2700,2416,284,0.939319753481921,0.647668393782383,1.7714773274354,587,284,303,24,1.1,69.02,8.5,0,0,0,0,0,0,0.517999256806242,141.143875594663,74.4045402371742
8.7,"random_instances_SVM","SVM",53,27,1112,995,117,2800,2504,296,0.941203612542228,0.652849740932642,1.77474272343067,614,296,318,27,1.1,71.57,8.5,0,0,0,0,0,0,0.5,130.775256175871,71.8158935373751
8.7,"random_instances_SVM","SVM",53,28,1012,907,105,2900,2592,308,0.941175692634156,0.663212435233161,1.76984913136239,634,308,326,20,1.1,74.13,8.4,0,0,0,0,0,0,0.5,121.202511046906,73.6559694576416
8.7,"random_instances_SVM","SVM",53,29,912,809,103,3000,2690,310,0.941703231949794,0.652849740932642,1.76660170176356,645,310,335,11,1.1,76.69,8.7,0,0,0,0,0,0,0.437376685053677,111.589340191578,67.55702090808
8.7,"random_instances_SVM","SVM",53,30,812,717,95,3100,2782,318,0.941856056709755,0.652849740932642,1.76660170176356,660,318,342,15,1.1,79.24,8.7,0,0,0,0,0,0,0.417538037165107,103.055916660878,68.8678760880219
8.7,"random_instances_SVM","SVM",53,31,712,631,81,3200,2868,332,0.94164445319596,0.647668393782383,1.76984913136239,682,332,350,22,1.1,81.8,8.6,0,0,0,0,0,0,0.336540391425368,91.0813669816883,68.11453989222
8.7,"random_instances_SVM","SVM",53,32,612,537,75,3300,2962,338,0.942367431868092,0.658031088082902,1.7714773274354,692,338,354,10,1,84.36,8.8,0,0,0,0,0,0,0.237170721866385,76.4332661996146,58.922639975873
8.7,"random_instances_SVM","SVM",53,33,512,450,62,3400,3049,351,0.943228540611727,0.647668393782383,1.7714773274354,721,351,370,29,1.1,86.91,8.7,0,0,0,0,0,0,0.172846356535092,63.4711462549959,53.1743400305053
8.7,"random_instances_SVM","SVM",53,34,412,362,50,3500,3137,363,0.943068368507536,0.647668393782383,1.77310852202788,749,363,386,28,1.1,89.47,8.6,0,0,0,0,0,0,0.0883874811893842,52.104974012494,46.7509865045024
8.7,"random_instances_SVM","SVM",53,35,312,275,37,3600,3224,376,0.941997125718955,0.647668393782383,1.76984913136239,769,376,393,20,1,92.02,8.6,0,0,0,0,0,0,0.0507501760115757,41.6124342140917,39.4001033853221
8.7,"random_instances_SVM","SVM",53,36,212,187,25,3700,3312,388,0.941811972644385,0.642487046632124,1.77474272343067,791,386,405,22,1,94.58,8.5,0,0,0,0,0,0,0.0127674551178494,27.0474819431556,26.6768783703865
8.7,"random_instances_SVM","SVM",53,37,112,97,15,3800,3402,398,0.942276324799655,0.647668393782383,1.76984913136239,812,395,417,21,1.1,97.14,8.5,0,0,0,0,0,0,0.00188716765268287,17.9751017238109,17.9656659819215
8.7,"random_instances_SVM","SVM",53,38,12,10,2,3900,3489,411,0.942155828354299,0.652849740932642,1.77474272343067,834,407,427,22,1,99.69,8.5,0,0,0,0,0,0,0.000179809075292271,2.57155144813675,2.57155144813675
8.7,"random_instances_SVM","SVM",53,39,0,0,0,3912,3499,413,0.942113213757772,0.658031088082902,1.77310852202788,840,408,432,6,1.1,100,8.5,0,0,0,0,0,0,0,0,0
8.7,"random_instances_SVM","SVM",54,0,3812,3414,398,100,92,8,0.864161446469255,0.515,1.67785321100917,22,8,14,0,1.8,2.56,11.5,0,0,0,0,0,0,0.5,297.763357953031,58.0653463763868
8.7,"random_instances_SVM","SVM",54,1,3712,3330,382,200,176,24,0.884980068337127,0.545,1.70361290322581,52,24,28,30,1.2,5.11,7.3,0,0,0,0,0,0,0.738439482725474,370.612740866237,80.7733730560476
8.7,"random_instances_SVM","SVM",54,2,3612,3242,370,300,264,36,0.896285592255132,0.565,1.72271559633028,78,36,42,26,1.2,7.67,7.3,0,0,0,0,0,0,0.668441622027387,369.817629229129,72.7928881501353
8.7,"random_instances_SVM","SVM",54,3,3512,3153,359,400,353,47,0.90508969248292,0.575,1.76508287292818,103,47,56,25,1.2,10.22,7.5,0,0,0,0,0,0,0.744943115010669,390.203464958224,80.6163956962318
8.7,"random_instances_SVM","SVM",54,4,3412,3067,345,500,439,61,0.913149202733495,0.565,1.78473732718894,129,61,68,26,1.1,12.78,7.2,0,0,0,0,0,0,0.746145275540453,393.100619320234,80.1482672063552
8.7,"random_instances_SVM","SVM",54,5,3312,2972,340,600,534,66,0.915953872437366,0.565,1.77167429094236,138,66,72,9,1.1,15.34,8.1,0,0,0,0,0,0,0.782954319512877,374.991744426287,83.7902519656842
8.7,"random_instances_SVM","SVM",54,6,3212,2882,330,700,624,76,0.915388667425974,0.555,1.77981617647059,159,76,83,21,1.1,17.89,8.2,0,0,0,0,0,0,0.82594556022226,355.962056419734,88.3783583017945
8.7,"random_instances_SVM","SVM",54,7,3112,2787,325,800,719,81,0.917961275626428,0.57,1.77818181818182,176,81,95,17,1.2,20.45,8.9,0,0,0,0,0,0,0.715970705088651,304.972060055088,80.2958676901232
8.7,"random_instances_SVM","SVM",54,8,3012,2694,318,900,812,88,0.917919988610487,0.57,1.77981617647059,187,88,99,11,1.1,23.01,9.2,0,0,0,0,0,0,0.782892628211092,313.066825065124,85.9935108862326
8.7,"random_instances_SVM","SVM",54,9,2912,2601,311,1000,905,95,0.917517084282468,0.575,1.77818181818182,201,95,106,14,1.1,25.56,9.5,0,0,0,0,0,0,0.733510787612587,293.749990365351,83.3758911559955
8.7,"random_instances_SVM","SVM",54,10,2812,2511,301,1100,995,105,0.920444191343977,0.58,1.75769585253456,222,105,117,21,1.1,28.12,9.5,0,0,0,0,0,0,0.793747958275734,301.371794669716,87.6416452587236
8.7,"random_instances_SVM","SVM",54,11,2712,2420,292,1200,1086,114,0.918160592255141,0.585,1.75769585253456,243,114,129,21,1.1,30.67,9.5,0,0,0,0,0,0,0.72345012910705,280.064796116269,83.2806287656975
8.7,"random_instances_SVM","SVM",54,12,2612,2328,284,1300,1178,122,0.920795842824614,0.575,1.74642857142857,256,122,134,13,1.1,33.23,9.7,0,0,0,0,0,0,0.754671633576203,271.813383628482,85.7260853726509
8.7,"random_instances_SVM","SVM",54,13,2512,2239,273,1400,1267,133,0.921594533029624,0.575,1.75284926470588,281,133,148,25,1.1,35.79,9.5,0,0,0,0,0,0,0.74109885408021,258.373189910959,84.3871032446691
8.7,"random_instances_SVM","SVM",54,14,2412,2148,264,1500,1358,142,0.916110478359929,0.59,1.75446182152714,295,142,153,14,1.1,38.34,9.6,0,0,0,0,0,0,0.733495174497221,248.761984746777,85.329908727014
8.7,"random_instances_SVM","SVM",54,15,2312,2063,249,1600,1443,157,0.920284738041018,0.575,1.77082720588235,323,157,166,28,1.1,40.9,9.2,0,0,0,0,0,0,0.709994208698589,238.250532197307,83.1385988541736
8.7,"random_instances_SVM","SVM",54,16,2212,1974,238,1700,1532,168,0.916601651480654,0.57,1.75860550458716,350,168,182,27,1.1,43.46,9.1,0,0,0,0,0,0,0.77417323007313,244.331722371596,87.8524190416754
8.7,"random_instances_SVM","SVM",54,17,2112,1887,225,1800,1619,181,0.920545273348527,0.565,1.77082720588235,374,181,193,24,1.1,46.01,8.9,0,0,0,0,0,0,0.711506415247287,230.644355188121,82.7327181556688
8.7,"random_instances_SVM","SVM",54,18,2012,1799,213,1900,1707,193,0.919494589977227,0.575,1.77408839779006,397,193,204,23,1.1,48.57,8.8,0,0,0,0,0,0,0.756058546237236,230.143607958708,87.8948027191309
8.7,"random_instances_SVM","SVM",54,19,1912,1710,202,2000,1796,204,0.920347380410033,0.57,1.76670967741935,422,204,218,25,1.1,51.12,8.8,0,0,0,0,0,0,0.709048459139416,208.343402066524,83.6973552443905
8.7,"random_instances_SVM","SVM",54,20,1812,1623,189,2100,1883,217,0.919807801822332,0.565,1.76183823529412,448,217,231,26,1.1,53.68,8.7,0,0,0,0,0,0,0.701496786034717,195.847719781847,84.6494367634418
8.7,"random_instances_SVM","SVM",54,21,1712,1537,175,2200,1969,231,0.920711845102515,0.575,1.77245630174793,465,228,237,17,1,56.24,8.5,0,0,0,0,0,0,0.638341281393441,178.13543943458,80.1723013875001
8.7,"random_instances_SVM","SVM",54,22,1612,1446,166,2300,2060,240,0.920996583143515,0.57,1.76920110192837,481,234,247,16,1.1,58.79,8.6,0,0,0,0,0,0,0.609568084173891,167.074715409169,77.9816001977724
8.7,"random_instances_SVM","SVM",54,23,1512,1353,159,2400,2153,247,0.920384396355361,0.57,1.77082720588235,493,240,253,12,1.1,61.35,8.7,0,0,0,0,0,0,0.591652726864294,156.218211075639,77.519600648995
8.7,"random_instances_SVM","SVM",54,24,1412,1263,149,2500,2243,257,0.918577733485202,0.565,1.76757798165138,522,253,269,29,1.1,63.91,8.7,0,0,0,0,0,0,0.579674234229135,147.619607238827,77.9061107623484
8.7,"random_instances_SVM","SVM",54,25,1312,1173,139,2600,2333,267,0.919803530751717,0.57,1.77245630174793,543,263,280,21,1.1,66.46,8.7,0,0,0,0,0,0,0.558259360682203,138.289217994824,76.2744602908497
8.7,"random_instances_SVM","SVM",54,26,1212,1085,127,2700,2421,279,0.918861047835999,0.57,1.76508287292818,563,272,291,20,1.1,69.02,8.7,0,0,0,0,0,0,0.520578584024702,125.735836983513,73.3892057117128
8.7,"random_instances_SVM","SVM",54,27,1112,999,113,2800,2507,293,0.92140375854215,0.565,1.76920110192837,583,283,300,20,1.1,71.57,8.6,0,0,0,0,0,0,0.511003110429145,118.735501831314,72.2714498539348
8.7,"random_instances_SVM","SVM",54,28,1012,909,103,2900,2597,303,0.920373006833724,0.57,1.77245630174793,597,292,305,14,1,74.13,8.6,0,0,0,0,0,0,0.479327723016524,110.578602608152,69.8845930731055
8.7,"random_instances_SVM","SVM",54,29,912,818,94,3000,2688,312,0.919339407744885,0.575,1.77408839779006,612,299,313,15,1,76.69,8.6,0,0,0,0,0,0,0.417534594474124,97.4703429504564,67.3667057775718
8.7,"random_instances_SVM","SVM",54,30,812,736,76,3100,2770,330,0.921279897494313,0.575,1.77408839779006,640,313,327,28,1,79.24,8.4,0,0,0,0,0,0,0.320762594662123,86.7227116564677,64.0136019750834
8.7,"random_instances_SVM","SVM",54,31,712,647,65,3200,2859,341,0.921493451025065,0.585,1.77408839779006,658,322,336,18,1,81.8,8.4,0,0,0,0,0,0,0.251841541867285,76.487596350373,60.0028886286188
8.7,"random_instances_SVM","SVM",54,32,612,557,55,3300,2949,351,0.920862756264245,0.585,1.77082720588235,675,332,343,17,1,84.36,8.4,0,0,0,0,0,0,0.1479039116528,62.5708904562638,52.6160312238627
8.7,"random_instances_SVM","SVM",54,33,512,465,47,3400,3041,359,0.920872722095679,0.585,1.77082720588235,697,339,358,22,1.1,86.91,8.5,0,0,0,0,0,0,0.0955462386055518,56.0683547719352,48.9916780247287
8.7,"random_instances_SVM","SVM",54,34,412,374,38,3500,3132,368,0.920919703872446,0.585,1.77245630174793,713,349,364,16,1,89.47,8.5,0,0,0,0,0,0,0.0614315569193001,46.1260316085182,41.7559009611071
8.7,"random_instances_SVM","SVM",54,35,312,282,30,3600,3224,376,0.919550113895225,0.575,1.77572350230415,733,358,375,20,1,92.02,8.6,0,0,0,0,0,0,0.0444491386035253,34.6695353854251,32.8342471655077
8.7,"random_instances_SVM","SVM",54,36,212,186,26,3700,3320,380,0.91936645785878,0.575,1.77082720588235,745,365,380,12,1,94.58,8.7,0,0,0,0,0,0,0.0178037767740554,26.1925270649414,25.7470052604165
8.7,"random_instances_SVM","SVM",54,37,112,99,13,3800,3407,393,0.9188041002278,0.585,1.77082720588235,778,378,400,33,1.1,97.14,8.7,0,0,0,0,0,0,0.000871911437582387,14.4441059991514,14.4391508572847
8.7,"random_instances_SVM","SVM",54,38,12,12,0,3900,3494,406,0.921359624145794,0.59,1.77408839779006,796,391,405,18,1,99.69,8.6,0,0,0,0,0,0,0.000939186086659362,1.45879828224717,1.45879828224717
8.7,"random_instances_SVM","SVM",54,39,0,0,0,3912,3506,406,0.921210136674269,0.585,1.77245630174793,804,391,413,8,1.1,100,8.6,0,0,0,0,0,0,0,0,0
8.7,"random_instances_SVM","SVM",55,0,3812,3396,416,100,91,9,0.876347365963746,0.513812154696133,1.7183336041599,25,9,16,0,1.8,2.56,10.1,0,0,0,0,0,0,0.422029551268737,372.041256197126,50.5409237027617
8.7,"random_instances_SVM","SVM",55,1,3712,3312,400,200,175,25,0.911751614660345,0.574585635359116,1.77125240377278,56,25,31,31,1.2,5.11,7,0,0,0,0,0,0,0.894519692717833,521.407318492067,93.4543077832028
8.7,"random_instances_SVM","SVM",55,2,3612,3220,392,300,267,33,0.918250719788345,0.546961325966851,1.78950632029967,73,33,40,17,1.2,7.67,8.1,0,0,0,0,0,0,0.874339687573267,500.70518570958,92.5164727051358
8.7,"random_instances_SVM","SVM",55,3,3512,3130,382,400,357,43,0.91457785386352,0.569060773480663,1.77956461852023,96,43,53,23,1.2,10.22,8.3,0,0,0,0,0,0,0.888405547919002,495.227306321423,92.9530088643412
8.7,"random_instances_SVM","SVM",55,4,3412,3041,371,500,446,54,0.914341296397176,0.569060773480663,1.77956461852023,115,54,61,19,1.1,12.78,8.3,0,0,0,0,0,0,0.84003025163366,483.108261433411,87.9978488677269
8.7,"random_instances_SVM","SVM",55,5,3312,2953,359,600,534,66,0.91581978056183,0.558011049723757,1.77956461852023,140,66,74,25,1.1,15.34,8.1,0,0,0,0,0,0,0.863776863804758,477.905834999823,89.9262783889286
8.7,"random_instances_SVM","SVM",55,6,3212,2869,343,700,618,82,0.924759162711077,0.591160220994475,1.78786155346116,178,82,96,38,1.2,17.89,7.5,0,0,0,0,0,0,0.757586025826805,424.703801800939,81.2084988037717
8.7,"random_instances_SVM","SVM",55,7,3112,2778,334,800,709,91,0.928341763286908,0.591160220994475,1.78120325997375,191,91,100,13,1.1,20.45,7.8,0,0,0,0,0,0,0.703674953820563,351.977381234156,77.4551898966326
8.7,"random_instances_SVM","SVM",55,8,3012,2689,323,900,798,102,0.927127849972766,0.607734806629834,1.78458107354656,214,102,112,23,1.1,23.01,7.8,0,0,0,0,0,0,0.759719629911224,355.374132482298,82.0668037611689
8.7,"random_instances_SVM","SVM",55,9,2912,2598,314,1000,889,111,0.929060773480664,0.613259668508287,1.79944802207912,237,111,126,23,1.1,25.56,8,0,0,0,0,0,0,0.767822384053703,337.359927203032,83.8714134317594
8.7,"random_instances_SVM","SVM",55,10,2812,2502,310,1100,985,115,0.929786008870906,0.613259668508287,1.80276497695853,244,115,129,7,1.1,28.12,8.6,0,0,0,0,0,0,0.654058719116511,302.223142259473,73.0353575042485
8.7,"random_instances_SVM","SVM",55,11,2712,2410,302,1200,1077,123,0.929096568360441,0.635359116022099,1.79779411764706,260,123,137,16,1.1,30.67,8.8,0,0,0,0,0,0,0.645310437709763,281.686525471885,73.0400106572938
8.7,"random_instances_SVM","SVM",55,12,2612,2324,288,1300,1163,137,0.93161932923508,0.607734806629834,1.79449541284404,287,137,150,27,1.1,33.23,8.5,0,0,0,0,0,0,0.768039130982977,297.786822948522,84.6930377494825
8.7,"random_instances_SVM","SVM",55,13,2512,2241,271,1400,1246,154,0.930175083651078,0.602209944751381,1.79614325068871,324,154,170,37,1.1,35.79,8.1,0,0,0,0,0,0,0.685825105963164,274.924098440341,79.5821288351152
8.7,"random_instances_SVM","SVM",55,14,2412,2147,265,1500,1340,160,0.928005602676838,0.602209944751381,1.78786155346116,335,160,175,11,1.1,38.34,8.4,0,0,0,0,0,0,0.629096081621419,259.183424975587,73.0505320327608
8.7,"random_instances_SVM","SVM",55,15,2312,2055,257,1600,1432,168,0.927126293673646,0.613259668508287,1.78786155346116,361,168,193,26,1.1,40.9,8.5,0,0,0,0,0,0,0.735809693834103,266.284300815486,84.0069166958026
8.7,"random_instances_SVM","SVM",55,16,2212,1962,250,1700,1525,175,0.929155707727028,0.607734806629834,1.79449541284404,376,175,201,15,1.1,43.46,8.7,0,0,0,0,0,0,0.747290605445226,249.515786576064,85.0405570808037
8.7,"random_instances_SVM","SVM",55,17,2112,1873,239,1800,1614,186,0.931516613493116,0.61878453038674,1.79779411764706,389,186,203,13,1.1,46.01,8.7,0,0,0,0,0,0,0.796073477734377,247.716953796761,88.2675442889003
8.7,"random_instances_SVM","SVM",55,18,2012,1782,230,1900,1705,195,0.933037117734031,0.607734806629834,1.79779411764706,409,195,214,20,1.1,48.57,8.7,0,0,0,0,0,0,0.764302668364136,235.947197697884,85.5666649981651
8.7,"random_instances_SVM","SVM",55,19,1912,1693,219,2000,1794,206,0.93492646486655,0.602209944751381,1.78786155346116,429,206,223,20,1.1,51.12,8.7,0,0,0,0,0,0,0.751479712036823,230.755305763448,84.9612207571695
8.7,"random_instances_SVM","SVM",55,20,1812,1605,207,2100,1882,218,0.93513189635048,0.602209944751381,1.78786155346116,452,218,234,23,1.1,53.68,8.6,0,0,0,0,0,0,0.669747661016869,203.53861039999,77.8803818228351
8.7,"random_instances_SVM","SVM",55,21,1712,1517,195,2200,1970,230,0.935945840790602,0.607734806629834,1.78950632029967,474,230,244,22,1.1,56.24,8.6,0,0,0,0,0,0,0.760564419405896,205.859926794615,86.6181478563275
8.7,"random_instances_SVM","SVM",55,22,1612,1429,183,2300,2058,242,0.935323321142326,0.61878453038674,1.79614325068871,500,242,258,26,1.1,58.79,8.5,0,0,0,0,0,0,0.734833087506508,198.319156652612,84.7199558370982
8.7,"random_instances_SVM","SVM",55,23,1512,1340,172,2400,2147,253,0.937243794257258,0.613259668508287,1.80276497695853,523,253,270,23,1.1,61.35,8.5,0,0,0,0,0,0,0.745540477174656,191.35039800647,86.9861291920433
8.7,"random_instances_SVM","SVM",55,24,1412,1249,163,2500,2238,262,0.936227530931448,0.607734806629834,1.79779411764706,542,262,280,19,1.1,63.91,8.5,0,0,0,0,0,0,0.719352381594474,179.106844543326,86.3026306644984
8.7,"random_instances_SVM","SVM",55,25,1312,1159,153,2600,2328,272,0.936040775036965,0.602209944751381,1.79779411764706,559,272,287,17,1.1,66.46,8.6,0,0,0,0,0,0,0.69488329797469,167.349992201351,85.2990056533608
8.7,"random_instances_SVM","SVM",55,26,1212,1071,141,2700,2416,284,0.936267994708585,0.613259668508287,1.79779411764706,583,284,299,24,1.1,69.02,8.5,0,0,0,0,0,0,0.652358593580549,152.009821635039,83.8028326778084
8.7,"random_instances_SVM","SVM",55,27,1112,988,124,2800,2499,301,0.936378491946153,0.61878453038674,1.79944802207912,619,300,319,36,1.1,71.57,8.3,0,0,0,0,0,0,0.580793843200766,137.892291402728,80.0335575586882
8.7,"random_instances_SVM","SVM",55,28,1012,905,107,2900,2582,318,0.937551941483154,0.613259668508287,1.79944802207912,641,313,328,22,1,74.13,8.1,0,0,0,0,0,0,0.481830380528183,117.797820175809,72.6031802681396
8.7,"random_instances_SVM","SVM",55,29,912,818,94,3000,2669,331,0.937128628122325,0.602209944751381,1.79614325068871,668,325,343,27,1.1,76.69,8.1,0,0,0,0,0,0,0.413637657026858,102.773185544294,69.2858882594369
8.7,"random_instances_SVM","SVM",55,30,812,729,83,3100,2758,342,0.937130184421446,0.613259668508287,1.79449541284404,681,334,347,13,1,79.24,8.1,0,0,0,0,0,0,0.34349324889195,90.0625886233807,64.4556905030266
8.7,"random_instances_SVM","SVM",55,31,712,639,73,3200,2848,352,0.936920084040153,0.613259668508287,1.79614325068871,699,341,358,18,1,81.8,8.1,0,0,0,0,0,0,0.265895308183708,77.6640362269527,59.2273613869455
8.7,"random_instances_SVM","SVM",55,32,612,550,62,3300,2937,363,0.93675200373512,0.61878453038674,1.79779411764706,720,351,369,21,1.1,84.36,8.1,0,0,0,0,0,0,0.191300693939671,67.4963575299267,54.2578265870249
8.7,"random_instances_SVM","SVM",55,33,512,458,54,3400,3029,371,0.937109952532878,0.61878453038674,1.79614325068871,737,361,376,17,1,86.91,8.2,0,0,0,0,0,0,0.144766022670736,58.5905720762124,49.291921710308
8.7,"random_instances_SVM","SVM",55,34,412,368,44,3500,3119,381,0.936806474204343,0.61878453038674,1.80110497237569,760,370,390,23,1.1,89.47,8.2,0,0,0,0,0,0,0.0992499756137057,47.8427674010127,42.278211638113
8.7,"random_instances_SVM","SVM",55,35,312,278,34,3600,3209,391,0.937222006069568,0.613259668508287,1.79779411764706,781,380,401,21,1.1,92.02,8.2,0,0,0,0,0,0,0.0619684341573695,36.4421786467292,33.7500442395259
8.7,"random_instances_SVM","SVM",55,36,212,186,26,3700,3301,399,0.937695121002256,0.613259668508287,1.79779411764706,792,386,406,11,1.1,94.58,8.3,0,0,0,0,0,0,0.021241760605905,28.4937058739088,27.9857480763593
8.7,"random_instances_SVM","SVM",55,37,112,99,13,3800,3388,412,0.93668819547117,0.61878453038674,1.80110497237569,818,399,419,26,1.1,97.14,8.2,0,0,0,0,0,0,0.00137149961483608,13.3428482254266,13.3329084681564
8.7,"random_instances_SVM","SVM",55,38,12,11,1,3900,3476,424,0.936627499805464,0.613259668508287,1.80110497237569,840,408,432,22,1.1,99.69,8.2,0,0,0,0,0,0,0.00114209959315811,0.61670679125754,0.61670679125754
8.7,"random_instances_SVM","SVM",55,39,0,0,0,3912,3487,425,0.936688195471171,0.61878453038674,1.79779411764706,843,409,434,3,1.1,100,8.2,0,0,0,0,0,0,0,0,0
8.7,"random_instances_SVM","SVM",56,0,3812,3412,400,100,87,13,0.877078931049587,0.393782383419689,1.72803896755092,38,13,25,0,1.9,2.56,6.7,0,0,0,0,0,0,0.18493387509154,508.241866409453,21.3736075438508
8.7,"random_instances_SVM","SVM",56,1,3712,3328,384,200,171,29,0.904800460825443,0.528497409326425,1.76336616751125,65,29,36,27,1.2,5.11,5.9,0,0,0,0,0,0,0.621312259853461,519.692732134377,73.9818193469146
8.7,"random_instances_SVM","SVM",56,2,3612,3238,374,300,261,39,0.915129357342499,0.564766839378238,1.74450012741018,92,39,53,27,1.4,7.67,6.7,0,0,0,0,0,0,0.602127574312368,481.665616627326,69.9138474219695
8.7,"random_instances_SVM","SVM",56,3,3512,3148,364,400,351,49,0.916278481979915,0.533678756476684,1.76336616751125,116,49,67,24,1.4,10.22,7.2,0,0,0,0,0,0,0.6477158862324,434.109293509567,75.5371673007436
8.7,"random_instances_SVM","SVM",56,4,3412,3058,354,500,441,59,0.926153312623622,0.55440414507772,1.79449541284404,135,59,76,19,1.3,12.78,7.5,0,0,0,0,0,0,0.530171070909212,408.279556602407,62.5554071913265
8.7,"random_instances_SVM","SVM",56,5,3312,2969,343,600,530,70,0.931607980979197,0.549222797927461,1.79012445719788,159,70,89,24,1.3,15.34,7.6,0,0,0,0,0,0,0.566070937354383,379.181260705344,64.8463693994379
8.7,"random_instances_SVM","SVM",56,6,3212,2879,333,700,620,80,0.93160210310382,0.559585492227979,1.79012445719788,178,80,98,19,1.2,17.89,7.8,0,0,0,0,0,0,0.620340769552523,369.558783960591,69.6250898139974
8.7,"random_instances_SVM","SVM",56,7,3112,2793,319,800,706,94,0.93330374802725,0.575129533678757,1.78356121445838,206,94,112,28,1.2,20.45,7.5,0,0,0,0,0,0,0.76215479659509,418.871356798406,82.7241216414458
8.7,"random_instances_SVM","SVM",56,8,3012,2701,311,900,798,102,0.932009145974109,0.569948186528497,1.78192791664294,221,102,119,15,1.2,23.01,7.8,0,0,0,0,0,0,0.774731000885434,403.087165622243,83.8468751190655
8.7,"random_instances_SVM","SVM",56,9,2912,2607,305,1000,892,108,0.934446994789268,0.590673575129534,1.78683680897529,238,108,130,17,1.2,25.56,8.3,0,0,0,0,0,0,0.689186434811557,345.263200803289,77.7232896447048
8.7,"random_instances_SVM","SVM",56,10,2812,2514,298,1100,985,115,0.93270714367585,0.569948186528497,1.78029760747859,255,115,140,17,1.2,28.12,8.6,0,0,0,0,0,0,0.700966223022646,332.170434662613,79.4534681755558
8.7,"random_instances_SVM","SVM",56,11,2712,2427,285,1200,1072,128,0.933247908211109,0.585492227979275,1.79012445719788,275,128,147,20,1.1,30.67,8.4,0,0,0,0,0,0,0.701367392884166,334.585084927083,79.0981720845914
8.7,"random_instances_SVM","SVM",56,12,2612,2339,273,1300,1160,140,0.936107494585019,0.575129533678757,1.78683680897529,297,140,157,22,1.1,33.23,8.3,0,0,0,0,0,0,0.733373611966273,321.734508560192,82.2530579899908
8.7,"random_instances_SVM","SVM",56,13,2512,2251,261,1400,1248,152,0.93491722481993,0.601036269430052,1.78356121445838,313,152,161,16,1.1,35.79,8.2,0,0,0,0,0,0,0.788034843073465,315.138632919817,87.1290434491392
8.7,"random_instances_SVM","SVM",56,14,2412,2163,249,1500,1336,164,0.932848212685058,0.585492227979275,1.78683680897529,341,164,177,28,1.1,38.34,8.1,0,0,0,0,0,0,0.709863867724869,296.657641675428,81.5461171962973
8.7,"random_instances_SVM","SVM",56,15,2312,2074,238,1600,1425,175,0.932830579058909,0.590673575129534,1.78683680897529,365,175,190,24,1.1,40.9,8.1,0,0,0,0,0,0,0.717271371337675,265.787405511119,83.3981800772201
8.7,"random_instances_SVM","SVM",56,16,2212,1979,233,1700,1520,180,0.931440461530796,0.601036269430052,1.77753036726188,375,180,195,10,1.1,43.46,8.4,0,0,0,0,0,0,0.669969780313971,246.507698470498,80.9870472723929
8.7,"random_instances_SVM","SVM",56,17,2112,1884,228,1800,1615,185,0.931621206198828,0.595854922279793,1.78244067214382,387,185,202,12,1.1,46.01,8.7,0,0,0,0,0,0,0.630149363115659,229.377108855499,78.6336306777323
8.7,"random_instances_SVM","SVM",56,18,2012,1795,217,1900,1704,196,0.930907044339773,0.601036269430052,1.77916412679061,406,196,210,19,1.1,48.57,8.7,0,0,0,0,0,0,0.689593131489129,228.736541280213,83.6759205833954
8.7,"random_instances_SVM","SVM",56,19,1912,1703,209,2000,1796,204,0.932354471152877,0.595854922279793,1.79342422578257,421,204,217,15,1.1,51.12,8.8,0,0,0,0,0,0,0.655899568313352,216.332105576603,80.6550523046935
8.7,"random_instances_SVM","SVM",56,20,1812,1612,200,2100,1887,213,0.933941497506331,0.606217616580311,1.78080089231664,436,213,223,15,1,53.68,8.9,0,0,0,0,0,0,0.710967092853962,212.470974493146,85.2796764077493
8.7,"random_instances_SVM","SVM",56,21,1712,1526,186,2200,1973,227,0.935002454012991,0.601036269430052,1.78408347460662,466,227,239,30,1.1,56.24,8.7,0,0,0,0,0,0,0.65154484655536,194.160966435489,81.1782884509067
8.7,"random_instances_SVM","SVM",56,22,1612,1431,181,2300,2068,232,0.935014209763761,0.621761658031088,1.7714773274354,480,232,248,14,1.1,58.79,8.9,0,0,0,0,0,0,0.600297409924948,178.018609980644,78.5304865091148
8.7,"random_instances_SVM","SVM",56,23,1512,1346,166,2400,2153,247,0.934723254932291,0.621761658031088,1.77264704207709,511,247,264,31,1.1,61.35,8.7,0,0,0,0,0,0,0.573033934035604,166.003597215903,76.1285249201844
8.7,"random_instances_SVM","SVM",56,24,1412,1257,155,2500,2242,258,0.93590617735315,0.626943005181347,1.78847912221884,532,258,274,21,1.1,63.91,8.7,0,0,0,0,0,0,0.601270272553402,163.640790844873,77.1258526067472
8.7,"random_instances_SVM","SVM",56,25,1312,1176,136,2600,2323,277,0.935848868068164,0.621761658031088,1.77589960545705,563,275,288,31,1,66.46,8.4,0,0,0,0,0,0,0.5,139.926775940763,69.8274552766037
8.7,"random_instances_SVM","SVM",56,26,1212,1090,122,2700,2409,291,0.936308811816897,0.621761658031088,1.78519750915054,586,286,300,23,1,69.02,8.3,0,0,0,0,0,0,0.491302358457921,126.585861400918,69.9422387694578
8.7,"random_instances_SVM","SVM",56,27,1112,1000,112,2800,2499,301,0.937233107720898,0.616580310880829,1.78683680897529,603,295,308,17,1,71.57,8.3,0,0,0,0,0,0,0.478806866865709,119.284069641298,69.8877631608241
8.7,"random_instances_SVM","SVM",56,28,1012,910,102,2900,2589,311,0.936689404247954,0.616580310880829,1.79342422578257,624,304,320,21,1.1,74.13,8.3,0,0,0,0,0,0,0.407037042559934,104.351027846499,65.8861843731524
8.7,"random_instances_SVM","SVM",56,29,912,820,92,3000,2679,321,0.937347726290867,0.621761658031088,1.78519750915054,642,314,328,18,1,76.69,8.3,0,0,0,0,0,0,0.358049105606139,94.7239802460417,61.7649454541604
8.7,"random_instances_SVM","SVM",56,30,812,730,82,3100,2769,331,0.937763585974227,0.626943005181347,1.78519750915054,658,322,336,16,1,79.24,8.4,0,0,0,0,0,0,0.32966972819394,85.1529310224154,60.3968291518618
8.7,"random_instances_SVM","SVM",56,31,712,638,74,3200,2861,339,0.938802500448202,0.621761658031088,1.78683680897529,672,329,343,14,1,81.8,8.4,0,0,0,0,0,0,0.263481597355045,75.8710735025663,57.7581930846227
8.7,"random_instances_SVM","SVM",56,32,612,546,66,3300,2953,347,0.93893916105086,0.626943005181347,1.79177282225975,688,336,352,16,1,84.36,8.5,0,0,0,0,0,0,0.197370381271985,66.425544337922,53.4057214890689
8.7,"random_instances_SVM","SVM",56,33,512,457,55,3400,3042,358,0.939169867659649,0.632124352331606,1.78519750915054,709,348,361,21,1,86.91,8.5,0,0,0,0,0,0,0.160893664917781,57.8626201332002,48.4364993198889
8.7,"random_instances_SVM","SVM",56,34,412,369,43,3500,3130,370,0.939084638466594,0.621761658031088,1.79012445719788,726,358,368,17,1,89.47,8.5,0,0,0,0,0,0,0.0889857528559782,47.4535634190048,42.0935009687174
8.7,"random_instances_SVM","SVM",56,35,312,281,31,3600,3218,382,0.939795861387957,0.626943005181347,1.79012445719788,748,369,379,22,1,92.02,8.4,0,0,0,0,0,0,0.0507427580388609,36.2375392220426,33.5715418739
8.7,"random_instances_SVM","SVM",56,36,212,189,23,3700,3310,390,0.940139717097875,0.621761658031088,1.78356121445838,773,380,393,25,1,94.58,8.5,0,0,0,0,0,0,0.0220780975374566,25.6048193891948,25.0712079021822
8.7,"random_instances_SVM","SVM",56,37,112,96,16,3800,3403,397,0.940593782971225,0.632124352331606,1.78847912221884,795,390,405,22,1,97.14,8.6,0,0,0,0,0,0,0.00136600989433885,17.267317506893,17.2583712565377
8.7,"random_instances_SVM","SVM",56,38,12,9,3,3900,3490,410,0.939620994595312,0.632124352331606,1.78519750915054,821,402,419,26,1,99.69,8.5,0,0,0,0,0,0,0.00225576444888494,1.94369048168383,1.94369048168383
8.7,"random_instances_SVM","SVM",56,39,0,0,0,3912,3499,413,0.939454944615737,0.642487046632124,1.78683680897529,828,405,423,7,1,100,8.5,0,0,0,0,0,0,0,0,0
8.7,"random_instances_SVM","SVM",57,0,3812,3402,410,100,82,18,0.924305810088348,0.601123595505618,1.77270620706701,39,18,21,0,1.2,2.56,4.6,0,0,0,0,0,0,0.755876255800252,607.331870956833,79.9353635333235
8.7,"random_instances_SVM","SVM",57,1,3712,3318,394,200,166,34,0.926446518623375,0.601123595505618,1.77759418374091,66,32,34,27,1.1,5.11,4.9,0,0,0,0,0,0,0.810880067110747,496.941955444088,84.962629178949
8.7,"random_instances_SVM","SVM",57,2,3612,3225,387,300,259,41,0.933345761555086,0.617977528089888,1.79098640511515,86,41,45,20,1.1,7.67,6.3,0,0,0,0,0,0,0.77361940640614,448.637102168884,82.2709977089436
8.7,"random_instances_SVM","SVM",57,3,3512,3131,381,400,353,47,0.932410485206203,0.617977528089888,1.77238129757158,102,47,55,16,1.2,10.22,7.5,0,0,0,0,0,0,0.736412651539139,379.367838908216,79.3672511042981
8.7,"random_instances_SVM","SVM",57,4,3412,3043,369,500,441,59,0.933849736479568,0.612359550561798,1.77074927059408,126,59,67,24,1.1,12.78,7.5,0,0,0,0,0,0,0.781440132930302,394.401648532062,83.7132515305936
8.7,"random_instances_SVM","SVM",57,5,3312,2954,358,600,530,70,0.932048697564491,0.595505617977528,1.76425110813318,147,70,77,21,1.1,15.34,7.6,0,0,0,0,0,0,0.727449202539845,370.722044796096,78.6212362340035
8.7,"random_instances_SVM","SVM",57,6,3212,2868,344,700,616,84,0.936505478949968,0.629213483146067,1.78250919070056,175,84,91,28,1.1,17.89,7.3,0,0,0,0,0,0,0.774834289113367,394.122737557326,83.4189514538723
8.7,"random_instances_SVM","SVM",57,7,3112,2779,333,800,705,95,0.935955688123254,0.623595505617977,1.78250919070056,197,95,102,22,1.1,20.45,7.4,0,0,0,0,0,0,0.767667278476706,356.366023589537,82.765495868499
8.7,"random_instances_SVM","SVM",57,8,3012,2686,326,900,798,102,0.936224264101817,0.634831460674157,1.7792295049771,213,102,111,16,1.1,23.01,7.8,0,0,0,0,0,0,0.68099486150525,328.08234787143,75.2967496307725
8.7,"random_instances_SVM","SVM",57,9,2912,2589,323,1000,895,105,0.935906712503634,0.646067415730337,1.76749421678784,221,105,116,8,1.1,25.56,8.5,0,0,0,0,0,0,0.792311734015809,329.001246317019,85.3859757947368
8.7,"random_instances_SVM","SVM",57,10,2812,2496,316,1100,988,112,0.93701735316793,0.634831460674157,1.77074927059408,231,112,119,10,1.1,28.12,8.8,0,0,0,0,0,0,0.693067648446672,292.593000974686,76.5177301769316
8.7,"random_instances_SVM","SVM",57,11,2712,2405,307,1200,1079,121,0.935279508600749,0.623595505617977,1.77238129757158,250,121,129,19,1.1,30.67,8.9,0,0,0,0,0,0,0.754002398171164,298.199911944186,82.6751179758482
8.7,"random_instances_SVM","SVM",57,12,2612,2317,295,1300,1167,133,0.936015722753755,0.623595505617977,1.76587117342991,275,133,142,25,1.1,33.23,8.8,0,0,0,0,0,0,0.754988292441792,290.656404628859,83.3934687698102
8.7,"random_instances_SVM","SVM",57,13,2512,2231,281,1400,1253,147,0.937195877200743,0.634831460674157,1.750512136073,301,147,154,26,1,35.79,8.5,0,0,0,0,0,0,0.727661174912762,276.731814003326,79.2834019639949
8.7,"random_instances_SVM","SVM",57,14,2412,2144,268,1500,1340,160,0.936707700863232,0.629213483146067,1.7622534044426,326,159,167,25,1.1,38.34,8.4,0,0,0,0,0,0,0.764705165133756,278.942062391899,83.4015349299566
8.7,"random_instances_SVM","SVM",57,15,2312,2059,253,1600,1425,175,0.937279609711702,0.629213483146067,1.75256181835034,354,172,182,28,1.1,40.9,8.1,0,0,0,0,0,0,0.743608858779864,265.090990521641,82.6170034962668
8.7,"random_instances_SVM","SVM",57,16,2212,1967,245,1700,1517,183,0.936941519950453,0.623595505617977,1.75578048101031,368,180,188,14,1,43.46,8.3,0,0,0,0,0,0,0.707855613476197,239.861617282346,80.5067084597977
8.7,"random_instances_SVM","SVM",57,17,2112,1877,235,1800,1607,193,0.93816749029967,0.629213483146067,1.7743325430368,387,189,198,19,1,46.01,8.3,0,0,0,0,0,0,0.718836886727621,236.69037923975,80.935055407108
8.7,"random_instances_SVM","SVM",57,18,2012,1787,225,1900,1697,203,0.939445595985894,0.640449438202247,1.7743325430368,407,200,207,20,1,48.57,8.4,0,0,0,0,0,0,0.719902843457359,226.274646753837,81.5091979242985
8.7,"random_instances_SVM","SVM",57,19,1912,1699,213,2000,1785,215,0.939377662061904,0.640449438202247,1.77596186584951,433,209,224,26,1.1,51.12,8.3,0,0,0,0,0,0,0.719700964900459,222.012341482317,81.7928515823287
8.7,"random_instances_SVM","SVM",57,20,1812,1617,195,2100,1867,233,0.941276652216218,0.640449438202247,1.76101987899741,465,227,238,32,1,53.68,8,0,0,0,0,0,0,0.680656438765645,204.889099164196,79.3917960835283
8.7,"random_instances_SVM","SVM",57,21,1712,1526,186,2200,1958,242,0.941074430302946,0.634831460674157,1.77238129757158,480,236,244,15,1,56.24,8.1,0,0,0,0,0,0,0.652187586941033,188.989369957107,78.6068467538137
8.7,"random_instances_SVM","SVM",57,22,1612,1432,180,2300,2052,248,0.941854880499482,0.640449438202247,1.75578048101031,499,244,255,19,1,58.79,8.3,0,0,0,0,0,0,0.659550047923616,183.88697388193,78.7978552421586
8.7,"random_instances_SVM","SVM",57,23,1512,1341,171,2400,2143,257,0.941717432792804,0.640449438202247,1.75416967322956,522,254,268,23,1.1,61.35,8.3,0,0,0,0,0,0,0.604005462048817,168.598718168661,74.7710856203087
8.7,"random_instances_SVM","SVM",57,24,1412,1257,155,2500,2227,273,0.942191390402037,0.640449438202247,1.74775589014646,548,268,280,26,1,63.91,8.2,0,0,0,0,0,0,0.590698290081764,156.72407566874,75.73127490174
8.7,"random_instances_SVM","SVM",57,25,1312,1167,145,2600,2317,283,0.941257693911857,0.640449438202247,1.75416967322956,579,282,297,31,1.1,66.46,8.2,0,0,0,0,0,0,0.611939216342499,156.112173338273,78.3168900923341
8.7,"random_instances_SVM","SVM",57,26,1212,1075,137,2700,2409,291,0.940523059617548,0.640449438202247,1.75739424983477,590,288,302,11,1,69.02,8.3,0,0,0,0,0,0,0.577719778481665,141.477962416963,75.7821115188854
8.7,"random_instances_SVM","SVM",57,27,1112,982,130,2800,2502,298,0.940191289291084,0.651685393258427,1.75739424983477,609,297,312,19,1.1,71.57,8.4,0,0,0,0,0,0,0.563698262778297,133.498250861241,75.5585564942356
8.7,"random_instances_SVM","SVM",57,28,1012,896,116,2900,2588,312,0.940458285410953,0.651685393258427,1.75901098787509,635,309,326,26,1.1,74.13,8.3,0,0,0,0,0,0,0.500530479639804,120.1070924891,73.3407904835182
8.7,"random_instances_SVM","SVM",57,29,912,807,105,3000,2677,323,0.940644708737257,0.646067415730337,1.75739424983477,652,319,333,17,1,76.69,8.3,0,0,0,0,0,0,0.472721908301385,109.405810014326,70.8213878433458
8.7,"random_instances_SVM","SVM",57,30,812,718,94,3100,2766,334,0.940587833824146,0.646067415730337,1.75095690826028,678,330,348,26,1.1,79.24,8.3,0,0,0,0,0,0,0.448660194809321,104.116715363998,70.6623906203528
8.7,"random_instances_SVM","SVM",57,31,712,630,82,3200,2854,346,0.94280595543535,0.662921348314607,1.75739424983477,704,343,361,26,1.1,81.8,8.2,0,0,0,0,0,0,0.32157472209602,91.0263128749474,67.8539263492958
8.7,"random_instances_SVM","SVM",57,32,612,544,68,3300,2940,360,0.943057152968243,0.657303370786517,1.75739424983477,721,354,367,17,1,84.36,8.2,0,0,0,0,0,0,0.258903337196838,78.5202854785295,61.8466966655213
8.7,"random_instances_SVM","SVM",57,33,512,458,54,3400,3026,374,0.943156684066181,0.662921348314607,1.75095690826028,756,370,386,35,1,86.91,8.1,0,0,0,0,0,0,0.149893540672071,64.9622267914918,53.8699607703714
8.7,"random_instances_SVM","SVM",57,34,412,373,39,3500,3111,389,0.944139356175989,0.651685393258427,1.76263401270868,783,382,401,27,1,89.47,8,0,0,0,0,0,0,0.0995708083519191,51.7908121409551,45.1694209900279
8.7,"random_instances_SVM","SVM",57,35,312,283,29,3600,3201,399,0.943820224719107,0.662921348314607,1.7691202464261,807,394,413,24,1,92.02,8,0,0,0,0,0,0,0.064062919383266,37.1924957219855,34.3278890806336
8.7,"random_instances_SVM","SVM",57,36,212,193,19,3700,3291,409,0.942224567434694,0.646067415730337,1.76587117342991,822,403,419,15,1,94.58,8,0,0,0,0,0,0,0.0258305677162287,26.5662025732208,25.9279154145089
8.7,"random_instances_SVM","SVM",57,37,112,103,9,3800,3381,419,0.942840712326695,0.651685393258427,1.76587117342991,847,412,435,25,1.1,97.14,8.1,0,0,0,0,0,0,0.00118526460057268,13.0972912258047,13.0902595291666
8.7,"random_instances_SVM","SVM",57,38,12,11,1,3900,3473,427,0.942407831043595,0.662921348314607,1.75901098787509,852,418,434,5,1,99.69,8.1,0,0,0,0,0,0,0.000583441901471252,0.309124885248715,0.309124885248715
8.7,"random_instances_SVM","SVM",57,39,0,0,0,3912,3484,428,0.942290921499986,0.662921348314607,1.75416967322956,855,419,436,3,1,100,8.1,0,0,0,0,0,0,0,0,0
8.7,"random_instances_SVM","SVM",58,0,3812,3412,400,100,90,10,0.874426020408169,0.51530612244898,1.73838051349572,29,10,19,0,1.9,2.56,9,0,0,0,0,0,0,0.255380503038351,376.151040832649,28.927346195351
8.7,"random_instances_SVM","SVM",58,1,3712,3328,384,200,174,26,0.899924628942488,0.551020408163265,1.72565677689191,59,26,33,30,1.3,5.11,6.7,0,0,0,0,0,0,0.749430838509997,523.933445445457,81.1248645922352
8.7,"random_instances_SVM","SVM",58,2,3612,3236,376,300,266,34,0.910001159554726,0.540816326530612,1.76272459305709,73,34,39,14,1.1,7.67,7.8,0,0,0,0,0,0,0.854971381917955,512.012627988196,90.2957457050145
8.7,"random_instances_SVM","SVM",58,3,3512,3147,365,400,355,45,0.907847286641927,0.556122448979592,1.73755883392555,98,45,53,25,1.2,10.22,7.9,0,0,0,0,0,0,0.795869156611889,451.626213319664,85.8337565648718
8.7,"random_instances_SVM","SVM",58,4,3412,3060,352,500,442,58,0.907651611781079,0.556122448979592,1.74871746863883,124,58,66,26,1.1,12.78,7.6,0,0,0,0,0,0,0.782411854358782,441.04646004323,85.0328965864083
8.7,"random_instances_SVM","SVM",58,5,3312,2965,347,600,537,63,0.908493738404462,0.556122448979592,1.74275960384154,141,63,78,17,1.2,15.34,8.5,0,0,0,0,0,0,0.770384271221485,370.112501024569,85.0169336067923
8.7,"random_instances_SVM","SVM",58,6,3212,2872,340,700,630,70,0.90840677179963,0.551020408163265,1.74436287854608,154,70,84,13,1.2,17.89,9,0,0,0,0,0,0,0.726884270657936,340.368282219254,81.7615378509991
8.7,"random_instances_SVM","SVM",58,7,3112,2786,326,800,716,84,0.919210923005558,0.571428571428571,1.78108630756811,183,84,99,29,1.2,20.45,8.5,0,0,0,0,0,0,0.805358371026509,356.955016834626,86.3176175390608
8.7,"random_instances_SVM","SVM",58,8,3012,2692,320,900,810,90,0.91923121521335,0.556122448979592,1.78272635020859,194,90,104,11,1.2,23.01,9,0,0,0,0,0,0,0.786783541706239,326.603532710569,84.9412775535432
8.7,"random_instances_SVM","SVM",58,9,2912,2599,313,1000,903,97,0.920367578849714,0.545918367346939,1.78272635020859,208,97,111,14,1.1,25.56,9.3,0,0,0,0,0,0,0.76652391356596,316.470393551553,83.0245466976333
8.7,"random_instances_SVM","SVM",58,10,2812,2511,301,1100,991,109,0.924744897959176,0.561224489795918,1.78108630756811,231,109,122,23,1.1,28.12,9.1,0,0,0,0,0,0,0.724631188925319,297.578126686953,79.5329638911961
8.7,"random_instances_SVM","SVM",58,11,2712,2426,286,1200,1076,124,0.921951820500925,0.576530612244898,1.77944927971188,259,124,135,28,1.1,30.67,8.7,0,0,0,0,0,0,0.762050926279733,304.928756579824,82.6644634818907
8.7,"random_instances_SVM","SVM",58,12,2612,2334,278,1300,1168,132,0.922904104823744,0.586734693877551,1.77781525833474,273,132,141,14,1.1,33.23,8.8,0,0,0,0,0,0,0.755691534044351,288.358622657539,82.7037171518964
8.7,"random_instances_SVM","SVM",58,13,2512,2245,267,1400,1257,143,0.923557803803336,0.566326530612245,1.77944927971188,298,143,155,25,1.1,35.79,8.8,0,0,0,0,0,0,0.734711133219102,277.642618942122,81.0383540115449
8.7,"random_instances_SVM","SVM",58,14,2412,2160,252,1500,1342,158,0.926601634972165,0.581632653061224,1.77618423516195,331,158,173,33,1.1,38.34,8.5,0,0,0,0,0,0,0.70571567021644,272.177319396117,80.4440616458563
8.7,"random_instances_SVM","SVM",58,15,2312,2068,244,1600,1434,166,0.927588705936914,0.586734693877551,1.77455620194916,347,166,181,16,1.1,40.9,8.6,0,0,0,0,0,0,0.755995719939591,262.365123338664,84.9662604909693
8.7,"random_instances_SVM","SVM",58,16,2212,1975,237,1700,1527,173,0.929301948051942,0.591836734693878,1.77781525833474,360,173,187,13,1.1,43.46,8.8,0,0,0,0,0,0,0.776493825807134,246.347922617258,86.7875024574118
8.7,"random_instances_SVM","SVM",58,17,2112,1886,226,1800,1616,184,0.928287337662332,0.586734693877551,1.78272635020859,385,184,201,25,1.1,46.01,8.8,0,0,0,0,0,0,0.731999270166857,235.97207078331,84.6698911219232
8.7,"random_instances_SVM","SVM",58,18,2012,1798,214,1900,1704,196,0.929087430426711,0.586734693877551,1.78436941596915,409,196,213,24,1.1,48.57,8.7,0,0,0,0,0,0,0.71406783904514,221.831847751686,84.1658492867544
8.7,"random_instances_SVM","SVM",58,19,1912,1707,205,2000,1795,205,0.930510783858992,0.591836734693878,1.78108630756811,422,205,217,13,1.1,51.12,8.8,0,0,0,0,0,0,0.684593154949707,206.379024131007,82.1615920956677
8.7,"random_instances_SVM","SVM",58,20,1812,1621,191,2100,1881,219,0.928142393320959,0.591836734693878,1.77781525833474,452,218,234,30,1.1,53.68,8.6,0,0,0,0,0,0,0.655402850920354,203.865273185544,81.639303230102
8.7,"random_instances_SVM","SVM",58,21,1712,1528,184,2200,1974,226,0.928556934137286,0.602040816326531,1.78436941596915,465,225,240,13,1.1,56.24,8.7,0,0,0,0,0,0,0.648907411393903,188.923476735583,81.9526727268914
8.7,"random_instances_SVM","SVM",58,22,1612,1437,175,2300,2065,235,0.930867346938769,0.612244897959184,1.77781525833474,491,235,256,26,1.1,58.79,8.8,0,0,0,0,0,0,0.608770053151669,183.019826283953,77.8747332372612
8.7,"random_instances_SVM","SVM",58,23,1512,1347,165,2400,2155,245,0.929867230983297,0.61734693877551,1.77455620194916,504,244,260,13,1.1,61.35,8.8,0,0,0,0,0,0,0.62091732871525,171.608781275211,80.0917100912409
8.7,"random_instances_SVM","SVM",58,24,1412,1260,152,2500,2242,258,0.931174628942482,0.607142857142857,1.77618423516195,526,256,270,22,1.1,63.91,8.7,0,0,0,0,0,0,0.554246527847249,159.36706000886,76.4681211308427
8.7,"random_instances_SVM","SVM",58,25,1312,1171,141,2600,2331,269,0.931766001855282,0.602040816326531,1.77944927971188,545,266,279,19,1,66.46,8.7,0,0,0,0,0,0,0.534594979626675,148.731654240079,75.8535565237432
8.7,"random_instances_SVM","SVM",58,26,1212,1079,133,2700,2423,277,0.932139958256022,0.607142857142857,1.77293115048217,568,275,293,23,1.1,69.02,8.7,0,0,0,0,0,0,0.548353458454351,139.489169618539,75.5200599048155
8.7,"random_instances_SVM","SVM",58,27,1112,990,122,2800,2512,288,0.932522611317249,0.612244897959184,1.77455620194916,585,286,299,17,1,71.57,8.7,0,0,0,0,0,0,0.527534158896369,128.511254333965,73.9460308155836
8.7,"random_instances_SVM","SVM",58,28,1012,904,108,2900,2598,302,0.933163265306116,0.612244897959184,1.77781525833474,606,295,311,21,1.1,74.13,8.6,0,0,0,0,0,0,0.46182607541908,111.507265077246,68.5409138055426
8.7,"random_instances_SVM","SVM",58,29,912,817,95,3000,2685,315,0.934919990723559,0.61734693877551,1.78697925451172,623,305,318,17,1,76.69,8.5,0,0,0,0,0,0,0.404870482977639,100.721128901919,66.1624502296313
8.7,"random_instances_SVM","SVM",58,30,812,728,84,3100,2774,326,0.934403988868269,0.612244897959184,1.77455620194916,644,316,328,21,1,79.24,8.5,0,0,0,0,0,0,0.334100958542879,92.6842474933966,65.8351851643295
8.7,"random_instances_SVM","SVM",58,31,712,640,72,3200,2862,338,0.934473562152128,0.602040816326531,1.77455620194916,674,330,344,30,1,81.8,8.5,0,0,0,0,0,0,0.256672050424362,81.5291552421184,61.050002416352
8.7,"random_instances_SVM","SVM",58,32,612,551,61,3300,2951,349,0.935653409090905,0.591836734693878,1.78108630756811,692,339,353,18,1,84.36,8.5,0,0,0,0,0,0,0.215245427111392,71.6912859398423,55.8101982670492
8.7,"random_instances_SVM","SVM",58,33,512,459,53,3400,3043,357,0.935998376623374,0.596938775510204,1.77618423516195,718,350,368,26,1.1,86.91,8.5,0,0,0,0,0,0,0.154406045676763,62.0914562598347,51.4336572595978
8.7,"random_instances_SVM","SVM",58,34,412,373,39,3500,3129,371,0.936627435064932,0.591836734693878,1.77944927971188,737,360,377,19,1,89.47,8.4,0,0,0,0,0,0,0.0795766687131634,46.9520303125876,41.0238638184188
8.7,"random_instances_SVM","SVM",58,35,312,287,25,3600,3215,385,0.938059485157696,0.602040816326531,1.77455620194916,763,372,391,26,1.1,92.02,8.4,0,0,0,0,0,0,0.0535807350790016,32.7019276897771,29.8479141821228
8.7,"random_instances_SVM","SVM",58,36,212,197,15,3700,3305,395,0.938207328385897,0.602040816326531,1.78108630756811,777,380,397,14,1,94.58,8.4,0,0,0,0,0,0,0.0223689795284043,20.5536691297847,19.9082068771704
8.7,"random_instances_SVM","SVM",58,37,112,104,8,3800,3398,402,0.938156597866417,0.612244897959184,1.77944927971188,798,390,408,21,1,97.14,8.5,0,0,0,0,0,0,0.00117243615741109,10.7958334115268,10.7891263073832
8.7,"random_instances_SVM","SVM",58,38,12,12,0,3900,3490,410,0.938616071428569,0.61734693877551,1.78108630756811,806,395,411,8,1,99.69,8.5,0,0,0,0,0,0,0.00384592670474448,0.463532583420416,0.463532583420416
8.7,"random_instances_SVM","SVM",58,39,0,0,0,3912,3502,410,0.938618970315397,0.61734693877551,1.78108630756811,805,394,411,-1,1,100,8.5,0,0,0,0,0,0,0,0,0
8.7,"random_instances_SVM","SVM",59,0,3812,3427,385,100,92,8,0.896196455843497,0.596244131455399,1.72659180891802,26,8,18,0,2.2,2.56,11.5,0,0,0,0,0,0,0.24232533131299,310.053811828802,31.3101250628722
8.7,"random_instances_SVM","SVM",59,1,3712,3343,369,200,176,24,0.912551614910354,0.563380281690141,1.77573729670843,53,24,29,27,1.2,5.11,7.3,0,0,0,0,0,0,0.862747491262613,535.700168511035,89.4819947385496
8.7,"random_instances_SVM","SVM",59,2,3612,3252,360,300,267,33,0.913510514223228,0.563380281690141,1.77084545842548,70,33,37,17,1.1,7.67,8.1,0,0,0,0,0,0,0.856445442987383,488.13238615352,89.5167870088791
8.7,"random_instances_SVM","SVM",59,3,3512,3160,352,400,359,41,0.922760121640156,0.586854460093897,1.76598049837486,90,41,49,20,1.2,10.22,8.8,0,0,0,0,0,0,0.678122896240589,420.385154303131,73.4448346501544
8.7,"random_instances_SVM","SVM",59,4,3412,3070,342,500,449,51,0.929496658666875,0.652582159624413,1.77927805584656,109,51,58,19,1.1,12.78,8.8,0,0,0,0,0,0,0.718247403730895,390.720112007452,78.6465485756631
8.7,"random_instances_SVM","SVM",59,5,3312,2980,332,600,539,61,0.925857689645236,0.633802816901408,1.76241286100441,131,61,70,22,1.1,15.34,8.8,0,0,0,0,0,0,0.709308813335491,374.486285780393,76.5432764626084
8.7,"random_instances_SVM","SVM",59,6,3212,2891,321,700,628,72,0.927573472966318,0.63849765258216,1.75237110737821,157,72,85,26,1.2,17.89,8.7,0,0,0,0,0,0,0.742495403038026,355.749357934101,81.5248759252943
8.7,"random_instances_SVM","SVM",59,7,3112,2799,313,800,720,80,0.926341179607773,0.63849765258216,1.76079596847138,173,80,93,16,1.2,20.45,9,0,0,0,0,0,0,0.756742536736049,352.321622015569,82.0518321053251
8.7,"random_instances_SVM","SVM",59,8,3012,2704,308,900,815,85,0.928745161733458,0.647887323943662,1.77410368373997,189,85,104,16,1.2,23.01,9.6,0,0,0,0,0,0,0.821637433285074,334.825883779682,88.5590714810153
8.7,"random_instances_SVM","SVM",59,9,2912,2613,299,1000,906,94,0.929763318869053,0.63849765258216,1.77410368373997,205,94,111,16,1.2,25.56,9.6,0,0,0,0,0,0,0.701265637831973,293.216620927373,79.9911470388726
8.7,"random_instances_SVM","SVM",59,10,2812,2525,287,1100,994,106,0.929340433497927,0.63849765258216,1.77410368373997,230,106,124,25,1.2,28.12,9.4,0,0,0,0,0,0,0.733187532447238,296.255279116683,82.1469901482162
8.7,"random_instances_SVM","SVM",59,11,2712,2435,277,1200,1084,116,0.928074470921928,0.624413145539906,1.76759917894166,248,116,132,18,1.1,30.67,9.3,0,0,0,0,0,0,0.637738729867327,275.179641808696,75.0491689521532
8.7,"random_instances_SVM","SVM",59,12,2612,2343,269,1300,1176,124,0.929262320913444,0.643192488262911,1.76241286100441,265,124,141,17,1.1,33.23,9.5,0,0,0,0,0,0,0.665428544332144,271.67063657734,78.5402954799436
8.7,"random_instances_SVM","SVM",59,13,2512,2252,260,1400,1267,133,0.928473114456499,0.633802816901408,1.76891023560719,283,133,150,18,1.1,35.79,9.5,0,0,0,0,0,0,0.684650077879131,256.921599258029,79.9006188156915
8.7,"random_instances_SVM","SVM",59,14,2412,2164,248,1500,1355,145,0.929112829587974,0.633802816901408,1.76403272576636,305,145,160,22,1.1,38.34,9.3,0,0,0,0,0,0,0.74916837225787,260.737883199422,85.4998750477637
8.7,"random_instances_SVM","SVM",59,15,2312,2079,233,1600,1440,160,0.928793645406584,0.63849765258216,1.75918203999432,335,160,175,30,1.1,40.9,9,0,0,0,0,0,0,0.727976577985377,252.511708131945,83.4536022149802
8.7,"random_instances_SVM","SVM",59,16,2212,1987,225,1700,1532,168,0.926960693208794,0.633802816901408,1.76922082956454,354,168,186,19,1.1,43.46,9.1,0,0,0,0,0,0,0.747532451469451,242.898966813536,85.148063747078
8.7,"random_instances_SVM","SVM",59,17,2112,1896,216,1800,1623,177,0.926584944742086,0.629107981220657,1.76922082956454,369,177,192,15,1.1,46.01,9.2,0,0,0,0,0,0,0.694676120429683,234.11408525497,80.7876128418148
8.7,"random_instances_SVM","SVM",59,18,2012,1805,207,1900,1714,186,0.928688597448147,0.63849765258216,1.75918203999432,387,186,201,18,1.1,48.57,9.2,0,0,0,0,0,0,0.652708989235246,218.360606373683,78.2833711404423
8.7,"random_instances_SVM","SVM",59,19,1912,1726,186,2000,1793,207,0.928359985885872,0.619718309859155,1.76241286100441,427,207,220,40,1.1,51.12,8.7,0,0,0,0,0,0,0.702452255979682,218.940932190794,81.3105444279419
8.7,"random_instances_SVM","SVM",59,20,1812,1640,172,2100,1879,221,0.92813103520724,0.624413145539906,1.76079596847138,451,220,231,24,1.1,53.68,8.5,0,0,0,0,0,0,0.688281937984495,202.179831390512,81.9347520532834
8.7,"random_instances_SVM","SVM",59,21,1712,1542,170,2200,1977,223,0.928470420919104,0.624413145539906,1.76565557096026,459,223,236,8,1.1,56.24,8.9,0,0,0,0,0,0,0.65907492191202,190.613959157856,80.7425508854884
8.7,"random_instances_SVM","SVM",59,22,1612,1448,164,2300,2071,229,0.928971418874709,0.629107981220657,1.76079596847138,476,229,247,17,1.1,58.79,9,0,0,0,0,0,0,0.586741235106705,174.867700260245,76.5419273348131
8.7,"random_instances_SVM","SVM",59,23,1512,1359,153,2400,2160,240,0.929712141658537,0.63849765258216,1.76079596847138,499,240,259,23,1.1,61.35,9,0,0,0,0,0,0,0.643490061923163,176.64317981467,80.2904914689411
8.7,"random_instances_SVM","SVM",59,24,1412,1266,146,2500,2253,247,0.930043446758209,0.652582159624413,1.76728140481934,510,247,263,11,1.1,63.91,9.1,0,0,0,0,0,0,0.631139401833048,166.250161741765,80.490252870915
8.7,"random_instances_SVM","SVM",59,25,1312,1174,138,2600,2345,255,0.931142410015668,0.657276995305164,1.76565557096026,525,255,270,15,1.1,66.46,9.2,0,0,0,0,0,0,0.590373740957282,149.977374557409,79.2398829698971
8.7,"random_instances_SVM","SVM",59,26,1212,1083,129,2700,2436,264,0.93031549403518,0.652582159624413,1.76241286100441,552,264,288,27,1.1,69.02,9.2,0,0,0,0,0,0,0.560461675065069,137.280184971529,76.0625138292712
8.7,"random_instances_SVM","SVM",59,27,1112,996,116,2800,2523,277,0.929813149310876,0.647887323943662,1.76079596847138,578,277,301,26,1.1,71.57,9.1,0,0,0,0,0,0,0.538807861962633,128.494429108825,75.9879024849201
8.7,"random_instances_SVM","SVM",59,28,1012,909,103,2900,2610,290,0.930121559342686,0.647887323943662,1.75918203999432,601,290,311,23,1.1,74.13,9,0,0,0,0,0,0,0.443929759359336,108.870120074893,70.1628374225519
8.7,"random_instances_SVM","SVM",59,29,912,820,92,3000,2699,301,0.92972830288291,0.629107981220657,1.76079596847138,619,301,318,18,1.1,76.69,9,0,0,0,0,0,0,0.375295171475799,95.3751404223292,65.4184765124842
8.7,"random_instances_SVM","SVM",59,30,812,727,85,3100,2792,308,0.929396997783236,0.624413145539906,1.76403272576636,637,308,329,18,1.1,79.24,9.1,0,0,0,0,0,0,0.318241600797362,84.2433818717634,61.1024669312623
8.7,"random_instances_SVM","SVM",59,31,712,634,78,3200,2885,315,0.929875100670979,0.633802816901408,1.76079596847138,649,315,334,12,1.1,81.8,9.2,0,0,0,0,0,0,0.291580318254399,79.7027835388625,61.7801762382375
8.7,"random_instances_SVM","SVM",59,32,612,550,62,3300,2969,331,0.931285167497639,0.643192488262911,1.75918203999432,679,331,348,30,1.1,84.36,9,0,0,0,0,0,0,0.175538530166106,68.9129211005524,58.0432842919428
8.7,"random_instances_SVM","SVM",59,33,512,459,53,3400,3060,340,0.930827266140365,0.63849765258216,1.75435795761774,699,340,359,20,1.1,86.91,9,0,0,0,0,0,0,0.1022135560072,61.4690045806279,54.5707843661309
8.7,"random_instances_SVM","SVM",59,34,412,373,39,3500,3146,354,0.930411114612724,0.633802816901408,1.76403272576636,722,352,370,23,1.1,89.47,8.9,0,0,0,0,0,0,0.0752438443469418,45.6872507538395,41.4222119525039
8.7,"random_instances_SVM","SVM",59,35,312,286,26,3600,3233,367,0.930913459337026,0.63849765258216,1.76241286100441,743,363,380,21,1,92.02,8.8,0,0,0,0,0,0,0.0527907173537912,32.3010469812204,30.4565623702681
8.7,"random_instances_SVM","SVM",59,36,212,193,19,3700,3326,374,0.930742419712398,0.633802816901408,1.75757106743022,752,368,384,9,1,94.58,8.9,0,0,0,0,0,0,0.00849849149942237,21.6721092106468,21.4507055207895
8.7,"random_instances_SVM","SVM",59,37,112,102,10,3800,3417,383,0.930306066654289,0.629107981220657,1.76403272576636,777,376,401,25,1.1,97.14,8.9,0,0,0,0,0,0,0.000356898260815766,10.1553263086322,10.1531897241119
8.7,"random_instances_SVM","SVM",59,38,12,12,0,3900,3507,393,0.930382832470066,0.633802816901408,1.76565557096026,788,385,403,11,1,99.69,8.9,0,0,0,0,0,0,0.000186108535120574,0.0592139559374364,0.0592139559374364
8.7,"random_instances_SVM","SVM",59,39,0,0,0,3912,3519,393,0.930478453047615,0.633802816901408,1.76079596847138,788,386,402,0,1,100,9,0,0,0,0,0,0,0,0,0
8.7,"random_instances_SVM","SVM",60,0,3812,3426,386,100,90,10,0.931879670539454,0.60952380952381,1.7770111915734,28,10,18,0,1.8,2.56,9,0,0,0,0,0,0,0.212360420462179,380.401072589846,22.8462713152514
8.7,"random_instances_SVM","SVM",60,1,3712,3342,370,200,174,26,0.920501281841478,0.580952380952381,1.74162629304701,59,26,33,31,1.3,5.11,6.7,0,0,0,0,0,0,0.454652958515288,409.486510419004,51.5691586794508
8.7,"random_instances_SVM","SVM",60,2,3612,3250,362,300,266,34,0.913275241368018,0.561904761904762,1.72833638025594,78,34,44,19,1.3,7.67,7.8,0,0,0,0,0,0,0.505526298053104,405.986613403058,60.3298197329587
8.7,"random_instances_SVM","SVM",60,3,3512,3158,354,400,358,42,0.910772923144054,0.576190476190476,1.71061261970353,96,42,54,18,1.3,10.22,8.5,0,0,0,0,0,0,0.71027759176277,410.474081512667,78.9007160163676
8.7,"random_instances_SVM","SVM",60,4,3412,3071,341,500,445,55,0.919691267113946,0.614285714285714,1.72297226582941,124,55,69,28,1.3,12.78,8.1,0,0,0,0,0,0,0.743560581260679,394.244416720324,80.5666380292196
8.7,"random_instances_SVM","SVM",60,5,3312,2980,332,600,536,64,0.916355751922755,0.576190476190476,1.75660402155342,154,64,90,30,1.4,15.34,8.4,0,0,0,0,0,0,0.688623791047769,368.800576414626,78.3986101913725
8.7,"random_instances_SVM","SVM",60,6,3212,2888,324,700,628,72,0.916320296732668,0.585714285714286,1.74803522144829,163,72,91,9,1.3,17.89,8.7,0,0,0,0,0,0,0.775081255906113,367.124768292524,85.0221212788146
8.7,"random_instances_SVM","SVM",60,7,3112,2793,319,800,723,77,0.918038509791086,0.576190476190476,1.745364324889,171,77,94,8,1.2,20.45,9.4,0,0,0,0,0,0,0.482447664823249,293.754760103358,60.8531147319934
8.7,"random_instances_SVM","SVM",60,8,3012,2704,308,900,812,88,0.922298587247044,0.59047619047619,1.7587010606259,197,88,109,26,1.2,23.01,9.2,0,0,0,0,0,0,0.576512900681014,299.077405990793,70.2993530361402
8.7,"random_instances_SVM","SVM",60,9,2912,2612,300,1000,904,96,0.928473244968084,0.604761904761905,1.78067226890756,215,96,119,18,1.2,25.56,9.4,0,0,0,0,0,0,0.654161473693066,301.852081245078,76.7179062944026
8.7,"random_instances_SVM","SVM",60,10,2812,2521,291,1100,995,105,0.927185948835428,0.60952380952381,1.77577582820479,230,105,125,15,1.2,28.12,9.5,0,0,0,0,0,0,0.543213351967655,269.08287428722,68.0769905207083
8.7,"random_instances_SVM","SVM",60,11,2712,2431,281,1200,1085,115,0.931791032564231,0.619047619047619,1.79252828203104,261,115,146,31,1.3,30.67,9.4,0,0,0,0,0,0,0.515207015712646,251.746690044974,65.8917147346895
8.7,"random_instances_SVM","SVM",60,12,2612,2340,272,1300,1176,124,0.933364697539952,0.628571428571429,1.77740498034076,275,124,151,14,1.2,33.23,9.5,0,0,0,0,0,0,0.505272591837923,248.686394641054,66.2664379710752
8.7,"random_instances_SVM","SVM",60,13,2512,2248,264,1400,1268,132,0.931853760977473,0.628571428571429,1.7839515916864,299,132,167,24,1.3,35.79,9.6,0,0,0,0,0,0,0.562850503338045,242.979037844736,70.7416128709784
8.7,"random_instances_SVM","SVM",60,14,2412,2155,257,1500,1361,139,0.932296950853647,0.614285714285714,1.78067226890756,313,139,174,14,1.3,38.34,9.8,0,0,0,0,0,0,0.655393384589419,242.59113331285,79.4768215873059
8.7,"random_instances_SVM","SVM",60,15,2312,2063,249,1600,1453,147,0.931197839960722,0.614285714285714,1.78231042186884,332,147,185,19,1.3,40.9,9.9,0,0,0,0,0,0,0.536046273401218,215.004882261063,71.1006726707037
8.7,"random_instances_SVM","SVM",60,16,2212,1973,239,1700,1543,157,0.929253259150158,0.614285714285714,1.78067226890756,344,157,187,12,1.2,43.46,9.8,0,0,0,0,0,0,0.609427978818595,212.857051478553,76.7853875810373
8.7,"random_instances_SVM","SVM",60,17,2112,1886,226,1800,1630,170,0.934939726176839,0.638095238095238,1.78923319327731,373,170,203,29,1.2,46.01,9.6,0,0,0,0,0,0,0.64861529621298,208.940282555146,80.6873849764157
8.7,"random_instances_SVM","SVM",60,18,2012,1794,218,1900,1722,178,0.936044291714393,0.628571428571429,1.79418038183015,394,178,216,21,1.2,48.57,9.7,0,0,0,0,0,0,0.630176375556874,198.227155761813,77.8579630113704
8.7,"random_instances_SVM","SVM",60,19,1912,1706,206,2000,1810,190,0.936052473681337,0.638095238095238,1.78759018759019,416,190,226,22,1.2,51.12,9.5,0,0,0,0,0,0,0.65100090487661,197.560957454528,80.2446538171792
8.7,"random_instances_SVM","SVM",60,20,1812,1618,194,2100,1898,202,0.93554791905307,0.638095238095238,1.79252828203104,432,202,230,16,1.1,53.68,9.4,0,0,0,0,0,0,0.647403459628502,186.9853900082,82.1784009316349
8.7,"random_instances_SVM","SVM",60,21,1712,1526,186,2200,1990,210,0.937012491136203,0.633333333333333,1.78431321199424,448,210,238,16,1.1,56.24,9.5,0,0,0,0,0,0,0.548769717973408,167.846260111714,73.7451627440758
8.7,"random_instances_SVM","SVM",60,22,1612,1432,180,2300,2084,216,0.939172530409645,0.647619047619048,1.78923319327731,462,216,246,14,1.1,58.79,9.6,0,0,0,0,0,0,0.565031456052372,162.315175581005,77.4612747249937
8.7,"random_instances_SVM","SVM",60,23,1512,1342,170,2400,2174,226,0.941224840451645,0.652380952380952,1.78923319327731,484,226,258,22,1.1,61.35,9.6,0,0,0,0,0,0,0.553066972778208,156.425334118874,78.882239846225
8.7,"random_instances_SVM","SVM",60,24,1412,1258,154,2500,2258,242,0.94209076528664,0.652380952380952,1.78759018759019,511,242,269,27,1.1,63.91,9.3,0,0,0,0,0,0,0.473771310580664,141.655332898688,72.3764598494758
8.7,"random_instances_SVM","SVM",60,25,1312,1168,144,2600,2348,252,0.942191676212293,0.642857142857143,1.79252828203104,533,252,281,22,1.1,66.46,9.3,0,0,0,0,0,0,0.456700870104602,134.108932257839,71.3933094771389
8.7,"random_instances_SVM","SVM",60,26,1212,1079,133,2700,2437,263,0.941537118856708,0.642857142857143,1.78759018759019,561,263,298,28,1.1,69.02,9.3,0,0,0,0,0,0,0.4383064654144,123.33523103865,71.4604442401127
8.7,"random_instances_SVM","SVM",60,27,1112,991,121,2800,2525,275,0.942596683576068,0.657142857142857,1.79252828203104,584,275,309,23,1.1,71.57,9.2,0,0,0,0,0,0,0.450283759809467,119.03122976538,71.446984796659
8.7,"random_instances_SVM","SVM",60,28,1012,904,108,2900,2612,288,0.942731686030657,0.647619047619048,1.79944802207912,607,288,319,23,1.1,74.13,9.1,0,0,0,0,0,0,0.328362346554922,100.373972840104,62.5594496083901
8.7,"random_instances_SVM","SVM",60,29,912,813,99,3000,2703,297,0.943957617411225,0.657142857142857,1.80110497237569,628,297,331,21,1.1,76.69,9.1,0,0,0,0,0,0,0.335719691944387,96.8064673943131,63.2818896159485
8.7,"random_instances_SVM","SVM",60,30,812,726,86,3100,2790,310,0.946687667048491,0.671428571428571,1.79779411764706,648,310,338,20,1.1,79.24,9,0,0,0,0,0,0,0.277884287142297,87.5018396823626,62.8502416628926
8.7,"random_instances_SVM","SVM",60,31,712,641,71,3200,2875,325,0.947160857470139,0.661904761904762,1.79944802207912,675,325,350,27,1.1,81.8,8.8,0,0,0,0,0,0,0.205864807303417,74.8096170469938,56.7424151411589
8.7,"random_instances_SVM","SVM",60,32,612,552,60,3300,2964,336,0.946080837833416,0.661904761904762,1.79285059578368,697,336,361,22,1.1,84.36,8.8,0,0,0,0,0,0,0.141297886050104,63.665820584447,49.9840753021418
8.7,"random_instances_SVM","SVM",60,33,512,459,53,3400,3057,343,0.946691758031965,0.652380952380952,1.79285059578368,714,343,371,17,1.1,86.91,8.9,0,0,0,0,0,0,0.119002731637199,56.2708347470807,47.1632209713115
8.7,"random_instances_SVM","SVM",60,34,412,367,45,3500,3149,351,0.94601265477554,0.652380952380952,1.80276497695853,727,351,376,13,1.1,89.47,9,0,0,0,0,0,0,0.0912819636224861,48.0206074366928,42.7605309611068
8.7,"random_instances_SVM","SVM",60,35,312,278,34,3600,3238,362,0.947638138875251,0.661904761904762,1.80110497237569,746,362,384,19,1.1,92.02,8.9,0,0,0,0,0,0,0.0572599530930638,35.9649248136312,33.7965947031449
8.7,"random_instances_SVM","SVM",60,36,212,190,22,3700,3326,374,0.947336769759448,0.647619047619048,1.80110497237569,773,374,399,27,1.1,94.58,8.9,0,0,0,0,0,0,0.0174751981730723,24.4596107329887,24.075974283101
8.7,"random_instances_SVM","SVM",60,37,112,99,13,3800,3417,383,0.948551791850759,0.657142857142857,1.80276497695853,795,383,412,22,1.1,97.14,8.9,0,0,0,0,0,0,0.000575757816912414,14.0150901544297,14.0118652388079
8.7,"random_instances_SVM","SVM",60,38,12,11,1,3900,3505,395,0.947565864833904,0.652380952380952,1.80110497237569,814,395,419,19,1.1,99.69,8.9,0,0,0,0,0,0,0.000388955418844766,2.19117746673291,2.19117746673291
8.7,"random_instances_SVM","SVM",60,39,0,0,0,3912,3516,396,0.947621774941361,0.652380952380952,1.79944802207912,816,396,420,2,1.1,100,8.9,0,0,0,0,0,0,0,0,0
8.7,"random_instances_SVM","SVM",61,0,3812,3410,402,100,91,9,0.905974169687957,0.58974358974359,1.73450629882469,25,9,16,0,1.8,2.56,10.1,0,0,0,0,0,0,0.482083110021826,330.356507242472,53.337716595223
8.7,"random_instances_SVM","SVM",61,1,3712,3326,386,200,175,25,0.905758674412837,0.58974358974359,1.7316663134845,58,25,33,33,1.3,5.11,7,0,0,0,0,0,0,0.686164153988537,443.734786966597,73.5104403401414
8.7,"random_instances_SVM","SVM",61,2,3612,3234,378,300,267,33,0.916973165014056,0.625641025641026,1.74568635784105,80,33,47,22,1.4,7.67,8.1,0,0,0,0,0,0,0.351010394272553,366.789075365422,40.3226638470498
8.7,"random_instances_SVM","SVM",61,3,3512,3148,364,400,353,47,0.932532506297417,0.61025641025641,1.78099214492959,111,47,64,31,1.4,10.22,7.5,0,0,0,0,0,0,0.429769821687883,388.10539799511,53.4895184336741
8.7,"random_instances_SVM","SVM",61,4,3412,3058,354,500,443,57,0.939067254910529,0.620512820512821,1.79352002835874,130,57,73,19,1.3,12.78,7.8,0,0,0,0,0,0,0.27837679184857,350.349687716444,32.4010787941021
8.7,"random_instances_SVM","SVM",61,5,3312,2969,343,600,532,68,0.94028742410344,0.625641025641026,1.79449541284404,156,68,88,26,1.3,15.34,7.8,0,0,0,0,0,0,0.602000257868762,347.907767136739,71.0677904329457
8.7,"random_instances_SVM","SVM",61,6,3212,2875,337,700,626,74,0.938998820600186,0.620512820512821,1.79779411764706,171,74,97,15,1.3,17.89,8.5,0,0,0,0,0,0,0.628500179797976,339.209981681286,74.0217270901494
8.7,"random_instances_SVM","SVM",61,7,3112,2785,327,800,716,84,0.940028247353634,0.625641025641026,1.80276497695853,197,84,113,26,1.3,20.45,8.5,0,0,0,0,0,0,0.665790731080617,318.892026479791,77.740106665961
8.7,"random_instances_SVM","SVM",61,8,3012,2695,317,900,806,94,0.935374714250357,0.6,1.79352002835874,206,94,112,9,1.2,23.01,8.6,0,0,0,0,0,0,0.670567674764451,316.254075496496,76.6876860409897
8.7,"random_instances_SVM","SVM",61,9,2912,2598,314,1000,903,97,0.934868009143995,0.6,1.79944802207912,215,97,118,9,1.2,25.56,9.3,0,0,0,0,0,0,0.645536023831315,278.25699508061,75.0421323566962
8.7,"random_instances_SVM","SVM",61,10,2812,2508,304,1100,993,107,0.936455102724274,0.58974358974359,1.79614325068871,236,107,129,21,1.2,28.12,9.3,0,0,0,0,0,0,0.500178514311402,260.655513059241,62.1540563593669
8.7,"random_instances_SVM","SVM",61,11,2712,2415,297,1200,1086,114,0.931003654683384,0.605128205128205,1.79614325068871,253,114,139,17,1.2,30.67,9.5,0,0,0,0,0,0,0.506474366461233,264.629483623963,63.9619528520422
8.7,"random_instances_SVM","SVM",61,12,2612,2329,283,1300,1172,128,0.937912607929647,0.620512820512821,1.79186853661992,280,128,152,27,1.2,33.23,9.2,0,0,0,0,0,0,0.667923630073733,253.858339453003,78.6299641694098
8.7,"random_instances_SVM","SVM",61,13,2512,2238,274,1400,1263,137,0.937586452918655,0.620512820512821,1.80110497237569,296,137,159,16,1.2,35.79,9.2,0,0,0,0,0,0,0.656847700840074,250.879910771975,78.6637464186744
8.7,"random_instances_SVM","SVM",61,14,2412,2149,263,1500,1352,148,0.938326125890013,0.620512820512821,1.79449541284404,319,148,171,23,1.2,38.34,9.1,0,0,0,0,0,0,0.684280088706292,246.738190161196,81.4974771556992
8.7,"random_instances_SVM","SVM",61,15,2312,2054,258,1600,1447,153,0.936629828623016,0.605128205128205,1.79614325068871,331,153,178,12,1.2,40.9,9.5,0,0,0,0,0,0,0.587879179051875,232.559432585224,73.8635164640859
8.7,"random_instances_SVM","SVM",61,16,2212,1964,248,1700,1537,163,0.933554652805079,0.620512820512821,1.79944802207912,355,163,192,24,1.2,43.46,9.4,0,0,0,0,0,0,0.685647595974005,234.00295278386,83.588114426838
8.7,"random_instances_SVM","SVM",61,17,2112,1874,238,1800,1627,173,0.934975756781551,0.620512820512821,1.79944802207912,377,173,204,22,1.2,46.01,9.4,0,0,0,0,0,0,0.508124900836082,205.669272679877,67.0024674665896
8.7,"random_instances_SVM","SVM",61,18,2012,1786,226,1900,1715,185,0.936160980794712,0.625641025641026,1.80276497695853,394,185,209,17,1.1,48.57,9.3,0,0,0,0,0,0,0.671142232355637,206.784557006204,82.0792858821555
8.7,"random_instances_SVM","SVM",61,19,1912,1701,211,2000,1800,200,0.936644389114579,0.630769230769231,1.80110497237569,418,200,218,24,1.1,51.12,9,0,0,0,0,0,0,0.61574762676095,190.100048095413,77.1871888711632
8.7,"random_instances_SVM","SVM",61,20,1812,1608,204,2100,1893,207,0.937446672199656,0.620512820512821,1.80110497237569,435,207,228,17,1.1,53.68,9.1,0,0,0,0,0,0,0.660532585270894,190.026318735595,81.3163742885293
8.7,"random_instances_SVM","SVM",61,21,1712,1518,194,2200,1983,217,0.938042196304551,0.620512820512821,1.80110497237569,453,217,236,18,1.1,56.24,9.1,0,0,0,0,0,0,0.596677500176801,165.684663116787,77.2639463717099
8.7,"random_instances_SVM","SVM",61,22,1612,1426,186,2300,2075,225,0.937951921256865,0.630769230769231,1.80276497695853,471,225,246,18,1.1,58.79,9.2,0,0,0,0,0,0,0.592688698634456,159.774987781532,77.9511609240367
8.7,"random_instances_SVM","SVM",61,23,1512,1340,172,2400,2161,239,0.937619942049245,0.646153846153846,1.80276497695853,501,239,262,30,1.1,61.35,9,0,0,0,0,0,0,0.472069402739497,144.745468333835,68.8275189193408
8.7,"random_instances_SVM","SVM",61,24,1412,1255,157,2500,2246,254,0.936452190625958,0.641025641025641,1.79449541284404,523,254,269,22,1.1,63.91,8.8,0,0,0,0,0,0,0.553369094773025,140.086974371566,77.4096405242906
8.7,"random_instances_SVM","SVM",61,25,1312,1166,146,2600,2335,265,0.93758790896781,0.630769230769231,1.79352002835874,549,265,284,26,1.1,66.46,8.8,0,0,0,0,0,0,0.490333426224748,127.324170884555,71.3499999009432
8.7,"random_instances_SVM","SVM",61,26,1212,1075,137,2700,2426,274,0.936653125409515,0.635897435897436,1.80110497237569,566,274,292,17,1.1,69.02,8.9,0,0,0,0,0,0,0.492695755624417,125.99659101989,74.3199361736582
8.7,"random_instances_SVM","SVM",61,27,1112,988,124,2800,2513,287,0.936520624936301,0.630769230769231,1.79779411764706,595,287,308,29,1.1,71.57,8.8,0,0,0,0,0,0,0.445377525817593,114.579489530544,70.0884746970208
8.7,"random_instances_SVM","SVM",61,28,1012,901,111,2900,2600,300,0.939489509165833,0.630769230769231,1.80276497695853,619,300,319,24,1.1,74.13,8.7,0,0,0,0,0,0,0.448210256522636,108.930998586115,70.5493515968874
8.7,"random_instances_SVM","SVM",61,29,912,810,102,3000,2691,309,0.938793517669158,0.630769230769231,1.79779411764706,638,309,329,19,1.1,76.69,8.7,0,0,0,0,0,0,0.417780892753824,102.463695639117,70.4497852870903
8.7,"random_instances_SVM","SVM",61,30,812,721,91,3100,2780,320,0.940249566825378,0.625641025641026,1.80110497237569,664,320,344,26,1.1,79.24,8.7,0,0,0,0,0,0,0.355941551757023,94.1751715496636,66.500626024614
8.7,"random_instances_SVM","SVM",61,31,712,631,81,3200,2870,330,0.940925173633863,0.641025641025641,1.79614325068871,685,330,355,21,1.1,81.8,8.7,0,0,0,0,0,0,0.275468860173445,79.3513403790813,60.9845951694747
8.7,"random_instances_SVM","SVM",61,32,612,542,70,3300,2959,341,0.940334017676439,0.630769230769231,1.79779411764706,701,341,360,16,1.1,84.36,8.7,0,0,0,0,0,0,0.186739101339988,71.2219812522261,58.0624075104122
8.7,"random_instances_SVM","SVM",61,33,512,450,62,3400,3051,349,0.941488664657321,0.635897435897436,1.79779411764706,711,349,362,10,1,86.91,8.7,0,0,0,0,0,0,0.140907038505206,65.4748199311926,55.4684992266688
8.7,"random_instances_SVM","SVM",61,34,412,361,51,3500,3140,360,0.941405669855417,0.635897435897436,1.79779411764706,738,359,379,27,1.1,89.47,8.7,0,0,0,0,0,0,0.0893246559248473,52.5279153954853,46.3248545781921
8.7,"random_instances_SVM","SVM",61,35,312,277,35,3600,3224,376,0.940463606051343,0.625641025641026,1.79449541284404,765,374,391,27,1,92.02,8.6,0,0,0,0,0,0,0.0562173745561223,36.7039072502711,33.8873805118328
8.7,"random_instances_SVM","SVM",61,36,212,188,24,3700,3313,387,0.940246654727066,0.630769230769231,1.79614325068871,778,382,396,13,1,94.58,8.6,0,0,0,0,0,0,0.0247377358455948,23.6551923166938,23.0155062342538
8.7,"random_instances_SVM","SVM",61,37,112,99,13,3800,3402,398,0.939652586671327,0.630769230769231,1.79944802207912,800,392,408,22,1,97.14,8.5,0,0,0,0,0,0,0.00160740914516808,13.7387616475655,13.7287581050602
8.7,"random_instances_SVM","SVM",61,38,12,10,2,3900,3491,409,0.941262977038106,0.630769230769231,1.79779411764706,826,404,422,26,1,99.69,8.5,0,0,0,0,0,0,0.00114509778170335,1.76715991514326,1.76715991514326
8.7,"random_instances_SVM","SVM",61,39,0,0,0,3912,3501,411,0.941019816829017,0.630769230769231,1.79449541284404,827,405,422,1,1,100,8.5,0,0,0,0,0,0,0,0,0
8.7,"random_instances_SVM","SVM",62,0,3812,3410,402,100,89,11,0.778211597635913,0.373056994818653,1.53134430336503,32,11,21,0,1.9,2.56,8.1,0,0,0,0,0,0,0.756770990022506,596.273641008579,87.7684299285339
8.7,"random_instances_SVM","SVM",62,1,3712,3326,386,200,173,27,0.906309605330068,0.559585492227979,1.73099815869481,63,27,36,31,1.3,5.11,6.4,0,0,0,0,0,0,0.804161673470249,564.484270909234,84.6915394980331
8.7,"random_instances_SVM","SVM",62,2,3612,3235,377,300,264,36,0.900411157383052,0.569948186528497,1.69374689474058,82,36,46,19,1.3,7.67,7.3,0,0,0,0,0,0,0.7594739447271,528.177592951327,81.8214538075562
8.7,"random_instances_SVM","SVM",62,3,3512,3143,369,400,356,44,0.911007497230068,0.590673575129534,1.7201121832961,101,44,57,19,1.3,10.22,8.1,0,0,0,0,0,0,0.634142377103732,417.5750495868,69.8164538205961
8.7,"random_instances_SVM","SVM",62,4,3412,3052,360,500,447,53,0.91227858778166,0.606217616580311,1.70935746519902,120,53,67,19,1.3,12.78,8.4,0,0,0,0,0,0,0.70713951921409,429.472653618215,78.3047095874806
8.7,"random_instances_SVM","SVM",62,5,3312,2962,350,600,537,63,0.913028016893013,0.61139896373057,1.7216917169814,143,63,80,23,1.3,15.34,8.5,0,0,0,0,0,0,0.687682195639714,388.599135775513,77.9882514156088
8.7,"random_instances_SVM","SVM",62,6,3212,2874,338,700,625,75,0.913592292929801,0.606217616580311,1.7201121832961,171,75,96,28,1.3,17.89,8.3,0,0,0,0,0,0,0.786189799688057,384.247490032474,86.3943162678476
8.7,"random_instances_SVM","SVM",62,7,3112,2787,325,800,712,88,0.921562691949384,0.626943005181347,1.74350663279168,191,88,103,20,1.2,20.45,8.1,0,0,0,0,0,0,0.78097504065579,367.958422105898,86.1528095653737
8.7,"random_instances_SVM","SVM",62,8,3012,2699,313,900,800,100,0.924908672511249,0.637305699481865,1.72941008698959,213,100,113,22,1.1,23.01,8,0,0,0,0,0,0,0.687780351270422,331.652941570939,79.1131328544125
8.7,"random_instances_SVM","SVM",62,9,2912,2604,308,1000,895,105,0.922532541387608,0.647668393782383,1.75444422179601,227,105,122,14,1.2,25.56,8.5,0,0,0,0,0,0,0.730062251620418,329.193292796812,82.779832055845
8.7,"random_instances_SVM","SVM",62,10,2812,2512,300,1100,987,113,0.927243658507212,0.637305699481865,1.74800589437657,251,113,138,24,1.2,28.12,8.7,0,0,0,0,0,0,0.66775926122589,304.009949211101,78.7779490351555
8.7,"random_instances_SVM","SVM",62,11,2712,2423,289,1200,1076,124,0.929947481183468,0.647668393782383,1.75444422179601,273,124,149,22,1.2,30.67,8.7,0,0,0,0,0,0,0.691656773128958,303.716823699517,80.1027720262987
8.7,"random_instances_SVM","SVM",62,12,2612,2333,279,1300,1166,134,0.929503701592041,0.652849740932642,1.76215376255416,285,134,151,12,1.1,33.23,8.7,0,0,0,0,0,0,0.798302475922327,315.245936787174,87.920233824603
8.7,"random_instances_SVM","SVM",62,13,2512,2247,265,1400,1252,148,0.92932001798632,0.652849740932642,1.77310852202788,311,148,163,26,1.1,35.79,8.5,0,0,0,0,0,0,0.779550523229012,304.22989919651,86.9822395925661
8.7,"random_instances_SVM","SVM",62,14,2412,2152,260,1500,1347,153,0.926364916137425,0.652849740932642,1.75569307048247,323,153,170,12,1.1,38.34,8.8,0,0,0,0,0,0,0.713758403183863,277.220574765696,80.848057045188
8.7,"random_instances_SVM","SVM",62,15,2312,2066,246,1600,1433,167,0.932608689263197,0.652849740932642,1.76660170176356,358,167,191,35,1.1,40.9,8.6,0,0,0,0,0,0,0.703641649112668,262.845672036521,82.4868151681651
8.7,"random_instances_SVM","SVM",62,16,2212,1974,238,1700,1525,175,0.932839395871987,0.652849740932642,1.76822392554847,376,175,201,18,1.1,43.46,8.7,0,0,0,0,0,0,0.709178646863771,253.515382729369,81.9616478234748
8.7,"random_instances_SVM","SVM",62,17,2112,1885,227,1800,1614,186,0.932467620254002,0.658031088082902,1.76984913136239,392,186,206,16,1.1,46.01,8.7,0,0,0,0,0,0,0.699426187468245,239.257352314232,82.7301647776525
8.7,"random_instances_SVM","SVM",62,18,2012,1799,213,1900,1700,200,0.933324320591101,0.652849740932642,1.76984913136239,421,200,221,29,1.1,48.57,8.5,0,0,0,0,0,0,0.718637208681589,232.716424604273,83.8909228248285
8.7,"random_instances_SVM","SVM",62,19,1912,1708,204,2000,1791,209,0.934279475340865,0.647668393782383,1.77474272343067,440,209,231,19,1.1,51.12,8.6,0,0,0,0,0,0,0.70215895840997,226.212498286067,82.9286248237345
8.7,"random_instances_SVM","SVM",62,20,1812,1617,195,2100,1882,218,0.934485200979277,0.642487046632124,1.77310852202788,462,218,244,22,1.1,53.68,8.6,0,0,0,0,0,0,0.679055878531352,209.512981733055,82.4307943178557
8.7,"random_instances_SVM","SVM",62,21,1712,1522,190,2200,1977,223,0.932898174625819,0.642487046632124,1.77310852202788,471,223,248,9,1.1,56.24,8.9,0,0,0,0,0,0,0.680067220977171,199.545428232744,82.2297040271227
8.7,"random_instances_SVM","SVM",62,22,1612,1434,178,2300,2065,235,0.933272889181497,0.652849740932642,1.77310852202788,490,235,255,19,1.1,58.79,8.8,0,0,0,0,0,0,0.702227687216358,192.170690302346,83.922458629137
8.7,"random_instances_SVM","SVM",62,23,1512,1346,166,2400,2153,247,0.935064171704516,0.652849740932642,1.77474272343067,514,247,267,24,1.1,61.35,8.7,0,0,0,0,0,0,0.634743895400284,179.016544430018,79.7802020369871
8.7,"random_instances_SVM","SVM",62,24,1412,1261,151,2500,2238,262,0.935460928292876,0.642487046632124,1.77310852202788,552,262,290,38,1.1,63.91,8.5,0,0,0,0,0,0,0.627533648224556,163.995787302525,81.4156561492477
8.7,"random_instances_SVM","SVM",62,25,1312,1173,139,2600,2326,274,0.935184668149864,0.647668393782383,1.77310852202788,573,274,299,21,1.1,66.46,8.5,0,0,0,0,0,0,0.607173222357045,156.185553488283,81.1608906676762
8.7,"random_instances_SVM","SVM",62,26,1212,1085,127,2700,2414,286,0.93565489818052,0.642487046632124,1.7714773274354,596,286,310,23,1.1,69.02,8.4,0,0,0,0,0,0,0.562384395565054,144.151530806202,78.4022589915138
8.7,"random_instances_SVM","SVM",62,27,1112,993,119,2800,2506,294,0.933917986004793,0.642487046632124,1.7714773274354,611,294,317,15,1.1,71.57,8.5,0,0,0,0,0,0,0.565925703385917,135.453495679705,79.5297852855655
8.7,"random_instances_SVM","SVM",62,28,1012,903,109,2900,2596,304,0.934576308047708,0.652849740932642,1.7714773274354,631,304,327,20,1.1,74.13,8.5,0,0,0,0,0,0,0.476252059510127,113.918956320292,73.0633591113075
8.7,"random_instances_SVM","SVM",62,29,912,811,101,3000,2688,312,0.933164148486892,0.647668393782383,1.76660170176356,647,312,335,16,1.1,76.69,8.6,0,0,0,0,0,0,0.43359527187471,102.687900970695,72.407358992918
8.7,"random_instances_SVM","SVM",62,30,812,724,88,3100,2775,325,0.93333607634186,0.642487046632124,1.76498245180777,672,325,347,25,1.1,79.24,8.5,0,0,0,0,0,0,0.311019434289312,86.9077285766268,64.8395456095731
8.7,"random_instances_SVM","SVM",62,31,712,633,79,3200,2866,334,0.933409549784151,0.642487046632124,1.77474272343067,687,334,353,15,1.1,81.8,8.6,0,0,0,0,0,0,0.228104881726374,76.1485979194308,60.9384638115557
8.7,"random_instances_SVM","SVM",62,32,612,542,70,3300,2957,343,0.933001037445022,0.637305699481865,1.7714773274354,709,343,366,22,1.1,84.36,8.6,0,0,0,0,0,0,0.144800941398717,66.609520039734,55.1285143769004
8.7,"random_instances_SVM","SVM",62,33,512,451,61,3400,3048,352,0.933806306372517,0.642487046632124,1.7714773274354,720,352,368,11,1,86.91,8.7,0,0,0,0,0,0,0.105327141517162,58.5247708692177,50.8180345095466
8.7,"random_instances_SVM","SVM",62,34,412,363,49,3500,3136,364,0.935643142429757,0.642487046632124,1.7714773274354,743,364,379,23,1,89.47,8.6,0,0,0,0,0,0,0.0811847961093394,47.7790445704442,43.4676880054141
8.7,"random_instances_SVM","SVM",62,35,312,273,39,3600,3226,374,0.934918694288776,0.652849740932642,1.76377637191195,767,374,393,24,1.1,92.02,8.6,0,0,0,0,0,0,0.0468674928483834,34.4374883955344,32.9847869356605
8.7,"random_instances_SVM","SVM",62,36,212,185,27,3700,3314,386,0.936615930805666,0.663212435233161,1.75891748383505,790,386,404,23,1,94.58,8.6,0,0,0,0,0,0,0.0108279425368897,23.7845023760938,23.5286635276811
8.7,"random_instances_SVM","SVM",62,37,112,99,13,3800,3400,400,0.937338909477796,0.663212435233161,1.76984913136239,818,398,420,28,1.1,97.14,8.5,0,0,0,0,0,0,0.000929042572643415,12.5551241473983,12.5523043220493
8.7,"random_instances_SVM","SVM",62,38,12,10,2,3900,3489,411,0.935347779191747,0.652849740932642,1.76377637191195,836,408,428,18,1,99.69,8.5,0,0,0,0,0,0,9.89932611783248e-05,1.89402629934908,1.89402629934908
8.7,"random_instances_SVM","SVM",62,39,0,0,0,3912,3499,413,0.934854037659563,0.652849740932642,1.76377637191195,840,409,431,4,1.1,100,8.5,0,0,0,0,0,0,0,0,0
8.7,"random_instances_SVM","SVM",63,0,3812,3428,384,100,88,12,0.884309714722079,0.538095238095238,1.71061261970353,33,12,21,0,1.8,2.56,7.3,0,0,0,0,0,0,0.567290857009803,532.090868794213,63.3302770419819
8.7,"random_instances_SVM","SVM",63,1,3712,3343,369,200,173,27,0.911312932962411,0.6,1.74803522144829,58,27,31,25,1.1,5.11,6.4,0,0,0,0,0,0,0.83725205277094,545.090264161277,86.9722713358474
8.7,"random_instances_SVM","SVM",63,2,3612,3251,361,300,265,35,0.895639011618397,0.566666666666667,1.72074579831933,76,35,41,18,1.2,7.67,7.6,0,0,0,0,0,0,0.847849116953183,448.785660165505,89.4829019414191
8.7,"random_instances_SVM","SVM",63,3,3512,3158,354,400,358,42,0.896544482626954,0.571428571428571,1.74642857142857,92,42,50,16,1.2,10.22,8.5,0,0,0,0,0,0,0.726220840605353,376.024724532832,79.5714346286792
8.7,"random_instances_SVM","SVM",63,4,3412,3068,344,500,448,52,0.898634975181367,0.585714285714286,1.70362394957983,111,52,59,19,1.1,12.78,8.6,0,0,0,0,0,0,0.82570131370825,401.947367677112,87.674203697354
8.7,"random_instances_SVM","SVM",63,5,3312,2980,332,600,536,64,0.90894016254842,0.60952380952381,1.74162629304701,137,64,73,26,1.1,15.34,8.4,0,0,0,0,0,0,0.748392852619706,371.02099186235,81.4526949790547
8.7,"random_instances_SVM","SVM",63,6,3212,2884,328,700,632,68,0.912635684285172,0.595238095238095,1.75660402155342,143,68,75,6,1.1,17.89,9.3,0,0,0,0,0,0,0.777915506259961,337.306407040454,85.0321143164707
8.7,"random_instances_SVM","SVM",63,7,3112,2797,315,800,719,81,0.916141657121046,0.604761904761905,1.76679821099711,170,81,89,27,1.1,20.45,8.9,0,0,0,0,0,0,0.69602771843731,319.851395606671,77.8791939724843
8.7,"random_instances_SVM","SVM",63,8,3012,2708,304,900,808,92,0.918387607047411,0.60952380952381,1.76031454783748,191,92,99,21,1.1,23.01,8.8,0,0,0,0,0,0,0.67811766220692,317.331163544631,77.1312267392061
8.7,"random_instances_SVM","SVM",63,9,2912,2615,297,1000,901,99,0.918202149129992,0.60952380952381,1.76842659644503,203,99,104,12,1.1,25.56,9.1,0,0,0,0,0,0,0.793270301546314,315.241587018604,86.1021136287858
8.7,"random_instances_SVM","SVM",63,10,2812,2525,287,1100,991,109,0.919603992799884,0.614285714285714,1.76031454783748,227,109,118,24,1.1,28.12,9.1,0,0,0,0,0,0,0.76890184683261,290.845148367261,85.1912159838986
8.7,"random_instances_SVM","SVM",63,11,2712,2433,279,1200,1083,117,0.919805814651185,0.628571428571429,1.75337793519612,246,117,129,19,1.1,30.67,9.3,0,0,0,0,0,0,0.647960663210664,264.299333805345,74.688849230558
8.7,"random_instances_SVM","SVM",63,12,2612,2345,267,1300,1171,129,0.922853597338144,0.628571428571429,1.76679821099711,274,129,145,28,1.1,33.23,9.1,0,0,0,0,0,0,0.7429903634664,267.476075845817,84.4166894935122
8.7,"random_instances_SVM","SVM",63,13,2512,2255,257,1400,1261,139,0.923806796487212,0.638095238095238,1.76193099829463,294,139,155,20,1.1,35.79,9.1,0,0,0,0,0,0,0.656516082775361,251.881834560996,77.9763676244272
8.7,"random_instances_SVM","SVM",63,14,2412,2168,244,1500,1348,152,0.924723176785038,0.628571428571429,1.76193099829463,321,152,169,27,1.1,38.34,8.9,0,0,0,0,0,0,0.6758670483782,246.367187621917,79.2889972106858
8.7,"random_instances_SVM","SVM",63,15,2312,2084,228,1600,1432,168,0.923209512900233,0.638095238095238,1.76517282165856,347,168,179,26,1.1,40.9,8.5,0,0,0,0,0,0,0.736549460277364,249.435420715471,84.8393592683954
8.7,"random_instances_SVM","SVM",63,16,2212,1990,222,1700,1526,174,0.922917689412539,0.628571428571429,1.76517282165856,364,174,190,17,1.1,43.46,8.8,0,0,0,0,0,0,0.659116875944312,228.753340060406,78.5027376489707
8.7,"random_instances_SVM","SVM",63,17,2112,1900,212,1800,1616,184,0.923544973544977,0.623809523809524,1.7737416217637,390,184,206,26,1.1,46.01,8.8,0,0,0,0,0,0,0.734550645589746,233.762250620336,84.5421416259595
8.7,"random_instances_SVM","SVM",63,18,2012,1816,196,1900,1700,200,0.924675448644526,0.633333333333333,1.76885976408912,415,200,215,25,1.1,48.57,8.5,0,0,0,0,0,0,0.728113610924584,224.610296094931,84.1579139231373
8.7,"random_instances_SVM","SVM",63,19,1912,1724,188,2000,1792,208,0.926422298587253,0.633333333333333,1.7737416217637,434,208,226,19,1.1,51.12,8.6,0,0,0,0,0,0,0.685555334816611,214.392061241599,80.9634489396429
8.7,"random_instances_SVM","SVM",63,20,1812,1632,180,2100,1884,216,0.925669557628327,0.633333333333333,1.77211134453782,450,216,234,16,1.1,53.68,8.7,0,0,0,0,0,0,0.643039122654442,200.895027551044,77.8405057669232
8.7,"random_instances_SVM","SVM",63,21,1712,1538,174,2200,1978,222,0.924856815578474,0.633333333333333,1.76400470526729,456,222,234,6,1.1,56.24,8.9,0,0,0,0,0,0,0.663209715045848,186.458603142555,81.3872056715723
8.7,"random_instances_SVM","SVM",63,22,1612,1446,166,2300,2070,230,0.927439589810731,0.628571428571429,1.77537490134175,478,230,248,22,1.1,58.79,9,0,0,0,0,0,0,0.640412380918149,182.086601994749,80.1098116496747
8.7,"random_instances_SVM","SVM",63,23,1512,1358,154,2400,2158,242,0.926785032455146,0.638095238095238,1.7737416217637,500,242,258,22,1.1,61.35,8.9,0,0,0,0,0,0,0.608798818950208,170.355420188812,77.5229328240828
8.7,"random_instances_SVM","SVM",63,24,1412,1277,135,2500,2239,261,0.926967763050248,0.633333333333333,1.76723844441535,532,260,272,32,1,63.91,8.6,0,0,0,0,0,0,0.592909593314344,154.561099030721,75.6033444368224
8.7,"random_instances_SVM","SVM",63,25,1312,1186,126,2600,2330,270,0.927453226422308,0.628571428571429,1.7737416217637,554,270,284,22,1.1,66.46,8.6,0,0,0,0,0,0,0.577820914154364,148.36922286352,74.66192577666
8.7,"random_instances_SVM","SVM",63,26,1212,1095,117,2700,2421,279,0.928118693067157,0.638095238095238,1.7737416217637,572,279,293,18,1.1,69.02,8.7,0,0,0,0,0,0,0.576307660531687,139.873801727078,75.4610976252673
8.7,"random_instances_SVM","SVM",63,27,1112,1005,107,2800,2511,289,0.928992799869099,0.638095238095238,1.77211134453782,591,289,302,19,1,71.57,8.7,0,0,0,0,0,0,0.588112285598093,132.917004423311,77.0474847853189
8.7,"random_instances_SVM","SVM",63,28,1012,914,98,2900,2602,298,0.930179185076102,0.657142857142857,1.77537490134175,619,298,321,28,1.1,74.13,8.7,0,0,0,0,0,0,0.492150882479134,116.176610449376,72.7270155738276
8.7,"random_instances_SVM","SVM",63,29,912,820,92,3000,2696,304,0.929973272241322,0.657142857142857,1.77537490134175,627,304,323,8,1.1,76.69,8.9,0,0,0,0,0,0,0.43653023897104,105.746600369126,71.7795006752296
8.7,"random_instances_SVM","SVM",63,30,812,732,80,3100,2784,316,0.930636011563857,0.657142857142857,1.7770111915734,651,316,335,24,1.1,79.24,8.8,0,0,0,0,0,0,0.329911799849305,92.9194372239296,66.3537870683857
8.7,"random_instances_SVM","SVM",63,31,712,635,77,3200,2881,319,0.930401461844768,0.661904761904762,1.7737416217637,663,319,344,12,1.1,81.8,9,0,0,0,0,0,0,0.280643774167252,84.0402070454866,63.7876830603782
8.7,"random_instances_SVM","SVM",63,32,612,549,63,3300,2967,333,0.931155566464855,0.661904761904762,1.77537490134175,688,333,355,25,1.1,84.36,8.9,0,0,0,0,0,0,0.235889177394692,76.1613062619206,62.4101695829444
8.7,"random_instances_SVM","SVM",63,33,512,457,55,3400,3059,341,0.930914198439982,0.666666666666667,1.7737416217637,701,341,360,13,1.1,86.91,9,0,0,0,0,0,0,0.123384734532107,61.7183178331105,53.0563698476346
8.7,"random_instances_SVM","SVM",63,34,412,364,48,3500,3152,348,0.930371461299308,0.657142857142857,1.77048406139315,721,348,373,20,1.1,89.47,9.1,0,0,0,0,0,0,0.0922109934353776,52.1221117393735,46.3058841314371
8.7,"random_instances_SVM","SVM",63,35,312,282,30,3600,3234,366,0.930491463481169,0.661904761904762,1.7770111915734,749,364,385,28,1.1,92.02,8.8,0,0,0,0,0,0,0.0521939925969676,35.6885390951029,33.6640855972297
8.7,"random_instances_SVM","SVM",63,36,212,194,18,3700,3322,378,0.931004200076381,0.652380952380952,1.7770111915734,769,376,393,20,1,94.58,8.8,0,0,0,0,0,0,0.0159077976257634,25.5172063999335,25.1110459722365
8.7,"random_instances_SVM","SVM",63,37,112,101,11,3800,3415,385,0.931076474117728,0.661904761904762,1.77537490134175,788,383,405,19,1.1,97.14,8.9,0,0,0,0,0,0,0.000871488205352576,13.6368878425885,13.6336104890434
8.7,"random_instances_SVM","SVM",63,38,12,10,2,3900,3506,394,0.931244204440096,0.657142857142857,1.7737416217637,811,392,419,23,1.1,99.69,8.9,0,0,0,0,0,0,0.00292383711049801,2.35485389717603,2.35485389717603
8.7,"random_instances_SVM","SVM",63,39,0,0,0,3912,3516,396,0.931116020291293,0.657142857142857,1.77048406139315,815,394,421,4,1.1,100,8.9,0,0,0,0,0,0,0,0,0
8.7,"random_instances_SVM","SVM",64,0,3812,3415,397,100,85,15,0.901570380425259,0.541237113402062,1.74700935911445,37,15,22,0,1.5,2.56,5.7,0,0,0,0,0,0,0.299161710392923,469.447952311288,32.84948517805
8.7,"random_instances_SVM","SVM",64,1,3712,3331,381,200,169,31,0.914998186222317,0.56701030927835,1.72524397993152,70,31,39,33,1.3,5.11,5.5,0,0,0,0,0,0,0.515012408281316,506.696565671223,55.448339247814
8.7,"random_instances_SVM","SVM",64,2,3612,3241,371,300,259,41,0.922551692664144,0.587628865979381,1.72207548777371,95,41,54,25,1.3,7.67,6.3,0,0,0,0,0,0,0.660683307844985,480.790195680108,72.3423068664135
8.7,"random_instances_SVM","SVM",64,3,3512,3152,360,400,348,52,0.931872169629192,0.608247422680412,1.76512610203445,115,52,63,20,1.2,10.22,6.7,0,0,0,0,0,0,0.586945846086855,415.915320216594,66.2442804017681
8.7,"random_instances_SVM","SVM",64,4,3412,3063,349,500,437,63,0.930457715576249,0.61340206185567,1.76072619769557,141,63,78,26,1.2,12.78,6.9,0,0,0,0,0,0,0.701951183257612,426.953554753191,78.5499442844189
8.7,"random_instances_SVM","SVM",64,5,3312,2974,338,600,526,74,0.931402635243462,0.608247422680412,1.76396878737825,164,74,90,23,1.2,15.34,7.1,0,0,0,0,0,0,0.520058054007232,371.429954156682,58.9344092106313
8.7,"random_instances_SVM","SVM",64,6,3212,2886,326,700,614,86,0.93174344992219,0.608247422680412,1.75106956407019,192,86,106,28,1.2,17.89,7.1,0,0,0,0,0,0,0.744296512204642,414.365249139697,80.1618080714239
8.7,"random_instances_SVM","SVM",64,7,3112,2794,318,800,706,94,0.931070596908403,0.603092783505155,1.76674548377944,212,94,118,20,1.3,20.45,7.5,0,0,0,0,0,0,0.707736064097059,367.008227044499,79.764617640894
8.7,"random_instances_SVM","SVM",64,8,3012,2700,312,900,800,100,0.931108627730911,0.618556701030928,1.73581058117141,222,100,122,10,1.2,23.01,8,0,0,0,0,0,0,0.538243248998312,315.133526244621,64.8558667191569
8.7,"random_instances_SVM","SVM",64,9,2912,2608,304,1000,892,108,0.929916507717342,0.608247422680412,1.74824553106971,235,108,127,13,1.2,25.56,8.3,0,0,0,0,0,0,0.745474311791063,327.44730671937,85.9242399275383
8.7,"random_instances_SVM","SVM",64,10,2812,2518,294,1100,982,118,0.92949085504992,0.618556701030928,1.75468474112889,260,118,142,25,1.2,28.12,8.3,0,0,0,0,0,0,0.757633986177841,306.565983948122,86.3563440043061
8.7,"random_instances_SVM","SVM",64,11,2712,2429,283,1200,1071,129,0.932379734837427,0.634020618556701,1.7514592177077,280,129,151,20,1.2,30.67,8.3,0,0,0,0,0,0,0.667237682465853,289.184254827057,78.9645064272367
8.7,"random_instances_SVM","SVM",64,12,2612,2334,278,1300,1166,134,0.928882361889614,0.61340206185567,1.74985089886683,301,134,167,21,1.2,33.23,8.7,0,0,0,0,0,0,0.724016429457329,293.123548100082,83.8463155552717
8.7,"random_instances_SVM","SVM",64,13,2512,2247,265,1400,1253,147,0.92911932316838,0.61340206185567,1.75468474112889,322,147,175,21,1.2,35.79,8.5,0,0,0,0,0,0,0.723358885187915,290.209639435822,84.0355342326346
8.7,"random_instances_SVM","SVM",64,14,2412,2156,256,1500,1344,156,0.929894566858191,0.628865979381443,1.75468474112889,336,156,180,14,1.2,38.34,8.6,0,0,0,0,0,0,0.704692284570396,265.265224386718,82.6557610740809
8.7,"random_instances_SVM","SVM",64,15,2312,2069,243,1600,1431,169,0.932315374983925,0.628865979381443,1.74540069487954,364,169,195,28,1.2,40.9,8.5,0,0,0,0,0,0,0.740102161820789,264.121677222335,85.8081707986645
8.7,"random_instances_SVM","SVM",64,16,2212,1975,237,1700,1525,175,0.932754192166842,0.634020618556701,1.74219223771983,377,175,202,13,1.2,43.46,8.7,0,0,0,0,0,0,0.749714129286029,259.403409853711,85.8987809944707
8.7,"random_instances_SVM","SVM",64,17,2112,1885,227,1800,1615,185,0.933124261324433,0.628865979381443,1.74700935911445,397,185,212,20,1.1,46.01,8.7,0,0,0,0,0,0,0.717487346791461,251.722605534534,84.5334095330477
8.7,"random_instances_SVM","SVM",64,18,2012,1796,216,1900,1704,196,0.931292930947729,0.628865979381443,1.74700935911445,417,196,221,20,1.1,48.57,8.7,0,0,0,0,0,0,0.746768414339505,243.554638850282,87.7170843700667
8.7,"random_instances_SVM","SVM",64,19,1912,1710,202,2000,1790,210,0.932256866026195,0.634020618556701,1.74219223771983,444,210,234,27,1.1,51.12,8.5,0,0,0,0,0,0,0.614108808645801,215.88424658124,75.7989021441961
8.7,"random_instances_SVM","SVM",64,20,1812,1626,186,2100,1874,226,0.934853201025081,0.65979381443299,1.74985089886683,472,226,246,28,1.1,53.68,8.3,0,0,0,0,0,0,0.691307809400071,204.29181891974,83.5128846022187
8.7,"random_instances_SVM","SVM",64,21,1712,1533,179,2200,1967,233,0.93373275448472,0.634020618556701,1.76234600100532,487,233,254,15,1.1,56.24,8.4,0,0,0,0,0,0,0.695624086286963,195.342482922708,84.5943485300587
8.7,"random_instances_SVM","SVM",64,22,1612,1443,169,2300,2057,243,0.93368302187066,0.649484536082474,1.76559456506247,513,243,270,26,1.1,58.79,8.5,0,0,0,0,0,0,0.656160457904812,182.759636749241,83.7039382313202
8.7,"random_instances_SVM","SVM",64,23,1512,1352,160,2400,2148,252,0.931600102975781,0.644329896907217,1.75307049573687,539,252,287,26,1.1,61.35,8.5,0,0,0,0,0,0,0.582001416426381,167.401557253611,78.6094049157793
8.7,"random_instances_SVM","SVM",64,24,1412,1267,145,2500,2233,267,0.933548451267903,0.654639175257732,1.76234600100532,561,267,294,22,1.1,63.91,8.4,0,0,0,0,0,0,0.573040579140907,156.04088317299,80.4689215926986
8.7,"random_instances_SVM","SVM",64,25,1312,1175,137,2600,2325,275,0.932735176755575,0.654639175257732,1.76234600100532,576,275,301,15,1.1,66.46,8.5,0,0,0,0,0,0,0.52916881879093,142.976127237799,78.5805659065779
8.7,"random_instances_SVM","SVM",64,26,1212,1085,127,2700,2415,285,0.93430175409857,0.654639175257732,1.76072619769557,595,285,310,19,1.1,69.02,8.5,0,0,0,0,0,0,0.522130703216938,136.112058878828,77.4263840630039
8.7,"random_instances_SVM","SVM",64,27,1112,1002,110,2800,2498,302,0.936182817089312,0.649484536082474,1.75468474112889,628,302,326,33,1.1,71.57,8.3,0,0,0,0,0,0,0.519581882625823,124.522174563412,77.7766691757123
8.7,"random_instances_SVM","SVM",64,28,1012,912,100,2900,2588,312,0.93567817732896,0.65979381443299,1.76072619769557,652,312,340,24,1.1,74.13,8.3,0,0,0,0,0,0,0.459967713884308,108.984972178393,73.1459870801236
8.7,"random_instances_SVM","SVM",64,29,912,825,87,3000,2675,325,0.934888306399722,0.649484536082474,1.74985089886683,676,325,351,24,1.1,76.69,8.2,0,0,0,0,0,0,0.344850938880713,95.1889697527841,66.2070506242019
8.7,"random_instances_SVM","SVM",64,30,812,732,80,3100,2768,332,0.935075535064433,0.65979381443299,1.75630196208846,687,332,355,11,1.1,79.24,8.3,0,0,0,0,0,0,0.28344462393049,84.6599218629112,61.1779665451014
8.7,"random_instances_SVM","SVM",64,31,712,644,68,3200,2856,344,0.935844927858472,0.654639175257732,1.77488716803649,711,344,367,24,1.1,81.8,8.3,0,0,0,0,0,0,0.240285628165375,77.2194865709982,61.146960798314
8.7,"random_instances_SVM","SVM",64,32,612,552,60,3300,2948,352,0.935607966579698,0.65979381443299,1.75910936923121,721,352,369,10,1,84.36,8.4,0,0,0,0,0,0,0.179027960161187,65.2067029622076,54.5727402230258
8.7,"random_instances_SVM","SVM",64,33,512,462,50,3400,3038,362,0.93626911780195,0.664948453608247,1.76072619769557,740,362,378,19,1,86.91,8.4,0,0,0,0,0,0,0.102262126823079,57.6312503509727,49.3359996603456
8.7,"random_instances_SVM","SVM",64,34,412,373,39,3500,3127,373,0.937181857542399,0.65979381443299,1.76072619769557,764,373,391,24,1,89.47,8.4,0,0,0,0,0,0,0.0766437689350968,48.3641242740792,42.8307176861402
8.7,"random_instances_SVM","SVM",64,35,312,284,28,3600,3216,384,0.937366160759224,0.65979381443299,1.76072619769557,789,384,405,25,1.1,92.02,8.4,0,0,0,0,0,0,0.0581131003635941,37.4106379340039,34.8244289936381
8.7,"random_instances_SVM","SVM",64,36,212,192,20,3700,3308,392,0.93655873714267,0.649484536082474,1.76234600100532,802,391,411,13,1.1,94.58,8.4,0,0,0,0,0,0,0.0255708302735113,25.7913173200579,25.2423008852771
8.7,"random_instances_SVM","SVM",64,37,112,99,13,3800,3401,399,0.935950243982361,0.644329896907217,1.74985089886683,817,397,420,15,1.1,97.14,8.5,0,0,0,0,0,0,0.00140534289966572,15.1492089097827,15.1413487201194
8.7,"random_instances_SVM","SVM",64,38,12,10,2,3900,3490,410,0.935388557988237,0.644329896907217,1.75749550742457,833,406,427,16,1.1,99.69,8.5,0,0,0,0,0,0,0.000133723053544846,1.84805288317768,1.84805288317768
8.7,"random_instances_SVM","SVM",64,39,0,0,0,3912,3500,412,0.935610892027582,0.644329896907217,1.75427665118387,836,407,429,3,1.1,100,8.5,0,0,0,0,0,0,0,0,0
8.7,"random_instances_SVM","SVM",65,0,3812,3425,387,100,88,12,0.892628776139863,0.51207729468599,1.72438389100381,32,12,20,0,1.7,2.56,7.3,0,0,0,0,0,0,0.330568169579672,399.805860686291,35.6145341340338
8.7,"random_instances_SVM","SVM",65,1,3712,3341,371,200,172,28,0.91855387343493,0.570048309178744,1.77878920961925,59,28,31,27,1.1,5.11,6.1,0,0,0,0,0,0,0.758485996219966,555.22005459138,79.4450515858729
8.7,"random_instances_SVM","SVM",65,2,3612,3256,356,300,257,43,0.927297309988041,0.579710144927536,1.79120879120879,90,43,47,31,1.1,7.67,6,0,0,0,0,0,0,0.744292990687183,492.988443281209,79.632209712
8.7,"random_instances_SVM","SVM",65,3,3512,3164,348,400,349,51,0.935263214590541,0.603864734299517,1.78370299196626,112,51,61,22,1.2,10.22,6.8,0,0,0,0,0,0,0.64356817823399,442.708828038442,72.094740027119
8.7,"random_instances_SVM","SVM",65,4,3412,3069,343,500,444,56,0.937101394033314,0.603864734299517,1.7820620508513,125,56,69,13,1.2,12.78,7.9,0,0,0,0,0,0,0.557665956580622,379.627922005395,64.0944869261695
8.7,"random_instances_SVM","SVM",65,5,3312,2984,328,600,529,71,0.943751156630583,0.599033816425121,1.78255560864257,154,71,83,29,1.2,15.34,7.5,0,0,0,0,0,0,0.522962091104236,363.409105446561,60.4182243078333
8.7,"random_instances_SVM","SVM",65,6,3212,2890,322,700,623,77,0.944092276331835,0.589371980676328,1.78255560864257,171,77,94,17,1.2,17.89,8.1,0,0,0,0,0,0,0.604933825214214,340.313159595675,71.077797252009
8.7,"random_instances_SVM","SVM",65,7,3112,2803,309,800,710,90,0.942636648132971,0.613526570048309,1.79075503646521,197,90,107,26,1.2,20.45,7.9,0,0,0,0,0,0,0.665014275651596,342.608816255794,75.6448273584376
8.7,"random_instances_SVM","SVM",65,8,3012,2707,305,900,806,94,0.942294147380298,0.608695652173913,1.794055967408,212,94,118,15,1.3,23.01,8.6,0,0,0,0,0,0,0.698529589722889,321.717039734767,81.2181930616403
8.7,"random_instances_SVM","SVM",65,9,2912,2611,301,1000,902,98,0.941697533165964,0.623188405797101,1.794055967408,224,98,126,12,1.3,25.56,9.2,0,0,0,0,0,0,0.605012030013083,284.535934412226,72.7043022009673
8.7,"random_instances_SVM","SVM",65,10,2812,2523,289,1100,990,110,0.937554378899758,0.603864734299517,1.78418948179439,246,110,136,22,1.2,28.12,9,0,0,0,0,0,0,0.626531359001993,275.049307379239,76.4220477695659
8.7,"random_instances_SVM","SVM",65,11,2712,2441,271,1200,1072,128,0.940918620163918,0.618357487922705,1.79075503646521,280,128,152,34,1.2,30.67,8.4,0,0,0,0,0,0,0.588415141587302,280.806507201399,69.0990806836082
8.7,"random_instances_SVM","SVM",65,12,2612,2349,263,1300,1164,136,0.940719748759142,0.608695652173913,1.79075503646521,294,136,158,14,1.2,33.23,8.6,0,0,0,0,0,0,0.728281837101456,279.484083553568,82.4233466222862
8.7,"random_instances_SVM","SVM",65,13,2512,2257,255,1400,1256,144,0.940692127730699,0.618357487922705,1.79075503646521,312,144,168,18,1.2,35.79,8.7,0,0,0,0,0,0,0.720813270046625,270.380754266163,81.9020450063209
8.7,"random_instances_SVM","SVM",65,14,2412,2168,244,1500,1345,155,0.943393464312267,0.628019323671498,1.794055967408,330,155,175,18,1.1,38.34,8.7,0,0,0,0,0,0,0.660607882950289,255.584045400246,77.7525841526913
8.7,"random_instances_SVM","SVM",65,15,2312,2070,242,1600,1443,157,0.944774515734335,0.623188405797101,1.78746623015398,335,157,178,5,1.1,40.9,9.2,0,0,0,0,0,0,0.726929625110074,244.689372433307,83.6572929237642
8.7,"random_instances_SVM","SVM",65,16,2212,1983,229,1700,1530,170,0.943213927627396,0.628019323671498,1.77929682325199,359,170,189,24,1.1,43.46,9,0,0,0,0,0,0,0.705060466935374,231.872280743439,81.9947274096752
8.7,"random_instances_SVM","SVM",65,17,2112,1889,223,1800,1624,176,0.943379653798042,0.613526570048309,1.79075503646521,375,176,199,16,1.1,46.01,9.2,0,0,0,0,0,0,0.671190982575233,216.505008633492,81.0299650797332
8.7,"random_instances_SVM","SVM",65,18,2012,1799,213,1900,1714,186,0.942788563789399,0.608695652173913,1.79075503646521,395,186,209,20,1.1,48.57,9.2,0,0,0,0,0,0,0.649973370027324,204.282295433261,79.5909057343802
8.7,"random_instances_SVM","SVM",65,19,1912,1708,204,2000,1805,195,0.941730678400096,0.613526570048309,1.79075503646521,415,195,220,20,1.1,51.12,9.3,0,0,0,0,0,0,0.568729506271259,190.635184805213,71.2522919514905
8.7,"random_instances_SVM","SVM",65,20,1812,1613,199,2100,1900,200,0.943224976038772,0.608695652173913,1.79075503646521,417,200,217,2,1.1,53.68,9.5,0,0,0,0,0,0,0.594464691714435,176.383359431927,76.6276433032741
8.7,"random_instances_SVM","SVM",65,21,1712,1519,193,2200,1994,206,0.943393464312266,0.613526570048309,1.78255560864257,434,206,228,17,1.1,56.24,9.7,0,0,0,0,0,0,0.579909346486302,168.226529031217,75.3607826236506
8.7,"random_instances_SVM","SVM",65,22,1612,1428,184,2300,2085,215,0.945061774430116,0.613526570048309,1.78255560864257,449,215,234,15,1.1,58.79,9.7,0,0,0,0,0,0,0.535849934277127,153.7254089108,72.3937408522902
8.7,"random_instances_SVM","SVM",65,23,1512,1343,169,2400,2170,230,0.946075466173918,0.623188405797101,1.78910912190963,480,230,250,31,1.1,61.35,9.4,0,0,0,0,0,0,0.561994339621359,153.067564640461,74.900327262732
8.7,"random_instances_SVM","SVM",65,24,1412,1253,159,2500,2260,240,0.946310244915667,0.618357487922705,1.79075503646521,502,240,262,22,1.1,63.91,9.4,0,0,0,0,0,0,0.553353879216279,143.614346874589,73.0871393472867
8.7,"random_instances_SVM","SVM",65,25,1312,1162,150,2600,2351,249,0.9474951870358,0.628019323671498,1.79449541284404,526,249,277,24,1.1,66.46,9.4,0,0,0,0,0,0,0.519680020882228,132.383372715468,71.532191872007
8.7,"random_instances_SVM","SVM",65,26,1212,1078,134,2700,2435,265,0.949065442502694,0.628019323671498,1.80110497237569,549,265,284,23,1.1,69.02,9.2,0,0,0,0,0,0,0.491415523429582,121.777700733586,69.7709128090897
8.7,"random_instances_SVM","SVM",65,27,1112,988,124,2800,2525,275,0.949269838113158,0.63768115942029,1.80110497237569,574,275,299,25,1.1,71.57,9.2,0,0,0,0,0,0,0.428179137800233,112.310667754537,67.9200041483999
8.7,"random_instances_SVM","SVM",65,28,1012,902,110,2900,2611,289,0.947727203674708,0.628019323671498,1.79944802207912,593,289,304,19,1.1,74.13,9,0,0,0,0,0,0,0.415046929696689,104.124170104727,68.7061642413934
8.7,"random_instances_SVM","SVM",65,29,912,813,99,3000,2700,300,0.947826639377096,0.642512077294686,1.80276497695853,620,300,320,27,1.1,76.69,9,0,0,0,0,0,0,0.343974419848103,92.4938405390971,65.5715696137125
8.7,"random_instances_SVM","SVM",65,30,812,724,88,3100,2789,311,0.945373892051502,0.63768115942029,1.80276497695853,641,311,330,21,1.1,79.24,9,0,0,0,0,0,0,0.297021536620486,83.8708677586081,61.7027140451344
8.7,"random_instances_SVM","SVM",65,31,712,635,77,3200,2878,322,0.946263289167312,0.63768115942029,1.80110497237569,660,322,338,19,1,81.8,8.9,0,0,0,0,0,0,0.262054421799971,75.0992724060258,58.7452558285241
8.7,"random_instances_SVM","SVM",65,32,612,547,65,3300,2966,334,0.947663675309289,0.628019323671498,1.80276497695853,685,334,351,25,1.1,84.36,8.9,0,0,0,0,0,0,0.224205636616874,69.1484626236932,56.0606759219387
8.7,"random_instances_SVM","SVM",65,33,512,459,53,3400,3054,346,0.948981198365946,0.628019323671498,1.79449541284404,711,346,365,26,1.1,86.91,8.8,0,0,0,0,0,0,0.154627154657689,58.5733453915357,49.4562818685335
8.7,"random_instances_SVM","SVM",65,34,412,374,38,3500,3139,361,0.948768516446946,0.628019323671498,1.79779411764706,748,361,387,37,1.1,89.47,8.7,0,0,0,0,0,0,0.0803033935832886,44.8258918222875,40.049223253949
8.7,"random_instances_SVM","SVM",65,35,312,285,27,3600,3228,372,0.951502998262643,0.647342995169082,1.79944802207912,765,371,394,17,1.1,92.02,8.7,0,0,0,0,0,0,0.0498269293178197,35.8494375469214,33.6277867505994
8.7,"random_instances_SVM","SVM",65,36,212,200,12,3700,3313,387,0.95120745325832,0.632850241545894,1.79614325068871,792,385,407,27,1.1,94.58,8.6,0,0,0,0,0,0,0.0165840270471168,21.6004424120198,21.0694654423382
8.7,"random_instances_SVM","SVM",65,37,112,105,7,3800,3408,392,0.951704631770263,0.63768115942029,1.79614325068871,800,390,410,8,1.1,97.14,8.7,0,0,0,0,0,0,0.00133838734287634,12.1725649220914,12.1636663115782
8.7,"random_instances_SVM","SVM",65,38,12,10,2,3900,3503,397,0.951011343956385,0.642512077294686,1.78956999085087,812,397,415,12,1,99.69,8.8,0,0,0,0,0,0,0.000657968857321803,0.473082984893789,0.473082984893789
8.7,"random_instances_SVM","SVM",65,39,0,0,0,3912,3513,399,0.951157735407124,0.63768115942029,1.80276497695853,817,399,418,5,1,100,8.8,0,0,0,0,0,0,0,0,0
8.7,"random_instances_SVM","SVM",66,0,3812,3404,408,100,94,6,0.901080050075587,0.541666666666667,1.73703917050691,20,6,14,0,2.3,2.56,15.7,0,0,0,0,0,0,0.164782213421215,256.544012523125,18.5143926293423
8.7,"random_instances_SVM","SVM",66,1,3712,3320,392,200,178,22,0.922125968442936,0.583333333333333,1.77459677419355,48,22,26,28,1.2,5.11,8.1,0,0,0,0,0,0,0.839063781334732,448.105504696863,87.9058147291638
8.7,"random_instances_SVM","SVM",66,2,3612,3226,386,300,272,28,0.91914239654195,0.578125,1.74456272893773,63,28,35,15,1.2,7.67,9.7,0,0,0,0,0,0,0.610362614738626,331.026530570943,68.9417708653576
8.7,"random_instances_SVM","SVM",66,3,3512,3133,379,400,365,35,0.919481942082393,0.59375,1.75420119705341,80,35,45,17,1.3,10.22,10.4,0,0,0,0,0,0,0.71200013734072,329.664309593197,78.4134120254052
8.7,"random_instances_SVM","SVM",66,4,3412,3044,368,500,454,46,0.917012117346941,0.583333333333333,1.74936868686869,101,46,55,21,1.2,12.78,9.9,0,0,0,0,0,0,0.585751721331287,321.396841496549,65.3669675698669
8.7,"random_instances_SVM","SVM",66,5,3312,2957,355,600,541,59,0.922468466553288,0.598958333333333,1.75872359963269,132,59,73,31,1.2,15.34,9.2,0,0,0,0,0,0,0.641284355221568,349.299907515758,70.8976212215355
8.7,"random_instances_SVM","SVM",66,6,3212,2867,345,700,631,69,0.928394274376425,0.609375,1.77459677419355,152,69,83,20,1.2,17.89,9.1,0,0,0,0,0,0,0.616759676832125,311.317395665973,70.6808890831148
8.7,"random_instances_SVM","SVM",66,7,3112,2777,335,800,721,79,0.921812996031761,0.604166666666667,1.7509765625,175,79,96,23,1.2,20.45,9.1,0,0,0,0,0,0,0.607481319678788,297.708887825126,71.8352659767709
8.7,"random_instances_SVM","SVM",66,8,3012,2683,329,900,815,85,0.919822963907791,0.598958333333333,1.76520737327189,185,85,100,10,1.2,23.01,9.6,0,0,0,0,0,0,0.651470608841157,279.125412334377,76.5012655966368
8.7,"random_instances_SVM","SVM",66,9,2912,2590,322,1000,908,92,0.924806901927456,0.604166666666667,1.76520737327189,201,92,109,16,1.2,25.56,9.9,0,0,0,0,0,0,0.492776556132719,249.990373475586,61.7211582177754
8.7,"random_instances_SVM","SVM",66,10,2812,2500,312,1100,998,102,0.92625218490176,0.598958333333333,1.77296270718232,221,102,119,20,1.2,28.12,9.8,0,0,0,0,0,0,0.627374171945677,282.866939908243,74.8633139565805
8.7,"random_instances_SVM","SVM",66,11,2712,2411,301,1200,1087,113,0.927549839380216,0.604166666666667,1.78398617511521,241,113,128,20,1.1,30.67,9.6,0,0,0,0,0,0,0.629479441875515,264.778305818354,74.6353910454389
8.7,"random_instances_SVM","SVM",66,12,2612,2321,291,1300,1177,123,0.928840112433881,0.619791666666667,1.78070377184913,260,123,137,19,1.1,33.23,9.6,0,0,0,0,0,0,0.647283237639636,258.065157649698,76.8304989224262
8.7,"random_instances_SVM","SVM",66,13,2512,2232,280,1400,1266,134,0.929061555177647,0.625,1.78070377184913,285,134,151,25,1.1,35.79,9.4,0,0,0,0,0,0,0.592352724927444,242.937097608943,71.60636387851
8.7,"random_instances_SVM","SVM",66,14,2412,2145,267,1500,1353,147,0.930523077286487,0.609375,1.78070377184913,310,147,163,25,1.1,38.34,9.2,0,0,0,0,0,0,0.672624516922127,247.033885693519,79.4457202592131
8.7,"random_instances_SVM","SVM",66,15,2312,2058,254,1600,1440,160,0.931193310657616,0.614583333333333,1.78070377184913,333,160,173,23,1.1,40.9,9,0,0,0,0,0,0,0.703134965425989,245.512880548771,81.2904125090448
8.7,"random_instances_SVM","SVM",66,16,2212,1967,245,1700,1531,169,0.933700042517023,0.619791666666667,1.78070377184913,350,169,181,17,1.1,43.46,9.1,0,0,0,0,0,0,0.712172135051554,239.483282543929,82.0585141512716
8.7,"random_instances_SVM","SVM",66,17,2112,1877,235,1800,1621,179,0.931839923469408,0.619791666666667,1.78398617511521,375,179,196,25,1.1,46.01,9.1,0,0,0,0,0,0,0.687947442505712,234.835216820179,81.929506711402
8.7,"random_instances_SVM","SVM",66,18,2012,1786,226,1900,1712,188,0.933537651171596,0.635416666666667,1.78398617511521,394,188,206,19,1.1,48.57,9.1,0,0,0,0,0,0,0.670040558664796,224.463904544901,80.7000151110444
8.7,"random_instances_SVM","SVM",66,19,1912,1697,215,2000,1801,199,0.934922406462597,0.630208333333333,1.77906709558824,413,199,214,19,1.1,51.12,9.1,0,0,0,0,0,0,0.71103665234777,222.352063915225,84.0019503048344
8.7,"random_instances_SVM","SVM",66,20,1812,1605,207,2100,1893,207,0.934782159391546,0.630208333333333,1.77906709558824,429,207,222,16,1.1,53.68,9.1,0,0,0,0,0,0,0.661207952383579,204.433381302824,79.8767412822834
8.7,"random_instances_SVM","SVM",66,21,1712,1517,195,2200,1981,219,0.934922406462594,0.630208333333333,1.78070377184913,455,219,236,26,1.1,56.24,9,0,0,0,0,0,0,0.694826865380702,195.822451453839,84.1975265378278
8.7,"random_instances_SVM","SVM",66,22,1612,1425,187,2300,2073,227,0.936454790249442,0.640625,1.78234346224678,470,227,243,15,1.1,58.79,9.1,0,0,0,0,0,0,0.691463094371901,188.549195024202,84.8341548550784
8.7,"random_instances_SVM","SVM",66,23,1512,1333,179,2400,2165,235,0.936410501700692,0.640625,1.77906709558824,485,235,250,15,1.1,61.35,9.2,0,0,0,0,0,0,0.639523195419957,170.065951237234,80.2291281582908
8.7,"random_instances_SVM","SVM",66,24,1412,1245,167,2500,2253,247,0.934842687074844,0.640625,1.78234346224678,511,247,264,26,1.1,63.91,9.1,0,0,0,0,0,0,0.617091062208411,160.163060532308,79.1460115417565
8.7,"random_instances_SVM","SVM",66,25,1312,1158,154,2600,2340,260,0.934860402494344,0.635416666666667,1.78398617511521,535,260,275,24,1.1,66.46,9,0,0,0,0,0,0,0.646044691681553,153.917951820002,81.920751400669
8.7,"random_instances_SVM","SVM",66,26,1212,1070,142,2700,2428,272,0.933927390400621,0.630208333333333,1.77580275229358,560,272,288,25,1.1,69.02,8.9,0,0,0,0,0,0,0.592859521862302,139.441503079341,80.3792523779184
8.7,"random_instances_SVM","SVM",66,27,1112,982,130,2800,2516,284,0.934278746220726,0.640625,1.78070377184913,587,284,303,27,1.1,71.57,8.9,0,0,0,0,0,0,0.522954776104076,128.366770572383,76.6910561120995
8.7,"random_instances_SVM","SVM",66,28,1012,892,120,2900,2606,294,0.934625673185954,0.635416666666667,1.77906709558824,608,294,314,21,1.1,74.13,8.9,0,0,0,0,0,0,0.508702970612942,119.9893423066,75.9328634231233
8.7,"random_instances_SVM","SVM",66,29,912,805,107,3000,2693,307,0.935769794028738,0.645833333333333,1.7774334251607,627,307,320,19,1,76.69,8.8,0,0,0,0,0,0,0.431745384699022,106.017631110711,72.9226575454068
8.7,"random_instances_SVM","SVM",66,30,812,723,89,3100,2775,325,0.935855418556328,0.640625,1.78234346224678,668,325,343,41,1.1,79.24,8.5,0,0,0,0,0,0,0.347396033200339,94.0219738851269,69.3059027478738
8.7,"random_instances_SVM","SVM",66,31,712,633,79,3200,2865,335,0.936073908730174,0.645833333333333,1.78070377184913,681,334,347,13,1,81.8,8.6,0,0,0,0,0,0,0.268315212582085,81.7555010170946,64.2063655709616
8.7,"random_instances_SVM","SVM",66,32,612,542,70,3300,2956,344,0.935926280234332,0.635416666666667,1.77580275229358,701,343,358,20,1,84.36,8.6,0,0,0,0,0,0,0.202874279499872,73.9310806694352,59.5076688439988
8.7,"random_instances_SVM","SVM",66,33,512,456,56,3400,3042,358,0.936726426681798,0.630208333333333,1.78234346224678,729,356,373,28,1,86.91,8.5,0,0,0,0,0,0,0.12378410269054,60.406826587667,51.1837625983307
8.7,"random_instances_SVM","SVM",66,34,412,362,50,3500,3136,364,0.937313988095254,0.630208333333333,1.77255036630037,744,363,381,15,1,89.47,8.6,0,0,0,0,0,0,0.0971172904743998,50.872593816666,44.5393107987595
8.7,"random_instances_SVM","SVM",66,35,312,277,35,3600,3221,379,0.937579719387773,0.645833333333333,1.78398617511521,777,378,399,33,1.1,92.02,8.5,0,0,0,0,0,0,0.0612267863087676,36.0171220062025,33.3949766575548
8.7,"random_instances_SVM","SVM",66,36,212,187,25,3700,3311,389,0.938087561413472,0.640625,1.77417506874427,798,387,411,21,1.1,94.58,8.5,0,0,0,0,0,0,0.0159848674653646,25.7657377801324,25.4018378117361
8.7,"random_instances_SVM","SVM",66,37,112,95,17,3800,3403,397,0.938316385582028,0.645833333333333,1.78234346224678,813,396,417,15,1.1,97.14,8.6,0,0,0,0,0,0,0.000830574637437129,16.078979179325,16.0749333320929
8.7,"random_instances_SVM","SVM",66,38,12,11,1,3900,3487,413,0.93837986583524,0.645833333333333,1.78398617511521,838,409,429,25,1,99.69,8.4,0,0,0,0,0,0,0.000255269556512357,0.448117168878449,0.448117168878449
8.7,"random_instances_SVM","SVM",66,39,0,0,0,3912,3498,414,0.938409391534409,0.645833333333333,1.78398617511521,837,410,427,-1,1,100,8.4,0,0,0,0,0,0,0,0,0
8.7,"random_instances_SVM","SVM",67,0,3812,3414,398,100,87,13,0.856905313123366,0.420512820512821,1.68258064516129,42,13,29,0,2.2,2.56,6.7,0,0,0,0,0,0,0.167666471854909,507.1664596909,18.1653596490019
8.7,"random_instances_SVM","SVM",67,1,3712,3330,382,200,171,29,0.920904497735845,0.6,1.7641592293526,72,29,43,30,1.5,5.11,5.9,0,0,0,0,0,0,0.405225980368775,477.086568151318,46.4531808207692
8.7,"random_instances_SVM","SVM",67,2,3612,3240,372,300,261,39,0.924288355974905,0.635897435897436,1.75607417330607,90,39,51,18,1.3,7.67,6.7,0,0,0,0,0,0,0.482343170243188,448.370907703455,53.5610535652722
8.7,"random_instances_SVM","SVM",67,3,3512,3148,364,400,353,47,0.92920397792628,0.620512820512821,1.76526827892547,109,47,62,19,1.3,10.22,7.5,0,0,0,0,0,0,0.640294738764526,430.433070438059,70.7433548274039
8.7,"random_instances_SVM","SVM",67,4,3412,3059,353,500,442,58,0.93145648597095,0.625641025641026,1.75401429171921,126,58,68,17,1.2,12.78,7.6,0,0,0,0,0,0,0.508452005130792,387.922842569709,57.7645709565408
8.7,"random_instances_SVM","SVM",67,5,3312,2969,343,600,532,68,0.935834825783719,0.625641025641026,1.76688779110797,150,68,82,24,1.2,15.34,7.8,0,0,0,0,0,0,0.611394607747038,374.933181826287,67.678747240923
8.7,"random_instances_SVM","SVM",67,6,3212,2880,332,700,621,79,0.93261695714847,0.58974358974359,1.76851027760119,177,79,98,27,1.2,17.89,7.9,0,0,0,0,0,0,0.695508090678351,390.39599221744,76.4641407202437
8.7,"random_instances_SVM","SVM",67,7,3112,2786,326,800,715,85,0.932503385314287,0.584615384615385,1.77013574660633,190,85,105,13,1.2,20.45,8.4,0,0,0,0,0,0,0.766651103308278,388.936470620149,83.3933108698534
8.7,"random_instances_SVM","SVM",67,8,3012,2692,320,900,809,91,0.937368045545221,0.6,1.77013574660633,200,91,109,10,1.2,23.01,8.9,0,0,0,0,0,0,0.590231896448407,322.827310780603,67.079592285591
8.7,"random_instances_SVM","SVM",67,9,2912,2601,311,1000,900,100,0.93773933808005,0.61025641025641,1.76526827892547,221,100,121,21,1.2,25.56,9,0,0,0,0,0,0,0.468376271018357,284.728165130802,56.4947307161474
8.7,"random_instances_SVM","SVM",67,10,2812,2514,298,1100,987,113,0.938845935438784,0.58974358974359,1.76851027760119,245,113,132,24,1.2,28.12,8.7,0,0,0,0,0,0,0.588984022467244,298.263411133858,69.674962115176
8.7,"random_instances_SVM","SVM",67,11,2712,2426,286,1200,1075,125,0.938610055475475,0.61025641025641,1.76851027760119,267,125,142,22,1.1,30.67,8.6,0,0,0,0,0,0,0.65247404588587,313.678635894716,74.8640809118126
8.7,"random_instances_SVM","SVM",67,12,2612,2333,279,1300,1168,132,0.939396322019836,0.615384615384615,1.76203814483778,288,132,156,21,1.2,33.23,8.8,0,0,0,0,0,0,0.679943379810716,308.124488148407,77.5971723986993
8.7,"random_instances_SVM","SVM",67,13,2512,2245,267,1400,1256,144,0.937388430233397,0.615384615384615,1.77013574660633,312,144,168,24,1.2,35.79,8.7,0,0,0,0,0,0,0.630288663423279,286.801897746622,73.1245297289229
8.7,"random_instances_SVM","SVM",67,14,2412,2155,257,1500,1346,154,0.93690647796269,0.615384615384615,1.76526827892547,328,154,174,16,1.1,38.34,8.7,0,0,0,0,0,0,0.616143551743223,275.326011155463,72.2647657289908
8.7,"random_instances_SVM","SVM",67,15,2312,2065,247,1600,1436,164,0.939604537049176,0.630769230769231,1.7636517328825,348,164,184,20,1.1,40.9,8.8,0,0,0,0,0,0,0.675034600621389,271.059921477919,78.6511132065186
8.7,"random_instances_SVM","SVM",67,16,2212,1969,243,1700,1532,168,0.936562850361829,0.630769230769231,1.77176420635482,362,168,194,14,1.2,43.46,9.1,0,0,0,0,0,0,0.629031153648429,248.231262188912,75.3627735073876
8.7,"random_instances_SVM","SVM",67,17,2112,1876,236,1800,1625,175,0.935074768124167,0.630769230769231,1.77013574660633,378,175,203,16,1.2,46.01,9.3,0,0,0,0,0,0,0.680978350277696,241.395430422727,79.7246135118676
8.7,"random_instances_SVM","SVM",67,18,2012,1791,221,1900,1710,190,0.934338007251117,0.625641025641026,1.77339566510837,404,190,214,26,1.1,48.57,9,0,0,0,0,0,0,0.694143599366542,232.85083995313,82.5247415976763
8.7,"random_instances_SVM","SVM",67,19,1912,1704,208,2000,1797,203,0.936264360284801,0.625641025641026,1.77013574660633,433,203,230,29,1.1,51.12,8.9,0,0,0,0,0,0,0.64014232041158,223.820835577031,78.1942006766864
8.7,"random_instances_SVM","SVM",67,20,1812,1612,200,2100,1889,211,0.936562850361823,0.630769230769231,1.77503013115916,447,211,236,14,1.1,53.68,9,0,0,0,0,0,0,0.724427658911115,217.859495249812,84.3798715933859
8.7,"random_instances_SVM","SVM",67,21,1712,1522,190,2200,1979,221,0.93510097700897,0.615384615384615,1.77013574660633,464,221,243,17,1.1,56.24,9,0,0,0,0,0,0,0.609290687091923,195.44660775264,75.5472978642076
8.7,"random_instances_SVM","SVM",67,22,1612,1433,179,2300,2068,232,0.93296786499511,0.620512820512821,1.77013574660633,486,232,254,22,1.1,58.79,8.9,0,0,0,0,0,0,0.690159909368991,194.203267457701,83.210716727291
8.7,"random_instances_SVM","SVM",67,23,1512,1341,171,2400,2160,240,0.932142285123535,0.625641025641026,1.77176420635482,501,240,261,15,1.1,61.35,9,0,0,0,0,0,0,0.680034892771105,184.017519833655,82.0340367104478
8.7,"random_instances_SVM","SVM",67,24,1412,1255,157,2500,2246,254,0.934390425020733,0.615384615384615,1.7636517328825,530,254,276,29,1.1,63.91,8.8,0,0,0,0,0,0,0.617118106935914,168.277098902035,79.7702157684721
8.7,"random_instances_SVM","SVM",67,25,1312,1171,141,2600,2330,270,0.936398316807159,0.625641025641026,1.77339566510837,557,270,287,27,1.1,66.46,8.6,0,0,0,0,0,0,0.633628608266245,155.139563176768,81.0454631664816
8.7,"random_instances_SVM","SVM",67,26,1212,1079,133,2700,2422,278,0.935172323417627,0.630769230769231,1.77339566510837,577,278,299,20,1.1,69.02,8.7,0,0,0,0,0,0,0.586335526007869,141.053299895465,78.1491563517793
8.7,"random_instances_SVM","SVM",67,27,1112,985,127,2800,2516,284,0.937430655658927,0.635897435897436,1.77339566510837,587,284,303,10,1.1,71.57,8.9,0,0,0,0,0,0,0.522875814887244,129.618258078153,76.9425009887007
8.7,"random_instances_SVM","SVM",67,28,1012,892,120,2900,2609,291,0.937322908021369,0.635897435897436,1.77339566510837,601,291,310,14,1.1,74.13,9,0,0,0,0,0,0,0.484286901944641,120.313428982347,74.5597562223696
8.7,"random_instances_SVM","SVM",67,29,912,810,102,3000,2691,309,0.938942034683095,0.635897435897436,1.76526827892547,635,309,326,34,1.1,76.69,8.7,0,0,0,0,0,0,0.446985539087558,110.092592432387,74.079340163873
8.7,"random_instances_SVM","SVM",67,30,812,724,88,3100,2777,323,0.939505525706545,0.656410256410256,1.77013574660633,664,322,342,29,1.1,79.24,8.6,0,0,0,0,0,0,0.333077418877488,93.2893023457538,66.6877360850324
8.7,"random_instances_SVM","SVM",67,31,712,632,80,3200,2869,331,0.939533190640513,0.646153846153846,1.77503013115916,674,329,345,10,1,81.8,8.7,0,0,0,0,0,0,0.253761425709912,82.1123876829717,60.8146559417128
8.7,"random_instances_SVM","SVM",67,32,612,539,73,3300,2962,338,0.940406820134252,0.635897435897436,1.77503013115916,685,336,349,11,1,84.36,8.8,0,0,0,0,0,0,0.196471754622521,72.5556697679357,57.434542638183
8.7,"random_instances_SVM","SVM",67,33,512,450,62,3400,3051,349,0.940963030911926,0.646153846153846,1.76851027760119,709,348,361,24,1,86.91,8.7,0,0,0,0,0,0,0.142295520756869,60.3152058915786,50.4791107949032
8.7,"random_instances_SVM","SVM",67,34,412,360,52,3500,3141,359,0.940901876847367,0.651282051282051,1.76688779110797,731,357,374,22,1,89.47,8.7,0,0,0,0,0,0,0.093430382756471,49.4389857172113,42.8956755737723
8.7,"random_instances_SVM","SVM",67,35,312,270,42,3600,3231,369,0.940412644330875,0.661538461538462,1.77176420635482,748,365,383,17,1,92.02,8.8,0,0,0,0,0,0,0.061898343387441,37.1085804349968,34.1722231457206
8.7,"random_instances_SVM","SVM",67,36,212,183,29,3700,3318,382,0.94058154603299,0.656410256410256,1.76851027760119,773,377,396,25,1.1,94.58,8.7,0,0,0,0,0,0,0.0352665973847495,26.2231865437548,25.5192128716159
8.7,"random_instances_SVM","SVM",67,37,112,95,17,3800,3406,394,0.940377699151119,0.651282051282051,1.77503013115916,800,391,409,27,1,97.14,8.6,0,0,0,0,0,0,0.00114095741133085,16.524266065739,16.5168794498267
8.7,"random_instances_SVM","SVM",67,38,12,8,4,3900,3493,407,0.939163354154832,0.651282051282051,1.77013574660633,828,401,427,28,1.1,99.69,8.6,0,0,0,0,0,0,0.000171862510080434,2.69753130237443,2.69753130237443
8.7,"random_instances_SVM","SVM",67,39,0,0,0,3912,3501,411,0.939073079107147,0.651282051282051,1.77176420635482,828,404,424,0,1,100,8.5,0,0,0,0,0,0,0,0,0
8.7,"random_instances_SVM","SVM",68,0,3812,3398,414,100,89,11,0.897159754104749,0.50828729281768,1.76475239495159,27,11,16,0,1.5,2.56,8.1,0,0,0,0,0,0,0.810355503878333,571.005451453336,84.5173941895423
8.7,"random_instances_SVM","SVM",68,1,3712,3314,398,200,173,27,0.912484631546187,0.524861878453039,1.77125240377278,58,27,31,31,1.1,5.11,6.4,0,0,0,0,0,0,0.914527993395027,581.876914268758,93.4784036412809
8.7,"random_instances_SVM","SVM",68,2,3612,3224,388,300,263,37,0.916585479729205,0.541436464088398,1.76152024770809,81,37,44,23,1.2,7.67,7.1,0,0,0,0,0,0,0.832924937102772,526.247477565624,86.3454641662712
8.7,"random_instances_SVM","SVM",68,3,3512,3142,370,400,345,55,0.918863901641898,0.541436464088398,1.76962291674079,110,52,58,29,1.1,10.22,6.3,0,0,0,0,0,0,0.834888783951602,489.15063185381,86.6684915260979
8.7,"random_instances_SVM","SVM",68,4,3412,3055,357,500,432,68,0.920222550774262,0.546961325966851,1.76475239495159,138,65,73,28,1.1,12.78,6.4,0,0,0,0,0,0,0.828139898584159,477.399090576803,86.4846489569688
8.7,"random_instances_SVM","SVM",68,5,3312,2966,346,600,521,79,0.918138666251656,0.535911602209945,1.77125240377278,157,75,82,19,1.1,15.34,6.6,0,0,0,0,0,0,0.83144516601407,465.868714451331,86.8410372665665
8.7,"random_instances_SVM","SVM",68,6,3212,2879,333,700,608,92,0.921195237724692,0.552486187845304,1.75644947719282,186,89,97,29,1.1,17.89,6.6,0,0,0,0,0,0,0.8197177237449,443.096119901381,86.1271727424095
8.7,"random_instances_SVM","SVM",68,7,3112,2792,320,800,695,105,0.921550073924211,0.546961325966851,1.76962291674079,206,100,106,20,1.1,20.45,6.6,0,0,0,0,0,0,0.789803594647404,401.975490082826,83.3620508486007
8.7,"random_instances_SVM","SVM",68,8,3012,2700,312,900,787,113,0.920619407050037,0.541436464088398,1.76637292056679,227,110,117,21,1.1,23.01,7,0,0,0,0,0,0,0.811115988385797,394.463493991451,85.9485611028404
8.7,"random_instances_SVM","SVM",68,9,2912,2610,302,1000,877,123,0.919575130340058,0.558011049723757,1.76799642508937,251,121,130,24,1.1,25.56,7.1,0,0,0,0,0,0,0.836510596085586,389.941256468682,88.1847265267788
8.7,"random_instances_SVM","SVM",68,10,2812,2524,288,1100,963,137,0.919393043342934,0.552486187845304,1.75644947719282,274,132,142,23,1.1,28.12,7,0,0,0,0,0,0,0.785940641589167,352.312464546796,84.7613025288252
8.7,"random_instances_SVM","SVM",68,11,2712,2431,281,1200,1056,144,0.917346509999224,0.558011049723757,1.74492371635663,291,140,151,17,1.1,30.67,7.3,0,0,0,0,0,0,0.777373397062399,342.245261549523,84.0407571402735
8.7,"random_instances_SVM","SVM",68,12,2612,2343,269,1300,1144,156,0.917646875729519,0.558011049723757,1.75806386090348,307,150,157,16,1,33.23,7.3,0,0,0,0,0,0,0.77454511910658,315.635435234545,84.1958128946832
8.7,"random_instances_SVM","SVM",68,13,2512,2257,255,1400,1230,170,0.918823437864764,0.558011049723757,1.75644947719282,333,161,172,26,1.1,35.79,7.2,0,0,0,0,0,0,0.759685749006267,299.656909388689,82.965509132655
8.7,"random_instances_SVM","SVM",68,14,2412,2163,249,1500,1324,176,0.918972842580348,0.56353591160221,1.75483805565411,355,172,183,22,1.1,38.34,7.5,0,0,0,0,0,0,0.770918394883397,290.795494029781,84.624445958362
8.7,"random_instances_SVM","SVM",68,15,2312,2070,242,1600,1417,183,0.922113454205906,0.569060773480663,1.76637292056679,362,179,183,7,1,40.9,7.7,0,0,0,0,0,0,0.737939558648693,270.800674769148,82.0951205187485
8.7,"random_instances_SVM","SVM",68,16,2212,1986,226,1700,1501,199,0.922493191191355,0.569060773480663,1.76313484005246,394,191,203,32,1.1,43.46,7.5,0,0,0,0,0,0,0.750335488196963,263.490342681246,82.4413242278869
8.7,"random_instances_SVM","SVM",68,17,2112,1894,218,1800,1593,207,0.923579487977597,0.574585635359116,1.76313484005246,412,200,212,18,1.1,46.01,7.7,0,0,0,0,0,0,0.745038565100674,250.942934262934,81.7059549846305
8.7,"random_instances_SVM","SVM",68,18,2012,1804,208,1900,1683,217,0.924544393432424,0.574585635359116,1.76962291674079,427,210,217,15,1,48.57,7.8,0,0,0,0,0,0,0.73481476625581,229.250022818433,81.8227820892062
8.7,"random_instances_SVM","SVM",68,19,1912,1716,196,2000,1771,229,0.926212746089805,0.585635359116022,1.77304009196287,449,221,228,22,1,51.12,7.7,0,0,0,0,0,0,0.748389232204693,228.772362916191,83.9604238625531
8.7,"random_instances_SVM","SVM",68,20,1812,1625,187,2100,1862,238,0.925470391409236,0.585635359116022,1.76475239495159,472,230,242,23,1.1,53.68,7.8,0,0,0,0,0,0,0.700784998243031,212.586239192012,80.9074869657066
8.7,"random_instances_SVM","SVM",68,21,1712,1535,177,2200,1952,248,0.92647109174384,0.591160220994475,1.76799642508937,494,240,254,22,1.1,56.24,7.9,0,0,0,0,0,0,0.693876512142557,199.70347791625,79.6253017414057
8.7,"random_instances_SVM","SVM",68,22,1612,1447,165,2300,2040,260,0.928606334137431,0.585635359116022,1.77956461852023,519,252,267,25,1.1,58.79,7.8,0,0,0,0,0,0,0.687881284481038,191.635285341258,80.0638354099102
8.7,"random_instances_SVM","SVM",68,23,1512,1357,155,2400,2130,270,0.928066298342551,0.585635359116022,1.78120325997375,537,260,277,18,1.1,61.35,7.9,0,0,0,0,0,0,0.668470608515142,176.173330211127,78.8963789403528
8.7,"random_instances_SVM","SVM",68,24,1412,1271,141,2500,2216,284,0.928338650688671,0.580110497237569,1.77956461852023,560,271,289,23,1.1,63.91,7.8,0,0,0,0,0,0,0.657980656161363,167.52199844542,78.9536083563867
8.7,"random_instances_SVM","SVM",68,25,1312,1181,131,2600,2306,294,0.929622597463242,0.580110497237569,1.77792898927527,588,285,303,28,1.1,66.46,7.8,0,0,0,0,0,0,0.616522183323536,155.842054004264,78.2725174472477
8.7,"random_instances_SVM","SVM",68,26,1212,1091,121,2700,2396,304,0.929873161621673,0.591160220994475,1.76979573680832,611,296,315,23,1.1,69.02,7.9,0,0,0,0,0,0,0.596805503285919,143.272928885958,77.8707809664675
8.7,"random_instances_SVM","SVM",68,27,1112,997,115,2800,2490,310,0.929621041164121,0.580110497237569,1.77629636394076,623,303,320,12,1.1,71.57,8,0,0,0,0,0,0,0.568790492254303,130.962915017378,75.769820302175
8.7,"random_instances_SVM","SVM",68,28,1012,905,107,2900,2582,318,0.929028091199139,0.596685082872928,1.77466673424908,638,311,327,15,1.1,74.13,8.1,0,0,0,0,0,0,0.519013297079305,119.298986459984,73.5209686037501
8.7,"random_instances_SVM","SVM",68,29,912,813,99,3000,2674,326,0.929740876196415,0.585635359116022,1.77466673424908,656,318,338,18,1.1,76.69,8.2,0,0,0,0,0,0,0.511799935501845,111.747729876159,74.0499229252745
8.7,"random_instances_SVM","SVM",68,30,812,725,87,3100,2762,338,0.92961792856588,0.591160220994475,1.77629636394076,663,325,338,7,1,79.24,8.2,0,0,0,0,0,0,0.462662913867156,100.464764460608,70.7791438808764
8.7,"random_instances_SVM","SVM",68,31,712,635,77,3200,2852,348,0.92986382382695,0.596685082872928,1.78284492196451,685,335,350,22,1,81.8,8.2,0,0,0,0,0,0,0.355276389973015,86.1763161829766,66.6803513401159
8.7,"random_instances_SVM","SVM",68,32,612,553,59,3300,2934,366,0.929457629756452,0.585635359116022,1.76817800761562,715,350,365,30,1,84.36,8,0,0,0,0,0,0,0.238386638322334,72.9028499756884,59.9283677891758
8.7,"random_instances_SVM","SVM",68,33,512,459,53,3400,3028,372,0.928632791222487,0.596685082872928,1.77792898927527,728,357,371,13,1,86.91,8.1,0,0,0,0,0,0,0.159575530962912,62.2887157938397,54.2242656398713
8.7,"random_instances_SVM","SVM",68,34,412,375,37,3500,3112,388,0.928425803439434,0.596685082872928,1.77304009196287,752,368,384,24,1,89.47,8,0,0,0,0,0,0,0.0615767399746677,47.4963577896,43.4899648540071
8.7,"random_instances_SVM","SVM",68,35,312,287,25,3600,3200,400,0.928254610536158,0.602209944751381,1.77304009196287,770,378,392,18,1,92.02,8,0,0,0,0,0,0,0.0370655386730161,33.2173460997149,31.439886049749
8.7,"random_instances_SVM","SVM",68,36,212,195,17,3700,3292,408,0.928105205820572,0.596685082872928,1.77304009196287,786,384,402,16,1,94.58,8.1,0,0,0,0,0,0,0.0171131423666404,22.7093431752403,22.1001372935049
8.7,"random_instances_SVM","SVM",68,37,112,102,10,3800,3385,415,0.927960470002348,0.602209944751381,1.78120325997375,808,396,412,22,1,97.14,8.2,0,0,0,0,0,0,0.00205207982601374,11.4608357554167,11.4478525859085
8.7,"random_instances_SVM","SVM",68,38,12,12,0,3900,3475,425,0.927974476694433,0.607734806629834,1.77629636394076,826,403,423,18,1,99.69,8.2,0,0,0,0,0,0,0.000752458277976542,0.243677565268694,0.243677565268694
8.7,"random_instances_SVM","SVM",68,39,0,0,0,3912,3487,425,0.928112987316175,0.607734806629834,1.77466673424908,825,403,422,-1,1,100,8.2,0,0,0,0,0,0,0,0,0
8.7,"random_instances_SVM","SVM",69,0,3812,3412,400,100,89,11,0.863192533379924,0.502564102564103,1.64560085076214,31,11,20,0,1.8,2.56,8.1,0,0,0,0,0,0,0.220414870647783,355.376130539197,25.1059949756755
8.7,"random_instances_SVM","SVM",69,1,3712,3328,384,200,173,27,0.925463387643965,0.6,1.76042750667979,60,27,33,29,1.2,5.11,6.4,0,0,0,0,0,0,0.55046950049527,459.617863234567,60.089674256575
8.7,"random_instances_SVM","SVM",69,2,3612,3239,373,300,262,38,0.930957061110386,0.594871794871795,1.78099214492959,83,38,45,23,1.2,7.67,6.9,0,0,0,0,0,0,0.795769772115139,518.268110698307,84.4563651260091
8.7,"random_instances_SVM","SVM",69,3,3512,3152,360,400,349,51,0.931928245897585,0.605128205128205,1.76688779110797,108,51,57,25,1.1,10.22,6.8,0,0,0,0,0,0,0.83738802155318,508.120287514587,88.0168380448632
8.7,"random_instances_SVM","SVM",69,4,3412,3061,351,500,440,60,0.922995384324163,0.58974358974359,1.71615173481596,129,60,69,21,1.1,12.78,7.3,0,0,0,0,0,0,0.796961350909837,471.189942862266,84.7413938371996
8.7,"random_instances_SVM","SVM",69,5,3312,2971,341,600,530,70,0.93023194863059,0.625641025641026,1.76253626778006,155,70,85,26,1.2,15.34,7.6,0,0,0,0,0,0,0.701987771235683,393.477070834206,78.4522776385606
8.7,"random_instances_SVM","SVM",69,6,3212,2881,331,700,620,80,0.927474191528708,0.620512820512821,1.75446604677374,175,80,95,20,1.2,17.89,7.8,0,0,0,0,0,0,0.607296413704529,370.231967749681,69.3106614108653
8.7,"random_instances_SVM","SVM",69,7,3112,2789,323,800,712,88,0.928226968942468,0.61025641025641,1.75768525052929,190,88,102,15,1.2,20.45,8.1,0,0,0,0,0,0,0.70828583235348,357.57935159111,78.7078415910735
8.7,"random_instances_SVM","SVM",69,8,3012,2695,317,900,806,94,0.925706547853045,0.61025641025641,1.7484827099506,204,94,110,14,1.2,23.01,8.6,0,0,0,0,0,0,0.555702722136875,301.395272664043,64.9840293899657
8.7,"random_instances_SVM","SVM",69,9,2912,2602,310,1000,899,101,0.922608075248608,0.630769230769231,1.74408039063053,219,101,118,15,1.2,25.56,8.9,0,0,0,0,0,0,0.635155303606893,304.24381848474,74.5723771185713
8.7,"random_instances_SVM","SVM",69,10,2812,2515,297,1100,986,114,0.925342535563994,0.620512820512821,1.75008829554284,247,114,133,28,1.2,28.12,8.6,0,0,0,0,0,0,0.804269885960496,336.400200012469,87.9423413625433
8.7,"random_instances_SVM","SVM",69,11,2712,2429,283,1200,1072,128,0.921013701422545,0.61025641025641,1.72403846153846,269,127,142,22,1.1,30.67,8.4,0,0,0,0,0,0,0.790043952831662,313.222917167965,85.9627171843542
8.7,"random_instances_SVM","SVM",69,12,2612,2344,268,1300,1157,143,0.926332648990219,0.61025641025641,1.77176420635482,293,142,151,24,1.1,33.23,8.1,0,0,0,0,0,0,0.752484780594231,295.771221105934,82.8310704255586
8.7,"random_instances_SVM","SVM",69,13,2512,2256,256,1400,1245,155,0.930127113091331,0.620512820512821,1.77013574660633,320,154,166,27,1.1,35.79,8,0,0,0,0,0,0,0.708577331326812,280.844403365558,79.3984796148219
8.7,"random_instances_SVM","SVM",69,14,2412,2165,247,1500,1336,164,0.932075306862351,0.615384615384615,1.77772126863036,340,163,177,20,1.1,38.34,8.1,0,0,0,0,0,0,0.768756789842646,289.672905820471,85.6553939028363
8.7,"random_instances_SVM","SVM",69,15,2312,2078,234,1600,1423,177,0.934438474642905,0.61025641025641,1.79779411764706,369,176,193,29,1.1,40.9,8,0,0,0,0,0,0,0.635721033544929,252.631089963865,73.6227042296223
8.7,"random_instances_SVM","SVM",69,16,2212,1983,229,1700,1518,182,0.934089022845411,0.615384615384615,1.79779411764706,383,182,201,14,1.1,43.46,8.3,0,0,0,0,0,0,0.742372149544082,259.036276953152,84.3984245276708
8.7,"random_instances_SVM","SVM",69,17,2112,1889,223,1800,1612,188,0.934674354606212,0.620512820512821,1.79779411764706,401,188,213,18,1.1,46.01,8.6,0,0,0,0,0,0,0.772399370547739,259.041175634583,87.1327071255298
8.7,"random_instances_SVM","SVM",69,18,2012,1800,212,1900,1701,199,0.935119905648017,0.615384615384615,1.79449541284404,419,199,220,18,1.1,48.57,8.5,0,0,0,0,0,0,0.681767842712274,234.678766224731,80.8697054980411
8.7,"random_instances_SVM","SVM",69,19,1912,1711,201,2000,1790,210,0.933848774734636,0.615384615384615,1.79614325068871,444,210,234,25,1.1,51.12,8.5,0,0,0,0,0,0,0.676508414839322,218.640627924433,79.9162843128732
8.7,"random_instances_SVM","SVM",69,20,1812,1620,192,2100,1881,219,0.93469037114693,0.61025641025641,1.79779411764706,461,219,242,17,1.1,53.68,8.6,0,0,0,0,0,0,0.733026238383134,215.674011603708,85.6755558165888
8.7,"random_instances_SVM","SVM",69,21,1712,1530,182,2200,1971,229,0.936267272383119,0.61025641025641,1.80110497237569,477,229,248,16,1.1,56.24,8.6,0,0,0,0,0,0,0.726049222765874,205.265915479551,85.0719152334491
8.7,"random_instances_SVM","SVM",69,22,1612,1440,172,2300,2061,239,0.935951309716216,0.620512820512821,1.80110497237569,493,239,254,16,1.1,58.79,8.6,0,0,0,0,0,0,0.686161723000261,192.924985439331,82.3700582749254
8.7,"random_instances_SVM","SVM",69,23,1512,1353,159,2400,2148,252,0.936564306410984,0.620512820512821,1.79779411764706,522,252,270,29,1.1,61.35,8.5,0,0,0,0,0,0,0.634523637460569,180.57855976082,78.2760446179192
8.7,"random_instances_SVM","SVM",69,24,1412,1263,149,2500,2238,262,0.936886093274509,0.61025641025641,1.79944802207912,540,262,278,18,1.1,63.91,8.5,0,0,0,0,0,0,0.639878211093469,172.640943887188,80.8249074220921
8.7,"random_instances_SVM","SVM",69,25,1312,1171,141,2600,2330,270,0.936136227959056,0.61025641025641,1.79779411764706,555,270,285,15,1.1,66.46,8.6,0,0,0,0,0,0,0.62380959933665,159.090785066949,79.7364620674271
8.7,"random_instances_SVM","SVM",69,26,1212,1081,131,2700,2420,280,0.939875362192229,0.620512820512821,1.80110497237569,576,280,296,21,1.1,69.02,8.6,0,0,0,0,0,0,0.594101267260568,149.414200341294,80.2054198998137
8.7,"random_instances_SVM","SVM",69,27,1112,991,121,2800,2510,290,0.939355552643458,0.615384615384615,1.80276497695853,596,290,306,20,1.1,71.57,8.7,0,0,0,0,0,0,0.550244575542979,137.36129165966,77.3363667212083
8.7,"random_instances_SVM","SVM",69,28,1012,900,112,2900,2601,299,0.940156379679379,0.620512820512821,1.79285059578368,614,299,315,18,1.1,74.13,8.7,0,0,0,0,0,0,0.490987223160388,118.927608668281,74.9646980929708
8.7,"random_instances_SVM","SVM",69,29,912,804,108,3000,2697,303,0.940584458131308,0.620512820512821,1.79779411764706,630,303,327,16,1.1,76.69,8.9,0,0,0,0,0,0,0.467232506829819,110.219278876795,73.3064862331455
8.7,"random_instances_SVM","SVM",69,30,812,715,97,3100,2786,314,0.940829074389553,0.635897435897436,1.79944802207912,652,314,338,22,1.1,79.24,8.9,0,0,0,0,0,0,0.421840473150797,102.829869651007,71.2958386207244
8.7,"random_instances_SVM","SVM",69,31,712,622,90,3200,2879,321,0.940537864558309,0.635897435897436,1.79944802207912,666,321,345,14,1.1,81.8,9,0,0,0,0,0,0,0.326075654604457,87.0661296552023,64.7766392335825
8.7,"random_instances_SVM","SVM",69,32,612,532,80,3300,2969,331,0.941367812577355,0.635897435897436,1.79614325068871,682,331,351,16,1.1,84.36,9,0,0,0,0,0,0,0.250494415671959,77.2933581448626,60.5901463099611
8.7,"random_instances_SVM","SVM",69,33,512,439,73,3400,3062,338,0.941085339041049,0.635897435897436,1.79779411764706,696,338,358,14,1.1,86.91,9.1,0,0,0,0,0,0,0.191306604330055,67.9030587098373,57.4850038001567
8.7,"random_instances_SVM","SVM",69,34,412,355,57,3500,3146,354,0.942145342826776,0.646153846153846,1.79285059578368,728,352,376,32,1.1,89.47,8.9,0,0,0,0,0,0,0.0962996495301092,54.1563727581192,48.8044839596772
8.7,"random_instances_SVM","SVM",69,35,312,274,38,3600,3227,373,0.942360838101895,0.635897435897436,1.79285059578368,760,370,390,32,1.1,92.02,8.7,0,0,0,0,0,0,0.0553811135544431,37.435948637868,34.9623516526791
8.7,"random_instances_SVM","SVM",69,36,212,188,24,3700,3313,387,0.943269412775377,0.630769230769231,1.79944802207912,780,380,400,20,1.1,94.58,8.6,0,0,0,0,0,0,0.0240439883313157,24.0110850958575,23.3105014656033
8.7,"random_instances_SVM","SVM",69,37,112,101,11,3800,3400,400,0.944157602760671,0.641025641025641,1.79779411764706,803,393,410,23,1,97.14,8.5,0,0,0,0,0,0,0.00177429360527511,13.9745338360143,13.9652052948839
8.7,"random_instances_SVM","SVM",69,38,12,12,0,3900,3489,411,0.943719331964649,0.630769230769231,1.79779411764706,826,403,423,23,1,99.69,8.5,0,0,0,0,0,0,0.000273633820538002,0.47339007545489,0.47339007545489
8.7,"random_instances_SVM","SVM",69,39,0,0,0,3912,3501,411,0.943675650489962,0.625641025641026,1.79449541284404,826,403,423,0,1,100,8.5,0,0,0,0,0,0,0,0,0
8.7,"random_instances_SVM","SVM",70,0,3812,3435,377,100,88,12,0.91082061569364,0.580645161290323,1.77958893501415,29,12,17,0,1.4,2.56,7.3,0,0,0,0,0,0,0.572969111815125,393.948807687284,63.1975184480038
8.7,"random_instances_SVM","SVM",70,1,3712,3350,362,200,173,27,0.924356653937985,0.599078341013825,1.78622584872955,57,27,30,28,1.1,5.11,6.4,0,0,0,0,0,0,0.907568134652332,542.225996948149,92.8490488157735
8.7,"random_instances_SVM","SVM",70,2,3612,3258,354,300,265,35,0.928355456152297,0.603686635944701,1.80110497237569,80,35,45,23,1.3,7.67,7.6,0,0,0,0,0,0,0.810958302892337,454.379824283257,85.8763840612386
8.7,"random_instances_SVM","SVM",70,3,3512,3167,345,400,356,44,0.923813410429743,0.608294930875576,1.77620490363317,99,44,55,19,1.2,10.22,8.1,0,0,0,0,0,0,0.85206817294431,429.860708005912,90.1021718774219
8.7,"random_instances_SVM","SVM",70,4,3412,3078,334,500,445,55,0.923400015369814,0.622119815668203,1.76141715638608,123,55,68,24,1.2,12.78,8.1,0,0,0,0,0,0,0.723094279111171,390.843689554041,78.5269023042739
8.7,"random_instances_SVM","SVM",70,5,3312,2984,328,600,539,61,0.919468787347987,0.626728110599078,1.74808552453239,135,61,74,12,1.2,15.34,8.8,0,0,0,0,0,0,0.821747887328487,387.826509797315,89.165060906503
8.7,"random_instances_SVM","SVM",70,6,3212,2893,319,700,630,70,0.925758487186075,0.626728110599078,1.76627847328503,156,70,86,21,1.2,17.89,9,0,0,0,0,0,0,0.787361063022562,365.888668041832,85.5703178085444
8.7,"random_instances_SVM","SVM",70,7,3112,2801,311,800,722,78,0.925064195482861,0.622119815668203,1.75798608608651,175,78,97,19,1.2,20.45,9.3,0,0,0,0,0,0,0.744732305807509,321.260609444005,84.5534830300059
8.7,"random_instances_SVM","SVM",70,8,3012,2710,302,900,813,87,0.928126233891503,0.622119815668203,1.77293982108973,186,87,99,11,1.1,23.01,9.3,0,0,0,0,0,0,0.705939825473729,318.474901126164,80.530677315719
8.7,"random_instances_SVM","SVM",70,9,2912,2614,298,1000,909,91,0.929326669546296,0.63594470046083,1.76465505557062,201,91,110,15,1.2,25.56,10,0,0,0,0,0,0,0.745359055926071,294.703410296221,85.0284106056978
8.7,"random_instances_SVM","SVM",70,10,2812,2524,288,1100,999,101,0.926784024930899,0.63594470046083,1.77457086048355,220,101,119,19,1.2,28.12,9.9,0,0,0,0,0,0,0.73088267646119,288.089002158707,81.9651874605729
8.7,"random_instances_SVM","SVM",70,11,2712,2434,278,1200,1089,111,0.926479278572618,0.640552995391705,1.76953428613901,238,111,127,18,1.1,30.67,9.8,0,0,0,0,0,0,0.714937655469026,280.957778411789,82.4165406701062
8.7,"random_instances_SVM","SVM",70,12,2612,2345,267,1300,1178,122,0.925710787756083,0.63594470046083,1.76968672050057,258,122,136,20,1.1,33.23,9.7,0,0,0,0,0,0,0.659576801204919,247.306207597336,77.2208713243372
8.7,"random_instances_SVM","SVM",70,13,2512,2260,252,1400,1263,137,0.928381955835626,0.626728110599078,1.76806464284658,288,137,151,30,1.1,35.79,9.2,0,0,0,0,0,0,0.720100668968439,258.356672768715,81.6588970728044
8.7,"random_instances_SVM","SVM",70,14,2412,2167,245,1500,1356,144,0.927255719294152,0.626728110599078,1.77131177717688,301,144,157,13,1.1,38.34,9.4,0,0,0,0,0,0,0.741221473149198,259.170644131472,84.4869293804422
8.7,"random_instances_SVM","SVM",70,15,2312,2072,240,1600,1451,149,0.930951100134352,0.626728110599078,1.78450492654734,315,149,166,14,1.1,40.9,9.7,0,0,0,0,0,0,0.709911302190525,238.78835860811,82.8162604343064
8.7,"random_instances_SVM","SVM",70,16,2212,1982,230,1700,1541,159,0.93075102752522,0.63594470046083,1.78122458660884,333,159,174,18,1.1,43.46,9.7,0,0,0,0,0,0,0.657885653528781,228.439974517969,78.8847221349886
8.7,"random_instances_SVM","SVM",70,17,2112,1890,222,1800,1633,167,0.93438678407793,0.631336405529954,1.77632662715895,353,167,186,20,1.1,46.01,9.8,0,0,0,0,0,0,0.621296538402231,210.119148831139,76.7322395114418
8.7,"random_instances_SVM","SVM",70,18,2012,1799,213,1900,1724,176,0.934728629992871,0.626728110599078,1.78450492654734,364,176,188,11,1.1,48.57,9.8,0,0,0,0,0,0,0.683194385120002,209.250240503369,83.0354990575198
8.7,"random_instances_SVM","SVM",70,19,1912,1708,204,2000,1815,185,0.935232123976118,0.631336405529954,1.77958893501415,387,185,202,23,1.1,51.12,9.8,0,0,0,0,0,0,0.608304636076438,195.769270303788,77.1591095728942
8.7,"random_instances_SVM","SVM",70,20,1812,1621,191,2100,1902,198,0.93484787856785,0.622119815668203,1.78786609285143,410,198,212,23,1.1,53.68,9.6,0,0,0,0,0,0,0.52784702870498,181.000488384897,71.1765459176186
8.7,"random_instances_SVM","SVM",70,21,1712,1528,184,2200,1995,205,0.935997964824319,0.626728110599078,1.77958893501415,423,205,218,13,1.1,56.24,9.7,0,0,0,0,0,0,0.591179521908522,178.087305471951,77.3565863259756
8.7,"random_instances_SVM","SVM",70,22,1612,1437,175,2300,2086,214,0.935986039966822,0.63594470046083,1.78122458660884,446,214,232,23,1.1,58.79,9.7,0,0,0,0,0,0,0.575299473291249,162.409754889514,77.7935006510231
8.7,"random_instances_SVM","SVM",70,23,1512,1349,163,2400,2174,226,0.940423411940226,0.640552995391705,1.79445730425365,476,226,250,30,1.1,61.35,9.6,0,0,0,0,0,0,0.508580639888082,145.74557783843,73.4495344163986
8.7,"random_instances_SVM","SVM",70,24,1412,1266,146,2500,2257,243,0.939666845981189,0.631336405529954,1.78950935212795,505,243,262,29,1.1,63.91,9.3,0,0,0,0,0,0,0.534482496846309,140.289007481161,74.7293292831254
8.7,"random_instances_SVM","SVM",70,25,1312,1176,136,2600,2347,253,0.940015316816963,0.626728110599078,1.7911556348806,527,253,274,22,1.1,66.46,9.3,0,0,0,0,0,0,0.554544224056482,134.219375602016,76.3204430811201
8.7,"random_instances_SVM","SVM",70,26,1212,1088,124,2700,2435,265,0.942376438601558,0.640552995391705,1.79445730425365,549,265,284,22,1.1,69.02,9.2,0,0,0,0,0,0,0.523049646688755,124.986751971992,74.5349473590225
8.7,"random_instances_SVM","SVM",70,27,1112,999,113,2800,2524,276,0.941519173845871,0.640552995391705,1.79280494946152,568,276,292,19,1.1,71.57,9.1,0,0,0,0,0,0,0.459825096453493,115.977405640832,71.1171629604921
8.7,"random_instances_SVM","SVM",70,28,1012,908,104,2900,2615,285,0.940147815233606,0.640552995391705,1.79280494946152,588,285,303,20,1.1,74.13,9.2,0,0,0,0,0,0,0.382068130345596,99.2328270436314,67.2321708299081
8.7,"random_instances_SVM","SVM",70,29,912,810,102,3000,2713,287,0.940595659881863,0.640552995391705,1.79280494946152,593,287,306,5,1.1,76.69,9.5,0,0,0,0,0,0,0.325304302460722,89.3772099040214,64.3199291382537
8.7,"random_instances_SVM","SVM",70,30,812,723,89,3100,2800,300,0.940600959818529,0.63594470046083,1.78950935212795,622,300,322,29,1.1,79.24,9.3,0,0,0,0,0,0,0.258410185878163,79.4815135872619,59.2581705822891
8.7,"random_instances_SVM","SVM",70,31,712,633,79,3200,2890,310,0.941258151965083,0.63594470046083,1.79445730425365,633,310,323,11,1,81.8,9.3,0,0,0,0,0,0,0.212913179424705,72.8087723308791,57.9779914224113
8.7,"random_instances_SVM","SVM",70,32,612,537,75,3300,2986,314,0.942159141198262,0.645161290322581,1.79280494946152,648,314,334,15,1.1,84.36,9.5,0,0,0,0,0,0,0.161345625922136,65.7565615362404,55.0885693376597
8.7,"random_instances_SVM","SVM",70,33,512,455,57,3400,3068,332,0.943131679576428,0.640552995391705,1.78950935212795,683,332,351,35,1.1,86.91,9.2,0,0,0,0,0,0,0.110036474542915,53.3251651375889,44.7759779117352
8.7,"random_instances_SVM","SVM",70,34,412,372,40,3500,3151,349,0.942462562572377,0.631336405529954,1.78950935212795,717,349,368,34,1.1,89.47,9,0,0,0,0,0,0,0.0613783927261365,42.5600807330707,39.0738848790027
8.7,"random_instances_SVM","SVM",70,35,312,281,31,3600,3242,358,0.943083980146436,0.63594470046083,1.79445730425365,735,358,377,18,1.1,92.02,9.1,0,0,0,0,0,0,0.046381721051835,33.1415345542888,31.0547777189224
8.7,"random_instances_SVM","SVM",70,36,212,188,24,3700,3335,365,0.942750084136494,0.631336405529954,1.80110497237569,753,365,388,18,1.1,94.58,9.1,0,0,0,0,0,0,0.0106781689001499,24.8077340135782,24.4636302917966
8.7,"random_instances_SVM","SVM",70,37,112,99,13,3800,3424,376,0.943028330811446,0.63594470046083,1.79280494946152,776,376,400,23,1.1,97.14,9.1,0,0,0,0,0,0,0.00110722913442868,14.6801885588391,14.6737487948603
8.7,"random_instances_SVM","SVM",70,38,12,10,2,3900,3513,387,0.942285014694074,0.63594470046083,1.79280494946152,796,387,409,20,1.1,99.69,9.1,0,0,0,0,0,0,0.000232331642957908,1.59399611673501,1.59399611673501
8.7,"random_instances_SVM","SVM",70,39,0,0,0,3912,3523,389,0.942612285783184,0.63594470046083,1.78786609285143,800,389,411,4,1.1,100,9.1,0,0,0,0,0,0,0,0,0
8.7,"random_instances_SVM","SVM",71,0,3812,3403,409,100,92,8,0.774732530250351,0.259259259259259,1.56430400117036,29,8,21,0,2.6,2.56,11.5,0,0,0,0,0,0,0.136431150535283,328.311055703934,15.1107188473388
8.7,"random_instances_SVM","SVM",71,1,3712,3319,393,200,176,24,0.926565218302624,0.571428571428571,1.76578611980072,64,24,40,35,1.7,5.11,7.3,0,0,0,0,0,0,0.62570400825445,463.685405980401,68.394900836305
8.7,"random_instances_SVM","SVM",71,2,3612,3230,382,300,265,35,0.927936627710253,0.576719576719577,1.78500072811999,80,35,45,16,1.3,7.67,7.6,0,0,0,0,0,0,0.625849981550706,430.130920526823,68.940789900667
8.7,"random_instances_SVM","SVM",71,3,3512,3140,372,400,355,45,0.934887996574468,0.619047619047619,1.78663984724591,103,45,58,23,1.3,10.22,7.9,0,0,0,0,0,0,0.677595619661882,401.369229820746,74.7520384163965
8.7,"random_instances_SVM","SVM",71,4,3412,3051,361,500,444,56,0.929656878157159,0.603174603174603,1.78173149601721,122,56,66,19,1.2,12.78,7.9,0,0,0,0,0,0,0.745053039133248,384.656466003219,79.6536842186014
8.7,"random_instances_SVM","SVM",71,5,3312,2962,350,600,533,67,0.929204732260757,0.592592592592593,1.79614325068871,144,67,77,22,1.1,15.34,8,0,0,0,0,0,0,0.780554212842049,414.484905053573,82.7875391160193
8.7,"random_instances_SVM","SVM",71,6,3212,2875,337,700,620,80,0.926527789006564,0.587301587301587,1.78992713307341,166,80,86,22,1.1,17.89,7.8,0,0,0,0,0,0,0.820488748014022,405.332283567531,86.4602065097179
8.7,"random_instances_SVM","SVM",71,7,3112,2785,327,800,710,90,0.929839533121929,0.592592592592593,1.7804062440677,190,90,100,24,1.1,20.45,7.9,0,0,0,0,0,0,0.760706981016444,359.787205682093,81.9834613373191
8.7,"random_instances_SVM","SVM",71,8,3012,2691,321,900,804,96,0.927530894140964,0.582010582010582,1.7820456604987,202,96,106,12,1.1,23.01,8.4,0,0,0,0,0,0,0.812963585973508,366.231527076801,86.355713623366
8.7,"random_instances_SVM","SVM",71,9,2912,2595,317,1000,900,100,0.930098543850663,0.592592592592593,1.76901424799048,212,100,112,10,1.1,25.56,9,0,0,0,0,0,0,0.769525599853667,318.946239147927,83.1971874924987
8.7,"random_instances_SVM","SVM",71,10,2812,2506,306,1100,989,111,0.929582019565039,0.576719576719577,1.77876984126984,232,111,121,20,1.1,28.12,8.9,0,0,0,0,0,0,0.755485933925104,305.93997199475,81.68580344687
8.7,"random_instances_SVM","SVM",71,11,2712,2413,299,1200,1082,118,0.931410066384597,0.576719576719577,1.7820456604987,245,118,127,13,1.1,30.67,9.2,0,0,0,0,0,0,0.710464622305535,278.906876967183,80.0056364673677
8.7,"random_instances_SVM","SVM",71,12,2612,2320,292,1300,1175,125,0.929734731092961,0.597883597883598,1.76601135867191,263,125,138,18,1.1,33.23,9.4,0,0,0,0,0,0,0.714171701176064,275.294542189158,79.498660001175
8.7,"random_instances_SVM","SVM",71,13,2512,2234,278,1400,1261,139,0.928589394633534,0.587301587301587,1.78828197945845,290,139,151,27,1.1,35.79,9.1,0,0,0,0,0,0,0.779641040987947,281.443551728622,85.4732535656678
8.7,"random_instances_SVM","SVM",71,14,2412,2147,265,1500,1348,152,0.928966681937817,0.582010582010582,1.77550604339595,314,152,162,24,1.1,38.34,8.9,0,0,0,0,0,0,0.789011500045317,271.545094120819,86.5151888834277
8.7,"random_instances_SVM","SVM",71,15,2312,2055,257,1600,1440,160,0.927138635118259,0.592592592592593,1.7804062440677,329,159,170,15,1.1,40.9,9,0,0,0,0,0,0,0.746527705036868,255.008479297033,83.2274183037623
8.7,"random_instances_SVM","SVM",71,16,2212,1965,247,1700,1530,170,0.929153828418116,0.592592592592593,1.77876984126984,348,168,180,19,1.1,43.46,9,0,0,0,0,0,0,0.759692410050861,251.675367602408,84.5441916017051
8.7,"random_instances_SVM","SVM",71,17,2112,1875,237,1800,1620,180,0.930513260451006,0.592592592592593,1.77063274227044,373,180,193,25,1.1,46.01,9,0,0,0,0,0,0,0.728105042175692,235.672970818572,82.7967608548445
8.7,"random_instances_SVM","SVM",71,18,2012,1784,228,1900,1711,189,0.932238002413439,0.587301587301587,1.77550604339595,392,189,203,19,1.1,48.57,9.1,0,0,0,0,0,0,0.729993514543721,228.454095349539,85.5244273479133
8.7,"random_instances_SVM","SVM",71,19,1912,1698,214,2000,1797,203,0.931922099154694,0.592592592592593,1.77876984126984,417,203,214,25,1.1,51.12,8.9,0,0,0,0,0,0,0.69382831579092,216.305352267996,82.0833337181402
8.7,"random_instances_SVM","SVM",71,20,1812,1615,197,2100,1880,220,0.932378736566624,0.603174603174603,1.77713644380311,445,215,230,28,1.1,53.68,8.5,0,0,0,0,0,0,0.646614506621889,198.006258082619,77.7063070644002
8.7,"random_instances_SVM","SVM",71,21,1712,1528,184,2200,1967,233,0.934196303183285,0.603174603174603,1.78336461379541,466,227,239,21,1.1,56.24,8.4,0,0,0,0,0,0,0.621159491747534,181.500518936837,74.8441740813489
8.7,"random_instances_SVM","SVM",71,22,1612,1438,174,2300,2057,243,0.934088506810633,0.603174603174603,1.77713644380311,488,237,251,22,1.1,58.79,8.5,0,0,0,0,0,0,0.580380675184669,167.292886218165,72.067109128197
8.7,"random_instances_SVM","SVM",71,23,1512,1348,164,2400,2147,253,0.934546641394404,0.608465608465608,1.77550604339595,506,247,259,18,1,61.35,8.5,0,0,0,0,0,0,0.604504128900051,163.240817996742,74.7646995105613
8.7,"random_instances_SVM","SVM",71,24,1412,1260,152,2500,2235,265,0.93500178163449,0.619047619047619,1.77713644380311,532,259,273,26,1.1,63.91,8.4,0,0,0,0,0,0,0.59608150048194,155.797159264743,75.2464671792613
8.7,"random_instances_SVM","SVM",71,25,1312,1167,145,2600,2328,272,0.935942005551509,0.608465608465608,1.77387863180714,554,270,284,22,1.1,66.46,8.6,0,0,0,0,0,0,0.553930823137638,148.264606321072,74.6539112686051
8.7,"random_instances_SVM","SVM",71,26,1212,1075,137,2700,2420,280,0.934838589903669,0.608465608465608,1.77876984126984,573,279,294,19,1.1,69.02,8.6,0,0,0,0,0,0,0.505454795377198,137.164150293551,73.0872070998413
8.7,"random_instances_SVM","SVM",71,27,1112,982,130,2800,2513,287,0.935206894176896,0.613756613756614,1.77550604339595,586,285,301,13,1.1,71.57,8.8,0,0,0,0,0,0,0.514076141376329,128.564139411325,73.2351117732183
8.7,"random_instances_SVM","SVM",71,28,1012,896,116,2900,2599,301,0.934223252276446,0.62962962962963,1.77713644380311,611,298,313,25,1.1,74.13,8.6,0,0,0,0,0,0,0.436918543340735,108.00962548532,67.501478225192
8.7,"random_instances_SVM","SVM",71,29,912,804,108,3000,2691,309,0.936307315481052,0.634920634920635,1.77387863180714,632,306,326,21,1.1,76.69,8.7,0,0,0,0,0,0,0.393873910912045,99.2872753522923,66.1004313840813
8.7,"random_instances_SVM","SVM",71,30,812,712,100,3100,2783,317,0.936373191042119,0.624338624338624,1.77387863180714,639,312,327,7,1,79.24,8.8,0,0,0,0,0,0,0.333045239001574,87.53732450704,62.5865376182275
8.7,"random_instances_SVM","SVM",71,31,712,620,92,3200,2875,325,0.936118671828912,0.62962962962963,1.77414965986395,656,320,336,17,1.1,81.8,8.8,0,0,0,0,0,0,0.296165974320661,81.6949633998949,61.8610475425772
8.7,"random_instances_SVM","SVM",71,32,612,532,80,3300,2963,337,0.936189038905504,0.62962962962963,1.76925770308123,680,331,349,24,1.1,84.36,8.8,0,0,0,0,0,0,0.248308080667757,74.2017652371425,59.6483527117394
8.7,"random_instances_SVM","SVM",71,33,512,446,66,3400,3049,351,0.936184547389977,0.62962962962963,1.77088535506199,703,342,361,23,1.1,86.91,8.7,0,0,0,0,0,0,0.197814961399033,63.1656180766333,52.0179367679813
8.7,"random_instances_SVM","SVM",71,34,412,363,49,3500,3132,368,0.936545365803994,0.624338624338624,1.77876984126984,729,357,372,26,1,89.47,8.5,0,0,0,0,0,0,0.112188385505656,48.7929728147808,42.5379841715569
8.7,"random_instances_SVM","SVM",71,35,312,276,36,3600,3219,381,0.938156322706405,0.634920634920635,1.7820456604987,756,369,387,27,1,92.02,8.4,0,0,0,0,0,0,0.0613308125052121,37.2430451096227,34.5158783056899
8.7,"random_instances_SVM","SVM",71,36,212,188,24,3700,3307,393,0.938443779700144,0.62962962962963,1.77876984126984,780,380,400,24,1.1,94.58,8.4,0,0,0,0,0,0,0.0262233112502534,25.1974738192235,24.5410094874703
8.7,"random_instances_SVM","SVM",71,37,112,98,14,3800,3397,403,0.938569542134905,0.634920634920635,1.77876984126984,801,392,409,21,1,97.14,8.4,0,0,0,0,0,0,0.000793498083125428,13.9987109147592,13.9933491975476
8.7,"random_instances_SVM","SVM",71,38,12,9,3,3900,3486,414,0.939442393319018,0.624338624338624,1.77387863180714,821,403,418,20,1,99.69,8.4,0,0,0,0,0,0,0.000791081250674379,1.49926104310658,1.49926104310658
8.7,"random_instances_SVM","SVM",71,39,0,0,0,3912,3495,417,0.939695415360382,0.62962962962963,1.77550604339595,826,405,421,5,1,100,8.4,0,0,0,0,0,0,0,0,0
8.7,"random_instances_SVM","SVM",72,0,3812,3416,396,100,92,8,0.823692945121199,0.48019801980198,1.60642423689374,24,8,16,0,2,2.56,11.5,0,0,0,0,0,0,0.243149698717409,304.142423575217,37.2782022844935
8.7,"random_instances_SVM","SVM",72,1,3712,3332,380,200,176,24,0.854304729218642,0.514851485148515,1.65387447835693,56,24,32,32,1.3,5.11,7.3,0,0,0,0,0,0,0.654446016057306,384.908447385741,79.7012424775353
8.7,"random_instances_SVM","SVM",72,2,3612,3240,372,300,268,32,0.85706080585253,0.485148514851485,1.68480034816668,74,32,42,18,1.3,7.67,8.4,0,0,0,0,0,0,0.559190480270081,354.145075477935,73.9824571292888
8.7,"random_instances_SVM","SVM",72,3,3512,3148,364,400,360,40,0.868817525994323,0.51980198019802,1.69255011977739,96,40,56,22,1.4,10.22,9,0,0,0,0,0,0,0.697709433859224,325.398487182097,82.8735737908974
8.7,"random_instances_SVM","SVM",72,4,3412,3058,354,500,450,50,0.877760310238558,0.524752475247525,1.69410863738308,111,50,61,15,1.2,12.78,9,0,0,0,0,0,0,0.545357159902471,321.830805418226,69.7698299595751
8.7,"random_instances_SVM","SVM",72,5,3312,2971,341,600,537,63,0.883971008275295,0.54950495049505,1.71036643682768,140,63,77,29,1.2,15.34,8.5,0,0,0,0,0,0,0.440458312330186,328.477160763037,53.6081184515675
8.7,"random_instances_SVM","SVM",72,6,3212,2879,333,700,629,71,0.886900662700257,0.574257425742574,1.71927459535282,154,71,83,14,1.2,17.89,8.9,0,0,0,0,0,0,0.807096008466914,349.51595554581,89.1310835673704
8.7,"random_instances_SVM","SVM",72,7,3112,2790,322,800,718,82,0.890688327669716,0.569306930693069,1.73549432149097,180,82,98,26,1.2,20.45,8.8,0,0,0,0,0,0,0.829775554123765,355.589624613103,90.2912635828829
8.7,"random_instances_SVM","SVM",72,8,3012,2701,311,900,807,93,0.897970127685527,0.579207920792079,1.75734860378797,197,93,104,17,1.1,23.01,8.7,0,0,0,0,0,0,0.749780253424413,329.73772790752,84.483542942234
8.7,"random_instances_SVM","SVM",72,9,2912,2608,304,1000,900,100,0.900527224900378,0.589108910891089,1.76057605760576,208,100,108,11,1.1,25.56,9,0,0,0,0,0,0,0.787173351888237,323.648414483315,87.0317081906847
8.7,"random_instances_SVM","SVM",72,10,2812,2518,294,1100,990,110,0.909993564920919,0.594059405940594,1.7492175023954,234,110,124,26,1.1,28.12,9,0,0,0,0,0,0,0.703963623228114,293.623606362668,81.3104489807293
8.7,"random_instances_SVM","SVM",72,11,2712,2428,284,1200,1080,120,0.915728688034143,0.589108910891089,1.76381538797854,254,120,134,20,1.1,30.67,9,0,0,0,0,0,0,0.777394368391203,295.960128544764,88.3211365570998
8.7,"random_instances_SVM","SVM",72,12,2612,2334,278,1300,1174,126,0.914136852681853,0.589108910891089,1.7549072294534,269,126,143,15,1.1,33.23,9.3,0,0,0,0,0,0,0.736588953869441,272.513540071126,85.5373706455311
8.7,"random_instances_SVM","SVM",72,13,2512,2243,269,1400,1265,135,0.910772548178425,0.599009900990099,1.75814208148925,286,135,151,17,1.1,35.79,9.4,0,0,0,0,0,0,0.701198465708937,261.096407824904,83.0562930300149
8.7,"random_instances_SVM","SVM",72,14,2412,2158,254,1500,1350,150,0.908044695575603,0.589108910891089,1.74760680487938,309,150,159,23,1.1,38.34,9,0,0,0,0,0,0,0.685335744103997,239.215594946493,81.1418518295543
8.7,"random_instances_SVM","SVM",72,15,2312,2066,246,1600,1442,158,0.897936258848239,0.589108910891089,1.73230992824053,331,158,173,22,1.1,40.9,9.1,0,0,0,0,0,0,0.687513635244156,235.020369907895,83.0296928353202
8.7,"random_instances_SVM","SVM",72,16,2212,1979,233,1700,1529,171,0.898664438849823,0.594059405940594,1.73709091240311,359,171,188,28,1.1,43.46,8.9,0,0,0,0,0,0,0.734763872118791,245.377768619062,86.3455874084735
8.7,"random_instances_SVM","SVM",72,17,2112,1894,218,1800,1614,186,0.903885884597585,0.589108910891089,1.74279246106429,385,186,199,26,1.1,46.01,8.7,0,0,0,0,0,0,0.711539117878808,231.970019438878,85.0526746049061
8.7,"random_instances_SVM","SVM",72,18,2012,1806,206,1900,1702,198,0.906743567743324,0.599009900990099,1.73800456968774,408,198,210,23,1.1,48.57,8.6,0,0,0,0,0,0,0.624407907614338,212.640084527647,79.6405366616467
8.7,"random_instances_SVM","SVM",72,19,1912,1723,189,2000,1785,215,0.914263860821662,0.599009900990099,1.7621942341293,446,215,231,38,1.1,51.12,8.3,0,0,0,0,0,0,0.682150935228596,211.839410274358,82.7946578602528
8.7,"random_instances_SVM","SVM",72,20,1812,1631,181,2100,1877,223,0.913576605665133,0.594059405940594,1.76543952737815,461,222,239,15,1.1,53.68,8.4,0,0,0,0,0,0,0.622088981287242,199.189660592904,78.939362522041
8.7,"random_instances_SVM","SVM",72,21,1712,1536,176,2200,1972,228,0.912485746864316,0.589108910891089,1.74847310578904,469,227,242,8,1.1,56.24,8.6,0,0,0,0,0,0,0.582975831786743,186.933073398552,77.2300142900854
8.7,"random_instances_SVM","SVM",72,22,1612,1448,164,2300,2060,240,0.914091694232144,0.594059405940594,1.76784449087111,496,239,257,27,1.1,58.79,8.6,0,0,0,0,0,0,0.629733953650103,184.357835122663,81.3968436357492
8.7,"random_instances_SVM","SVM",72,23,1512,1366,146,2400,2142,258,0.918776883389599,0.589108910891089,1.77272354650368,526,257,269,30,1,61.35,8.3,0,0,0,0,0,0,0.629844099958517,170.050225005377,80.6327876473217
8.7,"random_instances_SVM","SVM",72,24,1412,1277,135,2500,2231,269,0.919296205561269,0.589108910891089,1.77435588862754,543,266,277,17,1,63.91,8.3,0,0,0,0,0,0,0.595301492852866,155.057589195376,77.858993706463
8.7,"random_instances_SVM","SVM",72,25,1312,1191,121,2600,2317,283,0.921830723551266,0.589108910891089,1.77599123967696,561,278,283,18,1,66.46,8.2,0,0,0,0,0,0,0.553181251885607,137.749913664396,74.7924558341831
8.7,"random_instances_SVM","SVM",72,26,1212,1097,115,2700,2411,289,0.921729117039418,0.608910891089109,1.77109420500874,585,284,301,24,1.1,69.02,8.3,0,0,0,0,0,0,0.537914958742515,129.665970515608,73.7243310808483
8.7,"random_instances_SVM","SVM",72,27,1112,1007,105,2800,2501,299,0.921415830294552,0.603960396039604,1.77599123967696,602,294,308,17,1,71.57,8.4,0,0,0,0,0,0,0.488257801917318,117.000312774622,70.874080823177
8.7,"random_instances_SVM","SVM",72,28,1012,921,91,2900,2587,313,0.922163767117883,0.613861386138614,1.77272354650368,620,307,313,18,1,74.13,8.3,0,0,0,0,0,0,0.426562174830211,106.493549891322,66.6133933208269
8.7,"random_instances_SVM","SVM",72,29,912,828,84,3000,2680,320,0.921665612969514,0.608910891089109,1.77435588862754,637,313,324,17,1,76.69,8.4,0,0,0,0,0,0,0.407123345943947,95.4492044728751,65.0537168862267
8.7,"random_instances_SVM","SVM",72,30,812,737,75,3100,2771,329,0.924197308556404,0.608910891089109,1.77109420500874,659,323,336,22,1,79.24,8.4,0,0,0,0,0,0,0.359266587616408,85.0561458985061,62.4405067107808
8.7,"random_instances_SVM","SVM",72,31,712,646,66,3200,2862,338,0.924808358829048,0.603960396039604,1.77109420500874,677,331,346,18,1,81.8,8.5,0,0,0,0,0,0,0.287628315259305,76.82029396838,59.6316498922093
8.7,"random_instances_SVM","SVM",72,32,612,556,56,3300,2952,348,0.926709247321546,0.613861386138614,1.77109420500874,694,341,353,17,1,84.36,8.5,0,0,0,0,0,0,0.215664159706049,66.9603366185742,55.2108877409922
8.7,"random_instances_SVM","SVM",72,33,512,465,47,3400,3043,357,0.925621210923837,0.618811881188119,1.77109420500874,717,351,366,23,1,86.91,8.5,0,0,0,0,0,0,0.11538079065428,58.4975202169453,50.810214507403
8.7,"random_instances_SVM","SVM",72,34,412,377,35,3500,3131,369,0.925886516815886,0.623762376237624,1.77272354650368,735,360,375,18,1,89.47,8.5,0,0,0,0,0,0,0.0619000253415151,44.6482713806558,40.6581086816645
8.7,"random_instances_SVM","SVM",72,35,312,285,27,3600,3223,377,0.925849825575496,0.618811881188119,1.77599123967696,748,368,380,13,1,92.02,8.5,0,0,0,0,0,0,0.0331462423965889,35.8798151058637,34.2613442913845
8.7,"random_instances_SVM","SVM",72,36,212,191,21,3700,3317,383,0.925491380380919,0.618811881188119,1.77599123967696,755,372,383,7,1,94.58,8.7,0,0,0,0,0,0,0.0180255414096761,26.2529463125615,25.8113514355093
8.7,"random_instances_SVM","SVM",72,37,112,99,13,3800,3409,391,0.923349176422783,0.618811881188119,1.77272354650368,777,382,395,22,1,97.14,8.7,0,0,0,0,0,0,0.000958439380527014,16.6255722517376,16.6180087252059
8.7,"random_instances_SVM","SVM",72,38,12,9,3,3900,3499,401,0.922420605800613,0.618811881188119,1.77435588862754,792,390,402,15,1,99.69,8.7,0,0,0,0,0,0,0.000292400759899054,2.71765571617242,2.71765571617242
8.7,"random_instances_SVM","SVM",72,39,0,0,0,3912,3508,404,0.923320952391714,0.618811881188119,1.77272354650368,797,394,403,5,1,100,8.7,0,0,0,0,0,0,0,0,0
8.7,"random_instances_SVM","SVM",73,0,3812,3414,398,100,94,6,0.908913995732527,0.504950495049505,1.76543952737815,18,6,12,0,2,2.56,15.7,0,0,0,0,0,0,0.467379312529605,279.480722786005,54.1118281910473
8.7,"random_instances_SVM","SVM",73,1,3712,3330,382,200,178,22,0.930100364654491,0.584158415841584,1.77599123967696,55,22,33,37,1.5,5.11,8.1,0,0,0,0,0,0,0.371499794205233,340.412623409124,42.3657707810028
8.7,"random_instances_SVM","SVM",73,2,3612,3244,368,300,264,36,0.931965973108146,0.589108910891089,1.77745829377458,77,36,41,22,1.1,7.67,7.3,0,0,0,0,0,0,0.488224544915274,400.237118917868,55.5786154244954
8.7,"random_instances_SVM","SVM",73,3,3512,3157,355,400,351,49,0.93280140442779,0.599009900990099,1.79053986355397,108,49,59,31,1.2,10.22,7.2,0,0,0,0,0,0,0.710826786046415,445.617369237706,78.0826929796255
8.7,"random_instances_SVM","SVM",73,4,3412,3066,346,500,442,58,0.933248755320234,0.603960396039604,1.77908302713269,126,58,68,18,1.2,12.78,7.6,0,0,0,0,0,0,0.680381204828309,430.868152105167,74.6029267783136
8.7,"random_instances_SVM","SVM",73,5,3312,2972,340,600,536,64,0.92852264131773,0.594059405940594,1.77185147608997,139,64,75,13,1.2,15.34,8.4,0,0,0,0,0,0,0.658752637296668,380.100048185471,74.7835294879965
8.7,"random_instances_SVM","SVM",73,6,3212,2885,327,700,623,77,0.934031972182402,0.594059405940594,1.77509959978583,163,77,86,24,1.1,17.89,8.1,0,0,0,0,0,0,0.697550816563126,355.774091989276,77.651565444102
8.7,"random_instances_SVM","SVM",73,7,3112,2799,313,800,709,91,0.935922982264024,0.594059405940594,1.79053986355397,191,91,100,28,1.1,20.45,7.8,0,0,0,0,0,0,0.824429136627484,379.334638128285,88.8412424007826
8.7,"random_instances_SVM","SVM",73,8,3012,2707,305,900,801,99,0.934904094742435,0.594059405940594,1.78725145241797,210,99,111,19,1.1,23.01,8.1,0,0,0,0,0,0,0.797857979812708,351.688244708619,86.9328449846318
8.7,"random_instances_SVM","SVM",73,9,2912,2618,294,1000,890,110,0.936720311141721,0.589108910891089,1.80110497237569,232,110,122,22,1.1,25.56,8.1,0,0,0,0,0,0,0.783431558979355,349.044309829818,85.1024994020165
8.7,"random_instances_SVM","SVM",73,10,2812,2531,281,1100,977,123,0.93540930489857,0.594059405940594,1.77509959978583,258,123,135,26,1.1,28.12,7.9,0,0,0,0,0,0,0.673850990194795,323.212687489371,75.8448982246069
8.7,"random_instances_SVM","SVM",73,11,2712,2438,274,1200,1070,130,0.937861973198465,0.599009900990099,1.78725145241797,275,130,145,17,1.1,30.67,8.2,0,0,0,0,0,0,0.71170329970255,309.320579781257,80.1711718790394
8.7,"random_instances_SVM","SVM",73,12,2612,2351,261,1300,1157,143,0.938234530408577,0.589108910891089,1.77509959978583,299,143,156,24,1.1,33.23,8.1,0,0,0,0,0,0,0.679965460474787,288.271294035602,77.3044026307677
8.7,"random_instances_SVM","SVM",73,13,2512,2265,247,1400,1243,157,0.940818440452943,0.599009900990099,1.79449541284404,328,157,171,29,1.1,35.79,7.9,0,0,0,0,0,0,0.715385981738581,284.687204230568,81.1584920255727
8.7,"random_instances_SVM","SVM",73,14,2412,2176,236,1500,1332,168,0.940949682197412,0.584158415841584,1.79614325068871,345,168,177,17,1.1,38.34,7.9,0,0,0,0,0,0,0.803724536768016,298.772923133156,88.0856406869983
8.7,"random_instances_SVM","SVM",73,15,2312,2081,231,1600,1427,173,0.942157670727166,0.594059405940594,1.79285059578368,358,173,185,13,1.1,40.9,8.2,0,0,0,0,0,0,0.759349899272589,273.859959937766,84.8952998826075
8.7,"random_instances_SVM","SVM",73,16,2212,1990,222,1700,1518,182,0.941835916772979,0.603960396039604,1.80276497695853,373,182,191,15,1,43.46,8.3,0,0,0,0,0,0,0.730389859037851,250.129091186411,83.6361955223782
8.7,"random_instances_SVM","SVM",73,17,2112,1903,209,1800,1605,195,0.940921458166344,0.608910891089109,1.79779411764706,394,193,201,21,1,46.01,8.2,0,0,0,0,0,0,0.694925265463712,233.609071789498,80.6829218553052
8.7,"random_instances_SVM","SVM",73,18,2012,1811,201,1900,1697,203,0.940690021111577,0.603960396039604,1.79944802207912,409,198,211,15,1.1,48.57,8.4,0,0,0,0,0,0,0.65223328577958,215.434671135181,77.5161019675634
8.7,"random_instances_SVM","SVM",73,19,1912,1726,186,2000,1782,218,0.942030662587356,0.603960396039604,1.79944802207912,438,212,226,29,1.1,51.12,8.2,0,0,0,0,0,0,0.668597154548958,212.429981259644,79.4267389969175
8.7,"random_instances_SVM","SVM",73,20,1812,1633,179,2100,1875,225,0.94347573297809,0.623762376237624,1.79449541284404,448,219,229,10,1,53.68,8.3,0,0,0,0,0,0,0.648625019940485,197.803205637913,78.9457271374443
8.7,"random_instances_SVM","SVM",73,21,1712,1539,173,2200,1969,231,0.94492362577193,0.603960396039604,1.79779411764706,469,229,240,21,1,56.24,8.5,0,0,0,0,0,0,0.679054282911165,193.250780644415,81.5344696834037
8.7,"random_instances_SVM","SVM",73,22,1612,1451,161,2300,2057,243,0.945245379726118,0.613861386138614,1.79944802207912,494,241,253,25,1,58.79,8.5,0,0,0,0,0,0,0.652123867509814,181.178649450273,79.8037518476156
8.7,"random_instances_SVM","SVM",73,23,1512,1366,146,2400,2142,258,0.946173950348287,0.628712871287129,1.79944802207912,520,254,266,26,1,61.35,8.3,0,0,0,0,0,0,0.603692790660223,160.964690268625,76.541669965202
8.7,"random_instances_SVM","SVM",73,24,1412,1273,139,2500,2235,265,0.945671562595259,0.633663366336634,1.79944802207912,533,262,271,13,1,63.91,8.4,0,0,0,0,0,0,0.578708841058102,150.967653273129,75.5294389446673
8.7,"random_instances_SVM","SVM",73,25,1312,1185,127,2600,2323,277,0.945694141820114,0.613861386138614,1.79614325068871,554,271,283,21,1,66.46,8.4,0,0,0,0,0,0,0.478947947896071,130.663325317096,69.1375005998388
8.7,"random_instances_SVM","SVM",73,26,1212,1094,118,2700,2414,286,0.94535263104418,0.618811881188119,1.80110497237569,577,281,296,23,1.1,69.02,8.4,0,0,0,0,0,0,0.447364835667404,119.970185724084,68.9018953438502
8.7,"random_instances_SVM","SVM",73,27,1112,1006,106,2800,2502,298,0.944855888097367,0.618811881188119,1.79944802207912,600,292,308,23,1.1,71.57,8.4,0,0,0,0,0,0,0.433794097060674,112.343339355321,68.4360734288754
8.7,"random_instances_SVM","SVM",73,28,1012,919,93,2900,2589,311,0.945564311277198,0.628712871287129,1.80276497695853,620,303,317,20,1,74.13,8.3,0,0,0,0,0,0,0.367366581287924,101.210959421679,64.9489006862119
8.7,"random_instances_SVM","SVM",73,29,912,830,82,3000,2678,322,0.945338519028646,0.638613861386139,1.79614325068871,644,314,330,24,1.1,76.69,8.3,0,0,0,0,0,0,0.315454407717965,91.2913023682668,61.6894473723099
8.7,"random_instances_SVM","SVM",73,30,812,741,71,3100,2767,333,0.945754823486914,0.643564356435644,1.79779411764706,659,324,335,15,1,79.24,8.3,0,0,0,0,0,0,0.249084596527574,82.72198542694,59.0968538625053
8.7,"random_instances_SVM","SVM",73,31,712,647,65,3200,2861,339,0.945987671743235,0.638613861386139,1.80276497695853,682,332,350,23,1.1,81.8,8.4,0,0,0,0,0,0,0.192088076773925,72.6577173811429,55.1977323885368
8.7,"random_instances_SVM","SVM",73,32,612,556,56,3300,2952,348,0.946439256240339,0.643564356435644,1.79944802207912,701,342,359,19,1,84.36,8.5,0,0,0,0,0,0,0.166831199860742,65.9524743458942,52.307211783303
8.7,"random_instances_SVM","SVM",73,33,512,463,49,3400,3045,355,0.945898766045368,0.638613861386139,1.79218861112631,725,353,372,24,1.1,86.91,8.6,0,0,0,0,0,0,0.121517179649441,56.9724372268778,47.5234483368079
8.7,"random_instances_SVM","SVM",73,34,412,372,40,3500,3136,364,0.946368696162667,0.638613861386139,1.79384039786467,743,361,382,18,1.1,89.47,8.6,0,0,0,0,0,0,0.0758700528867305,45.4517515852019,39.8971332862027
8.7,"random_instances_SVM","SVM",73,35,312,282,30,3600,3226,374,0.94637434096888,0.643564356435644,1.79218861112631,767,372,395,24,1.1,92.02,8.6,0,0,0,0,0,0,0.0582366516746608,34.3234184476566,31.5841337208211
8.7,"random_instances_SVM","SVM",73,36,212,187,25,3700,3321,379,0.945901588448474,0.643564356435644,1.79218861112631,778,377,401,11,1.1,94.58,8.8,0,0,0,0,0,0,0.0232081778293447,23.6921854368852,23.1137734045048
8.7,"random_instances_SVM","SVM",73,37,112,100,12,3800,3408,392,0.945722365851184,0.643564356435644,1.80276497695853,803,390,413,25,1.1,97.14,8.7,0,0,0,0,0,0,0.000897393049841665,12.0083166182626,12.0031202015576
8.7,"random_instances_SVM","SVM",73,38,12,10,2,3900,3498,402,0.945744945076041,0.648514851485149,1.79449541284404,813,398,415,10,1,99.69,8.7,0,0,0,0,0,0,0.000234677574817113,0.726008223196157,0.726008223196157
8.7,"random_instances_SVM","SVM",73,39,0,0,0,3912,3508,404,0.945753412285362,0.648514851485149,1.79285059578368,817,400,417,4,1,100,8.7,0,0,0,0,0,0,0,0,0
8.7,"random_instances_SVM","SVM",74,0,3812,3424,388,100,89,11,0.892170267067732,0.541062801932367,1.74408112748034,30,11,19,0,1.7,2.56,8.1,0,0,0,0,0,0,0.472664452814757,405.940817233799,54.0514672349883
8.7,"random_instances_SVM","SVM",74,1,3712,3340,372,200,173,27,0.917921351883617,0.603864734299517,1.77011218908452,62,27,35,32,1.3,5.11,6.4,0,0,0,0,0,0,0.486151159357844,452.988448616685,52.3816983337807
8.7,"random_instances_SVM","SVM",74,2,3612,3253,359,300,260,40,0.917893730855179,0.613526570048309,1.77878920961925,84,40,44,22,1.1,7.67,6.5,0,0,0,0,0,0,0.740423967833425,447.810597644611,78.4348911321752
8.7,"random_instances_SVM","SVM",74,3,3512,3162,350,400,351,49,0.916029311435386,0.623188405797101,1.75820613982651,105,49,56,21,1.1,10.22,7.2,0,0,0,0,0,0,0.696977600620424,356.022869666553,75.3277897370387
8.7,"random_instances_SVM","SVM",74,4,3412,3068,344,500,445,55,0.921248304759385,0.628019323671498,1.76848823294775,120,55,65,15,1.2,12.78,8.1,0,0,0,0,0,0,0.727541446907774,368.500641531429,78.3051378962616
8.7,"random_instances_SVM","SVM",74,5,3312,2975,337,600,538,62,0.926210422518875,0.642512077294686,1.78092472519458,135,62,73,15,1.2,15.34,8.7,0,0,0,0,0,0,0.73521098655623,352.17673019282,79.8276856442474
8.7,"random_instances_SVM","SVM",74,6,3212,2883,329,700,630,70,0.928541637319328,0.661835748792271,1.77011218908452,152,70,82,17,1.2,17.89,9,0,0,0,0,0,0,0.722322881007032,330.11443683663,80.5166324816113
8.7,"random_instances_SVM","SVM",74,7,3112,2793,319,800,720,80,0.925329311711607,0.661835748792271,1.76848823294775,178,80,98,26,1.2,20.45,9,0,0,0,0,0,0,0.751331244615138,327.183200525598,82.1706185587329
8.7,"random_instances_SVM","SVM",74,8,3012,2701,311,900,812,88,0.927363600456301,0.661835748792271,1.76848823294775,195,88,107,17,1.2,23.01,9.2,0,0,0,0,0,0,0.64562930203474,296.239831718441,74.1120854413138
8.7,"random_instances_SVM","SVM",74,9,2912,2608,304,1000,905,95,0.929610571120005,0.657004830917874,1.79779411764706,211,95,116,16,1.2,25.56,9.5,0,0,0,0,0,0,0.738810883876167,312.414997872243,82.6073834486102
8.7,"random_instances_SVM","SVM",74,10,2812,2517,295,1100,996,104,0.931742914515679,0.642512077294686,1.794055967408,229,104,125,18,1.2,28.12,9.6,0,0,0,0,0,0,0.702866460545483,285.552242130037,80.1311859832278
8.7,"random_instances_SVM","SVM",74,11,2712,2425,287,1200,1088,112,0.932872614578937,0.657004830917874,1.78042412617221,248,112,136,19,1.2,30.67,9.7,0,0,0,0,0,0,0.678485601550727,279.904547628043,77.4430014184594
8.7,"random_instances_SVM","SVM",74,12,2612,2333,279,1300,1180,120,0.930312145242415,0.647342995169082,1.7820620508513,264,120,144,16,1.2,33.23,9.8,0,0,0,0,0,0,0.692380350384316,265.5671906081,79.4139658913239
8.7,"random_instances_SVM","SVM",74,13,2512,2244,268,1400,1269,131,0.930948809947991,0.652173913043478,1.78910912190963,277,131,146,13,1.1,35.79,9.7,0,0,0,0,0,0,0.735141549438272,257.759850953993,84.5168950261666
8.7,"random_instances_SVM","SVM",74,14,2412,2155,257,1500,1358,142,0.92828199965198,0.642512077294686,1.76792893875643,304,142,162,27,1.1,38.34,9.6,0,0,0,0,0,0,0.676194753490365,236.629689244783,79.154659331529
8.7,"random_instances_SVM","SVM",74,15,2312,2067,245,1600,1446,154,0.928657645638782,0.642512077294686,1.76630101155684,328,154,174,24,1.1,40.9,9.4,0,0,0,0,0,0,0.704718060821697,236.213747759971,81.1797255063065
8.7,"random_instances_SVM","SVM",74,16,2212,1977,235,1700,1536,164,0.93111867927291,0.652173913043478,1.77011218908452,346,164,182,18,1.1,43.46,9.4,0,0,0,0,0,0,0.769041022276213,236.751958455147,86.4861130550296
8.7,"random_instances_SVM","SVM",74,17,2112,1889,223,1800,1624,176,0.934342053292014,0.657004830917874,1.79240398217098,370,176,194,24,1.1,46.01,9.2,0,0,0,0,0,0,0.773855500659473,236.722811421551,87.5184128489764
8.7,"random_instances_SVM","SVM",74,18,2012,1800,212,1900,1713,187,0.931853398629446,0.652173913043478,1.7820620508513,396,187,209,26,1.1,48.57,9.2,0,0,0,0,0,0,0.670770939451525,207.30388523669,80.2903758414604
8.7,"random_instances_SVM","SVM",74,19,1912,1711,201,2000,1802,198,0.929139632585084,0.647342995169082,1.75981917298232,420,198,222,24,1.1,51.12,9.1,0,0,0,0,0,0,0.621638176873043,191.793494303946,76.5743392800734
8.7,"random_instances_SVM","SVM",74,20,1812,1624,188,2100,1889,211,0.934724604535926,0.642512077294686,1.79449541284404,438,211,227,18,1.1,53.68,9,0,0,0,0,0,0,0.672243164250191,186.132820595847,82.3928653789435
8.7,"random_instances_SVM","SVM",74,21,1712,1533,179,2200,1980,220,0.935176208350943,0.647342995169082,1.79075503646521,453,220,233,15,1.1,56.24,9,0,0,0,0,0,0,0.668634290057908,176.27989235762,82.8084937312908
8.7,"random_instances_SVM","SVM",74,22,1612,1446,166,2300,2067,233,0.936809992183249,0.661835748792271,1.78582635287861,481,233,248,28,1.1,58.79,8.9,0,0,0,0,0,0,0.604361309972208,163.363358120941,77.7208218945535
8.7,"random_instances_SVM","SVM",74,23,1512,1358,154,2400,2155,245,0.936247904254469,0.652173913043478,1.794055967408,505,245,260,24,1.1,61.35,8.8,0,0,0,0,0,0,0.560270561840136,149.000435578761,74.0728966945631
8.7,"random_instances_SVM","SVM",74,24,1412,1268,144,2500,2245,255,0.936490969304752,0.652173913043478,1.79449541284404,524,255,269,19,1.1,63.91,8.8,0,0,0,0,0,0,0.576036382467104,143.972550099273,76.1187152663042
8.7,"random_instances_SVM","SVM",74,25,1312,1175,137,2600,2338,262,0.935645765834442,0.657004830917874,1.77878920961925,540,262,278,16,1.1,66.46,8.9,0,0,0,0,0,0,0.560748424678005,139.025090458654,75.1685896663943
8.7,"random_instances_SVM","SVM",74,26,1212,1089,123,2700,2424,276,0.93659040500714,0.652173913043478,1.78793418647166,564,276,288,24,1,69.02,8.8,0,0,0,0,0,0,0.559016191649146,130.759950584439,77.1153140585811
8.7,"random_instances_SVM","SVM",74,27,1112,1001,111,2800,2512,288,0.935658195297245,0.652173913043478,1.79449541284404,582,286,296,18,1,71.57,8.7,0,0,0,0,0,0,0.514762539329859,119.440706979287,73.493426826481
8.7,"random_instances_SVM","SVM",74,28,1012,913,99,2900,2600,300,0.934659695119089,0.647342995169082,1.7722794595383,611,298,313,29,1.1,74.13,8.7,0,0,0,0,0,0,0.439792762242948,106.673623089509,69.9198410735718
8.7,"random_instances_SVM","SVM",74,29,912,822,90,3000,2691,309,0.93489447386084,0.647342995169082,1.78582635287861,624,305,319,13,1,76.69,8.7,0,0,0,0,0,0,0.413923525312779,97.9670731384577,66.4257034795936
8.7,"random_instances_SVM","SVM",74,30,812,738,74,3100,2775,325,0.935872258267663,0.642512077294686,1.80110497237569,652,320,332,28,1,79.24,8.5,0,0,0,0,0,0,0.326634618266851,82.8615325195425,60.6147836813894
8.7,"random_instances_SVM","SVM",74,31,712,651,61,3200,2862,338,0.935723104714079,0.647342995169082,1.77878920961925,676,332,344,24,1,81.8,8.5,0,0,0,0,0,0,0.264373089375028,76.8439157882211,58.6733922185012
8.7,"random_instances_SVM","SVM",74,32,612,561,51,3300,2952,348,0.935228688304978,0.647342995169082,1.7755283678051,701,341,360,25,1.1,84.36,8.5,0,0,0,0,0,0,0.209560682648682,70.4523703993469,57.0789279913221
8.7,"random_instances_SVM","SVM",74,33,512,471,41,3400,3042,358,0.935294978773238,0.642512077294686,1.79944802207912,726,353,373,25,1.1,86.91,8.5,0,0,0,0,0,0,0.121494473786143,58.4409532761213,49.9788061500023
8.7,"random_instances_SVM","SVM",74,34,412,377,35,3500,3136,364,0.934690078250372,0.63768115942029,1.78582635287861,738,360,378,12,1.1,89.47,8.6,0,0,0,0,0,0,0.0786572482490931,48.6967856798346,43.8489263289786
8.7,"random_instances_SVM","SVM",74,35,312,284,28,3600,3229,371,0.935145825219656,0.647342995169082,1.78746623015398,755,368,387,17,1.1,92.02,8.7,0,0,0,0,0,0,0.0568264906574567,38.146200342719,35.4829890327611
8.7,"random_instances_SVM","SVM",74,36,212,191,21,3700,3322,378,0.934068605110443,0.63768115942029,1.7820620508513,770,375,395,15,1.1,94.58,8.8,0,0,0,0,0,0,0.0232472726579261,27.8188654568942,27.1763020203684
8.7,"random_instances_SVM","SVM",74,37,112,102,10,3800,3411,389,0.933659813889509,0.63768115942029,1.77878920961925,797,388,409,27,1.1,97.14,8.8,0,0,0,0,0,0,0.00157709404097971,13.1759029986105,13.1649664236172
8.7,"random_instances_SVM","SVM",74,38,12,12,0,3900,3501,399,0.932846374601912,0.63768115942029,1.78370299196626,815,396,419,18,1.1,99.69,8.8,0,0,0,0,0,0,0.00131234245787946,0.916255597971437,0.916255597971437
8.7,"random_instances_SVM","SVM",74,39,0,0,0,3912,3513,399,0.932249760387578,0.63768115942029,1.78370299196626,813,396,417,-2,1.1,100,8.8,0,0,0,0,0,0,0,0,0
8.7,"random_instances_SVM","SVM",75,0,3812,3432,380,100,84,16,0.909376534118801,0.533333333333333,1.75337793519612,36,16,20,0,1.2,2.56,5.2,0,0,0,0,0,0,0.7498680792689,510.145312070324,79.0786785779939
8.7,"random_instances_SVM","SVM",75,1,3712,3347,365,200,169,31,0.913977526864128,0.561904761904762,1.76679821099711,65,29,36,29,1.2,5.11,5.5,0,0,0,0,0,0,0.817664365480716,486.7264531604,85.27233328458
8.7,"random_instances_SVM","SVM",75,2,3612,3258,354,300,258,42,0.916530300550918,0.571428571428571,1.75498949579832,81,38,43,16,1.1,7.67,6.1,0,0,0,0,0,0,0.816242689479978,439.595369437908,85.5423923581704
8.7,"random_instances_SVM","SVM",75,3,3512,3164,348,400,352,48,0.915935744286261,0.585714285714286,1.75660402155342,99,46,53,18,1.2,10.22,7.3,0,0,0,0,0,0,0.844817165773605,413.338126341413,87.8741572531994
8.7,"random_instances_SVM","SVM",75,4,3412,3074,338,500,442,58,0.915003000054549,0.566666666666667,1.76842659644503,121,57,64,22,1.1,12.78,7.6,0,0,0,0,0,0,0.841603564256065,394.719606052288,88.6295126405526
8.7,"random_instances_SVM","SVM",75,5,3312,2988,324,600,528,72,0.91523754977363,0.571428571428571,1.76679821099711,144,67,77,23,1.1,15.34,7.3,0,0,0,0,0,0,0.833391242701164,372.2079892902,88.324661258976
8.7,"random_instances_SVM","SVM",75,6,3212,2896,316,700,620,80,0.91605574646812,0.580952380952381,1.76193099829463,161,78,83,17,1.1,17.89,7.8,0,0,0,0,0,0,0.789729610988863,365.608597130549,84.5724766466744
8.7,"random_instances_SVM","SVM",75,7,3112,2806,306,800,710,90,0.916605301914578,0.576190476190476,1.76355042016807,182,89,93,21,1,20.45,7.9,0,0,0,0,0,0,0.805948512218721,327.318523277425,86.7675347788748
8.7,"random_instances_SVM","SVM",75,8,3012,2716,296,900,800,100,0.920078546882668,0.580952380952381,1.75984200131666,206,99,107,24,1.1,23.01,8,0,0,0,0,0,0,0.822886523464278,337.06590450841,88.0777226334253
8.7,"random_instances_SVM","SVM",75,9,2912,2629,283,1000,887,113,0.921907216494838,0.585714285714286,1.76355042016807,231,111,120,25,1.1,25.56,7.8,0,0,0,0,0,0,0.79681471507224,329.792444814435,86.3202521683966
8.7,"random_instances_SVM","SVM",75,10,2812,2537,275,1100,979,121,0.920424916816662,0.576190476190476,1.76517282165856,247,118,129,16,1.1,28.12,8.1,0,0,0,0,0,0,0.794875814554426,308.79472001894,86.2973674234586
8.7,"random_instances_SVM","SVM",75,11,2712,2441,271,1200,1075,125,0.920520373097691,0.6,1.76355042016807,259,125,134,12,1.1,30.67,8.6,0,0,0,0,0,0,0.761557185619279,283.717751499476,84.7574302169016
8.7,"random_instances_SVM","SVM",75,12,2612,2345,267,1300,1171,129,0.922579501445486,0.595238095238095,1.76885976408912,266,129,137,7,1.1,33.23,9.1,0,0,0,0,0,0,0.76052290885515,267.583998491439,85.068841743279
8.7,"random_instances_SVM","SVM",75,13,2512,2260,252,1400,1256,144,0.925609556537398,0.6,1.77048406139315,299,144,155,33,1.1,35.79,8.7,0,0,0,0,0,0,0.732524054418169,259.467056338433,84.609863426506
8.7,"random_instances_SVM","SVM",75,14,2412,2178,234,1500,1338,162,0.923692248949992,0.6,1.7770111915734,326,160,166,27,1,38.34,8.3,0,0,0,0,0,0,0.737721632214673,247.338778751308,85.0767427271969
8.7,"random_instances_SVM","SVM",75,15,2312,2088,224,1600,1428,172,0.925980472372234,0.604761904761905,1.7737416217637,348,170,178,22,1,40.9,8.3,0,0,0,0,0,0,0.697886753571016,228.499254928402,83.2677630415766
8.7,"random_instances_SVM","SVM",75,16,2212,1997,215,1700,1519,181,0.92623274968637,0.604761904761905,1.77537490134175,362,177,185,14,1,43.46,8.4,0,0,0,0,0,0,0.688264827895768,219.871307543478,82.6757925188859
8.7,"random_instances_SVM","SVM",75,17,2112,1907,205,1800,1609,191,0.926605029182356,0.60952380952381,1.77048406139315,380,185,195,18,1.1,46.01,8.4,0,0,0,0,0,0,0.666758438418596,206.560471653677,80.8602517945446
8.7,"random_instances_SVM","SVM",75,18,2012,1814,198,1900,1702,198,0.927573228604167,0.619047619047619,1.76517282165856,405,196,209,25,1.1,48.57,8.6,0,0,0,0,0,0,0.667012343024265,202.515925704383,81.8498606733285
8.7,"random_instances_SVM","SVM",75,19,1912,1734,178,2000,1782,218,0.928391425298654,0.619047619047619,1.76193099829463,438,213,225,33,1.1,51.12,8.2,0,0,0,0,0,0,0.627634311648918,188.498489751595,78.4330870526563
8.7,"random_instances_SVM","SVM",75,20,1812,1644,168,2100,1872,228,0.929354170075833,0.614285714285714,1.76842659644503,458,222,236,20,1.1,53.68,8.2,0,0,0,0,0,0,0.619973369231691,178.291234773625,78.8806800634445
8.7,"random_instances_SVM","SVM",75,21,1712,1551,161,2200,1965,235,0.92957508318334,0.619047619047619,1.7737416217637,473,230,243,15,1.1,56.24,8.4,0,0,0,0,0,0,0.603388096571648,171.719761500582,77.4701235004274
8.7,"random_instances_SVM","SVM",75,22,1612,1458,154,2300,2058,242,0.929168712158416,0.619047619047619,1.77211134453782,490,238,252,17,1.1,58.79,8.5,0,0,0,0,0,0,0.60906074785713,164.818397200643,80.0499122099246
8.7,"random_instances_SVM","SVM",75,23,1512,1364,148,2400,2152,248,0.929933726067765,0.619047619047619,1.76679821099711,499,244,255,9,1,61.35,8.7,0,0,0,0,0,0,0.579579981877112,151.438024631766,77.5093575174108
8.7,"random_instances_SVM","SVM",75,24,1412,1277,135,2500,2239,261,0.93062373861345,0.619047619047619,1.77537490134175,524,257,267,25,1,63.91,8.6,0,0,0,0,0,0,0.523911777677699,145.595398200711,75.1013766049795
8.7,"random_instances_SVM","SVM",75,25,1312,1192,120,2600,2324,276,0.92966235749743,0.619047619047619,1.76842659644503,546,268,278,22,1,66.46,8.4,0,0,0,0,0,0,0.5,133.137513210979,72.3029382095266
8.7,"random_instances_SVM","SVM",75,26,1212,1102,110,2700,2414,286,0.930304641902598,0.614285714285714,1.77211134453782,565,277,288,19,1,69.02,8.4,0,0,0,0,0,0,0.481836915739805,123.807134068052,71.597823475572
8.7,"random_instances_SVM","SVM",75,27,1112,1015,97,2800,2501,299,0.92967735777016,0.614285714285714,1.77211134453782,594,287,307,29,1.1,71.57,8.4,0,0,0,0,0,0,0.423657850075261,112.100714874603,67.4409702713771
8.7,"random_instances_SVM","SVM",75,28,1012,922,90,2900,2594,306,0.929461899307278,0.60952380952381,1.77537490134175,605,294,311,11,1.1,74.13,8.5,0,0,0,0,0,0,0.403029549336993,104.060302774853,66.4075967805366
8.7,"random_instances_SVM","SVM",75,29,912,829,83,3000,2687,313,0.929416898489082,0.619047619047619,1.77537490134175,620,302,318,15,1.1,76.69,8.6,0,0,0,0,0,0,0.300214489114666,86.1828347105514,59.1870037764511
8.7,"random_instances_SVM","SVM",75,30,812,738,74,3100,2778,322,0.930183276059584,0.614285714285714,1.76193099829463,635,310,325,15,1,79.24,8.6,0,0,0,0,0,0,0.260497069186315,75.9952722512839,55.9162400433757
8.7,"random_instances_SVM","SVM",75,31,712,644,68,3200,2872,328,0.929345988108894,0.619047619047619,1.76517282165856,651,318,333,16,1,81.8,8.8,0,0,0,0,0,0,0.181682963514834,65.5279566012356,50.5287871360316
8.7,"random_instances_SVM","SVM",75,32,612,554,58,3300,2962,338,0.929250531827872,0.623809523809524,1.7737416217637,673,328,345,22,1.1,84.36,8.8,0,0,0,0,0,0,0.128161298287715,55.3555814745409,44.0229235436058
8.7,"random_instances_SVM","SVM",75,33,512,461,51,3400,3055,345,0.929579174166822,0.633333333333333,1.77211134453782,691,336,355,18,1.1,86.91,8.9,0,0,0,0,0,0,0.0859273951807547,43.350569022246,36.1433177862318
8.7,"random_instances_SVM","SVM",75,34,412,370,42,3500,3146,354,0.928167784868837,0.633333333333333,1.77048406139315,712,345,367,21,1.1,89.47,8.9,0,0,0,0,0,0,0.0688703136465392,37.8289394835442,33.2730657106587
8.7,"random_instances_SVM","SVM",75,35,312,285,27,3600,3231,369,0.928321878579631,0.628571428571429,1.76885976408912,731,357,374,19,1,92.02,8.8,0,0,0,0,0,0,0.051649990128067,27.3707808628828,24.6903004827812
8.7,"random_instances_SVM","SVM",75,36,212,196,16,3700,3320,380,0.928743249877292,0.623809523809524,1.76562009419152,760,368,392,29,1.1,94.58,8.7,0,0,0,0,0,0,0.0227147466334703,19.7540394720021,19.1387607911581
8.7,"random_instances_SVM","SVM",75,37,112,106,6,3800,3410,390,0.929937817051238,0.628571428571429,1.76517282165856,778,378,400,18,1.1,97.14,8.7,0,0,0,0,0,0,0.00158753626370525,8.81349241478124,8.80445351328212
8.7,"random_instances_SVM","SVM",75,38,12,11,1,3900,3505,395,0.930158730158749,0.628571428571429,1.7587010606259,790,384,406,12,1.1,99.69,8.9,0,0,0,0,0,0,0.000368135725207452,0.933349916231278,0.933349916231278
8.7,"random_instances_SVM","SVM",75,39,0,0,0,3912,3516,396,0.930090547100876,0.628571428571429,1.76517282165856,790,385,405,0,1.1,100,8.9,0,0,0,0,0,0,0,0,0
8.7,"random_instances_SVM","SVM",76,0,3812,3420,392,100,87,13,0.900001417414346,0.537313432835821,1.73200054772012,30,13,17,0,1.3,2.56,6.7,0,0,0,0,0,0,0.610335393897266,482.475797991788,66.8645845410798
8.7,"random_instances_SVM","SVM",76,1,3712,3336,376,200,171,29,0.898361469008229,0.54228855721393,1.75878406134465,63,29,34,33,1.2,5.11,5.9,0,0,0,0,0,0,0.871810019278065,548.528516497025,90.3017878253201
8.7,"random_instances_SVM","SVM",76,2,3612,3246,366,300,261,39,0.906388286487789,0.527363184079602,1.75146307032331,82,39,43,19,1.1,7.67,6.7,0,0,0,0,0,0,0.814439953228995,421.331012940784,86.2134341473833
8.7,"random_instances_SVM","SVM",76,3,3512,3153,359,400,354,46,0.900308996328888,0.54726368159204,1.73837992358649,98,46,52,16,1.1,10.22,7.7,0,0,0,0,0,0,0.877327279641099,418.926145443103,91.4857203155569
8.7,"random_instances_SVM","SVM",76,4,3412,3061,351,500,446,54,0.90151805077177,0.54726368159204,1.75307287093942,114,54,60,16,1.1,12.78,8.3,0,0,0,0,0,0,0.810891403080145,380.297434380161,86.6180365782794
8.7,"random_instances_SVM","SVM",76,5,3312,2974,338,600,533,67,0.906374112344256,0.552238805970149,1.76039910639639,139,67,72,25,1.1,15.34,8,0,0,0,0,0,0,0.832009746921086,359.016858689154,88.2616626980863
8.7,"random_instances_SVM","SVM",76,6,3212,2886,326,700,621,79,0.910949525874895,0.532338308457711,1.7677118992195,162,79,83,23,1.1,17.89,7.9,0,0,0,0,0,0,0.801009986559714,364.341364101735,85.3009231029125
8.7,"random_instances_SVM","SVM",76,7,3112,2794,318,800,713,87,0.911865175546763,0.54228855721393,1.77422280860889,183,87,96,21,1.1,20.45,8.2,0,0,0,0,0,0,0.839916914627762,354.700794322932,88.3768158704811
8.7,"random_instances_SVM","SVM",76,8,3012,2702,310,900,805,95,0.915675185326934,0.537313432835821,1.78318352986449,197,95,102,14,1.1,23.01,8.5,0,0,0,0,0,0,0.790379093192642,321.699962936696,85.3414798478007
8.7,"random_instances_SVM","SVM",76,9,2912,2611,301,1000,896,104,0.921140735071098,0.54228855721393,1.77259058891376,219,104,115,22,1.1,25.56,8.6,0,0,0,0,0,0,0.690813838576419,285.616519844846,77.2597489062091
8.7,"random_instances_SVM","SVM",76,10,2812,2520,292,1100,987,113,0.921557454890791,0.552238805970149,1.76933514246947,239,113,126,20,1.1,28.12,8.7,0,0,0,0,0,0,0.745165925345241,289.050052287908,83.1386656330792
8.7,"random_instances_SVM","SVM",76,11,2712,2427,285,1200,1080,120,0.923032983231992,0.552238805970149,1.76526208735329,252,120,132,13,1.1,30.67,9,0,0,0,0,0,0,0.720404599682039,275.271641596091,82.1929572369924
8.7,"random_instances_SVM","SVM",76,12,2612,2338,274,1300,1169,131,0.923307961616424,0.557213930348259,1.7677118992195,272,131,141,20,1.1,33.23,8.9,0,0,0,0,0,0,0.704092424972513,260.448976436706,80.7792762740213
8.7,"random_instances_SVM","SVM",76,13,2512,2250,262,1400,1257,143,0.927645249535804,0.572139303482587,1.77096136962248,297,143,154,25,1.1,35.79,8.8,0,0,0,0,0,0,0.705112382280939,251.0566506402,81.7793260093258
8.7,"random_instances_SVM","SVM",76,14,2412,2164,248,1500,1343,157,0.927360349250907,0.587064676616915,1.77422280860889,331,157,174,34,1.1,38.34,8.6,0,0,0,0,0,0,0.713022147624043,241.722889784634,83.8771829693581
8.7,"random_instances_SVM","SVM",76,15,2312,2076,236,1600,1431,169,0.927830930816014,0.592039800995025,1.77585803700392,357,169,188,26,1.1,40.9,8.5,0,0,0,0,0,0,0.692535218893997,229.319588736124,81.8790288532003
8.7,"random_instances_SVM","SVM",76,16,2212,1983,229,1700,1524,176,0.925239897379207,0.572139303482587,1.76609163166751,371,176,195,14,1.1,43.46,8.7,0,0,0,0,0,0,0.601079486517469,212.582563414376,74.6377270402092
8.7,"random_instances_SVM","SVM",76,17,2112,1892,220,1800,1615,185,0.924911057249354,0.572139303482587,1.77585803700392,391,185,206,20,1.1,46.01,8.7,0,0,0,0,0,0,0.689499962969891,213.672919287384,82.7534580493327
8.7,"random_instances_SVM","SVM",76,18,2012,1803,209,1900,1704,196,0.925806863120303,0.572139303482587,1.77422280860889,406,196,210,15,1.1,48.57,8.7,0,0,0,0,0,0,0.683874160267288,206.622761086217,82.154353832409
8.7,"random_instances_SVM","SVM",76,19,1912,1712,200,2000,1795,205,0.926945046845558,0.587064676616915,1.77422280860889,423,205,218,17,1.1,51.12,8.8,0,0,0,0,0,0,0.681333564415936,197.844413883627,83.5051569852422
8.7,"random_instances_SVM","SVM",76,20,1812,1620,192,2100,1887,213,0.926437612507274,0.582089552238806,1.77096136962248,441,213,228,18,1.1,53.68,8.9,0,0,0,0,0,0,0.669119297118928,185.908992659882,84.2246834307893
8.7,"random_instances_SVM","SVM",76,21,1712,1530,182,2200,1977,223,0.92577851483325,0.577114427860697,1.77585803700392,458,223,235,17,1.1,56.24,8.9,0,0,0,0,0,0,0.604613468288616,172.382693956544,78.3023875521315
8.7,"random_instances_SVM","SVM",76,22,1612,1438,174,2300,2069,231,0.92516052217544,0.577114427860697,1.77259058891376,474,231,243,16,1.1,58.79,9,0,0,0,0,0,0,0.619032904787659,167.213045969461,79.0119743520893
8.7,"random_instances_SVM","SVM",76,23,1512,1352,160,2400,2155,245,0.926769287465814,0.577114427860697,1.77422280860889,497,245,252,23,1,61.35,8.8,0,0,0,0,0,0,0.641969366702043,160.404219846097,80.3668923451944
8.7,"random_instances_SVM","SVM",76,24,1412,1266,146,2500,2241,259,0.925743079474435,0.582089552238806,1.76526208735329,527,257,270,30,1.1,63.91,8.7,0,0,0,0,0,0,0.610434857865294,151.284571345023,79.5756879944197
8.7,"random_instances_SVM","SVM",76,25,1312,1183,129,2600,2324,276,0.927272469561035,0.582089552238806,1.76609163166751,556,272,284,29,1,66.46,8.4,0,0,0,0,0,0,0.564292791495182,138.105869137289,75.2047403623583
8.7,"random_instances_SVM","SVM",76,26,1212,1092,120,2700,2415,285,0.928042125554572,0.582089552238806,1.77096136962248,579,282,297,23,1.1,69.02,8.5,0,0,0,0,0,0,0.533103566210784,129.650055953547,74.4736227465694
8.7,"random_instances_SVM","SVM",76,27,1112,1004,108,2800,2503,297,0.928957775226442,0.587064676616915,1.76526208735329,606,296,310,27,1,71.57,8.4,0,0,0,0,0,0,0.500744603274482,116.372092150428,73.8025449174145
8.7,"random_instances_SVM","SVM",76,28,1012,915,97,2900,2592,308,0.928888321923154,0.592039800995025,1.76526208735329,633,307,326,27,1.1,74.13,8.4,0,0,0,0,0,0,0.39727320879901,106.354927511273,71.4188393015428
8.7,"random_instances_SVM","SVM",76,29,912,829,83,3000,2678,322,0.930492834970459,0.592039800995025,1.77422280860889,654,318,336,21,1.1,76.69,8.3,0,0,0,0,0,0,0.316869213336827,89.8345781120625,63.8928282219298
8.7,"random_instances_SVM","SVM",76,30,812,742,70,3100,2765,335,0.931210046632942,0.597014925373134,1.77585803700392,679,332,347,25,1,79.24,8.3,0,0,0,0,0,0,0.267527021728201,81.7512113623387,61.4365848621114
8.7,"random_instances_SVM","SVM",76,31,712,652,60,3200,2855,345,0.931751498915686,0.606965174129353,1.76363811119197,699,341,358,20,1,81.8,8.3,0,0,0,0,0,0,0.177929487792463,70.0556841399737,55.1091766645753
8.7,"random_instances_SVM","SVM",76,32,612,562,50,3300,2945,355,0.930816005442874,0.611940298507463,1.77259058891376,713,349,364,14,1,84.36,8.3,0,0,0,0,0,0,0.117131658952752,57.8401456983738,47.9051245744355
8.7,"random_instances_SVM","SVM",76,33,512,466,46,3400,3041,359,0.930297231789771,0.611940298507463,1.77259058891376,729,355,374,16,1.1,86.91,8.5,0,0,0,0,0,0,0.101260086707807,51.892425763788,44.7719070342394
8.7,"random_instances_SVM","SVM",76,34,412,373,39,3500,3134,366,0.929782710379728,0.606965174129353,1.76526208735329,739,361,378,10,1,89.47,8.6,0,0,0,0,0,0,0.0765061286580282,44.0673373938883,39.5902294673863
8.7,"random_instances_SVM","SVM",76,35,312,284,28,3600,3223,377,0.930158325183202,0.601990049751244,1.77259058891376,758,370,388,19,1,92.02,8.5,0,0,0,0,0,0,0.0444806938349131,30.5529027733284,28.8531240645616
8.7,"random_instances_SVM","SVM",76,36,212,194,18,3700,3313,387,0.930036427548867,0.606965174129353,1.77096136962248,779,380,399,21,1.1,94.58,8.6,0,0,0,0,0,0,0.0142186103186732,22.766126017564,22.4280951142939
8.7,"random_instances_SVM","SVM",76,37,112,105,7,3800,3402,398,0.930708281952065,0.606965174129353,1.76039910639639,798,389,409,19,1.1,97.14,8.5,0,0,0,0,0,0,0.000604357720490129,12.0644908388822,12.0606215505079
8.7,"random_instances_SVM","SVM",76,38,12,10,2,3900,3497,403,0.929653725673634,0.611940298507463,1.76688905701905,808,396,412,10,1,99.69,8.7,0,0,0,0,0,0,0.000538820208296895,1.83507218980081,1.83507218980081
8.7,"random_instances_SVM","SVM",76,39,0,0,0,3912,3507,405,0.929983983217822,0.601990049751244,1.76201712028095,812,398,414,4,1,100,8.7,0,0,0,0,0,0,0,0,0
8.7,"random_instances_SVM","SVM",77,0,3812,3414,398,100,90,10,0.881574562461925,0.53030303030303,1.74813573523251,29,10,19,0,1.9,2.56,9,0,0,0,0,0,0,0.388231885193586,403.134624519562,47.0793730155116
8.7,"random_instances_SVM","SVM",77,1,3712,3330,382,200,174,26,0.921799048505528,0.601010101010101,1.76730608840701,59,26,33,30,1.3,5.11,6.7,0,0,0,0,0,0,0.755053923273361,539.312557937056,79.9202660635106
8.7,"random_instances_SVM","SVM",77,2,3612,3240,372,300,264,36,0.923097585640247,0.601010101010101,1.77636919655268,81,36,45,22,1.2,7.67,7.3,0,0,0,0,0,0,0.842611801467378,519.426020044487,88.0141419744907
8.7,"random_instances_SVM","SVM",77,3,3512,3151,361,400,353,47,0.926310890474706,0.611111111111111,1.76730608840701,107,47,60,26,1.3,10.22,7.5,0,0,0,0,0,0,0.61875932186027,425.04738487067,67.2725166572564
8.7,"random_instances_SVM","SVM",77,4,3412,3060,352,500,444,56,0.930091587088164,0.626262626262626,1.7624552940198,128,56,72,21,1.3,12.78,7.9,0,0,0,0,0,0,0.521735814022152,401.498305687283,57.990679719098
8.7,"random_instances_SVM","SVM",77,5,3312,2967,345,600,537,63,0.930085841348631,0.621212121212121,1.76406926406926,140,63,77,12,1.2,15.34,8.5,0,0,0,0,0,0,0.69118745922549,379.621530887933,76.8020336855594
8.7,"random_instances_SVM","SVM",77,6,3212,2875,337,700,629,71,0.924095907884292,0.595959595959596,1.747023562885,160,71,89,20,1.3,17.89,8.9,0,0,0,0,0,0,0.734851843255973,353.568847296421,82.2210966866899
8.7,"random_instances_SVM","SVM",77,7,3112,2786,326,800,718,82,0.929643419404502,0.626262626262626,1.77055481283422,185,82,103,25,1.3,20.45,8.8,0,0,0,0,0,0,0.709391162964484,361.807918034458,78.3500933772196
8.7,"random_instances_SVM","SVM",77,8,3012,2694,318,900,810,90,0.928454051320934,0.616161616161616,1.77545035609552,194,90,104,9,1.2,23.01,9,0,0,0,0,0,0,0.643652841604357,313.981296993084,73.457621314459
8.7,"random_instances_SVM","SVM",77,9,2912,2600,312,1000,904,96,0.930476551636948,0.611111111111111,1.77218365810822,211,96,115,17,1.2,25.56,9.4,0,0,0,0,0,0,0.76198061428316,322.335626977562,85.1065005051278
8.7,"random_instances_SVM","SVM",77,10,2812,2513,299,1100,991,109,0.929129175716191,0.616161616161616,1.7689289590116,232,109,123,21,1.1,28.12,9.1,0,0,0,0,0,0,0.746397227182184,311.585466385312,83.1008529674324
8.7,"random_instances_SVM","SVM",77,11,2712,2425,287,1200,1079,121,0.930068604130023,0.641414141414141,1.77381550309727,258,121,137,26,1.1,30.67,8.9,0,0,0,0,0,0,0.736809644083141,305.633772727045,83.2959931885449
8.7,"random_instances_SVM","SVM",77,12,2612,2339,273,1300,1165,135,0.92970949540914,0.631313131313131,1.77055481283422,285,135,150,27,1.1,33.23,8.6,0,0,0,0,0,0,0.776071239692476,310.827986950654,85.4559755893587
8.7,"random_instances_SVM","SVM",77,13,2512,2254,258,1400,1250,150,0.928712609599968,0.631313131313131,1.76634548247451,313,150,163,28,1.1,35.79,8.3,0,0,0,0,0,0,0.836747705318609,316.909435379409,89.7338259816561
8.7,"random_instances_SVM","SVM",77,14,2412,2170,242,1500,1334,166,0.928919456223197,0.626262626262626,1.7647190133378,336,163,173,23,1.1,38.34,8,0,0,0,0,0,0,0.818050705337652,299.733754670915,88.8057461370638
8.7,"random_instances_SVM","SVM",77,15,2312,2080,232,1600,1424,176,0.929514140264979,0.631313131313131,1.76309553678459,354,172,182,18,1.1,40.9,8.1,0,0,0,0,0,0,0.786029732498682,275.273098204694,86.9878241757602
8.7,"random_instances_SVM","SVM",77,16,2212,1986,226,1700,1518,182,0.928962549269698,0.616161616161616,1.76309553678459,374,180,194,20,1.1,43.46,8.3,0,0,0,0,0,0,0.799001014413824,267.483345736536,88.3527391431024
8.7,"random_instances_SVM","SVM",77,17,2112,1896,216,1800,1608,192,0.931163167511271,0.626262626262626,1.75824298026133,392,192,200,18,1,46.01,8.4,0,0,0,0,0,0,0.797498463494354,261.957007719629,88.6861470381406
8.7,"random_instances_SVM","SVM",77,18,2012,1804,208,1900,1700,200,0.931381505613569,0.626262626262626,1.77381550309727,407,199,208,15,1,48.57,8.5,0,0,0,0,0,0,0.758759458746042,244.714676131305,86.4037684472738
8.7,"random_instances_SVM","SVM",77,19,1912,1716,196,2000,1788,212,0.931826800427465,0.631313131313131,1.77218365810822,432,210,222,25,1.1,51.12,8.4,0,0,0,0,0,0,0.759912979484194,237.563855713729,87.550405881855
8.7,"random_instances_SVM","SVM",77,20,1812,1627,185,2100,1877,223,0.93050384389973,0.626262626262626,1.77055481283422,449,219,230,17,1.1,53.68,8.4,0,0,0,0,0,0,0.698802271086431,214.489501341739,82.9232865160342
8.7,"random_instances_SVM","SVM",77,21,1712,1538,174,2200,1966,234,0.930059985520719,0.626262626262626,1.77218365810822,476,231,245,27,1.1,56.24,8.4,0,0,0,0,0,0,0.659281649456575,200.655348330069,81.7045917818646
8.7,"random_instances_SVM","SVM",77,22,1612,1449,163,2300,2055,245,0.929775571413783,0.636363636363636,1.77055481283422,487,239,248,11,1,58.79,8.4,0,0,0,0,0,0,0.627474570519278,187.472786260034,79.0589718682475
8.7,"random_instances_SVM","SVM",77,23,1512,1363,149,2400,2141,259,0.930878753404338,0.631313131313131,1.7647190133378,519,252,267,32,1.1,61.35,8.3,0,0,0,0,0,0,0.619351270586341,179.918766695988,78.6311646036553
8.7,"random_instances_SVM","SVM",77,24,1412,1281,131,2500,2223,277,0.932361154204143,0.626262626262626,1.77545035609552,543,265,278,24,1,63.91,8,0,0,0,0,0,0,0.603127959402178,164.894136761714,76.9999431127539
8.7,"random_instances_SVM","SVM",77,25,1312,1195,117,2600,2309,291,0.933322129141229,0.626262626262626,1.77381550309727,567,279,288,24,1,66.46,7.9,0,0,0,0,0,0,0.595787439719516,158.346646309732,77.0390210967034
8.7,"random_instances_SVM","SVM",77,26,1212,1102,110,2700,2402,298,0.932674297008756,0.621212121212121,1.77218365810822,588,287,301,21,1,69.02,8.1,0,0,0,0,0,0,0.567405504569866,148.047121637004,75.6511750939913
8.7,"random_instances_SVM","SVM",77,27,1112,1011,101,2800,2493,307,0.931867020604207,0.626262626262626,1.76634548247451,607,296,311,19,1.1,71.57,8.1,0,0,0,0,0,0,0.545372775757988,133.888651096756,74.2521186185323
8.7,"random_instances_SVM","SVM",77,28,1012,924,88,2900,2580,320,0.931835419036769,0.616161616161616,1.76309553678459,640,311,329,33,1.1,74.13,8.1,0,0,0,0,0,0,0.507139352968518,120.840052324826,73.4186339252859
8.7,"random_instances_SVM","SVM",77,29,912,834,78,3000,2670,330,0.932891198676167,0.626262626262626,1.7647190133378,651,319,332,11,1,76.69,8.1,0,0,0,0,0,0,0.463978156558051,107.029530353243,69.1407373568583
8.7,"random_instances_SVM","SVM",77,30,812,737,75,3100,2767,333,0.931973316785589,0.626262626262626,1.76309553678459,658,323,335,7,1,79.24,8.3,0,0,0,0,0,0,0.42234788167656,96.630317409076,67.4531239837685
8.7,"random_instances_SVM","SVM",77,31,712,647,65,3200,2857,343,0.932849542064546,0.626262626262626,1.76309553678459,679,331,348,21,1.1,81.8,8.3,0,0,0,0,0,0,0.34807324201049,83.5397246270267,62.6112035899178
8.7,"random_instances_SVM","SVM",77,32,612,554,58,3300,2950,350,0.932861033543612,0.631313131313131,1.75985752845257,694,339,355,15,1,84.36,8.4,0,0,0,0,0,0,0.239480732683321,73.9340369861028,59.4778527250754
8.7,"random_instances_SVM","SVM",77,33,512,463,49,3400,3041,359,0.932243366543693,0.626262626262626,1.76147504456328,715,349,366,21,1,86.91,8.5,0,0,0,0,0,0,0.147628819517323,61.7901979468832,52.3447287291687
8.7,"random_instances_SVM","SVM",77,34,412,374,38,3500,3130,370,0.931979062525122,0.616161616161616,1.76309553678459,733,360,373,18,1,89.47,8.5,0,0,0,0,0,0,0.073533019662621,46.0769306325196,40.9253106278094
8.7,"random_instances_SVM","SVM",77,35,312,286,26,3600,3218,382,0.931795198860029,0.616161616161616,1.76634548247451,753,369,384,20,1,92.02,8.4,0,0,0,0,0,0,0.0569224693478488,34.1714780435721,31.6460850634197
8.7,"random_instances_SVM","SVM",77,36,212,196,16,3700,3308,392,0.932165799059983,0.626262626262626,1.76309553678459,775,379,396,22,1,94.58,8.4,0,0,0,0,0,0,0.0173609662975212,21.9536802927514,21.4963694412662
8.7,"random_instances_SVM","SVM",77,37,112,104,8,3800,3400,400,0.931950333827452,0.626262626262626,1.76634548247451,793,390,403,18,1,97.14,8.5,0,0,0,0,0,0,0.000887254976396281,13.1078854180847,13.1011719889406
8.7,"random_instances_SVM","SVM",77,38,12,10,2,3900,3494,406,0.931223497776382,0.626262626262626,1.75985752845257,816,397,419,23,1.1,99.69,8.6,0,0,0,0,0,0,0.000185136480534916,1.90572104407235,1.90572104407235
8.7,"random_instances_SVM","SVM",77,39,0,0,0,3912,3504,408,0.931573987887964,0.626262626262626,1.76309553678459,816,398,418,0,1.1,100,8.6,0,0,0,0,0,0,0,0,0
8.7,"random_instances_SVM","SVM",78,0,3812,3421,391,100,90,10,0.912970985220989,0.565853658536585,1.76499597963013,24,10,14,0,1.4,2.56,9,0,0,0,0,0,0,0.845574334713019,544.426383824792,87.6373931145661
8.7,"random_instances_SVM","SVM",78,1,3712,3337,375,200,174,26,0.914224624256523,0.565853658536585,1.78353321654763,58,26,32,34,1.2,5.11,6.7,0,0,0,0,0,0,0.949835484542399,633.96525362177,96.4577771427891
8.7,"random_instances_SVM","SVM",78,2,3612,3245,367,300,266,34,0.915917036954494,0.575609756097561,1.77311463639015,73,34,39,15,1.1,7.67,7.8,0,0,0,0,0,0,0.892585702862602,533.345171951326,91.9639571766501
8.7,"random_instances_SVM","SVM",78,3,3512,3152,360,400,359,41,0.916254126561825,0.565853658536585,1.77474733863361,89,41,48,16,1.2,10.22,8.8,0,0,0,0,0,0,0.894746343837767,471.563507951932,92.9099899138782
8.7,"random_instances_SVM","SVM",78,4,3412,3065,347,500,446,54,0.912582357119978,0.575609756097561,1.76823450436339,113,54,59,24,1.1,12.78,8.3,0,0,0,0,0,0,0.867164891175633,454.348188834857,90.2787286624941
8.7,"random_instances_SVM","SVM",78,5,3312,2970,342,600,541,59,0.912752294855906,0.565853658536585,1.76338116171647,123,59,64,10,1.1,15.34,9.2,0,0,0,0,0,0,0.756887822811985,381.750205177271,81.4087833719812
8.7,"random_instances_SVM","SVM",78,6,3212,2875,337,700,636,64,0.910050006268199,0.565853658536585,1.72044786501223,135,64,71,12,1.1,17.89,9.9,0,0,0,0,0,0,0.818598726182422,377.046283127289,87.0039607060138
8.7,"random_instances_SVM","SVM",78,7,3112,2788,324,800,723,77,0.908910587678124,0.570731707317073,1.72922566024188,166,77,89,31,1.2,20.45,9.4,0,0,0,0,0,0,0.811345292351014,367.542749583868,86.5898330724814
8.7,"random_instances_SVM","SVM",78,8,3012,2699,313,900,812,88,0.904468526695558,0.585365853658537,1.68945177892146,190,88,102,24,1.2,23.01,9.2,0,0,0,0,0,0,0.831655431770827,348.381203604297,88.4896762155307
8.7,"random_instances_SVM","SVM",78,9,2912,2610,302,1000,901,99,0.911752169492005,0.585365853658537,1.73163130714717,207,99,108,17,1.1,25.56,9.1,0,0,0,0,0,0,0.791817791257423,333.269928782571,85.3110913555213
8.7,"random_instances_SVM","SVM",78,10,2812,2519,293,1100,992,108,0.914083938098094,0.585365853658537,1.74678125070119,223,108,115,16,1.1,28.12,9.2,0,0,0,0,0,0,0.736366249654661,312.767950504519,80.7447632188557
8.7,"random_instances_SVM","SVM",78,11,2712,2427,285,1200,1084,116,0.914001755094655,0.580487804878049,1.75394548063128,240,116,124,17,1.1,30.67,9.3,0,0,0,0,0,0,0.735031715348473,290.629849645402,81.9734818395523
8.7,"random_instances_SVM","SVM",78,12,2612,2335,277,1300,1176,124,0.913334540541298,0.580487804878049,1.74592194229353,259,124,135,19,1.1,33.23,9.5,0,0,0,0,0,0,0.734748532224279,280.891306724169,82.1622385939315
8.7,"random_instances_SVM","SVM",78,13,2512,2245,267,1400,1266,134,0.91546294103718,0.590243902439024,1.7643368411605,279,134,145,20,1.1,35.79,9.4,0,0,0,0,0,0,0.739530399127663,264.983628711297,83.4115391695976
8.7,"random_instances_SVM","SVM",78,14,2412,2158,254,1500,1353,147,0.914480923792683,0.575609756097561,1.76596146071958,306,147,159,27,1.1,38.34,9.2,0,0,0,0,0,0,0.764223414186376,260.222119037538,84.7235690993926
8.7,"random_instances_SVM","SVM",78,15,2312,2075,237,1600,1436,164,0.921792425234362,0.585365853658537,1.78189243161981,335,164,171,29,1,40.9,8.8,0,0,0,0,0,0,0.729830849463297,259.513155523708,82.105250979483
8.7,"random_instances_SVM","SVM",78,16,2212,1985,227,1700,1526,174,0.922338454680952,0.570731707317073,1.77311463639015,363,174,189,28,1.1,43.46,8.8,0,0,0,0,0,0,0.75473646771438,258.180145699712,84.1876602406608
8.7,"random_instances_SVM","SVM",78,17,2112,1899,213,1800,1612,188,0.921558412614396,0.570731707317073,1.77311463639015,388,188,200,25,1.1,46.01,8.6,0,0,0,0,0,0,0.728834576570378,245.0634256082,82.2249242674915
8.7,"random_instances_SVM","SVM",78,18,2012,1809,203,1900,1702,198,0.923433299438651,0.575609756097561,1.76985822750789,407,197,210,19,1.1,48.57,8.6,0,0,0,0,0,0,0.758731452957279,240.307371818428,84.1896357109047
8.7,"random_instances_SVM","SVM",78,19,1912,1719,193,2000,1792,208,0.925049100862227,0.580487804878049,1.77311463639015,428,208,220,21,1.1,51.12,8.6,0,0,0,0,0,0,0.721252113659306,223.97268178519,82.2355266768413
8.7,"random_instances_SVM","SVM",78,20,1812,1628,184,2100,1883,217,0.924204983911633,0.590243902439024,1.77148493543759,445,217,228,17,1.1,53.68,8.7,0,0,0,0,0,0,0.700603559496196,201.558917315,81.6315694959271
8.7,"random_instances_SVM","SVM",78,21,1712,1532,180,2200,1979,221,0.923919432797985,0.595121951219512,1.77148493543759,455,221,234,10,1.1,56.24,9,0,0,0,0,0,0,0.647139378528213,185.8600725559,79.4596800578819
8.7,"random_instances_SVM","SVM",78,22,1612,1441,171,2300,2070,230,0.926389101697985,0.595121951219512,1.79067022684946,471,230,241,16,1,58.79,9,0,0,0,0,0,0,0.623353350848751,175.960046933541,80.3610458926072
8.7,"random_instances_SVM","SVM",78,23,1512,1353,159,2400,2158,242,0.930748979677117,0.604878048780488,1.79614325068871,498,242,256,27,1.1,61.35,8.9,0,0,0,0,0,0,0.596794859653233,167.058061585517,77.5988159360918
8.7,"random_instances_SVM","SVM",78,24,1412,1260,152,2500,2251,249,0.933274365867586,0.609756097560976,1.79449541284404,512,249,263,14,1.1,63.91,9,0,0,0,0,0,0,0.512672509667492,149.000108165464,71.3501505520024
8.7,"random_instances_SVM","SVM",78,25,1312,1176,136,2600,2335,265,0.933988940117841,0.595121951219512,1.77535937045897,546,265,281,34,1.1,66.46,8.8,0,0,0,0,0,0,0.584680685253788,152.530084808671,77.5066590554197
8.7,"random_instances_SVM","SVM",78,26,1212,1086,126,2700,2425,275,0.935282974188967,0.604878048780488,1.78353321654763,568,275,293,22,1.1,69.02,8.8,0,0,0,0,0,0,0.521542816460303,139.942070548001,78.4202821562084
8.7,"random_instances_SVM","SVM",78,27,1112,995,117,2800,2516,284,0.936124305275035,0.604878048780488,1.78353321654763,585,284,301,17,1.1,71.57,8.9,0,0,0,0,0,0,0.501179009704043,132.633155789631,77.0359031438752
8.7,"random_instances_SVM","SVM",78,28,1012,904,108,2900,2607,293,0.938209524870804,0.609756097560976,1.79397100146117,601,293,308,16,1.1,74.13,8.9,0,0,0,0,0,0,0.442192536940022,116.833373708453,71.0636827720829
8.7,"random_instances_SVM","SVM",78,29,912,813,99,3000,2698,302,0.938125948935103,0.609756097560976,1.79231909446166,626,302,324,25,1.1,76.69,8.9,0,0,0,0,0,0,0.379631231833049,106.141161521047,67.2487003694615
8.7,"random_instances_SVM","SVM",78,30,812,725,87,3100,2786,314,0.937490771823766,0.609756097560976,1.79067022684946,651,314,337,25,1.1,79.24,8.9,0,0,0,0,0,0,0.348518134463162,95.0960181831473,66.3638715454658
8.7,"random_instances_SVM","SVM",78,31,712,637,75,3200,2874,326,0.938053516457495,0.604878048780488,1.78574177668382,673,326,347,22,1.1,81.8,8.8,0,0,0,0,0,0,0.275395628667412,82.2635299204145,59.7475898168833
8.7,"random_instances_SVM","SVM",78,32,612,545,67,3300,2966,334,0.939279296847795,0.604878048780488,1.80110497237569,689,334,355,16,1.1,84.36,8.9,0,0,0,0,0,0,0.227439354792864,73.0216941084765,58.401348011123
8.7,"random_instances_SVM","SVM",78,33,512,456,56,3400,3055,345,0.940844952709951,0.609756097560976,1.79067022684946,707,345,362,18,1,86.91,8.9,0,0,0,0,0,0,0.17275238886476,65.8165827966166,56.0199339401611
8.7,"random_instances_SVM","SVM",78,34,412,370,42,3500,3141,359,0.941748965747798,0.609756097560976,1.79231909446166,735,358,377,28,1.1,89.47,8.7,0,0,0,0,0,0,0.089545188513927,51.1258189095851,45.9919686614455
8.7,"random_instances_SVM","SVM",78,35,312,283,29,3600,3228,372,0.942789486147292,0.619512195121951,1.79067022684946,754,367,387,19,1.1,92.02,8.7,0,0,0,0,0,0,0.0507077393615774,36.9653928346749,34.5241758391465
8.7,"random_instances_SVM","SVM",78,36,212,190,22,3700,3321,379,0.942733768856823,0.619512195121951,1.79067022684946,764,373,391,10,1,94.58,8.8,0,0,0,0,0,0,0.0277114059374723,28.1955283858929,27.4694658609952
8.7,"random_instances_SVM","SVM",78,37,112,100,12,3800,3411,389,0.942976139070357,0.639024390243902,1.79067022684946,783,383,400,19,1,97.14,8.8,0,0,0,0,0,0,0.00153553141746185,12.5399791982995,12.5290287165058
8.7,"random_instances_SVM","SVM",78,38,12,10,2,3900,3501,399,0.942346533688068,0.624390243902439,1.7873815762951,805,393,412,22,1,99.69,8.8,0,0,0,0,0,0,0.000536302657140192,2.16898965638635,2.16898965638635
8.7,"random_instances_SVM","SVM",78,39,0,0,0,3912,3511,401,0.942320067975095,0.624390243902439,1.7890243902439,807,393,414,2,1.1,100,8.8,0,0,0,0,0,0,0,0,0
8.7,"random_instances_SVM","SVM",79,0,3812,3413,399,100,93,7,0.851551822323469,0.51,1.67657142857143,35,7,28,0,4,2.56,13.3,0,0,0,0,0,0,0.0773896274652111,271.728453024796,7.99710967937972
8.7,"random_instances_SVM","SVM",79,1,3712,3329,383,200,177,23,0.885281890660597,0.61,1.68837465564738,51,23,28,16,1.2,5.11,7.7,0,0,0,0,0,0,0.563744612699338,419.276546800858,63.7453409816808
8.7,"random_instances_SVM","SVM",79,2,3612,3237,375,300,269,31,0.899345102505699,0.595,1.71217231897342,77,31,46,26,1.5,7.67,8.7,0,0,0,0,0,0,0.487323730242353,366.15896833017,58.1070569200645
8.7,"random_instances_SVM","SVM",79,3,3512,3148,364,400,358,42,0.920122437357648,0.595,1.77245630174793,113,42,71,36,1.7,10.22,8.5,0,0,0,0,0,0,0.558997459392067,372.877711983164,65.9444691591868
8.7,"random_instances_SVM","SVM",79,4,3412,3053,359,500,453,47,0.914710990888393,0.585,1.75284926470588,123,47,76,10,1.6,12.78,9.6,0,0,0,0,0,0,0.544247810793743,327.574753920307,67.4055844644558
8.7,"random_instances_SVM","SVM",79,5,3312,2960,352,600,546,54,0.916971810933955,0.595,1.7560773480663,145,54,91,22,1.7,15.34,10.1,0,0,0,0,0,0,0.583311359669021,305.940073804721,73.791037342803
8.7,"random_instances_SVM","SVM",79,6,3212,2874,338,700,632,68,0.920210706150353,0.61,1.76022038567493,170,68,102,25,1.5,17.89,9.3,0,0,0,0,0,0,0.644495642636312,337.937232433713,79.0449354040462
8.7,"random_instances_SVM","SVM",79,7,3112,2779,333,800,727,73,0.920257687927123,0.615,1.75284926470588,177,73,104,7,1.4,20.45,10,0,0,0,0,0,0,0.587557954331955,295.248180955163,72.8541453076594
8.7,"random_instances_SVM","SVM",79,8,3012,2688,324,900,818,82,0.917984054669718,0.605,1.7560773480663,198,82,116,21,1.4,23.01,10,0,0,0,0,0,0,0.472217955075219,277.144211003459,62.4190116191867
8.7,"random_instances_SVM","SVM",79,9,2912,2599,313,1000,907,93,0.92348804100229,0.62,1.76670967741935,224,93,131,26,1.4,25.56,9.8,0,0,0,0,0,0,0.520755077556244,276.438107983636,64.7793669294556
8.7,"random_instances_SVM","SVM",79,10,2812,2509,303,1100,997,103,0.919994305239191,0.615,1.76022038567493,242,103,139,18,1.3,28.12,9.7,0,0,0,0,0,0,0.703405321978405,291.337539100155,81.6609064003781
8.7,"random_instances_SVM","SVM",79,11,2712,2421,291,1200,1085,115,0.927109908883844,0.63,1.76345906163753,261,115,146,19,1.3,30.67,9.4,0,0,0,0,0,0,0.690785555056891,280.173513189694,81.0669539887452
8.7,"random_instances_SVM","SVM",79,12,2612,2336,276,1300,1170,130,0.92937642369022,0.645,1.75769585253456,284,130,154,23,1.2,33.23,9,0,0,0,0,0,0,0.694485939397378,270.00187882557,80.8922689449109
8.7,"random_instances_SVM","SVM",79,13,2512,2250,262,1400,1256,144,0.93126850797268,0.655,1.76508287292818,309,144,165,25,1.1,35.79,8.7,0,0,0,0,0,0,0.697643938669822,260.684070372604,81.0065867573608
8.7,"random_instances_SVM","SVM",79,14,2412,2159,253,1500,1347,153,0.931526195899788,0.665,1.76670967741935,323,153,170,14,1.1,38.34,8.8,0,0,0,0,0,0,0.740446317718311,257.061535251648,85.7650310977235
8.7,"random_instances_SVM","SVM",79,15,2312,2071,241,1600,1435,165,0.935871298405477,0.67,1.76022038567493,349,165,184,26,1.1,40.9,8.7,0,0,0,0,0,0,0.65565116937077,238.125680076072,77.9502719839928
8.7,"random_instances_SVM","SVM",79,16,2212,1979,233,1700,1527,173,0.936321184510258,0.67,1.76345906163753,363,173,190,14,1.1,43.46,8.8,0,0,0,0,0,0,0.77641446845807,249.590005993717,87.6389002828422
8.7,"random_instances_SVM","SVM",79,17,2112,1888,224,1800,1618,182,0.934718109339417,0.66,1.76508287292818,378,182,196,15,1.1,46.01,8.9,0,0,0,0,0,0,0.714223109311207,229.902394549156,83.1205641966561
8.7,"random_instances_SVM","SVM",79,18,2012,1798,214,1900,1708,192,0.936164578587708,0.665,1.76670967741935,405,192,213,27,1.1,48.57,8.9,0,0,0,0,0,0,0.76329713349264,229.787084655456,87.5362015938626
8.7,"random_instances_SVM","SVM",79,19,1912,1708,204,2000,1798,202,0.936560364464701,0.665,1.76670967741935,424,202,222,19,1.1,51.12,8.9,0,0,0,0,0,0,0.702520893179433,213.504569619005,83.6609046863605
8.7,"random_instances_SVM","SVM",79,20,1812,1619,193,2100,1887,213,0.935358769931673,0.66,1.76022038567493,447,213,234,23,1.1,53.68,8.9,0,0,0,0,0,0,0.734712387676664,206.183328126818,86.4838780506196
8.7,"random_instances_SVM","SVM",79,21,1712,1529,183,2200,1977,223,0.934812072892951,0.67,1.76345906163753,464,223,241,17,1.1,56.24,8.9,0,0,0,0,0,0,0.601973873603789,181.618268554392,77.5883318023012
8.7,"random_instances_SVM","SVM",79,22,1612,1438,174,2300,2068,232,0.934380694760834,0.66,1.76508287292818,486,232,254,22,1.1,58.79,8.9,0,0,0,0,0,0,0.639166868274885,176.817335342399,82.2136180352411
8.7,"random_instances_SVM","SVM",79,23,1512,1346,166,2400,2160,240,0.932890091116188,0.66,1.76345906163753,507,240,267,21,1.1,61.35,9,0,0,0,0,0,0,0.599367697617381,167.092182740212,79.9354307182886
8.7,"random_instances_SVM","SVM",79,24,1412,1259,153,2500,2247,253,0.932999715261975,0.66,1.76508287292818,530,253,277,23,1.1,63.91,8.9,0,0,0,0,0,0,0.587879481774131,154.797064473988,79.841836521086
8.7,"random_instances_SVM","SVM",79,25,1312,1170,142,2600,2336,264,0.933826879271085,0.66,1.76508287292818,549,264,285,19,1.1,66.46,8.8,0,0,0,0,0,0,0.562904927651718,146.882630979626,79.5389051004588
8.7,"random_instances_SVM","SVM",79,26,1212,1077,135,2700,2429,271,0.931731207289313,0.665,1.76670967741935,569,271,298,20,1.1,69.02,9,0,0,0,0,0,0,0.463721152150866,126.269723497084,72.7158630381709
8.7,"random_instances_SVM","SVM",79,27,1112,984,128,2800,2522,278,0.932462984054686,0.66,1.76670967741935,589,278,311,20,1.1,71.57,9.1,0,0,0,0,0,0,0.446967443290827,119.321930293896,72.7448983598632
8.7,"random_instances_SVM","SVM",79,28,1012,893,119,2900,2613,287,0.932425968109356,0.67,1.76345906163753,602,287,315,13,1.1,74.13,9.1,0,0,0,0,0,0,0.413561202207395,108.287002985379,70.6794496637689
8.7,"random_instances_SVM","SVM",79,29,912,809,103,3000,2697,303,0.933627562642383,0.675,1.75860550458716,628,303,325,26,1.1,76.69,8.9,0,0,0,0,0,0,0.37658789519136,98.4602112506931,68.8589598831158
8.7,"random_instances_SVM","SVM",79,30,812,717,95,3100,2789,311,0.932770501138968,0.67,1.76670967741935,646,311,335,18,1.1,79.24,9,0,0,0,0,0,0,0.32369523932195,90.2570218855705,63.8370653264678
8.7,"random_instances_SVM","SVM",79,31,712,623,89,3200,2883,317,0.932576879271086,0.66,1.76183823529412,659,317,342,13,1.1,81.8,9.1,0,0,0,0,0,0,0.26940227934948,80.367695676821,62.5903778927626
8.7,"random_instances_SVM","SVM",79,32,612,535,77,3300,2971,329,0.932710706150357,0.66,1.76508287292818,679,329,350,20,1.1,84.36,9,0,0,0,0,0,0,0.173647240282627,70.2917908081583,57.1953941433867
8.7,"random_instances_SVM","SVM",79,33,512,442,70,3400,3064,336,0.932098519362202,0.66,1.76345906163753,696,336,360,17,1.1,86.91,9.1,0,0,0,0,0,0,0.120241551704312,60.3178504756058,51.337448594651
8.7,"random_instances_SVM","SVM",79,34,412,360,52,3500,3146,354,0.933718678815502,0.655,1.76670967741935,733,354,379,37,1.1,89.47,8.9,0,0,0,0,0,0,0.0854228590792089,47.2402756083758,42.573094012583
8.7,"random_instances_SVM","SVM",79,35,312,276,36,3600,3230,370,0.933621867881565,0.655,1.76670967741935,766,370,396,33,1.1,92.02,8.7,0,0,0,0,0,0,0.0566119288691156,33.6450253861892,31.6220415915523
8.7,"random_instances_SVM","SVM",79,36,212,190,22,3700,3316,384,0.932537015945347,0.65,1.76345906163753,787,383,404,21,1.1,94.58,8.6,0,0,0,0,0,0,0.0120538954439343,22.7649919283519,22.4653902156412
8.7,"random_instances_SVM","SVM",79,37,112,101,11,3800,3405,395,0.932169703872454,0.65,1.76345906163753,808,392,416,21,1.1,97.14,8.6,0,0,0,0,0,0,0.000598903450868588,10.6591981900988,10.655622847653
8.7,"random_instances_SVM","SVM",79,38,12,10,2,3900,3496,404,0.931958997722111,0.65,1.76345906163753,823,398,425,15,1.1,99.69,8.7,0,0,0,0,0,0,0.000151700884395234,2.25350451551391,2.25350451551391
8.7,"random_instances_SVM","SVM",79,39,0,0,0,3912,3506,406,0.932248006833728,0.65,1.76508287292818,826,400,426,3,1.1,100,8.6,0,0,0,0,0,0,0,0,0
8.7,"random_instances_SVM","SVM",80,0,3812,3440,372,100,88,12,0.903480470089481,0.572072072072072,1.71052371052371,28,12,16,0,1.3,2.56,7.3,0,0,0,0,0,0,0.540043118208197,446.149974141468,61.9748589170459
8.7,"random_instances_SVM","SVM",80,1,3712,3354,358,200,174,26,0.902479036129569,0.594594594594595,1.70557897346888,64,26,38,36,1.5,5.11,6.7,0,0,0,0,0,0,0.612969999593979,449.931409184885,74.2228286354809
8.7,"random_instances_SVM","SVM",80,2,3612,3265,347,300,263,37,0.930345137525079,0.621621621621622,1.76865263053108,80,37,43,16,1.2,7.67,7.1,0,0,0,0,0,0,0.704870407355341,446.654975972988,77.3959145576049
8.7,"random_instances_SVM","SVM",80,3,3512,3176,336,400,352,48,0.925206781175619,0.635135135135135,1.76865263053108,106,48,58,26,1.2,10.22,7.3,0,0,0,0,0,0,0.624183435545484,382.002848253124,73.280426218056
8.7,"random_instances_SVM","SVM",80,4,3412,3086,326,500,442,58,0.924472915822406,0.648648648648649,1.74279774279774,131,58,73,25,1.3,12.78,7.6,0,0,0,0,0,0,0.530039262337694,373.485748089823,66.6623780869463
8.7,"random_instances_SVM","SVM",80,5,3312,2993,319,600,535,65,0.924007917952562,0.630630630630631,1.76216216216216,147,65,82,16,1.3,15.34,8.2,0,0,0,0,0,0,0.628394960100502,347.774138147005,76.2549678523118
8.7,"random_instances_SVM","SVM",80,6,3212,2901,311,700,627,73,0.929221609152395,0.653153153153153,1.76540143084261,163,73,90,16,1.2,17.89,8.6,0,0,0,0,0,0,0.609718722434065,322.058932166315,75.0499621389593
8.7,"random_instances_SVM","SVM",80,7,3112,2807,305,800,721,79,0.926525141058012,0.630630630630631,1.76702553519481,182,79,103,19,1.3,20.45,9.1,0,0,0,0,0,0,0.509405293348732,270.860095534562,67.0923895531843
8.7,"random_instances_SVM","SVM",80,8,3012,2714,298,900,814,86,0.929582696883717,0.648648648648649,1.75568957387139,194,86,108,12,1.3,23.01,9.5,0,0,0,0,0,0,0.56741939483294,260.67828992328,74.1561076834053
8.7,"random_instances_SVM","SVM",80,9,2912,2625,287,1000,903,97,0.92503143281689,0.644144144144144,1.76053954506993,211,97,114,17,1.2,25.56,9.3,0,0,0,0,0,0,0.578059348701748,268.499284605038,75.4399931570243
8.7,"random_instances_SVM","SVM",80,10,2812,2540,272,1100,988,112,0.930159398152464,0.648648648648649,1.77349960254372,248,112,136,37,1.2,28.12,8.8,0,0,0,0,0,0,0.491464976011562,261.08388926062,65.7318140827572
8.7,"random_instances_SVM","SVM",80,11,2712,2446,266,1200,1082,118,0.929393060880942,0.63963963963964,1.77840328808071,261,118,143,13,1.2,30.67,9.2,0,0,0,0,0,0,0.480879320380445,232.60581684197,66.6506985126619
8.7,"random_instances_SVM","SVM",80,12,2612,2356,256,1300,1172,128,0.92749410309965,0.635135135135135,1.77187104459832,281,128,153,20,1.2,33.23,9.2,0,0,0,0,0,0,0.52664307772037,231.31266788277,72.2294993024671
8.7,"random_instances_SVM","SVM",80,13,2512,2269,243,1400,1259,141,0.92913458441139,0.635135135135135,1.77349960254372,308,141,167,27,1.2,35.79,8.9,0,0,0,0,0,0,0.53419789848204,220.157105282365,72.7398462537413
8.7,"random_instances_SVM","SVM",80,14,2412,2176,236,1500,1352,148,0.929244988933573,0.635135135135135,1.77187104459832,324,148,176,16,1.2,38.34,9.1,0,0,0,0,0,0,0.590186174436548,220.090419209419,78.3161670080873
8.7,"random_instances_SVM","SVM",80,15,2312,2095,217,1600,1433,167,0.935206833130702,0.666666666666667,1.76862288502985,366,167,199,42,1.2,40.9,8.6,0,0,0,0,0,0,0.596526135673278,215.374402695338,78.1569055170319
8.7,"random_instances_SVM","SVM",80,16,2212,2004,208,1700,1524,176,0.935261385953414,0.653153153153153,1.77187104459832,377,176,201,11,1.1,43.46,8.7,0,0,0,0,0,0,0.620597039129378,211.971107203374,79.6923807137657
8.7,"random_instances_SVM","SVM",80,17,2112,1912,200,1800,1616,184,0.933513097872961,0.662162162162162,1.76862288502985,395,184,211,18,1.1,46.01,8.8,0,0,0,0,0,0,0.5735513158501,195.157110887891,75.0459646388092
8.7,"random_instances_SVM","SVM",80,18,2012,1823,189,1900,1705,195,0.934580774546165,0.662162162162162,1.77349960254372,414,195,219,19,1.1,48.57,8.7,0,0,0,0,0,0,0.576790626139018,187.977308575076,76.2419318989742
8.7,"random_instances_SVM","SVM",80,19,1912,1735,177,2000,1793,207,0.937726653989626,0.662162162162162,1.77676571599224,440,207,233,26,1.1,51.12,8.7,0,0,0,0,0,0,0.529162334992749,175.820824546625,72.2660141530584
8.7,"random_instances_SVM","SVM",80,20,1812,1641,171,2100,1887,213,0.936299188461806,0.666666666666667,1.77676571599224,451,213,238,11,1.1,53.68,8.9,0,0,0,0,0,0,0.557096831640849,171.06607655571,74.2084140990205
8.7,"random_instances_SVM","SVM",80,21,1712,1551,161,2200,1977,223,0.937882519197396,0.671171171171171,1.77513115691589,475,223,252,24,1.1,56.24,8.9,0,0,0,0,0,0,0.527197307824369,160.571778989158,73.61400577001
8.7,"random_instances_SVM","SVM",80,22,1612,1461,151,2300,2067,233,0.937970842815134,0.671171171171171,1.77513115691589,489,233,256,14,1.1,58.79,8.9,0,0,0,0,0,0,0.488964005986073,146.220841693942,71.9232419181886
8.7,"random_instances_SVM","SVM",80,23,1512,1370,142,2400,2158,242,0.936755094194536,0.666666666666667,1.77349960254372,503,242,261,14,1.1,61.35,8.9,0,0,0,0,0,0,0.487779213451536,139.607621159403,72.2729603835557
8.7,"random_instances_SVM","SVM",80,24,1412,1285,127,2500,2243,257,0.937866932676627,0.671171171171171,1.77349960254372,535,257,278,32,1.1,63.91,8.7,0,0,0,0,0,0,0.412614609279148,128.868540519807,63.524753871862
8.7,"random_instances_SVM","SVM",80,25,1312,1196,116,2600,2332,268,0.939191786942656,0.666666666666667,1.77513115691589,555,268,287,20,1.1,66.46,8.7,0,0,0,0,0,0,0.423989356924958,118.611208566115,68.1259577721678
8.7,"random_instances_SVM","SVM",80,26,1212,1099,113,2700,2429,271,0.939397009466211,0.666666666666667,1.77513115691589,565,271,294,10,1.1,69.02,9,0,0,0,0,0,0,0.411191358504487,113.221731226941,68.108351235017
8.7,"random_instances_SVM","SVM",80,27,1112,1013,99,2800,2515,285,0.938325436162816,0.666666666666667,1.77349960254372,587,285,302,22,1.1,71.57,8.8,0,0,0,0,0,0,0.397332609044333,105.91134727174,68.1074099908562
8.7,"random_instances_SVM","SVM",80,28,1012,924,88,2900,2604,296,0.939406101603337,0.666666666666667,1.77349960254372,614,296,318,27,1.1,74.13,8.8,0,0,0,0,0,0,0.369699563898157,96.3661363542913,64.876973694899
8.7,"random_instances_SVM","SVM",80,29,912,833,79,3000,2695,305,0.939082681297221,0.662162162162162,1.77840328808071,631,304,327,17,1.1,76.69,8.8,0,0,0,0,0,0,0.306411436375627,86.020535039027,60.6405199462506
8.7,"random_instances_SVM","SVM",80,30,812,742,70,3100,2786,314,0.9394541600424,0.666666666666667,1.77676571599224,648,314,334,17,1.1,79.24,8.9,0,0,0,0,0,0,0.250775689467377,76.9452806802689,56.4467639492145
8.7,"random_instances_SVM","SVM",80,31,712,647,65,3200,2881,319,0.939633405031335,0.662162162162162,1.77187104459832,660,319,341,12,1.1,81.8,9,0,0,0,0,0,0,0.199324932899283,69.5971570253911,53.7951422012512
8.7,"random_instances_SVM","SVM",80,32,612,557,55,3300,2971,329,0.940004883776515,0.666666666666667,1.77840328808071,684,329,355,24,1.1,84.36,9,0,0,0,0,0,0,0.151821202614459,60.9470641421811,50.2766184715878
8.7,"random_instances_SVM","SVM",80,33,512,462,50,3400,3066,334,0.94011398942195,0.666666666666667,1.77513115691589,693,334,359,9,1.1,86.91,9.2,0,0,0,0,0,0,0.107213637600171,50.4468007956092,42.67330247509
8.7,"random_instances_SVM","SVM",80,34,412,376,36,3500,3152,348,0.940272452383181,0.666666666666667,1.77840328808071,717,348,369,24,1.1,89.47,9.1,0,0,0,0,0,0,0.0660221877602698,39.3682950119848,34.9019583539157
8.7,"random_instances_SVM","SVM",80,35,312,284,28,3600,3244,356,0.940723162608978,0.662162162162162,1.77349960254372,736,356,380,19,1.1,92.02,9.1,0,0,0,0,0,0,0.0501930249458679,31.8122783731286,29.6948842752054
8.7,"random_instances_SVM","SVM",80,36,212,194,18,3700,3334,366,0.939997090516118,0.666666666666667,1.77840328808071,759,366,393,23,1.1,94.58,9.1,0,0,0,0,0,0,0.0123711241448898,22.2323758517149,21.9156081943861
8.7,"random_instances_SVM","SVM",80,37,112,103,9,3800,3425,375,0.940779014308422,0.666666666666667,1.77840328808071,773,375,398,14,1.1,97.14,9.1,0,0,0,0,0,0,0.00160786817716564,12.3009118754287,12.2908133388529
8.7,"random_instances_SVM","SVM",80,38,12,12,0,3900,3516,384,0.940459490632503,0.666666666666667,1.77187104459832,795,384,411,22,1.1,99.69,9.2,0,0,0,0,0,0,0.000645915486296882,0.21122248661028,0.21122248661028
8.7,"random_instances_SVM","SVM",80,39,0,0,0,3912,3528,384,0.940543917620043,0.666666666666667,1.77349960254372,793,384,409,-2,1.1,100,9.2,0,0,0,0,0,0,0,0,0
8.7,"random_instances_SVM","SVM",81,0,3812,3404,408,100,91,9,0.827714447408839,0.455026455026455,1.62153463535952,23,9,14,0,1.6,2.56,10.1,0,0,0,0,0,0,0.246585973372929,384.422073999427,27.1936072801352
8.7,"random_instances_SVM","SVM",81,1,3712,3320,392,200,175,25,0.886250872102588,0.571428571428571,1.70747675788922,56,25,31,33,1.2,5.11,7,0,0,0,0,0,0,0.676099115064447,446.058589048092,73.6803336180091
8.7,"random_instances_SVM","SVM",81,2,3612,3228,384,300,267,33,0.866932863820244,0.523809523809524,1.64863047735976,83,33,50,27,1.5,7.67,8.1,0,0,0,0,0,0,0.555873820870528,393.878836186985,67.1881483434153
8.7,"random_instances_SVM","SVM",81,3,3512,3136,376,400,359,41,0.867140970706333,0.513227513227513,1.65663468699347,104,41,63,21,1.5,10.22,8.8,0,0,0,0,0,0,0.541671750142644,367.993199556039,66.0871740737353
8.7,"random_instances_SVM","SVM",81,4,3412,3044,368,500,451,49,0.875673353036109,0.529100529100529,1.69643583929298,109,49,60,5,1.2,12.78,9.2,0,0,0,0,0,0,0.5,323.197810498742,64.0072719683148
8.7,"random_instances_SVM","SVM",81,5,3312,2955,357,600,540,60,0.87624976419543,0.529100529100529,1.66768978923675,136,60,76,27,1.3,15.34,9,0,0,0,0,0,0,0.368327777105621,295.165104974514,50.6832539508401
8.7,"random_instances_SVM","SVM",81,6,3212,2862,350,700,633,67,0.88137757775561,0.523809523809524,1.71218487394958,153,67,86,17,1.3,17.89,9.4,0,0,0,0,0,0,0.627347823112081,307.467929015894,76.7136972678837
8.7,"random_instances_SVM","SVM",81,7,3112,2768,344,800,727,73,0.883621838347354,0.507936507936508,1.71218487394958,166,73,93,13,1.3,20.45,10,0,0,0,0,0,0,0.641291844253721,280.679798130288,78.0859887044598
8.7,"random_instances_SVM","SVM",81,8,3012,2676,336,900,819,81,0.883990142620584,0.513227513227513,1.70423913202202,182,81,101,16,1.2,23.01,10.1,0,0,0,0,0,0,0.645515398633329,281.338151322968,78.224614101543
8.7,"random_instances_SVM","SVM",81,9,2912,2581,331,1000,914,86,0.886042765216502,0.518518518518518,1.71218487394958,194,86,108,12,1.3,25.56,10.6,0,0,0,0,0,0,0.725482487764576,274.257362279039,84.2110437892468
8.7,"random_instances_SVM","SVM",81,10,2812,2496,316,1100,999,101,0.892678230821974,0.518518518518518,1.71533806892923,221,101,120,27,1.2,28.12,9.9,0,0,0,0,0,0,0.689793414346037,280.404110379396,81.0698315227582
8.7,"random_instances_SVM","SVM",81,11,2712,2405,307,1200,1090,110,0.896948164916468,0.529100529100529,1.7312091503268,237,110,127,16,1.2,30.67,9.9,0,0,0,0,0,0,0.738602039519875,278.645856271344,84.8267798220635
8.7,"random_instances_SVM","SVM",81,12,2612,2316,296,1300,1179,121,0.905588343618897,0.53968253968254,1.76136446605628,260,121,139,23,1.1,33.23,9.7,0,0,0,0,0,0,0.720918630625427,270.410501659904,84.7170091520712
8.7,"random_instances_SVM","SVM",81,13,2512,2227,285,1400,1268,132,0.903146456343959,0.55026455026455,1.75023342670401,281,132,149,21,1.1,35.79,9.6,0,0,0,0,0,0,0.72907698755991,271.061323952934,86.0650304897882
8.7,"random_instances_SVM","SVM",81,14,2412,2141,271,1500,1354,146,0.90240086476645,0.544973544973545,1.73752730449978,311,146,165,30,1.1,38.34,9.3,0,0,0,0,0,0,0.745218911057938,274.111612509791,87.072844234938
8.7,"random_instances_SVM","SVM",81,15,2312,2052,260,1600,1443,157,0.911132370951268,0.555555555555556,1.75974556489262,332,157,175,21,1.1,40.9,9.2,0,0,0,0,0,0,0.777378172269631,267.172300745695,88.1593670906949
8.7,"random_instances_SVM","SVM",81,16,2212,1961,251,1700,1534,166,0.911112907717317,0.544973544973545,1.76298634862171,352,166,186,20,1.1,43.46,9.2,0,0,0,0,0,0,0.764368025328067,259.693689741718,88.7753119109679
8.7,"random_instances_SVM","SVM",81,17,2112,1871,241,1800,1624,176,0.915532558996051,0.555555555555556,1.76461122083242,368,176,192,16,1.1,46.01,9.2,0,0,0,0,0,0,0.693186531483556,241.372369849176,83.6561355888498
8.7,"random_instances_SVM","SVM",81,18,2012,1788,224,1900,1707,193,0.917257300958484,0.566137566137566,1.75812963691752,403,193,210,35,1.1,48.57,8.8,0,0,0,0,0,0,0.730048217413176,238.578493307945,85.9209555297793
8.7,"random_instances_SVM","SVM",81,19,1912,1697,215,2000,1798,202,0.917156990445044,0.566137566137566,1.7725160045602,422,202,220,19,1.1,51.12,8.9,0,0,0,0,0,0,0.720677487662037,227.140019424646,85.9248934487453
8.7,"random_instances_SVM","SVM",81,20,1812,1610,202,2100,1885,215,0.916686878486534,0.582010582010582,1.76925770308123,443,215,228,21,1.1,53.68,8.8,0,0,0,0,0,0,0.712489447344426,217.464884153161,84.8058380294875
8.7,"random_instances_SVM","SVM",81,21,1712,1526,186,2200,1969,231,0.91357725256989,0.576719576719577,1.7725160045602,467,227,240,24,1.1,56.24,8.5,0,0,0,0,0,0,0.633335676560609,187.267488400245,78.763421531837
8.7,"random_instances_SVM","SVM",81,22,1612,1437,175,2300,2058,242,0.913816800064672,0.597883597883598,1.77088535506199,488,237,251,21,1.1,58.79,8.5,0,0,0,0,0,0,0.640110886960305,180.551994737574,78.704994387574
8.7,"random_instances_SVM","SVM",81,23,1512,1356,156,2400,2139,261,0.914758521153535,0.597883597883598,1.76601135867191,518,252,266,30,1.1,61.35,8.2,0,0,0,0,0,0,0.632917006264275,170.48240169632,78.0357107230342
8.7,"random_instances_SVM","SVM",81,24,1412,1265,147,2500,2230,270,0.916869533451305,0.603174603174603,1.75974556489262,537,262,275,19,1,63.91,8.3,0,0,0,0,0,0,0.588557150397974,158.029024664256,75.2709330416426
8.7,"random_instances_SVM","SVM",81,25,1312,1174,138,2600,2321,279,0.916574590598354,0.592592592592593,1.76136446605628,552,270,282,15,1,66.46,8.3,0,0,0,0,0,0,0.542911297740813,144.798586362247,73.5391383727356
8.7,"random_instances_SVM","SVM",81,26,1212,1083,129,2700,2412,288,0.917601650482234,0.587301587301587,1.76601135867191,579,284,295,27,1,69.02,8.4,0,0,0,0,0,0,0.527079320565753,135.562024142467,72.8545868416456
8.7,"random_instances_SVM","SVM",81,27,1112,993,119,2800,2502,298,0.917568712701701,0.587301587301587,1.77088535506199,591,292,299,12,1,71.57,8.4,0,0,0,0,0,0,0.494592948061582,121.261756667156,70.9267295890336
8.7,"random_instances_SVM","SVM",81,28,1012,904,108,2900,2591,309,0.91982345349634,0.592592592592593,1.76439264981886,607,299,308,16,1,74.13,8.4,0,0,0,0,0,0,0.470905663069626,112.562827067794,68.4007329999822
8.7,"random_instances_SVM","SVM",81,29,912,817,95,3000,2678,322,0.920209723831677,0.597883597883598,1.77088535506199,632,309,323,25,1,76.69,8.3,0,0,0,0,0,0,0.42026821737611,102.306509215021,67.5574642642667
8.7,"random_instances_SVM","SVM",81,30,812,722,90,3100,2773,327,0.922206951069425,0.592592592592593,1.77088535506199,634,314,320,2,1,79.24,8.5,0,0,0,0,0,0,0.409761801702822,96.2336586953937,67.2679748541224
8.7,"random_instances_SVM","SVM",81,31,712,631,81,3200,2864,336,0.922081188634664,0.597883597883598,1.76601135867191,654,322,332,20,1,81.8,8.5,0,0,0,0,0,0,0.318244300053381,86.9393306888491,64.7183082389893
8.7,"random_instances_SVM","SVM",81,32,612,536,76,3300,2959,341,0.922548306249489,0.592592592592593,1.77088535506199,681,332,349,27,1.1,84.36,8.7,0,0,0,0,0,0,0.223762737659309,75.6774689398939,59.8516675072576
8.7,"random_instances_SVM","SVM",81,33,512,454,58,3400,3041,359,0.924569488236715,0.608465608465608,1.77387863180714,711,349,362,30,1,86.91,8.5,0,0,0,0,0,0,0.120130891456574,57.7962858192531,48.1220361124555
8.7,"random_instances_SVM","SVM",81,34,412,364,48,3500,3131,369,0.924735674311221,0.603174603174603,1.77550604339595,730,359,371,19,1,89.47,8.5,0,0,0,0,0,0,0.0783274769484221,47.2187153023014,41.4961373267183
8.7,"random_instances_SVM","SVM",81,35,312,279,33,3600,3216,384,0.924099376278205,0.603174603174603,1.7804062440677,759,370,389,29,1.1,92.02,8.4,0,0,0,0,0,0,0.0529345283966094,33.6774929329165,30.9652138842064
8.7,"random_instances_SVM","SVM",81,36,212,189,23,3700,3306,394,0.924151777292688,0.603174603174603,1.76925770308123,770,378,392,11,1,94.58,8.4,0,0,0,0,0,0,0.0195978473532478,20.0895349219283,19.516271221398
8.7,"random_instances_SVM","SVM",81,37,112,101,11,3800,3394,406,0.924731182795693,0.613756613756614,1.7804062440677,796,390,406,26,1,97.14,8.4,0,0,0,0,0,0,0.00172075893845011,10.9615362479842,10.9519640771222
8.7,"random_instances_SVM","SVM",81,38,12,11,1,3900,3484,416,0.924958752915737,0.603174603174603,1.77713644380311,815,400,415,19,1,99.69,8.4,0,0,0,0,0,0,0.000405652894148182,0.79193455156735,0.79193455156735
8.7,"random_instances_SVM","SVM",81,39,0,0,0,3912,3495,417,0.925210277785258,0.608465608465608,1.78368809889547,821,401,420,6,1,100,8.4,0,0,0,0,0,0,0,0,0
8.7,"random_instances_SVM","SVM",82,0,3812,3424,388,100,93,7,0.88525916973343,0.502369668246445,1.73655555990756,25,7,18,0,2.6,2.56,13.3,0,0,0,0,0,0,0.449898647076956,316.467650285841,56.9392007629919
8.7,"random_instances_SVM","SVM",82,1,3712,3340,372,200,177,23,0.91095479297655,0.57345971563981,1.75036598450919,49,23,26,24,1.1,5.11,7.7,0,0,0,0,0,0,0.713304635583778,402.859462768371,79.5513703632801
8.7,"random_instances_SVM","SVM",82,2,3612,3246,366,300,271,29,0.908471054740016,0.568720379146919,1.74667201003624,69,29,40,20,1.4,7.67,9.3,0,0,0,0,0,0,0.514871968930991,324.640176273595,58.9429702746167
8.7,"random_instances_SVM","SVM",82,3,3512,3153,359,400,364,36,0.920645310229635,0.592417061611374,1.77911819617981,81,36,45,12,1.2,10.22,10.1,0,0,0,0,0,0,0.469971305920936,285.611749376009,54.4776560805633
8.7,"random_instances_SVM","SVM",82,4,3412,3067,345,500,450,50,0.925229837450269,0.62085308056872,1.76696080228326,111,50,61,30,1.2,12.78,9,0,0,0,0,0,0,0.492892481642098,310.970353894241,56.4045120199425
8.7,"random_instances_SVM","SVM",82,5,3312,2977,335,600,540,60,0.921897364168434,0.616113744075829,1.75680707368862,128,60,68,17,1.1,15.34,9,0,0,0,0,0,0,0.560633206739056,309.234301099835,64.1294696459692
8.7,"random_instances_SVM","SVM",82,6,3212,2884,328,700,633,67,0.917206914814158,0.597156398104265,1.75680707368862,148,67,81,20,1.2,17.89,9.4,0,0,0,0,0,0,0.654680063246901,329.448317169285,75.7107798866943
8.7,"random_instances_SVM","SVM",82,7,3112,2791,321,800,726,74,0.923787666861317,0.616113744075829,1.76898126005478,165,74,91,17,1.2,20.45,9.8,0,0,0,0,0,0,0.773470884753515,324.297934664417,87.3280790609312
8.7,"random_instances_SVM","SVM",82,8,3012,2703,309,900,814,86,0.925702413123478,0.625592417061611,1.76371271257318,189,86,103,24,1.2,23.01,9.5,0,0,0,0,0,0,0.752378325699222,308.55566095289,85.0766869505768
8.7,"random_instances_SVM","SVM",82,9,2912,2612,300,1000,905,95,0.924510110131852,0.616113744075829,1.76533526336672,205,95,110,16,1.2,25.56,9.5,0,0,0,0,0,0,0.710639346872482,280.146197805366,81.6356131010685
8.7,"random_instances_SVM","SVM",82,10,2812,2519,293,1100,998,102,0.922497589592464,0.625592417061611,1.76696080228326,212,102,110,7,1.1,28.12,9.8,0,0,0,0,0,0,0.725624567013098,273.110196939276,84.746068906026
8.7,"random_instances_SVM","SVM",82,11,2712,2435,277,1200,1082,118,0.929895843235237,0.649289099526066,1.77549684480637,248,118,130,36,1.1,30.67,9.2,0,0,0,0,0,0,0.665189719520505,260.947504596712,78.7631289734666
8.7,"random_instances_SVM","SVM",82,12,2612,2347,265,1300,1170,130,0.932083542687981,0.639810426540284,1.78403288732948,273,130,143,25,1.1,33.23,9,0,0,0,0,0,0,0.68892435517353,252.109133377278,80.6051685763799
8.7,"random_instances_SVM","SVM",82,13,2512,2256,256,1400,1261,139,0.930676679476906,0.635071090047393,1.76898126005478,300,139,161,27,1.2,35.79,9.1,0,0,0,0,0,0,0.608007208158327,239.973361999849,75.3791951217059
8.7,"random_instances_SVM","SVM",82,14,2412,2166,246,1500,1351,149,0.931612324990828,0.649289099526066,1.78239164272292,315,149,166,15,1.1,38.34,9.1,0,0,0,0,0,0,0.680345694652847,245.445775234014,81.2208175214639
8.7,"random_instances_SVM","SVM",82,15,2312,2079,233,1600,1438,162,0.933277203655671,0.654028436018957,1.78403288732948,343,162,181,28,1.1,40.9,8.9,0,0,0,0,0,0,0.654921813918719,239.266861327938,79.8425518355716
8.7,"random_instances_SVM","SVM",82,16,2212,1988,224,1700,1529,171,0.932581919906583,0.658767772511848,1.77911819617981,360,171,189,17,1.1,43.46,8.9,0,0,0,0,0,0,0.6804292159758,226.904137139427,84.4651466163129
8.7,"random_instances_SVM","SVM",82,17,2112,1894,218,1800,1623,177,0.931905647822495,0.663507109004739,1.77386345304482,377,177,200,17,1.1,46.01,9.2,0,0,0,0,0,0,0.658891143647547,214.573096789853,82.2625268760309
8.7,"random_instances_SVM","SVM",82,18,2012,1803,209,1900,1714,186,0.932981164871882,0.663507109004739,1.77911819617981,391,186,205,14,1.1,48.57,9.2,0,0,0,0,0,0,0.667712799030494,216.107574091938,83.6176067353572
8.7,"random_instances_SVM","SVM",82,19,1912,1710,202,2000,1807,193,0.933252760086371,0.658767772511848,1.77911819617981,403,193,210,12,1.1,51.12,9.4,0,0,0,0,0,0,0.672264011013703,203.463954906333,83.7174374974826
8.7,"random_instances_SVM","SVM",82,20,1812,1619,193,2100,1898,202,0.933154985809158,0.663507109004739,1.7774859776512,422,202,220,19,1.1,53.68,9.4,0,0,0,0,0,0,0.625491868785104,192.07082333161,81.6748722380376
8.7,"random_instances_SVM","SVM",82,21,1712,1524,188,2200,1993,207,0.932913266068259,0.658767772511848,1.78239164272292,432,207,225,10,1.1,56.24,9.6,0,0,0,0,0,0,0.610063181384962,178.402292210123,81.7094954913755
8.7,"random_instances_SVM","SVM",82,22,1612,1435,177,2300,2082,218,0.934043102160542,0.654028436018957,1.78075341511012,455,218,237,23,1.1,58.79,9.6,0,0,0,0,0,0,0.595815568170056,165.359063686733,80.4619712559164
8.7,"random_instances_SVM","SVM",82,23,1512,1346,166,2400,2171,229,0.934173467863495,0.644549763033175,1.78403288732948,476,229,247,21,1.1,61.35,9.5,0,0,0,0,0,0,0.579544057914225,153.169162574419,79.1271411278106
8.7,"random_instances_SVM","SVM",82,24,1412,1259,153,2500,2258,242,0.93399557299801,0.644549763033175,1.78075341511012,504,242,262,28,1.1,63.91,9.3,0,0,0,0,0,0,0.500498025680734,139.202485837776,75.6556507781885
8.7,"random_instances_SVM","SVM",82,25,1312,1169,143,2600,2348,252,0.934134086557404,0.644549763033175,1.78403288732948,526,252,274,22,1.1,66.46,9.3,0,0,0,0,0,0,0.533345225795813,138.337438795617,77.227778452309
8.7,"random_instances_SVM","SVM",82,26,1212,1083,129,2700,2434,266,0.935539591792398,0.658767772511848,1.78075341511012,551,266,285,25,1.1,69.02,9.2,0,0,0,0,0,0,0.5,131.046055065327,75.676209362535
8.7,"random_instances_SVM","SVM",82,27,1112,991,121,2800,2526,274,0.936779423946548,0.66824644549763,1.78403288732948,567,274,293,16,1.1,71.57,9.2,0,0,0,0,0,0,0.429326765721977,115.188493356458,71.3440092778848
8.7,"random_instances_SVM","SVM",82,28,1012,901,111,2900,2616,284,0.937059167017475,0.658767772511848,1.78403288732948,588,284,304,21,1.1,74.13,9.2,0,0,0,0,0,0,0.361420885475081,104.152370079277,65.6258802730684
8.7,"random_instances_SVM","SVM",82,29,912,811,101,3000,2706,294,0.937975800866392,0.663507109004739,1.77911819617981,612,294,318,24,1.1,76.69,9.2,0,0,0,0,0,0,0.332752211396833,94.4424219014537,65.7600365728749
8.7,"random_instances_SVM","SVM",82,30,812,721,91,3100,2796,304,0.937841361235222,0.663507109004739,1.78075341511012,634,304,330,22,1.1,79.24,9.2,0,0,0,0,0,0,0.275724685518606,85.7322188130011,64.5497947827185
8.7,"random_instances_SVM","SVM",82,31,712,634,78,3200,2883,317,0.939344640747438,0.663507109004739,1.77911819617981,654,317,337,20,1.1,81.8,9.1,0,0,0,0,0,0,0.176427818800275,70.9179414851181,55.9916868839999
8.7,"random_instances_SVM","SVM",82,32,612,547,65,3300,2970,330,0.940716196580621,0.658767772511848,1.78403288732948,677,330,347,23,1.1,84.36,9,0,0,0,0,0,0,0.124782291296156,61.3388119823449,51.5667871273669
8.7,"random_instances_SVM","SVM",82,33,512,456,56,3400,3061,339,0.940623854207679,0.658767772511848,1.78567715727171,699,339,360,22,1.1,86.91,9,0,0,0,0,0,0,0.0924566283848852,51.3624254520752,44.5030265468089
8.7,"random_instances_SVM","SVM",82,34,412,367,45,3500,3150,350,0.941248523201011,0.649289099526066,1.78239164272292,722,350,372,23,1.1,89.47,9,0,0,0,0,0,0,0.0637401823502576,41.5674372829386,37.4647617733836
8.7,"random_instances_SVM","SVM",82,35,312,281,31,3600,3236,364,0.942290090848594,0.654028436018957,1.78599069524762,756,364,392,34,1.1,92.02,8.9,0,0,0,0,0,0,0.0453818740912356,28.24465729808,26.2735262741899
8.7,"random_instances_SVM","SVM",82,36,212,188,24,3700,3329,371,0.942319966322186,0.649289099526066,1.79256892985258,770,371,399,14,1.1,94.58,9,0,0,0,0,0,0,0.0178024313040481,22.0127301482765,21.5306366901777
8.7,"random_instances_SVM","SVM",82,37,112,101,11,3800,3416,384,0.94298944852591,0.654028436018957,1.79091983240102,782,382,400,12,1,97.14,8.9,0,0,0,0,0,0,0.00150484237515874,9.10589408701557,9.0962953000323
8.7,"random_instances_SVM","SVM",82,38,12,12,0,3900,3505,395,0.943364249921909,0.658767772511848,1.79091983240102,805,392,413,23,1.1,99.69,8.9,0,0,0,0,0,0,0.000804987633894759,0.493433139476769,0.493433139476769
8.7,"random_instances_SVM","SVM",82,39,0,0,0,3912,3517,395,0.943331658496171,0.658767772511848,1.78763072343426,803,393,410,-2,1,100,8.9,0,0,0,0,0,0,0,0,0
8.7,"random_instances_SVM","SVM",83,0,3812,3431,381,100,86,14,0.899902225722781,0.597156398104265,1.72861883431384,40,14,26,0,1.9,2.56,6.1,0,0,0,0,0,0,0.647296111343801,485.02211371881,70.9880583083066
8.7,"random_instances_SVM","SVM",83,1,3712,3346,366,200,171,29,0.90889610125069,0.592417061611374,1.75886290676409,65,29,36,25,1.2,5.11,5.9,0,0,0,0,0,0,0.792395613169531,488.444877917011,85.2624639164391
8.7,"random_instances_SVM","SVM",83,2,3612,3255,357,300,262,38,0.912334496666159,0.582938388625592,1.74079242397404,81,38,43,16,1.1,7.67,6.9,0,0,0,0,0,0,0.632531182270549,409.949115015575,69.1928386610694
8.7,"random_instances_SVM","SVM",83,3,3512,3164,348,400,353,47,0.903904181208337,0.563981042654028,1.74506808716201,100,47,53,19,1.1,10.22,7.5,0,0,0,0,0,0,0.632609601034725,350.548093097811,70.5116867837449
8.7,"random_instances_SVM","SVM",83,4,3412,3075,337,500,442,58,0.914667499558672,0.57345971563981,1.76533526336672,126,58,68,26,1.2,12.78,7.6,0,0,0,0,0,0,0.580610847638755,360.979261529278,66.0696588746946
8.7,"random_instances_SVM","SVM",83,5,3312,2986,326,600,531,69,0.912464862369122,0.568720379146919,1.78239164272292,149,69,80,23,1.2,15.34,7.7,0,0,0,0,0,0,0.813289200302112,398.665705211815,87.293091962738
8.7,"random_instances_SVM","SVM",83,6,3212,2897,315,700,620,80,0.914803297165904,0.592417061611374,1.76371271257318,168,80,88,19,1.1,17.89,7.8,0,0,0,0,0,0,0.744029419984872,361.1078850448,82.0449505649039
8.7,"random_instances_SVM","SVM",83,7,3112,2804,308,800,713,87,0.921039123290658,0.57345971563981,1.77911819617981,190,87,103,22,1.2,20.45,8.2,0,0,0,0,0,0,0.763942031978374,344.948796416722,83.9705695250515
8.7,"random_instances_SVM","SVM",83,8,3012,2709,303,900,808,92,0.91982509268188,0.587677725118483,1.77060566892536,202,92,110,12,1.2,23.01,8.8,0,0,0,0,0,0,0.702265699065409,319.417027595399,79.7690347180213
8.7,"random_instances_SVM","SVM",83,9,2912,2619,293,1000,898,102,0.919108081315616,0.597156398104265,1.78075341511012,220,102,118,18,1.2,25.56,8.8,0,0,0,0,0,0,0.679308012873516,313.540549753982,78.0503344982686
8.7,"random_instances_SVM","SVM",83,10,2812,2529,283,1100,988,112,0.920524450359195,0.592417061611374,1.77223306384165,245,112,133,25,1.2,28.12,8.8,0,0,0,0,0,0,0.523030039066581,279.896848554046,63.9506008615761
8.7,"random_instances_SVM","SVM",83,11,2712,2443,269,1200,1074,126,0.922071185105733,0.606635071090047,1.77549684480637,267,126,141,22,1.1,30.67,8.5,0,0,0,0,0,0,0.761724370880323,300.963529322794,85.0833411758434
8.7,"random_instances_SVM","SVM",83,12,2612,2356,256,1300,1161,139,0.922318336750918,0.611374407582938,1.77060566892536,291,139,152,24,1.1,33.23,8.4,0,0,0,0,0,0,0.745414211308403,283.573657079464,84.5321823325507
8.7,"random_instances_SVM","SVM",83,13,2512,2266,246,1400,1251,149,0.922693138146915,0.616113744075829,1.77585675127389,317,149,168,26,1.1,35.79,8.4,0,0,0,0,0,0,0.714729850816599,269.426083808552,82.7346955761423
8.7,"random_instances_SVM","SVM",83,14,2412,2177,235,1500,1340,160,0.923069297518986,0.606635071090047,1.78403288732948,335,160,175,18,1.1,38.34,8.4,0,0,0,0,0,0,0.54124902758618,237.809828304702,66.9804016430926
8.7,"random_instances_SVM","SVM",83,15,2312,2084,228,1600,1433,167,0.923191515365508,0.625592417061611,1.7774859776512,351,167,184,16,1.1,40.9,8.6,0,0,0,0,0,0,0.683235594076205,243.355617185182,81.2868057547659
8.7,"random_instances_SVM","SVM",83,16,2212,1993,219,1700,1524,176,0.922728445524796,0.630331753554502,1.77911819617981,369,176,193,18,1.1,43.46,8.7,0,0,0,0,0,0,0.670111705053755,234.38437047819,81.2598007704438
8.7,"random_instances_SVM","SVM",83,17,2112,1902,210,1800,1615,185,0.92245685031031,0.62085308056872,1.78239164272292,383,185,198,14,1.1,46.01,8.7,0,0,0,0,0,0,0.646171667973758,216.288028772598,79.8437931009942
8.7,"random_instances_SVM","SVM",83,18,2012,1811,201,1900,1706,194,0.92117899482612,0.616113744075829,1.77549684480637,399,194,205,16,1.1,48.57,8.8,0,0,0,0,0,0,0.672089265481117,215.593700208518,82.0393312948274
8.7,"random_instances_SVM","SVM",83,19,1912,1722,190,2000,1795,205,0.922847947419174,0.62085308056872,1.76936960332403,421,205,216,22,1.1,51.12,8.8,0,0,0,0,0,0,0.63587137092475,202.021285888255,80.5276628963276
8.7,"random_instances_SVM","SVM",83,20,1812,1634,178,2100,1883,217,0.922929425983526,0.630331753554502,1.77713324742831,444,217,227,23,1,53.68,8.7,0,0,0,0,0,0,0.641320110029764,192.154100845662,80.8649587790314
8.7,"random_instances_SVM","SVM",83,21,1712,1542,170,2200,1975,225,0.924496530371148,0.630331753554502,1.77585675127389,461,225,236,17,1,56.24,8.8,0,0,0,0,0,0,0.636686523090308,185.392617890497,79.548054406902
8.7,"random_instances_SVM","SVM",83,22,1612,1453,159,2300,2064,236,0.924602452504797,0.62085308056872,1.76735982901899,483,236,247,22,1,58.79,8.7,0,0,0,0,0,0,0.592309334887148,167.722636926054,77.2658074693203
8.7,"random_instances_SVM","SVM",83,23,1512,1360,152,2400,2157,243,0.927029155746282,0.630331753554502,1.76251332126117,499,243,256,16,1.1,61.35,8.9,0,0,0,0,0,0,0.59945928041348,159.834654541195,78.1869625524317
8.7,"random_instances_SVM","SVM",83,24,1412,1270,142,2500,2247,253,0.925743152405654,0.644549763033175,1.77060566892536,527,253,274,28,1.1,63.91,8.9,0,0,0,0,0,0,0.597074700331249,154.609604911028,78.8974604900431
8.7,"random_instances_SVM","SVM",83,25,1312,1178,134,2600,2339,261,0.927242357989659,0.639810426540284,1.77386345304482,538,261,277,11,1.1,66.46,9,0,0,0,0,0,0,0.578619089843097,143.776198130608,77.5613300147973
8.7,"random_instances_SVM","SVM",83,26,1212,1091,121,2700,2426,274,0.926950393134078,0.635071090047393,1.77549684480637,560,273,287,22,1.1,69.02,8.9,0,0,0,0,0,0,0.511688403607711,128.562461323669,72.6508250673161
8.7,"random_instances_SVM","SVM",83,27,1112,998,114,2800,2519,281,0.927823571748672,0.635071090047393,1.77060566892536,582,281,301,22,1.1,71.57,9,0,0,0,0,0,0,0.5,122.737706655138,71.9685988464588
8.7,"random_instances_SVM","SVM",83,28,1012,912,100,2900,2605,295,0.929780415269089,0.639810426540284,1.77549684480637,613,295,318,31,1.1,74.13,8.8,0,0,0,0,0,0,0.450361363669329,112.078660902701,70.7161760781684
8.7,"random_instances_SVM","SVM",83,29,912,821,91,3000,2696,304,0.930132131071854,0.625592417061611,1.77549684480637,625,303,322,12,1.1,76.69,8.9,0,0,0,0,0,0,0.385627661547071,99.1869158869918,68.2952391684411
8.7,"random_instances_SVM","SVM",83,30,812,732,80,3100,2785,315,0.930622360434011,0.635071090047393,1.77549684480637,651,315,336,26,1.1,79.24,8.8,0,0,0,0,0,0,0.279922481762288,85.4534248569676,64.6981819954501
8.7,"random_instances_SVM","SVM",83,31,712,642,70,3200,2875,325,0.931213080025532,0.635071090047393,1.77060566892536,671,325,346,20,1.1,81.8,8.8,0,0,0,0,0,0,0.213362119336028,74.6810338377873,59.7713194516967
8.7,"random_instances_SVM","SVM",83,32,612,552,60,3300,2965,335,0.931150613126194,0.630331753554502,1.76735982901899,690,335,355,19,1.1,84.36,8.9,0,0,0,0,0,0,0.119752572074453,59.3151851513012,47.1447366345505
8.7,"random_instances_SVM","SVM",83,33,512,461,51,3400,3056,344,0.932480071701141,0.635071090047393,1.77549684480637,712,344,368,22,1.1,86.91,8.9,0,0,0,0,0,0,0.0888584638448245,53.4644957264901,45.7871593645412
8.7,"random_instances_SVM","SVM",83,34,412,375,37,3500,3142,358,0.932408098969303,0.639810426540284,1.77386345304482,742,358,384,30,1.1,89.47,8.8,0,0,0,0,0,0,0.0676629675534885,40.7050640682771,35.4967592692431
8.7,"random_instances_SVM","SVM",83,35,312,284,28,3600,3233,367,0.932820923695331,0.635071090047393,1.77549684480637,755,366,389,13,1.1,92.02,8.8,0,0,0,0,0,0,0.0490770658627101,30.5047098339033,28.0515062461498
8.7,"random_instances_SVM","SVM",83,36,212,195,17,3700,3322,378,0.932511305150812,0.630331753554502,1.7657413676371,768,375,393,13,1,94.58,8.8,0,0,0,0,0,0,0.016376272751551,20.032182088128,19.5635394323777
8.7,"random_instances_SVM","SVM",83,37,112,108,4,3800,3409,391,0.933385841741476,0.639810426540284,1.77549684480637,791,386,405,23,1,97.14,8.7,0,0,0,0,0,0,0.0014208423449633,7.77900495322243,7.76784363153657
8.7,"random_instances_SVM","SVM",83,38,12,12,0,3900,3505,395,0.933665584812402,0.644549763033175,1.77713324742831,801,391,410,10,1,99.69,8.9,0,0,0,0,0,0,0.00168461067587956,0.434109659787024,0.434109659787024
8.7,"random_instances_SVM","SVM",83,39,0,0,0,3912,3517,395,0.933766075041764,0.644549763033175,1.77060566892536,799,390,409,-2,1,100,8.9,0,0,0,0,0,0,0,0,0
8.7,"random_instances_SVM","SVM",84,0,3812,3426,386,100,91,9,0.865696166433548,0.535545023696682,1.66606241946404,22,9,13,0,1.4,2.56,10.1,0,0,0,0,0,0,0.268625030039687,320.279392732882,29.343849054084
8.7,"random_instances_SVM","SVM",84,1,3712,3342,370,200,175,25,0.903910971088688,0.582938388625592,1.71795295447628,55,25,30,33,1.2,5.11,7,0,0,0,0,0,0,0.669111409183956,438.727483408883,72.7385964405438
8.7,"random_instances_SVM","SVM",84,2,3612,3251,361,300,266,34,0.903866157878286,0.630331753554502,1.72111095623083,77,34,43,22,1.3,7.67,7.8,0,0,0,0,0,0,0.794049658138298,418.02529514164,86.1274674078977
8.7,"random_instances_SVM","SVM",84,3,3512,3156,356,400,361,39,0.904344165455813,0.616113744075829,1.71101797814422,88,39,49,11,1.3,10.22,9.3,0,0,0,0,0,0,0.586075528094798,297.270988424712,70.0738789854382
8.7,"random_instances_SVM","SVM",84,4,3412,3070,342,500,447,53,0.902554352992305,0.616113744075829,1.71416612529812,114,53,61,26,1.2,12.78,8.4,0,0,0,0,0,0,0.773029877357359,366.778746467258,85.7805533601778
8.7,"random_instances_SVM","SVM",84,5,3312,2983,329,600,534,66,0.916663724385171,0.606635071090047,1.7600454277415,145,66,79,31,1.2,15.34,8.1,0,0,0,0,0,0,0.713070527743795,349.268809651299,80.8842003239919
8.7,"random_instances_SVM","SVM",84,6,3212,2893,319,700,624,76,0.920300384307234,0.616113744075829,1.75150151789809,167,76,91,22,1.2,17.89,8.2,0,0,0,0,0,0,0.762738361293617,354.510263158974,83.6754121414367
8.7,"random_instances_SVM","SVM",84,7,3112,2797,315,800,720,80,0.920533956191695,0.611374407582938,1.76371271257318,180,80,100,13,1.2,20.45,9,0,0,0,0,0,0,0.699381499686321,307.218324302854,80.2540739661727
8.7,"random_instances_SVM","SVM",84,8,3012,2707,305,900,810,90,0.923126332514029,0.649289099526066,1.75842475976015,193,90,103,13,1.1,23.01,9,0,0,0,0,0,0,0.769044821499966,315.10801145301,85.0828632974876
8.7,"random_instances_SVM","SVM",84,9,2912,2615,297,1000,902,98,0.925968576433695,0.649289099526066,1.75036598450919,208,98,110,15,1.1,25.56,9.2,0,0,0,0,0,0,0.712393457556147,282.21326511338,80.7081257971166
8.7,"random_instances_SVM","SVM",84,10,2812,2524,288,1100,993,107,0.924644549763041,0.654028436018957,1.77549684480637,229,107,122,21,1.1,28.12,9.3,0,0,0,0,0,0,0.744299057318303,291.013284828377,83.6958526712952
8.7,"random_instances_SVM","SVM",84,11,2712,2433,279,1200,1084,116,0.926136965466667,0.649289099526066,1.7685893375849,247,116,131,18,1.1,30.67,9.3,0,0,0,0,0,0,0.721651596764836,269.836219760861,82.9870036758422
8.7,"random_instances_SVM","SVM",84,12,2612,2341,271,1300,1176,124,0.927899618408727,0.639810426540284,1.7685893375849,260,124,136,13,1.1,33.23,9.5,0,0,0,0,0,0,0.663082258766349,258.888889993108,76.1269657402344
8.7,"random_instances_SVM","SVM",84,13,2512,2253,259,1400,1264,136,0.927959369355911,0.639810426540284,1.76533526336672,283,136,147,23,1.1,35.79,9.3,0,0,0,0,0,0,0.73057671501066,250.326413980756,83.0481615478677
8.7,"random_instances_SVM","SVM",84,14,2412,2164,248,1500,1353,147,0.929360800662687,0.635071090047393,1.76533526336672,304,147,157,21,1.1,38.34,9.2,0,0,0,0,0,0,0.611365318360717,228.092574223337,73.2266342956071
8.7,"random_instances_SVM","SVM",84,15,2312,2076,236,1600,1441,159,0.930699765070144,0.649289099526066,1.76209314167091,333,159,174,29,1.1,40.9,9.1,0,0,0,0,0,0,0.646943875569034,227.946023635366,77.3834056406157
8.7,"random_instances_SVM","SVM",84,16,2212,1991,221,1700,1526,174,0.930678037452996,0.639810426540284,1.76371271257318,362,174,188,29,1.1,43.46,8.8,0,0,0,0,0,0,0.686818397009831,228.410205074036,79.8721986827379
8.7,"random_instances_SVM","SVM",84,17,2112,1900,212,1800,1617,183,0.932490935509733,0.630331753554502,1.76047654245837,387,183,204,25,1.1,46.01,8.8,0,0,0,0,0,0,0.7133449122705,235.193609300165,82.1263730755186
8.7,"random_instances_SVM","SVM",84,18,2012,1809,203,1900,1708,192,0.932739445130993,0.630331753554502,1.76533526336672,400,192,208,13,1.1,48.57,8.9,0,0,0,0,0,0,0.711665864925149,215.631004696609,82.6177081279074
8.7,"random_instances_SVM","SVM",84,19,1912,1719,193,2000,1798,202,0.930976792188937,0.630331753554502,1.7685893375849,423,202,221,23,1.1,51.12,8.9,0,0,0,0,0,0,0.717835921056124,209.446331429046,83.7207963344591
8.7,"random_instances_SVM","SVM",84,20,1812,1627,185,2100,1890,210,0.929931150613147,0.625592417061611,1.76696080228326,434,210,224,11,1.1,53.68,9,0,0,0,0,0,0,0.654638886141163,191.510936351589,79.4655253954682
8.7,"random_instances_SVM","SVM",84,21,1712,1540,172,2200,1977,223,0.931085430274734,0.644549763033175,1.76371271257318,456,222,234,22,1.1,56.24,8.9,0,0,0,0,0,0,0.613114047945929,176.308079455527,76.9309244068733
8.7,"random_instances_SVM","SVM",84,22,1612,1451,161,2300,2066,234,0.931598745230128,0.639810426540284,1.76209314167091,483,234,249,27,1.1,58.79,8.8,0,0,0,0,0,0,0.610913936759634,166.708791294663,77.4514153943357
8.7,"random_instances_SVM","SVM",84,23,1512,1365,147,2400,2152,248,0.932609079428035,0.644549763033175,1.77386345304482,515,248,267,32,1.1,61.35,8.7,0,0,0,0,0,0,0.576036230931409,150.903408890888,75.6751235221157
8.7,"random_instances_SVM","SVM",84,24,1412,1273,139,2500,2244,256,0.932280449218499,0.625592417061611,1.77223306384165,529,256,273,14,1.1,63.91,8.8,0,0,0,0,0,0,0.53631164313192,139.99967188858,74.6855488728999
8.7,"random_instances_SVM","SVM",84,25,1312,1188,124,2600,2329,271,0.934071619658077,0.635071090047393,1.77549684480637,557,271,286,28,1.1,66.46,8.6,0,0,0,0,0,0,0.536223031854961,133.322637723394,75.1707525023161
8.7,"random_instances_SVM","SVM",84,26,1212,1095,117,2700,2422,278,0.936422276239506,0.639810426540284,1.76696080228326,567,278,289,10,1,69.02,8.7,0,0,0,0,0,0,0.546384879911564,127.480059272023,75.9811698642008
8.7,"random_instances_SVM","SVM",84,27,1112,1010,102,2800,2507,293,0.936111299718911,0.639810426540284,1.76696080228326,602,293,309,35,1.1,71.57,8.6,0,0,0,0,0,0,0.519673939457124,117.728790820081,73.6471085038852
8.7,"random_instances_SVM","SVM",84,28,1012,924,88,2900,2593,307,0.934784557096118,0.625592417061611,1.7685893375849,631,307,324,29,1.1,74.13,8.4,0,0,0,0,0,0,0.442817440870278,101.34443572098,69.0595301432265
8.7,"random_instances_SVM","SVM",84,29,912,834,78,3000,2683,317,0.936400548622345,0.649289099526066,1.76533526336672,650,317,333,19,1.1,76.69,8.5,0,0,0,0,0,0,0.439799665674125,97.8942357465222,70.1889525823837
8.7,"random_instances_SVM","SVM",84,30,812,745,67,3100,2772,328,0.934665055201739,0.630331753554502,1.76533526336672,670,327,343,20,1,79.24,8.5,0,0,0,0,0,0,0.319236285411127,85.5232428628238,64.0465137407803
8.7,"random_instances_SVM","SVM",84,31,712,650,62,3200,2867,333,0.934545553307362,0.644549763033175,1.76371271257318,681,333,348,11,1,81.8,8.6,0,0,0,0,0,0,0.255078767105697,77.1435669887942,59.9819918750525
8.7,"random_instances_SVM","SVM",84,32,612,561,51,3300,2956,344,0.933087087005539,0.616113744075829,1.76047654245837,705,344,361,24,1,84.36,8.6,0,0,0,0,0,0,0.153221498453593,63.2223348853649,52.7891925014156
8.7,"random_instances_SVM","SVM",84,33,512,468,44,3400,3049,351,0.9330151142737,0.630331753554502,1.76696080228326,721,351,370,16,1.1,86.91,8.7,0,0,0,0,0,0,0.119239291595874,54.6432409962035,46.6701816644896
8.7,"random_instances_SVM","SVM",84,34,412,379,33,3500,3138,362,0.9348741835169,0.630331753554502,1.7685893375849,740,362,378,19,1,89.47,8.7,0,0,0,0,0,0,0.0763886441700266,45.5887302294823,41.9764704542704
8.7,"random_instances_SVM","SVM",84,35,312,288,24,3600,3229,371,0.934955662081248,0.644549763033175,1.76533526336672,757,371,386,17,1,92.02,8.7,0,0,0,0,0,0,0.034522405671809,31.3856126944507,30.2896939655188
8.7,"random_instances_SVM","SVM",84,36,212,197,15,3700,3320,380,0.936097719958191,0.644549763033175,1.76371271257318,774,380,394,17,1,94.58,8.7,0,0,0,0,0,0,0.00647726519651227,23.0246293391695,22.8771933281168
8.7,"random_instances_SVM","SVM",84,37,112,101,11,3800,3416,384,0.935634650117481,0.639810426540284,1.76533526336672,786,384,402,12,1,97.14,8.9,0,0,0,0,0,0,0.000269842346643441,13.7353421519913,13.7336723236798
8.7,"random_instances_SVM","SVM",84,38,12,11,1,3900,3506,394,0.934893195181917,0.635071090047393,1.7685893375849,810,394,416,24,1.1,99.69,8.9,0,0,0,0,0,0,0.000155331279258718,0.709586808522673,0.709586808522673
8.7,"random_instances_SVM","SVM",84,39,0,0,0,3912,3517,395,0.93514306277925,0.635071090047393,1.7685893375849,810,395,415,0,1.1,100,8.9,0,0,0,0,0,0,0,0,0
8.7,"random_instances_SVM","SVM",85,0,3812,3423,389,100,94,6,0.837156941294698,0.5260663507109,1.6062550505602,24,6,18,0,3,2.56,15.7,0,0,0,0,0,0,0.142352373328418,265.230780220632,15.2939880778356
8.7,"random_instances_SVM","SVM",85,1,3712,3339,373,200,178,22,0.913119406836053,0.606635071090047,1.75680707368862,50,22,28,26,1.3,5.11,8.1,0,0,0,0,0,0,0.703540160377902,410.529881058783,76.9812072816863
8.7,"random_instances_SVM","SVM",85,2,3612,3248,364,300,269,31,0.914545281712123,0.601895734597156,1.74827888401052,72,31,41,22,1.3,7.67,8.7,0,0,0,0,0,0,0.818568061427683,439.070517916531,86.0989785327537
8.7,"random_instances_SVM","SVM",85,3,3512,3157,355,400,360,40,0.908877089585678,0.592417061611374,1.74827888401052,88,40,48,16,1.2,10.22,9,0,0,0,0,0,0,0.814383396425615,381.706425803747,86.018958359231
8.7,"random_instances_SVM","SVM",85,4,3412,3072,340,500,445,55,0.913198169448244,0.606635071090047,1.76371271257318,117,55,62,29,1.1,12.78,8.1,0,0,0,0,0,0,0.824421824642638,396.079651132281,86.762674302589
8.7,"random_instances_SVM","SVM",85,5,3312,2986,326,600,531,69,0.914507258382099,0.62085308056872,1.77386345304482,147,69,78,30,1.1,15.34,7.7,0,0,0,0,0,0,0.752192324253576,363.780321326231,84.0771278115362
8.7,"random_instances_SVM","SVM",85,6,3212,2891,321,700,626,74,0.913678892977897,0.616113744075829,1.75564449339398,155,74,81,8,1.1,17.89,8.5,0,0,0,0,0,0,0.77500203284497,368.776445711573,84.801450748304
8.7,"random_instances_SVM","SVM",85,7,3112,2798,314,800,719,81,0.913264710275795,0.606635071090047,1.78075341511012,174,81,93,19,1.1,20.45,8.9,0,0,0,0,0,0,0.750649237920971,336.617402864608,83.3413989528956
8.7,"random_instances_SVM","SVM",85,8,3012,2707,305,900,810,90,0.91701951411615,0.630331753554502,1.77585675127389,190,90,100,16,1.1,23.01,9,0,0,0,0,0,0,0.786614767304376,323.283966573485,86.3878132839042
8.7,"random_instances_SVM","SVM",85,9,2912,2616,296,1000,901,99,0.921662434307896,0.630331753554502,1.76371271257318,208,99,109,18,1.1,25.56,9.1,0,0,0,0,0,0,0.756878510125481,307.3490404104,85.2281857875876
8.7,"random_instances_SVM","SVM",85,10,2812,2525,287,1100,992,108,0.921552438246029,0.635071090047393,1.78567715727171,224,108,116,16,1.1,28.12,9.2,0,0,0,0,0,0,0.733760474164162,290.680363488612,83.3171045491322
8.7,"random_instances_SVM","SVM",85,11,2712,2432,280,1200,1085,115,0.922915846222778,0.630331753554502,1.76371271257318,239,115,124,15,1.1,30.67,9.4,0,0,0,0,0,0,0.71981415049833,280.201080167346,83.2513110157218
8.7,"random_instances_SVM","SVM",85,12,2612,2339,273,1300,1178,122,0.922921278127068,0.62085308056872,1.77386345304482,255,122,133,16,1.1,33.23,9.7,0,0,0,0,0,0,0.732012183097535,273.233334558748,84.6517539310384
8.7,"random_instances_SVM","SVM",85,13,2512,2252,260,1400,1265,135,0.92272437159655,0.630331753554502,1.74667201003624,279,135,144,24,1.1,35.79,9.4,0,0,0,0,0,0,0.733488009780094,259.173469933711,85.4958674305408
8.7,"random_instances_SVM","SVM",85,14,2412,2163,249,1500,1354,146,0.924425915615347,0.62085308056872,1.75680707368862,303,146,157,24,1.1,38.34,9.3,0,0,0,0,0,0,0.751531598383845,250.569522203438,85.8345599454424
8.7,"random_instances_SVM","SVM",85,15,2312,2073,239,1600,1444,156,0.923808036502376,0.625592417061611,1.74988871723705,320,156,164,17,1.1,40.9,9.3,0,0,0,0,0,0,0.690361047142199,229.193197848077,82.0354006797871
8.7,"random_instances_SVM","SVM",85,16,2212,1983,229,1700,1534,166,0.923912600659954,0.625592417061611,1.74667201003624,340,166,174,20,1,43.46,9.2,0,0,0,0,0,0,0.711746299262364,224.129713815623,84.5233613432194
8.7,"random_instances_SVM","SVM",85,17,2112,1891,221,1800,1626,174,0.924173332065866,0.62085308056872,1.74295760805469,358,174,184,18,1.1,46.01,9.3,0,0,0,0,0,0,0.727121183410926,220.182911624994,85.7214195896173
8.7,"random_instances_SVM","SVM",85,18,2012,1804,208,1900,1713,187,0.923023126332491,0.611374407582938,1.73815165876777,387,187,200,29,1.1,48.57,9.2,0,0,0,0,0,0,0.700959915913556,208.89503688344,84.8748942609644
8.7,"random_instances_SVM","SVM",85,19,1912,1717,195,2000,1800,200,0.923753717459473,0.62085308056872,1.73281663219083,409,200,209,22,1,51.12,9,0,0,0,0,0,0,0.664870310839066,193.137521423425,81.6453259137647
8.7,"random_instances_SVM","SVM",85,20,1812,1629,183,2100,1888,212,0.923926180420677,0.616113744075829,1.73441369821128,435,212,223,26,1.1,53.68,8.9,0,0,0,0,0,0,0.646760618855361,182.000405213666,81.5036821233782
8.7,"random_instances_SVM","SVM",85,21,1712,1535,177,2200,1982,218,0.9206656798707,0.625592417061611,1.73281663219083,447,218,229,12,1.1,56.24,9.1,0,0,0,0,0,0,0.636767961854556,177.808121813174,80.8752506669151
8.7,"random_instances_SVM","SVM",85,22,1612,1448,164,2300,2069,231,0.921375901356596,0.62085308056872,1.73441369821128,477,231,246,30,1.1,58.79,9,0,0,0,0,0,0,0.627212050851078,170.844527802628,80.8362027891121
8.7,"random_instances_SVM","SVM",85,23,1512,1358,154,2400,2159,241,0.921821317508367,0.644549763033175,1.74988871723705,501,241,260,24,1.1,61.35,9,0,0,0,0,0,0,0.653987543237133,162.527549840113,83.1244924741118
8.7,"random_instances_SVM","SVM",85,24,1412,1276,136,2500,2241,259,0.922754247070149,0.630331753554502,1.74988871723705,527,258,269,26,1,63.91,8.7,0,0,0,0,0,0,0.546600286258638,141.83311187942,75.1657519202742
8.7,"random_instances_SVM","SVM",85,25,1312,1187,125,2600,2330,270,0.923518787598945,0.630331753554502,1.73815165876777,555,269,286,28,1.1,66.46,8.6,0,0,0,0,0,0,0.501422879433116,133.828464388395,75.8868613110789
8.7,"random_instances_SVM","SVM",85,26,1212,1096,116,2700,2421,279,0.923168429772249,0.635071090047393,1.73122250465432,575,279,296,20,1.1,69.02,8.7,0,0,0,0,0,0,0.488138228631522,125.375500192895,76.3828060781413
8.7,"random_instances_SVM","SVM",85,27,1112,1010,102,2800,2507,293,0.926672008039201,0.639810426540284,1.73496238966912,603,293,310,28,1.1,71.57,8.6,0,0,0,0,0,0,0.466738311821624,116.040238265209,73.8955262976938
8.7,"random_instances_SVM","SVM",85,28,1012,916,96,2900,2601,299,0.926841755048259,0.639810426540284,1.73496238966912,614,299,315,11,1.1,74.13,8.7,0,0,0,0,0,0,0.426227438761264,105.275029658672,71.5515842749755
8.7,"random_instances_SVM","SVM",85,29,912,822,90,3000,2695,305,0.926872988497926,0.644549763033175,1.73122250465432,629,305,324,15,1.1,76.69,8.8,0,0,0,0,0,0,0.366954757178568,95.1446712501285,68.4950599702327
8.7,"random_instances_SVM","SVM",85,30,812,734,78,3100,2783,317,0.927978381020908,0.635071090047393,1.75680707368862,648,317,331,19,1,79.24,8.8,0,0,0,0,0,0,0.33036303172677,87.4282126200917,65.9445158694912
8.7,"random_instances_SVM","SVM",85,31,712,643,69,3200,2874,326,0.928270345876488,0.639810426540284,1.73815165876777,670,326,344,22,1.1,81.8,8.8,0,0,0,0,0,0,0.228617025552234,74.40290649354,58.1630949200622
8.7,"random_instances_SVM","SVM",85,32,612,551,61,3300,2966,334,0.929301049715485,0.630331753554502,1.74827888401052,690,334,356,20,1.1,84.36,8.9,0,0,0,0,0,0,0.171045213496615,64.8657084957456,54.961762366792
8.7,"random_instances_SVM","SVM",85,33,512,459,53,3400,3058,342,0.929040318309574,0.635071090047393,1.74988871723705,700,342,358,10,1,86.91,8.9,0,0,0,0,0,0,0.128709372148084,57.7041952011931,49.5218003574763
8.7,"random_instances_SVM","SVM",85,34,412,365,47,3500,3152,348,0.929014516764198,0.644549763033175,1.76371271257318,712,348,364,12,1,89.47,9.1,0,0,0,0,0,0,0.0873281888135188,45.5522371516321,40.2478813468337
8.7,"random_instances_SVM","SVM",85,35,312,275,37,3600,3242,358,0.92848626407201,0.639810426540284,1.75680707368862,731,358,373,19,1,92.02,9.1,0,0,0,0,0,0,0.0512761314376486,36.3486748615103,34.2168168618607
8.7,"random_instances_SVM","SVM",85,36,212,186,26,3700,3331,369,0.929507462078503,0.649289099526066,1.75842475976015,753,369,384,22,1,94.58,9,0,0,0,0,0,0,0.017835461061268,26.1767729880921,25.828907060918
8.7,"random_instances_SVM","SVM",85,37,112,99,13,3800,3418,382,0.929898559187371,0.649289099526066,1.75358061441646,781,380,401,28,1.1,97.14,8.9,0,0,0,0,0,0,0.000661414753422922,13.7803649926151,13.7774271910472
8.7,"random_instances_SVM","SVM",85,38,12,11,1,3900,3506,394,0.929480302557053,0.639810426540284,1.74988871723705,802,391,411,21,1.1,99.69,8.9,0,0,0,0,0,0,0.00011994920444072,1.34645599228393,1.34645599228393
8.7,"random_instances_SVM","SVM",85,39,0,0,0,3912,3517,395,0.929442279227024,0.644549763033175,1.75150151789809,801,391,410,-1,1,100,8.9,0,0,0,0,0,0,0,0,0
8.7,"random_instances_SVM","SVM",86,0,3812,3427,385,100,91,9,0.883511662627633,0.5,1.75174332666725,26,9,17,0,1.9,2.56,10.1,0,0,0,0,0,0,0.266667281617535,321.762884933825,31.4692749305106
8.7,"random_instances_SVM","SVM",86,1,3712,3343,369,200,175,25,0.923181365760778,0.594339622641509,1.79120879120879,53,25,28,27,1.1,5.11,7,0,0,0,0,0,0,0.688449478302974,437.899016504622,73.9173808318918
8.7,"random_instances_SVM","SVM",86,2,3612,3255,357,300,263,37,0.927373636835711,0.627358490566038,1.7746340792212,88,37,51,35,1.4,7.67,7.1,0,0,0,0,0,0,0.62643392226461,423.571885259221,68.4094523172101
8.7,"random_instances_SVM","SVM",86,3,3512,3160,352,400,358,42,0.927370932144706,0.608490566037736,1.7791985030407,102,42,60,14,1.4,10.22,8.5,0,0,0,0,0,0,0.63876893600915,380.353038695391,70.5504613024692
8.7,"random_instances_SVM","SVM",86,4,3412,3071,341,500,447,53,0.91078576683398,0.589622641509434,1.7707261292167,129,53,76,27,1.4,12.78,8.4,0,0,0,0,0,0,0.610684252069598,371.194931835203,71.726640473367
8.7,"random_instances_SVM","SVM",86,5,3312,2978,334,600,540,60,0.913727118313986,0.599056603773585,1.74370780682015,137,60,77,8,1.3,15.34,9,0,0,0,0,0,0,0.653146667709644,362.02234110239,75.6337245567104
8.7,"random_instances_SVM","SVM",86,6,3212,2887,325,700,631,69,0.920807999394131,0.608490566037736,1.79260919420411,155,69,86,18,1.2,17.89,9.1,0,0,0,0,0,0,0.606002816945417,319.473788215706,71.88007547042
8.7,"random_instances_SVM","SVM",86,7,3112,2795,317,800,723,77,0.918989094685814,0.608490566037736,1.7811286229695,177,77,100,22,1.3,20.45,9.4,0,0,0,0,0,0,0.575912227801003,294.657057437538,70.6885208554517
8.7,"random_instances_SVM","SVM",86,8,3012,2705,307,900,813,87,0.920230547862201,0.60377358490566,1.78931395671476,188,87,101,11,1.2,23.01,9.3,0,0,0,0,0,0,0.737843348317887,313.370741584515,83.7892679801777
8.7,"random_instances_SVM","SVM",86,9,2912,2613,299,1000,905,95,0.92236049203738,0.617924528301887,1.75539331298557,211,95,116,23,1.2,25.56,9.5,0,0,0,0,0,0,0.701086796987747,283.470764030143,82.1042660598956
8.7,"random_instances_SVM","SVM",86,10,2812,2523,289,1100,995,105,0.919607116582999,0.627358490566038,1.75741239892183,237,105,132,26,1.3,28.12,9.5,0,0,0,0,0,0,0.624732007599192,253.463143797314,77.5383449190962
8.7,"random_instances_SVM","SVM",86,11,2712,2433,279,1200,1085,115,0.920829636922269,0.632075471698113,1.77235363485017,251,115,136,14,1.2,30.67,9.4,0,0,0,0,0,0,0.521362823320155,238.319042749393,69.5743643648908
8.7,"random_instances_SVM","SVM",86,12,2612,2341,271,1300,1177,123,0.92206432837111,0.627358490566038,1.77235363485017,267,123,144,16,1.2,33.23,9.6,0,0,0,0,0,0,0.666499425129553,237.70365001052,81.3478055478483
8.7,"random_instances_SVM","SVM",86,13,2512,2252,260,1400,1266,134,0.922943352951347,0.627358490566038,1.78247209734252,294,134,160,27,1.2,35.79,9.4,0,0,0,0,0,0,0.606258842634402,238.446451976412,76.4572418076677
8.7,"random_instances_SVM","SVM",86,14,2412,2166,246,1500,1352,148,0.923657391379606,0.622641509433962,1.78575776019477,313,148,165,19,1.1,38.34,9.1,0,0,0,0,0,0,0.655258194702027,236.763397697321,80.9306921961187
8.7,"random_instances_SVM","SVM",86,15,2312,2079,233,1600,1439,161,0.924150997490049,0.627358490566038,1.79260919420411,345,161,184,32,1.1,40.9,8.9,0,0,0,0,0,0,0.684443832280776,232.745265886073,82.4391238011019
8.7,"random_instances_SVM","SVM",86,16,2212,1984,228,1700,1534,166,0.924878559373379,0.632075471698113,1.79260919420411,351,166,185,6,1.1,43.46,9.2,0,0,0,0,0,0,0.591335367899743,210.589088560188,77.2790525904383
8.7,"random_instances_SVM","SVM",86,17,2112,1896,216,1800,1622,178,0.926270122901162,0.627358490566038,1.79096005971082,381,178,203,30,1.1,46.01,9.1,0,0,0,0,0,0,0.579067966636003,205.076442389283,75.0201668110389
8.7,"random_instances_SVM","SVM",86,18,2012,1805,207,1900,1713,187,0.927005798857541,0.641509433962264,1.78603081184006,391,187,204,10,1.1,48.57,9.2,0,0,0,0,0,0,0.613540029141689,198.239147556885,77.6767481775669
8.7,"random_instances_SVM","SVM",86,19,1912,1719,193,2000,1799,201,0.927564317552362,0.641509433962264,1.78931395671476,422,201,221,31,1.1,51.12,9,0,0,0,0,0,0,0.581576554165428,186.471077623647,76.902367026002
8.7,"random_instances_SVM","SVM",86,20,1812,1629,183,2100,1889,211,0.928896377877795,0.64622641509434,1.7876708768647,436,211,225,14,1.1,53.68,9,0,0,0,0,0,0,0.548482228120934,175.14991997277,72.2714656660826
8.7,"random_instances_SVM","SVM",86,21,1712,1541,171,2200,1977,223,0.93091678206682,0.641509433962264,1.78247209734252,463,223,240,27,1.1,56.24,8.9,0,0,0,0,0,0,0.627223805753463,175.540941149715,79.9703754634784
8.7,"random_instances_SVM","SVM",86,22,1612,1450,162,2300,2068,232,0.9295860740869,0.650943396226415,1.7791985030407,480,232,248,17,1.1,58.79,8.9,0,0,0,0,0,0,0.616921372645427,165.530645498,79.6283844503814
8.7,"random_instances_SVM","SVM",86,23,1512,1358,154,2400,2160,240,0.930005301194394,0.64622641509434,1.77756621083607,497,240,257,17,1.1,61.35,9,0,0,0,0,0,0,0.556290328609499,153.510694980307,74.3072377697505
8.7,"random_instances_SVM","SVM",86,24,1412,1273,139,2500,2245,255,0.933237406958632,0.641509433962264,1.78411341603252,526,255,271,29,1.1,63.91,8.8,0,0,0,0,0,0,0.584588714556965,149.359322380223,78.6514851347225
8.7,"random_instances_SVM","SVM",86,25,1312,1183,129,2600,2335,265,0.933221178812534,0.650943396226415,1.7791985030407,549,265,284,23,1.1,66.46,8.8,0,0,0,0,0,0,0.544541434717027,135.628891143407,74.3739890428454
8.7,"random_instances_SVM","SVM",86,26,1212,1091,121,2700,2427,273,0.933683680976289,0.650943396226415,1.79096005971082,566,273,293,17,1.1,69.02,8.9,0,0,0,0,0,0,0.546267510678475,129.539929980383,75.386572818032
8.7,"random_instances_SVM","SVM",86,27,1112,998,114,2800,2520,280,0.933364527436389,0.64622641509434,1.7876708768647,575,280,295,9,1.1,71.57,9,0,0,0,0,0,0,0.485235686652618,115.966606227035,69.0989732032133
8.7,"random_instances_SVM","SVM",86,28,1012,910,102,2900,2608,292,0.933099467716811,0.64622641509434,1.7811286229695,601,291,310,26,1.1,74.13,8.9,0,0,0,0,0,0,0.409815690865312,109.179021220023,70.0724854070784
8.7,"random_instances_SVM","SVM",86,29,912,820,92,3000,2698,302,0.933202245975423,0.641509433962264,1.78083379578246,619,301,318,18,1.1,76.69,8.9,0,0,0,0,0,0,0.387155145309317,99.1941159669529,69.1840356285441
8.7,"random_instances_SVM","SVM",86,30,812,730,82,3100,2788,312,0.933365879781897,0.632075471698113,1.78411341603252,631,309,322,12,1,79.24,8.9,0,0,0,0,0,0,0.283390902323363,85.2895526545555,61.8376991973791
8.7,"random_instances_SVM","SVM",86,31,712,641,71,3200,2877,323,0.934143478449025,0.632075471698113,1.78247209734252,652,318,334,21,1.1,81.8,8.9,0,0,0,0,0,0,0.237304211025637,73.4639171954834,56.665555376879
8.7,"random_instances_SVM","SVM",86,32,612,551,61,3300,2967,333,0.934752033927647,0.627358490566038,1.78247209734252,668,327,341,16,1,84.36,8.9,0,0,0,0,0,0,0.168236905526856,66.4170608253442,53.8378176518453
8.7,"random_instances_SVM","SVM",86,33,512,459,53,3400,3059,341,0.934743919854599,0.632075471698113,1.79426136857665,684,335,349,16,1,86.91,9,0,0,0,0,0,0,0.132510037148977,57.3581946129603,48.3560107735404
8.7,"random_instances_SVM","SVM",86,34,412,369,43,3500,3149,351,0.933284739051414,0.632075471698113,1.79779411764706,706,345,361,22,1,89.47,9,0,0,0,0,0,0,0.0773160198707923,44.2429816680914,38.9499610152454
8.7,"random_instances_SVM","SVM",86,35,312,279,33,3600,3239,361,0.932864159598411,0.632075471698113,1.79096005971082,723,356,367,17,1,92.02,9,0,0,0,0,0,0,0.0479376741735453,33.4122514134287,30.4775663646368
8.7,"random_instances_SVM","SVM",86,36,212,190,22,3700,3328,372,0.934435585078764,0.632075471698113,1.78603081184006,747,366,381,24,1,94.58,8.9,0,0,0,0,0,0,0.0268151253813358,23.2631989215947,22.4778332568896
8.7,"random_instances_SVM","SVM",86,37,112,100,12,3800,3418,382,0.934075861173623,0.632075471698113,1.78931395671476,768,374,394,21,1.1,97.14,8.9,0,0,0,0,0,0,0.00171597478234025,13.3990321482886,13.3880254875986
8.7,"random_instances_SVM","SVM",86,38,12,12,0,3900,3506,394,0.934643846287003,0.636792452830189,1.79779411764706,794,386,408,26,1.1,99.69,8.9,0,0,0,0,0,0,0.000688654366767665,0.294827000364257,0.294827000364257
8.7,"random_instances_SVM","SVM",86,39,0,0,0,3912,3518,394,0.934171877704694,0.636792452830189,1.79779411764706,794,386,408,0,1.1,100,8.9,0,0,0,0,0,0,0,0,0
8.7,"random_instances_SVM","SVM",87,0,3812,3420,392,100,95,5,0.896678653494822,0.588516746411483,1.74238528873503,16,5,11,0,2.2,2.56,19,0,0,0,0,0,0,0.128770065758169,195.602620113957,14.091553165633
8.7,"random_instances_SVM","SVM",87,1,3712,3336,376,200,179,21,0.917950937081476,0.583732057416268,1.76873710548264,47,21,26,31,1.2,5.11,8.5,0,0,0,0,0,0,0.544191930089902,337.836150314162,60.3013194562628
8.7,"random_instances_SVM","SVM",87,2,3612,3244,368,300,271,29,0.919410719127523,0.578947368421053,1.78222842378171,61,29,32,14,1.1,7.67,9.3,0,0,0,0,0,0,0.789384046027962,393.070665949214,84.692721242046
8.7,"random_instances_SVM","SVM",87,3,3512,3151,361,400,364,36,0.884007581006934,0.569377990430622,1.73216315525126,82,36,46,21,1.3,10.22,10.1,0,0,0,0,0,0,0.7265584773494,355.379585259275,81.7340131265244
8.7,"random_instances_SVM","SVM",87,4,3412,3059,353,500,456,44,0.893578328398916,0.578947368421053,1.75801633667292,99,44,55,17,1.2,12.78,10.4,0,0,0,0,0,0,0.447004961366644,285.716315893795,54.5239317442598
8.7,"random_instances_SVM","SVM",87,5,3312,2966,346,600,549,51,0.900648548571298,0.569377990430622,1.74297879812124,115,51,64,16,1.3,15.34,10.8,0,0,0,0,0,0,0.700818799805888,308.93567284707,81.1498941657541
8.7,"random_instances_SVM","SVM",87,6,3212,2877,335,700,638,62,0.903183310829502,0.583732057416268,1.74939860953237,135,62,73,20,1.2,17.89,10.3,0,0,0,0,0,0,0.747840987278395,327.623261708332,84.409413254862
8.7,"random_instances_SVM","SVM",87,7,3112,2789,323,800,726,74,0.907343552720581,0.593301435406699,1.74138120068942,163,74,89,28,1.2,20.45,9.8,0,0,0,0,0,0,0.705615618167166,313.791876985286,80.2030275306279
8.7,"random_instances_SVM","SVM",87,8,3012,2699,313,900,816,84,0.922705499242719,0.588516746411483,1.77361862463301,179,84,95,16,1.1,23.01,9.7,0,0,0,0,0,0,0.744866491390084,307.41936294059,83.9119530232474
8.7,"random_instances_SVM","SVM",87,9,2912,2606,306,1000,909,91,0.918901301753105,0.602870813397129,1.77525179095403,196,91,105,17,1.2,25.56,10,0,0,0,0,0,0,0.763546562012756,294.740567241689,85.7810885607047
8.7,"random_instances_SVM","SVM",87,10,2812,2522,290,1100,993,107,0.916825289012182,0.593301435406699,1.77732320793644,225,107,118,29,1.1,28.12,9.3,0,0,0,0,0,0,0.77855483395821,292.363594465988,86.580434660807
8.7,"random_instances_SVM","SVM",87,11,2712,2432,280,1200,1083,117,0.917230631869252,0.588516746411483,1.77361862463301,245,117,128,20,1.1,30.67,9.3,0,0,0,0,0,0,0.708904127614423,267.834794739903,80.600945014076
8.7,"random_instances_SVM","SVM",87,12,2612,2341,271,1300,1174,126,0.918834201077437,0.602870813397129,1.76663406381348,264,126,138,19,1.1,33.23,9.3,0,0,0,0,0,0,0.753328425967899,272.503047061086,84.5167537520753
8.7,"random_instances_SVM","SVM",87,13,2512,2251,261,1400,1264,136,0.91807007501581,0.598086124401914,1.77525179095403,286,136,150,22,1.1,35.79,9.3,0,0,0,0,0,0,0.740259979449665,260.470743463669,84.1600165920199
8.7,"random_instances_SVM","SVM",87,14,2412,2169,243,1500,1346,154,0.924283049821566,0.61244019138756,1.7789552769979,320,154,166,34,1.1,38.34,8.7,0,0,0,0,0,0,0.760897067005895,267.376656088911,85.7683002752144
8.7,"random_instances_SVM","SVM",87,15,2312,2077,235,1600,1438,162,0.922575406096029,0.61244019138756,1.78386951809458,336,162,174,16,1.1,40.9,8.9,0,0,0,0,0,0,0.684981411274929,241.389125167429,79.9896281808301
8.7,"random_instances_SVM","SVM",87,16,2212,1990,222,1700,1525,175,0.926364540168657,0.61244019138756,1.7789552769979,365,175,190,29,1.1,43.46,8.7,0,0,0,0,0,0,0.730335378168157,243.141292970091,85.0176427257587
8.7,"random_instances_SVM","SVM",87,17,2112,1901,211,1800,1614,186,0.922921864686696,0.617224880382775,1.78059034618632,382,186,196,17,1.1,46.01,8.7,0,0,0,0,0,0,0.628373730415253,223.800858757029,74.4509497178839
8.7,"random_instances_SVM","SVM",87,18,2012,1808,204,1900,1707,193,0.928403579067876,0.607655502392344,1.79248724523514,403,193,210,21,1.1,48.57,8.8,0,0,0,0,0,0,0.697181034201498,224.063829536786,82.5251375492996
8.7,"random_instances_SVM","SVM",87,19,1912,1717,195,2000,1798,202,0.929426522021346,0.61244019138756,1.78427236326797,419,202,217,16,1.1,51.12,8.9,0,0,0,0,0,0,0.625003805032738,206.301425927793,80.503450087286
8.7,"random_instances_SVM","SVM",87,20,1812,1630,182,2100,1885,215,0.92870895561222,0.62200956937799,1.79413930721231,447,215,232,28,1.1,53.68,8.8,0,0,0,0,0,0,0.654366169304981,203.419417199975,82.113902359155
8.7,"random_instances_SVM","SVM",87,21,1712,1541,171,2200,1974,226,0.928943123276267,0.607655502392344,1.79248724523514,467,226,241,20,1.1,56.24,8.7,0,0,0,0,0,0,0.565929287203091,179.993623707563,75.0268173266678
8.7,"random_instances_SVM","SVM",87,22,1612,1452,160,2300,2063,237,0.92976887240738,0.607655502392344,1.78263841421736,491,237,254,24,1.1,58.79,8.7,0,0,0,0,0,0,0.548184383147774,170.656967105956,73.5190727975773
8.7,"random_instances_SVM","SVM",87,23,1512,1364,148,2400,2151,249,0.932302265264032,0.61244019138756,1.79083822293041,512,249,263,21,1.1,61.35,8.6,0,0,0,0,0,0,0.578030680846549,163.911875616527,77.3756557387893
8.7,"random_instances_SVM","SVM",87,24,1412,1279,133,2500,2236,264,0.935372463525988,0.607655502392344,1.78919223191669,541,264,277,29,1,63.91,8.5,0,0,0,0,0,0,0.582011731927791,156.186128460202,76.0401627380413
8.7,"random_instances_SVM","SVM",87,25,1312,1189,123,2600,2326,274,0.935821627232466,0.61244019138756,1.78427236326797,558,272,286,17,1.1,66.46,8.5,0,0,0,0,0,0,0.519838201914046,144.153971762986,72.8679074370035
8.7,"random_instances_SVM","SVM",87,26,1212,1099,113,2700,2416,284,0.936088660533574,0.61244019138756,1.79248724523514,581,281,300,23,1.1,69.02,8.5,0,0,0,0,0,0,0.517322368952243,134.28745393639,74.5934985122134
8.7,"random_instances_SVM","SVM",87,27,1112,1009,103,2800,2506,294,0.937796304259112,0.617224880382775,1.78919223191669,604,291,313,23,1.1,71.57,8.5,0,0,0,0,0,0,0.510890617719238,128.592668584129,74.2824825590081
8.7,"random_instances_SVM","SVM",87,28,1012,922,90,2900,2593,307,0.936355693834677,0.62200956937799,1.78263841421736,622,303,319,18,1.1,74.13,8.4,0,0,0,0,0,0,0.44638512730407,109.203625567211,69.4832173919548
8.7,"random_instances_SVM","SVM",87,29,912,834,78,3000,2681,319,0.93734987935572,0.617224880382775,1.79083822293041,648,314,334,26,1.1,76.69,8.4,0,0,0,0,0,0,0.400271177014561,101.564274440568,68.1463308046581
8.7,"random_instances_SVM","SVM",87,30,812,742,70,3100,2773,327,0.936695305417621,0.62200956937799,1.7855136374661,662,323,339,14,1,79.24,8.5,0,0,0,0,0,0,0.328684882129304,84.3164283571722,61.4722358432271
8.7,"random_instances_SVM","SVM",87,31,712,647,65,3200,2868,332,0.936413208699527,0.61244019138756,1.78222842378171,675,328,347,13,1.1,81.8,8.6,0,0,0,0,0,0,0.276740904442641,78.1687802554306,61.4031542720053
8.7,"random_instances_SVM","SVM",87,32,612,557,55,3300,2958,342,0.937180073564246,0.62200956937799,1.7789552769979,693,338,355,18,1.1,84.36,8.6,0,0,0,0,0,0,0.204643783639916,68.4937017125182,55.047976038197
8.7,"random_instances_SVM","SVM",87,33,512,467,45,3400,3048,352,0.93673090985777,0.62200956937799,1.78919223191669,714,347,367,21,1.1,86.91,8.7,0,0,0,0,0,0,0.0972215663169169,55.5526589200106,48.1450427644676
8.7,"random_instances_SVM","SVM",87,34,412,380,32,3500,3135,365,0.936962338718728,0.62200956937799,1.78059034618632,738,359,379,24,1.1,89.47,8.6,0,0,0,0,0,0,0.0810498987752443,44.5525003163063,38.6771824723021
8.7,"random_instances_SVM","SVM",87,35,312,289,23,3600,3226,374,0.934834288719142,0.61244019138756,1.78059034618632,754,370,384,16,1,92.02,8.6,0,0,0,0,0,0,0.0478219463853438,30.4692851489695,28.2240586206153
8.7,"random_instances_SVM","SVM",87,36,212,192,20,3700,3323,377,0.935109538429513,0.617224880382775,1.78222842378171,764,373,391,10,1,94.58,8.8,0,0,0,0,0,0,0.0173839338413651,23.1554734847392,22.6139666075594
8.7,"random_instances_SVM","SVM",87,37,112,103,9,3800,3412,388,0.936106462753644,0.61244019138756,1.78386951809458,783,384,399,19,1,97.14,8.8,0,0,0,0,0,0,0.00193958271043355,10.7766678746768,10.7640124398226
8.7,"random_instances_SVM","SVM",87,38,12,11,1,3900,3504,396,0.936370757251664,0.607655502392344,1.79248724523514,792,389,403,9,1,99.69,8.8,0,0,0,0,0,0,0.000202065641071238,1.10355254615985,1.10355254615985
8.7,"random_instances_SVM","SVM",87,39,0,0,0,3912,3515,397,0.936276268545117,0.607655502392344,1.7875492638433,797,391,406,5,1,100,8.9,0,0,0,0,0,0,0,0,0
8.7,"random_instances_SVM","SVM",88,0,3812,3429,383,100,91,9,0.900755925619939,0.55607476635514,1.76257047964779,23,9,14,0,1.6,2.56,10.1,0,0,0,0,0,0,0.774152685767712,428.440260940733,83.6226134156794
8.7,"random_instances_SVM","SVM",88,1,3712,3344,368,200,176,24,0.912034453898728,0.570093457943925,1.7609534425105,50,24,26,27,1.1,5.11,7.3,0,0,0,0,0,0,0.735178599962196,381.752318653097,79.6976241486658
8.7,"random_instances_SVM","SVM",88,2,3612,3253,359,300,267,33,0.912709100078325,0.565420560747664,1.77259139637163,70,33,37,20,1.1,7.67,8.1,0,0,0,0,0,0,0.605319715660245,341.306504131741,66.5732080620723
8.7,"random_instances_SVM","SVM",88,3,3512,3163,349,400,357,43,0.91323218558537,0.58411214953271,1.77749257073948,90,43,47,20,1.1,10.22,8.3,0,0,0,0,0,0,0.830589065844626,365.856617513374,88.4166621412586
8.7,"random_instances_SVM","SVM",88,4,3412,3071,341,500,449,51,0.913025633872329,0.588785046728972,1.76581347961035,108,51,57,18,1.1,12.78,8.8,0,0,0,0,0,0,0.754380344626147,330.894516224843,81.8186925820182
8.7,"random_instances_SVM","SVM",88,5,3312,2979,333,600,541,59,0.918457675676245,0.602803738317757,1.75578958218802,131,59,72,23,1.2,15.34,9.2,0,0,0,0,0,0,0.617353265041656,319.747154425138,69.9431535864294
8.7,"random_instances_SVM","SVM",88,6,3212,2889,323,700,631,69,0.916765024625256,0.607476635514019,1.74418245734374,151,69,82,20,1.2,17.89,9.1,0,0,0,0,0,0,0.753636505750289,314.458894439447,82.5953439795777
8.7,"random_instances_SVM","SVM",88,7,3112,2799,313,800,721,79,0.918149189351592,0.607476635514019,1.75902308049775,170,79,91,19,1.2,20.45,9.1,0,0,0,0,0,0,0.711580709155138,303.208661274573,78.9410591155854
8.7,"random_instances_SVM","SVM",88,8,3012,2712,300,900,808,92,0.916675161217634,0.607476635514019,1.7609534425105,192,92,100,22,1.1,23.01,8.8,0,0,0,0,0,0,0.770200599604714,300.935228220919,84.68525124824
8.7,"random_instances_SVM","SVM",88,9,2912,2620,292,1000,900,100,0.920225436441084,0.616822429906542,1.77422211522754,215,100,115,23,1.1,25.56,9,0,0,0,0,0,0,0.679590725699495,260.202462415047,78.455063287329
8.7,"random_instances_SVM","SVM",88,10,2812,2528,284,1100,992,108,0.915764455937414,0.621495327102804,1.76581347961035,230,108,122,15,1.1,28.12,9.2,0,0,0,0,0,0,0.725576476381289,260.921595471559,82.6846095207264
8.7,"random_instances_SVM","SVM",88,11,2712,2436,276,1200,1084,116,0.918911016449028,0.626168224299065,1.77749257073948,249,116,133,19,1.1,30.67,9.3,0,0,0,0,0,0,0.715797850626188,261.343330679548,81.1646947281498
8.7,"random_instances_SVM","SVM",88,12,2612,2343,269,1300,1177,123,0.915828835692124,0.607476635514019,1.76581347961035,262,123,139,13,1.1,33.23,9.6,0,0,0,0,0,0,0.70551829354819,240.190519404808,81.1059784571626
8.7,"random_instances_SVM","SVM",88,13,2512,2249,263,1400,1271,129,0.919439466935619,0.61214953271028,1.75902308049775,274,129,145,12,1.1,35.79,9.9,0,0,0,0,0,0,0.665684016534216,225.284351190746,78.3833906307383
8.7,"random_instances_SVM","SVM",88,14,2412,2160,252,1500,1360,140,0.919367039711568,0.621495327102804,1.74578409412734,301,140,161,27,1.1,38.34,9.7,0,0,0,0,0,0,0.725916167217785,219.976505838075,83.7211623949375
8.7,"random_instances_SVM","SVM",88,15,2312,2070,242,1600,1450,150,0.917572454048932,0.616822429906542,1.74379602911409,311,150,161,10,1.1,40.9,9.7,0,0,0,0,0,0,0.669757366791379,205.945452258418,81.2408253044744
8.7,"random_instances_SVM","SVM",88,16,2212,1979,233,1700,1541,159,0.917309570050522,0.61214953271028,1.75578958218802,339,159,180,28,1.1,43.46,9.7,0,0,0,0,0,0,0.66413006223172,200.25677282385,80.2368330479298
8.7,"random_instances_SVM","SVM",88,17,2112,1895,217,1800,1625,175,0.918767503245796,0.61214953271028,1.75060670212217,364,175,189,25,1.1,46.01,9.3,0,0,0,0,0,0,0.653997510364282,198.318496307214,80.1977123701089
8.7,"random_instances_SVM","SVM",88,18,2012,1805,207,1900,1715,185,0.920778029335695,0.621495327102804,1.75417728688757,390,185,205,26,1.1,48.57,9.3,0,0,0,0,0,0,0.666742982210173,194.549219635367,82.3470789142676
8.7,"random_instances_SVM","SVM",88,19,1912,1718,194,2000,1802,198,0.925574321061823,0.626168224299065,1.77096367240802,418,198,220,28,1.1,51.12,9.1,0,0,0,0,0,0,0.658609793266828,193.003413013338,81.147540908331
8.7,"random_instances_SVM","SVM",88,20,1812,1629,183,2100,1891,209,0.925983400753224,0.621495327102804,1.76933893509389,437,209,228,19,1.1,53.68,9,0,0,0,0,0,0,0.578269187838347,175.79999917937,74.5278126130967
8.7,"random_instances_SVM","SVM",88,21,1712,1538,174,2200,1982,218,0.926637928259478,0.616822429906542,1.76933893509389,454,218,236,17,1.1,56.24,9.1,0,0,0,0,0,0,0.676449378740295,172.648626838063,82.7186151930262
8.7,"random_instances_SVM","SVM",88,22,1612,1445,167,2300,2075,225,0.925228279880237,0.616822429906542,1.77096367240802,472,225,247,18,1.1,58.79,9.2,0,0,0,0,0,0,0.666736515056859,166.272338990833,83.0481471036073
8.7,"random_instances_SVM","SVM",88,23,1512,1352,160,2400,2168,232,0.925595780980054,0.621495327102804,1.76581347961035,483,232,251,11,1.1,61.35,9.3,0,0,0,0,0,0,0.590111017495486,155.927866511061,78.3683938568968
8.7,"random_instances_SVM","SVM",88,24,1412,1265,147,2500,2255,245,0.925327532002085,0.621495327102804,1.77749257073948,509,245,264,26,1.1,63.91,9.2,0,0,0,0,0,0,0.549072502539319,144.376687181756,77.3632352503258
8.7,"random_instances_SVM","SVM",88,25,1312,1174,138,2600,2346,254,0.926035709303932,0.626168224299065,1.77749257073948,525,254,271,16,1.1,66.46,9.2,0,0,0,0,0,0,0.542498353055379,132.318666215312,78.3995894560748
8.7,"random_instances_SVM","SVM",88,26,1212,1083,129,2700,2437,263,0.926840456237844,0.630841121495327,1.77422211522754,548,263,285,23,1.1,69.02,9.3,0,0,0,0,0,0,0.476461774232788,121.989453583413,74.6934900152403
8.7,"random_instances_SVM","SVM",88,27,1112,991,121,2800,2529,271,0.926499780035822,0.635514018691589,1.77422211522754,562,271,291,14,1.1,71.57,9.3,0,0,0,0,0,0,0.430209847649664,110.645763898189,71.4573523557134
8.7,"random_instances_SVM","SVM",88,28,1012,904,108,2900,2616,284,0.926180563752033,0.630841121495327,1.77585583724893,590,284,306,28,1.1,74.13,9.2,0,0,0,0,0,0,0.38013040708666,101.567372289448,73.3823596970144
8.7,"random_instances_SVM","SVM",88,29,912,813,99,3000,2707,293,0.925772825305519,0.626168224299065,1.77749257073948,601,293,308,11,1.1,76.69,9.2,0,0,0,0,0,0,0.307215228158356,91.8436474098088,69.4958093690612
8.7,"random_instances_SVM","SVM",88,30,812,720,92,3100,2800,300,0.92723209974568,0.626168224299065,1.77749257073948,616,300,316,15,1.1,79.24,9.3,0,0,0,0,0,0,0.230682455946723,81.4118824143825,65.6295599320978
8.7,"random_instances_SVM","SVM",88,31,712,630,82,3200,2890,310,0.929387480283684,0.607476635514019,1.78427221562452,633,310,323,17,1,81.8,9.3,0,0,0,0,0,0,0.190079060124301,74.2635072012229,61.6558625662711
8.7,"random_instances_SVM","SVM",88,32,612,540,72,3300,2980,320,0.929769735077292,0.61214953271028,1.78263075084473,658,320,338,25,1.1,84.36,9.3,0,0,0,0,0,0,0.151225653105082,64.9171394656034,54.4748985254678
8.7,"random_instances_SVM","SVM",88,33,512,451,61,3400,3069,331,0.928299730678008,0.61214953271028,1.77935686516825,673,331,342,15,1,86.91,9.3,0,0,0,0,0,0,0.0804412532972683,53.9572619698012,48.0878633429668
8.7,"random_instances_SVM","SVM",88,34,412,360,52,3500,3160,340,0.928291683208669,0.616822429906542,1.78427221562452,692,338,354,19,1,89.47,9.3,0,0,0,0,0,0,0.0640277356716245,45.3340585571929,41.4432608788321
8.7,"random_instances_SVM","SVM",88,35,312,274,38,3600,3246,354,0.929015955449193,0.621495327102804,1.78591670614583,724,352,372,32,1.1,92.02,9.2,0,0,0,0,0,0,0.0339092765170463,35.4179165605246,34.0293131619118
8.7,"random_instances_SVM","SVM",88,36,212,189,23,3700,3331,369,0.929015955449193,0.61214953271028,1.78263075084473,744,363,381,20,1,94.58,9,0,0,0,0,0,0,0.0113249002643499,22.142478422122,21.8012815171041
8.7,"random_instances_SVM","SVM",88,37,112,98,14,3800,3422,378,0.929889105872487,0.616822429906542,1.77772442767727,764,374,390,20,1,97.14,9.1,0,0,0,0,0,0,0.000630227676149089,11.5059658877422,11.5024430030773
8.7,"random_instances_SVM","SVM",88,38,12,9,3,3900,3511,389,0.929938731933412,0.616822429906542,1.77935686516825,785,382,403,21,1.1,99.69,9,0,0,0,0,0,0,0.000655073506450763,2.09435396562502,2.09435396562502
8.7,"random_instances_SVM","SVM",88,39,0,0,0,3912,3520,392,0.92969462536346,0.616822429906542,1.78591670614583,786,385,401,1,1,100,9,0,0,0,0,0,0,0,0,0
8.7,"random_instances_SVM","SVM",89,0,3812,3420,392,100,89,11,0.899862024003912,0.561576354679803,1.75190326914465,25,11,14,0,1.3,2.56,8.1,0,0,0,0,0,0,0.618790290149721,368.789342326373,67.1140582184195
8.7,"random_instances_SVM","SVM",89,1,3712,3336,376,200,173,27,0.903565738115386,0.566502463054187,1.74305527283584,57,27,30,32,1.1,5.11,6.4,0,0,0,0,0,0,0.851587826298031,455.945131165167,89.3885717509031
8.7,"random_instances_SVM","SVM",89,2,3612,3245,367,300,264,36,0.906625938925258,0.576354679802956,1.74948128305827,77,36,41,20,1.1,7.67,7.3,0,0,0,0,0,0,0.840584325419098,483.292226742674,87.7978960377041
8.7,"random_instances_SVM","SVM",89,3,3512,3155,357,400,354,46,0.915199559376055,0.596059113300493,1.75351347435526,98,46,52,21,1.1,10.22,7.7,0,0,0,0,0,0,0.830584184683002,446.783519819516,87.0679437460728
8.7,"random_instances_SVM","SVM",89,4,3412,3066,346,500,443,57,0.910360564156042,0.591133004926108,1.74305527283584,124,57,67,26,1.2,12.78,7.8,0,0,0,0,0,0,0.778553230588938,417.077595018085,83.1577858912496
8.7,"random_instances_SVM","SVM",89,5,3312,2975,337,600,534,66,0.913077932551958,0.586206896551724,1.75351347435526,140,66,74,16,1.1,15.34,8.1,0,0,0,0,0,0,0.71683339747586,376.807963781032,78.1316345138028
8.7,"random_instances_SVM","SVM",89,6,3212,2887,325,700,622,78,0.917079517449334,0.586206896551724,1.75351347435526,162,78,84,22,1.1,17.89,8,0,0,0,0,0,0,0.808557741397622,393.438344103044,85.5827764995071
8.7,"random_instances_SVM","SVM",89,7,3112,2798,314,800,711,89,0.915000042151541,0.591133004926108,1.74869171411414,186,89,97,24,1.1,20.45,8,0,0,0,0,0,0,0.831126427155072,381.130399215637,88.1600263309484
8.7,"random_instances_SVM","SVM",89,8,3012,2706,306,900,803,97,0.917051416431804,0.610837438423645,1.75512664222495,207,97,110,21,1.1,23.01,8.3,0,0,0,0,0,0,0.822616336558365,377.705566867844,86.9837541312625
8.7,"random_instances_SVM","SVM",89,9,2912,2614,298,1000,895,105,0.923747888911062,0.61576354679803,1.75752349044805,219,105,114,12,1.1,25.56,8.5,0,0,0,0,0,0,0.731992893821179,330.807869474103,80.4915373209728
8.7,"random_instances_SVM","SVM",89,10,2812,2522,290,1100,987,113,0.924885980121341,0.640394088669951,1.76236960301362,235,113,122,16,1.1,28.12,8.7,0,0,0,0,0,0,0.773673449225701,320.176304271399,84.6529236475261
8.7,"random_instances_SVM","SVM",89,11,2712,2434,278,1200,1075,125,0.926965455419141,0.625615763546798,1.76236960301362,258,125,133,23,1.1,30.67,8.6,0,0,0,0,0,0,0.747582823863778,319.949648667894,82.3322492069299
8.7,"random_instances_SVM","SVM",89,12,2612,2342,270,1300,1167,133,0.92640905527189,0.620689655172414,1.76635526678196,275,133,142,17,1.1,33.23,8.8,0,0,0,0,0,0,0.770564407463114,305.939350336468,84.9191965933301
8.7,"random_instances_SVM","SVM",89,13,2512,2256,256,1400,1253,147,0.924770765949434,0.61576354679803,1.76959926176227,306,147,159,31,1.1,35.79,8.5,0,0,0,0,0,0,0.747980862436219,282.960630018506,84.2517440429865
8.7,"random_instances_SVM","SVM",89,14,2412,2160,252,1500,1349,151,0.923690281825108,0.630541871921182,1.74071410592931,319,151,168,13,1.1,38.34,8.9,0,0,0,0,0,0,0.712817291789449,263.162677408611,82.556389442795
8.7,"random_instances_SVM","SVM",89,15,2312,2069,243,1600,1440,160,0.923327778698868,0.630541871921182,1.75029601843901,337,160,177,18,1.1,40.9,9,0,0,0,0,0,0,0.624392364281451,237.840901718363,75.6101493380707
8.7,"random_instances_SVM","SVM",89,16,2212,1976,236,1700,1533,167,0.921891816702693,0.630541871921182,1.75029601843901,352,167,185,15,1.1,43.46,9.2,0,0,0,0,0,0,0.730368424754312,242.956728077486,84.8788540254022
8.7,"random_instances_SVM","SVM",89,17,2112,1883,229,1800,1626,174,0.921020685159026,0.630541871921182,1.75351347435526,367,174,193,15,1.1,46.01,9.3,0,0,0,0,0,0,0.689305015282416,233.943819737479,83.3197648492502
8.7,"random_instances_SVM","SVM",89,18,2012,1794,218,1900,1715,185,0.920953242716936,0.625615763546798,1.75029601843901,391,185,206,24,1.1,48.57,9.3,0,0,0,0,0,0,0.697810890857834,221.740487735883,83.8048490657412
8.7,"random_instances_SVM","SVM",89,19,1912,1709,203,2000,1800,200,0.922623848209562,0.625615763546798,1.75674278093787,423,200,223,32,1.1,51.12,9,0,0,0,0,0,0,0.611452691749966,205.355092874985,75.6469961508467
8.7,"random_instances_SVM","SVM",89,20,1812,1617,195,2100,1892,208,0.923278601918185,0.630541871921182,1.75512664222495,435,208,227,12,1.1,53.68,9.1,0,0,0,0,0,0,0.668467225242059,193.596229301398,83.077071910605
8.7,"random_instances_SVM","SVM",89,21,1712,1527,185,2200,1982,218,0.92393195057593,0.630541871921182,1.75674278093787,452,218,234,17,1.1,56.24,9.1,0,0,0,0,0,0,0.642001792768038,177.663913179674,79.7606267464063
8.7,"random_instances_SVM","SVM",89,22,1612,1434,178,2300,2075,225,0.925252698400217,0.630541871921182,1.75351347435526,467,225,242,15,1.1,58.79,9.2,0,0,0,0,0,0,0.641791427918507,178.968808146421,79.8737632360007
8.7,"random_instances_SVM","SVM",89,23,1512,1350,162,2400,2159,241,0.925640492442236,0.645320197044335,1.75351347435526,494,241,253,27,1,61.35,9,0,0,0,0,0,0,0.654166191118591,167.094411023328,80.9258884107429
8.7,"random_instances_SVM","SVM",89,24,1412,1261,151,2500,2248,252,0.924338010279366,0.630541871921182,1.75190326914465,518,252,266,24,1.1,63.91,8.9,0,0,0,0,0,0,0.548885854275908,147.365397459854,74.8181384203329
8.7,"random_instances_SVM","SVM",89,25,1312,1178,134,2600,2331,269,0.925655948001881,0.645320197044335,1.75674278093787,552,267,285,34,1.1,66.46,8.7,0,0,0,0,0,0,0.546432060694832,134.177668692288,76.3393797542269
8.7,"random_instances_SVM","SVM",89,26,1212,1089,123,2700,2420,280,0.926070438010563,0.650246305418719,1.75351347435526,565,278,287,13,1,69.02,8.6,0,0,0,0,0,0,0.51299345899927,122.823047712153,72.5014732149049
8.7,"random_instances_SVM","SVM",89,27,1112,999,113,2800,2510,290,0.926351448185941,0.645320197044335,1.75674278093787,585,287,298,20,1,71.57,8.7,0,0,0,0,0,0,0.452805589045505,114.233136665747,69.8389755341464
8.7,"random_instances_SVM","SVM",89,28,1012,909,103,2900,2600,300,0.92698512613143,0.640394088669951,1.75190326914465,602,295,307,17,1,74.13,8.7,0,0,0,0,0,0,0.396735798291561,103.002755152136,67.3078367457707
8.7,"random_instances_SVM","SVM",89,29,912,820,92,3000,2689,311,0.929157334787098,0.640394088669951,1.75512664222495,627,306,321,25,1,76.69,8.6,0,0,0,0,0,0,0.3668460727758,93.2225919821331,64.5783110154996
8.7,"random_instances_SVM","SVM",89,30,812,729,83,3100,2780,320,0.926459637103469,0.640394088669951,1.75674278093787,647,316,331,20,1,79.24,8.7,0,0,0,0,0,0,0.334565298907412,89.1790377306871,65.8130340696103
8.7,"random_instances_SVM","SVM",89,31,712,635,77,3200,2874,326,0.927395400987471,0.645320197044335,1.75836189870832,664,325,339,17,1,81.8,8.8,0,0,0,0,0,0,0.270685862999152,79.6949212689978,61.7624992290323
8.7,"random_instances_SVM","SVM",89,32,612,546,66,3300,2963,337,0.927089099896308,0.645320197044335,1.75512664222495,686,336,350,22,1,84.36,8.8,0,0,0,0,0,0,0.207492950087909,72.3098930415771,59.2800471748204
8.7,"random_instances_SVM","SVM",89,33,512,453,59,3400,3056,344,0.926765938194617,0.640394088669951,1.75351347435526,704,342,362,18,1.1,86.91,8.9,0,0,0,0,0,0,0.156967054517066,64.4069975215619,55.7365733653168
8.7,"random_instances_SVM","SVM",89,34,412,361,51,3500,3148,352,0.927184643355933,0.635467980295567,1.75674278093787,722,351,371,18,1.1,89.47,8.9,0,0,0,0,0,0,0.0760022627727842,51.6090496004816,47.1897521939842
8.7,"random_instances_SVM","SVM",89,35,312,272,40,3600,3237,363,0.927322338341868,0.630541871921182,1.75351347435526,746,362,384,24,1.1,92.02,8.9,0,0,0,0,0,0,0.0601057677140911,40.4050661998883,37.9754031478883
8.7,"random_instances_SVM","SVM",89,36,212,187,25,3700,3322,378,0.928924096341538,0.635467980295567,1.75512664222495,767,375,392,21,1,94.58,8.8,0,0,0,0,0,0,0.0155804121967742,27.0665392559034,26.704445940981
8.7,"random_instances_SVM","SVM",89,37,112,95,17,3800,3414,386,0.928853843797697,0.635467980295567,1.74869171411414,781,382,399,14,1,97.14,8.8,0,0,0,0,0,0,0.000442438195797386,14.9046932602365,14.902979462106
8.7,"random_instances_SVM","SVM",89,38,12,10,2,3900,3499,401,0.929547938930881,0.640394088669951,1.75351347435526,804,393,411,23,1,99.69,8.7,0,0,0,0,0,0,0.000678336712078604,1.59332607453939,1.59332607453939
8.7,"random_instances_SVM","SVM",89,39,0,0,0,3912,3509,403,0.929761506664169,0.645320197044335,1.74709034807557,808,393,415,4,1.1,100,8.7,0,0,0,0,0,0,0,0,0
8.7,"random_instances_SVM","SVM",90,0,3812,3389,423,100,92,8,0.851996470682594,0.434285714285714,1.67914680710994,30,8,22,0,2.8,2.56,11.5,0,0,0,0,0,0,0.123317696028822,317.096119108566,13.8259288988648
8.7,"random_instances_SVM","SVM",90,1,3712,3305,407,200,176,24,0.916384053902294,0.491428571428571,1.78752100840336,57,24,33,27,1.4,5.11,7.3,0,0,0,0,0,0,0.439739959256383,353.893401325227,52.3215164596213
8.7,"random_instances_SVM","SVM",90,2,3612,3212,400,300,269,31,0.914664313788409,0.502857142857143,1.77561589925226,75,31,44,18,1.4,7.67,8.7,0,0,0,0,0,0,0.453412721833732,336.668203959695,52.3575431686705
8.7,"random_instances_SVM","SVM",90,3,3512,3121,391,400,360,40,0.92355498516082,0.542857142857143,1.79246346280448,91,40,51,16,1.3,10.22,9,0,0,0,0,0,0,0.364137796043426,295.17773788366,41.3301034476934
8.7,"random_instances_SVM","SVM",90,4,3412,3033,379,500,448,52,0.924541589797062,0.531428571428571,1.80110497237569,111,52,59,20,1.1,12.78,8.6,0,0,0,0,0,0,0.526006598912884,341.068514895982,57.8260900917555
8.7,"random_instances_SVM","SVM",90,5,3312,2945,367,600,536,64,0.930061763054458,0.531428571428571,1.78424115334207,141,64,77,30,1.2,15.34,8.4,0,0,0,0,0,0,0.645912638157111,356.271319768674,71.4136051687301
8.7,"random_instances_SVM","SVM",90,6,3212,2854,358,700,627,73,0.925743161947547,0.52,1.78752100840336,160,73,87,19,1.2,17.89,8.6,0,0,0,0,0,0,0.608408533554174,342.794420123279,69.4233622110949
8.7,"random_instances_SVM","SVM",90,7,3112,2767,345,800,714,86,0.926280580733131,0.531428571428571,1.78752100840336,184,86,98,24,1.1,20.45,8.3,0,0,0,0,0,0,0.686093962892772,338.42967839673,78.2264987106186
8.7,"random_instances_SVM","SVM",90,8,3012,2674,338,900,807,93,0.925226598219298,0.537142857142857,1.78587957497048,200,93,107,16,1.2,23.01,8.7,0,0,0,0,0,0,0.672232907565333,309.478269601442,76.288796605422
8.7,"random_instances_SVM","SVM",90,9,2912,2588,324,1000,893,107,0.930145183283864,0.571428571428571,1.78260573523635,225,107,118,25,1.1,25.56,8.3,0,0,0,0,0,0,0.783301581617708,320.746876840937,85.3096140477374
8.7,"random_instances_SVM","SVM",90,10,2812,2496,316,1100,985,115,0.927368252185774,0.565714285714286,1.78752100840336,241,115,126,16,1.1,28.12,8.6,0,0,0,0,0,0,0.790251900425053,311.393674486911,86.3618697917914
8.7,"random_instances_SVM","SVM",90,11,2712,2405,307,1200,1076,124,0.924469399213934,0.565714285714286,1.76860034170062,261,124,137,20,1.1,30.67,8.7,0,0,0,0,0,0,0.675067641425785,276.08804974408,76.9892347453072
8.7,"random_instances_SVM","SVM",90,12,2612,2314,298,1300,1167,133,0.92510628058074,0.577142857142857,1.78052091554854,278,133,145,17,1.1,33.23,8.8,0,0,0,0,0,0,0.72747868425646,279.816984924124,81.9417671118646
8.7,"random_instances_SVM","SVM",90,13,2512,2227,285,1400,1254,146,0.92641373225315,0.582857142857143,1.77236087468901,300,145,155,22,1.1,35.79,8.6,0,0,0,0,0,0,0.723224413481406,262.625025319526,82.607427580817
8.7,"random_instances_SVM","SVM",90,14,2412,2140,272,1500,1341,159,0.927239913371307,0.588571428571429,1.78052091554854,326,159,167,26,1.1,38.34,8.4,0,0,0,0,0,0,0.737174806112605,267.827369404557,83.2232418021496
8.7,"random_instances_SVM","SVM",90,15,2312,2050,262,1600,1431,169,0.922666238870632,0.56,1.77724789915966,351,169,182,25,1.1,40.9,8.5,0,0,0,0,0,0,0.706995073933133,246.944785640852,81.5185421366362
8.7,"random_instances_SVM","SVM",90,16,2212,1959,253,1700,1522,178,0.921334723670495,0.571428571428571,1.76697478991597,368,178,190,17,1.1,43.46,8.6,0,0,0,0,0,0,0.69314533122399,240.076510840501,81.8669821735107
8.7,"random_instances_SVM","SVM",90,17,2112,1873,239,1800,1608,192,0.920794096414541,0.571428571428571,1.77724789915966,399,190,209,31,1.1,46.01,8.4,0,0,0,0,0,0,0.655777475836542,227.756266759791,79.6850088831001
8.7,"random_instances_SVM","SVM",90,18,2012,1782,230,1900,1699,201,0.922650196518819,0.588571428571429,1.77888290182678,414,199,215,15,1.1,48.57,8.5,0,0,0,0,0,0,0.680028873929971,220.588068779604,81.6855914305877
8.7,"random_instances_SVM","SVM",90,19,1912,1698,214,2000,1783,217,0.929179433704991,0.6,1.77236087468901,437,213,224,23,1.1,51.12,8.2,0,0,0,0,0,0,0.673325692747315,209.584421213593,80.112546733573
8.7,"random_instances_SVM","SVM",90,20,1812,1611,201,2100,1870,230,0.931617871179913,0.588571428571429,1.78052091554854,462,225,237,25,1.1,53.68,8.1,0,0,0,0,0,0,0.674030633082685,201.69042515923,80.889798267531
8.7,"random_instances_SVM","SVM",90,21,1712,1521,191,2200,1960,240,0.932496992059034,0.594285714285714,1.78916546195295,478,233,245,16,1.1,56.24,8.2,0,0,0,0,0,0,0.64447679508383,185.833628728127,78.3947353266911
8.7,"random_instances_SVM","SVM",90,22,1612,1435,177,2300,2046,254,0.932368653244559,0.588571428571429,1.78752100840336,505,246,259,27,1.1,58.79,8.1,0,0,0,0,0,0,0.627583355269795,177.173596110042,77.5841623022621
8.7,"random_instances_SVM","SVM",90,23,1512,1351,161,2400,2130,270,0.93532846715328,0.588571428571429,1.78424115334207,532,262,270,27,1,61.35,7.9,0,0,0,0,0,0,0.56992014791206,168.782449527403,74.0152455119039
8.7,"random_instances_SVM","SVM",90,24,1412,1262,150,2500,2219,281,0.934264859228359,0.577142857142857,1.79246346280448,552,271,281,20,1,63.91,7.9,0,0,0,0,0,0,0.564811794308009,159.490976504408,74.9373909619037
8.7,"random_instances_SVM","SVM",90,25,1312,1180,132,2600,2301,299,0.935309216331113,0.571428571428571,1.78424115334207,581,286,295,29,1,66.46,7.7,0,0,0,0,0,0,0.558456760378502,149.153499966142,73.6314964088414
8.7,"random_instances_SVM","SVM",90,26,1212,1093,119,2700,2388,312,0.934877677067456,0.571428571428571,1.78587957497048,603,297,306,22,1,69.02,7.7,0,0,0,0,0,0,0.500939353660136,134.390435388164,70.4467644357312
8.7,"random_instances_SVM","SVM",90,27,1112,1004,108,2800,2477,323,0.934345070987402,0.577142857142857,1.78587957497048,625,309,316,22,1,71.57,7.7,0,0,0,0,0,0,0.472618927513459,120.651455137932,69.0195506265826
8.7,"random_instances_SVM","SVM",90,28,1012,920,92,2900,2561,339,0.935362156092079,0.588571428571429,1.79081294396212,654,320,334,29,1,74.13,7.6,0,0,0,0,0,0,0.415606404986568,105.600641763952,64.8482192784387
8.7,"random_instances_SVM","SVM",90,29,912,829,83,3000,2652,348,0.935974973931173,0.588571428571429,1.78587957497048,666,327,339,12,1,76.69,7.6,0,0,0,0,0,0,0.371021360657943,96.1251183237183,62.0714881606213
8.7,"random_instances_SVM","SVM",90,30,812,738,74,3100,2743,357,0.936672816234856,0.594285714285714,1.78424115334207,685,337,348,19,1,79.24,7.7,0,0,0,0,0,0,0.329951018688697,86.4238156710716,60.2330783407491
8.7,"random_instances_SVM","SVM",90,31,712,646,66,3200,2835,365,0.936335926846872,0.588571428571429,1.80110497237569,711,348,363,26,1,81.8,7.8,0,0,0,0,0,0,0.244132444776829,72.8003749012495,54.2915236699872
8.7,"random_instances_SVM","SVM",90,32,612,556,56,3300,2925,375,0.93680275928451,0.582857142857143,1.79614325068871,729,356,373,18,1,84.36,7.8,0,0,0,0,0,0,0.176093791899529,63.619114080462,51.0872911667439
8.7,"random_instances_SVM","SVM",90,33,512,465,47,3400,3016,384,0.936873345632468,0.588571428571429,1.79614325068871,746,364,382,17,1,86.91,7.9,0,0,0,0,0,0,0.129768205974356,55.2633197917019,46.3216047559478
8.7,"random_instances_SVM","SVM",90,34,412,375,37,3500,3106,394,0.937673858987727,0.588571428571429,1.79779411764706,760,375,385,14,1,89.47,7.9,0,0,0,0,0,0,0.0731862308889568,42.4568332272172,37.500730972935
8.7,"random_instances_SVM","SVM",90,35,312,285,27,3600,3196,404,0.937213443490815,0.582857142857143,1.79081294396212,783,383,400,23,1,92.02,7.9,0,0,0,0,0,0,0.0583589685445452,33.2215628188803,30.716047928483
8.7,"random_instances_SVM","SVM",90,36,212,196,16,3700,3285,415,0.936197962621321,0.577142857142857,1.79449541284404,799,393,406,16,1,94.58,7.9,0,0,0,0,0,0,0.0185812732658287,22.2885509495972,21.8067719500007
8.7,"random_instances_SVM","SVM",90,37,112,108,4,3800,3373,427,0.936539664714846,0.588571428571429,1.78916546195295,821,403,418,22,1,97.14,7.9,0,0,0,0,0,0,0.00130429590367981,9.3074357958434,9.29844753659593
8.7,"random_instances_SVM","SVM",90,38,12,11,1,3900,3470,430,0.93592845111093,0.582857142857143,1.78752100840336,832,409,423,11,1,99.69,8.1,0,0,0,0,0,0,0.000399831230342007,2.07963128990063,2.07963128990063
8.7,"random_instances_SVM","SVM",90,39,0,0,0,3912,3481,431,0.935729525948501,0.588571428571429,1.78752100840336,834,411,423,2,1,100,8.1,0,0,0,0,0,0,0,0,0
8.7,"random_instances_SVM","SVM",91,0,3812,3423,389,100,92,8,0.887984323091124,0.478468899521531,1.76015100302884,27,8,19,0,2.4,2.56,11.5,0,0,0,0,0,0,0.452058282978407,329.54582200873,59.232383971786
8.7,"random_instances_SVM","SVM",91,1,3712,3339,373,200,176,24,0.911172399437996,0.526315789473684,1.77361862463301,55,24,31,28,1.3,5.11,7.3,0,0,0,0,0,0,0.663349305681145,460.350989496757,72.4799220957485
8.7,"random_instances_SVM","SVM",91,2,3612,3247,365,300,268,32,0.920930754841507,0.545454545454545,1.79248724523514,70,32,38,15,1.2,7.67,8.4,0,0,0,0,0,0,0.464599678866903,367.497763120508,50.9410463050955
8.7,"random_instances_SVM","SVM",91,3,3512,3156,356,400,359,41,0.919240913336034,0.545454545454545,1.77937947744548,94,41,53,24,1.3,10.22,8.8,0,0,0,0,0,0,0.651315181817203,409.952784365549,72.9703622242105
8.7,"random_instances_SVM","SVM",91,4,3412,3067,345,500,448,52,0.916921147120265,0.569377990430622,1.7617673033071,121,52,69,27,1.3,12.78,8.6,0,0,0,0,0,0,0.696305428244011,431.915380396452,75.7511308299434
8.7,"random_instances_SVM","SVM",91,5,3312,2977,335,600,538,62,0.9194353683553,0.564593301435407,1.77688796771989,139,62,77,18,1.2,15.34,8.7,0,0,0,0,0,0,0.761128754649456,412.015558619251,82.4880004234565
8.7,"random_instances_SVM","SVM",91,6,3212,2890,322,700,625,75,0.924825332833021,0.578947368421053,1.79413930721231,163,75,88,24,1.2,17.89,8.3,0,0,0,0,0,0,0.842211357867879,443.243255633227,89.3359792706456
8.7,"random_instances_SVM","SVM",91,7,3112,2795,317,800,720,80,0.922498719609531,0.593301435406699,1.78590931039024,176,80,96,13,1.2,20.45,9,0,0,0,0,0,0,0.831442410942323,404.204159792118,88.8357143682421
8.7,"random_instances_SVM","SVM",91,8,3012,2708,304,900,807,93,0.922773969319907,0.569377990430622,1.77732320793644,194,93,101,18,1.1,23.01,8.7,0,0,0,0,0,0,0.808097149070593,371.843439948712,87.028175192867
8.7,"random_instances_SVM","SVM",91,9,2912,2616,296,1000,899,101,0.922174171443574,0.574162679425837,1.77198846045595,212,101,111,18,1.1,25.56,8.9,0,0,0,0,0,0,0.848905770021399,369.525393795127,90.353109745061
8.7,"random_instances_SVM","SVM",91,10,2812,2520,292,1100,995,105,0.920267964494144,0.607655502392344,1.77361862463301,222,105,117,10,1.1,28.12,9.5,0,0,0,0,0,0,0.778686220255989,334.784163276122,87.0674055347324
8.7,"random_instances_SVM","SVM",91,11,2712,2427,285,1200,1088,112,0.919881793258695,0.61244019138756,1.77361862463301,241,112,129,19,1.2,30.67,9.7,0,0,0,0,0,0,0.789337307938124,313.003714082632,88.4940042742024
8.7,"random_instances_SVM","SVM",91,12,2612,2344,268,1300,1171,129,0.920336434571341,0.602870813397129,1.77361862463301,271,129,142,30,1.1,33.23,9.1,0,0,0,0,0,0,0.788788358686054,298.715029563393,88.3175206137833
8.7,"random_instances_SVM","SVM",91,13,2512,2254,258,1400,1261,139,0.9198790544556,0.617224880382775,1.77569413075226,293,139,154,22,1.1,35.79,9.1,0,0,0,0,0,0,0.77691220780358,284.82053912518,88.0059682013198
8.7,"random_instances_SVM","SVM",91,14,2412,2171,241,1500,1344,156,0.919639409185382,0.607655502392344,1.76015100302884,326,156,170,33,1.1,38.34,8.6,0,0,0,0,0,0,0.743263521017948,278.019439863724,87.7385111770753
8.7,"random_instances_SVM","SVM",91,15,2312,2080,232,1600,1435,165,0.919561353297362,0.602870813397129,1.77525179095403,342,165,177,16,1.1,40.9,8.7,0,0,0,0,0,0,0.739796702817873,266.260018366798,86.8437654276338
8.7,"random_instances_SVM","SVM",91,16,2212,1989,223,1700,1526,174,0.918786272023382,0.598086124401914,1.77688796771989,371,174,197,29,1.1,43.46,8.8,0,0,0,0,0,0,0.696048702054359,246.738917594485,84.4350798507361
8.7,"random_instances_SVM","SVM",91,17,2112,1897,215,1800,1618,182,0.919906442486493,0.598086124401914,1.77688796771989,386,182,204,15,1.1,46.01,8.9,0,0,0,0,0,0,0.669717410112423,235.912273078709,82.8250686344309
8.7,"random_instances_SVM","SVM",91,18,2012,1806,206,1900,1709,191,0.92025153167561,0.602870813397129,1.75692728324307,400,191,209,14,1.1,48.57,8.9,0,0,0,0,0,0,0.737206605395069,236.413425379697,87.4409801847347
8.7,"random_instances_SVM","SVM",91,19,1912,1714,198,2000,1801,199,0.920807508702532,0.602870813397129,1.76873710548264,415,199,216,15,1.1,51.12,9.1,0,0,0,0,0,0,0.660473043379365,215.778377524498,82.1098957469143
8.7,"random_instances_SVM","SVM",91,20,1812,1620,192,2100,1895,205,0.921221067968868,0.598086124401914,1.7789552769979,428,205,223,13,1.1,53.68,9.2,0,0,0,0,0,0,0.656142016056503,202.092993697783,81.5504607793476
8.7,"random_instances_SVM","SVM",91,21,1712,1530,182,2200,1985,215,0.922379581675209,0.607655502392344,1.77406803722593,450,215,235,22,1.1,56.24,9.2,0,0,0,0,0,0,0.700936965000947,200.538654252576,84.6013172625277
8.7,"random_instances_SVM","SVM",91,22,1612,1439,173,2300,2076,224,0.922888999049625,0.607655502392344,1.7703612901525,466,224,242,16,1.1,58.79,9.3,0,0,0,0,0,0,0.713661662687891,184.548702013488,85.5624980841972
8.7,"random_instances_SVM","SVM",91,23,1512,1346,166,2400,2169,231,0.9230122451886,0.61244019138756,1.77361862463301,479,231,248,13,1.1,61.35,9.4,0,0,0,0,0,0,0.643135537996143,167.04801457029,80.5966152013715
8.7,"random_instances_SVM","SVM",91,24,1412,1258,154,2500,2257,243,0.922812312563158,0.62200956937799,1.7789552769979,502,243,259,23,1.1,63.91,9.3,0,0,0,0,0,0,0.642569600514012,160.311624960897,80.7800349402164
8.7,"random_instances_SVM","SVM",91,25,1312,1164,148,2600,2351,249,0.923298450111322,0.62200956937799,1.78386951809458,518,249,269,16,1.1,66.46,9.4,0,0,0,0,0,0,0.619073430723533,148.962343296154,79.5166246054539
8.7,"random_instances_SVM","SVM",91,26,1212,1074,138,2700,2441,259,0.923943438238614,0.617224880382775,1.78222842378171,532,258,274,14,1.1,69.02,9.4,0,0,0,0,0,0,0.55203531993796,133.958520452554,75.3693847377913
8.7,"random_instances_SVM","SVM",91,27,1112,986,126,2800,2529,271,0.923291603103605,0.617224880382775,1.77361862463301,556,269,287,24,1.1,71.57,9.3,0,0,0,0,0,0,0.539568966154537,126.318459184162,75.5786207731996
8.7,"random_instances_SVM","SVM",91,28,1012,892,120,2900,2623,277,0.923369658991618,0.62200956937799,1.75692728324307,574,276,298,18,1.1,74.13,9.5,0,0,0,0,0,0,0.513441033428818,118.568281371864,75.6199749496282
8.7,"random_instances_SVM","SVM",91,29,912,807,105,3000,2708,292,0.92387496816139,0.617224880382775,1.7650088254843,608,292,316,34,1.1,76.69,9.3,0,0,0,0,0,0,0.437636426188859,107.086934598705,73.1343988390598
8.7,"random_instances_SVM","SVM",91,30,812,718,94,3100,2797,303,0.924165281288751,0.607655502392344,1.7617673033071,629,303,326,21,1.1,79.24,9.2,0,0,0,0,0,0,0.378928001152728,94.3587663443573,68.3647502783202
8.7,"random_instances_SVM","SVM",91,31,712,627,85,3200,2888,312,0.924648680033829,0.617224880382775,1.75478468899522,642,311,331,13,1.1,81.8,9.3,0,0,0,0,0,0,0.294495663165402,84.174263839117,64.1940709105927
8.7,"random_instances_SVM","SVM",91,32,612,538,74,3300,2977,323,0.924862306674718,0.617224880382775,1.76663406381348,658,320,338,16,1.1,84.36,9.2,0,0,0,0,0,0,0.239987374115582,73.3288537038868,59.4075709943713
8.7,"random_instances_SVM","SVM",91,33,512,448,64,3400,3067,333,0.924589795767443,0.61244019138756,1.76663406381348,674,328,346,16,1.1,86.91,9.2,0,0,0,0,0,0,0.18517343726998,64.9663927861135,55.1415045965599
8.7,"random_instances_SVM","SVM",91,34,412,352,60,3500,3163,337,0.92424196777523,0.62200956937799,1.7650088254843,688,334,354,14,1.1,89.47,9.4,0,0,0,0,0,0,0.107308669170713,55.576987001531,49.5538847484186
8.7,"random_instances_SVM","SVM",91,35,312,266,46,3600,3249,351,0.924535019705667,0.62200956937799,1.7531733164617,711,346,365,23,1.1,92.02,9.3,0,0,0,0,0,0,0.0598392999262472,41.7372067181807,39.0986466433796
8.7,"random_instances_SVM","SVM",91,36,212,180,32,3700,3335,365,0.924817116423755,0.62200956937799,1.7650088254843,739,359,380,28,1.1,94.58,9.1,0,0,0,0,0,0,0.0303658336613844,25.1234815885678,24.3751286009996
8.7,"random_instances_SVM","SVM",91,37,112,97,15,3800,3418,382,0.92583732057414,0.617224880382775,1.75478468899522,763,371,392,24,1.1,97.14,8.9,0,0,0,0,0,0,0.00135589245447038,11.722467190289,11.7153758969837
8.7,"random_instances_SVM","SVM",91,38,12,12,0,3900,3503,397,0.925529205226715,0.607655502392344,1.7563990263356,784,383,401,21,1,99.69,8.8,0,0,0,0,0,0,0.000809071995919693,0.341757359638443,0.341757359638443
8.7,"random_instances_SVM","SVM",91,39,0,0,0,3912,3515,397,0.925545638045244,0.607655502392344,1.7563990263356,782,383,399,-2,1,100,8.9,0,0,0,0,0,0,0,0,0
8.7,"random_instances_SVM","SVM",92,0,3812,3415,397,100,87,13,0.908395176252323,0.556122448979592,1.74275960384154,31,13,18,0,1.4,2.56,6.7,0,0,0,0,0,0,0.798974249196387,597.290102958624,82.8880234708005
8.7,"random_instances_SVM","SVM",92,1,3712,3331,381,200,171,29,0.913131957328388,0.571428571428571,1.72283128127284,63,29,34,32,1.2,5.11,5.9,0,0,0,0,0,0,0.835002603612005,577.561572847121,87.1971978314002
8.7,"random_instances_SVM","SVM",92,2,3612,3239,373,300,263,37,0.918844213821889,0.576530612244898,1.75787305747987,81,37,44,18,1.2,7.67,7.1,0,0,0,0,0,0,0.746460148235703,472.170675462488,79.4300772061886
8.7,"random_instances_SVM","SVM",92,3,3512,3147,365,400,355,45,0.921273480983303,0.581632653061224,1.77618423516195,95,45,50,14,1.1,10.22,7.9,0,0,0,0,0,0,0.608395786471629,360.734400342314,66.9681999253881
8.7,"random_instances_SVM","SVM",92,4,3412,3058,354,500,444,56,0.923040352504635,0.596938775510204,1.77517163547447,118,56,62,23,1.1,12.78,7.9,0,0,0,0,0,0,0.726252976199742,410.494826974061,77.9028854278088
8.7,"random_instances_SVM","SVM",92,5,3312,2972,340,600,530,70,0.921469155844155,0.581632653061224,1.77781525833474,150,70,80,32,1.1,15.34,7.6,0,0,0,0,0,0,0.723440566499593,386.372849073941,77.9993506019301
8.7,"random_instances_SVM","SVM",92,6,3212,2880,332,700,622,78,0.926532061688316,0.586734693877551,1.77618423516195,164,78,86,14,1.1,17.89,8,0,0,0,0,0,0,0.580192157525713,321.682013369938,64.9483224766537
8.7,"random_instances_SVM","SVM",92,7,3112,2786,326,800,716,84,0.927188659554732,0.602040816326531,1.78272635020859,182,84,98,18,1.2,20.45,8.5,0,0,0,0,0,0,0.631533621638111,302.196453177948,71.2815791341785
8.7,"random_instances_SVM","SVM",92,8,3012,2697,315,900,805,95,0.928785946196664,0.607142857142857,1.78436941596915,199,95,104,17,1.1,23.01,8.5,0,0,0,0,0,0,0.711087937735589,316.93935992018,79.0548320536376
8.7,"random_instances_SVM","SVM",92,9,2912,2604,308,1000,898,102,0.928910598330244,0.61734693877551,1.77455620194916,215,102,113,16,1.1,25.56,8.8,0,0,0,0,0,0,0.687337596237998,302.061416435362,78.1570873972278
8.7,"random_instances_SVM","SVM",92,10,2812,2516,296,1100,986,114,0.927116187384048,0.607142857142857,1.7719054503126,242,114,128,27,1.1,28.12,8.6,0,0,0,0,0,0,0.516841640769097,287.765329575449,60.656575675489
8.7,"random_instances_SVM","SVM",92,11,2712,2427,285,1200,1075,125,0.924907235621526,0.607142857142857,1.78272635020859,264,125,139,22,1.1,30.67,8.6,0,0,0,0,0,0,0.583498893511954,281.510864251547,67.1137506165603
8.7,"random_instances_SVM","SVM",92,12,2612,2332,280,1300,1170,130,0.925278293135437,0.622448979591837,1.78108630756811,275,130,145,11,1.1,33.23,9,0,0,0,0,0,0,0.670281026473925,269.686780091719,76.0377549762181
8.7,"random_instances_SVM","SVM",92,13,2512,2244,268,1400,1258,142,0.926272611317257,0.607142857142857,1.78108630756811,300,142,158,25,1.1,35.79,8.9,0,0,0,0,0,0,0.648369365972206,256.805942241474,74.1032519465314
8.7,"random_instances_SVM","SVM",92,14,2412,2156,256,1500,1346,154,0.926526263914658,0.607142857142857,1.77618423516195,319,154,165,19,1.1,38.34,8.7,0,0,0,0,0,0,0.639968080144904,257.985875785418,73.6328390094623
8.7,"random_instances_SVM","SVM",92,15,2312,2069,243,1600,1433,167,0.926613230519474,0.596938775510204,1.78272635020859,347,167,180,28,1.1,40.9,8.6,0,0,0,0,0,0,0.718518327291964,255.078111477552,81.9174800166389
8.7,"random_instances_SVM","SVM",92,16,2212,1978,234,1700,1524,176,0.927711908627074,0.612244897959184,1.7702768607443,368,176,192,21,1.1,43.46,8.7,0,0,0,0,0,0,0.747886419377,255.020225856916,84.6653251329943
8.7,"random_instances_SVM","SVM",92,17,2112,1891,221,1800,1611,189,0.927217648422995,0.591836734693878,1.7719054503126,390,189,201,22,1.1,46.01,8.5,0,0,0,0,0,0,0.764935556168743,251.376798003095,85.9765975927019
8.7,"random_instances_SVM","SVM",92,18,2012,1806,206,1900,1696,204,0.927181412337652,0.596938775510204,1.77944927971188,419,204,215,29,1.1,48.57,8.3,0,0,0,0,0,0,0.763666432246334,242.654673406772,86.7216696827636
8.7,"random_instances_SVM","SVM",92,19,1912,1715,197,2000,1787,213,0.926904568645629,0.602040816326531,1.78272635020859,440,213,227,21,1.1,51.12,8.4,0,0,0,0,0,0,0.76626575322961,233.652845706907,86.5941586488899
8.7,"random_instances_SVM","SVM",92,20,1812,1623,189,2100,1879,221,0.927004580241178,0.596938775510204,1.77944927971188,459,221,238,19,1.1,53.68,8.5,0,0,0,0,0,0,0.779808877950188,224.066484620961,87.8395097515557
8.7,"random_instances_SVM","SVM",92,21,1712,1536,176,2200,1966,234,0.928246753246746,0.612244897959184,1.78436941596915,484,233,251,25,1.1,56.24,8.4,0,0,0,0,0,0,0.722577047088429,203.066911782725,82.9516647047177
8.7,"random_instances_SVM","SVM",92,22,1612,1445,167,2300,2057,243,0.926936456400732,0.596938775510204,1.78272635020859,505,243,262,21,1.1,58.79,8.5,0,0,0,0,0,0,0.738343590822017,200.488019472577,85.9456958077411
8.7,"random_instances_SVM","SVM",92,23,1512,1352,160,2400,2150,250,0.927968460111307,0.607142857142857,1.78108630756811,519,250,269,14,1.1,61.35,8.6,0,0,0,0,0,0,0.697910670897036,186.538671720102,83.7927813868764
8.7,"random_instances_SVM","SVM",92,24,1412,1272,140,2500,2230,270,0.927165468460104,0.591836734693878,1.77944927971188,552,269,283,33,1.1,63.91,8.3,0,0,0,0,0,0,0.662533155642234,171.900064490174,82.1522546134715
8.7,"random_instances_SVM","SVM",92,25,1312,1186,126,2600,2316,284,0.929071486549156,0.622448979591837,1.76702864632091,578,282,296,26,1,66.46,8.2,0,0,0,0,0,0,0.606182355576937,154.589468541213,78.080442586434
8.7,"random_instances_SVM","SVM",92,26,1212,1094,118,2700,2408,292,0.928632305194795,0.61734693877551,1.76540900503189,591,289,302,13,1,69.02,8.2,0,0,0,0,0,0,0.542592418252354,136.896539644025,75.2712371274448
8.7,"random_instances_SVM","SVM",92,27,1112,997,115,2800,2505,295,0.92872072124303,0.612244897959184,1.76702864632091,604,294,310,13,1.1,71.57,8.5,0,0,0,0,0,0,0.560237521982096,131.757291980751,76.9278799332698
8.7,"random_instances_SVM","SVM",92,28,1012,910,102,2900,2592,308,0.929084531539876,0.607142857142857,1.76702864632091,626,305,321,22,1.1,74.13,8.4,0,0,0,0,0,0,0.489023505890271,115.501670211444,73.0214594877092
8.7,"random_instances_SVM","SVM",92,29,912,820,92,3000,2682,318,0.928698979591825,0.612244897959184,1.77353703912504,640,314,326,14,1,76.69,8.4,0,0,0,0,0,0,0.427856450563561,102.174575286747,67.9833253554574
8.7,"random_instances_SVM","SVM",92,30,812,734,78,3100,2768,332,0.929278756957316,0.607142857142857,1.76110444177671,668,325,343,28,1.1,79.24,8.3,0,0,0,0,0,0,0.364618749787098,92.1102166339717,66.2400612165437
8.7,"random_instances_SVM","SVM",92,31,712,646,66,3200,2856,344,0.928194573283845,0.602040816326531,1.75948726598077,687,335,352,19,1.1,81.8,8.3,0,0,0,0,0,0,0.23330283113897,73.9364952128756,57.1297912719804
8.7,"random_instances_SVM","SVM",92,32,612,558,54,3300,2944,356,0.928487360853419,0.607142857142857,1.75787305747987,706,346,360,19,1,84.36,8.3,0,0,0,0,0,0,0.145642799713995,59.5038019874243,47.6513961905556
8.7,"random_instances_SVM","SVM",92,33,512,465,47,3400,3037,363,0.92818877551019,0.612244897959184,1.76272459305709,726,354,372,20,1.1,86.91,8.4,0,0,0,0,0,0,0.100690754366911,51.9812091920191,43.9302102054949
8.7,"random_instances_SVM","SVM",92,34,412,373,39,3500,3129,371,0.927836560760656,0.612244897959184,1.76110444177671,749,364,385,23,1.1,89.47,8.4,0,0,0,0,0,0,0.0750014813665092,43.7327191831008,38.9048353282317
8.7,"random_instances_SVM","SVM",92,35,312,279,33,3600,3223,377,0.928368506493496,0.61734693877551,1.75948726598077,757,371,386,8,1,92.02,8.5,0,0,0,0,0,0,0.057964619450891,35.3991002502976,33.1271652211179
8.7,"random_instances_SVM","SVM",92,36,212,190,22,3700,3312,388,0.929026553803329,0.607142857142857,1.75948726598077,772,378,394,15,1,94.58,8.5,0,0,0,0,0,0,0.0200101199250208,24.7159697514121,24.2618554948493
8.7,"random_instances_SVM","SVM",92,37,112,99,13,3800,3403,397,0.928620709647481,0.596938775510204,1.76272459305709,785,385,400,13,1,97.14,8.6,0,0,0,0,0,0,0.000884245817275051,14.4338840255125,14.4282962984135
8.7,"random_instances_SVM","SVM",92,38,12,10,2,3900,3492,408,0.92681035482373,0.607142857142857,1.76434772804149,814,397,417,29,1.1,99.69,8.6,0,0,0,0,0,0,0.00079604865948038,1.51721869672885,1.51721869672885
8.7,"random_instances_SVM","SVM",92,39,0,0,0,3912,3502,410,0.926701646567701,0.612244897959184,1.76597385497978,818,400,418,4,1,100,8.5,0,0,0,0,0,0,0,0,0
8.7,"random_instances_SVM","SVM",93,0,3812,3425,387,100,88,12,0.917208729349833,0.618357487922705,1.74729010839566,30,12,18,0,1.5,2.56,7.3,0,0,0,0,0,0,0.458904577690195,470.960141296528,50.8877196557188
8.7,"random_instances_SVM","SVM",93,1,3712,3341,371,200,172,28,0.921139201697033,0.584541062801932,1.76467607962348,59,28,31,29,1.1,5.11,6.1,0,0,0,0,0,0,0.918108160175539,598.700445352739,93.9381358912272
8.7,"random_instances_SVM","SVM",93,2,3612,3247,365,300,266,34,0.919473653682016,0.584541062801932,1.76143516854979,72,34,38,13,1.1,7.67,7.8,0,0,0,0,0,0,0.833987453108655,467.772358389636,87.8496296352887
8.7,"random_instances_SVM","SVM",93,3,3512,3154,358,400,359,41,0.919548230458815,0.589371980676328,1.75338473359298,89,41,48,17,1.2,10.22,8.8,0,0,0,0,0,0,0.598151093646219,351.460820404398,66.2127724498374
8.7,"random_instances_SVM","SVM",93,4,3412,3064,348,500,449,51,0.923210778830146,0.589371980676328,1.76686725381581,108,51,57,19,1.1,12.78,8.8,0,0,0,0,0,0,0.728145401059574,374.522258460872,78.3879273192664
8.7,"random_instances_SVM","SVM",93,5,3312,2977,335,600,536,64,0.928551304679279,0.613526570048309,1.80110497237569,137,64,73,29,1.1,15.34,8.4,0,0,0,0,0,0,0.738565063285909,380.702541882311,80.672984798549
8.7,"random_instances_SVM","SVM",93,6,3212,2886,326,700,627,73,0.931907259634909,0.618357487922705,1.78042412617221,157,73,84,20,1.2,17.89,8.6,0,0,0,0,0,0,0.790943386076492,375.557168370273,85.3005193134356
8.7,"random_instances_SVM","SVM",93,7,3112,2796,316,800,717,83,0.935811492005094,0.628019323671498,1.7820620508513,179,83,96,22,1.2,20.45,8.6,0,0,0,0,0,0,0.68692814046798,333.432461045073,76.7076824367859
8.7,"random_instances_SVM","SVM",93,8,3012,2701,311,900,812,88,0.939237880583249,0.618357487922705,1.77390242607634,193,88,105,14,1.2,23.01,9.2,0,0,0,0,0,0,0.586506566861529,300.596115615468,68.8445180565819
8.7,"random_instances_SVM","SVM",93,9,2912,2613,299,1000,900,100,0.938150993114081,0.613526570048309,1.77878920961925,210,100,110,17,1.1,25.56,9,0,0,0,0,0,0,0.671493447205445,300.993114216862,76.9323707583742
8.7,"random_instances_SVM","SVM",93,10,2812,2523,289,1100,990,110,0.933560378187125,0.608695652173913,1.78746623015398,230,110,120,20,1.1,28.12,9,0,0,0,0,0,0,0.815667869343904,308.889482567926,88.0145995650874
8.7,"random_instances_SVM","SVM",93,11,2712,2438,274,1200,1075,125,0.935567045903388,0.613526570048309,1.78582635287861,260,125,135,30,1.1,30.67,8.6,0,0,0,0,0,0,0.715199967181345,279.197787841173,79.631606134279
8.7,"random_instances_SVM","SVM",93,12,2612,2346,266,1300,1167,133,0.938369199238764,0.618357487922705,1.7820620508513,278,133,145,18,1.1,33.23,8.8,0,0,0,0,0,0,0.731030369895942,264.234134373647,82.1340264653791
8.7,"random_instances_SVM","SVM",93,13,2512,2256,256,1400,1257,143,0.935644384783026,0.623188405797101,1.77500200176155,297,143,154,19,1.1,35.79,8.8,0,0,0,0,0,0,0.745802646481311,254.069431804977,82.9419738923178
8.7,"random_instances_SVM","SVM",93,14,2412,2170,242,1500,1343,157,0.933328361548215,0.618357487922705,1.7820620508513,322,157,165,25,1.1,38.34,8.6,0,0,0,0,0,0,0.755105797665691,246.012847580706,84.3467713757863
8.7,"random_instances_SVM","SVM",93,15,2312,2082,230,1600,1431,169,0.933458180381892,0.623188405797101,1.78370299196626,345,168,177,23,1.1,40.9,8.5,0,0,0,0,0,0,0.707756126290651,234.605798251731,81.2065385259375
8.7,"random_instances_SVM","SVM",93,16,2212,1991,221,1700,1522,178,0.934568545725235,0.623188405797101,1.77336906523739,365,178,187,20,1.1,43.46,8.6,0,0,0,0,0,0,0.744245404179457,226.489625038822,84.9414069636099
8.7,"random_instances_SVM","SVM",93,17,2112,1902,210,1800,1611,189,0.936590405007146,0.628019323671498,1.77336906523739,394,189,205,29,1.1,46.01,8.5,0,0,0,0,0,0,0.751811943132903,226.297063630779,86.3741696152111
8.7,"random_instances_SVM","SVM",93,18,2012,1811,201,1900,1702,198,0.937511566305671,0.632850241545894,1.78370299196626,412,198,214,18,1.1,48.57,8.6,0,0,0,0,0,0,0.68047740672866,207.107384233242,82.1244811379759
8.7,"random_instances_SVM","SVM",93,19,1912,1725,187,2000,1788,212,0.937021293050834,0.63768115942029,1.78534695785748,439,212,227,27,1.1,51.12,8.4,0,0,0,0,0,0,0.657326507508904,200.831190193971,80.4609618620682
8.7,"random_instances_SVM","SVM",93,20,1812,1639,173,2100,1874,226,0.936986766765276,0.632850241545894,1.78370299196626,459,223,236,20,1.1,53.68,8.3,0,0,0,0,0,0,0.637565539176754,190.058598471877,78.00712276585
8.7,"random_instances_SVM","SVM",93,21,1712,1549,163,2200,1964,236,0.936901141577118,0.63768115942029,1.77715729291318,488,235,253,29,1.1,56.24,8.3,0,0,0,0,0,0,0.591070924302687,175.349825570504,76.0417376765676
8.7,"random_instances_SVM","SVM",93,22,1612,1460,152,2300,2053,247,0.936513066127517,0.63768115942029,1.7820620508513,509,246,263,21,1.1,58.79,8.3,0,0,0,0,0,0,0.602440054785241,168.387186553679,77.6912485266206
8.7,"random_instances_SVM","SVM",93,23,1512,1369,143,2400,2144,256,0.938588786414884,0.632850241545894,1.77715729291318,524,255,269,15,1.1,61.35,8.4,0,0,0,0,0,0,0.576966752691182,157.743653784785,75.6581503640056
8.7,"random_instances_SVM","SVM",93,24,1412,1278,134,2500,2235,265,0.93844653811841,0.63768115942029,1.78042412617221,542,264,278,18,1.1,63.91,8.4,0,0,0,0,0,0,0.549303405732284,145.044173249088,74.6088396611996
8.7,"random_instances_SVM","SVM",93,25,1312,1190,122,2600,2323,277,0.939090108081101,0.642512077294686,1.7820620508513,566,275,291,24,1.1,66.46,8.4,0,0,0,0,0,0,0.50052834066312,134.712030028691,73.724889813286
8.7,"random_instances_SVM","SVM",93,26,1212,1103,109,2700,2410,290,0.939272406868807,0.642512077294686,1.78534695785748,587,287,300,21,1,69.02,8.3,0,0,0,0,0,0,0.448744240713803,121.900719803415,68.8995217115209
8.7,"random_instances_SVM","SVM",93,27,1112,1009,103,2800,2504,296,0.937935549092252,0.657004830917874,1.78534695785748,600,293,307,13,1,71.57,8.5,0,0,0,0,0,0,0.432940470478131,115.804700568191,68.4948038795982
8.7,"random_instances_SVM","SVM",93,28,1012,922,90,2900,2591,309,0.939409130959594,0.652173913043478,1.78370299196626,623,304,319,23,1,74.13,8.4,0,0,0,0,0,0,0.38587590474847,100.565576183512,65.3629200581888
8.7,"random_instances_SVM","SVM",93,29,912,827,85,3000,2686,314,0.939703294912494,0.647342995169082,1.77878920961925,635,310,325,12,1,76.69,8.6,0,0,0,0,0,0,0.322556480975837,90.0577324460845,61.3949962275931
8.7,"random_instances_SVM","SVM",93,30,812,734,78,3100,2779,321,0.938893998779166,0.647342995169082,1.7820620508513,650,317,333,15,1.1,79.24,8.7,0,0,0,0,0,0,0.299559783033504,80.7451071766059,58.8342953125074
8.7,"random_instances_SVM","SVM",93,31,712,645,67,3200,2868,332,0.939841400054706,0.647342995169082,1.78534695785748,677,329,348,27,1.1,81.8,8.6,0,0,0,0,0,0,0.252891680313139,73.9083237965609,57.9121187962437
8.7,"random_instances_SVM","SVM",93,32,612,556,56,3300,2957,343,0.939404987805328,0.657004830917874,1.7820620508513,692,337,355,15,1.1,84.36,8.6,0,0,0,0,0,0,0.154578619313637,59.6438347767281,49.2693310501569
8.7,"random_instances_SVM","SVM",93,33,512,461,51,3400,3052,348,0.938443776015575,0.657004830917874,1.7820620508513,704,344,360,12,1,86.91,8.8,0,0,0,0,0,0,0.117786793996532,52.7778312133717,45.1221600512358
8.7,"random_instances_SVM","SVM",93,34,412,373,39,3500,3140,360,0.939277931074501,0.657004830917874,1.7820620508513,731,355,376,27,1.1,89.47,8.7,0,0,0,0,0,0,0.0663430125447277,43.449178691246,38.9347090447575
8.7,"random_instances_SVM","SVM",93,35,312,283,29,3600,3230,370,0.938087464748681,0.657004830917874,1.78534695785748,753,368,385,22,1,92.02,8.7,0,0,0,0,0,0,0.0491192750708446,36.3951783558223,33.9614017579647
8.7,"random_instances_SVM","SVM",93,36,212,190,22,3700,3323,377,0.937659338807839,0.657004830917874,1.7820620508513,766,375,391,13,1,94.58,8.8,0,0,0,0,0,0,0.0179415720727039,22.6104612093526,22.1444615272306
8.7,"random_instances_SVM","SVM",93,37,112,102,10,3800,3411,389,0.936827945851754,0.661835748792271,1.78042412617221,794,387,407,28,1.1,97.14,8.8,0,0,0,0,0,0,0.000410510022870805,11.5306339077801,11.528361985849
8.7,"random_instances_SVM","SVM",93,38,12,12,0,3900,3501,399,0.936687078606703,0.657004830917874,1.7820620508513,815,396,419,21,1.1,99.69,8.8,0,0,0,0,0,0,0.000760423681900417,0.714626796670628,0.714626796670628
8.7,"random_instances_SVM","SVM",93,39,0,0,0,3912,3513,399,0.936449537762108,0.647342995169082,1.78370299196626,813,396,417,-2,1.1,100,8.8,0,0,0,0,0,0,0,0,0
8.7,"random_instances_SVM","SVM",94,0,3812,3425,387,100,87,13,0.910846047156727,0.597087378640777,1.75254754072053,31,13,18,0,1.4,2.56,6.7,0,0,0,0,0,0,0.904025346192065,614.76774697557,92.6619801801258
8.7,"random_instances_SVM","SVM",94,1,3712,3341,371,200,171,29,0.919877947295422,0.587378640776699,1.76775983177486,59,28,31,28,1.1,5.11,5.9,0,0,0,0,0,0,0.87169132633105,498.181661550502,89.9671613874092
8.7,"random_instances_SVM","SVM",94,2,3612,3253,359,300,259,41,0.920224687933427,0.572815533980582,1.78906696173615,87,41,46,28,1.1,7.67,6.3,0,0,0,0,0,0,0.822614255547289,503.908830378453,85.945335512708
8.7,"random_instances_SVM","SVM",94,3,3512,3165,347,400,347,53,0.925751733703192,0.567961165048544,1.77057560213699,112,53,59,25,1.1,10.22,6.5,0,0,0,0,0,0,0.75110206725712,462.57617363938,80.7566714774302
8.7,"random_instances_SVM","SVM",94,4,3412,3075,337,500,437,63,0.921601941747571,0.587378640776699,1.7477328496746,133,63,70,21,1.1,12.78,6.9,0,0,0,0,0,0,0.653152231573112,413.853551053367,71.7172765772495
8.7,"random_instances_SVM","SVM",94,5,3312,2981,331,600,531,69,0.926900138696247,0.592233009708738,1.77925489430433,149,69,80,16,1.2,15.34,7.7,0,0,0,0,0,0,0.631339338332755,378.876719547147,69.7350267148535
8.7,"random_instances_SVM","SVM",94,6,3212,2889,323,700,623,77,0.926177531206654,0.572815533980582,1.78742410869507,163,77,86,14,1.1,17.89,8.1,0,0,0,0,0,0,0.688426284161221,364.900950115496,75.7864699785822
8.7,"random_instances_SVM","SVM",94,7,3112,2798,314,800,714,86,0.923683772538139,0.58252427184466,1.75803796285585,185,86,99,22,1.2,20.45,8.3,0,0,0,0,0,0,0.745705427001598,344.553811940824,82.9925857929945
8.7,"random_instances_SVM","SVM",94,8,3012,2705,307,900,807,93,0.920644937586687,0.58252427184466,1.76288549400343,199,93,106,14,1.1,23.01,8.7,0,0,0,0,0,0,0.690393396228279,315.747409167518,78.8387322315806
8.7,"random_instances_SVM","SVM",94,9,2912,2613,299,1000,899,101,0.915445214979183,0.587378640776699,1.74703691463992,217,101,116,18,1.1,25.56,8.9,0,0,0,0,0,0,0.583375577723138,285.790904771961,71.08147975169
8.7,"random_instances_SVM","SVM",94,10,2812,2523,289,1100,989,111,0.921639389736455,0.597087378640777,1.76126668271417,232,111,121,15,1.1,28.12,8.9,0,0,0,0,0,0,0.700525764571914,284.56899395696,80.4398549141418
8.7,"random_instances_SVM","SVM",94,11,2712,2431,281,1200,1081,119,0.920582524271824,0.592233009708738,1.77707312728244,251,119,132,19,1.1,30.67,9.1,0,0,0,0,0,0,0.640926375083512,267.458632790053,75.1870810797205
8.7,"random_instances_SVM","SVM",94,12,2612,2341,271,1300,1171,129,0.916251040221891,0.592233009708738,1.76613206029073,267,129,138,16,1.1,33.23,9.1,0,0,0,0,0,0,0.711280352354076,262.522629376602,81.6217286320479
8.7,"random_instances_SVM","SVM",94,13,2512,2253,259,1400,1259,141,0.921040221913984,0.597087378640777,1.75965084172085,298,141,157,31,1.1,35.79,8.9,0,0,0,0,0,0,0.689971463758951,265.232724000244,80.1072462966624
8.7,"random_instances_SVM","SVM",94,14,2412,2163,249,1500,1349,151,0.925384188626889,0.616504854368932,1.79071283750592,312,151,161,14,1.1,38.34,8.9,0,0,0,0,0,0,0.719603391474284,260.130460667527,81.8324346797046
8.7,"random_instances_SVM","SVM",94,15,2312,2071,241,1600,1441,159,0.928527045769743,0.611650485436893,1.78033980582524,335,159,176,23,1.1,40.9,9.1,0,0,0,0,0,0,0.677125681143836,241.981918964608,79.813061752776
8.7,"random_instances_SVM","SVM",94,16,2212,1982,230,1700,1530,170,0.928427184465995,0.621359223300971,1.78526240436669,355,170,185,20,1.1,43.46,9,0,0,0,0,0,0,0.729806527464151,233.574019541992,83.6772037549843
8.7,"random_instances_SVM","SVM",94,17,2112,1893,219,1800,1619,181,0.928984743411908,0.621359223300971,1.78414743755173,373,181,192,18,1.1,46.01,8.9,0,0,0,0,0,0,0.712387730610694,231.599684947512,82.7142352071799
8.7,"random_instances_SVM","SVM",94,18,2012,1804,208,1900,1708,192,0.92834951456309,0.621359223300971,1.78906696173615,398,191,207,25,1.1,48.57,8.9,0,0,0,0,0,0,0.667418419403617,211.238095436419,80.0938355915466
8.7,"random_instances_SVM","SVM",94,19,1912,1714,198,2000,1798,202,0.929414701803029,0.621359223300971,1.77870496670144,414,201,213,16,1.1,51.12,8.9,0,0,0,0,0,0,0.669027704603518,203.830606699695,80.2402373139706
8.7,"random_instances_SVM","SVM",94,20,1812,1623,189,2100,1889,211,0.928467406380009,0.616504854368932,1.78906696173615,434,210,224,20,1.1,53.68,9,0,0,0,0,0,0,0.624044223771052,186.152054994193,78.0983750868006
8.7,"random_instances_SVM","SVM",94,21,1712,1534,178,2200,1978,222,0.92874895977807,0.621359223300971,1.78906696173615,460,221,239,26,1.1,56.24,8.9,0,0,0,0,0,0,0.640407716017983,181.445971102268,79.5337203486857
8.7,"random_instances_SVM","SVM",94,22,1612,1445,167,2300,2067,233,0.930618585298184,0.621359223300971,1.78088275788557,478,232,246,18,1.1,58.79,8.9,0,0,0,0,0,0,0.661659510621401,172.164114742041,80.3292975992319
8.7,"random_instances_SVM","SVM",94,23,1512,1354,158,2400,2158,242,0.932036061026344,0.621359223300971,1.79236174435445,495,241,254,17,1.1,61.35,8.9,0,0,0,0,0,0,0.615196986116195,156.81802425196,76.7371803555829
8.7,"random_instances_SVM","SVM",94,24,1412,1273,139,2500,2239,261,0.930546463245479,0.621359223300971,1.78088275788557,535,259,276,40,1.1,63.91,8.6,0,0,0,0,0,0,0.567170650127415,148.104305802082,76.1227531722624
8.7,"random_instances_SVM","SVM",94,25,1312,1189,123,2600,2323,277,0.930997226074884,0.62621359223301,1.79236174435445,561,274,287,26,1,66.46,8.4,0,0,0,0,0,0,0.545921126868932,137.084634998593,74.566266140804
8.7,"random_instances_SVM","SVM",94,26,1212,1098,114,2700,2414,286,0.932554785020791,0.631067961165049,1.78906696173615,582,285,297,21,1,69.02,8.4,0,0,0,0,0,0,0.487911127767182,124.286001852371,71.0039597923607
8.7,"random_instances_SVM","SVM",94,27,1112,1009,103,2800,2503,297,0.934134535367541,0.631067961165049,1.78251360290195,597,294,303,15,1,71.57,8.4,0,0,0,0,0,0,0.474824745413613,115.62268194226,71.3973309880652
8.7,"random_instances_SVM","SVM",94,28,1012,922,90,2900,2590,310,0.9329736477115,0.640776699029126,1.78578427006324,618,305,313,21,1,74.13,8.4,0,0,0,0,0,0,0.409872393068923,101.543345051455,66.0805287061413
8.7,"random_instances_SVM","SVM",94,29,912,831,81,3000,2681,319,0.93484466019416,0.631067961165049,1.78578427006324,640,314,326,22,1,76.69,8.4,0,0,0,0,0,0,0.340932246452003,91.2542988705343,62.4076530047169
8.7,"random_instances_SVM","SVM",94,30,812,736,76,3100,2776,324,0.935721220527026,0.640776699029126,1.78251360290195,659,321,338,19,1.1,79.24,8.6,0,0,0,0,0,0,0.240201387247904,81.158602097782,60.712793702233
8.7,"random_instances_SVM","SVM",94,31,712,645,67,3200,2867,333,0.936693481275989,0.645631067961165,1.78906696173615,682,332,350,23,1.1,81.8,8.6,0,0,0,0,0,0,0.201622275901669,72.3425151802491,55.88452035898
8.7,"random_instances_SVM","SVM",94,32,612,552,60,3300,2960,340,0.936276005547833,0.631067961165049,1.79236174435445,696,339,357,14,1.1,84.36,8.7,0,0,0,0,0,0,0.127273746434719,61.9451146586187,50.9272009491229
8.7,"random_instances_SVM","SVM",94,33,512,458,54,3400,3054,346,0.936267683772518,0.635922330097087,1.78578427006324,711,344,367,15,1.1,86.91,8.8,0,0,0,0,0,0,0.103230572764759,52.0646943591306,43.8772244681334
8.7,"random_instances_SVM","SVM",94,34,412,366,46,3500,3146,354,0.936515950069329,0.635922330097087,1.78742410869507,717,351,366,6,1,89.47,8.9,0,0,0,0,0,0,0.077799132571356,44.0586976220269,38.7688146071552
8.7,"random_instances_SVM","SVM",94,35,312,275,37,3600,3237,363,0.93676005547848,0.631067961165049,1.77381841459511,741,358,383,24,1.1,92.02,8.9,0,0,0,0,0,0,0.052461272884231,31.6246604137634,29.3426599886054
8.7,"random_instances_SVM","SVM",94,36,212,186,26,3700,3326,374,0.937045769764194,0.62621359223301,1.78526240436669,753,366,387,12,1.1,94.58,8.9,0,0,0,0,0,0,0.0165606826792046,19.2475020020485,18.7500294598101
8.7,"random_instances_SVM","SVM",94,37,112,97,15,3800,3415,385,0.937481276005525,0.631067961165049,1.79236174435445,775,378,397,22,1.1,97.14,8.9,0,0,0,0,0,0,0.00148589589964782,11.0987169803646,11.0924306029336
8.7,"random_instances_SVM","SVM",94,38,12,9,3,3900,3503,397,0.938205270457675,0.62621359223301,1.78197765293272,796,390,406,21,1,99.69,8.8,0,0,0,0,0,0,0.00184155353933333,2.57478984111654,2.57478984111654
8.7,"random_instances_SVM","SVM",94,39,0,0,0,3912,3512,400,0.937520110956982,0.631067961165049,1.79071283750592,804,392,412,8,1.1,100,8.8,0,0,0,0,0,0,0,0,0
8.7,"random_instances_SVM","SVM",95,0,3812,3429,383,100,90,10,0.909682997583901,0.539906103286385,1.77737392094502,23,10,13,0,1.3,2.56,9,0,0,0,0,0,0,0.384416132806947,327.666479908062,43.0270325578251
8.7,"random_instances_SVM","SVM",95,1,3712,3344,368,200,175,25,0.898442866031532,0.549295774647887,1.69650994200497,54,25,29,31,1.2,5.11,7,0,0,0,0,0,0,0.684494027121741,384.346517394374,75.4677514999671
8.7,"random_instances_SVM","SVM",95,2,3612,3253,359,300,266,34,0.910426413905117,0.568075117370892,1.72341500706169,72,34,38,18,1.1,7.67,7.8,0,0,0,0,0,0,0.68587463828924,384.069660229508,76.2420569484914
8.7,"random_instances_SVM","SVM",95,3,3512,3160,352,400,359,41,0.907404264947119,0.563380281690141,1.71496689428198,88,41,47,16,1.1,10.22,8.8,0,0,0,0,0,0,0.645635521326093,347.336309960322,71.5443159919591
8.7,"random_instances_SVM","SVM",95,4,3412,3070,342,500,449,51,0.904767291836695,0.605633802816901,1.71024680191239,114,51,63,26,1.2,12.78,8.8,0,0,0,0,0,0,0.533726863136147,331.194857440692,63.5276431453239
8.7,"random_instances_SVM","SVM",95,5,3312,2979,333,600,540,60,0.911594062366166,0.605633802816901,1.7250019453739,135,60,75,21,1.2,15.34,9,0,0,0,0,0,0,0.738969959848464,346.74268071232,82.419957029706
8.7,"random_instances_SVM","SVM",95,6,3212,2885,327,700,634,66,0.905429902036038,0.605633802816901,1.70711448176237,147,66,81,12,1.2,17.89,9.6,0,0,0,0,0,0,0.784037304098323,322.635707999752,87.2882797803373
8.7,"random_instances_SVM","SVM",95,7,3112,2791,321,800,728,72,0.90302726667906,0.586854460093897,1.72659180891802,162,72,90,15,1.2,20.45,10.1,0,0,0,0,0,0,0.698673325812189,296.017585021522,81.8063030692936
8.7,"random_instances_SVM","SVM",95,8,3012,2700,312,900,819,81,0.909622392992491,0.610328638497653,1.74715202982601,174,81,93,12,1.1,23.01,10.1,0,0,0,0,0,0,0.7031525053135,286.380567474274,81.2631171549928
8.7,"random_instances_SVM","SVM",95,9,2912,2610,302,1000,909,91,0.911641199270596,0.610328638497653,1.73756984319077,198,91,107,24,1.2,25.56,10,0,0,0,0,0,0,0.768467758414879,301.507110412974,86.3085979488966
8.7,"random_instances_SVM","SVM",95,10,2812,2522,290,1100,997,103,0.913296378000272,0.610328638497653,1.75882551293025,220,103,117,22,1.1,28.12,9.7,0,0,0,0,0,0,0.744908449528462,278.603951372868,84.3481178080922
8.7,"random_instances_SVM","SVM",95,11,2712,2436,276,1200,1083,117,0.917779770995459,0.605633802816901,1.76403272576636,247,117,130,27,1.1,30.67,9.3,0,0,0,0,0,0,0.701460580623028,274.171325422951,79.0039925703449
8.7,"random_instances_SVM","SVM",95,12,2612,2352,260,1300,1167,133,0.920791145803871,0.586854460093897,1.77410368373997,274,133,141,27,1.1,33.23,8.8,0,0,0,0,0,0,0.774453439330839,282.525442299275,84.5282953473577
8.7,"random_instances_SVM","SVM",95,13,2512,2268,244,1400,1251,149,0.922128487120848,0.586854460093897,1.77573729670843,299,145,154,25,1.1,35.79,8.4,0,0,0,0,0,0,0.693509254636897,262.692564629043,77.1144443519297
8.7,"random_instances_SVM","SVM",95,14,2412,2175,237,1500,1344,156,0.923749996633075,0.582159624413146,1.77247307373654,314,153,161,15,1.1,38.34,8.6,0,0,0,0,0,0,0.74214005899131,272.77754745852,81.9172459943338
8.7,"random_instances_SVM","SVM",95,15,2312,2084,228,1600,1435,165,0.922752041027959,0.591549295774648,1.77573729670843,328,161,167,14,1,40.9,8.7,0,0,0,0,0,0,0.732139108834481,257.577894396893,81.0746589544153
8.7,"random_instances_SVM","SVM",95,16,2212,1992,220,1700,1527,173,0.923118362113779,0.586854460093897,1.77410368373997,345,170,175,17,1,43.46,8.8,0,0,0,0,0,0,0.71454837969709,239.235713047527,79.9958284845354
8.7,"random_instances_SVM","SVM",95,17,2112,1899,213,1800,1620,180,0.923193781160857,0.591549295774648,1.77410368373997,361,177,184,16,1,46.01,9,0,0,0,0,0,0,0.711851011446862,232.540968515799,80.6090743344227
8.7,"random_instances_SVM","SVM",95,18,2012,1806,206,1900,1713,187,0.923642255137246,0.610328638497653,1.77573729670843,378,185,193,17,1,48.57,9.2,0,0,0,0,0,0,0.696971218405606,219.55683048315,81.4534300586576
8.7,"random_instances_SVM","SVM",95,19,1912,1714,198,2000,1805,195,0.92351431211095,0.615023474178404,1.77410368373997,389,190,199,11,1,51.12,9.3,0,0,0,0,0,0,0.648924383539229,200.047567116472,77.4683852378665
8.7,"random_instances_SVM","SVM",95,20,1812,1623,189,2100,1896,204,0.922418042390892,0.60093896713615,1.76403272576636,415,201,214,26,1.1,53.68,9.3,0,0,0,0,0,0,0.648001137124874,193.886014408323,79.2785788313407
8.7,"random_instances_SVM","SVM",95,21,1712,1530,182,2200,1989,211,0.922418042390886,0.605633802816901,1.77084545842548,429,208,221,14,1.1,56.24,9.4,0,0,0,0,0,0,0.605948012597891,177.725481133787,76.2304629921084
8.7,"random_instances_SVM","SVM",95,22,1612,1440,172,2300,2079,221,0.923003886774456,0.605633802816901,1.76403272576636,453,219,234,24,1.1,58.79,9.4,0,0,0,0,0,0,0.595750067225484,169.636903382113,75.716783245476
8.7,"random_instances_SVM","SVM",95,23,1512,1353,159,2400,2166,234,0.921036257706881,0.596244131455399,1.76728140481934,479,233,246,26,1.1,61.35,9.3,0,0,0,0,0,0,0.609089158201203,167.531122550536,77.7326901562693
8.7,"random_instances_SVM","SVM",95,24,1412,1268,144,2500,2251,249,0.922628138307752,0.605633802816901,1.76079596847138,504,248,256,25,1,63.91,9,0,0,0,0,0,0,0.540119782381578,150.635029283667,72.9352534593893
8.7,"random_instances_SVM","SVM",95,25,1312,1177,135,2600,2342,258,0.923518352417041,0.605633802816901,1.75757106743022,519,254,265,15,1,66.46,9.1,0,0,0,0,0,0,0.507334639370952,136.379865386557,70.242111422403
8.7,"random_instances_SVM","SVM",95,26,1212,1085,127,2700,2434,266,0.924993064141203,0.619718309859155,1.76403272576636,538,263,275,19,1,69.02,9.2,0,0,0,0,0,0,0.505653488685554,131.041574030197,70.1965881516131
8.7,"random_instances_SVM","SVM",95,27,1112,991,121,2800,2528,272,0.923973560236919,0.615023474178404,1.75237110737821,556,271,285,18,1.1,71.57,9.3,0,0,0,0,0,0,0.520910848463211,126.7710427514,74.4254703790104
8.7,"random_instances_SVM","SVM",95,28,1012,901,111,2900,2618,282,0.924826064822667,0.619718309859155,1.75398026358334,573,280,293,17,1,74.13,9.3,0,0,0,0,0,0,0.4651866994628,115.177186222957,69.9542693279227
8.7,"random_instances_SVM","SVM",95,29,912,816,96,3000,2703,297,0.926144551377875,0.615023474178404,1.74596390040425,599,293,306,26,1,76.69,9.1,0,0,0,0,0,0,0.354864861406969,98.1977991978268,63.4517259882695
8.7,"random_instances_SVM","SVM",95,30,812,726,86,3100,2793,307,0.925884625019187,0.619718309859155,1.75076490104698,619,304,315,20,1,79.24,9.1,0,0,0,0,0,0,0.31100381132297,87.0067408148216,61.71962945758
8.7,"random_instances_SVM","SVM",95,31,712,636,76,3200,2883,317,0.926358687600835,0.619718309859155,1.76241286100441,645,314,331,26,1.1,81.8,9.1,0,0,0,0,0,0,0.259572240427676,79.656978964187,60.3766103113973
8.7,"random_instances_SVM","SVM",95,32,612,548,64,3300,2971,329,0.92716270851346,0.619718309859155,1.76403272576636,670,326,344,25,1.1,84.36,9,0,0,0,0,0,0,0.209862953334351,71.2409654293029,55.6758708428137
8.7,"random_instances_SVM","SVM",95,33,512,458,54,3400,3061,339,0.927996358337446,0.619718309859155,1.75918203999432,691,336,355,21,1.1,86.91,9,0,0,0,0,0,0,0.162311641576363,60.1620175551594,48.8032711228473
8.7,"random_instances_SVM","SVM",95,34,412,373,39,3500,3146,354,0.928131035207231,0.619718309859155,1.75918203999432,708,348,360,17,1,89.47,8.9,0,0,0,0,0,0,0.0946036985827396,46.2850204415416,40.5510468828434
8.7,"random_instances_SVM","SVM",95,35,312,284,28,3600,3235,365,0.927762020584014,0.610328638497653,1.76728140481934,740,360,380,32,1.1,92.02,8.9,0,0,0,0,0,0,0.0436958501679598,29.893158939245,27.8496280555214
8.7,"random_instances_SVM","SVM",95,36,212,194,18,3700,3325,375,0.928342477892798,0.615023474178404,1.75757106743022,760,370,390,20,1.1,94.58,8.9,0,0,0,0,0,0,0.0136695261229987,19.9331348768017,19.4937367052055
8.7,"random_instances_SVM","SVM",95,37,112,102,10,3800,3417,383,0.929620561387068,0.615023474178404,1.76079596847138,777,379,398,17,1.1,97.14,8.9,0,0,0,0,0,0,0.00136430026890574,11.7988499995326,11.7927083003853
8.7,"random_instances_SVM","SVM",95,38,12,11,1,3900,3508,392,0.929079160370526,0.619718309859155,1.76403272576636,797,388,409,20,1.1,99.69,8.9,0,0,0,0,0,0,0.000732795026201733,1.69696865203541,1.69696865203541
8.7,"random_instances_SVM","SVM",95,39,0,0,0,3912,3519,393,0.929022596085216,0.619718309859155,1.76241286100441,797,390,407,0,1,100,9,0,0,0,0,0,0,0,0,0
8.7,"random_instances_SVM","SVM",96,0,3812,3403,409,100,85,15,0.919583235254031,0.56043956043956,1.76007158440827,33,15,18,0,1.2,2.56,5.7,0,0,0,0,0,0,0.711796019922025,691.247811832627,73.9796822003437
8.7,"random_instances_SVM","SVM",96,1,3712,3319,393,200,169,31,0.927908619002193,0.571428571428571,1.75505595322109,67,31,36,34,1.2,5.11,5.5,0,0,0,0,0,0,0.792403730772011,651.761605875536,82.7853148253559
8.7,"random_instances_SVM","SVM",96,2,3612,3231,381,300,257,43,0.931913351586405,0.571428571428571,1.77967386799034,91,43,48,24,1.1,7.67,6,0,0,0,0,0,0,0.770809129161568,524.484975356801,80.974259029999
8.7,"random_instances_SVM","SVM",96,3,3512,3141,371,400,347,53,0.933300915544432,0.576923076923077,1.7666716844799,115,53,62,24,1.2,10.22,6.5,0,0,0,0,0,0,0.647124393219146,483.489965275986,69.5348200831464
8.7,"random_instances_SVM","SVM",96,4,3412,3049,363,500,439,61,0.931464251644646,0.565934065934066,1.77304907074492,130,61,69,15,1.1,12.78,7.2,0,0,0,0,0,0,0.345885038800884,370.872885954082,38.2121770129816
8.7,"random_instances_SVM","SVM",96,5,3312,2963,349,600,525,75,0.935753930398812,0.582417582417582,1.7632981134356,163,75,88,33,1.2,15.34,7,0,0,0,0,0,0,0.766958792481642,424.851521755114,83.4610359231537
8.7,"random_instances_SVM","SVM",96,6,3212,2872,340,700,616,84,0.932034143984533,0.571428571428571,1.7632981134356,181,84,97,18,1.2,17.89,7.3,0,0,0,0,0,0,0.714465196151044,383.947558882484,79.0976816363026
8.7,"random_instances_SVM","SVM",96,7,3112,2784,328,800,704,96,0.929649268431692,0.554945054945055,1.75184156502838,201,96,105,20,1.1,20.45,7.3,0,0,0,0,0,0,0.517966881771655,337.892543788817,58.6014074528101
8.7,"random_instances_SVM","SVM",96,8,3012,2693,319,900,795,105,0.932105380527037,0.593406593406593,1.76152024770809,222,105,117,21,1.1,23.01,7.6,0,0,0,0,0,0,0.701637070051509,349.927754121773,77.0199112275745
8.7,"random_instances_SVM","SVM",96,9,2912,2602,310,1000,886,114,0.931859149869298,0.576923076923077,1.77803813833226,238,114,124,16,1.1,25.56,7.8,0,0,0,0,0,0,0.73129863880968,329.570275963416,79.8215096980749
8.7,"random_instances_SVM","SVM",96,10,2812,2521,291,1100,967,133,0.934248671283619,0.604395604395604,1.76978679094594,275,133,142,37,1.1,28.12,7.3,0,0,0,0,0,0,0.768380686323188,338.230867258477,83.2769340321479
8.7,"random_instances_SVM","SVM",96,11,2712,2429,283,1200,1059,141,0.935521637325462,0.598901098901099,1.77141642887499,292,141,151,17,1.1,30.67,7.5,0,0,0,0,0,0,0.778654255678984,338.404669421957,84.4831847765429
8.7,"random_instances_SVM","SVM",96,12,2612,2342,270,1300,1146,154,0.935518540084492,0.598901098901099,1.76653649380922,315,153,162,23,1.1,33.23,7.4,0,0,0,0,0,0,0.773860156089934,332.132718813961,84.0159438838827
8.7,"random_instances_SVM","SVM",96,13,2512,2254,258,1400,1234,166,0.935868528314976,0.598901098901099,1.76978679094594,327,160,167,12,1,35.79,7.4,0,0,0,0,0,0,0.773121854060154,311.706405849845,83.7624105234554
8.7,"random_instances_SVM","SVM",96,14,2412,2165,247,1500,1323,177,0.93639660790168,0.587912087912088,1.76491581812683,354,173,181,27,1,38.34,7.5,0,0,0,0,0,0,0.74175733652014,283.083137639561,81.4275745547781
8.7,"random_instances_SVM","SVM",96,15,2312,2078,234,1600,1410,190,0.937085744019227,0.587912087912088,1.76816014867485,379,186,193,25,1,40.9,7.4,0,0,0,0,0,0,0.720047697395714,278.797365403624,80.3043234948336
8.7,"random_instances_SVM","SVM",96,16,2212,1988,224,1700,1500,200,0.937122910910967,0.593406593406593,1.76491581812683,396,194,202,17,1,43.46,7.5,0,0,0,0,0,0,0.734507160583923,267.390463570619,81.4331389826118
8.7,"random_instances_SVM","SVM",96,17,2112,1898,214,1800,1590,210,0.937886380811974,0.598901098901099,1.77141642887499,415,205,210,19,1,46.01,7.6,0,0,0,0,0,0,0.730777382256366,254.817272610495,81.4206208339036
8.7,"random_instances_SVM","SVM",96,18,2012,1805,207,1900,1683,217,0.937931290806149,0.604395604395604,1.7632981134356,435,214,221,20,1,48.57,7.8,0,0,0,0,0,0,0.721480535518008,240.408554591396,81.3180179916702
8.7,"random_instances_SVM","SVM",96,19,1912,1719,193,2000,1769,231,0.937607629123984,0.604395604395604,1.76491581812683,467,229,238,32,1,51.12,7.7,0,0,0,0,0,0,0.682688607972321,227.147386458237,78.9705007264741
8.7,"random_instances_SVM","SVM",96,20,1812,1630,182,2100,1858,242,0.937993235625715,0.604395604395604,1.77640541276905,486,237,249,19,1.1,53.68,7.7,0,0,0,0,0,0,0.669632263710599,207.437343198229,78.942937388684
8.7,"random_instances_SVM","SVM",96,21,1712,1538,174,2200,1950,250,0.937891026673449,0.615384615384615,1.77967386799034,506,247,259,20,1,56.24,7.8,0,0,0,0,0,0,0.641185996188302,193.339237853089,77.9612680133431
8.7,"random_instances_SVM","SVM",96,22,1612,1451,161,2300,2037,263,0.938594100375383,0.60989010989011,1.77141642887499,533,259,274,27,1.1,58.79,7.7,0,0,0,0,0,0,0.658098681159272,189.148694005762,79.468169848305
8.7,"random_instances_SVM","SVM",96,23,1512,1358,154,2400,2130,270,0.939356021655904,0.620879120879121,1.76816014867485,551,270,281,18,1,61.35,7.9,0,0,0,0,0,0,0.589894601737949,170.914917852209,76.7472114126697
8.7,"random_instances_SVM","SVM",96,24,1412,1273,139,2500,2215,285,0.940799335951531,0.626373626373626,1.76653649380922,584,283,301,33,1.1,63.91,7.8,0,0,0,0,0,0,0.628599290109449,167.291736728356,79.0154452501065
8.7,"random_instances_SVM","SVM",96,25,1312,1185,127,2600,2303,297,0.941867884088848,0.631868131868132,1.76653649380922,607,295,312,23,1.1,66.46,7.8,0,0,0,0,0,0,0.617687629508139,156.363901828984,79.0052736931817
8.7,"random_instances_SVM","SVM",96,26,1212,1097,115,2700,2391,309,0.942059913029465,0.626373626373626,1.77141642887499,632,307,325,25,1.1,69.02,7.7,0,0,0,0,0,0,0.553509596838542,142.321748873654,76.1574356805098
8.7,"random_instances_SVM","SVM",96,27,1112,1003,109,2800,2485,315,0.941226755206456,0.626373626373626,1.76816014867485,650,314,336,18,1.1,71.57,7.9,0,0,0,0,0,0,0.543305811092742,133.341534101917,75.5700122350129
8.7,"random_instances_SVM","SVM",96,28,1012,913,99,2900,2575,325,0.940619695974825,0.626373626373626,1.77304907074492,663,323,340,13,1.1,74.13,7.9,0,0,0,0,0,0,0.507490620239259,121.967530906201,73.8376452025046
8.7,"random_instances_SVM","SVM",96,29,912,819,93,3000,2669,331,0.941643334117967,0.626373626373626,1.76816014867485,672,329,343,9,1,76.69,8.1,0,0,0,0,0,0,0.476487253920249,113.798542453828,71.7342229443685
8.7,"random_instances_SVM","SVM",96,30,812,732,80,3100,2756,344,0.941455951038814,0.626373626373626,1.77141642887499,691,339,352,19,1,79.24,8,0,0,0,0,0,0,0.358980554370048,98.8168285965153,65.415210967532
8.7,"random_instances_SVM","SVM",96,31,712,643,69,3200,2845,355,0.941081184880507,0.626373626373626,1.76653649380922,716,349,367,25,1.1,81.8,8,0,0,0,0,0,0,0.315428648829067,85.8683282422098,61.4737146376209
8.7,"random_instances_SVM","SVM",96,32,612,554,58,3300,2934,366,0.941805939269299,0.620879120879121,1.7632981134356,733,359,374,17,1,84.36,8,0,0,0,0,0,0,0.239846215235594,74.975356815942,58.1871534148923
8.7,"random_instances_SVM","SVM",96,33,512,465,47,3400,3023,377,0.94230924092818,0.631868131868132,1.76816014867485,754,369,385,21,1,86.91,8,0,0,0,0,0,0,0.180059201059002,64.7204923649243,53.7985887453975
8.7,"random_instances_SVM","SVM",96,34,412,373,39,3500,3115,385,0.941892662016674,0.626373626373626,1.76978679094594,768,375,393,14,1,89.47,8.1,0,0,0,0,0,0,0.10934695498462,54.661705058593,47.9472465500332
8.7,"random_instances_SVM","SVM",96,35,312,282,30,3600,3206,394,0.941558159991077,0.631868131868132,1.76653649380922,792,384,408,24,1.1,92.02,8.1,0,0,0,0,0,0,0.0617046005573631,42.0193920366524,38.9441363356803
8.7,"random_instances_SVM","SVM",96,36,212,191,21,3700,3297,403,0.942207031975908,0.637362637362637,1.77141642887499,816,394,422,24,1.1,94.58,8.2,0,0,0,0,0,0,0.0322729955994241,29.0339623122002,28.2655279794954
8.7,"random_instances_SVM","SVM",96,37,112,97,15,3800,3391,409,0.941747091690715,0.620879120879121,1.76978679094594,821,400,421,5,1.1,97.14,8.3,0,0,0,0,0,0,0.00105041297123302,15.9790221690643,15.9720682918089
8.7,"random_instances_SVM","SVM",96,38,12,10,2,3900,3478,422,0.940486514612779,0.626373626373626,1.77141642887499,842,412,430,21,1,99.69,8.2,0,0,0,0,0,0,0.00138766364710493,1.1833943090584,1.1833943090584
8.7,"random_instances_SVM","SVM",96,39,0,0,0,3912,3488,424,0.940553105293801,0.631868131868132,1.77141642887499,845,413,432,3,1,100,8.2,0,0,0,0,0,0,0,0,0
8.7,"random_instances_SVM","SVM",97,0,3812,3412,400,100,92,8,0.819646981763023,0.44949494949495,1.58424801005446,26,8,18,0,2.2,2.56,11.5,0,0,0,0,0,0,0.401973299866205,349.744387489009,52.6301469661184
8.7,"random_instances_SVM","SVM",97,1,3712,3328,384,200,176,24,0.891214476965333,0.535353535353535,1.71607620320856,52,24,28,26,1.2,5.11,7.3,0,0,0,0,0,0,0.747318615205154,435.091208792683,80.1050108397463
8.7,"random_instances_SVM","SVM",97,2,3612,3239,373,300,265,35,0.901075602440791,0.53030303030303,1.75239527629233,77,35,42,25,1.2,7.67,7.6,0,0,0,0,0,0,0.686467740895065,408.629801565469,74.0579711381575
8.7,"random_instances_SVM","SVM",97,3,3512,3148,364,400,356,44,0.900719366589669,0.54040404040404,1.74813573523251,97,44,53,20,1.2,10.22,8.1,0,0,0,0,0,0,0.720904504696973,399.987275552883,78.1866469943268
8.7,"random_instances_SVM","SVM",97,4,3412,3063,349,500,441,59,0.901000907826837,0.555555555555556,1.74011676396998,123,59,64,26,1.1,12.78,7.5,0,0,0,0,0,0,0.799553046018067,419.507209657742,84.844065653321
8.7,"random_instances_SVM","SVM",97,5,3312,2976,336,600,528,72,0.912799783960187,0.606060606060606,1.7417146673345,152,72,80,29,1.1,15.34,7.3,0,0,0,0,0,0,0.805964691722062,400.016925609584,85.6399501636272
8.7,"random_instances_SVM","SVM",97,6,3212,2883,329,700,621,79,0.914316659197204,0.611111111111111,1.74917987211565,169,79,90,17,1.1,17.89,7.9,0,0,0,0,0,0,0.634270963316809,350.654909025572,71.6087491986661
8.7,"random_instances_SVM","SVM",97,7,3112,2793,319,800,711,89,0.916324795164383,0.611111111111111,1.76568619281727,188,89,99,19,1.1,20.45,8,0,0,0,0,0,0,0.728221668044269,348.683206451164,80.2423140860287
8.7,"random_instances_SVM","SVM",97,8,3012,2704,308,900,800,100,0.911682237620799,0.606060606060606,1.75724060885351,207,100,107,19,1.1,23.01,8,0,0,0,0,0,0,0.77206988197018,341.989348404432,84.3752243464422
8.7,"random_instances_SVM","SVM",97,9,2912,2613,299,1000,891,109,0.913947495432133,0.606060606060606,1.75562252357832,224,108,116,17,1.1,25.56,8.2,0,0,0,0,0,0,0.776231643928734,332.369053596893,84.611797595025
8.7,"random_instances_SVM","SVM",97,10,2812,2525,287,1100,979,121,0.9157387297319,0.611111111111111,1.76309553678459,245,120,125,21,1,28.12,8.1,0,0,0,0,0,0,0.765337200450802,321.823772620624,83.9183728314516
8.7,"random_instances_SVM","SVM",97,11,2712,2436,276,1200,1068,132,0.91625297342021,0.611111111111111,1.74491929413733,269,130,139,24,1.1,30.67,8.1,0,0,0,0,0,0,0.73177878935264,304.426142248322,80.4907313283026
8.7,"random_instances_SVM","SVM",97,12,2612,2343,269,1300,1161,139,0.915376748141254,0.616161616161616,1.74011676396998,284,137,147,15,1.1,33.23,8.4,0,0,0,0,0,0,0.723261359168831,292.108856079497,80.3434590894496
8.7,"random_instances_SVM","SVM",97,13,2512,2255,257,1400,1249,151,0.916099274887668,0.611111111111111,1.74597624597625,303,146,157,19,1.1,35.79,8.3,0,0,0,0,0,0,0.706852717804467,276.150998608428,79.5902182858037
8.7,"random_instances_SVM","SVM",97,14,2412,2167,245,1500,1337,163,0.916775835717813,0.616161616161616,1.75400741546096,323,156,167,20,1.1,38.34,8.2,0,0,0,0,0,0,0.688020736681216,256.326536023621,78.1672798307554
8.7,"random_instances_SVM","SVM",97,15,2312,2078,234,1600,1426,174,0.920190241435972,0.616161616161616,1.77055481283422,351,168,183,28,1.1,40.9,8.2,0,0,0,0,0,0,0.703371055920628,251.834580710266,79.6971894765644
8.7,"random_instances_SVM","SVM",97,16,2212,1984,228,1700,1520,180,0.919925937417403,0.611111111111111,1.75824298026133,367,176,191,16,1.1,43.46,8.4,0,0,0,0,0,0,0.667516891964474,236.598842526347,77.0174563792356
8.7,"random_instances_SVM","SVM",97,17,2112,1894,218,1800,1610,190,0.920612553291728,0.616161616161616,1.74917987211565,386,185,201,19,1.1,46.01,8.5,0,0,0,0,0,0,0.672078158887775,229.553334954603,78.8723767040021
8.7,"random_instances_SVM","SVM",97,18,2012,1801,211,1900,1703,197,0.921790429896228,0.606060606060606,1.75824298026133,396,192,204,10,1.1,48.57,8.6,0,0,0,0,0,0,0.651834411009633,217.646638487532,77.9469156555985
8.7,"random_instances_SVM","SVM",97,19,1912,1707,205,2000,1797,203,0.922105009135723,0.616161616161616,1.74331550802139,410,199,211,14,1.1,51.12,8.9,0,0,0,0,0,0,0.689767713972088,216.232906640855,81.1865941861268
8.7,"random_instances_SVM","SVM",97,20,1812,1618,194,2100,1886,214,0.921720044586934,0.616161616161616,1.74813573523251,431,209,222,21,1.1,53.68,8.8,0,0,0,0,0,0,0.671746337819123,198.82935561551,79.483030114323
8.7,"random_instances_SVM","SVM",97,21,1712,1530,182,2200,1974,226,0.920711667298691,0.621212121212121,1.74491929413733,449,220,229,18,1,56.24,8.7,0,0,0,0,0,0,0.653502276660618,187.698595988309,78.400699873762
8.7,"random_instances_SVM","SVM",97,22,1612,1439,173,2300,2065,235,0.921254639684671,0.616161616161616,1.76634548247451,468,229,239,19,1,58.79,8.8,0,0,0,0,0,0,0.622974573849589,171.714631967363,76.226661650167
8.7,"random_instances_SVM","SVM",97,23,1512,1347,165,2400,2157,243,0.920726031647529,0.611111111111111,1.75985752845257,486,235,251,18,1.1,61.35,8.9,0,0,0,0,0,0,0.606590934668454,163.65020414008,75.4822368348065
8.7,"random_instances_SVM","SVM",97,24,1412,1263,149,2500,2241,259,0.922550303949621,0.616161616161616,1.77218365810822,508,249,259,22,1,63.91,8.7,0,0,0,0,0,0,0.581127025316289,151.906313180892,73.3006768008082
8.7,"random_instances_SVM","SVM",97,25,1312,1178,134,2600,2326,274,0.922525884556599,0.621212121212121,1.77055481283422,535,263,272,27,1,66.46,8.5,0,0,0,0,0,0,0.54343504279608,135.929321979998,70.7150396488926
8.7,"random_instances_SVM","SVM",97,26,1212,1088,124,2700,2416,284,0.922558922558919,0.626262626262626,1.76084427455543,553,272,281,18,1,69.02,8.5,0,0,0,0,0,0,0.532159739216431,127.296776333514,70.0284059979759
8.7,"random_instances_SVM","SVM",97,27,1112,997,115,2800,2507,293,0.922260144103144,0.621212121212121,1.77218365810822,574,282,292,21,1,71.57,8.6,0,0,0,0,0,0,0.490285457216966,117.502618838302,68.5091050171148
8.7,"random_instances_SVM","SVM",97,28,1012,910,102,2900,2594,306,0.922570414037988,0.611111111111111,1.75663139182846,602,294,308,28,1,74.13,8.5,0,0,0,0,0,0,0.435473665981214,105.146022274675,65.5197499510543
8.7,"random_instances_SVM","SVM",97,29,912,816,96,3000,2688,312,0.922439698463588,0.611111111111111,1.76730608840701,612,300,312,10,1,76.69,8.6,0,0,0,0,0,0,0.386186961087739,96.8492546186489,62.984520714879
8.7,"random_instances_SVM","SVM",97,30,812,731,81,3100,2773,327,0.923481113754147,0.616161616161616,1.7689289590116,641,313,328,29,1,79.24,8.5,0,0,0,0,0,0,0.31475452853158,86.3681951248073,60.8854655462945
8.7,"random_instances_SVM","SVM",97,31,712,644,68,3200,2860,340,0.923024327461182,0.611111111111111,1.77055481283422,664,325,339,23,1,81.8,8.4,0,0,0,0,0,0,0.241170236227075,75.2364271496238,56.4996054872717
8.7,"random_instances_SVM","SVM",97,32,612,552,60,3300,2952,348,0.923713816205279,0.611111111111111,1.7689289590116,681,333,348,17,1,84.36,8.5,0,0,0,0,0,0,0.20622216877564,69.3940221256722,53.8191335695054
8.7,"random_instances_SVM","SVM",97,33,512,461,51,3400,3043,357,0.924949150205116,0.631313131313131,1.77218365810822,703,344,359,22,1,86.91,8.5,0,0,0,0,0,0,0.131931314572724,60.1924364939365,50.5202578406967
8.7,"random_instances_SVM","SVM",97,34,412,369,43,3500,3135,365,0.925592673032938,0.626262626262626,1.7624552940198,721,353,368,18,1,89.47,8.6,0,0,0,0,0,0,0.0792420551662631,49.9467769954158,44.2239636136261
8.7,"random_instances_SVM","SVM",97,35,312,285,27,3600,3219,381,0.925362843451572,0.631313131313131,1.7689289590116,757,368,389,36,1.1,92.02,8.4,0,0,0,0,0,0,0.0519492075502436,33.6449208706717,30.6509910635439
8.7,"random_instances_SVM","SVM",97,36,212,191,21,3700,3313,387,0.925954654623589,0.631313131313131,1.77055481283422,766,376,390,9,1,94.58,8.6,0,0,0,0,0,0,0.033326808359555,23.1227829249646,22.3411942353184
8.7,"random_instances_SVM","SVM",97,37,112,99,13,3800,3405,395,0.925276657358561,0.626262626262626,1.7689289590116,788,385,403,22,1,97.14,8.6,0,0,0,0,0,0,0.000977398224749136,13.0005771399171,12.9948467681131
8.7,"random_instances_SVM","SVM",97,38,12,11,1,3900,3493,407,0.926319509084009,0.636363636363636,1.76730608840701,812,395,417,24,1.1,99.69,8.6,0,0,0,0,0,0,0.000813739002160868,0.45910449659024,0.45910449659024
8.7,"random_instances_SVM","SVM",97,39,0,0,0,3912,3504,408,0.926241941600298,0.636363636363636,1.7689289590116,816,398,418,4,1.1,100,8.6,0,0,0,0,0,0,0,0,0
8.7,"random_instances_SVM","SVM",98,0,3812,3394,418,100,90,10,0.911916558183037,0.539325842696629,1.76063070333354,25,10,15,0,1.5,2.56,9,0,0,0,0,0,0,0.663450197251427,384.11375887368,72.2488268248342
8.7,"random_instances_SVM","SVM",98,1,3712,3310,402,200,174,26,0.915513896437105,0.544943820224719,1.77759418374091,55,26,29,30,1.1,5.11,6.7,0,0,0,0,0,0,0.830644289271889,548.879383824622,86.2618123773713
8.7,"random_instances_SVM","SVM",98,2,3612,3216,396,300,268,32,0.915667142730754,0.550561797752809,1.77238129757158,69,32,37,14,1.2,7.67,8.4,0,0,0,0,0,0,0.859000981066966,463.008871849476,89.6658763215617
8.7,"random_instances_SVM","SVM",98,3,3512,3129,383,400,355,45,0.916376499285898,0.561797752808989,1.74729428288169,95,45,50,26,1.1,10.22,7.9,0,0,0,0,0,0,0.825009074152943,433.738689740133,87.7112571573524
8.7,"random_instances_SVM","SVM",98,4,3412,3039,373,500,445,55,0.90837767470077,0.573033707865168,1.73559909617111,119,55,64,24,1.2,12.78,8.1,0,0,0,0,0,0,0.853231649305381,455.738354146131,89.2100610530358
8.7,"random_instances_SVM","SVM",98,5,3312,2945,367,600,539,61,0.916340162535843,0.561797752808989,1.7622534044426,129,61,68,10,1.1,15.34,8.8,0,0,0,0,0,0,0.851253004395221,395.367907493204,89.1725112303316
8.7,"random_instances_SVM","SVM",98,6,3212,2856,356,700,628,72,0.922732270825687,0.561797752808989,1.7691202464261,151,72,79,22,1.1,17.89,8.7,0,0,0,0,0,0,0.787598565480668,380.641425533418,84.7180113151159
8.7,"random_instances_SVM","SVM",98,7,3112,2766,346,800,718,82,0.916384398579375,0.533707865168539,1.7691202464261,179,82,97,28,1.2,20.45,8.8,0,0,0,0,0,0,0.740793566639053,358.0796683957,82.3334315606697
8.7,"random_instances_SVM","SVM",98,8,3012,2675,337,900,809,91,0.908071182113454,0.550561797752809,1.76063070333354,197,91,106,18,1.2,23.01,8.9,0,0,0,0,0,0,0.76487140681215,336.686051381698,85.3367988461359
8.7,"random_instances_SVM","SVM",98,9,2912,2586,326,1000,898,102,0.907891078221947,0.561797752808989,1.74248962399201,218,102,116,21,1.1,25.56,8.8,0,0,0,0,0,0,0.745765384310273,326.70650053323,83.5410518004685
8.7,"random_instances_SVM","SVM",98,10,2812,2494,318,1100,990,110,0.90513896437102,0.567415730337079,1.75212551131362,238,110,128,20,1.2,28.12,9,0,0,0,0,0,0,0.700695717815637,288.489694368011,81.4617567743903
8.7,"random_instances_SVM","SVM",98,11,2712,2400,312,1200,1084,116,0.907079030851475,0.556179775280899,1.74890172932409,246,116,130,8,1.1,30.67,9.3,0,0,0,0,0,0,0.755051429410928,286.498422735056,85.1089377958157
8.7,"random_instances_SVM","SVM",98,12,2612,2309,303,1300,1175,125,0.909979651419975,0.573033707865168,1.77238129757158,270,125,145,24,1.2,33.23,9.4,0,0,0,0,0,0,0.710278916240788,277.746160923294,83.0416757422713
8.7,"random_instances_SVM","SVM",98,13,2512,2221,291,1400,1263,137,0.915733496796042,0.584269662921348,1.7622534044426,295,137,158,25,1.2,35.79,9.2,0,0,0,0,0,0,0.753361433740293,274.089873119433,85.6436981708815
8.7,"random_instances_SVM","SVM",98,14,2412,2132,280,1500,1352,148,0.917610368928595,0.578651685393258,1.76063070333354,315,148,167,20,1.1,38.34,9.1,0,0,0,0,0,0,0.749570670368612,273.102845124516,85.1321352695311
8.7,"random_instances_SVM","SVM",98,15,2312,2047,265,1600,1437,163,0.91892955094096,0.573033707865168,1.78086783785462,346,163,183,31,1.1,40.9,8.8,0,0,0,0,0,0,0.777676603088835,265.993802758628,86.9032652824985
8.7,"random_instances_SVM","SVM",98,16,2212,1956,256,1700,1528,172,0.920466753453556,0.573033707865168,1.76587117342991,363,172,191,17,1.1,43.46,8.9,0,0,0,0,0,0,0.741313741322721,248.737885473137,84.4680725052577
8.7,"random_instances_SVM","SVM",98,17,2112,1871,241,1800,1613,187,0.922343625586108,0.578651685393258,1.77238129757158,391,187,204,28,1.1,46.01,8.6,0,0,0,0,0,0,0.773968508345873,255.027579915677,86.7354376234619
8.7,"random_instances_SVM","SVM",98,18,2012,1781,231,1900,1703,197,0.922435257390563,0.578651685393258,1.7691202464261,411,197,214,20,1.1,48.57,8.6,0,0,0,0,0,0,0.734554250427829,242.136521932757,84.150826141302
8.7,"random_instances_SVM","SVM",98,19,1912,1691,221,2000,1793,207,0.923286801228479,0.584269662921348,1.76425110813318,430,206,224,19,1.1,51.12,8.7,0,0,0,0,0,0,0.73051921167207,225.583261003196,85.0674478409444
8.7,"random_instances_SVM","SVM",98,20,1812,1604,208,2100,1880,220,0.925361155698213,0.584269662921348,1.7691202464261,456,219,237,26,1.1,53.68,8.5,0,0,0,0,0,0,0.733673957887226,218.796077677314,85.3837340570313
8.7,"random_instances_SVM","SVM",98,21,1712,1517,195,2200,1967,233,0.927604555048575,0.573033707865168,1.76425110813318,478,232,246,22,1.1,56.24,8.4,0,0,0,0,0,0,0.709152415074222,207.786476209644,82.9701527950912
8.7,"random_instances_SVM","SVM",98,22,1612,1426,186,2300,2058,242,0.927631412646431,0.578651685393258,1.76749421678784,498,241,257,20,1.1,58.79,8.5,0,0,0,0,0,0,0.721959795675649,198.07593059323,84.2894283553872
8.7,"random_instances_SVM","SVM",98,23,1512,1342,170,2400,2142,258,0.929361357920122,0.567415730337079,1.76587117342991,532,255,277,34,1.1,61.35,8.3,0,0,0,0,0,0,0.679115677007992,186.470232520652,82.4577535639948
8.7,"random_instances_SVM","SVM",98,24,1412,1262,150,2500,2222,278,0.930347189747323,0.578651685393258,1.77074927059408,561,272,289,29,1.1,63.91,8,0,0,0,0,0,0,0.622670288381988,167.285714851563,77.5878554631876
8.7,"random_instances_SVM","SVM",98,25,1312,1167,145,2600,2317,283,0.930296634269007,0.584269662921348,1.77074927059408,579,279,300,18,1.1,66.46,8.2,0,0,0,0,0,0,0.661717651410237,161.533984041688,81.398965713768
8.7,"random_instances_SVM","SVM",98,26,1212,1076,136,2700,2408,292,0.929528822942051,0.584269662921348,1.77238129757158,595,287,308,16,1.1,69.02,8.2,0,0,0,0,0,0,0.643373643884171,149.408363368372,81.1612229866766
8.7,"random_instances_SVM","SVM",98,27,1112,986,126,2800,2498,302,0.932126110640642,0.584269662921348,1.77238129757158,617,298,319,22,1.1,71.57,8.3,0,0,0,0,0,0,0.529807451340139,134.84236584493,78.8095377290013
8.7,"random_instances_SVM","SVM",98,28,1012,900,112,2900,2584,316,0.932127690499338,0.578651685393258,1.77074927059408,643,312,331,26,1.1,74.13,8.2,0,0,0,0,0,0,0.458978228396288,119.557371113116,74.9243154926095
8.7,"random_instances_SVM","SVM",98,29,912,813,99,3000,2671,329,0.932675901467349,0.584269662921348,1.77238129757158,669,324,345,26,1.1,76.69,8.1,0,0,0,0,0,0,0.407845681721743,106.704793638818,72.4243934438625
8.7,"random_instances_SVM","SVM",98,30,812,724,88,3100,2760,340,0.934598589502133,0.584269662921348,1.77074927059408,686,335,351,17,1,79.24,8.1,0,0,0,0,0,0,0.31031215823651,93.5349691791165,66.286592171087
8.7,"random_instances_SVM","SVM",98,31,712,636,76,3200,2848,352,0.934781853111033,0.589887640449438,1.77074927059408,707,347,360,21,1,81.8,8.1,0,0,0,0,0,0,0.233302680114166,81.9279637249632,61.825787956637
8.7,"random_instances_SVM","SVM",98,32,612,547,65,3300,2937,363,0.934781853111034,0.589887640449438,1.76749421678784,721,355,366,14,1,84.36,8.1,0,0,0,0,0,0,0.17770342241313,69.5230632014658,55.4902272672839
8.7,"random_instances_SVM","SVM",98,33,512,457,55,3400,3027,373,0.93524791142678,0.589887640449438,1.76587117342991,740,365,375,19,1,86.91,8.1,0,0,0,0,0,0,0.141116456054736,59.5281465868344,49.349349840512
8.7,"random_instances_SVM","SVM",98,34,412,372,40,3500,3112,388,0.935713969742523,0.589887640449438,1.76101987899741,766,375,391,26,1,89.47,8,0,0,0,0,0,0,0.0783879675269482,46.2781656626287,40.5471993562464
8.7,"random_instances_SVM","SVM",98,35,312,281,31,3600,3203,397,0.934225742849538,0.595505617977528,1.76749421678784,783,384,399,17,1,92.02,8.1,0,0,0,0,0,0,0.0638290325745494,34.9456124117313,32.015515123597
8.7,"random_instances_SVM","SVM",98,36,212,189,23,3700,3295,405,0.934756575371876,0.589887640449438,1.76749421678784,797,391,406,14,1,94.58,8.1,0,0,0,0,0,0,0.0239667019923248,23.041477594059,22.3372819787052
8.7,"random_instances_SVM","SVM",98,37,112,99,13,3800,3385,415,0.934821349578471,0.584269662921348,1.7691202464261,814,400,414,17,1,97.14,8.2,0,0,0,0,0,0,0.00149731410999503,12.837993344053,12.8316329489143
8.7,"random_instances_SVM","SVM",98,38,12,10,2,3900,3474,426,0.935772424514329,0.584269662921348,1.77074927059408,833,411,422,19,1,99.69,8.2,0,0,0,0,0,0,0.000392952461203498,2.31610977673093,2.31610977673093
8.7,"random_instances_SVM","SVM",98,39,0,0,0,3912,3484,428,0.935608119209796,0.595505617977528,1.76587117342991,833,412,421,0,1,100,8.1,0,0,0,0,0,0,0,0,0
8.7,"random_instances_SVM","SVM",99,0,3812,3399,413,100,88,12,0.916414286825929,0.513812154696133,1.79449541284404,28,12,16,0,1.3,2.56,7.3,0,0,0,0,0,0,0.859865226713408,592.376844457125,89.1951503714325
8.7,"random_instances_SVM","SVM",99,1,3712,3315,397,200,172,28,0.916604155318656,0.524861878453039,1.78621980731473,57,27,30,29,1.1,5.11,6.1,0,0,0,0,0,0,0.847335151430945,562.318711314269,88.0789285329716
8.7,"random_instances_SVM","SVM",99,2,3612,3225,387,300,262,38,0.910596840712782,0.524861878453039,1.76130154757181,83,38,45,26,1.2,7.67,6.9,0,0,0,0,0,0,0.854757189424441,531.111932920015,88.9749014900583
8.7,"random_instances_SVM","SVM",99,3,3512,3138,374,400,349,51,0.914160765699171,0.513812154696133,1.78786155346116,108,51,57,25,1.1,10.22,6.8,0,0,0,0,0,0,0.854861049755497,520.824052665948,89.1941980532206
8.7,"random_instances_SVM","SVM",99,4,3412,3049,363,500,438,62,0.917909890280916,0.524861878453039,1.78131261004189,128,62,66,20,1.1,12.78,7.1,0,0,0,0,0,0,0.755160647355029,437.973467882654,81.134792890381
8.7,"random_instances_SVM","SVM",99,5,3312,2964,348,600,523,77,0.910480118278738,0.541436464088398,1.74813129671758,160,77,83,32,1.1,15.34,6.8,0,0,0,0,0,0,0.827526803847009,455.986320566408,87.6851454147958
8.7,"random_instances_SVM","SVM",99,6,3212,2883,329,700,604,96,0.912274531164894,0.546961325966851,1.75644947719282,191,91,100,31,1.1,17.89,6.3,0,0,0,0,0,0,0.821692665324894,425.610584738845,86.9030502054448
8.7,"random_instances_SVM","SVM",99,7,3112,2792,320,800,695,105,0.912395922496311,0.546961325966851,1.76637292056679,207,99,108,16,1.1,20.45,6.6,0,0,0,0,0,0,0.835128548708642,412.680148185932,87.8755577165561
8.7,"random_instances_SVM","SVM",99,8,3012,2698,314,900,789,111,0.909893393510236,0.552486187845304,1.75644947719282,227,110,117,20,1.1,23.01,7.1,0,0,0,0,0,0,0.808249204074226,369.366736445383,86.6308444978279
8.7,"random_instances_SVM","SVM",99,9,2912,2606,306,1000,881,119,0.913015329546344,0.541436464088398,1.76962291674079,245,118,127,18,1.1,25.56,7.4,0,0,0,0,0,0,0.783636122109467,354.026283938197,86.8270721270545
8.7,"random_instances_SVM","SVM",99,10,2812,2512,300,1100,975,125,0.913438642907172,0.552486187845304,1.75644947719282,260,125,135,15,1.1,28.12,7.8,0,0,0,0,0,0,0.741827580718783,316.101337286465,84.2999140929015
8.7,"random_instances_SVM","SVM",99,11,2712,2419,293,1200,1068,132,0.911963271340757,0.552486187845304,1.76130154757181,276,131,145,16,1.1,30.67,8.1,0,0,0,0,0,0,0.786251356738554,308.757415758852,88.301054532675
8.7,"random_instances_SVM","SVM",99,12,2612,2327,285,1300,1160,140,0.913357715352896,0.541436464088398,1.76313484005246,293,140,153,17,1.1,33.23,8.3,0,0,0,0,0,0,0.772231102810196,297.539436018854,87.0250380748919
8.7,"random_instances_SVM","SVM",99,13,2512,2238,274,1400,1249,151,0.918921484709365,0.546961325966851,1.78786155346116,315,151,164,22,1.1,35.79,8.3,0,0,0,0,0,0,0.765585945352411,280.772683494583,86.0031927481794
8.7,"random_instances_SVM","SVM",99,14,2412,2149,263,1500,1338,162,0.915548984514826,0.552486187845304,1.75968121496135,336,162,174,21,1.1,38.34,8.3,0,0,0,0,0,0,0.737212226465225,251.282255130269,86.4217896691742
8.7,"random_instances_SVM","SVM",99,15,2312,2053,259,1600,1434,166,0.914487588514517,0.546961325966851,1.76292486697049,344,166,178,8,1.1,40.9,8.6,0,0,0,0,0,0,0.719511451789264,239.288710573944,85.1393880984738
8.7,"random_instances_SVM","SVM",99,16,2212,1961,251,1700,1526,174,0.915217492802123,0.56353591160221,1.77125240377278,364,174,190,20,1.1,43.46,8.8,0,0,0,0,0,0,0.686382588267668,231.420943085933,83.5657842853375
8.7,"random_instances_SVM","SVM",99,17,2112,1872,240,1800,1615,185,0.919337016574591,0.56353591160221,1.75968121496135,391,185,206,27,1.1,46.01,8.7,0,0,0,0,0,0,0.728259255400333,228.227522309153,86.3456267998201
8.7,"random_instances_SVM","SVM",99,18,2012,1784,228,1900,1703,197,0.919673177184659,0.558011049723757,1.75806386090348,417,197,220,26,1.1,48.57,8.6,0,0,0,0,0,0,0.755208228138591,227.177599459313,87.3396017604993
8.7,"random_instances_SVM","SVM",99,19,1912,1694,218,2000,1793,207,0.91988172126683,0.558011049723757,1.76292486697049,438,207,231,21,1.1,51.12,8.7,0,0,0,0,0,0,0.641199297955195,205.029741110084,79.1250790988608
8.7,"random_instances_SVM","SVM",99,20,1812,1607,205,2100,1880,220,0.922211501050506,0.569060773480663,1.76475239495159,452,220,232,14,1.1,53.68,8.5,0,0,0,0,0,0,0.693672867412708,204.012264420841,83.6908295587461
8.7,"random_instances_SVM","SVM",99,21,1712,1517,195,2200,1970,230,0.923451871449698,0.558011049723757,1.76962291674079,476,230,246,24,1.1,56.24,8.6,0,0,0,0,0,0,0.686683766748335,188.678810994042,83.3190177953568
8.7,"random_instances_SVM","SVM",99,22,1612,1427,185,2300,2060,240,0.924774725702281,0.552486187845304,1.76962291674079,494,240,254,18,1.1,58.79,8.6,0,0,0,0,0,0,0.686126948841464,176.753569831777,82.9614842252789
8.7,"random_instances_SVM","SVM",99,23,1512,1340,172,2400,2147,253,0.927488911368766,0.558011049723757,1.76637292056679,519,253,266,25,1.1,61.35,8.5,0,0,0,0,0,0,0.638052165575694,164.831895926372,79.1949518835882
8.7,"random_instances_SVM","SVM",99,24,1412,1255,157,2500,2232,268,0.927081160999146,0.552486187845304,1.76962291674079,546,265,281,27,1.1,63.91,8.3,0,0,0,0,0,0,0.620996721981968,154.907576616449,78.8537987515503
8.7,"random_instances_SVM","SVM",99,25,1312,1171,141,2600,2316,284,0.928209477861646,0.558011049723757,1.77125240377278,567,279,288,21,1,66.46,8.2,0,0,0,0,0,0,0.544836655526231,139.338526657175,73.8053830088294
8.7,"random_instances_SVM","SVM",99,26,1212,1082,130,2700,2405,295,0.92483386506887,0.552486187845304,1.75990860978704,596,291,305,29,1,69.02,8.2,0,0,0,0,0,0,0.525637342450916,132.126652135635,73.420229061418
8.7,"random_instances_SVM","SVM",99,27,1112,994,118,2800,2493,307,0.926377713796593,0.558011049723757,1.78284492196451,619,302,317,23,1,71.57,8.1,0,0,0,0,0,0,0.487530734211407,120.491667249202,70.8043381592657
8.7,"random_instances_SVM","SVM",99,28,1012,908,104,2900,2579,321,0.925437709127697,0.558011049723757,1.77956461852023,648,314,334,29,1.1,74.13,8,0,0,0,0,0,0,0.429547844930329,107.881789943673,66.1355072989291
8.7,"random_instances_SVM","SVM",99,29,912,822,90,3000,2665,335,0.924752937514591,0.558011049723757,1.78284492196451,659,322,337,11,1,76.69,8,0,0,0,0,0,0,0.360675653387013,94.2499684657145,62.8930357158798
8.7,"random_instances_SVM","SVM",99,30,812,732,80,3100,2755,345,0.925517080382851,0.552486187845304,1.76799642508937,679,331,348,20,1.1,79.24,8,0,0,0,0,0,0,0.308654525583287,82.7308932080444,58.9590089959406
8.7,"random_instances_SVM","SVM",99,31,712,640,72,3200,2847,353,0.927036028324644,0.558011049723757,1.76799642508937,701,340,361,22,1.1,81.8,8.1,0,0,0,0,0,0,0.215110056044661,74.1431482362199,56.4111937217209
8.7,"random_instances_SVM","SVM",99,32,612,552,60,3300,2935,365,0.927585401914248,0.552486187845304,1.76962291674079,712,347,365,11,1.1,84.36,8,0,0,0,0,0,0,0.165289346784351,62.2608055893645,49.9828422022703
8.7,"random_instances_SVM","SVM",99,33,512,460,52,3400,3027,373,0.928117656213524,0.546961325966851,1.76637292056679,729,355,374,17,1.1,86.91,8.1,0,0,0,0,0,0,0.127035823946629,55.0537262755024,46.3199185248026
8.7,"random_instances_SVM","SVM",99,34,412,368,44,3500,3119,381,0.928397790055249,0.552486187845304,1.77125240377278,741,361,380,12,1.1,89.47,8.2,0,0,0,0,0,0,0.088057077594247,47.5252670009053,41.9944814871869
8.7,"random_instances_SVM","SVM",99,35,312,277,35,3600,3210,390,0.927877986148938,0.552486187845304,1.77141642887499,756,372,384,15,1,92.02,8.2,0,0,0,0,0,0,0.0560244652826493,37.5522897343298,34.7999924822676
8.7,"random_instances_SVM","SVM",99,36,212,188,24,3700,3299,401,0.929272430161075,0.56353591160221,1.77792898927527,776,381,395,20,1,94.58,8.2,0,0,0,0,0,0,0.0211931840038201,25.2561100172007,24.6092612935191
8.7,"random_instances_SVM","SVM",99,37,112,95,17,3800,3392,408,0.930218660026456,0.56353591160221,1.77792898927527,799,390,409,23,1,97.14,8.3,0,0,0,0,0,0,0.00223644228923211,16.4362048610994,16.423459725133
8.7,"random_instances_SVM","SVM",99,38,12,11,1,3900,3476,424,0.930724457240681,0.580110497237569,1.77466673424908,821,401,420,22,1,99.69,8.2,0,0,0,0,0,0,0.000682109411610287,1.27774175573672,1.27774175573672
8.7,"random_instances_SVM","SVM",99,39,0,0,0,3912,3487,425,0.930903431639561,0.574585635359116,1.77956461852023,820,403,417,-1,1,100,8.2,0,0,0,0,0,0,0,0,0
8.7,"random_instances_SVM","SVM",100,0,3812,3428,384,100,91,9,0.827678251571006,0.300469483568075,1.65888232621536,33,9,24,0,2.7,2.56,10.1,0,0,0,0,0,0,0.178122064453556,321.136991135032,27.9968177392736
8.7,"random_instances_SVM","SVM",100,1,3712,3343,369,200,176,24,0.885214903881123,0.553990610328638,1.69339707972606,65,24,41,32,1.7,5.11,7.3,0,0,0,0,0,0,0.823783345804128,503.193429993969,88.5373218449794
8.7,"random_instances_SVM","SVM",100,2,3612,3253,359,300,266,34,0.907730182971999,0.582159624413146,1.72659180891802,84,34,50,19,1.5,7.67,7.8,0,0,0,0,0,0,0.418478955047039,426.599417365857,48.4894836649302
8.7,"random_instances_SVM","SVM",100,3,3512,3162,350,400,357,43,0.918915097007743,0.619718309859155,1.75882551293025,101,43,58,17,1.3,10.22,8.3,0,0,0,0,0,0,0.63704323060109,411.828896140207,70.1463743739839
8.7,"random_instances_SVM","SVM",100,4,3412,3072,340,500,447,53,0.920866564850958,0.619718309859155,1.76403272576636,120,53,67,19,1.3,12.78,8.4,0,0,0,0,0,0,0.800168148695586,408.314417140839,86.2277252778766
8.7,"random_instances_SVM","SVM",100,5,3312,2981,331,600,538,62,0.925984285902845,0.624413145539906,1.77573729670843,140,62,78,20,1.3,15.34,8.7,0,0,0,0,0,0,0.601385173505369,353.421175311864,69.1447064838296
8.7,"random_instances_SVM","SVM",100,6,3212,2894,318,700,625,75,0.927581553578505,0.615023474178404,1.76598049837486,167,75,92,27,1.2,17.89,8.3,0,0,0,0,0,0,0.711357939886806,369.241980611868,78.9339909992155
8.7,"random_instances_SVM","SVM",100,7,3112,2800,312,800,719,81,0.920805960259554,0.60093896713615,1.77247307373654,181,81,100,14,1.2,20.45,8.9,0,0,0,0,0,0,0.665294898046931,336.082918164394,75.5082557884829
8.7,"random_instances_SVM","SVM",100,8,3012,2706,306,900,813,87,0.917494256031513,0.591549295774648,1.76891023560719,200,87,113,19,1.3,23.01,9.3,0,0,0,0,0,0,0.608444772671586,297.891686430829,73.0806225904391
8.7,"random_instances_SVM","SVM",100,9,2912,2614,298,1000,905,95,0.918218817590968,0.586854460093897,1.77737392094502,220,95,125,20,1.3,25.56,9.5,0,0,0,0,0,0,0.558917136877725,264.091017616076,70.4149822441297
8.7,"random_instances_SVM","SVM",100,10,2812,2524,288,1100,995,105,0.922078656679036,0.596244131455399,1.76241286100441,243,105,138,23,1.3,28.12,9.5,0,0,0,0,0,0,0.551312176481772,269.574387511789,69.911566806086
8.7,"random_instances_SVM","SVM",100,11,2712,2443,269,1200,1076,124,0.933294546394843,0.63849765258216,1.77247307373654,274,124,150,31,1.2,30.67,8.7,0,0,0,0,0,0,0.719904575799229,310.014916547849,81.6649879849996
8.7,"random_instances_SVM","SVM",100,12,2612,2349,263,1300,1170,130,0.935058813389045,0.647887323943662,1.77410368373997,283,130,153,9,1.2,33.23,9,0,0,0,0,0,0,0.701314984599077,284.947127871326,80.2733168531695
8.7,"random_instances_SVM","SVM",100,13,2512,2260,252,1400,1259,141,0.934091833463979,0.647887323943662,1.76241286100441,302,141,161,19,1.1,35.79,8.9,0,0,0,0,0,0,0.732825650100391,283.778230762798,82.2118056535268
8.7,"random_instances_SVM","SVM",100,14,2412,2168,244,1500,1351,149,0.933957156594196,0.63849765258216,1.76728140481934,316,149,167,14,1.1,38.34,9.1,0,0,0,0,0,0,0.710443362707273,263.994151774874,80.8782107667237
8.7,"random_instances_SVM","SVM",100,15,2312,2078,234,1600,1441,159,0.93450394468553,0.652582159624413,1.75720745818055,337,159,178,21,1.1,40.9,9.1,0,0,0,0,0,0,0.680543062095485,249.28180243356,78.9370531688812
8.7,"random_instances_SVM","SVM",100,16,2212,1987,225,1700,1532,168,0.934988781416758,0.661971830985915,1.75076490104698,360,168,192,23,1.1,43.46,9.1,0,0,0,0,0,0,0.696636818273898,238.389272346045,80.41983494349
8.7,"random_instances_SVM","SVM",100,17,2112,1900,212,1800,1619,181,0.935403586175702,0.661971830985915,1.75559237779619,381,181,200,21,1.1,46.01,8.9,0,0,0,0,0,0,0.687782664153243,227.785595261915,80.0026711165347
8.7,"random_instances_SVM","SVM",100,18,2012,1812,200,1900,1707,193,0.937359094324997,0.657276995305164,1.76403272576636,409,193,216,28,1.1,48.57,8.8,0,0,0,0,0,0,0.722998733317881,235.16446523084,82.0300206846412
8.7,"random_instances_SVM","SVM",100,19,1912,1722,190,2000,1797,203,0.935031878015093,0.652582159624413,1.76403272576636,437,203,234,28,1.2,51.12,8.9,0,0,0,0,0,0,0.72406877112353,223.708419034776,82.4396039250162
8.7,"random_instances_SVM","SVM",100,20,1812,1632,180,2100,1887,213,0.933773996051285,0.647887323943662,1.76565557096026,452,213,239,15,1.1,53.68,8.9,0,0,0,0,0,0,0.709059500314754,213.122763181771,82.5416126965223
8.7,"random_instances_SVM","SVM",100,21,1712,1537,175,2200,1982,218,0.934388122577509,0.647887323943662,1.77084545842548,464,218,246,12,1.1,56.24,9.1,0,0,0,0,0,0,0.650947310864,195.534335440114,78.3877197913836
8.7,"random_instances_SVM","SVM",100,22,1612,1443,169,2300,2076,224,0.93387904400972,0.657276995305164,1.76891023560719,476,224,252,12,1.1,58.79,9.3,0,0,0,0,0,0,0.692901238793171,188.916860660951,82.7216718250904
8.7,"random_instances_SVM","SVM",100,23,1512,1350,162,2400,2169,231,0.934180720198042,0.671361502347418,1.76241286100441,490,231,259,14,1.1,61.35,9.4,0,0,0,0,0,0,0.670237845168894,175.394544816217,81.6944824032572
8.7,"random_instances_SVM","SVM",100,24,1412,1264,148,2500,2255,245,0.933367271904527,0.661971830985915,1.76891023560719,518,245,273,28,1.1,63.91,9.2,0,0,0,0,0,0,0.61086970603684,162.567076297475,79.5419324288929
8.7,"random_instances_SVM","SVM",100,25,1312,1174,138,2600,2345,255,0.933237982109525,0.671361502347418,1.75882551293025,541,255,286,23,1.1,66.46,9.2,0,0,0,0,0,0,0.62264044168281,148.58220949461,79.8534103195221
8.7,"random_instances_SVM","SVM",100,26,1212,1082,130,2700,2437,263,0.933283772245252,0.666666666666667,1.76044655026936,558,263,295,17,1.1,69.02,9.3,0,0,0,0,0,0,0.621506960154066,141.661002096668,81.4787210635556
8.7,"random_instances_SVM","SVM",100,27,1112,994,118,2800,2525,275,0.933308014081815,0.657276995305164,1.77410368373997,580,275,305,22,1.1,71.57,9.2,0,0,0,0,0,0,0.507199958294221,125.969052981409,75.7701892075682
8.7,"random_instances_SVM","SVM",100,28,1012,906,106,2900,2613,287,0.932147099464259,0.647887323943662,1.76565557096026,602,287,315,22,1.1,74.13,9.1,0,0,0,0,0,0,0.458213571680561,113.819136963909,73.5480669981073
8.7,"random_instances_SVM","SVM",100,29,912,827,85,3000,2692,308,0.934524146215985,0.671361502347418,1.75237110737821,638,308,330,36,1.1,76.69,8.7,0,0,0,0,0,0,0.403682628467915,103.45946615574,72.8934974516938
8.7,"random_instances_SVM","SVM",100,30,812,733,79,3100,2786,314,0.934724814751974,0.666666666666667,1.75720745818055,651,314,337,13,1.1,79.24,8.9,0,0,0,0,0,0,0.291123926172017,86.4105368041227,63.6055384061749
8.7,"random_instances_SVM","SVM",100,31,712,643,69,3200,2876,324,0.935802229710263,0.661971830985915,1.76403272576636,673,324,349,22,1.1,81.8,8.9,0,0,0,0,0,0,0.270131806088067,81.8183946258464,64.5251141708886
8.7,"random_instances_SVM","SVM",100,32,612,555,57,3300,2964,336,0.937236538373479,0.666666666666667,1.74916163648558,698,336,362,25,1.1,84.36,8.8,0,0,0,0,0,0,0.172101852805088,68.6753492340176,57.4007477893709
8.7,"random_instances_SVM","SVM",100,33,512,459,53,3400,3060,340,0.935969229028798,0.666666666666667,1.75237110737821,709,340,369,11,1.1,86.91,9,0,0,0,0,0,0,0.127811279521701,59.8089102966042,51.469111600107
8.7,"random_instances_SVM","SVM",100,34,412,367,45,3500,3152,348,0.936946983103441,0.666666666666667,1.76044655026936,728,348,380,19,1.1,89.47,9.1,0,0,0,0,0,0,0.0883872248107103,50.9631176409927,45.7793751729665
8.7,"random_instances_SVM","SVM",100,35,312,278,34,3600,3241,359,0.93720556269343,0.671361502347418,1.75882551293025,745,359,386,17,1.1,92.02,9,0,0,0,0,0,0,0.0604997142552479,38.6121559819129,35.8908070042518
8.7,"random_instances_SVM","SVM",100,36,212,190,22,3700,3329,371,0.938204865067246,0.676056338028169,1.74756130561963,769,371,398,24,1.1,94.58,9,0,0,0,0,0,0,0.0235388313990598,28.9109145933233,28.3933697504946
8.7,"random_instances_SVM","SVM",100,37,112,98,14,3800,3421,379,0.937927430715478,0.676056338028169,1.75559237779619,778,379,399,9,1.1,97.14,9,0,0,0,0,0,0,0.000772616804404807,16.6970409509179,16.6920252209042
8.7,"random_instances_SVM","SVM",100,38,12,11,1,3900,3508,392,0.937373908780657,0.666666666666667,1.75559237779619,801,392,409,23,1,99.69,8.9,0,0,0,0,0,0,0.00115899746022021,2.32855849263203,2.32855849263203
8.7,"random_instances_SVM","SVM",100,39,0,0,0,3912,3519,393,0.937111288884578,0.666666666666667,1.75237110737821,805,393,412,4,1,100,9,0,0,0,0,0,0,0,0,0
8.7,"random_policy_SVM","SVM",1,0,3812,3438,374,100,92,8,0.891300313427912,0.540178571428571,1.76398863933142,23,8,15,0,1.9,2.56,11.5,0,0,0,0,0,0,0.649057055194634,442.015649889589,76.7469440673465
8.7,"random_policy_SVM","SVM",1,1,3712,3380,332,200,150,50,0.904499855658217,0.584821428571429,1.71311794472557,105,50,55,82,1.1,5.11,3,0,0,0,0,0,0,0.762198399907512,581.26059373573,82.6553852802559
8.7,"random_policy_SVM","SVM",1,2,3612,3332,280,300,198,102,0.929940098152437,0.620535714285714,1.77684300117847,190,92,98,85,1.1,7.67,1.9,0,0,0,0,0,0,0.63835995377174,345.15834603476,73.3285202043099
8.7,"random_policy_SVM","SVM",1,3,3512,3291,221,400,239,161,0.909500268063335,0.625,1.7159582841401,258,129,129,68,1,10.22,1.5,0,0,0,0,0,0,0.479574800916418,278.011297682412,65.9195232225332
8.7,"random_policy_SVM","SVM",1,4,3412,3254,158,500,276,224,0.918012568046857,0.660714285714286,1.71753545168067,330,163,167,72,1,12.78,1.2,0,0,0,0,0,0,0.354069609329274,232.065663290385,52.6801178692519
8.7,"random_policy_SVM","SVM",1,5,3312,3200,112,600,330,270,0.910997814252718,0.665178571428571,1.70304902089631,420,208,212,90,1,15.34,1.2,0,0,0,0,0,0,0.200055430173097,147.195311716909,31.4998143768525
8.7,"random_policy_SVM","SVM",1,6,3212,3131,81,700,399,301,0.886736792725181,0.674107142857143,1.61617008681926,485,237,248,65,1,17.89,1.3,0,0,0,0,0,0,0.134900697174788,162.230438549311,18.849823097433
8.7,"random_policy_SVM","SVM",1,7,3112,3049,63,800,481,319,0.882432314005288,0.683035714285714,1.59714745273109,536,256,280,51,1.1,20.45,1.5,0,0,0,0,0,0,0.0965229250006821,141.972515980547,11.6295174797747
8.7,"random_policy_SVM","SVM",1,8,3012,2959,53,900,571,329,0.880970853266256,0.683035714285714,1.58912158613445,570,270,300,34,1.1,23.01,1.7,0,0,0,0,0,0,0.073714922224468,120.998307703231,8.60348783402539
8.7,"random_policy_SVM","SVM",1,9,2912,2867,45,1000,663,337,0.894933345018161,0.678571428571429,1.65637332280979,593,284,309,23,1.1,25.56,2,0,0,0,0,0,0,0.0678455781827698,111.137288182419,7.63864043898289
8.7,"random_policy_SVM","SVM",1,10,2812,2775,37,1100,755,345,0.91060860689543,0.674107142857143,1.70304902089631,616,296,320,23,1.1,28.12,2.2,0,0,0,0,0,0,0.0682491415508017,90.1971502890775,7.54499332860808
8.7,"random_policy_SVM","SVM",1,11,2712,2680,32,1200,850,350,0.919235607060389,0.678571428571429,1.73838051349572,632,303,329,16,1.1,30.67,2.4,0,0,0,0,0,0,0.0702997636894358,75.3539505477863,7.6996959331923
8.7,"random_policy_SVM","SVM",1,12,2612,2581,31,1300,949,351,0.919868391207535,0.669642857142857,1.72873914759274,640,307,333,8,1.1,33.23,2.7,0,0,0,0,0,0,0.056802928831174,56.40509944539,6.05897964486319
8.7,"random_policy_SVM","SVM",1,13,2512,2486,26,1400,1044,356,0.918740720884205,0.665178571428571,1.71911552109344,660,312,348,20,1.1,35.79,2.9,0,0,0,0,0,0,0.0584533317866042,51.3404141899358,6.43448999332646
8.7,"random_policy_SVM","SVM",1,14,2412,2390,22,1500,1140,360,0.918980431375788,0.665178571428571,1.72714877119201,672,317,355,12,1.1,38.34,3.2,0,0,0,0,0,0,0.0526347011838273,46.5935169962668,5.96763008390985
8.7,"random_policy_SVM","SVM",1,15,2312,2296,16,1600,1234,366,0.919828439458926,0.665178571428571,1.73033245556287,684,323,361,12,1.1,40.9,3.4,0,0,0,0,0,0,0.040030698092729,39.373281288948,4.8071389200624
8.7,"random_policy_SVM","SVM",1,16,2212,2201,11,1700,1329,371,0.9204032291323,0.665178571428571,1.72873914759274,690,329,361,6,1.1,43.46,3.6,0,0,0,0,0,0,0.0329015283424117,35.455034457756,3.67506667394055
8.7,"random_policy_SVM","SVM",1,17,2112,2103,9,1800,1427,373,0.920864607390301,0.665178571428571,1.73033245556287,702,332,370,12,1.1,46.01,3.8,0,0,0,0,0,0,0.0304096730726063,31.0839510007742,3.10985293840048
8.7,"random_policy_SVM","SVM",1,18,2012,2003,9,1900,1527,373,0.922424014351722,0.65625,1.74321527138914,721,347,374,19,1.1,48.57,4.1,0,0,0,0,0,0,0.0203130894373183,14.5583392961528,2.67344675313987
8.7,"random_policy_SVM","SVM",1,19,1912,1904,8,2000,1626,374,0.922627639392963,0.65625,1.74963891806723,720,348,372,-1,1.1,51.12,4.3,0,0,0,0,0,0,0.0148481854124092,12.4671643173886,1.73894055086
8.7,"random_policy_SVM","SVM",1,20,1812,1805,7,2100,1725,375,0.922648259650304,0.665178571428571,1.74321527138914,728,349,379,8,1.1,53.68,4.6,0,0,0,0,0,0,0.0120001134147111,10.1801939247817,1.32032921762203
8.7,"random_policy_SVM","SVM",1,21,1712,1705,7,2200,1825,375,0.922516805509756,0.660714285714286,1.74642857142857,728,349,379,0,1.1,56.24,4.9,0,0,0,0,0,0,0.0107635944604599,8.95016454514266,1.14626928300836
8.7,"random_policy_SVM","SVM",1,22,1612,1605,7,2300,1925,375,0.922395661497878,0.65625,1.75928177158628,733,351,382,5,1.1,58.79,5.1,0,0,0,0,0,0,0.0089577250061479,6.61993412729401,0.911407452704908
8.7,"random_policy_SVM","SVM",1,23,1512,1506,6,2400,2024,376,0.922975606235584,0.65625,1.77057274522712,743,362,381,10,1.1,61.35,5.4,0,0,0,0,0,0,0.00649792600469449,4.1619283642749,0.772176304986149
8.7,"random_policy_SVM","SVM",1,24,1412,1407,5,2500,2123,377,0.922723008083159,0.65625,1.76731502168485,743,362,381,0,1.1,63.91,5.6,0,0,0,0,0,0,0.00578972890956122,3.72120007012876,0.616359198361493
8.7,"random_policy_SVM","SVM",1,25,1312,1308,4,2600,2222,378,0.923055509732779,0.65625,1.76245085190039,752,367,385,9,1,66.46,5.9,0,0,0,0,0,0,0.00514604592728366,3.05136060961948,0.545889436033597
8.7,"random_policy_SVM","SVM",1,26,1212,1209,3,2700,2321,379,0.923220471791506,0.65625,1.76731502168485,757,368,389,5,1.1,69.02,6.1,0,0,0,0,0,0,0.00494391054913925,2.6287202328022,0.517393672313177
8.7,"random_policy_SVM","SVM",1,27,1112,1109,3,2800,2421,379,0.923529775651619,0.665178571428571,1.7656906512605,763,370,393,6,1.1,71.57,6.4,0,0,0,0,0,0,0.00375682320684739,1.76284697935537,0.400548937084847
8.7,"random_policy_SVM","SVM",1,28,1012,1009,3,2900,2521,379,0.923591636423642,0.660714285714286,1.76406926406926,763,370,393,0,1.1,74.13,6.7,0,0,0,0,0,0,0.00320464510131596,1.28720289430758,0.340875612391437
8.7,"random_policy_SVM","SVM",1,29,912,910,2,3000,2620,380,0.923742422055445,0.65625,1.76245085190039,768,373,395,5,1.1,76.69,6.9,0,0,0,0,0,0,0.00269989280373739,0.986887541667598,0.300758929738651
8.7,"random_policy_SVM","SVM",1,30,812,810,2,3100,2720,380,0.923784951336211,0.65625,1.76245085190039,770,373,397,2,1.1,79.24,7.2,0,0,0,0,0,0,0.00228105952801082,0.711903543970625,0.248632185867415
8.7,"random_policy_SVM","SVM",1,31,712,710,2,3200,2820,380,0.923975688716613,0.651785714285714,1.76406926406926,770,373,397,0,1.1,81.8,7.4,0,0,0,0,0,0,0.00157175550088136,0.462115975003679,0.191890152074755
8.7,"random_policy_SVM","SVM",1,32,612,610,2,3300,2920,380,0.924245040828127,0.651785714285714,1.76894238358327,771,374,397,1,1.1,84.36,7.7,0,0,0,0,0,0,0.000810677232199273,0.256167213048523,0.115149257656254
8.7,"random_policy_SVM","SVM",1,33,512,511,1,3400,3019,381,0.924837873226674,0.647321428571429,1.76894238358327,779,377,402,8,1.1,86.91,7.9,0,0,0,0,0,0,0.00060978112052164,0.185608441812659,0.0822212232897105
8.7,"random_policy_SVM","SVM",1,34,412,412,0,3500,3118,382,0.925993896403841,0.638392857142857,1.77057274522712,783,379,404,4,1.1,89.47,8.2,0,0,0,0,0,0,0.000442128301193204,0.126326862871871,0.0575888436927116
8.7,"random_policy_SVM","SVM",1,35,312,312,0,3600,3218,382,0.926566108545048,0.638392857142857,1.76245085190039,785,380,405,2,1.1,92.02,8.4,0,0,0,0,0,0,0.000211573863007026,0.0511327294111464,0.0268852353242491
8.7,"random_policy_SVM","SVM",1,36,212,212,0,3700,3318,382,0.927287817551975,0.638392857142857,1.77057274522712,785,381,404,0,1.1,94.58,8.7,0,0,0,0,0,0,0.000100415086523829,0.0215151843043877,0.0141339703324345
8.7,"random_policy_SVM","SVM",1,37,112,112,0,3800,3418,382,0.928160312190707,0.638392857142857,1.76894238358327,783,381,402,-2,1.1,97.14,8.9,0,0,0,0,0,0,2.37543985928153e-05,0.00489797967992374,0.00464197703045
8.7,"random_policy_SVM","SVM",1,38,12,12,0,3900,3518,382,0.928617824150455,0.638392857142857,1.76731502168485,785,382,403,2,1.1,99.69,9.2,0,0,0,0,0,0,1.55924858550313e-05,0.00021007704002571,0.00021007704002571
8.7,"random_policy_SVM","SVM",1,39,0,0,0,3912,3530,382,0.92862942304521,0.638392857142857,1.7656906512605,785,382,403,0,1.1,100,9.2,0,0,0,0,0,0,0,0,0
8.7,"random_policy_SVM","SVM",2,0,3812,3426,386,100,87,13,0.918857704747778,0.579710144927536,1.77878920961925,30,13,17,0,1.3,2.56,6.7,0,0,0,0,0,0,0.70659886270428,488.667041672181,75.5993051321643
8.7,"random_policy_SVM","SVM",2,1,3712,3384,328,200,129,71,0.923569852199889,0.589371980676328,1.76467607962348,103,52,51,73,1,5.11,1.8,0,0,0,0,0,0,0.599960627201378,265.035246477727,70.5473616505289
8.7,"random_policy_SVM","SVM",2,2,3612,3343,269,300,170,130,0.916311045925507,0.623188405797101,1.71647387315517,184,95,89,81,0.9,7.67,1.3,0,0,0,0,0,0,0.506397377333523,198.360577653425,67.3019947451718
8.7,"random_policy_SVM","SVM",2,3,3512,3302,210,400,211,189,0.905533320627668,0.618357487922705,1.74729010839566,254,128,126,70,1,10.22,1.1,0,0,0,0,0,0,0.28196243730638,137.334323927723,49.2500206808595
8.7,"random_policy_SVM","SVM",2,4,3412,3247,165,500,266,234,0.910731598180344,0.632850241545894,1.73222279785863,331,164,167,77,1,12.78,1.1,0,0,0,0,0,0,0.173360905844484,129.362334987885,28.8589771980999
8.7,"random_policy_SVM","SVM",2,5,3312,3185,127,600,328,272,0.910123935554615,0.642512077294686,1.71567488145328,407,199,208,76,1,15.34,1.2,0,0,0,0,0,0,0.129013938602129,99.8650933461704,18.2513603445192
8.7,"random_policy_SVM","SVM",2,6,3212,3112,100,700,401,299,0.903287731015374,0.666666666666667,1.66905323787049,467,225,242,60,1.1,17.89,1.3,0,0,0,0,0,0,0.0992005777304646,101.109557735977,13.256767783384
8.7,"random_policy_SVM","SVM",2,7,3112,3032,80,800,481,319,0.893888295036775,0.690821256038647,1.63578615848613,516,246,270,49,1.1,20.45,1.5,0,0,0,0,0,0,0.0882197303356166,129.395086450049,11.7664937478301
8.7,"random_policy_SVM","SVM",2,8,3012,2952,60,900,561,339,0.888836408934844,0.695652173913043,1.60245775729647,565,268,297,49,1.1,23.01,1.7,0,0,0,0,0,0,0.0999704518851371,155.184919437821,13.2373423135818
8.7,"random_policy_SVM","SVM",2,9,2912,2859,53,1000,654,346,0.917512560662696,0.685990338164251,1.68334198373724,593,289,304,28,1.1,25.56,1.9,0,0,0,0,0,0,0.0616543142937039,72.8726145825323,7.68302528712071
8.7,"random_policy_SVM","SVM",2,10,2812,2767,45,1100,746,354,0.924934331004891,0.676328502415459,1.71251816594003,615,299,316,22,1.1,28.12,2.1,0,0,0,0,0,0,0.0601487348705385,79.011182492948,7.08542894037372
8.7,"random_policy_SVM","SVM",2,11,2712,2673,39,1200,840,360,0.934176327121375,0.681159420289855,1.74729010839566,640,310,330,25,1.1,30.67,2.3,0,0,0,0,0,0,0.0598127385290996,71.5564076729619,6.70618702370802
8.7,"random_policy_SVM","SVM",2,12,2612,2581,31,1300,932,368,0.938192424656766,0.671497584541063,1.76305413469736,659,319,340,19,1.1,33.23,2.5,0,0,0,0,0,0,0.0628464519797041,67.3936469087293,6.90811986469293
8.7,"random_policy_SVM","SVM",2,13,2512,2486,26,1400,1027,373,0.941157542059942,0.666666666666667,1.77500200176155,677,325,352,18,1.1,35.79,2.8,0,0,0,0,0,0,0.0632707342714493,60.7672575529701,7.33782877872106
8.7,"random_policy_SVM","SVM",2,14,2412,2388,24,1500,1125,375,0.943382415900894,0.661835748792271,1.78534695785748,685,328,357,8,1.1,38.34,3,0,0,0,0,0,0,0.056012386068382,51.8046244465559,6.15541727157152
8.7,"random_policy_SVM","SVM",2,15,2312,2294,18,1600,1219,381,0.944978911344808,0.661835748792271,1.78534695785748,704,335,369,19,1.1,40.9,3.2,0,0,0,0,0,0,0.0474498043511262,44.8110293541,5.62168234306329
8.7,"random_policy_SVM","SVM",2,16,2212,2198,14,1700,1315,385,0.945661150747313,0.661835748792271,1.77663794830695,711,339,372,7,1.1,43.46,3.4,0,0,0,0,0,0,0.0365327147997542,38.3429137226649,4.21217212142279
8.7,"random_policy_SVM","SVM",2,17,2112,2098,14,1800,1415,385,0.945628005513183,0.661835748792271,1.77663794830695,714,340,374,3,1.1,46.01,3.7,0,0,0,0,0,0,0.0290253628125404,31.6819180019725,3.1396169749954
8.7,"random_policy_SVM","SVM",2,18,2012,1999,13,1900,1514,386,0.94420137939418,0.661835748792271,1.77500200176155,716,341,375,2,1.1,48.57,3.9,0,0,0,0,0,0,0.0274501932421357,27.1899440686231,2.83372231309635
8.7,"random_policy_SVM","SVM",2,19,1912,1899,13,2000,1614,386,0.944271813016712,0.642512077294686,1.78910912190963,740,358,382,24,1.1,51.12,4.2,0,0,0,0,0,0,0.0200451849716927,12.3891950893972,2.7267641085977
8.7,"random_policy_SVM","SVM",2,20,1812,1802,10,2100,1711,389,0.944332579279282,0.642512077294686,1.78910912190963,742,361,381,2,1.1,53.68,4.4,0,0,0,0,0,0,0.0146529297185554,10.5256902140438,1.75003824518419
8.7,"random_policy_SVM","SVM",2,21,1712,1702,10,2200,1811,389,0.944362962410567,0.642512077294686,1.79075503646521,743,360,383,1,1.1,56.24,4.7,0,0,0,0,0,0,0.0101245103119522,8.15616039570975,1.15795055022897
8.7,"random_policy_SVM","SVM",2,22,1612,1606,6,2300,1907,393,0.944335341382124,0.642512077294686,1.79075503646521,762,367,395,19,1.1,58.79,4.9,0,0,0,0,0,0,0.0100426259817487,8.69499114300161,1.10883869382142
8.7,"random_policy_SVM","SVM",2,23,1512,1506,6,2400,2007,393,0.944258002502488,0.63768115942029,1.794055967408,765,369,396,3,1.1,61.35,5.1,0,0,0,0,0,0,0.00794149712587269,6.14041340955267,0.81727974226338
8.7,"random_policy_SVM","SVM",2,24,1412,1406,6,2500,2107,393,0.944462398112956,0.63768115942029,1.78910912190963,776,374,402,11,1.1,63.91,5.4,0,0,0,0,0,0,0.0058638236675209,4.13888490728273,0.695806093699896
8.7,"random_policy_SVM","SVM",2,25,1312,1306,6,2600,2207,393,0.944506591758462,0.63768115942029,1.794055967408,776,373,403,0,1.1,66.46,5.6,0,0,0,0,0,0,0.00476318207202387,3.16274048009827,0.494096859095321
8.7,"random_policy_SVM","SVM",2,26,1212,1206,6,2700,2307,393,0.94425800250249,0.642512077294686,1.78910912190963,782,377,405,6,1.1,69.02,5.9,0,0,0,0,0,0,0.00388558881060675,2.35476788204431,0.414402247067634
8.7,"random_policy_SVM","SVM",2,27,1112,1107,5,2800,2406,394,0.943979030115231,0.642512077294686,1.79075503646521,784,380,404,2,1.1,71.57,6.1,0,0,0,0,0,0,0.00372290510995636,2.04144884303144,0.388886031364756
8.7,"random_policy_SVM","SVM",2,28,1012,1007,5,2900,2506,394,0.943517758940261,0.642512077294686,1.79075503646521,784,381,403,0,1.1,74.13,6.4,0,0,0,0,0,0,0.00301967283630688,1.4326957660713,0.314556437101837
8.7,"random_policy_SVM","SVM",2,29,912,907,5,3000,2606,394,0.94328298019851,0.642512077294686,1.794055967408,785,383,402,1,1,76.69,6.6,0,0,0,0,0,0,0.00280022676957353,1.15163187096173,0.296743340065043
8.7,"random_policy_SVM","SVM",2,30,812,809,3,3100,2704,396,0.943046820405334,0.63768115942029,1.79240398217098,794,386,408,9,1.1,79.24,6.8,0,0,0,0,0,0,0.00226520027184803,0.850573635529669,0.247450198438206
8.7,"random_policy_SVM","SVM",2,31,712,709,3,3200,2804,396,0.943012294119782,0.63768115942029,1.79240398217098,793,386,407,-1,1.1,81.8,7.1,0,0,0,0,0,0,0.00218604704408015,0.727849066153213,0.244381382847449
8.7,"random_policy_SVM","SVM",2,32,612,610,2,3300,2903,397,0.943190449753229,0.63768115942029,1.79240398217098,796,387,409,3,1.1,84.36,7.3,0,0,0,0,0,0,0.00146946910331497,0.459626525389924,0.176530194423185
8.7,"random_policy_SVM","SVM",2,33,512,510,2,3400,3003,397,0.943213927627404,0.63768115942029,1.79075503646521,796,388,408,0,1.1,86.91,7.6,0,0,0,0,0,0,0.000831807203117521,0.246885866345754,0.106537274192495
8.7,"random_policy_SVM","SVM",2,34,412,412,0,3500,3101,399,0.943197355010338,0.63768115942029,1.78746623015398,805,393,412,9,1,89.47,7.8,0,0,0,0,0,0,0.000842000944490967,0.249558082377558,0.107326294744743
8.7,"random_policy_SVM","SVM",2,35,312,312,0,3600,3201,399,0.943287123352772,0.63768115942029,1.78910912190963,807,394,413,2,1,92.02,8,0,0,0,0,0,0,0.000519241708080584,0.128916011540334,0.0645760609082627
8.7,"random_policy_SVM","SVM",2,36,212,212,0,3700,3301,399,0.943423847443556,0.632850241545894,1.794055967408,809,395,414,2,1,94.58,8.3,0,0,0,0,0,0,0.000302396342444011,0.0616495599359158,0.0399260291284937
8.7,"random_policy_SVM","SVM",2,37,112,112,0,3800,3401,399,0.943825733407377,0.632850241545894,1.79240398217098,810,396,414,1,1,97.14,8.5,0,0,0,0,0,0,9.17703210755405e-05,0.0174180658129048,0.0164357459098126
8.7,"random_policy_SVM","SVM",2,38,12,12,0,3900,3501,399,0.944081227920458,0.628019323671498,1.78746623015398,812,396,416,2,1.1,99.69,8.8,0,0,0,0,0,0,7.05084082998788e-05,0.000982199142183991,0.000982199142183991
8.7,"random_policy_SVM","SVM",2,39,0,0,0,3912,3513,399,0.944140613131607,0.628019323671498,1.78582635287861,814,398,416,2,1,100,8.8,0,0,0,0,0,0,0,0,0
8.7,"random_policy_SVM","SVM",3,0,3812,3422,390,100,84,16,0.880196469248293,0.475,1.68527956003666,42,16,26,0,1.6,2.56,5.2,0,0,0,0,0,0,0.545189454700446,556.848945402155,68.4373209448846
8.7,"random_policy_SVM","SVM",3,1,3712,3365,347,200,141,59,0.897287870159454,0.595,1.68403314917127,116,56,60,74,1.1,5.11,2.4,0,0,0,0,0,0,0.711563636979927,588.411958754162,78.0762262583436
8.7,"random_policy_SVM","SVM",3,2,3612,3313,299,300,193,107,0.910902619589972,0.635,1.72113657195234,180,88,92,64,1,7.67,1.8,0,0,0,0,0,0,0.620240630093026,403.635358797982,73.9030582968428
8.7,"random_policy_SVM","SVM",3,3,3512,3277,235,400,229,171,0.906842255125283,0.645,1.67939393939394,252,125,127,72,1,10.22,1.3,0,0,0,0,0,0,0.550517571832625,391.226340087342,69.6586304626155
8.7,"random_policy_SVM","SVM",3,4,3412,3235,177,500,271,229,0.901560364464696,0.64,1.66295955882353,333,167,166,81,1,12.78,1.2,0,0,0,0,0,0,0.309732022301464,334.787875849015,49.9321784224815
8.7,"random_policy_SVM","SVM",3,5,3312,3179,133,600,327,273,0.877751993166292,0.665,1.60003676470588,416,205,211,83,1,15.34,1.2,0,0,0,0,0,0,0.218802079950377,285.201366041689,32.6105703869219
8.7,"random_policy_SVM","SVM",3,6,3212,3119,93,700,387,313,0.884080296127563,0.66,1.61347465437788,488,241,247,72,1,17.89,1.2,0,0,0,0,0,0,0.151137413920827,243.58628311941,20.0134492509107
8.7,"random_policy_SVM","SVM",3,7,3112,3035,77,800,471,329,0.901691343963552,0.68,1.6285004599816,540,260,280,52,1.1,20.45,1.4,0,0,0,0,0,0,0.109633968741749,171.200547316207,13.1368432733966
8.7,"random_policy_SVM","SVM",3,8,3012,2944,68,900,562,338,0.90406748291571,0.69,1.64801104972376,572,273,299,32,1.1,23.01,1.7,0,0,0,0,0,0,0.085969706651459,130.168848047257,10.0510670525003
8.7,"random_policy_SVM","SVM",3,9,2912,2850,62,1000,656,344,0.907243735763095,0.695,1.65854377880184,592,281,311,20,1.1,25.56,1.9,0,0,0,0,0,0,0.0678036412177539,101.639729617422,7.46637728532879
8.7,"random_policy_SVM","SVM",3,10,2812,2754,58,1100,752,348,0.907398917995452,0.68,1.65397058823529,605,289,316,13,1.1,28.12,2.2,0,0,0,0,0,0,0.0532691034046802,75.3209535489575,5.85591358814041
8.7,"random_policy_SVM","SVM",3,11,2712,2658,54,1200,848,352,0.910785876993181,0.68,1.69148114075437,612,295,317,7,1.1,30.67,2.4,0,0,0,0,0,0,0.0464988060809958,63.3325235346247,5.01626236910388
8.7,"random_policy_SVM","SVM",3,12,2612,2562,50,1300,944,356,0.924955865603639,0.655,1.69891544117647,640,311,329,28,1.1,33.23,2.7,0,0,0,0,0,0,0.0416340434041104,37.5894144350727,4.9255469665055
8.7,"random_policy_SVM","SVM",3,13,2512,2469,43,1400,1037,363,0.928048120728932,0.66,1.71104972375691,657,321,336,17,1,35.79,2.9,0,0,0,0,0,0,0.0341302579250772,38.0834656923454,3.96055024909717
8.7,"random_policy_SVM","SVM",3,14,2412,2382,30,1500,1124,376,0.93525341685651,0.675,1.7560773480663,689,333,356,32,1.1,38.34,3,0,0,0,0,0,0,0.0662878828945764,52.5764027312036,7.97058075343245
8.7,"random_policy_SVM","SVM",3,15,2312,2286,26,1600,1220,380,0.936207289293873,0.67,1.75123966942149,709,342,367,20,1.1,40.9,3.2,0,0,0,0,0,0,0.0609234731631897,42.0099133939956,6.63184329049323
8.7,"random_policy_SVM","SVM",3,16,2212,2189,23,1700,1317,383,0.936944760820071,0.67,1.76345906163753,715,346,369,6,1.1,43.46,3.4,0,0,0,0,0,0,0.0484749395115799,30.9400741930409,5.63331369848554
8.7,"random_policy_SVM","SVM",3,17,2112,2094,18,1800,1412,388,0.937435933940799,0.665,1.76183823529412,730,351,379,15,1.1,46.01,3.6,0,0,0,0,0,0,0.0388362023564917,26.7662450012264,4.82972685272892
8.7,"random_policy_SVM","SVM",3,18,2012,2000,12,1900,1506,394,0.937730637813233,0.66,1.76670967741935,745,357,388,15,1.1,48.57,3.8,0,0,0,0,0,0,0.0276128006398798,24.8609032224202,3.89797454609334
8.7,"random_policy_SVM","SVM",3,19,1912,1901,11,2000,1605,395,0.937739179954464,0.66,1.76670967741935,746,361,385,1,1.1,51.12,4.1,0,0,0,0,0,0,0.0218547215591339,20.778722712783,2.37404414472144
8.7,"random_policy_SVM","SVM",3,20,1812,1802,10,2100,1704,396,0.937460136674279,0.66,1.76183823529412,758,364,394,12,1.1,53.68,4.3,0,0,0,0,0,0,0.0160294188966297,14.2383729567246,1.81352104507464
8.7,"random_policy_SVM","SVM",3,21,1712,1703,9,2200,1803,397,0.937951309795007,0.655,1.76757798165138,768,370,398,10,1.1,56.24,4.5,0,0,0,0,0,0,0.0121505544476904,10.313863666251,1.37996454290876
8.7,"random_policy_SVM","SVM",3,22,1612,1606,6,2300,1900,400,0.938388382687948,0.66,1.76920110192837,779,374,405,11,1.1,58.79,4.8,0,0,0,0,0,0,0.0120745332834926,9.23255280214456,1.25854751598986
8.7,"random_policy_SVM","SVM",3,23,1512,1506,6,2400,2000,400,0.938300113895232,0.665,1.77408839779006,783,382,401,4,1,61.35,5,0,0,0,0,0,0,0.00820559279795423,5.8909961950091,0.962903664248829
8.7,"random_policy_SVM","SVM",3,24,1412,1408,4,2500,2098,402,0.938522209567216,0.67,1.77408839779006,787,383,404,4,1.1,63.91,5.2,0,0,0,0,0,0,0.00788607961085079,5.75505444594811,0.839391434345569
8.7,"random_policy_SVM","SVM",3,25,1312,1308,4,2600,2198,402,0.938587699316644,0.665,1.76920110192837,796,389,407,9,1,66.46,5.5,0,0,0,0,0,0,0.00654672335499186,4.38160438905617,0.71667530153904
8.7,"random_policy_SVM","SVM",3,26,1212,1208,4,2700,2298,402,0.938499430523934,0.66,1.77245630174793,795,389,406,-1,1,69.02,5.7,0,0,0,0,0,0,0.00581178656964046,3.47124658636038,0.60257138797293
8.7,"random_policy_SVM","SVM",3,27,1112,1108,4,2800,2398,402,0.938658883826894,0.66,1.76920110192837,795,389,406,0,1,71.57,6,0,0,0,0,0,0,0.00451320176531069,2.42761718452562,0.491727604216168
8.7,"random_policy_SVM","SVM",3,28,1012,1009,3,2900,2497,403,0.938779897494321,0.665,1.77082720588235,799,390,409,4,1,74.13,6.2,0,0,0,0,0,0,0.00415710434810781,2.07538534190852,0.449677627715957
8.7,"random_policy_SVM","SVM",3,29,912,909,3,3000,2597,403,0.938841116173136,0.665,1.77082720588235,797,390,407,-2,1,76.69,6.4,0,0,0,0,0,0,0.00340429854065699,1.52046708666743,0.364996559155003
8.7,"random_policy_SVM","SVM",3,30,812,809,3,3100,2697,403,0.938866742596828,0.665,1.77245630174793,800,391,409,3,1,79.24,6.7,0,0,0,0,0,0,0.00302074379919871,1.22286992262787,0.328863260137934
8.7,"random_policy_SVM","SVM",3,31,712,709,3,3200,2797,403,0.939023348519379,0.66,1.77245630174793,800,391,409,0,1,81.8,6.9,0,0,0,0,0,0,0.00228347159601843,0.805880192073556,0.250899488904663
8.7,"random_policy_SVM","SVM",3,32,612,609,3,3300,2897,403,0.939037585421429,0.66,1.77082720588235,802,391,411,2,1.1,84.36,7.2,0,0,0,0,0,0,0.00181081242611586,0.567870254419823,0.205516500091039
8.7,"random_policy_SVM","SVM",3,33,512,510,2,3400,2996,404,0.939436218678831,0.66,1.76757798165138,807,393,414,5,1.1,86.91,7.4,0,0,0,0,0,0,0.00141525894328276,0.441132095934321,0.175422876864362
8.7,"random_policy_SVM","SVM",3,34,412,411,1,3500,3095,405,0.93935933940776,0.66,1.76920110192837,811,396,415,4,1,89.47,7.6,0,0,0,0,0,0,0.001085518648873,0.303042631558714,0.133895420987037
8.7,"random_policy_SVM","SVM",3,35,312,312,0,3600,3194,406,0.93950740318908,0.66,1.77408839779006,816,398,418,5,1.1,92.02,7.9,0,0,0,0,0,0,0.00080343240456709,0.208781027084884,0.105875578330498
8.7,"random_policy_SVM","SVM",3,36,212,212,0,3700,3294,406,0.939832004555822,0.655,1.76920110192837,821,400,421,5,1.1,94.58,8.1,0,0,0,0,0,0,0.000555459246069916,0.116321642566435,0.072225303741868
8.7,"random_policy_SVM","SVM",3,37,112,112,0,3800,3394,406,0.939904612756277,0.65,1.77408839779006,823,400,423,2,1.1,97.14,8.4,0,0,0,0,0,0,0.000233862376018684,0.0371811646084126,0.0346624565644863
8.7,"random_policy_SVM","SVM",3,38,12,12,0,3900,3494,406,0.940327448747164,0.65,1.77245630174793,825,401,424,2,1.1,99.69,8.6,0,0,0,0,0,0,0.000179052124642012,0.00246747476803348,0.00246747476803348
8.7,"random_policy_SVM","SVM",3,39,0,0,0,3912,3506,406,0.940219248291583,0.645,1.77245630174793,825,401,424,0,1.1,100,8.6,0,0,0,0,0,0,0,0,0
8.7,"random_policy_SVM","SVM",4,0,3812,3425,387,100,91,9,0.925849560901107,0.604761904761905,1.76679821099711,23,9,14,0,1.6,2.56,10.1,0,0,0,0,0,0,0.407202147833007,312.242198637218,45.6804154176481
8.7,"random_policy_SVM","SVM",4,1,3712,3399,313,200,117,83,0.919677630502364,0.619047619047619,1.76517282165856,92,48,44,69,0.9,5.11,1.4,0,0,0,0,0,0,0.705784972750888,262.88665949665,82.1756889576957
8.7,"random_policy_SVM","SVM",4,2,3612,3355,257,300,161,139,0.921779032346042,0.661904761904762,1.74106813996317,172,88,84,80,1,7.67,1.2,0,0,0,0,0,0,0.481525316227327,173.951997907284,68.1291538932265
8.7,"random_policy_SVM","SVM",4,3,3512,3311,201,400,205,195,0.922229040528027,0.685714285714286,1.74964483030781,250,128,122,78,1,10.22,1.1,0,0,0,0,0,0,0.281278857352213,137.753294340357,49.2604145674675
8.7,"random_policy_SVM","SVM",4,4,3412,3254,158,500,262,238,0.890837560682927,0.680952380952381,1.6436974789916,339,168,171,89,1,12.78,1.1,0,0,0,0,0,0,0.184283627684118,121.334717961858,27.4395749711115
8.7,"random_policy_SVM","SVM",4,5,3312,3182,130,600,334,266,0.893187148857251,0.695238095238095,1.61652892561983,399,194,205,60,1.1,15.34,1.3,0,0,0,0,0,0,0.100719551124966,78.6020872940969,14.8083346405548
8.7,"random_policy_SVM","SVM",4,6,3212,3103,109,700,413,287,0.89329351442753,0.69047619047619,1.62099447513812,456,218,238,57,1.1,17.89,1.4,0,0,0,0,0,0,0.0663143726933281,63.4875805487409,9.12650400829221
8.7,"random_policy_SVM","SVM",4,7,3112,3018,94,800,498,302,0.901999127256859,0.69047619047619,1.66541145490454,489,233,256,33,1.1,20.45,1.6,0,0,0,0,0,0,0.05399072177568,65.0588413987349,7.03863015888171
8.7,"random_policy_SVM","SVM",4,8,3012,2929,83,900,587,313,0.908841978945076,0.704761904761905,1.68805362071231,517,248,269,28,1.1,23.01,1.9,0,0,0,0,0,0,0.0514898917851046,68.3948316323083,5.87722540718081
8.7,"random_policy_SVM","SVM",4,9,2912,2839,73,1000,677,323,0.911827033218793,0.704761904761905,1.68650210084034,545,257,288,28,1.1,25.56,2.1,0,0,0,0,0,0,0.0605678929816245,90.4916237336893,7.24865814517263
8.7,"random_policy_SVM","SVM",4,10,2812,2744,68,1100,772,328,0.918420334915187,0.7,1.68805362071231,565,270,295,20,1.1,28.12,2.4,0,0,0,0,0,0,0.0453547713464,60.9648343840565,5.21709337314278
8.7,"random_policy_SVM","SVM",4,11,2712,2654,58,1200,862,338,0.925027273223153,0.704761904761905,1.69506302521008,596,288,308,31,1.1,30.67,2.6,0,0,0,0,0,0,0.0385613836134327,50.6674804278525,5.10693008461916
8.7,"random_policy_SVM","SVM",4,12,2612,2565,47,1300,951,349,0.925407734686079,0.704761904761905,1.69662242081745,628,300,328,32,1.1,33.23,2.7,0,0,0,0,0,0,0.042316105484293,56.8017073409285,4.72106224292712
8.7,"random_policy_SVM","SVM",4,13,2512,2469,43,1400,1047,353,0.936726122293116,0.695238095238095,1.73408821593153,655,316,339,27,1.1,35.79,3,0,0,0,0,0,0,0.0326907149979087,34.0592323911241,4.01370006587983
8.7,"random_policy_SVM","SVM",4,14,2412,2377,35,1500,1139,361,0.939633447880863,0.695238095238095,1.74803522144829,674,324,350,19,1.1,38.34,3.2,0,0,0,0,0,0,0.0541711310235502,45.5767744730507,6.66362079461269
8.7,"random_policy_SVM","SVM",4,15,2312,2279,33,1600,1237,363,0.94047482681502,0.69047619047619,1.75822152065246,684,331,353,10,1.1,40.9,3.4,0,0,0,0,0,0,0.0418051107841191,34.5807627793338,4.68258186047605
8.7,"random_policy_SVM","SVM",4,16,2212,2183,29,1700,1333,367,0.941136202476398,0.69047619047619,1.75498949579832,697,339,358,13,1.1,43.46,3.6,0,0,0,0,0,0,0.0380793061356985,28.8230970321789,4.29754324207033
8.7,"random_policy_SVM","SVM",4,17,2112,2089,23,1800,1427,373,0.941408934707891,0.685714285714286,1.75337793519612,709,345,364,12,1.1,46.01,3.8,0,0,0,0,0,0,0.0406818039847434,26.7748351421764,4.70451578947723
8.7,"random_policy_SVM","SVM",4,18,2012,1997,15,1900,1519,381,0.940142093492599,0.685714285714286,1.76031454783748,733,353,380,24,1.1,48.57,4,0,0,0,0,0,0,0.0404715619000618,25.8417276799107,5.11296435814849
8.7,"random_policy_SVM","SVM",4,19,1912,1901,11,2000,1615,385,0.93934298805431,0.685714285714286,1.75498949579832,736,357,379,3,1.1,51.12,4.2,0,0,0,0,0,0,0.0277450338641904,23.0232818573277,3.58280330114156
8.7,"random_policy_SVM","SVM",4,20,1812,1801,11,2100,1715,385,0.93937026127746,0.685714285714286,1.75176933158585,737,357,380,1,1.1,53.68,4.5,0,0,0,0,0,0,0.0208454846870354,17.6128910360267,2.28122511891106
8.7,"random_policy_SVM","SVM",4,21,1712,1703,9,2200,1813,387,0.939877543228048,0.685714285714286,1.75822152065246,742,362,380,5,1,56.24,4.7,0,0,0,0,0,0,0.0175795535493755,14.9276361874839,1.87195204568175
8.7,"random_policy_SVM","SVM",4,22,1612,1603,9,2300,1913,387,0.939687994327158,0.685714285714286,1.75660402155342,748,362,386,6,1.1,58.79,4.9,0,0,0,0,0,0,0.0167698905804163,12.9916502805224,1.72013367867367
8.7,"random_policy_SVM","SVM",4,23,1512,1505,7,2400,2011,389,0.941253477335949,0.676190476190476,1.76193099829463,761,372,389,13,1,61.35,5.2,0,0,0,0,0,0,0.0116826702247334,8.09900646411432,1.42059923862626
8.7,"random_policy_SVM","SVM",4,24,1412,1405,7,2500,2111,389,0.941089837997053,0.671428571428571,1.75660402155342,761,372,389,0,1,63.91,5.4,0,0,0,0,0,0,0.00947513392993254,6.32812607530485,1.00176152821963
8.7,"random_policy_SVM","SVM",4,25,1312,1305,7,2600,2211,389,0.941310751104562,0.676190476190476,1.76517282165856,762,372,390,1,1,66.46,5.7,0,0,0,0,0,0,0.00830110233178728,4.96875396639195,0.857314990855766
8.7,"random_policy_SVM","SVM",4,26,1212,1206,6,2700,2310,390,0.941812578410509,0.676190476190476,1.77048406139315,776,377,399,14,1.1,69.02,5.9,0,0,0,0,0,0,0.00647791801341576,3.53382215284583,0.698993323932302
8.7,"random_policy_SVM","SVM",4,27,1112,1106,6,2800,2410,390,0.94182621502208,0.676190476190476,1.76885976408912,779,378,401,3,1.1,71.57,6.2,0,0,0,0,0,0,0.00578203684445566,2.75805936249122,0.601720329147259
8.7,"random_policy_SVM","SVM",4,28,1012,1006,6,2900,2510,390,0.942120765832091,0.676190476190476,1.77211134453782,782,379,403,3,1.1,74.13,6.4,0,0,0,0,0,0,0.0043182522867827,1.75511813460029,0.454988867719523
8.7,"random_policy_SVM","SVM",4,29,912,906,6,3000,2610,390,0.942415316642101,0.671428571428571,1.77048406139315,788,380,408,6,1.1,76.69,6.7,0,0,0,0,0,0,0.0037998889057845,1.31487125207452,0.407473313124083
8.7,"random_policy_SVM","SVM",4,30,812,807,5,3100,2709,391,0.942506681939651,0.671428571428571,1.77211134453782,788,381,407,0,1.1,79.24,6.9,0,0,0,0,0,0,0.00302917267814462,0.905836256352127,0.34032507184487
8.7,"random_policy_SVM","SVM",4,31,712,708,4,3200,2808,392,0.942824414989341,0.671428571428571,1.7737416217637,791,383,408,3,1.1,81.8,7.2,0,0,0,0,0,0,0.00189167085498215,0.581860133715454,0.243554703010859
8.7,"random_policy_SVM","SVM",4,32,612,609,3,3300,2907,393,0.94285714285712,0.671428571428571,1.77048406139315,793,385,408,2,1.1,84.36,7.4,0,0,0,0,0,0,0.00113931019205595,0.351793057132484,0.150643890097185
8.7,"random_policy_SVM","SVM",4,33,512,510,2,3400,3006,394,0.943312605683716,0.671428571428571,1.7770111915734,799,388,411,6,1.1,86.91,7.6,0,0,0,0,0,0,0.000945516395325911,0.290544163557269,0.122835044470747
8.7,"random_policy_SVM","SVM",4,34,412,411,1,3500,3105,395,0.94347897234493,0.676190476190476,1.77537490134175,804,390,414,5,1.1,89.47,7.9,0,0,0,0,0,0,0.00057909208442035,0.167074574714235,0.0735701742716848
8.7,"random_policy_SVM","SVM",4,35,312,312,0,3600,3204,396,0.943915343915321,0.671428571428571,1.77252646712848,807,393,414,3,1.1,92.02,8.1,0,0,0,0,0,0,0.000623633480565386,0.148251384044256,0.0743680351930493
8.7,"random_policy_SVM","SVM",4,36,212,212,0,3700,3304,396,0.943802160039251,0.671428571428571,1.76885976408912,809,394,415,2,1.1,94.58,8.3,0,0,0,0,0,0,0.000207193057821853,0.0432852116964936,0.0284766645816774
8.7,"random_policy_SVM","SVM",4,37,112,112,0,3800,3404,396,0.943868979435968,0.666666666666667,1.76723844441535,814,396,418,5,1.1,97.14,8.6,0,0,0,0,0,0,9.11235230811216e-05,0.0167703076789016,0.0158072960590394
8.7,"random_policy_SVM","SVM",4,38,12,12,0,3900,3504,396,0.943803523700409,0.666666666666667,1.76723844441535,814,396,418,0,1.1,99.69,8.8,0,0,0,0,0,0,4.49797850594325e-05,0.000734938476605912,0.000734938476605912
8.7,"random_policy_SVM","SVM",4,39,0,0,0,3912,3516,396,0.943849888179764,0.666666666666667,1.7737416217637,813,396,417,-1,1.1,100,8.9,0,0,0,0,0,0,0,0,0
8.7,"random_policy_SVM","SVM",5,0,3812,3412,400,100,88,12,0.914375065822582,0.556701030927835,1.77488716803649,34,12,22,0,1.8,2.56,7.3,0,0,0,0,0,0,0.296610892390413,447.695517156522,33.7145039555752
8.7,"random_policy_SVM","SVM",5,1,3712,3388,324,200,112,88,0.914857764723801,0.608247422680412,1.74219223771983,97,47,50,63,1.1,5.11,1.3,0,0,0,0,0,0,0.823726556707059,381.59145738647,87.178112058856
8.7,"random_policy_SVM","SVM",5,2,3612,3335,277,300,165,135,0.890143580982258,0.623711340206186,1.6434802311091,177,89,88,80,1,7.67,1.2,0,0,0,0,0,0,0.618836319964298,299.715438136998,73.5055640630184
8.7,"random_policy_SVM","SVM",5,3,3512,3297,215,400,203,197,0.856193758264392,0.608247422680412,1.57683589563634,256,129,127,79,1,10.22,1,0,0,0,0,0,0,0.463122030452728,292.442212917258,64.8310927214646
8.7,"random_policy_SVM","SVM",5,4,3412,3250,162,500,250,250,0.883542307827326,0.65979381443299,1.64025545785324,331,167,164,75,1,12.78,1,0,0,0,0,0,0,0.283549054860745,181.465202495744,44.1050929678088
8.7,"random_policy_SVM","SVM",5,5,3312,3193,119,600,307,293,0.879234585815092,0.644329896907217,1.6217214978775,416,209,207,85,1,15.34,1,0,0,0,0,0,0,0.163072645094606,154.541047005464,23.1307772699069
8.7,"random_policy_SVM","SVM",5,6,3212,3115,97,700,385,315,0.886220555367029,0.654639175257732,1.62620552045228,470,228,242,54,1.1,17.89,1.2,0,0,0,0,0,0,0.0984784935510002,118.881972331814,13.0286528104107
8.7,"random_policy_SVM","SVM",5,7,3112,3033,79,800,467,333,0.881522286062004,0.664948453608247,1.63248892724703,515,249,266,45,1.1,20.45,1.4,0,0,0,0,0,0,0.083657774339601,124.78396250578,10.3353343288878
8.7,"random_policy_SVM","SVM",5,8,3012,2949,63,900,551,349,0.901965315889881,0.675257731958763,1.64025545785324,553,267,286,38,1.1,23.01,1.6,0,0,0,0,0,0,0.0724421144534918,114.194706166164,8.51590414612982
8.7,"random_policy_SVM","SVM",5,9,2912,2858,54,1000,642,358,0.908828416630594,0.65979381443299,1.67112832488466,576,279,297,23,1.1,25.56,1.8,0,0,0,0,0,0,0.0620159887193146,101.722339870055,6.87017676607737
8.7,"random_policy_SVM","SVM",5,10,2812,2764,48,1100,736,364,0.916513568227296,0.664948453608247,1.70054634424438,592,284,308,16,1.1,28.12,2,0,0,0,0,0,0,0.0570878766241405,87.9660806175162,6.08905565588452
8.7,"random_policy_SVM","SVM",5,11,2712,2666,46,1200,834,366,0.922190399850213,0.65979381443299,1.7082645098821,601,292,309,9,1.1,30.67,2.3,0,0,0,0,0,0,0.0520502702434951,78.9158585636114,5.80124146064855
8.7,"random_policy_SVM","SVM",5,12,2612,2569,43,1300,931,369,0.929277297354228,0.664948453608247,1.71281701740933,624,304,320,23,1.1,33.23,2.5,0,0,0,0,0,0,0.0443753407128944,59.2876144480557,5.09201190622183
8.7,"random_policy_SVM","SVM",5,13,2512,2476,36,1400,1024,376,0.933639140152352,0.65979381443299,1.75307049573687,647,313,334,23,1.1,35.79,2.7,0,0,0,0,0,0,0.0617919834922834,59.2587189615055,7.08663442034575
8.7,"random_policy_SVM","SVM",5,14,2412,2376,36,1500,1124,376,0.932748341271043,0.654639175257732,1.74824553106971,651,315,336,4,1.1,38.34,3,0,0,0,0,0,0,0.0484400575397604,48.1554198230357,5.35794505990317
8.7,"random_policy_SVM","SVM",5,15,2312,2281,31,1600,1219,381,0.933504569549584,0.649484536082474,1.76072619769557,664,322,342,13,1.1,40.9,3.2,0,0,0,0,0,0,0.0482500198011169,40.1277696243881,5.45040461177091
8.7,"random_policy_SVM","SVM",5,16,2212,2190,22,1700,1310,390,0.932173490761416,0.654639175257732,1.76072619769557,698,334,364,34,1.1,43.46,3.4,0,0,0,0,0,0,0.0512919722513773,37.7458248041916,5.87933987164915
8.7,"random_policy_SVM","SVM",5,17,2112,2098,14,1800,1402,398,0.932205670688163,0.654639175257732,1.76234600100532,715,343,372,17,1.1,46.01,3.5,0,0,0,0,0,0,0.0395925731559474,32.4224436962157,4.98409721289076
8.7,"random_policy_SVM","SVM",5,18,2012,2001,11,1900,1499,401,0.933096469569473,0.654639175257732,1.76072619769557,720,345,375,5,1.1,48.57,3.7,0,0,0,0,0,0,0.0295994091674199,28.6309324533508,3.47014151893721
8.7,"random_policy_SVM","SVM",5,19,1912,1902,10,2000,1598,402,0.933241279239831,0.654639175257732,1.76072619769557,722,347,375,2,1.1,51.12,4,0,0,0,0,0,0,0.025381932364473,24.8927405154779,2.71126051502184
8.7,"random_policy_SVM","SVM",5,20,1812,1802,10,2100,1698,402,0.932891688217445,0.644329896907217,1.76396878737825,727,349,378,5,1.1,53.68,4.2,0,0,0,0,0,0,0.0195139921084077,19.2059800364285,2.11260444528789
8.7,"random_policy_SVM","SVM",5,21,1712,1703,9,2200,1797,403,0.93297213803431,0.644329896907217,1.75910936923121,733,353,380,6,1.1,56.24,4.5,0,0,0,0,0,0,0.0178000236316991,15.9976446019353,1.80918655252165
8.7,"random_policy_SVM","SVM",5,22,1612,1604,8,2300,1896,404,0.931181763928044,0.644329896907217,1.77162150627377,759,367,392,26,1.1,58.79,4.7,0,0,0,0,0,0,0.0120170463336953,8.28161618097119,1.55567023392154
8.7,"random_policy_SVM","SVM",5,23,1512,1506,6,2400,1994,406,0.931246123781535,0.639175257731959,1.76836783959558,759,370,389,0,1.1,61.35,4.9,0,0,0,0,0,0,0.00906087781342081,7.01949935279117,1.05057520519541
8.7,"random_policy_SVM","SVM",5,24,1412,1406,6,2500,2094,406,0.931341200837833,0.639175257731959,1.76999317768344,759,370,389,0,1.1,63.91,5.2,0,0,0,0,0,0,0.00740494921429255,5.53307719288127,0.770733944026747
8.7,"random_policy_SVM","SVM",5,25,1312,1308,4,2600,2192,408,0.931257825573078,0.639175257731959,1.77162150627377,767,373,394,8,1.1,66.46,5.4,0,0,0,0,0,0,0.0060781621916427,4.45388066077104,0.710816596861526
8.7,"random_policy_SVM","SVM",5,26,1212,1209,3,2700,2291,409,0.930991609815448,0.639175257731959,1.77488716803649,771,377,394,4,1,69.02,5.6,0,0,0,0,0,0,0.0059645019476245,3.95451049852765,0.615459206219901
8.7,"random_policy_SVM","SVM",5,27,1112,1109,3,2800,2391,409,0.930780977567655,0.634020618556701,1.77488716803649,774,381,393,3,1,71.57,5.8,0,0,0,0,0,0,0.00461901943852639,2.73689650605747,0.503121153827053
8.7,"random_policy_SVM","SVM",5,28,1012,1010,2,2900,2490,410,0.931228571094229,0.628865979381443,1.77162150627377,781,383,398,7,1,74.13,6.1,0,0,0,0,0,0,0.00496970868490421,2.7238912841274,0.525075677222991
8.7,"random_policy_SVM","SVM",5,29,912,910,2,3000,2590,410,0.932199819792416,0.628865979381443,1.77162150627377,786,386,400,5,1,76.69,6.3,0,0,0,0,0,0,0.00368468849055073,1.7663956242483,0.396173711366071
8.7,"random_policy_SVM","SVM",5,30,812,810,2,3100,2690,410,0.93252746995566,0.628865979381443,1.77325283362761,788,386,402,2,1,79.24,6.6,0,0,0,0,0,0,0.00278027295511054,1.11967054337519,0.292700574353698
8.7,"random_policy_SVM","SVM",5,31,712,710,2,3200,2790,410,0.932855120118905,0.628865979381443,1.76836783959558,791,387,404,3,1,81.8,6.8,0,0,0,0,0,0,0.00232731912734805,0.810583637642558,0.257177760012373
8.7,"random_policy_SVM","SVM",5,32,612,610,2,3300,2890,410,0.932878523701994,0.628865979381443,1.76512610203445,792,388,404,1,1,84.36,7,0,0,0,0,0,0,0.00161271362905016,0.502748843839434,0.191605630109458
8.7,"random_policy_SVM","SVM",5,33,512,510,2,3400,2990,410,0.933106708637109,0.628865979381443,1.76512610203445,790,388,402,-2,1,86.91,7.3,0,0,0,0,0,0,0.000948034569513034,0.304384443449309,0.127317394357077
8.7,"random_policy_SVM","SVM",5,34,412,412,0,3500,3088,412,0.933074528710368,0.628865979381443,1.77325283362761,800,391,409,10,1,89.47,7.5,0,0,0,0,0,0,0.00113394029940579,0.335905514308837,0.139200268369283
8.7,"random_policy_SVM","SVM",5,35,312,312,0,3600,3188,412,0.93339340252995,0.623711340206186,1.77325283362761,805,393,412,5,1,92.02,7.7,0,0,0,0,0,0,0.000705453649823829,0.179018693058544,0.0878078971316673
8.7,"random_policy_SVM","SVM",5,36,212,212,0,3700,3288,412,0.93361573656929,0.618556701030928,1.77162150627377,810,395,415,5,1.1,94.58,8,0,0,0,0,0,0,0.000382954759581594,0.0801995847351916,0.050004538001835
8.7,"random_policy_SVM","SVM",5,37,112,112,0,3800,3388,412,0.933955088524073,0.618556701030928,1.77162150627377,815,397,418,5,1.1,97.14,8.2,0,0,0,0,0,0,0.000180192662540907,0.0297056026128272,0.0277972941381026
8.7,"random_policy_SVM","SVM",5,38,12,12,0,3900,3488,412,0.934183273459185,0.623711340206186,1.76999317768344,815,398,417,0,1,99.69,8.5,0,0,0,0,0,0,9.66432913253039e-05,0.00142531502646609,0.00142531502646609
8.7,"random_policy_SVM","SVM",5,39,0,0,0,3912,3500,412,0.934221304281703,0.623711340206186,1.77162150627377,815,398,417,0,1,100,8.5,0,0,0,0,0,0,0,0,0
8.7,"random_policy_SVM","SVM",6,0,3812,3396,416,100,91,9,0.894834643218441,0.524861878453039,1.74300481197647,23,9,14,0,1.6,2.56,10.1,0,0,0,0,0,0,0.282126655902208,341.67125683949,32.0732791941071
8.7,"random_policy_SVM","SVM",6,1,3712,3361,351,200,126,74,0.893315695276647,0.519337016574586,1.71675570369694,93,47,46,70,1,5.11,1.7,0,0,0,0,0,0,0.844985787201819,364.580294859881,90.4282711124243
8.7,"random_policy_SVM","SVM",6,2,3612,3304,308,300,183,117,0.90441833320366,0.591160220994475,1.70997270606413,172,87,85,79,1,7.67,1.6,0,0,0,0,0,0,0.573000746614752,195.378065018526,72.1789382287027
8.7,"random_policy_SVM","SVM",6,3,3512,3271,241,400,216,184,0.900250564158442,0.61878453038674,1.71154726656695,243,122,121,71,1,10.22,1.2,0,0,0,0,0,0,0.363504071273564,138.263376075861,61.3752066547899
8.7,"random_policy_SVM","SVM",6,4,3412,3234,178,500,253,247,0.892602910279364,0.624309392265193,1.67328461949742,320,161,159,77,1,12.78,1,0,0,0,0,0,0,0.206095619160956,94.7809179385416,38.6543987282102
8.7,"random_policy_SVM","SVM",6,5,3312,3174,138,600,313,287,0.882353124270488,0.613259668508287,1.6533645645034,395,195,200,75,1,15.34,1.1,0,0,0,0,0,0,0.17391733383397,90.0144510133606,26.264453338182
8.7,"random_policy_SVM","SVM",6,6,3212,3098,114,700,389,311,0.880319041319756,0.640883977900553,1.61203870455725,441,218,223,46,1,17.89,1.3,0,0,0,0,0,0,0.0782292427714728,52.5462110525487,13.0770309454554
8.7,"random_policy_SVM","SVM",6,7,3112,3013,99,800,474,326,0.885300754805088,0.651933701657459,1.61352445451537,482,232,250,41,1.1,20.45,1.5,0,0,0,0,0,0,0.0552792866865584,49.2686376619308,7.58351995852719
8.7,"random_policy_SVM","SVM",6,8,3012,2937,75,900,550,350,0.887177651544636,0.668508287292818,1.64340453700639,551,263,288,69,1.1,23.01,1.6,0,0,0,0,0,0,0.0590947162998351,83.3155120027281,9.01765942484285
8.7,"random_policy_SVM","SVM",6,9,2912,2845,67,1000,642,358,0.901735273519566,0.668508287292818,1.6617929855621,570,274,296,19,1.1,25.56,1.8,0,0,0,0,0,0,0.0447789427751679,61.1586039948718,5.6607646396815
8.7,"random_policy_SVM","SVM",6,10,2812,2758,54,1100,729,371,0.912511088631228,0.674033149171271,1.68324464699442,609,292,317,39,1.1,28.12,2,0,0,0,0,0,0,0.0532685182730689,80.0680747780166,6.48919626380572
8.7,"random_policy_SVM","SVM",6,11,2712,2663,49,1200,824,376,0.917298264726476,0.662983425414365,1.72308475698246,636,306,330,27,1.1,30.67,2.2,0,0,0,0,0,0,0.0454572131471722,63.369335285634,5.08246382548902
8.7,"random_policy_SVM","SVM",6,12,2612,2571,41,1300,916,384,0.922178818768975,0.657458563535912,1.70316470198844,653,315,338,17,1.1,33.23,2.4,0,0,0,0,0,0,0.0479494488669655,65.355957863649,5.67029572073117
8.7,"random_policy_SVM","SVM",6,13,2512,2477,35,1400,1010,390,0.930402303322721,0.651933701657459,1.72826616834579,668,325,343,15,1.1,35.79,2.6,0,0,0,0,0,0,0.0533655959920418,55.3224723122739,5.95949939965595
8.7,"random_policy_SVM","SVM",6,14,2412,2381,31,1500,1106,394,0.932571784296963,0.651933701657459,1.72985610962302,685,332,353,17,1.1,38.34,2.8,0,0,0,0,0,0,0.0509901798407627,46.4639397209126,5.63774200913687
8.7,"random_policy_SVM","SVM",6,15,2312,2284,28,1600,1203,397,0.932497081939169,0.646408839779006,1.74300481197647,691,335,356,6,1.1,40.9,3,0,0,0,0,0,0,0.0449502316782629,39.2613535400196,5.08882485999278
8.7,"random_policy_SVM","SVM",6,16,2212,2189,23,1700,1298,402,0.932294763053482,0.646408839779006,1.74139983516987,710,342,368,19,1.1,43.46,3.2,0,0,0,0,0,0,0.044366792629557,36.2166836256852,5.44156258866704
8.7,"random_policy_SVM","SVM",6,17,2112,2099,13,1800,1388,412,0.931933701657484,0.646408839779006,1.73304478447947,739,351,388,29,1.1,46.01,3.4,0,0,0,0,0,0,0.0379629501688348,37.8752105166359,4.97519854465403
8.7,"random_policy_SVM","SVM",6,18,2012,2000,12,1900,1487,413,0.931823204419914,0.640883977900553,1.7314489789689,741,352,389,2,1.1,48.57,3.6,0,0,0,0,0,0,0.0276681974811811,29.457909776751,3.02828937586587
8.7,"random_policy_SVM","SVM",6,19,1912,1901,11,2000,1586,414,0.932945296085929,0.635359116022099,1.73660259044488,752,360,392,11,1.1,51.12,3.8,0,0,0,0,0,0,0.0208236514573333,20.7599092999841,2.29477071760869
8.7,"random_policy_SVM","SVM",6,20,1812,1801,11,2100,1686,414,0.933832386584718,0.640883977900553,1.75644947719282,767,367,400,15,1.1,53.68,4.1,0,0,0,0,0,0,0.0158846762307444,14.7500284487455,1.85475761109917
8.7,"random_policy_SVM","SVM",6,21,1712,1704,8,2200,1783,417,0.934009804684477,0.640883977900553,1.75483805565411,774,369,405,7,1.1,56.24,4.3,0,0,0,0,0,0,0.0131522736031369,11.5927182468989,1.36814489219207
8.7,"random_policy_SVM","SVM",6,22,1612,1604,8,2300,1883,417,0.93355225274299,0.640883977900553,1.75644947719282,778,379,399,4,1.1,58.79,4.5,0,0,0,0,0,0,0.00938500535268505,7.50372761255532,1.12294975032372
8.7,"random_policy_SVM","SVM",6,23,1512,1506,6,2400,1981,419,0.933771690919008,0.635359116022099,1.75806386090348,783,382,401,5,1,61.35,4.7,0,0,0,0,0,0,0.00886152306949106,7.11904432427165,0.940354192655741
8.7,"random_policy_SVM","SVM",6,24,1412,1406,6,2500,2081,419,0.934205898373679,0.640883977900553,1.75806386090348,790,385,405,7,1.1,63.91,5,0,0,0,0,0,0,0.00773565339858636,5.75556651626982,0.815568860363416
8.7,"random_policy_SVM","SVM",6,25,1312,1307,5,2600,2180,420,0.93427748813323,0.635359116022099,1.75968121496135,795,388,407,5,1,66.46,5.2,0,0,0,0,0,0,0.00706634737340925,4.6080901531548,0.725523104316547
8.7,"random_policy_SVM","SVM",6,26,1212,1207,5,2700,2280,420,0.935488288849123,0.635359116022099,1.76292486697049,802,392,410,7,1,69.02,5.4,0,0,0,0,0,0,0.00512201882078994,3.02302918333902,0.561296719934366
8.7,"random_policy_SVM","SVM",6,27,1112,1108,4,2800,2379,421,0.935911602209951,0.635359116022099,1.76292486697049,807,394,413,5,1,71.57,5.7,0,0,0,0,0,0,0.00552440509107735,2.91205259290422,0.568723113830259
8.7,"random_policy_SVM","SVM",6,28,1012,1008,4,2900,2479,421,0.936048556532572,0.635359116022099,1.75968121496135,812,399,413,5,1,74.13,5.9,0,0,0,0,0,0,0.00471611146076816,2.22650866205343,0.50836788367855
8.7,"random_policy_SVM","SVM",6,29,912,908,4,3000,2579,421,0.936149715975417,0.635359116022099,1.76130154757181,816,399,417,4,1,76.69,6.1,0,0,0,0,0,0,0.00358660316197952,1.42707540082128,0.384648148066507
8.7,"random_policy_SVM","SVM",6,30,812,808,4,3100,2679,421,0.936468757295157,0.635359116022099,1.75968121496135,818,399,419,2,1.1,79.24,6.4,0,0,0,0,0,0,0.00292902214173261,1.00684620009689,0.323037305169644
8.7,"random_policy_SVM","SVM",6,31,712,708,4,3200,2779,421,0.936445412808347,0.635359116022099,1.76130154757181,818,399,419,0,1.1,81.8,6.6,0,0,0,0,0,0,0.00206366846204036,0.6358083114219,0.238304825785933
8.7,"random_policy_SVM","SVM",6,32,612,610,2,3300,2877,423,0.937186211189795,0.635359116022099,1.76130154757181,827,404,423,9,1,84.36,6.8,0,0,0,0,0,0,0.00178147580387738,0.555183522447388,0.217595587582201
8.7,"random_policy_SVM","SVM",6,33,512,510,2,3400,2977,423,0.937386973776363,0.635359116022099,1.76292486697049,827,404,423,0,1,86.91,7,0,0,0,0,0,0,0.00104176859834493,0.326587772438502,0.135847233866427
8.7,"random_policy_SVM","SVM",6,34,412,411,1,3500,3076,424,0.937941016263329,0.629834254143646,1.76962291674079,832,407,425,5,1,89.47,7.3,0,0,0,0,0,0,0.000862024046039537,0.263222659478998,0.110510786331172
8.7,"random_policy_SVM","SVM",6,35,312,312,0,3600,3175,425,0.93814644774726,0.629834254143646,1.77629636394076,838,409,429,6,1,92.02,7.5,0,0,0,0,0,0,0.000697313252717863,0.17691031248805,0.0833041033445013
8.7,"random_policy_SVM","SVM",6,36,212,212,0,3700,3275,425,0.938267839078675,0.635359116022099,1.77792898927527,837,409,428,-1,1,94.58,7.7,0,0,0,0,0,0,0.000378442796604181,0.0774360500924497,0.0476886203456836
8.7,"random_policy_SVM","SVM",6,37,112,112,0,3800,3375,425,0.938339428838227,0.629834254143646,1.77956461852023,843,412,431,6,1,97.14,7.9,0,0,0,0,0,0,0.000192392418274136,0.0306970243003371,0.0286978378169768
8.7,"random_policy_SVM","SVM",6,38,12,12,0,3900,3475,425,0.93830519025757,0.629834254143646,1.77956461852023,844,412,432,1,1,99.69,8.2,0,0,0,0,0,0,0.000146848478321177,0.00203542557770758,0.00203542557770758
8.7,"random_policy_SVM","SVM",6,39,0,0,0,3912,3487,425,0.938373667418881,0.629834254143646,1.77956461852023,845,412,433,1,1.1,100,8.2,0,0,0,0,0,0,0,0,0
8.7,"random_policy_SVM","SVM",7,0,3812,3423,389,100,95,5,0.835378981305163,0.424528301886792,1.66670724284845,28,5,23,0,4.6,2.56,19,0,0,0,0,0,0,0.0821781270840772,211.908162702491,9.8099240710381
8.7,"random_policy_SVM","SVM",7,1,3712,3369,343,200,149,51,0.899385494201131,0.55188679245283,1.75217240782413,104,49,55,76,1.1,5.11,2.9,0,0,0,0,0,0,0.717992651395468,355.837283288539,77.9857433062743
8.7,"random_policy_SVM","SVM",7,2,3612,3335,277,300,183,117,0.908235243205788,0.561320754716981,1.75539331298557,173,85,88,69,1,7.67,1.6,0,0,0,0,0,0,0.678010468201762,298.415136430876,79.3427725021684
8.7,"random_policy_SVM","SVM",7,3,3512,3298,214,400,220,180,0.917098515665537,0.60377358490566,1.76225375539269,240,120,120,67,1,10.22,1.2,0,0,0,0,0,0,0.59713661977,289.889089800689,75.4621277196927
8.7,"random_policy_SVM","SVM",7,4,3412,3251,161,500,267,233,0.899188051756953,0.608490566037736,1.653631381798,310,154,156,70,1,12.78,1.1,0,0,0,0,0,0,0.34541841970258,192.48768108592,58.1242502321143
8.7,"random_policy_SVM","SVM",7,5,3312,3193,119,600,325,275,0.880485113380639,0.608490566037736,1.63667105993341,396,196,200,86,1,15.34,1.2,0,0,0,0,0,0,0.188296721472425,153.482430409171,32.9205870366093
8.7,"random_policy_SVM","SVM",7,6,3212,3122,90,700,396,304,0.908722087588707,0.622641509433962,1.69603218645949,457,220,237,61,1.1,17.89,1.3,0,0,0,0,0,0,0.103894410400567,111.599872260071,16.6066593542751
8.7,"random_policy_SVM","SVM",7,7,3112,3046,66,800,472,328,0.891148357711609,0.617924528301887,1.63667105993341,518,246,272,61,1.1,20.45,1.4,0,0,0,0,0,0,0.0840101797854562,145.231064965067,14.229911243252
8.7,"random_policy_SVM","SVM",7,8,3012,2956,56,900,562,338,0.897106792020075,0.627358490566038,1.65667674345877,535,259,276,17,1.1,23.01,1.7,0,0,0,0,0,0,0.0590176875400335,87.8763990244964,6.96940696357535
8.7,"random_policy_SVM","SVM",7,9,2912,2860,52,1000,658,342,0.896651051583863,0.627358490566038,1.64970002608469,555,265,290,20,1.1,25.56,1.9,0,0,0,0,0,0,0.0629428759662321,96.9201952741424,6.42503627330261
8.7,"random_policy_SVM","SVM",7,10,2812,2760,52,1100,758,342,0.920576748312263,0.60377358490566,1.75700821023763,593,293,300,38,1,28.12,2.2,0,0,0,0,0,0,0.0597678019249735,40.7393759259942,7.646071081833
8.7,"random_policy_SVM","SVM",7,11,2712,2666,46,1200,852,348,0.923369341786388,0.608490566037736,1.74691315205327,603,297,306,10,1,30.67,2.4,0,0,0,0,0,0,0.0331013846099017,24.798905674041,4.01058844820738
8.7,"random_policy_SVM","SVM",7,12,2612,2572,40,1300,946,354,0.927384455599776,0.608490566037736,1.74210954118603,619,305,314,16,1,33.23,2.7,0,0,0,0,0,0,0.0290436754882303,26.3922745464255,3.32720556437699
8.7,"random_policy_SVM","SVM",7,13,2512,2475,37,1400,1043,357,0.928485264843329,0.608490566037736,1.74691315205327,627,307,320,8,1,35.79,2.9,0,0,0,0,0,0,0.023156888970849,23.583578179059,2.63549671133091
8.7,"random_policy_SVM","SVM",7,14,2412,2383,29,1500,1135,365,0.932390838670559,0.613207547169811,1.77235363485017,656,315,341,29,1.1,38.34,3.1,0,0,0,0,0,0,0.0507997742127332,39.4163593433408,5.93224922096428
8.7,"random_policy_SVM","SVM",7,15,2312,2284,28,1600,1234,366,0.932187986844355,0.613207547169811,1.77398413497422,661,322,339,5,1.1,40.9,3.4,0,0,0,0,0,0,0.0404658569463607,28.1677892424731,4.46116238125767
8.7,"random_policy_SVM","SVM",7,16,2212,2189,23,1700,1329,371,0.930978989960161,0.608490566037736,1.77398413497422,677,329,348,16,1.1,43.46,3.6,0,0,0,0,0,0,0.04834481214139,25.8779655130248,5.55185364576223
8.7,"random_policy_SVM","SVM",7,17,2112,2092,20,1800,1426,374,0.931008741561335,0.608490566037736,1.77398413497422,686,334,352,9,1.1,46.01,3.8,0,0,0,0,0,0,0.042947675174395,20.8340418250581,4.97618466279878
8.7,"random_policy_SVM","SVM",7,18,2012,1997,15,1900,1521,379,0.931030379089462,0.60377358490566,1.77398413497422,697,338,359,11,1.1,48.57,4,0,0,0,0,0,0,0.0342981446857156,16.2273746303767,4.3597834980411
8.7,"random_policy_SVM","SVM",7,19,1912,1904,8,2000,1614,386,0.930964114159568,0.599056603773585,1.77235363485017,715,345,370,18,1.1,51.12,4.2,0,0,0,0,0,0,0.016167237753927,12.5874529548908,2.57333200436632
8.7,"random_policy_SVM","SVM",7,20,1812,1805,7,2100,1713,387,0.931319781028186,0.599056603773585,1.77235363485017,718,348,370,3,1.1,53.68,4.4,0,0,0,0,0,0,0.0133097785405478,10.6533180006512,1.48858887222325
8.7,"random_policy_SVM","SVM",7,21,1712,1705,7,2200,1813,387,0.931360351393428,0.60377358490566,1.77398413497422,719,348,371,1,1.1,56.24,4.7,0,0,0,0,0,0,0.0103335340116289,8.45882735966189,1.14313143149887
8.7,"random_policy_SVM","SVM",7,22,1612,1606,6,2300,1912,388,0.931630820495039,0.599056603773585,1.77398413497422,724,349,375,5,1.1,58.79,4.9,0,0,0,0,0,0,0.00864241509242144,6.96672050861479,0.923670096053357
8.7,"random_policy_SVM","SVM",7,23,1512,1507,5,2400,2011,389,0.931730894062635,0.60377358490566,1.77561763786094,729,351,378,5,1.1,61.35,5.2,0,0,0,0,0,0,0.00805899270652918,6.19706284537149,0.829760149942948
8.7,"random_policy_SVM","SVM",7,24,1412,1407,5,2500,2111,389,0.931430673359849,0.60377358490566,1.77398413497422,735,356,379,6,1.1,63.91,5.4,0,0,0,0,0,0,0.00651158331738171,4.78698899212962,0.732675422982386
8.7,"random_policy_SVM","SVM",7,25,1312,1307,5,2600,2211,389,0.931330599792254,0.60377358490566,1.77561763786094,736,356,380,1,1.1,66.46,5.7,0,0,0,0,0,0,0.0061072894971249,3.97050709663097,0.625501081916014
8.7,"random_policy_SVM","SVM",7,26,1212,1207,5,2700,2311,389,0.931413092868245,0.589622641509434,1.77561763786094,744,361,383,8,1.1,69.02,5.9,0,0,0,0,0,0,0.00450330759896535,2.68652142594562,0.504171932080394
8.7,"random_policy_SVM","SVM",7,27,1112,1107,5,2800,2411,389,0.931330599792254,0.594339622641509,1.77725415181289,743,361,382,-1,1.1,71.57,6.2,0,0,0,0,0,0,0.00429607750823832,2.19691255926624,0.440443841136394
8.7,"random_policy_SVM","SVM",7,28,1012,1007,5,2900,2511,389,0.931990544400183,0.594339622641509,1.77561763786094,750,364,386,7,1.1,74.13,6.5,0,0,0,0,0,0,0.0032547551040145,1.46856425518351,0.362723503560289
8.7,"random_policy_SVM","SVM",7,29,912,908,4,3000,2610,390,0.932160939934201,0.589622641509434,1.77235363485017,756,366,390,6,1.1,76.69,6.7,0,0,0,0,0,0,0.00318379330108427,1.22265218259707,0.334108658027066
8.7,"random_policy_SVM","SVM",7,30,812,808,4,3100,2710,390,0.932409771507682,0.594339622641509,1.77398413497422,756,367,389,0,1.1,79.24,6.9,0,0,0,0,0,0,0.00221834938587761,0.724486443444912,0.248152406931543
8.7,"random_policy_SVM","SVM",7,31,712,709,3,3200,2809,391,0.932493616929181,0.589622641509434,1.77235363485017,759,369,390,3,1.1,81.8,7.2,0,0,0,0,0,0,0.00179352106791653,0.536646260411047,0.210199809770175
8.7,"random_policy_SVM","SVM",7,32,612,610,2,3300,2908,392,0.932561234204584,0.589622641509434,1.77235363485017,761,370,391,2,1.1,84.36,7.4,0,0,0,0,0,0,0.00117915945259784,0.369655401754487,0.155462304660416
8.7,"random_policy_SVM","SVM",7,33,512,511,1,3400,3007,393,0.932477388783086,0.589622641509434,1.77398413497422,767,373,394,6,1.1,86.91,7.7,0,0,0,0,0,0,0.000946751957584543,0.301706151114345,0.124844409550746
8.7,"random_policy_SVM","SVM",7,34,412,412,0,3500,3106,394,0.932766790721807,0.584905660377358,1.77398413497422,772,377,395,5,1,89.47,7.9,0,0,0,0,0,0,0.000689966131227459,0.208880626954293,0.0847820127359057
8.7,"random_policy_SVM","SVM",7,35,312,312,0,3600,3206,394,0.93313868573652,0.584905660377358,1.77235363485017,773,379,394,1,1,92.02,8.1,0,0,0,0,0,0,0.000482517187364916,0.123291260831902,0.058174973133046
8.7,"random_policy_SVM","SVM",7,36,212,212,0,3700,3306,394,0.933012917604271,0.589622641509434,1.77398413497422,778,381,397,5,1,94.58,8.4,0,0,0,0,0,0,0.000322146449285342,0.0650873503128297,0.0397615348005287
8.7,"random_policy_SVM","SVM",7,37,112,112,0,3800,3406,394,0.933112991171867,0.589622641509434,1.77725415181289,776,381,395,-2,1,97.14,8.6,0,0,0,0,0,0,8.87360768278524e-05,0.0159458319195242,0.0150194078556123
8.7,"random_policy_SVM","SVM",7,38,12,12,0,3900,3506,394,0.933253635104705,0.589622641509434,1.78575776019477,780,381,399,4,1,99.69,8.9,0,0,0,0,0,0,6.67806201487654e-05,0.000983064644266569,0.000983064644266569
8.7,"random_policy_SVM","SVM",7,39,0,0,0,3912,3518,394,0.933130571663472,0.589622641509434,1.78411341603252,780,381,399,0,1,100,8.9,0,0,0,0,0,0,0,0,0
8.7,"random_policy_SVM","SVM",8,0,3812,3428,384,100,89,11,0.908722280313421,0.578199052132701,1.7600454277415,32,11,21,0,1.9,2.56,8.1,0,0,0,0,0,0,0.290900071072158,386.018460423964,33.7053799950705
8.7,"random_policy_SVM","SVM",8,1,3712,3401,311,200,116,84,0.908515867950399,0.568720379146919,1.71101797814422,102,53,49,70,0.9,5.11,1.4,0,0,0,0,0,0,0.670390434081587,392.755408894926,75.6976493915822
8.7,"random_policy_SVM","SVM",8,2,3612,3351,261,300,166,134,0.91176143076359,0.597156398104265,1.73178480287485,182,92,90,80,1,7.67,1.2,0,0,0,0,0,0,0.513769162072034,291.513770941235,64.7878852103886
8.7,"random_policy_SVM","SVM",8,3,3512,3323,189,400,194,206,0.913127554692492,0.62085308056872,1.74667201003624,252,127,125,70,1,10.22,0.9,0,0,0,0,0,0,0.434084000400413,242.878768015527,61.5899461988089
8.7,"random_policy_SVM","SVM",8,4,3412,3272,140,500,245,255,0.889075082497032,0.616113744075829,1.67696786912642,335,168,167,83,1,12.78,1,0,0,0,0,0,0,0.297232611756253,216.513518927998,42.6477012173234
8.7,"random_policy_SVM","SVM",8,5,3312,3200,112,600,317,283,0.901180081206974,0.62085308056872,1.70094351928345,409,203,206,74,1,15.34,1.1,0,0,0,0,0,0,0.133093662813308,136.641896639335,21.4282291755544
8.7,"random_policy_SVM","SVM",8,6,3212,3121,91,700,396,304,0.905365363462289,0.639810426540284,1.67696786912642,463,222,241,54,1.1,17.89,1.3,0,0,0,0,0,0,0.0886963237918978,114.839798893881,11.3634850859872
8.7,"random_policy_SVM","SVM",8,7,3112,3036,76,800,481,319,0.892605820285441,0.644549763033175,1.63038412191354,503,238,265,40,1.1,20.45,1.5,0,0,0,0,0,0,0.0799091874345427,137.795582867471,12.1093233686674
8.7,"random_policy_SVM","SVM",8,8,3012,2955,57,900,562,338,0.899482611116394,0.644549763033175,1.65143028736307,557,264,293,54,1.1,23.01,1.7,0,0,0,0,0,0,0.0786827083706441,122.753081337892,9.03090326208965
8.7,"random_policy_SVM","SVM",8,9,2912,2859,53,1000,658,342,0.907483806135343,0.639810426540284,1.68548039638087,575,271,304,18,1.1,25.56,1.9,0,0,0,0,0,0,0.074426070296883,105.149108909716,8.50862555110086
8.7,"random_policy_SVM","SVM",8,10,2812,2761,51,1100,756,344,0.913410013715563,0.635071090047393,1.71953050539867,581,281,300,6,1.1,28.12,2.2,0,0,0,0,0,0,0.0562328015576833,70.2148131987393,6.25132890337198
8.7,"random_policy_SVM","SVM",8,11,2712,2668,44,1200,849,351,0.91941769986013,0.635071090047393,1.73122250465432,602,290,312,21,1.1,30.67,2.4,0,0,0,0,0,0,0.0520521983639422,62.6578519581614,5.84716842121605
8.7,"random_policy_SVM","SVM",8,12,2612,2577,35,1300,940,360,0.927971591140574,0.639810426540284,1.75842475976015,623,304,319,21,1,33.23,2.6,0,0,0,0,0,0,0.0607831473987654,62.9064991495348,6.6671962016873
8.7,"random_policy_SVM","SVM",8,13,2512,2481,31,1400,1036,364,0.928873287252686,0.639810426540284,1.75197182486195,639,308,331,16,1.1,35.79,2.8,0,0,0,0,0,0,0.0476939058312824,48.892527526986,5.40061040443355
8.7,"random_policy_SVM","SVM",8,14,2412,2384,28,1500,1133,367,0.929855103953076,0.639810426540284,1.75680707368862,645,311,334,6,1.1,38.34,3.1,0,0,0,0,0,0,0.0456211132924817,48.2197037063558,5.27683035608957
8.7,"random_policy_SVM","SVM",8,15,2312,2293,19,1600,1224,376,0.929776341340863,0.639810426540284,1.74827888401052,674,322,352,29,1.1,40.9,3.3,0,0,0,0,0,0,0.044386068846832,47.6433685667985,5.43113436232466
8.7,"random_policy_SVM","SVM",8,16,2212,2199,13,1700,1318,382,0.929436847322747,0.635071090047393,1.74827888401052,691,329,362,17,1.1,43.46,3.5,0,0,0,0,0,0,0.0368705120389571,41.8597076634178,4.3408167500164
8.7,"random_policy_SVM","SVM",8,17,2112,2099,13,1800,1418,382,0.929447711131327,0.635071090047393,1.74827888401052,689,331,358,-2,1.1,46.01,3.7,0,0,0,0,0,0,0.0288715318768365,32.1952663982587,3.14148162363013
8.7,"random_policy_SVM","SVM",8,18,2012,2000,12,1900,1517,383,0.929985469656026,0.635071090047393,1.74827888401052,699,334,365,10,1.1,48.57,4,0,0,0,0,0,0,0.0243884554466001,27.4109372289812,2.64590127422389
8.7,"random_policy_SVM","SVM",8,19,1912,1904,8,2000,1613,387,0.929583508738576,0.630331753554502,1.74827888401052,710,340,370,11,1.1,51.12,4.2,0,0,0,0,0,0,0.0230380677935653,25.049778455657,2.40934431732834
8.7,"random_policy_SVM","SVM",8,20,1812,1805,7,2100,1712,388,0.929607952307873,0.625592417061611,1.76696080228326,719,349,370,9,1.1,53.68,4.4,0,0,0,0,0,0,0.0152169340808629,14.7107856978377,1.86704708409605
8.7,"random_policy_SVM","SVM",8,21,1712,1706,6,2200,1811,389,0.929284754002626,0.625592417061611,1.76533526336672,721,350,371,2,1.1,56.24,4.7,0,0,0,0,0,0,0.013996918431899,13.723563119932,1.4531281422571
8.7,"random_policy_SVM","SVM",8,22,1612,1606,6,2300,1911,389,0.930330395578431,0.616113744075829,1.76533526336672,732,358,374,11,1,58.79,4.9,0,0,0,0,0,0,0.0104712749740135,7.81674291789365,1.28062174424469
8.7,"random_policy_SVM","SVM",8,23,1512,1507,5,2400,2010,390,0.930399652358126,0.62085308056872,1.76696080228326,735,358,377,3,1.1,61.35,5.2,0,0,0,0,0,0,0.00802163146448188,6.91853840229092,0.892931525778139
8.7,"random_policy_SVM","SVM",8,24,1412,1408,4,2500,2109,391,0.930130773095782,0.616113744075829,1.76696080228326,737,361,376,2,1,63.91,5.4,0,0,0,0,0,0,0.0093388066024082,7.2820914127637,0.950553158381435
8.7,"random_policy_SVM","SVM",8,25,1312,1308,4,2600,2209,391,0.931758986406667,0.62085308056872,1.7685893375849,759,372,387,22,1,66.46,5.6,0,0,0,0,0,0,0.00557259615111882,3.76412087928806,0.684338129939538
8.7,"random_policy_SVM","SVM",8,26,1212,1208,4,2700,2309,391,0.931715531172348,0.62085308056872,1.76371271257318,762,371,391,3,1.1,69.02,5.9,0,0,0,0,0,0,0.00445815216013708,3.01739052110935,0.479656633416227
8.7,"random_policy_SVM","SVM",8,27,1112,1108,4,2800,2409,391,0.931878488301039,0.62085308056872,1.76696080228326,765,375,390,3,1,71.57,6.2,0,0,0,0,0,0,0.00398045701863439,2.418956073062,0.411109277468743
8.7,"random_policy_SVM","SVM",8,28,1012,1009,3,2900,2508,392,0.932193538749838,0.625592417061611,1.7685893375849,770,378,392,5,1,74.13,6.4,0,0,0,0,0,0,0.00349954385423135,1.95377741766098,0.371275219705441
8.7,"random_policy_SVM","SVM",8,29,912,909,3,3000,2608,392,0.932006138051836,0.625592417061611,1.7685893375849,771,378,393,1,1,76.69,6.7,0,0,0,0,0,0,0.00297401641742452,1.45319491377302,0.311737403332673
8.7,"random_policy_SVM","SVM",8,30,812,809,3,3100,2708,392,0.932086258640111,0.62085308056872,1.76696080228326,771,378,393,0,1,79.24,6.9,0,0,0,0,0,0,0.00224382845448003,0.974242069117563,0.241163985625739
8.7,"random_policy_SVM","SVM",8,31,712,710,2,3200,2807,393,0.931991200315041,0.62085308056872,1.76696080228326,776,379,397,5,1,81.8,7.1,0,0,0,0,0,0,0.00198680083346402,0.814215263640538,0.221201559811918
8.7,"random_policy_SVM","SVM",8,32,612,610,2,3300,2907,393,0.932216624343069,0.62085308056872,1.76696080228326,776,380,396,0,1,84.36,7.4,0,0,0,0,0,0,0.00172635583521046,0.628367628753933,0.190572158210849
8.7,"random_policy_SVM","SVM",8,33,512,511,1,3400,3006,394,0.932156873395887,0.616113744075829,1.76371271257318,780,382,398,4,1,86.91,7.6,0,0,0,0,0,0,0.00154276902821272,0.528202909616827,0.174902348767178
8.7,"random_policy_SVM","SVM",8,34,412,412,0,3500,3105,395,0.931797009736693,0.62085308056872,1.76533526336672,781,384,397,1,1,89.47,7.9,0,0,0,0,0,0,0.00143234262563706,0.438224340491817,0.167530890783108
8.7,"random_policy_SVM","SVM",8,35,312,312,0,3600,3205,395,0.932473281820772,0.62085308056872,1.77713324742831,789,386,403,8,1,92.02,8.1,0,0,0,0,0,0,0.000905343891016368,0.232381445858837,0.109959264554662
8.7,"random_policy_SVM","SVM",8,36,212,212,0,3700,3305,395,0.932660682518773,0.62085308056872,1.77386345304482,791,386,405,2,1,94.58,8.4,0,0,0,0,0,0,0.00054841667023449,0.117290911349574,0.070674837599868
8.7,"random_policy_SVM","SVM",8,37,112,112,0,3800,3405,395,0.93298388082402,0.62085308056872,1.77713324742831,793,386,407,2,1.1,97.14,8.6,0,0,0,0,0,0,0.000302204550985255,0.0448705105572833,0.0415799843371851
8.7,"random_policy_SVM","SVM",8,38,12,12,0,3900,3505,395,0.933135974144135,0.616113744075829,1.77223306384165,796,388,408,3,1.1,99.69,8.9,0,0,0,0,0,0,0.000161586387228936,0.00289729490807813,0.00289729490807813
8.7,"random_policy_SVM","SVM",8,39,0,0,0,3912,3517,395,0.933106098670541,0.616113744075829,1.76898126005478,799,389,410,3,1.1,100,8.9,0,0,0,0,0,0,0,0,0
8.7,"random_policy_SVM","SVM",9,0,3812,3417,395,100,91,9,0.907555008636557,0.569306930693069,1.74029292330155,26,9,17,0,1.9,2.56,10.1,0,0,0,0,0,0,0.2185421421063,294.060743148403,23.4529229963418
8.7,"random_policy_SVM","SVM",9,1,3712,3391,321,200,117,83,0.919825406143815,0.569306930693069,1.77672813152875,92,46,46,66,1,5.11,1.4,0,0,0,0,0,0,0.628424995371959,264.938163771793,76.9381830721159
8.7,"random_policy_SVM","SVM",9,2,3612,3349,263,300,159,141,0.924009618749797,0.638613861386139,1.7662241017869,165,85,80,73,0.9,7.67,1.1,0,0,0,0,0,0,0.487465897142606,211.107436251287,66.315112634174
8.7,"random_policy_SVM","SVM",9,3,3512,3302,210,400,206,194,0.908633166623409,0.623762376237624,1.73709091240311,255,127,128,90,1,10.22,1.1,0,0,0,0,0,0,0.350944736270609,178.856311694392,57.1581028320469
8.7,"random_policy_SVM","SVM",9,4,3412,3245,167,500,263,237,0.89378450387798,0.633663366336634,1.67319452533489,327,163,164,72,1,12.78,1.1,0,0,0,0,0,0,0.174852759475047,132.153625281618,30.006763617967
8.7,"random_policy_SVM","SVM",9,5,3312,3184,128,600,324,276,0.898610813190778,0.668316831683168,1.65387447835693,405,200,205,78,1,15.34,1.2,0,0,0,0,0,0,0.151326901355845,137.989647696981,20.5638830131425
8.7,"random_policy_SVM","SVM",9,6,3212,3109,103,700,399,301,0.904173769714484,0.668316831683168,1.65691748567681,463,222,241,58,1.1,17.89,1.3,0,0,0,0,0,0,0.0995607765997529,112.944617984683,12.7388525143597
8.7,"random_policy_SVM","SVM",9,7,3112,3040,72,800,468,332,0.903708073201839,0.678217821782178,1.65084262780082,537,258,279,74,1.1,20.45,1.4,0,0,0,0,0,0,0.10258991731088,167.208394946872,14.8448634258614
8.7,"random_policy_SVM","SVM",9,8,3012,2952,60,900,556,344,0.906894566309536,0.683168316831683,1.66582564420195,558,270,288,21,1.1,23.01,1.6,0,0,0,0,0,0,0.0758706704285745,123.137289033975,8.68547170106885
8.7,"random_policy_SVM","SVM",9,9,2912,2859,53,1000,649,351,0.913640109735027,0.678217821782178,1.67319452533489,587,281,306,29,1.1,25.56,1.8,0,0,0,0,0,0,0.0702992956950645,112.504475978688,7.68623038634883
8.7,"random_policy_SVM","SVM",9,10,2812,2763,49,1100,745,355,0.928141616898309,0.663366336633663,1.71194135988184,611,298,313,24,1.1,28.12,2.1,0,0,0,0,0,0,0.0612906047220601,80.187267768349,7.19015436477494
8.7,"random_policy_SVM","SVM",9,11,2712,2672,40,1200,836,364,0.931136186594732,0.678217821782178,1.71140245892721,636,308,328,25,1.1,30.67,2.3,0,0,0,0,0,0,0.0601362374330989,76.8398402397741,6.81003102299596
8.7,"random_policy_SVM","SVM",9,12,2612,2576,36,1300,932,368,0.935230082301282,0.663366336633663,1.72342628758289,653,315,338,17,1.1,33.23,2.5,0,0,0,0,0,0,0.0582264861352862,65.7107609858409,6.28205291874305
8.7,"random_policy_SVM","SVM",9,13,2512,2478,34,1400,1030,370,0.937053354708338,0.668316831683168,1.75652316612877,657,317,340,4,1.1,35.79,2.8,0,0,0,0,0,0,0.0495890589256099,55.5467650405183,5.34372869356878
8.7,"random_policy_SVM","SVM",9,14,2412,2382,30,1500,1126,374,0.938686114905692,0.668316831683168,1.76706666058311,671,321,350,14,1.1,38.34,3,0,0,0,0,0,0,0.0496206089030877,48.2221157513128,5.65570731739322
8.7,"random_policy_SVM","SVM",9,15,2312,2286,26,1600,1222,378,0.938299445680045,0.673267326732673,1.76381538797854,684,328,356,13,1.1,40.9,3.2,0,0,0,0,0,0,0.0466791417945823,41.9408869029352,5.53509247232471
8.7,"random_policy_SVM","SVM",9,16,2212,2195,17,1700,1313,387,0.938869571107637,0.683168316831683,1.76381538797854,709,340,369,25,1.1,43.46,3.4,0,0,0,0,0,0,0.0364096634055543,37.5684342411261,4.67067226455427
8.7,"random_policy_SVM","SVM",9,17,2112,2098,14,1800,1410,390,0.939580816690577,0.683168316831683,1.76057605760576,716,342,374,7,1.1,46.01,3.6,0,0,0,0,0,0,0.0316143456424705,32.2135666844868,3.26710156548544
8.7,"random_policy_SVM","SVM",9,18,2012,1998,14,1900,1510,390,0.938372828160821,0.658415841584158,1.77599123967696,738,355,383,22,1.1,48.57,3.9,0,0,0,0,0,0,0.0227440677331736,17.2284304706523,2.93477705027667
8.7,"random_policy_SVM","SVM",9,19,1912,1900,12,2000,1608,392,0.938959888007055,0.653465346534653,1.77272354650368,741,357,384,3,1.1,51.12,4.1,0,0,0,0,0,0,0.0169648796246739,14.360316838823,1.95912377077325
8.7,"random_policy_SVM","SVM",9,20,1812,1801,11,2100,1707,393,0.939075606534438,0.653465346534653,1.77599123967696,743,358,385,2,1.1,53.68,4.3,0,0,0,0,0,0,0.0127702101245906,11.622142061025,1.41824937940458
8.7,"random_policy_SVM","SVM",9,21,1712,1704,8,2200,1804,396,0.939594928706108,0.653465346534653,1.77599123967696,753,362,391,10,1.1,56.24,4.6,0,0,0,0,0,0,0.0129063157108435,10.8960521496195,1.32184586189263
8.7,"random_policy_SVM","SVM",9,22,1612,1604,8,2300,1904,396,0.938765142192675,0.653465346534653,1.77999417588818,762,373,389,9,1,58.79,4.8,0,0,0,0,0,0,0.00895374243958673,6.7233016546173,1.06474374100233
8.7,"random_policy_SVM","SVM",9,23,1512,1504,8,2400,2004,396,0.938780665409763,0.653465346534653,1.78327224987692,760,371,389,-2,1,61.35,5.1,0,0,0,0,0,0,0.00750004125445114,5.65953615660006,0.800187307057261
8.7,"random_policy_SVM","SVM",9,24,1412,1404,8,2500,2104,396,0.938803244634618,0.653465346534653,1.78327224987692,764,373,391,4,1,63.91,5.3,0,0,0,0,0,0,0.00664036718215608,4.56484366114346,0.682487363907102
8.7,"random_policy_SVM","SVM",9,25,1312,1305,7,2600,2203,397,0.938592975603153,0.653465346534653,1.77999417588818,770,377,393,6,1,66.46,5.5,0,0,0,0,0,0,0.00535504670928244,3.46358934334892,0.587734650651488
8.7,"random_policy_SVM","SVM",9,26,1212,1206,6,2700,2302,398,0.938614143626456,0.648514851485149,1.77999417588818,774,379,395,4,1,69.02,5.8,0,0,0,0,0,0,0.00513954118235265,2.94901604716136,0.531817139326948
8.7,"random_policy_SVM","SVM",9,27,1112,1106,6,2800,2402,398,0.938139979904497,0.648514851485149,1.77999417588818,779,379,400,5,1.1,71.57,6,0,0,0,0,0,0,0.00442715807806517,2.28014258191942,0.467335781954394
8.7,"random_policy_SVM","SVM",9,28,1012,1006,6,2900,2502,398,0.938138568702944,0.648514851485149,1.78163170502883,778,380,398,-1,1,74.13,6.3,0,0,0,0,0,0,0.00379599591064901,1.70685028206533,0.402785865861343
8.7,"random_policy_SVM","SVM",9,29,912,907,5,3000,2601,399,0.938290978470716,0.648514851485149,1.78491581877082,782,383,399,4,1,76.69,6.5,0,0,0,0,0,0,0.0037707419942382,1.56103398834307,0.410346732714088
8.7,"random_policy_SVM","SVM",9,30,812,808,4,3100,2700,400,0.938350248935961,0.653465346534653,1.78163170502883,785,385,400,3,1,79.24,6.8,0,0,0,0,0,0,0.0033637335113407,1.26133290023577,0.369963025155471
8.7,"random_policy_SVM","SVM",9,31,712,708,4,3200,2800,400,0.938257109633433,0.648514851485149,1.77999417588818,786,385,401,1,1,81.8,7,0,0,0,0,0,0,0.00212170775177706,0.692242480868444,0.235673750059261
8.7,"random_policy_SVM","SVM",9,32,612,609,3,3300,2899,401,0.938429276222954,0.648514851485149,1.78163170502883,792,386,406,6,1.1,84.36,7.2,0,0,0,0,0,0,0.00185907704649894,0.565906796793378,0.220929750880129
8.7,"random_policy_SVM","SVM",9,33,512,509,3,3400,2999,401,0.938652246068399,0.648514851485149,1.77835965414723,792,386,406,0,1.1,86.91,7.5,0,0,0,0,0,0,0.000997723063310186,0.319494499452317,0.134179984316647
8.7,"random_policy_SVM","SVM",9,34,412,409,3,3500,3099,401,0.938736918161606,0.648514851485149,1.78163170502883,796,387,409,4,1.1,89.47,7.7,0,0,0,0,0,0,0.000714010352658143,0.208928592864253,0.0902137780735161
8.7,"random_policy_SVM","SVM",9,35,312,312,0,3600,3196,404,0.939772740101838,0.653465346534653,1.79053986355397,807,396,411,11,1,92.02,7.9,0,0,0,0,0,0,0.000980260196287573,0.249847880094007,0.124483292452152
8.7,"random_policy_SVM","SVM",9,36,212,212,0,3700,3296,404,0.940039457195439,0.653465346534653,1.78889414676762,814,396,418,7,1.1,94.58,8.2,0,0,0,0,0,0,0.000535412944991895,0.114504671882561,0.0722021368241588
8.7,"random_policy_SVM","SVM",9,37,112,112,0,3800,3396,404,0.940213034986513,0.653465346534653,1.79053986355397,814,397,417,0,1.1,97.14,8.4,0,0,0,0,0,0,0.000258147672882982,0.0418435870130976,0.039033390884388
8.7,"random_policy_SVM","SVM",9,38,12,12,0,3900,3496,404,0.940317463901469,0.653465346534653,1.78725145241797,812,397,415,-2,1,99.69,8.7,0,0,0,0,0,0,0.000172190537890758,0.00258611302254672,0.00258611302254672
8.7,"random_policy_SVM","SVM",9,39,0,0,0,3912,3508,404,0.940369678358946,0.653465346534653,1.78889414676762,813,397,416,1,1,100,8.7,0,0,0,0,0,0,0,0,0
8.7,"random_policy_SVM","SVM",10,0,3812,3411,401,100,89,11,0.897027159858188,0.541237113402062,1.67580850162406,28,11,17,0,1.5,2.56,8.1,0,0,0,0,0,0,0.535637693659268,405.021371525579,58.2543814328756
8.7,"random_policy_SVM","SVM",10,1,3712,3391,321,200,109,91,0.906533402763973,0.551546391752577,1.74219223771983,73,38,35,45,0.9,5.11,1.2,0,0,0,0,0,0,0.736038089743572,271.272341760028,84.5958757068409
8.7,"random_policy_SVM","SVM",10,2,3612,3342,270,300,158,142,0.921390289853391,0.623711340206186,1.77488716803649,161,82,79,88,1,7.67,1.1,0,0,0,0,0,0,0.566383276965874,242.249962940289,70.3077861474132
8.7,"random_policy_SVM","SVM",10,3,3512,3299,213,400,201,199,0.902453865686828,0.61340206185567,1.69741746412618,248,127,121,87,1,10.22,1,0,0,0,0,0,0,0.459982185367395,253.007211348776,61.5789805315707
8.7,"random_policy_SVM","SVM",10,4,3412,3247,165,500,253,247,0.89382086897506,0.628865979381443,1.67578313595183,313,156,157,65,1,12.78,1,0,0,0,0,0,0,0.291097728992278,179.648289384656,43.2574914978379
8.7,"random_policy_SVM","SVM",10,5,3312,3178,134,600,322,278,0.893557578665294,0.618556701030928,1.67266853532234,399,196,203,86,1,15.34,1.2,0,0,0,0,0,0,0.120401209800018,79.672583590245,18.2135196528183
8.7,"random_policy_SVM","SVM",10,6,3212,3104,108,700,396,304,0.891012439004405,0.644329896907217,1.64800772485871,450,219,231,51,1.1,17.89,1.3,0,0,0,0,0,0,0.100388384065988,82.2069753294369,13.6834899609311
8.7,"random_policy_SVM","SVM",10,7,3112,3024,88,800,476,324,0.889526311478284,0.654639175257732,1.64327618613658,507,242,265,57,1.1,20.45,1.5,0,0,0,0,0,0,0.0658818445932045,75.2898211286885,12.2232172904304
8.7,"random_policy_SVM","SVM",10,8,3012,2945,67,900,555,345,0.887964122307122,0.654639175257732,1.64176443251548,550,264,286,43,1.1,23.01,1.6,0,0,0,0,0,0,0.0620131337729434,87.7689614923036,7.39650596131081
8.7,"random_policy_SVM","SVM",10,9,2912,2849,63,1000,651,349,0.893817943527149,0.65979381443299,1.65103993778393,567,275,292,17,1.1,25.56,1.9,0,0,0,0,0,0,0.0485195285161353,63.7856858583851,5.40140797008298
8.7,"random_policy_SVM","SVM",10,10,2812,2756,56,1100,744,356,0.896485951999248,0.649484536082474,1.65408332937432,583,282,301,16,1.1,28.12,2.1,0,0,0,0,0,0,0.0473030391759306,62.0891791949792,5.2692493429235
8.7,"random_policy_SVM","SVM",10,11,2712,2657,55,1200,843,357,0.896746316861105,0.65979381443299,1.67266853532234,586,286,300,3,1,30.67,2.4,0,0,0,0,0,0,0.0334278508747373,41.0912154332317,3.73761241164124
8.7,"random_policy_SVM","SVM",10,12,2612,2561,51,1300,939,361,0.907336438208687,0.649484536082474,1.66959094832083,607,296,311,21,1.1,33.23,2.6,0,0,0,0,0,0,0.0310902478274059,34.9011334667646,3.61699338122259
8.7,"random_policy_SVM","SVM",10,13,2512,2468,44,1400,1032,368,0.920584328960762,0.654639175257732,1.71754855613146,630,306,324,23,1.1,35.79,2.8,0,0,0,0,0,0,0.0328493177355236,44.2244194270176,4.04078879591997
8.7,"random_policy_SVM","SVM",10,14,2412,2376,36,1500,1124,376,0.936295446832909,0.639175257731959,1.73771675614043,665,325,340,35,1,38.34,3,0,0,0,0,0,0,0.0517693685364975,49.4449249822228,6.04561512446703
8.7,"random_policy_SVM","SVM",10,15,2312,2282,30,1600,1218,382,0.943325298103143,0.634020618556701,1.79779411764706,686,333,353,21,1.1,40.9,3.2,0,0,0,0,0,0,0.0572894023025855,44.0698391865507,6.29551852018516
8.7,"random_policy_SVM","SVM",10,16,2212,2185,27,1700,1315,385,0.94457885252232,0.634020618556701,1.80110497237569,700,339,361,14,1.1,43.46,3.4,0,0,0,0,0,0,0.0488439492814451,35.8867929228833,5.50872785655146
8.7,"random_policy_SVM","SVM",10,17,2112,2088,24,1800,1412,388,0.944899189065847,0.634020618556701,1.80276497695853,708,344,364,8,1.1,46.01,3.6,0,0,0,0,0,0,0.0393520799695813,25.992327333731,4.54277718306687
8.7,"random_policy_SVM","SVM",10,18,2012,1993,19,1900,1507,393,0.944232186947822,0.639175257731959,1.80276497695853,719,349,370,11,1.1,48.57,3.8,0,0,0,0,0,0,0.0365521073545341,24.5648791499303,4.54396850414494
8.7,"random_policy_SVM","SVM",10,19,1912,1898,14,2000,1602,398,0.943228758322899,0.639175257731959,1.80276497695853,732,355,377,13,1.1,51.12,4,0,0,0,0,0,0,0.0280637396780204,22.0684786269543,3.61370151260455
8.7,"random_policy_SVM","SVM",10,20,1812,1801,11,2100,1699,401,0.943494974080531,0.634020618556701,1.79944802207912,742,360,382,10,1.1,53.68,4.2,0,0,0,0,0,0,0.0220895190320198,18.2781069519689,2.48012418872722
8.7,"random_policy_SVM","SVM",10,21,1712,1701,11,2200,1799,401,0.943290192728505,0.634020618556701,1.79944802207912,744,359,385,2,1.1,56.24,4.5,0,0,0,0,0,0,0.0186596250794026,16.6406391990736,2.03229206546842
8.7,"random_policy_SVM","SVM",10,22,1612,1602,10,2300,1898,402,0.94317610026095,0.634020618556701,1.80276497695853,747,362,385,3,1.1,58.79,4.7,0,0,0,0,0,0,0.0164606154763871,12.9679110064739,1.66387105462343
8.7,"random_policy_SVM","SVM",10,23,1512,1503,9,2400,1997,403,0.942716804942838,0.639175257731959,1.79944802207912,779,379,400,32,1.1,61.35,5,0,0,0,0,0,0,0.011419003006903,7.1548920666989,1.50704917592738
8.7,"random_policy_SVM","SVM",10,24,1412,1404,8,2500,2096,404,0.942766537556901,0.634020618556701,1.80276497695853,778,378,400,-1,1.1,63.91,5.2,0,0,0,0,0,0,0.00872897710532771,6.24359743221356,1.01860843167791
8.7,"random_policy_SVM","SVM",10,25,1312,1304,8,2600,2196,404,0.94295376622161,0.634020618556701,1.79944802207912,779,378,401,1,1.1,66.46,5.4,0,0,0,0,0,0,0.00704239506769204,4.77906854676143,0.73710706938025
8.7,"random_policy_SVM","SVM",10,26,1212,1204,8,2700,2296,404,0.942585159787965,0.634020618556701,1.79944802207912,785,382,403,6,1.1,69.02,5.7,0,0,0,0,0,0,0.00559755210493091,3.48574841040469,0.607679485127367
8.7,"random_policy_SVM","SVM",10,27,1112,1105,7,2800,2395,405,0.942506172695041,0.634020618556701,1.79944802207912,786,383,403,1,1.1,71.57,5.9,0,0,0,0,0,0,0.00568381076283523,3.12945199113417,0.58205139467847
8.7,"random_policy_SVM","SVM",10,28,1012,1005,7,2900,2495,405,0.942519337210528,0.634020618556701,1.80110497237569,795,387,408,9,1.1,74.13,6.2,0,0,0,0,0,0,0.00437141870722067,2.17235065117566,0.474528173669833
8.7,"random_policy_SVM","SVM",10,29,912,906,6,3000,2594,406,0.942463753700693,0.634020618556701,1.80110497237569,796,389,407,1,1,76.69,6.4,0,0,0,0,0,0,0.00452850282903676,1.90779505281309,0.473063917835131
8.7,"random_policy_SVM","SVM",10,30,812,806,6,3100,2694,406,0.942437424669719,0.623711340206186,1.80110497237569,799,391,408,3,1,79.24,6.6,0,0,0,0,0,0,0.00349628092068401,1.3010443077811,0.387736502169207
8.7,"random_policy_SVM","SVM",10,31,712,707,5,3200,2793,407,0.942485694559839,0.623711340206186,1.79944802207912,803,392,411,4,1,81.8,6.9,0,0,0,0,0,0,0.00358874610496551,1.16467456855064,0.39632514536706
8.7,"random_policy_SVM","SVM",10,32,612,608,4,3300,2892,408,0.942512023590814,0.618556701030928,1.80276497695853,811,394,417,8,1.1,84.36,7.1,0,0,0,0,0,0,0.00269203041163611,0.787667572056127,0.314530805171155
8.7,"random_policy_SVM","SVM",10,33,512,508,4,3400,2992,408,0.942602712475282,0.623711340206186,1.79944802207912,813,394,419,2,1.1,86.91,7.3,0,0,0,0,0,0,0.00154491366357336,0.438974626162363,0.200691918834751
8.7,"random_policy_SVM","SVM",10,34,412,411,1,3500,3089,411,0.942785552968162,0.623711340206186,1.80110497237569,822,399,423,9,1.1,89.47,7.5,0,0,0,0,0,0,0.00142534904544058,0.422492507059483,0.181125116301486
8.7,"random_policy_SVM","SVM",10,35,312,312,0,3600,3188,412,0.942684625016093,0.623711340206186,1.80276497695853,825,402,423,3,1.1,92.02,7.7,0,0,0,0,0,0,0.00095498523979735,0.237245335870892,0.117252636879547
8.7,"random_policy_SVM","SVM",10,36,212,212,0,3700,3288,412,0.942671460500606,0.623711340206186,1.80110497237569,830,404,426,5,1.1,94.58,8,0,0,0,0,0,0,0.000529782848629423,0.10991140859764,0.0693120344682683
8.7,"random_policy_SVM","SVM",10,37,112,112,0,3800,3388,412,0.942731432182271,0.623711340206186,1.79944802207912,834,404,430,4,1.1,97.14,8.2,0,0,0,0,0,0,0.000245099098955931,0.0406956135792187,0.0381037942477867
8.7,"random_policy_SVM","SVM",10,38,12,12,0,3900,3488,412,0.942690475911866,0.623711340206186,1.80276497695853,835,405,430,1,1.1,99.69,8.5,0,0,0,0,0,0,0.000148051954155697,0.00207551734073836,0.00207551734073836
8.7,"random_policy_SVM","SVM",10,39,0,0,0,3912,3500,412,0.94270217770341,0.623711340206186,1.80276497695853,834,405,429,-1,1.1,100,8.5,0,0,0,0,0,0,0,0,0
8.7,"random_policy_SVM","SVM",11,0,3812,3410,402,100,94,6,0.898734213580625,0.55050505050505,1.7026113671275,17,6,11,0,1.8,2.56,15.7,0,0,0,0,0,0,0.198603767043443,202.592988885481,22.2717265784433
8.7,"random_policy_SVM","SVM",11,1,3712,3373,339,200,131,69,0.90564633824019,0.555555555555556,1.7208211143695,99,52,47,82,0.9,5.11,1.9,0,0,0,0,0,0,0.597869016416922,258.320635393004,71.4100579360763
8.7,"random_policy_SVM","SVM",11,2,3612,3345,267,300,159,141,0.915750221210966,0.595959595959596,1.75824298026133,160,82,78,61,1,7.67,1.1,0,0,0,0,0,0,0.525737421446532,207.152037686114,69.4121054724735
8.7,"random_policy_SVM","SVM",11,3,3512,3308,204,400,196,204,0.906873053630724,0.575757575757576,1.7208211143695,237,119,118,77,1,10.22,1,0,0,0,0,0,0,0.426900210573322,174.639844994312,63.1173710830352
8.7,"random_policy_SVM","SVM",11,4,3412,3254,158,500,250,250,0.906985095551658,0.611111111111111,1.7283330542999,318,161,157,81,1,12.78,1,0,0,0,0,0,0,0.234455163515847,147.002920472779,38.8649306656138
8.7,"random_policy_SVM","SVM",11,5,3312,3186,126,600,318,282,0.891951368060583,0.611111111111111,1.66619187264349,403,199,204,85,1,15.34,1.1,0,0,0,0,0,0,0.125069122480691,86.1337383082587,19.6001124949645
8.7,"random_policy_SVM","SVM",11,6,3212,3117,95,700,387,313,0.898584824352738,0.631313131313131,1.67221432354827,471,229,242,68,1.1,17.89,1.2,0,0,0,0,0,0,0.108226232083275,96.1060797366603,15.5414132151345
8.7,"random_policy_SVM","SVM",11,7,3112,3044,68,800,460,340,0.891914020753611,0.646464646464647,1.64494995957737,534,256,278,63,1.1,20.45,1.4,0,0,0,0,0,0,0.0944946218018954,120.050786514719,12.7360955892492
8.7,"random_policy_SVM","SVM",11,8,3012,2951,61,900,553,347,0.892557543581432,0.651515151515151,1.64798212540148,548,263,285,14,1.1,23.01,1.6,0,0,0,0,0,0,0.0616307817113358,78.705431225699,7.01450926354777
8.7,"random_policy_SVM","SVM",11,9,2912,2861,51,1000,643,357,0.892175451902418,0.661616161616162,1.63586183825374,583,276,307,35,1.1,25.56,1.8,0,0,0,0,0,0,0.0609444874045611,92.577015640448,6.84986192519998
8.7,"random_policy_SVM","SVM",11,10,2812,2761,51,1100,743,357,0.897944174394684,0.656565656565657,1.64798212540148,586,278,308,3,1.1,28.12,2.1,0,0,0,0,0,0,0.0451440227082525,64.4823171971778,4.95260794663824
8.7,"random_policy_SVM","SVM",11,11,2712,2664,48,1200,840,360,0.900278381080431,0.641414141414141,1.65556113622412,592,282,310,6,1.1,30.67,2.3,0,0,0,0,0,0,0.0389983355174577,57.2401786750173,4.18596484009051
8.7,"random_policy_SVM","SVM",11,12,2612,2567,45,1300,937,363,0.900825662771057,0.641414141414141,1.65556113622412,605,290,315,13,1.1,33.23,2.6,0,0,0,0,0,0,0.0424710834118194,55.5923328499922,4.86515925460568
8.7,"random_policy_SVM","SVM",11,13,2512,2468,44,1400,1036,364,0.904442605807791,0.636363636363636,1.67529674626449,605,291,314,0,1.1,35.79,2.8,0,0,0,0,0,0,0.0302373989938718,39.8118042618104,3.25355837027718
8.7,"random_policy_SVM","SVM",11,14,2412,2371,41,1500,1133,367,0.924857218372567,0.636363636363636,1.74491929413733,635,309,326,30,1.1,38.34,3.1,0,0,0,0,0,0,0.0295989200014046,27.6666972493969,3.56036321743842
8.7,"random_policy_SVM","SVM",11,15,2312,2276,36,1600,1228,372,0.927040599395544,0.636363636363636,1.73264323677547,651,315,336,16,1.1,40.9,3.3,0,0,0,0,0,0,0.0257469961702529,28.3986360580101,3.04951587513934
8.7,"random_policy_SVM","SVM",11,16,2212,2184,28,1700,1320,380,0.931499293274026,0.641414141414141,1.77381550309727,675,327,348,24,1.1,43.46,3.5,0,0,0,0,0,0,0.0599596175455642,40.5392526767173,7.15104519382678
8.7,"random_policy_SVM","SVM",11,17,2112,2085,27,1800,1419,381,0.931884257822814,0.641414141414141,1.76730608840701,687,333,354,12,1.1,46.01,3.7,0,0,0,0,0,0,0.0470810280418265,32.3290139288285,5.42040402367255
8.7,"random_policy_SVM","SVM",11,18,2012,1988,24,1900,1516,384,0.931467691706593,0.636363636363636,1.76568619281727,695,339,356,8,1.1,48.57,3.9,0,0,0,0,0,0,0.0368119080712606,22.4689115131107,4.16460252558963
8.7,"random_policy_SVM","SVM",11,19,1912,1893,19,2000,1611,389,0.930197883269549,0.636363636363636,1.76568619281727,713,346,367,18,1.1,51.12,4.1,0,0,0,0,0,0,0.034391422330176,18.6989477633254,4.13741884045836
8.7,"random_policy_SVM","SVM",11,20,1812,1803,9,2100,1701,399,0.928714046034858,0.626262626262626,1.77055481283422,738,357,381,25,1.1,53.68,4.3,0,0,0,0,0,0,0.0354379569789505,19.1520004020774,4.84608797344896
8.7,"random_policy_SVM","SVM",11,21,1712,1705,7,2200,1799,401,0.929331713034779,0.626262626262626,1.77381550309727,744,359,385,6,1.1,56.24,4.5,0,0,0,0,0,0,0.01880988685833,13.3892940599318,2.47891837872855
8.7,"random_policy_SVM","SVM",11,22,1612,1605,7,2300,1899,401,0.929292929292923,0.621212121212121,1.7689289590116,745,359,386,1,1.1,58.79,4.7,0,0,0,0,0,0,0.0141411571089408,10.9249535945777,1.61823774641876
8.7,"random_policy_SVM","SVM",11,23,1512,1506,6,2400,1998,402,0.929860321071919,0.626262626262626,1.76730608840701,750,361,389,5,1.1,61.35,5,0,0,0,0,0,0,0.0115103076609119,9.11858377045546,1.25869258236425
8.7,"random_policy_SVM","SVM",11,24,1412,1407,5,2500,2097,403,0.930536881902061,0.626262626262626,1.77545035609552,752,364,388,2,1.1,63.91,5.2,0,0,0,0,0,0,0.00903146084780328,7.01543412675554,0.974923649649019
8.7,"random_policy_SVM","SVM",11,25,1312,1307,5,2600,2197,403,0.930615885820656,0.626262626262626,1.76730608840701,754,365,389,2,1.1,66.46,5.5,0,0,0,0,0,0,0.00813067920482244,6.31120058699685,0.883540354871962
8.7,"random_policy_SVM","SVM",11,26,1212,1207,5,2700,2297,403,0.930714999827621,0.626262626262626,1.77381550309727,754,365,389,0,1.1,69.02,5.7,0,0,0,0,0,0,0.00649033769381046,4.42419477638823,0.657329676337713
8.7,"random_policy_SVM","SVM",11,27,1112,1107,5,2800,2397,403,0.931614208064717,0.621212121212121,1.77545035609552,768,375,393,14,1,71.57,5.9,0,0,0,0,0,0,0.00536802875067015,3.29784459304332,0.661516908262039
8.7,"random_policy_SVM","SVM",11,28,1012,1008,4,2900,2496,404,0.931667356155408,0.621212121212121,1.77381550309727,771,375,396,3,1.1,74.13,6.2,0,0,0,0,0,0,0.00490795672709248,2.72424917741271,0.506806577542469
8.7,"random_policy_SVM","SVM",11,29,912,908,4,3000,2596,404,0.932240493673939,0.611111111111111,1.77055481283422,777,380,397,6,1,76.69,6.4,0,0,0,0,0,0,0.00361435488270712,1.78504467283232,0.391390316676786
8.7,"random_policy_SVM","SVM",11,30,812,809,3,3100,2695,405,0.931775088771675,0.606060606060606,1.77218365810822,784,384,400,7,1,79.24,6.7,0,0,0,0,0,0,0.0034988707176442,1.50128174519047,0.365686149123776
8.7,"random_policy_SVM","SVM",11,31,712,709,3,3200,2795,405,0.931849783385619,0.601010101010101,1.77055481283422,789,385,404,5,1,81.8,6.9,0,0,0,0,0,0,0.0028404674052629,1.02475814712706,0.304879230080016
8.7,"random_policy_SVM","SVM",11,32,612,610,2,3300,2894,406,0.931858401994918,0.601010101010101,1.77218365810822,794,389,405,5,1,84.36,7.1,0,0,0,0,0,0,0.00271184819283539,0.795086998993403,0.289560121003331
8.7,"random_policy_SVM","SVM",11,33,512,510,2,3400,2994,406,0.932004918353037,0.595959595959596,1.7689289590116,800,391,409,6,1,86.91,7.4,0,0,0,0,0,0,0.00176848126229342,0.486308607504398,0.22622217694366
8.7,"random_policy_SVM","SVM",11,34,412,410,2,3500,3094,406,0.932269222371607,0.601010101010101,1.77218365810822,801,391,410,1,1,89.47,7.6,0,0,0,0,0,0,0.000761897088857273,0.235759741651406,0.116051022637213
8.7,"random_policy_SVM","SVM",11,35,312,312,0,3600,3192,408,0.932879707197108,0.601010101010101,1.78291199285674,810,394,416,9,1.1,92.02,7.8,0,0,0,0,0,0,0.000858789053344701,0.219131086000296,0.110418783799652
8.7,"random_policy_SVM","SVM",11,36,212,212,0,3700,3292,408,0.933225888004039,0.590909090909091,1.78455522971652,811,395,416,1,1.1,94.58,8.1,0,0,0,0,0,0,0.000466260961003596,0.0982002672227278,0.0614412234362909
8.7,"random_policy_SVM","SVM",11,37,112,112,0,3800,3392,408,0.933724330908625,0.590909090909091,1.78291199285674,810,397,413,-1,1,97.14,8.3,0,0,0,0,0,0,0.000177065821201344,0.0286918681284965,0.0268214912222048
8.7,"random_policy_SVM","SVM",11,38,12,12,0,3900,3492,408,0.934234265292279,0.590909090909091,1.78127177943185,812,398,414,2,1,99.69,8.6,0,0,0,0,0,0,0.000134198120238703,0.00197798075618417,0.00197798075618417
8.7,"random_policy_SVM","SVM",11,39,0,0,0,3912,3504,408,0.934258684685299,0.595959595959596,1.78291199285674,812,398,414,0,1,100,8.6,0,0,0,0,0,0,0,0,0
8.7,"random_policy_SVM","SVM",12,0,3812,3429,383,100,83,17,0.886604715672676,0.519417475728155,1.67817134321989,40,17,23,0,1.4,2.56,4.9,0,0,0,0,0,0,0.755082958750557,602.92772327674,80.8889930204038
8.7,"random_policy_SVM","SVM",12,1,3712,3377,335,200,135,65,0.916418862690709,0.601941747572815,1.76450728378632,114,56,58,74,1,5.11,2.1,0,0,0,0,0,0,0.645297782642893,447.83846208602,73.9245298157924
8.7,"random_policy_SVM","SVM",12,2,3612,3334,278,300,178,122,0.918918169209415,0.640776699029126,1.72400340029529,182,92,90,68,1,7.67,1.5,0,0,0,0,0,0,0.500163125243634,302.257240381938,70.0924181241218
8.7,"random_policy_SVM","SVM",12,3,3512,3289,223,400,223,177,0.902016643550623,0.645631067961165,1.71209617634712,254,128,126,72,1,10.22,1.3,0,0,0,0,0,0,0.300654263046753,224.398179845359,52.226441910288
8.7,"random_policy_SVM","SVM",12,4,3412,3243,169,500,269,231,0.876355062413298,0.635922330097087,1.68899825511163,334,165,169,80,1,12.78,1.2,0,0,0,0,0,0,0.211406857948114,154.907773093521,33.0390273729134
8.7,"random_policy_SVM","SVM",12,5,3312,3166,146,600,346,254,0.879561719833554,0.669902912621359,1.62624041195087,382,183,199,48,1.1,15.34,1.4,0,0,0,0,0,0,0.150479706036776,106.021370460684,24.8790319872257
8.7,"random_policy_SVM","SVM",12,6,3212,3088,124,700,424,276,0.893536754507612,0.669902912621359,1.64791783679692,418,202,216,36,1.1,17.89,1.5,0,0,0,0,0,0,0.0777951684359951,65.0578140994136,11.097187293556
8.7,"random_policy_SVM","SVM",12,7,3112,3010,102,800,502,298,0.899633841886242,0.684466019417476,1.65968506890792,473,224,249,55,1.1,20.45,1.7,0,0,0,0,0,0,0.0735702459847229,88.583657778826,11.0221972141914
8.7,"random_policy_SVM","SVM",12,8,3012,2932,80,900,580,320,0.897320388349499,0.699029126213592,1.66274439622388,520,246,274,47,1.1,23.01,1.8,0,0,0,0,0,0,0.0616963722886552,89.2055157615714,9.8708722828501
8.7,"random_policy_SVM","SVM",12,9,2912,2841,71,1000,671,329,0.904493758668512,0.703883495145631,1.67715543805432,548,262,286,28,1.1,25.56,2,0,0,0,0,0,0,0.0606601276881422,82.5389155294049,7.19497145195891
8.7,"random_policy_SVM","SVM",12,10,2812,2747,65,1100,765,335,0.912352288488214,0.689320388349515,1.67869978007831,568,274,294,20,1.1,28.12,2.3,0,0,0,0,0,0,0.0450743825104038,57.7990142104026,5.22999585271339
8.7,"random_policy_SVM","SVM",12,11,2712,2656,56,1200,856,344,0.919456310679606,0.684466019417476,1.6961862361208,589,284,305,21,1.1,30.67,2.5,0,0,0,0,0,0,0.0448284322888717,62.8603163161617,5.08636724885165
8.7,"random_policy_SVM","SVM",12,12,2612,2564,48,1300,948,352,0.931342579750339,0.679611650485437,1.72083136092032,623,299,324,34,1.1,33.23,2.7,0,0,0,0,0,0,0.0512196377288813,61.2138318946275,6.07399922847531
8.7,"random_policy_SVM","SVM",12,13,2512,2476,36,1400,1036,364,0.940169209431357,0.669902912621359,1.74150597288712,663,318,345,40,1.1,35.79,2.8,0,0,0,0,0,0,0.0599730077386634,63.3481828270906,6.86655669400953
8.7,"random_policy_SVM","SVM",12,14,2412,2382,30,1500,1130,370,0.945914008321791,0.669902912621359,1.77487528831197,675,326,349,12,1.1,38.34,3.1,0,0,0,0,0,0,0.0620914996969671,61.7030680832844,6.95958079909275
8.7,"random_policy_SVM","SVM",12,15,2312,2285,27,1600,1227,373,0.946274618585313,0.669902912621359,1.7699858247078,686,331,355,11,1.1,40.9,3.3,0,0,0,0,0,0,0.0543223260151912,50.3645765446491,5.94273027651887
8.7,"random_policy_SVM","SVM",12,16,2212,2188,24,1700,1324,376,0.946779472954244,0.669902912621359,1.77487528831197,695,338,357,9,1.1,43.46,3.5,0,0,0,0,0,0,0.0499586998042354,43.1964633539195,5.59452446030541
8.7,"random_policy_SVM","SVM",12,17,2112,2093,19,1800,1419,381,0.94723994452151,0.674757281553398,1.77161264991433,712,342,370,17,1.1,46.01,3.7,0,0,0,0,0,0,0.0403039500384454,34.6449153650567,4.84657453386633
8.7,"random_policy_SVM","SVM",12,18,2012,1995,17,1900,1517,383,0.947353675450774,0.674757281553398,1.77324246835952,716,344,372,4,1.1,48.57,4,0,0,0,0,0,0,0.034341326090017,31.3643296722854,3.88075589597024
8.7,"random_policy_SVM","SVM",12,19,1912,1898,14,2000,1614,386,0.947626907073518,0.679611650485437,1.77487528831197,727,348,379,11,1.1,51.12,4.2,0,0,0,0,0,0,0.0261665589543815,24.7397135705394,2.89207692635719
8.7,"random_policy_SVM","SVM",12,20,1812,1799,13,2100,1713,387,0.947839112343975,0.679611650485437,1.7699858247078,732,350,382,5,1.1,53.68,4.4,0,0,0,0,0,0,0.0255836183653587,23.206524938855,2.60902383772779
8.7,"random_policy_SVM","SVM",12,21,1712,1699,13,2200,1813,387,0.94851595006935,0.674757281553398,1.78197765293272,746,363,383,14,1.1,56.24,4.7,0,0,0,0,0,0,0.0170188467483679,10.996664304659,2.27859583155652
8.7,"random_policy_SVM","SVM",12,22,1612,1603,9,2300,1909,391,0.949280166435508,0.674757281553398,1.78033980582524,754,367,387,8,1.1,58.79,4.9,0,0,0,0,0,0,0.0117275353073142,9.31163288523655,1.43152653870414
8.7,"random_policy_SVM","SVM",12,23,1512,1504,8,2400,2008,392,0.949276005547852,0.679611650485437,1.78526240436669,759,368,391,5,1.1,61.35,5.1,0,0,0,0,0,0,0.00975527599917405,7.66492087689174,1.02678091055846
8.7,"random_policy_SVM","SVM",12,24,1412,1406,6,2500,2106,394,0.949478502080439,0.679611650485437,1.78361851633321,775,377,398,16,1.1,63.91,5.3,0,0,0,0,0,0,0.00820798153880622,6.18034592861687,0.913268685389192
8.7,"random_policy_SVM","SVM",12,25,1312,1308,4,2600,2204,396,0.94891816920942,0.679611650485437,1.78526240436669,789,383,406,14,1.1,66.46,5.6,0,0,0,0,0,0,0.008023171922769,5.58772523124382,0.84571304023135
8.7,"random_policy_SVM","SVM",12,26,1212,1208,4,2700,2304,396,0.948962552011069,0.674757281553398,1.78361851633321,793,384,409,4,1.1,69.02,5.8,0,0,0,0,0,0,0.00582036190021122,3.78414438744646,0.656989090030626
8.7,"random_policy_SVM","SVM",12,27,1112,1108,4,2800,2404,396,0.948984743411901,0.674757281553398,1.77870496670144,792,384,408,-1,1.1,71.57,6.1,0,0,0,0,0,0,0.00509606955026095,2.8267819748998,0.520744641061257
8.7,"random_policy_SVM","SVM",12,28,1012,1008,4,2900,2504,396,0.948679611650458,0.674757281553398,1.78033980582524,795,388,407,3,1,74.13,6.3,0,0,0,0,0,0,0.0042170097867043,2.16862682999776,0.468403073495506
8.7,"random_policy_SVM","SVM",12,29,912,908,4,3000,2604,396,0.948808599167795,0.674757281553398,1.78033980582524,796,388,408,1,1.1,76.69,6.6,0,0,0,0,0,0,0.00378109906992416,1.65880738856774,0.398167638567269
8.7,"random_policy_SVM","SVM",12,30,812,808,4,3100,2704,396,0.948601941747546,0.674757281553398,1.78033980582524,796,389,407,0,1,79.24,6.8,0,0,0,0,0,0,0.00269700611110335,1.0009535568446,0.289556071891339
8.7,"random_policy_SVM","SVM",12,31,712,708,4,3200,2804,396,0.948690707350875,0.674757281553398,1.78361851633321,796,389,407,0,1,81.8,7.1,0,0,0,0,0,0,0.00252511164091666,0.810386505807716,0.276754542910018
8.7,"random_policy_SVM","SVM",12,32,612,611,1,3300,2901,399,0.948787794729516,0.684466019417476,1.77870496670144,806,393,413,10,1.1,84.36,7.3,0,0,0,0,0,0,0.00187339450158689,0.561528114852363,0.226176912282537
8.7,"random_policy_SVM","SVM",12,33,512,511,1,3400,3001,399,0.948696255201083,0.684466019417476,1.78361851633321,805,393,412,-1,1,86.91,7.5,0,0,0,0,0,0,0.00120635090552891,0.359553413184778,0.160957351713807
8.7,"random_policy_SVM","SVM",12,34,412,411,1,3500,3101,399,0.948785020804412,0.689320388349515,1.78197765293272,805,393,412,0,1,89.47,7.8,0,0,0,0,0,0,0.000694931317286672,0.20336288028725,0.0917923173846059
8.7,"random_policy_SVM","SVM",12,35,312,312,0,3600,3200,400,0.948732316227437,0.689320388349515,1.78197765293272,809,396,413,4,1,92.02,8,0,0,0,0,0,0,0.000679890137573768,0.164812867730616,0.0827713770932396
8.7,"random_policy_SVM","SVM",12,36,212,212,0,3700,3300,400,0.948762829403582,0.684466019417476,1.77057560213699,812,397,415,3,1,94.58,8.2,0,0,0,0,0,0,0.000279672195323358,0.0597130113890897,0.0384007541620125
8.7,"random_policy_SVM","SVM",12,37,112,112,0,3800,3400,400,0.948538141470156,0.684466019417476,1.77707312728244,818,399,419,6,1.1,97.14,8.5,0,0,0,0,0,0,0.000102190779886951,0.018503548773694,0.0173913834498842
8.7,"random_policy_SVM","SVM",12,38,12,12,0,3900,3500,400,0.948413314840475,0.669902912621359,1.77870496670144,820,400,420,2,1.1,99.69,8.8,0,0,0,0,0,0,7.35054607185004e-05,0.00103991632769253,0.00103991632769253
8.7,"random_policy_SVM","SVM",12,39,0,0,0,3912,3512,400,0.948327323162251,0.669902912621359,1.77870496670144,820,400,420,0,1.1,100,8.8,0,0,0,0,0,0,0,0,0
8.7,"random_policy_SVM","SVM",13,0,3812,3427,385,100,90,10,0.875036325859933,0.507109004739337,1.74295760805469,24,10,14,0,1.4,2.56,9,0,0,0,0,0,0,0.369456367874115,345.579456557964,41.32063982017
8.7,"random_policy_SVM","SVM",13,1,3712,3391,321,200,126,74,0.905340919892983,0.57345971563981,1.73122250465432,101,49,52,77,1.1,5.11,1.7,0,0,0,0,0,0,0.6547762442959,332.866220753408,74.019750125937
8.7,"random_policy_SVM","SVM",13,2,3612,3346,266,300,171,129,0.909091649805117,0.62085308056872,1.7600454277415,178,92,86,77,0.9,7.67,1.3,0,0,0,0,0,0,0.544509392813822,279.710770975006,69.2857635651299
8.7,"random_policy_SVM","SVM",13,3,3512,3301,211,400,216,184,0.887149472426296,0.611374407582938,1.69169414899426,255,129,126,77,1,10.22,1.2,0,0,0,0,0,0,0.344087494786318,184.07201630587,54.3886764164084
8.7,"random_policy_SVM","SVM",13,4,3412,3261,151,500,256,244,0.868618530941487,0.630331753554502,1.65446879755142,337,169,168,82,1,12.78,1,0,0,0,0,0,0,0.199376980873381,127.622802372228,30.9265059015926
8.7,"random_policy_SVM","SVM",13,5,3312,3190,122,600,327,273,0.86003612216352,0.644549763033175,1.59623995182111,409,199,210,72,1.1,15.34,1.2,0,0,0,0,0,0,0.134148009455046,115.538947909303,19.9061302952962
8.7,"random_policy_SVM","SVM",13,6,3212,3116,96,700,401,299,0.869400725159219,0.649289099526066,1.60035512383638,465,225,240,56,1.1,17.89,1.3,0,0,0,0,0,0,0.10252084615195,104.839888079561,13.1393569778725
8.7,"random_policy_SVM","SVM",13,7,3112,3039,73,800,478,322,0.873776124064687,0.682464454976303,1.61182784916092,514,247,267,49,1.1,20.45,1.5,0,0,0,0,0,0,0.0952055693444668,135.797981517227,12.8640078369332
8.7,"random_policy_SVM","SVM",13,8,3012,2951,61,900,566,334,0.881147218186013,0.687203791469194,1.61479896040361,551,261,290,37,1.1,23.01,1.7,0,0,0,0,0,0,0.0607580827611133,90.7689105851315,7.72738381501358
8.7,"random_policy_SVM","SVM",13,9,2912,2857,55,1000,660,340,0.888442265647279,0.66824644549763,1.63188678009042,565,271,294,14,1.1,25.56,1.9,0,0,0,0,0,0,0.0508529602164895,71.734347424646,5.63602352884674
8.7,"random_policy_SVM","SVM",13,10,2812,2760,52,1100,757,343,0.897216149051449,0.66824644549763,1.65599224948286,575,276,299,10,1.1,28.12,2.2,0,0,0,0,0,0,0.0441214636403623,64.4512155244046,4.77762485772615
8.7,"random_policy_SVM","SVM",13,11,2712,2665,47,1200,852,348,0.911821181710779,0.672985781990521,1.70023805883766,592,285,307,17,1.1,30.67,2.4,0,0,0,0,0,0,0.038383311918851,56.742229640369,4.40078733233606
8.7,"random_policy_SVM","SVM",13,12,2612,2572,40,1300,945,355,0.929076983663547,0.658767772511848,1.72111095623083,627,303,324,35,1.1,33.23,2.7,0,0,0,0,0,0,0.042718164681032,45.9846147604626,5.07615616660689
8.7,"random_policy_SVM","SVM",13,13,2512,2477,35,1400,1040,360,0.931555289995784,0.654028436018957,1.74135267471394,649,311,338,22,1.1,35.79,2.9,0,0,0,0,0,0,0.0492037177282303,44.7048326916231,5.94009427343273
8.7,"random_policy_SVM","SVM",13,14,2412,2379,33,1500,1138,362,0.933956191691881,0.649289099526066,1.75358061441646,658,318,340,9,1.1,38.34,3.1,0,0,0,0,0,0,0.0393968561775281,34.5067786773139,4.41450876620866
8.7,"random_policy_SVM","SVM",13,15,2312,2282,30,1600,1235,365,0.934055323945172,0.654028436018957,1.75842475976015,660,321,339,2,1.1,40.9,3.4,0,0,0,0,0,0,0.0349049864013322,29.2290109184538,3.89820617077453
8.7,"random_policy_SVM","SVM",13,16,2212,2187,25,1700,1330,370,0.933548798870153,0.654028436018957,1.76696080228326,672,328,344,12,1,43.46,3.6,0,0,0,0,0,0,0.0354633549130974,27.5424062519373,4.15448986631848
8.7,"random_policy_SVM","SVM",13,17,2112,2094,18,1800,1423,377,0.931142465269749,0.649289099526066,1.7685893375849,693,337,356,21,1.1,46.01,3.8,0,0,0,0,0,0,0.0314461764842045,24.7076670472147,4.1869128056311
8.7,"random_policy_SVM","SVM",13,18,2012,1998,14,1900,1519,381,0.930324963674124,0.644549763033175,1.75680707368862,705,342,363,12,1.1,48.57,4,0,0,0,0,0,0,0.0253334173516519,21.6466249620183,3.0319952966731
8.7,"random_policy_SVM","SVM",13,19,1912,1900,12,2000,1617,383,0.931321718111318,0.639810426540284,1.76533526336672,710,344,366,5,1.1,51.12,4.2,0,0,0,0,0,0,0.0209443334678232,18.8157729531129,2.3163227951376
8.7,"random_policy_SVM","SVM",13,20,1812,1802,10,2100,1715,385,0.931073208490055,0.639810426540284,1.76047654245837,717,347,370,7,1.1,53.68,4.5,0,0,0,0,0,0,0.0170023315506818,15.6122154029376,1.85010264077151
8.7,"random_policy_SVM","SVM",13,21,1712,1702,10,2200,1815,385,0.930770379825897,0.639810426540284,1.76371271257318,720,347,373,3,1.1,56.24,4.7,0,0,0,0,0,0,0.0141191648427281,12.708119024708,1.47995362709418
8.7,"random_policy_SVM","SVM",13,22,1612,1603,9,2300,1914,386,0.931538994282909,0.630331753554502,1.78403288732948,727,354,373,7,1.1,58.79,5,0,0,0,0,0,0,0.0108744075632297,9.14984154598947,1.32497719037986
8.7,"random_policy_SVM","SVM",13,23,1512,1503,9,2400,2014,386,0.931460231670707,0.630331753554502,1.77713324742831,727,354,373,0,1.1,61.35,5.2,0,0,0,0,0,0,0.00966715907565615,7.42575868430177,0.982332386760118
8.7,"random_policy_SVM","SVM",13,24,1412,1404,8,2500,2113,387,0.932038729477565,0.625592417061611,1.77911819617981,747,363,384,20,1.1,63.91,5.5,0,0,0,0,0,0,0.0063832000946013,4.41907371555928,0.779154701833264
8.7,"random_policy_SVM","SVM",13,25,1312,1307,5,2600,2210,390,0.932136503754783,0.62085308056872,1.7774859776512,757,367,390,10,1.1,66.46,5.7,0,0,0,0,0,0,0.0067365277235767,4.3351153363015,0.695406538413706
8.7,"random_policy_SVM","SVM",13,26,1212,1207,5,2700,2310,390,0.932606363475855,0.62085308056872,1.77911819617981,761,371,390,4,1.1,69.02,5.9,0,0,0,0,0,0,0.00535945585814583,3.29981862973448,0.616112026170291
8.7,"random_policy_SVM","SVM",13,27,1112,1107,5,2800,2410,390,0.932618585260507,0.625592417061611,1.7774859776512,761,371,390,0,1.1,71.57,6.2,0,0,0,0,0,0,0.00439151011187228,2.33475099770233,0.454946168698588
8.7,"random_policy_SVM","SVM",13,28,1012,1007,5,2900,2510,390,0.933016472249739,0.62085308056872,1.77911819617981,768,374,394,7,1.1,74.13,6.4,0,0,0,0,0,0,0.00346348391920106,1.7050909556309,0.383176943565149
8.7,"random_policy_SVM","SVM",13,29,912,909,3,3000,2608,392,0.93319300913916,0.625592417061611,1.79091983240102,776,380,396,8,1,76.69,6.7,0,0,0,0,0,0,0.00339765772134395,1.51800317861662,0.372677122782978
8.7,"random_policy_SVM","SVM",13,30,812,809,3,3100,2708,392,0.933225600564899,0.625592417061611,1.79422106711512,774,380,394,-2,1,79.24,6.9,0,0,0,0,0,0,0.00293228590845225,1.18108470103578,0.322317567687024
8.7,"random_policy_SVM","SVM",13,31,712,710,2,3200,2807,393,0.933040915819045,0.625592417061611,1.78927376637859,779,382,397,5,1,81.8,7.1,0,0,0,0,0,0,0.00234378247724602,0.842021459333851,0.259571334209453
8.7,"random_policy_SVM","SVM",13,32,612,610,2,3300,2907,393,0.932875242738205,0.625592417061611,1.78763072343426,779,382,397,0,1,84.36,7.4,0,0,0,0,0,0,0.00187135860170689,0.598243005467196,0.212965790530209
8.7,"random_policy_SVM","SVM",13,33,512,510,2,3400,3007,393,0.932939067613611,0.630331753554502,1.78599069524762,781,382,399,2,1,86.91,7.7,0,0,0,0,0,0,0.00126862876703219,0.39776906853945,0.160566242671711
8.7,"random_policy_SVM","SVM",13,34,412,410,2,3500,3107,393,0.932994744632581,0.630331753554502,1.78763072343426,780,382,398,-1,1,89.47,7.9,0,0,0,0,0,0,0.000786002957806434,0.229364456609897,0.101488684834508
8.7,"random_policy_SVM","SVM",13,35,312,312,0,3600,3205,395,0.933631635410566,0.630331753554502,1.78599069524762,786,386,400,6,1,92.02,8.1,0,0,0,0,0,0,0.000925465876119374,0.2390622235434,0.11696279755561
8.7,"random_policy_SVM","SVM",13,36,212,212,0,3700,3305,395,0.933869281223248,0.635071090047393,1.79422106711512,789,388,401,3,1,94.58,8.4,0,0,0,0,0,0,0.000475731210439842,0.0964359441460527,0.0596975447503896
8.7,"random_policy_SVM","SVM",13,37,112,112,0,3800,3405,395,0.934064829777685,0.635071090047393,1.78763072343426,794,389,405,5,1,97.14,8.6,0,0,0,0,0,0,0.00018765524449944,0.0311663592562636,0.0292312099992816
8.7,"random_policy_SVM","SVM",13,38,12,12,0,3900,3505,395,0.934123222748802,0.635071090047393,1.78599069524762,795,390,405,1,1,99.69,8.9,0,0,0,0,0,0,0.000139206429588637,0.00208026330890346,0.00208026330890346
8.7,"random_policy_SVM","SVM",13,39,0,0,0,3912,3517,395,0.934216923097802,0.635071090047393,1.78435367352879,795,390,405,0,1,100,8.9,0,0,0,0,0,0,0,0,0
8.7,"random_policy_SVM","SVM",14,0,3812,3414,398,100,87,13,0.89815955386652,0.533333333333333,1.7636517328825,32,13,19,0,1.5,2.56,6.7,0,0,0,0,0,0,0.696650548181584,532.295199723732,75.8883714316644
8.7,"random_policy_SVM","SVM",14,1,3712,3378,334,200,123,77,0.915493819071329,0.564102564102564,1.77176420635482,95,47,48,63,1,5.11,1.6,0,0,0,0,0,0,0.742413700819283,322.122200863392,82.893309912629
8.7,"random_policy_SVM","SVM",14,2,3612,3331,281,300,170,130,0.902070501900145,0.61025641025641,1.73007762879323,178,88,90,83,1,7.67,1.3,0,0,0,0,0,0,0.624678560538356,293.3061420555,73.314797148258
8.7,"random_policy_SVM","SVM",14,3,3512,3294,218,400,207,193,0.88323359396613,0.630769230769231,1.68258064516129,251,125,126,73,1,10.22,1.1,0,0,0,0,0,0,0.471626314731082,248.822010022192,67.0615241066083
8.7,"random_policy_SVM","SVM",14,4,3412,3249,163,500,252,248,0.880041934215705,0.61025641025641,1.63184389140271,331,166,165,80,1,12.78,1,0,0,0,0,0,0,0.273392553925208,198.731521277386,45.4570861044109
8.7,"random_policy_SVM","SVM",14,5,3312,3189,123,600,312,288,0.873820236171176,0.641025641025641,1.63184389140271,407,200,207,76,1,15.34,1.1,0,0,0,0,0,0,0.188869180302143,154.752743774949,26.5178732666848
8.7,"random_policy_SVM","SVM",14,6,3212,3114,98,700,387,313,0.871701684648871,0.641025641025641,1.61786600496278,474,229,245,67,1.1,17.89,1.2,0,0,0,0,0,0,0.102487466360003,102.25273508283,13.4007223425439
8.7,"random_policy_SVM","SVM",14,7,3112,3029,83,800,472,328,0.880863145939826,0.656410256410256,1.63635590216235,513,245,268,39,1.1,20.45,1.4,0,0,0,0,0,0,0.0805566572756288,106.084697195579,9.84160782209988
8.7,"random_policy_SVM","SVM",14,8,3012,2949,63,900,552,348,0.870286404869031,0.666666666666667,1.58429045701773,561,269,292,48,1.1,23.01,1.6,0,0,0,0,0,0,0.114799714739656,169.237429280124,18.4937774688194
8.7,"random_policy_SVM","SVM",14,9,2912,2854,58,1000,647,353,0.892252362439759,0.641025641025641,1.64574490587323,581,282,299,20,1.1,25.56,1.8,0,0,0,0,0,0,0.0652031068081967,79.3171768174022,8.37887641758392
8.7,"random_policy_SVM","SVM",14,10,2812,2761,51,1100,740,360,0.896268146012612,0.646153846153846,1.63955640319277,599,290,309,18,1.1,28.12,2.1,0,0,0,0,0,0,0.0472539366581077,63.364155316514,5.33534561595665
8.7,"random_policy_SVM","SVM",14,11,2712,2665,47,1200,836,364,0.901887039706457,0.646153846153846,1.64408556452755,610,296,314,11,1.1,30.67,2.3,0,0,0,0,0,0,0.0443240904354591,56.6018771834147,4.86949990323085
8.7,"random_policy_SVM","SVM",14,12,2612,2569,43,1300,932,368,0.903691084611015,0.635897435897436,1.65332200028333,623,303,320,13,1.1,33.23,2.5,0,0,0,0,0,0,0.0423449891598632,52.9248839384267,4.38864194905005
8.7,"random_policy_SVM","SVM",14,13,2512,2474,38,1400,1027,373,0.919612982134265,0.646153846153846,1.69326746647848,659,322,337,36,1,35.79,2.8,0,0,0,0,0,0,0.0394641532353631,33.7632898639324,4.89140111740459
8.7,"random_policy_SVM","SVM",14,14,2412,2377,35,1500,1124,376,0.920866640457764,0.641025641025641,1.69794069775671,667,327,340,8,1,38.34,3,0,0,0,0,0,0,0.030572010068542,31.0348360178368,3.64212682888941
8.7,"random_policy_SVM","SVM",14,15,2312,2284,28,1600,1217,383,0.923988409848701,0.635897435897436,1.71167254763585,686,336,350,19,1,40.9,3.2,0,0,0,0,0,0,0.0433666981394403,34.9621502432993,5.84306952224536
8.7,"random_policy_SVM","SVM",14,16,2212,2187,25,1700,1314,386,0.926760727442147,0.635897435897436,1.74408039063053,704,343,361,18,1.1,43.46,3.4,0,0,0,0,0,0,0.0378309835962147,28.2850811481979,4.24581387810023
8.7,"random_policy_SVM","SVM",14,17,2112,2091,21,1800,1410,390,0.92750331251182,0.641025641025641,1.75169683257919,720,349,371,16,1.1,46.01,3.6,0,0,0,0,0,0,0.0355012063306109,25.4840157166762,4.01386760315768
8.7,"random_policy_SVM","SVM",14,18,2012,1996,16,1900,1505,395,0.928323068186774,0.635897435897436,1.7484827099506,733,356,377,13,1.1,48.57,3.8,0,0,0,0,0,0,0.036102005597749,23.8526841100934,4.24989393379492
8.7,"random_policy_SVM","SVM",14,19,1912,1900,12,2000,1601,399,0.928813756752422,0.635897435897436,1.74688006768667,748,361,387,15,1.1,51.12,4,0,0,0,0,0,0,0.0308811065183554,21.2624240104074,3.95563906998258
8.7,"random_policy_SVM","SVM",14,20,1812,1804,8,2100,1697,403,0.928646311099457,0.630769230769231,1.74208972015188,758,364,394,10,1.1,53.68,4.2,0,0,0,0,0,0,0.0201014145977299,16.3721210972388,2.61814645666047
8.7,"random_policy_SVM","SVM",14,21,1712,1706,6,2200,1795,405,0.928623014312958,0.630769230769231,1.75169683257919,758,367,391,0,1.1,56.24,4.4,0,0,0,0,0,0,0.0145930138596446,12.5681886999771,1.64585635621477
8.7,"random_policy_SVM","SVM",14,22,1612,1606,6,2300,1895,405,0.92884578983386,0.630769230769231,1.75492279359683,761,367,394,3,1.1,58.79,4.7,0,0,0,0,0,0,0.0144936567142224,11.216847018489,1.47970399360496
8.7,"random_policy_SVM","SVM",14,23,1512,1507,5,2400,1994,406,0.930427059217521,0.630769230769231,1.76091628959276,775,379,396,14,1,61.35,4.9,0,0,0,0,0,0,0.0107851463860315,7.30547982032254,1.30740533291038
8.7,"random_policy_SVM","SVM",14,24,1412,1409,3,2500,2092,408,0.930543543150017,0.635897435897436,1.75125861341583,778,380,398,3,1,63.91,5.1,0,0,0,0,0,0,0.00946159183112875,6.31463784151891,0.994706185989055
8.7,"random_policy_SVM","SVM",14,25,1312,1309,3,2600,2192,408,0.930904643340759,0.630769230769231,1.75768525052929,783,383,400,5,1,66.46,5.4,0,0,0,0,0,0,0.0077619336570966,4.82253245489652,0.830778345994824
8.7,"random_policy_SVM","SVM",14,26,1212,1209,3,2700,2292,408,0.931239534646689,0.625641025641026,1.75607417330607,784,384,400,1,1,69.02,5.6,0,0,0,0,0,0,0.00680574848132296,3.78776013372249,0.70593332918138
8.7,"random_policy_SVM","SVM",14,27,1112,1109,3,2800,2392,408,0.931329809694373,0.625641025641026,1.75929928657201,789,387,402,5,1,71.57,5.9,0,0,0,0,0,0,0.00569169683252694,2.84967269213204,0.60309222956796
8.7,"random_policy_SVM","SVM",14,28,1012,1009,3,2900,2492,408,0.931443381528557,0.625641025641026,1.76091628959276,789,387,402,0,1,74.13,6.1,0,0,0,0,0,0,0.00483421565225573,2.11403191688617,0.51143391660697
8.7,"random_policy_SVM","SVM",14,29,912,909,3,3000,2592,408,0.93148415090493,0.625641025641026,1.75607417330607,793,387,406,4,1,76.69,6.4,0,0,0,0,0,0,0.00440743289233098,1.72238397828042,0.477768023303251
8.7,"random_policy_SVM","SVM",14,30,812,809,3,3100,2692,408,0.931725855064861,0.625641025641026,1.75768525052929,792,387,405,-1,1,79.24,6.6,0,0,0,0,0,0,0.00319390176703983,1.14529236987651,0.363417293130786
8.7,"random_policy_SVM","SVM",14,31,712,709,3,3200,2792,408,0.931909317258544,0.625641025641026,1.76253626778006,794,387,407,2,1.1,81.8,6.8,0,0,0,0,0,0,0.00250328301682768,0.779337733032849,0.284127459596781
8.7,"random_policy_SVM","SVM",14,32,612,610,2,3300,2891,409,0.932104427845474,0.625641025641026,1.75607417330607,798,389,409,4,1.1,84.36,7.1,0,0,0,0,0,0,0.0018169368244531,0.597623015763826,0.231241677399748
8.7,"random_policy_SVM","SVM",14,33,512,510,2,3400,2991,409,0.932142285123534,0.625641025641026,1.76253626778006,800,390,410,2,1.1,86.91,7.3,0,0,0,0,0,0,0.00106377503970437,0.327778815903318,0.135605816691303
8.7,"random_policy_SVM","SVM",14,34,412,411,1,3500,3090,410,0.932466984085368,0.615384615384615,1.75768525052929,803,391,412,3,1.1,89.47,7.5,0,0,0,0,0,0,0.000965231928922754,0.286941732373853,0.118440457501905
8.7,"random_policy_SVM","SVM",14,35,312,312,0,3600,3189,411,0.933197920761787,0.615384615384615,1.75768525052929,812,394,418,9,1.1,92.02,7.8,0,0,0,0,0,0,0.000676003972611549,0.172181454663509,0.0850550889119116
8.7,"random_policy_SVM","SVM",14,36,212,212,0,3700,3289,411,0.93326635507213,0.615384615384615,1.7641592293526,814,395,419,2,1.1,94.58,8,0,0,0,0,0,0,0.000453988344380589,0.0922709826523366,0.057764109601002
8.7,"random_policy_SVM","SVM",14,37,112,112,0,3800,3389,411,0.933219761499131,0.615384615384615,1.7641592293526,818,397,421,4,1.1,97.14,8.2,0,0,0,0,0,0,0.000163901776651106,0.0266087321185797,0.0248510154312039
8.7,"random_policy_SVM","SVM",14,38,12,12,0,3900,3489,411,0.933407591840285,0.615384615384615,1.75768525052929,821,398,423,3,1.1,99.69,8.5,0,0,0,0,0,0,0.000141803977364187,0.00194444697968734,0.00194444697968734
8.7,"random_policy_SVM","SVM",14,39,0,0,0,3912,3501,411,0.933457097511597,0.615384615384615,1.75768525052929,821,399,422,0,1.1,100,8.5,0,0,0,0,0,0,0,0,0
8.7,"random_policy_SVM","SVM",15,0,3812,3411,401,100,88,12,0.912040533828636,0.575129533678757,1.76540197225472,29,12,17,0,1.4,2.56,7.3,0,0,0,0,0,0,0.368483395418629,434.906486859486,41.6095247714058
8.7,"random_policy_SVM","SVM",15,1,3712,3369,343,200,130,70,0.914150691091191,0.585492227979275,1.76660170176356,92,46,46,63,1,5.11,1.9,0,0,0,0,0,0,0.682985959753564,422.417638322042,74.903967707777
8.7,"random_policy_SVM","SVM",15,2,3612,3314,298,300,185,115,0.902777002224768,0.585492227979275,1.72782492650656,170,85,85,78,1,7.67,1.6,0,0,0,0,0,0,0.549811799082117,304.479592429197,68.8377660368051
8.7,"random_policy_SVM","SVM",15,3,3512,3271,241,400,228,172,0.896076224287986,0.632124352331606,1.70464416336483,244,121,123,74,1,10.22,1.3,0,0,0,0,0,0,0.353599505753282,218.763363276108,54.2588011349622
8.7,"random_policy_SVM","SVM",15,4,3412,3234,178,500,265,235,0.901044498455591,0.642487046632124,1.6953291679366,321,160,161,77,1,12.78,1.1,0,0,0,0,0,0,0.232282436537133,185.046695243743,34.8099371833812
8.7,"random_policy_SVM","SVM",15,5,3312,3171,141,600,328,272,0.906543250876545,0.663212435233161,1.68911917098446,391,193,198,70,1,15.34,1.2,0,0,0,0,0,0,0.130172891993655,122.581615660783,19.6293523343978
8.7,"random_policy_SVM","SVM",15,6,3212,3101,111,700,398,302,0.89179713100903,0.673575129533679,1.62080920451082,461,225,236,70,1,17.89,1.3,0,0,0,0,0,0,0.114495730197292,192.712275194186,17.5513747428712
8.7,"random_policy_SVM","SVM",15,7,3112,3026,86,800,473,327,0.899602949517872,0.678756476683938,1.63943919536727,524,249,275,63,1.1,20.45,1.4,0,0,0,0,0,0,0.093938848967582,149.065525867548,12.1274370390653
8.7,"random_policy_SVM","SVM",15,8,3012,2940,72,900,559,341,0.913072100958397,0.66839378238342,1.67045487075258,557,267,290,33,1.1,23.01,1.6,0,0,0,0,0,0,0.0725275630061878,109.900058140932,8.66244130012443
8.7,"random_policy_SVM","SVM",15,9,2912,2854,58,1000,645,355,0.918309287924793,0.66839378238342,1.66891811374177,591,284,307,34,1.1,25.56,1.8,0,0,0,0,0,0,0.0843090515056813,137.03929068862,9.01046256720325
8.7,"random_policy_SVM","SVM",15,10,2812,2760,52,1100,739,361,0.929953359058834,0.66839378238342,1.73099815869481,617,296,321,26,1.1,28.12,2,0,0,0,0,0,0,0.0632789836561042,92.4861324163181,7.33415115397098
8.7,"random_policy_SVM","SVM",15,11,2712,2666,46,1200,833,367,0.934764400059961,0.66839378238342,1.74350663279168,632,304,328,15,1.1,30.67,2.3,0,0,0,0,0,0,0.0790270707023346,96.1995176479427,9.07535839556349
8.7,"random_policy_SVM","SVM",15,12,2612,2569,43,1300,930,370,0.937224290907827,0.66839378238342,1.75444422179601,641,310,331,9,1.1,33.23,2.5,0,0,0,0,0,0,0.0618614808981774,71.733334173763,6.86799761232664
8.7,"random_policy_SVM","SVM",15,13,2512,2476,36,1400,1023,377,0.938717271255134,0.66839378238342,1.76215376255416,662,319,343,21,1.1,35.79,2.7,0,0,0,0,0,0,0.0646115662137556,68.1290277763174,7.23552870449644
8.7,"random_policy_SVM","SVM",15,14,2412,2383,29,1500,1116,384,0.939501967618788,0.66839378238342,1.76215376255416,683,329,354,21,1.1,38.34,2.9,0,0,0,0,0,0,0.0594444988607709,55.9608023476967,6.60442948710181
8.7,"random_policy_SVM","SVM",15,15,2312,2289,23,1600,1210,390,0.940457122368552,0.66839378238342,1.76540197225472,697,333,364,14,1.1,40.9,3.1,0,0,0,0,0,0,0.0431476591305797,47.6858136532342,5.2124686548919
8.7,"random_policy_SVM","SVM",15,16,2212,2193,19,1700,1306,394,0.941875159804738,0.66839378238342,1.76984913136239,713,338,375,16,1.1,43.46,3.3,0,0,0,0,0,0,0.0375445096342659,42.8648755614975,4.12504920387457
8.7,"random_policy_SVM","SVM",15,17,2112,2094,18,1800,1405,395,0.942618711040708,0.66839378238342,1.78244067214382,717,341,376,4,1.1,46.01,3.6,0,0,0,0,0,0,0.0308968674360972,35.4473822283321,3.31290623830525
8.7,"random_policy_SVM","SVM",15,18,2012,1997,15,1900,1502,398,0.942996364534082,0.66839378238342,1.77916412679061,719,346,373,2,1.1,48.57,3.8,0,0,0,0,0,0,0.0285177956396706,32.5052196952493,3.07071718922654
8.7,"random_policy_SVM","SVM",15,19,1912,1899,13,2000,1600,400,0.942708348640306,0.673575129533679,1.7714773274354,727,351,376,8,1.1,51.12,4,0,0,0,0,0,0,0.025662441398537,25.4262426895398,2.62978124021538
8.7,"random_policy_SVM","SVM",15,20,1812,1801,11,2100,1698,402,0.939690059631048,0.652849740932642,1.79944802207912,766,371,395,39,1.1,53.68,4.2,0,0,0,0,0,0,0.0203665777308471,13.6962381534607,2.74371333359118
8.7,"random_policy_SVM","SVM",15,21,1712,1703,9,2200,1796,404,0.939704754319508,0.658031088082902,1.79614325068871,772,373,399,6,1.1,56.24,4.4,0,0,0,0,0,0,0.0133206323108427,10.3707862703886,1.57090542076716
8.7,"random_policy_SVM","SVM",15,22,1612,1606,6,2300,1893,407,0.940089755157102,0.658031088082902,1.79944802207912,776,376,400,4,1.1,58.79,4.7,0,0,0,0,0,0,0.0121420758624446,10.3911230162629,1.37810621873221
8.7,"random_policy_SVM","SVM",15,23,1512,1506,6,2400,1993,407,0.940166167537083,0.658031088082902,1.79614325068871,779,376,403,3,1.1,61.35,4.9,0,0,0,0,0,0,0.00983142512796812,8.21359256708181,1.0252438771047
8.7,"random_policy_SVM","SVM",15,24,1412,1406,6,2500,2093,407,0.93949315080571,0.647668393782383,1.79614325068871,785,383,402,6,1,63.91,5.1,0,0,0,0,0,0,0.00765664898248201,5.98643604907806,0.861800210200409
8.7,"random_policy_SVM","SVM",15,25,1312,1307,5,2600,2192,408,0.939654792378747,0.647668393782383,1.79614325068871,791,386,405,6,1,66.46,5.4,0,0,0,0,0,0,0.00737937292678953,5.28144520454404,0.75476420215879
8.7,"random_policy_SVM","SVM",15,26,1212,1207,5,2700,2292,408,0.939211012787317,0.647668393782383,1.79779411764706,795,387,408,4,1.1,69.02,5.6,0,0,0,0,0,0,0.00525301297735238,3.41821720054197,0.58570817291125
8.7,"random_policy_SVM","SVM",15,27,1112,1109,3,2800,2390,410,0.939287425167297,0.647668393782383,1.79342422578257,799,390,409,4,1,71.57,5.8,0,0,0,0,0,0,0.00591020858705238,3.52151421545791,0.609905628126141
8.7,"random_policy_SVM","SVM",15,28,1012,1009,3,2900,2490,410,0.938554160213248,0.637305699481865,1.79177282225975,804,392,412,5,1.1,74.13,6.1,0,0,0,0,0,0,0.00468244057156248,2.52270592783914,0.512220040523437
8.7,"random_policy_SVM","SVM",15,29,912,909,3,3000,2590,410,0.938560038088631,0.637305699481865,1.79177282225975,804,392,412,0,1.1,76.69,6.3,0,0,0,0,0,0,0.00387108686369933,1.82184552503788,0.411589750514836
8.7,"random_policy_SVM","SVM",15,30,812,809,3,3100,2690,410,0.938086869120287,0.637305699481865,1.79177282225975,805,393,412,1,1,79.24,6.6,0,0,0,0,0,0,0.00346238923768613,1.41500722523609,0.372182124702186
8.7,"random_policy_SVM","SVM",15,31,712,709,3,3200,2790,410,0.938103033277591,0.637305699481865,1.79177282225975,804,393,411,-1,1,81.8,6.8,0,0,0,0,0,0,0.002425752671066,0.891558259516109,0.270838517744506
8.7,"random_policy_SVM","SVM",15,32,612,609,3,3300,2890,410,0.938135361592198,0.637305699481865,1.79342422578257,806,394,412,2,1,84.36,7,0,0,0,0,0,0,0.00210768541879301,0.712830761852707,0.244954967750748
8.7,"random_policy_SVM","SVM",15,33,512,510,2,3400,2989,411,0.938211773972179,0.637305699481865,1.79342422578257,811,396,415,5,1,86.91,7.3,0,0,0,0,0,0,0.00147569040889421,0.492106150377283,0.177523646244556
8.7,"random_policy_SVM","SVM",15,34,412,412,0,3500,3087,413,0.938743721694356,0.642487046632124,1.78847912221884,819,400,419,8,1,89.47,7.5,0,0,0,0,0,0,0.00207409764420072,0.631513476592538,0.240785494968306
8.7,"random_policy_SVM","SVM",15,35,312,312,0,3600,3187,413,0.938367537669833,0.642487046632124,1.79012445719788,823,402,421,4,1,92.02,7.7,0,0,0,0,0,0,0.00111006950307227,0.292384047040955,0.136068997282112
8.7,"random_policy_SVM","SVM",15,36,212,212,0,3700,3287,413,0.938470400489038,0.642487046632124,1.79177282225975,826,405,421,3,1,94.58,8,0,0,0,0,0,0,0.000713637574339302,0.146442627679144,0.0869439431155588
8.7,"random_policy_SVM","SVM",15,37,112,112,0,3800,3387,413,0.938502728803645,0.642487046632124,1.79012445719788,828,406,422,2,1,97.14,8.2,0,0,0,0,0,0,0.00035773801523602,0.054850467328274,0.0508592463677831
8.7,"random_policy_SVM","SVM",15,38,12,12,0,3900,3487,413,0.938580610652472,0.642487046632124,1.79177282225975,831,407,424,3,1,99.69,8.4,0,0,0,0,0,0,0.000203698023589649,0.00266881153216066,0.00266881153216066
8.7,"random_policy_SVM","SVM",15,39,0,0,0,3912,3499,413,0.938617347373616,0.642487046632124,1.78847912221884,831,407,424,0,1,100,8.5,0,0,0,0,0,0,0,0,0
8.7,"random_policy_SVM","SVM",16,0,3812,3417,395,100,93,7,0.897584833019978,0.568627450980392,1.73206831119545,23,7,16,0,2.3,2.56,13.3,0,0,0,0,0,0,0.342362663425692,267.415636606286,40.3163616014308
8.7,"random_policy_SVM","SVM",16,1,3712,3381,331,200,129,71,0.907763676246758,0.57843137254902,1.7553439038909,103,53,50,80,0.9,5.11,1.8,0,0,0,0,0,0,0.650137063213061,250.794746652719,76.1852765512752
8.7,"random_policy_SVM","SVM",16,2,3612,3341,271,300,169,131,0.910553205300396,0.598039215686274,1.72570626046562,175,89,86,72,1,7.67,1.3,0,0,0,0,0,0,0.488830322971492,199.392654810247,66.5012191846571
8.7,"random_policy_SVM","SVM",16,3,3512,3302,210,400,208,192,0.916610708210233,0.602941176470588,1.73206831119545,259,133,126,84,0.9,10.22,1.1,0,0,0,0,0,0,0.293974442714886,158.671945949802,51.1972368422945
8.7,"random_policy_SVM","SVM",16,4,3412,3253,159,500,257,243,0.874627876264671,0.637254901960784,1.6318523729639,334,168,166,75,1,12.78,1.1,0,0,0,0,0,0,0.186287082089494,155.092992561214,30.1887765679969
8.7,"random_policy_SVM","SVM",16,5,3312,3193,119,600,317,283,0.881519160175498,0.661764705882353,1.6318523729639,408,200,208,74,1,15.34,1.1,0,0,0,0,0,0,0.116646363095642,106.514980442258,16.4582592771608
8.7,"random_policy_SVM","SVM",16,6,3212,3114,98,700,396,304,0.885251589220171,0.661764705882353,1.62452605351533,460,224,236,52,1.1,17.89,1.3,0,0,0,0,0,0,0.0878585018885598,96.7976099974768,11.2687215539739
8.7,"random_policy_SVM","SVM",16,7,3112,3034,78,800,476,324,0.893305410063581,0.676470588235294,1.63615758229897,508,245,263,48,1.1,20.45,1.5,0,0,0,0,0,0,0.0791978952757121,111.232967719193,10.2147011101734
8.7,"random_policy_SVM","SVM",16,8,3012,2948,64,900,562,338,0.895234577849416,0.676470588235294,1.64218394540136,551,265,286,43,1.1,23.01,1.7,0,0,0,0,0,0,0.0674394622484974,115.136781196456,9.70157947912361
8.7,"random_policy_SVM","SVM",16,9,2912,2859,53,1000,651,349,0.902646275405148,0.666666666666667,1.63766002268676,580,279,301,29,1.1,25.56,1.9,0,0,0,0,0,0,0.05971818907197,94.0379691739535,6.57868127745551
8.7,"random_policy_SVM","SVM",16,10,2812,2770,42,1100,740,360,0.910456676963037,0.661764705882353,1.66867078323042,612,296,316,32,1.1,28.12,2.1,0,0,0,0,0,0,0.0610299669033928,94.9408347115808,6.67590032231345
8.7,"random_policy_SVM","SVM",16,11,2712,2672,40,1200,838,362,0.914726307189559,0.661764705882353,1.67749972917344,632,305,327,20,1.1,30.67,2.3,0,0,0,0,0,0,0.050127523375083,71.5683264112362,5.7302795531512
8.7,"random_policy_SVM","SVM",16,12,2612,2581,31,1300,929,371,0.92344743262603,0.656862745098039,1.70085423875433,661,318,343,29,1.1,33.23,2.5,0,0,0,0,0,0,0.0572952800609845,71.3272018122071,6.44870187481045
8.7,"random_policy_SVM","SVM",16,13,2512,2484,28,1400,1026,374,0.928364781985863,0.651960784313726,1.72254272928236,663,321,342,2,1.1,35.79,2.7,0,0,0,0,0,0,0.0519877826230751,60.9844915473457,5.84323234854274
8.7,"random_policy_SVM","SVM",16,14,2412,2385,27,1500,1125,375,0.93021700689409,0.651960784313726,1.7345108842435,669,323,346,6,1.1,38.34,3,0,0,0,0,0,0,0.0421723465691091,47.9550552519522,4.56485439806438
8.7,"random_policy_SVM","SVM",16,15,2312,2287,25,1600,1223,377,0.932144775718513,0.647058823529412,1.75051268213708,673,324,349,4,1.1,40.9,3.2,0,0,0,0,0,0,0.033763356324603,38.2289875811767,3.75784338221438
8.7,"random_policy_SVM","SVM",16,16,2212,2193,19,1700,1317,383,0.933787156415084,0.651960784313726,1.7553439038909,687,332,355,14,1.1,43.46,3.4,0,0,0,0,0,0,0.0394727848008129,40.2440720127216,4.86953975590312
8.7,"random_policy_SVM","SVM",16,17,2112,2100,12,1800,1410,390,0.933458400483488,0.642156862745098,1.7569602426606,711,340,371,24,1.1,46.01,3.6,0,0,0,0,0,0,0.0296427782359536,33.2548199449821,3.84100219808019
8.7,"random_policy_SVM","SVM",16,18,2012,2004,8,1900,1506,394,0.93335347837766,0.637254901960784,1.7585795608566,720,345,375,9,1.1,48.57,3.8,0,0,0,0,0,0,0.0269956961506381,30.3250583168826,2.90611197948349
8.7,"random_policy_SVM","SVM",16,19,1912,1904,8,2000,1606,394,0.932919800340234,0.642156862745098,1.7553439038909,721,345,376,1,1.1,51.12,4.1,0,0,0,0,0,0,0.0232391458055784,24.4555116829612,2.39905004242213
8.7,"random_policy_SVM","SVM",16,20,1812,1805,7,2100,1705,395,0.930091100367094,0.632352941176471,1.76416472752855,746,358,388,25,1.1,53.68,4.3,0,0,0,0,0,0,0.0174918998541323,14.0846367622784,2.20811431933631
8.7,"random_policy_SVM","SVM",16,21,1712,1705,7,2200,1805,395,0.930057525293229,0.632352941176471,1.76578918860362,744,358,386,-2,1.1,56.24,4.6,0,0,0,0,0,0,0.0110091841950042,9.92788275453554,1.27812424832801
8.7,"random_policy_SVM","SVM",16,22,1612,1608,4,2300,1902,398,0.930088302444271,0.632352941176471,1.76578918860362,753,362,391,9,1.1,58.79,4.8,0,0,0,0,0,0,0.0112788677179999,10.09601621558,1.19978673858299
8.7,"random_policy_SVM","SVM",16,23,1512,1508,4,2400,2002,398,0.929954002148811,0.637254901960784,1.76741664407699,762,368,394,9,1.1,61.35,5,0,0,0,0,0,0,0.00768602271288231,6.55829573420137,0.895391182905097
8.7,"random_policy_SVM","SVM",16,24,1412,1409,3,2500,2101,399,0.929668614020957,0.637254901960784,1.76578918860362,764,370,394,2,1.1,63.91,5.3,0,0,0,0,0,0,0.00851477146205229,6.18441893892826,0.872638915942023
8.7,"random_policy_SVM","SVM",16,25,1312,1309,3,2600,2201,399,0.93019462351151,0.647058823529412,1.76416472752855,781,378,403,17,1.1,66.46,5.5,0,0,0,0,0,0,0.00503739082248367,3.14679461541503,0.596913478169875
8.7,"random_policy_SVM","SVM",16,26,1212,1210,2,2700,2300,400,0.93043524487421,0.642156862745098,1.76092475557716,783,379,404,2,1.1,69.02,5.8,0,0,0,0,0,0,0.00438529111175489,2.81940747518372,0.479649470850193
8.7,"random_policy_SVM","SVM",16,27,1112,1111,1,2800,2399,401,0.930863327065991,0.642156862745098,1.76254325259516,789,381,408,6,1.1,71.57,6,0,0,0,0,0,0,0.00482718070299433,2.81637791444107,0.49722306302605
8.7,"random_policy_SVM","SVM",16,28,1012,1011,1,2900,2499,401,0.930715037156419,0.642156862745098,1.76416472752855,786,383,403,-3,1.1,74.13,6.2,0,0,0,0,0,0,0.00405029124744651,2.18045511909602,0.448747379665662
8.7,"random_policy_SVM","SVM",16,29,912,911,1,3000,2599,401,0.930807368609548,0.642156862745098,1.76254325259516,785,383,402,-1,1,76.69,6.5,0,0,0,0,0,0,0.00312756853245167,1.41089651186005,0.32778619152994
8.7,"random_policy_SVM","SVM",16,30,812,811,1,3100,2699,401,0.930978041901696,0.651960784313726,1.76092475557716,790,386,404,5,1,79.24,6.7,0,0,0,0,0,0,0.00242532012178705,0.957190864539732,0.266112614067443
8.7,"random_policy_SVM","SVM",16,31,712,711,1,3200,2799,401,0.931073171277648,0.647058823529412,1.75769666253302,791,387,404,1,1,81.8,7,0,0,0,0,0,0,0.00212095193099594,0.704993131192783,0.230764265575434
8.7,"random_policy_SVM","SVM",16,32,612,611,1,3300,2899,401,0.931179492344887,0.651960784313726,1.76092475557716,792,387,405,1,1,84.36,7.2,0,0,0,0,0,0,0.00159704442759707,0.477716569129299,0.186896804354729
8.7,"random_policy_SVM","SVM",16,33,512,511,1,3400,2999,401,0.931165502730777,0.651960784313726,1.75769666253302,792,387,405,0,1,86.91,7.5,0,0,0,0,0,0,0.000935887153311162,0.275225244671023,0.121788661590404
8.7,"random_policy_SVM","SVM",16,34,412,412,0,3500,3098,402,0.931652341301822,0.651960784313726,1.76648514584569,794,390,404,2,1,89.47,7.7,0,0,0,0,0,0,0.00066685992522903,0.198415599242404,0.0894574866301555
8.7,"random_policy_SVM","SVM",16,35,312,312,0,3600,3198,402,0.931506849315072,0.642156862745098,1.76648514584569,796,392,404,2,1,92.02,8,0,0,0,0,0,0,0.000472134451478158,0.119815075419701,0.0608298153521485
8.7,"random_policy_SVM","SVM",16,36,212,212,0,3700,3298,402,0.931285813412127,0.642156862745098,1.76972937935505,800,391,409,4,1,94.58,8.2,0,0,0,0,0,0,0.000238425601226826,0.0506009669301725,0.0322558031803584
8.7,"random_policy_SVM","SVM",16,37,112,112,0,3800,3398,402,0.931319388485992,0.642156862745098,1.76972937935505,801,392,409,1,1,97.14,8.5,0,0,0,0,0,0,9.80499950771606e-05,0.0167488826689462,0.0157296183308061
8.7,"random_policy_SVM","SVM",16,38,12,12,0,3900,3498,402,0.931467678395563,0.647058823529412,1.77625372729737,803,394,409,2,1,99.69,8.7,0,0,0,0,0,0,5.68871558493212e-05,0.000815384684236722,0.000815384684236722
8.7,"random_policy_SVM","SVM",16,39,0,0,0,3912,3510,402,0.931491460739551,0.647058823529412,1.76810577441986,804,394,410,1,1,100,8.7,0,0,0,0,0,0,0,0,0
8.7,"random_policy_SVM","SVM",17,0,3812,3410,402,100,92,8,0.865674281076056,0.418367346938776,1.72600116403507,33,8,25,0,3.1,2.56,11.5,0,0,0,0,0,0,0.340341623501196,310.881095736015,46.3713393623594
8.7,"random_policy_SVM","SVM",17,1,3712,3347,365,200,155,45,0.910963589981447,0.494897959183673,1.78436941596915,99,45,54,66,1.2,5.11,3.4,0,0,0,0,0,0,0.354781577116482,472.133237816209,43.0988229175496
8.7,"random_policy_SVM","SVM",17,2,3612,3303,309,300,199,101,0.933760435992563,0.622448979591837,1.77455620194916,193,94,99,94,1.1,7.67,2,0,0,0,0,0,0,0.536377432284379,430.328729250148,63.9905887256995
8.7,"random_policy_SVM","SVM",17,3,3512,3267,245,400,235,165,0.935696892393303,0.622448979591837,1.7702768607443,266,130,136,73,1,10.22,1.4,0,0,0,0,0,0,0.475586971928247,366.169445504556,63.9840973025096
8.7,"random_policy_SVM","SVM",17,4,3412,3228,184,500,274,226,0.92737998608533,0.627551020408163,1.75948726598077,332,163,169,66,1,12.78,1.2,0,0,0,0,0,0,0.353366373303457,283.482776224274,49.6672490723826
8.7,"random_policy_SVM","SVM",17,5,3312,3170,142,600,332,268,0.907203733766237,0.668367346938776,1.6908332393731,407,201,206,75,1,15.34,1.2,0,0,0,0,0,0,0.199379230675533,216.962193977959,31.4018946490152
8.7,"random_policy_SVM","SVM",17,6,3212,3108,104,700,394,306,0.90810963589981,0.663265306122449,1.66020783313325,476,232,244,69,1.1,17.89,1.3,0,0,0,0,0,0,0.14066894112335,157.489718702656,18.1754988375899
8.7,"random_policy_SVM","SVM",17,7,3112,3033,79,800,469,331,0.901263914656767,0.678571428571429,1.63720492805417,534,258,276,58,1.1,20.45,1.4,0,0,0,0,0,0,0.0995345506265125,149.916973859854,13.7789561078956
8.7,"random_policy_SVM","SVM",17,8,3012,2955,57,900,547,353,0.891601924860848,0.683673469387755,1.62202732332602,590,281,309,56,1.1,23.01,1.5,0,0,0,0,0,0,0.116210663845197,171.219382685741,13.5484579459265
8.7,"random_policy_SVM","SVM",17,9,2912,2856,56,1000,646,354,0.909186572356213,0.668367346938776,1.68164392828955,602,294,308,12,1,25.56,1.8,0,0,0,0,0,0,0.0796018483338647,112.165971011106,9.28931514516307
8.7,"random_policy_SVM","SVM",17,10,2812,2764,48,1100,738,362,0.913589981447113,0.668367346938776,1.67855267106843,618,299,319,16,1.1,28.12,2,0,0,0,0,0,0,0.0707376112263236,102.305521593928,7.59345908041177
8.7,"random_policy_SVM","SVM",17,11,2712,2671,41,1200,831,369,0.922440282931338,0.668367346938776,1.71682030677957,646,311,335,28,1.1,30.67,2.3,0,0,0,0,0,0,0.0730215290077361,94.5554164652132,8.15512444979673
8.7,"random_policy_SVM","SVM",17,12,2612,2572,40,1300,930,370,0.923818703617794,0.663265306122449,1.73358718487395,655,313,342,9,1.1,33.23,2.5,0,0,0,0,0,0,0.0596953745018653,67.2989984259145,6.27536552731878
8.7,"random_policy_SVM","SVM",17,13,2512,2475,37,1400,1027,373,0.926182745825592,0.663265306122449,1.73518202129058,666,318,348,11,1.1,35.79,2.8,0,0,0,0,0,0,0.0527470829187862,52.4396011438064,5.9939789965852
8.7,"random_policy_SVM","SVM",17,14,2412,2382,30,1500,1120,380,0.928804788961025,0.663265306122449,1.74871746863883,689,327,362,23,1.1,38.34,2.9,0,0,0,0,0,0,0.0540085141698467,50.5652690120028,6.09729983818019
8.7,"random_policy_SVM","SVM",17,15,2312,2294,18,1600,1208,392,0.928293135435981,0.668367346938776,1.75354373580159,713,338,375,24,1.1,40.9,3.1,0,0,0,0,0,0,0.051045279132189,49.2438214214345,6.07583850420936
8.7,"random_policy_SVM","SVM",17,16,2212,2200,12,1700,1302,398,0.92773944805194,0.663265306122449,1.75032326980379,730,344,386,17,1.1,43.46,3.3,0,0,0,0,0,0,0.0403238311891316,43.5435635183633,4.60062031299918
8.7,"random_policy_SVM","SVM",17,17,2112,2100,12,1800,1402,398,0.927568413729119,0.663265306122449,1.75354373580159,731,344,387,1,1.1,46.01,3.5,0,0,0,0,0,0,0.0356165595308533,37.9787831930297,3.79709522358243
8.7,"random_policy_SVM","SVM",17,18,2012,2000,12,1900,1502,398,0.927671324211492,0.668367346938776,1.75515841695794,730,345,385,-1,1.1,48.57,3.8,0,0,0,0,0,0,0.027185465378873,27.8278818312971,2.89953633440375
8.7,"random_policy_SVM","SVM",17,19,1912,1902,10,2000,1600,400,0.926958198051938,0.658163265306122,1.75193202280912,729,349,380,-1,1.1,51.12,4,0,0,0,0,0,0,0.0241929850935395,24.364089978226,2.58262436004081
8.7,"random_policy_SVM","SVM",17,20,1812,1803,9,2100,1699,401,0.926652365491643,0.658163265306122,1.75193202280912,736,352,384,7,1.1,53.68,4.2,0,0,0,0,0,0,0.0227371125989097,21.779569730708,2.34453097176718
8.7,"random_policy_SVM","SVM",17,21,1712,1704,8,2200,1798,402,0.92951646567716,0.653061224489796,1.75677607448509,757,366,391,21,1.1,56.24,4.5,0,0,0,0,0,0,0.0139223169160677,10.7636192016205,1.8212272898652
8.7,"random_policy_SVM","SVM",17,22,1612,1605,7,2300,1897,403,0.92891784554729,0.653061224489796,1.75515841695794,759,367,392,2,1.1,58.79,4.7,0,0,0,0,0,0,0.0114605881683999,9.56805144168862,1.26649414618797
8.7,"random_policy_SVM","SVM",17,23,1512,1505,7,2400,1997,403,0.928814935064916,0.653061224489796,1.75677607448509,758,368,390,-1,1.1,61.35,5,0,0,0,0,0,0,0.010468114659449,7.78953188218545,1.05763082585064
8.7,"random_policy_SVM","SVM",17,24,1412,1405,7,2500,2097,403,0.930893436920214,0.642857142857143,1.7719054503126,776,376,400,18,1.1,63.91,5.2,0,0,0,0,0,0,0.00628254527597583,4.15108294961844,0.798347657177396
8.7,"random_policy_SVM","SVM",17,25,1312,1306,6,2600,2196,404,0.931126797309824,0.647959183673469,1.7702768607443,780,378,402,4,1.1,66.46,5.4,0,0,0,0,0,0,0.00554011209783856,3.51617970635932,0.582912252697166
8.7,"random_policy_SVM","SVM",17,26,1212,1207,5,2700,2295,405,0.931883406771794,0.642857142857143,1.77944927971188,790,383,407,10,1.1,69.02,5.7,0,0,0,0,0,0,0.0048247152819079,2.90883970480466,0.533013065254583
8.7,"random_policy_SVM","SVM",17,27,1112,1107,5,2800,2395,405,0.931886305658621,0.642857142857143,1.77944927971188,791,383,408,1,1.1,71.57,5.9,0,0,0,0,0,0,0.00442533992939184,2.24725315364139,0.450335318398459
8.7,"random_policy_SVM","SVM",17,28,1012,1007,5,2900,2495,405,0.93186166512059,0.642857142857143,1.77455620194916,797,388,409,6,1.1,74.13,6.2,0,0,0,0,0,0,0.00330578051960251,1.47005030486904,0.368182259175868
8.7,"random_policy_SVM","SVM",17,29,912,908,4,3000,2594,406,0.932621173469385,0.637755102040816,1.77455620194916,798,389,409,1,1.1,76.69,6.4,0,0,0,0,0,0,0.00377903648963909,1.4039094748452,0.406889356558735
8.7,"random_policy_SVM","SVM",17,30,812,808,4,3100,2694,406,0.932792207792206,0.637755102040816,1.77944927971188,803,393,410,5,1,79.24,6.6,0,0,0,0,0,0,0.00220635199674544,0.699217407032458,0.253168461805479
8.7,"random_policy_SVM","SVM",17,31,712,708,4,3200,2794,406,0.93307339981447,0.637755102040816,1.77781525833474,803,393,410,0,1,81.8,6.9,0,0,0,0,0,0,0.00170897153769422,0.487559449337462,0.20128224291272
8.7,"random_policy_SVM","SVM",17,32,612,609,3,3300,2893,407,0.933129928107605,0.637755102040816,1.77618423516195,805,394,411,2,1,84.36,7.1,0,0,0,0,0,0,0.00115346686157096,0.344835803853031,0.152349765002453
8.7,"random_policy_SVM","SVM",17,33,512,509,3,3400,2993,407,0.933557513914655,0.637755102040816,1.77618423516195,805,395,410,0,1,86.91,7.4,0,0,0,0,0,0,0.000605333741901309,0.184655426347584,0.0858464773977997
8.7,"random_policy_SVM","SVM",17,34,412,411,1,3500,3091,409,0.935162047773654,0.642857142857143,1.78272635020859,812,399,413,7,1,89.47,7.6,0,0,0,0,0,0,0.000582090081016696,0.167156184253128,0.0745648128934908
8.7,"random_policy_SVM","SVM",17,35,312,312,0,3600,3190,410,0.935830241187383,0.642857142857143,1.785339824003,817,402,415,5,1,92.02,7.8,0,0,0,0,0,0,0.000330052724489402,0.0826121521358688,0.0424093905326303
8.7,"random_policy_SVM","SVM",17,36,212,212,0,3700,3290,410,0.936410018552875,0.642857142857143,1.78370339886642,820,402,418,3,1,94.58,8,0,0,0,0,0,0,0.000210302362086426,0.0437414857581605,0.027962769564543
8.7,"random_policy_SVM","SVM",17,37,112,112,0,3800,3390,410,0.937039076994433,0.647959183673469,1.78697925451172,824,404,420,4,1,97.14,8.3,0,0,0,0,0,0,8.815438704432e-05,0.0154838292169577,0.0145368730009592
8.7,"random_policy_SVM","SVM",17,38,12,12,0,3900,3490,410,0.937317370129869,0.647959183673469,1.78697925451172,826,405,421,2,1,99.69,8.5,0,0,0,0,0,0,3.53604847374554e-05,0.000578929126752889,0.000578929126752889
8.7,"random_policy_SVM","SVM",17,39,0,0,0,3912,3502,410,0.937357954545454,0.647959183673469,1.78697925451172,828,406,422,2,1,100,8.5,0,0,0,0,0,0,0,0,0
8.7,"random_policy_SVM","SVM",18,0,3812,3418,394,100,89,11,0.905183484287965,0.577114427860697,1.74985622346981,28,11,17,0,1.5,2.56,8.1,0,0,0,0,0,0,0.6138522508259,407.531231802674,65.8651464313482
8.7,"random_policy_SVM","SVM",18,1,3712,3373,339,200,134,66,0.899749117659562,0.577114427860697,1.715718926031,104,52,52,76,1,5.11,2,0,0,0,0,0,0,0.693699886060099,321.44453296913,76.5597945650484
8.7,"random_policy_SVM","SVM",18,2,3612,3343,269,300,164,136,0.905224589304185,0.592039800995025,1.71149775981969,164,82,82,60,1,7.67,1.2,0,0,0,0,0,0,0.684759963102148,221.199538026879,79.905452587205
8.7,"random_policy_SVM","SVM",18,3,3512,3299,213,400,208,192,0.873354027582892,0.582089552238806,1.68461559605288,239,121,118,75,1,10.22,1.1,0,0,0,0,0,0,0.448955405076486,257.879191667719,69.0786185996616
8.7,"random_policy_SVM","SVM",18,4,3412,3250,162,500,257,243,0.893849839123472,0.592039800995025,1.72782820030482,313,158,155,74,1,12.78,1.1,0,0,0,0,0,0,0.217472547501187,118.47612687395,40.4474455654571
8.7,"random_policy_SVM","SVM",18,5,3312,3184,128,600,323,277,0.869096114867262,0.616915422885572,1.60544741729142,380,188,192,67,1,15.34,1.2,0,0,0,0,0,0,0.0980698400607617,64.8263523755624,17.6848502952309
8.7,"random_policy_SVM","SVM",18,6,3212,3109,103,700,398,302,0.869104619353378,0.631840796019901,1.59354103447802,442,213,229,62,1.1,17.89,1.3,0,0,0,0,0,0,0.0783977498232119,88.8333437203215,11.3630056050792
8.7,"random_policy_SVM","SVM",18,7,3112,3027,85,800,480,320,0.866765885671364,0.651741293532338,1.56668360131266,487,230,257,45,1.1,20.45,1.5,0,0,0,0,0,0,0.0656789136558425,95.1545454519325,8.52055129372772
8.7,"random_policy_SVM","SVM",18,8,3012,2940,72,900,567,333,0.872446882397124,0.646766169154229,1.62338537726116,515,248,267,28,1.1,23.01,1.7,0,0,0,0,0,0,0.0612900761937944,88.1814121761997,8.22483537684066
8.7,"random_policy_SVM","SVM",18,9,2912,2848,64,1000,659,341,0.886792533061191,0.63681592039801,1.62785338015803,542,262,280,27,1.1,25.56,1.9,0,0,0,0,0,0,0.0436284906010358,55.172663174847,5.58585144702425
8.7,"random_policy_SVM","SVM",18,10,2812,2756,56,1100,751,349,0.894558546299851,0.641791044776119,1.64725590080874,564,271,293,22,1.1,28.12,2.2,0,0,0,0,0,0,0.0386421651403826,53.2664385823643,4.26374500824599
8.7,"random_policy_SVM","SVM",18,11,2712,2662,50,1200,845,355,0.911544839903049,0.621890547263682,1.70097076713946,590,285,305,26,1.1,30.67,2.4,0,0,0,0,0,0,0.0338270782109609,41.8270533654419,4.03764395486917
8.7,"random_policy_SVM","SVM",18,12,2612,2568,44,1300,939,361,0.916936684100858,0.616915422885572,1.70992324486125,606,293,313,16,1.1,33.23,2.6,0,0,0,0,0,0,0.0433605868112003,51.3378360487181,4.90659954015483
8.7,"random_policy_SVM","SVM",18,13,2512,2474,38,1400,1033,367,0.917543337443837,0.621890547263682,1.71887572258304,637,308,329,31,1.1,35.79,2.8,0,0,0,0,0,0,0.060448502441274,51.8090725567561,7.12553725642755
8.7,"random_policy_SVM","SVM",18,14,2412,2381,31,1500,1126,374,0.919496534421914,0.616915422885572,1.73101313707958,657,317,340,20,1.1,38.34,3,0,0,0,0,0,0,0.0585593111348668,41.4202791786539,6.43828621450167
8.7,"random_policy_SVM","SVM",18,15,2312,2288,24,1600,1219,381,0.918507179203703,0.621890547263682,1.73101313707958,672,325,347,15,1.1,40.9,3.2,0,0,0,0,0,0,0.0594747194794294,36.9125450929178,6.47409920100698
8.7,"random_policy_SVM","SVM",18,16,2212,2192,20,1700,1315,385,0.917568850902192,0.621890547263682,1.72782820030482,688,329,359,16,1.1,43.46,3.4,0,0,0,0,0,0,0.0503606459178023,32.1791437032602,5.89174070729215
8.7,"random_policy_SVM","SVM",18,17,2112,2099,13,1800,1408,392,0.916753837649371,0.626865671641791,1.72624012291484,703,338,365,15,1.1,46.01,3.6,0,0,0,0,0,0,0.040621162578152,28.2445897614422,4.89647138737641
8.7,"random_policy_SVM","SVM",18,18,2012,2002,10,1900,1505,395,0.916060722030881,0.621890547263682,1.72941920233089,719,342,377,16,1.1,48.57,3.8,0,0,0,0,0,0,0.0308739483946003,25.6873227977134,3.72172295994524
8.7,"random_policy_SVM","SVM",18,19,1912,1904,8,2000,1603,397,0.917108191237554,0.621890547263682,1.72941920233089,721,348,373,2,1.1,51.12,4,0,0,0,0,0,0,0.0212449617907552,17.869567636306,2.35512498550335
8.7,"random_policy_SVM","SVM",18,20,1812,1804,8,2100,1703,397,0.916989128431925,0.621890547263682,1.72624012291484,721,348,373,0,1.1,53.68,4.3,0,0,0,0,0,0,0.0176055285290275,15.669694501549,1.93624994260736
8.7,"random_policy_SVM","SVM",18,21,1712,1704,8,2200,1803,397,0.917177644540838,0.621890547263682,1.72782820030482,722,348,374,1,1.1,56.24,4.5,0,0,0,0,0,0,0.0149385616647545,12.573940097227,1.52939405638219
8.7,"random_policy_SVM","SVM",18,22,1612,1605,7,2300,1902,398,0.920704171450449,0.616915422885572,1.73678067802661,747,358,389,25,1.1,58.79,4.8,0,0,0,0,0,0,0.0114520176189293,8.79775783313106,1.46541866493037
8.7,"random_policy_SVM","SVM",18,23,1512,1507,5,2400,2000,400,0.920752363538437,0.616915422885572,1.73837992358649,748,359,389,1,1.1,61.35,5,0,0,0,0,0,0,0.0113414976686642,7.87918970350383,1.14931653235535
8.7,"random_policy_SVM","SVM",18,24,1412,1407,5,2500,2100,400,0.921285311335075,0.597014925373134,1.75468563347018,755,371,384,7,1,63.91,5.2,0,0,0,0,0,0,0.0083378255027866,5.23997760828063,1.03592986965217
8.7,"random_policy_SVM","SVM",18,25,1312,1308,4,2600,2199,401,0.921359016881418,0.601990049751244,1.75468563347018,758,373,385,3,1,66.46,5.5,0,0,0,0,0,0,0.00709770355224018,4.07710634490031,0.730092451547161
8.7,"random_policy_SVM","SVM",18,26,1212,1208,4,2700,2299,401,0.921370356196237,0.601990049751244,1.75630136609769,766,374,392,8,1,69.02,5.7,0,0,0,0,0,0,0.00592608123742539,3.09845394057413,0.642651054312574
8.7,"random_policy_SVM","SVM",18,27,1112,1108,4,2800,2399,401,0.921451148814342,0.601990049751244,1.75307287093942,768,375,393,2,1,71.57,6,0,0,0,0,0,0,0.00550139834986243,2.41994919108811,0.565094969649548
8.7,"random_policy_SVM","SVM",18,28,1012,1008,4,2900,2499,401,0.92260917634052,0.597014925373134,1.75792007703418,777,379,398,9,1.1,74.13,6.2,0,0,0,0,0,0,0.00335884863348156,1.35139024181386,0.383401597745906
8.7,"random_policy_SVM","SVM",18,29,912,908,4,3000,2599,401,0.922835962636957,0.597014925373134,1.75792007703418,780,382,398,3,1,76.69,6.5,0,0,0,0,0,0,0.00300944036962516,1.09581813444724,0.337690748981746
8.7,"random_policy_SVM","SVM",18,30,812,808,4,3100,2699,401,0.922946520956471,0.601990049751244,1.75792007703418,780,382,398,0,1,79.24,6.7,0,0,0,0,0,0,0.002217503153453,0.710970686211003,0.251432326453859
8.7,"random_policy_SVM","SVM",18,31,712,708,4,3200,2799,401,0.922875650238836,0.597014925373134,1.75792007703418,778,381,397,-2,1,81.8,7,0,0,0,0,0,0,0.00161513928470195,0.48631730377648,0.198715923379212
8.7,"random_policy_SVM","SVM",18,32,612,609,3,3300,2898,402,0.923238508313137,0.592039800995025,1.75630136609769,783,383,400,5,1,84.36,7.2,0,0,0,0,0,0,0.0010745068885844,0.325602303464002,0.140927470997964
8.7,"random_policy_SVM","SVM",18,33,512,510,2,3400,2997,403,0.924012416549729,0.597014925373134,1.75792007703418,785,385,400,2,1,86.91,7.4,0,0,0,0,0,0,0.000612719761877181,0.19887353181258,0.086020723007194
8.7,"random_policy_SVM","SVM",18,34,412,411,1,3500,3096,404,0.924324247707336,0.597014925373134,1.75792007703418,790,387,403,5,1,89.47,7.7,0,0,0,0,0,0,0.000464386010875395,0.132464639487549,0.0579067408572726
8.7,"random_policy_SVM","SVM",18,35,312,312,0,3600,3195,405,0.924946492608187,0.592039800995025,1.75630136609769,796,389,407,6,1,92.02,7.9,0,0,0,0,0,0,0.000453023414116491,0.112759204242521,0.0563712875460494
8.7,"random_policy_SVM","SVM",18,36,212,212,0,3700,3295,405,0.925322107411661,0.592039800995025,1.75630136609769,798,391,407,2,1,94.58,8.1,0,0,0,0,0,0,0.000232894950500558,0.047370700912852,0.0301899480363567
8.7,"random_policy_SVM","SVM",18,37,112,112,0,3800,3395,405,0.925582911652565,0.582089552238806,1.75630136609769,805,394,411,7,1,97.14,8.4,0,0,0,0,0,0,7.52504766358319e-05,0.0136295091332884,0.0128769092522138
8.7,"random_policy_SVM","SVM",18,38,12,12,0,3900,3495,405,0.926076171847321,0.592039800995025,1.75792007703418,810,397,413,5,1,99.69,8.6,0,0,0,0,0,0,5.6666261103899e-05,0.000775563953348068,0.000775563953348068
8.7,"random_policy_SVM","SVM",18,39,0,0,0,3912,3507,405,0.926081841504732,0.592039800995025,1.75792007703418,810,397,413,0,1,100,8.7,0,0,0,0,0,0,0,0,0
8.7,"random_policy_SVM","SVM",19,0,3812,3396,416,100,94,6,0.817523800176664,0.451086956521739,1.61660989781607,21,6,15,0,2.5,2.56,15.7,0,0,0,0,0,0,0.163894700627114,253.31235034679,18.7508529398677
8.7,"random_policy_SVM","SVM",19,1,3712,3369,343,200,121,79,0.896432427127295,0.521739130434783,1.75216190247418,74,36,38,53,1.1,5.11,1.5,0,0,0,0,0,0,0.752436359139501,338.405403459391,84.9451038785631
8.7,"random_policy_SVM","SVM",19,2,3612,3330,282,300,160,140,0.909559328687822,0.58695652173913,1.74894101662404,141,71,70,67,1,7.67,1.1,0,0,0,0,0,0,0.688709316153918,278.117641504103,80.0455320216848
8.7,"random_policy_SVM","SVM",19,3,3512,3280,232,400,210,190,0.889372116988916,0.576086956521739,1.71458625525947,231,116,115,90,1,10.22,1.1,0,0,0,0,0,0,0.477564911097569,237.951608238927,64.3960254970636
8.7,"random_policy_SVM","SVM",19,4,3412,3235,177,500,255,245,0.904618338404186,0.614130434782609,1.72939977621483,314,158,156,83,1,12.78,1,0,0,0,0,0,0,0.260574420877939,149.307313495029,44.1071064602108
8.7,"random_policy_SVM","SVM",19,5,3312,3178,134,600,312,288,0.8802952326038,0.619565217391304,1.66771041084962,389,195,194,75,1,15.34,1.1,0,0,0,0,0,0,0.157376311636753,127.37107841823,24.1950559327926
8.7,"random_policy_SVM","SVM",19,6,3212,3100,112,700,390,310,0.881992835410737,0.635869565217391,1.62640753356041,447,221,226,58,1,17.89,1.3,0,0,0,0,0,0,0.0918869380936267,107.81882866221,12.9296744304636
8.7,"random_policy_SVM","SVM",19,7,3112,3020,92,800,470,330,0.884095286583573,0.641304347826087,1.62490992073024,487,238,249,40,1,20.45,1.4,0,0,0,0,0,0,0.071863160585328,112.82667841218,10.5640294343282
8.7,"random_policy_SVM","SVM",19,8,3012,2941,71,900,549,351,0.887958214741399,0.641304347826087,1.62043358486046,551,261,290,64,1.1,23.01,1.6,0,0,0,0,0,0,0.0695776003359354,109.829468223985,9.45233138890795
8.7,"random_policy_SVM","SVM",19,9,2912,2852,60,1000,638,362,0.888682034547058,0.630434782608696,1.64297428102876,583,278,305,32,1.1,25.56,1.8,0,0,0,0,0,0,0.0614448776923955,92.3023327819602,6.67854561363252
8.7,"random_policy_SVM","SVM",19,10,2812,2758,54,1100,732,368,0.905598255471602,0.614130434782609,1.65795771838851,616,297,319,33,1.1,28.12,2,0,0,0,0,0,0,0.0543656013070871,51.0189018322267,6.43030920142948
8.7,"random_policy_SVM","SVM",19,11,2712,2666,46,1200,824,376,0.911542165570712,0.619565217391304,1.68721579577184,634,306,328,18,1.1,30.67,2.2,0,0,0,0,0,0,0.0439064633310631,51.9206463304651,4.98018668074839
8.7,"random_policy_SVM","SVM",19,12,2612,2570,42,1300,920,380,0.918304973500833,0.619565217391304,1.71333014811276,642,312,330,8,1.1,33.23,2.4,0,0,0,0,0,0,0.0363967293008986,46.4673907617781,4.3054902115366
8.7,"random_policy_SVM","SVM",19,13,2512,2479,33,1400,1011,389,0.923960582490911,0.614130434782609,1.76195051645448,672,327,345,30,1.1,35.79,2.6,0,0,0,0,0,0,0.0608883122227526,59.5865330197011,7.56325820610158
8.7,"random_policy_SVM","SVM",19,14,2412,2383,29,1500,1107,393,0.927157964471474,0.608695652173913,1.77337206972551,687,334,353,15,1.1,38.34,2.8,0,0,0,0,0,0,0.0514868887826532,41.6021421113567,5.82087433607085
8.7,"random_policy_SVM","SVM",19,15,2312,2286,26,1600,1204,396,0.927504539208939,0.614130434782609,1.76848225703325,700,340,360,13,1.1,40.9,3,0,0,0,0,0,0,0.0438390867703997,33.891959967104,4.9143117895472
8.7,"random_policy_SVM","SVM",19,16,2212,2190,22,1700,1300,400,0.92709662380998,0.614130434782609,1.77337206972551,714,343,371,14,1.1,43.46,3.2,0,0,0,0,0,0,0.0395487251353532,30.6345937507175,4.65114736414526
8.7,"random_policy_SVM","SVM",19,17,2112,2094,18,1800,1396,404,0.926630434782599,0.614130434782609,1.76848225703325,721,348,373,7,1.1,46.01,3.5,0,0,0,0,0,0,0.0313664532551745,25.5784532036945,3.86570073164052
8.7,"random_policy_SVM","SVM",19,18,2012,1998,14,1900,1492,408,0.926337533123948,0.608695652173913,1.77173913043478,730,352,378,9,1.1,48.57,3.7,0,0,0,0,0,0,0.0233155455902091,21.5877125350001,2.91077488798622
8.7,"random_policy_SVM","SVM",19,19,1912,1900,12,2000,1590,410,0.926901867209725,0.608695652173913,1.77173913043478,736,355,381,6,1.1,51.12,3.9,0,0,0,0,0,0,0.0195893788404367,18.7296300921015,2.1203997102804
8.7,"random_policy_SVM","SVM",19,20,1812,1800,12,2100,1690,410,0.925305476494252,0.608695652173913,1.77010919563217,746,359,387,10,1.1,53.68,4.1,0,0,0,0,0,0,0.0139186929576158,12.7065146848395,1.62763527700551
8.7,"random_policy_SVM","SVM",19,21,1712,1703,9,2200,1787,413,0.925112253410538,0.608695652173913,1.77337206972551,756,364,392,10,1.1,56.24,4.3,0,0,0,0,0,0,0.0129102172393528,10.7749251865873,1.32046577225991
8.7,"random_policy_SVM","SVM",19,22,1612,1603,9,2300,1887,413,0.924232014918053,0.603260869565217,1.77173913043478,775,375,400,19,1.1,58.79,4.6,0,0,0,0,0,0,0.0100206199518763,7.75060527520923,1.21741953457863
8.7,"random_policy_SVM","SVM",19,23,1512,1504,8,2400,1986,414,0.924357763274123,0.608695652173913,1.766858306384,779,376,403,4,1.1,61.35,4.8,0,0,0,0,0,0,0.00871891390374696,6.41759478083334,0.903926308975532
8.7,"random_policy_SVM","SVM",19,24,1412,1405,7,2500,2085,415,0.924961968789875,0.608695652173913,1.766858306384,785,382,403,6,1.1,63.91,5,0,0,0,0,0,0,0.00738977574744178,5.07258679423483,0.813405719770825
8.7,"random_policy_SVM","SVM",19,25,1312,1306,6,2600,2184,416,0.925118387476694,0.608695652173913,1.76848225703325,788,384,404,3,1.1,66.46,5.2,0,0,0,0,0,0,0.0073949861868,4.58022468629346,0.760167938509544
8.7,"random_policy_SVM","SVM",19,26,1212,1206,6,2700,2284,416,0.925573841888314,0.608695652173913,1.76848225703325,791,386,405,3,1,69.02,5.5,0,0,0,0,0,0,0.00576251139099971,3.33901934182286,0.636134759559278
8.7,"random_policy_SVM","SVM",19,27,1112,1107,5,2800,2383,417,0.925724126508984,0.603260869565217,1.77173913043478,794,388,406,3,1,71.57,5.7,0,0,0,0,0,0,0.00520915335363161,2.61568182936287,0.544412009404772
8.7,"random_policy_SVM","SVM",19,28,1012,1008,4,2900,2482,418,0.926506219943078,0.603260869565217,1.76848225703325,806,394,412,12,1,74.13,5.9,0,0,0,0,0,0,0.0046548602231373,2.14253940960884,0.50042908396119
8.7,"random_policy_SVM","SVM",19,29,912,908,4,3000,2582,418,0.926920269408187,0.603260869565217,1.76848225703325,804,394,410,-2,1,76.69,6.2,0,0,0,0,0,0,0.00391020664166088,1.62931892718225,0.427570279627802
8.7,"random_policy_SVM","SVM",19,30,812,809,3,3100,2681,419,0.927041417214644,0.592391304347826,1.77010919563217,809,396,413,5,1,79.24,6.4,0,0,0,0,0,0,0.00340858379541288,1.29297255106019,0.374820488113899
8.7,"random_policy_SVM","SVM",19,31,712,709,3,3200,2781,419,0.927139562273041,0.592391304347826,1.76848225703325,806,396,410,-3,1,81.8,6.6,0,0,0,0,0,0,0.00251020373100998,0.882614388895566,0.289483647019078
8.7,"random_policy_SVM","SVM",19,32,612,609,3,3300,2881,419,0.927219305132989,0.592391304347826,1.76848225703325,804,396,408,-2,1,84.36,6.9,0,0,0,0,0,0,0.00175468504771163,0.596944593291987,0.212347592316726
8.7,"random_policy_SVM","SVM",19,33,512,510,2,3400,2980,420,0.927660957895779,0.592391304347826,1.766858306384,811,398,413,7,1,86.91,7.1,0,0,0,0,0,0,0.00126250655154741,0.415347187172922,0.150754781489733
8.7,"random_policy_SVM","SVM",19,34,412,411,1,3500,3079,421,0.928308101874585,0.592391304347826,1.77010919563217,815,399,416,4,1,89.47,7.3,0,0,0,0,0,0,0.00117586546310273,0.361148665518657,0.138953392330708
8.7,"random_policy_SVM","SVM",19,35,312,312,0,3600,3178,422,0.930571572283847,0.597826086956522,1.77661995448557,821,404,417,6,1,92.02,7.5,0,0,0,0,0,0,0.00102677307443647,0.260339055664795,0.121538752617008
8.7,"random_policy_SVM","SVM",19,36,212,212,0,3700,3278,422,0.930612977230361,0.597826086956522,1.78152774441509,823,404,419,2,1,94.58,7.8,0,0,0,0,0,0,0.000546007502536563,0.115285921924126,0.0705304572700494
8.7,"random_policy_SVM","SVM",19,37,112,112,0,3800,3378,422,0.930686586024159,0.597826086956522,1.77825287723785,831,405,426,8,1.1,97.14,8,0,0,0,0,0,0,0.00037504229756761,0.0569387034653617,0.0528418455812329
8.7,"random_policy_SVM","SVM",19,38,12,12,0,3900,3478,422,0.931178844832685,0.58695652173913,1.78316970546985,829,405,424,-2,1,99.69,8.2,0,0,0,0,0,0,0.000242159117979958,0.00365594983973575,0.00365594983973575
8.7,"random_policy_SVM","SVM",19,39,0,0,0,3912,3490,422,0.931209515163435,0.58695652173913,1.78152774441509,829,405,424,0,1,100,8.3,0,0,0,0,0,0,0,0,0
8.7,"random_policy_SVM","SVM",20,0,3812,3410,402,100,86,14,0.89801215950409,0.589473684210526,1.72526897353882,32,14,18,0,1.3,2.56,6.1,0,0,0,0,0,0,0.787886458988797,473.946215214795,86.4329500119651
8.7,"random_policy_SVM","SVM",20,1,3712,3375,337,200,121,79,0.91060678309593,0.58421052631579,1.75048374613003,106,53,53,74,1,5.11,1.5,0,0,0,0,0,0,0.772481905352447,454.852864535513,82.4460145046328
8.7,"random_policy_SVM","SVM",20,2,3612,3331,281,300,165,135,0.91352148775108,0.605263157894737,1.76156490582482,186,91,95,80,1,7.67,1.2,0,0,0,0,0,0,0.670301166110769,356.642925980502,76.2885214218864
8.7,"random_policy_SVM","SVM",20,3,3512,3288,224,400,208,192,0.889056446325339,0.615789473684211,1.66532507739938,257,130,127,71,1,10.22,1.1,0,0,0,0,0,0,0.493545231837219,283.338474320757,68.929877123986
8.7,"random_policy_SVM","SVM",20,4,3412,3253,159,500,243,257,0.885350479823583,0.652631578947368,1.65586300309598,335,169,166,78,1,12.78,0.9,0,0,0,0,0,0,0.347751681579728,270.114881086152,50.4946364288568
8.7,"random_policy_SVM","SVM",20,5,3312,3194,118,600,302,298,0.878390057817263,0.663157894736842,1.59109088268048,426,214,212,91,1,15.34,1,0,0,0,0,0,0,0.257220738946311,223.068759466656,36.9745691219332
8.7,"random_policy_SVM","SVM",20,6,3212,3111,101,700,385,315,0.890454193240751,0.668421052631579,1.62897399893478,470,231,239,44,1,17.89,1.2,0,0,0,0,0,0,0.1234513788253,130.070520136316,16.1872036023654
8.7,"random_policy_SVM","SVM",20,7,3112,3029,83,800,467,333,0.888855278059247,0.673684210526316,1.62747678018576,522,249,273,52,1.1,20.45,1.4,0,0,0,0,0,0,0.0819071459944856,109.355797404646,11.2364684351241
8.7,"random_policy_SVM","SVM",20,8,3012,2942,70,900,554,346,0.889777671812604,0.673684210526316,1.64146495270434,553,265,288,31,1.1,23.01,1.6,0,0,0,0,0,0,0.06442429013099,100.033605023244,7.4178836313317
8.7,"random_policy_SVM","SVM",20,9,2912,2851,61,1000,645,355,0.898828753650838,0.673684210526316,1.64146495270434,577,277,300,24,1.1,25.56,1.8,0,0,0,0,0,0,0.0598828680137124,85.1269387418631,6.56029669125988
8.7,"random_policy_SVM","SVM",20,10,2812,2757,55,1100,739,361,0.905582046849863,0.673684210526316,1.66685711518908,597,284,313,20,1.1,28.12,2,0,0,0,0,0,0,0.0523575794739684,76.3642979595824,5.81209225721939
8.7,"random_policy_SVM","SVM",20,11,2712,2664,48,1200,832,368,0.915013113190679,0.673684210526316,1.68424922600619,612,296,316,15,1.1,30.67,2.3,0,0,0,0,0,0,0.0488069724602524,75.946909093463,5.61910835789625
8.7,"random_policy_SVM","SVM",20,12,2612,2575,37,1300,921,379,0.922734994337487,0.663157894736842,1.703173374613,649,313,336,37,1.1,33.23,2.4,0,0,0,0,0,0,0.0649639037681408,78.7622167355583,7.63904597495762
8.7,"random_policy_SVM","SVM",20,13,2512,2478,34,1400,1018,382,0.928166537521624,0.657894736842105,1.72209752321981,662,318,344,13,1.1,35.79,2.7,0,0,0,0,0,0,0.056619895883114,58.2173331319749,6.21573277570656
8.7,"random_policy_SVM","SVM",20,14,2412,2382,30,1500,1114,386,0.930136496393893,0.647368421052632,1.73942293750906,678,325,353,16,1.1,38.34,2.9,0,0,0,0,0,0,0.0536207445996159,54.3099218897403,5.87526585806015
8.7,"random_policy_SVM","SVM",20,15,2312,2285,27,1600,1211,389,0.930456875484307,0.647368421052632,1.75048374613003,691,330,361,13,1.1,40.9,3.1,0,0,0,0,0,0,0.050508900277006,46.4757813338122,5.59988797216949
8.7,"random_policy_SVM","SVM",20,16,2212,2190,22,1700,1306,394,0.930117124634929,0.647368421052632,1.75370747310265,702,336,366,11,1.1,43.46,3.3,0,0,0,0,0,0,0.0454892955754985,40.0685753136152,5.29190122454144
8.7,"random_policy_SVM","SVM",20,17,2112,2097,15,1800,1399,401,0.929254336293754,0.642105263157895,1.74422797324804,721,344,377,19,1.1,46.01,3.5,0,0,0,0,0,0,0.0396155403419325,38.3139034566356,4.92715228353106
8.7,"random_policy_SVM","SVM",20,18,2012,2003,9,1900,1493,407,0.928416880252743,0.647368421052632,1.74583555663352,740,351,389,19,1.1,48.57,3.7,0,0,0,0,0,0,0.0373249038591271,35.7838943753672,4.25536514010244
8.7,"random_policy_SVM","SVM",20,19,1912,1903,9,2000,1593,407,0.929074029921934,0.647368421052632,1.74422797324804,744,353,391,4,1.1,51.12,3.9,0,0,0,0,0,0,0.0276856564467957,27.2681928820576,3.00396242709351
8.7,"random_policy_SVM","SVM",20,20,1812,1803,9,2100,1693,407,0.929048697621758,0.652631578947368,1.75532379335435,743,355,388,-1,1.1,53.68,4.2,0,0,0,0,0,0,0.0240119219816993,23.3069886728536,2.52493127986392
8.7,"random_policy_SVM","SVM",20,21,1712,1704,8,2200,1792,408,0.928524169994647,0.647368421052632,1.75532379335435,750,359,391,7,1.1,56.24,4.4,0,0,0,0,0,0,0.0177202123819873,15.800654370747,1.9046766748547
8.7,"random_policy_SVM","SVM",20,22,1612,1605,7,2300,1891,409,0.929562794301738,0.642105263157895,1.77266647281186,758,368,390,8,1.1,58.79,4.6,0,0,0,0,0,0,0.0122458986280173,10.4664175004432,1.50421019715778
8.7,"random_policy_SVM","SVM",20,23,1512,1507,5,2400,1989,411,0.929316921976531,0.642105263157895,1.76481203007519,766,370,396,8,1.1,61.35,4.8,0,0,0,0,0,0,0.0142167777505891,10.6635645559538,1.43372738181377
8.7,"random_policy_SVM","SVM",20,24,1412,1407,5,2500,2089,411,0.930351075877702,0.626315789473684,1.76940789473684,785,383,402,19,1,63.91,5.1,0,0,0,0,0,0,0.00978702899405038,6.32994269139039,1.22359433652262
8.7,"random_policy_SVM","SVM",20,25,1312,1308,4,2600,2188,412,0.930184180723623,0.626315789473684,1.77103568488839,784,381,403,-1,1.1,66.46,5.3,0,0,0,0,0,0,0.0079077447197033,5.17136694315596,0.877713549688892
8.7,"random_policy_SVM","SVM",20,26,1212,1208,4,2700,2288,412,0.930196101806058,0.626315789473684,1.77266647281186,784,381,403,0,1.1,69.02,5.6,0,0,0,0,0,0,0.00706988287380447,4.22077423498285,0.738748846975188
8.7,"random_policy_SVM","SVM",20,27,1112,1108,4,2800,2388,412,0.930303391547965,0.626315789473684,1.77266647281186,784,383,401,0,1,71.57,5.8,0,0,0,0,0,0,0.00634462073866521,3.33815707541082,0.663607394768759
8.7,"random_policy_SVM","SVM",20,28,1012,1009,3,2900,2487,413,0.93064612266795,0.626315789473684,1.77266647281186,792,387,405,8,1,74.13,6,0,0,0,0,0,0,0.00552527741083727,2.53062265016992,0.569290109296731
8.7,"random_policy_SVM","SVM",20,29,912,909,3,3000,2587,413,0.930947129999416,0.621052631578947,1.77103568488839,796,387,409,4,1.1,76.69,6.3,0,0,0,0,0,0,0.00429575053532855,1.68959505980499,0.458668343014584
8.7,"random_policy_SVM","SVM",20,30,812,809,3,3100,2687,413,0.930902425940287,0.621052631578947,1.77103568488839,796,387,409,0,1.1,79.24,6.5,0,0,0,0,0,0,0.00379417369028062,1.31114460373685,0.421783502387059
8.7,"random_policy_SVM","SVM",20,31,712,710,2,3200,2786,414,0.931429933838004,0.621052631578947,1.76940789473684,800,390,410,4,1.1,81.8,6.7,0,0,0,0,0,0,0.00284843097550733,0.876079999300309,0.324277303149881
8.7,"random_policy_SVM","SVM",20,32,612,612,0,3300,2884,416,0.93200214579485,0.626315789473684,1.77103568488839,809,393,416,9,1.1,84.36,6.9,0,0,0,0,0,0,0.00214194410709905,0.676365439514284,0.266815173749748
8.7,"random_policy_SVM","SVM",20,33,512,512,0,3400,2984,416,0.932145198784061,0.626315789473684,1.77430026679602,812,394,418,3,1.1,86.91,7.2,0,0,0,0,0,0,0.00124500857049267,0.397811989551158,0.164616092924827
8.7,"random_policy_SVM","SVM",20,34,412,412,0,3500,3084,416,0.932189902843188,0.621052631578947,1.77430026679602,814,396,418,2,1.1,89.47,7.4,0,0,0,0,0,0,0.000767280592119977,0.225666846956767,0.0964636813056638
8.7,"random_policy_SVM","SVM",20,35,312,312,0,3600,3184,416,0.931918698217807,0.626315789473684,1.77430026679602,816,398,418,2,1.1,92.02,7.7,0,0,0,0,0,0,0.000527211148614262,0.133565008437791,0.0662127536699913
8.7,"random_policy_SVM","SVM",20,36,212,212,0,3700,3284,416,0.932033438636235,0.621052631578947,1.77266647281186,817,401,416,1,1,94.58,7.9,0,0,0,0,0,0,0.00027418684929159,0.0576289384735786,0.0362576907643539
8.7,"random_policy_SVM","SVM",20,37,112,112,0,3800,3384,416,0.932550515586815,0.621052631578947,1.77103568488839,822,405,417,5,1,97.14,8.1,0,0,0,0,0,0,0.000125158225923013,0.0212638045033554,0.0198877636806258
8.7,"random_policy_SVM","SVM",20,38,12,12,0,3900,3484,416,0.932946891577754,0.621052631578947,1.77103568488839,823,404,419,1,1,99.69,8.4,0,0,0,0,0,0,0.000102259424502872,0.00145721900496923,0.00145721900496923
8.7,"random_policy_SVM","SVM",20,39,0,0,0,3912,3496,416,0.932890266436191,0.621052631578947,1.77103568488839,824,404,420,1,1,100,8.4,0,0,0,0,0,0,0,0,0
8.7,"random_policy_SVM","SVM",21,0,3812,3418,394,100,87,13,0.88999636772365,0.517587939698492,1.7302920130607,30,13,17,0,1.3,2.56,6.7,0,0,0,0,0,0,0.392420183688337,426.693800661515,42.8765365072936
8.7,"random_policy_SVM","SVM",21,1,3712,3371,341,200,134,66,0.910432927300123,0.582914572864322,1.71920039759236,121,60,61,91,1,5.11,2,0,0,0,0,0,0,0.637515613921789,448.95073344108,70.2668902167039
8.7,"random_policy_SVM","SVM",21,2,3612,3344,268,300,161,139,0.924394310768402,0.608040201005025,1.77809155972701,182,93,89,61,1,7.67,1.2,0,0,0,0,0,0,0.635107342333798,320.785578380285,73.1610653232502
8.7,"random_policy_SVM","SVM",21,3,3512,3295,217,400,210,190,0.916394722617061,0.608040201005025,1.75585107859741,267,134,133,85,1,10.22,1.1,0,0,0,0,0,0,0.435834115919511,214.789798194285,64.3029703053577
8.7,"random_policy_SVM","SVM",21,4,3412,3251,161,500,254,246,0.902875218437084,0.618090452261307,1.70311465159901,353,177,176,86,1,12.78,1,0,0,0,0,0,0,0.297327592158155,238.49884262773,42.9534488048168
8.7,"random_policy_SVM","SVM",21,5,3312,3189,123,600,316,284,0.880929977148115,0.638190954773869,1.62167390573399,428,212,216,75,1,15.34,1.1,0,0,0,0,0,0,0.18129254606379,189.995024884503,26.8685382666935
8.7,"random_policy_SVM","SVM",21,6,3212,3113,99,700,392,308,0.881899537528264,0.653266331658292,1.61711129175288,482,237,245,54,1,17.89,1.3,0,0,0,0,0,0,0.13078952885186,182.365280509585,16.6678603267989
8.7,"random_policy_SVM","SVM",21,7,3112,3034,78,800,471,329,0.871408837013755,0.688442211055276,1.61252344672672,534,255,279,52,1.1,20.45,1.4,0,0,0,0,0,0,0.113211480926385,185.788782102821,17.0221228688474
8.7,"random_policy_SVM","SVM",21,8,3012,2938,74,900,567,333,0.885420271534099,0.673366834170854,1.62764142700624,548,264,284,14,1.1,23.01,1.7,0,0,0,0,0,0,0.0772076316377836,110.836743962791,8.98712613274105
8.7,"random_policy_SVM","SVM",21,9,2912,2847,65,1000,658,342,0.887668278787205,0.678391959798995,1.6351795743423,567,274,293,19,1.1,25.56,1.9,0,0,0,0,0,0,0.0618102106761875,98.075311070582,7.34554471490587
8.7,"random_policy_SVM","SVM",21,10,2812,2756,56,1100,749,351,0.896954893991862,0.678391959798995,1.65781904916286,591,285,306,24,1.1,28.12,2.1,0,0,0,0,0,0,0.0551533770039975,87.6607379888279,5.96697957524924
8.7,"random_policy_SVM","SVM",21,11,2712,2662,50,1200,843,357,0.908089108033053,0.673366834170854,1.66228199822643,617,297,320,26,1.1,30.67,2.4,0,0,0,0,0,0,0.0605237304038788,90.9542352621443,6.4542778814397
8.7,"random_policy_SVM","SVM",21,12,2612,2567,45,1300,938,362,0.917235580291885,0.663316582914573,1.70902349835655,639,308,331,22,1.1,33.23,2.6,0,0,0,0,0,0,0.052275344912723,64.7615847323397,5.63394436312637
8.7,"random_policy_SVM","SVM",21,13,2512,2473,39,1400,1032,368,0.921256824818434,0.663316582914573,1.72393648684192,655,317,338,16,1.1,35.79,2.8,0,0,0,0,0,0,0.0692301718473683,61.8836973594042,7.65775676074759
8.7,"random_policy_SVM","SVM",21,14,2412,2377,35,1500,1128,372,0.923702176219721,0.658291457286432,1.72710840310106,667,322,345,12,1.1,38.34,3,0,0,0,0,0,0,0.0600632604197131,51.4235389272485,6.52654267206137
8.7,"random_policy_SVM","SVM",21,15,2312,2284,28,1600,1221,379,0.922944260288329,0.653266331658292,1.72710840310106,686,329,357,19,1.1,40.9,3.2,0,0,0,0,0,0,0.0602243051719551,46.4626850044429,6.63694576634253
8.7,"random_policy_SVM","SVM",21,16,2212,2192,20,1700,1313,387,0.923041502332358,0.658291457286432,1.72710840310106,712,339,373,26,1.1,43.46,3.4,0,0,0,0,0,0,0.0536620996716053,42.982848907529,6.53438337054065
8.7,"random_policy_SVM","SVM",21,17,2112,2096,16,1800,1409,391,0.923012901731175,0.648241206030151,1.72710840310106,719,343,376,7,1.1,46.01,3.6,0,0,0,0,0,0,0.0350376935685641,34.3182583880907,4.46999268611157
8.7,"random_policy_SVM","SVM",21,18,2012,1997,15,1900,1508,392,0.922964280709161,0.648241206030151,1.72710840310106,721,344,377,2,1.1,48.57,3.8,0,0,0,0,0,0,0.0293282714230743,29.4223703840022,3.17563938022701
8.7,"random_policy_SVM","SVM",21,19,1912,1900,12,2000,1605,395,0.923926690939022,0.658291457286432,1.72869874233044,730,350,380,9,1.1,51.12,4.1,0,0,0,0,0,0,0.02415488173053,24.314341219884,2.5971129375968
8.7,"random_policy_SVM","SVM",21,20,1812,1803,9,2100,1702,398,0.925535474755659,0.663316582914573,1.73615085547332,744,355,389,14,1.1,53.68,4.3,0,0,0,0,0,0,0.0215676716241775,20.2140074574339,2.25352749207534
8.7,"random_policy_SVM","SVM",21,21,1712,1704,8,2200,1801,399,0.926765300606604,0.648241206030151,1.73615085547332,759,364,395,15,1.1,56.24,4.5,0,0,0,0,0,0,0.0167719534580663,12.2751719576767,2.04131186673889
8.7,"random_policy_SVM","SVM",21,22,1612,1605,7,2300,1900,400,0.927686239964754,0.658291457286432,1.74519330784558,765,365,400,6,1.1,58.79,4.8,0,0,0,0,0,0,0.0124028058128419,10.2555311749375,1.4088233956465
8.7,"random_policy_SVM","SVM",21,23,1512,1506,6,2400,1999,401,0.928341193731877,0.658291457286432,1.74841025403515,764,367,397,-1,1.1,61.35,5,0,0,0,0,0,0,0.0110410165841452,8.13510671407919,1.11635900718211
8.7,"random_policy_SVM","SVM",21,24,1412,1406,6,2500,2099,401,0.929397985945666,0.648241206030151,1.75585107859741,779,376,403,15,1.1,63.91,5.2,0,0,0,0,0,0,0.00907257019673781,5.90027737725901,1.08044820282649
8.7,"random_policy_SVM","SVM",21,25,1312,1307,5,2600,2198,402,0.929244972729327,0.648241206030151,1.75746937452238,780,376,404,1,1.1,66.46,5.5,0,0,0,0,0,0,0.00685420945364034,4.38880653956765,0.74670440015939
8.7,"random_policy_SVM","SVM",21,26,1212,1208,4,2700,2297,403,0.92937081537454,0.648241206030151,1.75746937452238,783,378,405,3,1.1,69.02,5.7,0,0,0,0,0,0,0.00662628837325079,3.87683778457006,0.690328590557729
8.7,"random_policy_SVM","SVM",21,27,1112,1109,3,2800,2396,404,0.929267853210275,0.648241206030151,1.75262341117351,793,384,409,10,1.1,71.57,5.9,0,0,0,0,0,0,0.00561861969525382,2.9140268412472,0.61415274857185
8.7,"random_policy_SVM","SVM",21,28,1012,1009,3,2900,2496,404,0.929190631587076,0.648241206030151,1.75262341117351,792,384,408,-1,1.1,74.13,6.2,0,0,0,0,0,0,0.00496571250382922,2.13180052257416,0.509575974097032
8.7,"random_policy_SVM","SVM",21,29,912,909,3,3000,2596,404,0.929928527097634,0.638190954773869,1.75101402328447,797,386,411,5,1.1,76.69,6.4,0,0,0,0,0,0,0.00377849488455199,1.38826697774023,0.412156933166525
8.7,"random_policy_SVM","SVM",21,30,812,809,3,3100,2696,404,0.930020049021425,0.64321608040201,1.74780409840218,797,386,411,0,1.1,79.24,6.7,0,0,0,0,0,0,0.00369390652330485,1.15989693560482,0.40968252616794
8.7,"random_policy_SVM","SVM",21,31,712,709,3,3200,2796,404,0.930225973349958,0.638190954773869,1.76165755246822,800,388,412,3,1.1,81.8,6.9,0,0,0,0,0,0,0.00204973484941162,0.600392968884083,0.257754396468556
8.7,"random_policy_SVM","SVM",21,32,612,609,3,3300,2896,404,0.930471938520146,0.633165829145729,1.76327821259009,803,388,415,3,1.1,84.36,7.2,0,0,0,0,0,0,0.0011386622583914,0.345672498156961,0.155434523757559
8.7,"random_policy_SVM","SVM",21,33,512,509,3,3400,2996,404,0.931081131325378,0.633165829145729,1.76327821259009,802,389,413,-1,1.1,86.91,7.4,0,0,0,0,0,0,0.000602139696127804,0.176406392413441,0.0848556820453108
8.7,"random_policy_SVM","SVM",21,34,412,411,1,3500,3094,406,0.932318107326599,0.633165829145729,1.76165755246822,807,394,413,5,1,89.47,7.6,0,0,0,0,0,0,0.000633396090763057,0.190722717943026,0.0872854834196487
8.7,"random_policy_SVM","SVM",21,35,312,312,0,3600,3193,407,0.932888689320232,0.633165829145729,1.75681339787849,812,397,415,5,1,92.02,7.8,0,0,0,0,0,0,0.000553056302462613,0.136233579685044,0.068636854971704
8.7,"random_policy_SVM","SVM",21,36,212,212,0,3700,3293,407,0.933509322365944,0.628140703517588,1.76003986876531,814,398,416,2,1,94.58,8.1,0,0,0,0,0,0,0.000286319539088726,0.0588103830047786,0.036855415692375
8.7,"random_policy_SVM","SVM",21,37,112,112,0,3800,3393,407,0.933996962616148,0.633165829145729,1.75842515328938,815,400,415,1,1,97.14,8.3,0,0,0,0,0,0,0.000113348539443457,0.0202642956006062,0.0190697013723674
8.7,"random_policy_SVM","SVM",21,38,12,12,0,3900,3493,407,0.93433301968007,0.628140703517588,1.76906571424616,820,401,419,5,1,99.69,8.6,0,0,0,0,0,0,8.29623495964777e-05,0.00115275852462265,0.00115275852462265
8.7,"random_policy_SVM","SVM",21,39,0,0,0,3912,3505,407,0.934350180040781,0.628140703517588,1.76744271817805,822,401,421,2,1,100,8.6,0,0,0,0,0,0,0,0,0
8.7,"random_policy_SVM","SVM",22,0,3812,3413,399,100,92,8,0.845322228673242,0.412060301507538,1.65781904916286,31,8,23,0,2.9,2.56,11.5,0,0,0,0,0,0,0.171624429982717,328.657608016088,20.2736806113329
8.7,"random_policy_SVM","SVM",22,1,3712,3346,366,200,159,41,0.873682584807925,0.522613065326633,1.70311465159901,92,41,51,61,1.2,5.11,3.9,0,0,0,0,0,0,0.32777205305317,320.759926436193,43.2157618529029
8.7,"random_policy_SVM","SVM",22,2,3612,3301,311,300,204,96,0.868408633949482,0.522613065326633,1.62008939726256,180,87,93,88,1.1,7.67,2.1,0,0,0,0,0,0,0.526736193720609,371.321451744016,62.8565781151958
8.7,"random_policy_SVM","SVM",22,3,3512,3262,250,400,243,157,0.894944271728588,0.613065326633166,1.68499641062455,243,120,123,63,1,10.22,1.5,0,0,0,0,0,0,0.360920116992806,190.458050680211,58.3804301400695
8.7,"random_policy_SVM","SVM",22,4,3412,3229,183,500,276,224,0.919732412775306,0.663316582914573,1.74940758840072,321,159,162,78,1,12.78,1.2,0,0,0,0,0,0,0.368041324587943,203.463539028971,53.0888701736268
8.7,"random_policy_SVM","SVM",22,5,3312,3178,134,600,327,273,0.885883601273297,0.663316582914573,1.64572633175075,405,199,206,84,1,15.34,1.2,0,0,0,0,0,0,0.228013381920914,193.196680200905,36.1853149035272
8.7,"random_policy_SVM","SVM",22,6,3212,3115,97,700,390,310,0.887470934639042,0.658291457286432,1.64421371563701,474,232,242,69,1,17.89,1.3,0,0,0,0,0,0,0.130961168587462,123.849574752055,18.2566849018613
8.7,"random_policy_SVM","SVM",22,7,3112,3036,76,800,469,331,0.881584930915241,0.678391959798995,1.62914017601821,528,254,274,54,1.1,20.45,1.4,0,0,0,0,0,0,0.0931981744234559,124.728245958888,12.9567270734674
8.7,"random_policy_SVM","SVM",22,8,3012,2952,60,900,553,347,0.876185137411576,0.688442211055276,1.6110386185069,574,274,300,46,1.1,23.01,1.6,0,0,0,0,0,0,0.0931718011682885,148.255870783757,13.7889826307886
8.7,"random_policy_SVM","SVM",22,9,2912,2853,59,1000,652,348,0.897346722228104,0.668341708542714,1.64421371563701,585,285,300,11,1.1,25.56,1.9,0,0,0,0,0,0,0.065044868870073,84.0651693963648,7.60722783354112
8.7,"random_policy_SVM","SVM",22,10,2812,2763,49,1100,742,358,0.906807801099982,0.683417085427136,1.67285368886752,608,296,312,23,1.1,28.12,2.1,0,0,0,0,0,0,0.057510100470041,83.9154127291339,6.30445365813201
8.7,"random_policy_SVM","SVM",22,11,2712,2672,40,1200,833,367,0.92219063444712,0.688442211055276,1.71059718481912,637,308,329,29,1.1,30.67,2.3,0,0,0,0,0,0,0.0634594699961336,92.1956601671303,7.30587376427186
8.7,"random_policy_SVM","SVM",22,12,2612,2582,30,1300,923,377,0.929382255614988,0.678391959798995,1.74680029984175,669,322,347,32,1.1,33.23,2.4,0,0,0,0,0,0,0.0862800465731805,91.7750814064049,9.51546366241084
8.7,"random_policy_SVM","SVM",22,13,2512,2484,28,1400,1021,379,0.929696862228028,0.678391959798995,1.74680029984175,677,326,351,8,1.1,35.79,2.7,0,0,0,0,0,0,0.0678029685086882,68.0482264165617,7.29277072763908
8.7,"random_policy_SVM","SVM",22,14,2412,2387,25,1500,1118,382,0.930400437017179,0.678391959798995,1.75585107859741,688,332,356,11,1.1,38.34,2.9,0,0,0,0,0,0,0.0606588676131783,51.7420762484964,6.51403124215011
8.7,"random_policy_SVM","SVM",22,15,2312,2293,19,1600,1212,388,0.930217393169599,0.678391959798995,1.75423576021783,706,338,368,18,1.1,40.9,3.1,0,0,0,0,0,0,0.059513806562484,48.7829979207245,6.60868817723479
8.7,"random_policy_SVM","SVM",22,16,2212,2198,14,1700,1307,393,0.930409017197534,0.673366834170854,1.75746937452238,718,344,374,12,1.1,43.46,3.3,0,0,0,0,0,0,0.0468412000987457,41.8804057655185,5.58142722986353
8.7,"random_policy_SVM","SVM",22,17,2112,2102,10,1800,1403,397,0.929285013570976,0.678391959798995,1.74519330784558,730,348,382,12,1.1,46.01,3.5,0,0,0,0,0,0,0.0379057790955738,37.4908325950176,4.44320898218479
8.7,"random_policy_SVM","SVM",22,18,2012,2003,9,1900,1502,398,0.928790223170481,0.678391959798995,1.74519330784558,732,349,383,2,1.1,48.57,3.8,0,0,0,0,0,0,0.0295903811862877,30.7036236598015,3.2659870232067
8.7,"random_policy_SVM","SVM",22,19,1912,1903,9,2000,1602,398,0.928970406957946,0.678391959798995,1.75262341117351,731,350,381,-1,1.1,51.12,4,0,0,0,0,0,0,0.0255636277747164,25.1539403130979,2.63516378837371
8.7,"random_policy_SVM","SVM",22,20,1812,1803,9,2100,1702,398,0.927568977499897,0.663316582914573,1.76652849500961,749,359,390,18,1.1,53.68,4.3,0,0,0,0,0,0,0.0182947807722951,15.5182606108197,2.29248706070992
8.7,"random_policy_SVM","SVM",22,21,1712,1705,7,2200,1800,400,0.927621888612088,0.658291457286432,1.76165755246822,754,360,394,5,1.1,56.24,4.5,0,0,0,0,0,0,0.0137552486328504,12.2551905861386,1.48270098008816
8.7,"random_policy_SVM","SVM",22,22,1612,1606,6,2300,1899,401,0.927975106036716,0.658291457286432,1.77069169376293,760,367,393,6,1.1,58.79,4.7,0,0,0,0,0,0,0.0114747163456867,9.87311647603573,1.28404260958667
8.7,"random_policy_SVM","SVM",22,23,1512,1507,5,2400,1998,402,0.928092368501572,0.653266331658292,1.77558761549684,763,368,395,3,1.1,61.35,5,0,0,0,0,0,0,0.011117351470652,8.53261010349531,1.12490372989212
8.7,"random_policy_SVM","SVM",22,24,1412,1407,5,2500,2098,402,0.928020866998608,0.653266331658292,1.77069169376293,779,376,403,16,1.1,63.91,5.2,0,0,0,0,0,0,0.0090654929802191,5.93195225339481,1.08528041641744
8.7,"random_policy_SVM","SVM",22,25,1312,1307,5,2600,2198,402,0.928007996728076,0.653266331658292,1.77069169376293,779,375,404,0,1.1,66.46,5.5,0,0,0,0,0,0,0.00729955367015091,4.71035433083761,0.798515796844003
8.7,"random_policy_SVM","SVM",22,26,1212,1207,5,2700,2298,402,0.927992266397424,0.648241206030151,1.76906571424616,779,375,404,0,1.1,69.02,5.7,0,0,0,0,0,0,0.00599245883920078,3.65433431739773,0.628427802368224
8.7,"random_policy_SVM","SVM",22,27,1112,1107,5,2800,2398,402,0.928304012950337,0.648241206030151,1.77558761549684,779,377,402,0,1.1,71.57,6,0,0,0,0,0,0,0.00513617268707534,2.70128763252633,0.527652563517933
8.7,"random_policy_SVM","SVM",22,28,1012,1008,4,2900,2497,403,0.928597169112478,0.64321608040201,1.77395263610872,787,382,405,8,1.1,74.13,6.2,0,0,0,0,0,0,0.00468394475486126,2.18900457211348,0.494824808134431
8.7,"random_policy_SVM","SVM",22,29,912,908,4,3000,2597,403,0.928721581727632,0.638190954773869,1.77558761549684,787,383,404,0,1.1,76.69,6.4,0,0,0,0,0,0,0.00392741890484336,1.53504327028355,0.407541662846143
8.7,"random_policy_SVM","SVM",22,30,812,810,2,3100,2695,405,0.929419436396537,0.638190954773869,1.76582269735478,798,387,411,11,1.1,79.24,6.7,0,0,0,0,0,0,0.0035144830417337,1.21695839242852,0.387058273038662
8.7,"random_policy_SVM","SVM",22,31,712,710,2,3200,2795,405,0.929456617178077,0.638190954773869,1.77558761549684,801,389,412,3,1.1,81.8,6.9,0,0,0,0,0,0,0.00271860299930393,0.86304530401808,0.321675744660106
8.7,"random_policy_SVM","SVM",22,32,612,611,1,3300,2894,406,0.929565299462579,0.638190954773869,1.77232066496235,805,391,414,4,1.1,84.36,7.1,0,0,0,0,0,0,0.00172303738398085,0.560064243528147,0.225898980575439
8.7,"random_policy_SVM","SVM",22,33,512,512,0,3400,2993,407,0.929445176937603,0.638190954773869,1.77069169376293,805,392,413,0,1.1,86.91,7.4,0,0,0,0,0,0,0.00120691564426744,0.397759898716731,0.155423961095738
8.7,"random_policy_SVM","SVM",22,34,412,412,0,3500,3093,407,0.92969400216791,0.638190954773869,1.77558761549684,809,392,417,4,1.1,89.47,7.6,0,0,0,0,0,0,0.000772852321558402,0.229777982143258,0.0976654622018273
8.7,"random_policy_SVM","SVM",22,35,312,312,0,3600,3193,407,0.929902786556559,0.633165829145729,1.76906571424616,810,394,416,1,1.1,92.02,7.8,0,0,0,0,0,0,0.000499904943184325,0.129485362263863,0.0615147437492535
8.7,"random_policy_SVM","SVM",22,36,212,212,0,3700,3293,407,0.930177352327932,0.628140703517588,1.76906571424616,813,394,419,3,1.1,94.58,8.1,0,0,0,0,0,0,0.000301652141205526,0.0620449200149852,0.0377016430319195
8.7,"random_policy_SVM","SVM",22,37,112,112,0,3800,3393,407,0.930457638219543,0.628140703517588,1.77069169376293,814,396,418,1,1.1,97.14,8.3,0,0,0,0,0,0,0.000139678123487541,0.023152091067892,0.0216556698659814
8.7,"random_policy_SVM","SVM",22,38,12,12,0,3900,3493,407,0.930936698289392,0.628140703517588,1.77069169376293,817,397,420,3,1.1,99.69,8.6,0,0,0,0,0,0,8.81277374377557e-05,0.00121887885895937,0.00121887885895937
8.7,"random_policy_SVM","SVM",22,39,0,0,0,3912,3505,407,0.9309610088004,0.628140703517588,1.77232066496235,817,397,420,0,1.1,100,8.6,0,0,0,0,0,0,0,0,0
8.7,"random_policy_SVM","SVM",23,0,3812,3427,385,100,84,16,0.897494114861201,0.585365853658537,1.75394548063128,32,15,17,0,1.1,2.56,5.2,0,0,0,0,0,0,0.957209950854811,501.075429093022,96.9466611522504
8.7,"random_policy_SVM","SVM",23,1,3712,3379,333,200,132,68,0.880902898692052,0.580487804878049,1.69567443740736,100,49,51,68,1,5.11,1.9,0,0,0,0,0,0,0.727414985419223,336.30820723621,79.7120324750876
8.7,"random_policy_SVM","SVM",23,2,3612,3335,277,300,176,124,0.865873159588252,0.585365853658537,1.68688855949333,173,85,88,73,1,7.67,1.4,0,0,0,0,0,0,0.637371792335714,278.558923260052,75.6628237086654
8.7,"random_policy_SVM","SVM",23,3,3512,3293,219,400,218,182,0.880907077488839,0.619512195121951,1.71167006978257,247,123,124,74,1,10.22,1.2,0,0,0,0,0,0,0.3947773735538,161.188021331752,62.0073883500724
8.7,"random_policy_SVM","SVM",23,4,3412,3251,161,500,260,240,0.866267359418311,0.64390243902439,1.61214808842303,317,160,157,70,1,12.78,1.1,0,0,0,0,0,0,0.253437583434768,148.51751981351,41.9507226431709
8.7,"random_policy_SVM","SVM",23,5,3312,3189,123,600,322,278,0.857926481035233,0.634146341463415,1.59024390243902,386,192,194,69,1,15.34,1.2,0,0,0,0,0,0,0.109649262101387,82.9923904921206,18.8063112735139
8.7,"random_policy_SVM","SVM",23,6,3212,3113,99,700,398,302,0.860795921494344,0.653658536585366,1.56388626869694,449,219,230,63,1.1,17.89,1.3,0,0,0,0,0,0,0.0838046099740314,86.0157372540591,12.9161119066615
8.7,"random_policy_SVM","SVM",23,7,3112,3034,78,800,477,323,0.860082740176346,0.663414634146341,1.54631451286889,508,241,267,59,1.1,20.45,1.5,0,0,0,0,0,0,0.0651233675333905,100.77419833395,10.3992014245539
8.7,"random_policy_SVM","SVM",23,8,3012,2948,64,900,563,337,0.874892395982785,0.663414634146341,1.58586306524222,545,260,285,37,1.1,23.01,1.7,0,0,0,0,0,0,0.0528586924823174,71.6084905125804,6.47623800119035
8.7,"random_policy_SVM","SVM",23,9,2912,2862,50,1000,649,351,0.899224136730235,0.673170731707317,1.6339319217368,585,276,309,40,1.1,25.56,1.8,0,0,0,0,0,0,0.053293168593064,85.056934902689,6.17377787768977
8.7,"random_policy_SVM","SVM",23,10,2812,2773,39,1100,738,362,0.923837249794554,0.668292682926829,1.72203207114944,611,288,323,26,1.1,28.12,2,0,0,0,0,0,0,0.0769272158380927,108.449418034643,8.48448818713218
8.7,"random_policy_SVM","SVM",23,11,2712,2681,31,1200,830,370,0.929123427727715,0.648780487804878,1.74752077191102,639,304,335,28,1.1,30.67,2.2,0,0,0,0,0,0,0.0877265428587259,86.9229338592632,9.80204619844523
8.7,"random_policy_SVM","SVM",23,12,2612,2585,27,1300,926,374,0.928258416793197,0.64390243902439,1.75555904593085,653,311,342,14,1.1,33.23,2.5,0,0,0,0,0,0,0.0831834418356996,67.4405135944025,9.02138358490648
8.7,"random_policy_SVM","SVM",23,13,2512,2489,23,1400,1022,378,0.92837542310318,0.648780487804878,1.75717558280555,666,318,348,13,1.1,35.79,2.7,0,0,0,0,0,0,0.071651915907614,54.8284076983676,7.86067463405628
8.7,"random_policy_SVM","SVM",23,14,2412,2392,20,1500,1119,381,0.928532824448753,0.648780487804878,1.75717558280555,677,324,353,11,1.1,38.34,2.9,0,0,0,0,0,0,0.0596941097953362,44.1449229321551,6.51115051246623
8.7,"random_policy_SVM","SVM",23,15,2312,2296,16,1600,1215,385,0.92897159811119,0.648780487804878,1.75879509947173,686,329,357,9,1.1,40.9,3.2,0,0,0,0,0,0,0.041223635359571,35.4166611967772,5.02028535451463
8.7,"random_policy_SVM","SVM",23,16,2212,2200,12,1700,1311,389,0.928347564457946,0.648780487804878,1.75879509947173,695,332,363,9,1.1,43.46,3.4,0,0,0,0,0,0,0.0291186296470299,28.4880787387376,3.4406742028401
8.7,"random_policy_SVM","SVM",23,17,2112,2102,10,1800,1409,391,0.929052388182368,0.648780487804878,1.75879509947173,704,336,368,9,1.1,46.01,3.6,0,0,0,0,0,0,0.0225390496262413,23.6830944270122,2.52500267290504
8.7,"random_policy_SVM","SVM",23,18,2012,2003,9,1900,1508,392,0.929890933403914,0.648780487804878,1.75879509947173,705,338,367,1,1.1,48.57,3.8,0,0,0,0,0,0,0.0183336876871751,19.0032552379435,2.01411766730345
8.7,"random_policy_SVM","SVM",23,19,1912,1903,9,2000,1608,392,0.929723781532509,0.64390243902439,1.75879509947173,708,340,368,3,1.1,51.12,4.1,0,0,0,0,0,0,0.0147154018372676,14.9777308948434,1.56704947037834
8.7,"random_policy_SVM","SVM",23,20,1812,1803,9,2100,1708,392,0.929832430248924,0.64390243902439,1.75879509947173,710,341,369,2,1.1,53.68,4.4,0,0,0,0,0,0,0.0128589448156857,12.4983772342189,1.36154396292883
8.7,"random_policy_SVM","SVM",23,21,1712,1705,7,2200,1806,394,0.929603989358005,0.639024390243902,1.75879509947173,713,344,369,3,1.1,56.24,4.6,0,0,0,0,0,0,0.0114535419270786,11.2460652836422,1.23258741524482
8.7,"random_policy_SVM","SVM",23,22,1612,1607,5,2300,1904,396,0.928818375562405,0.634146341463415,1.76109655311429,725,351,374,12,1.1,58.79,4.8,0,0,0,0,0,0,0.0101334891476824,9.55042205914322,1.15314257208028
8.7,"random_policy_SVM","SVM",23,23,1512,1507,5,2400,2004,396,0.928411639341988,0.634146341463415,1.76596146071958,727,351,376,2,1.1,61.35,5.1,0,0,0,0,0,0,0.00873269280910209,7.32230562636026,0.89089234177681
8.7,"random_policy_SVM","SVM",23,24,1412,1407,5,2500,2104,396,0.927982616205384,0.639024390243902,1.76271520803443,753,364,389,26,1.1,63.91,5.3,0,0,0,0,0,0,0.0060670605335418,3.97589444241549,0.786645510494756
8.7,"random_policy_SVM","SVM",23,25,1312,1307,5,2600,2204,396,0.927886503879326,0.639024390243902,1.76596146071958,752,364,388,-1,1.1,66.46,5.6,0,0,0,0,0,0,0.00431386506911707,3.22096101174804,0.498025474559406
8.7,"random_policy_SVM","SVM",23,26,1212,1208,4,2700,2303,397,0.928141410483218,0.634146341463415,1.7643368411605,752,364,388,0,1.1,69.02,5.8,0,0,0,0,0,0,0.00453731898030674,3.07942081497326,0.462294262429922
8.7,"random_policy_SVM","SVM",23,27,1112,1108,4,2800,2403,397,0.928002117257047,0.629268292682927,1.76271520803443,759,369,390,7,1.1,71.57,6.1,0,0,0,0,0,0,0.00307882947831711,1.81546995564397,0.36714427336005
8.7,"random_policy_SVM","SVM",23,28,1012,1009,3,2900,2502,398,0.927917148389083,0.629268292682927,1.75948086820318,762,371,391,3,1.1,74.13,6.3,0,0,0,0,0,0,0.00287412155931505,1.66294102935644,0.305662447205422
8.7,"random_policy_SVM","SVM",23,29,912,910,2,3000,2601,399,0.927712387346613,0.634146341463415,1.76271520803443,768,374,394,6,1.1,76.69,6.5,0,0,0,0,0,0,0.00248370072954857,1.2618572761289,0.260337020185057
8.7,"random_policy_SVM","SVM",23,30,812,810,2,3100,2701,399,0.92788232508254,0.634146341463415,1.7643368411605,774,377,397,6,1.1,79.24,6.8,0,0,0,0,0,0,0.0020629748169458,0.892610657161043,0.216460566735361
8.7,"random_policy_SVM","SVM",23,31,712,710,2,3200,2801,399,0.92798122327312,0.634146341463415,1.76271520803443,775,379,396,1,1,81.8,7,0,0,0,0,0,0,0.00191013795405949,0.689754469241721,0.202044339825844
8.7,"random_policy_SVM","SVM",23,32,612,610,2,3300,2901,399,0.928323884609498,0.624390243902439,1.75625837577057,779,380,399,4,1.1,84.36,7.3,0,0,0,0,0,0,0.00150227635489373,0.466491944951354,0.169841115090706
8.7,"random_policy_SVM","SVM",23,33,512,511,1,3400,3000,400,0.928752907746102,0.629268292682927,1.76271520803443,784,383,401,5,1,86.91,7.5,0,0,0,0,0,0,0.00108476168207566,0.328044712680646,0.132705888243353
8.7,"random_policy_SVM","SVM",23,34,412,412,0,3500,3099,401,0.92868604699754,0.629268292682927,1.75948086820318,789,386,403,5,1,89.47,7.7,0,0,0,0,0,0,0.000789139802300231,0.235355518850823,0.101210276792633
8.7,"random_policy_SVM","SVM",23,35,312,312,0,3600,3199,401,0.928656795420045,0.629268292682927,1.76109655311429,791,387,404,2,1,92.02,8,0,0,0,0,0,0,0.000431364102314726,0.115002780597765,0.0560735770689108
8.7,"random_policy_SVM","SVM",23,36,212,212,0,3700,3299,401,0.928550932568154,0.629268292682927,1.76338116171647,795,390,405,4,1,94.58,8.2,0,0,0,0,0,0,0.000311100935107852,0.0649145222547646,0.039266311937685
8.7,"random_policy_SVM","SVM",23,37,112,112,0,3800,3399,401,0.928715298575034,0.629268292682927,1.76338116171647,796,391,405,1,1,97.14,8.5,0,0,0,0,0,0,0.000143155219662787,0.022570001100244,0.0210527186656854
8.7,"random_policy_SVM","SVM",23,38,12,12,0,3900,3499,401,0.92872922789765,0.624390243902439,1.77311463639015,798,391,407,2,1,99.69,8.7,0,0,0,0,0,0,9.91044111523016e-05,0.00135656603241731,0.00135656603241731
8.7,"random_policy_SVM","SVM",23,39,0,0,0,3912,3511,401,0.928738978423482,0.624390243902439,1.77474733863361,798,391,407,0,1,100,8.8,0,0,0,0,0,0,0,0,0
8.7,"random_policy_SVM","SVM",24,0,3812,3436,376,100,86,14,0.886230842911903,0.560185185185185,1.71544221817446,31,14,17,0,1.2,2.56,6.1,0,0,0,0,0,0,0.525731502636804,485.66316279636,56.9019325893044
8.7,"random_policy_SVM","SVM",24,1,3712,3404,308,200,118,82,0.885249042145601,0.555555555555556,1.72447102115915,93,47,46,62,1,5.11,1.4,0,0,0,0,0,0,0.703751356016606,351.939242882639,79.5454012214144
8.7,"random_policy_SVM","SVM",24,2,3612,3363,249,300,159,141,0.874132609621119,0.564814814814815,1.7197247706422,166,86,80,73,0.9,7.67,1.1,0,0,0,0,0,0,0.578541528253818,215.79340747346,76.3129039347514
8.7,"random_policy_SVM","SVM",24,3,3512,3321,191,400,201,199,0.838453863346091,0.578703703703704,1.63433599345202,236,121,115,70,1,10.22,1,0,0,0,0,0,0,0.329594288592347,160.033204327029,57.9748743979969
8.7,"random_policy_SVM","SVM",24,4,3412,3263,149,500,259,241,0.870377022137085,0.597222222222222,1.68959354575163,318,158,160,82,1,12.78,1.1,0,0,0,0,0,0,0.14583576164597,78.2782081019527,28.3220187545041
8.7,"random_policy_SVM","SVM",24,5,3312,3196,116,600,326,274,0.861390485312909,0.597222222222222,1.62749615975422,390,191,199,72,1,15.34,1.2,0,0,0,0,0,0,0.0862821033684849,50.4361987254826,12.3406971887025
8.7,"random_policy_SVM","SVM",24,6,3212,3119,93,700,403,297,0.86046988080035,0.615740740740741,1.5857654889913,438,213,225,48,1.1,17.89,1.4,0,0,0,0,0,0,0.0812527598711151,62.9335071988424,10.486990483505
8.7,"random_policy_SVM","SVM",24,7,3112,3038,74,800,484,316,0.85759764793529,0.62037037037037,1.55928995293636,483,233,250,45,1.1,20.45,1.5,0,0,0,0,0,0,0.0648659098698079,77.4514804405108,8.74084261414487
8.7,"random_policy_SVM","SVM",24,8,3012,2951,61,900,571,329,0.854956896551738,0.634259259259259,1.58430529977491,520,253,267,37,1.1,23.01,1.7,0,0,0,0,0,0,0.0658518347540388,102.540047919477,8.44046584626926
8.7,"random_policy_SVM","SVM",24,9,2912,2861,51,1000,661,339,0.868763303533423,0.643518518518518,1.61320273441486,551,263,288,31,1.1,25.56,1.9,0,0,0,0,0,0,0.0668294320161801,110.420500264053,8.08071053644829
8.7,"random_policy_SVM","SVM",24,10,2812,2767,45,1100,755,345,0.8873376968923,0.638888888888889,1.62749615975422,574,277,297,23,1.1,28.12,2.2,0,0,0,0,0,0,0.0544315092673645,74.489162328534,6.05301891827524
8.7,"random_policy_SVM","SVM",24,11,2712,2678,34,1200,844,356,0.899148573861222,0.634259259259259,1.64797794117647,599,290,309,25,1.1,30.67,2.4,0,0,0,0,0,0,0.0617020419113819,85.6492802907712,6.89418928699529
8.7,"random_policy_SVM","SVM",24,12,2612,2583,29,1300,939,361,0.909928426990211,0.634259259259259,1.69791666666667,623,299,324,24,1.1,33.23,2.6,0,0,0,0,0,0,0.060922800817165,70.8787868562679,6.61487514317205
8.7,"random_policy_SVM","SVM",24,13,2512,2485,27,1400,1037,363,0.913825031928485,0.638888888888889,1.71614024327916,630,303,327,7,1.1,35.79,2.9,0,0,0,0,0,0,0.0504466475610486,55.9688736617301,5.50282276408393
8.7,"random_policy_SVM","SVM",24,14,2412,2389,23,1500,1133,367,0.915487973605798,0.643518518518518,1.72605893186004,641,309,332,11,1.1,38.34,3.1,0,0,0,0,0,0,0.0450105312593879,48.4036680110431,4.88633431369742
8.7,"random_policy_SVM","SVM",24,15,2312,2296,16,1600,1226,374,0.918851106853997,0.643518518518518,1.74113257691915,659,316,343,18,1.1,40.9,3.3,0,0,0,0,0,0,0.0524895921781854,45.4726630159329,6.03445315418172
8.7,"random_policy_SVM","SVM",24,16,2212,2199,13,1700,1323,377,0.918664857386137,0.638888888888889,1.7427358297524,667,318,349,8,1.1,43.46,3.5,0,0,0,0,0,0,0.0389111790469353,37.5396053166779,4.67555877391062
8.7,"random_policy_SVM","SVM",24,17,2112,2102,10,1800,1420,380,0.91824978714348,0.643518518518518,1.7427358297524,673,322,351,6,1.1,46.01,3.7,0,0,0,0,0,0,0.0304639043036015,31.5904496624899,3.48290183651825
8.7,"random_policy_SVM","SVM",24,18,2012,2003,9,1900,1519,381,0.917784163473834,0.643518518518518,1.74434203789042,677,324,353,4,1.1,48.57,4,0,0,0,0,0,0,0.0236771533162966,24.7807728085736,2.56448574745232
8.7,"random_policy_SVM","SVM",24,19,1912,1903,9,2000,1619,381,0.917821413367405,0.634259259259259,1.74113257691915,688,327,361,11,1.1,51.12,4.2,0,0,0,0,0,0,0.0216709677287414,22.7228627216933,2.32197958994649
8.7,"random_policy_SVM","SVM",24,20,1812,1805,7,2100,1717,383,0.917798797360589,0.638888888888889,1.73953227124183,695,330,365,7,1.1,53.68,4.5,0,0,0,0,0,0,0.0195195057066711,18.7201377176028,1.97800804426832
8.7,"random_policy_SVM","SVM",24,21,1712,1705,7,2200,1817,383,0.916600148999572,0.634259259259259,1.76612491055913,711,348,363,16,1,56.24,4.7,0,0,0,0,0,0,0.0127818406713198,8.66305365570581,1.74920426781448
8.7,"random_policy_SVM","SVM",24,22,1612,1606,6,2300,1916,384,0.916262239250743,0.634259259259259,1.76450163398693,715,349,366,4,1,58.79,5,0,0,0,0,0,0,0.00921021069825714,7.17448781500795,1.08220699940957
8.7,"random_policy_SVM","SVM",24,23,1512,1507,5,2400,2015,385,0.916629416773094,0.634259259259259,1.76612491055913,718,350,368,3,1.1,61.35,5.2,0,0,0,0,0,0,0.0079586947684655,6.36697592118977,0.862815810991251
8.7,"random_policy_SVM","SVM",24,24,1412,1407,5,2500,2115,385,0.916358024691357,0.634259259259259,1.76612491055913,720,352,368,2,1,63.91,5.5,0,0,0,0,0,0,0.00652340558589886,4.84152447571088,0.688874289921825
8.7,"random_policy_SVM","SVM",24,25,1312,1307,5,2600,2215,385,0.915942954448701,0.62962962962963,1.76612491055913,733,360,373,13,1,66.46,5.8,0,0,0,0,0,0,0.00526038597468623,3.59189788982219,0.592014832476083
8.7,"random_policy_SVM","SVM",24,26,1212,1210,2,2700,2312,388,0.917371753937849,0.625,1.76288133863891,738,364,374,5,1,69.02,6,0,0,0,0,0,0,0.00507805997883098,3.18402389868867,0.545580711565387
8.7,"random_policy_SVM","SVM",24,27,1112,1110,2,2800,2412,388,0.917749574286943,0.625,1.75964965882473,747,367,380,9,1,71.57,6.2,0,0,0,0,0,0,0.00389517636509614,2.29296016457717,0.435495294551494
8.7,"random_policy_SVM","SVM",24,28,1012,1011,1,2900,2511,389,0.917741592166883,0.625,1.76450163398693,750,368,382,3,1,74.13,6.5,0,0,0,0,0,0,0.0042472337840833,1.98903388064229,0.445184328281708
8.7,"random_policy_SVM","SVM",24,29,912,911,1,3000,2611,389,0.917653788846329,0.625,1.76288133863891,753,370,383,3,1,76.69,6.7,0,0,0,0,0,0,0.00329418364158774,1.46373577426278,0.363580343962591
8.7,"random_policy_SVM","SVM",24,30,812,811,1,3100,2711,389,0.917736270753523,0.625,1.76612491055913,754,370,384,1,1,79.24,7,0,0,0,0,0,0,0.0032322468694984,1.29219915028489,0.351667572392713
8.7,"random_policy_SVM","SVM",24,31,712,711,1,3200,2811,389,0.917877288207759,0.625,1.76288133863891,753,371,382,-1,1,81.8,7.2,0,0,0,0,0,0,0.00219447436024842,0.770253318659185,0.243196507771586
8.7,"random_policy_SVM","SVM",24,32,612,611,1,3300,2911,389,0.917889261387835,0.625,1.76126401630989,755,371,384,2,1,84.36,7.5,0,0,0,0,0,0,0.00157670790587497,0.506545370090007,0.184990833439655
8.7,"random_policy_SVM","SVM",24,33,512,511,1,3400,3011,389,0.917950457641558,0.62037037037037,1.76775117659096,759,371,388,4,1,86.91,7.7,0,0,0,0,0,0,0.00098705160557851,0.330122239542747,0.130847850670533
8.7,"random_policy_SVM","SVM",24,34,412,412,0,3500,3110,390,0.917871966794387,0.615740740740741,1.76450163398693,769,375,394,10,1.1,89.47,8,0,0,0,0,0,0,0.00106050630894531,0.313545852567615,0.127909204882778
8.7,"random_policy_SVM","SVM",24,35,312,312,0,3600,3210,390,0.917911877394641,0.615740740740741,1.76288133863891,764,375,389,-5,1,92.02,8.2,0,0,0,0,0,0,0.000597032678267506,0.146726053249295,0.0728676327046403
8.7,"random_policy_SVM","SVM",24,36,212,212,0,3700,3310,390,0.918953544061304,0.615740740740741,1.76450163398693,769,377,392,5,1,94.58,8.5,0,0,0,0,0,0,0.000400733551001368,0.0826481903691237,0.0524005072827115
8.7,"random_policy_SVM","SVM",24,37,112,112,0,3800,3410,390,0.919651979565772,0.615740740740741,1.76288133863891,773,378,395,4,1,97.14,8.7,0,0,0,0,0,0,0.000157853638173175,0.0259368624630642,0.0242470935364675
8.7,"random_policy_SVM","SVM",24,38,12,12,0,3900,3510,390,0.92015485312899,0.611111111111111,1.76288133863891,775,378,397,2,1.1,99.69,9,0,0,0,0,0,0,0.0001152007131469,0.0018690270526886,0.0018690270526886
8.7,"random_policy_SVM","SVM",24,39,0,0,0,3912,3522,390,0.920204076202638,0.611111111111111,1.76450163398693,776,379,397,1,1,100,9,0,0,0,0,0,0,0,0,0
8.7,"random_policy_SVM","SVM",25,0,3812,3411,401,100,88,12,0.873513999629693,0.481865284974093,1.69067596284711,34,12,22,0,1.8,2.56,7.3,0,0,0,0,0,0,0.229091724399752,438.617826080053,26.4656192305619
8.7,"random_policy_SVM","SVM",25,1,3712,3348,364,200,151,49,0.909601215544621,0.559585492227979,1.74030460040823,107,49,58,73,1.2,5.11,3.1,0,0,0,0,0,0,0.644338635887895,450.548886097765,75.231706230879
8.7,"random_policy_SVM","SVM",25,2,3612,3317,295,300,182,118,0.917095506658174,0.590673575129534,1.74672046990282,183,89,94,76,1.1,7.67,1.5,0,0,0,0,0,0,0.61490954819329,418.993014327763,72.8986539426654
8.7,"random_policy_SVM","SVM",25,3,3512,3275,237,400,224,176,0.908278693583426,0.647668393782383,1.73418306791044,256,126,130,73,1,10.22,1.3,0,0,0,0,0,0,0.484172315449751,306.719223806033,65.8051071627908
8.7,"random_policy_SVM","SVM",25,4,3412,3232,180,500,267,233,0.895000573092863,0.658031088082902,1.70307883355458,331,164,167,75,1,12.78,1.1,0,0,0,0,0,0,0.345311211959606,244.305514079079,52.6625257870162
8.7,"random_policy_SVM","SVM",25,5,3312,3178,134,600,321,279,0.87045603496161,0.637305699481865,1.59579766982509,416,206,210,85,1,15.34,1.2,0,0,0,0,0,0,0.26606216296817,246.430014815873,38.5529370065987
8.7,"random_policy_SVM","SVM",25,6,3212,3107,105,700,392,308,0.874610223388657,0.652849740932642,1.56491923194148,482,233,249,66,1.1,17.89,1.3,0,0,0,0,0,0,0.128922409933949,161.107259936933,18.1109419613297
8.7,"random_policy_SVM","SVM",25,7,3112,3022,90,800,477,323,0.899267910621034,0.663212435233161,1.63943919536727,524,249,275,42,1.1,20.45,1.5,0,0,0,0,0,0,0.080440467995756,109.693747979999,10.3228714162397
8.7,"random_policy_SVM","SVM",25,8,3012,2935,77,900,564,336,0.904453666177825,0.694300518134715,1.64875419079549,557,266,291,33,1.1,23.01,1.7,0,0,0,0,0,0,0.0778307989293532,116.765447756766,10.8902992650217
8.7,"random_policy_SVM","SVM",25,9,2912,2847,65,1000,652,348,0.911843625003308,0.689119170984456,1.67515950841434,591,284,307,34,1.1,25.56,1.9,0,0,0,0,0,0,0.0746700370661402,103.528973849655,9.21056649547492
8.7,"random_policy_SVM","SVM",25,10,2812,2755,57,1100,744,356,0.915991935554975,0.694300518134715,1.69845132110039,607,295,312,16,1.1,28.12,2.1,0,0,0,0,0,0,0.0636792311587091,88.8644108500445,6.97144786823909
8.7,"random_policy_SVM","SVM",25,11,2712,2661,51,1200,838,362,0.920710400018818,0.689119170984456,1.70001671402307,622,303,319,15,1.1,30.67,2.3,0,0,0,0,0,0,0.049535359627943,66.2461396130393,5.51130706267117
8.7,"random_policy_SVM","SVM",25,12,2612,2564,48,1300,935,365,0.922166643644981,0.683937823834197,1.69845132110039,634,306,328,12,1.1,33.23,2.6,0,0,0,0,0,0,0.0444763792587459,58.5316757496494,4.87060887810391
8.7,"random_policy_SVM","SVM",25,13,2512,2467,45,1400,1032,368,0.927076139058784,0.689119170984456,1.72803896755092,650,312,338,16,1.1,35.79,2.8,0,0,0,0,0,0,0.043241626094985,53.5175901113849,5.01441997654255
8.7,"random_policy_SVM","SVM",25,14,2412,2377,35,1500,1122,378,0.934335315156988,0.683937823834197,1.74672046990282,679,325,354,29,1.1,38.34,3,0,0,0,0,0,0,0.0551160502678435,56.7678126939371,6.13336324882211
8.7,"random_policy_SVM","SVM",25,15,2312,2282,30,1600,1217,383,0.934890774380701,0.673575129533679,1.75606122107877,689,331,358,10,1.1,40.9,3.2,0,0,0,0,0,0,0.0542729637367841,47.4964410759277,6.04088519734971
8.7,"random_policy_SVM","SVM",25,16,2212,2188,24,1700,1311,389,0.934207471367407,0.663212435233161,1.75444422179601,708,338,370,19,1.1,43.46,3.4,0,0,0,0,0,0,0.0520650011567673,43.68836126932,5.99265902642445
8.7,"random_policy_SVM","SVM",25,17,2112,2094,18,1800,1405,395,0.933186190519578,0.66839378238342,1.74672046990282,727,345,382,19,1.1,46.01,3.6,0,0,0,0,0,0,0.0456605888714864,40.6498565975716,5.40303255199687
8.7,"random_policy_SVM","SVM",25,18,2012,1999,13,1900,1500,400,0.932730655177384,0.673575129533679,1.74672046990282,735,351,384,8,1.1,48.57,3.8,0,0,0,0,0,0,0.0361387128561246,32.9599401953449,4.06658432734272
8.7,"random_policy_SVM","SVM",25,19,1912,1899,13,2000,1600,400,0.932707143675851,0.673575129533679,1.74672046990282,738,353,385,3,1.1,51.12,4,0,0,0,0,0,0,0.0280127566900611,26.0303359059757,3.00109260877331
8.7,"random_policy_SVM","SVM",25,20,1812,1801,11,2100,1698,402,0.932789433931215,0.673575129533679,1.74672046990282,740,356,384,2,1.1,53.68,4.2,0,0,0,0,0,0,0.0251682709255177,23.589341238097,2.69843987279011
8.7,"random_policy_SVM","SVM",25,21,1712,1703,9,2200,1796,404,0.932801189681983,0.673575129533679,1.75606122107877,751,363,388,11,1.1,56.24,4.4,0,0,0,0,0,0,0.0175364679725549,16.0516289934122,2.0313886452764
8.7,"random_policy_SVM","SVM",25,22,1612,1604,8,2300,1895,405,0.93280118968198,0.66839378238342,1.75606122107877,758,365,393,7,1.1,58.79,4.7,0,0,0,0,0,0,0.0175905412964942,14.0205607924921,1.76582621898968
8.7,"random_policy_SVM","SVM",25,23,1512,1504,8,2400,1995,405,0.932336837526706,0.66839378238342,1.77474272343067,784,380,404,26,1.1,61.35,4.9,0,0,0,0,0,0,0.0105108512605351,6.43499513529638,1.50875608101809
8.7,"random_policy_SVM","SVM",25,24,1412,1406,6,2500,2093,407,0.932228096832118,0.66839378238342,1.76984913136239,791,383,408,7,1.1,63.91,5.1,0,0,0,0,0,0,0.00782067293484952,5.27004203216315,0.933870280324365
8.7,"random_policy_SVM","SVM",25,25,1312,1307,5,2600,2192,408,0.932383860529772,0.66839378238342,1.77474272343067,788,384,404,-3,1.1,66.46,5.4,0,0,0,0,0,0,0.00700593821534356,4.79773897761084,0.765875191463253
8.7,"random_policy_SVM","SVM",25,26,1212,1207,5,2700,2292,408,0.93232508177594,0.66839378238342,1.77474272343067,789,384,405,1,1.1,69.02,5.6,0,0,0,0,0,0,0.00613483717566048,3.80190968796719,0.63146306383423
8.7,"random_policy_SVM","SVM",25,27,1112,1107,5,2800,2392,408,0.932028249069088,0.66839378238342,1.7714773274354,796,386,410,7,1.1,71.57,5.9,0,0,0,0,0,0,0.00464334811974309,2.61666138028224,0.507904956084729
8.7,"random_policy_SVM","SVM",25,28,1012,1007,5,2900,2492,408,0.932013554380629,0.66839378238342,1.7714773274354,797,387,410,1,1.1,74.13,6.1,0,0,0,0,0,0,0.00413202217641092,1.94736454347726,0.422554730335406
8.7,"random_policy_SVM","SVM",25,29,912,907,5,3000,2592,408,0.932266303022099,0.663212435233161,1.7714773274354,806,391,415,9,1.1,76.69,6.4,0,0,0,0,0,0,0.00371162927236017,1.49590541931749,0.403569842530086
8.7,"random_policy_SVM","SVM",25,30,812,807,5,3100,2692,408,0.932348593277462,0.663212435233161,1.7714773274354,807,392,415,1,1.1,79.24,6.6,0,0,0,0,0,0,0.00314812994847569,1.02480530838278,0.334858700980243
8.7,"random_policy_SVM","SVM",25,31,712,707,5,3200,2792,408,0.93233830699554,0.663212435233161,1.77310852202788,810,395,415,3,1.1,81.8,6.8,0,0,0,0,0,0,0.00234622560950602,0.687366507258474,0.281394898030331
8.7,"random_policy_SVM","SVM",25,32,612,609,3,3300,2890,410,0.932713021551215,0.66839378238342,1.76822392554847,817,398,419,7,1.1,84.36,7,0,0,0,0,0,0,0.0015833794470602,0.484072932229935,0.207899924701022
8.7,"random_policy_SVM","SVM",25,33,512,511,1,3400,2988,412,0.933791611684028,0.66839378238342,1.76984913136239,829,402,427,12,1.1,86.91,7.3,0,0,0,0,0,0,0.00111174694559975,0.354258396557207,0.151859257077441
8.7,"random_policy_SVM","SVM",25,34,412,411,1,3500,3088,412,0.934091383328567,0.66839378238342,1.7714773274354,830,404,426,1,1.1,89.47,7.5,0,0,0,0,0,0,0.000594430776008971,0.167815315648431,0.0768817699180658
8.7,"random_policy_SVM","SVM",25,35,312,312,0,3600,3187,413,0.934549857608453,0.658031088082902,1.76822392554847,834,407,427,4,1,92.02,7.7,0,0,0,0,0,0,0.000428415717985011,0.10988133088817,0.0565356899712106
8.7,"random_policy_SVM","SVM",25,36,212,212,0,3700,3287,413,0.934640964676893,0.658031088082902,1.7714773274354,838,407,431,4,1.1,94.58,8,0,0,0,0,0,0,0.000238113354390324,0.0493744729956111,0.0311824002981359
8.7,"random_policy_SVM","SVM",25,37,112,112,0,3800,3387,413,0.934854037659533,0.658031088082902,1.76660170176356,840,409,431,2,1.1,97.14,8.2,0,0,0,0,0,0,8.24208346222267e-05,0.0146376309885969,0.0137487506598586
8.7,"random_policy_SVM","SVM",25,38,12,12,0,3900,3487,413,0.935093561081398,0.658031088082902,1.7714773274354,841,409,432,1,1.1,99.69,8.4,0,0,0,0,0,0,6.14439468083403e-05,0.00084236198071531,0.00084236198071531
8.7,"random_policy_SVM","SVM",25,39,0,0,0,3912,3499,413,0.935250794247898,0.658031088082902,1.77310852202788,841,409,432,0,1.1,100,8.5,0,0,0,0,0,0,0,0,0
8.7,"random_policy_SVM","SVM",26,0,3812,3410,402,100,88,12,0.902382133408902,0.536458333333333,1.76807851239669,29,12,17,0,1.4,2.56,7.3,0,0,0,0,0,0,0.72513446404959,479.946993405817,77.3368638548639
8.7,"random_policy_SVM","SVM",26,1,3712,3358,354,200,140,60,0.881886869331065,0.5625,1.70103211009174,106,51,55,77,1.1,5.11,2.3,0,0,0,0,0,0,0.720040041843005,391.316791140257,78.4442587203672
8.7,"random_policy_SVM","SVM",26,2,3612,3325,287,300,173,127,0.888564106198024,0.59375,1.71826036866359,172,86,86,66,1,7.67,1.4,0,0,0,0,0,0,0.678945453912422,292.516525527865,78.8807445369912
8.7,"random_policy_SVM","SVM",26,3,3512,3289,223,400,209,191,0.889765802154209,0.604166666666667,1.71667817679558,236,121,115,64,1,10.22,1.1,0,0,0,0,0,0,0.520439189053833,178.291257357512,74.6180106999619
8.7,"random_policy_SVM","SVM",26,4,3412,3242,170,500,256,244,0.881785005668946,0.625,1.67761039558418,318,162,156,82,1,12.78,1,0,0,0,0,0,0,0.276590277358305,162.204339315268,48.1211763439637
8.7,"random_policy_SVM","SVM",26,5,3312,3186,126,600,312,288,0.871876181027962,0.609375,1.61200551977921,393,197,196,75,1,15.34,1.1,0,0,0,0,0,0,0.142313367660898,105.582288845181,25.6484922234999
8.7,"random_policy_SVM","SVM",26,6,3212,3117,95,700,381,319,0.872998157596382,0.625,1.60904499540863,460,227,233,67,1,17.89,1.2,0,0,0,0,0,0,0.102448671703272,77.4818014880097,13.3879027493831
8.7,"random_policy_SVM","SVM",26,7,3112,3036,76,800,462,338,0.866703278533645,0.630208333333333,1.57596685082873,505,246,259,45,1.1,20.45,1.4,0,0,0,0,0,0,0.0761013515293975,90.9647321648155,10.8214807372453
8.7,"random_policy_SVM","SVM",26,8,3012,2950,62,900,548,352,0.870984504913078,0.645833333333333,1.59326126954922,543,260,283,38,1.1,23.01,1.6,0,0,0,0,0,0,0.0626951771709734,89.5515079457208,7.67076833822801
8.7,"random_policy_SVM","SVM",26,9,2912,2859,53,1000,639,361,0.881897203325779,0.640625,1.6213776448942,569,271,298,26,1.1,25.56,1.8,0,0,0,0,0,0,0.054968454682516,82.4278810975753,6.32372892357
8.7,"random_policy_SVM","SVM",26,10,2812,2775,37,1100,723,377,0.891227324263034,0.625,1.64314516129032,622,291,331,53,1.1,28.12,1.9,0,0,0,0,0,0,0.0703260135433146,115.112980442128,8.07358592823899
8.7,"random_policy_SVM","SVM",26,11,2712,2677,35,1200,821,379,0.899578668272866,0.614583333333333,1.65734145220588,626,298,328,4,1.1,30.67,2.2,0,0,0,0,0,0,0.055951609331753,77.7764885487283,6.06514229514997
8.7,"random_policy_SVM","SVM",26,12,2612,2583,29,1300,915,385,0.910872248204844,0.609375,1.67606847426471,645,309,336,19,1.1,33.23,2.4,0,0,0,0,0,0,0.0618075927044511,80.0395740590738,7.07142205401194
8.7,"random_policy_SVM","SVM",26,13,2512,2486,26,1400,1012,388,0.919381554705221,0.604166666666667,1.73841743119266,661,319,342,16,1.1,35.79,2.6,0,0,0,0,0,0,0.0517923187635673,60.1270929277557,5.78328902688466
8.7,"random_policy_SVM","SVM",26,14,2412,2389,23,1500,1109,391,0.924006755479984,0.604166666666667,1.77133164673413,666,321,345,5,1.1,38.34,2.8,0,0,0,0,0,0,0.0469662026398194,48.9803847650388,5.17103679783289
8.7,"random_policy_SVM","SVM",26,15,2312,2291,21,1600,1207,393,0.925887542517023,0.604166666666667,1.78070377184913,674,324,350,8,1.1,40.9,3.1,0,0,0,0,0,0,0.0404981007946325,39.6894860530422,4.559029845979
8.7,"random_policy_SVM","SVM",26,16,2212,2196,16,1700,1302,398,0.9266020644369,0.604166666666667,1.78070377184913,687,331,356,13,1.1,43.46,3.3,0,0,0,0,0,0,0.0362344949051829,34.2950526896713,4.33332903312674
8.7,"random_policy_SVM","SVM",26,17,2112,2100,12,1800,1398,402,0.926126700680286,0.609375,1.77296270718232,706,337,369,19,1.1,46.01,3.5,0,0,0,0,0,0,0.0308341633122514,31.7258232666749,3.67875022088354
8.7,"random_policy_SVM","SVM",26,18,2012,2001,11,1900,1497,403,0.926191657218457,0.609375,1.76970358455882,710,338,372,4,1.1,48.57,3.7,0,0,0,0,0,0,0.0250273111570296,25.7578621284924,2.68210044663767
8.7,"random_policy_SVM","SVM",26,19,1912,1901,11,2000,1597,403,0.926566633597897,0.609375,1.77580275229358,708,340,368,-2,1.1,51.12,4,0,0,0,0,0,0,0.0181113777378568,18.6135046370929,1.97227574118119
8.7,"random_policy_SVM","SVM",26,20,1812,1803,9,2100,1695,405,0.926935704837501,0.609375,1.78070377184913,712,342,370,4,1.1,53.68,4.2,0,0,0,0,0,0,0.0172721929343793,18.1226902772822,1.85881501936005
8.7,"random_policy_SVM","SVM",26,21,1712,1704,8,2200,1794,406,0.926953420257,0.604166666666667,1.7774334251607,724,352,372,12,1.1,56.24,4.4,0,0,0,0,0,0,0.0143495810385143,14.3747038871377,1.50641726226361
8.7,"random_policy_SVM","SVM",26,22,1612,1605,7,2300,1893,407,0.926848604024943,0.59375,1.77906709558824,735,359,376,11,1,58.79,4.7,0,0,0,0,0,0,0.0119876217183011,11.0123298900864,1.4389662668287
8.7,"random_policy_SVM","SVM",26,23,1512,1506,6,2400,1992,408,0.926727548658354,0.59375,1.77580275229358,739,360,379,4,1.1,61.35,4.9,0,0,0,0,0,0,0.0105559648510586,8.91972829624133,1.06649573997101
8.7,"random_policy_SVM","SVM",26,24,1412,1406,6,2500,2092,408,0.927074475623564,0.59375,1.77255036630037,756,368,388,17,1.1,63.91,5.1,0,0,0,0,0,0,0.00792518532898596,5.55436754238021,0.964028696515007
8.7,"random_policy_SVM","SVM",26,25,1312,1306,6,2600,2192,408,0.927207341269822,0.59375,1.77417506874427,756,367,389,0,1.1,66.46,5.4,0,0,0,0,0,0,0.00647924508694917,4.93496197873256,0.738604395642835
8.7,"random_policy_SVM","SVM",26,26,1212,1207,5,2700,2291,409,0.927393353174585,0.59375,1.7774334251607,760,370,390,4,1.1,69.02,5.6,0,0,0,0,0,0,0.00574294786163714,4.03501737253066,0.593948673786601
8.7,"random_policy_SVM","SVM",26,27,1112,1107,5,2800,2391,409,0.92686484315947,0.59375,1.77906709558824,762,373,389,2,1,71.57,5.8,0,0,0,0,0,0,0.00413084698041948,2.60549145811946,0.450361728655624
8.7,"random_policy_SVM","SVM",26,28,1012,1008,4,2900,2490,410,0.926489866780029,0.59375,1.78070377184913,768,375,393,6,1,74.13,6.1,0,0,0,0,0,0,0.00484435950468587,2.79901748523862,0.504945373506451
8.7,"random_policy_SVM","SVM",26,29,912,909,3,3000,2589,411,0.925999740173831,0.583333333333333,1.7774334251607,775,381,394,7,1,76.69,6.3,0,0,0,0,0,0,0.00413564640138792,2.11182102036101,0.439554138972047
8.7,"random_policy_SVM","SVM",26,30,812,809,3,3100,2689,411,0.925704483182146,0.583333333333333,1.78070377184913,777,382,395,2,1,79.24,6.5,0,0,0,0,0,0,0.00339627337276658,1.50930662628375,0.359850183533928
8.7,"random_policy_SVM","SVM",26,31,712,710,2,3200,2788,412,0.925943641345411,0.583333333333333,1.79007589696412,778,382,396,1,1,81.8,6.8,0,0,0,0,0,0,0.00307895620462084,1.2456343354651,0.332969234785153
8.7,"random_policy_SVM","SVM",26,32,612,610,2,3300,2888,412,0.925952499055162,0.583333333333333,1.79007589696412,779,383,396,1,1,84.36,7,0,0,0,0,0,0,0.00279137142685173,1.0048821696883,0.304808724113038
8.7,"random_policy_SVM","SVM",26,33,512,510,2,3400,2988,412,0.925970214474664,0.583333333333333,1.7867883379247,780,383,397,1,1,86.91,7.3,0,0,0,0,0,0,0.00192849262227249,0.628439750772981,0.222345411188864
8.7,"random_policy_SVM","SVM",26,34,412,412,0,3500,3086,414,0.926244803476934,0.588541666666667,1.79007589696412,788,387,401,8,1,89.47,7.5,0,0,0,0,0,0,0.00196544657820101,0.611495746033194,0.238966486339437
8.7,"random_policy_SVM","SVM",26,35,312,312,0,3600,3186,414,0.926168036659096,0.583333333333333,1.79337557603687,787,388,399,-1,1,92.02,7.7,0,0,0,0,0,0,0.0014073504825311,0.36762204484132,0.169714004736618
8.7,"random_policy_SVM","SVM",26,36,212,212,0,3700,3286,414,0.926323046579731,0.583333333333333,1.78843060661765,792,389,403,5,1,94.58,7.9,0,0,0,0,0,0,0.000756834038483479,0.161838154385894,0.0965342468879581
8.7,"random_policy_SVM","SVM",26,37,112,112,0,3800,3386,414,0.926182799508681,0.578125,1.79337557603687,797,391,406,5,1,97.14,8.2,0,0,0,0,0,0,0.000459464488125293,0.0703183404346163,0.065457394753132
8.7,"random_policy_SVM","SVM",26,38,12,12,0,3900,3486,414,0.926101603835968,0.578125,1.79172421731123,798,391,407,1,1,99.69,8.4,0,0,0,0,0,0,0.000270992260603133,0.00406233160968141,0.00406233160968141
8.7,"random_policy_SVM","SVM",26,39,0,0,0,3912,3498,414,0.926135558390012,0.578125,1.7867883379247,798,391,407,0,1,100,8.4,0,0,0,0,0,0,0,0,0
8.7,"random_policy_SVM","SVM",27,0,3812,3405,407,100,86,14,0.855345124910353,0.432432432432432,1.71506289699838,37,14,23,0,1.6,2.56,6.1,0,0,0,0,0,0,0.364922117690811,482.172054330704,43.7506726299466
8.7,"random_policy_SVM","SVM",27,1,3712,3360,352,200,131,69,0.907940238375025,0.518918918918919,1.7426907570554,131,64,67,94,1,5.11,1.9,0,0,0,0,0,0,0.574623740232214,589.821977288737,63.5220701189794
8.7,"random_policy_SVM","SVM",27,2,3612,3318,294,300,173,127,0.901320066537462,0.589189189189189,1.69905442632715,204,100,104,73,1,7.67,1.4,0,0,0,0,0,0,0.65572847337499,477.073088787155,73.7487040650255
8.7,"random_policy_SVM","SVM",27,3,3512,3277,235,400,214,186,0.895038686343046,0.6,1.72163405355678,274,137,137,70,1,10.22,1.2,0,0,0,0,0,0,0.581504223031013,372.004954062416,70.8133850619468
8.7,"random_policy_SVM","SVM",27,4,3412,3232,180,500,259,241,0.88792558792561,0.610810810810811,1.66480513662834,353,176,177,79,1,12.78,1.1,0,0,0,0,0,0,0.328971946086887,257.530625597839,55.7782355376463
8.7,"random_policy_SVM","SVM",27,5,3312,3188,124,600,303,297,0.884707067315765,0.616216216216216,1.62287360890302,434,216,218,81,1,15.34,1,0,0,0,0,0,0,0.258408673604345,229.947513698792,39.1881188998255
8.7,"random_policy_SVM","SVM",27,6,3212,3115,97,700,376,324,0.869748348009213,0.637837837837838,1.58933782545148,481,238,243,47,1,17.89,1.2,0,0,0,0,0,0,0.153237402057327,200.621719674448,20.9180140219071
8.7,"random_policy_SVM","SVM",27,7,3112,3034,78,800,457,343,0.873450638668025,0.648648648648649,1.61315580286169,532,257,275,51,1.1,20.45,1.3,0,0,0,0,0,0,0.088927763515965,124.726033153454,10.8825101803745
8.7,"random_policy_SVM","SVM",27,8,3012,2952,60,900,539,361,0.872040532910092,0.654054054054054,1.59518635470797,578,277,301,46,1.1,23.01,1.5,0,0,0,0,0,0,0.0770017234558731,116.794690799341,9.86858385575019
8.7,"random_policy_SVM","SVM",27,9,2912,2857,55,1000,634,366,0.876194545759757,0.654054054054054,1.61761614148711,601,289,312,23,1.1,25.56,1.7,0,0,0,0,0,0,0.063202445899564,95.1580983800647,7.01517836512007
8.7,"random_policy_SVM","SVM",27,10,2812,2761,51,1100,730,370,0.884348436522353,0.648648648648649,1.61612662386143,618,295,323,17,1.1,28.12,2,0,0,0,0,0,0,0.0506696177099072,69.713513076819,5.481759951881
8.7,"random_policy_SVM","SVM",27,11,2712,2665,47,1200,826,374,0.892386344560267,0.637837837837838,1.62436659290385,633,303,330,15,1.1,30.67,2.2,0,0,0,0,0,0,0.043751660366583,57.3420112953194,5.03885778829003
8.7,"random_policy_SVM","SVM",27,12,2612,2572,40,1300,919,381,0.90808979504633,0.632432432432432,1.6714626391097,651,312,339,18,1.1,33.23,2.4,0,0,0,0,0,0,0.0514385763803094,61.6241410077677,6.01003813715603
8.7,"random_policy_SVM","SVM",27,13,2512,2476,36,1400,1015,385,0.91569582004366,0.637837837837838,1.70876330876331,666,323,343,15,1.1,35.79,2.6,0,0,0,0,0,0,0.0397819149960824,47.5211972481762,4.56530014734356
8.7,"random_policy_SVM","SVM",27,14,2412,2381,31,1500,1110,390,0.922218322218345,0.637837837837838,1.74108754568736,687,332,355,21,1.1,38.34,2.8,0,0,0,0,0,0,0.044453862014288,42.9182308294475,5.12499481514442
8.7,"random_policy_SVM","SVM",27,15,2312,2284,28,1600,1207,393,0.923735254170056,0.632432432432432,1.73470408997448,690,334,356,3,1.1,40.9,3.1,0,0,0,0,0,0,0.0337453873946478,32.9369116168023,3.81204697202176
8.7,"random_policy_SVM","SVM",27,16,2212,2190,22,1700,1301,399,0.928148702061766,0.637837837837838,1.76378627475402,707,341,366,17,1.1,43.46,3.3,0,0,0,0,0,0,0.0386497669555048,33.7388833242012,4.3679992611174
8.7,"random_policy_SVM","SVM",27,17,2112,2096,16,1800,1395,405,0.931145939841614,0.643243243243243,1.77353095030514,724,349,375,17,1.1,46.01,3.4,0,0,0,0,0,0,0.0375804728114904,32.086437082567,4.62625029746843
8.7,"random_policy_SVM","SVM",27,18,2012,1999,13,1900,1492,408,0.931557983731918,0.643243243243243,1.76539548723035,745,357,388,21,1.1,48.57,3.7,0,0,0,0,0,0,0.0279395016485431,26.705507852098,3.32213634407645
8.7,"random_policy_SVM","SVM",27,19,1912,1899,13,2000,1592,408,0.931567140262813,0.643243243243243,1.76701660338024,743,358,385,-2,1.1,51.12,3.9,0,0,0,0,0,0,0.0224483632865601,20.5829757166521,2.29779672800426
8.7,"random_policy_SVM","SVM",27,20,1812,1799,13,2100,1692,408,0.93139316617579,0.627027027027027,1.76216216216216,751,366,385,8,1.1,53.68,4.1,0,0,0,0,0,0,0.017375568827732,13.3588254179747,2.23319610110691
8.7,"random_policy_SVM","SVM",27,21,1712,1700,12,2200,1791,409,0.931344331344346,0.621621621621622,1.77189786471554,755,367,388,4,1.1,56.24,4.4,0,0,0,0,0,0,0.01254419937593,9.98800358425958,1.34187273350587
8.7,"random_policy_SVM","SVM",27,22,1612,1602,10,2300,1889,411,0.931661757748725,0.621621621621622,1.76377734287908,776,379,397,21,1,58.79,4.6,0,0,0,0,0,0,0.00992226137640504,7.21004045247668,1.18752355430258
8.7,"random_policy_SVM","SVM",27,23,1512,1504,8,2400,1987,413,0.931548827201014,0.621621621621622,1.76864069952305,777,381,396,1,1,61.35,4.8,0,0,0,0,0,0,0.00920381060373253,6.50774374317899,0.961894909344668
8.7,"random_policy_SVM","SVM",27,24,1412,1404,8,2500,2087,413,0.932055488577233,0.610810810810811,1.77189786471554,784,384,400,7,1,63.91,5.1,0,0,0,0,0,0,0.00701771770968229,4.75268572539604,0.852395103229493
8.7,"random_policy_SVM","SVM",27,25,1312,1305,7,2600,2186,414,0.931713644757131,0.610810810810811,1.77026778388324,791,386,405,7,1,66.46,5.3,0,0,0,0,0,0,0.00664524845702211,3.98981056706212,0.689538329112898
8.7,"random_policy_SVM","SVM",27,26,1212,1205,7,2700,2286,414,0.932839898057287,0.616216216216216,1.76701660338024,791,389,402,0,1,69.02,5.5,0,0,0,0,0,0,0.00535347569567807,3.16007548955872,0.62192717278496
8.7,"random_policy_SVM","SVM",27,27,1112,1108,4,2800,2383,417,0.933319089840825,0.616216216216216,1.76377734287908,802,394,408,11,1,71.57,5.7,0,0,0,0,0,0,0.00562396471622396,2.97037074372633,0.624968175627709
8.7,"random_policy_SVM","SVM",27,28,1012,1009,3,2900,2482,418,0.934146229798399,0.610810810810811,1.76701660338024,809,397,412,7,1,74.13,5.9,0,0,0,0,0,0,0.00444677820150857,2.17411263267963,0.501360554586265
8.7,"random_policy_SVM","SVM",27,29,912,909,3,3000,2582,418,0.934204221160738,0.610810810810811,1.76701660338024,808,397,411,-1,1,76.69,6.2,0,0,0,0,0,0,0.00383111970980854,1.72501637801366,0.414631479657294
8.7,"random_policy_SVM","SVM",27,30,812,809,3,3100,2682,418,0.934143177621433,0.610810810810811,1.76701660338024,809,397,412,1,1,79.24,6.4,0,0,0,0,0,0,0.00301901832072556,1.21678256886076,0.327768922006171
8.7,"random_policy_SVM","SVM",27,31,712,709,3,3200,2782,418,0.934138599355985,0.610810810810811,1.76539548723035,808,397,411,-1,1,81.8,6.7,0,0,0,0,0,0,0.00266815492755164,0.983182879666123,0.295756918419118
8.7,"random_policy_SVM","SVM",27,32,612,609,3,3300,2882,418,0.934260686434595,0.610810810810811,1.76864069952305,809,397,412,1,1,84.36,6.9,0,0,0,0,0,0,0.00188006811554851,0.6380318227427,0.220912354380939
8.7,"random_policy_SVM","SVM",27,33,512,509,3,3400,2982,418,0.934466708379747,0.610810810810811,1.76701660338024,811,399,412,2,1,86.91,7.1,0,0,0,0,0,0,0.00130425910857701,0.398106212839957,0.154414078001371
8.7,"random_policy_SVM","SVM",27,34,412,411,1,3500,3080,420,0.933703664138443,0.610810810810811,1.77026778388324,818,402,416,7,1,89.47,7.3,0,0,0,0,0,0,0.00159671588297461,0.480679231016196,0.202102208615016
8.7,"random_policy_SVM","SVM",27,35,312,312,0,3600,3179,421,0.933917316526008,0.605405405405405,1.76539548723035,828,406,422,10,1,92.02,7.6,0,0,0,0,0,0,0.00144574028042854,0.363133468608184,0.175765316075507
8.7,"random_policy_SVM","SVM",27,36,212,212,0,3700,3279,421,0.933775390297124,0.605405405405405,1.76864069952305,830,408,422,2,1,94.58,7.8,0,0,0,0,0,0,0.000695542923822745,0.147931728371863,0.0915171900346435
8.7,"random_policy_SVM","SVM",27,37,112,112,0,3800,3379,421,0.933746394615955,0.605405405405405,1.77353095030514,834,409,425,4,1,97.14,8,0,0,0,0,0,0,0.000320844443170506,0.0527339297529452,0.0491107542857445
8.7,"random_policy_SVM","SVM",27,38,12,12,0,3900,3479,421,0.933758603323816,0.605405405405405,1.77353095030514,835,409,426,1,1,99.69,8.3,0,0,0,0,0,0,0.00024286129629932,0.00329953853744027,0.00329953853744027
8.7,"random_policy_SVM","SVM",27,39,0,0,0,3912,3491,421,0.933709768492373,0.605405405405405,1.77353095030514,835,409,426,0,1,100,8.3,0,0,0,0,0,0,0,0,0
8.7,"random_policy_SVM","SVM",28,0,3812,3424,388,100,89,11,0.906384048303665,0.584541062801932,1.72438389100381,26,11,15,0,1.4,2.56,8.1,0,0,0,0,0,0,0.376779011708992,433.854934481663,42.1197810542578
8.7,"random_policy_SVM","SVM",28,1,3712,3383,329,200,130,70,0.922879326488856,0.594202898550725,1.76305413469736,100,50,50,74,1,5.11,1.9,0,0,0,0,0,0,0.816512749594653,474.415298471348,86.2079958250177
8.7,"random_policy_SVM","SVM",28,2,3612,3326,286,300,187,113,0.925743627138248,0.618357487922705,1.77663794830695,174,88,86,74,1,7.67,1.7,0,0,0,0,0,0,0.590039091076133,237.352482438435,71.0490657559879
8.7,"random_policy_SVM","SVM",28,3,3512,3288,224,400,225,175,0.910115649246085,0.628019323671498,1.72990413716785,248,123,125,74,1,10.22,1.3,0,0,0,0,0,0,0.470125584470419,209.857080010391,65.3791876845873
8.7,"random_policy_SVM","SVM",28,4,3412,3249,163,500,264,236,0.895740284993773,0.642512077294686,1.7109441602728,327,165,162,79,1,12.78,1.1,0,0,0,0,0,0,0.320867378326769,171.162737224494,48.2449490917981
8.7,"random_policy_SVM","SVM",28,5,3312,3187,125,600,326,274,0.885880958891631,0.652173913043478,1.63428129541485,404,202,202,77,1,15.34,1.2,0,0,0,0,0,0,0.156027920325485,112.470334720101,27.5582135253607
8.7,"random_policy_SVM","SVM",28,6,3212,3112,100,700,401,299,0.886828360167158,0.666666666666667,1.62858478594804,463,224,239,59,1.1,17.89,1.3,0,0,0,0,0,0,0.0952948067076949,81.775681728814,12.2150674668675
8.7,"random_policy_SVM","SVM",28,7,3112,3029,83,800,484,316,0.895451645246569,0.661835748792271,1.64600280504909,506,242,264,43,1.1,20.45,1.5,0,0,0,0,0,0,0.0803910580808286,85.9899137410521,9.55790125758315
8.7,"random_policy_SVM","SVM",28,8,3012,2940,72,900,573,327,0.897644754904811,0.666666666666667,1.64600280504909,530,253,277,24,1.1,23.01,1.8,0,0,0,0,0,0,0.0605936249363376,70.9465734361281,7.27566164511207
8.7,"random_policy_SVM","SVM",28,9,2912,2858,54,1000,655,345,0.894805313181022,0.671497584541063,1.63578615848613,574,276,298,44,1.1,25.56,1.9,0,0,0,0,0,0,0.0640846267532868,106.061676949341,9.05781105077811
8.7,"random_policy_SVM","SVM",28,10,2812,2766,46,1100,747,353,0.908259516134828,0.666666666666667,1.68083884325119,594,287,307,20,1.1,28.12,2.1,0,0,0,0,0,0,0.0536184465303232,80.2157850994056,5.95212465635282
8.7,"random_policy_SVM","SVM",28,11,2712,2670,42,1200,843,357,0.911535370107973,0.666666666666667,1.67774622348439,604,293,311,10,1.1,30.67,2.4,0,0,0,0,0,0,0.045582181681599,66.3259249998095,4.88474027831495
8.7,"random_policy_SVM","SVM",28,12,2612,2573,39,1300,940,360,0.918860466850636,0.666666666666667,1.6864392090983,617,299,318,13,1.1,33.23,2.6,0,0,0,0,0,0,0.0430590182545676,61.776297392729,4.76722071807594
8.7,"random_policy_SVM","SVM",28,13,2512,2477,35,1400,1036,364,0.926859516687247,0.657004830917874,1.72438389100381,640,308,332,23,1.1,35.79,2.8,0,0,0,0,0,0,0.0594033587769004,59.1768431429878,6.74800363085954
8.7,"random_policy_SVM","SVM",28,14,2412,2383,29,1500,1130,370,0.932912665070174,0.652173913043478,1.76305413469736,662,322,340,22,1.1,38.34,3.1,0,0,0,0,0,0,0.0596676673670972,53.2425069169332,6.52213583279946
8.7,"random_policy_SVM","SVM",28,15,2312,2286,26,1600,1227,373,0.933723342254927,0.657004830917874,1.75981917298232,676,327,349,14,1.1,40.9,3.3,0,0,0,0,0,0,0.0552919773649764,44.9359186220404,6.0513171496899
8.7,"random_policy_SVM","SVM",28,16,2212,2188,24,1700,1325,375,0.933655670735248,0.657004830917874,1.76305413469736,682,329,353,6,1.1,43.46,3.5,0,0,0,0,0,0,0.048005089851872,37.3431886311221,5.36065735354206
8.7,"random_policy_SVM","SVM",28,17,2112,2095,17,1800,1418,382,0.933317313136844,0.661835748792271,1.75598309400957,697,336,361,15,1.1,46.01,3.7,0,0,0,0,0,0,0.0441959130828225,36.2781583866691,5.59163369516098
8.7,"random_policy_SVM","SVM",28,18,2012,2000,12,1900,1513,387,0.932621263220123,0.661835748792271,1.75598309400957,715,343,372,18,1.1,48.57,3.9,0,0,0,0,0,0,0.034746662448614,29.7468227972594,4.11665336504904
8.7,"random_policy_SVM","SVM",28,19,1912,1900,12,2000,1613,387,0.932897473504537,0.661835748792271,1.75760002135212,715,342,373,0,1.1,51.12,4.2,0,0,0,0,0,0,0.0255934290309259,22.3001865105377,2.75509565027426
8.7,"random_policy_SVM","SVM",28,20,1812,1800,12,2100,1713,387,0.933140538554818,0.661835748792271,1.76143516854979,718,345,373,3,1.1,53.68,4.4,0,0,0,0,0,0,0.0195474955909876,17.5589466995183,2.15464780997961
8.7,"random_policy_SVM","SVM",28,21,1712,1700,12,2200,1813,387,0.933300740519779,0.661835748792271,1.76630101155684,721,345,376,3,1.1,56.24,4.7,0,0,0,0,0,0,0.0165994684692627,14.0034903242929,1.71201523226093
8.7,"random_policy_SVM","SVM",28,22,1612,1601,11,2300,1912,388,0.932137895222415,0.652173913043478,1.77878920961925,735,354,381,14,1.1,58.79,4.9,0,0,0,0,0,0,0.0116699569835198,9.00436675427634,1.48452338590799
8.7,"random_policy_SVM","SVM",28,23,1512,1501,11,2400,2012,388,0.932089558422643,0.652173913043478,1.78370299196626,735,354,381,0,1.1,61.35,5.2,0,0,0,0,0,0,0.00918046666473318,6.59963075147969,0.939288346677963
8.7,"random_policy_SVM","SVM",28,24,1412,1402,10,2500,2111,389,0.932905759813077,0.657004830917874,1.7755283678051,751,365,386,16,1.1,63.91,5.4,0,0,0,0,0,0,0.00569848013355164,3.55072940351332,0.718361504391936
8.7,"random_policy_SVM","SVM",28,25,1312,1304,8,2600,2209,391,0.933347696268139,0.657004830917874,1.78370299196626,758,368,390,7,1.1,66.46,5.6,0,0,0,0,0,0,0.00527942188651822,3.34946932347812,0.566490440054894
8.7,"random_policy_SVM","SVM",28,26,1212,1204,8,2700,2309,391,0.933554853981449,0.657004830917874,1.78534695785748,760,370,390,2,1.1,69.02,5.9,0,0,0,0,0,0,0.00451269176534496,2.59455631383782,0.47724339995635
8.7,"random_policy_SVM","SVM",28,27,1112,1105,7,2800,2408,392,0.93395673994527,0.657004830917874,1.78370299196626,767,374,393,7,1.1,71.57,6.1,0,0,0,0,0,0,0.00435390303431288,2.18446563023604,0.45591496714921
8.7,"random_policy_SVM","SVM",28,28,1012,1006,6,2900,2507,393,0.934129371373029,0.657004830917874,1.794055967408,770,377,393,3,1,74.13,6.4,0,0,0,0,0,0,0.00379053088373692,1.63784185379337,0.409026053831628
8.7,"random_policy_SVM","SVM",28,29,912,906,6,3000,2607,393,0.934264714412392,0.647342995169082,1.79075503646521,775,379,396,5,1,76.69,6.6,0,0,0,0,0,0,0.00310887079526935,1.20233528066182,0.342168187278399
8.7,"random_policy_SVM","SVM",28,30,812,807,5,3100,2706,394,0.934226044972576,0.647342995169082,1.794055967408,777,379,398,2,1.1,79.24,6.9,0,0,0,0,0,0,0.00237388865482031,0.799877756481049,0.264624377008939
8.7,"random_policy_SVM","SVM",28,31,712,708,4,3200,2805,395,0.93446220476575,0.652173913043478,1.78910912190963,782,383,399,5,1,81.8,7.1,0,0,0,0,0,0,0.00224152083457778,0.685727402169284,0.251569266545123
8.7,"random_policy_SVM","SVM",28,32,612,609,3,3300,2904,396,0.934680410890439,0.652173913043478,1.79240398217098,784,383,401,2,1,84.36,7.3,0,0,0,0,0,0,0.00165799634108698,0.497961889846825,0.210177089734762
8.7,"random_policy_SVM","SVM",28,33,512,510,2,3400,3003,397,0.934677648787596,0.647342995169082,1.79240398217098,787,385,402,3,1,86.91,7.6,0,0,0,0,0,0,0.00108208096898727,0.344640698081715,0.147238434486219
8.7,"random_policy_SVM","SVM",28,34,412,410,2,3500,3103,397,0.934803324467003,0.642512077294686,1.79075503646521,791,386,405,4,1,89.47,7.8,0,0,0,0,0,0,0.00062992780702066,0.176825196161249,0.0799287788473014
8.7,"random_policy_SVM","SVM",28,35,312,312,0,3600,3201,399,0.935272881950508,0.642512077294686,1.79240398217098,804,392,412,13,1.1,92.02,8,0,0,0,0,0,0,0.000626402947138306,0.154365244733432,0.0825486591288349
8.7,"random_policy_SVM","SVM",28,36,212,212,0,3700,3301,399,0.935355745035832,0.642512077294686,1.78582635287861,809,393,416,5,1.1,94.58,8.3,0,0,0,0,0,0,0.000254955259342545,0.0543447155019662,0.0353647985035353
8.7,"random_policy_SVM","SVM",28,37,112,112,0,3800,3401,399,0.935817016210803,0.647342995169082,1.794055967408,812,394,418,3,1.1,97.14,8.5,0,0,0,0,0,0,0.000129227138038334,0.0224349371841451,0.0211066472264975
8.7,"random_policy_SVM","SVM",28,38,12,12,0,3900,3501,399,0.936122228575081,0.642512077294686,1.78582635287861,812,395,417,0,1.1,99.69,8.8,0,0,0,0,0,0,6.06257172246843e-05,0.00101457538858486,0.00101457538858486
8.7,"random_policy_SVM","SVM",28,39,0,0,0,3912,3513,399,0.936210615866093,0.642512077294686,1.78582635287861,812,395,417,0,1.1,100,8.8,0,0,0,0,0,0,0,0,0
8.7,"random_policy_SVM","SVM",29,0,3812,3411,401,100,87,13,0.906131897203331,0.520833333333333,1.76520737327189,35,13,22,0,1.7,2.56,6.7,0,0,0,0,0,0,0.414230258737418,509.352499160239,45.7212500793063
8.7,"random_policy_SVM","SVM",29,1,3712,3365,347,200,133,67,0.901874291383225,0.572916666666667,1.70568389752973,120,58,62,85,1.1,5.11,2,0,0,0,0,0,0,0.684053056981475,580.385133283157,75.1026272972581
8.7,"random_policy_SVM","SVM",29,2,3612,3329,283,300,169,131,0.906357768801971,0.567708333333333,1.7509765625,191,92,99,71,1.1,7.67,1.3,0,0,0,0,0,0,0.710626004227229,511.857908305442,79.4620295916882
8.7,"random_policy_SVM","SVM",29,3,3512,3281,231,400,217,183,0.907495984504916,0.598958333333333,1.73384314627415,254,127,127,63,1,10.22,1.2,0,0,0,0,0,0,0.630984365741931,323.010368241671,75.8525840560582
8.7,"random_policy_SVM","SVM",29,4,3412,3233,179,500,265,235,0.889102950207855,0.625,1.63861443014706,337,167,170,83,1,12.78,1.1,0,0,0,0,0,0,0.402769500483652,335.508129773654,59.9637252154312
8.7,"random_policy_SVM","SVM",29,5,3312,3186,126,600,312,288,0.900510204081643,0.614583333333333,1.66823827046918,417,206,211,80,1,15.34,1.1,0,0,0,0,0,0,0.285272501632781,263.774015057908,44.7867920540121
8.7,"random_policy_SVM","SVM",29,6,3212,3112,100,700,386,314,0.874397675736966,0.635416666666667,1.59822247706422,473,232,241,56,1,17.89,1.2,0,0,0,0,0,0,0.161089601732859,247.153942072405,25.3115973948692
8.7,"random_policy_SVM","SVM",29,7,3112,3035,77,800,463,337,0.880042989417993,0.635416666666667,1.61839990817264,534,257,277,61,1.1,20.45,1.4,0,0,0,0,0,0,0.102075186902404,157.277296420237,14.6203020525428
8.7,"random_policy_SVM","SVM",29,8,3012,2942,70,900,556,344,0.898133385298562,0.630208333333333,1.6697744014733,555,269,286,21,1.1,23.01,1.6,0,0,0,0,0,0,0.0687449896950816,91.3440482123457,8.44447474133592
8.7,"random_policy_SVM","SVM",29,9,2912,2849,63,1000,649,351,0.896516853269086,0.630208333333333,1.66670496323529,574,277,297,19,1.1,25.56,1.8,0,0,0,0,0,0,0.0558506340641493,79.9998739650699,6.23724582508461
8.7,"random_policy_SVM","SVM",29,10,2812,2758,54,1100,740,360,0.893735532407415,0.630208333333333,1.67606847426471,601,287,314,27,1.1,28.12,2.1,0,0,0,0,0,0,0.056466613208771,72.5756861861023,6.45152686467838
8.7,"random_policy_SVM","SVM",29,11,2712,2659,53,1200,839,361,0.896288029100535,0.635416666666667,1.67452938475666,609,291,318,8,1.1,30.67,2.3,0,0,0,0,0,0,0.0406762132550882,53.438023538177,4.52046069604941
8.7,"random_policy_SVM","SVM",29,12,2612,2562,50,1300,936,364,0.901579034391533,0.635416666666667,1.68388429752066,615,296,319,6,1.1,33.23,2.6,0,0,0,0,0,0,0.0408996546191712,55.2885601694878,4.26595284198322
8.7,"random_policy_SVM","SVM",29,13,2512,2465,47,1400,1033,367,0.917891983182161,0.630208333333333,1.69948156682028,646,314,332,31,1.1,35.79,2.8,0,0,0,0,0,0,0.0358133367156458,30.6749981968435,4.54575651657104
8.7,"random_policy_SVM","SVM",29,14,2412,2369,43,1500,1129,371,0.919509991496597,0.630208333333333,1.70887096774194,651,319,332,5,1,38.34,3,0,0,0,0,0,0,0.0280629731631,28.3051143649664,3.15590413346981
8.7,"random_policy_SVM","SVM",29,15,2312,2277,35,1600,1221,379,0.925906734221471,0.630208333333333,1.73543968692449,676,328,348,25,1.1,40.9,3.2,0,0,0,0,0,0,0.0276919417102635,30.1128781958217,3.2494988893427
8.7,"random_policy_SVM","SVM",29,16,2212,2189,23,1700,1309,391,0.927123193027205,0.630208333333333,1.76034007352941,711,345,366,35,1.1,43.46,3.3,0,0,0,0,0,0,0.0637020000325542,44.7641299623061,7.66974125217817
8.7,"random_policy_SVM","SVM",29,17,2112,2089,23,1800,1409,391,0.926968183106569,0.635416666666667,1.75420119705341,719,350,369,8,1.1,46.01,3.6,0,0,0,0,0,0,0.0452347332140225,29.6873515323869,4.96601587643547
8.7,"random_policy_SVM","SVM",29,18,2012,1997,15,1900,1501,399,0.92741992630385,0.635416666666667,1.75872359963269,736,358,378,17,1.1,48.57,3.8,0,0,0,0,0,0,0.0493544153551462,26.4907053398302,5.61585784098173
8.7,"random_policy_SVM","SVM",29,19,1912,1902,10,2000,1596,404,0.927021329365074,0.635416666666667,1.76195952161914,752,363,389,16,1.1,51.12,4,0,0,0,0,0,0,0.0364959208968404,22.1428068525463,4.7319597406674
8.7,"random_policy_SVM","SVM",29,20,1812,1805,7,2100,1693,407,0.926616827286464,0.640625,1.76195952161914,761,367,394,9,1.1,53.68,4.2,0,0,0,0,0,0,0.022094736617492,18.0020547996633,2.88927728379864
8.7,"random_policy_SVM","SVM",29,21,1712,1706,6,2200,1792,408,0.927133527021917,0.640625,1.76034007352941,762,368,394,1,1.1,56.24,4.4,0,0,0,0,0,0,0.0160805136200686,14.2731684257754,1.80301545908184
8.7,"random_policy_SVM","SVM",29,22,1612,1607,5,2300,1891,409,0.927882003495841,0.635416666666667,1.75711009174312,768,370,398,6,1.1,58.79,4.6,0,0,0,0,0,0,0.0145259856730249,12.5319945209597,1.49148680511008
8.7,"random_policy_SVM","SVM",29,23,1512,1508,4,2400,1990,410,0.928598001700682,0.625,1.76195952161914,789,381,408,21,1.1,61.35,4.9,0,0,0,0,0,0,0.0109848377270019,8.65114531716628,1.32083876808891
8.7,"random_policy_SVM","SVM",29,24,1412,1408,4,2500,2090,410,0.928630479969767,0.625,1.76358195211786,786,380,406,-3,1.1,63.91,5.1,0,0,0,0,0,0,0.00936245537595834,6.96691801050094,0.965514084700613
8.7,"random_policy_SVM","SVM",29,25,1312,1308,4,2600,2190,410,0.928925736961453,0.619791666666667,1.75872359963269,791,384,407,5,1.1,66.46,5.3,0,0,0,0,0,0,0.0066998037014059,4.63069002372827,0.762535414039665
8.7,"random_policy_SVM","SVM",29,26,1212,1208,4,2700,2290,410,0.929092557161756,0.619791666666667,1.76034007352941,790,384,406,-1,1.1,69.02,5.6,0,0,0,0,0,0,0.00656780932741887,4.09384159533496,0.680014029642547
8.7,"random_policy_SVM","SVM",29,27,1112,1108,4,2800,2390,410,0.929070412887378,0.614583333333333,1.76195952161914,797,386,411,7,1.1,71.57,5.8,0,0,0,0,0,0,0.00552392988224501,3.04117914011978,0.594520733783498
8.7,"random_policy_SVM","SVM",29,28,1012,1009,3,2900,2489,411,0.929430626417234,0.619791666666667,1.7509765625,800,387,413,3,1.1,74.13,6.1,0,0,0,0,0,0,0.00471081390231059,2.36158902470982,0.491416922899479
8.7,"random_policy_SVM","SVM",29,29,912,909,3,3000,2589,411,0.929457199546489,0.619791666666667,1.75420119705341,805,389,416,5,1.1,76.69,6.3,0,0,0,0,0,0,0.00373730780255821,1.64389948207519,0.402866979028072
8.7,"random_policy_SVM","SVM",29,30,812,810,2,3100,2688,412,0.92953987150416,0.614583333333333,1.7509765625,807,391,416,2,1.1,79.24,6.5,0,0,0,0,0,0,0.00370623193876964,1.43840571350101,0.393328016708465
8.7,"random_policy_SVM","SVM",29,31,712,710,2,3200,2788,412,0.929731788548758,0.614583333333333,1.75258739650414,809,393,416,2,1.1,81.8,6.8,0,0,0,0,0,0,0.00276517686549064,0.919380969592332,0.30685032108839
8.7,"random_policy_SVM","SVM",29,32,612,610,2,3300,2888,412,0.929736217403634,0.614583333333333,1.75420119705341,809,393,416,0,1.1,84.36,7,0,0,0,0,0,0,0.00191831519094044,0.578176840877172,0.233466538669951
8.7,"random_policy_SVM","SVM",29,33,512,511,1,3400,2987,413,0.930034426965238,0.614583333333333,1.7509765625,808,394,414,-1,1.1,86.91,7.2,0,0,0,0,0,0,0.00128570875552457,0.42247595840147,0.17309696836855
8.7,"random_policy_SVM","SVM",29,34,412,412,0,3500,3086,414,0.93057769982994,0.614583333333333,1.7509765625,817,398,419,9,1.1,89.47,7.5,0,0,0,0,0,0,0.00108741546626504,0.332433375433228,0.133181186363512
8.7,"random_policy_SVM","SVM",29,35,312,312,0,3600,3186,414,0.931181500377939,0.604166666666667,1.75581797235023,824,399,425,7,1.1,92.02,7.7,0,0,0,0,0,0,0.00066128319625372,0.162061585357845,0.0785187253764509
8.7,"random_policy_SVM","SVM",29,36,212,212,0,3700,3286,414,0.931746917517021,0.604166666666667,1.75420119705341,827,402,425,3,1.1,94.58,7.9,0,0,0,0,0,0,0.000381538308374944,0.078447424326579,0.0496290276750354
8.7,"random_policy_SVM","SVM",29,37,112,112,0,3800,3386,414,0.931801540060481,0.598958333333333,1.75581797235023,826,403,423,-1,1,97.14,8.2,0,0,0,0,0,0,0.000174412155245605,0.0285626793200401,0.0266692857697335
8.7,"random_policy_SVM","SVM",29,38,12,12,0,3900,3486,414,0.932067271352998,0.598958333333333,1.75581797235023,827,404,423,1,1,99.69,8.4,0,0,0,0,0,0,0.0001171299128853,0.00157531267182496,0.00157531267182496
8.7,"random_policy_SVM","SVM",29,39,0,0,0,3912,3498,414,0.932020030234328,0.59375,1.74616177818515,827,404,423,0,1,100,8.4,0,0,0,0,0,0,0,0,0
8.7,"random_policy_SVM","SVM",30,0,3812,3413,399,100,89,11,0.895785018552878,0.510204081632653,1.76646059883808,30,11,19,0,1.7,2.56,8.1,0,0,0,0,0,0,0.556675881395441,413.890762576428,60.690153567206
8.7,"random_policy_SVM","SVM",30,1,3712,3383,329,200,119,81,0.906352910482375,0.510204081632653,1.79449541284404,100,51,49,70,1,5.11,1.5,0,0,0,0,0,0,0.629387791162532,349.753529117619,68.4598324782009
8.7,"random_policy_SVM","SVM",30,2,3612,3338,274,300,164,136,0.90431644248608,0.530612244897959,1.77517163547447,177,90,87,77,1,7.67,1.2,0,0,0,0,0,0,0.564270994379053,255.215599311938,67.6730590436519
8.7,"random_policy_SVM","SVM",30,3,3512,3297,215,400,205,195,0.889703153988879,0.576530612244898,1.72759048370729,254,130,124,77,1,10.22,1.1,0,0,0,0,0,0,0.368065605758253,152.862229549306,58.941531209005
8.7,"random_policy_SVM","SVM",30,4,3412,3254,158,500,248,252,0.858551716141001,0.586734693877551,1.64649544510747,330,166,164,76,1,12.78,1,0,0,0,0,0,0,0.207950835488834,118.216110643142,35.9795265960039
8.7,"random_policy_SVM","SVM",30,5,3312,3197,115,600,305,295,0.874402829313552,0.591836734693878,1.64337344873552,407,205,202,77,1,15.34,1,0,0,0,0,0,0,0.106303955717465,57.8118722272834,16.2958195223048
8.7,"random_policy_SVM","SVM",30,6,3212,3118,94,700,384,316,0.876411757884984,0.596938775510204,1.63720492805417,458,222,236,51,1.1,17.89,1.2,0,0,0,0,0,0,0.0642474996231787,40.9188199144963,8.99724369768671
8.7,"random_policy_SVM","SVM",30,7,3112,3035,77,800,467,333,0.875946486549173,0.602040816326531,1.62650806178825,495,241,254,37,1.1,20.45,1.4,0,0,0,0,0,0,0.0522490631506617,43.0432609493508,7.75410855817506
8.7,"random_policy_SVM","SVM",30,8,3012,2958,54,900,544,356,0.872909902597395,0.612244897959184,1.62800714755948,546,268,278,51,1,23.01,1.5,0,0,0,0,0,0,0.0559519940990244,67.6881317050508,7.27046760702185
8.7,"random_policy_SVM","SVM",30,9,2912,2869,43,1000,633,367,0.886663671150285,0.61734693877551,1.6356973728718,580,282,298,34,1.1,25.56,1.7,0,0,0,0,0,0,0.0463478194019404,63.3577590771966,5.53087781334372
8.7,"random_policy_SVM","SVM",30,10,2812,2775,37,1100,727,373,0.89635899814471,0.607142857142857,1.64337344873552,598,292,306,18,1,28.12,1.9,0,0,0,0,0,0,0.0446304612959629,64.0266542935429,5.49951974919637
8.7,"random_policy_SVM","SVM",30,11,2712,2685,27,1200,817,383,0.906574675324662,0.602040816326531,1.69845859226855,632,305,327,34,1.1,30.67,2.1,0,0,0,0,0,0,0.0627935995086387,67.1318143830916,7.37941529480824
8.7,"random_policy_SVM","SVM",30,12,2612,2586,26,1300,916,384,0.907377666975873,0.602040816326531,1.6968975090036,647,313,334,15,1.1,33.23,2.4,0,0,0,0,0,0,0.0495533112878149,47.1212412386186,5.5605361779011
8.7,"random_policy_SVM","SVM",30,13,2512,2488,24,1400,1014,386,0.909818529684595,0.602040816326531,1.71840117262375,655,318,337,8,1.1,35.79,2.6,0,0,0,0,0,0,0.043686447047487,39.1106695272628,4.87673548464168
8.7,"random_policy_SVM","SVM",30,14,2412,2391,21,1500,1111,389,0.909461966604816,0.607142857142857,1.72600116403507,667,321,346,12,1.1,38.34,2.9,0,0,0,0,0,0,0.0385634783206946,32.6519543543628,4.77163660056572
8.7,"random_policy_SVM","SVM",30,15,2312,2298,14,1600,1204,396,0.910485273654911,0.602040816326531,1.73838051349572,680,331,349,13,1.1,40.9,3,0,0,0,0,0,0,0.0348409528834574,30.1975373309839,4.32625253713389
8.7,"random_policy_SVM","SVM",30,16,2212,2205,7,1700,1297,403,0.910554846938768,0.596938775510204,1.72283128127284,701,337,364,21,1.1,43.46,3.2,0,0,0,0,0,0,0.0279512769087723,27.8584628553383,3.40058263317228
8.7,"random_policy_SVM","SVM",30,17,2112,2106,6,1800,1396,404,0.910125811688304,0.596938775510204,1.72283128127284,705,341,364,4,1.1,46.01,3.5,0,0,0,0,0,0,0.0217474363970704,21.78982670663,2.390055519122
8.7,"random_policy_SVM","SVM",30,18,2012,2006,6,1900,1496,404,0.909825776901663,0.596938775510204,1.72441476590636,705,341,364,0,1.1,48.57,3.7,0,0,0,0,0,0,0.0170538025553677,17.1028468374133,1.85669182537868
8.7,"random_policy_SVM","SVM",30,19,1912,1907,5,2000,1595,405,0.909902597402593,0.612244897959184,1.72723704866562,713,344,369,8,1.1,51.12,3.9,0,0,0,0,0,0,0.0147900601183646,14.7658874456092,1.59466968829646
8.7,"random_policy_SVM","SVM",30,20,1812,1807,5,2100,1695,405,0.910021451762521,0.607142857142857,1.74275960384154,715,346,369,2,1.1,53.68,4.2,0,0,0,0,0,0,0.0110712039590464,10.0044601211516,1.16498643435644
8.7,"random_policy_SVM","SVM",30,21,1712,1707,5,2200,1795,405,0.911304209183666,0.596938775510204,1.76434772804149,726,357,369,11,1,56.24,4.4,0,0,0,0,0,0,0.00675236620993792,5.47620092982119,0.892923483683557
8.7,"random_policy_SVM","SVM",30,22,1612,1607,5,2300,1895,405,0.911353490259732,0.596938775510204,1.76434772804149,726,357,369,0,1,58.79,4.7,0,0,0,0,0,0,0.00624390677240405,4.94234083094608,0.644111995784674
8.7,"random_policy_SVM","SVM",30,23,1512,1507,5,2400,1995,405,0.913408801020397,0.596938775510204,1.76434772804149,740,363,377,14,1,61.35,4.9,0,0,0,0,0,0,0.00477375862131293,3.51043424949802,0.590816166096048
8.7,"random_policy_SVM","SVM",30,24,1412,1407,5,2500,2095,405,0.913413149350638,0.596938775510204,1.76434772804149,735,361,374,-5,1,63.91,5.2,0,0,0,0,0,0,0.00396152765337791,2.72618390527547,0.406345205481279
8.7,"random_policy_SVM","SVM",30,25,1312,1307,5,2600,2195,405,0.913730577458246,0.596938775510204,1.76434772804149,748,369,379,13,1,66.46,5.4,0,0,0,0,0,0,0.00320660318430189,2.14966629910986,0.376589233886811
8.7,"random_policy_SVM","SVM",30,26,1212,1207,5,2700,2295,405,0.913908858998135,0.596938775510204,1.76272459305709,749,369,380,1,1,69.02,5.7,0,0,0,0,0,0,0.00265305429048401,1.54304791475705,0.272240467117148
8.7,"random_policy_SVM","SVM",30,27,1112,1107,5,2800,2395,405,0.914369782003705,0.591836734693878,1.76597385497978,755,372,383,6,1,71.57,5.9,0,0,0,0,0,0,0.00231639358400799,1.27402266928224,0.257969679282002
8.7,"random_policy_SVM","SVM",30,28,1012,1007,5,2900,2495,405,0.914384276437842,0.591836734693878,1.75787305747987,755,372,383,0,1,74.13,6.2,0,0,0,0,0,0,0.00165354795138616,0.781712665905064,0.172924048117076
8.7,"random_policy_SVM","SVM",30,29,912,908,4,3000,2594,406,0.915420628478659,0.591836734693878,1.75787305747987,758,374,384,3,1,76.69,6.4,0,0,0,0,0,0,0.00165191585321409,0.687584388772893,0.1782276693557
8.7,"random_policy_SVM","SVM",30,30,812,809,3,3100,2693,407,0.915380044063075,0.591836734693878,1.76110444177671,764,375,389,6,1,79.24,6.6,0,0,0,0,0,0,0.00162798804940656,0.641684143205832,0.180056895780275
8.7,"random_policy_SVM","SVM",30,31,712,709,3,3200,2793,407,0.915584415584411,0.586734693877551,1.75787305747987,765,375,390,1,1,81.8,6.9,0,0,0,0,0,0,0.00122870283265069,0.438100854221005,0.138440407688929
8.7,"random_policy_SVM","SVM",30,32,612,609,3,3300,2893,407,0.915572820037101,0.586734693877551,1.75948726598077,765,375,390,0,1,84.36,7.1,0,0,0,0,0,0,0.000951666089470651,0.30660594404235,0.110292836889548
8.7,"random_policy_SVM","SVM",30,33,512,509,3,3400,2993,407,0.915810528756952,0.586734693877551,1.76272459305709,767,376,391,2,1,86.91,7.4,0,0,0,0,0,0,0.000588780696089817,0.175702200060838,0.0726335755156304
8.7,"random_policy_SVM","SVM",30,34,412,411,1,3500,3091,409,0.916071428571423,0.586734693877551,1.78108630756811,777,380,397,10,1,89.47,7.6,0,0,0,0,0,0,0.000595256121323729,0.181445508515446,0.0757106516480191
8.7,"random_policy_SVM","SVM",30,35,312,312,0,3600,3190,410,0.916333777829307,0.586734693877551,1.77944927971188,784,382,402,7,1.1,92.02,7.8,0,0,0,0,0,0,0.000537123223236626,0.136344062207897,0.0647598448806356
8.7,"random_policy_SVM","SVM",30,36,212,212,0,3700,3290,410,0.916555542671608,0.586734693877551,1.78272635020859,787,385,402,3,1,94.58,8,0,0,0,0,0,0,0.000325646844092394,0.0700585508276036,0.0426996919662775
8.7,"random_policy_SVM","SVM",30,37,112,112,0,3800,3390,410,0.916570037105747,0.581632653061224,1.78436941596915,788,388,400,1,1,97.14,8.3,0,0,0,0,0,0,0.000166978047255248,0.0251715495002315,0.023371717929762
8.7,"random_policy_SVM","SVM",30,38,12,12,0,3900,3490,410,0.916684543135433,0.581632653061224,1.78272635020859,791,389,402,3,1,99.69,8.5,0,0,0,0,0,0,0.000120634790221941,0.00161752653488874,0.00161752653488874
8.7,"random_policy_SVM","SVM",30,39,0,0,0,3912,3502,410,0.916790352504635,0.581632653061224,1.78108630756811,792,389,403,1,1,100,8.5,0,0,0,0,0,0,0,0,0
8.7,"random_policy_SVM","SVM",31,0,3812,3393,419,100,93,7,0.90400400400401,0.572222222222222,1.74267281105991,20,7,13,0,1.9,2.56,13.3,0,0,0,0,0,0,0.237837734096459,282.155498849517,26.4060794932687
8.7,"random_policy_SVM","SVM",31,1,3712,3358,354,200,128,72,0.923124687187188,0.533333333333333,1.79109883364027,91,45,46,71,1,5.11,1.8,0,0,0,0,0,0,0.791340224251517,413.968973143107,84.2860510736464
8.7,"random_policy_SVM","SVM",31,2,3612,3308,304,300,178,122,0.90185341591593,0.583333333333333,1.7578431372549,165,83,82,74,1,7.67,1.5,0,0,0,0,0,0,0.647011290788761,282.761735417297,75.7840185619014
8.7,"random_policy_SVM","SVM",31,3,3512,3269,243,400,217,183,0.893046171171177,0.605555555555556,1.7326574500768,239,121,118,74,1,10.22,1.2,0,0,0,0,0,0,0.473024920092131,231.1401372595,65.6762639745601
8.7,"random_policy_SVM","SVM",31,4,3412,3224,188,500,262,238,0.907523148148157,0.6,1.73946642134315,313,158,155,74,1,12.78,1.1,0,0,0,0,0,0,0.293884500143985,126.349890034026,49.9587371614226
8.7,"random_policy_SVM","SVM",31,5,3312,3164,148,600,322,278,0.883893268268268,0.605555555555556,1.64251920122888,385,190,195,72,1,15.34,1.2,0,0,0,0,0,0,0.104957494630547,68.8479536180269,20.3829188822956
8.7,"random_policy_SVM","SVM",31,6,3212,3104,108,700,382,318,0.874418168168161,0.6,1.59364497402994,456,222,234,71,1.1,17.89,1.2,0,0,0,0,0,0,0.0954659543474459,85.3835923102968,12.7930119604544
8.7,"random_policy_SVM","SVM",31,7,3112,3032,80,800,454,346,0.863266391391398,0.627777777777778,1.56239631336406,525,255,270,69,1.1,20.45,1.3,0,0,0,0,0,0,0.111831605275659,153.247321739892,18.8196235040506
8.7,"random_policy_SVM","SVM",31,8,3012,2942,70,900,544,356,0.88018018018018,0.633333333333333,1.61247311827957,560,271,289,35,1.1,23.01,1.5,0,0,0,0,0,0,0.0734057264556227,103.925115310168,8.86506980433407
8.7,"random_policy_SVM","SVM",31,9,2912,2851,61,1000,635,365,0.891427364864874,0.638888888888889,1.64100675260896,575,280,295,15,1.1,25.56,1.7,0,0,0,0,0,0,0.0612838890451099,86.9737087829276,8.14346074362988
8.7,"random_policy_SVM","SVM",31,10,2812,2758,54,1100,728,372,0.910865553053063,0.633333333333333,1.68792892156863,603,292,311,28,1.1,28.12,2,0,0,0,0,0,0,0.0544498111156936,70.5375763471901,6.42006768306625
8.7,"random_policy_SVM","SVM",31,11,2712,2668,44,1200,818,382,0.922791541541541,0.633333333333333,1.73106200122775,632,302,330,29,1.1,30.67,2.1,0,0,0,0,0,0,0.0524017149259948,75.9860714741695,5.97552921454095
8.7,"random_policy_SVM","SVM",31,12,2612,2572,40,1300,914,386,0.93223223223225,0.633333333333333,1.74785539215686,648,316,332,16,1.1,33.23,2.4,0,0,0,0,0,0,0.0427777581583727,53.6445454193903,4.89115820538263
8.7,"random_policy_SVM","SVM",31,13,2512,2476,36,1400,1010,390,0.933162850350366,0.633333333333333,1.75107427869859,665,323,342,17,1.1,35.79,2.6,0,0,0,0,0,0,0.0500849451599611,54.2001534763188,5.88486837255495
8.7,"random_policy_SVM","SVM",31,14,2412,2377,35,1500,1109,391,0.935435435435458,0.633333333333333,1.76270353302611,674,330,344,9,1,38.34,2.8,0,0,0,0,0,0,0.0389712539851598,42.193065353685,4.38968168368284
8.7,"random_policy_SVM","SVM",31,15,2312,2279,33,1600,1207,393,0.935942192192218,0.633333333333333,1.76270353302611,680,333,347,6,1,40.9,3.1,0,0,0,0,0,0,0.0353400905005746,35.7756270270173,3.92053614689869
8.7,"random_policy_SVM","SVM",31,16,2212,2181,31,1700,1305,395,0.93670545545548,0.638888888888889,1.77271889400922,688,333,355,8,1.1,43.46,3.3,0,0,0,0,0,0,0.0324830874978459,30.9867225341121,3.68741059693062
8.7,"random_policy_SVM","SVM",31,17,2112,2088,24,1800,1398,402,0.933852602602623,0.644444444444444,1.74946335479914,699,341,358,11,1,46.01,3.5,0,0,0,0,0,0,0.0357463636707009,32.3555132572724,4.77088308437347
8.7,"random_policy_SVM","SVM",31,18,2012,1996,16,1900,1490,410,0.933336461461478,0.633333333333333,1.74304919034525,728,351,377,29,1.1,48.57,3.6,0,0,0,0,0,0,0.0287316903691718,27.1197163339606,3.62038096185356
8.7,"random_policy_SVM","SVM",31,19,1912,1899,13,2000,1587,413,0.933485047547564,0.633333333333333,1.74785539215686,741,354,387,13,1.1,51.12,3.8,0,0,0,0,0,0,0.0227327714411509,22.3153702245028,2.54227430335033
8.7,"random_policy_SVM","SVM",31,20,1812,1799,13,2100,1687,413,0.933474099099116,0.633333333333333,1.74625038261402,741,354,387,0,1.1,53.68,4.1,0,0,0,0,0,0,0.022444371012948,20.4294045729549,2.26390037646332
8.7,"random_policy_SVM","SVM",31,21,1712,1699,13,2200,1787,413,0.93508508508509,0.616666666666667,1.78273425499232,760,371,389,19,1,56.24,4.3,0,0,0,0,0,0,0.0148079629685315,9.26005150627874,1.94717146094589
8.7,"random_policy_SVM","SVM",31,22,1612,1603,9,2300,1883,417,0.935280593093098,0.616666666666667,1.78109269490485,773,379,394,13,1,58.79,4.5,0,0,0,0,0,0,0.00939610194328907,7.37318144142589,1.18046425663406
8.7,"random_policy_SVM","SVM",31,23,1512,1504,8,2400,1982,418,0.935332207207212,0.627777777777778,1.77781862745098,774,380,394,1,1,61.35,4.7,0,0,0,0,0,0,0.00866248737189894,7.07134193534771,0.938423836342651
8.7,"random_policy_SVM","SVM",31,24,1412,1404,8,2500,2082,418,0.935513638638644,0.627777777777778,1.78109269490485,778,381,397,4,1,63.91,5,0,0,0,0,0,0,0.00795627575933867,5.88259054029863,0.823093613911461
8.7,"random_policy_SVM","SVM",31,25,1312,1304,8,2600,2182,418,0.935582457457464,0.616666666666667,1.78273425499232,791,384,407,13,1.1,66.46,5.2,0,0,0,0,0,0,0.00584583618369444,3.93619936467622,0.653180629119022
8.7,"random_policy_SVM","SVM",31,26,1212,1204,8,2700,2282,418,0.935576201201207,0.616666666666667,1.77455657492355,792,385,407,1,1.1,69.02,5.5,0,0,0,0,0,0,0.00563233939927636,3.30389402625617,0.577454120808383
8.7,"random_policy_SVM","SVM",31,27,1112,1105,7,2800,2381,419,0.936067317317321,0.611111111111111,1.77781862745098,798,389,409,6,1.1,71.57,5.7,0,0,0,0,0,0,0.00474923928693368,2.57239348610078,0.526184714471222
8.7,"random_policy_SVM","SVM",31,28,1012,1007,5,2900,2479,421,0.936021959459463,0.611111111111111,1.77781862745098,803,392,411,5,1,74.13,5.9,0,0,0,0,0,0,0.00473634690781897,2.34639352365825,0.50864449260418
8.7,"random_policy_SVM","SVM",31,29,912,907,5,3000,2579,421,0.936286286286291,0.611111111111111,1.77455657492355,808,395,413,5,1,76.69,6.1,0,0,0,0,0,0,0.00376858192312089,1.67711888365687,0.413142994257149
8.7,"random_policy_SVM","SVM",31,30,812,807,5,3100,2679,421,0.936427052052057,0.616666666666667,1.77945415516713,809,396,413,1,1,79.24,6.4,0,0,0,0,0,0,0.00299020574269721,1.17594751843028,0.323938963517902
8.7,"random_policy_SVM","SVM",31,31,712,708,4,3200,2778,422,0.936464589589596,0.616666666666667,1.78109269490485,812,397,415,3,1,81.8,6.6,0,0,0,0,0,0,0.00277939307256736,0.972953906631387,0.302869959597727
8.7,"random_policy_SVM","SVM",31,32,612,609,3,3300,2877,423,0.936655405405412,0.616666666666667,1.77781862745098,820,400,420,8,1.1,84.36,6.8,0,0,0,0,0,0,0.00207640818535078,0.683093932778581,0.240676903875947
8.7,"random_policy_SVM","SVM",31,33,512,510,2,3400,2976,424,0.936796171171178,0.622222222222222,1.77945415516713,821,401,420,1,1,86.91,7,0,0,0,0,0,0,0.00161923015747228,0.563791410260084,0.203728451561803
8.7,"random_policy_SVM","SVM",31,34,412,412,0,3500,3074,426,0.937043293293302,0.622222222222222,1.77781862745098,827,404,423,6,1,89.47,7.2,0,0,0,0,0,0,0.00188676234937214,0.587568354309511,0.226710260174896
8.7,"random_policy_SVM","SVM",31,35,312,312,0,3600,3174,426,0.937415540540551,0.616666666666667,1.78109269490485,831,409,422,4,1,92.02,7.5,0,0,0,0,0,0,0.00121737122133569,0.302965333307431,0.140827872743004
8.7,"random_policy_SVM","SVM",31,36,212,212,0,3700,3274,426,0.937853478478492,0.616666666666667,1.78109269490485,837,411,426,6,1,94.58,7.7,0,0,0,0,0,0,0.000845986834670554,0.170057966553758,0.10550277528667
8.7,"random_policy_SVM","SVM",31,37,112,112,0,3800,3374,426,0.938228853853874,0.616666666666667,1.78273425499232,839,412,427,2,1,97.14,7.9,0,0,0,0,0,0,0.000390889520259718,0.0621499422772565,0.0579584154476925
8.7,"random_policy_SVM","SVM",31,38,12,12,0,3900,3474,426,0.938582332332352,0.616666666666667,1.77945415516713,841,413,428,2,1,99.69,8.2,0,0,0,0,0,0,0.000227779916477379,0.00309281794789307,0.00309281794789307
8.7,"random_policy_SVM","SVM",31,39,0,0,0,3912,3486,426,0.938652715215235,0.616666666666667,1.77781862745098,842,414,428,1,1,100,8.2,0,0,0,0,0,0,0,0,0
8.7,"random_policy_SVM","SVM",32,0,3812,3432,380,100,94,6,0.189717741935484,0,0.221248428990364,23,6,17,0,2.8,2.56,15.7,0,0,0,0,0,0,0.0665416712521658,237.620195604712,6.69775328286609
8.7,"random_policy_SVM","SVM",32,1,3712,3355,357,200,171,29,0.897727272727263,0.536363636363636,1.76017076845806,62,29,33,39,1.1,5.11,5.9,0,0,0,0,0,0,0.764592251132572,429.182428544905,82.3283522276158
8.7,"random_policy_SVM","SVM",32,2,3612,3321,291,300,205,95,0.906860075408461,0.563636363636364,1.75855147612277,132,66,66,70,1,7.67,2.2,0,0,0,0,0,0,0.627295780693881,299.896850530594,74.0018409608727
8.7,"random_policy_SVM","SVM",32,3,3512,3280,232,400,246,154,0.906200251361545,0.586363636363636,1.75198392767454,209,105,104,77,1,10.22,1.6,0,0,0,0,0,0,0.47964472329126,251.229285896074,63.8374484211528
8.7,"random_policy_SVM","SVM",32,4,3412,3237,175,500,289,211,0.901785714285708,0.586363636363636,1.73241978609626,285,145,140,76,1,12.78,1.4,0,0,0,0,0,0,0.336306600705674,182.094568120528,48.8963616761269
8.7,"random_policy_SVM","SVM",32,5,3312,3181,131,600,345,255,0.890073837452872,0.618181818181818,1.73082895066366,372,187,185,87,1,15.34,1.4,0,0,0,0,0,0,0.234848630277517,143.08563202916,32.0478894825381
8.7,"random_policy_SVM","SVM",32,6,3212,3099,113,700,427,273,0.895145580226238,0.609090909090909,1.7290155006284,418,206,212,46,1,17.89,1.6,0,0,0,0,0,0,0.0944678983153362,58.0334325208896,13.7291750049009
8.7,"random_policy_SVM","SVM",32,7,3112,3020,92,800,506,294,0.902672025555096,0.631818181818182,1.72742340532396,463,226,237,45,1,20.45,1.7,0,0,0,0,0,0,0.069767784644503,49.1310059721849,8.59369082487012
8.7,"random_policy_SVM","SVM",32,8,3012,2940,72,900,586,314,0.894894218684548,0.636363636363636,1.69000751314801,508,246,262,45,1.1,23.01,1.9,0,0,0,0,0,0,0.0712489833263352,82.7135667104842,9.6677936460015
8.7,"random_policy_SVM","SVM",32,9,2912,2855,57,1000,671,329,0.876868192291572,0.659090909090909,1.59643395278754,542,262,280,34,1.1,25.56,2,0,0,0,0,0,0,0.0627428330002341,86.1132653421609,8.66230986834479
8.7,"random_policy_SVM","SVM",32,10,2812,2763,49,1100,763,337,0.883119501466283,0.654545454545455,1.62099447513812,575,277,298,33,1.1,28.12,2.3,0,0,0,0,0,0,0.0607176609764948,79.6795658200157,6.95859636560208
8.7,"random_policy_SVM","SVM",32,11,2712,2669,43,1200,857,343,0.891922392124003,0.65,1.64404114744501,593,287,306,18,1.1,30.67,2.5,0,0,0,0,0,0,0.0511297751681073,66.8530534519592,5.80723536368164
8.7,"random_policy_SVM","SVM",32,12,2612,2576,36,1300,950,350,0.898408043569329,0.65,1.66346041055718,606,296,310,13,1,33.23,2.7,0,0,0,0,0,0,0.0437829710445483,57.3450619908753,5.19507768781596
8.7,"random_policy_SVM","SVM",32,13,2512,2484,28,1400,1042,358,0.906899350649342,0.65,1.6752172459893,642,309,333,36,1.1,35.79,2.9,0,0,0,0,0,0,0.0437514411086892,56.4289315673518,5.1879296065044
8.7,"random_policy_SVM","SVM",32,14,2412,2391,21,1500,1135,365,0.915194281524914,0.65,1.68493769340135,664,318,346,22,1.1,38.34,3.1,0,0,0,0,0,0,0.0479808234316842,51.5075501441242,5.57484033469516
8.7,"random_policy_SVM","SVM",32,15,2312,2295,17,1600,1231,369,0.917883326351065,0.65,1.7208211143695,671,320,351,7,1.1,40.9,3.3,0,0,0,0,0,0,0.049645009481729,43.748251444451,5.86085500893862
8.7,"random_policy_SVM","SVM",32,16,2212,2199,13,1700,1327,373,0.918380812735646,0.65,1.7290155006284,684,325,359,13,1.1,43.46,3.6,0,0,0,0,0,0,0.040743676916096,37.5181256889894,4.85994472311309
8.7,"random_policy_SVM","SVM",32,17,2112,2102,10,1800,1424,376,0.918659666945954,0.65,1.72742340532396,689,330,359,5,1.1,46.01,3.8,0,0,0,0,0,0,0.0341132539917438,34.5638265191036,4.02859564773018
8.7,"random_policy_SVM","SVM",32,18,2012,2004,8,1900,1522,378,0.919539432341847,0.654545454545455,1.72742340532396,702,335,367,13,1.1,48.57,4,0,0,0,0,0,0,0.0278769511917361,28.1108372839248,2.97445276669313
8.7,"random_policy_SVM","SVM",32,19,1912,1905,7,2000,1621,379,0.921041055718468,0.65,1.73241978609626,716,345,371,14,1.1,51.12,4.3,0,0,0,0,0,0,0.0208441286180645,19.1340236563207,2.53765349102004
8.7,"random_policy_SVM","SVM",32,20,1812,1805,7,2100,1721,379,0.920779220779212,0.65,1.73720988688731,714,344,370,-2,1.1,53.68,4.5,0,0,0,0,0,0,0.0181421698439454,15.5604160041577,1.831064370217
8.7,"random_policy_SVM","SVM",32,21,1712,1705,7,2200,1821,379,0.920200565563459,0.640909090909091,1.75210399133406,731,356,375,17,1.1,56.24,4.8,0,0,0,0,0,0,0.0118379448285636,8.18044993441783,1.52595538550032
8.7,"random_policy_SVM","SVM",32,22,1612,1607,5,2300,1919,381,0.920301372015072,0.640909090909091,1.75693516042781,736,359,377,5,1.1,58.79,5,0,0,0,0,0,0,0.0078247415116957,6.1954039220741,0.918288431838023
8.7,"random_policy_SVM","SVM",32,23,1512,1508,4,2400,2018,382,0.920169145370749,0.640909090909091,1.75855147612277,736,359,377,0,1.1,61.35,5.3,0,0,0,0,0,0,0.00873902093870339,6.10128198035606,0.894952791480726
8.7,"random_policy_SVM","SVM",32,24,1412,1408,4,2500,2118,382,0.921245286971093,0.631818181818182,1.75210399133406,751,365,386,15,1.1,63.91,5.5,0,0,0,0,0,0,0.00708112660488083,4.67327770062008,0.85552351278756
8.7,"random_policy_SVM","SVM",32,25,1312,1308,4,2600,2218,382,0.921419407205697,0.636363636363636,1.76017076845806,752,365,387,1,1.1,66.46,5.8,0,0,0,0,0,0,0.0052931619443196,3.24143799362099,0.555547791018848
8.7,"random_policy_SVM","SVM",32,26,1212,1208,4,2700,2318,382,0.921208630079601,0.636363636363636,1.76179304566401,752,366,386,0,1.1,69.02,6.1,0,0,0,0,0,0,0.00484103247825082,2.69159852901291,0.503945445551035
8.7,"random_policy_SVM","SVM",32,27,1112,1109,3,2800,2417,383,0.921744082530382,0.631818181818182,1.76510695187166,759,369,390,7,1.1,71.57,6.3,0,0,0,0,0,0,0.00406296457975938,2.04691902977591,0.429669349892855
8.7,"random_policy_SVM","SVM",32,28,1012,1009,3,2900,2517,383,0.921779430247185,0.631818181818182,1.76673078531404,760,371,389,1,1,74.13,6.6,0,0,0,0,0,0,0.00372641413115175,1.67171171607547,0.394577253625711
8.7,"random_policy_SVM","SVM",32,29,912,909,3,3000,2617,383,0.922030791788868,0.627272727272727,1.76673078531404,763,371,392,3,1.1,76.69,6.8,0,0,0,0,0,0,0.00296272251402044,1.17518360334758,0.320207822378741
8.7,"random_policy_SVM","SVM",32,30,812,809,3,3100,2717,383,0.922140762463355,0.627272727272727,1.76348610067618,761,371,390,-2,1.1,79.24,7.1,0,0,0,0,0,0,0.00223016679997429,0.787004598765174,0.245780809848616
8.7,"random_policy_SVM","SVM",32,31,712,709,3,3200,2817,383,0.922314882697959,0.631818181818182,1.76510695187166,762,372,390,1,1,81.8,7.4,0,0,0,0,0,0,0.00160600461544297,0.496542348727507,0.181178737318685
8.7,"random_policy_SVM","SVM",32,32,612,609,3,3300,2917,383,0.922347612065366,0.631818181818182,1.76835760924159,761,372,389,-1,1,84.36,7.6,0,0,0,0,0,0,0.00125474895586956,0.353699187520998,0.151015615351502
8.7,"random_policy_SVM","SVM",32,33,512,509,3,3400,3017,383,0.922626466275671,0.631818181818182,1.76835760924159,764,372,392,3,1.1,86.91,7.9,0,0,0,0,0,0,0.000714974896835815,0.202801500332804,0.0946175132202255
8.7,"random_policy_SVM","SVM",32,34,412,409,3,3500,3117,383,0.923160609551748,0.627272727272727,1.76835760924159,764,373,391,0,1,89.47,8.1,0,0,0,0,0,0,0.000367518778998333,0.104335438638214,0.0521332020908437
8.7,"random_policy_SVM","SVM",32,35,312,312,0,3600,3214,386,0.924744710934231,0.627272727272727,1.76510695187166,774,380,394,10,1,92.02,8.3,0,0,0,0,0,0,0.000528065100245927,0.132504541092545,0.0698132367323395
8.7,"random_policy_SVM","SVM",32,36,212,212,0,3700,3314,386,0.925000000000003,0.631818181818182,1.76673078531404,774,380,394,0,1,94.58,8.6,0,0,0,0,0,0,0.000252872396131318,0.0546256850036029,0.0348847750232614
8.7,"random_policy_SVM","SVM",32,37,112,112,0,3800,3414,386,0.925256598240471,0.627272727272727,1.76835760924159,777,381,396,3,1,97.14,8.8,0,0,0,0,0,0,0.000100591369125705,0.0163897004423985,0.0153615689381849
8.7,"random_policy_SVM","SVM",32,38,12,12,0,3900,3514,386,0.925483085462926,0.627272727272727,1.7618682235196,775,382,393,-2,1,99.69,9.1,0,0,0,0,0,0,5.5454151200863e-05,0.000886884709547533,0.000886884709547533
8.7,"random_policy_SVM","SVM",32,39,0,0,0,3912,3526,386,0.92561531210725,0.627272727272727,1.76348610067618,776,382,394,1,1,100,9.1,0,0,0,0,0,0,0,0,0
8.7,"random_policy_SVM","SVM",33,0,3812,3422,390,100,89,11,0.914733044532049,0.55609756097561,1.78517702596381,27,11,16,0,1.5,2.56,8.1,0,0,0,0,0,0,0.404179822711031,400.493228006006,46.7048926603172
8.7,"random_policy_SVM","SVM",33,1,3712,3363,349,200,148,52,0.912154726915635,0.614634146341463,1.73321995972253,113,52,61,86,1.2,5.11,2.8,0,0,0,0,0,0,0.529032422051867,562.598339099728,57.794400441633
8.7,"random_policy_SVM","SVM",33,2,3612,3331,281,300,180,120,0.906099650374012,0.629268292682927,1.74357320432708,179,91,88,66,1,7.67,1.5,0,0,0,0,0,0,0.558013088918001,302.244612437784,67.5641533508352
8.7,"random_policy_SVM","SVM",33,3,3512,3286,226,400,225,175,0.902996197294939,0.663414634146341,1.70289227455292,259,129,130,80,1,10.22,1.3,0,0,0,0,0,0,0.447955351354789,198.8280760313,60.2749991374516
8.7,"random_policy_SVM","SVM",33,4,3412,3239,173,500,272,228,0.90173280773357,0.653658536585366,1.71886657101865,346,171,175,87,1,12.78,1.2,0,0,0,0,0,0,0.268102068250358,170.760599695408,41.1991841379398
8.7,"random_policy_SVM","SVM",33,5,3312,3180,132,600,331,269,0.907191709267193,0.668292682926829,1.73081794906347,416,204,212,70,1,15.34,1.2,0,0,0,0,0,0,0.155337322902114,116.250928116055,22.5753801420021
8.7,"random_policy_SVM","SVM",33,6,3212,3105,107,700,406,294,0.896421557019688,0.68780487804878,1.64295916992319,473,231,242,57,1,17.89,1.4,0,0,0,0,0,0,0.101970985150388,91.8115460915266,13.9335618937831
8.7,"random_policy_SVM","SVM",33,7,3112,3025,87,800,486,314,0.886913401401275,0.702439024390244,1.62688546701135,530,255,275,57,1.1,20.45,1.5,0,0,0,0,0,0,0.0778110003298737,99.8033758450852,11.7182366321708
8.7,"random_policy_SVM","SVM",33,8,3012,2942,70,900,569,331,0.89435723140783,0.697560975609756,1.64295916992319,559,272,287,29,1.1,23.01,1.7,0,0,0,0,0,0,0.0646673487202791,91.1766434045235,8.68464008010542
8.7,"random_policy_SVM","SVM",33,9,2912,2855,57,1000,656,344,0.900987588973556,0.702439024390244,1.65326739350343,593,284,309,34,1.1,25.56,1.9,0,0,0,0,0,0,0.0595148608577436,93.7425158219463,6.85532097878447
8.7,"random_policy_SVM","SVM",33,10,2812,2765,47,1100,746,354,0.910838405928336,0.702439024390244,1.67655888886396,621,296,325,28,1.1,28.12,2.1,0,0,0,0,0,0,0.0613792036840503,95.4053753421441,7.12594944418439
8.7,"random_policy_SVM","SVM",33,11,2712,2669,43,1200,842,358,0.923179785767039,0.697560975609756,1.71482522198494,645,314,331,24,1.1,30.67,2.4,0,0,0,0,0,0,0.0562525360219301,77.2126943167319,6.45273437148138
8.7,"random_policy_SVM","SVM",33,12,2612,2579,33,1300,932,368,0.927545235475212,0.697560975609756,1.72044786501223,672,325,347,27,1.1,33.23,2.5,0,0,0,0,0,0,0.0795677986233875,84.0916198456036,8.82984042189143
8.7,"random_policy_SVM","SVM",33,13,2512,2481,31,1400,1030,370,0.930358958643853,0.692682926829268,1.7396038269775,675,329,346,3,1.1,35.79,2.8,0,0,0,0,0,0,0.0595138705033159,57.0714947692109,6.34332975384206
8.7,"random_policy_SVM","SVM",33,14,2412,2385,27,1500,1126,374,0.930966277109954,0.68780487804878,1.75000112397437,692,335,357,17,1.1,38.34,3,0,0,0,0,0,0,0.0565117178822452,48.2775565419114,6.15061643475125
8.7,"random_policy_SVM","SVM",33,15,2312,2294,18,1600,1217,383,0.930409104205274,0.682926829268293,1.75000112397437,716,344,372,24,1.1,40.9,3.2,0,0,0,0,0,0,0.0604082380738282,45.2671240265827,6.95338490479182
8.7,"random_policy_SVM","SVM",33,16,2212,2197,15,1700,1314,386,0.929907648591061,0.682926829268293,1.73081794906347,735,347,388,19,1.1,43.46,3.4,0,0,0,0,0,0,0.0441923124320531,40.3652509441625,5.57877587754714
8.7,"random_policy_SVM","SVM",33,17,2112,2103,9,1800,1408,392,0.930239166469348,0.678048780487805,1.73241317297966,748,354,394,13,1.1,46.01,3.6,0,0,0,0,0,0,0.0396657615568711,38.8551395771681,4.54266353119906
8.7,"random_policy_SVM","SVM",33,18,2012,2003,9,1900,1508,392,0.930673761334998,0.673170731707317,1.73800345547154,752,357,395,4,1.1,48.57,3.8,0,0,0,0,0,0,0.0285114166602327,28.0113386126871,3.0823308032233
8.7,"random_policy_SVM","SVM",33,19,1912,1903,9,2000,1608,392,0.930670975470474,0.673170731707317,1.7396038269775,747,358,389,-5,1.1,51.12,4.1,0,0,0,0,0,0,0.0224920548460738,21.3905900555762,2.40754721579364
8.7,"random_policy_SVM","SVM",33,20,1812,1803,9,2100,1708,392,0.931010850942329,0.678048780487805,1.74838970489152,749,358,391,2,1.1,53.68,4.4,0,0,0,0,0,0,0.0178581778310454,17.2558077869987,1.95020157377078
8.7,"random_policy_SVM","SVM",33,21,1712,1703,9,2200,1808,392,0.931141786574929,0.673170731707317,1.75000112397437,747,359,388,-2,1.1,56.24,4.6,0,0,0,0,0,0,0.014543729928211,13.6155057251,1.53521918118461
8.7,"random_policy_SVM","SVM",33,22,1612,1603,9,2300,1908,392,0.933197754593204,0.668292682926829,1.75233487872069,755,361,394,8,1.1,58.79,4.9,0,0,0,0,0,0,0.010437643367284,9.03249188861434,1.19349097596499
8.7,"random_policy_SVM","SVM",33,23,1512,1504,8,2400,2007,393,0.934080873647123,0.678048780487805,1.76758907496909,763,370,393,8,1.1,61.35,5.1,0,0,0,0,0,0,0.0074179077644292,6.05500420847961,0.86122599191524
8.7,"random_policy_SVM","SVM",33,24,1412,1406,6,2500,2105,395,0.934977922023659,0.673170731707317,1.76596146071958,773,374,399,10,1.1,63.91,5.3,0,0,0,0,0,0,0.00765026608214335,5.6219981935989,0.787954692437431
8.7,"random_policy_SVM","SVM",33,25,1312,1307,5,2600,2204,396,0.938088339764041,0.673170731707317,1.76596146071958,782,384,398,9,1,66.46,5.6,0,0,0,0,0,0,0.00534931711537928,3.64615625786439,0.668671074137892
8.7,"random_policy_SVM","SVM",33,26,1212,1207,5,2700,2304,396,0.937953225334656,0.673170731707317,1.7643368411605,780,384,396,-2,1,69.02,5.8,0,0,0,0,0,0,0.00469013603610722,2.82007537857294,0.479267900912558
8.7,"random_policy_SVM","SVM",33,27,1112,1107,5,2800,2404,396,0.938833558524051,0.663414634146341,1.76758907496909,791,387,404,11,1,71.57,6.1,0,0,0,0,0,0,0.00370908182494677,2.13988250565472,0.445000902375984
8.7,"random_policy_SVM","SVM",33,28,1012,1008,4,2900,2503,397,0.939116323773177,0.663414634146341,1.76271520803443,793,388,405,2,1,74.13,6.3,0,0,0,0,0,0,0.00304192389339773,1.51533485259022,0.316394724974307
8.7,"random_policy_SVM","SVM",33,29,912,908,4,3000,2603,397,0.939308548425291,0.668292682926829,1.76596146071958,794,390,404,1,1,76.69,6.6,0,0,0,0,0,0,0.00287521578348519,1.3151246103036,0.321136938895704
8.7,"random_policy_SVM","SVM",33,30,812,808,4,3100,2703,397,0.939360086918974,0.668292682926829,1.7643368411605,797,390,407,3,1,79.24,6.8,0,0,0,0,0,0,0.00207706713276812,0.770676344348377,0.219249439603815
8.7,"random_policy_SVM","SVM",33,31,712,709,3,3200,2802,398,0.939627529913221,0.663414634146341,1.76271520803443,802,393,409,5,1,81.8,7,0,0,0,0,0,0,0.00180217427186489,0.594820867886883,0.2006616284044
8.7,"random_policy_SVM","SVM",33,32,612,610,2,3300,2901,399,0.939800253513672,0.658536585365854,1.7643368411605,805,395,410,3,1,84.36,7.3,0,0,0,0,0,0,0.00156508402254351,0.499310001423341,0.184865047646396
8.7,"random_policy_SVM","SVM",33,33,512,510,2,3400,3001,399,0.939942332604366,0.663414634146341,1.76758907496909,806,395,411,1,1,86.91,7.5,0,0,0,0,0,0,0.00100144518330188,0.311249163201683,0.124847251623785
8.7,"random_policy_SVM","SVM",33,34,412,412,0,3500,3099,401,0.940349068824784,0.668292682926829,1.76596146071958,817,398,419,11,1.1,89.47,7.7,0,0,0,0,0,0,0.00104850812575286,0.317595746846977,0.129525420380068
8.7,"random_policy_SVM","SVM",33,35,312,312,0,3600,3199,401,0.94032121017955,0.668292682926829,1.76758907496909,815,399,416,-2,1,92.02,8,0,0,0,0,0,0,0.000535090407987086,0.131843175156337,0.0646997015431709
8.7,"random_policy_SVM","SVM",33,36,212,212,0,3700,3299,401,0.940138736053266,0.668292682926829,1.76596146071958,820,400,420,5,1.1,94.58,8.2,0,0,0,0,0,0,0.000260572201103016,0.0531115043160319,0.0340598217398716
8.7,"random_policy_SVM","SVM",33,37,112,112,0,3800,3399,401,0.940067696507919,0.668292682926829,1.77148493543759,821,401,420,1,1,97.14,8.5,0,0,0,0,0,0,8.40583476324906e-05,0.0148729340693077,0.014009562087597
8.7,"random_policy_SVM","SVM",33,38,12,12,0,3900,3499,401,0.940034266133637,0.668292682926829,1.77311463639015,822,401,421,1,1,99.69,8.7,0,0,0,0,0,0,3.31681455748872e-05,0.000517714728182474,0.000517714728182474
8.7,"random_policy_SVM","SVM",33,39,0,0,0,3912,3511,401,0.940042623727207,0.668292682926829,1.77148493543759,822,401,421,0,1,100,8.8,0,0,0,0,0,0,0,0,0
8.7,"random_policy_SVM","SVM",34,0,3812,3408,404,100,92,8,0.892712124226213,0.5,1.70054634424438,28,8,20,0,2.5,2.56,11.5,0,0,0,0,0,0,0.156338876969005,312.260875318506,16.9257936909768
8.7,"random_policy_SVM","SVM",34,1,3712,3376,336,200,124,76,0.907795733526807,0.572164948453608,1.75910936923121,104,52,52,76,1,5.11,1.6,0,0,0,0,0,0,0.691628596253888,384.555194846204,75.7501913156015
8.7,"random_policy_SVM","SVM",34,2,3612,3330,282,300,170,130,0.904743028657676,0.597938144329897,1.73292525773196,182,92,90,78,1,7.67,1.3,0,0,0,0,0,0,0.597910681398413,308.901197856246,70.9764706625795
8.7,"random_policy_SVM","SVM",34,3,3512,3299,213,400,201,199,0.91201130393063,0.603092783505155,1.73422246536064,250,127,123,68,1,10.22,1,0,0,0,0,0,0,0.505571786430811,282.026981160342,66.9838731141223
8.7,"random_policy_SVM","SVM",34,4,3412,3253,159,500,247,253,0.914345811343715,0.603092783505155,1.74700935911445,333,169,164,83,1,12.78,1,0,0,0,0,0,0,0.29001401062551,178.972437085348,46.3282491905066
8.7,"random_policy_SVM","SVM",34,5,3312,3193,119,600,307,293,0.893730180090574,0.61340206185567,1.67112832488466,409,202,207,76,1,15.34,1,0,0,0,0,0,0,0.285523144863188,201.585651857987,40.4024055509821
8.7,"random_policy_SVM","SVM",34,6,3212,3113,99,700,387,313,0.899095451513635,0.618556701030928,1.68196113829636,454,225,229,45,1,17.89,1.2,0,0,0,0,0,0,0.107738527686509,95.6830322148159,15.592455555928
8.7,"random_policy_SVM","SVM",34,7,3112,3033,79,800,467,333,0.892953473676834,0.618556701030928,1.6618442786353,512,248,264,58,1.1,20.45,1.4,0,0,0,0,0,0,0.0791607146189275,96.0052151705532,10.9854280008578
8.7,"random_policy_SVM","SVM",34,8,3012,2954,58,900,546,354,0.881855787121027,0.618556701030928,1.61097384340121,561,269,292,49,1.1,23.01,1.5,0,0,0,0,0,0,0.0790196989304133,117.134820986946,10.4160540271638
8.7,"random_policy_SVM","SVM",34,9,2912,2860,52,1000,640,360,0.889263021168541,0.634020618556701,1.63549812342629,583,283,300,22,1.1,25.56,1.8,0,0,0,0,0,0,0.0580778323957997,83.1543406333812,6.88541448226227
8.7,"random_policy_SVM","SVM",34,10,2812,2765,47,1100,735,365,0.892621435341761,0.634020618556701,1.6447907264003,595,289,306,12,1.1,28.12,2,0,0,0,0,0,0,0.0584850123816644,87.9938839910157,6.21908647526048
8.7,"random_policy_SVM","SVM",34,11,2712,2667,45,1200,833,367,0.913184408532958,0.618556701030928,1.71913155019241,626,306,320,31,1,30.67,2.3,0,0,0,0,0,0,0.0460037165333953,40.5640432867133,5.76435831074751
8.7,"random_policy_SVM","SVM",34,12,2612,2574,38,1300,926,374,0.91314637771044,0.618556701030928,1.70669296939463,640,314,326,14,1,33.23,2.5,0,0,0,0,0,0,0.0346868732162116,36.857710335518,3.91802246398969
8.7,"random_policy_SVM","SVM",34,13,2512,2477,35,1400,1023,377,0.914711492329466,0.623711340206186,1.71596847466308,647,318,329,7,1,35.79,2.7,0,0,0,0,0,0,0.0266665498597175,32.8278506214259,2.99840369700125
8.7,"random_policy_SVM","SVM",34,14,2412,2381,31,1500,1119,381,0.916551599049814,0.618556701030928,1.70669296939463,657,322,335,10,1,38.34,2.9,0,0,0,0,0,0,0.0289992868494133,37.7870091170529,3.22567930477507
8.7,"random_policy_SVM","SVM",34,15,2312,2291,21,1600,1209,391,0.920454146529832,0.603092783505155,1.74379499046842,691,337,354,34,1.1,40.9,3.1,0,0,0,0,0,0,0.0639949282064676,46.011711209022,7.42153075419314
8.7,"random_policy_SVM","SVM",34,16,2212,2193,19,1700,1307,393,0.920617971611453,0.597938144329897,1.74700935911445,704,343,361,13,1.1,43.46,3.3,0,0,0,0,0,0,0.0526178297333533,32.6096687685314,5.76465673931175
8.7,"random_policy_SVM","SVM",34,17,2112,2096,16,1800,1404,396,0.920231812490491,0.592783505154639,1.74379499046842,713,347,366,9,1.1,46.01,3.5,0,0,0,0,0,0,0.0498585580558405,29.7914471443639,5.57657077370789
8.7,"random_policy_SVM","SVM",34,18,2012,2000,12,1900,1500,400,0.919327849093697,0.592783505154639,1.74379499046842,728,352,376,15,1.1,48.57,3.8,0,0,0,0,0,0,0.0397599697782677,23.3335070739555,4.72835010961627
8.7,"random_policy_SVM","SVM",34,19,1912,1908,4,2000,1592,408,0.918611114361611,0.587628865979381,1.74379499046842,743,360,383,15,1.1,51.12,3.9,0,0,0,0,0,0,0.0231296763531712,19.8840991753923,3.39436316663244
8.7,"random_policy_SVM","SVM",34,20,1812,1809,3,2100,1691,409,0.918494096446168,0.592783505154639,1.74379499046842,748,363,385,5,1.1,53.68,4.1,0,0,0,0,0,0,0.016984551276991,15.5121387967023,1.91067501266617
8.7,"random_policy_SVM","SVM",34,21,1712,1709,3,2200,1791,409,0.918722281381281,0.592783505154639,1.74700935911445,751,362,389,3,1.1,56.24,4.4,0,0,0,0,0,0,0.0148049506467422,12.1655200645496,1.50121833057002
8.7,"random_policy_SVM","SVM",34,22,1612,1609,3,2300,1891,409,0.919541406789372,0.592783505154639,1.74379499046842,771,373,398,20,1.1,58.79,4.6,0,0,0,0,0,0,0.0107682710512655,7.29169261530731,1.42713395767082
8.7,"random_policy_SVM","SVM",34,23,1512,1509,3,2400,1991,409,0.919427314321817,0.597938144329897,1.74219223771983,768,371,397,-3,1.1,61.35,4.9,0,0,0,0,0,0,0.00802077124085747,5.85895736020013,0.919865157714598
8.7,"random_policy_SVM","SVM",34,24,1412,1409,3,2500,2091,409,0.919250324724709,0.597938144329897,1.74219223771983,766,371,395,-2,1.1,63.91,5.1,0,0,0,0,0,0,0.00683161299851979,4.69350235023054,0.708773761326828
8.7,"random_policy_SVM","SVM",34,25,1312,1309,3,2600,2191,409,0.920623822507212,0.587628865979381,1.74540069487954,775,375,400,9,1.1,66.46,5.4,0,0,0,0,0,0,0.00531524327001427,3.44025060221182,0.586326037846345
8.7,"random_policy_SVM","SVM",34,26,1212,1209,3,2700,2291,409,0.92093684543102,0.587628865979381,1.74379499046842,777,377,400,2,1.1,69.02,5.6,0,0,0,0,0,0,0.00463525283374025,2.6623270310148,0.480099357066052
8.7,"random_policy_SVM","SVM",34,27,1112,1109,3,2800,2391,409,0.921244017459056,0.587628865979381,1.7514592177077,779,377,402,2,1.1,71.57,5.8,0,0,0,0,0,0,0.00421169303210822,2.19241895611888,0.446847073203022
8.7,"random_policy_SVM","SVM",34,28,1012,1010,2,2900,2490,410,0.921396140749132,0.587628865979381,1.75468474112889,787,381,406,8,1.1,74.13,6.1,0,0,0,0,0,0,0.00376657779462893,1.75439352278815,0.396804558143787
8.7,"random_policy_SVM","SVM",34,29,912,911,1,3000,2589,411,0.921299600968893,0.587628865979381,1.75468474112889,788,384,404,1,1.1,76.69,6.3,0,0,0,0,0,0,0.00340614446819905,1.43763392695006,0.367017268748194
8.7,"random_policy_SVM","SVM",34,30,812,811,1,3100,2689,411,0.92133178089564,0.587628865979381,1.75307049573687,790,385,405,2,1.1,79.24,6.5,0,0,0,0,0,0,0.00284102431232982,1.0502345550054,0.312406745430386
8.7,"random_policy_SVM","SVM",34,31,712,712,0,3200,2788,412,0.921305451864665,0.587628865979381,1.7514592177077,795,387,408,5,1.1,81.8,6.8,0,0,0,0,0,0,0.00199445284312884,0.67033086519625,0.229509974799772
8.7,"random_policy_SVM","SVM",34,32,612,612,0,3300,2888,412,0.921302526416779,0.587628865979381,1.75468474112889,796,387,409,1,1.1,84.36,7,0,0,0,0,0,0,0.00153684801299009,0.474161530095624,0.182080410108564
8.7,"random_policy_SVM","SVM",34,33,512,512,0,3400,2988,412,0.921165030366134,0.587628865979381,1.75307049573687,799,388,411,3,1.1,86.91,7.3,0,0,0,0,0,0,0.000943627561202082,0.301725388866861,0.125114324647535
8.7,"random_policy_SVM","SVM",34,34,412,412,0,3500,3088,412,0.921068490585893,0.587628865979381,1.7514592177077,801,389,412,2,1.1,89.47,7.5,0,0,0,0,0,0,0.000541437759307478,0.159651421835942,0.0694809660886242
8.7,"random_policy_SVM","SVM",34,35,312,312,0,3600,3188,412,0.920983652597198,0.587628865979381,1.74985089886683,805,391,414,4,1.1,92.02,7.7,0,0,0,0,0,0,0.00038818557386873,0.100003165718136,0.048584959799283
8.7,"random_policy_SVM","SVM",34,36,212,212,0,3700,3288,412,0.921030459763376,0.587628865979381,1.76234600100532,805,391,414,0,1.1,94.58,8,0,0,0,0,0,0,0.000211664299526261,0.0437463115059798,0.0279880322690379
8.7,"random_policy_SVM","SVM",34,37,112,112,0,3800,3388,412,0.921124074095731,0.587628865979381,1.76396878737825,808,391,417,3,1.1,97.14,8.2,0,0,0,0,0,0,9.399464666682e-05,0.015984125660108,0.0150299583731289
8.7,"random_policy_SVM","SVM",34,38,12,12,0,3900,3488,412,0.921334706343532,0.587628865979381,1.76559456506247,811,394,417,3,1.1,99.69,8.5,0,0,0,0,0,0,6.52121800029597e-05,0.000915298930981927,0.000915298930981927
8.7,"random_policy_SVM","SVM",34,39,0,0,0,3912,3500,412,0.921333243619589,0.587628865979381,1.76396878737825,811,394,417,0,1.1,100,8.5,0,0,0,0,0,0,0,0,0
8.7,"random_policy_SVM","SVM",35,0,3812,3433,379,100,91,9,0.877318651618951,0.440366972477064,1.77795628461506,36,9,27,0,3,2.56,10.1,0,0,0,0,0,0,0.0972761610448968,347.746257061292,9.86904056021919
8.7,"random_policy_SVM","SVM",35,1,3712,3363,349,200,161,39,0.877664403880882,0.568807339449541,1.68543768057175,87,39,48,51,1.2,5.11,4.1,0,0,0,0,0,0,0.43143493438031,343.400847707703,55.6374944761305
8.7,"random_policy_SVM","SVM",35,2,3612,3334,278,300,190,110,0.894160217903108,0.628440366972477,1.66737844247698,165,81,84,78,1,7.67,1.7,0,0,0,0,0,0,0.525618934448515,314.316968344894,67.7282590052932
8.7,"random_policy_SVM","SVM",35,3,3512,3290,222,400,234,166,0.855326432364528,0.623853211009174,1.59162506745818,246,125,121,81,1,10.22,1.4,0,0,0,0,0,0,0.354315425902674,257.530107580273,56.4142514808684
8.7,"random_policy_SVM","SVM",35,4,3412,3241,171,500,283,217,0.875286367331419,0.628440366972477,1.65238988291348,328,164,164,82,1,12.78,1.3,0,0,0,0,0,0,0.248392212622757,174.611630328773,36.863963460827
8.7,"random_policy_SVM","SVM",35,5,3312,3185,127,600,339,261,0.880335406087343,0.623853211009174,1.67563279120211,406,199,207,78,1,15.34,1.3,0,0,0,0,0,0,0.154003946947275,115.194853920461,25.0676928598602
8.7,"random_policy_SVM","SVM",35,6,3212,3105,107,700,419,281,0.909352202785029,0.665137614678899,1.69369962998631,453,219,234,47,1.1,17.89,1.5,0,0,0,0,0,0,0.0946858679382241,86.7917576938131,13.2399580490004
8.7,"random_policy_SVM","SVM",35,7,3112,3031,81,800,493,307,0.917201570929356,0.697247706422018,1.70353020758466,515,245,270,62,1.1,20.45,1.6,0,0,0,0,0,0,0.0813731238304881,99.7212513316315,10.3565245358693
8.7,"random_policy_SVM","SVM",35,8,3012,2949,63,900,575,325,0.92252641969575,0.711009174311927,1.69369962998631,560,266,294,45,1.1,23.01,1.8,0,0,0,0,0,0,0.0913653074774812,122.926317728554,10.9058552001108
8.7,"random_policy_SVM","SVM",35,9,2912,2858,54,1000,666,334,0.923824970175578,0.706422018348624,1.69369962998631,591,284,307,31,1.1,25.56,2,0,0,0,0,0,0,0.0734288692008086,97.7135982177081,8.82479135790407
8.7,"random_policy_SVM","SVM",35,10,2812,2767,45,1100,757,343,0.929285744449492,0.701834862385321,1.72357325957906,615,295,320,24,1.1,28.12,2.2,0,0,0,0,0,0,0.0738693801786373,93.2685996913569,8.19441541777878
8.7,"random_policy_SVM","SVM",35,11,2712,2673,39,1200,851,349,0.932496489690783,0.701834862385321,1.75979522530285,635,305,330,20,1.1,30.67,2.4,0,0,0,0,0,0,0.0635124041990332,70.4858751421071,6.96172698752777
8.7,"random_policy_SVM","SVM",35,12,2612,2580,32,1300,944,356,0.933017757413883,0.701834862385321,1.75153327588829,650,313,337,15,1.1,33.23,2.7,0,0,0,0,0,0,0.0680227783391539,72.325813179617,7.62927653218911
8.7,"random_policy_SVM","SVM",35,13,2512,2482,30,1400,1042,358,0.933507353174062,0.706422018348624,1.75153327588829,656,315,341,6,1.1,35.79,2.9,0,0,0,0,0,0,0.0551388691367875,57.8251909684945,6.0631634581466
8.7,"random_policy_SVM","SVM",35,14,2412,2384,28,1500,1140,360,0.933684188300377,0.697247706422018,1.74831354560173,665,317,348,9,1.1,38.34,3.2,0,0,0,0,0,0,0.0459275995408901,48.0844786088202,4.98272486237279
8.7,"random_policy_SVM","SVM",35,15,2312,2290,22,1600,1234,366,0.934024661901793,0.701834862385321,1.74992192972832,687,324,363,22,1.1,40.9,3.4,0,0,0,0,0,0,0.0417468885296517,44.9050387349674,4.65304939151452
8.7,"random_policy_SVM","SVM",35,16,2212,2192,20,1700,1332,368,0.934185661046649,0.697247706422018,1.74670811534865,693,328,365,6,1.1,43.46,3.6,0,0,0,0,0,0,0.0375426384921323,38.9814061721626,3.99463635907606
8.7,"random_policy_SVM","SVM",35,17,2112,2092,20,1800,1432,368,0.934138153102264,0.697247706422018,1.74350608397312,699,328,371,6,1.1,46.01,3.9,0,0,0,0,0,0,0.0319677973959569,32.5147481275621,3.40890604803665
8.7,"random_policy_SVM","SVM",35,18,2012,1992,20,1900,1532,368,0.933913810031562,0.697247706422018,1.74831354560173,701,329,372,2,1.1,48.57,4.2,0,0,0,0,0,0,0.0235510283261029,22.0558356701188,2.4974220847578
8.7,"random_policy_SVM","SVM",35,19,1912,1893,19,2000,1631,369,0.933908531371073,0.697247706422018,1.75817627845345,703,332,371,2,1.1,51.12,4.4,0,0,0,0,0,0,0.0198471984539761,18.5684039044826,2.13873857727076
8.7,"random_policy_SVM","SVM",35,20,1812,1799,13,2100,1725,375,0.934753117049012,0.697247706422018,1.76141715638608,714,341,373,11,1.1,53.68,4.6,0,0,0,0,0,0,0.0187767933101185,18.5254473425828,2.05239955653837
8.7,"random_policy_SVM","SVM",35,21,1712,1702,10,2200,1822,378,0.935837881779114,0.692660550458716,1.75012602076822,726,346,380,12,1.1,56.24,4.8,0,0,0,0,0,0,0.0197338526865851,17.3191024930743,1.99909259590708
8.7,"random_policy_SVM","SVM",35,22,1612,1602,10,2300,1922,378,0.935471014875259,0.701834862385321,1.75494730457199,741,361,380,15,1.1,58.79,5.1,0,0,0,0,0,0,0.0121657193461323,7.36595828358232,1.59078008913545
8.7,"random_policy_SVM","SVM",35,23,1512,1505,7,2400,2019,381,0.935957971305197,0.701834862385321,1.75656030760928,749,364,385,8,1.1,61.35,5.3,0,0,0,0,0,0,0.00893262686333885,6.28990521494296,1.08536798415374
8.7,"random_policy_SVM","SVM",35,24,1412,1407,5,2500,2117,383,0.935763980532294,0.701834862385321,1.75817627845345,756,367,389,7,1.1,63.91,5.5,0,0,0,0,0,0,0.00777936290861899,5.9023120992546,0.863022485482235
8.7,"random_policy_SVM","SVM",35,25,1312,1308,4,2600,2216,384,0.936516189651707,0.701834862385321,1.75656030760928,766,369,397,10,1.1,66.46,5.8,0,0,0,0,0,0,0.0077063720240892,5.21795607985649,0.784790957610736
8.7,"random_policy_SVM","SVM",35,26,1212,1208,4,2700,2316,384,0.937344939348167,0.697247706422018,1.76805717471742,771,374,397,5,1.1,69.02,6,0,0,0,0,0,0,0.0049673880841793,3.03494936795926,0.583194364252957
8.7,"random_policy_SVM","SVM",35,27,1112,1108,4,2800,2416,384,0.937511217153511,0.697247706422018,1.76805717471742,768,374,394,-3,1.1,71.57,6.3,0,0,0,0,0,0,0.00456981914418382,2.47569207450887,0.469331774238223
8.7,"random_policy_SVM","SVM",35,28,1012,1008,4,2900,2516,384,0.937368693320356,0.701834862385321,1.76480706961684,775,377,398,7,1.1,74.13,6.6,0,0,0,0,0,0,0.00346630509996894,1.67161070989868,0.372939333628481
8.7,"random_policy_SVM","SVM",35,29,912,909,3,3000,2615,385,0.93742411925547,0.701834862385321,1.76643062717858,780,379,401,5,1.1,76.69,6.8,0,0,0,0,0,0,0.00369322710154697,1.54360940317586,0.385760906873652
8.7,"random_policy_SVM","SVM",35,30,812,809,3,3100,2715,385,0.937521774474482,0.701834862385321,1.75995425457664,780,380,400,0,1.1,79.24,7.1,0,0,0,0,0,0,0.00221817312776871,0.771194509299264,0.2423573271819
8.7,"random_policy_SVM","SVM",35,31,712,709,3,3200,2815,385,0.937494061506925,0.706422018348624,1.76156889150745,780,380,400,0,1.1,81.8,7.3,0,0,0,0,0,0,0.00183876855009591,0.589303319143678,0.212747988283077
8.7,"random_policy_SVM","SVM",35,32,612,610,2,3300,2914,386,0.937764592856891,0.701834862385321,1.76332958757526,785,382,403,5,1.1,84.36,7.5,0,0,0,0,0,0,0.00111228870621679,0.36326918903656,0.143961657704557
8.7,"random_policy_SVM","SVM",35,33,512,512,0,3400,3012,388,0.937611511702766,0.701834862385321,1.77305383162439,797,386,411,12,1.1,86.91,7.8,0,0,0,0,0,0,0.00102133361583315,0.338740224442458,0.127909936942216
8.7,"random_policy_SVM","SVM",35,34,412,412,0,3500,3112,388,0.937698609600805,0.697247706422018,1.78622584872955,794,387,407,-3,1.1,89.47,8,0,0,0,0,0,0,0.000626661590731356,0.186727038967328,0.0771575408217297
8.7,"random_policy_SVM","SVM",35,35,312,312,0,3600,3212,388,0.937641864000568,0.697247706422018,1.77305383162439,795,387,408,1,1.1,92.02,8.3,0,0,0,0,0,0,0.000503485241787265,0.127941644345457,0.0604428297343448
8.7,"random_policy_SVM","SVM",35,36,212,212,0,3700,3312,388,0.937426758585719,0.697247706422018,1.77468497590372,799,388,411,4,1.1,94.58,8.5,0,0,0,0,0,0,0.000218470348449464,0.0433335926696512,0.0275287539524396
8.7,"random_policy_SVM","SVM",35,37,112,112,0,3800,3412,388,0.937368693320361,0.688073394495413,1.77305383162439,802,388,414,3,1.1,97.14,8.8,0,0,0,0,0,0,7.37647354847917e-05,0.0134913191580386,0.0127099629570841
8.7,"random_policy_SVM","SVM",35,38,12,12,0,3900,3512,388,0.93809978779783,0.688073394495413,1.77468497590372,798,388,410,-4,1.1,99.69,9.1,0,0,0,0,0,0,4.98995534151931e-05,0.000676924971572496,0.000676924971572496
8.7,"random_policy_SVM","SVM",35,39,0,0,0,3912,3524,388,0.93821063966806,0.688073394495413,1.77142568301868,798,388,410,0,1.1,100,9.1,0,0,0,0,0,0,0,0,0
8.7,"random_policy_SVM","SVM",36,0,3812,3413,399,100,91,9,0.892885050734876,0.505050505050505,1.75663139182846,24,9,15,0,1.7,2.56,10.1,0,0,0,0,0,0,0.651123089206591,353.962972401427,75.7077147022456
8.7,"random_policy_SVM","SVM",36,1,3712,3368,344,200,136,64,0.917063122694511,0.585858585858586,1.76147504456328,105,53,52,81,1,5.11,2.1,0,0,0,0,0,0,0.65815143512721,286.943415686624,77.4794431073845
8.7,"random_policy_SVM","SVM",36,2,3612,3328,284,300,176,124,0.904043276910146,0.606060606060606,1.74813573523251,171,89,82,66,0.9,7.67,1.4,0,0,0,0,0,0,0.529245087934835,215.5006195963,71.8100125679344
8.7,"random_policy_SVM","SVM",36,3,3512,3291,221,400,213,187,0.90018501281298,0.601010101010101,1.73583117281369,249,127,122,78,1,10.22,1.1,0,0,0,0,0,0,0.398859618364547,166.194276524246,60.1626072687893
8.7,"random_policy_SVM","SVM",36,4,3412,3235,177,500,269,231,0.901467749163993,0.621212121212121,1.73742954405938,315,159,156,66,1,12.78,1.2,0,0,0,0,0,0,0.172706914018432,97.8113958881626,32.1733870087111
8.7,"random_policy_SVM","SVM",36,5,3312,3176,136,600,328,272,0.890807965893293,0.631313131313131,1.65708699902248,391,192,199,76,1,15.34,1.2,0,0,0,0,0,0,0.101846166213978,69.4329492904199,16.2428945736923
8.7,"random_policy_SVM","SVM",36,6,3212,3104,108,700,400,300,0.893396421553417,0.631313131313131,1.65403808090101,460,221,239,69,1.1,17.89,1.3,0,0,0,0,0,0,0.0757290605991671,59.6874431582286,11.676585083512
8.7,"random_policy_SVM","SVM",36,7,3112,3024,88,800,480,320,0.894723687385798,0.656565656565657,1.64798212540148,499,238,261,39,1.1,20.45,1.5,0,0,0,0,0,0,0.066729898078121,71.0444055479617,10.9747314768336
8.7,"random_policy_SVM","SVM",36,8,3012,2944,68,900,560,340,0.892586272279102,0.676767676767677,1.64646464646465,547,262,285,48,1.1,23.01,1.6,0,0,0,0,0,0,0.0639678667986797,90.1645533832772,8.94477441273747
8.7,"random_policy_SVM","SVM",36,9,2912,2859,53,1000,645,355,0.901746417531395,0.666666666666667,1.65556113622412,587,282,305,40,1.1,25.56,1.8,0,0,0,0,0,0,0.0553829073935384,76.5425092153397,6.3814367742116
8.7,"random_policy_SVM","SVM",36,10,2812,2765,47,1100,739,361,0.910826122430219,0.656565656565657,1.68440161988549,606,292,314,19,1.1,28.12,2,0,0,0,0,0,0,0.0512218257471308,73.0098582616008,5.80081336292227
8.7,"random_policy_SVM","SVM",36,11,2712,2673,39,1200,831,369,0.924413359993569,0.661616161616162,1.7251559714795,637,306,331,31,1.1,30.67,2.3,0,0,0,0,0,0,0.0577790974154377,67.7888907782005,6.46557606729925
8.7,"random_policy_SVM","SVM",36,12,2612,2582,30,1300,922,378,0.930186391790472,0.661616161616162,1.74491929413733,662,319,343,25,1.1,33.23,2.4,0,0,0,0,0,0,0.0577255961128348,62.4787663425009,6.46432345840246
8.7,"random_policy_SVM","SVM",36,13,2512,2485,27,1400,1019,381,0.929769825674258,0.651515151515151,1.74813573523251,674,322,352,12,1.1,35.79,2.7,0,0,0,0,0,0,0.0553367689062474,55.6160696216572,5.92431804758023
8.7,"random_policy_SVM","SVM",36,14,2412,2387,25,1500,1117,383,0.92872410107904,0.656565656565657,1.74491929413733,684,327,357,10,1.1,38.34,2.9,0,0,0,0,0,0,0.0462539070036144,45.8728705619498,5.13293970615859
8.7,"random_policy_SVM","SVM",36,15,2312,2295,17,1600,1209,391,0.9268696636444,0.661616161616162,1.74331550802139,713,336,377,29,1.1,40.9,3.1,0,0,0,0,0,0,0.0471248612493695,42.4366530421822,5.84748323762235
8.7,"random_policy_SVM","SVM",36,16,2212,2200,12,1700,1304,396,0.926876845818817,0.661616161616162,1.74813573523251,720,342,378,7,1.1,43.46,3.3,0,0,0,0,0,0,0.0345229058253725,35.7336021280643,4.27418793556369
8.7,"random_policy_SVM","SVM",36,17,2112,2103,9,1800,1401,399,0.92706358235368,0.661616161616162,1.74331550802139,728,345,383,8,1.1,46.01,3.5,0,0,0,0,0,0,0.0289828128882307,31.5967944909934,3.18610798259345
8.7,"random_policy_SVM","SVM",36,18,2012,2003,9,1900,1501,399,0.926879718688583,0.651515151515151,1.74491929413733,727,349,378,-1,1.1,48.57,3.8,0,0,0,0,0,0,0.0209912566444425,21.8764364351941,2.43752202266527
8.7,"random_policy_SVM","SVM",36,19,1912,1904,8,2000,1600,400,0.927256064628072,0.651515151515151,1.75562252357832,736,352,384,9,1.1,51.12,4,0,0,0,0,0,0,0.0185229579372064,17.9056525635166,1.91438207014337
8.7,"random_policy_SVM","SVM",36,20,1812,1805,7,2100,1699,401,0.929899104813773,0.646464646464647,1.78291199285674,752,367,385,16,1,53.68,4.2,0,0,0,0,0,0,0.0128454672876232,10.0533104143814,1.6006789455938
8.7,"random_policy_SVM","SVM",36,21,1712,1705,7,2200,1799,401,0.929772698544022,0.646464646464647,1.78291199285674,754,368,386,2,1,56.24,4.5,0,0,0,0,0,0,0.0087856568164258,7.73635800717618,0.997730798937612
8.7,"random_policy_SVM","SVM",36,22,1612,1605,7,2300,1899,401,0.929834465244016,0.646464646464647,1.77381550309727,756,369,387,2,1,58.79,4.7,0,0,0,0,0,0,0.00769346229325379,6.09041536464361,0.785536925143419
8.7,"random_policy_SVM","SVM",36,23,1512,1505,7,2400,1999,401,0.930760965743901,0.641414141414141,1.7689289590116,769,376,393,13,1,61.35,5,0,0,0,0,0,0,0.00543280727174018,3.84166902670555,0.658664356342074
8.7,"random_policy_SVM","SVM",36,24,1412,1405,7,2500,2099,401,0.930569919904392,0.641414141414141,1.77055481283422,769,376,393,0,1,63.91,5.2,0,0,0,0,0,0,0.00491672393353832,3.45066486002634,0.517755716989512
8.7,"random_policy_SVM","SVM",36,25,1312,1305,7,2600,2199,401,0.931013778283403,0.636363636363636,1.77218365810822,772,377,395,3,1,66.46,5.5,0,0,0,0,0,0,0.00385039510183911,2.45055561785448,0.407699968683092
8.7,"random_policy_SVM","SVM",36,26,1212,1206,6,2700,2298,402,0.93192735086933,0.636363636363636,1.77636919655268,784,382,402,12,1.1,69.02,5.7,0,0,0,0,0,0,0.00359293593222853,2.05881126412827,0.375068452796878
8.7,"random_policy_SVM","SVM",36,27,1112,1106,6,2800,2398,402,0.932320934027418,0.631313131313131,1.77963458110517,780,381,399,-4,1,71.57,6,0,0,0,0,0,0,0.0030414907163039,1.54265275329453,0.321017060809018
8.7,"random_policy_SVM","SVM",36,28,1012,1006,6,2900,2498,402,0.932703025706438,0.626262626262626,1.78127177943185,782,383,399,2,1,74.13,6.2,0,0,0,0,0,0,0.00241150377511668,1.05730437870272,0.252673413902524
8.7,"random_policy_SVM","SVM",36,29,912,907,5,3000,2597,403,0.933263235311018,0.626262626262626,1.78127177943185,792,387,405,10,1,76.69,6.4,0,0,0,0,0,0,0.00225619434549033,0.863759215451108,0.244934400057224
8.7,"random_policy_SVM","SVM",36,30,812,809,3,3100,2695,405,0.933493064892383,0.626262626262626,1.78127177943185,799,390,409,7,1,79.24,6.7,0,0,0,0,0,0,0.00190473941723105,0.664515319708186,0.213206070254086
8.7,"random_policy_SVM","SVM",36,31,712,709,3,3200,2795,405,0.933734385952817,0.626262626262626,1.77636919655268,801,390,411,2,1.1,81.8,6.9,0,0,0,0,0,0,0.00150891039113743,0.483735973907069,0.17472611481255
8.7,"random_policy_SVM","SVM",36,32,612,609,3,3300,2895,405,0.933768860390021,0.626262626262626,1.78127177943185,801,390,411,0,1.1,84.36,7.1,0,0,0,0,0,0,0.00106605087567859,0.326783797332336,0.132282121050819
8.7,"random_policy_SVM","SVM",36,33,512,510,2,3400,2994,406,0.934150952069041,0.636363636363636,1.78127177943185,805,394,411,4,1,86.91,7.4,0,0,0,0,0,0,0.00082430250924846,0.262184397602149,0.108005239923872
8.7,"random_policy_SVM","SVM",36,34,412,411,1,3500,3093,407,0.934584755403868,0.636363636363636,1.77963458110517,809,395,414,4,1,89.47,7.6,0,0,0,0,0,0,0.000621816083645982,0.185914910686483,0.0774528866812765
8.7,"random_policy_SVM","SVM",36,35,312,312,0,3600,3192,408,0.934834695073604,0.631313131313131,1.78127177943185,814,400,414,5,1,92.02,7.8,0,0,0,0,0,0,0.000538676943595184,0.134928228440078,0.0639249950546917
8.7,"random_policy_SVM","SVM",36,36,212,212,0,3700,3292,408,0.934870605945692,0.636363636363636,1.79200848261622,816,402,414,2,1,94.58,8.1,0,0,0,0,0,0,0.000228256475360271,0.049360675724266,0.0308171587701588
8.7,"random_policy_SVM","SVM",36,37,112,112,0,3800,3392,408,0.935098999092174,0.636363636363636,1.78871434937611,819,402,417,3,1,97.14,8.3,0,0,0,0,0,0,0.000120478417964079,0.0182349545107494,0.0169509792570209
8.7,"random_policy_SVM","SVM",36,38,12,12,0,3900,3492,408,0.935432251985154,0.636363636363636,1.78543230469836,822,404,418,3,1,99.69,8.6,0,0,0,0,0,0,8.14450582523984e-05,0.00113509651861276,0.00113509651861276
8.7,"random_policy_SVM","SVM",36,39,0,0,0,3912,3504,408,0.935380540329347,0.636363636363636,1.79200848261622,822,404,418,0,1,100,8.6,0,0,0,0,0,0,0,0,0
8.7,"random_policy_SVM","SVM",37,0,3812,3417,395,100,89,11,0.900808656036458,0.505,1.75769585253456,33,11,22,0,2,2.56,8.1,0,0,0,0,0,0,0.26322907211477,405.478133580062,30.8796965028928
8.7,"random_policy_SVM","SVM",37,1,3712,3382,330,200,124,76,0.922423120728938,0.595,1.76508287292818,106,52,54,73,1,5.11,1.6,0,0,0,0,0,0,0.687149140269114,355.233126055567,76.5888581244366
8.7,"random_policy_SVM","SVM",37,2,3612,3340,272,300,166,134,0.924664009111634,0.61,1.76183823529412,186,93,93,80,1,7.67,1.2,0,0,0,0,0,0,0.581747118169041,286.731736725582,71.2429955039523
8.7,"random_policy_SVM","SVM",37,3,3512,3297,215,400,209,191,0.930247722095685,0.665,1.77818181818182,260,132,128,74,1,10.22,1.1,0,0,0,0,0,0,0.424036871402672,249.609246401616,61.178668422867
8.7,"random_policy_SVM","SVM",37,4,3412,3253,159,500,253,247,0.898149202733479,0.625,1.66143250688705,343,172,171,83,1,12.78,1,0,0,0,0,0,0,0.297531525713102,276.917008448822,43.115265564742
8.7,"random_policy_SVM","SVM",37,5,3312,3191,121,600,315,285,0.921954726651485,0.68,1.72005524861878,416,206,210,73,1,15.34,1.1,0,0,0,0,0,0,0.165683349520653,166.651713435528,26.5218887752485
8.7,"random_policy_SVM","SVM",37,6,3212,3117,95,700,389,311,0.904547266514798,0.68,1.64649494020239,485,235,250,69,1.1,17.89,1.3,0,0,0,0,0,0,0.117507812905132,176.557442930259,15.298999998411
8.7,"random_policy_SVM","SVM",37,7,3112,3031,81,800,475,325,0.907447323462411,0.685,1.65397058823529,527,249,278,42,1.1,20.45,1.5,0,0,0,0,0,0,0.0889426343870839,139.784531428337,10.3385131633938
8.7,"random_policy_SVM","SVM",37,8,3012,2939,73,900,567,333,0.915025626423697,0.69,1.6809375,544,260,284,17,1.1,23.01,1.7,0,0,0,0,0,0,0.0681301346061182,109.965151003941,7.46980475161555
8.7,"random_policy_SVM","SVM",37,9,2912,2847,65,1000,659,341,0.929695330296133,0.67,1.73010082493126,571,277,294,27,1.1,25.56,1.9,0,0,0,0,0,0,0.0657622128438462,97.8733082623918,7.51763108481908
8.7,"random_policy_SVM","SVM",37,10,2812,2760,52,1100,746,354,0.941563211845117,0.67,1.75446182152714,608,295,313,37,1.1,28.12,2.1,0,0,0,0,0,0,0.0896681291988566,116.980588808565,10.3637975087785
8.7,"random_policy_SVM","SVM",37,11,2712,2666,46,1200,840,360,0.943801252847399,0.66,1.76508287292818,631,307,324,23,1.1,30.67,2.3,0,0,0,0,0,0,0.0706048417782611,81.4486409734874,7.98277995998835
8.7,"random_policy_SVM","SVM",37,12,2612,2574,38,1300,932,368,0.946359624145798,0.665,1.76508287292818,654,315,339,23,1.1,33.23,2.5,0,0,0,0,0,0,0.0683046162062989,74.3886984095208,7.38574090774824
8.7,"random_policy_SVM","SVM",37,13,2512,2475,37,1400,1031,369,0.946571753986345,0.665,1.76508287292818,659,317,342,5,1.1,35.79,2.8,0,0,0,0,0,0,0.0560814123747817,55.9319316793223,5.98688365366506
8.7,"random_policy_SVM","SVM",37,14,2412,2378,34,1500,1128,372,0.946665717539874,0.665,1.77082720588235,665,321,344,6,1.1,38.34,3,0,0,0,0,0,0,0.0522331135482422,49.6216235588586,5.79774916586787
8.7,"random_policy_SVM","SVM",37,15,2312,2287,25,1600,1219,381,0.946296981776776,0.66,1.77408839779006,696,331,365,31,1.1,40.9,3.2,0,0,0,0,0,0,0.0489176946662061,46.6049888146239,6.2597691446665
8.7,"random_policy_SVM","SVM",37,16,2212,2196,16,1700,1310,390,0.945102505694775,0.65,1.76345906163753,723,341,382,27,1.1,43.46,3.4,0,0,0,0,0,0,0.0418999606249309,46.2641241699037,5.07491939442065
8.7,"random_policy_SVM","SVM",37,17,2112,2099,13,1800,1407,393,0.945512528473824,0.66,1.76345906163753,724,344,380,1,1.1,46.01,3.6,0,0,0,0,0,0,0.0384984047925595,40.3115750356105,3.95929395160055
8.7,"random_policy_SVM","SVM",37,18,2012,2000,12,1900,1506,394,0.944285307517096,0.645,1.77981617647059,754,363,391,30,1.1,48.57,3.8,0,0,0,0,0,0,0.0275316420146199,20.6332633948166,3.6206230116821
8.7,"random_policy_SVM","SVM",37,19,1912,1901,11,2000,1605,395,0.944179954441924,0.645,1.78145354185833,754,363,391,0,1.1,51.12,4.1,0,0,0,0,0,0,0.01819815796695,15.3653419756168,2.16686530272022
8.7,"random_policy_SVM","SVM",37,20,1812,1802,10,2100,1704,396,0.94380837129841,0.645,1.77408839779006,758,365,393,4,1.1,53.68,4.3,0,0,0,0,0,0,0.014774930832412,13.1331056182041,1.63561815570843
8.7,"random_policy_SVM","SVM",37,21,1712,1704,8,2200,1802,398,0.944266799544421,0.645,1.77082720588235,762,369,393,4,1.1,56.24,4.5,0,0,0,0,0,0,0.0135816660268207,11.347560746879,1.41966621222709
8.7,"random_policy_SVM","SVM",37,22,1612,1606,6,2300,1900,400,0.94455580865604,0.65,1.78880514705882,789,378,411,27,1.1,58.79,4.8,0,0,0,0,0,0,0.00958903830435451,7.56489212929609,1.17128840520447
8.7,"random_policy_SVM","SVM",37,23,1512,1507,5,2400,1999,401,0.944356492027339,0.645,1.78716253443526,793,381,412,4,1.1,61.35,5,0,0,0,0,0,0,0.0106883462793073,7.62826753765246,1.09398780971017
8.7,"random_policy_SVM","SVM",37,24,1412,1407,5,2500,2099,401,0.943895216400917,0.64,1.78880514705882,800,387,413,7,1.1,63.91,5.2,0,0,0,0,0,0,0.00704491750268263,4.61126059870922,0.804187439804965
8.7,"random_policy_SVM","SVM",37,25,1312,1307,5,2600,2199,401,0.943977790432808,0.64,1.79045078196872,799,386,413,-1,1.1,66.46,5.5,0,0,0,0,0,0,0.00586558660122373,3.55236953514885,0.612659484590355
8.7,"random_policy_SVM","SVM",37,26,1212,1207,5,2700,2299,401,0.944128701594538,0.635,1.79375115207373,799,389,410,0,1.1,69.02,5.7,0,0,0,0,0,0,0.00506018506632263,2.86364461135403,0.540558681691344
8.7,"random_policy_SVM","SVM",37,27,1112,1108,4,2800,2398,402,0.94451879271071,0.635,1.78388634280477,800,390,410,1,1.1,71.57,6,0,0,0,0,0,0,0.00478168593231811,2.42321099431939,0.500792006201348
8.7,"random_policy_SVM","SVM",37,28,1012,1008,4,2900,2498,402,0.94449886104784,0.635,1.79209944751381,803,392,411,3,1,74.13,6.2,0,0,0,0,0,0,0.00406950744383337,1.86471117305509,0.438746816238952
8.7,"random_policy_SVM","SVM",37,29,912,909,3,3000,2597,403,0.944709567198181,0.635,1.78716253443526,810,394,416,7,1.1,76.69,6.4,0,0,0,0,0,0,0.003331763616715,1.38270750636468,0.363265519381098
8.7,"random_policy_SVM","SVM",37,30,812,809,3,3100,2697,403,0.944733769931666,0.635,1.79209944751381,808,394,414,-2,1.1,79.24,6.7,0,0,0,0,0,0,0.00253299230779708,0.955356860420768,0.283781127296128
8.7,"random_policy_SVM","SVM",37,31,712,710,2,3200,2796,404,0.94479498861048,0.635,1.79375115207373,814,395,419,6,1.1,81.8,6.9,0,0,0,0,0,0,0.00204169361629027,0.692862325421656,0.228528115451342
8.7,"random_policy_SVM","SVM",37,32,612,610,2,3300,2896,404,0.94473804100228,0.64,1.79045078196872,814,395,419,0,1.1,84.36,7.2,0,0,0,0,0,0,0.00155476801983243,0.485574235947048,0.182650649379847
8.7,"random_policy_SVM","SVM",37,33,512,510,2,3400,2996,404,0.944730922551254,0.64,1.79209944751381,814,396,418,0,1.1,86.91,7.4,0,0,0,0,0,0,0.000981441358322127,0.288278295886163,0.124742493146897
8.7,"random_policy_SVM","SVM",37,34,412,411,1,3500,3095,405,0.94484339407745,0.64,1.79045078196872,816,397,419,2,1.1,89.47,7.6,0,0,0,0,0,0,0.000843594823369194,0.243314361315033,0.10929100536774
8.7,"random_policy_SVM","SVM",37,35,312,312,0,3600,3194,406,0.945472665148065,0.635,1.79045078196872,822,402,420,6,1,92.02,7.9,0,0,0,0,0,0,0.000596566279659684,0.145166200728434,0.0741887360314959
8.7,"random_policy_SVM","SVM",37,36,212,212,0,3700,3294,406,0.945498291571755,0.635,1.79045078196872,826,402,424,4,1.1,94.58,8.1,0,0,0,0,0,0,0.000226026066245717,0.051607675320245,0.0336324495184842
8.7,"random_policy_SVM","SVM",37,37,112,112,0,3800,3394,406,0.945666287015946,0.635,1.80276497695853,829,402,427,3,1.1,97.14,8.4,0,0,0,0,0,0,0.000106115835884754,0.0188720718903835,0.0177209231666599
8.7,"random_policy_SVM","SVM",37,38,12,12,0,3900,3494,406,0.945881264236903,0.63,1.79779411764706,833,404,429,4,1.1,99.69,8.6,0,0,0,0,0,0,6.05760693431588e-05,0.000880641453370743,0.000880641453370743
8.7,"random_policy_SVM","SVM",37,39,0,0,0,3912,3506,406,0.945802961275627,0.63,1.80110497237569,835,404,431,2,1.1,100,8.6,0,0,0,0,0,0,0,0,0
8.7,"random_policy_SVM","SVM",38,0,3812,3418,394,100,91,9,0.90675520360593,0.551724137931034,1.75836189870832,23,9,14,0,1.6,2.56,10.1,0,0,0,0,0,0,0.345760198404571,319.15800283929,38.7181480056156
8.7,"random_policy_SVM","SVM",38,1,3712,3391,321,200,118,82,0.919563647399677,0.596059113300493,1.76075126545346,87,46,41,64,0.9,5.11,1.4,0,0,0,0,0,0,0.712664024832911,261.18167834874,80.0343431164944
8.7,"random_policy_SVM","SVM",38,2,3612,3337,275,300,172,128,0.89980301186706,0.591133004926108,1.69619758915802,166,83,83,79,1,7.67,1.3,0,0,0,0,0,0,0.427361057538058,153.484009875417,67.551683589112
8.7,"random_policy_SVM","SVM",38,3,3512,3292,220,400,217,183,0.907764030135535,0.610837438423645,1.74626236625412,245,124,121,79,1,10.22,1.2,0,0,0,0,0,0,0.183116677696182,77.1119465811273,42.472084268265
8.7,"random_policy_SVM","SVM",38,4,3412,3244,168,500,265,235,0.886025082968258,0.625615763546798,1.67843635785794,323,161,162,78,1,12.78,1.1,0,0,0,0,0,0,0.147577040639659,79.5994004192346,25.7677962441648
8.7,"random_policy_SVM","SVM",38,5,3312,3181,131,600,328,272,0.895899780531062,0.640394088669951,1.68111929867416,400,198,202,77,1,15.34,1.2,0,0,0,0,0,0,0.0912417386123348,55.232529575183,15.1189627044819
8.7,"random_policy_SVM","SVM",38,6,3212,3104,108,700,405,295,0.892162345198506,0.660098522167488,1.64140108319952,452,219,233,52,1.1,17.89,1.4,0,0,0,0,0,0,0.0675657881204477,55.5436040153383,10.7856380716268
8.7,"random_policy_SVM","SVM",38,7,3112,3030,82,800,479,321,0.895003358071594,0.669950738916256,1.63989105460412,514,245,269,62,1.1,20.45,1.5,0,0,0,0,0,0,0.0709481233815709,92.8708325771608,10.6520906300385
8.7,"random_policy_SVM","SVM",38,8,3012,2942,70,900,567,333,0.902596253010331,0.689655172413793,1.65027352148709,546,261,285,32,1.1,23.01,1.7,0,0,0,0,0,0,0.048168168150852,63.9130134806387,5.93109898312613
8.7,"random_policy_SVM","SVM",38,9,2912,2859,53,1000,650,350,0.911765615032941,0.684729064039409,1.68421243445829,583,279,304,37,1.1,25.56,1.9,0,0,0,0,0,0,0.0746361201386561,120.516051563329,9.53278461746919
8.7,"random_policy_SVM","SVM",38,10,2812,2765,47,1100,744,356,0.922505823935896,0.694581280788177,1.7003767024051,611,295,316,28,1.1,28.12,2.1,0,0,0,0,0,0,0.0705358915518761,98.4552211282577,8.19411926230259
8.7,"random_policy_SVM","SVM",38,11,2712,2668,44,1200,841,359,0.931589477855021,0.689655172413793,1.72694508838018,635,304,331,24,1.1,30.67,2.3,0,0,0,0,0,0,0.0594870219126327,75.6468481314896,6.49787988189504
8.7,"random_policy_SVM","SVM",38,12,2612,2576,36,1300,933,367,0.937902371444901,0.679802955665025,1.74626236625412,654,313,341,19,1.1,33.23,2.5,0,0,0,0,0,0,0.0594559294266518,65.2546067151987,6.5179497490729
8.7,"random_policy_SVM","SVM",38,13,2512,2480,32,1400,1029,371,0.940399146853142,0.679802955665025,1.76561521922543,664,317,347,10,1.1,35.79,2.8,0,0,0,0,0,0,0.0557487031451328,58.8632029373331,6.02400585401436
8.7,"random_policy_SVM","SVM",38,14,2412,2385,27,1500,1124,376,0.942229928145733,0.684729064039409,1.76399091819578,669,322,347,5,1.1,38.34,3,0,0,0,0,0,0,0.059847403016999,57.04603950564,6.44278264446228
8.7,"random_policy_SVM","SVM",38,15,2312,2291,21,1600,1218,382,0.94248283730357,0.684729064039409,1.76399091819578,696,330,366,27,1.1,40.9,3.2,0,0,0,0,0,0,0.0587905713105809,50.379855317493,6.70824995201441
8.7,"random_policy_SVM","SVM",38,16,2212,2196,16,1700,1313,387,0.942079587701898,0.684729064039409,1.76236960301362,712,334,378,16,1.1,43.46,3.4,0,0,0,0,0,0,0.0419686071589772,46.2359227924031,5.30687304381102
8.7,"random_policy_SVM","SVM",38,17,2112,2098,14,1800,1411,389,0.941755020949333,0.684729064039409,1.76399091819578,717,336,381,5,1.1,46.01,3.6,0,0,0,0,0,0,0.0360346987007629,37.8117425864943,3.70075765597324
8.7,"random_policy_SVM","SVM",38,18,2012,1998,14,1900,1511,389,0.942246788756249,0.669950738916256,1.77518704311586,737,356,381,20,1.1,48.57,3.9,0,0,0,0,0,0,0.0242541978817597,17.5238050896071,3.19695174338561
8.7,"random_policy_SVM","SVM",38,19,1912,1900,12,2000,1609,391,0.942324066554479,0.669950738916256,1.7889379889887,740,357,383,3,1.1,51.12,4.1,0,0,0,0,0,0,0.0160673322048516,13.5305607198505,1.97409698075615
8.7,"random_policy_SVM","SVM",38,20,1812,1801,11,2100,1708,392,0.942134384686099,0.669950738916256,1.7735614139555,745,358,387,5,1.1,53.68,4.4,0,0,0,0,0,0,0.0145138819563743,12.9601494548538,1.61004500988449
8.7,"random_policy_SVM","SVM",38,21,1712,1702,10,2200,1807,393,0.942241168552742,0.67487684729064,1.78565553396303,747,360,387,2,1.1,56.24,4.6,0,0,0,0,0,0,0.0119417514118936,10.3204107670796,1.25230709460967
8.7,"random_policy_SVM","SVM",38,22,1612,1604,8,2300,1905,395,0.941742375491443,0.669950738916256,1.78565553396303,756,364,392,9,1.1,58.79,4.8,0,0,0,0,0,0,0.0124863728739082,9.99606748162983,1.27394125107325
8.7,"random_policy_SVM","SVM",38,23,1512,1505,7,2400,2004,396,0.941013154086331,0.655172413793103,1.79058374610828,770,373,397,14,1.1,61.35,5.1,0,0,0,0,0,0,0.00885680483513237,6.19889316024581,1.08751711407554
8.7,"random_policy_SVM","SVM",38,24,1412,1406,6,2500,2103,397,0.941277303651187,0.655172413793103,1.79058374610828,771,374,397,1,1.1,63.91,5.3,0,0,0,0,0,0,0.0075909096790934,5.15279401816564,0.806312302095725
8.7,"random_policy_SVM","SVM",38,25,1312,1306,6,2600,2203,397,0.940951331847748,0.650246305418719,1.79388436130848,779,379,400,8,1.1,66.46,5.5,0,0,0,0,0,0,0.00650034362870736,4.20824579681794,0.720721065135511
8.7,"random_policy_SVM","SVM",38,26,1212,1206,6,2700,2303,397,0.940878269202149,0.650246305418719,1.79223253408813,777,379,398,-2,1.1,69.02,5.8,0,0,0,0,0,0,0.00586806874771683,3.27230503136177,0.599932667169191
8.7,"random_policy_SVM","SVM",38,27,1112,1106,6,2800,2403,397,0.940845953031981,0.650246305418719,1.79223253408813,781,381,400,4,1,71.57,6.1,0,0,0,0,0,0,0.00421580279105644,2.09940734326734,0.466333442134453
8.7,"random_policy_SVM","SVM",38,28,1012,1007,5,2900,2502,398,0.941097457138943,0.650246305418719,1.7889379889887,782,382,400,1,1,74.13,6.3,0,0,0,0,0,0,0.00407830860438012,1.79029761020068,0.428130560884534
8.7,"random_policy_SVM","SVM",38,29,912,907,5,3000,2602,398,0.941024394493344,0.650246305418719,1.79058374610828,787,385,402,5,1,76.69,6.5,0,0,0,0,0,0,0.00323301032935866,1.22839459839249,0.349471762846371
8.7,"random_policy_SVM","SVM",38,30,812,808,4,3100,2701,399,0.941104482393325,0.650246305418719,1.79223253408813,789,387,402,2,1,79.24,6.8,0,0,0,0,0,0,0.00282229983619656,0.957948064996988,0.315197620250106
8.7,"random_policy_SVM","SVM",38,31,712,709,3,3200,2800,400,0.941111507647707,0.640394088669951,1.7889379889887,794,388,406,5,1,81.8,7,0,0,0,0,0,0,0.00216789672947705,0.681832064689044,0.256578815037952
8.7,"random_policy_SVM","SVM",38,32,612,609,3,3300,2900,400,0.94124920263364,0.645320197044335,1.79388436130848,794,388,406,0,1,84.36,7.2,0,0,0,0,0,0,0.00152349804559955,0.457394360152987,0.192408838578726
8.7,"random_policy_SVM","SVM",38,33,512,509,3,3400,3000,400,0.941586414844092,0.645320197044335,1.79058374610828,795,388,407,1,1,86.91,7.5,0,0,0,0,0,0,0.000811179548268448,0.247347814599185,0.11050495888531
8.7,"random_policy_SVM","SVM",38,34,412,412,0,3500,3097,403,0.942345142317609,0.640394088669951,1.78729525437989,807,394,413,12,1,89.47,7.7,0,0,0,0,0,0,0.000953961859753331,0.280915464871587,0.118939349896407
8.7,"random_policy_SVM","SVM",38,35,312,312,0,3600,3197,403,0.942536229236863,0.640394088669951,1.79388436130848,813,394,419,6,1.1,92.02,7.9,0,0,0,0,0,0,0.000595091288335017,0.145656381684641,0.0729195625687263
8.7,"random_policy_SVM","SVM",38,36,212,212,0,3700,3297,403,0.942918403075375,0.640394088669951,1.79223253408813,818,397,421,5,1.1,94.58,8.2,0,0,0,0,0,0,0.000322584898937449,0.0685796291951751,0.043380027436413
8.7,"random_policy_SVM","SVM",38,37,112,112,0,3800,3397,403,0.943221894064781,0.640394088669951,1.79388436130848,817,398,419,-1,1.1,97.14,8.4,0,0,0,0,0,0,0.00012717110065307,0.0205423658924222,0.0191621508644092
8.7,"random_policy_SVM","SVM",38,38,12,12,0,3900,3497,403,0.943365209254224,0.640394088669951,1.79388436130848,816,398,418,-1,1.1,99.69,8.7,0,0,0,0,0,0,9.40181217128504e-05,0.00133347262214677,0.00133347262214677
8.7,"random_policy_SVM","SVM",38,39,0,0,0,3912,3509,403,0.943396120373515,0.640394088669951,1.79388436130848,816,398,418,0,1.1,100,8.7,0,0,0,0,0,0,0,0,0
8.7,"random_policy_SVM","SVM",39,0,3812,3413,399,100,90,10,0.870981146994559,0.49746192893401,1.69295188191537,30,10,20,0,2,2.56,9,0,0,0,0,0,0,0.176498268652868,377.576770250191,19.3456102049907
8.7,"random_policy_SVM","SVM",39,1,3712,3366,346,200,137,63,0.903256060925246,0.573604060913706,1.70496846638979,113,55,58,83,1.1,5.11,2.2,0,0,0,0,0,0,0.671963785634744,382.565358655871,73.7402386918189
8.7,"random_policy_SVM","SVM",39,2,3612,3323,289,300,180,120,0.90271352839494,0.583756345177665,1.72955624692975,188,93,95,75,1,7.67,1.5,0,0,0,0,0,0,0.603202853272453,294.33350766715,71.7925944474133
8.7,"random_policy_SVM","SVM",39,3,3512,3288,224,400,215,185,0.923142186810089,0.629441624365482,1.78702577225881,259,134,125,71,0.9,10.22,1.2,0,0,0,0,0,0,0.464324184099418,209.852035986244,65.1840114499047
8.7,"random_policy_SVM","SVM",39,4,3412,3251,161,500,252,248,0.900771377368884,0.614213197969543,1.69119205667429,320,164,156,61,1,12.78,1,0,0,0,0,0,0,0.318465451099733,210.64749032419,48.3033651605243
8.7,"random_policy_SVM","SVM",39,5,3312,3185,127,600,318,282,0.929418826455955,0.649746192893401,1.76291100640238,401,197,204,81,1,15.34,1.1,0,0,0,0,0,0,0.167128206394916,130.624809592683,28.403829913207
8.7,"random_policy_SVM","SVM",39,6,3212,3114,98,700,389,311,0.922136481561105,0.67005076142132,1.71566139146014,463,227,236,62,1,17.89,1.3,0,0,0,0,0,0,0.100467371750026,99.8140058586324,13.2192244807962
8.7,"random_policy_SVM","SVM",39,7,3112,3027,85,800,476,324,0.917035810032806,0.680203045685279,1.69585098795989,498,242,256,35,1.1,20.45,1.5,0,0,0,0,0,0,0.0784259516717459,101.332523215043,9.42750987320053
8.7,"random_policy_SVM","SVM",39,8,3012,2944,68,900,559,341,0.909861683062878,0.685279187817259,1.67156846721055,540,259,281,42,1.1,23.01,1.6,0,0,0,0,0,0,0.0857516894910023,148.629776648876,12.4780187256328
8.7,"random_policy_SVM","SVM",39,9,2912,2853,59,1000,650,350,0.919526265211828,0.6751269035533,1.70967832403175,571,276,295,31,1.1,25.56,1.9,0,0,0,0,0,0,0.0607080187915008,94.9920380158542,6.94378597339287
8.7,"random_policy_SVM","SVM",39,10,2812,2759,53,1100,744,356,0.927521405505545,0.680203045685279,1.70967832403175,594,288,306,23,1.1,28.12,2.1,0,0,0,0,0,0,0.0493658746256685,71.9556732131322,5.57972414037063
8.7,"random_policy_SVM","SVM",39,11,2712,2664,48,1200,839,361,0.93067704019646,0.680203045685279,1.72637399072565,605,293,312,11,1.1,30.67,2.3,0,0,0,0,0,0,0.0490072241728496,70.3690602299184,5.2716434232838
8.7,"random_policy_SVM","SVM",39,12,2612,2574,38,1300,929,371,0.940881269064389,0.67005076142132,1.76291100640238,636,308,328,31,1.1,33.23,2.5,0,0,0,0,0,0,0.063590782642813,70.677845150428,7.52300558881472
8.7,"random_policy_SVM","SVM",39,13,2512,2475,37,1400,1028,372,0.943497257036325,0.67005076142132,1.77041654225142,645,311,334,9,1.1,35.79,2.8,0,0,0,0,0,0,0.0511244455203327,57.7887771048717,5.67636923383158
8.7,"random_policy_SVM","SVM",39,14,2412,2378,34,1500,1125,375,0.945917009837725,0.67005076142132,1.77954240071663,654,317,337,9,1.1,38.34,3,0,0,0,0,0,0,0.0444364700210312,48.3192244365915,4.77309943856519
8.7,"random_policy_SVM","SVM",39,15,2312,2281,31,1600,1222,378,0.947284884408821,0.67005076142132,1.79031376815993,662,321,341,8,1.1,40.9,3.2,0,0,0,0,0,0,0.039725081863062,42.3828854034664,4.4804140286645
8.7,"random_policy_SVM","SVM",39,16,2212,2186,26,1700,1317,383,0.948599371470283,0.66497461928934,1.7919623075413,679,327,352,17,1.1,43.46,3.4,0,0,0,0,0,0,0.0403664916384968,40.1617001053744,4.93750094577604
8.7,"random_policy_SVM","SVM",39,17,2112,2090,22,1800,1413,387,0.950118751136279,0.65989847715736,1.79361388570493,691,330,361,12,1.1,46.01,3.7,0,0,0,0,0,0,0.0338415739309696,34.3112678656268,3.84882297746043
8.7,"random_policy_SVM","SVM",39,18,2012,1995,17,1900,1508,392,0.950473705930043,0.654822335025381,1.79031376815993,709,338,371,18,1.1,48.57,3.8,0,0,0,0,0,0,0.0317937752301365,32.09935138007,3.49902021422215
8.7,"random_policy_SVM","SVM",39,19,1912,1896,16,2000,1607,393,0.950167809928912,0.654822335025381,1.79031376815993,711,341,370,2,1.1,51.12,4.1,0,0,0,0,0,0,0.0268460698934744,24.7144928637663,2.7331292869592
8.7,"random_policy_SVM","SVM",39,20,1812,1796,16,2100,1707,393,0.947062676936299,0.649746192893401,1.79361388570493,726,354,372,15,1.1,53.68,4.3,0,0,0,0,0,0,0.0192278973933921,12.9523089408271,2.40737022130911
8.7,"random_policy_SVM","SVM",39,21,1712,1698,14,2200,1805,395,0.947004960709671,0.649746192893401,1.78866825918185,731,356,375,5,1.1,56.24,4.6,0,0,0,0,0,0,0.0127643995944126,10.6961568127531,1.58188083698086
8.7,"random_policy_SVM","SVM",39,22,1612,1602,10,2300,1901,399,0.947258912106835,0.649746192893401,1.79361388570493,743,361,382,12,1.1,58.79,4.8,0,0,0,0,0,0,0.0129211856463222,10.0956090327229,1.31105741719805
8.7,"random_policy_SVM","SVM",39,23,1512,1502,10,2400,2001,399,0.94660960455727,0.639593908629442,1.79031376815993,764,372,392,21,1.1,61.35,5,0,0,0,0,0,0,0.00966239456092751,6.30523940733159,1.2087048677322
8.7,"random_policy_SVM","SVM",39,24,1412,1403,9,2500,2100,400,0.946583632255287,0.639593908629442,1.79361388570493,765,373,392,1,1.1,63.91,5.2,0,0,0,0,0,0,0.00786036972950604,5.6578557579351,0.892103947801204
8.7,"random_policy_SVM","SVM",39,25,1312,1303,9,2600,2200,400,0.946762552557836,0.639593908629442,1.79361388570493,766,373,393,1,1.1,66.46,5.5,0,0,0,0,0,0,0.00620963634849234,4.18801222409717,0.651994163162699
8.7,"random_policy_SVM","SVM",39,26,1212,1205,7,2700,2298,402,0.947429174975396,0.644670050761421,1.79361388570493,775,378,397,9,1.1,69.02,5.7,0,0,0,0,0,0,0.00663569056455843,4.15748134871529,0.694541485043642
8.7,"random_policy_SVM","SVM",39,27,1112,1106,6,2800,2397,403,0.94838726433743,0.644670050761421,1.79944802207912,782,380,402,7,1.1,71.57,5.9,0,0,0,0,0,0,0.00494120482748377,2.80919309489912,0.539384850948128
8.7,"random_policy_SVM","SVM",39,28,1012,1006,6,2900,2497,403,0.948433437318733,0.644670050761421,1.79944802207912,782,380,402,0,1.1,74.13,6.2,0,0,0,0,0,0,0.00470365483523299,2.28912260407345,0.486713239485441
8.7,"random_policy_SVM","SVM",39,29,912,908,4,3000,2595,405,0.948941340113064,0.639593908629442,1.79614325068871,790,387,403,8,1,76.69,6.4,0,0,0,0,0,0,0.00420030324635641,1.8045325387404,0.459331753568963
8.7,"random_policy_SVM","SVM",39,30,812,809,3,3100,2694,406,0.948974526943375,0.639593908629442,1.79779411764706,796,390,406,6,1,79.24,6.6,0,0,0,0,0,0,0.00369517197663689,1.44650942566505,0.4092195906493
8.7,"random_policy_SVM","SVM",39,31,712,709,3,3200,2794,406,0.949091402302298,0.639593908629442,1.79944802207912,797,389,408,1,1,81.8,6.9,0,0,0,0,0,0,0.00278760969629503,0.987238886351883,0.319338395548149
8.7,"random_policy_SVM","SVM",39,32,612,609,3,3300,2894,406,0.949089959396632,0.639593908629442,1.79779411764706,799,389,410,2,1.1,84.36,7.1,0,0,0,0,0,0,0.00203138568127644,0.692579402687421,0.245406096732341
8.7,"random_policy_SVM","SVM",39,33,512,509,3,3400,2994,406,0.949219820906546,0.639593908629442,1.80110497237569,801,390,411,2,1.1,86.91,7.4,0,0,0,0,0,0,0.00144743130237773,0.474130895582563,0.1774622181371
8.7,"random_policy_SVM","SVM",39,34,412,411,1,3500,3092,408,0.950263041702857,0.639593908629442,1.79944802207912,810,395,415,9,1.1,89.47,7.6,0,0,0,0,0,0,0.0014596645220024,0.440466898854939,0.17993336285685
8.7,"random_policy_SVM","SVM",39,35,312,312,0,3600,3191,409,0.950459276873395,0.639593908629442,1.80276497695853,820,398,422,10,1.1,92.02,7.8,0,0,0,0,0,0,0.00134946518269187,0.35288490474053,0.166043958338881
8.7,"random_policy_SVM","SVM",39,36,212,212,0,3700,3291,409,0.950361159288126,0.639593908629442,1.79944802207912,823,398,425,3,1.1,94.58,8,0,0,0,0,0,0,0.000881360555332685,0.187582456379745,0.112231014105179
8.7,"random_policy_SVM","SVM",39,37,112,112,0,3800,3391,409,0.950252941363197,0.639593908629442,1.80110497237569,827,401,426,4,1.1,97.14,8.3,0,0,0,0,0,0,0.000477115301380796,0.07095390106155,0.0657471442853759
8.7,"random_policy_SVM","SVM",39,38,12,12,0,3900,3491,409,0.950065363626655,0.639593908629442,1.79779411764706,830,402,428,3,1.1,99.69,8.5,0,0,0,0,0,0,0.000352936811659253,0.00473161967602039,0.00473161967602039
8.7,"random_policy_SVM","SVM",39,39,0,0,0,3912,3503,409,0.950032176796343,0.639593908629442,1.80276497695853,829,402,427,-1,1.1,100,8.6,0,0,0,0,0,0,0,0,0
8.7,"random_policy_SVM","SVM",40,0,3812,3413,399,100,92,8,0.902326086894346,0.557788944723618,1.72123289257347,20,8,12,0,1.5,2.56,11.5,0,0,0,0,0,0,0.256292674406765,287.34660918553,28.3491076034404
8.7,"random_policy_SVM","SVM",40,1,3712,3378,334,200,127,73,0.895007193051183,0.587939698492462,1.70588479588023,96,49,47,76,1,5.11,1.7,0,0,0,0,0,0,0.748579198462409,319.700776799108,83.2861126511282
8.7,"random_policy_SVM","SVM",40,2,3612,3335,277,300,170,130,0.889518737683854,0.557788944723618,1.71964796357478,168,85,83,72,1,7.67,1.3,0,0,0,0,0,0,0.588145214286318,216.172478802421,72.8823609346336
8.7,"random_policy_SVM","SVM",40,3,3512,3308,204,400,197,203,0.885939372445599,0.562814070351759,1.70154640606347,225,115,110,57,1,10.22,1,0,0,0,0,0,0,0.44337882772548,202.324706264246,64.0930425311703
8.7,"random_policy_SVM","SVM",40,4,3412,3260,152,500,245,255,0.845345109154194,0.592964824120603,1.55530180802818,309,154,155,84,1,12.78,1,0,0,0,0,0,0,0.233271056255528,151.589323378407,39.7244491651648
8.7,"random_policy_SVM","SVM",40,5,3312,3195,117,600,310,290,0.852515279871181,0.603015075376884,1.58388628223993,396,199,197,87,1,15.34,1.1,0,0,0,0,0,0,0.128580595483115,99.5704342720705,21.2056839538535
8.7,"random_policy_SVM","SVM",40,6,3212,3116,96,700,389,311,0.853534891303418,0.628140703517588,1.58388628223993,453,222,231,57,1,17.89,1.3,0,0,0,0,0,0,0.0751954714863248,72.5943711220614,12.288893352507
8.7,"random_policy_SVM","SVM",40,7,3112,3041,71,800,464,336,0.849533667197676,0.648241206030151,1.57483550348427,510,246,264,57,1.1,20.45,1.4,0,0,0,0,0,0,0.0750950774388015,96.9904796775763,10.2039231987966
8.7,"random_policy_SVM","SVM",40,8,3012,2946,66,900,559,341,0.860228862010683,0.64321608040201,1.58388628223993,521,254,267,11,1.1,23.01,1.6,0,0,0,0,0,0,0.0494072987920152,57.4674597152648,5.80899935560373
8.7,"random_policy_SVM","SVM",40,9,2912,2855,57,1000,650,350,0.876705668353142,0.64321608040201,1.6066004955909,541,262,279,20,1.1,25.56,1.9,0,0,0,0,0,0,0.048726423956735,70.6892084512099,5.89515344423046
8.7,"random_policy_SVM","SVM",40,10,2812,2767,45,1100,738,362,0.891291974957304,0.638190954773869,1.64875992867564,575,279,296,34,1.1,28.12,2,0,0,0,0,0,0,0.0465546367519623,69.8253191462243,5.79514603806179
8.7,"random_policy_SVM","SVM",40,11,2712,2678,34,1200,827,373,0.900235382947746,0.628140703517588,1.65476878412301,615,297,318,40,1.1,30.67,2.2,0,0,0,0,0,0,0.0631530966158172,80.2167880073008,7.31448964545571
8.7,"random_policy_SVM","SVM",40,12,2612,2580,32,1300,925,375,0.907355502612663,0.618090452261307,1.69249562730781,633,303,330,18,1.1,33.23,2.5,0,0,0,0,0,0,0.0489336474103055,59.6789027802655,5.46684324748573
8.7,"random_policy_SVM","SVM",40,13,2512,2482,30,1400,1023,377,0.910357135706985,0.613065326633166,1.70154640606347,636,306,330,3,1.1,35.79,2.7,0,0,0,0,0,0,0.0359129141839751,41.3753070643728,3.88924526113103
8.7,"random_policy_SVM","SVM",40,14,2412,2385,27,1500,1120,380,0.912823937559156,0.608040201005025,1.71964796357478,647,310,337,11,1.1,38.34,2.9,0,0,0,0,0,0,0.0321777920188518,36.4446043414081,3.49156267424824
8.7,"random_policy_SVM","SVM",40,15,2312,2287,25,1600,1218,382,0.914741607868577,0.608040201005025,1.7302920130607,654,313,341,7,1.1,40.9,3.2,0,0,0,0,0,0,0.0253051081529178,27.8001728608457,2.85582267146837
8.7,"random_policy_SVM","SVM",40,16,2212,2193,19,1700,1312,388,0.917563057175452,0.613065326633166,1.74358926987881,677,322,355,23,1.1,43.46,3.4,0,0,0,0,0,0,0.0268333078597021,28.1199866094207,3.48161047969691
8.7,"random_policy_SVM","SVM",40,17,2112,2099,13,1800,1406,394,0.917927714840559,0.613065326633166,1.74680029984175,696,330,366,19,1.1,46.01,3.6,0,0,0,0,0,0,0.0260569473174696,29.4646636697414,3.13920001521054
8.7,"random_policy_SVM","SVM",40,18,2012,2000,12,1900,1505,395,0.918223731062818,0.613065326633166,1.74680029984175,699,333,366,3,1.1,48.57,3.8,0,0,0,0,0,0,0.0209303762721873,23.6194956158276,2.24444247447364
8.7,"random_policy_SVM","SVM",40,19,1912,1900,12,2000,1605,395,0.917907694419722,0.613065326633166,1.74519330784558,701,335,366,2,1.1,51.12,4.1,0,0,0,0,0,0,0.016090131521432,17.3827171560647,1.74489588976858
8.7,"random_policy_SVM","SVM",40,20,1812,1800,12,2100,1705,395,0.917349982696624,0.608040201005025,1.75585107859741,707,344,363,6,1.1,53.68,4.3,0,0,0,0,0,0,0.0107266309702978,10.1432474498869,1.28941588712679
8.7,"random_policy_SVM","SVM",40,21,1712,1703,9,2200,1802,398,0.917916274600078,0.608040201005025,1.75262341117351,714,349,365,7,1,56.24,4.5,0,0,0,0,0,0,0.0101873788913766,9.91405893723505,1.07046181337633
8.7,"random_policy_SVM","SVM",40,22,1612,1604,8,2300,1901,399,0.91723844035201,0.597989949748744,1.75423576021783,723,355,368,9,1,58.79,4.8,0,0,0,0,0,0,0.00794840494504526,6.5998572965434,0.968195741012077
8.7,"random_policy_SVM","SVM",40,23,1512,1507,5,2400,1998,402,0.917424344259708,0.603015075376884,1.75101402328447,735,360,375,12,1,61.35,5,0,0,0,0,0,0,0.00769908401977629,6.79061503151078,0.879969141164072
8.7,"random_policy_SVM","SVM",40,24,1412,1408,4,2500,2097,403,0.918040687215242,0.592964824120603,1.75262341117351,751,367,384,16,1,63.91,5.2,0,0,0,0,0,0,0.00604712643401178,4.96500681654103,0.698211328466987
8.7,"random_policy_SVM","SVM",40,25,1312,1308,4,2600,2197,403,0.918010656583998,0.592964824120603,1.75101402328447,751,367,384,0,1,66.46,5.5,0,0,0,0,0,0,0.00552004140269991,4.1579485085134,0.564203211269609
8.7,"random_policy_SVM","SVM",40,26,1212,1208,4,2700,2297,403,0.918780012755869,0.592964824120603,1.75423576021783,763,373,390,12,1,69.02,5.7,0,0,0,0,0,0,0.00382042371735863,2.7025136097094,0.448736522554089
8.7,"random_policy_SVM","SVM",40,27,1112,1110,2,2800,2395,405,0.919557949108094,0.592964824120603,1.75746937452238,771,377,394,8,1,71.57,5.9,0,0,0,0,0,0,0.0041260082388186,2.72118175341465,0.428369120220287
8.7,"random_policy_SVM","SVM",40,28,1012,1010,2,2900,2495,405,0.919972657825277,0.592964824120603,1.75746937452238,777,381,396,6,1,74.13,6.2,0,0,0,0,0,0,0.00369504091296631,2.24899507406219,0.39969611829281
8.7,"random_policy_SVM","SVM",40,29,912,911,1,3000,2594,406,0.920985119107209,0.603015075376884,1.75423576021783,774,382,392,-3,1,76.69,6.4,0,0,0,0,0,0,0.00326345040595701,1.70972769659585,0.346781799120608
8.7,"random_policy_SVM","SVM",40,30,812,811,1,3100,2694,406,0.921073780970879,0.603015075376884,1.75423576021783,782,385,397,8,1,79.24,6.6,0,0,0,0,0,0,0.00276793352929841,1.33896913467909,0.301513113543369
8.7,"random_policy_SVM","SVM",40,31,712,712,0,3200,2793,407,0.92163149269398,0.603015075376884,1.75262341117351,785,386,399,3,1,81.8,6.9,0,0,0,0,0,0,0.00264397862414239,1.19272405018747,0.286517976509498
8.7,"random_policy_SVM","SVM",40,32,612,612,0,3300,2893,407,0.921874597804049,0.603015075376884,1.75423576021783,784,386,398,-1,1,84.36,7.1,0,0,0,0,0,0,0.00217331543380686,0.860883619246144,0.235134887474436
8.7,"random_policy_SVM","SVM",40,33,512,512,0,3400,2993,407,0.922014740749853,0.603015075376884,1.75262341117351,784,386,398,0,1,86.91,7.4,0,0,0,0,0,0,0.00174071183131065,0.60592574184534,0.190781277576065
8.7,"random_policy_SVM","SVM",40,34,412,412,0,3500,3093,407,0.922137723334947,0.603015075376884,1.75101402328447,789,387,402,5,1,89.47,7.6,0,0,0,0,0,0,0.00122291744336271,0.361976495842324,0.138716388751202
8.7,"random_policy_SVM","SVM",40,35,312,312,0,3600,3193,407,0.922349367783714,0.603015075376884,1.75746937452238,790,389,401,1,1,92.02,7.8,0,0,0,0,0,0,0.000944760582157817,0.235847970921532,0.113306820519009
8.7,"random_policy_SVM","SVM",40,36,212,212,0,3700,3293,407,0.922621073494966,0.597989949748744,1.75101402328447,791,390,401,1,1,94.58,8.1,0,0,0,0,0,0,0.000489927518542708,0.101513788260126,0.0624639050411048
8.7,"random_policy_SVM","SVM",40,37,112,112,0,3800,3393,407,0.92317020503771,0.597989949748744,1.75585107859741,792,391,401,1,1,97.14,8.3,0,0,0,0,0,0,0.000237525529079867,0.0378228703678042,0.0353729241483077
8.7,"random_policy_SVM","SVM",40,38,12,12,0,3900,3493,407,0.923913820668508,0.603015075376884,1.75423576021783,797,391,406,5,1,99.69,8.6,0,0,0,0,0,0,0.000155748438126524,0.00260067435985271,0.00260067435985271
8.7,"random_policy_SVM","SVM",40,39,0,0,0,3912,3505,407,0.923968161810759,0.603015075376884,1.75423576021783,797,391,406,0,1,100,8.6,0,0,0,0,0,0,0,0,0
8.7,"random_policy_SVM","SVM",41,0,3812,3423,389,100,90,10,0.880097115536009,0.516908212560386,1.69825686235223,28,10,18,0,1.8,2.56,9,0,0,0,0,0,0,0.367270340324376,346.0675698736,43.4052475384897
8.7,"random_policy_SVM","SVM",41,1,3712,3376,336,200,137,63,0.913098720317759,0.550724637681159,1.75436913895993,115,57,58,87,1,5.11,2.2,0,0,0,0,0,0,0.597772074696151,294.645806110025,69.0342742608483
8.7,"random_policy_SVM","SVM",41,2,3612,3342,270,300,171,129,0.909093671193754,0.565217391304348,1.7401980409427,180,91,89,65,1,7.67,1.3,0,0,0,0,0,0,0.592554463211512,226.074452042971,73.3037990629952
8.7,"random_policy_SVM","SVM",41,3,3512,3294,218,400,219,181,0.883820430169901,0.555555555555556,1.68954785280171,247,123,124,67,1,10.22,1.2,0,0,0,0,0,0,0.338175295013292,157.397369176785,55.1895234273497
8.7,"random_policy_SVM","SVM",41,4,3412,3247,165,500,266,234,0.9047709802427,0.579710144927536,1.72121115155394,324,162,162,77,1,12.78,1.1,0,0,0,0,0,0,0.156370702218413,84.4593093489388,30.603946254184
8.7,"random_policy_SVM","SVM",41,5,3312,3193,119,600,320,280,0.893689423631998,0.608695652173913,1.69669308991913,398,197,201,74,1,15.34,1.1,0,0,0,0,0,0,0.12692119670906,79.9978552522049,19.9513660242642
8.7,"random_policy_SVM","SVM",41,6,3212,3108,104,700,405,295,0.901705046085689,0.618357487922705,1.66751918158568,432,212,220,34,1,17.89,1.4,0,0,0,0,0,0,0.0729367246979141,48.2303172246703,10.0301846725404
8.7,"random_policy_SVM","SVM",41,7,3112,3028,84,800,485,315,0.89183881472643,0.628019323671498,1.65166726664267,473,228,245,41,1.1,20.45,1.5,0,0,0,0,0,0,0.060901401155364,62.0069215100265,8.55454999371269
8.7,"random_policy_SVM","SVM",41,8,3012,2940,72,900,573,327,0.896106263620616,0.647342995169082,1.64297428102876,510,248,262,37,1.1,23.01,1.8,0,0,0,0,0,0,0.0499945524466236,65.3868800455704,6.40934001375475
8.7,"random_policy_SVM","SVM",41,9,2912,2857,55,1000,656,344,0.895584226183086,0.652173913043478,1.6399568810636,558,269,289,48,1.1,25.56,1.9,0,0,0,0,0,0,0.0530726540128563,80.1411688169019,6.66131134539117
8.7,"random_policy_SVM","SVM",41,10,2812,2760,52,1100,753,347,0.903391309872045,0.63768115942029,1.65318813889556,573,279,294,15,1.1,28.12,2.2,0,0,0,0,0,0,0.0416848786505079,53.0081964949012,4.94119112819101
8.7,"random_policy_SVM","SVM",41,11,2712,2665,47,1200,848,352,0.905574752170346,0.642512077294686,1.66751918158568,584,283,301,11,1.1,30.67,2.4,0,0,0,0,0,0,0.031259487449679,44.7321905977333,3.48493071913043
8.7,"random_policy_SVM","SVM",41,12,2612,2571,41,1300,942,358,0.911353071320267,0.628019323671498,1.69201900427197,601,293,308,17,1.1,33.23,2.6,0,0,0,0,0,0,0.0300666508297791,44.377893541357,3.37519847689649
8.7,"random_policy_SVM","SVM",41,13,2512,2472,40,1400,1041,359,0.915684048579878,0.613526570048309,1.70225916453538,615,301,314,14,1,35.79,2.9,0,0,0,0,0,0,0.0244773979664718,33.7029541238678,2.80562205500174
8.7,"random_policy_SVM","SVM",41,14,2412,2375,37,1500,1138,362,0.921992691475879,0.623188405797101,1.72121115155394,617,302,315,2,1,38.34,3.1,0,0,0,0,0,0,0.0310931540328761,34.8189428479618,3.568786197674
8.7,"random_policy_SVM","SVM",41,15,2312,2279,33,1600,1234,366,0.924176133774164,0.618357487922705,1.74568414322251,637,309,328,20,1.1,40.9,3.4,0,0,0,0,0,0,0.0451218394511536,35.7907916802252,5.34037953113346
8.7,"random_policy_SVM","SVM",41,16,2212,2182,30,1700,1331,369,0.925198111826495,0.623188405797101,1.74248105305146,651,314,337,14,1.1,43.46,3.6,0,0,0,0,0,0,0.0398689014203897,26.721766895943,4.66527424273601
8.7,"random_policy_SVM","SVM",41,17,2112,2090,22,1800,1423,377,0.925232638112047,0.628019323671498,1.74729010839566,672,323,349,21,1.1,46.01,3.8,0,0,0,0,0,0,0.0402332344325578,26.1553022678961,4.83866601696251
8.7,"random_policy_SVM","SVM",41,18,2012,2000,12,1900,1513,387,0.926867802995776,0.623188405797101,1.75051091965538,697,333,364,25,1.1,48.57,3.9,0,0,0,0,0,0,0.0323952131775337,24.1302417529037,4.30483284482282
8.7,"random_policy_SVM","SVM",41,19,1912,1901,11,2000,1612,388,0.926724173647879,0.623188405797101,1.75051091965538,698,334,364,1,1.1,51.12,4.2,0,0,0,0,0,0,0.0232382608605989,18.6086786786557,2.66338790318853
8.7,"random_policy_SVM","SVM",41,20,1812,1802,10,2100,1711,389,0.92800993252182,0.623188405797101,1.74568414322251,702,336,366,4,1.1,53.68,4.4,0,0,0,0,0,0,0.0148596063194309,13.5749010643156,1.71052556305045
8.7,"random_policy_SVM","SVM",41,21,1712,1703,9,2200,1810,390,0.92857340150202,0.623188405797101,1.74889903114741,708,341,367,6,1.1,56.24,4.6,0,0,0,0,0,0,0.0139498393330365,12.51006806067,1.43231755740801
8.7,"random_policy_SVM","SVM",41,22,1612,1603,9,2300,1910,390,0.927364981507717,0.613526570048309,1.76467607962348,730,356,374,22,1.1,58.79,4.9,0,0,0,0,0,0,0.00844040322833733,6.2710391822702,1.21963453378115
8.7,"random_policy_SVM","SVM",41,23,1512,1505,7,2400,2008,392,0.927185444822849,0.608695652173913,1.76467607962348,733,358,375,3,1,61.35,5.1,0,0,0,0,0,0,0.00756447240829499,6.19513783871917,0.857124109814822
8.7,"random_policy_SVM","SVM",41,24,1412,1406,6,2500,2107,393,0.927144013280187,0.608695652173913,1.76143516854979,742,363,379,9,1,63.91,5.4,0,0,0,0,0,0,0.00700704844509597,5.27202351667928,0.719590992318325
8.7,"random_policy_SVM","SVM",41,25,1312,1307,5,2600,2206,394,0.928132846098385,0.613526570048309,1.76792893875643,757,369,388,15,1.1,66.46,5.6,0,0,0,0,0,0,0.00533940307957233,3.42983267903089,0.629054029296589
8.7,"random_policy_SVM","SVM",41,26,1212,1208,4,2700,2305,395,0.927866303173927,0.613526570048309,1.76630101155684,762,371,391,5,1.1,69.02,5.8,0,0,0,0,0,0,0.00428904483322979,2.80230512109752,0.466441039852198
8.7,"random_policy_SVM","SVM",41,27,1112,1109,3,2800,2404,396,0.927812442168467,0.613526570048309,1.76630101155684,766,373,393,4,1.1,71.57,6.1,0,0,0,0,0,0,0.00434260559371535,2.5180970590341,0.444628371440763
8.7,"random_policy_SVM","SVM",41,28,1012,1009,3,2900,2504,396,0.928993241134337,0.613526570048309,1.75981917298232,773,375,398,7,1.1,74.13,6.3,0,0,0,0,0,0,0.00323433510538244,1.65210679057526,0.363258735703741
8.7,"random_policy_SVM","SVM",41,29,912,909,3,3000,2604,396,0.928777797112494,0.613526570048309,1.76305413469736,773,375,398,0,1.1,76.69,6.6,0,0,0,0,0,0,0.00308681086991055,1.34107132297457,0.319754575220397
8.7,"random_policy_SVM","SVM",41,30,812,809,3,3100,2704,396,0.929210066207605,0.608695652173913,1.76305413469736,779,379,400,6,1.1,79.24,6.8,0,0,0,0,0,0,0.00260831912856734,0.957846814718653,0.28424250884782
8.7,"random_policy_SVM","SVM",41,31,712,710,2,3200,2803,397,0.92921282831045,0.599033816425121,1.76467607962348,784,381,403,5,1.1,81.8,7.1,0,0,0,0,0,0,0.002223594448874,0.711984652451122,0.248420266202714
8.7,"random_policy_SVM","SVM",41,32,612,611,1,3300,2902,398,0.929672718434008,0.603864734299517,1.75981917298232,788,384,404,4,1.1,84.36,7.3,0,0,0,0,0,0,0.00166114948799892,0.49949541121845,0.198930107822477
8.7,"random_policy_SVM","SVM",41,33,512,511,1,3400,3002,398,0.929910259278607,0.603864734299517,1.76305413469736,789,385,404,1,1,86.91,7.5,0,0,0,0,0,0,0.000969212625081633,0.283062827138847,0.12695576418893
8.7,"random_policy_SVM","SVM",41,34,412,411,1,3500,3102,398,0.929954452924116,0.599033816425121,1.76305413469736,793,386,407,4,1.1,89.47,7.8,0,0,0,0,0,0,0.000605356095868845,0.17407669951436,0.0800077910055508
8.7,"random_policy_SVM","SVM",41,35,312,312,0,3600,3201,399,0.93006079388362,0.603864734299517,1.76630101155684,794,389,405,1,1,92.02,8,0,0,0,0,0,0,0.000393443156843936,0.0999211377015091,0.051053232330309
8.7,"random_policy_SVM","SVM",41,36,212,212,0,3700,3301,399,0.930243092671338,0.599033816425121,1.76467607962348,798,391,407,4,1,94.58,8.3,0,0,0,0,0,0,0.000208537006355239,0.0439565073048095,0.0280672222344686
8.7,"random_policy_SVM","SVM",41,37,112,112,0,3800,3401,399,0.930361863093637,0.599033816425121,1.76467607962348,802,393,409,4,1,97.14,8.5,0,0,0,0,0,0,7.13414570448417e-05,0.0131693174821529,0.0124230055737569
8.7,"random_policy_SVM","SVM",41,38,12,12,0,3900,3501,399,0.930400532533453,0.594202898550725,1.76630101155684,806,394,412,4,1,99.69,8.8,0,0,0,0,0,0,4.09683075870151e-05,0.000607452891327474,0.000607452891327474
8.7,"random_policy_SVM","SVM",41,39,0,0,0,3912,3513,399,0.930392246224921,0.594202898550725,1.76630101155684,807,394,413,1,1,100,8.8,0,0,0,0,0,0,0,0,0
8.7,"random_policy_SVM","SVM",42,0,3812,3415,397,100,91,9,0.83546412300684,0.32,1.74868202764977,33,9,24,0,2.7,2.56,10.1,0,0,0,0,0,0,0.160213703157086,336.610007476141,21.571556131723
8.7,"random_policy_SVM","SVM",42,1,3712,3347,365,200,159,41,0.913556378132126,0.505,1.76920110192837,94,41,53,61,1.3,5.11,3.9,0,0,0,0,0,0,0.420989311514771,355.537049774873,54.4390092150025
8.7,"random_policy_SVM","SVM",42,2,3612,3305,307,300,201,99,0.93734624145786,0.6,1.79449541284404,186,92,94,92,1,7.67,2,0,0,0,0,0,0,0.629453560132548,462.252190775611,67.8325401820047
8.7,"random_policy_SVM","SVM",42,3,3512,3263,249,400,243,157,0.939023348519365,0.605,1.79120879120879,262,130,132,76,1,10.22,1.5,0,0,0,0,0,0,0.6093341113832,335.489991276912,70.0096679812858
8.7,"random_policy_SVM","SVM",42,4,3412,3229,183,500,277,223,0.93818621867882,0.62,1.79614325068871,330,164,166,68,1,12.78,1.2,0,0,0,0,0,0,0.452052072260041,326.175819059372,63.1641881135567
8.7,"random_policy_SVM","SVM",42,5,3312,3176,136,600,330,270,0.897175398633244,0.66,1.65093577981651,413,205,208,83,1,15.34,1.2,0,0,0,0,0,0,0.253296806315168,214.284123070784,43.0675722936747
8.7,"random_policy_SVM","SVM",42,6,3212,3116,96,700,390,310,0.91767938496584,0.65,1.69148114075437,477,237,240,64,1,17.89,1.3,0,0,0,0,0,0,0.132325759919382,127.784169543604,18.8275628322601
8.7,"random_policy_SVM","SVM",42,7,3112,3039,73,800,467,333,0.912183940774484,0.665,1.66448942042318,531,255,276,54,1.1,20.45,1.4,0,0,0,0,0,0,0.10745037834986,146.523914352197,13.7342769222223
8.7,"random_policy_SVM","SVM",42,8,3012,2956,56,900,550,350,0.914941628701588,0.665,1.67502762430939,576,278,298,45,1.1,23.01,1.6,0,0,0,0,0,0,0.088635974548846,135.417903250761,10.5275406436865
8.7,"random_policy_SVM","SVM",42,9,2912,2861,51,1000,645,355,0.922944191343956,0.66,1.70361290322581,594,290,304,18,1,25.56,1.8,0,0,0,0,0,0,0.077007498787824,108.541583717661,8.57845497790926
8.7,"random_policy_SVM","SVM",42,10,2812,2764,48,1100,742,358,0.934343678815502,0.65,1.74963302752294,616,298,318,22,1.1,28.12,2.1,0,0,0,0,0,0,0.0616769804001453,71.3931632611088,7.00153437764678
8.7,"random_policy_SVM","SVM",42,11,2712,2669,43,1200,837,363,0.936399487471535,0.64,1.76508287292818,628,303,325,12,1.1,30.67,2.3,0,0,0,0,0,0,0.0503821669066938,54.1917753585086,5.7106012486095
8.7,"random_policy_SVM","SVM",42,12,2612,2584,28,1300,922,378,0.94254555808657,0.645,1.78716253443526,665,320,345,37,1.1,33.23,2.4,0,0,0,0,0,0,0.0633687764761356,65.3924370940445,7.15864802894308
8.7,"random_policy_SVM","SVM",42,13,2512,2489,23,1400,1017,383,0.943126423690219,0.645,1.79209944751381,680,326,354,15,1.1,35.79,2.7,0,0,0,0,0,0,0.0630240952453273,60.0800697918468,7.06502470002325
8.7,"random_policy_SVM","SVM",42,14,2412,2389,23,1500,1117,383,0.943072323462429,0.645,1.78716253443526,680,327,353,0,1.1,38.34,2.9,0,0,0,0,0,0,0.0485959580035707,46.5410444289686,5.36798885935756
8.7,"random_policy_SVM","SVM",42,15,2312,2291,21,1600,1215,385,0.942818906605937,0.645,1.77492208982585,691,330,361,11,1.1,40.9,3.2,0,0,0,0,0,0,0.0373261252597966,38.5826855788927,4.1831867644165
8.7,"random_policy_SVM","SVM",42,16,2212,2195,17,1700,1311,389,0.942445899772227,0.645,1.78309392265193,696,335,361,5,1.1,43.46,3.4,0,0,0,0,0,0,0.031720665557695,35.2561977575418,3.58929448496518
8.7,"random_policy_SVM","SVM",42,17,2112,2098,14,1800,1408,392,0.942475797266533,0.64,1.7732967032967,710,341,369,14,1.1,46.01,3.6,0,0,0,0,0,0,0.0253167606603271,28.9022689856927,2.88827982656311
8.7,"random_policy_SVM","SVM",42,18,2012,2000,12,1900,1506,394,0.942303530751726,0.64,1.78145354185833,719,343,376,9,1.1,48.57,3.8,0,0,0,0,0,0,0.0224820613902964,25.8265136962149,2.3929341456896
8.7,"random_policy_SVM","SVM",42,19,1912,1900,12,2000,1606,394,0.941799544419152,0.635,1.77818181818182,714,343,371,-5,1.1,51.12,4.1,0,0,0,0,0,0,0.0202948813106576,21.9643809328471,2.10424663557285
8.7,"random_policy_SVM","SVM",42,20,1812,1800,12,2100,1706,394,0.941722665148077,0.625,1.78880514705882,725,352,373,11,1.1,53.68,4.3,0,0,0,0,0,0,0.013309379124112,11.4067615312374,1.68122880709574
8.7,"random_policy_SVM","SVM",42,21,1712,1702,10,2200,1804,396,0.941967539863342,0.63,1.79045078196872,729,355,374,4,1.1,56.24,4.6,0,0,0,0,0,0,0.0112087423029879,10.8445246481237,1.23500861832209
8.7,"random_policy_SVM","SVM",42,22,1612,1603,9,2300,1903,397,0.942057232346255,0.625,1.7765504587156,729,355,374,0,1.1,58.79,4.8,0,0,0,0,0,0,0.0110116414020797,9.68960424620612,1.10960252566645
8.7,"random_policy_SVM","SVM",42,23,1512,1503,9,2400,2003,397,0.941930523918003,0.625,1.78145354185833,750,368,382,21,1,61.35,5,0,0,0,0,0,0,0.00676701600339388,4.70805843543581,0.863711705646482
8.7,"random_policy_SVM","SVM",42,24,1412,1406,6,2500,2100,400,0.942286446469255,0.625,1.79375115207373,765,376,389,15,1,63.91,5.2,0,0,0,0,0,0,0.00613394295180906,5.05491253345333,0.695056667137651
8.7,"random_policy_SVM","SVM",42,25,1312,1306,6,2600,2200,400,0.942111332574039,0.625,1.78880514705882,765,376,389,0,1,66.46,5.5,0,0,0,0,0,0,0.00616672815272612,4.59885614817837,0.630683987803502
8.7,"random_policy_SVM","SVM",42,26,1212,1206,6,2700,2300,400,0.941813781321192,0.625,1.79614325068871,768,378,390,3,1,69.02,5.8,0,0,0,0,0,0,0.00415285862161275,2.7289249946673,0.467594028224787
8.7,"random_policy_SVM","SVM",42,27,1112,1107,5,2800,2399,401,0.941894931662877,0.625,1.80110497237569,770,379,391,2,1,71.57,6,0,0,0,0,0,0,0.00394310049097083,2.42809103332713,0.41279436684814
8.7,"random_policy_SVM","SVM",42,28,1012,1008,4,2900,2498,402,0.941791002277913,0.63,1.79614325068871,780,382,398,10,1,74.13,6.2,0,0,0,0,0,0,0.00351323484222082,1.89908577843924,0.368256670840768
8.7,"random_policy_SVM","SVM",42,29,912,908,4,3000,2598,402,0.941870728929393,0.63,1.79285059578368,780,383,397,0,1,76.69,6.5,0,0,0,0,0,0,0.0032600650399763,1.55572589822515,0.342180741794807
8.7,"random_policy_SVM","SVM",42,30,812,809,3,3100,2697,403,0.942010250569483,0.63,1.79779411764706,785,385,400,5,1,79.24,6.7,0,0,0,0,0,0,0.00264806835110442,1.14640115912839,0.285264131272489
8.7,"random_policy_SVM","SVM",42,31,712,709,3,3200,2797,403,0.941983200455588,0.63,1.79779411764706,787,385,402,2,1,81.8,6.9,0,0,0,0,0,0,0.00237345170909744,0.911113643182386,0.257331182854086
8.7,"random_policy_SVM","SVM",42,32,612,609,3,3300,2897,403,0.942088553530758,0.63,1.79779411764706,786,385,401,-1,1,84.36,7.2,0,0,0,0,0,0,0.00166658134326254,0.583413577670367,0.187598408264995
8.7,"random_policy_SVM","SVM",42,33,512,511,1,3400,2995,405,0.942297835990894,0.625,1.79779411764706,795,388,407,9,1,86.91,7.4,0,0,0,0,0,0,0.0019433377000231,0.729253318114835,0.241102911442101
8.7,"random_policy_SVM","SVM",42,34,412,412,0,3500,3094,406,0.942468678815494,0.63,1.80110497237569,802,392,410,7,1,89.47,7.6,0,0,0,0,0,0,0.00177535136029088,0.559212062505315,0.200043383553489
8.7,"random_policy_SVM","SVM",42,35,312,312,0,3600,3194,406,0.942359054669708,0.63,1.79779411764706,803,392,411,1,1,92.02,7.9,0,0,0,0,0,0,0.00122711968457255,0.308520428973589,0.140009627949826
8.7,"random_policy_SVM","SVM",42,36,212,212,0,3700,3294,406,0.942257972665152,0.63,1.80276497695853,807,394,413,4,1,94.58,8.1,0,0,0,0,0,0,0.000780284193722239,0.163254969416267,0.0997037625295332
8.7,"random_policy_SVM","SVM",42,37,112,112,0,3800,3394,406,0.942400341685654,0.63,1.79779411764706,813,395,418,6,1.1,97.14,8.4,0,0,0,0,0,0,0.000336440782927371,0.0535185888552367,0.0497700584602193
8.7,"random_policy_SVM","SVM",42,38,12,12,0,3900,3494,406,0.942421697038729,0.63,1.79449541284404,814,396,418,1,1.1,99.69,8.6,0,0,0,0,0,0,0.000341377603324191,0.00465282229370645,0.00465282229370645
8.7,"random_policy_SVM","SVM",42,39,0,0,0,3912,3506,406,0.942290717539868,0.63,1.79449541284404,814,396,418,0,1.1,100,8.6,0,0,0,0,0,0,0,0,0
8.7,"random_policy_SVM","SVM",43,0,3812,3422,390,100,93,7,0.917403176463824,0.583732057416268,1.7789552769979,19,7,12,0,1.7,2.56,13.3,0,0,0,0,0,0,0.820616908890698,611.355629772365,85.1710831185143
8.7,"random_policy_SVM","SVM",43,1,3712,3376,336,200,139,61,0.885512553303953,0.574162679425837,1.71250716827834,93,46,47,74,1,5.11,2.3,0,0,0,0,0,0,0.717970885303813,294.899606332377,78.9084766712769
8.7,"random_policy_SVM","SVM",43,2,3612,3341,271,300,174,126,0.88985355619887,0.583732057416268,1.68287608094465,164,82,82,71,1,7.67,1.4,0,0,0,0,0,0,0.601775779495455,229.779279459073,76.7634811716852
8.7,"random_policy_SVM","SVM",43,3,3512,3297,215,400,218,182,0.888218490755166,0.631578947368421,1.68991180559515,241,122,119,77,1,10.22,1.2,0,0,0,0,0,0,0.405245635410206,193.238368138473,62.6462642931113
8.7,"random_policy_SVM","SVM",43,4,3412,3247,165,500,268,232,0.89287719480832,0.631578947368421,1.7016093953893,311,156,155,70,1,12.78,1.2,0,0,0,0,0,0,0.18232445142074,101.129351225468,32.5512190311474
8.7,"random_policy_SVM","SVM",43,5,3312,3183,129,600,332,268,0.881071584096326,0.62200956937799,1.62875042956462,386,191,195,75,1,15.34,1.2,0,0,0,0,0,0,0.107436324735281,74.6095200849295,16.4538746067113
8.7,"random_policy_SVM","SVM",43,6,3212,3110,102,700,405,295,0.88116744220441,0.645933014354067,1.63736815670517,444,214,230,58,1.1,17.89,1.4,0,0,0,0,0,0,0.0883689216927753,79.0106237136248,12.3501798587751
8.7,"random_policy_SVM","SVM",43,7,3112,3029,83,800,486,314,0.880577230138886,0.655502392344498,1.61864223995633,493,234,259,49,1.1,20.45,1.5,0,0,0,0,0,0,0.0711476786453058,90.0802968970694,9.26159355850658
8.7,"random_policy_SVM","SVM",43,8,3012,2947,65,900,568,332,0.882465634868256,0.665071770334928,1.62875042956462,532,258,274,39,1.1,23.01,1.7,0,0,0,0,0,0,0.0577296206469089,87.0136921367628,6.99138479891503
8.7,"random_policy_SVM","SVM",43,9,2912,2858,54,1000,657,343,0.888663546257015,0.655502392344498,1.62875042956462,568,270,298,36,1.1,25.56,1.9,0,0,0,0,0,0,0.0702702731837868,112.110841139319,7.31057621388775
8.7,"random_policy_SVM","SVM",43,10,2812,2761,51,1100,754,346,0.909342878975027,0.641148325358852,1.6773677174219,606,297,309,38,1,28.12,2.2,0,0,0,0,0,0,0.0664797579412551,53.5524073895195,8.59745350878092
8.7,"random_policy_SVM","SVM",43,11,2712,2664,48,1200,851,349,0.909003267392073,0.641148325358852,1.68045679240794,610,299,311,4,1,30.67,2.4,0,0,0,0,0,0,0.0416579701974943,34.4854285777753,4.80115480922554
8.7,"random_policy_SVM","SVM",43,12,2612,2568,44,1300,947,353,0.91173111526799,0.650717703349282,1.68907451954849,620,306,314,10,1,33.23,2.7,0,0,0,0,0,0,0.0323080303139412,31.3929417650094,3.69045437690766
8.7,"random_policy_SVM","SVM",43,13,2512,2475,37,1400,1040,360,0.924354258701867,0.650717703349282,1.73056962888949,639,314,325,19,1,35.79,2.9,0,0,0,0,0,0,0.0295625049367495,36.9948159512563,3.66246901633749
8.7,"random_policy_SVM","SVM",43,14,2412,2383,29,1500,1132,368,0.932622705225362,0.641148325358852,1.7650088254843,668,323,345,29,1.1,38.34,3.1,0,0,0,0,0,0,0.0659173169583114,52.6406303146038,8.13666435320641
8.7,"random_policy_SVM","SVM",43,15,2312,2286,26,1600,1229,371,0.933269062754184,0.636363636363636,1.7650088254843,682,332,350,14,1.1,40.9,3.3,0,0,0,0,0,0,0.0498978193800965,37.146092876368,5.61134018361753
8.7,"random_policy_SVM","SVM",43,16,2212,2188,24,1700,1327,373,0.934044144028159,0.631578947368421,1.77361862463301,695,336,359,13,1.1,43.46,3.6,0,0,0,0,0,0,0.0419865174479271,30.0600280657929,4.63428916746769
8.7,"random_policy_SVM","SVM",43,17,2112,2091,21,1800,1424,376,0.934746647020301,0.626794258373206,1.77525179095403,703,339,364,8,1.1,46.01,3.8,0,0,0,0,0,0,0.0361965710082191,24.7023826928687,4.18843657878419
8.7,"random_policy_SVM","SVM",43,18,2012,1995,17,1900,1520,380,0.935545008120532,0.631578947368421,1.76873710548264,715,345,370,12,1.1,48.57,4,0,0,0,0,0,0,0.0357765074703638,23.1917928531475,4.38994559511808
8.7,"random_policy_SVM","SVM",43,19,1912,1904,8,2000,1611,389,0.936168085823112,0.62200956937799,1.77525179095403,731,356,375,16,1.1,51.12,4.1,0,0,0,0,0,0,0.0245325921059427,19.4581756781439,3.93833133698548
8.7,"random_policy_SVM","SVM",43,20,1812,1805,7,2100,1710,390,0.936609033120325,0.626794258373206,1.77198846045595,735,357,378,4,1.1,53.68,4.4,0,0,0,0,0,0,0.018945321935705,15.6027251065604,2.13665539463988
8.7,"random_policy_SVM","SVM",43,21,1712,1705,7,2200,1810,390,0.936593969703339,0.626794258373206,1.77525179095403,734,357,377,-1,1.1,56.24,4.6,0,0,0,0,0,0,0.0153350346901754,12.8686615029721,1.67980886488093
8.7,"random_policy_SVM","SVM",43,22,1612,1605,7,2300,1910,390,0.936533716035397,0.62200956937799,1.77361862463301,737,357,380,3,1.1,58.79,4.9,0,0,0,0,0,0,0.0127757413619429,10.4394065806501,1.3612144380614
8.7,"random_policy_SVM","SVM",43,23,1512,1506,6,2400,2009,391,0.936896607444595,0.626794258373206,1.77198846045595,740,357,383,3,1.1,61.35,5.1,0,0,0,0,0,0,0.0113824444472504,8.69560487225499,1.16439199049183
8.7,"random_policy_SVM","SVM",43,24,1412,1407,5,2500,2108,392,0.936233817097242,0.62200956937799,1.77198846045595,756,365,391,16,1.1,63.91,5.4,0,0,0,0,0,0,0.00825792377915915,5.74697378993718,0.995639881433258
8.7,"random_policy_SVM","SVM",43,25,1312,1307,5,2600,2208,392,0.936222861884889,0.62200956937799,1.7654976602345,757,365,392,1,1.1,66.46,5.6,0,0,0,0,0,0,0.00705395168123755,4.57029383049248,0.730973901947193
8.7,"random_policy_SVM","SVM",43,26,1212,1207,5,2700,2308,392,0.935868186884959,0.62200956937799,1.7703612901525,756,370,386,-1,1,69.02,5.9,0,0,0,0,0,0,0.00540554465336424,3.22348107332768,0.595696977515107
8.7,"random_policy_SVM","SVM",43,27,1112,1107,5,2800,2408,392,0.935812041421649,0.617224880382775,1.76873710548264,755,370,385,-1,1,71.57,6.1,0,0,0,0,0,0,0.00549695845892888,2.80478730831925,0.562077560913542
8.7,"random_policy_SVM","SVM",43,28,1012,1007,5,2900,2508,392,0.935766851170682,0.61244019138756,1.76711589823655,759,370,389,4,1.1,74.13,6.4,0,0,0,0,0,0,0.00380851022517379,1.69271103741519,0.424290041883139
8.7,"random_policy_SVM","SVM",43,29,912,908,4,3000,2607,393,0.935870925688035,0.61244019138756,1.7654976602345,760,372,388,1,1,76.69,6.6,0,0,0,0,0,0,0.00352195359035308,1.30031693257749,0.367922635281032
8.7,"random_policy_SVM","SVM",43,30,812,808,4,3100,2707,393,0.935636758023987,0.617224880382775,1.76873710548264,763,373,390,3,1,79.24,6.9,0,0,0,0,0,0,0.00284067988822993,0.89713181009612,0.317087942738813
8.7,"random_policy_SVM","SVM",43,31,712,709,3,3200,2806,394,0.935870925688035,0.617224880382775,1.7789552769979,768,376,392,5,1,81.8,7.1,0,0,0,0,0,0,0.00224223142431899,0.685243910136941,0.278049279549428
8.7,"random_policy_SVM","SVM",43,32,612,610,2,3300,2905,395,0.935665515456413,0.61244019138756,1.7789552769979,774,380,394,6,1,84.36,7.4,0,0,0,0,0,0,0.00138545495445006,0.435631561408504,0.186323170157122
8.7,"random_policy_SVM","SVM",43,33,512,511,1,3400,3004,396,0.935609369993102,0.61244019138756,1.77732320793644,777,382,395,3,1,86.91,7.6,0,0,0,0,0,0,0.00112809264253394,0.353410201512389,0.142632297839118
8.7,"random_policy_SVM","SVM",43,34,412,412,0,3500,3103,397,0.93587366449112,0.617224880382775,1.7789552769979,784,384,400,7,1,89.47,7.8,0,0,0,0,0,0,0.000706561308159796,0.212431110498644,0.0905570041688343
8.7,"random_policy_SVM","SVM",43,35,312,312,0,3600,3203,397,0.93564908263788,0.617224880382775,1.78222842378171,790,384,406,6,1.1,92.02,8.1,0,0,0,0,0,0,0.000463861358313403,0.121387697772785,0.059665183790824
8.7,"random_policy_SVM","SVM",43,36,212,212,0,3700,3303,397,0.935801086209279,0.61244019138756,1.78059034618632,796,388,408,6,1.1,94.58,8.3,0,0,0,0,0,0,0.000256354062718325,0.0541782884472325,0.0333032243939632
8.7,"random_policy_SVM","SVM",43,37,112,112,0,3800,3403,397,0.935773698178397,0.61244019138756,1.78059034618632,797,388,409,1,1.1,97.14,8.6,0,0,0,0,0,0,0.000120943415438771,0.0182589170695633,0.0170632998315237
8.7,"random_policy_SVM","SVM",43,38,12,12,0,3900,3503,397,0.935892836112736,0.61244019138756,1.7855136374661,799,389,410,2,1.1,99.69,8.8,0,0,0,0,0,0,6.35222381240246e-05,0.000969587829368209,0.000969587829368209
8.7,"random_policy_SVM","SVM",43,39,0,0,0,3912,3515,397,0.935805194413912,0.61244019138756,1.78059034618632,799,389,410,0,1.1,100,8.9,0,0,0,0,0,0,0,0,0
8.7,"random_policy_SVM","SVM",44,0,3812,3403,409,100,85,15,0.910045281663098,0.5,1.7748656453036,37,15,22,0,1.5,2.56,5.7,0,0,0,0,0,0,0.714286760749304,670.433591407082,74.8602076343814
8.7,"random_policy_SVM","SVM",44,1,3712,3351,361,200,137,63,0.898525093846419,0.554945054945055,1.69279072575776,116,57,59,79,1,5.11,2.2,0,0,0,0,0,0,0.646614767927416,474.013436687361,71.424597353161
8.7,"random_policy_SVM","SVM",44,2,3612,3312,300,300,176,124,0.889499733637294,0.571428571428571,1.69069017459082,179,89,90,63,1,7.67,1.4,0,0,0,0,0,0,0.649219110438235,344.384029507215,75.0872012140795
8.7,"random_policy_SVM","SVM",44,3,3512,3273,239,400,215,185,0.8855724320775,0.598901098901099,1.68390135210412,255,127,128,76,1,10.22,1.2,0,0,0,0,0,0,0.482215466711883,277.177383231654,68.5796098033384
8.7,"random_policy_SVM","SVM",44,4,3412,3235,177,500,253,247,0.846949837085131,0.604395604395604,1.56215817301374,323,162,161,68,1,12.78,1,0,0,0,0,0,0,0.273628946020813,203.601147976796,47.8049526946776
8.7,"random_policy_SVM","SVM",44,5,3312,3185,127,600,303,297,0.85552609735248,0.615384615384615,1.58598321934711,406,199,207,83,1,15.34,1,0,0,0,0,0,0,0.184052785656603,184.012614975613,30.1406954823566
8.7,"random_policy_SVM","SVM",44,6,3212,3118,94,700,370,330,0.853008040437579,0.60989010989011,1.59475363346331,470,230,240,64,1,17.89,1.1,0,0,0,0,0,0,0.116274475987652,136.889259185551,15.5547818764263
8.7,"random_policy_SVM","SVM",44,7,3112,3030,82,800,458,342,0.858734839005417,0.615384615384615,1.59475363346331,504,244,260,34,1.1,20.45,1.3,0,0,0,0,0,0,0.0700061494823993,98.7715122835684,8.6982207539369
8.7,"random_policy_SVM","SVM",44,8,3012,2941,71,900,547,353,0.868912372858255,0.604395604395604,1.58484833139211,535,259,276,31,1.1,23.01,1.5,0,0,0,0,0,0,0.0610836841260674,91.3358504798079,7.02009543669017
8.7,"random_policy_SVM","SVM",44,9,2912,2851,61,1000,637,363,0.881154217822751,0.615384615384615,1.6328698925384,569,273,296,34,1.1,25.56,1.8,0,0,0,0,0,0,0.0598897332475749,80.5858597588534,6.89251997471473
8.7,"random_policy_SVM","SVM",44,10,2812,2759,53,1100,729,371,0.882661025558424,0.615384615384615,1.6328698925384,600,283,317,31,1.1,28.12,2,0,0,0,0,0,0,0.061223904261613,78.0075077299959,6.19788000970301
8.7,"random_policy_SVM","SVM",44,11,2712,2661,51,1200,827,373,0.912818860958672,0.604395604395604,1.70057725163521,635,311,324,35,1,30.67,2.2,0,0,0,0,0,0,0.0590122593576938,41.5380167100507,7.43049889848706
8.7,"random_policy_SVM","SVM",44,12,2612,2567,45,1300,921,379,0.914736053123896,0.604395604395604,1.69380665417532,651,317,334,16,1.1,33.23,2.4,0,0,0,0,0,0,0.0405270955029067,33.3494349933107,4.74861090896095
8.7,"random_policy_SVM","SVM",44,13,2512,2472,40,1400,1016,384,0.917133317640659,0.604395604395604,1.6922469795398,660,322,338,9,1,35.79,2.6,0,0,0,0,0,0,0.0343058327789652,31.6080777317361,3.8024659556599
8.7,"random_policy_SVM","SVM",44,14,2412,2379,33,1500,1109,391,0.923840392977934,0.615384615384615,1.7219355230405,679,330,349,19,1.1,38.34,2.8,0,0,0,0,0,0,0.0339048000148893,36.6079872716956,4.13567151227506
8.7,"random_policy_SVM","SVM",44,15,2312,2285,27,1600,1203,397,0.930147924229111,0.60989010989011,1.75666757484939,698,340,358,19,1.1,40.9,3,0,0,0,0,0,0,0.0568587839761857,44.2124552402475,7.1911255843699
8.7,"random_policy_SVM","SVM",44,16,2212,2187,25,1700,1301,399,0.932765092855294,0.593406593406593,1.77640541276905,718,347,371,20,1.1,43.46,3.3,0,0,0,0,0,0,0.0433068985178719,32.8768756136488,4.97648451299339
8.7,"random_policy_SVM","SVM",44,17,2112,2088,24,1800,1400,400,0.932727925963561,0.593406593406593,1.77803813833226,718,349,369,0,1.1,46.01,3.5,0,0,0,0,0,0,0.0312413678414174,23.9638424825092,3.51864969813423
8.7,"random_policy_SVM","SVM",44,18,2012,1995,17,1900,1493,407,0.933059330748173,0.604395604395604,1.77803813833226,735,360,375,17,1,48.57,3.7,0,0,0,0,0,0,0.0324052255544507,22.0600840067329,3.6831455760936
8.7,"random_policy_SVM","SVM",44,19,1912,1899,13,2000,1589,411,0.932548285986844,0.60989010989011,1.78131261004189,743,364,379,8,1,51.12,3.9,0,0,0,0,0,0,0.0303885303466489,20.006436443839,3.59936572556302
8.7,"random_policy_SVM","SVM",44,20,1812,1803,9,2100,1685,415,0.932966413518838,0.615384615384615,1.78295437281612,755,369,386,12,1,53.68,4.1,0,0,0,0,0,0,0.0255015062776345,18.7906037773535,3.33850961449191
8.7,"random_policy_SVM","SVM",44,21,1712,1706,6,2200,1782,418,0.932805356987995,0.60989010989011,1.77967386799034,764,373,391,9,1,56.24,4.3,0,0,0,0,0,0,0.0162246417748505,13.0909030488232,2.01198968257912
8.7,"random_policy_SVM","SVM",44,22,1612,1607,5,2300,1881,419,0.932099186045069,0.615384615384615,1.76816014867485,766,375,391,2,1,58.79,4.5,0,0,0,0,0,0,0.0147150470288377,11.9184299964838,1.56502897765691
8.7,"random_policy_SVM","SVM",44,23,1512,1507,5,2400,1981,419,0.933136761772614,0.615384615384615,1.77640541276905,772,379,393,6,1,61.35,4.7,0,0,0,0,0,0,0.0111684702977578,8.61479782623655,1.25308684169262
8.7,"random_policy_SVM","SVM",44,24,1412,1407,5,2500,2081,419,0.933129018670171,0.615384615384615,1.77477568303256,776,380,396,4,1,63.91,5,0,0,0,0,0,0,0.00927538174518526,6.55285656991459,0.96983262180594
8.7,"random_policy_SVM","SVM",44,25,1312,1307,5,2600,2181,419,0.933096497639905,0.615384615384615,1.77477568303256,778,383,395,2,1,66.46,5.2,0,0,0,0,0,0,0.00846394215149178,5.73687195370857,0.924278244590761
8.7,"random_policy_SVM","SVM",44,26,1212,1207,5,2700,2281,419,0.933053136266216,0.615384615384615,1.77967386799034,781,384,397,3,1,69.02,5.4,0,0,0,0,0,0,0.00652998146908979,3.88658194146008,0.673079264642037
8.7,"random_policy_SVM","SVM",44,27,1112,1107,5,2800,2381,419,0.932757349752842,0.615384615384615,1.77803813833226,784,385,399,3,1,71.57,5.7,0,0,0,0,0,0,0.00561500341789591,3.060951858089,0.603932387541891
8.7,"random_policy_SVM","SVM",44,28,1012,1007,5,2900,2481,419,0.932724828722577,0.615384615384615,1.78295437281612,784,385,399,0,1,74.13,5.9,0,0,0,0,0,0,0.00512386020238448,2.43246346105121,0.534080016258821
8.7,"random_policy_SVM","SVM",44,29,912,908,4,3000,2580,420,0.932743412168444,0.615384615384615,1.78295437281612,793,388,405,9,1,76.69,6.1,0,0,0,0,0,0,0.00470393390198586,2.01439214294011,0.50509355084714
8.7,"random_policy_SVM","SVM",44,30,812,809,3,3100,2679,421,0.932760446993822,0.615384615384615,1.77803813833226,797,392,405,4,1,79.24,6.4,0,0,0,0,0,0,0.00370427681459027,1.47584485700208,0.410147084087357
8.7,"random_policy_SVM","SVM",44,31,712,709,3,3200,2779,421,0.93287349628951,0.615384615384615,1.77640541276905,798,392,406,1,1,81.8,6.6,0,0,0,0,0,0,0.0026170105030833,0.922164391167353,0.294611211508709
8.7,"random_policy_SVM","SVM",44,32,612,610,2,3300,2878,422,0.933118178326755,0.60989010989011,1.78295437281612,803,393,410,5,1,84.36,6.8,0,0,0,0,0,0,0.0024680514500785,0.83287330018748,0.283575528859408
8.7,"random_policy_SVM","SVM",44,33,512,510,2,3400,2978,422,0.93326374865271,0.604395604395604,1.78131261004189,805,394,411,2,1,86.91,7.1,0,0,0,0,0,0,0.00159796900914348,0.515072796908409,0.194425222408791
8.7,"random_policy_SVM","SVM",44,34,412,411,1,3500,3077,423,0.933403124496713,0.598901098901099,1.77803813833226,809,397,412,4,1,89.47,7.3,0,0,0,0,0,0,0.0013538340861693,0.386985893733272,0.163374887941157
8.7,"random_policy_SVM","SVM",44,35,312,312,0,3600,3176,424,0.933739175142804,0.598901098901099,1.77803813833226,815,400,415,6,1,92.02,7.5,0,0,0,0,0,0,0.00107258322510703,0.268047682421094,0.135435205861947
8.7,"random_policy_SVM","SVM",44,36,212,212,0,3700,3276,424,0.934319907826129,0.598901098901099,1.77314894088496,816,401,415,1,1,94.58,7.7,0,0,0,0,0,0,0.000499496799767674,0.110661664491151,0.0708850489136658
8.7,"random_policy_SVM","SVM",44,37,112,112,0,3800,3376,424,0.934741132599102,0.598901098901099,1.77967386799034,822,403,419,6,1,97.14,8,0,0,0,0,0,0,0.000307926308065838,0.0483388716488654,0.0449601388306986
8.7,"random_policy_SVM","SVM",44,38,12,12,0,3900,3476,424,0.935075634624696,0.598901098901099,1.77803813833226,826,404,422,4,1,99.69,8.2,0,0,0,0,0,0,0.000217781364876666,0.00310725521339324,0.00310725521339324
8.7,"random_policy_SVM","SVM",44,39,0,0,0,3912,3488,424,0.935106607034474,0.598901098901099,1.77314894088496,826,404,422,0,1,100,8.2,0,0,0,0,0,0,0,0,0
8.7,"random_policy_SVM","SVM",45,0,3812,3420,392,100,90,10,0.914674545617339,0.622549019607843,1.7585795608566,22,10,12,0,1.2,2.56,9,0,0,0,0,0,0,0.417457345513292,305.371835393403,45.7179714656499
8.7,"random_policy_SVM","SVM",45,1,3712,3402,310,200,108,92,0.907832225355905,0.607843137254902,1.71281551294551,81,42,39,59,0.9,5.11,1.2,0,0,0,0,0,0,0.660883223269667,218.849188965961,75.2265848286104
8.7,"random_policy_SVM","SVM",45,2,3612,3350,262,300,160,140,0.913304962395926,0.588235294117647,1.7449178200692,163,83,80,82,1,7.67,1.1,0,0,0,0,0,0,0.426565097412087,164.470308909009,62.214574098083
8.7,"random_policy_SVM","SVM",45,3,3512,3309,203,400,201,199,0.877921031426278,0.632352941176471,1.64646464646465,245,124,121,82,1,10.22,1,0,0,0,0,0,0,0.203115942589077,91.6174259936578,39.2477561028916
8.7,"random_policy_SVM","SVM",45,4,3412,3259,153,500,251,249,0.862307223117562,0.617647058823529,1.58921026974326,338,171,167,93,1,12.78,1,0,0,0,0,0,0,0.157294100521756,95.5314089225965,24.4949912554155
8.7,"random_policy_SVM","SVM",45,5,3312,3184,128,600,326,274,0.84744325812518,0.651960784313726,1.56416373000813,394,194,200,56,1,15.34,1.2,0,0,0,0,0,0,0.118887622080923,92.1008350623414,17.4747446111423
8.7,"random_policy_SVM","SVM",45,6,3212,3098,114,700,412,288,0.860596293311855,0.681372549019608,1.56128578386276,439,210,229,45,1.1,17.89,1.4,0,0,0,0,0,0,0.0661624308314773,56.8862860500342,8.98397883066678
8.7,"random_policy_SVM","SVM",45,7,3112,3022,90,800,488,312,0.86540732160445,0.700980392156863,1.57155237785722,491,239,252,52,1.1,20.45,1.6,0,0,0,0,0,0,0.0663390807527287,81.4232784163481,9.72545249679726
8.7,"random_policy_SVM","SVM",45,8,3012,2947,65,900,563,337,0.870582079863917,0.691176470588235,1.57010660750041,550,265,285,59,1.1,23.01,1.7,0,0,0,0,0,0,0.066143140376696,98.8965482881521,8.27705335204749
8.7,"random_policy_SVM","SVM",45,9,2912,2855,57,1000,655,345,0.874037514549205,0.686274509803922,1.57155237785722,581,276,305,31,1.1,25.56,1.9,0,0,0,0,0,0,0.0594060687164842,84.24838716837,6.59372639764848
8.7,"random_policy_SVM","SVM",45,10,2812,2757,55,1100,753,347,0.875579170024181,0.686274509803922,1.58921026974326,588,281,307,7,1.1,28.12,2.2,0,0,0,0,0,0,0.043648865424577,60.0134775613979,4.76224832994594
8.7,"random_policy_SVM","SVM",45,11,2712,2661,51,1200,849,351,0.875934506222586,0.676470588235294,1.59951206288967,593,289,304,5,1.1,30.67,2.4,0,0,0,0,0,0,0.037528626199805,49.6780526577373,4.18966179705142
8.7,"random_policy_SVM","SVM",45,12,2612,2564,48,1300,946,354,0.880509110036712,0.681372549019608,1.60686816162929,607,293,314,14,1.1,33.23,2.7,0,0,0,0,0,0,0.0349466224025557,44.2135369499986,3.61312186676066
8.7,"random_policy_SVM","SVM",45,13,2512,2465,47,1400,1045,355,0.901033272898206,0.661764705882353,1.64797794117647,625,307,318,18,1,35.79,2.9,0,0,0,0,0,0,0.0292735436910237,21.5018446322221,3.65865299791292
8.7,"random_policy_SVM","SVM",45,14,2412,2373,39,1500,1137,363,0.902268555824159,0.656862745098039,1.64067319660155,644,316,328,19,1,38.34,3.1,0,0,0,0,0,0,0.0260459547017275,23.274814232986,3.02520956294807
8.7,"random_policy_SVM","SVM",45,15,2312,2277,35,1600,1233,367,0.908449167338177,0.661764705882353,1.66867078323042,659,323,336,15,1,40.9,3.4,0,0,0,0,0,0,0.0224281558766002,23.1858872772346,2.55484801548604
8.7,"random_policy_SVM","SVM",45,16,2212,2181,31,1700,1329,371,0.913975064911824,0.666666666666667,1.6728785177983,668,328,340,9,1,43.46,3.6,0,0,0,0,0,0,0.0203944880831966,23.5645042417611,2.29555751823314
8.7,"random_policy_SVM","SVM",45,17,2112,2085,27,1800,1425,375,0.922999764974493,0.666666666666667,1.73047340483155,688,336,352,20,1,46.01,3.8,0,0,0,0,0,0,0.0217746450623526,24.3455817444525,2.48038893172078
8.7,"random_policy_SVM","SVM",45,18,2012,1991,21,1900,1519,381,0.930488405407832,0.661764705882353,1.76972937935505,704,345,359,16,1,48.57,4,0,0,0,0,0,0,0.0391425056257225,29.692408628266,4.76433889977207
8.7,"random_policy_SVM","SVM",45,19,1912,1893,19,2000,1617,383,0.932097211030537,0.661764705882353,1.76972937935505,715,349,366,11,1,51.12,4.2,0,0,0,0,0,0,0.036784435915817,24.9454762109101,3.98765803898595
8.7,"random_policy_SVM","SVM",45,20,1812,1796,16,2100,1714,386,0.932351822007348,0.661764705882353,1.77461813454664,730,353,377,15,1.1,53.68,4.4,0,0,0,0,0,0,0.0374068162682485,22.302309519508,4.3511192946482
8.7,"random_policy_SVM","SVM",45,21,1712,1702,10,2200,1808,392,0.931671926761578,0.656862745098039,1.76972937935505,749,362,387,19,1.1,56.24,4.6,0,0,0,0,0,0,0.0263146876066909,16.6823601457711,3.82768147378763
8.7,"random_policy_SVM","SVM",45,22,1612,1606,6,2300,1904,396,0.931172497537834,0.661764705882353,1.77135596885813,758,366,392,9,1.1,58.79,4.8,0,0,0,0,0,0,0.0151075113824399,12.2999519489086,2.04936210270867
8.7,"random_policy_SVM","SVM",45,23,1512,1506,6,2400,2004,396,0.931344569791393,0.661764705882353,1.77298555116619,759,367,392,1,1.1,61.35,5.1,0,0,0,0,0,0,0.0126638382759519,10.5001792573043,1.36769139882813
8.7,"random_policy_SVM","SVM",45,24,1412,1406,6,2500,2104,396,0.93114032142538,0.661764705882353,1.77298555116619,762,370,392,3,1.1,63.91,5.3,0,0,0,0,0,0,0.0111583509200653,8.36935387256121,1.14373381504666
8.7,"random_policy_SVM","SVM",45,25,1312,1306,6,2600,2204,396,0.930765399767219,0.656862745098039,1.76972937935505,768,374,394,6,1.1,66.46,5.6,0,0,0,0,0,0,0.00742236670530806,5.26369917795687,0.894968585629554
8.7,"random_policy_SVM","SVM",45,26,1212,1208,4,2700,2302,398,0.930424053182923,0.661764705882353,1.76810577441986,769,376,393,1,1,69.02,5.8,0,0,0,0,0,0,0.00636464749111423,4.06341747819742,0.656927943720846
8.7,"random_policy_SVM","SVM",45,27,1112,1108,4,2800,2402,398,0.930793378995439,0.656862745098039,1.77298555116619,777,384,393,8,1,71.57,6,0,0,0,0,0,0,0.00551486067367884,3.32876378557112,0.614523996936657
8.7,"random_policy_SVM","SVM",45,28,1012,1009,3,2900,2501,399,0.930563949324028,0.651960784313726,1.77298555116619,781,384,397,4,1,74.13,6.3,0,0,0,0,0,0,0.00580295952185738,3.12006175309439,0.611977602624327
8.7,"random_policy_SVM","SVM",45,29,912,909,3,3000,2601,399,0.931492859700963,0.642156862745098,1.76972937935505,790,386,404,9,1,76.69,6.5,0,0,0,0,0,0,0.00466674532279312,2.26510415175493,0.503098305010169
8.7,"random_policy_SVM","SVM",45,30,812,810,2,3100,2700,400,0.931455087742865,0.647058823529412,1.77135596885813,794,387,407,4,1.1,79.24,6.8,0,0,0,0,0,0,0.00389150923770927,1.67475293371587,0.415161794267715
8.7,"random_policy_SVM","SVM",45,31,712,710,2,3200,2800,400,0.931294207180595,0.647058823529412,1.77298555116619,794,387,407,0,1.1,81.8,7,0,0,0,0,0,0,0.00348953569210095,1.33759903103484,0.378726767378647
8.7,"random_policy_SVM","SVM",45,32,612,610,2,3300,2900,400,0.931165502730778,0.647058823529412,1.77135596885813,794,387,407,0,1.1,84.36,7.2,0,0,0,0,0,0,0.00286771066246469,0.979130142347381,0.322074019892073
8.7,"random_policy_SVM","SVM",45,33,512,510,2,3400,3000,400,0.930964052287587,0.647058823529412,1.77298555116619,794,387,407,0,1.1,86.91,7.5,0,0,0,0,0,0,0.00199045597847791,0.59794568779238,0.233050024289316
8.7,"random_policy_SVM","SVM",45,34,412,410,2,3500,3100,400,0.931064777509183,0.647058823529412,1.77135596885813,793,387,406,-1,1,89.47,7.8,0,0,0,0,0,0,0.00116713542545727,0.336960579951326,0.145845602546227
8.7,"random_policy_SVM","SVM",45,35,312,312,0,3600,3198,402,0.931252238338263,0.647058823529412,1.76972937935505,797,391,406,4,1,92.02,8,0,0,0,0,0,0,0.00135505543999737,0.346825938377723,0.174656903041991
8.7,"random_policy_SVM","SVM",45,36,212,212,0,3700,3298,402,0.931744672754952,0.642156862745098,1.76486748545572,798,392,406,1,1,94.58,8.2,0,0,0,0,0,0,0.000832422834093727,0.174973526367792,0.10704755697268
8.7,"random_policy_SVM","SVM",45,37,112,112,0,3800,3398,402,0.931948921120964,0.642156862745098,1.76325278510306,803,393,410,5,1,97.14,8.5,0,0,0,0,0,0,0.000425231867823643,0.0677147171769105,0.0630761814049395
8.7,"random_policy_SVM","SVM",45,38,12,12,0,3900,3498,402,0.932105604799002,0.642156862745098,1.76810577441986,808,396,412,5,1,99.69,8.7,0,0,0,0,0,0,0.00023904123497361,0.00373447690775974,0.00373447690775974
8.7,"random_policy_SVM","SVM",45,39,0,0,0,3912,3510,402,0.932111200644646,0.642156862745098,1.76486748545572,808,396,412,0,1,100,8.7,0,0,0,0,0,0,0,0,0
8.7,"random_policy_SVM","SVM",46,0,3812,3417,395,100,89,11,0.898758542141231,0.535,1.74707182320442,25,11,14,0,1.3,2.56,8.1,0,0,0,0,0,0,0.744770888691527,390.068000991904,81.0780867842172
8.7,"random_policy_SVM","SVM",46,1,3712,3378,334,200,128,72,0.900993735763105,0.565,1.77082720588235,105,54,51,80,0.9,5.11,1.8,0,0,0,0,0,0,0.738503091751678,295.995700905945,82.0665148285694
8.7,"random_policy_SVM","SVM",46,2,3612,3332,280,300,174,126,0.895654897494317,0.57,1.71531680440771,174,86,88,69,1,7.67,1.4,0,0,0,0,0,0,0.622341411813071,243.097209376966,74.307257413198
8.7,"random_policy_SVM","SVM",46,3,3512,3288,224,400,218,182,0.869567198177677,0.59,1.64649494020239,253,127,126,79,1,10.22,1.2,0,0,0,0,0,0,0.378448403229019,174.985010993131,60.9211374073578
8.7,"random_policy_SVM","SVM",46,4,3412,3253,159,500,253,247,0.87602220956721,0.615,1.64649494020239,329,166,163,76,1,12.78,1,0,0,0,0,0,0,0.22429285314984,119.67552740043,37.6041360071548
8.7,"random_policy_SVM","SVM",46,5,3312,3194,118,600,312,288,0.878749999999999,0.615,1.63150230414747,406,203,203,77,1,15.34,1.1,0,0,0,0,0,0,0.140083660325443,91.1358715972568,20.7963066832772
8.7,"random_policy_SVM","SVM",46,6,3212,3122,90,700,384,316,0.862208143507975,0.635,1.57018348623853,467,225,242,61,1.1,17.89,1.2,0,0,0,0,0,0,0.10079729729837,91.7827302492883,14.6016501672467
8.7,"random_policy_SVM","SVM",46,7,3112,3036,76,800,470,330,0.865844248291573,0.635,1.57306985294118,507,241,266,40,1.1,20.45,1.4,0,0,0,0,0,0,0.0629697409148526,65.9655365269607,7.69466093669846
8.7,"random_policy_SVM","SVM",46,8,3012,2949,63,900,557,343,0.873105068337117,0.64,1.59397790055249,543,258,285,36,1.1,23.01,1.6,0,0,0,0,0,0,0.0558246829035819,71.310318406704,6.97455397925149
8.7,"random_policy_SVM","SVM",46,9,2912,2863,49,1000,643,357,0.889097380410019,0.64,1.64051612903226,580,276,304,37,1.1,25.56,1.8,0,0,0,0,0,0,0.0526057348202739,78.6827970039536,6.46668272330879
8.7,"random_policy_SVM","SVM",46,10,2812,2771,41,1100,735,365,0.908562072892945,0.645,1.69303867403315,594,285,309,14,1.1,28.12,2,0,0,0,0,0,0,0.0478593286912682,68.5316239852039,6.00413353272408
8.7,"random_policy_SVM","SVM",46,11,2712,2676,36,1200,830,370,0.91744447608201,0.64,1.70204419889503,617,297,320,23,1.1,30.67,2.2,0,0,0,0,0,0,0.0470427219221668,60.7519828982877,5.26860504481202
8.7,"random_policy_SVM","SVM",46,12,2612,2579,33,1300,927,373,0.92225227790434,0.635,1.71847286108556,635,303,332,18,1.1,33.23,2.5,0,0,0,0,0,0,0.0517009037158351,53.326955478281,5.75426587182374
8.7,"random_policy_SVM","SVM",46,13,2512,2480,32,1400,1026,374,0.923231776765392,0.63,1.71847286108556,638,307,331,3,1.1,35.79,2.7,0,0,0,0,0,0,0.0407242401858151,39.3184144447709,4.43821875925896
8.7,"random_policy_SVM","SVM",46,14,2412,2384,28,1500,1122,378,0.926315489749448,0.63,1.74868202764977,645,311,334,7,1.1,38.34,3,0,0,0,0,0,0,0.0354347340624873,32.7822282590411,3.9685234284679
8.7,"random_policy_SVM","SVM",46,15,2312,2289,23,1600,1217,383,0.924871867881564,0.63,1.74707182320442,668,319,349,23,1.1,40.9,3.2,0,0,0,0,0,0,0.0351501224586992,29.9482944029438,4.47461079997863
8.7,"random_policy_SVM","SVM",46,16,2212,2194,18,1700,1312,388,0.926714123006847,0.635,1.74707182320442,677,324,353,9,1.1,43.46,3.4,0,0,0,0,0,0,0.0271793568036576,26.4982467904546,3.38793510113504
8.7,"random_policy_SVM","SVM",46,17,2112,2100,12,1800,1406,394,0.928006833712996,0.63,1.74707182320442,690,330,360,13,1.1,46.01,3.6,0,0,0,0,0,0,0.024692304969387,25.3332105997153,2.8226479374678
8.7,"random_policy_SVM","SVM",46,18,2012,2001,11,1900,1505,395,0.928405466970399,0.63,1.74707182320442,695,335,360,5,1.1,48.57,3.8,0,0,0,0,0,0,0.0203159830226156,20.5773938525676,2.20146166774075
8.7,"random_policy_SVM","SVM",46,19,1912,1902,10,2000,1604,396,0.928052391799559,0.63,1.74868202764977,697,339,358,2,1.1,51.12,4.1,0,0,0,0,0,0,0.016760203017618,16.7243719508084,1.80477321879826
8.7,"random_policy_SVM","SVM",46,20,1812,1803,9,2100,1703,397,0.928963553530771,0.625,1.75769585253456,709,341,368,12,1.1,53.68,4.3,0,0,0,0,0,0,0.0137201188942441,12.7399625740082,1.43826518128538
8.7,"random_policy_SVM","SVM",46,21,1712,1703,9,2200,1803,397,0.926931947608217,0.615,1.76508287292818,728,350,378,19,1.1,56.24,4.5,0,0,0,0,0,0,0.00993874979685624,8.74682826115878,1.23829123051298
8.7,"random_policy_SVM","SVM",46,22,1612,1605,7,2300,1901,399,0.927613895216416,0.62,1.76670967741935,731,351,380,3,1.1,58.79,4.8,0,0,0,0,0,0,0.0100775731790686,8.022394002297,1.01836452745426
8.7,"random_policy_SVM","SVM",46,23,1512,1505,7,2400,2001,399,0.926705580865614,0.61,1.76670967741935,747,364,383,16,1.1,61.35,5,0,0,0,0,0,0,0.00663418309144917,4.50621826437504,0.892549320937439
8.7,"random_policy_SVM","SVM",46,24,1412,1406,6,2500,2100,400,0.925755979498874,0.61,1.76508287292818,751,364,387,4,1.1,63.91,5.2,0,0,0,0,0,0,0.00572420556735216,3.70755619384497,0.593668857906492
8.7,"random_policy_SVM","SVM",46,25,1312,1306,6,2600,2200,400,0.925441343963564,0.605,1.77245630174793,757,370,387,6,1,66.46,5.5,0,0,0,0,0,0,0.00467733844146029,2.79833612732859,0.513942864392433
8.7,"random_policy_SVM","SVM",46,26,1212,1207,5,2700,2299,401,0.925569476082014,0.6,1.77245630174793,760,372,388,3,1,69.02,5.7,0,0,0,0,0,0,0.00494698071384932,2.64881434337566,0.511128730962993
8.7,"random_policy_SVM","SVM",46,27,1112,1108,4,2800,2398,402,0.926030751708436,0.6,1.77572350230415,768,377,391,8,1,71.57,6,0,0,0,0,0,0,0.00432195758293879,2.10666986814112,0.459127557624398
8.7,"random_policy_SVM","SVM",46,28,1012,1008,4,2900,2498,402,0.925922551252855,0.605,1.77572350230415,771,379,392,3,1,74.13,6.2,0,0,0,0,0,0,0.00407124913031557,1.73961681822739,0.432768668230225
8.7,"random_policy_SVM","SVM",46,29,912,908,4,3000,2598,402,0.92602363325741,0.605,1.77408839779006,774,379,395,3,1,76.69,6.5,0,0,0,0,0,0,0.00316843465961334,1.19848204950125,0.346379492612998
8.7,"random_policy_SVM","SVM",46,30,812,808,4,3100,2698,402,0.926060649202741,0.605,1.77408839779006,773,379,394,-1,1,79.24,6.7,0,0,0,0,0,0,0.00229687958851621,0.769176692420029,0.255299400850482
8.7,"random_policy_SVM","SVM",46,31,712,709,3,3200,2797,403,0.926409453302968,0.605,1.77245630174793,779,381,398,6,1,81.8,6.9,0,0,0,0,0,0,0.00175284709228001,0.530709903823764,0.204518468033813
8.7,"random_policy_SVM","SVM",46,32,612,609,3,3300,2897,403,0.92657460136675,0.605,1.77245630174793,779,382,397,0,1,84.36,7.2,0,0,0,0,0,0,0.00115767955494424,0.35632855316746,0.15488382934059
8.7,"random_policy_SVM","SVM",46,33,512,509,3,3400,2997,403,0.926808086560371,0.605,1.77245630174793,780,383,397,1,1,86.91,7.4,0,0,0,0,0,0,0.000672964603499777,0.204977208840513,0.0897842979566089
8.7,"random_policy_SVM","SVM",46,34,412,411,1,3500,3095,405,0.928362756264244,0.6,1.77245630174793,792,385,407,12,1.1,89.47,7.6,0,0,0,0,0,0,0.000568364328166886,0.169423220793129,0.0728782986439894
8.7,"random_policy_SVM","SVM",46,35,312,312,0,3600,3194,406,0.928992027334858,0.605,1.77082720588235,797,390,407,5,1,92.02,7.9,0,0,0,0,0,0,0.000476381395394269,0.120729396419694,0.058135192409791
8.7,"random_policy_SVM","SVM",46,36,212,212,0,3700,3294,406,0.929036161731212,0.605,1.77082720588235,799,390,409,2,1,94.58,8.1,0,0,0,0,0,0,0.000295064861442976,0.0618512687103656,0.0389212875841439
8.7,"random_policy_SVM","SVM",46,37,112,112,0,3800,3394,406,0.929246867881553,0.605,1.77082720588235,799,390,409,0,1,97.14,8.4,0,0,0,0,0,0,0.000119151184728491,0.0216531195836042,0.0202987626986223
8.7,"random_policy_SVM","SVM",46,38,12,12,0,3900,3494,406,0.929319476082007,0.605,1.76920110192837,806,394,412,7,1,99.69,8.6,0,0,0,0,0,0,9.6031499715612e-05,0.00127412822480234,0.00127412822480234
8.7,"random_policy_SVM","SVM",46,39,0,0,0,3912,3506,406,0.929258257403192,0.605,1.77082720588235,807,394,413,1,1,100,8.6,0,0,0,0,0,0,0,0,0
8.7,"random_policy_SVM","SVM",47,0,3812,3410,402,100,88,12,0.903229520975051,0.557291666666667,1.74001377410468,28,12,16,0,1.3,2.56,7.3,0,0,0,0,0,0,0.5,361.483256160904,56.2647559067461
8.7,"random_policy_SVM","SVM",47,1,3712,3383,329,200,115,85,0.917446145124719,0.5625,1.75711009174312,90,44,46,62,1,5.11,1.4,0,0,0,0,0,0,0.646154879537094,263.895173578897,77.4271096230005
8.7,"random_policy_SVM","SVM",47,2,3612,3337,275,300,161,139,0.905683106575944,0.5625,1.73384314627415,168,85,83,78,1,7.67,1.2,0,0,0,0,0,0,0.627164158968692,223.387574557055,75.0774859327392
8.7,"random_policy_SVM","SVM",47,3,3512,3289,223,400,209,191,0.882576294406652,0.583333333333333,1.68698252069917,233,116,117,65,1,10.22,1.1,0,0,0,0,0,0,0.350013736318342,143.947242403463,57.1138949284128
8.7,"random_policy_SVM","SVM",47,4,3412,3236,176,500,262,238,0.888605442176868,0.614583333333333,1.69009216589862,312,157,155,79,1,12.78,1.1,0,0,0,0,0,0,0.162047239305565,93.6693375465484,30.8177556526411
8.7,"random_policy_SVM","SVM",47,5,3312,3171,141,600,327,273,0.87501476284958,0.625,1.62287062615101,384,186,198,72,1.1,15.34,1.2,0,0,0,0,0,0,0.109947973406926,73.4284120855309,16.3633869388461
8.7,"random_policy_SVM","SVM",47,6,3212,3097,115,700,401,299,0.878153344671202,0.645833333333333,1.60263339466421,433,211,222,49,1.1,17.89,1.3,0,0,0,0,0,0,0.0856206184803102,75.6053011902456,12.4133423628716
8.7,"random_policy_SVM","SVM",47,7,3112,3021,91,800,477,323,0.877707506613762,0.661458333333333,1.61052389705882,504,239,265,71,1.1,20.45,1.5,0,0,0,0,0,0,0.0824298676487231,122.929057418744,12.219057809833
8.7,"random_policy_SVM","SVM",47,8,3012,2945,67,900,553,347,0.867934500188963,0.666666666666667,1.6041091160221,556,264,292,52,1.1,23.01,1.6,0,0,0,0,0,0,0.0942345454702901,148.170842628024,12.2340574083295
8.7,"random_policy_SVM","SVM",47,9,2912,2851,61,1000,647,353,0.899772061602428,0.671875,1.6697744014733,586,285,301,30,1.1,25.56,1.8,0,0,0,0,0,0,0.0682720257476902,82.6973126687391,9.71506586133977
8.7,"random_policy_SVM","SVM",47,10,2812,2758,54,1100,740,360,0.899612622826916,0.666666666666667,1.66517447199265,601,292,309,15,1.1,28.12,2.1,0,0,0,0,0,0,0.0552984244109364,71.3806642477791,6.00767963057383
8.7,"random_policy_SVM","SVM",47,11,2712,2665,47,1200,833,367,0.908136692176878,0.666666666666667,1.6697744014733,623,301,322,22,1.1,30.67,2.3,0,0,0,0,0,0,0.0522113584490012,72.5825682105861,5.7298805168907
8.7,"random_policy_SVM","SVM",47,12,2612,2571,41,1300,927,373,0.922196830120932,0.65625,1.69013519706691,642,311,331,19,1.1,33.23,2.5,0,0,0,0,0,0,0.0489343085566208,67.1617127908852,5.68100071952516
8.7,"random_policy_SVM","SVM",47,13,2512,2474,38,1400,1024,376,0.928344080687822,0.651041666666667,1.72288602941176,660,319,341,18,1.1,35.79,2.7,0,0,0,0,0,0,0.0446414500710038,53.0870779065397,5.20827803652115
8.7,"random_policy_SVM","SVM",47,14,2412,2377,35,1500,1121,379,0.931603717876028,0.645833333333333,1.72605893186004,668,328,340,8,1,38.34,3,0,0,0,0,0,0,0.0402426842322704,43.9560482167125,4.41246450313774
8.7,"random_policy_SVM","SVM",47,15,2312,2279,33,1600,1219,381,0.934603528911565,0.645833333333333,1.73703917050691,678,329,349,10,1.1,40.9,3.2,0,0,0,0,0,0,0.0384806061998807,39.5147171096834,4.23926737582631
8.7,"random_policy_SVM","SVM",47,16,2212,2184,28,1700,1314,386,0.937876452664398,0.645833333333333,1.74456272893773,692,335,357,14,1.1,43.46,3.4,0,0,0,0,0,0,0.0353226419831828,32.1400220745029,4.16970753171388
8.7,"random_policy_SVM","SVM",47,17,2112,2089,23,1800,1409,391,0.939088482615271,0.645833333333333,1.76195952161914,709,341,368,17,1.1,46.01,3.6,0,0,0,0,0,0,0.0343326252106847,31.4430547832969,4.24806679915312
8.7,"random_policy_SVM","SVM",47,18,2012,1996,16,1900,1502,398,0.939478221844295,0.65625,1.76520737327189,725,351,374,16,1.1,48.57,3.8,0,0,0,0,0,0,0.0327021642444891,30.1068858856137,4.06661838159691
8.7,"random_policy_SVM","SVM",47,19,1912,1898,14,2000,1600,400,0.939628802910053,0.651041666666667,1.76358195211786,737,354,383,12,1.1,51.12,4,0,0,0,0,0,0,0.026613694148598,25.0413925554252,2.94873682617004
8.7,"random_policy_SVM","SVM",47,20,1812,1799,13,2100,1699,401,0.940033304988663,0.651041666666667,1.76195952161914,739,357,382,2,1.1,53.68,4.2,0,0,0,0,0,0,0.0227365283724273,20.0891700227525,2.32476710993702
8.7,"random_policy_SVM","SVM",47,21,1712,1700,12,2200,1798,402,0.93934830876795,0.645833333333333,1.76807851239669,755,366,389,16,1.1,56.24,4.5,0,0,0,0,0,0,0.0168207221366,11.7164883305103,2.13922697391379
8.7,"random_policy_SVM","SVM",47,22,1612,1603,9,2300,1895,405,0.940269510582006,0.645833333333333,1.77133164673413,759,368,391,4,1.1,58.79,4.7,0,0,0,0,0,0,0.0114590952900832,9.37814509065199,1.34498325844531
8.7,"random_policy_SVM","SVM",47,23,1512,1506,6,2400,1992,408,0.941060799319719,0.645833333333333,1.76970358455882,767,374,393,8,1.1,61.35,4.9,0,0,0,0,0,0,0.012261146581785,9.28941743458515,1.2628490262158
8.7,"random_policy_SVM","SVM",47,24,1412,1406,6,2500,2092,408,0.941242382369599,0.635416666666667,1.77296270718232,780,383,397,13,1,63.91,5.1,0,0,0,0,0,0,0.00970597582362733,6.59963175923181,1.12910509497534
8.7,"random_policy_SVM","SVM",47,25,1312,1306,6,2600,2192,408,0.941347198601647,0.635416666666667,1.77133164673413,781,383,398,1,1,66.46,5.4,0,0,0,0,0,0,0.00804428519857881,5.42311651539902,0.85915501300562
8.7,"random_policy_SVM","SVM",47,26,1212,1206,6,2700,2292,408,0.941288147203311,0.635416666666667,1.77459677419355,780,383,397,-1,1,69.02,5.6,0,0,0,0,0,0,0.00683419858138719,4.09549949790226,0.704766335442405
8.7,"random_policy_SVM","SVM",47,27,1112,1107,5,2800,2391,409,0.940798020597112,0.640625,1.78070377184913,789,387,402,9,1,71.57,5.8,0,0,0,0,0,0,0.006505954590117,3.41894609712239,0.682407643421829
8.7,"random_policy_SVM","SVM",47,28,1012,1007,5,2900,2491,409,0.940511621315176,0.640625,1.77255036630037,795,388,407,6,1,74.13,6.1,0,0,0,0,0,0,0.00570051435763233,2.63092519637531,0.602117576303393
8.7,"random_policy_SVM","SVM",47,29,912,908,4,3000,2590,410,0.940340372259999,0.640625,1.77255036630037,797,390,407,2,1,76.69,6.3,0,0,0,0,0,0,0.00495151034595236,2.03298338968511,0.529093290220725
8.7,"random_policy_SVM","SVM",47,30,812,808,4,3100,2690,410,0.940319704270581,0.640625,1.7774334251607,799,391,408,2,1,79.24,6.6,0,0,0,0,0,0,0.00388527543498903,1.39263163198562,0.42600558569097
8.7,"random_policy_SVM","SVM",47,31,712,708,4,3200,2790,410,0.940344801114875,0.640625,1.77255036630037,799,391,408,0,1,81.8,6.8,0,0,0,0,0,0,0.00333790181697833,1.10189681714361,0.383533949654601
8.7,"random_policy_SVM","SVM",47,32,612,609,3,3300,2889,411,0.940434854497339,0.635416666666667,1.77417506874427,804,393,411,5,1,84.36,7,0,0,0,0,0,0,0.00224085352337978,0.738996888462914,0.281476557720849
8.7,"random_policy_SVM","SVM",47,33,512,510,2,3400,2988,412,0.940579530423265,0.630208333333333,1.7867883379247,808,395,413,4,1,86.91,7.3,0,0,0,0,0,0,0.00159091552755225,0.550516061543379,0.202483111132741
8.7,"random_policy_SVM","SVM",47,34,412,411,1,3500,3087,413,0.940588388133015,0.635416666666667,1.7867883379247,814,400,414,6,1,89.47,7.5,0,0,0,0,0,0,0.00118863357253928,0.360001793647303,0.14051562227917
8.7,"random_policy_SVM","SVM",47,35,312,312,0,3600,3186,414,0.94049981103551,0.635416666666667,1.79007589696412,821,403,418,7,1,92.02,7.7,0,0,0,0,0,0,0.00113165903761005,0.29062291570586,0.136025624898072
8.7,"random_policy_SVM","SVM",47,36,212,212,0,3700,3286,414,0.940573625283432,0.635416666666667,1.78843060661765,825,405,420,4,1,94.58,7.9,0,0,0,0,0,0,0.000579052554821394,0.122795566400662,0.0748757036542343
8.7,"random_policy_SVM","SVM",47,37,112,112,0,3800,3386,414,0.940623818972018,0.635416666666667,1.79007589696412,830,406,424,5,1,97.14,8.2,0,0,0,0,0,0,0.000310007115160257,0.0455021925203392,0.042247740281886
8.7,"random_policy_SVM","SVM",47,38,12,12,0,3900,3486,414,0.940552957294014,0.635416666666667,1.79007589696412,829,406,423,-1,1,99.69,8.4,0,0,0,0,0,0,0.000218398052020594,0.00300025669126374,0.00300025669126374
8.7,"random_policy_SVM","SVM",47,39,0,0,0,3912,3498,414,0.940579530423266,0.635416666666667,1.7867883379247,829,406,423,0,1,100,8.4,0,0,0,0,0,0,0,0,0
8.7,"random_policy_SVM","SVM",48,0,3812,3422,390,100,90,10,0.914812760055477,0.611650485436893,1.71525211399937,27,10,17,0,1.7,2.56,9,0,0,0,0,0,0,0.170828659946224,372.542819513071,17.956769387119
8.7,"random_policy_SVM","SVM",48,1,3712,3393,319,200,119,81,0.9151761442441,0.621359223300971,1.74703691463992,88,44,44,61,1,5.11,1.5,0,0,0,0,0,0,0.715718120607553,318.116992634178,82.1246588285787
8.7,"random_policy_SVM","SVM",48,2,3612,3352,260,300,160,140,0.912621359223291,0.606796116504854,1.72639011473963,166,84,82,78,1,7.67,1.1,0,0,0,0,0,0,0.587904043874319,256.922790662345,74.5889872228049
8.7,"random_policy_SVM","SVM",48,3,3512,3309,203,400,203,197,0.916432732316239,0.616504854368932,1.75577209921312,241,122,119,75,1,10.22,1,0,0,0,0,0,0,0.395580827328273,202.000837215644,58.1301946547581
8.7,"random_policy_SVM","SVM",48,4,3412,3254,158,500,258,242,0.914360610263519,0.650485436893204,1.72797687035979,333,164,169,92,1,12.78,1.1,0,0,0,0,0,0,0.200239932405767,119.261181189083,35.0578591018729
8.7,"random_policy_SVM","SVM",48,5,3312,3189,123,600,323,277,0.912474341192776,0.640776699029126,1.72400340029529,403,198,205,70,1,15.34,1.2,0,0,0,0,0,0,0.136896009282641,110.838741761107,20.3812112772659
8.7,"random_policy_SVM","SVM",48,6,3212,3108,104,700,404,296,0.916152565880724,0.66504854368932,1.69462580720072,461,222,239,58,1.1,17.89,1.4,0,0,0,0,0,0,0.080436439493159,71.6141040546951,10.5010880559352
8.7,"random_policy_SVM","SVM",48,7,3112,3021,91,800,491,309,0.907123439667123,0.684466019417476,1.66995655205707,493,232,261,32,1.1,20.45,1.6,0,0,0,0,0,0,0.0760273522704988,104.109915122765,10.9403216342759
8.7,"random_policy_SVM","SVM",48,8,3012,2939,73,900,573,327,0.908330097087376,0.679611650485437,1.6714956825198,539,256,283,46,1.1,23.01,1.8,0,0,0,0,0,0,0.0879467814763544,124.355103216082,13.0485349783413
8.7,"random_policy_SVM","SVM",48,9,2912,2848,64,1000,664,336,0.921294036061012,0.674757281553398,1.71052255853798,573,274,299,34,1.1,25.56,2,0,0,0,0,0,0,0.0817339616742197,93.8083621861451,9.26806417805147
8.7,"random_policy_SVM","SVM",48,10,2812,2759,53,1100,753,347,0.924135922330078,0.66504854368932,1.71767097274599,610,288,322,37,1.1,28.12,2.2,0,0,0,0,0,0,0.0791930630452235,73.8737940073757,8.79153278438364
8.7,"random_policy_SVM","SVM",48,11,2712,2665,47,1200,847,353,0.925177531206642,0.66504854368932,1.72241592018452,624,297,327,14,1.1,30.67,2.4,0,0,0,0,0,0,0.069553068708536,63.0627322689968,7.59244104077692
8.7,"random_policy_SVM","SVM",48,12,2612,2571,41,1300,941,359,0.92524271844659,0.66504854368932,1.72083136092032,635,306,329,11,1.1,33.23,2.6,0,0,0,0,0,0,0.0653325874087577,55.5473101538162,7.27998009087031
8.7,"random_policy_SVM","SVM",48,13,2512,2477,35,1400,1035,365,0.925167822468778,0.66504854368932,1.72241592018452,653,312,341,18,1.1,35.79,2.8,0,0,0,0,0,0,0.059167406948839,48.7604077088966,6.50541063225664
8.7,"random_policy_SVM","SVM",48,14,2412,2385,27,1500,1127,373,0.925852981969469,0.66504854368932,1.72083136092032,673,319,354,20,1.1,38.34,3,0,0,0,0,0,0,0.0506351542742988,45.318598934069,5.67899420611081
8.7,"random_policy_SVM","SVM",48,15,2312,2295,17,1600,1217,383,0.927705963938959,0.674757281553398,1.72400340029529,705,335,370,32,1.1,40.9,3.2,0,0,0,0,0,0,0.0458465658737448,50.5857464285392,5.34507435900922
8.7,"random_policy_SVM","SVM",48,16,2212,2198,14,1700,1314,386,0.929087378640771,0.669902912621359,1.72400340029529,714,340,374,9,1.1,43.46,3.4,0,0,0,0,0,0,0.0354039273552109,40.7718199771696,3.93630253515581
8.7,"random_policy_SVM","SVM",48,17,2112,2101,11,1800,1411,389,0.930133148404996,0.674757281553398,1.71609512781687,729,342,387,15,1.1,46.01,3.6,0,0,0,0,0,0,0.0334736038667118,36.3851676225052,3.59290009298756
8.7,"random_policy_SVM","SVM",48,18,2012,2005,7,1900,1507,393,0.930884882108195,0.66504854368932,1.7327546865912,737,348,389,8,1.1,48.57,3.8,0,0,0,0,0,0,0.0303086273968256,32.7523014972375,3.29060611718314
8.7,"random_policy_SVM","SVM",48,19,1912,1905,7,2000,1607,393,0.930424410540925,0.669902912621359,1.72956654549352,738,350,388,1,1.1,51.12,4.1,0,0,0,0,0,0,0.0253017186089635,26.1437457695379,2.71355157773096
8.7,"random_policy_SVM","SVM",48,20,1812,1805,7,2100,1707,393,0.930203883495154,0.669902912621359,1.73115914820576,738,351,387,0,1.1,53.68,4.3,0,0,0,0,0,0,0.0196079189358577,19.5452217565975,2.07902175208893
8.7,"random_policy_SVM","SVM",48,21,1712,1705,7,2200,1807,393,0.930191400832182,0.669902912621359,1.72956654549352,742,352,390,4,1.1,56.24,4.6,0,0,0,0,0,0,0.0190902309582221,17.9589307434138,1.95724913183364
8.7,"random_policy_SVM","SVM",48,22,1612,1605,7,2300,1907,393,0.931251040221905,0.660194174757282,1.74864560424824,753,365,388,11,1.1,58.79,4.9,0,0,0,0,0,0,0.0114636553440249,8.1316362341894,1.52960991570157
8.7,"random_policy_SVM","SVM",48,23,1512,1507,5,2400,2005,395,0.931054091539521,0.655339805825243,1.74864560424824,760,367,393,7,1.1,61.35,5.1,0,0,0,0,0,0,0.00956515547755077,7.83216945871453,1.12088353170658
8.7,"random_policy_SVM","SVM",48,24,1412,1408,4,2500,2104,396,0.931367545076276,0.655339805825243,1.75025725918303,763,368,395,3,1.1,63.91,5.3,0,0,0,0,0,0,0.00854349190014386,6.4072118385407,0.863993000049328
8.7,"random_policy_SVM","SVM",48,25,1312,1308,4,2600,2204,396,0.93288488210819,0.655339805825243,1.74864560424824,773,377,396,10,1.1,66.46,5.6,0,0,0,0,0,0,0.00614069697553521,3.91266536422694,0.754129912966
8.7,"random_policy_SVM","SVM",48,26,1212,1208,4,2700,2304,396,0.932821081830798,0.655339805825243,1.74864560424824,773,377,396,0,1.1,69.02,5.8,0,0,0,0,0,0,0.00479064257235748,3.0402720643332,0.523116624274231
8.7,"random_policy_SVM","SVM",48,27,1112,1109,3,2800,2403,397,0.933478502080449,0.655339805825243,1.75025725918303,779,379,400,6,1.1,71.57,6.1,0,0,0,0,0,0,0.0047429774972069,2.71001402631498,0.499281270824452
8.7,"random_policy_SVM","SVM",48,28,1012,1009,3,2900,2503,397,0.934423023578359,0.650485436893204,1.75738883226948,793,386,407,14,1.1,74.13,6.3,0,0,0,0,0,0,0.00369165288320662,1.89367193241411,0.409397838596003
8.7,"random_policy_SVM","SVM",48,29,912,910,2,3000,2602,398,0.934393897364768,0.650485436893204,1.75254754072053,794,387,407,1,1.1,76.69,6.5,0,0,0,0,0,0,0.00305732483116103,1.29555276021746,0.313282425254261
8.7,"random_policy_SVM","SVM",48,30,812,811,1,3100,2701,399,0.934740638002767,0.650485436893204,1.75577209921312,801,391,410,7,1,79.24,6.8,0,0,0,0,0,0,0.00261367667535781,0.951651972697603,0.284612379451336
8.7,"random_policy_SVM","SVM",48,31,712,712,0,3200,2800,400,0.93481276005547,0.655339805825243,1.75415833809252,807,393,414,6,1.1,81.8,7,0,0,0,0,0,0,0.00187110664423877,0.574856946852188,0.206845473088189
8.7,"random_policy_SVM","SVM",48,32,612,612,0,3300,2900,400,0.935020804438271,0.655339805825243,1.75254754072053,805,393,412,-2,1,84.36,7.2,0,0,0,0,0,0,0.00157294072899378,0.447090317730304,0.192114209327381
8.7,"random_policy_SVM","SVM",48,33,512,512,0,3400,3000,400,0.935195561719825,0.655339805825243,1.75415833809252,808,393,415,3,1.1,86.91,7.5,0,0,0,0,0,0,0.00073896415601599,0.22825711989363,0.103830330528832
8.7,"random_policy_SVM","SVM",48,34,412,412,0,3500,3100,400,0.935818307905682,0.655339805825243,1.7477328496746,813,396,417,5,1.1,89.47,7.8,0,0,0,0,0,0,0.000354899481064141,0.101584769497379,0.0487498370556109
8.7,"random_policy_SVM","SVM",48,35,312,312,0,3600,3200,400,0.936391123439663,0.655339805825243,1.75093969894006,812,396,416,-1,1.1,92.02,8,0,0,0,0,0,0,0.00020899862083712,0.0525920777847696,0.0283318659622178
8.7,"random_policy_SVM","SVM",48,36,212,212,0,3700,3300,400,0.93663800277392,0.650485436893204,1.75415833809252,814,397,417,2,1.1,94.58,8.2,0,0,0,0,0,0,8.51929472116434e-05,0.0189280370465063,0.0125196414390283
8.7,"random_policy_SVM","SVM",48,37,112,112,0,3800,3400,400,0.936907073509011,0.650485436893204,1.75254754072053,816,398,418,2,1.1,97.14,8.5,0,0,0,0,0,0,2.67099219412709e-05,0.0051890201370678,0.00491260864348463
8.7,"random_policy_SVM","SVM",48,38,12,12,0,3900,3500,400,0.937031900138693,0.650485436893204,1.75254754072053,819,399,420,3,1.1,99.69,8.8,0,0,0,0,0,0,2.29419815914028e-05,0.000346229584602747,0.000346229584602747
8.7,"random_policy_SVM","SVM",48,39,0,0,0,3912,3512,400,0.937051317614421,0.650485436893204,1.75254754072053,819,399,420,0,1.1,100,8.8,0,0,0,0,0,0,0,0,0
8.7,"random_policy_SVM","SVM",49,0,3812,3421,391,100,90,10,0.869816550821141,0.521951219512195,1.69255738880918,31,10,21,0,2.1,2.56,9,0,0,0,0,0,0,0.543555033684984,392.245797248581,64.4605945477831
8.7,"random_policy_SVM","SVM",49,1,3712,3360,352,200,151,49,0.890206293267976,0.595121951219512,1.71167006978257,107,49,58,76,1.2,5.11,3.1,0,0,0,0,0,0,0.670716573253867,370.038904870753,78.2780220480064
8.7,"random_policy_SVM","SVM",49,2,3612,3325,287,300,186,114,0.915188533381623,0.629268292682927,1.73081794906347,183,91,92,76,1,7.67,1.6,0,0,0,0,0,0,0.686942675925895,340.299537918239,79.0655898571995
8.7,"random_policy_SVM","SVM",49,3,3512,3283,229,400,228,172,0.91359362594198,0.648780487804878,1.7396038269775,248,124,124,65,1,10.22,1.3,0,0,0,0,0,0,0.480396482474751,179.005329049532,68.6526176168904
8.7,"random_policy_SVM","SVM",49,4,3412,3238,174,500,273,227,0.900104469919647,0.648780487804878,1.72763629842181,326,165,161,78,1,12.78,1.2,0,0,0,0,0,0,0.256691757305781,155.582594395928,47.1379221262504
8.7,"random_policy_SVM","SVM",49,5,3312,3174,138,600,337,263,0.908520566644857,0.64390243902439,1.73241317297966,396,195,201,70,1,15.34,1.3,0,0,0,0,0,0,0.122512753506121,72.3461267232092,20.7839815943677
8.7,"random_policy_SVM","SVM",49,6,3212,3102,110,700,409,291,0.912002897299117,0.648780487804878,1.71482522198494,448,216,232,52,1.1,17.89,1.4,0,0,0,0,0,0,0.0741537428598561,55.0505063397042,11.0320516980028
8.7,"random_policy_SVM","SVM",49,7,3112,3027,85,800,484,316,0.906407488403848,0.678048780487805,1.6781026815793,494,240,254,46,1.1,20.45,1.5,0,0,0,0,0,0,0.0672997647829328,80.3108130159967,9.04747900526904
8.7,"random_policy_SVM","SVM",49,8,3012,2937,75,900,574,326,0.914363917482713,0.678048780487805,1.69255738880918,522,253,269,28,1.1,23.01,1.8,0,0,0,0,0,0,0.0585854314240704,81.1536428507369,7.02637887751086
8.7,"random_policy_SVM","SVM",49,9,2912,2855,57,1000,656,344,0.913880569987896,0.682926829268293,1.69567443740736,572,279,293,50,1.1,25.56,1.9,0,0,0,0,0,0,0.0967702514645272,128.938738512603,11.8326457085062
8.7,"random_policy_SVM","SVM",49,10,2812,2763,49,1100,748,352,0.921778495911758,0.682926829268293,1.71167006978257,605,293,312,33,1.1,28.12,2.1,0,0,0,0,0,0,0.0673442688616399,90.1529652731179,7.92482153138962
8.7,"random_policy_SVM","SVM",49,11,2712,2673,39,1200,838,362,0.929899290997491,0.673170731707317,1.73081794906347,642,307,335,37,1.1,30.67,2.3,0,0,0,0,0,0,0.0674896343548512,88.7030499620205,7.65092270369152
8.7,"random_policy_SVM","SVM",49,12,2612,2579,33,1300,932,368,0.935668816425463,0.702439024390244,1.73481152993348,663,316,347,21,1.1,33.23,2.5,0,0,0,0,0,0,0.0610144934156,72.2983430722128,6.52831738103262
8.7,"random_policy_SVM","SVM",49,13,2512,2481,31,1400,1030,370,0.936490646459867,0.692682926829268,1.74678125070119,669,321,348,6,1.1,35.79,2.8,0,0,0,0,0,0,0.0525877546212803,56.925309323356,5.76247910042253
8.7,"random_policy_SVM","SVM",49,14,2412,2389,23,1500,1122,378,0.938382248471259,0.697560975609756,1.75555904593085,691,330,361,22,1.1,38.34,3,0,0,0,0,0,0,0.0552870666608574,55.0823450835353,6.27525614495636
8.7,"random_policy_SVM","SVM",49,15,2312,2293,19,1600,1218,382,0.939410232480409,0.697560975609756,1.76109655311429,703,333,370,12,1.1,40.9,3.2,0,0,0,0,0,0,0.0480444810956952,51.4032214160374,5.44551579325233
8.7,"random_policy_SVM","SVM",49,16,2212,2199,13,1700,1312,388,0.940193060411485,0.68780487804878,1.76758907496909,719,341,378,16,1.1,43.46,3.4,0,0,0,0,0,0,0.0375795856231905,41.8116602065999,4.30761786706766
8.7,"random_policy_SVM","SVM",49,17,2112,2100,12,1800,1411,389,0.939886615313911,0.682926829268293,1.76271520803443,728,344,384,9,1.1,46.01,3.6,0,0,0,0,0,0,0.0313738708574928,33.7925106513791,3.36698104053258
8.7,"random_policy_SVM","SVM",49,18,2012,2000,12,1900,1511,389,0.939485450822541,0.682926829268293,1.76271520803443,727,344,383,-1,1.1,48.57,3.9,0,0,0,0,0,0,0.02599503521199,25.1949771691228,2.63317188878959
8.7,"random_policy_SVM","SVM",49,19,1912,1900,12,2000,1611,389,0.939482664958013,0.658536585365854,1.7786199019015,753,362,391,26,1.1,51.12,4.1,0,0,0,0,0,0,0.0210037021264482,14.4276126009471,2.67401391231844
8.7,"random_policy_SVM","SVM",49,20,1812,1801,11,2100,1710,390,0.939620565251922,0.658536585365854,1.78025466284075,753,363,390,0,1.1,53.68,4.4,0,0,0,0,0,0,0.0148808575685507,11.21601814429,1.716175381047
8.7,"random_policy_SVM","SVM",49,21,1712,1703,9,2200,1808,392,0.940120627933873,0.663414634146341,1.78189243161981,757,364,393,4,1.1,56.24,4.6,0,0,0,0,0,0,0.0105362787858585,9.00783333452627,1.2252104528788
8.7,"random_policy_SVM","SVM",49,22,1612,1604,8,2300,1907,393,0.940098341017686,0.668292682926829,1.78189243161981,762,365,397,5,1.1,58.79,4.9,0,0,0,0,0,0,0.0110105302051777,8.57991528074014,1.13122987068245
8.7,"random_policy_SVM","SVM",49,23,1512,1504,8,2400,2007,393,0.940714017077358,0.658536585365854,1.78189243161981,770,374,396,8,1.1,61.35,5.1,0,0,0,0,0,0,0.00710854160736683,4.98014813156883,0.884513155732058
8.7,"random_policy_SVM","SVM",49,24,1412,1405,7,2500,2106,394,0.940942457968278,0.658536585365854,1.78517702596381,773,375,398,3,1.1,63.91,5.3,0,0,0,0,0,0,0.00620898977236872,4.48941445278723,0.688940818025539
8.7,"random_policy_SVM","SVM",49,25,1312,1307,5,2600,2204,396,0.941512167263314,0.653658536585366,1.78353321654763,777,379,398,4,1.1,66.46,5.6,0,0,0,0,0,0,0.00667956926745922,4.29543871336884,0.690770184273699
8.7,"random_policy_SVM","SVM",49,26,1212,1207,5,2700,2304,396,0.941531668314977,0.653658536585366,1.78353321654763,787,384,403,10,1,69.02,5.8,0,0,0,0,0,0,0.00539670178599339,3.18468982108694,0.572169557506128
8.7,"random_policy_SVM","SVM",49,27,1112,1108,4,2800,2403,397,0.941740608154233,0.653658536585366,1.78353321654763,790,386,404,3,1,71.57,6.1,0,0,0,0,0,0,0.00444863681736268,2.34785854796165,0.46508046029825
8.7,"random_policy_SVM","SVM",49,28,1012,1008,4,2900,2503,397,0.941721107102569,0.653658536585366,1.78353321654763,792,386,406,2,1.1,74.13,6.3,0,0,0,0,0,0,0.00440231415218125,2.1214273124763,0.467525760064609
8.7,"random_policy_SVM","SVM",49,29,912,908,4,3000,2603,397,0.941736429357448,0.658536585365854,1.7786199019015,792,387,405,0,1,76.69,6.6,0,0,0,0,0,0,0.00314653406856349,1.33802433714432,0.340700350237571
8.7,"random_policy_SVM","SVM",49,30,812,808,4,3100,2703,397,0.941914724686946,0.658536585365854,1.7786199019015,794,388,406,2,1,79.24,6.8,0,0,0,0,0,0,0.00243637731193557,0.943445373398616,0.269801954404397
8.7,"random_policy_SVM","SVM",49,31,712,708,4,3200,2803,397,0.942176595952146,0.658536585365854,1.78025466284075,793,389,404,-1,1,81.8,7.1,0,0,0,0,0,0,0.00212152769573108,0.749971813210213,0.239435054651418
8.7,"random_policy_SVM","SVM",49,32,612,609,3,3300,2902,398,0.942449610675439,0.653658536585366,1.77698814052361,798,389,409,5,1.1,84.36,7.3,0,0,0,0,0,0,0.00183143028040943,0.594054335291481,0.208660387073417
8.7,"random_policy_SVM","SVM",49,33,512,509,3,3400,3002,398,0.942718446601948,0.658536585365854,1.78353321654763,803,390,413,5,1.1,86.91,7.5,0,0,0,0,0,0,0.0010623530311306,0.328367381152358,0.131674007089423
8.7,"random_policy_SVM","SVM",49,34,412,410,2,3500,3101,399,0.943190650638665,0.658536585365854,1.7786199019015,808,392,416,5,1.1,89.47,7.8,0,0,0,0,0,0,0.000832277616592695,0.238809764407686,0.105767534717144
8.7,"random_policy_SVM","SVM",49,35,312,311,1,3600,3200,400,0.943764538730486,0.658536585365854,1.78189243161981,811,394,417,3,1.1,92.02,8,0,0,0,0,0,0,0.00053050167540456,0.130261343235904,0.0676490785139161
8.7,"random_policy_SVM","SVM",49,36,212,212,0,3700,3299,401,0.944260422615652,0.658536585365854,1.7786199019015,813,397,416,2,1,94.58,8.2,0,0,0,0,0,0,0.000380966942893229,0.0826887254174319,0.0521569421730872
8.7,"random_policy_SVM","SVM",49,37,112,112,0,3800,3399,401,0.944376035993373,0.658536585365854,1.78025466284075,813,397,416,0,1,97.14,8.5,0,0,0,0,0,0,0.000153119514016245,0.0252506090913386,0.0235706927212505
8.7,"random_policy_SVM","SVM",49,38,12,12,0,3900,3499,401,0.944547366661563,0.653658536585366,1.78189243161981,814,398,416,1,1,99.69,8.7,0,0,0,0,0,0,0.000180037112983379,0.00238588266441056,0.00238588266441056
8.7,"random_policy_SVM","SVM",49,39,0,0,0,3912,3511,401,0.944530651474422,0.653658536585366,1.78025466284075,815,398,417,1,1,100,8.8,0,0,0,0,0,0,0,0,0
8.7,"random_policy_SVM","SVM",50,0,3812,3431,381,100,95,5,0.856103372434023,0.490909090909091,1.67165479681609,24,5,19,0,3.8,2.56,19,0,0,0,0,0,0,0.0714586583893139,207.385456297345,7.70051916671777
8.7,"random_policy_SVM","SVM",50,1,3712,3357,355,200,169,31,0.879252199413508,0.463636363636364,1.75359865940511,72,31,41,48,1.3,5.11,5.5,0,0,0,0,0,0,0.209429115487484,196.296683901954,31.4226703291865
8.7,"random_policy_SVM","SVM",50,2,3612,3301,311,300,225,75,0.897917103058243,0.640909090909091,1.74059157754011,158,73,85,86,1.2,7.67,3,0,0,0,0,0,0,0.312999352865563,148.447932976042,42.356050070279
8.7,"random_policy_SVM","SVM",50,3,3512,3268,244,400,258,142,0.899408253037292,0.663636363636364,1.7145003756574,240,116,124,82,1.1,10.22,1.8,0,0,0,0,0,0,0.493121638733083,223.397564764046,61.2152172627491
8.7,"random_policy_SVM","SVM",50,4,3412,3235,177,500,291,209,0.909509844993704,0.663636363636364,1.73082895066366,306,150,156,66,1,12.78,1.4,0,0,0,0,0,0,0.355896395677532,195.444534870864,52.5351188279097
8.7,"random_policy_SVM","SVM",50,5,3312,3181,131,600,345,255,0.855642542940929,0.672727272727273,1.57332216170926,383,189,194,77,1,15.34,1.4,0,0,0,0,0,0,0.166390954218003,127.162928573733,30.9587963882581
8.7,"random_policy_SVM","SVM",50,6,3212,3108,104,700,418,282,0.868100649350646,0.677272727272727,1.58971093422706,451,218,233,68,1.1,17.89,1.5,0,0,0,0,0,0,0.100343304258578,84.9512764588627,13.4480763854749
8.7,"random_policy_SVM","SVM",50,7,3112,3028,84,800,498,302,0.871202084206113,0.695454545454545,1.58532754010695,496,234,262,45,1.1,20.45,1.6,0,0,0,0,0,0,0.0840478883048415,93.3698611238158,11.1233506361951
8.7,"random_policy_SVM","SVM",50,8,3012,2950,62,900,576,324,0.870063102220355,0.695454545454545,1.58824711200402,547,260,287,51,1.1,23.01,1.8,0,0,0,0,0,0,0.0672874277186913,102.338948728637,11.1867426941661
8.7,"random_policy_SVM","SVM",50,9,2912,2859,53,1000,667,333,0.875230414746546,0.7,1.61132391067994,577,274,303,30,1.1,25.56,2,0,0,0,0,0,0,0.0658866575243696,93.5546953266285,7.42810645114573
8.7,"random_policy_SVM","SVM",50,10,2812,2763,49,1100,763,337,0.883593422706326,0.686363636363636,1.61132391067994,589,283,306,12,1.1,28.12,2.3,0,0,0,0,0,0,0.0536142322905946,73.5772880858508,5.87142768038877
8.7,"random_policy_SVM","SVM",50,11,2712,2671,41,1200,855,345,0.898387096774199,0.686363636363636,1.63887725178048,612,293,319,23,1.1,30.67,2.5,0,0,0,0,0,0,0.0554024879736337,78.5073289933265,6.47749574862946
8.7,"random_policy_SVM","SVM",50,12,2612,2577,35,1300,949,351,0.912243401759543,0.686363636363636,1.64767306088407,644,307,337,32,1.1,33.23,2.7,0,0,0,0,0,0,0.0513637983075382,69.3638992425241,5.84643850612263
8.7,"random_policy_SVM","SVM",50,13,2512,2483,29,1400,1043,357,0.925070695433609,0.686363636363636,1.70633608815427,656,315,341,12,1.1,35.79,2.9,0,0,0,0,0,0,0.05668306616562,68.0443246108043,6.35838155406595
8.7,"random_policy_SVM","SVM",50,14,2412,2389,23,1500,1137,363,0.932606304985347,0.677272727272727,1.74059157754011,678,328,350,22,1.1,38.34,3.1,0,0,0,0,0,0,0.0512614324550357,58.1151828699754,5.63615325995114
8.7,"random_policy_SVM","SVM",50,15,2312,2290,22,1600,1236,364,0.935858294930889,0.677272727272727,1.76673078531404,683,329,354,5,1.1,40.9,3.4,0,0,0,0,0,0,0.0449671840677824,48.8770074321068,4.85352624309482
8.7,"random_policy_SVM","SVM",50,16,2212,2191,21,1700,1335,365,0.937009059488918,0.677272727272727,1.76835760924159,686,330,356,3,1.1,43.46,3.7,0,0,0,0,0,0,0.0422781352215501,44.0035614007272,4.60601084664498
8.7,"random_policy_SVM","SVM",50,17,2112,2096,16,1800,1430,370,0.93896365731045,0.677272727272727,1.77818181818182,703,338,365,17,1.1,46.01,3.9,0,0,0,0,0,0,0.0431305413096851,41.2195396193015,5.1249553927784
8.7,"random_policy_SVM","SVM",50,18,2012,2000,12,1900,1526,374,0.939613007959798,0.672727272727273,1.77818181818182,712,342,370,9,1.1,48.57,4.1,0,0,0,0,0,0,0.0324499316486412,31.9250889396613,3.87365877277806
8.7,"random_policy_SVM","SVM",50,19,1912,1901,11,2000,1625,375,0.939324989526618,0.672727272727273,1.77818181818182,718,343,375,6,1.1,51.12,4.3,0,0,0,0,0,0,0.0260077661746679,25.9113691162053,2.83394440294277
8.7,"random_policy_SVM","SVM",50,20,1812,1802,10,2100,1724,376,0.938505446166754,0.672727272727273,1.77818181818182,721,347,374,3,1.1,53.68,4.6,0,0,0,0,0,0,0.0235224740688382,22.244562928137,2.39995607846516
8.7,"random_policy_SVM","SVM",50,21,1712,1702,10,2200,1824,376,0.936994658567254,0.668181818181818,1.79126871288785,739,360,379,18,1.1,56.24,4.9,0,0,0,0,0,0,0.0141985088307576,9.31721891431732,1.96493709075424
8.7,"random_policy_SVM","SVM",50,22,1612,1605,7,2300,1921,379,0.937162232928376,0.668181818181818,1.79126871288785,745,362,383,6,1.1,58.79,5.1,0,0,0,0,0,0,0.00927689032984001,7.89510074323415,1.13456920156188
8.7,"random_policy_SVM","SVM",50,23,1512,1505,7,2400,2021,379,0.93723816506076,0.668181818181818,1.79126871288785,745,362,383,0,1.1,61.35,5.3,0,0,0,0,0,0,0.00870668796728991,7.089122438586,0.898041254154005
8.7,"random_policy_SVM","SVM",50,24,1412,1405,7,2500,2121,379,0.937176633850034,0.672727272727273,1.78962232620321,752,365,387,7,1.1,63.91,5.6,0,0,0,0,0,0,0.00543508663521954,4.12304598934791,0.645250225524361
8.7,"random_policy_SVM","SVM",50,25,1312,1306,6,2600,2220,380,0.937102010892347,0.668181818181818,1.79126871288785,756,367,389,4,1.1,66.46,5.8,0,0,0,0,0,0,0.00517956046205759,3.66895422466392,0.53748769944888
8.7,"random_policy_SVM","SVM",50,26,1212,1207,5,2700,2319,381,0.937064044826152,0.668181818181818,1.79291813159216,767,373,394,11,1.1,69.02,6.1,0,0,0,0,0,0,0.00435288606495411,2.96763707482249,0.502470446498995
8.7,"random_policy_SVM","SVM",50,27,1112,1108,4,2800,2418,382,0.936553466694607,0.668181818181818,1.79291813159216,769,375,394,2,1.1,71.57,6.3,0,0,0,0,0,0,0.00394154702180176,2.48278260782529,0.41130414964231
8.7,"random_policy_SVM","SVM",50,28,1012,1008,4,2900,2518,382,0.936416003351496,0.663636363636364,1.79126871288785,770,375,395,1,1.1,74.13,6.6,0,0,0,0,0,0,0.00367855673092826,2.19044506631034,0.391205450179135
8.7,"random_policy_SVM","SVM",50,29,912,909,3,3000,2617,383,0.936099183074999,0.663636363636364,1.78633861551293,775,377,398,5,1.1,76.69,6.8,0,0,0,0,0,0,0.00279982195182013,1.47996692594633,0.296223410963882
8.7,"random_policy_SVM","SVM",50,30,812,809,3,3100,2717,383,0.936063835358199,0.659090909090909,1.78633861551293,776,378,398,1,1.1,79.24,7.1,0,0,0,0,0,0,0.00247859506903553,1.1698441162171,0.262978971810258
8.7,"random_policy_SVM","SVM",50,31,712,709,3,3200,2817,383,0.936057289484718,0.659090909090909,1.78797896318557,777,379,398,1,1.1,81.8,7.4,0,0,0,0,0,0,0.00169075392224797,0.695725441787051,0.181706719180356
8.7,"random_policy_SVM","SVM",50,32,612,610,2,3300,2916,384,0.935863531629668,0.659090909090909,1.78962232620321,783,380,403,6,1.1,84.36,7.6,0,0,0,0,0,0,0.00164690172543504,0.638989656357142,0.18290119899493
8.7,"random_policy_SVM","SVM",50,33,512,511,1,3400,3015,385,0.935995758273991,0.659090909090909,1.78306693306693,790,382,408,7,1.1,86.91,7.8,0,0,0,0,0,0,0.0013089911703186,0.467968792878498,0.152402004043293
8.7,"random_policy_SVM","SVM",50,34,412,412,0,3500,3114,386,0.936579650188529,0.659090909090909,1.78306693306693,795,384,411,5,1.1,89.47,8.1,0,0,0,0,0,0,0.00114785133539487,0.343264345572939,0.129730144154537
8.7,"random_policy_SVM","SVM",50,35,312,312,0,3600,3214,386,0.936641181399253,0.659090909090909,1.79457059069962,799,384,415,4,1.1,92.02,8.3,0,0,0,0,0,0,0.00071765541122526,0.179461467961606,0.0849660363123415
8.7,"random_policy_SVM","SVM",50,36,212,212,0,3700,3314,386,0.936620234604113,0.659090909090909,1.79126871288785,801,385,416,2,1.1,94.58,8.6,0,0,0,0,0,0,0.000465381930391449,0.0987014306918434,0.0599542567823179
8.7,"random_policy_SVM","SVM",50,37,112,112,0,3800,3414,386,0.936507645580233,0.659090909090909,1.79126871288785,799,385,414,-2,1.1,97.14,8.8,0,0,0,0,0,0,0.000263440395992463,0.0410591969457568,0.0381401716426846
8.7,"random_policy_SVM","SVM",50,38,12,12,0,3900,3514,386,0.936654273146215,0.659090909090909,1.78633861551293,803,385,418,4,1.1,99.69,9.1,0,0,0,0,0,0,0.000192360531125912,0.00260513303575053,0.00260513303575053
8.7,"random_policy_SVM","SVM",50,39,0,0,0,3912,3526,386,0.936647727272734,0.659090909090909,1.79291813159216,804,385,419,1,1.1,100,9.1,0,0,0,0,0,0,0,0,0
8.7,"random_policy_SVM","SVM",51,0,3812,3421,391,100,90,10,0.882079926453187,0.492682926829268,1.70603124648758,35,10,25,0,2.5,2.56,9,0,0,0,0,0,0,0.281765652677818,372.651202437565,32.2397542202664
8.7,"random_policy_SVM","SVM",51,1,3712,3378,334,200,133,67,0.917801674304587,0.6,1.76596146071958,108,53,55,73,1,5.11,2,0,0,0,0,0,0,0.757955251315456,403.188822555119,82.044917432229
8.7,"random_policy_SVM","SVM",51,2,3612,3334,278,300,177,123,0.920559680182756,0.609756097560976,1.75717558280555,181,90,91,73,1,7.67,1.4,0,0,0,0,0,0,0.658016610123803,330.378937743631,76.1910137111775
8.7,"random_policy_SVM","SVM",51,3,3512,3286,226,400,225,175,0.910662896463363,0.604878048780488,1.71167006978257,255,129,126,74,1,10.22,1.3,0,0,0,0,0,0,0.449649288297227,244.387071330145,64.982443646827
8.7,"random_policy_SVM","SVM",51,4,3412,3240,172,500,271,229,0.901948712234135,0.619512195121951,1.71482522198494,336,169,167,81,1,12.78,1.2,0,0,0,0,0,0,0.230251766956567,167.011429313715,39.2986155324252
8.7,"random_policy_SVM","SVM",51,5,3312,3184,128,600,327,273,0.896240475825682,0.629268292682927,1.70289227455292,416,208,208,80,1,15.34,1.2,0,0,0,0,0,0,0.158448500671533,115.04397227114,24.7384362570141
8.7,"random_policy_SVM","SVM",51,6,3212,3107,105,700,404,296,0.911250713877811,0.634146341463415,1.71167006978257,454,223,231,38,1,17.89,1.4,0,0,0,0,0,0,0.0889427305868104,72.0602233274985,12.2443959421125
8.7,"random_policy_SVM","SVM",51,7,3112,3026,86,800,485,315,0.916697079021074,0.663414634146341,1.71167006978257,502,244,258,48,1.1,20.45,1.5,0,0,0,0,0,0,0.0742233845708683,76.138433898901,8.95462849503998
8.7,"random_policy_SVM","SVM",51,8,3012,2942,70,900,569,331,0.912654789597593,0.678048780487805,1.68533668409361,551,263,288,49,1.1,23.01,1.7,0,0,0,0,0,0,0.0727420733958111,109.832551609551,11.0500971939629
8.7,"random_policy_SVM","SVM",51,9,2912,2859,53,1000,652,348,0.909215639843441,0.702439024390244,1.66931680366527,594,284,310,43,1.1,25.56,1.9,0,0,0,0,0,0,0.067624928096525,107.268401214928,8.67665089846644
8.7,"random_policy_SVM","SVM",51,10,2812,2760,52,1100,751,349,0.91857196584532,0.697560975609756,1.69411447932327,608,293,315,14,1.1,28.12,2.2,0,0,0,0,0,0,0.0506708687768714,70.281653440319,5.73377781056249
8.7,"random_policy_SVM","SVM",51,11,2712,2663,49,1200,848,352,0.924182696995463,0.697560975609756,1.7236191974823,615,300,315,7,1.1,30.67,2.4,0,0,0,0,0,0,0.0476774251668302,69.3749338503433,5.20813345172179
8.7,"random_policy_SVM","SVM",51,12,2612,2567,45,1300,944,356,0.930840913206407,0.702439024390244,1.72922566024188,628,304,324,13,1.1,33.23,2.7,0,0,0,0,0,0,0.0440713724352663,65.0537653646945,4.98762962854964
8.7,"random_policy_SVM","SVM",51,13,2512,2475,37,1400,1036,364,0.939438091125631,0.697560975609756,1.75000112397437,655,316,339,27,1.1,35.79,2.8,0,0,0,0,0,0,0.0609313472468225,61.3064471757919,6.8469803312281
8.7,"random_policy_SVM","SVM",51,14,2412,2378,34,1500,1133,367,0.941134682620387,0.68780487804878,1.7643368411605,670,320,350,15,1.1,38.34,3.1,0,0,0,0,0,0,0.0500918988643036,47.9032124576988,5.65095881886769
8.7,"random_policy_SVM","SVM",51,15,2312,2282,30,1600,1229,371,0.941541418840811,0.682926829268293,1.77638305046645,683,327,356,13,1.1,40.9,3.3,0,0,0,0,0,0,0.055984681652938,50.2061976007578,6.12586514358277
8.7,"random_policy_SVM","SVM",51,16,2212,2188,24,1700,1323,377,0.940159630037201,0.678048780487805,1.77474733863361,700,334,366,17,1.1,43.46,3.5,0,0,0,0,0,0,0.0559707258854821,44.2633669235075,6.38238966955493
8.7,"random_policy_SVM","SVM",51,17,2112,2092,20,1800,1419,381,0.939805825242726,0.68780487804878,1.76985822750789,710,340,370,10,1.1,46.01,3.7,0,0,0,0,0,0,0.0436965713993643,38.1832058870024,5.3895112972501
8.7,"random_policy_SVM","SVM",51,18,2012,1997,15,1900,1514,386,0.938541042749098,0.682926829268293,1.7643368411605,728,345,383,18,1.1,48.57,3.9,0,0,0,0,0,0,0.0360763807117857,32.5654493220166,4.17128432477959
8.7,"random_policy_SVM","SVM",51,19,1912,1899,13,2000,1612,388,0.938688693568839,0.682926829268293,1.76758907496909,733,348,385,5,1.1,51.12,4.2,0,0,0,0,0,0,0.0288582896414094,27.1441976630177,3.17907071215885
8.7,"random_policy_SVM","SVM",51,20,1812,1802,10,2100,1709,391,0.939343371731839,0.68780487804878,1.7643368411605,738,352,386,5,1.1,53.68,4.4,0,0,0,0,0,0,0.0261824068339675,24.1701358453774,2.74031630855773
8.7,"random_policy_SVM","SVM",51,21,1712,1702,10,2200,1809,391,0.939713891713454,0.682926829268293,1.77148493543759,749,358,391,11,1.1,56.24,4.6,0,0,0,0,0,0,0.0181243979228904,15.6522708406458,2.10242555082554
8.7,"random_policy_SVM","SVM",51,22,1612,1603,9,2300,1908,392,0.9403741416055,0.682926829268293,1.78189243161981,752,359,393,3,1.1,58.79,4.9,0,0,0,0,0,0,0.0169011778243842,12.8834307274718,1.69813243776532
8.7,"random_policy_SVM","SVM",51,23,1512,1504,8,2400,2007,393,0.939761251410349,0.673170731707317,1.78517702596381,772,374,398,20,1.1,61.35,5.1,0,0,0,0,0,0,0.0127969392982575,7.8242610169624,1.65814705136455
8.7,"random_policy_SVM","SVM",51,24,1412,1407,5,2500,2104,396,0.939683247203694,0.673170731707317,1.78353321654763,780,378,402,8,1.1,63.91,5.3,0,0,0,0,0,0,0.00888086807977048,6.18689344322791,1.05390265695935
8.7,"random_policy_SVM","SVM",51,25,1312,1307,5,2600,2204,396,0.939677675474648,0.673170731707317,1.78517702596381,780,378,402,0,1.1,66.46,5.6,0,0,0,0,0,0,0.00840882451416312,5.28890625559877,0.860896199154479
8.7,"random_policy_SVM","SVM",51,26,1212,1207,5,2700,2304,396,0.939885222381639,0.663414634146341,1.78025466284075,784,381,403,4,1.1,69.02,5.8,0,0,0,0,0,0,0.00726314785898957,4.31962069224491,0.836740472276566
8.7,"random_policy_SVM","SVM",51,27,1112,1107,5,2800,2404,396,0.940009193352931,0.663414634146341,1.78189243161981,783,381,402,-1,1.1,71.57,6.1,0,0,0,0,0,0,0.00562289374324226,2.98432732942261,0.577429444100654
8.7,"random_policy_SVM","SVM",51,28,1012,1007,5,2900,2504,396,0.939669317881075,0.658536585365854,1.78025466284075,786,385,401,3,1,74.13,6.3,0,0,0,0,0,0,0.00450995874164933,2.16564557634622,0.492619464443053
8.7,"random_policy_SVM","SVM",51,29,912,908,4,3000,2603,397,0.940076054101493,0.663414634146341,1.78517702596381,788,386,402,2,1,76.69,6.6,0,0,0,0,0,0,0.00396005139089448,1.67124855045895,0.427715523749061
8.7,"random_policy_SVM","SVM",51,30,812,808,4,3100,2703,397,0.939928403281752,0.658536585365854,1.79397100146117,791,388,403,3,1,79.24,6.8,0,0,0,0,0,0,0.00280768119760769,1.02081312289843,0.313612549980284
8.7,"random_policy_SVM","SVM",51,31,712,709,3,3200,2802,398,0.940371355740973,0.658536585365854,1.79397100146117,797,389,408,6,1,81.8,7,0,0,0,0,0,0,0.00254828119186066,0.854558231339177,0.2898217730979
8.7,"random_policy_SVM","SVM",51,32,612,610,2,3300,2901,399,0.940365784011926,0.653658536585366,1.79397100146117,800,391,409,3,1,84.36,7.3,0,0,0,0,0,0,0.00211618856374484,0.696776356207863,0.255609043021552
8.7,"random_policy_SVM","SVM",51,33,512,510,2,3400,3001,399,0.940608154225462,0.653658536585366,1.78517702596381,802,391,411,2,1.1,86.91,7.5,0,0,0,0,0,0,0.0012759664001603,0.401462964446067,0.16158858362135
8.7,"random_policy_SVM","SVM",51,34,412,411,1,3500,3100,400,0.940828237522811,0.653658536585366,1.78517702596381,806,393,413,4,1.1,89.47,7.8,0,0,0,0,0,0,0.000987101299193713,0.300345517867639,0.123746916514708
8.7,"random_policy_SVM","SVM",51,35,312,312,0,3600,3199,401,0.94091738518756,0.658536585365854,1.78025466284075,812,396,416,6,1.1,92.02,8,0,0,0,0,0,0,0.000956476135584376,0.241569938522482,0.113379333892099
8.7,"random_policy_SVM","SVM",51,36,212,212,0,3700,3299,401,0.940956387290888,0.653658536585366,1.78353321654763,815,398,417,3,1,94.58,8.2,0,0,0,0,0,0,0.000499832011031491,0.105167589038912,0.0649203985054125
8.7,"random_policy_SVM","SVM",51,37,112,112,0,3800,3399,401,0.940998175258739,0.648780487804878,1.78189243161981,814,399,415,-1,1,97.14,8.5,0,0,0,0,0,0,0.000210603265356729,0.0332254286492601,0.0310550661742485
8.7,"random_policy_SVM","SVM",51,38,12,12,0,3900,3499,401,0.940812915267932,0.648780487804878,1.78353321654763,820,400,420,6,1.1,99.69,8.7,0,0,0,0,0,0,0.000140854482357944,0.00191328194335638,0.00191328194335638
8.7,"random_policy_SVM","SVM",51,39,0,0,0,3912,3511,401,0.940870025490662,0.648780487804878,1.78353321654763,820,400,420,0,1.1,100,8.8,0,0,0,0,0,0,0,0,0
8.7,"random_policy_SVM","SVM",52,0,3812,3410,402,100,89,11,0.906750445983799,0.559585492227979,1.74961104212164,24,11,13,0,1.2,2.56,8.1,0,0,0,0,0,0,0.757039661687439,449.164763787727,80.5137498137845
8.7,"random_policy_SVM","SVM",52,1,3712,3359,353,200,140,60,0.906970866310667,0.564766839378238,1.75606122107877,107,51,56,83,1.1,5.11,2.3,0,0,0,0,0,0,0.709824671249472,333.487956122702,77.7041913865356
8.7,"random_policy_SVM","SVM",52,2,3612,3318,294,300,181,119,0.907734990110494,0.601036269430052,1.74800589437657,180,92,88,73,1,7.67,1.5,0,0,0,0,0,0,0.626694074531831,228.965879081191,76.0650991844686
8.7,"random_policy_SVM","SVM",52,3,3512,3280,232,400,219,181,0.906612315912276,0.601036269430052,1.75283019767292,247,125,122,67,1,10.22,1.2,0,0,0,0,0,0,0.361081023010567,151.41577420791,66.2569111983452
8.7,"random_policy_SVM","SVM",52,4,3412,3236,176,500,263,237,0.886568760855693,0.601036269430052,1.71553593814797,320,161,159,73,1,12.78,1.1,0,0,0,0,0,0,0.19346672646525,105.066602855219,37.7608166505468
8.7,"random_policy_SVM","SVM",52,5,3312,3178,134,600,321,279,0.895391451805846,0.601036269430052,1.68756524350425,393,194,199,73,1,15.34,1.2,0,0,0,0,0,0,0.106790294119136,69.6914767333251,17.5260285726778
8.7,"random_policy_SVM","SVM",52,6,3212,3108,104,700,391,309,0.898327450559722,0.61139896373057,1.69067596284711,468,227,241,75,1.1,17.89,1.3,0,0,0,0,0,0,0.0942781314709652,84.9043712136182,12.1295488284903
8.7,"random_policy_SVM","SVM",52,7,3112,3032,80,800,467,333,0.895337081458541,0.647668393782383,1.64572895374816,519,251,268,51,1.1,20.45,1.4,0,0,0,0,0,0,0.0735671219594793,105.478182493909,11.4200697454626
8.7,"random_policy_SVM","SVM",52,8,3012,2948,64,900,551,349,0.903573454339205,0.658031088082902,1.67669917708016,567,274,293,48,1.1,23.01,1.6,0,0,0,0,0,0,0.0639195861010394,103.982804240015,8.1603952457542
8.7,"random_policy_SVM","SVM",52,9,2912,2857,55,1000,642,358,0.912491660764306,0.647668393782383,1.68601417250838,590,284,306,23,1.1,25.56,1.8,0,0,0,0,0,0,0.0570916304081561,90.7401405256288,6.40916822252082
8.7,"random_policy_SVM","SVM",52,10,2812,2769,43,1100,730,370,0.92266773252142,0.652849740932642,1.70464416336483,622,300,322,32,1.1,28.12,2,0,0,0,0,0,0,0.0923342665269327,112.482883652101,10.8020909721726
8.7,"random_policy_SVM","SVM",52,11,2712,2673,39,1200,826,374,0.928012190713558,0.652849740932642,1.7325891496495,645,311,334,23,1.1,30.67,2.2,0,0,0,0,0,0,0.0727159918996983,88.5286601004879,8.20767126285237
8.7,"random_policy_SVM","SVM",52,12,2612,2574,38,1300,925,375,0.928504462776903,0.652849740932642,1.73418306791044,654,315,339,9,1.1,33.23,2.5,0,0,0,0,0,0,0.0538112175583888,60.2488041058091,5.77817328817267
8.7,"random_policy_SVM","SVM",52,13,2512,2477,35,1400,1022,378,0.929946011714632,0.647668393782383,1.75444422179601,660,320,340,6,1.1,35.79,2.7,0,0,0,0,0,0,0.0471689027341296,48.1148165650368,5.23543338519026
8.7,"random_policy_SVM","SVM",52,14,2412,2380,32,1500,1119,381,0.929903397118109,0.647668393782383,1.74961104212164,674,326,348,14,1.1,38.34,2.9,0,0,0,0,0,0,0.0421710725252251,41.6183207056171,4.75716896389227
8.7,"random_policy_SVM","SVM",52,15,2312,2291,21,1600,1208,392,0.928766028231467,0.647668393782383,1.75121914050594,696,334,362,22,1.1,40.9,3.1,0,0,0,0,0,0,0.0423246128193441,41.5437956993623,5.46261216532571
8.7,"random_policy_SVM","SVM",52,16,2212,2195,17,1700,1304,396,0.929093719784077,0.652849740932642,1.75444422179601,708,339,369,12,1.1,43.46,3.3,0,0,0,0,0,0,0.0331766887396635,37.804252382097,3.9816664884401
8.7,"random_policy_SVM","SVM",52,17,2112,2096,16,1800,1403,397,0.929149559600217,0.652849740932642,1.75121914050594,712,341,371,4,1.1,46.01,3.5,0,0,0,0,0,0,0.0276882675137859,31.9039235145279,2.96489066914315
8.7,"random_policy_SVM","SVM",52,18,2012,1997,15,1900,1502,398,0.928489768088459,0.647668393782383,1.75283019767292,728,345,383,16,1.1,48.57,3.8,0,0,0,0,0,0,0.0233979303949647,25.8429617591547,2.53556514860533
8.7,"random_policy_SVM","SVM",52,19,1912,1899,13,2000,1600,400,0.928334004390807,0.642487046632124,1.75283019767292,734,347,387,6,1.1,51.12,4,0,0,0,0,0,0,0.0232096304188883,23.4549430252159,2.346008342429
8.7,"random_policy_SVM","SVM",52,20,1812,1800,12,2100,1699,401,0.925715410907593,0.632124352331606,1.76215376255416,749,365,384,15,1.1,53.68,4.2,0,0,0,0,0,0,0.016509494021618,10.5429206788035,2.0728679570797
8.7,"random_policy_SVM","SVM",52,21,1712,1702,10,2200,1797,403,0.92540976138767,0.632124352331606,1.76377637191195,753,367,386,4,1.1,56.24,4.5,0,0,0,0,0,0,0.0117800500397908,8.55544643482094,1.4211853053029
8.7,"random_policy_SVM","SVM",52,22,1612,1605,7,2300,1894,406,0.925650754278381,0.632124352331606,1.75283019767292,762,369,393,9,1.1,58.79,4.7,0,0,0,0,0,0,0.00990391957357944,8.03716777451486,1.11838123201909
8.7,"random_policy_SVM","SVM",52,23,1512,1507,5,2400,1992,408,0.926006365739062,0.632124352331606,1.75283019767292,769,372,397,7,1.1,61.35,4.9,0,0,0,0,0,0,0.00922154468506834,7.56604291098328,0.994786300832853
8.7,"random_policy_SVM","SVM",52,24,1412,1407,5,2500,2092,408,0.926012243614445,0.632124352331606,1.75730379807007,771,372,399,2,1.1,63.91,5.1,0,0,0,0,0,0,0.00799477523223246,6.3149772218478,0.843727966522524
8.7,"random_policy_SVM","SVM",52,25,1312,1308,4,2600,2191,409,0.92594464804754,0.632124352331606,1.74961104212164,774,375,399,3,1.1,66.46,5.4,0,0,0,0,0,0,0.00727248125790727,5.24979924690166,0.759043547448805
8.7,"random_policy_SVM","SVM",52,26,1212,1208,4,2700,2291,409,0.927196635504148,0.626943005181347,1.76377637191195,790,382,408,16,1.1,69.02,5.6,0,0,0,0,0,0,0.00572812910582645,3.80067827272392,0.649566541360684
8.7,"random_policy_SVM","SVM",52,27,1112,1109,3,2800,2390,410,0.927302437261043,0.626943005181347,1.76377637191195,791,383,408,1,1.1,71.57,5.8,0,0,0,0,0,0,0.00610414640790771,3.55619243052828,0.619681268590252
8.7,"random_policy_SVM","SVM",52,28,1012,1009,3,2900,2490,410,0.928182649099669,0.621761658031088,1.76053413593417,789,387,402,-2,1,74.13,6.1,0,0,0,0,0,0,0.00456710205145361,2.36003884736125,0.498484998683539
8.7,"random_policy_SVM","SVM",52,29,912,909,3,3000,2590,410,0.928203221663508,0.621761658031088,1.76053413593417,789,387,402,0,1,76.69,6.3,0,0,0,0,0,0,0.00375728083407777,1.60643151551816,0.38837129060916
8.7,"random_policy_SVM","SVM",52,30,812,809,3,3100,2690,410,0.92907314722021,0.626943005181347,1.76377637191195,793,388,405,4,1,79.24,6.6,0,0,0,0,0,0,0.00314513464300874,1.17186511129922,0.34332061244959
8.7,"random_policy_SVM","SVM",52,31,712,709,3,3200,2790,410,0.92908637243982,0.626943005181347,1.75891748383505,794,389,405,1,1,81.8,6.8,0,0,0,0,0,0,0.00219199335643346,0.709325346337316,0.24870251809204
8.7,"random_policy_SVM","SVM",52,32,612,611,1,3300,2888,412,0.929988626311133,0.621761658031088,1.76215376255416,803,394,409,9,1,84.36,7,0,0,0,0,0,0,0.00210542588996323,0.67106391217967,0.257858743126832
8.7,"random_policy_SVM","SVM",52,33,512,511,1,3400,2988,412,0.930548493941374,0.616580310880829,1.76053413593417,807,395,412,4,1,86.91,7.3,0,0,0,0,0,0,0.00117672368279126,0.389291165534608,0.158010210058227
8.7,"random_policy_SVM","SVM",52,34,412,411,1,3500,3088,412,0.930874716025136,0.616580310880829,1.76053413593417,811,395,416,4,1.1,89.47,7.5,0,0,0,0,0,0,0.000675685755837123,0.194433996793214,0.0842644443377155
8.7,"random_policy_SVM","SVM",52,35,312,312,0,3600,3187,413,0.931277350488881,0.626943005181347,1.76053413593417,813,397,416,2,1,92.02,7.7,0,0,0,0,0,0,0.000611156007421127,0.154943901833781,0.0757942958468092
8.7,"random_policy_SVM","SVM",52,36,212,212,0,3700,3287,413,0.931481606658446,0.626943005181347,1.75569307048247,818,400,418,5,1,94.58,8,0,0,0,0,0,0,0.00035777949580887,0.0741116181512968,0.0454988299184558
8.7,"random_policy_SVM","SVM",52,37,112,112,0,3800,3387,413,0.931503648691134,0.626943005181347,1.76377637191195,822,402,420,4,1,97.14,8.2,0,0,0,0,0,0,0.00016129372705426,0.0265325835521499,0.024785121915716
8.7,"random_policy_SVM","SVM",52,38,12,12,0,3900,3487,413,0.931531568599207,0.626943005181347,1.76377637191195,822,403,419,0,1,99.69,8.4,0,0,0,0,0,0,0.000114915610338313,0.00161081123342045,0.00161081123342045
8.7,"random_policy_SVM","SVM",52,39,0,0,0,3912,3499,413,0.931516873910749,0.626943005181347,1.76215376255416,821,403,418,-1,1,100,8.5,0,0,0,0,0,0,0,0,0
8.7,"random_policy_SVM","SVM",53,0,3812,3416,396,100,83,17,0.909802532776505,0.533678756476684,1.75121914050594,38,17,21,0,1.2,2.56,4.9,0,0,0,0,0,0,0.918703796895496,718.127182779799,94.1830576139833
8.7,"random_policy_SVM","SVM",53,1,3712,3345,367,200,154,46,0.914978002051387,0.575129533678757,1.73870799068308,101,46,55,63,1.2,5.11,3.3,0,0,0,0,0,0,0.455267443051696,442.55476580765,54.1886350696761
8.7,"random_policy_SVM","SVM",53,2,3612,3316,296,300,183,117,0.926964459426506,0.606217616580311,1.76053413593417,173,85,88,72,1,7.67,1.6,0,0,0,0,0,0,0.538224572134121,295.436475872595,71.3867553458122
8.7,"random_policy_SVM","SVM",53,3,3512,3267,245,400,232,168,0.920851469028013,0.632124352331606,1.74350663279168,252,126,126,79,1,10.22,1.4,0,0,0,0,0,0,0.397228056033301,216.888172981248,58.879679682149
8.7,"random_policy_SVM","SVM",53,4,3412,3234,178,500,265,235,0.915245445381327,0.652849740932642,1.74511207168007,330,168,162,78,1,12.78,1.1,0,0,0,0,0,0,0.248382250989441,139.798893488503,41.2200066615496
8.7,"random_policy_SVM","SVM",53,5,3312,3178,134,600,321,279,0.891520870866019,0.637305699481865,1.65959454886053,416,207,209,86,1,15.34,1.2,0,0,0,0,0,0,0.175570214733249,175.692821851369,24.6595979570353
8.7,"random_policy_SVM","SVM",53,6,3212,3105,107,700,394,306,0.90171604571812,0.663212435233161,1.66112272063665,480,234,246,64,1.1,17.89,1.3,0,0,0,0,0,0,0.114067025801407,135.916087895236,15.6490857619707
8.7,"random_policy_SVM","SVM",53,7,3112,3027,85,800,472,328,0.897513364819157,0.683937823834197,1.63943919536727,527,253,274,47,1.1,20.45,1.4,0,0,0,0,0,0,0.0948347906341175,150.155237719001,12.4243413552256
8.7,"random_policy_SVM","SVM",53,8,3012,2952,60,900,547,353,0.899905660100106,0.683937823834197,1.66265370931926,596,282,314,69,1.1,23.01,1.5,0,0,0,0,0,0,0.104124687551044,174.80530447975,13.8394122628023
8.7,"random_policy_SVM","SVM",53,9,2912,2858,54,1000,641,359,0.912230095309764,0.683937823834197,1.67983829641861,613,296,317,17,1.1,25.56,1.8,0,0,0,0,0,0,0.077293800437009,119.453450521246,9.39427964208083
8.7,"random_policy_SVM","SVM",53,10,2812,2768,44,1100,731,369,0.916290237730681,0.678756476683938,1.68601417250838,640,304,336,27,1.1,28.12,2,0,0,0,0,0,0,0.0667295236384282,101.753282591178,7.33434236014041
8.7,"random_policy_SVM","SVM",53,11,2712,2671,41,1200,828,372,0.921957979068909,0.678756476683938,1.67983829641861,660,317,343,20,1.1,30.67,2.2,0,0,0,0,0,0,0.0621768011976861,85.5019120367128,6.81238234606837
8.7,"random_policy_SVM","SVM",53,12,2612,2577,35,1300,922,378,0.926335526760512,0.673575129533679,1.72327415422127,671,322,349,11,1.1,33.23,2.4,0,0,0,0,0,0,0.0538287978373915,68.8048794684199,5.90730255954163
8.7,"random_policy_SVM","SVM",53,13,2512,2480,32,1400,1019,381,0.931258247393911,0.673575129533679,1.73737971872687,680,327,353,9,1.1,35.79,2.7,0,0,0,0,0,0,0.0549391581185987,65.890844352814,5.96795742230825
8.7,"random_policy_SVM","SVM",53,14,2412,2384,28,1500,1115,385,0.933400732971071,0.673575129533679,1.74672046990282,694,334,360,14,1.1,38.34,2.9,0,0,0,0,0,0,0.0454225741075556,51.8057193631815,5.16290876759924
8.7,"random_policy_SVM","SVM",53,15,2312,2288,24,1600,1211,389,0.934561613359238,0.66839378238342,1.73418306791044,708,339,369,14,1.1,40.9,3.1,0,0,0,0,0,0,0.0421419355039157,49.6162034292632,4.76557452844295
8.7,"random_policy_SVM","SVM",53,16,2212,2194,18,1700,1305,395,0.936592419304122,0.66839378238342,1.74511207168007,722,346,376,14,1.1,43.46,3.3,0,0,0,0,0,0,0.038426615860777,44.7000106120074,4.26003201434615
8.7,"random_policy_SVM","SVM",53,17,2112,2100,12,1800,1399,401,0.937963433737246,0.678756476683938,1.74511207168007,739,353,386,17,1.1,46.01,3.5,0,0,0,0,0,0,0.0383863253498754,44.3389252492391,4.19381463447723
8.7,"random_policy_SVM","SVM",53,18,2012,2000,12,1900,1499,401,0.938614408435936,0.683937823834197,1.74672046990282,740,354,386,1,1.1,48.57,3.7,0,0,0,0,0,0,0.0314130781147854,32.4635581568165,3.20144162968482
8.7,"random_policy_SVM","SVM",53,19,1912,1901,11,2000,1598,402,0.939366776484979,0.663212435233161,1.77474272343067,763,370,393,23,1.1,51.12,4,0,0,0,0,0,0,0.024797000765807,17.9587201212272,3.23092243255894
8.7,"random_policy_SVM","SVM",53,20,1812,1801,11,2100,1698,402,0.939299180918072,0.663212435233161,1.7714773274354,763,370,393,0,1.1,53.68,4.2,0,0,0,0,0,0,0.0158558052377158,12.6849660413064,1.84954403221381
8.7,"random_policy_SVM","SVM",53,21,1712,1701,11,2200,1798,402,0.939131661469653,0.663212435233161,1.76984913136239,764,370,394,1,1.1,56.24,4.5,0,0,0,0,0,0,0.0125595263658325,10.8732841097623,1.36855560355783
8.7,"random_policy_SVM","SVM",53,22,1612,1603,9,2300,1896,404,0.939419677363427,0.66839378238342,1.7714773274354,771,373,398,7,1.1,58.79,4.7,0,0,0,0,0,0,0.0117623841505661,9.69353360004711,1.21409910697661
8.7,"random_policy_SVM","SVM",53,23,1512,1504,8,2400,1995,405,0.939194848630021,0.663212435233161,1.77310852202788,783,379,404,12,1.1,61.35,4.9,0,0,0,0,0,0,0.00915494307644633,6.79735945486936,1.07550410567354
8.7,"random_policy_SVM","SVM",53,24,1412,1406,6,2500,2093,407,0.939484333992644,0.66839378238342,1.7714773274354,790,381,409,7,1.1,63.91,5.1,0,0,0,0,0,0,0.00788832240065955,5.61358422123836,0.818452554446654
8.7,"random_policy_SVM","SVM",53,25,1312,1308,4,2600,2191,409,0.939801739263334,0.652849740932642,1.77474272343067,798,390,408,8,1,66.46,5.4,0,0,0,0,0,0,0.00672011075403784,4.37078081205509,0.70557138537234
8.7,"random_policy_SVM","SVM",53,26,1212,1208,4,2700,2291,409,0.939954564023295,0.647668393782383,1.77474272343067,799,391,408,1,1,69.02,5.6,0,0,0,0,0,0,0.00646081829852791,3.80622750284613,0.672500999456141
8.7,"random_policy_SVM","SVM",53,27,1112,1108,4,2800,2391,409,0.940039793216351,0.647668393782383,1.77474272343067,804,392,412,5,1.1,71.57,5.8,0,0,0,0,0,0,0.00588161548048178,3.05845643124715,0.613355138084468
8.7,"random_policy_SVM","SVM",53,28,1012,1009,3,2900,2490,410,0.940077999406341,0.647668393782383,1.77474272343067,813,395,418,9,1.1,74.13,6.1,0,0,0,0,0,0,0.00531648364377865,2.41086687183221,0.557635077445216
8.7,"random_policy_SVM","SVM",53,29,912,910,2,3000,2589,411,0.940407160427798,0.647668393782383,1.77474272343067,818,396,422,5,1.1,76.69,6.3,0,0,0,0,0,0,0.00470163103801244,2.00751064176406,0.510883137310407
8.7,"random_policy_SVM","SVM",53,30,812,810,2,3100,2689,411,0.940583496689293,0.647668393782383,1.77474272343067,818,397,421,0,1.1,79.24,6.5,0,0,0,0,0,0,0.00382465179025189,1.44060291694846,0.418082088950494
8.7,"random_policy_SVM","SVM",53,31,712,710,2,3200,2789,411,0.940468878119322,0.647668393782383,1.77474272343067,817,397,420,-1,1.1,81.8,6.8,0,0,0,0,0,0,0.00291616478348259,0.99123080046203,0.329442583884797
8.7,"random_policy_SVM","SVM",53,32,612,610,2,3300,2889,411,0.940580557751603,0.647668393782383,1.77474272343067,817,397,420,0,1.1,84.36,7,0,0,0,0,0,0,0.00194345857527133,0.658102850598349,0.246325182872505
8.7,"random_policy_SVM","SVM",53,33,512,510,2,3400,2989,411,0.940649622787356,0.647668393782383,1.77310852202788,818,399,419,1,1.1,86.91,7.3,0,0,0,0,0,0,0.00124289224345587,0.390868177649258,0.153057931271933
8.7,"random_policy_SVM","SVM",53,34,412,412,0,3500,3087,413,0.940821550642317,0.652849740932642,1.76822392554847,833,403,430,15,1.1,89.47,7.5,0,0,0,0,0,0,0.00124942307713058,0.374921515665764,0.150602564049155
8.7,"random_policy_SVM","SVM",53,35,312,312,0,3600,3187,413,0.941268269171438,0.652849740932642,1.76984913136239,836,405,431,3,1.1,92.02,7.7,0,0,0,0,0,0,0.000811236892108032,0.202313170034439,0.0971478080444784
8.7,"random_policy_SVM","SVM",53,36,212,212,0,3700,3287,413,0.941672373104033,0.652849740932642,1.76984913136239,839,405,434,3,1.1,94.58,8,0,0,0,0,0,0,0.000412302677372198,0.0857773579892369,0.0541146966719746
8.7,"random_policy_SVM","SVM",53,37,112,112,0,3800,3387,413,0.942155828354301,0.652849740932642,1.77474272343067,841,407,434,2,1.1,97.14,8.2,0,0,0,0,0,0,0.000157685254006816,0.0252867128650706,0.023589777583587
8.7,"random_policy_SVM","SVM",53,38,12,12,0,3900,3487,413,0.942135255790459,0.658031088082902,1.76822392554847,840,408,432,-1,1.1,99.69,8.4,0,0,0,0,0,0,0.000106557073729531,0.00149236060152037,0.00149236060152037
8.7,"random_policy_SVM","SVM",53,39,0,0,0,3912,3499,413,0.942113213757772,0.658031088082902,1.77310852202788,840,408,432,0,1.1,100,8.5,0,0,0,0,0,0,0,0,0
8.7,"random_policy_SVM","SVM",54,0,3812,3414,398,100,92,8,0.864161446469255,0.515,1.67785321100917,22,8,14,0,1.8,2.56,11.5,0,0,0,0,0,0,0.5,297.763357953031,58.0653463763868
8.7,"random_policy_SVM","SVM",54,1,3712,3382,330,200,124,76,0.894350797266521,0.545,1.72164055299539,96,49,47,74,1,5.11,1.6,0,0,0,0,0,0,0.746252746597371,322.675215448164,82.3110542226837
8.7,"random_policy_SVM","SVM",54,2,3612,3339,273,300,167,133,0.890605068337136,0.56,1.69303867403315,162,82,80,66,1,7.67,1.3,0,0,0,0,0,0,0.606802608301529,223.435237016973,74.3679588560811
8.7,"random_policy_SVM","SVM",54,3,3512,3296,216,400,210,190,0.886084851936237,0.58,1.7126267281106,238,120,118,76,1,10.22,1.1,0,0,0,0,0,0,0.322069868435789,138.367526436178,57.0410601820047
8.7,"random_policy_SVM","SVM",54,4,3412,3252,160,500,254,246,0.862495728929384,0.58,1.65397058823529,313,157,156,75,1,12.78,1,0,0,0,0,0,0,0.21015518307984,135.808822896501,35.7137233545744
8.7,"random_policy_SVM","SVM",54,5,3312,3186,126,600,320,280,0.875190774487472,0.605,1.65701657458564,383,189,194,70,1,15.34,1.1,0,0,0,0,0,0,0.0910850642661785,53.6645163802965,15.7191022386207
8.7,"random_policy_SVM","SVM",54,6,3212,3110,102,700,396,304,0.873895216400909,0.61,1.6285004599816,435,208,227,52,1.1,17.89,1.3,0,0,0,0,0,0,0.0691517166595939,53.8032899721026,9.40601837991467
8.7,"random_policy_SVM","SVM",54,7,3112,3030,82,800,476,324,0.876719817767646,0.62,1.61347465437788,481,230,251,46,1.1,20.45,1.5,0,0,0,0,0,0,0.0666863545637127,86.2875893045123,9.22385793272881
8.7,"random_policy_SVM","SVM",54,8,3012,2943,69,900,563,337,0.876167425968112,0.63,1.60902573529412,515,245,270,34,1.1,23.01,1.7,0,0,0,0,0,0,0.0541843304502914,84.6254199290293,6.3195727804198
8.7,"random_policy_SVM","SVM",54,9,2912,2852,60,1000,654,346,0.886258542141232,0.625,1.63900552486188,542,262,280,27,1.1,25.56,1.9,0,0,0,0,0,0,0.0594243845571431,94.6806238919582,7.01594244315412
8.7,"random_policy_SVM","SVM",54,10,2812,2764,48,1100,742,358,0.903308656036449,0.62,1.68837465564738,591,285,306,49,1.1,28.12,2.1,0,0,0,0,0,0,0.0511358901935896,73.0541779820958,6.39086630665534
8.7,"random_policy_SVM","SVM",54,11,2712,2669,43,1200,837,363,0.909729498861049,0.615,1.70947562097516,600,289,311,9,1.1,30.67,2.3,0,0,0,0,0,0,0.041510236119878,58.8593840847064,4.52565434147487
8.7,"random_policy_SVM","SVM",54,12,2612,2574,38,1300,932,368,0.918308656036457,0.605,1.72429752066116,617,302,315,17,1,33.23,2.5,0,0,0,0,0,0,0.0377104925177862,45.7438978589663,4.22120791609729
8.7,"random_policy_SVM","SVM",54,13,2512,2485,27,1400,1021,379,0.921292710706183,0.615,1.71847286108556,651,314,337,34,1.1,35.79,2.7,0,0,0,0,0,0,0.0620108620463422,52.5634742689485,7.27092434547218
8.7,"random_policy_SVM","SVM",54,14,2412,2387,25,1500,1119,381,0.92113895216404,0.61,1.72906077348066,663,318,345,12,1.1,38.34,2.9,0,0,0,0,0,0,0.0511327438747238,40.4002259783802,5.68948277459848
8.7,"random_policy_SVM","SVM",54,15,2312,2289,23,1600,1217,383,0.921103359908914,0.605,1.72906077348066,673,325,348,10,1.1,40.9,3.2,0,0,0,0,0,0,0.0430495642792621,32.5675542971313,4.74557384917477
8.7,"random_policy_SVM","SVM",54,16,2212,2197,15,1700,1309,391,0.91993166287018,0.605,1.72429752066116,690,332,358,17,1.1,43.46,3.3,0,0,0,0,0,0,0.041009739009733,30.9006657900827,5.40733855869388
8.7,"random_policy_SVM","SVM",54,17,2112,2103,9,1800,1403,397,0.919352220956741,0.605,1.72588235294118,703,337,366,13,1.1,46.01,3.5,0,0,0,0,0,0,0.028066528792118,26.7620757412813,3.87630549406688
8.7,"random_policy_SVM","SVM",54,18,2012,2004,8,1900,1502,398,0.919318052391821,0.605,1.72906077348066,707,339,368,4,1.1,48.57,3.8,0,0,0,0,0,0,0.0226094150995202,21.0113483485202,2.31860492762001
8.7,"random_policy_SVM","SVM",54,19,1912,1904,8,2000,1602,398,0.918695899772228,0.59,1.76345906163753,731,355,376,24,1.1,51.12,4,0,0,0,0,0,0,0.0178447333907572,11.7554087585809,2.39046918116
8.7,"random_policy_SVM","SVM",54,20,1812,1804,8,2100,1702,398,0.918600512528492,0.59,1.76508287292818,732,354,378,1,1.1,53.68,4.3,0,0,0,0,0,0,0.0108662004758748,8.17403593300617,1.29170704281677
8.7,"random_policy_SVM","SVM",54,21,1712,1705,7,2200,1801,399,0.918582004555828,0.595,1.76670967741935,736,355,381,4,1.1,56.24,4.5,0,0,0,0,0,0,0.00893287141186669,7.30034551169478,0.991749633988786
8.7,"random_policy_SVM","SVM",54,22,1612,1606,6,2300,1900,400,0.918414009111637,0.59,1.76345906163753,742,359,383,6,1.1,58.79,4.8,0,0,0,0,0,0,0.00892686524296513,6.73553483050778,0.911289435296783
8.7,"random_policy_SVM","SVM",54,23,1512,1507,5,2400,1999,401,0.918086560364482,0.59,1.76345906163753,753,368,385,11,1,61.35,5,0,0,0,0,0,0,0.00647393836573441,4.65404260182761,0.816280419944219
8.7,"random_policy_SVM","SVM",54,24,1412,1407,5,2500,2099,401,0.918096526195917,0.59,1.76508287292818,753,368,385,0,1,63.91,5.2,0,0,0,0,0,0,0.00520032557230304,3.35752435347562,0.536661015452938
8.7,"random_policy_SVM","SVM",54,25,1312,1307,5,2600,2199,401,0.918542141230086,0.58,1.76183823529412,759,370,389,6,1.1,66.46,5.5,0,0,0,0,0,0,0.00396516282581277,2.37621618940933,0.434972437072775
8.7,"random_policy_SVM","SVM",54,26,1212,1208,4,2700,2298,402,0.919114464692499,0.585,1.76345906163753,762,372,390,3,1,69.02,5.7,0,0,0,0,0,0,0.00388318087867376,2.09215582967459,0.404875554107961
8.7,"random_policy_SVM","SVM",54,27,1112,1108,4,2800,2398,402,0.919201309795004,0.585,1.76183823529412,766,374,392,4,1,71.57,6,0,0,0,0,0,0,0.00335372429333711,1.59753925491196,0.354533270165267
8.7,"random_policy_SVM","SVM",54,28,1012,1009,3,2900,2497,403,0.919434794988625,0.585,1.76508287292818,770,376,394,4,1,74.13,6.2,0,0,0,0,0,0,0.00299362683921204,1.3209048336387,0.32348673267959
8.7,"random_policy_SVM","SVM",54,29,912,910,2,3000,2596,404,0.919712414578603,0.585,1.77408839779006,773,377,396,3,1.1,76.69,6.4,0,0,0,0,0,0,0.00279511903031307,1.12226661441366,0.304239156222912
8.7,"random_policy_SVM","SVM",54,30,812,810,2,3100,2696,404,0.919723804100243,0.585,1.77572350230415,775,378,397,2,1.1,79.24,6.7,0,0,0,0,0,0,0.00242635055231781,0.884864476308182,0.269346548513961
8.7,"random_policy_SVM","SVM",54,31,712,710,2,3200,2796,404,0.919820615034183,0.585,1.77408839779006,776,378,398,1,1.1,81.8,6.9,0,0,0,0,0,0,0.00186140933381592,0.596430207625791,0.210875071172237
8.7,"random_policy_SVM","SVM",54,32,612,610,2,3300,2896,404,0.919814920273363,0.585,1.77572350230415,773,378,395,-3,1,84.36,7.2,0,0,0,0,0,0,0.00104693468514526,0.329308867415058,0.134662650531199
8.7,"random_policy_SVM","SVM",54,33,512,510,2,3400,2996,404,0.920015660592269,0.585,1.77408839779006,775,379,396,2,1,86.91,7.4,0,0,0,0,0,0,0.00073363995136612,0.231192524699305,0.095045281887589
8.7,"random_policy_SVM","SVM",54,34,412,412,0,3500,3094,406,0.920563781321196,0.585,1.77572350230415,784,384,400,9,1,89.47,7.6,0,0,0,0,0,0,0.000652808973589159,0.204009544497334,0.0829610712154289
8.7,"random_policy_SVM","SVM",54,35,312,312,0,3600,3194,406,0.920459851936229,0.585,1.77408839779006,787,385,402,3,1,92.02,7.9,0,0,0,0,0,0,0.000402785575926806,0.104648808171094,0.0495862619288334
8.7,"random_policy_SVM","SVM",54,36,212,212,0,3700,3294,406,0.920797266514816,0.585,1.77572350230415,790,387,403,3,1,94.58,8.1,0,0,0,0,0,0,0.000257118962212658,0.0532370143327524,0.0329464291275832
8.7,"random_policy_SVM","SVM",54,37,112,112,0,3800,3394,406,0.921205865603653,0.585,1.77408839779006,797,390,407,7,1,97.14,8.4,0,0,0,0,0,0,0.000122723681526016,0.021793986681822,0.0204940981680796
8.7,"random_policy_SVM","SVM",54,38,12,12,0,3900,3494,406,0.921267084282469,0.585,1.76920110192837,804,391,413,7,1.1,99.69,8.6,0,0,0,0,0,0,8.42989548164727e-05,0.00119532362284165,0.00119532362284165
8.7,"random_policy_SVM","SVM",54,39,0,0,0,3912,3506,406,0.921210136674269,0.585,1.77245630174793,804,391,413,0,1.1,100,8.6,0,0,0,0,0,0,0,0,0
8.7,"random_policy_SVM","SVM",55,0,3812,3396,416,100,91,9,0.876347365963746,0.513812154696133,1.7183336041599,25,9,16,0,1.8,2.56,10.1,0,0,0,0,0,0,0.422029551268737,372.041256197126,50.5409237027617
8.7,"random_policy_SVM","SVM",55,1,3712,3331,381,200,156,44,0.885252509532333,0.50828729281768,1.70526635916671,98,42,56,73,1.3,5.11,3.5,0,0,0,0,0,0,0.546135938903848,395.667553477824,64.340699610079
8.7,"random_policy_SVM","SVM",55,2,3612,3282,330,300,205,95,0.879355692164042,0.61878453038674,1.66332459200041,188,90,98,90,1.1,7.67,2.2,0,0,0,0,0,0,0.596441912180705,335.678116464809,69.343813338309
8.7,"random_policy_SVM","SVM",55,3,3512,3255,257,400,232,168,0.881929810909658,0.624309392265193,1.63043909182859,244,122,122,56,1,10.22,1.4,0,0,0,0,0,0,0.576091225264901,262.760377275081,72.8510529176714
8.7,"random_policy_SVM","SVM",55,4,3412,3219,193,500,268,232,0.871927476460991,0.635359116022099,1.60907539811505,325,164,161,81,1,12.78,1.2,0,0,0,0,0,0,0.340243200067766,182.794524898195,58.5655347491421
8.7,"random_policy_SVM","SVM",55,5,3312,3171,141,600,316,284,0.873544471247391,0.646408839779006,1.60907539811505,397,199,198,72,1,15.34,1.1,0,0,0,0,0,0,0.183777927467138,124.818054160288,33.5016069435872
8.7,"random_policy_SVM","SVM",55,6,3212,3107,105,700,380,320,0.860885534199674,0.657458563535912,1.58073058293138,468,233,235,71,1,17.89,1.2,0,0,0,0,0,0,0.137381889078981,129.362814028435,19.5715609092528
8.7,"random_policy_SVM","SVM",55,7,3112,3022,90,800,465,335,0.866727881098752,0.668508287292818,1.58073058293138,512,248,264,44,1.1,20.45,1.4,0,0,0,0,0,0,0.0752007800856416,87.0462850243827,9.91305128019017
8.7,"random_policy_SVM","SVM",55,8,3012,2945,67,900,542,358,0.872897050813177,0.646408839779006,1.60208784835628,566,273,293,54,1.1,23.01,1.5,0,0,0,0,0,0,0.0709583137002419,104.841637362488,11.159605776286
8.7,"random_policy_SVM","SVM",55,9,2912,2857,55,1000,630,370,0.876990117500592,0.646408839779006,1.62198956075822,595,286,309,29,1.1,25.56,1.7,0,0,0,0,0,0,0.0561658606246139,80.0782472199676,6.26000404943636
8.7,"random_policy_SVM","SVM",55,10,2812,2766,46,1100,721,379,0.887124737374529,0.640883977900553,1.61752126995723,620,299,321,25,1.1,28.12,1.9,0,0,0,0,0,0,0.0524659886882906,78.9710496788369,5.80731096267469
8.7,"random_policy_SVM","SVM",55,11,2712,2676,36,1200,811,389,0.888656135709285,0.646408839779006,1.63344450950938,646,311,335,26,1.1,30.67,2.1,0,0,0,0,0,0,0.061020433326557,87.3748316881381,6.30538669205054
8.7,"random_policy_SVM","SVM",55,12,2612,2576,36,1300,911,389,0.919103571706497,0.629834254143646,1.72985610962302,680,333,347,34,1,33.23,2.3,0,0,0,0,0,0,0.05054854435609,41.4643824744681,6.5639733962204
8.7,"random_policy_SVM","SVM",55,13,2512,2481,31,1400,1006,394,0.922527429772014,0.629834254143646,1.73979781140246,695,341,354,15,1,35.79,2.6,0,0,0,0,0,0,0.0369274047308779,33.9690866866402,4.19598267954792
8.7,"random_policy_SVM","SVM",55,14,2412,2383,29,1500,1104,396,0.925817446113149,0.629834254143646,1.75968121496135,698,340,358,3,1.1,38.34,2.8,0,0,0,0,0,0,0.0288965684466034,29.1346258750559,3.1740495758796
8.7,"random_policy_SVM","SVM",55,15,2312,2287,25,1600,1200,400,0.932767877986152,0.624309392265193,1.75990860978704,706,345,361,8,1,40.9,3,0,0,0,0,0,0,0.0318791937166323,31.7897367404327,3.70393325033009
8.7,"random_policy_SVM","SVM",55,16,2212,2193,19,1700,1294,406,0.93587425103105,0.624309392265193,1.78621980731473,728,355,373,22,1.1,43.46,3.2,0,0,0,0,0,0,0.0632849837818264,41.0019640184348,7.27780039997431
8.7,"random_policy_SVM","SVM",55,17,2112,2095,17,1800,1392,408,0.935706170726015,0.624309392265193,1.78621980731473,739,358,381,11,1.1,46.01,3.4,0,0,0,0,0,0,0.0490790988598182,28.3559542636563,5.4503700381754
8.7,"random_policy_SVM","SVM",55,18,2012,1996,16,1900,1491,409,0.935398023500118,0.61878453038674,1.78786155346116,743,360,383,4,1.1,48.57,3.6,0,0,0,0,0,0,0.0374427304860193,21.5217569884949,4.30573130532091
8.7,"random_policy_SVM","SVM",55,19,1912,1900,12,2000,1587,413,0.934778616450085,0.61878453038674,1.78950632029967,756,365,391,13,1.1,51.12,3.8,0,0,0,0,0,0,0.0264334408377013,17.927093134515,3.77406864698673
8.7,"random_policy_SVM","SVM",55,20,1812,1805,7,2100,1682,418,0.934492257411878,0.61878453038674,1.78621980731473,767,371,396,11,1.1,53.68,4,0,0,0,0,0,0,0.0171756379899613,13.6978682784774,2.23923755784489
8.7,"random_policy_SVM","SVM",55,21,1712,1706,6,2200,1781,419,0.934252587347292,0.624309392265193,1.79280494946152,768,373,395,1,1.1,56.24,4.3,0,0,0,0,0,0,0.0130247218322658,11.0880985763823,1.46783020420733
8.7,"random_policy_SVM","SVM",55,22,1612,1606,6,2300,1881,419,0.934321064508603,0.624309392265193,1.79280494946152,768,374,394,0,1.1,58.79,4.5,0,0,0,0,0,0,0.0103835551850508,8.99745414829054,1.1305866786227
8.7,"random_policy_SVM","SVM",55,23,1512,1506,6,2400,1981,419,0.934221461364878,0.624309392265193,1.79280494946152,770,374,396,2,1.1,61.35,4.7,0,0,0,0,0,0,0.00908064682152008,7.83688609808219,0.96911276033723
8.7,"random_policy_SVM","SVM",55,24,1412,1406,6,2500,2081,419,0.934442455840017,0.624309392265193,1.79115411617472,775,375,400,5,1.1,63.91,5,0,0,0,0,0,0,0.00812226809780111,6.29512721580339,0.819937737650269
8.7,"random_policy_SVM","SVM",55,25,1312,1306,6,2600,2181,419,0.93472570227998,0.624309392265193,1.78621980731473,789,384,405,14,1.1,66.46,5.2,0,0,0,0,0,0,0.00581364347065416,3.90583713974047,0.700832901491237
8.7,"random_policy_SVM","SVM",55,26,1212,1207,5,2700,2280,420,0.935005836121705,0.624309392265193,1.78786155346116,791,385,406,2,1.1,69.02,5.4,0,0,0,0,0,0,0.00478645832319067,3.35685413230622,0.529752998518055
8.7,"random_policy_SVM","SVM",55,27,1112,1107,5,2800,2380,420,0.934965372344567,0.624309392265193,1.79779411764706,794,386,408,3,1.1,71.57,5.7,0,0,0,0,0,0,0.00481447386472143,2.98512939204975,0.491395696031777
8.7,"random_policy_SVM","SVM",55,28,1012,1007,5,2900,2480,420,0.935320208544084,0.61878453038674,1.79280494946152,801,393,408,7,1,74.13,5.9,0,0,0,0,0,0,0.00302675374372802,1.67269512082314,0.345655541030312
8.7,"random_policy_SVM","SVM",55,29,912,909,3,3000,2578,422,0.935802661271498,0.61878453038674,1.79944802207912,812,395,417,11,1.1,76.69,6.1,0,0,0,0,0,0,0.00359266890159404,1.77365600015982,0.375747732457008
8.7,"random_policy_SVM","SVM",55,30,812,809,3,3100,2678,422,0.935821336860947,0.61878453038674,1.80276497695853,815,397,418,3,1.1,79.24,6.3,0,0,0,0,0,0,0.00285557746947361,1.20499682523698,0.307674842797195
8.7,"random_policy_SVM","SVM",55,31,712,709,3,3200,2778,422,0.935902264415222,0.624309392265193,1.79614325068871,815,397,418,0,1.1,81.8,6.6,0,0,0,0,0,0,0.0026480729908143,0.933049829545534,0.279950690256667
8.7,"random_policy_SVM","SVM",55,32,612,609,3,3300,2878,422,0.935967628978291,0.624309392265193,1.80110497237569,816,398,418,1,1.1,84.36,6.8,0,0,0,0,0,0,0.00206325406820395,0.639572692780664,0.236214318377968
8.7,"random_policy_SVM","SVM",55,33,512,509,3,3400,2978,422,0.935939615594119,0.624309392265193,1.80110497237569,816,397,419,0,1.1,86.91,7.1,0,0,0,0,0,0,0.0012024177369367,0.36168437928545,0.151306545510217
8.7,"random_policy_SVM","SVM",55,34,412,411,1,3500,3076,424,0.936474982491636,0.624309392265193,1.80110497237569,827,403,424,11,1.1,89.47,7.3,0,0,0,0,0,0,0.00111219531079489,0.339003651108747,0.139593636165905
8.7,"random_policy_SVM","SVM",55,35,312,312,0,3600,3175,425,0.936527896661739,0.61878453038674,1.80276497695853,834,407,427,7,1,92.02,7.5,0,0,0,0,0,0,0.000985163786151232,0.254449939765275,0.117873520851937
8.7,"random_policy_SVM","SVM",55,36,212,212,0,3700,3275,425,0.936692864368533,0.61878453038674,1.80110497237569,841,408,433,7,1.1,94.58,7.7,0,0,0,0,0,0,0.000565381669611932,0.118275228707963,0.0720015871975661
8.7,"random_policy_SVM","SVM",55,37,112,112,0,3800,3375,425,0.936688195471171,0.61878453038674,1.79779411764706,843,409,434,2,1.1,97.14,7.9,0,0,0,0,0,0,0.000217354295734734,0.0338227628244534,0.0316140167976583
8.7,"random_policy_SVM","SVM",55,38,12,12,0,3900,3475,425,0.936689751770292,0.61878453038674,1.79449541284404,843,409,434,0,1.1,99.69,8.2,0,0,0,0,0,0,0.00014794232507235,0.00243188615645653,0.00243188615645653
8.7,"random_policy_SVM","SVM",55,39,0,0,0,3912,3487,425,0.936688195471171,0.61878453038674,1.79779411764706,843,409,434,0,1.1,100,8.2,0,0,0,0,0,0,0,0,0
8.7,"random_policy_SVM","SVM",56,0,3812,3412,400,100,87,13,0.877078931049587,0.393782383419689,1.72803896755092,38,13,25,0,1.9,2.56,6.7,0,0,0,0,0,0,0.18493387509154,508.241866409453,21.3736075438508
8.7,"random_policy_SVM","SVM",56,1,3712,3357,355,200,142,58,0.894644961632159,0.559585492227979,1.73393569061716,110,51,59,72,1.2,5.11,2.4,0,0,0,0,0,0,0.708600522964726,593.937706826005,77.2286088157387
8.7,"random_policy_SVM","SVM",56,2,3612,3300,312,300,199,101,0.91120587552423,0.580310880829015,1.73393569061716,192,93,99,82,1.1,7.67,2,0,0,0,0,0,0,0.591908711030111,567.616055489778,66.4464928962941
8.7,"random_policy_SVM","SVM",56,3,3512,3258,254,400,241,159,0.918203486167893,0.642487046632124,1.75444422179601,271,132,139,79,1.1,10.22,1.5,0,0,0,0,0,0,0.556000496848141,403.010896554641,68.8253291907994
8.7,"random_policy_SVM","SVM",56,4,3412,3222,190,500,277,223,0.92042091465619,0.642487046632124,1.76053413593417,339,168,171,68,1,12.78,1.2,0,0,0,0,0,0,0.407207567798679,350.468966255,56.8564311015192
8.7,"random_policy_SVM","SVM",56,5,3312,3180,132,600,319,281,0.928889463614487,0.66839378238342,1.73870799068308,417,209,208,78,1,15.34,1.1,0,0,0,0,0,0,0.302343496364921,311.820600305923,42.9510509866679
8.7,"random_policy_SVM","SVM",56,6,3212,3116,96,700,383,317,0.902045206739566,0.647668393782383,1.64397220696736,483,238,245,66,1,17.89,1.2,0,0,0,0,0,0,0.221815141387176,282.649388522746,31.7058739031333
8.7,"random_policy_SVM","SVM",56,7,3112,3048,64,800,451,349,0.908327186055331,0.66839378238342,1.65502685744165,570,276,294,87,1.1,20.45,1.3,0,0,0,0,0,0,0.133018163375618,196.496385570262,18.4110808763158
8.7,"random_policy_SVM","SVM",56,8,3012,2960,52,900,539,361,0.904528609088972,0.663212435233161,1.66265370931926,601,288,313,31,1.1,23.01,1.5,0,0,0,0,0,0,0.0925956348142262,153.210147413391,11.1515227055769
8.7,"random_policy_SVM","SVM",56,9,2912,2863,49,1000,636,364,0.910578412327084,0.652849740932642,1.66738418165194,608,289,319,7,1.1,25.56,1.7,0,0,0,0,0,0,0.0679509088422926,110.339982384926,7.49399102660959
8.7,"random_policy_SVM","SVM",56,10,2812,2773,39,1100,726,374,0.929136334380581,0.652849740932642,1.71869821637497,637,304,333,29,1.1,28.12,1.9,0,0,0,0,0,0,0.0802921911070547,111.045072749592,9.12275469671266
8.7,"random_policy_SVM","SVM",56,11,2712,2678,34,1200,821,379,0.935763638875097,0.658031088082902,1.73418306791044,662,322,340,25,1.1,30.67,2.2,0,0,0,0,0,0,0.0712742117264451,90.3755012442775,8.11381070671027
8.7,"random_policy_SVM","SVM",56,12,2612,2583,29,1300,916,384,0.941088993972254,0.658031088082902,1.7714773274354,676,329,347,14,1.1,33.23,2.4,0,0,0,0,0,0,0.0638650511880985,69.9379342274239,7.15862788683571
8.7,"random_policy_SVM","SVM",56,13,2512,2486,26,1400,1013,387,0.941823728395148,0.652849740932642,1.77310852202788,684,335,349,8,1,35.79,2.6,0,0,0,0,0,0,0.0595861621198093,58.1712249982795,6.33660460742691
8.7,"random_policy_SVM","SVM",56,14,2412,2390,22,1500,1109,391,0.940559985187772,0.658031088082902,1.7714773274354,701,339,362,17,1.1,38.34,2.8,0,0,0,0,0,0,0.0579179358938102,49.9882256046409,6.4555443395451
8.7,"random_policy_SVM","SVM",56,15,2312,2295,17,1600,1204,396,0.940474755994716,0.652849740932642,1.77474272343067,716,345,371,15,1.1,40.9,3,0,0,0,0,0,0,0.0489844270583924,41.8550671155136,5.59870535039369
8.7,"random_policy_SVM","SVM",56,16,2212,2200,12,1700,1299,401,0.939269791541165,0.642487046632124,1.76215376255416,728,350,378,12,1.1,43.46,3.2,0,0,0,0,0,0,0.0402198060820631,37.8302195842597,4.91973554331111
8.7,"random_policy_SVM","SVM",56,17,2112,2103,9,1800,1396,404,0.939152234033501,0.647668393782383,1.76215376255416,736,353,383,8,1.1,46.01,3.5,0,0,0,0,0,0,0.0304308710954996,33.8480265403438,3.48433554350059
8.7,"random_policy_SVM","SVM",56,18,2012,2004,8,1900,1495,405,0.939334448170381,0.642487046632124,1.77474272343067,742,355,387,6,1.1,48.57,3.7,0,0,0,0,0,0,0.0253715194348691,28.2921919760823,2.72709790240672
8.7,"random_policy_SVM","SVM",56,19,1912,1904,8,2000,1595,405,0.938605591622868,0.647668393782383,1.77474272343067,748,358,390,6,1.1,51.12,3.9,0,0,0,0,0,0,0.0219302049172374,23.8779813167042,2.39034179430205
8.7,"random_policy_SVM","SVM",56,20,1812,1804,8,2100,1695,405,0.938201487690277,0.647668393782383,1.76984913136239,749,359,390,1,1.1,53.68,4.2,0,0,0,0,0,0,0.0180883301367964,18.5261742972959,1.87884578271113
8.7,"random_policy_SVM","SVM",56,21,1712,1704,8,2200,1795,405,0.937926697016117,0.647668393782383,1.77753036726188,750,362,388,1,1.1,56.24,4.4,0,0,0,0,0,0,0.0134944205634238,12.4482865744247,1.66256985705733
8.7,"random_policy_SVM","SVM",56,22,1612,1605,7,2300,1894,406,0.937817956321531,0.642487046632124,1.77916412679061,755,365,390,5,1.1,58.79,4.7,0,0,0,0,0,0,0.0117471386488348,10.1752680999885,1.1892584961639
8.7,"random_policy_SVM","SVM",56,23,1512,1505,7,2400,1994,406,0.937497612113148,0.647668393782383,1.79012445719788,771,375,396,16,1.1,61.35,4.9,0,0,0,0,0,0,0.00801447855886087,5.50061053077838,1.01335069986651
8.7,"random_policy_SVM","SVM",56,24,1412,1406,6,2500,2093,407,0.937494673175457,0.642487046632124,1.79177282225975,772,376,396,1,1.1,63.91,5.1,0,0,0,0,0,0,0.00545832074879187,4.22487533171959,0.62827108002372
8.7,"random_policy_SVM","SVM",56,25,1312,1307,5,2600,2192,408,0.937815017383839,0.642487046632124,1.79342422578257,778,379,399,6,1.1,66.46,5.4,0,0,0,0,0,0,0.00603500447663331,4.36729499337017,0.629572435089369
8.7,"random_policy_SVM","SVM",56,26,1212,1207,5,2700,2292,408,0.938033968241862,0.637305699481865,1.79177282225975,789,385,404,11,1,69.02,5.6,0,0,0,0,0,0,0.0043762329085767,2.84712260419212,0.499754251430118
8.7,"random_policy_SVM","SVM",56,27,1112,1108,4,2800,2391,409,0.938255858037577,0.637305699481865,1.79012445719788,789,385,404,0,1,71.57,5.8,0,0,0,0,0,0,0.00414061594228641,2.49996124266489,0.428045852843765
8.7,"random_policy_SVM","SVM",56,28,1012,1008,4,2900,2491,409,0.938091277526848,0.642487046632124,1.79342422578257,793,387,406,4,1,74.13,6.1,0,0,0,0,0,0,0.00316718937940103,1.7246099180655,0.349833964503811
8.7,"random_policy_SVM","SVM",56,29,912,910,2,3000,2589,411,0.938661431439015,0.642487046632124,1.79342422578257,798,390,408,5,1,76.69,6.3,0,0,0,0,0,0,0.00350359757860228,1.7062128580391,0.369321754024863
8.7,"random_policy_SVM","SVM",56,30,812,810,2,3100,2689,411,0.938446888987529,0.637305699481865,1.79177282225975,804,393,411,6,1,79.24,6.5,0,0,0,0,0,0,0.00258824920179167,1.10544681029153,0.278452649569453
8.7,"random_policy_SVM","SVM",56,31,712,711,1,3200,2788,412,0.938646736750557,0.637305699481865,1.79177282225975,808,395,413,4,1,81.8,6.8,0,0,0,0,0,0,0.00256187796757726,0.993645397490664,0.277686843501341
8.7,"random_policy_SVM","SVM",56,32,612,611,1,3300,2888,412,0.93838370182716,0.632124352331606,1.78847912221884,808,395,413,0,1,84.36,7,0,0,0,0,0,0,0.0016856109357202,0.57988496702954,0.191810802931096
8.7,"random_policy_SVM","SVM",56,33,512,511,1,3400,2988,412,0.938532118180585,0.632124352331606,1.79177282225975,809,396,413,1,1,86.91,7.3,0,0,0,0,0,0,0.00115682196168657,0.346176925734366,0.13361211791756
8.7,"random_policy_SVM","SVM",56,34,412,411,1,3500,3088,412,0.938643797812865,0.632124352331606,1.78847912221884,811,397,414,2,1,89.47,7.5,0,0,0,0,0,0,0.000700987300627254,0.201921544260505,0.0894850888023779
8.7,"random_policy_SVM","SVM",56,35,312,312,0,3600,3187,413,0.939089046873138,0.637305699481865,1.79177282225975,816,401,415,5,1,92.02,7.7,0,0,0,0,0,0,0.000626363729760978,0.160554164741639,0.0787854563414671
8.7,"random_policy_SVM","SVM",56,36,212,212,0,3700,3287,413,0.939357959671917,0.642487046632124,1.79342422578257,823,402,421,7,1,94.58,8,0,0,0,0,0,0,0.000320346192703501,0.0663775464473906,0.0412956836929922
8.7,"random_policy_SVM","SVM",56,37,112,112,0,3800,3387,413,0.939397635330752,0.647668393782383,1.79177282225975,826,403,423,3,1,97.14,8.2,0,0,0,0,0,0,0.000131549933851121,0.0226272326337486,0.0211670661074375
8.7,"random_policy_SVM","SVM",56,38,12,12,0,3900,3487,413,0.939440249927279,0.642487046632124,1.78683680897529,828,405,423,2,1,99.69,8.4,0,0,0,0,0,0,9.02667075511776e-05,0.00129603745193794,0.00129603745193794
8.7,"random_policy_SVM","SVM",56,39,0,0,0,3912,3499,413,0.939454944615737,0.642487046632124,1.78683680897529,828,405,423,0,1,100,8.5,0,0,0,0,0,0,0,0,0
8.7,"random_policy_SVM","SVM",57,0,3812,3402,410,100,82,18,0.924305810088348,0.601123595505618,1.77270620706701,39,18,21,0,1.2,2.56,4.6,0,0,0,0,0,0,0.755876255800252,607.331870956833,79.9353635333235
8.7,"random_policy_SVM","SVM",57,1,3712,3358,354,200,126,74,0.918533006407901,0.589887640449438,1.77074927059408,95,48,47,56,1,5.11,1.7,0,0,0,0,0,0,0.758833905060175,339.989887625026,82.3028182770915
8.7,"random_policy_SVM","SVM",57,2,3612,3315,297,300,169,131,0.917842608157117,0.623595505617977,1.76749421678784,157,78,79,62,1,7.67,1.3,0,0,0,0,0,0,0.663461298348515,307.898359485138,76.4207500150648
8.7,"random_policy_SVM","SVM",57,3,3512,3272,240,400,212,188,0.896759393839834,0.651685393258427,1.7116139387977,235,117,118,78,1,10.22,1.1,0,0,0,0,0,0,0.5,202.325045010971,70.7200082741737
8.7,"random_policy_SVM","SVM",57,4,3412,3227,185,500,257,243,0.900290378028601,0.662921348314607,1.69679444811633,321,162,159,86,1,12.78,1.1,0,0,0,0,0,0,0.294914214893114,154.763643636312,48.5844679918524
8.7,"random_policy_SVM","SVM",57,5,3312,3161,151,600,323,277,0.892462178182787,0.668539325842697,1.6609744731528,406,200,206,85,1,15.34,1.2,0,0,0,0,0,0,0.138620349320577,92.5967896248393,24.4826125931147
8.7,"random_policy_SVM","SVM",57,6,3212,3091,121,700,393,307,0.894286914978311,0.679775280898876,1.62908932894655,469,227,242,63,1.1,17.89,1.3,0,0,0,0,0,0,0.0908449272220095,78.8538238993761,12.4718775160398
8.7,"random_policy_SVM","SVM",57,7,3112,3014,98,800,470,330,0.899761125364931,0.707865168539326,1.64071868689484,525,254,271,56,1.1,20.45,1.4,0,0,0,0,0,0,0.0741929070444248,87.0554905705457,9.96666477383812
8.7,"random_policy_SVM","SVM",57,8,3012,2941,71,900,543,357,0.902394749813583,0.707865168539326,1.63920789620709,584,283,301,59,1.1,23.01,1.5,0,0,0,0,0,0,0.0732064625717496,114.175355378596,11.9158437026144
8.7,"random_policy_SVM","SVM",57,9,2912,2853,59,1000,631,369,0.916197975253091,0.713483146067416,1.67968216524924,621,301,320,37,1.1,25.56,1.7,0,0,0,0,0,0,0.0671680222965796,100.547218763395,7.86184025836031
8.7,"random_policy_SVM","SVM",57,10,2812,2762,50,1100,722,378,0.922481073292804,0.713483146067416,1.67659451421018,646,311,335,25,1.1,28.12,1.9,0,0,0,0,0,0,0.0636875715453944,98.332056627082,7.20497276108151
8.7,"random_policy_SVM","SVM",57,11,2712,2673,39,1200,811,389,0.92888266073484,0.702247191011236,1.68980073250978,674,327,347,28,1.1,30.67,2.1,0,0,0,0,0,0,0.080779894351408,99.9378490476668,9.25756786085889
8.7,"random_policy_SVM","SVM",57,12,2612,2578,34,1300,906,394,0.935260550296387,0.691011235955056,1.74199761818464,692,337,355,18,1.1,33.23,2.3,0,0,0,0,0,0,0.0687111760438388,75.6690850255664,7.64955281569582
8.7,"random_policy_SVM","SVM",57,13,2512,2486,26,1400,998,402,0.937557664842469,0.679775280898876,1.75212551131362,719,346,373,27,1.1,35.79,2.5,0,0,0,0,0,0,0.0742640285359255,67.6075900863903,8.34803927284569
8.7,"random_policy_SVM","SVM",57,14,2412,2389,23,1500,1095,405,0.937690372973051,0.674157303370786,1.74568978859071,728,350,378,9,1.1,38.34,2.7,0,0,0,0,0,0,0.0671638396883317,62.3205570823302,7.60241516907525
8.7,"random_policy_SVM","SVM",57,15,2312,2294,18,1600,1190,410,0.938180129169254,0.679775280898876,1.74729428288169,748,358,390,20,1.1,40.9,2.9,0,0,0,0,0,0,0.0524102001879871,45.2657715275213,6.01378666454391
8.7,"random_policy_SVM","SVM",57,16,2212,2199,13,1700,1285,415,0.939826341931975,0.679775280898876,1.76063070333354,760,362,398,12,1.1,43.46,3.1,0,0,0,0,0,0,0.0399359501814211,40.3968619099614,4.76140973742085
8.7,"random_policy_SVM","SVM",57,17,2112,2101,11,1800,1383,417,0.939049051452841,0.679775280898876,1.74890172932409,770,365,405,10,1.1,46.01,3.3,0,0,0,0,0,0,0.0323197285593201,35.6316352191294,3.62652833077477
8.7,"random_policy_SVM","SVM",57,18,2012,2002,10,1900,1482,418,0.940211827454151,0.679775280898876,1.7691202464261,777,370,407,7,1.1,48.57,3.5,0,0,0,0,0,0,0.0262591899748686,28.8534610891722,2.86808676106984
8.7,"random_policy_SVM","SVM",57,19,1912,1902,10,2000,1582,418,0.939758408007985,0.679775280898876,1.76749421678784,777,368,409,0,1.1,51.12,3.8,0,0,0,0,0,0,0.0205006862137252,21.4411324061372,2.21962273527991
8.7,"random_policy_SVM","SVM",57,20,1812,1803,9,2100,1681,419,0.939137523539892,0.674157303370786,1.77238129757158,780,373,407,3,1.1,53.68,4,0,0,0,0,0,0,0.0178966144439177,18.3131089727196,1.92922872836238
8.7,"random_policy_SVM","SVM",57,21,1712,1704,8,2200,1780,420,0.938695163104609,0.679775280898876,1.76749421678784,787,375,412,7,1.1,56.24,4.2,0,0,0,0,0,0,0.0149505435184364,14.4828234412339,1.55392831290779
8.7,"random_policy_SVM","SVM",57,22,1612,1604,8,2300,1880,420,0.936818290972048,0.679775280898876,1.75739424983477,793,383,410,6,1.1,58.79,4.5,0,0,0,0,0,0,0.0115598543151822,8.86898499371784,1.43685820908695
8.7,"random_policy_SVM","SVM",57,23,1512,1506,6,2400,1978,422,0.936519697678237,0.674157303370786,1.76063070333354,803,386,417,10,1.1,61.35,4.7,0,0,0,0,0,0,0.0094248867957824,8.14507671282978,1.05814651513747
8.7,"random_policy_SVM","SVM",57,24,1412,1408,4,2500,2076,424,0.936236902971398,0.674157303370786,1.75901098787509,803,390,413,0,1.1,63.91,4.9,0,0,0,0,0,0,0.00937833339847174,7.73514323958062,0.99901750186723
8.7,"random_policy_SVM","SVM",57,25,1312,1308,4,2600,2176,424,0.936868846450366,0.674157303370786,1.75739424983477,815,400,415,12,1,66.46,5.1,0,0,0,0,0,0,0.00615966638927405,4.44312732100338,0.777133939695976
8.7,"random_policy_SVM","SVM",57,26,1212,1210,2,2700,2274,426,0.936962058113517,0.674157303370786,1.75739424983477,818,401,417,3,1,69.02,5.3,0,0,0,0,0,0,0.00561145245655697,3.93063106851649,0.582169732532668
8.7,"random_policy_SVM","SVM",57,27,1112,1110,2,2800,2374,426,0.937274870135607,0.668539325842697,1.76063070333354,829,406,423,11,1,71.57,5.6,0,0,0,0,0,0,0.00463384170222331,2.92788951866384,0.496415471891883
8.7,"random_policy_SVM","SVM",57,28,1012,1010,2,2900,2474,426,0.937605060603372,0.668539325842697,1.75578048101031,831,406,425,2,1,74.13,5.8,0,0,0,0,0,0,0.00378506754611565,2.04088656825255,0.388143371414201
8.7,"random_policy_SVM","SVM",57,29,912,910,2,3000,2574,426,0.938624069463221,0.662921348314607,1.75416967322956,842,409,433,11,1.1,76.69,6,0,0,0,0,0,0,0.00293696089355947,1.39057303962058,0.31705838355809
8.7,"random_policy_SVM","SVM",57,30,812,811,1,3100,2673,427,0.939614640866513,0.662921348314607,1.75256181835034,848,410,438,6,1.1,79.24,6.3,0,0,0,0,0,0,0.0027555365528661,1.14846525411542,0.29498339664502
8.7,"random_policy_SVM","SVM",57,31,712,711,1,3200,2773,427,0.940197608725878,0.657303370786517,1.75416967322956,849,412,437,1,1.1,81.8,6.5,0,0,0,0,0,0,0.00217190858210489,0.8071957485277,0.242227593258795
8.7,"random_policy_SVM","SVM",57,32,612,611,1,3300,2873,427,0.940355594595622,0.657303370786517,1.75416967322956,849,413,436,0,1.1,84.36,6.7,0,0,0,0,0,0,0.00162944007201487,0.528966885112316,0.183577582326729
8.7,"random_policy_SVM","SVM",57,33,512,511,1,3400,2973,427,0.94022762604113,0.657303370786517,1.75901098787509,846,413,433,-3,1,86.91,7,0,0,0,0,0,0,0.00114900988762539,0.361157011154077,0.143424389032734
8.7,"random_policy_SVM","SVM",57,34,412,412,0,3500,3072,428,0.940606792128516,0.662921348314607,1.75578048101031,848,415,433,2,1,89.47,7.2,0,0,0,0,0,0,0.00096157199786983,0.293679941055486,0.119399886882017
8.7,"random_policy_SVM","SVM",57,35,312,312,0,3600,3172,428,0.940905385422332,0.662921348314607,1.75739424983477,852,417,435,4,1,92.02,7.4,0,0,0,0,0,0,0.000526105203684643,0.135418856267161,0.0648856555672402
8.7,"random_policy_SVM","SVM",57,36,212,212,0,3700,3272,428,0.941219777303122,0.662921348314607,1.75901098787509,854,418,436,2,1,94.58,7.6,0,0,0,0,0,0,0.000344526957422533,0.0738005668601767,0.0451921640018215
8.7,"random_policy_SVM","SVM",57,37,112,112,0,3800,3372,428,0.941804325021176,0.662921348314607,1.75578048101031,853,419,434,-1,1,97.14,7.9,0,0,0,0,0,0,0.000163646254365113,0.0266236304961544,0.0249130108362324
8.7,"random_policy_SVM","SVM",57,38,12,12,0,3900,3472,428,0.942268803478222,0.662921348314607,1.75901098787509,855,419,436,2,1,99.69,8.1,0,0,0,0,0,0,0.000139416912944109,0.00191813779828508,0.00191813779828508
8.7,"random_policy_SVM","SVM",57,39,0,0,0,3912,3484,428,0.942290921499986,0.662921348314607,1.75416967322956,855,419,436,0,1,100,8.1,0,0,0,0,0,0,0,0,0
8.7,"random_policy_SVM","SVM",58,0,3812,3412,400,100,90,10,0.874426020408169,0.51530612244898,1.73838051349572,29,10,19,0,1.9,2.56,9,0,0,0,0,0,0,0.255380503038351,376.151040832649,28.927346195351
8.7,"random_policy_SVM","SVM",58,1,3712,3361,351,200,141,59,0.898718692022255,0.561224489795918,1.75193202280912,109,53,56,80,1.1,5.11,2.4,0,0,0,0,0,0,0.70646516251124,538.825858719199,77.5333918136071
8.7,"random_policy_SVM","SVM",58,2,3612,3314,298,300,188,112,0.910224373840439,0.581632653061224,1.77353703912504,184,91,93,75,1,7.67,1.7,0,0,0,0,0,0,0.595448848052823,365.614213725925,72.0678111544829
8.7,"random_policy_SVM","SVM",58,3,3512,3281,231,400,221,179,0.906319573283853,0.591836734693878,1.75787305747987,254,125,129,70,1,10.22,1.2,0,0,0,0,0,0,0.510306318228327,283.609246476891,70.1084198244223
8.7,"random_policy_SVM","SVM",58,4,3412,3235,177,500,267,233,0.901236375231899,0.591836734693878,1.69982058757569,322,162,160,68,1,12.78,1.1,0,0,0,0,0,0,0.267660333274291,197.337204150386,48.9194240892122
8.7,"random_policy_SVM","SVM",58,5,3312,3189,123,600,313,287,0.86557571892393,0.612244897959184,1.60041380607543,407,203,204,85,1,15.34,1.1,0,0,0,0,0,0,0.230219370789936,170.141752157604,35.8368004553432
8.7,"random_policy_SVM","SVM",58,6,3212,3109,103,700,393,307,0.894961734693878,0.602040816326531,1.65716158022842,447,216,231,40,1.1,17.89,1.3,0,0,0,0,0,0,0.121521429046302,89.3840106382342,16.2477290864137
8.7,"random_policy_SVM","SVM",58,7,3112,3027,85,800,475,325,0.886294063079767,0.622448979591837,1.6356973728718,498,237,261,51,1.1,20.45,1.5,0,0,0,0,0,0,0.077933060814452,80.2100928075496,10.9561925361295
8.7,"random_policy_SVM","SVM",58,8,3012,2944,68,900,558,342,0.892074443413732,0.642857142857143,1.62053922486426,535,255,280,37,1.1,23.01,1.6,0,0,0,0,0,0,0.0706234892106372,102.528755217729,9.78012559370552
8.7,"random_policy_SVM","SVM",58,9,2912,2855,57,1000,647,353,0.900542091836736,0.647959183673469,1.62650806178825,561,267,294,26,1.1,25.56,1.8,0,0,0,0,0,0,0.0626242836059379,97.6886267823442,7.12930346514865
8.7,"random_policy_SVM","SVM",58,10,2812,2763,49,1100,739,361,0.909370651669758,0.647959183673469,1.6540759950389,593,282,311,32,1.1,28.12,2,0,0,0,0,0,0,0.065545393211941,101.558964630612,7.19572643675876
8.7,"random_policy_SVM","SVM",58,11,2712,2667,45,1200,835,365,0.923866535250457,0.647959183673469,1.71682030677957,607,292,315,14,1.1,30.67,2.3,0,0,0,0,0,0,0.060917420111054,82.6503704976175,6.57190995896656
8.7,"random_policy_SVM","SVM",58,12,2612,2574,38,1300,928,372,0.936818761595529,0.653061224489796,1.7719054503126,628,303,325,21,1.1,33.23,2.5,0,0,0,0,0,0,0.0755975745219315,79.5140111187422,8.76969956106516
8.7,"random_policy_SVM","SVM",58,13,2512,2478,34,1400,1024,376,0.9383986549165,0.647959183673469,1.77781525833474,649,311,338,21,1.1,35.79,2.7,0,0,0,0,0,0,0.0654824041606215,61.5712454175056,7.14728630188797
8.7,"random_policy_SVM","SVM",58,14,2412,2380,32,1500,1122,378,0.938849431818169,0.647959183673469,1.77944927971188,651,316,335,2,1.1,38.34,3,0,0,0,0,0,0,0.0545064986587512,46.8233227163534,5.85167350868055
8.7,"random_policy_SVM","SVM",58,15,2312,2287,25,1600,1215,385,0.939727794526887,0.642857142857143,1.77944927971188,678,324,354,27,1.1,40.9,3.2,0,0,0,0,0,0,0.0560906155881505,44.2783382282079,6.22398161030469
8.7,"random_policy_SVM","SVM",58,16,2212,2191,21,1700,1311,389,0.939898828849707,0.642857142857143,1.77293115048217,688,328,360,10,1.1,43.46,3.4,0,0,0,0,0,0,0.0432750941136843,34.6303822028866,4.99566775292776
8.7,"random_policy_SVM","SVM",58,17,2112,2096,16,1800,1406,394,0.938974083951744,0.637755102040816,1.76702864632091,704,334,370,16,1.1,46.01,3.6,0,0,0,0,0,0,0.036359711933848,32.4043060210606,4.50117252480111
8.7,"random_policy_SVM","SVM",58,18,2012,1998,14,1900,1504,396,0.938662453617792,0.637755102040816,1.7719054503126,705,337,368,1,1.1,48.57,3.8,0,0,0,0,0,0,0.0282640006597774,26.559952051538,3.16416051213175
8.7,"random_policy_SVM","SVM",58,19,1912,1899,13,2000,1603,397,0.938300092764361,0.63265306122449,1.77517163547447,712,340,372,7,1.1,51.12,4,0,0,0,0,0,0,0.0234767319456822,22.6650469072782,2.56788494515496
8.7,"random_policy_SVM","SVM",58,20,1812,1800,12,2100,1702,398,0.938249362244883,0.63265306122449,1.78272635020859,715,343,372,3,1.1,53.68,4.3,0,0,0,0,0,0,0.0197856854348886,19.1349928696339,2.11816544777962
8.7,"random_policy_SVM","SVM",58,21,1712,1702,10,2200,1800,400,0.938158047309819,0.63265306122449,1.77618423516195,721,348,373,6,1.1,56.24,4.5,0,0,0,0,0,0,0.0160282636485841,13.9200887738956,1.65196307665253
8.7,"random_policy_SVM","SVM",58,22,1612,1603,9,2300,1899,401,0.93753478664192,0.63265306122449,1.78272635020859,738,358,380,17,1.1,58.79,4.7,0,0,0,0,0,0,0.0130641540965769,9.42390827715383,1.65403405749481
8.7,"random_policy_SVM","SVM",58,23,1512,1504,8,2400,1998,402,0.937827574211492,0.627551020408163,1.78436941596915,740,360,380,2,1.1,61.35,5,0,0,0,0,0,0,0.00854656416035952,6.85906268760621,0.98574251379179
8.7,"random_policy_SVM","SVM",58,24,1412,1405,7,2500,2097,403,0.937949327458247,0.627551020408163,1.78272635020859,742,362,380,2,1,63.91,5.2,0,0,0,0,0,0,0.00748457605493149,5.36323463071033,0.784098946402776
8.7,"random_policy_SVM","SVM",58,25,1312,1305,7,2600,2197,403,0.936905728200363,0.622448979591837,1.78272635020859,753,368,385,11,1,66.46,5.5,0,0,0,0,0,0,0.006112358477755,4.24742666196923,0.741477153738201
8.7,"random_policy_SVM","SVM",58,26,1212,1206,6,2700,2296,404,0.93723040352504,0.622448979591837,1.78272635020859,756,370,386,3,1,69.02,5.7,0,0,0,0,0,0,0.00611002464431799,3.74024599984675,0.622095141267209
8.7,"random_policy_SVM","SVM",58,27,1112,1106,6,2800,2396,404,0.937347808441555,0.61734693877551,1.78272635020859,761,373,388,5,1,71.57,5.9,0,0,0,0,0,0,0.00451012002178198,2.58334105242717,0.516524637390145
8.7,"random_policy_SVM","SVM",58,28,1012,1006,6,2900,2496,404,0.937410134508345,0.61734693877551,1.78436941596915,760,372,388,-1,1,74.13,6.2,0,0,0,0,0,0,0.00409950065797591,2.00645702099095,0.424120932003387
8.7,"random_policy_SVM","SVM",58,29,912,906,6,3000,2596,404,0.937336212894245,0.607142857142857,1.78272635020859,765,376,389,5,1,76.69,6.4,0,0,0,0,0,0,0.00307169220183621,1.3328949403628,0.337919222553404
8.7,"random_policy_SVM","SVM",58,30,812,810,2,3100,2692,408,0.937611607142854,0.612244897959184,1.77618423516195,785,382,403,20,1.1,79.24,6.6,0,0,0,0,0,0,0.00378267464967849,1.5626431594579,0.446592840998491
8.7,"random_policy_SVM","SVM",58,31,712,710,2,3200,2792,408,0.937955125231909,0.612244897959184,1.77781525833474,783,382,401,-2,1,81.8,6.8,0,0,0,0,0,0,0.00318963955212498,1.13358714506327,0.351052289227701
8.7,"random_policy_SVM","SVM",58,32,612,610,2,3300,2892,408,0.937862360853431,0.612244897959184,1.77455620194916,785,382,403,2,1.1,84.36,7.1,0,0,0,0,0,0,0.00204134778662524,0.672720323688434,0.244395148410051
8.7,"random_policy_SVM","SVM",58,33,512,510,2,3400,2992,408,0.938056586270871,0.612244897959184,1.77130907257688,784,383,401,-1,1,86.91,7.3,0,0,0,0,0,0,0.00129531190612296,0.414892173898447,0.167105985002782
8.7,"random_policy_SVM","SVM",58,34,412,412,0,3500,3090,410,0.938340677179961,0.61734693877551,1.78108630756811,793,386,407,9,1.1,89.47,7.5,0,0,0,0,0,0,0.00131462943787063,0.38265040126842,0.159315132543038
8.7,"random_policy_SVM","SVM",58,35,312,312,0,3600,3190,410,0.938314587198514,0.61734693877551,1.77781525833474,798,389,409,5,1.1,92.02,7.8,0,0,0,0,0,0,0.000970770768164588,0.247186610510299,0.119843984239087
8.7,"random_policy_SVM","SVM",58,36,212,212,0,3700,3290,410,0.938389958256028,0.612244897959184,1.78436941596915,801,392,409,3,1,94.58,8,0,0,0,0,0,0,0.000495389622030056,0.101118677146048,0.0618916196964911
8.7,"random_policy_SVM","SVM",58,37,112,112,0,3800,3390,410,0.938501565398885,0.612244897959184,1.78272635020859,804,393,411,3,1,97.14,8.3,0,0,0,0,0,0,0.000216008861643275,0.0360303826089892,0.0336972377699363
8.7,"random_policy_SVM","SVM",58,38,12,12,0,3900,3490,410,0.938607374768087,0.61734693877551,1.78108630756811,804,393,411,0,1,99.69,8.5,0,0,0,0,0,0,0.000180067606435636,0.00250607484658592,0.00250607484658592
8.7,"random_policy_SVM","SVM",58,39,0,0,0,3912,3502,410,0.938618970315397,0.61734693877551,1.78108630756811,805,394,411,1,1,100,8.5,0,0,0,0,0,0,0,0,0
8.7,"random_policy_SVM","SVM",59,0,3812,3427,385,100,92,8,0.896196455843497,0.596244131455399,1.72659180891802,26,8,18,0,2.2,2.56,11.5,0,0,0,0,0,0,0.24232533131299,310.053811828802,31.3101250628722
8.7,"random_policy_SVM","SVM",59,1,3712,3391,321,200,128,72,0.909148330410853,0.60093896713615,1.76403272576636,99,50,49,73,1,5.11,1.8,0,0,0,0,0,0,0.803244606820686,453.522278348295,85.8688940910622
8.7,"random_policy_SVM","SVM",59,2,3612,3328,284,300,191,109,0.891841005874595,0.629107981220657,1.6696542893726,177,87,90,78,1,7.67,1.8,0,0,0,0,0,0,0.553616382594646,262.707306100044,68.9787973300716
8.7,"random_policy_SVM","SVM",59,3,3512,3292,220,400,227,173,0.903843408509962,0.657276995305164,1.71496689428198,246,124,122,69,1,10.22,1.3,0,0,0,0,0,0,0.466562070520649,219.896849652082,65.3790494165105
8.7,"random_policy_SVM","SVM",59,4,3412,3256,156,500,263,237,0.911657360494965,0.652582159624413,1.71395435743464,329,164,165,83,1,12.78,1.1,0,0,0,0,0,0,0.352185530445318,250.776546187238,51.6663870049371
8.7,"random_policy_SVM","SVM",59,5,3312,3200,112,600,319,281,0.897730425390367,0.661971830985915,1.6573548102612,411,203,208,82,1,15.34,1.1,0,0,0,0,0,0,0.214189728912475,182.722638015861,31.3339999838685
8.7,"random_policy_SVM","SVM",59,6,3212,3130,82,700,389,311,0.893465208924242,0.671361502347418,1.62203765370512,493,238,255,82,1.1,17.89,1.3,0,0,0,0,0,0,0.131066201837446,155.23568573512,17.285025317113
8.7,"random_policy_SVM","SVM",59,7,3112,3046,66,800,473,327,0.896156052782569,0.685446009389671,1.62502758486402,533,256,277,40,1.1,20.45,1.4,0,0,0,0,0,0,0.0881048072941577,122.911894272062,10.9752463987783
8.7,"random_policy_SVM","SVM",59,8,3012,2960,52,900,559,341,0.901373434718091,0.685446009389671,1.64738199204426,571,272,299,38,1.1,23.01,1.6,0,0,0,0,0,0,0.0808269431464599,135.040248094942,9.13130688015656
8.7,"random_policy_SVM","SVM",59,9,2912,2866,46,1000,653,347,0.90205220614181,0.68075117370892,1.65041864087752,586,278,308,15,1.1,25.56,1.9,0,0,0,0,0,0,0.0673970094505299,113.470588664144,7.36101181553388
8.7,"random_policy_SVM","SVM",59,10,2812,2770,42,1100,749,351,0.91340007919001,0.671361502347418,1.6696542893726,611,291,320,25,1.1,28.12,2.1,0,0,0,0,0,0,0.0612891203876564,88.2513533323394,6.76583766509434
8.7,"random_policy_SVM","SVM",59,11,2712,2677,35,1200,842,358,0.916229640224214,0.666666666666667,1.69117837781755,623,298,325,12,1.1,30.67,2.4,0,0,0,0,0,0,0.0567185858053917,80.4354046321132,6.29983049526792
8.7,"random_policy_SVM","SVM",59,12,2612,2582,30,1300,937,363,0.920513711452119,0.671361502347418,1.70809016159573,641,307,334,18,1.1,33.23,2.6,0,0,0,0,0,0,0.0573186664656896,71.5556600902956,6.49254115781118
8.7,"random_policy_SVM","SVM",59,13,2512,2486,26,1400,1033,367,0.923984334386507,0.671361502347418,1.7250019453739,654,315,339,13,1.1,35.79,2.8,0,0,0,0,0,0,0.0488305593152359,57.9585117570801,5.29983472944882
8.7,"random_policy_SVM","SVM",59,14,2412,2388,24,1500,1131,369,0.924874548495799,0.666666666666667,1.72709652409872,664,321,343,10,1.1,38.34,3.1,0,0,0,0,0,0,0.0424022465010154,46.4724114493293,4.66201617229406
8.7,"random_policy_SVM","SVM",59,15,2312,2295,17,1600,1224,376,0.925033467202146,0.657276995305164,1.72341500706169,680,326,354,16,1.1,40.9,3.3,0,0,0,0,0,0,0.046025134960575,42.2786042026758,5.71542522872502
8.7,"random_policy_SVM","SVM",59,16,2212,2201,11,1700,1318,382,0.925826713965187,0.647887323943662,1.7250019453739,696,333,363,16,1.1,43.46,3.5,0,0,0,0,0,0,0.0378853457766445,39.1564464509974,4.91262501841276
8.7,"random_policy_SVM","SVM",59,17,2112,2107,5,1800,1412,388,0.925736480462428,0.652582159624413,1.72024987389904,712,339,373,16,1.1,46.01,3.6,0,0,0,0,0,0,0.0322362271079496,35.8623209979402,3.62727275425393
8.7,"random_policy_SVM","SVM",59,18,2012,2007,5,1900,1512,388,0.9255640940691,0.652582159624413,1.72659180891802,717,343,374,5,1.1,48.57,3.9,0,0,0,0,0,0,0.0262530109665928,27.9558344675318,2.7493877089349
8.7,"random_policy_SVM","SVM",59,19,1912,1907,5,2000,1612,388,0.92603276957595,0.647887323943662,1.73027133388567,719,346,373,2,1.1,51.12,4.2,0,0,0,0,0,0,0.0189688892709347,19.0347076429636,2.14732296249919
8.7,"random_policy_SVM","SVM",59,20,1812,1808,4,2100,1711,389,0.926411211580045,0.647887323943662,1.74394624628505,729,352,377,10,1.1,53.68,4.4,0,0,0,0,0,0,0.016277303825227,15.474555035977,1.79047647927099
8.7,"random_policy_SVM","SVM",59,21,1712,1708,4,2200,1811,389,0.926524340150667,0.643192488262911,1.75559237779619,738,358,380,9,1.1,56.24,4.7,0,0,0,0,0,0,0.0130143587683378,11.1508488020668,1.34343677014738
8.7,"random_policy_SVM","SVM",59,22,1612,1609,3,2300,1910,390,0.926630734877795,0.647887323943662,1.76565557096026,757,364,393,19,1.1,58.79,4.9,0,0,0,0,0,0,0.00933775173344264,7.53912505830759,1.15370410131231
8.7,"random_policy_SVM","SVM",59,23,1512,1509,3,2400,2010,390,0.926722315149251,0.647887323943662,1.76565557096026,759,364,395,2,1.1,61.35,5.2,0,0,0,0,0,0,0.00813621234064222,6.3048368473723,0.852467397737227
8.7,"random_policy_SVM","SVM",59,24,1412,1409,3,2500,2110,390,0.926692686237898,0.647887323943662,1.76241286100441,754,366,388,-5,1.1,63.91,5.4,0,0,0,0,0,0,0.00596041428299392,4.29307731777969,0.653416103512692
8.7,"random_policy_SVM","SVM",59,25,1312,1309,3,2600,2210,390,0.92680581480852,0.647887323943662,1.76565557096026,756,366,390,2,1.1,66.46,5.7,0,0,0,0,0,0,0.00591788790331591,3.76442165971556,0.606275174797164
8.7,"random_policy_SVM","SVM",59,26,1212,1209,3,2700,2310,390,0.927040152561951,0.652582159624413,1.76241286100441,757,370,387,1,1,69.02,5.9,0,0,0,0,0,0,0.00388853927326583,2.12964927116156,0.447563059855318
8.7,"random_policy_SVM","SVM",59,27,1112,1110,2,2800,2409,391,0.927110184534242,0.647887323943662,1.76565557096026,760,371,389,3,1,71.57,6.2,0,0,0,0,0,0,0.00348866473680731,1.86548904726648,0.382920716758046
8.7,"random_policy_SVM","SVM",59,28,1012,1010,2,2900,2509,391,0.927158668207365,0.647887323943662,1.76565557096026,760,371,389,0,1,74.13,6.4,0,0,0,0,0,0,0.0031492864188247,1.48382617339841,0.327770259998163
8.7,"random_policy_SVM","SVM",59,29,912,910,2,3000,2609,391,0.928001745412236,0.643192488262911,1.76403272576636,763,373,390,3,1,76.69,6.7,0,0,0,0,0,0,0.00267896488612185,1.1105390517932,0.297541284376177
8.7,"random_policy_SVM","SVM",59,30,812,811,1,3100,2708,392,0.92841385663378,0.643192488262911,1.76728140481934,768,374,394,5,1.1,79.24,6.9,0,0,0,0,0,0,0.00240038227182343,0.852976137447117,0.260571759200063
8.7,"random_policy_SVM","SVM",59,31,712,712,0,3200,2807,393,0.928976805949493,0.63849765258216,1.76565557096026,777,379,398,9,1.1,81.8,7.1,0,0,0,0,0,0,0.00205130985085605,0.674458587978711,0.236765292631394
8.7,"random_policy_SVM","SVM",59,32,612,612,0,3300,2907,393,0.929108789281884,0.643192488262911,1.76565557096026,775,379,396,-2,1,84.36,7.4,0,0,0,0,0,0,0.00132393105047658,0.418570637452532,0.16730682186614
8.7,"random_policy_SVM","SVM",59,33,512,512,0,3400,3007,393,0.929372755946667,0.643192488262911,1.76565557096026,776,379,397,1,1,86.91,7.7,0,0,0,0,0,0,0.000782563198678831,0.242715012719768,0.10284324303849
8.7,"random_policy_SVM","SVM",59,34,412,412,0,3500,3107,393,0.929642109686241,0.647887323943662,1.76241286100441,779,380,399,3,1.1,89.47,7.9,0,0,0,0,0,0,0.000430902450169474,0.126216651825177,0.0560336962806575
8.7,"random_policy_SVM","SVM",59,35,312,312,0,3600,3207,393,0.929747157644676,0.643192488262911,1.75596304266588,779,381,398,0,1,92.02,8.2,0,0,0,0,0,0,0.000279283291660183,0.0721536518881381,0.0351506511427664
8.7,"random_policy_SVM","SVM",59,36,212,212,0,3700,3307,393,0.930013817846853,0.63849765258216,1.75275580423178,781,382,399,2,1,94.58,8.4,0,0,0,0,0,0,0.000169407067796138,0.0362694655860901,0.0228838389224926
8.7,"random_policy_SVM","SVM",59,37,112,112,0,3800,3407,393,0.93007846274435,0.633802816901408,1.76891023560719,785,383,402,4,1,97.14,8.7,0,0,0,0,0,0,6.67537659591142e-05,0.0110902717017591,0.0104182526208953
8.7,"random_policy_SVM","SVM",59,38,12,12,0,3900,3507,393,0.930385526007462,0.633802816901408,1.76241286100441,788,385,403,3,1,99.69,8.9,0,0,0,0,0,0,6.30449555932066e-05,0.000837517675366974,0.000837517675366974
8.7,"random_policy_SVM","SVM",59,39,0,0,0,3912,3519,393,0.930478453047615,0.633802816901408,1.76079596847138,788,386,402,0,1,100,9,0,0,0,0,0,0,0,0,0
8.7,"random_policy_SVM","SVM",60,0,3812,3426,386,100,90,10,0.931879670539454,0.60952380952381,1.7770111915734,28,10,18,0,1.8,2.56,9,0,0,0,0,0,0,0.212360420462179,380.401072589846,22.8462713152514
8.7,"random_policy_SVM","SVM",60,1,3712,3395,317,200,121,79,0.940716194839907,0.628571428571429,1.78759018759019,97,49,48,69,1,5.11,1.5,0,0,0,0,0,0,0.624133234983766,312.923418234705,69.6487717205954
8.7,"random_policy_SVM","SVM",60,2,3612,3344,268,300,172,128,0.930846015382073,0.6,1.78559578670178,176,88,88,79,1,7.67,1.3,0,0,0,0,0,0,0.500197836011536,259.564984015331,64.8615369662318
8.7,"random_policy_SVM","SVM",60,3,3512,3300,212,400,216,184,0.922683139693434,0.628571428571429,1.76193099829463,260,131,129,84,1,10.22,1.2,0,0,0,0,0,0,0.333838919990895,197.168204698387,53.0675693901669
8.7,"random_policy_SVM","SVM",60,4,3412,3246,166,500,270,230,0.921534936998826,0.661904761904762,1.75822152065246,341,171,170,81,1,12.78,1.2,0,0,0,0,0,0,0.193627153489373,137.298065539367,30.3396594874576
8.7,"random_policy_SVM","SVM",60,5,3312,3183,129,600,333,267,0.915360279277803,0.680952380952381,1.72550362080316,412,200,212,71,1.1,15.34,1.2,0,0,0,0,0,0,0.115962536052279,83.4643210347564,14.8457452802618
8.7,"random_policy_SVM","SVM",60,6,3212,3107,105,700,409,291,0.902389134347906,0.685714285714286,1.67399605003292,465,226,239,53,1.1,17.89,1.4,0,0,0,0,0,0,0.098515547795328,89.9814908916657,13.8657353830156
8.7,"random_policy_SVM","SVM",60,7,3112,3024,88,800,492,308,0.897250859106528,0.680952380952381,1.63107307439105,517,250,267,52,1.1,20.45,1.6,0,0,0,0,0,0,0.0608424454336785,69.8431944752747,9.38965977530614
8.7,"random_policy_SVM","SVM",60,8,3012,2944,68,900,572,328,0.900673648611795,0.69047619047619,1.62807201997634,561,270,291,44,1.1,23.01,1.7,0,0,0,0,0,0,0.068206992690081,102.48091782212,8.32663507053447
8.7,"random_policy_SVM","SVM",60,9,2912,2850,62,1000,666,334,0.909949271804943,0.695238095238095,1.65377842029176,584,278,306,23,1.1,25.56,2,0,0,0,0,0,0,0.0587614233574985,79.3465576060035,6.60116013292986
8.7,"random_policy_SVM","SVM",60,10,2812,2753,59,1100,763,337,0.910648829978731,0.695238095238095,1.65225840336134,591,280,311,7,1.1,28.12,2.3,0,0,0,0,0,0,0.0469552880876175,68.0693194180691,5.09618712809318
8.7,"random_policy_SVM","SVM",60,11,2712,2657,55,1200,859,341,0.926116838487981,0.69047619047619,1.69974983541804,605,290,315,14,1.1,30.67,2.5,0,0,0,0,0,0,0.0396504635333385,54.75770391071,4.49911698695542
8.7,"random_policy_SVM","SVM",60,12,2612,2564,48,1300,952,348,0.935718376697758,0.695238095238095,1.74106813996317,629,300,329,24,1.1,33.23,2.7,0,0,0,0,0,0,0.0539159191550212,68.7174805651079,6.26161109501645
8.7,"random_policy_SVM","SVM",60,13,2512,2468,44,1400,1048,352,0.943056237386121,0.69047619047619,1.77211134453782,650,308,342,21,1.1,35.79,3,0,0,0,0,0,0,0.0605119863958761,58.9183789846499,6.64274521195477
8.7,"random_policy_SVM","SVM",60,14,2412,2373,39,1500,1143,357,0.944894452626395,0.685714285714286,1.78067226890756,667,317,350,17,1.1,38.34,3.2,0,0,0,0,0,0,0.0590127041160392,48.1473701890961,6.32299151551867
8.7,"random_policy_SVM","SVM",60,15,2312,2280,32,1600,1236,364,0.945104456444649,0.680952380952381,1.78231042186884,686,327,359,19,1.1,40.9,3.4,0,0,0,0,0,0,0.0599972751958283,44.4641822102082,6.38596787014455
8.7,"random_policy_SVM","SVM",60,16,2212,2187,25,1700,1329,371,0.944193530791462,0.680952380952381,1.76723844441535,701,334,367,15,1.1,43.46,3.6,0,0,0,0,0,0,0.053476338048175,38.4606580595035,5.97128354284315
8.7,"random_policy_SVM","SVM",60,17,2112,2094,18,1800,1422,378,0.944253531882391,0.676190476190476,1.77211134453782,720,342,378,19,1.1,46.01,3.8,0,0,0,0,0,0,0.0450507324791519,35.2358675352492,5.32993476152544
8.7,"random_policy_SVM","SVM",60,18,2012,1995,17,1900,1521,379,0.944219440353454,0.676190476190476,1.77537490134175,721,343,378,1,1.1,48.57,4,0,0,0,0,0,0,0.0320717438531271,29.3590705186554,3.71617426876652
8.7,"random_policy_SVM","SVM",60,19,1912,1897,15,2000,1619,381,0.944785359733809,0.671428571428571,1.77048406139315,733,346,387,12,1.1,51.12,4.2,0,0,0,0,0,0,0.0254019516386792,24.6772256924801,2.80520878057968
8.7,"random_policy_SVM","SVM",60,20,1812,1798,14,2100,1718,382,0.944736267932139,0.671428571428571,1.7737416217637,740,348,392,7,1.1,53.68,4.5,0,0,0,0,0,0,0.0220284467581084,19.956012949798,2.25676347915829
8.7,"random_policy_SVM","SVM",60,21,1712,1698,14,2200,1818,382,0.944905361915659,0.661904761904762,1.7859501965924,755,359,396,15,1.1,56.24,4.8,0,0,0,0,0,0,0.0140232412296252,9.92625815026676,1.81593317102818
8.7,"random_policy_SVM","SVM",60,22,1612,1602,10,2300,1914,386,0.944689903452777,0.652380952380952,1.79418038183015,765,362,403,10,1.1,58.79,5,0,0,0,0,0,0,0.0105363782676516,8.79211837151057,1.24027780827875
8.7,"random_policy_SVM","SVM",60,23,1512,1503,9,2400,2013,387,0.944496263568414,0.652380952380952,1.78759018759019,768,363,405,3,1.1,61.35,5.2,0,0,0,0,0,0,0.0112745674511904,8.59898209280904,1.14340683960673
8.7,"random_policy_SVM","SVM",60,24,1412,1403,9,2500,2113,387,0.94490672557683,0.647619047619048,1.79252828203104,773,373,400,5,1.1,63.91,5.5,0,0,0,0,0,0,0.0076796548146729,5.25602267590985,0.950100984549619
8.7,"random_policy_SVM","SVM",60,25,1312,1304,8,2600,2212,388,0.944910816560303,0.647619047619048,1.78759018759019,774,372,402,1,1.1,66.46,5.7,0,0,0,0,0,0,0.00609288735740899,4.00635909457932,0.650684870046948
8.7,"random_policy_SVM","SVM",60,26,1212,1205,7,2700,2311,389,0.94545764468445,0.647619047619048,1.78923319327731,781,377,404,7,1.1,69.02,5.9,0,0,0,0,0,0,0.00564805784329755,3.2462991044743,0.585184251824868
8.7,"random_policy_SVM","SVM",60,27,1112,1105,7,2800,2411,389,0.945794468990345,0.642857142857143,1.78431321199424,785,382,403,4,1.1,71.57,6.2,0,0,0,0,0,0,0.00449422617048288,2.32001916539545,0.483904161917734
8.7,"random_policy_SVM","SVM",60,28,1012,1006,6,2900,2510,390,0.945956744668086,0.642857142857143,1.7859501965924,789,384,405,4,1.1,74.13,6.4,0,0,0,0,0,0,0.00388659652987093,1.71531974158782,0.403532949506553
8.7,"random_policy_SVM","SVM",60,29,912,906,6,3000,2610,390,0.946004472808597,0.642857142857143,1.79087922197398,791,385,406,2,1.1,76.69,6.7,0,0,0,0,0,0,0.0029991841153122,1.13918041855875,0.324965520092674
8.7,"random_policy_SVM","SVM",60,30,812,806,6,3100,2710,390,0.945922653139148,0.642857142857143,1.79285059578368,792,385,407,1,1.1,79.24,6.9,0,0,0,0,0,0,0.00232729597220268,0.738951565678069,0.255555002190601
8.7,"random_policy_SVM","SVM",60,31,712,708,4,3200,2808,392,0.946518573064963,0.647619047619048,1.79252828203104,800,387,413,8,1.1,81.8,7.2,0,0,0,0,0,0,0.00222106728514945,0.652019748098246,0.263002664715147
8.7,"random_policy_SVM","SVM",60,32,612,609,3,3300,2907,393,0.946642666230294,0.647619047619048,1.80110497237569,805,389,416,5,1.1,84.36,7.4,0,0,0,0,0,0,0.00107174405736361,0.328037153888424,0.148153147594451
8.7,"random_policy_SVM","SVM",60,33,512,509,3,3400,3007,393,0.946735395189002,0.647619047619048,1.80276497695853,804,389,415,-1,1.1,86.91,7.7,0,0,0,0,0,0,0.000686324412844055,0.20005955250875,0.0926487157338598
8.7,"random_policy_SVM","SVM",60,34,412,411,1,3500,3105,395,0.946781759668355,0.652380952380952,1.79944802207912,810,392,418,6,1.1,89.47,7.9,0,0,0,0,0,0,0.000539254120197709,0.160414971745839,0.0736636551166745
8.7,"random_policy_SVM","SVM",60,35,312,312,0,3600,3204,396,0.947148584519717,0.652380952380952,1.80110497237569,817,396,421,7,1.1,92.02,8.1,0,0,0,0,0,0,0.000363720624300448,0.0889560056797326,0.0466310146651655
8.7,"random_policy_SVM","SVM",60,36,212,212,0,3700,3304,396,0.947220858561063,0.652380952380952,1.79614325068871,818,396,422,1,1.1,94.58,8.3,0,0,0,0,0,0,0.000148907712941132,0.0326099262135776,0.0214295928061616
8.7,"random_policy_SVM","SVM",60,37,112,112,0,3800,3404,396,0.947358588337968,0.652380952380952,1.80110497237569,817,396,421,-1,1.1,97.14,8.6,0,0,0,0,0,0,4.88732919180382e-05,0.00881956023411325,0.00829495757590446
8.7,"random_policy_SVM","SVM",60,38,12,12,0,3900,3504,396,0.947572683139692,0.652380952380952,1.80110497237569,816,396,420,-1,1.1,99.69,8.8,0,0,0,0,0,0,4.92782901006272e-05,0.000662215046370003,0.000662215046370003
8.7,"random_policy_SVM","SVM",60,39,0,0,0,3912,3516,396,0.947621774941361,0.652380952380952,1.79944802207912,816,396,420,0,1.1,100,8.9,0,0,0,0,0,0,0,0,0
8.7,"random_policy_SVM","SVM",61,0,3812,3410,402,100,91,9,0.905974169687957,0.58974358974359,1.73450629882469,25,9,16,0,1.8,2.56,10.1,0,0,0,0,0,0,0.482083110021826,330.356507242472,53.337716595223
8.7,"random_policy_SVM","SVM",61,1,3712,3377,335,200,124,76,0.904509384236795,0.58974358974359,1.725624513481,89,46,43,64,0.9,5.11,1.6,0,0,0,0,0,0,0.785160718877025,334.577787325045,85.0314328156868
8.7,"random_policy_SVM","SVM",61,2,3612,3330,282,300,171,129,0.908522255711315,0.594871794871795,1.7316663134845,162,81,81,73,1,7.67,1.3,0,0,0,0,0,0,0.601540396076698,188.339290942706,74.3284738719572
8.7,"random_policy_SVM","SVM",61,3,3512,3289,223,400,212,188,0.89182137188951,0.57948717948718,1.71956043956044,230,114,116,68,1,10.22,1.1,0,0,0,0,0,0,0.413540324214676,168.867802910397,62.1652271429589
8.7,"random_policy_SVM","SVM",61,4,3412,3235,177,500,266,234,0.854080577760312,0.57948717948718,1.63635590216235,313,156,157,83,1,12.78,1.1,0,0,0,0,0,0,0.193175554340111,85.3081992669612,33.8740537006488
8.7,"random_policy_SVM","SVM",61,5,3312,3172,140,600,329,271,0.869896183695175,0.620512820512821,1.64560085076214,385,192,193,72,1,15.34,1.2,0,0,0,0,0,0,0.0976324789216303,57.3987545508298,17.2729258855488
8.7,"random_policy_SVM","SVM",61,6,3212,3102,110,700,399,301,0.88609618660727,0.630769230769231,1.64876739422194,446,217,229,61,1.1,17.89,1.3,0,0,0,0,0,0,0.0608367747774031,41.4071248874966,8.8935783534156
8.7,"random_policy_SVM","SVM",61,7,3112,3025,87,800,476,324,0.891352524061225,0.646153846153846,1.64257306630812,507,242,265,61,1.1,20.45,1.5,0,0,0,0,0,0,0.0594891849010698,53.9105380994744,8.77740715982298
8.7,"random_policy_SVM","SVM",61,8,3012,2946,66,900,555,345,0.900892558132767,0.666666666666667,1.64876739422194,550,266,284,43,1.1,23.01,1.6,0,0,0,0,0,0,0.0584545188575838,76.0536313720562,7.66023647500467
8.7,"random_policy_SVM","SVM",61,9,2912,2858,54,1000,643,357,0.913526696661267,0.671794871794872,1.70559954751131,586,283,303,36,1.1,25.56,1.8,0,0,0,0,0,0,0.057006383055128,87.8667874691156,6.72060365036732
8.7,"random_policy_SVM","SVM",61,10,2812,2762,50,1100,739,361,0.921565544052756,0.676923076923077,1.71324433142615,594,290,304,8,1,28.12,2,0,0,0,0,0,0,0.0462833293166983,70.0179577571652,5.20218931649294
8.7,"random_policy_SVM","SVM",61,11,2712,2666,46,1200,835,365,0.929972771880755,0.671794871794872,1.71324433142615,612,296,316,18,1.1,30.67,2.3,0,0,0,0,0,0,0.0433031500317281,60.9200002083926,4.94572733707122
8.7,"random_policy_SVM","SVM",61,12,2612,2573,39,1300,928,372,0.935248037973742,0.666666666666667,1.72403846153846,647,314,333,35,1.1,33.23,2.5,0,0,0,0,0,0,0.056066441251539,57.2448471783582,6.17975587477415
8.7,"random_policy_SVM","SVM",61,13,2512,2475,37,1400,1026,374,0.939891378732944,0.671794871794872,1.76578518255938,654,319,335,7,1.1,35.79,2.7,0,0,0,0,0,0,0.048664983782113,47.4780719039826,5.3674962349039
8.7,"random_policy_SVM","SVM",61,14,2412,2379,33,1500,1122,378,0.941338691594223,0.661538461538462,1.76578518255938,661,322,339,7,1.1,38.34,3,0,0,0,0,0,0,0.0448146393105434,40.9741733576841,5.05283308247891
8.7,"random_policy_SVM","SVM",61,15,2312,2281,31,1600,1220,380,0.943010236025568,0.666666666666667,1.78427507975895,676,326,350,15,1.1,40.9,3.2,0,0,0,0,0,0,0.04062451883898,34.0395519441648,4.55794915805797
8.7,"random_policy_SVM","SVM",61,16,2212,2189,23,1700,1312,388,0.943195154268407,0.656410256410256,1.77935520361991,698,333,365,22,1.1,43.46,3.4,0,0,0,0,0,0,0.0409900959229951,32.0309015656364,5.1978270444235
8.7,"random_policy_SVM","SVM",61,17,2112,2093,19,1800,1408,392,0.944367273839162,0.656410256410256,1.78427507975895,710,335,375,12,1.1,46.01,3.6,0,0,0,0,0,0,0.0313998253041168,29.2116940526793,3.76144491212515
8.7,"random_policy_SVM","SVM",61,18,2012,1998,14,1900,1503,397,0.945264200119391,0.656410256410256,1.78427507975895,725,343,382,15,1.1,48.57,3.8,0,0,0,0,0,0,0.0264131447795081,25.6996510511381,2.9094994111205
8.7,"random_policy_SVM","SVM",61,19,1912,1899,13,2000,1602,398,0.945654421293253,0.661538461538462,1.79352002835874,727,347,380,2,1.1,51.12,4,0,0,0,0,0,0,0.0201673245318405,19.2151655828577,2.15822947196709
8.7,"random_policy_SVM","SVM",61,20,1812,1799,13,2100,1702,398,0.945057441139204,0.661538461538462,1.78693225965953,730,349,381,3,1.1,53.68,4.3,0,0,0,0,0,0,0.0168050281767911,15.8182492090174,1.82499030613257
8.7,"random_policy_SVM","SVM",61,21,1712,1699,13,2200,1802,398,0.944633730834746,0.661538461538462,1.78857466063348,729,349,380,-1,1.1,56.24,4.5,0,0,0,0,0,0,0.013205217068418,11.9445018906082,1.37762465297327
8.7,"random_policy_SVM","SVM",61,22,1612,1599,13,2300,1902,398,0.943761557390181,0.656410256410256,1.79944802207912,738,355,383,9,1.1,58.79,4.8,0,0,0,0,0,0,0.00976189293478393,7.9581607672077,1.22129122633719
8.7,"random_policy_SVM","SVM",61,23,1512,1503,9,2400,1998,402,0.945063265335841,0.661538461538462,1.79779411764706,750,362,388,12,1.1,61.35,5,0,0,0,0,0,0,0.0105611408208353,8.48885683846429,1.09281784915217
8.7,"random_policy_SVM","SVM",61,24,1412,1403,9,2500,2098,402,0.942429272412239,0.641025641025641,1.80110497237569,758,370,388,8,1,63.91,5.2,0,0,0,0,0,0,0.00681729463666541,4.87711221099906,0.877304620136733
8.7,"random_policy_SVM","SVM",61,25,1312,1304,8,2600,2197,403,0.942615646704235,0.641025641025641,1.80110497237569,764,372,392,6,1.1,66.46,5.5,0,0,0,0,0,0,0.00670837386595056,4.33570732199427,0.685592841959245
8.7,"random_policy_SVM","SVM",61,26,1212,1204,8,2700,2297,403,0.941932759649967,0.641025641025641,1.80276497695853,776,377,399,12,1.1,69.02,5.7,0,0,0,0,0,0,0.00479069268940234,2.96922280729626,0.562979665703551
8.7,"random_policy_SVM","SVM",61,27,1112,1106,6,2800,2395,405,0.942203584793023,0.641025641025641,1.79944802207912,784,380,404,8,1.1,71.57,5.9,0,0,0,0,0,0,0.00581401297473308,2.89835619237411,0.597670142546288
8.7,"random_policy_SVM","SVM",61,28,1012,1006,6,2900,2495,405,0.941458087625039,0.641025641025641,1.79944802207912,788,384,404,4,1.1,74.13,6.2,0,0,0,0,0,0,0.00359525721679905,1.70556317803221,0.398804566178133
8.7,"random_policy_SVM","SVM",61,29,912,907,5,3000,2594,406,0.941495944903102,0.641025641025641,1.80276497695853,794,387,407,6,1.1,76.69,6.4,0,0,0,0,0,0,0.00348458485174926,1.50914836398994,0.37913123942412
8.7,"random_policy_SVM","SVM",61,30,812,808,4,3100,2693,407,0.941143581007297,0.635897435897436,1.80110497237569,800,389,411,6,1.1,79.24,6.6,0,0,0,0,0,0,0.00306707168431838,1.24484047345978,0.337569040712946
8.7,"random_policy_SVM","SVM",61,31,712,709,3,3200,2792,408,0.941041657566361,0.635897435897436,1.80276497695853,803,390,413,3,1.1,81.8,6.8,0,0,0,0,0,0,0.00266528151888376,1.01277011073459,0.303743525098982
8.7,"random_policy_SVM","SVM",61,32,612,609,3,3300,2892,408,0.94099215189505,0.635897435897436,1.79779411764706,802,391,411,-1,1.1,84.36,7.1,0,0,0,0,0,0,0.00203547945792971,0.693281887219318,0.233911494552448
8.7,"random_policy_SVM","SVM",61,33,512,509,3,3400,2992,408,0.941006712386612,0.635897435897436,1.80110497237569,804,392,412,2,1.1,86.91,7.3,0,0,0,0,0,0,0.00143364512344626,0.447933962494275,0.170085714022566
8.7,"random_policy_SVM","SVM",61,34,412,410,2,3500,3091,409,0.940954294616989,0.635897435897436,1.79779411764706,812,395,417,8,1.1,89.47,7.6,0,0,0,0,0,0,0.00111072686501289,0.326011926278678,0.133312968076935
8.7,"random_policy_SVM","SVM",61,35,312,312,0,3600,3189,411,0.94118435038367,0.635897435897436,1.79285059578368,819,399,420,7,1.1,92.02,7.8,0,0,0,0,0,0,0.00120077074515549,0.309229937894136,0.152124358454333
8.7,"random_policy_SVM","SVM",61,36,212,212,0,3700,3289,411,0.941040201517205,0.635897435897436,1.79449541284404,823,402,421,4,1,94.58,8,0,0,0,0,0,0,0.000657430054115664,0.134169661617295,0.0819831000065477
8.7,"random_policy_SVM","SVM",61,37,112,112,0,3800,3389,411,0.941021272878174,0.635897435897436,1.79944802207912,828,404,424,5,1,97.14,8.2,0,0,0,0,0,0,0.000308243556027372,0.0502828882265096,0.0469997892564895
8.7,"random_policy_SVM","SVM",61,38,12,12,0,3900,3489,411,0.941044569664673,0.630769230769231,1.79944802207912,827,405,422,-1,1,99.69,8.5,0,0,0,0,0,0,0.00015776169786583,0.00227063728808454,0.00227063728808454
8.7,"random_policy_SVM","SVM",61,39,0,0,0,3912,3501,411,0.941019816829017,0.630769230769231,1.79449541284404,827,405,422,0,1,100,8.5,0,0,0,0,0,0,0,0,0
8.7,"random_policy_SVM","SVM",62,0,3812,3410,402,100,89,11,0.778211597635913,0.373056994818653,1.53134430336503,32,11,21,0,1.9,2.56,8.1,0,0,0,0,0,0,0.756770990022506,596.273641008579,87.7684299285339
8.7,"random_policy_SVM","SVM",62,1,3712,3339,373,200,160,40,0.903735095912248,0.580310880829015,1.74350663279168,88,40,48,56,1.2,5.11,4,0,0,0,0,0,0,0.618744833289743,383.825931118732,70.8726531978936
8.7,"random_policy_SVM","SVM",62,2,3612,3300,312,300,199,101,0.912781146126922,0.606217616580311,1.74320807398945,172,86,86,84,1,7.67,2,0,0,0,0,0,0,0.618330196429643,258.533742134558,72.9957899861082
8.7,"random_policy_SVM","SVM",62,3,3512,3265,247,400,234,166,0.90988335356302,0.595854922279793,1.72485950302921,247,123,124,75,1,10.22,1.4,0,0,0,0,0,0,0.541410395843725,220.581447365459,70.9445121253811
8.7,"random_policy_SVM","SVM",62,4,3412,3223,189,500,276,224,0.903570515401526,0.601036269430052,1.74350663279168,314,159,155,67,1,12.78,1.2,0,0,0,0,0,0,0.329869342628011,179.951998672049,52.4741638699721
8.7,"random_policy_SVM","SVM",62,5,3312,3170,142,600,329,271,0.907787890988927,0.621761658031088,1.71711562133226,392,197,195,78,1,15.34,1.2,0,0,0,0,0,0,0.168277683905974,94.1585829878204,29.8623664554053
8.7,"random_policy_SVM","SVM",62,6,3212,3102,110,700,397,303,0.905557237281035,0.632124352331606,1.71553593814797,451,224,227,59,1,17.89,1.3,0,0,0,0,0,0,0.101947164266896,73.2573162886234,14.1234287172102
8.7,"random_policy_SVM","SVM",62,7,3112,3016,96,800,483,317,0.893257783041747,0.632124352331606,1.65027098397929,493,237,256,42,1.1,20.45,1.5,0,0,0,0,0,0,0.0709930871578952,64.8064522481583,9.84741721299052
8.7,"random_policy_SVM","SVM",62,8,3012,2933,79,900,566,334,0.900843181223725,0.642487046632124,1.62529070461546,535,260,275,42,1.1,23.01,1.7,0,0,0,0,0,0,0.0605401083603445,74.5448272023654,7.58007401611097
8.7,"random_policy_SVM","SVM",62,9,2912,2850,62,1000,649,351,0.904837197546597,0.658031088082902,1.64397220696736,581,278,303,46,1.1,25.56,1.8,0,0,0,0,0,0,0.0729943137609295,111.867204100524,9.89533467919196
8.7,"random_policy_SVM","SVM",62,10,2812,2759,53,1100,740,360,0.914997105146376,0.663212435233161,1.69688880838549,608,290,318,27,1.1,28.12,2.1,0,0,0,0,0,0,0.0628589273834991,88.150515955268,7.26799345487397
8.7,"random_policy_SVM","SVM",62,11,2712,2670,42,1200,829,371,0.919811085085191,0.66839378238342,1.71711562133226,642,307,335,34,1.1,30.67,2.2,0,0,0,0,0,0,0.0732770642178252,83.5403319579172,8.07925922856473
8.7,"random_policy_SVM","SVM",62,12,2612,2577,35,1300,922,378,0.925506746331466,0.663212435233161,1.75444422179601,666,318,348,24,1.1,33.23,2.4,0,0,0,0,0,0,0.0710787580970424,76.8446527944757,7.79795035004365
8.7,"random_policy_SVM","SVM",62,13,2512,2482,30,1400,1017,383,0.924971859671598,0.663212435233161,1.75606122107877,677,323,354,11,1.1,35.79,2.7,0,0,0,0,0,0,0.0688401111529063,68.1233192659762,7.52294925971225
8.7,"random_policy_SVM","SVM",62,14,2412,2388,24,1500,1111,389,0.923243764308946,0.66839378238342,1.74350663279168,698,332,366,21,1.1,38.34,2.9,0,0,0,0,0,0,0.0628002987052207,58.8571978072906,7.32583431540699
8.7,"random_policy_SVM","SVM",62,15,2312,2293,19,1600,1206,394,0.92280292365521,0.66839378238342,1.74350663279168,712,337,375,14,1.1,40.9,3.1,0,0,0,0,0,0,0.0505474296802955,46.1327267232893,5.78707091087812
8.7,"random_policy_SVM","SVM",62,16,2212,2198,14,1700,1301,399,0.921292309681736,0.66839378238342,1.7108142796026,726,342,384,14,1.1,43.46,3.3,0,0,0,0,0,0,0.0412386077444466,42.0508813894705,4.84188663789636
8.7,"random_policy_SVM","SVM",62,17,2112,2099,13,1800,1400,400,0.925123214962711,0.66839378238342,1.75444422179601,727,345,382,1,1.1,46.01,3.5,0,0,0,0,0,0,0.0343213191814616,35.9189353312624,3.81223517576089
8.7,"random_policy_SVM","SVM",62,18,2012,2000,12,1900,1499,401,0.924146018180257,0.66839378238342,1.73737971872687,732,349,383,5,1.1,48.57,3.7,0,0,0,0,0,0,0.0317457860868686,32.8624559644592,3.43884706329536
8.7,"random_policy_SVM","SVM",62,19,1912,1900,12,2000,1599,401,0.924134262429495,0.663212435233161,1.74672046990282,735,353,382,3,1.1,51.12,4,0,0,0,0,0,0,0.0243324249237608,23.4677190477859,2.6310731574072
8.7,"random_policy_SVM","SVM",62,20,1812,1801,11,2100,1698,402,0.92601812148981,0.663212435233161,1.74350663279168,741,356,385,6,1.1,53.68,4.2,0,0,0,0,0,0,0.0209392695579017,20.0349094754533,2.27004721271199
8.7,"random_policy_SVM","SVM",62,21,1712,1703,9,2200,1796,404,0.92800631283817,0.658031088082902,1.75444422179601,750,359,391,9,1.1,56.24,4.4,0,0,0,0,0,0,0.0169370359619057,16.0786790960105,1.83300075505367
8.7,"random_policy_SVM","SVM",62,22,1612,1605,7,2300,1894,406,0.929315609579778,0.658031088082902,1.76377637191195,756,362,394,6,1.1,58.79,4.7,0,0,0,0,0,0,0.0158202679991326,14.2444768925196,1.61143416098448
8.7,"random_policy_SVM","SVM",62,23,1512,1505,7,2400,1994,406,0.92871606629069,0.652849740932642,1.76377637191195,778,377,401,22,1.1,61.35,4.9,0,0,0,0,0,0,0.00998821055529117,7.45748415717267,1.30491907034088
8.7,"random_policy_SVM","SVM",62,24,1412,1405,7,2500,2094,406,0.928804234421438,0.652849740932642,1.76540197225472,779,376,403,1,1.1,63.91,5.2,0,0,0,0,0,0,0.00843050056856911,6.66967484602032,0.934264535260613
8.7,"random_policy_SVM","SVM",62,25,1312,1306,6,2600,2193,407,0.928613203471486,0.652849740932642,1.76540197225472,782,379,403,3,1.1,66.46,5.4,0,0,0,0,0,0,0.00757427262541921,5.40404513978173,0.7737704389861
8.7,"random_policy_SVM","SVM",62,26,1212,1207,5,2700,2292,408,0.929112822879046,0.663212435233161,1.76540197225472,791,385,406,9,1.1,69.02,5.6,0,0,0,0,0,0,0.00552923273198358,3.5897842537598,0.670830208686313
8.7,"random_policy_SVM","SVM",62,27,1112,1107,5,2800,2392,408,0.92900702112215,0.663212435233161,1.76540197225472,792,385,407,1,1.1,71.57,5.9,0,0,0,0,0,0,0.00485117512099318,2.97282558237382,0.507899940844025
8.7,"random_policy_SVM","SVM",62,28,1012,1007,5,2900,2492,408,0.93021492451338,0.658031088082902,1.76215376255416,802,390,412,10,1.1,74.13,6.1,0,0,0,0,0,0,0.00399427873116031,2.16155488888653,0.423844419949591
8.7,"random_policy_SVM","SVM",62,29,912,907,5,3000,2592,408,0.930414772276405,0.658031088082902,1.76215376255416,805,390,415,3,1.1,76.69,6.4,0,0,0,0,0,0,0.00350300523241158,1.60937008422164,0.359740633686173
8.7,"random_policy_SVM","SVM",62,30,812,808,4,3100,2691,409,0.930516165626763,0.658031088082902,1.76377637191195,809,395,414,4,1,79.24,6.6,0,0,0,0,0,0,0.00264229754560945,1.04481729511211,0.281838854136285
8.7,"random_policy_SVM","SVM",62,31,712,709,3,3200,2790,410,0.930984926188571,0.652849740932642,1.76540197225472,809,396,413,0,1,81.8,6.8,0,0,0,0,0,0,0.00253115825250996,0.796883822778394,0.272728366460374
8.7,"random_policy_SVM","SVM",62,32,612,610,2,3300,2889,411,0.931393438527702,0.658031088082902,1.76540197225472,816,398,418,7,1.1,84.36,7,0,0,0,0,0,0,0.00169788814328013,0.490143544830061,0.207926367497201
8.7,"random_policy_SVM","SVM",62,33,512,510,2,3400,2989,411,0.931643248231486,0.658031088082902,1.76053413593417,816,398,418,0,1.1,86.91,7.3,0,0,0,0,0,0,0.00099873249731082,0.294049479133955,0.136519298431077
8.7,"random_policy_SVM","SVM",62,34,412,411,1,3500,3088,412,0.932804128619664,0.658031088082902,1.75891748383505,827,403,424,11,1.1,89.47,7.5,0,0,0,0,0,0,0.000776877949153224,0.20247795102719,0.0976937915255396
8.7,"random_policy_SVM","SVM",62,35,312,312,0,3600,3187,413,0.933513882072194,0.658031088082902,1.76377637191195,833,405,428,6,1.1,92.02,7.7,0,0,0,0,0,0,0.000466771945614549,0.122240868196625,0.0660679032861429
8.7,"random_policy_SVM","SVM",62,36,212,212,0,3700,3287,413,0.93380336743482,0.658031088082902,1.76540197225472,836,408,428,3,1,94.58,8,0,0,0,0,0,0,0.000203032646176088,0.0438472659065761,0.0281738311453228
8.7,"random_policy_SVM","SVM",62,37,112,112,0,3800,3387,413,0.934361765596223,0.658031088082902,1.76053413593417,838,409,429,2,1,97.14,8.2,0,0,0,0,0,0,7.20262934998719e-05,0.0131033574901594,0.0123373083575948
8.7,"random_policy_SVM","SVM",62,38,12,12,0,3900,3487,413,0.934826117751493,0.652849740932642,1.76053413593417,839,409,430,1,1.1,99.69,8.4,0,0,0,0,0,0,4.04959936800876e-05,0.000664767674855005,0.000664767674855005
8.7,"random_policy_SVM","SVM",62,39,0,0,0,3912,3499,413,0.934854037659563,0.652849740932642,1.76377637191195,840,409,431,1,1.1,100,8.5,0,0,0,0,0,0,0,0,0
8.7,"random_policy_SVM","SVM",63,0,3812,3428,384,100,88,12,0.884309714722079,0.538095238095238,1.71061261970353,33,12,21,0,1.8,2.56,7.3,0,0,0,0,0,0,0.567290857009803,532.090868794213,63.3302770419819
8.7,"random_policy_SVM","SVM",63,1,3712,3369,343,200,147,53,0.895675830469647,0.595238095238095,1.70362394957983,113,53,60,80,1.1,5.11,2.8,0,0,0,0,0,0,0.754629906993592,560.683588083544,82.7302685739499
8.7,"random_policy_SVM","SVM",63,2,3612,3327,285,300,189,111,0.908441062564765,0.628571428571429,1.74267281105991,196,96,100,83,1,7.67,1.7,0,0,0,0,0,0,0.585900934709376,399.317113382047,72.3194845508034
8.7,"random_policy_SVM","SVM",63,3,3512,3286,226,400,230,170,0.897418589428907,0.633333333333333,1.70676137858458,268,132,136,72,1,10.22,1.4,0,0,0,0,0,0,0.494676175476311,382.045540703936,66.4300849889575
8.7,"random_policy_SVM","SVM",63,4,3412,3242,170,500,274,226,0.897673594065342,0.652380952380952,1.69974983541804,340,167,173,72,1,12.78,1.2,0,0,0,0,0,0,0.323225194417874,259.39645039302,50.2580588471795
8.7,"random_policy_SVM","SVM",63,5,3312,3184,128,600,332,268,0.888021600392732,0.676190476190476,1.61652892561983,412,204,208,72,1,15.34,1.2,0,0,0,0,0,0,0.181683008280428,187.411257055692,27.9412664145215
8.7,"random_policy_SVM","SVM",63,6,3212,3123,89,700,393,307,0.882520591283474,0.680952380952381,1.60797586252132,490,242,248,78,1,17.89,1.3,0,0,0,0,0,0,0.144760131475652,190.696235058287,18.6299242781025
8.7,"random_policy_SVM","SVM",63,7,3112,3047,65,800,469,331,0.873678612338405,0.680952380952381,1.57665921934551,553,267,286,63,1.1,20.45,1.4,0,0,0,0,0,0,0.128421727614887,214.508490450922,16.696359989921
8.7,"random_policy_SVM","SVM",63,8,3012,2958,54,900,558,342,0.89956499209077,0.69047619047619,1.66938025210084,590,284,306,37,1.1,23.01,1.6,0,0,0,0,0,0,0.0863459121303308,122.392659249708,10.7439702258397
8.7,"random_policy_SVM","SVM",63,9,2912,2867,45,1000,649,351,0.904577810505638,0.695238095238095,1.69818468823994,609,293,316,19,1.1,25.56,1.8,0,0,0,0,0,0,0.0704168553016731,105.476965398133,7.6424874416932
8.7,"random_policy_SVM","SVM",63,10,2812,2774,38,1100,742,358,0.915930289641624,0.69047619047619,1.71691902567479,634,306,328,25,1.1,28.12,2.1,0,0,0,0,0,0,0.0731353510812831,102.320142792492,8.26191925407415
8.7,"random_policy_SVM","SVM",63,11,2712,2680,32,1200,836,364,0.923722249495434,0.680952380952381,1.74267281105991,656,316,340,22,1.1,30.67,2.3,0,0,0,0,0,0,0.0692875222670945,82.733339271894,7.60015289455637
8.7,"random_policy_SVM","SVM",63,12,2612,2581,31,1300,935,365,0.924665903016414,0.680952380952381,1.73946642134315,660,317,343,4,1.1,33.23,2.6,0,0,0,0,0,0,0.0595156987406465,65.771761589385,6.19231237487306
8.7,"random_policy_SVM","SVM",63,13,2512,2484,28,1400,1032,368,0.92557955599192,0.680952380952381,1.75984200131666,671,322,349,11,1.1,35.79,2.8,0,0,0,0,0,0,0.0499547201974488,53.159165275474,5.50398408080924
8.7,"random_policy_SVM","SVM",63,14,2412,2390,22,1500,1126,374,0.927595047182673,0.676190476190476,1.76517282165856,681,327,354,10,1.1,38.34,3,0,0,0,0,0,0,0.0515190503674044,52.1357959426902,5.98298023053509
8.7,"random_policy_SVM","SVM",63,15,2312,2295,17,1600,1221,379,0.928257786505197,0.676190476190476,1.76679821099711,697,333,364,16,1.1,40.9,3.2,0,0,0,0,0,0,0.0352713482516603,37.0472479455714,4.20715244341417
8.7,"random_policy_SVM","SVM",63,16,2212,2199,13,1700,1317,383,0.930351006381931,0.676190476190476,1.76679821099711,709,337,372,12,1.1,43.46,3.4,0,0,0,0,0,0,0.031133510079738,34.8315205949866,3.48175071688613
8.7,"random_policy_SVM","SVM",63,17,2112,2101,11,1800,1415,385,0.930657830142366,0.676190476190476,1.76842659644503,716,340,376,7,1.1,46.01,3.7,0,0,0,0,0,0,0.0259665975792127,29.7977071002609,2.90319671834406
8.7,"random_policy_SVM","SVM",63,18,2012,2002,10,1900,1514,386,0.93039737086129,0.676190476190476,1.76679821099711,723,342,381,7,1.1,48.57,3.9,0,0,0,0,0,0,0.022802800772938,24.6229851942693,2.32862339893276
8.7,"random_policy_SVM","SVM",63,19,1912,1903,9,2000,1613,387,0.928410516554851,0.666666666666667,1.7737416217637,742,358,384,19,1.1,51.12,4.2,0,0,0,0,0,0,0.0150000959151463,12.0798954239891,1.98991984867225
8.7,"random_policy_SVM","SVM",63,20,1812,1804,8,2100,1712,388,0.92844324442263,0.666666666666667,1.77211134453782,746,360,386,4,1.1,53.68,4.4,0,0,0,0,0,0,0.0123983002336688,11.2512069794854,1.41375744307625
8.7,"random_policy_SVM","SVM",63,21,1712,1705,7,2200,1811,389,0.928541428025969,0.666666666666667,1.77537490134175,747,360,387,1,1.1,56.24,4.7,0,0,0,0,0,0,0.00944907070442167,8.64397258592376,1.01449415812333
8.7,"random_policy_SVM","SVM",63,22,1612,1605,7,2300,1911,389,0.928737795232646,0.666666666666667,1.7737416217637,750,362,388,3,1.1,58.79,4.9,0,0,0,0,0,0,0.00841617810898199,7.36257493780397,0.881475682681048
8.7,"random_policy_SVM","SVM",63,23,1512,1506,6,2400,2010,390,0.928745977199591,0.671428571428571,1.77537490134175,760,363,397,10,1.1,61.35,5.2,0,0,0,0,0,0,0.00911329412670284,7.24941463487429,0.924584011505714
8.7,"random_policy_SVM","SVM",63,24,1412,1407,5,2500,2109,391,0.928895979926913,0.671428571428571,1.77048406139315,768,374,394,8,1.1,63.91,5.4,0,0,0,0,0,0,0.00649370799401842,4.49590855230271,0.800714824833978
8.7,"random_policy_SVM","SVM",63,25,1312,1307,5,2600,2209,391,0.928894616265757,0.671428571428571,1.76885976408912,768,373,395,0,1.1,66.46,5.6,0,0,0,0,0,0,0.00556565225682848,3.77569366618429,0.592336981703253
8.7,"random_policy_SVM","SVM",63,26,1212,1207,5,2700,2309,391,0.929015982108771,0.666666666666667,1.76885976408912,772,375,397,4,1.1,69.02,5.9,0,0,0,0,0,0,0.00503619604596105,3.01005889287136,0.517099467568293
8.7,"random_policy_SVM","SVM",63,27,1112,1107,5,2800,2409,391,0.928945071728581,0.666666666666667,1.7737416217637,773,377,396,1,1.1,71.57,6.2,0,0,0,0,0,0,0.0039844139654413,2.10285434586629,0.422706494973928
8.7,"random_policy_SVM","SVM",63,28,1012,1008,4,2900,2508,392,0.929032346042659,0.666666666666667,1.7737416217637,777,378,399,4,1.1,74.13,6.4,0,0,0,0,0,0,0.00379192085134898,1.73391365873673,0.393270421187278
8.7,"random_policy_SVM","SVM",63,29,912,909,3,3000,2607,393,0.928812796596307,0.666666666666667,1.77537490134175,782,382,400,5,1,76.69,6.6,0,0,0,0,0,0,0.00322733374580027,1.31394284273182,0.346747802971287
8.7,"random_policy_SVM","SVM",63,30,812,810,2,3100,2706,394,0.928827796869039,0.666666666666667,1.7770111915734,792,385,407,10,1.1,79.24,6.9,0,0,0,0,0,0,0.00286570925674284,1.06842670495671,0.320033542256199
8.7,"random_policy_SVM","SVM",63,31,712,710,2,3200,2806,394,0.928690067092134,0.666666666666667,1.77537490134175,793,385,408,1,1.1,81.8,7.1,0,0,0,0,0,0,0.00239599364018749,0.813581839082816,0.273177396975743
8.7,"random_policy_SVM","SVM",63,32,612,611,1,3300,2905,395,0.929329624174989,0.666666666666667,1.7737416217637,794,386,408,1,1.1,84.36,7.4,0,0,0,0,0,0,0.00153175544314971,0.521763209810114,0.195876567024536
8.7,"random_policy_SVM","SVM",63,33,512,511,1,3400,3005,395,0.929423716794856,0.657142857142857,1.77537490134175,796,386,410,2,1.1,86.91,7.6,0,0,0,0,0,0,0.00100535949322884,0.322107669146197,0.126264253324079
8.7,"random_policy_SVM","SVM",63,34,412,412,0,3500,3104,396,0.929888725249556,0.657142857142857,1.7737416217637,802,389,413,6,1.1,89.47,7.8,0,0,0,0,0,0,0.00078214759903994,0.234915961969807,0.095489214932731
8.7,"random_policy_SVM","SVM",63,35,312,312,0,3600,3204,396,0.930008727431415,0.661904761904762,1.76885976408912,808,391,417,6,1.1,92.02,8.1,0,0,0,0,0,0,0.000477649684403787,0.117887521103859,0.056986668189116
8.7,"random_policy_SVM","SVM",63,36,212,212,0,3700,3304,396,0.930286914307541,0.657142857142857,1.77537490134175,807,391,416,-1,1.1,94.58,8.3,0,0,0,0,0,0,0.000216518881228844,0.0458296402079708,0.029513377949807
8.7,"random_policy_SVM","SVM",63,37,112,112,0,3800,3404,396,0.930657830142375,0.657142857142857,1.7770111915734,808,393,415,1,1.1,97.14,8.6,0,0,0,0,0,0,0.000103383649020904,0.0165058350714107,0.0154465290708718
8.7,"random_policy_SVM","SVM",63,38,12,12,0,3900,3504,396,0.931012382043324,0.657142857142857,1.7737416217637,812,394,418,4,1.1,99.69,8.8,0,0,0,0,0,0,6.65374397583508e-05,0.000955576636082232,0.000955576636082232
8.7,"random_policy_SVM","SVM",63,39,0,0,0,3912,3516,396,0.931116020291293,0.657142857142857,1.77048406139315,815,394,421,3,1.1,100,8.9,0,0,0,0,0,0,0,0,0
8.7,"random_policy_SVM","SVM",64,0,3812,3415,397,100,85,15,0.901570380425259,0.541237113402062,1.74700935911445,37,15,22,0,1.5,2.56,5.7,0,0,0,0,0,0,0.299161710392923,469.447952311288,32.84948517805
8.7,"random_policy_SVM","SVM",64,1,3712,3384,328,200,116,84,0.934968756216586,0.577319587628866,1.7759954601343,106,54,52,69,1,5.11,1.4,0,0,0,0,0,0,0.662284621961085,358.551682246345,73.9065708638191
8.7,"random_policy_SVM","SVM",64,2,3612,3337,275,300,163,137,0.924979814409582,0.587628865979381,1.75910936923121,183,92,91,77,1,7.67,1.2,0,0,0,0,0,0,0.538958806485804,311.212062415414,68.7507599945116
8.7,"random_policy_SVM","SVM",64,3,3512,3294,218,400,206,194,0.913550089518719,0.608247422680412,1.73899555471484,259,130,129,76,1,10.22,1.1,0,0,0,0,0,0,0.35945877233729,281.677693891991,57.3214040645612
8.7,"random_policy_SVM","SVM",64,4,3412,3241,171,500,259,241,0.919798846203347,0.644329896907217,1.73740160828522,340,169,171,81,1,12.78,1.1,0,0,0,0,0,0,0.180497308971702,141.030711813175,29.3615129211179
8.7,"random_policy_SVM","SVM",64,5,3312,3176,136,600,324,276,0.90410235557064,0.644329896907217,1.70199564929537,407,201,206,67,1,15.34,1.2,0,0,0,0,0,0,0.135113695945493,131.486140265747,18.074652836348
8.7,"random_policy_SVM","SVM",64,6,3212,3096,116,700,404,296,0.906896158301832,0.664948453608247,1.71754855613146,453,219,234,46,1.1,17.89,1.4,0,0,0,0,0,0,0.108665842656951,127.574345462952,13.2315933961215
8.7,"random_policy_SVM","SVM",64,7,3112,3012,100,800,488,312,0.905007781691379,0.670103092783505,1.69430007668058,496,238,258,43,1.1,20.45,1.6,0,0,0,0,0,0,0.115149901496898,122.206189470812,13.2913771572155
8.7,"random_policy_SVM","SVM",64,8,3012,2927,85,900,573,327,0.899077898826324,0.654639175257732,1.6618442786353,545,263,282,49,1.1,23.01,1.8,0,0,0,0,0,0,0.108507567326798,119.472007964614,15.4943878543503
8.7,"random_policy_SVM","SVM",64,9,2912,2845,67,1000,655,345,0.903071135190809,0.664948453608247,1.67112832488466,590,282,308,45,1.1,25.56,1.9,0,0,0,0,0,0,0.0895416648392686,95.6914631596088,9.83324916285128
8.7,"random_policy_SVM","SVM",64,10,2812,2754,58,1100,746,354,0.903969247691844,0.654639175257732,1.68196113829636,609,292,317,19,1.1,28.12,2.1,0,0,0,0,0,0,0.0824510920057938,82.5972016422706,9.08527985985099
8.7,"random_policy_SVM","SVM",64,11,2712,2662,50,1200,838,362,0.905598722164378,0.654639175257732,1.69125374127037,627,301,326,18,1.1,30.67,2.3,0,0,0,0,0,0,0.0744175536563549,68.4601838466661,8.13066542511622
8.7,"random_policy_SVM","SVM",64,12,2612,2567,45,1300,933,367,0.906520238248489,0.654639175257732,1.68969641738338,641,308,333,14,1.1,33.23,2.5,0,0,0,0,0,0,0.0664661384881022,59.3972374387222,7.3992781518324
8.7,"random_policy_SVM","SVM",64,13,2512,2472,40,1400,1028,372,0.905461226113734,0.654639175257732,1.69125374127037,656,313,343,15,1.1,35.79,2.8,0,0,0,0,0,0,0.0599188609925484,53.2750343313981,6.54815649890447
8.7,"random_policy_SVM","SVM",64,14,2412,2381,31,1500,1119,381,0.905645529330544,0.649484536082474,1.66805639781686,679,322,357,23,1.1,38.34,2.9,0,0,0,0,0,0,0.0521301559815669,51.0532541095294,5.87085494786879
8.7,"random_policy_SVM","SVM",64,15,2312,2285,27,1600,1215,385,0.911200954866189,0.649484536082474,1.69125374127037,688,326,362,9,1.1,40.9,3.2,0,0,0,0,0,0,0.0437127155308449,47.5309433911763,5.04327037340398
8.7,"random_policy_SVM","SVM",64,16,2212,2189,23,1700,1311,389,0.920401488467872,0.65979381443299,1.69741746412618,702,335,367,14,1.1,43.46,3.4,0,0,0,0,0,0,0.0433029592391534,47.5395374069028,4.90496969591495
8.7,"random_policy_SVM","SVM",64,17,2112,2096,16,1800,1404,396,0.922282551458631,0.664948453608247,1.7098389472184,725,344,381,23,1.1,46.01,3.5,0,0,0,0,0,0,0.0397603539264765,42.910704945731,4.45486203328852
8.7,"random_policy_SVM","SVM",64,18,2012,1999,13,1900,1501,399,0.924491264612612,0.664948453608247,1.71439129775622,740,356,384,15,1.1,48.57,3.8,0,0,0,0,0,0,0.0280875164387477,26.5936065467249,3.49009173191672
8.7,"random_policy_SVM","SVM",64,19,1912,1903,9,2000,1597,403,0.925800402541627,0.670103092783505,1.71754855613146,755,364,391,15,1.1,51.12,4,0,0,0,0,0,0,0.0233542978630396,22.4978054455054,2.5511077288604
8.7,"random_policy_SVM","SVM",64,20,1812,1805,7,2100,1695,405,0.929022783388147,0.65979381443299,1.73451948519997,767,370,397,12,1.1,53.68,4.2,0,0,0,0,0,0,0.019754397618944,17.4532518499,2.07009883794161
8.7,"random_policy_SVM","SVM",64,21,1712,1705,7,2200,1795,405,0.930185648922864,0.654639175257732,1.74219223771983,777,376,401,10,1.1,56.24,4.4,0,0,0,0,0,0,0.0142395432299754,11.374896254184,1.66328494684277
8.7,"random_policy_SVM","SVM",64,22,1612,1607,5,2300,1893,407,0.930067168283479,0.649484536082474,1.74379499046842,785,380,405,8,1.1,58.79,4.7,0,0,0,0,0,0,0.0132541777376755,10.5239911040425,1.39432578840219
8.7,"random_policy_SVM","SVM",64,23,1512,1507,5,2400,1993,407,0.930459178300211,0.649484536082474,1.74700935911445,788,380,408,3,1.1,61.35,4.9,0,0,0,0,0,0,0.0111295791610077,8.21747897480798,1.18057885493885
8.7,"random_policy_SVM","SVM",64,24,1412,1408,4,2500,2092,408,0.931412874311064,0.649484536082474,1.74379499046842,797,385,412,9,1.1,63.91,5.1,0,0,0,0,0,0,0.00851827356311348,6.03005748425292,0.944587251747156
8.7,"random_policy_SVM","SVM",64,25,1312,1308,4,2600,2192,408,0.932196894344527,0.649484536082474,1.74540069487954,801,389,412,4,1.1,66.46,5.4,0,0,0,0,0,0,0.00737182579158789,4.67100054872261,0.769935233808932
8.7,"random_policy_SVM","SVM",64,26,1212,1208,4,2700,2292,408,0.932688369589383,0.654639175257732,1.75468474112889,803,391,412,2,1.1,69.02,5.6,0,0,0,0,0,0,0.00580788493912329,3.32281172969735,0.613115311650002
8.7,"random_policy_SVM","SVM",64,27,1112,1108,4,2800,2392,408,0.933200322969442,0.649484536082474,1.75307049573687,806,393,413,3,1.1,71.57,5.9,0,0,0,0,0,0,0.00475483696897124,2.38168087931718,0.498846402982224
8.7,"random_policy_SVM","SVM",64,28,1012,1008,4,2900,2492,408,0.933571854850972,0.649484536082474,1.74985089886683,808,394,414,2,1.1,74.13,6.1,0,0,0,0,0,0,0.00443186702525155,1.92568355536082,0.466622319713634
8.7,"random_policy_SVM","SVM",64,29,912,908,4,3000,2592,408,0.933606960225605,0.644329896907217,1.74664310620163,809,394,415,1,1.1,76.69,6.4,0,0,0,0,0,0,0.00401663440013196,1.53357973162298,0.433981123777812
8.7,"random_policy_SVM","SVM",64,30,812,809,3,3100,2691,409,0.933902430462096,0.644329896907217,1.74985089886683,813,397,416,4,1,79.24,6.6,0,0,0,0,0,0,0.00322745023967633,1.09588424932504,0.362482620024795
8.7,"random_policy_SVM","SVM",64,31,712,709,3,3200,2791,409,0.933719589969217,0.644329896907217,1.74824553106971,814,397,417,1,1.1,81.8,6.8,0,0,0,0,0,0,0.00212973821390774,0.679020068401282,0.25482852951174
8.7,"random_policy_SVM","SVM",64,32,612,610,2,3300,2890,410,0.934135003569039,0.644329896907217,1.75468474112889,818,399,419,4,1.1,84.36,7,0,0,0,0,0,0,0.0018134246775481,0.546078577253353,0.221741720243814
8.7,"random_policy_SVM","SVM",64,33,512,510,2,3400,2990,410,0.934335396749235,0.644329896907217,1.74985089886683,816,399,417,-2,1,86.91,7.3,0,0,0,0,0,0,0.000952276814119134,0.296804600620782,0.130481439144154
8.7,"random_policy_SVM","SVM",64,34,412,411,1,3500,3089,411,0.934651345120933,0.649484536082474,1.7514592177077,823,401,422,7,1.1,89.47,7.5,0,0,0,0,0,0,0.000704940834285501,0.205703245063664,0.091330583525378
8.7,"random_policy_SVM","SVM",64,35,312,312,0,3600,3188,412,0.934905859087024,0.649484536082474,1.75910936923121,830,405,425,7,1,92.02,7.7,0,0,0,0,0,0,0.00052979424092436,0.130586439570291,0.0663989947512649
8.7,"random_policy_SVM","SVM",64,36,212,212,0,3700,3288,412,0.935170612120718,0.644329896907217,1.76999317768344,836,406,430,6,1.1,94.58,8,0,0,0,0,0,0,0.000268504985244181,0.0556078509122253,0.0360378813094289
8.7,"random_policy_SVM","SVM",64,37,112,112,0,3800,3388,412,0.935552383069856,0.644329896907217,1.76559456506247,834,407,427,-2,1,97.14,8.2,0,0,0,0,0,0,9.98918251708381e-05,0.0184684825638948,0.0174063817775869
8.7,"random_policy_SVM","SVM",64,38,12,12,0,3900,3488,412,0.935637221058556,0.644329896907217,1.75910936923121,836,407,429,2,1.1,99.69,8.5,0,0,0,0,0,0,5.20623812340688e-05,0.000733448974177216,0.000733448974177216
8.7,"random_policy_SVM","SVM",64,39,0,0,0,3912,3500,412,0.935610892027582,0.644329896907217,1.75427665118387,836,407,429,0,1.1,100,8.5,0,0,0,0,0,0,0,0,0
8.7,"random_policy_SVM","SVM",65,0,3812,3425,387,100,88,12,0.892628776139863,0.51207729468599,1.72438389100381,32,12,20,0,1.7,2.56,7.3,0,0,0,0,0,0,0.330568169579672,399.805860686291,35.6145341340338
8.7,"random_policy_SVM","SVM",65,1,3712,3395,317,200,118,82,0.925174633952323,0.570048309178744,1.79944802207912,96,47,49,64,1,5.11,1.4,0,0,0,0,0,0,0.633182468119914,354.261505080681,70.0650920530033
8.7,"random_policy_SVM","SVM",65,2,3612,3355,257,300,158,142,0.929716912079505,0.594202898550725,1.80110497237569,172,88,84,76,1,7.67,1.1,0,0,0,0,0,0,0.594914893029845,280.404865690167,72.5391606847892
8.7,"random_policy_SVM","SVM",65,3,3512,3303,209,400,210,190,0.928902091740486,0.603864734299517,1.78370299196626,262,133,129,90,1,10.22,1.1,0,0,0,0,0,0,0.392730352874201,204.581728275457,57.3467519592405
8.7,"random_policy_SVM","SVM",65,4,3412,3250,162,500,263,237,0.919664238778276,0.608695652173913,1.75436913895993,340,170,170,78,1,12.78,1.1,0,0,0,0,0,0,0.213688976010706,135.125224842455,33.2067222274551
8.7,"random_policy_SVM","SVM",65,5,3312,3182,130,600,331,269,0.924682979646073,0.63768115942029,1.75598309400957,403,198,205,63,1,15.34,1.2,0,0,0,0,0,0,0.118375950172652,76.3950776020971,17.9754662831405
8.7,"random_policy_SVM","SVM",65,6,3212,3105,107,700,408,292,0.926753175727757,0.642512077294686,1.75436913895993,450,217,233,47,1.1,17.89,1.4,0,0,0,0,0,0,0.0793138534800546,55.5620293311261,11.4605983467576
8.7,"random_policy_SVM","SVM",65,7,3112,3027,85,800,486,314,0.926318144529788,0.647342995169082,1.72990413716785,502,241,261,52,1.1,20.45,1.5,0,0,0,0,0,0,0.0845969124982093,97.1752778878235,11.2004496509062
8.7,"random_policy_SVM","SVM",65,8,3012,2945,67,900,568,332,0.920796700944364,0.666666666666667,1.69201900427197,554,269,285,52,1.1,23.01,1.7,0,0,0,0,0,0,0.0697909682392317,108.714144059834,8.9476442956955
8.7,"random_policy_SVM","SVM",65,9,2912,2855,57,1000,658,342,0.93486132862671,0.661835748792271,1.71962915601023,585,281,304,31,1.1,25.56,1.9,0,0,0,0,0,0,0.0723798173479467,109.762945933935,8.75623578071604
8.7,"random_policy_SVM","SVM",65,10,2812,2769,43,1100,744,356,0.946543642605997,0.671497584541063,1.77500200176155,629,299,330,44,1.1,28.12,2.1,0,0,0,0,0,0,0.0888020951818941,109.476838642467,10.2646471807402
8.7,"random_policy_SVM","SVM",65,11,2712,2670,42,1200,843,357,0.949754587162307,0.666666666666667,1.794055967408,637,302,335,8,1.1,30.67,2.4,0,0,0,0,0,0,0.0674698163827749,78.2785077565269,7.38429427092435
8.7,"random_policy_SVM","SVM",65,12,2612,2573,39,1300,940,360,0.950417491844894,0.661835748792271,1.79944802207912,649,312,337,12,1.1,33.23,2.6,0,0,0,0,0,0,0.0625274048196312,64.5291245422178,6.81666524305287
8.7,"random_policy_SVM","SVM",65,13,2512,2475,37,1400,1038,362,0.950511403341596,0.657004830917874,1.79614325068871,651,316,335,2,1.1,35.79,2.9,0,0,0,0,0,0,0.0561551379741233,52.6268293067754,6.04127561892671
8.7,"random_policy_SVM","SVM",65,14,2412,2380,32,1500,1133,367,0.950498973878797,0.652173913043478,1.79779411764706,667,321,346,16,1.1,38.34,3.1,0,0,0,0,0,0,0.0477400603417886,43.8023326394632,5.42572741091621
8.7,"random_policy_SVM","SVM",65,15,2312,2286,26,1600,1227,373,0.950655032689493,0.652173913043478,1.79240398217098,674,326,348,7,1.1,40.9,3.3,0,0,0,0,0,0,0.0413243462556482,39.9095907190391,4.92913029467219
8.7,"random_policy_SVM","SVM",65,16,2212,2192,20,1700,1321,379,0.95151957087971,0.647342995169082,1.78746623015398,695,332,363,21,1.1,43.46,3.5,0,0,0,0,0,0,0.0344676979410386,35.4199837719564,3.96579382463064
8.7,"random_policy_SVM","SVM",65,17,2112,2093,19,1800,1420,380,0.951994652568901,0.647342995169082,1.78746623015398,701,334,367,6,1.1,46.01,3.7,0,0,0,0,0,0,0.0285131865501114,30.6295598725163,3.15949085026365
8.7,"random_policy_SVM","SVM",65,18,2012,1997,15,1900,1516,384,0.951863452683807,0.647342995169082,1.78910912190963,717,341,376,16,1.1,48.57,3.9,0,0,0,0,0,0,0.0284099131673147,30.2785005108379,2.98241739227855
8.7,"random_policy_SVM","SVM",65,19,1912,1899,13,2000,1614,386,0.951849642169579,0.661835748792271,1.80110497237569,734,356,378,17,1.1,51.12,4.2,0,0,0,0,0,0,0.0194227503003643,14.8095310707623,2.42319951709611
8.7,"random_policy_SVM","SVM",65,20,1812,1800,12,2100,1713,387,0.951955983129079,0.661835748792271,1.79944802207912,734,357,377,0,1.1,53.68,4.4,0,0,0,0,0,0,0.0152316611698392,13.8744504965102,1.77283601395326
8.7,"random_policy_SVM","SVM",65,21,1712,1705,7,2200,1808,392,0.951804067472651,0.657004830917874,1.80276497695853,749,363,386,15,1.1,56.24,4.6,0,0,0,0,0,0,0.0152034249448738,14.2737030564729,1.6709826401492
8.7,"random_policy_SVM","SVM",65,22,1612,1605,7,2300,1908,392,0.950801424140229,0.657004830917874,1.80276497695853,757,370,387,8,1,58.79,4.9,0,0,0,0,0,0,0.0124777430571029,11.0490605756429,1.39156528945286
8.7,"random_policy_SVM","SVM",65,23,1512,1505,7,2400,2008,392,0.950758611546146,0.657004830917874,1.80110497237569,759,370,389,2,1.1,61.35,5.1,0,0,0,0,0,0,0.0123423486743564,9.89997670224719,1.25227860679756
8.7,"random_policy_SVM","SVM",65,24,1412,1406,6,2500,2107,393,0.950434064461959,0.647342995169082,1.79614325068871,774,379,395,15,1,63.91,5.4,0,0,0,0,0,0,0.00847680132094851,6.22504837069961,0.99524549605234
8.7,"random_policy_SVM","SVM",65,25,1312,1307,5,2600,2206,394,0.950341534016682,0.642512077294686,1.79779411764706,777,379,398,3,1.1,66.46,5.6,0,0,0,0,0,0,0.00753386727234449,5.39660353450798,0.800757991722441
8.7,"random_policy_SVM","SVM",65,26,1212,1207,5,2700,2306,394,0.950138519457638,0.642512077294686,1.79285059578368,778,380,398,1,1,69.02,5.9,0,0,0,0,0,0,0.00663208238595589,4.24327518218343,0.682069791783293
8.7,"random_policy_SVM","SVM",65,27,1112,1109,3,2800,2404,396,0.950304245628284,0.642512077294686,1.79944802207912,791,386,405,13,1,71.57,6.1,0,0,0,0,0,0,0.00577144486988684,3.36354049244707,0.609936613211244
8.7,"random_policy_SVM","SVM",65,28,1012,1009,3,2900,2504,396,0.950202047823052,0.642512077294686,1.80276497695853,796,387,409,5,1.1,74.13,6.3,0,0,0,0,0,0,0.00523548487299902,2.65600547799312,0.54570579781999
8.7,"random_policy_SVM","SVM",65,29,912,909,3,3000,2604,396,0.95003355954956,0.642512077294686,1.79944802207912,798,387,411,2,1.1,76.69,6.6,0,0,0,0,0,0,0.00463177978838886,2.03380131995493,0.490226508663107
8.7,"random_policy_SVM","SVM",65,30,812,809,3,3100,2704,396,0.949978317492677,0.642512077294686,1.79944802207912,796,389,407,-2,1,79.24,6.8,0,0,0,0,0,0,0.00330319830703269,1.28062025246456,0.359826361264697
8.7,"random_policy_SVM","SVM",65,31,712,709,3,3200,2804,396,0.950059799526579,0.642512077294686,1.79449541284404,797,389,408,1,1,81.8,7.1,0,0,0,0,0,0,0.0025376544266911,0.880064384467576,0.289888449982292
8.7,"random_policy_SVM","SVM",65,32,612,609,3,3300,2904,396,0.950126089994838,0.642512077294686,1.79449541284404,798,389,409,1,1.1,84.36,7.3,0,0,0,0,0,0,0.00207358187829944,0.654375921651364,0.241131786889782
8.7,"random_policy_SVM","SVM",65,33,512,509,3,3400,3004,396,0.950170283640345,0.642512077294686,1.79120879120879,799,389,410,1,1.1,86.91,7.6,0,0,0,0,0,0,0.00118283435774036,0.374105811420759,0.155884228843174
8.7,"random_policy_SVM","SVM",65,34,412,412,0,3500,3101,399,0.95038158450792,0.647342995169082,1.79944802207912,812,394,418,13,1.1,89.47,7.8,0,0,0,0,0,0,0.00130588808357959,0.390086356013227,0.17538533761037
8.7,"random_policy_SVM","SVM",65,35,312,312,0,3600,3201,399,0.950646746380957,0.642512077294686,1.79779411764706,818,396,422,6,1.1,92.02,8,0,0,0,0,0,0,0.00106716912902576,0.282233386947453,0.137159933670745
8.7,"random_policy_SVM","SVM",65,36,212,212,0,3700,3301,399,0.950863571454223,0.63768115942029,1.80110497237569,817,397,420,-1,1.1,94.58,8.3,0,0,0,0,0,0,0.000331103833163497,0.0683222893913526,0.0424168962017031
8.7,"random_policy_SVM","SVM",65,37,112,112,0,3800,3401,399,0.95115497330428,0.632850241545894,1.79944802207912,815,398,417,-2,1,97.14,8.5,0,0,0,0,0,0,0.000127422940691947,0.0206659984393572,0.0193206061456741
8.7,"random_policy_SVM","SVM",65,38,12,12,0,3900,3501,399,0.951138400687215,0.63768115942029,1.79614325068871,816,399,417,1,1,99.69,8.8,0,0,0,0,0,0,0.00013717822451643,0.00184288555015858,0.00184288555015858
8.7,"random_policy_SVM","SVM",65,39,0,0,0,3912,3513,399,0.951157735407124,0.63768115942029,1.80276497695853,817,399,418,1,1,100,8.8,0,0,0,0,0,0,0,0,0
8.7,"random_policy_SVM","SVM",66,0,3812,3404,408,100,94,6,0.901080050075587,0.541666666666667,1.73703917050691,20,6,14,0,2.3,2.56,15.7,0,0,0,0,0,0,0.164782213421215,256.544012523125,18.5143926293423
8.7,"random_policy_SVM","SVM",66,1,3712,3363,349,200,135,65,0.916834963151926,0.588541666666667,1.77459677419355,99,49,50,79,1,5.11,2.1,0,0,0,0,0,0,0.758841299631156,319.484263450302,83.5293012055356
8.7,"random_policy_SVM","SVM",66,2,3612,3312,300,300,186,114,0.91604072184429,0.598958333333333,1.75581797235023,169,84,85,70,1,7.67,1.6,0,0,0,0,0,0,0.5,156.941801443603,71.3240603818629
8.7,"random_policy_SVM","SVM",66,3,3512,3268,244,400,230,170,0.908127834467107,0.59375,1.73065886134068,239,120,119,70,1,10.22,1.4,0,0,0,0,0,0,0.263502767000735,102.911886733806,51.0417187108651
8.7,"random_policy_SVM","SVM",66,4,3412,3229,183,500,269,231,0.886001275510205,0.625,1.69479549632353,310,156,154,71,1,12.78,1.2,0,0,0,0,0,0,0.150941605459714,68.5083554163805,28.1985830761471
8.7,"random_policy_SVM","SVM",66,5,3312,3168,144,600,330,270,0.895250200774762,0.640625,1.71352251838235,382,189,193,72,1,15.34,1.2,0,0,0,0,0,0,0.0797548707369321,41.4062761459022,13.2226853239385
8.7,"random_policy_SVM","SVM",66,6,3212,3098,114,700,400,300,0.898672229308381,0.651041666666667,1.67915515653775,454,222,232,72,1,17.89,1.3,0,0,0,0,0,0,0.0740103644262403,50.3088172090627,10.8120179039279
8.7,"random_policy_SVM","SVM",66,7,3112,3023,89,800,475,325,0.907927059712766,0.65625,1.68070276497696,502,245,257,48,1,20.45,1.5,0,0,0,0,0,0,0.0652137185417514,65.7816656002341,9.37812915540082
8.7,"random_policy_SVM","SVM",66,8,3012,2940,72,900,558,342,0.899645101095996,0.666666666666667,1.65253456221198,542,262,280,40,1.1,23.01,1.6,0,0,0,0,0,0,0.0580022693693035,82.367255378614,9.63873351035658
8.7,"random_policy_SVM","SVM",66,9,2912,2854,58,1000,644,356,0.90215330924037,0.6875,1.65734145220588,585,280,305,43,1.1,25.56,1.8,0,0,0,0,0,0,0.0594791859578529,80.7550659823836,6.62620604845425
8.7,"random_policy_SVM","SVM",66,10,2812,2760,52,1100,738,362,0.927331349206372,0.666666666666667,1.72130394857668,628,307,321,43,1,28.12,2,0,0,0,0,0,0,0.051097761185006,45.4198410800336,6.64068562416164
8.7,"random_policy_SVM","SVM",66,11,2712,2670,42,1200,828,372,0.933763522770234,0.65625,1.74482044198895,649,315,334,21,1.1,30.67,2.2,0,0,0,0,0,0,0.0436466995018098,47.9319594986755,5.50633752734496
8.7,"random_policy_SVM","SVM",66,12,2612,2578,34,1300,920,380,0.937089592781581,0.645833333333333,1.78398617511521,672,326,346,23,1.1,33.23,2.4,0,0,0,0,0,0,0.0568488203783025,55.4670358955927,6.59315937508497
8.7,"random_policy_SVM","SVM",66,13,2512,2481,31,1400,1017,383,0.937263794406673,0.645833333333333,1.78070377184913,689,334,355,17,1.1,35.79,2.7,0,0,0,0,0,0,0.0544232586599491,46.8741553610195,5.91785515560714
8.7,"random_policy_SVM","SVM",66,14,2412,2384,28,1500,1114,386,0.937424709467143,0.645833333333333,1.78234346224678,697,341,356,8,1,38.34,2.9,0,0,0,0,0,0,0.0456799968587738,34.4911745641551,4.97960863857564
8.7,"random_policy_SVM","SVM",66,15,2312,2289,23,1600,1209,391,0.937597434807279,0.645833333333333,1.78398617511521,717,348,369,20,1.1,40.9,3.1,0,0,0,0,0,0,0.0462793627387086,31.0933390227769,5.43273004063284
8.7,"random_policy_SVM","SVM",66,16,2212,2194,18,1700,1304,396,0.938190901360566,0.640625,1.78398617511521,731,353,378,14,1.1,43.46,3.3,0,0,0,0,0,0,0.035282935195813,24.3576783166989,4.57185099179448
8.7,"random_policy_SVM","SVM",66,17,2112,2097,15,1800,1401,399,0.938211569349988,0.640625,1.77459677419355,736,357,379,5,1.1,46.01,3.5,0,0,0,0,0,0,0.027577280017366,21.5369250262172,3.27006103323952
8.7,"random_policy_SVM","SVM",66,18,2012,1999,13,1900,1499,401,0.938078703703727,0.645833333333333,1.77459677419355,739,357,382,3,1.1,48.57,3.7,0,0,0,0,0,0,0.0220821573474705,19.7101719992673,2.54560159300371
8.7,"random_policy_SVM","SVM",66,19,1912,1899,13,2000,1599,401,0.93792517006805,0.645833333333333,1.77459677419355,740,359,381,1,1.1,51.12,4,0,0,0,0,0,0,0.0167427990100677,15.2570932414629,1.85626891780386
8.7,"random_policy_SVM","SVM",66,20,1812,1800,12,2100,1698,402,0.937880881519296,0.640625,1.77459677419355,747,360,387,7,1.1,53.68,4.2,0,0,0,0,0,0,0.0144624024793538,13.3664665371085,1.55649025254638
8.7,"random_policy_SVM","SVM",66,21,1712,1702,10,2200,1796,404,0.938232237339401,0.640625,1.77459677419355,751,364,387,4,1.1,56.24,4.4,0,0,0,0,0,0,0.0133301313026234,11.3219008635242,1.36315422930636
8.7,"random_policy_SVM","SVM",66,22,1612,1603,9,2300,1895,405,0.937207695578253,0.645833333333333,1.78398617511521,771,375,396,20,1.1,58.79,4.7,0,0,0,0,0,0,0.009989694583558,6.86001722794533,1.24084933940034
8.7,"random_policy_SVM","SVM",66,23,1512,1504,8,2400,1994,406,0.937340561224511,0.645833333333333,1.78398617511521,772,376,396,1,1.1,61.35,4.9,0,0,0,0,0,0,0.00723021574373978,5.55381992030511,0.8240260982639
8.7,"random_policy_SVM","SVM",66,24,1412,1405,7,2500,2093,407,0.937340561224512,0.645833333333333,1.78234346224678,778,379,399,6,1.1,63.91,5.1,0,0,0,0,0,0,0.00756225148331893,5.10134787715501,0.776804132419536
8.7,"random_policy_SVM","SVM",66,25,1312,1305,7,2600,2193,407,0.936962632275153,0.640625,1.78070377184913,786,384,402,8,1,66.46,5.4,0,0,0,0,0,0,0.00537353056038096,3.51345725483851,0.627754930363454
8.7,"random_policy_SVM","SVM",66,26,1212,1207,5,2700,2291,409,0.937234268707503,0.640625,1.78234346224678,796,387,409,10,1.1,69.02,5.6,0,0,0,0,0,0,0.00597224605883753,3.45013399531183,0.621150693878876
8.7,"random_policy_SVM","SVM",66,27,1112,1107,5,2800,2391,409,0.937316940665175,0.645833333333333,1.78234346224678,805,393,412,9,1,71.57,5.8,0,0,0,0,0,0,0.00483427206601608,2.55875606732647,0.529340518749584
8.7,"random_policy_SVM","SVM",66,28,1012,1008,4,2900,2490,410,0.937331703514759,0.640625,1.78398617511521,809,393,416,4,1.1,74.13,6.1,0,0,0,0,0,0,0.00454032897860243,2.15749755780272,0.482713090949557
8.7,"random_policy_SVM","SVM",66,29,912,909,3,3000,2589,411,0.937358276644012,0.645833333333333,1.77417506874427,816,396,420,7,1.1,76.69,6.3,0,0,0,0,0,0,0.00382223069600495,1.61344015735087,0.413860278824304
8.7,"random_policy_SVM","SVM",66,30,812,809,3,3100,2689,411,0.937384849773263,0.645833333333333,1.77417506874427,815,396,419,-1,1.1,79.24,6.5,0,0,0,0,0,0,0.003082060216937,1.15587423711015,0.34057236383889
8.7,"random_policy_SVM","SVM",66,31,712,710,2,3200,2788,412,0.937523620559356,0.645833333333333,1.7774334251607,821,398,423,6,1.1,81.8,6.8,0,0,0,0,0,0,0.0025961387759274,0.922266854849607,0.294396849201113
8.7,"random_policy_SVM","SVM",66,32,612,611,1,3300,2887,413,0.937501476284979,0.645833333333333,1.77906709558824,825,402,423,4,1.1,84.36,7,0,0,0,0,0,0,0.00209868472776464,0.689791307296641,0.242896800263299
8.7,"random_policy_SVM","SVM",66,33,512,511,1,3400,2987,413,0.937451282596392,0.645833333333333,1.77906709558824,823,402,421,-2,1,86.91,7.2,0,0,0,0,0,0,0.00137470015265383,0.431279703756212,0.165755449237253
8.7,"random_policy_SVM","SVM",66,34,412,411,1,3500,3087,413,0.937401088907806,0.645833333333333,1.78234346224678,822,401,421,-1,1,89.47,7.5,0,0,0,0,0,0,0.000784481162616921,0.229074772181556,0.0987632648071112
8.7,"random_policy_SVM","SVM",66,35,312,312,0,3600,3186,414,0.937758349867745,0.645833333333333,1.77906709558824,828,405,423,6,1,92.02,7.7,0,0,0,0,0,0,0.000783082233861802,0.197677539443584,0.0986253799117452
8.7,"random_policy_SVM","SVM",66,36,212,212,0,3700,3286,414,0.937895644368878,0.645833333333333,1.7774334251607,834,407,427,6,1,94.58,7.9,0,0,0,0,0,0,0.000347221228168392,0.0747531034545006,0.0475436504988184
8.7,"random_policy_SVM","SVM",66,37,112,112,0,3800,3386,414,0.93808165627364,0.645833333333333,1.78398617511521,837,409,428,3,1,97.14,8.2,0,0,0,0,0,0,0.000123539494384713,0.0195923709699558,0.0182747789307405
8.7,"random_policy_SVM","SVM",66,38,12,12,0,3900,3486,414,0.938424154383994,0.645833333333333,1.78398617511521,837,410,427,0,1,99.69,8.4,0,0,0,0,0,0,9.45406623867318e-05,0.00131400384262906,0.00131400384262906
8.7,"random_policy_SVM","SVM",66,39,0,0,0,3912,3498,414,0.938409391534409,0.645833333333333,1.78398617511521,837,410,427,0,1,100,8.4,0,0,0,0,0,0,0,0,0
8.7,"random_policy_SVM","SVM",67,0,3812,3414,398,100,87,13,0.856905313123366,0.420512820512821,1.68258064516129,42,13,29,0,2.2,2.56,6.7,0,0,0,0,0,0,0.167666471854909,507.1664596909,18.1653596490019
8.7,"random_policy_SVM","SVM",67,1,3712,3352,360,200,149,51,0.909212423011404,0.528205128205128,1.75768525052929,108,49,59,66,1.2,5.11,2.9,0,0,0,0,0,0,0.804766582791965,510.066508386589,85.0540807423026
8.7,"random_policy_SVM","SVM",67,2,3612,3301,311,300,200,100,0.927494576216876,0.635897435897436,1.7636517328825,178,84,94,70,1.1,7.67,2,0,0,0,0,0,0,0.683018381916151,356.904671778721,77.6026155272394
8.7,"random_policy_SVM","SVM",67,3,3512,3260,252,400,241,159,0.916812999606869,0.646153846153846,1.73768596206726,249,123,126,71,1,10.22,1.5,0,0,0,0,0,0,0.519751402177918,291.880561648373,71.2452496852809
8.7,"random_policy_SVM","SVM",67,4,3412,3226,186,500,275,225,0.915866567655322,0.641025641025641,1.72087508821454,320,158,162,71,1,12.78,1.2,0,0,0,0,0,0,0.36023246869106,219.110027851956,55.6226017735767
8.7,"random_policy_SVM","SVM",67,5,3312,3170,142,600,331,269,0.890231366210938,0.641025641025641,1.65028280542986,389,193,196,69,1,15.34,1.2,0,0,0,0,0,0,0.222470407797671,169.565677094988,35.9573207572496
8.7,"random_policy_SVM","SVM",67,6,3212,3101,111,700,400,300,0.90295286768881,0.671794871794872,1.65332200028333,464,225,239,75,1.1,17.89,1.3,0,0,0,0,0,0,0.0969241633276862,127.454026651609,15.1570840032892
8.7,"random_policy_SVM","SVM",67,7,3112,3025,87,800,476,324,0.906108126210331,0.682051282051282,1.6625584360391,524,252,272,60,1.1,20.45,1.5,0,0,0,0,0,0,0.0894484499612681,124.942408922686,12.0476322551065
8.7,"random_policy_SVM","SVM",67,8,3012,2939,73,900,562,338,0.916996461800536,0.671794871794872,1.69950417906219,560,269,291,36,1.1,23.01,1.7,0,0,0,0,0,0,0.0754494217129254,99.4255611218162,9.12315661312955
8.7,"random_policy_SVM","SVM",67,9,2912,2855,57,1000,646,354,0.925485228381273,0.656410256410256,1.71956043956044,597,286,311,37,1.1,25.56,1.8,0,0,0,0,0,0,0.0889328832164728,118.370001203339,10.1770701107491
8.7,"random_policy_SVM","SVM",67,10,2812,2758,54,1100,743,357,0.929509748249082,0.656410256410256,1.73805033676001,615,296,319,18,1.1,28.12,2.1,0,0,0,0,0,0,0.074087907168149,91.5502767731928,8.13412887899262
8.7,"random_policy_SVM","SVM",67,11,2712,2666,46,1200,835,365,0.934978668879848,0.656410256410256,1.74408039063053,641,307,334,26,1.1,30.67,2.3,0,0,0,0,0,0,0.0730402766079227,85.3000382497422,8.13777780766203
8.7,"random_policy_SVM","SVM",67,12,2612,2574,38,1300,927,373,0.938257691579658,0.661538461538462,1.75929928657201,661,316,345,20,1.1,33.23,2.5,0,0,0,0,0,0,0.0645242781494303,67.5626539650465,7.22496446664935
8.7,"random_policy_SVM","SVM",67,13,2512,2485,27,1400,1016,384,0.939070167008834,0.666666666666667,1.76253626778006,689,326,363,28,1.1,35.79,2.6,0,0,0,0,0,0,0.0677009409384064,69.0320585173251,7.6506586869862
8.7,"random_policy_SVM","SVM",67,14,2412,2388,24,1500,1113,387,0.939387585724892,0.661538461538462,1.76253626778006,695,330,365,6,1.1,38.34,2.9,0,0,0,0,0,0,0.0612164721020151,64.6349888789803,6.63389906512474
8.7,"random_policy_SVM","SVM",67,15,2312,2294,18,1600,1207,393,0.939739949620694,0.641025641025641,1.75654023395959,706,338,368,11,1.1,40.9,3.1,0,0,0,0,0,0,0.0499619446566259,54.5367434990329,5.73818491492698
8.7,"random_policy_SVM","SVM",67,16,2212,2198,14,1700,1303,397,0.940186956711655,0.646153846153846,1.75492279359683,718,344,374,12,1.1,43.46,3.3,0,0,0,0,0,0,0.0436047537748148,49.9996174188953,4.75727666834489
8.7,"random_policy_SVM","SVM",67,17,2112,2100,12,1800,1401,399,0.939638026179765,0.651282051282051,1.75654023395959,728,348,380,10,1.1,46.01,3.5,0,0,0,0,0,0,0.036161960721504,39.9310200146721,3.86583129100377
8.7,"random_policy_SVM","SVM",67,18,2012,2002,10,1900,1499,401,0.93910365613943,0.646153846153846,1.75492279359683,736,351,385,8,1.1,48.57,3.7,0,0,0,0,0,0,0.0306913974616248,33.6609462508038,3.31778553086665
8.7,"random_policy_SVM","SVM",67,19,1912,1902,10,2000,1599,401,0.938736731752063,0.641025641025641,1.75169683257919,737,352,385,1,1.1,51.12,4,0,0,0,0,0,0,0.0248773764093752,26.32529677765,2.63998454267271
8.7,"random_policy_SVM","SVM",67,20,1812,1802,10,2100,1699,401,0.939169178351457,0.646153846153846,1.77503013115916,737,354,383,0,1.1,53.68,4.2,0,0,0,0,0,0,0.0196572014463854,18.8220880787847,2.02941607663144
8.7,"random_policy_SVM","SVM",67,21,1712,1703,9,2200,1798,402,0.938036372107915,0.666666666666667,1.77176420635482,751,365,386,14,1.1,56.24,4.5,0,0,0,0,0,0,0.0159250822542023,12.3245411629722,2.05403906495048
8.7,"random_policy_SVM","SVM",67,22,1612,1605,7,2300,1896,404,0.938100438270785,0.666666666666667,1.77176420635482,762,369,393,11,1.1,58.79,4.7,0,0,0,0,0,0,0.0115960303616877,10.1790286327308,1.34627199548466
8.7,"random_policy_SVM","SVM",67,23,1512,1505,7,2400,1996,404,0.937983954338288,0.661538461538462,1.77176420635482,762,371,391,0,1.1,61.35,4.9,0,0,0,0,0,0,0.0101360898622882,8.47221812541954,1.04473469340963
8.7,"random_policy_SVM","SVM",67,24,1412,1406,6,2500,2095,405,0.939110936385213,0.666666666666667,1.7636517328825,773,377,396,11,1.1,63.91,5.2,0,0,0,0,0,0,0.00783528451190211,6.03386559607947,0.905395428368319
8.7,"random_policy_SVM","SVM",67,25,1312,1307,5,2600,2194,406,0.938634808311126,0.666666666666667,1.77013574660633,778,378,400,5,1.1,66.46,5.4,0,0,0,0,0,0,0.00724024874463057,5.21123692936099,0.754190623826212
8.7,"random_policy_SVM","SVM",67,26,1212,1207,5,2700,2294,406,0.939137145270025,0.671794871794872,1.77176420635482,791,383,408,13,1.1,69.02,5.7,0,0,0,0,0,0,0.00584288467950944,3.74890886895871,0.651776182926494
8.7,"random_policy_SVM","SVM",67,27,1112,1108,4,2800,2393,407,0.939027941583308,0.671794871794872,1.77013574660633,793,383,410,2,1.1,71.57,5.9,0,0,0,0,0,0,0.00544705838819094,3.2474793798962,0.560996374771301
8.7,"random_policy_SVM","SVM",67,28,1012,1009,3,2900,2492,408,0.939307503021291,0.676923076923077,1.77013574660633,800,389,411,7,1.1,74.13,6.1,0,0,0,0,0,0,0.00508836511013818,2.77938918269746,0.541533722052959
8.7,"random_policy_SVM","SVM",67,29,912,909,3,3000,2592,408,0.939263821546603,0.671794871794872,1.76688779110797,802,389,413,2,1.1,76.69,6.4,0,0,0,0,0,0,0.00374126159534845,1.73032238048457,0.389337642978687
8.7,"random_policy_SVM","SVM",67,30,812,809,3,3100,2692,408,0.939204123531197,0.671794871794872,1.76851027760119,801,390,411,-1,1.1,79.24,6.6,0,0,0,0,0,0,0.00343976541569291,1.3439014747356,0.365256611275735
8.7,"random_policy_SVM","SVM",67,31,712,709,3,3200,2792,408,0.939122584778447,0.671794871794872,1.77176420635482,804,391,413,3,1.1,81.8,6.8,0,0,0,0,0,0,0.00278640072104428,0.922398145527311,0.304843298419747
8.7,"random_policy_SVM","SVM",67,32,612,609,3,3300,2892,408,0.939303134873817,0.671794871794872,1.76851027760119,804,391,413,0,1.1,84.36,7.1,0,0,0,0,0,0,0.00192781423172065,0.582572341898839,0.233942626900149
8.7,"random_policy_SVM","SVM",67,33,512,509,3,3400,2992,408,0.939233244514318,0.666666666666667,1.77013574660633,806,392,414,2,1.1,86.91,7.3,0,0,0,0,0,0,0.00105743014033777,0.314953790706321,0.138551043028157
8.7,"random_policy_SVM","SVM",67,34,412,412,0,3500,3089,411,0.938767308784328,0.661538461538462,1.77503013115916,818,398,420,12,1.1,89.47,7.5,0,0,0,0,0,0,0.00125449688854507,0.384207074262255,0.16249143751599
8.7,"random_policy_SVM","SVM",67,35,312,312,0,3600,3189,411,0.938614423622925,0.656410256410256,1.77339566510837,823,399,424,5,1.1,92.02,7.8,0,0,0,0,0,0,0.000872027857049493,0.225810512870626,0.107336438410235
8.7,"random_policy_SVM","SVM",67,36,212,212,0,3700,3289,411,0.938615879672084,0.656410256410256,1.76851027760119,822,401,421,-1,1,94.58,8,0,0,0,0,0,0,0.000427718348198958,0.089568764950182,0.0553856529409732
8.7,"random_policy_SVM","SVM",67,37,112,112,0,3800,3389,411,0.939081815402083,0.656410256410256,1.757215047726,824,403,421,2,1,97.14,8.2,0,0,0,0,0,0,0.000162632742671296,0.026468582431546,0.0248330834468876
8.7,"random_policy_SVM","SVM",67,38,12,12,0,3900,3489,411,0.939145881564958,0.651282051282051,1.7636517328825,827,404,423,3,1,99.69,8.5,0,0,0,0,0,0,9.27862375862544e-05,0.00155887785093822,0.00155887785093822
8.7,"random_policy_SVM","SVM",67,39,0,0,0,3912,3501,411,0.939073079107147,0.651282051282051,1.77176420635482,828,404,424,1,1,100,8.5,0,0,0,0,0,0,0,0,0
8.7,"random_policy_SVM","SVM",68,0,3812,3398,414,100,89,11,0.897159754104749,0.50828729281768,1.76475239495159,27,11,16,0,1.5,2.56,8.1,0,0,0,0,0,0,0.810355503878333,571.005451453336,84.5173941895423
8.7,"random_policy_SVM","SVM",68,1,3712,3352,360,200,135,65,0.89117422768657,0.546961325966851,1.696908816949,106,53,53,79,1,5.11,2.1,0,0,0,0,0,0,0.699046610285401,338.815757245666,76.5444494707425
8.7,"random_policy_SVM","SVM",68,2,3612,3312,300,300,175,125,0.856708427359752,0.580110497237569,1.59767438320929,173,88,85,67,1,7.67,1.4,0,0,0,0,0,0,0.665181950561119,323.760393960203,77.1262561991446
8.7,"random_policy_SVM","SVM",68,3,3512,3270,242,400,217,183,0.859936191736057,0.613259668508287,1.64340453700639,251,125,126,78,1,10.22,1.2,0,0,0,0,0,0,0.494099764164097,321.927825852756,66.3161185389101
8.7,"random_policy_SVM","SVM",68,4,3412,3235,177,500,252,248,0.876132596685081,0.624309392265193,1.63887309067273,325,164,161,74,1,12.78,1,0,0,0,0,0,0,0.337495051305651,228.401913089737,49.9151613231827
8.7,"random_policy_SVM","SVM",68,5,3312,3183,129,600,304,296,0.880295696832929,0.596685082872928,1.63887309067273,404,202,202,79,1,15.34,1,0,0,0,0,0,0,0.230832393377147,191.505267454196,33.430590749372
8.7,"random_policy_SVM","SVM",68,6,3212,3109,103,700,378,322,0.868659248307539,0.624309392265193,1.61203870455725,471,229,242,67,1.1,17.89,1.2,0,0,0,0,0,0,0.119916016792715,118.233165586773,17.2247653657891
8.7,"random_policy_SVM","SVM",68,7,3112,3025,87,800,462,338,0.86152828573653,0.613259668508287,1.58218613595434,512,247,265,41,1.1,20.45,1.4,0,0,0,0,0,0,0.0854131548213639,123.231733450684,11.997885267968
8.7,"random_policy_SVM","SVM",68,8,3012,2946,66,900,541,359,0.862840245895267,0.61878453038674,1.56790405308738,559,268,291,47,1.1,23.01,1.5,0,0,0,0,0,0,0.0837046963131197,136.715041584949,9.93482637938201
8.7,"random_policy_SVM","SVM",68,9,2912,2854,58,1000,633,367,0.868639016418968,0.613259668508287,1.60061398649026,582,280,302,23,1.1,25.56,1.7,0,0,0,0,0,0,0.066139955762172,97.3428597846489,7.22885319910098
8.7,"random_policy_SVM","SVM",68,10,2812,2756,56,1100,731,369,0.880535366897518,0.602209944751381,1.62446131330676,592,286,306,10,1.1,28.12,2,0,0,0,0,0,0,0.0482267860041092,63.5624665849326,5.50671437710794
8.7,"random_policy_SVM","SVM",68,11,2712,2665,47,1200,822,378,0.892503307135638,0.624309392265193,1.63586598408434,615,294,321,23,1.1,30.67,2.2,0,0,0,0,0,0,0.0478483228144726,71.3414651694794,5.21035686764164
8.7,"random_policy_SVM","SVM",68,12,2612,2573,39,1300,914,386,0.900284802739096,0.61878453038674,1.64729160007914,634,308,326,19,1.1,33.23,2.4,0,0,0,0,0,0,0.0471487766780807,71.4902101479862,4.98717203053597
8.7,"random_policy_SVM","SVM",68,13,2512,2474,38,1400,1013,387,0.912017741809987,0.602209944751381,1.6922469795398,647,318,329,13,1,35.79,2.6,0,0,0,0,0,0,0.0324858965568417,39.4429047868081,3.93814983727177
8.7,"random_policy_SVM","SVM",68,14,2412,2377,35,1500,1110,390,0.914054937358975,0.607734806629834,1.69069872063811,658,322,336,11,1,38.34,2.8,0,0,0,0,0,0,0.0281850687648577,37.6452230642379,3.04960486938874
8.7,"random_policy_SVM","SVM",68,15,2312,2282,30,1600,1205,395,0.91946774570074,0.607734806629834,1.72826616834579,673,329,344,15,1,40.9,3.1,0,0,0,0,0,0,0.039613321842391,42.811524273026,4.78451394136738
8.7,"random_policy_SVM","SVM",68,16,2212,2189,23,1700,1298,402,0.923711773402863,0.602209944751381,1.74492371635663,705,343,362,32,1.1,43.46,3.2,0,0,0,0,0,0,0.0482413858284215,38.8081624445034,5.5181482892838
8.7,"random_policy_SVM","SVM",68,17,2112,2090,22,1800,1397,403,0.924432339895741,0.596685082872928,1.74813129671758,707,346,361,2,1,46.01,3.5,0,0,0,0,0,0,0.0370267404040784,30.0750281230241,4.20866025220541
8.7,"random_policy_SVM","SVM",68,18,2012,1994,18,1900,1493,407,0.925795657925466,0.596685082872928,1.76313484005246,721,350,371,14,1.1,48.57,3.7,0,0,0,0,0,0,0.0350104264323281,27.4570535179022,4.18438711224828
8.7,"random_policy_SVM","SVM",68,19,1912,1904,8,2000,1583,417,0.925624465022194,0.591160220994475,1.76962291674079,750,363,387,29,1.1,51.12,3.8,0,0,0,0,0,0,0.0325052835469925,27.3387035023041,4.5291781128476
8.7,"random_policy_SVM","SVM",68,20,1812,1804,8,2100,1683,417,0.925464166212763,0.602209944751381,1.76799642508937,749,363,386,-1,1.1,53.68,4,0,0,0,0,0,0,0.0204086079926249,19.8316145279571,2.36273340985971
8.7,"random_policy_SVM","SVM",68,21,1712,1704,8,2200,1783,417,0.925303867403332,0.596685082872928,1.76799642508937,753,365,388,4,1.1,56.24,4.3,0,0,0,0,0,0,0.0176161542903833,15.349536650296,1.78152564249702
8.7,"random_policy_SVM","SVM",68,22,1612,1604,8,2300,1883,417,0.92649910512802,0.596685082872928,1.77956461852023,773,377,396,20,1.1,58.79,4.5,0,0,0,0,0,0,0.0127241834774119,8.69194364358368,1.60851789496727
8.7,"random_policy_SVM","SVM",68,23,1512,1506,6,2400,1981,419,0.926436853163192,0.596685082872928,1.77629636394076,778,379,399,5,1.1,61.35,4.7,0,0,0,0,0,0,0.010829678697202,8.3160428843765,1.2504963078315
8.7,"random_policy_SVM","SVM",68,24,1412,1407,5,2500,2080,420,0.927232122013868,0.607734806629834,1.77792898927527,780,380,400,2,1.1,63.91,5,0,0,0,0,0,0,0.00913002034123312,6.50315564739767,0.943762405460972
8.7,"random_policy_SVM","SVM",68,25,1312,1307,5,2600,2180,420,0.927576064119539,0.607734806629834,1.77792898927527,791,389,402,11,1,66.46,5.2,0,0,0,0,0,0,0.0074053600630332,5.07368830394006,0.860772984086598
8.7,"random_policy_SVM","SVM",68,26,1212,1208,4,2700,2279,421,0.927495136565264,0.607734806629834,1.78120325997375,792,389,403,1,1,69.02,5.4,0,0,0,0,0,0,0.00692888743817209,4.33455038626071,0.717772727728087
8.7,"random_policy_SVM","SVM",68,27,1112,1108,4,2800,2379,421,0.927488911368782,0.607734806629834,1.78284492196451,795,391,404,3,1,71.57,5.7,0,0,0,0,0,0,0.0054550931998251,3.11158625647647,0.574495825499342
8.7,"random_policy_SVM","SVM",68,28,1012,1009,3,2900,2478,422,0.927831297175332,0.607734806629834,1.78120325997375,807,393,414,12,1.1,74.13,5.9,0,0,0,0,0,0,0.00515274013915596,2.63085503647984,0.550097554755781
8.7,"random_policy_SVM","SVM",68,29,912,910,2,3000,2577,423,0.92742199050659,0.613259668508287,1.77792898927527,809,396,413,2,1,76.69,6.1,0,0,0,0,0,0,0.0042866639912555,2.00358967119533,0.46246137164143
8.7,"random_policy_SVM","SVM",68,30,812,811,1,3100,2676,424,0.927190101937607,0.613259668508287,1.77956461852023,812,399,413,3,1,79.24,6.3,0,0,0,0,0,0,0.00382854673065691,1.64023541586323,0.413723917024339
8.7,"random_policy_SVM","SVM",68,31,712,711,1,3200,2776,424,0.927204108629694,0.613259668508287,1.78120325997375,814,399,415,2,1,81.8,6.5,0,0,0,0,0,0,0.00302241721291594,1.14523554055484,0.33008167766488
8.7,"random_policy_SVM","SVM",68,32,612,611,1,3300,2876,424,0.927124737374539,0.613259668508287,1.77629636394076,813,399,414,-1,1,84.36,6.8,0,0,0,0,0,0,0.00242915073286338,0.82464702629972,0.27099920246584
8.7,"random_policy_SVM","SVM",68,33,512,511,1,3400,2976,424,0.927275698389246,0.613259668508287,1.78120325997375,813,399,414,0,1,86.91,7,0,0,0,0,0,0,0.00165669701055571,0.501441048481325,0.192873643484701
8.7,"random_policy_SVM","SVM",68,34,412,412,0,3500,3075,425,0.927527818846797,0.607734806629834,1.77792898927527,818,399,419,5,1.1,89.47,7.2,0,0,0,0,0,0,0.00132774502935141,0.40029921269889,0.164969213181893
8.7,"random_policy_SVM","SVM",68,35,312,312,0,3600,3175,425,0.927795502295555,0.607734806629834,1.77466673424908,822,401,421,4,1,92.02,7.5,0,0,0,0,0,0,0.000905740210802559,0.226626797539481,0.107513379254845
8.7,"random_policy_SVM","SVM",68,36,212,212,0,3700,3275,425,0.927932456618175,0.607734806629834,1.78120325997375,821,401,420,-1,1,94.58,7.7,0,0,0,0,0,0,0.000532476254882289,0.114878644003711,0.0706114603201905
8.7,"random_policy_SVM","SVM",68,37,112,112,0,3800,3375,425,0.927865535755985,0.607734806629834,1.77956461852023,824,402,422,3,1,97.14,7.9,0,0,0,0,0,0,0.000275313401760824,0.0415987756423114,0.0386711205754986
8.7,"random_policy_SVM","SVM",68,38,12,12,0,3900,3475,425,0.928004046377727,0.607734806629834,1.77792898927527,825,403,422,1,1,99.69,8.2,0,0,0,0,0,0,0.000207878474398337,0.00307294058519602,0.00307294058519602
8.7,"random_policy_SVM","SVM",68,39,0,0,0,3912,3487,425,0.928112987316175,0.607734806629834,1.77466673424908,825,403,422,0,1,100,8.2,0,0,0,0,0,0,0,0,0
8.7,"random_policy_SVM","SVM",69,0,3812,3412,400,100,89,11,0.863192533379924,0.502564102564103,1.64560085076214,31,11,20,0,1.8,2.56,8.1,0,0,0,0,0,0,0.220414870647783,355.376130539197,25.1059949756755
8.7,"random_policy_SVM","SVM",69,1,3712,3373,339,200,128,72,0.922232414566312,0.620512820512821,1.74368358082905,104,49,55,73,1.1,5.11,1.8,0,0,0,0,0,0,0.705536705602855,374.714203903544,79.067578361719
8.7,"random_policy_SVM","SVM",69,2,3612,3334,278,300,167,133,0.927251416007804,0.625641025641026,1.78857466063348,185,92,93,81,1,7.67,1.3,0,0,0,0,0,0,0.633776294141385,290.737307913784,75.5353967586682
8.7,"random_policy_SVM","SVM",69,3,3512,3295,217,400,206,194,0.926173939632195,0.625641025641026,1.79186853661992,258,131,127,73,1,10.22,1.1,0,0,0,0,0,0,0.45001816939102,187.997755994369,67.3924410160083
8.7,"random_policy_SVM","SVM",69,4,3412,3244,168,500,257,243,0.867470405800913,0.625641025641026,1.61786600496278,335,167,168,77,1,12.78,1.1,0,0,0,0,0,0,0.278383390375645,150.734938249837,44.6531168074098
8.7,"random_policy_SVM","SVM",69,5,3312,3192,120,600,309,291,0.872199653460293,0.651282051282051,1.58866694999292,423,212,211,88,1,15.34,1.1,0,0,0,0,0,0,0.191269758818991,130.03819160174,31.4426392144518
8.7,"random_policy_SVM","SVM",69,6,3212,3115,97,700,386,314,0.874717162451397,0.661538461538462,1.59790338574869,480,234,246,57,1.1,17.89,1.2,0,0,0,0,0,0,0.100771721067067,104.60043817779,15.8766237734128
8.7,"random_policy_SVM","SVM",69,7,3112,3038,74,800,463,337,0.879721603401336,0.676923076923077,1.60566131200906,537,255,282,57,1.1,20.45,1.4,0,0,0,0,0,0,0.0727613270279861,88.8934552891322,9.09248240677682
8.7,"random_policy_SVM","SVM",69,8,3012,2952,60,900,549,351,0.887408086897022,0.671794871794872,1.61340497737557,574,271,303,37,1.1,23.01,1.6,0,0,0,0,0,0,0.060096907029529,88.0103127636291,6.9935937567794
8.7,"random_policy_SVM","SVM",69,9,2912,2857,55,1000,644,356,0.890834170561609,0.676923076923077,1.61637625726024,594,283,311,20,1.1,25.56,1.8,0,0,0,0,0,0,0.0575894514918079,80.1799842197775,5.89350950987833
8.7,"random_policy_SVM","SVM",69,10,2812,2761,51,1100,740,360,0.920946723161353,0.646153846153846,1.69326746647848,628,308,320,34,1,28.12,2.1,0,0,0,0,0,0,0.0514581444592063,40.999986362091,6.63532188025152
8.7,"random_policy_SVM","SVM",69,11,2712,2670,42,1200,831,369,0.929617495886637,0.646153846153846,1.71324433142615,650,319,331,22,1,30.67,2.3,0,0,0,0,0,0,0.0380784169947415,37.6770515161523,4.59612963925142
8.7,"random_policy_SVM","SVM",69,12,2612,2578,34,1300,923,377,0.939250717104207,0.646153846153846,1.77013574660633,671,328,343,21,1,33.23,2.4,0,0,0,0,0,0,0.0474746431260454,48.9944930969851,5.89672730390504
8.7,"random_policy_SVM","SVM",69,13,2512,2483,29,1400,1018,382,0.94447793357504,0.646153846153846,1.79944802207912,693,337,356,22,1.1,35.79,2.7,0,0,0,0,0,0,0.0547574348820104,45.9999772530199,6.2148941439445
8.7,"random_policy_SVM","SVM",69,14,2412,2385,27,1500,1116,384,0.94447065332926,0.651282051282051,1.79779411764706,704,342,362,11,1.1,38.34,2.9,0,0,0,0,0,0,0.0458797182076104,38.161161184714,5.03931342172588
8.7,"random_policy_SVM","SVM",69,15,2312,2288,24,1600,1213,387,0.944798264389407,0.646153846153846,1.79944802207912,711,346,365,7,1.1,40.9,3.1,0,0,0,0,0,0,0.0413200461156672,30.2669077409065,4.58348248909666
8.7,"random_policy_SVM","SVM",69,16,2212,2192,20,1700,1309,391,0.944764775258816,0.646153846153846,1.79779411764706,727,351,376,16,1.1,43.46,3.3,0,0,0,0,0,0,0.0372538661768545,25.3704385711891,4.58557346718898
8.7,"random_policy_SVM","SVM",69,17,2112,2096,16,1800,1405,395,0.945018127811998,0.641025641025641,1.79779411764706,729,355,374,2,1.1,46.01,3.6,0,0,0,0,0,0,0.0260626800774386,21.1588149069556,3.38909697476786
8.7,"random_policy_SVM","SVM",69,18,2012,2000,12,1900,1501,399,0.94481136883181,0.641025641025641,1.78857466063348,742,359,383,13,1.1,48.57,3.8,0,0,0,0,0,0,0.0219008363596655,19.4365451597478,2.73525347422761
8.7,"random_policy_SVM","SVM",69,19,1912,1900,12,2000,1601,399,0.944808456733497,0.641025641025641,1.79186853661992,740,359,381,-2,1.1,51.12,4,0,0,0,0,0,0,0.0174567110753063,16.1522462617061,1.91016671873116
8.7,"random_policy_SVM","SVM",69,20,1812,1801,11,2100,1700,400,0.944907468076122,0.641025641025641,1.78857466063348,743,361,382,3,1.1,53.68,4.2,0,0,0,0,0,0,0.0139706624099297,12.9321403722536,1.49776406086699
8.7,"random_policy_SVM","SVM",69,21,1712,1701,11,2200,1800,400,0.944929308813466,0.641025641025641,1.79022008350435,744,361,383,1,1.1,56.24,4.5,0,0,0,0,0,0,0.0130013516502277,11.0984804675519,1.31987217100495
8.7,"random_policy_SVM","SVM",69,22,1612,1601,11,2300,1900,400,0.943631969015276,0.646153846153846,1.80110497237569,755,369,386,11,1,58.79,4.8,0,0,0,0,0,0,0.00979707692138096,7.32803601496199,1.15948788524767
8.7,"random_policy_SVM","SVM",69,23,1512,1504,8,2400,1997,403,0.943516941131935,0.641025641025641,1.80276497695853,763,373,390,8,1,61.35,5,0,0,0,0,0,0,0.00920755211875524,6.90067110285311,0.97691613782707
8.7,"random_policy_SVM","SVM",69,24,1412,1404,8,2500,2097,403,0.942975290845821,0.641025641025641,1.80110497237569,770,377,393,7,1,63.91,5.2,0,0,0,0,0,0,0.00832527237903381,5.89830727482805,0.913507057266847
8.7,"random_policy_SVM","SVM",69,25,1312,1304,8,2600,2197,403,0.943138368351317,0.641025641025641,1.79944802207912,770,377,393,0,1,66.46,5.5,0,0,0,0,0,0,0.00633057473213919,4.03413573295468,0.656083435758369
8.7,"random_policy_SVM","SVM",69,26,1212,1204,8,2700,2297,403,0.942963642452571,0.635897435897436,1.80276497695853,776,380,396,6,1,69.02,5.7,0,0,0,0,0,0,0.00568019168687559,3.35948010514555,0.61441649169879
8.7,"random_policy_SVM","SVM",69,27,1112,1104,8,2800,2397,403,0.943000043681477,0.635897435897436,1.80110497237569,776,380,396,0,1,71.57,5.9,0,0,0,0,0,0,0.00487688720119762,2.49360836225114,0.504282186567353
8.7,"random_policy_SVM","SVM",69,28,1012,1004,8,2900,2497,403,0.942892296043915,0.630769230769231,1.80110497237569,782,384,398,6,1,74.13,6.2,0,0,0,0,0,0,0.0042226945377111,1.90934218997578,0.451612388319351
8.7,"random_policy_SVM","SVM",69,29,912,907,5,3000,2594,406,0.942812213340323,0.630769230769231,1.80276497695853,795,387,408,13,1.1,76.69,6.4,0,0,0,0,0,0,0.00436419273614758,1.83195583854682,0.471710136562599
8.7,"random_policy_SVM","SVM",69,30,812,807,5,3100,2694,406,0.942602542261828,0.630769230769231,1.79944802207912,796,388,408,1,1.1,79.24,6.6,0,0,0,0,0,0,0.0031816782966728,1.17445218945078,0.354513714180971
8.7,"random_policy_SVM","SVM",69,31,712,708,4,3200,2793,407,0.942825317782729,0.635897435897436,1.79449541284404,798,389,409,2,1.1,81.8,6.9,0,0,0,0,0,0,0.00251447213793244,0.819106329930171,0.289068748854908
8.7,"random_policy_SVM","SVM",69,32,612,608,4,3300,2893,407,0.942949081961008,0.635897435897436,1.79944802207912,796,389,407,-2,1,84.36,7.1,0,0,0,0,0,0,0.0018060195990245,0.57264877626551,0.224216958384232
8.7,"random_policy_SVM","SVM",69,33,512,510,2,3400,2991,409,0.943199522415878,0.641025641025641,1.79449541284404,805,393,412,9,1,86.91,7.3,0,0,0,0,0,0,0.00131649433096236,0.443085151923036,0.169229718398782
8.7,"random_policy_SVM","SVM",69,34,412,411,1,3500,3090,410,0.943432490280873,0.641025641025641,1.79285059578368,810,395,415,5,1.1,89.47,7.5,0,0,0,0,0,0,0.00106815838532306,0.32739845228505,0.127839836405722
8.7,"random_policy_SVM","SVM",69,35,312,312,0,3600,3189,411,0.943755733193554,0.635897435897436,1.79449541284404,814,398,416,4,1,92.02,7.8,0,0,0,0,0,0,0.00120538336103513,0.3132564664577,0.144992627476135
8.7,"random_policy_SVM","SVM",69,36,212,212,0,3700,3289,411,0.943816887258115,0.630769230769231,1.79614325068871,820,401,419,6,1,94.58,8,0,0,0,0,0,0,0.000628602193233896,0.129264430198329,0.078469750239915
8.7,"random_policy_SVM","SVM",69,37,112,112,0,3800,3389,411,0.943712051718868,0.625641025641026,1.79614325068871,824,403,421,4,1,97.14,8.2,0,0,0,0,0,0,0.000248620020947581,0.0404009354495381,0.0377473418196963
8.7,"random_policy_SVM","SVM",69,38,12,12,0,3900,3489,411,0.943732436407055,0.625641025641026,1.79614325068871,826,403,423,2,1,99.69,8.5,0,0,0,0,0,0,0.000156586509799456,0.00244427546035374,0.00244427546035374
8.7,"random_policy_SVM","SVM",69,39,0,0,0,3912,3501,411,0.943675650489962,0.625641025641026,1.79449541284404,826,403,423,0,1,100,8.5,0,0,0,0,0,0,0,0,0
8.7,"random_policy_SVM","SVM",70,0,3812,3435,377,100,88,12,0.91082061569364,0.580645161290323,1.77958893501415,29,12,17,0,1.4,2.56,7.3,0,0,0,0,0,0,0.572969111815125,393.948807687284,63.1975184480038
8.7,"random_policy_SVM","SVM",70,1,3712,3401,311,200,122,78,0.921050818442718,0.594470046082949,1.76465505557062,92,46,46,63,1,5.11,1.6,0,0,0,0,0,0,0.692254919404662,323.760708768338,77.621616681293
8.7,"random_policy_SVM","SVM",70,2,3612,3347,265,300,176,124,0.919488662110484,0.626728110599078,1.78286324768207,174,89,85,82,1,7.67,1.4,0,0,0,0,0,0,0.530514908257656,180.669910158408,66.9362326340683
8.7,"random_policy_SVM","SVM",70,3,3512,3311,201,400,212,188,0.910181973325411,0.608294930875576,1.73980075901328,245,124,121,71,1,10.22,1.1,0,0,0,0,0,0,0.298613056339474,123.430445903199,52.8210638306025
8.7,"random_policy_SVM","SVM",70,4,3412,3259,153,500,264,236,0.885066898450545,0.645161290322581,1.67660462866309,316,158,158,71,1,12.78,1.1,0,0,0,0,0,0,0.18130877847853,92.4311556586283,30.5757305376241
8.7,"random_policy_SVM","SVM",70,5,3312,3188,124,600,335,265,0.883385493543337,0.663594470046083,1.64340453700639,385,190,195,69,1,15.34,1.3,0,0,0,0,0,0,0.0834423168586108,60.5696772764123,12.0166092801251
8.7,"random_policy_SVM","SVM",70,6,3212,3111,101,700,412,288,0.881737213240288,0.649769585253456,1.63661152286097,439,211,228,54,1.1,17.89,1.4,0,0,0,0,0,0,0.07158923941867,68.6605322770539,9.99523807822691
8.7,"random_policy_SVM","SVM",70,7,3112,3026,86,800,497,303,0.88783081542174,0.672811059907834,1.62381404174573,481,230,251,42,1.1,20.45,1.6,0,0,0,0,0,0,0.0657335250454513,86.1765165745233,9.36517796855881
8.7,"random_policy_SVM","SVM",70,8,3012,2946,66,900,577,323,0.888862978087402,0.682027649769585,1.62530789091017,525,256,269,44,1.1,23.01,1.8,0,0,0,0,0,0,0.0703162640474529,108.933077156596,9.55821802197196
8.7,"random_policy_SVM","SVM",70,9,2912,2855,57,1000,668,332,0.888828528499071,0.682027649769585,1.62530789091017,560,270,290,35,1.1,25.56,2,0,0,0,0,0,0,0.0657427364637515,93.8458724435941,7.09926727090311
8.7,"random_policy_SVM","SVM",70,10,2812,2757,55,1100,766,334,0.912622594159988,0.672811059907834,1.67198588312958,599,291,308,39,1.1,28.12,2.3,0,0,0,0,0,0,0.0598819351579818,49.7341959785867,7.62183729980082
8.7,"random_policy_SVM","SVM",70,11,2712,2663,49,1200,860,340,0.915667407774466,0.67741935483871,1.68335460129982,610,297,313,11,1.1,30.67,2.5,0,0,0,0,0,0,0.0422064333737835,41.5294002203188,4.78749792328412
8.7,"random_policy_SVM","SVM",70,12,2612,2569,43,1300,954,346,0.924407003336302,0.682027649769585,1.70823176289538,623,304,319,13,1,33.23,2.8,0,0,0,0,0,0,0.0370747058713598,45.251025890661,4.43806523869308
8.7,"random_policy_SVM","SVM",70,13,2512,2480,32,1400,1043,357,0.937354748610751,0.672811059907834,1.75475746150233,654,316,338,31,1.1,35.79,2.9,0,0,0,0,0,0,0.0645076970695033,55.8560813534078,7.71249955269841
8.7,"random_policy_SVM","SVM",70,14,2412,2383,29,1500,1140,360,0.938173588825612,0.672811059907834,1.77457086048355,668,324,344,14,1.1,38.34,3.2,0,0,0,0,0,0,0.0550764532958393,46.359371487162,6.13947358425323
8.7,"random_policy_SVM","SVM",70,15,2312,2285,27,1600,1238,362,0.938878480402158,0.67741935483871,1.77293982108973,679,329,350,11,1.1,40.9,3.4,0,0,0,0,0,0,0.0442087096389048,35.4887356566251,4.89652201497345
8.7,"random_policy_SVM","SVM",70,16,2212,2189,23,1700,1334,366,0.939560847247874,0.672811059907834,1.77620490363317,690,334,356,11,1.1,43.46,3.6,0,0,0,0,0,0,0.0393357518749693,28.8442732538821,4.35834450504174
8.7,"random_policy_SVM","SVM",70,17,2112,2096,16,1800,1427,373,0.940166365011936,0.654377880184332,1.767904880719,712,345,367,22,1.1,46.01,3.8,0,0,0,0,0,0,0.0426460956909483,29.0264861634039,5.47149358789064
8.7,"random_policy_SVM","SVM",70,18,2012,2000,12,1900,1523,377,0.940325363111909,0.649769585253456,1.76465505557062,720,349,371,8,1.1,48.57,4,0,0,0,0,0,0,0.0269331348646077,24.1720530156049,3.74574738397277
8.7,"random_policy_SVM","SVM",70,19,1912,1900,12,2000,1623,377,0.940358487716069,0.649769585253456,1.76465505557062,719,349,370,-1,1.1,51.12,4.3,0,0,0,0,0,0,0.0192405677195543,17.9214086694284,2.13018659252224
8.7,"random_policy_SVM","SVM",70,20,1812,1800,12,2100,1723,377,0.940028566658626,0.654377880184332,1.76465505557062,724,351,373,5,1.1,53.68,4.6,0,0,0,0,0,0,0.0192690616927738,16.449760651803,1.94867629554582
8.7,"random_policy_SVM","SVM",70,21,1712,1700,12,2200,1823,377,0.940966655448466,0.640552995391705,1.79280494946152,737,360,377,13,1,56.24,4.8,0,0,0,0,0,0,0.0125965333812936,9.04528001709567,1.64957215638269
8.7,"random_policy_SVM","SVM",70,22,1612,1602,10,2300,1921,379,0.941001105036793,0.640552995391705,1.78786609285143,740,362,378,3,1,58.79,5.1,0,0,0,0,0,0,0.0108198412104357,8.45312596462177,1.2010430991877
8.7,"random_policy_SVM","SVM",70,23,1512,1504,8,2400,2019,381,0.940427386892725,0.640552995391705,1.78950935212795,750,366,384,10,1,61.35,5.3,0,0,0,0,0,0,0.0104087654184737,7.60265414087171,1.08735002221297
8.7,"random_policy_SVM","SVM",70,24,1412,1405,7,2500,2118,382,0.940378362478567,0.640552995391705,1.79445730425365,754,367,387,4,1.1,63.91,5.5,0,0,0,0,0,0,0.00828870407145279,5.63193790656163,0.894549665399019
8.7,"random_policy_SVM","SVM",70,25,1312,1306,6,2600,2217,383,0.940954730590968,0.640552995391705,1.79280494946152,763,370,393,9,1.1,66.46,5.8,0,0,0,0,0,0,0.0081355521064085,4.95362782029431,0.83221205621485
8.7,"random_policy_SVM","SVM",70,26,1212,1206,6,2700,2317,383,0.940725508330174,0.63594470046083,1.7911556348806,764,372,392,1,1.1,69.02,6,0,0,0,0,0,0,0.00642405705500648,3.51750214003291,0.692608061651446
8.7,"random_policy_SVM","SVM",70,27,1112,1106,6,2800,2417,383,0.940709608520177,0.63594470046083,1.7911556348806,764,372,392,0,1.1,71.57,6.3,0,0,0,0,0,0,0.00623822822994639,2.97954895209374,0.640120560329549
8.7,"random_policy_SVM","SVM",70,28,1012,1006,6,2900,2517,383,0.941213102503424,0.63594470046083,1.7911556348806,766,374,392,2,1,74.13,6.6,0,0,0,0,0,0,0.00509294720964011,2.11983631308223,0.542688572512251
8.7,"random_policy_SVM","SVM",70,29,912,906,6,3000,2617,383,0.941336326030903,0.63594470046083,1.78950935212795,767,375,392,1,1,76.69,6.8,0,0,0,0,0,0,0.00398551218844314,1.43745576026563,0.43659219873097
8.7,"random_policy_SVM","SVM",70,30,812,806,6,3100,2717,383,0.941331026094237,0.63594470046083,1.78950935212795,767,375,392,0,1,79.24,7.1,0,0,0,0,0,0,0.00273967125049861,0.86296325778042,0.308084026510445
8.7,"random_policy_SVM","SVM",70,31,712,707,5,3200,2816,384,0.941572173212529,0.63594470046083,1.78950935212795,770,376,394,3,1,81.8,7.3,0,0,0,0,0,0,0.00243890097568111,0.762671328075166,0.294730010936546
8.7,"random_policy_SVM","SVM",70,32,612,609,3,3300,2914,386,0.94151254892504,0.640552995391705,1.78622584872955,776,380,396,6,1,84.36,7.5,0,0,0,0,0,0,0.00193370600560229,0.628448019824993,0.244008468970633
8.7,"random_policy_SVM","SVM",70,33,512,509,3,3400,3014,386,0.941656972199182,0.640552995391705,1.78622584872955,778,381,397,2,1,86.91,7.8,0,0,0,0,0,0,0.00109448353877111,0.352514643070202,0.144993513426492
8.7,"random_policy_SVM","SVM",70,34,412,411,1,3500,3112,388,0.941900769285807,0.640552995391705,1.79280494946152,789,386,403,11,1,89.47,8,0,0,0,0,0,0,0.000813996520546295,0.234733073774626,0.103106640938634
8.7,"random_policy_SVM","SVM",70,35,312,312,0,3600,3211,389,0.942270439868243,0.640552995391705,1.78950935212795,793,388,405,4,1,92.02,8.3,0,0,0,0,0,0,0.000684385239929723,0.167881419897413,0.0852708411957859
8.7,"random_policy_SVM","SVM",70,36,212,212,0,3700,3311,389,0.942437387873215,0.640552995391705,1.7911556348806,796,388,408,3,1.1,94.58,8.5,0,0,0,0,0,0,0.000357712223525969,0.0771946445239559,0.0492170676623224
8.7,"random_policy_SVM","SVM",70,37,112,112,0,3800,3411,389,0.942564586353193,0.63594470046083,1.78622584872955,800,389,411,4,1.1,97.14,8.8,0,0,0,0,0,0,0.000132202916719191,0.0223114445118842,0.0208950220121837
8.7,"random_policy_SVM","SVM",70,38,12,12,0,3900,3511,389,0.942516886923201,0.63594470046083,1.78622584872955,801,389,412,1,1.1,99.69,9,0,0,0,0,0,0,0.00010199204520186,0.00140693826342472,0.00140693826342472
8.7,"random_policy_SVM","SVM",70,39,0,0,0,3912,3523,389,0.942612285783184,0.63594470046083,1.78786609285143,800,389,411,-1,1.1,100,9.1,0,0,0,0,0,0,0,0,0
8.7,"random_policy_SVM","SVM",71,0,3812,3403,409,100,92,8,0.774732530250351,0.259259259259259,1.56430400117036,29,8,21,0,2.6,2.56,11.5,0,0,0,0,0,0,0.136431150535283,328.311055703934,15.1107188473388
8.7,"random_policy_SVM","SVM",71,1,3712,3322,390,200,173,27,0.851396711611757,0.439153439153439,1.70738058664326,80,27,53,51,2,5.11,6.4,0,0,0,0,0,0,0.253595609508759,326.523697322719,42.7729669031582
8.7,"random_policy_SVM","SVM",71,2,3612,3284,328,300,211,89,0.927312307051975,0.555555555555556,1.76763304036031,160,75,85,80,1.1,7.67,2.4,0,0,0,0,0,0,0.731046448502907,402.334266253307,78.9449741044936
8.7,"random_policy_SVM","SVM",71,3,3512,3241,271,400,254,146,0.92102268814209,0.582010582010582,1.74702198922382,228,111,117,68,1.1,10.22,1.7,0,0,0,0,0,0,0.616651244060852,333.142109771555,73.658361064772
8.7,"random_policy_SVM","SVM",71,4,3412,3199,213,500,296,204,0.921128987342902,0.619047619047619,1.73280179903915,307,149,158,79,1.1,12.78,1.5,0,0,0,0,0,0,0.398880642457702,254.404613127586,61.1588676626948
8.7,"random_policy_SVM","SVM",71,5,3312,3153,159,600,342,258,0.921283196042666,0.619047619047619,1.74072128851541,389,193,196,82,1,15.34,1.3,0,0,0,0,0,0,0.248244343217237,216.303684004523,42.3491681508179
8.7,"random_policy_SVM","SVM",71,6,3212,3097,115,700,398,302,0.904627159296084,0.650793650793651,1.65359219904674,455,220,235,66,1.1,17.89,1.3,0,0,0,0,0,0,0.149299697027583,160.965898700782,21.8038998627505
8.7,"random_policy_SVM","SVM",71,7,3112,3027,85,800,468,332,0.901803493201337,0.671957671957672,1.66004684794786,521,252,269,66,1.1,20.45,1.4,0,0,0,0,0,0,0.11414441770855,178.670168817931,16.1704014310967
8.7,"random_policy_SVM","SVM",71,8,3012,2951,61,900,544,356,0.903546201225882,0.677248677248677,1.6520751419834,571,274,297,50,1.1,23.01,1.5,0,0,0,0,0,0,0.102952852779261,157.869025827293,11.7450121508109
8.7,"random_policy_SVM","SVM",71,9,2912,2856,56,1000,639,361,0.913526348727249,0.656084656084656,1.70423913202202,602,290,312,31,1.1,25.56,1.8,0,0,0,0,0,0,0.073892392783743,106.954269963063,8.86596287451346
8.7,"random_policy_SVM","SVM",71,10,2812,2766,46,1100,729,371,0.917543260780378,0.656084656084656,1.74072128851541,621,301,320,19,1.1,28.12,2,0,0,0,0,0,0,0.0689194233078657,108.63705589713,7.5093102955759
8.7,"random_policy_SVM","SVM",71,11,2712,2671,41,1200,824,376,0.927921655991822,0.656084656084656,1.76298634862171,648,314,334,27,1.1,30.67,2.2,0,0,0,0,0,0,0.074200874445659,94.5224582888548,8.32194657044834
8.7,"random_policy_SVM","SVM",71,12,2612,2573,39,1300,922,378,0.929914391714045,0.656084656084656,1.76461122083242,655,318,337,7,1.1,33.23,2.4,0,0,0,0,0,0,0.0606785564508624,68.9963785003764,6.47036822293818
8.7,"random_policy_SVM","SVM",71,13,2512,2478,34,1400,1017,383,0.931219925560608,0.650793650793651,1.75507278180089,666,322,344,11,1.1,35.79,2.7,0,0,0,0,0,0,0.0583334691398404,60.0892094577775,6.25832967714377
8.7,"random_policy_SVM","SVM",71,14,2412,2383,29,1500,1112,388,0.931267835059564,0.645502645502645,1.75345669268321,680,329,351,14,1.1,38.34,2.9,0,0,0,0,0,0,0.0552601500326788,53.8447442884607,6.08259948073684
8.7,"random_policy_SVM","SVM",71,15,2312,2289,23,1600,1206,394,0.933417773825237,0.645502645502645,1.75184357705057,694,335,359,14,1.1,40.9,3.1,0,0,0,0,0,0,0.0453397298441649,47.2125304825766,5.40331364547792
8.7,"random_policy_SVM","SVM",71,16,2212,2198,14,1700,1297,403,0.936286355075255,0.645502645502645,1.75184357705057,722,343,379,28,1.1,43.46,3.2,0,0,0,0,0,0,0.0398634860372761,45.2033454914197,4.56344426143095
8.7,"random_policy_SVM","SVM",71,17,2112,2101,11,1800,1394,406,0.935663531588821,0.645502645502645,1.75507278180089,731,347,384,9,1.1,46.01,3.4,0,0,0,0,0,0,0.0379544458356034,41.0295047574221,3.84168333570761
8.7,"random_policy_SVM","SVM",71,18,2012,2002,10,1900,1493,407,0.934199297526966,0.64021164021164,1.7725160045602,757,365,392,26,1.1,48.57,3.7,0,0,0,0,0,0,0.0283420123900391,21.6394174583084,3.75221569521032
8.7,"random_policy_SVM","SVM",71,19,1912,1902,10,2000,1593,407,0.934163365402749,0.64021164021164,1.76298634862171,756,364,392,-1,1.1,51.12,3.9,0,0,0,0,0,0,0.0197966984472719,17.1922876688034,2.29645643296374
8.7,"random_policy_SVM","SVM",71,20,1812,1804,8,2100,1691,409,0.933886388611906,0.64021164021164,1.75974556489262,757,365,392,1,1.1,53.68,4.1,0,0,0,0,0,0,0.0166270236854097,14.1858406844179,1.73691804519766
8.7,"random_policy_SVM","SVM",71,21,1712,1704,8,2200,1791,409,0.934313082586988,0.64021164021164,1.77088535506199,769,373,396,12,1.1,56.24,4.4,0,0,0,0,0,0,0.0121849433779936,9.91721777158423,1.43529428787838
8.7,"random_policy_SVM","SVM",71,22,1612,1605,7,2300,1890,410,0.93470234726601,0.634920634920635,1.77414965986395,769,373,396,0,1.1,58.79,4.6,0,0,0,0,0,0,0.0110340653380593,8.11391243611373,1.13170082622244
8.7,"random_policy_SVM","SVM",71,23,1512,1505,7,2400,1990,410,0.934690369891271,0.634920634920635,1.7725160045602,782,381,401,13,1.1,61.35,4.9,0,0,0,0,0,0,0.00757028101177081,5.16215708064039,0.908837498943251
8.7,"random_policy_SVM","SVM",71,24,1412,1406,6,2500,2089,411,0.934792177576553,0.64021164021164,1.77414965986395,784,383,401,2,1,63.91,5.1,0,0,0,0,0,0,0.0069884099435408,4.56565840023064,0.737395423085223
8.7,"random_policy_SVM","SVM",71,25,1312,1308,4,2600,2187,413,0.935259295191379,0.645502645502645,1.7725160045602,788,387,401,4,1,66.46,5.3,0,0,0,0,0,0,0.00693567595399259,4.11578913821767,0.724520999701403
8.7,"random_policy_SVM","SVM",71,26,1212,1208,4,2700,2287,413,0.935705452400412,0.645502645502645,1.76763304036031,795,389,406,7,1,69.02,5.5,0,0,0,0,0,0,0.0050491646707811,2.70577563828946,0.538827358197128
8.7,"random_policy_SVM","SVM",71,27,1112,1108,4,2800,2387,413,0.93586714695939,0.645502645502645,1.76763304036031,797,389,408,2,1,71.57,5.8,0,0,0,0,0,0,0.00489770918062815,2.30616774188023,0.511895620065311
8.7,"random_policy_SVM","SVM",71,28,1012,1008,4,2900,2487,413,0.935819237460433,0.650793650793651,1.76925770308123,798,390,408,1,1,74.13,6,0,0,0,0,0,0,0.00371568084476792,1.5249099002465,0.401386492724258
8.7,"random_policy_SVM","SVM",71,29,912,908,4,3000,2587,413,0.936010875456259,0.650793650793651,1.77088535506199,798,390,408,0,1,76.69,6.3,0,0,0,0,0,0,0.00325281962131655,1.20019788115968,0.359521045006893
8.7,"random_policy_SVM","SVM",71,30,812,809,3,3100,2686,414,0.936238445576303,0.650793650793651,1.76763304036031,802,392,410,4,1,79.24,6.5,0,0,0,0,0,0,0.00267853039616891,0.891069452366762,0.303212061378258
8.7,"random_policy_SVM","SVM",71,31,712,709,3,3200,2786,414,0.936292343762629,0.650793650793651,1.76925770308123,802,392,410,0,1,81.8,6.7,0,0,0,0,0,0,0.00184167630803619,0.564514582028179,0.221855975393597
8.7,"random_policy_SVM","SVM",71,32,612,609,3,3300,2886,414,0.936445055290553,0.645502645502645,1.77088535506199,804,392,412,2,1.1,84.36,7,0,0,0,0,0,0,0.00112868596611936,0.355664810352367,0.150366737530077
8.7,"random_policy_SVM","SVM",71,33,512,509,3,3400,2986,414,0.93665615652033,0.64021164021164,1.76925770308123,807,393,414,3,1.1,86.91,7.2,0,0,0,0,0,0,0.000595111593731223,0.187023895792845,0.0796822502692747
8.7,"random_policy_SVM","SVM",71,34,412,411,1,3500,3084,416,0.937406239613367,0.634920634920635,1.77088535506199,816,398,418,9,1.1,89.47,7.4,0,0,0,0,0,0,0.00072141082359863,0.215194283367274,0.0917796538427495
8.7,"random_policy_SVM","SVM",71,35,312,312,0,3600,3183,417,0.938620445977546,0.634920634920635,1.76601135867191,823,404,419,7,1,92.02,7.6,0,0,0,0,0,0,0.000536996355720696,0.134945188293548,0.0661438436441992
8.7,"random_policy_SVM","SVM",71,36,212,212,0,3700,3283,417,0.938852507613117,0.624338624338624,1.76277690563405,824,404,420,1,1,94.58,7.9,0,0,0,0,0,0,0.000280210749888593,0.0583782225451165,0.0366110880160083
8.7,"random_policy_SVM","SVM",71,37,112,112,0,3800,3383,417,0.939310642196889,0.62962962962963,1.77387863180714,827,404,423,3,1,97.14,8.1,0,0,0,0,0,0,0.00013060921290629,0.0222041128178548,0.0208078235639645
8.7,"random_policy_SVM","SVM",71,38,12,12,0,3900,3483,417,0.939640020002214,0.62962962962963,1.77387863180714,826,405,421,-1,1,99.69,8.4,0,0,0,0,0,0,0.000105277426921758,0.00151142050133355,0.00151142050133355
8.7,"random_policy_SVM","SVM",71,39,0,0,0,3912,3495,417,0.939695415360382,0.62962962962963,1.77550604339595,826,405,421,0,1,100,8.4,0,0,0,0,0,0,0,0,0
8.7,"random_policy_SVM","SVM",72,0,3812,3416,396,100,92,8,0.823692945121199,0.48019801980198,1.60642423689374,24,8,16,0,2,2.56,11.5,0,0,0,0,0,0,0.243149698717409,304.142423575217,37.2782022844935
8.7,"random_policy_SVM","SVM",72,1,3712,3359,353,200,149,51,0.881505639161421,0.54950495049505,1.69099446709377,88,43,45,64,1,5.11,2.9,0,0,0,0,0,0,0.675986252054906,362.019965611492,74.7198236338229
8.7,"random_policy_SVM","SVM",72,2,3612,3316,296,300,192,108,0.876031588335591,0.569306930693069,1.68364196125224,163,81,82,75,1,7.67,1.8,0,0,0,0,0,0,0.680258176924401,300.064469596314,76.5256204322423
8.7,"random_policy_SVM","SVM",72,3,3512,3274,238,400,234,166,0.872476771622441,0.584158415841584,1.65844319238554,239,120,119,76,1,10.22,1.4,0,0,0,0,0,0,0.571728703927819,207.138420590045,69.2973461157783
8.7,"random_policy_SVM","SVM",72,4,3412,3242,170,500,266,234,0.879198324621523,0.603960396039604,1.70879440885265,312,159,153,73,1,12.78,1.1,0,0,0,0,0,0,0.360773915453826,192.957546957294,55.2159765664109
8.7,"random_policy_SVM","SVM",72,5,3312,3189,123,600,319,281,0.825685561714673,0.599009900990099,1.55287676233061,393,197,196,81,1,15.34,1.1,0,0,0,0,0,0,0.273244144941693,159.737890132496,39.6062763762804
8.7,"random_policy_SVM","SVM",72,6,3212,3112,100,700,396,304,0.848707903857666,0.594059405940594,1.55001958337508,447,223,224,54,1,17.89,1.3,0,0,0,0,0,0,0.0969699915105742,60.6278283459615,15.9475224068184
8.7,"random_policy_SVM","SVM",72,7,3112,3039,73,800,469,331,0.853898303171263,0.613861386138614,1.57965049961217,504,248,256,57,1,20.45,1.4,0,0,0,0,0,0,0.0771298263703144,56.5568407033657,10.1506357160557
8.7,"random_policy_SVM","SVM",72,8,3012,2954,58,900,554,346,0.859596735044094,0.618811881188119,1.59602866363984,545,264,281,41,1.1,23.01,1.6,0,0,0,0,0,0,0.0598452843787166,53.0708986282678,7.25093262416373
8.7,"random_policy_SVM","SVM",72,9,2912,2865,47,1000,643,357,0.863042889237619,0.628712871287129,1.61386138613861,575,280,295,30,1.1,25.56,1.8,0,0,0,0,0,0,0.0492107650204361,55.2146625876139,5.8218994200905
8.7,"random_policy_SVM","SVM",72,10,2812,2773,39,1100,735,365,0.873353127787131,0.643564356435644,1.61237669305109,598,290,308,23,1.1,28.12,2,0,0,0,0,0,0,0.0426429615742668,57.5276511568646,5.11101784493021
8.7,"random_policy_SVM","SVM",72,11,2712,2675,37,1200,833,367,0.878399584542266,0.643564356435644,1.62427339508144,598,292,306,0,1,30.67,2.3,0,0,0,0,0,0,0.0338698871879401,44.6586042091841,3.72699776475892
8.7,"random_policy_SVM","SVM",72,12,2612,2577,35,1300,931,369,0.877950822448268,0.643564356435644,1.61534881598759,608,296,312,10,1.1,33.23,2.5,0,0,0,0,0,0,0.0306892002878599,40.7091684701106,3.34376145095968
8.7,"random_policy_SVM","SVM",72,13,2512,2478,34,1400,1030,370,0.880719599896139,0.638613861386139,1.62427339508144,615,299,316,7,1.1,35.79,2.8,0,0,0,0,0,0,0.0243851824009442,30.6165375555152,2.6505354392716
8.7,"random_policy_SVM","SVM",72,14,2412,2383,29,1500,1125,375,0.898746288539923,0.638613861386139,1.66582564420195,640,309,331,25,1.1,38.34,3,0,0,0,0,0,0,0.0230510161193709,25.9744465689687,2.67218592505396
8.7,"random_policy_SVM","SVM",72,15,2312,2285,27,1600,1223,377,0.90729958115539,0.638613861386139,1.7056590062676,643,315,328,3,1,40.9,3.2,0,0,0,0,0,0,0.0191242152638133,22.496760094325,2.21425667277291
8.7,"random_policy_SVM","SVM",72,16,2212,2191,21,1700,1317,383,0.917408017882753,0.638613861386139,1.75814208148925,668,328,340,25,1,43.46,3.4,0,0,0,0,0,0,0.0380463754092509,29.9596764758527,4.8223125183312
8.7,"random_policy_SVM","SVM",72,17,2112,2092,20,1800,1416,384,0.918970218002428,0.638613861386139,1.76543952737815,677,329,348,9,1.1,46.01,3.7,0,0,0,0,0,0,0.0308569938378671,23.3731162879411,3.39022832101302
8.7,"random_policy_SVM","SVM",72,18,2012,1995,17,1900,1513,387,0.918697856102611,0.638613861386139,1.76706666058311,695,339,356,18,1.1,48.57,3.9,0,0,0,0,0,0,0.032036910818729,20.5373063782886,3.83507355950496
8.7,"random_policy_SVM","SVM",72,19,1912,1897,15,2000,1611,389,0.919109926956218,0.638613861386139,1.76381538797854,705,343,362,10,1.1,51.12,4.1,0,0,0,0,0,0,0.0242919467202289,14.9607021706252,3.0020717036142
8.7,"random_policy_SVM","SVM",72,20,1812,1801,11,2100,1707,393,0.919386522460695,0.628712871287129,1.76543952737815,714,347,367,9,1.1,53.68,4.3,0,0,0,0,0,0,0.0170869155539551,13.2571342730082,2.3916773883183
8.7,"random_policy_SVM","SVM",72,21,1712,1705,7,2200,1803,397,0.916496381679229,0.628712871287129,1.76706666058311,725,352,373,11,1.1,56.24,4.5,0,0,0,0,0,0,0.0127302898480757,11.4189521716836,1.60171892377608
8.7,"random_policy_SVM","SVM",72,22,1612,1606,6,2300,1902,398,0.91752373641014,0.633663366336634,1.76381538797854,728,353,375,3,1.1,58.79,4.8,0,0,0,0,0,0,0.0125490457813181,10.1870790905019,1.26513609112044
8.7,"random_policy_SVM","SVM",72,23,1512,1506,6,2400,2002,398,0.919095814940683,0.623762376237624,1.76706666058311,753,366,387,25,1.1,61.35,5,0,0,0,0,0,0,0.0076317302541564,5.01386200916996,1.06230595857338
8.7,"random_policy_SVM","SVM",72,24,1412,1407,5,2500,2101,399,0.919369588042053,0.628712871287129,1.76543952737815,751,367,384,-2,1,63.91,5.3,0,0,0,0,0,0,0.00589507761925352,4.13888041039126,0.640040890743957
8.7,"random_policy_SVM","SVM",72,25,1312,1307,5,2600,2201,399,0.919459904941472,0.618811881188119,1.76543952737815,762,370,392,11,1.1,66.46,5.5,0,0,0,0,0,0,0.00447955867260956,3.00370099727035,0.500252058155976
8.7,"random_policy_SVM","SVM",72,26,1212,1208,4,2700,2300,400,0.919524820212931,0.618811881188119,1.77109420500874,766,371,395,4,1.1,69.02,5.8,0,0,0,0,0,0,0.00487303136724321,3.00252168538417,0.505495714109065
8.7,"random_policy_SVM","SVM",72,27,1112,1108,4,2800,2400,400,0.919155085405926,0.618811881188119,1.77599123967696,771,376,395,5,1.1,71.57,6,0,0,0,0,0,0,0.00378386292862798,2.19157456504449,0.412444181949509
8.7,"random_policy_SVM","SVM",72,28,1012,1009,3,2900,2499,401,0.919228467886707,0.618811881188119,1.77599123967696,778,380,398,7,1,74.13,6.2,0,0,0,0,0,0,0.00355949324239296,1.82681409835419,0.371242245867544
8.7,"random_policy_SVM","SVM",72,29,912,909,3,3000,2599,401,0.919236935096027,0.618811881188119,1.77599123967696,778,380,398,0,1,76.69,6.5,0,0,0,0,0,0,0.00341510990657321,1.61861394045411,0.370003452575266
8.7,"random_policy_SVM","SVM",72,30,812,810,2,3100,2698,402,0.919383700057586,0.618811881188119,1.77599123967696,778,380,398,0,1,79.24,6.7,0,0,0,0,0,0,0.00268428616425159,1.17338998796363,0.294185172644266
8.7,"random_policy_SVM","SVM",72,31,712,710,2,3200,2798,402,0.919665940368276,0.618811881188119,1.77435588862754,779,382,397,1,1,81.8,7,0,0,0,0,0,0,0.00182175238248302,0.694044472450347,0.198932077433018
8.7,"random_policy_SVM","SVM",72,32,612,610,2,3300,2898,402,0.919948180678966,0.618811881188119,1.77435588862754,781,383,398,2,1,84.36,7.2,0,0,0,0,0,0,0.00177297706653165,0.608682301622113,0.197241768664916
8.7,"random_policy_SVM","SVM",72,33,512,510,2,3400,2998,402,0.920120347268487,0.618811881188119,1.77435588862754,779,383,396,-2,1,86.91,7.5,0,0,0,0,0,0,0.00105870875219691,0.325393242270985,0.124692496501057
8.7,"random_policy_SVM","SVM",72,34,412,410,2,3500,3098,402,0.920298158664222,0.618811881188119,1.77599123967696,778,383,395,-1,1,89.47,7.7,0,0,0,0,0,0,0.000873113374002151,0.252673115807101,0.106521294315541
8.7,"random_policy_SVM","SVM",72,35,312,312,0,3600,3196,404,0.921830723551269,0.618811881188119,1.77272354650368,790,387,403,12,1,92.02,7.9,0,0,0,0,0,0,0.000987042368538111,0.251340408044809,0.123455025462386
8.7,"random_policy_SVM","SVM",72,36,212,212,0,3700,3296,404,0.922447418630127,0.618811881188119,1.77435588862754,794,391,403,4,1,94.58,8.2,0,0,0,0,0,0,0.000506362997692525,0.105660094029249,0.0650665885961756
8.7,"random_policy_SVM","SVM",72,37,112,112,0,3800,3396,404,0.922573015568384,0.618811881188119,1.77599123967696,794,392,402,0,1,97.14,8.4,0,0,0,0,0,0,0.000257188223262505,0.0419307480278611,0.0390958483188299
8.7,"random_policy_SVM","SVM",72,38,12,12,0,3900,3496,404,0.923100804949376,0.618811881188119,1.77109420500874,797,394,403,3,1,99.69,8.7,0,0,0,0,0,0,0.000179718989272441,0.00233779309811436,0.00233779309811436
8.7,"random_policy_SVM","SVM",72,39,0,0,0,3912,3508,404,0.923320952391714,0.618811881188119,1.77272354650368,797,394,403,0,1,100,8.7,0,0,0,0,0,0,0,0,0
8.7,"random_policy_SVM","SVM",73,0,3812,3414,398,100,94,6,0.908913995732527,0.504950495049505,1.76543952737815,18,6,12,0,2,2.56,15.7,0,0,0,0,0,0,0.467379312529605,279.480722786005,54.1118281910473
8.7,"random_policy_SVM","SVM",73,1,3712,3377,335,200,131,69,0.920484437269273,0.579207920792079,1.7492175023954,90,45,45,72,1,5.11,1.9,0,0,0,0,0,0,0.654725907151712,252.756731358011,78.3352828857681
8.7,"random_policy_SVM","SVM",73,2,3612,3344,268,300,164,136,0.92281856463868,0.618811881188119,1.76543952737815,160,81,79,70,1,7.67,1.2,0,0,0,0,0,0,0.68079361027953,311.896146875997,78.6779199766135
8.7,"random_policy_SVM","SVM",73,3,3512,3288,224,400,220,180,0.900981631800585,0.608910891089109,1.69567002783228,228,114,114,68,1,10.22,1.2,0,0,0,0,0,0,0.374356856497788,181.318371205222,59.7932388441556
8.7,"random_policy_SVM","SVM",73,4,3412,3243,169,500,265,235,0.892548291317147,0.608910891089109,1.66429455445545,308,153,155,80,1,12.78,1.1,0,0,0,0,0,0,0.244050528759724,137.252487824472,39.6563570670121
8.7,"random_policy_SVM","SVM",73,5,3312,3173,139,600,335,265,0.909254095306924,0.613861386138614,1.70302499863246,367,183,184,59,1,15.34,1.3,0,0,0,0,0,0,0.0995913820489119,50.5449467092752,17.1661923629358
8.7,"random_policy_SVM","SVM",73,6,3212,3101,111,700,407,293,0.910476195852196,0.628712871287129,1.69410863738308,437,211,226,70,1.1,17.89,1.4,0,0,0,0,0,0,0.078015081399632,57.1790165997782,10.9268776327456
8.7,"random_policy_SVM","SVM",73,7,3112,3021,91,800,487,313,0.904577373358771,0.648514851485149,1.67627591488431,485,235,250,48,1.1,20.45,1.6,0,0,0,0,0,0,0.0612981455964637,77.6399487498605,10.9658727884065
8.7,"random_policy_SVM","SVM",73,8,3012,2933,79,900,575,325,0.914296318457382,0.663366336633663,1.68519227613369,516,250,266,31,1.1,23.01,1.8,0,0,0,0,0,0,0.0470723799615162,61.6185209065076,6.34923181195002
8.7,"random_policy_SVM","SVM",73,9,2912,2844,68,1000,664,336,0.924665827472144,0.653465346534653,1.69099446709377,547,261,286,31,1.1,25.56,2,0,0,0,0,0,0,0.0513360925778488,74.0573035579292,6.01140746847325
8.7,"random_policy_SVM","SVM",73,10,2812,2755,57,1100,753,347,0.932231279000202,0.658415841584158,1.71927459535282,576,274,302,29,1.1,28.12,2.2,0,0,0,0,0,0,0.0542309180446942,78.8217468729228,6.31128422321276
8.7,"random_policy_SVM","SVM",73,11,2712,2663,49,1200,845,355,0.941507106811024,0.653465346534653,1.73869044363,609,294,315,33,1.1,30.67,2.4,0,0,0,0,0,0,0.0532136702941308,65.1034116510873,6.02628486906033
8.7,"random_policy_SVM","SVM",73,12,2612,2573,39,1300,935,365,0.943851112591303,0.648514851485149,1.78327224987692,639,308,331,30,1.1,33.23,2.6,0,0,0,0,0,0,0.0600488763222847,64.9443521052659,6.56235432505715
8.7,"random_policy_SVM","SVM",73,13,2512,2474,38,1400,1034,366,0.944229314607629,0.653465346534653,1.78163170502883,647,311,336,8,1.1,35.79,2.8,0,0,0,0,0,0,0.0465539254133763,51.8518326072452,5.04891507532929
8.7,"random_policy_SVM","SVM",73,14,2412,2378,34,1500,1130,370,0.944872822516011,0.653465346534653,1.78327224987692,657,314,343,10,1.1,38.34,3.1,0,0,0,0,0,0,0.0468419804568012,44.7426789703447,5.33490903126079
8.7,"random_policy_SVM","SVM",73,15,2312,2285,27,1600,1223,377,0.94477403840727,0.653465346534653,1.77999417588818,675,323,352,18,1.1,40.9,3.2,0,0,0,0,0,0,0.0552508134429774,43.9623544898019,6.21283157154863
8.7,"random_policy_SVM","SVM",73,16,2212,2194,18,1700,1314,386,0.945513508021278,0.648514851485149,1.78163170502883,704,335,369,29,1.1,43.46,3.4,0,0,0,0,0,0,0.0419734918805895,39.4655191809677,5.54328567192459
8.7,"random_policy_SVM","SVM",73,17,2112,2097,15,1800,1411,389,0.945629226548661,0.643564356435644,1.78491581877082,711,338,373,7,1.1,46.01,3.6,0,0,0,0,0,0,0.0295041338559928,31.2445661175415,3.29359642735508
8.7,"random_policy_SVM","SVM",73,18,2012,1997,15,1900,1511,389,0.945291949377387,0.643564356435644,1.78327224987692,714,338,376,3,1.1,48.57,3.9,0,0,0,0,0,0,0.0248977882578978,24.9493909347527,2.60826689638305
8.7,"random_policy_SVM","SVM",73,19,1912,1897,15,2000,1611,389,0.943410817706635,0.638613861386139,1.78491581877082,725,349,376,11,1.1,51.12,4.1,0,0,0,0,0,0,0.0168937293129131,15.1007944458697,2.18451150240939
8.7,"random_policy_SVM","SVM",73,20,1812,1799,13,2100,1709,391,0.943427752125276,0.643564356435644,1.78491581877082,732,352,380,7,1.1,53.68,4.4,0,0,0,0,0,0,0.0153859177608205,13.6970820802198,1.63529846539044
8.7,"random_policy_SVM","SVM",73,21,1712,1700,12,2200,1808,392,0.943293687977696,0.638613861386139,1.79218861112631,742,359,383,10,1.1,56.24,4.6,0,0,0,0,0,0,0.0113297300100151,9.50931319587615,1.24495988239097
8.7,"random_policy_SVM","SVM",73,22,1612,1604,8,2300,1904,396,0.943050961310504,0.638613861386139,1.78561177218639,757,366,391,15,1.1,58.79,4.8,0,0,0,0,0,0,0.0106473256011539,8.14609083867762,1.12860875596955
8.7,"random_policy_SVM","SVM",73,23,1512,1504,8,2400,2004,396,0.94298463483749,0.648514851485149,1.78071073347042,772,373,399,15,1.1,61.35,5.1,0,0,0,0,0,0,0.00818209939283468,5.88190871349757,0.961387180253191
8.7,"random_policy_SVM","SVM",73,24,1412,1405,7,2500,2103,397,0.943304977590124,0.648514851485149,1.78889414676762,771,374,397,-1,1.1,63.91,5.3,0,0,0,0,0,0,0.00784902239033458,5.14248061727571,0.803259461924684
8.7,"random_policy_SVM","SVM",73,25,1312,1305,7,2600,2203,397,0.943543470652657,0.648514851485149,1.79053986355397,780,379,401,9,1.1,66.46,5.5,0,0,0,0,0,0,0.00604645658786274,3.61552916668134,0.674536817555709
8.7,"random_policy_SVM","SVM",73,26,1212,1205,7,2700,2303,397,0.943433396931488,0.648514851485149,1.79384039786467,779,377,402,-1,1.1,69.02,5.8,0,0,0,0,0,0,0.00588873221107162,3.11854793400795,0.601122286969738
8.7,"random_policy_SVM","SVM",73,27,1112,1105,7,2800,2403,397,0.943783374916743,0.648514851485149,1.80276497695853,781,379,402,2,1.1,71.57,6.1,0,0,0,0,0,0,0.00498466830399341,2.38888333645512,0.539193655401618
8.7,"random_policy_SVM","SVM",73,28,1012,1005,7,2900,2503,397,0.943821477358686,0.648514851485149,1.79779411764706,782,379,403,1,1.1,74.13,6.3,0,0,0,0,0,0,0.00352672825520913,1.41607125303361,0.374827499062528
8.7,"random_policy_SVM","SVM",73,29,912,905,7,3000,2603,397,0.944011989568402,0.648514851485149,1.79944802207912,784,381,403,2,1.1,76.69,6.6,0,0,0,0,0,0,0.00321038007605701,1.11755455426303,0.349550186245098
8.7,"random_policy_SVM","SVM",73,30,812,805,7,3100,2703,397,0.943965419917138,0.648514851485149,1.80110497237569,786,381,405,2,1.1,79.24,6.8,0,0,0,0,0,0,0.00264218721577699,0.850750961460639,0.309854633766886
8.7,"random_policy_SVM","SVM",73,31,712,706,6,3200,2802,398,0.944116418483357,0.653465346534653,1.79779411764706,788,383,405,2,1.1,81.8,7,0,0,0,0,0,0,0.00180144726982669,0.544943891374913,0.222881204246516
8.7,"random_policy_SVM","SVM",73,32,612,608,4,3300,2900,400,0.944706300732699,0.648514851485149,1.79285059578368,792,385,407,4,1.1,84.36,7.2,0,0,0,0,0,0,0.00122463034473831,0.391508601813559,0.162898218343306
8.7,"random_policy_SVM","SVM",73,33,512,509,3,3400,2999,401,0.945222800501263,0.648514851485149,1.79449541284404,803,391,412,11,1.1,86.91,7.5,0,0,0,0,0,0,0.00102032003463802,0.306923582886097,0.128986308029718
8.7,"random_policy_SVM","SVM",73,34,412,411,1,3500,3097,403,0.94570825383565,0.648514851485149,1.80276497695853,812,394,418,9,1.1,89.47,7.7,0,0,0,0,0,0,0.000818521267423632,0.240559604462858,0.101014067654926
8.7,"random_policy_SVM","SVM",73,35,312,312,0,3600,3196,404,0.945757645890021,0.648514851485149,1.79779411764706,818,397,421,6,1.1,92.02,7.9,0,0,0,0,0,0,0.000731662074650308,0.176518947512556,0.0876297186022587
8.7,"random_policy_SVM","SVM",73,36,212,212,0,3700,3296,404,0.945626404145551,0.648514851485149,1.79120879120879,821,398,423,3,1.1,94.58,8.2,0,0,0,0,0,0,0.000343317041782286,0.0727151412972033,0.0459481068222889
8.7,"random_policy_SVM","SVM",73,37,112,112,0,3800,3396,404,0.94578163631643,0.648514851485149,1.79944802207912,818,400,418,-3,1,97.14,8.4,0,0,0,0,0,0,0.000140266351038394,0.0221355037579193,0.0206365854782779
8.7,"random_policy_SVM","SVM",73,38,12,12,0,3900,3496,404,0.945812682750606,0.648514851485149,1.79285059578368,817,400,417,-1,1,99.69,8.7,0,0,0,0,0,0,7.82828308318937e-05,0.00114241765383246,0.00114241765383246
8.7,"random_policy_SVM","SVM",73,39,0,0,0,3912,3508,404,0.945753412285362,0.648514851485149,1.79285059578368,817,400,417,0,1,100,8.7,0,0,0,0,0,0,0,0,0
8.7,"random_policy_SVM","SVM",74,0,3812,3424,388,100,89,11,0.892170267067732,0.541062801932367,1.74408112748034,30,11,19,0,1.7,2.56,8.1,0,0,0,0,0,0,0.472664452814757,405.940817233799,54.0514672349883
8.7,"random_policy_SVM","SVM",74,1,3712,3373,339,200,140,60,0.905714238363967,0.57487922705314,1.73699914748508,116,57,59,86,1,5.11,2.3,0,0,0,0,0,0,0.712505435368165,434.804502062294,75.7983538669347
8.7,"random_policy_SVM","SVM",74,2,3612,3333,279,300,180,120,0.911685904712989,0.623188405797101,1.75436913895993,172,85,87,56,1,7.67,1.5,0,0,0,0,0,0,0.681515530211081,307.401915636115,79.9211515434634
8.7,"random_policy_SVM","SVM",74,3,3512,3289,223,400,224,176,0.909570133934378,0.618357487922705,1.75760002135212,251,127,124,79,1,10.22,1.3,0,0,0,0,0,0,0.511857844047746,216.390509371269,70.8958257143172
8.7,"random_policy_SVM","SVM",74,4,3412,3245,167,500,268,232,0.904039022988982,0.628019323671498,1.74180191010486,326,165,161,75,1,12.78,1.2,0,0,0,0,0,0,0.292433416859556,209.684586128181,48.9530414761842
8.7,"random_policy_SVM","SVM",74,5,3312,3188,124,600,325,275,0.89498208776307,0.618357487922705,1.70382518032612,407,202,205,81,1,15.34,1.2,0,0,0,0,0,0,0.227950728535551,151.031849841449,35.6986826760209
8.7,"random_policy_SVM","SVM",74,6,3212,3113,99,700,400,300,0.889908104838384,0.63768115942029,1.64600280504909,460,226,234,53,1,17.89,1.3,0,0,0,0,0,0,0.125449597480543,113.020449549404,17.8133046838439
8.7,"random_policy_SVM","SVM",74,7,3112,3033,79,800,480,320,0.891430023505498,0.647342995169082,1.65166726664267,508,246,262,48,1.1,20.45,1.5,0,0,0,0,0,0,0.0803744602702393,96.1368804304156,11.2901564657872
8.7,"random_policy_SVM","SVM",74,8,3012,2950,62,900,563,337,0.893468455404484,0.652173913043478,1.64600280504909,563,267,296,55,1.1,23.01,1.7,0,0,0,0,0,0,0.0755602947138596,113.206164431564,9.42970533855449
8.7,"random_policy_SVM","SVM",74,9,2912,2859,53,1000,654,346,0.902624826332782,0.652173913043478,1.65471181459961,587,279,308,24,1.1,25.56,1.9,0,0,0,0,0,0,0.0669781574298432,95.7393523974645,7.80403959046631
8.7,"random_policy_SVM","SVM",74,10,2812,2769,43,1100,744,356,0.913908016451096,0.661835748792271,1.69201900427197,618,298,320,31,1.1,28.12,2.1,0,0,0,0,0,0,0.0638105296908446,89.9062622901363,7.95967075314549
8.7,"random_policy_SVM","SVM",74,11,2712,2679,33,1200,834,366,0.923735578370534,0.666666666666667,1.70937304534142,654,309,345,36,1.1,30.67,2.3,0,0,0,0,0,0,0.0604245359558175,73.9898015983027,6.54570601407738
8.7,"random_policy_SVM","SVM",74,12,2612,2582,30,1300,931,369,0.924453725110017,0.661835748792271,1.72121115155394,665,315,350,11,1.1,33.23,2.5,0,0,0,0,0,0,0.052592644333423,63.3133172527684,5.71122932782116
8.7,"random_policy_SVM","SVM",74,13,2512,2485,27,1400,1028,372,0.927130202765978,0.666666666666667,1.73309290055433,672,319,353,7,1.1,35.79,2.8,0,0,0,0,0,0,0.0470568794766576,53.1434796775961,5.12686725746145
8.7,"random_policy_SVM","SVM",74,14,2412,2390,22,1500,1123,377,0.926728316802159,0.666666666666667,1.74248105305146,686,325,361,14,1.1,38.34,3,0,0,0,0,0,0,0.0485969314078053,46.6765489955264,5.89301643173943
8.7,"random_policy_SVM","SVM",74,15,2312,2293,19,1600,1220,380,0.927329074170759,0.671497584541063,1.74248105305146,695,328,367,9,1.1,40.9,3.2,0,0,0,0,0,0,0.0386574552226741,39.1905771508043,4.51123845397335
8.7,"random_policy_SVM","SVM",74,16,2212,2201,11,1700,1312,388,0.926290523501366,0.666666666666667,1.74180191010486,716,339,377,21,1.1,43.46,3.4,0,0,0,0,0,0,0.0338498222045235,36.7569800238518,4.1232335906929
8.7,"random_policy_SVM","SVM",74,17,2112,2102,10,1800,1411,389,0.926083365788057,0.666666666666667,1.73859712278176,720,341,379,4,1.1,46.01,3.6,0,0,0,0,0,0,0.0285031814978011,30.8616502557947,3.07650981555565
8.7,"random_policy_SVM","SVM",74,18,2012,2002,10,1900,1511,389,0.925811298657911,0.671497584541063,1.73699914748508,722,342,380,2,1.1,48.57,3.9,0,0,0,0,0,0,0.0217703254524143,23.0474920609455,2.34025540319204
8.7,"random_policy_SVM","SVM",74,19,1912,1902,10,2000,1611,389,0.925959071160072,0.661835748792271,1.7592199292059,732,345,387,10,1.1,51.12,4.1,0,0,0,0,0,0,0.0185587238376943,18.6710140361174,2.00426968906302
8.7,"random_policy_SVM","SVM",74,20,1812,1802,10,2100,1711,389,0.925541993630607,0.652173913043478,1.7592199292059,741,354,387,9,1.1,53.68,4.4,0,0,0,0,0,0,0.0147564637285277,13.7664727025095,1.58793561571372
8.7,"random_policy_SVM","SVM",74,21,1712,1703,9,2200,1810,390,0.926900948229924,0.657004830917874,1.75598309400957,746,360,386,5,1.1,56.24,4.6,0,0,0,0,0,0,0.0108369864180391,9.22837171259741,1.29249000037988
8.7,"random_policy_SVM","SVM",74,22,1612,1604,8,2300,1909,391,0.926859516687262,0.657004830917874,1.7592199292059,747,360,387,1,1.1,58.79,4.9,0,0,0,0,0,0,0.0101826741647223,8.24043477018816,1.04357833242138
8.7,"random_policy_SVM","SVM",74,23,1512,1505,7,2400,2008,392,0.92812455978987,0.647342995169082,1.78534695785748,757,369,388,10,1.1,61.35,5.1,0,0,0,0,0,0,0.00719080986522708,5.50238707170654,0.853886549263359
8.7,"random_policy_SVM","SVM",74,24,1412,1405,7,2500,2108,392,0.928096938761429,0.647342995169082,1.78534695785748,758,369,389,1,1.1,63.91,5.4,0,0,0,0,0,0,0.00679202984141472,4.64918765900049,0.691273992532615
8.7,"random_policy_SVM","SVM",74,25,1312,1305,7,2600,2208,392,0.929066436859715,0.647342995169082,1.7820620508513,765,376,389,7,1,66.46,5.6,0,0,0,0,0,0,0.00511928907211205,3.31023737139284,0.572972392585841
8.7,"random_policy_SVM","SVM",74,26,1212,1205,7,2700,2308,392,0.929058150551183,0.647342995169082,1.78370299196626,771,376,395,6,1.1,69.02,5.9,0,0,0,0,0,0,0.00472171061748292,2.62915849148667,0.478786034997712
8.7,"random_policy_SVM","SVM",74,27,1112,1105,7,2800,2408,392,0.92970033946244,0.642512077294686,1.78042412617221,776,378,398,5,1.1,71.57,6.1,0,0,0,0,0,0,0.00397546537354507,2.02331734629148,0.439528425465441
8.7,"random_policy_SVM","SVM",74,28,1012,1005,7,2900,2508,392,0.929718293130927,0.642512077294686,1.77878920961925,774,378,396,-2,1,74.13,6.4,0,0,0,0,0,0,0.00351632428264787,1.51976278910945,0.372217955724773
8.7,"random_policy_SVM","SVM",74,29,912,906,6,3000,2607,393,0.929957215026945,0.642512077294686,1.78370299196626,778,380,398,4,1,76.69,6.6,0,0,0,0,0,0,0.00306476959608592,1.23134137608947,0.339502769279496
8.7,"random_policy_SVM","SVM",74,30,812,808,4,3100,2705,395,0.929903354021483,0.642512077294686,1.77878920961925,783,384,399,5,1,79.24,6.8,0,0,0,0,0,0,0.00255960642735583,0.926324568545195,0.287400019592398
8.7,"random_policy_SVM","SVM",74,31,712,708,4,3200,2805,395,0.92988816245584,0.642512077294686,1.78042412617221,784,384,400,1,1,81.8,7.1,0,0,0,0,0,0,0.00173498532066761,0.570210857842614,0.203408236364253
8.7,"random_policy_SVM","SVM",74,32,612,609,3,3300,2904,396,0.929861922478821,0.63768115942029,1.77878920961925,786,386,400,2,1,84.36,7.3,0,0,0,0,0,0,0.0016820637952845,0.534088336527589,0.204063785971373
8.7,"random_policy_SVM","SVM",74,33,512,509,3,3400,3004,396,0.930226520054247,0.63768115942029,1.7820620508513,796,388,408,10,1.1,86.91,7.6,0,0,0,0,0,0,0.000898683103817653,0.275065377561748,0.116982562160532
8.7,"random_policy_SVM","SVM",74,34,412,411,1,3500,3102,398,0.930831420577114,0.63768115942029,1.7820620508513,803,390,413,7,1.1,89.47,7.8,0,0,0,0,0,0,0.000925516225730627,0.269316217395158,0.116196638518819
8.7,"random_policy_SVM","SVM",74,35,312,312,0,3600,3201,399,0.93155509152228,0.63768115942029,1.77878920961925,809,393,416,6,1.1,92.02,8,0,0,0,0,0,0,0.000795343335710767,0.202836604010706,0.099882177740972
8.7,"random_policy_SVM","SVM",74,36,212,212,0,3700,3301,399,0.931762249235591,0.63768115942029,1.7820620508513,808,394,414,-1,1.1,94.58,8.3,0,0,0,0,0,0,0.000281007809358631,0.0588401045378975,0.0380297409153192
8.7,"random_policy_SVM","SVM",74,37,112,112,0,3800,3401,399,0.932103368936841,0.63768115942029,1.77390242607634,810,396,414,2,1,97.14,8.5,0,0,0,0,0,0,0.000153461060080962,0.0261498561324947,0.0245617506368143
8.7,"random_policy_SVM","SVM",74,38,12,12,0,3900,3501,399,0.932215234102027,0.63768115942029,1.77878920961925,812,396,416,2,1.1,99.69,8.8,0,0,0,0,0,0,9.76167242930991e-05,0.00136097884175312,0.00136097884175312
8.7,"random_policy_SVM","SVM",74,39,0,0,0,3912,3513,399,0.932249760387578,0.63768115942029,1.78370299196626,813,396,417,1,1.1,100,8.8,0,0,0,0,0,0,0,0,0
8.7,"random_policy_SVM","SVM",75,0,3812,3432,380,100,84,16,0.909376534118801,0.533333333333333,1.75337793519612,36,16,20,0,1.2,2.56,5.2,0,0,0,0,0,0,0.7498680792689,510.145312070324,79.0786785779939
8.7,"random_policy_SVM","SVM",75,1,3712,3407,305,200,109,91,0.920741286205208,0.557142857142857,1.76517282165856,91,46,45,55,1,5.11,1.2,0,0,0,0,0,0,0.759747799663769,325.330876813593,83.4994589201685
8.7,"random_policy_SVM","SVM",75,2,3612,3362,250,300,154,146,0.905866470299446,0.580952380952381,1.75125740618828,168,87,81,77,0.9,7.67,1.1,0,0,0,0,0,0,0.624484351152686,219.723751945891,76.7131426292848
8.7,"random_policy_SVM","SVM",75,3,3512,3310,202,400,206,194,0.884463808432875,0.604761904761905,1.71533806892923,267,136,131,99,1,10.22,1.1,0,0,0,0,0,0,0.372519886916618,187.026644662136,59.4990049036659
8.7,"random_policy_SVM","SVM",75,4,3412,3269,143,500,247,253,0.895827196858115,0.60952380952381,1.70205955660501,335,168,167,68,1,12.78,1,0,0,0,0,0,0,0.157229541179456,82.4295618176838,31.4079838773448
8.7,"random_policy_SVM","SVM",75,5,3312,3202,110,600,314,286,0.887637047946317,0.633333333333333,1.65074117801391,413,204,209,78,1,15.34,1.1,0,0,0,0,0,0,0.108083740494244,73.3518774426509,16.1287153818622
8.7,"random_policy_SVM","SVM",75,6,3212,3124,88,700,392,308,0.881650575465006,0.647619047619048,1.63107307439105,461,221,240,48,1.1,17.89,1.3,0,0,0,0,0,0,0.0760279896928792,70.652141419148,11.8081597042815
8.7,"random_policy_SVM","SVM",75,7,3112,3044,68,800,472,328,0.871753122784044,0.642857142857143,1.59526440410418,505,245,260,44,1.1,20.45,1.4,0,0,0,0,0,0,0.0658772767942713,96.7987141978784,11.3999954197102
8.7,"random_policy_SVM","SVM",75,8,3012,2950,62,900,566,334,0.886497027218685,0.638095238095238,1.64520962018662,521,252,269,16,1.1,23.01,1.7,0,0,0,0,0,0,0.0436051524361522,46.9833384958483,5.3947507987006
8.7,"random_policy_SVM","SVM",75,9,2912,2853,59,1000,663,337,0.885422462226583,0.638095238095238,1.63107307439105,527,256,271,6,1.1,25.56,2,0,0,0,0,0,0,0.041357192254222,50.1181150340511,4.66479440764512
8.7,"random_policy_SVM","SVM",75,10,2812,2757,55,1100,759,341,0.885477008672881,0.642857142857143,1.62508198871835,544,264,280,17,1.1,28.12,2.2,0,0,0,0,0,0,0.0349138055337262,44.6907969408316,3.98444065776106
8.7,"random_policy_SVM","SVM",75,11,2712,2663,49,1200,853,347,0.884729722358583,0.647619047619048,1.64824226464779,569,274,295,25,1.1,30.67,2.5,0,0,0,0,0,0,0.0386490647610492,43.562385560082,3.8990192621949
8.7,"random_policy_SVM","SVM",75,12,2612,2563,49,1300,953,347,0.914844815360281,0.628571428571429,1.71601414167867,610,301,309,41,1,33.23,2.7,0,0,0,0,0,0,0.0352718724774734,18.8480251643996,4.84622664389426
8.7,"random_policy_SVM","SVM",75,13,2512,2469,43,1400,1047,353,0.917828505972834,0.638095238095238,1.71916568280205,625,307,318,15,1,35.79,3,0,0,0,0,0,0,0.0245460296485659,15.5047411437013,3.04163468338151
8.7,"random_policy_SVM","SVM",75,14,2412,2376,36,1500,1140,360,0.92236131566029,0.633333333333333,1.74642857142857,646,317,329,21,1,38.34,3.2,0,0,0,0,0,0,0.0216897833647084,16.8444094189901,2.6514303117257
8.7,"random_policy_SVM","SVM",75,15,2312,2279,33,1600,1237,363,0.924627720504004,0.633333333333333,1.74803522144829,650,319,331,4,1,40.9,3.4,0,0,0,0,0,0,0.0178109541227573,15.4776432068911,2.04532267249051
8.7,"random_policy_SVM","SVM",75,16,2212,2186,26,1700,1330,370,0.927502318223977,0.642857142857143,1.76193099829463,667,326,341,17,1,43.46,3.6,0,0,0,0,0,0,0.0321868662855279,22.7811784935236,4.08995013857882
8.7,"random_policy_SVM","SVM",75,17,2112,2087,25,1800,1429,371,0.928158239240725,0.633333333333333,1.76885976408912,681,331,350,14,1.1,46.01,3.9,0,0,0,0,0,0,0.0247848639220275,15.8755250451587,2.77596953095413
8.7,"random_policy_SVM","SVM",75,18,2012,1992,20,1900,1524,376,0.928385970654024,0.638095238095238,1.7737416217637,697,340,357,16,1.1,48.57,4.1,0,0,0,0,0,0,0.0314017344906135,16.3412148315129,3.6800049354055
8.7,"random_policy_SVM","SVM",75,19,1912,1896,16,2000,1620,380,0.928639611629315,0.638095238095238,1.76885976408912,709,346,363,12,1,51.12,4.3,0,0,0,0,0,0,0.027165977037713,12.5976264152356,3.27813609536949
8.7,"random_policy_SVM","SVM",75,20,1812,1800,12,2100,1716,384,0.927417771232216,0.638095238095238,1.7770111915734,720,351,369,11,1.1,53.68,4.5,0,0,0,0,0,0,0.0205842224653097,10.8781972265896,2.97938472217149
8.7,"random_policy_SVM","SVM",75,21,1712,1705,7,2200,1811,389,0.925856379206905,0.642857142857143,1.76355042016807,733,357,376,13,1.1,56.24,4.7,0,0,0,0,0,0,0.0114135063092878,7.86311149378529,1.75601385311696
8.7,"random_policy_SVM","SVM",75,22,1612,1606,6,2300,1910,390,0.925640920744023,0.642857142857143,1.76031454783748,736,358,378,3,1.1,58.79,4.9,0,0,0,0,0,0,0.00990613623089524,6.88943708046015,1.11671332628406
8.7,"random_policy_SVM","SVM",75,23,1512,1506,6,2400,2010,390,0.925696830851479,0.638095238095238,1.7587010606259,737,358,379,1,1.1,61.35,5.2,0,0,0,0,0,0,0.007065628494865,5.0176248926132,0.773252708384458
8.7,"random_policy_SVM","SVM",75,24,1412,1407,5,2500,2109,391,0.92589047073584,0.642857142857143,1.76031454783748,743,361,382,6,1.1,63.91,5.4,0,0,0,0,0,0,0.00637814958645845,4.60398222817584,0.676813507438722
8.7,"random_policy_SVM","SVM",75,25,1312,1307,5,2600,2209,391,0.926152293678076,0.642857142857143,1.76355042016807,740,361,379,-3,1,66.46,5.6,0,0,0,0,0,0,0.00493161292907511,3.22916992640993,0.521066160733189
8.7,"random_policy_SVM","SVM",75,26,1212,1207,5,2700,2309,391,0.926660939289815,0.638095238095238,1.76679821099711,748,364,384,8,1.1,69.02,5.9,0,0,0,0,0,0,0.00389378134132317,2.28353906497237,0.414885263779984
8.7,"random_policy_SVM","SVM",75,27,1112,1108,4,2800,2408,392,0.926935035182467,0.638095238095238,1.76842659644503,749,366,383,1,1,71.57,6.1,0,0,0,0,0,0,0.00444539445316092,2.34543906249627,0.459063550207166
8.7,"random_policy_SVM","SVM",75,28,1012,1008,4,2900,2508,392,0.927068673975899,0.638095238095238,1.76517282165856,757,370,387,8,1,74.13,6.4,0,0,0,0,0,0,0.00372472301681671,1.71872315922859,0.398393189680354
8.7,"random_policy_SVM","SVM",75,29,912,909,3,3000,2607,393,0.927645502645511,0.633333333333333,1.76355042016807,766,374,392,9,1,76.69,6.6,0,0,0,0,0,0,0.00342461165652282,1.31695987064532,0.372872463183934
8.7,"random_policy_SVM","SVM",75,30,812,809,3,3100,2707,393,0.927723231331487,0.628571428571429,1.76193099829463,768,374,394,2,1.1,79.24,6.9,0,0,0,0,0,0,0.00256568784236921,0.864282757062642,0.290609982018962
8.7,"random_policy_SVM","SVM",75,31,712,710,2,3200,2806,394,0.92790459826543,0.628571428571429,1.76355042016807,772,375,397,4,1.1,81.8,7.1,0,0,0,0,0,0,0.00193422429141464,0.608359297557939,0.232942740613573
8.7,"random_policy_SVM","SVM",75,32,612,610,2,3300,2906,394,0.928181421480398,0.628571428571429,1.7587010606259,772,375,397,0,1.1,84.36,7.4,0,0,0,0,0,0,0.00109265858933179,0.345155506919824,0.139591830438802
8.7,"random_policy_SVM","SVM",75,33,512,511,1,3400,3005,395,0.928587792505328,0.638095238095238,1.76193099829463,775,376,399,3,1.1,86.91,7.6,0,0,0,0,0,0,0.000950483126161649,0.300899345106919,0.118668356099369
8.7,"random_policy_SVM","SVM",75,34,412,412,0,3500,3104,396,0.929318714885741,0.638095238095238,1.7587010606259,781,380,401,6,1.1,89.47,7.8,0,0,0,0,0,0,0.000850652851931247,0.24210524695808,0.100350390234659
8.7,"random_policy_SVM","SVM",75,35,312,312,0,3600,3204,396,0.929774177712341,0.633333333333333,1.76355042016807,785,382,403,4,1.1,92.02,8.1,0,0,0,0,0,0,0.000413396656936874,0.100236488721335,0.0513343367081638
8.7,"random_policy_SVM","SVM",75,36,212,212,0,3700,3304,396,0.929812360224751,0.628571428571429,1.76193099829463,787,383,404,2,1.1,94.58,8.3,0,0,0,0,0,0,0.00025507266188923,0.0547969848808533,0.0346077418429027
8.7,"random_policy_SVM","SVM",75,37,112,112,0,3800,3404,396,0.929782359679287,0.628571428571429,1.76031454783748,789,384,405,2,1.1,97.14,8.6,0,0,0,0,0,0,0.000126459831861356,0.0208660116901696,0.0194898884624705
8.7,"random_policy_SVM","SVM",75,38,12,12,0,3900,3504,396,0.929954180985128,0.628571428571429,1.76031454783748,789,385,404,0,1,99.69,8.8,0,0,0,0,0,0,0.000103183182675419,0.00138273340305508,0.00138273340305508
8.7,"random_policy_SVM","SVM",75,39,0,0,0,3912,3516,396,0.930090547100876,0.628571428571429,1.76517282165856,790,385,405,1,1.1,100,8.9,0,0,0,0,0,0,0,0,0
8.7,"random_policy_SVM","SVM",76,0,3812,3420,392,100,87,13,0.900001417414346,0.537313432835821,1.73200054772012,30,13,17,0,1.3,2.56,6.7,0,0,0,0,0,0,0.610335393897266,482.475797991788,66.8645845410798
8.7,"random_policy_SVM","SVM",76,1,3712,3373,339,200,134,66,0.875108786551566,0.517412935323383,1.71257370343516,113,55,58,83,1.1,5.11,2,0,0,0,0,0,0,0.685299437823776,440.447204106068,77.4348493868025
8.7,"random_policy_SVM","SVM",76,2,3612,3325,287,300,182,118,0.891635837904504,0.611940298507463,1.72465496210408,175,87,88,62,1,7.67,1.5,0,0,0,0,0,0,0.625285354691636,327.495810771843,74.5785551097383
8.7,"random_policy_SVM","SVM",76,3,3512,3285,227,400,222,178,0.897554960241534,0.621890547263682,1.72782820030482,251,125,126,76,1,10.22,1.2,0,0,0,0,0,0,0.441935829542893,194.089238753009,65.4489805321648
8.7,"random_policy_SVM","SVM",76,4,3412,3242,170,500,265,235,0.886925770010354,0.621890547263682,1.68461559605288,328,163,165,77,1,12.78,1.1,0,0,0,0,0,0,0.277122406945776,186.692296742416,43.3882870660962
8.7,"random_policy_SVM","SVM",76,5,3312,3183,129,600,324,276,0.873699876684946,0.621890547263682,1.6413233372309,405,199,206,77,1,15.34,1.2,0,0,0,0,0,0,0.13441322153156,90.6486593703885,21.6296456470136
8.7,"random_policy_SVM","SVM",76,6,3212,3116,96,700,391,309,0.878794063868681,0.63681592039801,1.63235435724603,470,228,242,65,1.1,17.89,1.3,0,0,0,0,0,0,0.098934391406082,97.1016518204099,13.8030284365494
8.7,"random_policy_SVM","SVM",76,7,3112,3046,66,800,461,339,0.873793426032227,0.651741293532338,1.59647843730655,549,265,284,79,1.1,20.45,1.4,0,0,0,0,0,0,0.112721771905068,166.206905268714,17.9511235242495
8.7,"random_policy_SVM","SVM",76,8,3012,2957,55,900,550,350,0.894425309350695,0.671641791044776,1.64423063744638,577,278,299,28,1.1,23.01,1.6,0,0,0,0,0,0,0.0758186426166848,90.5819975681385,9.69190426566084
8.7,"random_policy_SVM","SVM",76,9,2912,2861,51,1000,646,354,0.89954642740713,0.656716417910448,1.66950568259619,589,282,307,12,1.1,25.56,1.8,0,0,0,0,0,0,0.0554879237186909,70.3825852813298,6.22406967412222
8.7,"random_policy_SVM","SVM",76,10,2812,2770,42,1100,737,363,0.90164561806354,0.656716417910448,1.67997478173869,614,293,321,25,1.1,28.12,2,0,0,0,0,0,0,0.048344109278269,70.9901812024978,5.38755137798228
8.7,"random_policy_SVM","SVM",76,11,2712,2674,38,1200,833,367,0.917237175943659,0.626865671641791,1.73998211706445,629,305,324,15,1.1,30.67,2.3,0,0,0,0,0,0,0.0433985841702977,55.0228370874582,5.11355520418589
8.7,"random_policy_SVM","SVM",76,12,2612,2578,34,1300,929,371,0.923720429193068,0.631840796019901,1.73837992358649,645,312,333,16,1.1,33.23,2.5,0,0,0,0,0,0,0.0456891726286994,48.9095074308694,5.25061380618117
8.7,"random_policy_SVM","SVM",76,13,2512,2481,31,1400,1026,374,0.925018780740172,0.631840796019901,1.72465496210408,657,315,342,12,1.1,35.79,2.7,0,0,0,0,0,0,0.0464577594027226,46.1877463447634,5.21222830272854
8.7,"random_policy_SVM","SVM",76,14,2412,2382,30,1500,1125,375,0.925208714263437,0.631840796019901,1.72782820030482,659,317,342,2,1.1,38.34,3,0,0,0,0,0,0,0.0355137774085728,35.3109041687936,3.9218862615246
8.7,"random_policy_SVM","SVM",76,15,2312,2286,26,1600,1221,379,0.925358960184822,0.631840796019901,1.73678067802661,668,321,347,9,1.1,40.9,3.2,0,0,0,0,0,0,0.033260061195317,31.5988725547665,4.03771596196047
8.7,"random_policy_SVM","SVM",76,16,2212,2194,18,1700,1313,387,0.926378081104439,0.63681592039801,1.73837992358649,689,331,358,21,1.1,43.46,3.4,0,0,0,0,0,0,0.0346372500436617,32.383274108079,4.42159442252286
8.7,"random_policy_SVM","SVM",76,17,2112,2101,11,1800,1406,394,0.92763532763532,0.631840796019901,1.73998211706445,707,339,368,18,1.1,46.01,3.6,0,0,0,0,0,0,0.0282030157644849,27.9846745717499,3.52186597987728
8.7,"random_policy_SVM","SVM",76,18,2012,2002,10,1900,1505,395,0.927658006264963,0.63681592039801,1.73998211706445,713,342,371,6,1.1,48.57,3.8,0,0,0,0,0,0,0.0229349484684717,23.3753685084189,2.49078364012134
8.7,"random_policy_SVM","SVM",76,19,1912,1903,9,2000,1604,396,0.92723845161655,0.641791044776119,1.73518437225637,716,345,371,3,1.1,51.12,4.1,0,0,0,0,0,0,0.0204416431697535,21.306563040197,2.21549747846446
8.7,"random_policy_SVM","SVM",76,20,1812,1803,9,2100,1704,396,0.926804722824611,0.641791044776119,1.73678067802661,718,345,373,2,1.1,53.68,4.3,0,0,0,0,0,0,0.0177693556449576,16.6734891428797,1.78899197154568
8.7,"random_policy_SVM","SVM",76,21,1712,1703,9,2200,1804,396,0.926164051537173,0.621890547263682,1.77585803700392,742,361,381,24,1.1,56.24,4.6,0,0,0,0,0,0,0.0126906891890095,7.97764306024033,1.58497260839143
8.7,"random_policy_SVM","SVM",76,22,1612,1605,7,2300,1902,398,0.926339810916911,0.621890547263682,1.77585803700392,745,363,382,3,1.1,58.79,4.8,0,0,0,0,0,0,0.009224828588158,6.76947125038075,1.10096511413459
8.7,"random_policy_SVM","SVM",76,23,1512,1507,5,2400,2000,400,0.927013082734461,0.626865671641791,1.77422280860889,755,367,388,10,1.1,61.35,5,0,0,0,0,0,0,0.00789966216986509,6.39471435162523,0.911042104352083
8.7,"random_policy_SVM","SVM",76,24,1412,1407,5,2500,2100,400,0.927134980368797,0.621890547263682,1.77422280860889,755,367,388,0,1.1,63.91,5.2,0,0,0,0,0,0,0.00698535238740032,4.99503371745063,0.706206497014352
8.7,"random_policy_SVM","SVM",76,25,1312,1307,5,2600,2200,400,0.927887627390099,0.621890547263682,1.77585803700392,770,377,393,15,1,66.46,5.5,0,0,0,0,0,0,0.00422460748525759,2.60326135072774,0.523984520229847
8.7,"random_policy_SVM","SVM",76,26,1212,1209,3,2700,2298,402,0.927893297047508,0.616915422885572,1.77585803700392,777,379,398,7,1.1,69.02,5.7,0,0,0,0,0,0,0.00402537077034501,2.61263986710368,0.446561105289002
8.7,"random_policy_SVM","SVM",76,27,1112,1110,2,2800,2397,403,0.928392226899668,0.616915422885572,1.77585803700392,782,380,402,5,1.1,71.57,5.9,0,0,0,0,0,0,0.00392639866843804,2.25937882335879,0.403170940975974
8.7,"random_policy_SVM","SVM",76,28,1012,1010,2,2900,2497,403,0.928531133506236,0.616915422885572,1.77259058891376,784,384,400,2,1,74.13,6.2,0,0,0,0,0,0,0.0029736827374107,1.49781294416856,0.321908810905845
8.7,"random_policy_SVM","SVM",76,29,912,910,2,3000,2597,403,0.928650196311867,0.616915422885572,1.77585803700392,785,384,401,1,1,76.69,6.4,0,0,0,0,0,0,0.00291484760698244,1.26259340040469,0.306252234547621
8.7,"random_policy_SVM","SVM",76,30,812,810,2,3100,2697,403,0.928752250145265,0.616915422885572,1.77096136962248,791,387,404,6,1,79.24,6.7,0,0,0,0,0,0,0.0022678731251355,0.847902659004052,0.247059381133418
8.7,"random_policy_SVM","SVM",76,31,712,710,2,3200,2797,403,0.92869271874245,0.616915422885572,1.77096136962248,792,388,404,1,1,81.8,6.9,0,0,0,0,0,0,0.00178769315790427,0.591938778751599,0.200950449140208
8.7,"random_policy_SVM","SVM",76,32,612,610,2,3300,2897,403,0.928684214256335,0.616915422885572,1.77585803700392,791,388,403,-1,1,84.36,7.2,0,0,0,0,0,0,0.00122272278185966,0.386301563445256,0.150978809830832
8.7,"random_policy_SVM","SVM",76,33,512,510,2,3400,2997,403,0.928806111890673,0.616915422885572,1.77259058891376,790,388,402,-1,1,86.91,7.4,0,0,0,0,0,0,0.000766240465788001,0.231914790614083,0.095006593445388
8.7,"random_policy_SVM","SVM",76,34,412,412,0,3500,3095,405,0.929344729344721,0.606965174129353,1.77096136962248,799,392,407,9,1,89.47,7.6,0,0,0,0,0,0,0.00082855887465069,0.253219668563371,0.103381653769032
8.7,"random_policy_SVM","SVM",76,35,312,312,0,3600,3195,405,0.929693413275506,0.606965174129353,1.76363811119197,806,393,413,7,1.1,92.02,7.9,0,0,0,0,0,0,0.000574504530408806,0.151066152129672,0.0694328442769784
8.7,"random_policy_SVM","SVM",76,36,212,212,0,3700,3295,405,0.929877677141365,0.606965174129353,1.76363811119197,808,396,412,2,1,94.58,8.1,0,0,0,0,0,0,0.000257069289878917,0.0523457836046492,0.0321470435424009
8.7,"random_policy_SVM","SVM",76,37,112,112,0,3800,3395,405,0.930064775835928,0.601990049751244,1.76201712028095,810,396,414,2,1,97.14,8.4,0,0,0,0,0,0,0.000109510725955446,0.0185002047435196,0.0173805983166785
8.7,"random_policy_SVM","SVM",76,38,12,12,0,3900,3495,405,0.930005244433114,0.601990049751244,1.76688905701905,813,398,415,3,1,99.69,8.6,0,0,0,0,0,0,7.78504219807731e-05,0.00107355323917413,0.00107355323917413
8.7,"random_policy_SVM","SVM",76,39,0,0,0,3912,3507,405,0.929983983217822,0.601990049751244,1.76201712028095,812,398,414,-1,1,100,8.7,0,0,0,0,0,0,0,0,0
8.7,"random_policy_SVM","SVM",77,0,3812,3414,398,100,90,10,0.881574562461925,0.53030303030303,1.74813573523251,29,10,19,0,1.9,2.56,9,0,0,0,0,0,0,0.388231885193586,403.134624519562,47.0793730155116
8.7,"random_policy_SVM","SVM",77,1,3712,3362,350,200,142,58,0.912661886211365,0.616161616161616,1.76147504456328,116,56,60,87,1.1,5.11,2.4,0,0,0,0,0,0,0.637618792278906,499.235838022694,69.4258960293758
8.7,"random_policy_SVM","SVM",77,2,3612,3325,287,300,179,121,0.906554165086593,0.636363636363636,1.71135738688443,189,95,94,73,1,7.67,1.5,0,0,0,0,0,0,0.627668759091992,312.321658859511,75.5826518990862
8.7,"random_policy_SVM","SVM",77,3,3512,3282,230,400,222,178,0.888038519437822,0.616161616161616,1.68440161988549,253,129,124,64,1,10.22,1.2,0,0,0,0,0,0,0.409446003750665,220.80148134773,63.8378559651443
8.7,"random_policy_SVM","SVM",77,4,3412,3235,177,500,269,231,0.897789039427257,0.646464646464647,1.67529674626449,325,162,163,72,1,12.78,1.2,0,0,0,0,0,0,0.241057005434935,173.719182962271,39.2811656832439
8.7,"random_policy_SVM","SVM",77,5,3312,3184,128,600,320,280,0.914799301318088,0.651515151515151,1.74331550802139,418,206,212,93,1,15.34,1.1,0,0,0,0,0,0,0.186638669780297,164.893540111704,30.3603326193786
8.7,"random_policy_SVM","SVM",77,6,3212,3113,99,700,391,309,0.885643982486993,0.661616161616162,1.61619875222816,486,237,249,68,1.1,17.89,1.3,0,0,0,0,0,0,0.142256186087103,186.742729484902,19.1670089398436
8.7,"random_policy_SVM","SVM",77,7,3112,3037,75,800,467,333,0.894651865641627,0.681818181818182,1.63736815670517,537,258,279,51,1.1,20.45,1.4,0,0,0,0,0,0,0.107729721136879,166.450895465745,13.9653288108833
8.7,"random_policy_SVM","SVM",77,8,3012,2959,53,900,545,355,0.897880971259823,0.686868686868687,1.63586183825374,585,280,305,48,1.1,23.01,1.5,0,0,0,0,0,0,0.0926379978154542,153.658282325502,10.8939326041525
8.7,"random_policy_SVM","SVM",77,9,2912,2864,48,1000,640,360,0.906740901621448,0.666666666666667,1.65403808090101,611,291,320,26,1.1,25.56,1.8,0,0,0,0,0,0,0.0748734972838519,117.251214297426,8.29424720029023
8.7,"random_policy_SVM","SVM",77,10,2812,2772,40,1100,732,368,0.910643695200005,0.671717171717172,1.67375411574307,629,304,325,18,1.1,28.12,2,0,0,0,0,0,0,0.0666905150753516,102.984191802536,7.38460671045341
8.7,"random_policy_SVM","SVM",77,11,2712,2680,32,1200,824,376,0.919688925661625,0.656565656565657,1.7208211143695,654,313,341,25,1.1,30.67,2.2,0,0,0,0,0,0,0.0645820717164548,90.1574107036487,7.11963473610211
8.7,"random_policy_SVM","SVM",77,12,2612,2582,30,1300,922,378,0.924015467530821,0.651515151515151,1.7283330542999,658,317,341,4,1.1,33.23,2.4,0,0,0,0,0,0,0.0524001943211421,68.0549390847391,5.75265566312304
8.7,"random_policy_SVM","SVM",77,13,2512,2483,29,1400,1021,379,0.925882832879411,0.651515151515151,1.7299259879905,662,320,342,4,1.1,35.79,2.7,0,0,0,0,0,0,0.0450040348235959,57.4789311711618,4.79754623890888
8.7,"random_policy_SVM","SVM",77,14,2412,2385,27,1500,1119,381,0.92840808540465,0.661616161616162,1.73742954405938,665,323,342,3,1.1,38.34,2.9,0,0,0,0,0,0,0.0411924741099374,50.2829919620271,4.48086309434519
8.7,"random_policy_SVM","SVM",77,15,2312,2290,22,1600,1214,386,0.931036761241513,0.656565656565657,1.75724060885351,684,329,355,19,1.1,40.9,3.1,0,0,0,0,0,0,0.038378490456214,45.9107986126377,4.5429304757694
8.7,"random_policy_SVM","SVM",77,16,2212,2198,14,1700,1306,394,0.933481573413284,0.646464646464647,1.75724060885351,713,340,373,29,1.1,43.46,3.3,0,0,0,0,0,0,0.039020487575822,45.6860487525953,4.56329022705444
8.7,"random_policy_SVM","SVM",77,17,2112,2100,12,1800,1404,396,0.934067638845766,0.646464646464647,1.75724060885351,719,342,377,6,1.1,46.01,3.5,0,0,0,0,0,0,0.0353258445498527,38.1197579000609,3.62492784406803
8.7,"random_policy_SVM","SVM",77,18,2012,2000,12,1900,1504,396,0.932682915618049,0.631313131313131,1.76309553678459,732,355,377,13,1.1,48.57,3.8,0,0,0,0,0,0,0.025020172591234,20.7623192329239,3.18379567422976
8.7,"random_policy_SVM","SVM",77,19,1912,1901,11,2000,1603,397,0.93303340572963,0.631313131313131,1.76309553678459,735,356,379,3,1.1,51.12,4,0,0,0,0,0,0,0.0181985092826344,17.0897231665053,2.12444330239577
8.7,"random_policy_SVM","SVM",77,20,1812,1804,8,2100,1700,400,0.932780593190127,0.636363636363636,1.76634548247451,742,359,383,7,1.1,53.68,4.2,0,0,0,0,0,0,0.0175473807456522,15.2760514632098,1.77926506759219
8.7,"random_policy_SVM","SVM",77,21,1712,1704,8,2200,1800,400,0.93122062490661,0.621212121212121,1.75663139182846,767,371,396,25,1.1,56.24,4.5,0,0,0,0,0,0,0.0137631842514749,9.50650362954967,1.69643343735412
8.7,"random_policy_SVM","SVM",77,22,1612,1607,5,2300,1897,403,0.931048252720584,0.621212121212121,1.76309553678459,776,375,401,9,1.1,58.79,4.7,0,0,0,0,0,0,0.0113682190486517,8.94573438233605,1.30366929618715
8.7,"random_policy_SVM","SVM",77,23,1512,1509,3,2400,1995,405,0.930890244883395,0.621212121212121,1.76309553678459,782,379,403,6,1.1,61.35,4.9,0,0,0,0,0,0,0.0112209525724353,8.59079234647902,1.1627129139674
8.7,"random_policy_SVM","SVM",77,24,1412,1409,3,2500,2095,405,0.930931901495019,0.616161616161616,1.76147504456328,788,381,407,6,1.1,63.91,5.2,0,0,0,0,0,0,0.00813399598604565,5.8693609609274,0.910781074774183
8.7,"random_policy_SVM","SVM",77,25,1312,1309,3,2600,2195,405,0.930865825490377,0.621212121212121,1.75824298026133,788,381,407,0,1.1,66.46,5.4,0,0,0,0,0,0,0.00713608739645129,4.6413685574419,0.736741276541123
8.7,"random_policy_SVM","SVM",77,26,1212,1209,3,2700,2295,405,0.930842842532241,0.626262626262626,1.7647190133378,789,384,405,1,1.1,69.02,5.7,0,0,0,0,0,0,0.00532066045953734,3.11969414193255,0.58380679592401
8.7,"random_policy_SVM","SVM",77,27,1112,1109,3,2800,2395,405,0.930962066627575,0.626262626262626,1.76634548247451,790,384,406,1,1.1,71.57,5.9,0,0,0,0,0,0,0.00533025696228405,2.82865412442473,0.55324675102565
8.7,"random_policy_SVM","SVM",77,28,1012,1010,2,2900,2494,406,0.930752347134579,0.631313131313131,1.76147504456328,791,386,405,1,1,74.13,6.1,0,0,0,0,0,0,0.00474550522854483,2.24383671709359,0.50094870005363
8.7,"random_policy_SVM","SVM",77,29,912,911,1,3000,2593,407,0.930730800611327,0.631313131313131,1.7647190133378,798,388,410,7,1.1,76.69,6.4,0,0,0,0,0,0,0.00425305412302511,1.80931872714781,0.452792311317635
8.7,"random_policy_SVM","SVM",77,30,812,811,1,3100,2693,407,0.930783948702018,0.626262626262626,1.76147504456328,797,389,408,-1,1,79.24,6.6,0,0,0,0,0,0,0.00335844035415853,1.28745139476891,0.369762789656872
8.7,"random_policy_SVM","SVM",77,31,712,712,0,3200,2792,408,0.930792567311319,0.631313131313131,1.76309553678459,803,391,412,6,1.1,81.8,6.8,0,0,0,0,0,0,0.00275954009722186,0.998320866647356,0.314203080250573
8.7,"random_policy_SVM","SVM",77,32,612,612,0,3300,2892,408,0.93093908366944,0.636363636363636,1.76309553678459,805,391,414,2,1.1,84.36,7.1,0,0,0,0,0,0,0.00219791616253382,0.7410331048064,0.256540651830354
8.7,"random_policy_SVM","SVM",77,33,512,512,0,3400,2992,408,0.930893117753167,0.631313131313131,1.76147504456328,806,391,415,1,1.1,86.91,7.3,0,0,0,0,0,0,0.00123737221187495,0.416295031608235,0.157631461700865
8.7,"random_policy_SVM","SVM",77,34,412,412,0,3500,3092,408,0.930913227841537,0.626262626262626,1.76309553678459,807,392,415,1,1.1,89.47,7.6,0,0,0,0,0,0,0.000807537718176265,0.237023248740189,0.0968087433689141
8.7,"random_policy_SVM","SVM",77,35,312,312,0,3600,3192,408,0.930913227841537,0.621212121212121,1.7647190133378,810,394,416,3,1.1,92.02,7.8,0,0,0,0,0,0,0.000570429845886859,0.145025057595553,0.0696565795255404
8.7,"random_policy_SVM","SVM",77,36,212,212,0,3700,3292,408,0.931059744199659,0.631313131313131,1.75985752845257,812,396,416,2,1.1,94.58,8.1,0,0,0,0,0,0,0.000354212639242587,0.0741606592407599,0.0461753321768875
8.7,"random_policy_SVM","SVM",77,37,112,112,0,3800,3392,408,0.931209133427547,0.631313131313131,1.76147504456328,814,396,418,2,1.1,97.14,8.3,0,0,0,0,0,0,0.000140676818122039,0.0235190673135555,0.0220292736687438
8.7,"random_policy_SVM","SVM",77,38,12,12,0,3900,3492,408,0.931482056055418,0.626262626262626,1.7647190133378,816,398,418,2,1.1,99.69,8.6,0,0,0,0,0,0,9.60888113209711e-05,0.00133133167634954,0.00133133167634954
8.7,"random_policy_SVM","SVM",77,39,0,0,0,3912,3504,408,0.931573987887964,0.626262626262626,1.76309553678459,816,398,418,0,1.1,100,8.6,0,0,0,0,0,0,0,0,0
8.7,"random_policy_SVM","SVM",78,0,3812,3421,391,100,90,10,0.912970985220989,0.565853658536585,1.76499597963013,24,10,14,0,1.4,2.56,9,0,0,0,0,0,0,0.845574334713019,544.426383824792,87.6373931145661
8.7,"random_policy_SVM","SVM",78,1,3712,3364,348,200,147,53,0.909437116073051,0.565853658536585,1.74517575322812,87,42,45,63,1.1,5.11,2.8,0,0,0,0,0,0,0.659490969807525,243.70780003873,75.2569440857637
8.7,"random_policy_SVM","SVM",78,2,3612,3330,282,300,181,119,0.903526904486646,0.575609756097561,1.7396038269775,161,80,81,74,1,7.67,1.5,0,0,0,0,0,0,0.550576062280003,213.505397764771,70.2918370088805
8.7,"random_policy_SVM","SVM",78,3,3512,3283,229,400,228,172,0.903219066456811,0.580487804878049,1.72922566024188,232,115,117,71,1,10.22,1.3,0,0,0,0,0,0,0.3178648888731,143.443606218932,55.6068263588743
8.7,"random_policy_SVM","SVM",78,4,3412,3238,174,500,273,227,0.903962892284559,0.595121951219512,1.71886657101865,307,153,154,75,1,12.78,1.2,0,0,0,0,0,0,0.182425555364088,90.8987436023368,30.8735304349574
8.7,"random_policy_SVM","SVM",78,5,3312,3175,137,600,336,264,0.884824003008748,0.614634146341463,1.64144770794534,376,183,193,69,1.1,15.34,1.3,0,0,0,0,0,0,0.110747948599622,61.7007896582337,19.0829186857178
8.7,"random_policy_SVM","SVM",78,6,3212,3100,112,700,411,289,0.893433717318339,0.629268292682927,1.65174504783722,423,202,221,47,1.1,17.89,1.4,0,0,0,0,0,0,0.0756013433924159,50.318395200914,11.1573871814046
8.7,"random_policy_SVM","SVM",78,7,3112,3020,92,800,491,309,0.897416110654544,0.639024390243902,1.66206136900079,472,225,247,49,1.1,20.45,1.6,0,0,0,0,0,0,0.0608115258727073,60.076800722792,8.67712423200677
8.7,"random_policy_SVM","SVM",78,8,3012,2940,72,900,571,329,0.890359515816751,0.639024390243902,1.64447341800607,520,246,274,48,1.1,23.01,1.7,0,0,0,0,0,0,0.0663148903507604,102.215369294313,9.85847144840618
8.7,"random_policy_SVM","SVM",78,9,2912,2850,62,1000,661,339,0.910504102185536,0.629268292682927,1.69976483235907,544,260,284,24,1.1,25.56,1.9,0,0,0,0,0,0,0.0484830293227885,71.3402780479912,6.02979835861645
8.7,"random_policy_SVM","SVM",78,10,2812,2763,49,1100,748,352,0.924812302377756,0.639024390243902,1.72203207114944,577,279,298,33,1.1,28.12,2.1,0,0,0,0,0,0,0.0603889318034208,89.4088039866266,6.9924313732477
8.7,"random_policy_SVM","SVM",78,11,2712,2668,44,1200,843,357,0.930743407948085,0.639024390243902,1.72604985553988,606,292,314,29,1.1,30.67,2.4,0,0,0,0,0,0,0.0456594197430102,60.2226610127818,5.41085960081369
8.7,"random_policy_SVM","SVM",78,12,2612,2576,36,1300,935,365,0.935760749954733,0.639024390243902,1.74678125070119,632,303,329,26,1.1,33.23,2.6,0,0,0,0,0,0,0.0470202363769843,57.4297487756132,5.28368314938712
8.7,"random_policy_SVM","SVM",78,13,2512,2481,31,1400,1030,370,0.942150130239174,0.629268292682927,1.77474733863361,648,311,337,16,1.1,35.79,2.8,0,0,0,0,0,0,0.0598764922158441,55.2839214818927,6.51094134114399
8.7,"random_policy_SVM","SVM",78,14,2412,2384,28,1500,1127,373,0.943190650638666,0.634146341463415,1.78189243161981,660,315,345,12,1.1,38.34,3,0,0,0,0,0,0,0.0571413509138974,50.8905476565292,6.42327216083871
8.7,"random_policy_SVM","SVM",78,15,2312,2289,23,1600,1222,378,0.944987533256262,0.634146341463415,1.79397100146117,672,322,350,12,1.1,40.9,3.2,0,0,0,0,0,0,0.0435862683279452,38.1374119987338,5.20196357395081
8.7,"random_policy_SVM","SVM",78,16,2212,2195,17,1700,1316,384,0.945149113398621,0.64390243902439,1.79231909446166,689,329,360,17,1.1,43.46,3.4,0,0,0,0,0,0,0.0327818831599131,32.8580084446379,4.28434239621159
8.7,"random_policy_SVM","SVM",78,17,2112,2096,16,1800,1415,385,0.945268905573128,0.64390243902439,1.78517702596381,691,331,360,2,1.1,46.01,3.7,0,0,0,0,0,0,0.0282848606480178,29.2145326364127,2.93683686028497
8.7,"random_policy_SVM","SVM",78,18,2012,1996,16,1900,1515,385,0.943446950174817,0.639024390243902,1.79231909446166,718,347,371,27,1.1,48.57,3.9,0,0,0,0,0,0,0.0192846748605301,14.6867975739856,2.5625325083427
8.7,"random_policy_SVM","SVM",78,19,1912,1898,14,2000,1613,387,0.943573707010632,0.639024390243902,1.79231909446166,722,348,374,4,1.1,51.12,4.2,0,0,0,0,0,0,0.0125806246801257,10.8707890130662,1.45145827776322
8.7,"random_policy_SVM","SVM",78,20,1812,1800,12,2100,1711,389,0.943105681770699,0.639024390243902,1.79231909446166,724,350,374,2,1.1,53.68,4.4,0,0,0,0,0,0,0.0120219254321358,11.2682035036228,1.31620976403215
8.7,"random_policy_SVM","SVM",78,21,1712,1701,11,2200,1810,390,0.942934351102509,0.634146341463415,1.79397100146117,728,353,375,4,1.1,56.24,4.6,0,0,0,0,0,0,0.0104302111501174,9.07433429222951,1.08560461992753
8.7,"random_policy_SVM","SVM",78,22,1612,1603,9,2300,1908,392,0.941434163056654,0.639024390243902,1.79231909446166,748,363,385,20,1.1,58.79,4.9,0,0,0,0,0,0,0.0081989641790776,6.93529085883257,0.930009499378413
8.7,"random_policy_SVM","SVM",78,23,1512,1504,8,2400,2007,393,0.94205123204859,0.634146341463415,1.79067022684946,747,365,382,-1,1,61.35,5.1,0,0,0,0,0,0,0.00773004878961665,6.07293552577763,0.796765631068217
8.7,"random_policy_SVM","SVM",78,24,1412,1404,8,2500,2107,393,0.941505202602002,0.629268292682927,1.79231909446166,757,368,389,10,1.1,63.91,5.4,0,0,0,0,0,0,0.00692489761472458,5.03827978525874,0.77280405739569
8.7,"random_policy_SVM","SVM",78,25,1312,1306,6,2600,2205,395,0.941981585435504,0.634146341463415,1.78410498312133,762,372,390,5,1,66.46,5.6,0,0,0,0,0,0,0.00599622290210363,3.94695563436789,0.619880485160636
8.7,"random_policy_SVM","SVM",78,26,1212,1206,6,2700,2305,395,0.941828362886717,0.639024390243902,1.78410498312133,766,373,393,4,1.1,69.02,5.8,0,0,0,0,0,0,0.00511068071235969,3.096012081439,0.559896020949631
8.7,"random_policy_SVM","SVM",78,27,1112,1107,5,2800,2404,396,0.9418799013804,0.629268292682927,1.7890243902439,768,374,394,2,1.1,71.57,6.1,0,0,0,0,0,0,0.00500450671720655,2.71427297035236,0.521608919459339
8.7,"random_policy_SVM","SVM",78,28,1012,1007,5,2900,2504,396,0.941427198395346,0.624390243902439,1.7873815762951,770,376,394,2,1,74.13,6.3,0,0,0,0,0,0,0.00395849814769181,1.93935085085443,0.433137097078999
8.7,"random_policy_SVM","SVM",78,29,912,907,5,3000,2604,396,0.941623601844246,0.624390243902439,1.7890243902439,769,376,393,-1,1,76.69,6.6,0,0,0,0,0,0,0.00368786515112046,1.57480286404021,0.392736378149545
8.7,"random_policy_SVM","SVM",78,30,812,807,5,3100,2704,396,0.941435555988916,0.629268292682927,1.7873815762951,772,378,394,3,1,79.24,6.8,0,0,0,0,0,0,0.00277266695521803,1.01453531552443,0.300226107529835
8.7,"random_policy_SVM","SVM",78,31,712,708,4,3200,2803,397,0.941615244250676,0.629268292682927,1.79231909446166,780,380,400,8,1.1,81.8,7.1,0,0,0,0,0,0,0.0023482389139956,0.810276963850038,0.268093862290142
8.7,"random_policy_SVM","SVM",78,32,612,609,3,3300,2902,398,0.941838113412549,0.624390243902439,1.79231909446166,783,382,401,3,1,84.36,7.3,0,0,0,0,0,0,0.00176771206620105,0.564117844733702,0.207036740414437
8.7,"random_policy_SVM","SVM",78,33,512,509,3,3400,3002,398,0.941996907690383,0.629268292682927,1.7890243902439,784,382,402,1,1.1,86.91,7.5,0,0,0,0,0,0,0.00128348291655944,0.385759988326859,0.157138573438701
8.7,"random_policy_SVM","SVM",78,34,412,409,3,3500,3102,398,0.94228106587177,0.624390243902439,1.7890243902439,783,382,401,-1,1,89.47,7.8,0,0,0,0,0,0,0.000721363747004173,0.20795217827659,0.0943018579624466
8.7,"random_policy_SVM","SVM",78,35,312,312,0,3600,3199,401,0.94264183532755,0.629268292682927,1.78410498312133,801,391,410,18,1,92.02,8,0,0,0,0,0,0,0.00107166206456497,0.278071512311259,0.14357562473329
8.7,"random_policy_SVM","SVM",78,36,212,212,0,3700,3299,401,0.942559652324109,0.624390243902439,1.7890243902439,802,391,411,1,1.1,94.58,8.2,0,0,0,0,0,0,0.000491105089359699,0.104024096106879,0.0645937146007995
8.7,"random_policy_SVM","SVM",78,37,112,112,0,3800,3399,401,0.942448217743172,0.624390243902439,1.7890243902439,806,393,413,4,1.1,97.14,8.5,0,0,0,0,0,0,0.000229879125168091,0.0370988900878082,0.0346671351811836
8.7,"random_policy_SVM","SVM",78,38,12,12,0,3900,3499,401,0.942400858046274,0.624390243902439,1.78574177668382,806,393,413,0,1.1,99.69,8.7,0,0,0,0,0,0,0.000152905640318267,0.0020946882500618,0.0020946882500618
8.7,"random_policy_SVM","SVM",78,39,0,0,0,3912,3511,401,0.942320067975095,0.624390243902439,1.7890243902439,807,393,414,1,1.1,100,8.8,0,0,0,0,0,0,0,0,0
8.7,"random_policy_SVM","SVM",79,0,3812,3413,399,100,93,7,0.851551822323469,0.51,1.67657142857143,35,7,28,0,4,2.56,13.3,0,0,0,0,0,0,0.0773896274652111,271.728453024796,7.99710967937972
8.7,"random_policy_SVM","SVM",79,1,3712,3352,360,200,154,46,0.902945615034186,0.57,1.73487132352941,94,44,50,59,1.1,5.11,3.3,0,0,0,0,0,0,0.534545002718753,434.919466365072,59.9486063409925
8.7,"random_policy_SVM","SVM",79,2,3612,3323,289,300,183,117,0.89958428246014,0.58,1.68992647058824,166,83,83,72,1,7.67,1.6,0,0,0,0,0,0,0.553174484187962,331.465549013802,70.207536087008
8.7,"random_policy_SVM","SVM",79,3,3512,3285,227,400,221,179,0.902873006833699,0.605,1.72164055299539,238,121,117,72,1,10.22,1.2,0,0,0,0,0,0,0.478950394055786,277.637110325034,64.2900958882834
8.7,"random_policy_SVM","SVM",79,4,3412,3236,176,500,270,230,0.883197608200459,0.64,1.63900552486188,311,155,156,73,1,12.78,1.2,0,0,0,0,0,0,0.276279038927017,173.213275871873,42.9447257962203
8.7,"random_policy_SVM","SVM",79,5,3312,3180,132,600,326,274,0.880649202733473,0.635,1.63599264705882,402,202,200,91,1,15.34,1.2,0,0,0,0,0,0,0.206324665171316,133.025971748541,31.6446249968067
8.7,"random_policy_SVM","SVM",79,6,3212,3093,119,700,413,287,0.88937072892938,0.665,1.66755760368664,436,216,220,34,1,17.89,1.4,0,0,0,0,0,0,0.0951839030640962,74.9227248571313,13.4701309967471
8.7,"random_policy_SVM","SVM",79,7,3112,3012,100,800,494,306,0.892245159453298,0.665,1.63,478,233,245,42,1.1,20.45,1.6,0,0,0,0,0,0,0.0734180286768839,81.0429709203722,9.55632851931181
8.7,"random_policy_SVM","SVM",79,8,3012,2932,80,900,574,326,0.899333712984049,0.68,1.63150230414747,527,254,273,49,1.1,23.01,1.8,0,0,0,0,0,0,0.0725770892014565,109.125477078576,10.4507450394054
8.7,"random_policy_SVM","SVM",79,9,2912,2845,67,1000,661,339,0.905183656036449,0.685,1.65397058823529,566,270,296,39,1.1,25.56,1.9,0,0,0,0,0,0,0.0614367610620464,91.9439919774948,8.04171425823544
8.7,"random_policy_SVM","SVM",79,10,2812,2758,54,1100,748,352,0.91697892938497,0.685,1.67657142857143,605,290,315,39,1.1,28.12,2.1,0,0,0,0,0,0,0.0614694297675918,87.3138482734084,6.84068735749684
8.7,"random_policy_SVM","SVM",79,11,2712,2667,45,1200,839,361,0.926920558086571,0.675,1.74707182320442,631,302,329,26,1.1,30.67,2.3,0,0,0,0,0,0,0.0796859572907267,87.5259841640547,8.88246165179369
8.7,"random_policy_SVM","SVM",79,12,2612,2576,36,1300,930,370,0.931046412300703,0.675,1.7560773480663,657,317,340,26,1.1,33.23,2.5,0,0,0,0,0,0,0.0648835038946087,65.4254346307241,7.54982636205317
8.7,"random_policy_SVM","SVM",79,13,2512,2482,30,1400,1024,376,0.931511958997741,0.675,1.75769585253456,672,324,348,15,1.1,35.79,2.7,0,0,0,0,0,0,0.0617029339855513,59.6857679348444,6.80755045202953
8.7,"random_policy_SVM","SVM",79,14,2412,2388,24,1500,1118,382,0.930763097949899,0.67,1.75769585253456,691,331,360,19,1.1,38.34,2.9,0,0,0,0,0,0,0.0652743960299973,60.4618973320939,7.55097893491447
8.7,"random_policy_SVM","SVM",79,15,2312,2293,19,1600,1213,387,0.930740318906619,0.67,1.74868202764977,702,338,364,11,1.1,40.9,3.1,0,0,0,0,0,0,0.0493649029484667,47.706555567069,6.01669731411383
8.7,"random_policy_SVM","SVM",79,16,2212,2198,14,1700,1308,392,0.931157460136687,0.67,1.74707182320442,716,341,375,14,1.1,43.46,3.3,0,0,0,0,0,0,0.0381476281116428,40.4586052593903,4.53846556061383
8.7,"random_policy_SVM","SVM",79,17,2112,2100,12,1800,1406,394,0.931412300683386,0.665,1.74386029411765,717,344,373,1,1.1,46.01,3.6,0,0,0,0,0,0,0.0297439783103436,34.9265201755354,3.29366241598423
8.7,"random_policy_SVM","SVM",79,18,2012,2001,11,1900,1505,395,0.931968963553549,0.67,1.7560773480663,730,349,381,13,1.1,48.57,3.8,0,0,0,0,0,0,0.0245435431053029,27.9534378110343,2.65873396259914
8.7,"random_policy_SVM","SVM",79,19,1912,1902,10,2000,1604,396,0.93249145785879,0.675,1.76345906163753,729,351,378,-1,1.1,51.12,4.1,0,0,0,0,0,0,0.0204181034907765,22.4043784403037,2.19094989506317
8.7,"random_policy_SVM","SVM",79,20,1812,1803,9,2100,1703,397,0.932017369020521,0.675,1.76508287292818,730,353,377,1,1.1,53.68,4.3,0,0,0,0,0,0,0.0194359167186392,20.4826976188206,2.04233714443478
8.7,"random_policy_SVM","SVM",79,21,1712,1704,8,2200,1802,398,0.931227220956739,0.675,1.76345906163753,745,359,386,15,1.1,56.24,4.5,0,0,0,0,0,0,0.0156135408456573,14.8955648205336,1.61551945876325
8.7,"random_policy_SVM","SVM",79,22,1612,1605,7,2300,1901,399,0.929074601366762,0.67,1.7560773480663,760,365,395,15,1.1,58.79,4.8,0,0,0,0,0,0,0.0107384518459524,8.20211806331569,1.32274100682727
8.7,"random_policy_SVM","SVM",79,23,1512,1506,6,2400,2000,400,0.929330865603658,0.67,1.75769585253456,759,366,393,-1,1.1,61.35,5,0,0,0,0,0,0,0.00811916543609552,6.8764853085238,0.918481457277533
8.7,"random_policy_SVM","SVM",79,24,1412,1407,5,2500,2099,401,0.929420558086572,0.675,1.7560773480663,770,368,402,11,1.1,63.91,5.2,0,0,0,0,0,0,0.00908267732228925,7.04043315543502,0.926341894198371
8.7,"random_policy_SVM","SVM",79,25,1312,1307,5,2600,2199,401,0.929567198177698,0.665,1.7560773480663,780,381,399,10,1,66.46,5.5,0,0,0,0,0,0,0.00540577030879611,3.52468466926746,0.663446703281001
8.7,"random_policy_SVM","SVM",79,26,1212,1209,3,2700,2297,403,0.929709567198198,0.665,1.75769585253456,785,384,401,5,1,69.02,5.7,0,0,0,0,0,0,0.00471944219414002,3.23244704080676,0.51641682533507
8.7,"random_policy_SVM","SVM",79,27,1112,1110,2,2800,2396,404,0.929719533029631,0.66,1.7560773480663,791,385,406,6,1.1,71.57,5.9,0,0,0,0,0,0,0.0053495231200129,3.34052582268252,0.546762509434852
8.7,"random_policy_SVM","SVM",79,28,1012,1010,2,2900,2496,404,0.930076879271086,0.655,1.7560773480663,800,390,410,9,1.1,74.13,6.2,0,0,0,0,0,0,0.00361233818084423,1.9868306361286,0.39776898798928
8.7,"random_policy_SVM","SVM",79,29,912,910,2,3000,2596,404,0.930096810933957,0.655,1.75284926470588,800,390,410,0,1.1,76.69,6.4,0,0,0,0,0,0,0.00336064507974985,1.54692012935495,0.344558011931472
8.7,"random_policy_SVM","SVM",79,30,812,810,2,3100,2696,404,0.929689635535323,0.65,1.75769585253456,805,391,414,5,1.1,79.24,6.7,0,0,0,0,0,0,0.00235959665433543,0.87813364598416,0.256525153143273
8.7,"random_policy_SVM","SVM",79,31,712,710,2,3200,2796,404,0.929703872437373,0.65,1.75769585253456,804,391,413,-1,1.1,81.8,6.9,0,0,0,0,0,0,0.00220078289731928,0.687115285391142,0.241403308473396
8.7,"random_policy_SVM","SVM",79,32,612,610,2,3300,2896,404,0.929775056947624,0.65,1.75769585253456,805,392,413,1,1.1,84.36,7.2,0,0,0,0,0,0,0.00130708511598302,0.40124085026447,0.16852948489249
8.7,"random_policy_SVM","SVM",79,33,512,510,2,3400,2996,404,0.930066913439651,0.65,1.7560773480663,806,392,414,1,1.1,86.91,7.4,0,0,0,0,0,0,0.000745360633437971,0.229463614109751,0.10248354597107
8.7,"random_policy_SVM","SVM",79,34,412,412,0,3500,3094,406,0.930933940774503,0.655,1.76345906163753,813,395,418,7,1.1,89.47,7.6,0,0,0,0,0,0,0.000986950613078672,0.297012019314772,0.124993762813389
8.7,"random_policy_SVM","SVM",79,35,312,312,0,3600,3194,406,0.931469248291587,0.655,1.76508287292818,817,397,420,4,1.1,92.02,7.9,0,0,0,0,0,0,0.000472327901822045,0.117233570650171,0.0588807548344752
8.7,"random_policy_SVM","SVM",79,36,212,212,0,3700,3294,406,0.93177961275628,0.655,1.76345906163753,821,398,423,4,1.1,94.58,8.1,0,0,0,0,0,0,0.000255271652317495,0.0552832008621284,0.0351265783436719
8.7,"random_policy_SVM","SVM",79,37,112,112,0,3800,3394,406,0.931903473804116,0.65,1.76508287292818,825,400,425,4,1.1,97.14,8.4,0,0,0,0,0,0,9.80260027967943e-05,0.0160514406253641,0.0150650129496897
8.7,"random_policy_SVM","SVM",79,38,12,12,0,3900,3494,406,0.932246583143523,0.65,1.76670967741935,824,400,424,-1,1.1,99.69,8.6,0,0,0,0,0,0,6.39608390264488e-05,0.000997408315485952,0.000997408315485952
8.7,"random_policy_SVM","SVM",79,39,0,0,0,3912,3506,406,0.932248006833728,0.65,1.76508287292818,826,400,426,2,1.1,100,8.6,0,0,0,0,0,0,0,0,0
8.7,"random_policy_SVM","SVM",80,0,3812,3440,372,100,88,12,0.903480470089481,0.572072072072072,1.71052371052371,28,12,16,0,1.3,2.56,7.3,0,0,0,0,0,0,0.540043118208197,446.149974141468,61.9748589170459
8.7,"random_policy_SVM","SVM",80,1,3712,3394,318,200,134,66,0.897653709072397,0.63963963963964,1.68132903545748,120,59,61,92,1,5.11,2,0,0,0,0,0,0,0.647691119650805,383.291844234345,73.2556399438677
8.7,"random_policy_SVM","SVM",80,2,3612,3346,266,300,182,118,0.917073215083602,0.653153153153153,1.72808720322532,198,97,101,78,1,7.67,1.5,0,0,0,0,0,0,0.543973433285509,346.496958728642,71.4906290531345
8.7,"random_policy_SVM","SVM",80,3,3512,3310,202,400,218,182,0.912858360090195,0.662162162162162,1.70714516169062,269,136,133,71,1,10.22,1.2,0,0,0,0,0,0,0.473522007000582,349.446723450902,64.3785406247098
8.7,"random_policy_SVM","SVM",80,4,3412,3265,147,500,263,237,0.899759188254004,0.68018018018018,1.65202702702703,342,175,167,73,1,12.78,1.1,0,0,0,0,0,0,0.250391307607363,239.823235194506,43.6704762466389
8.7,"random_policy_SVM","SVM",80,5,3312,3199,113,600,329,271,0.87518833712605,0.689189189189189,1.59163034001744,419,206,213,77,1,15.34,1.2,0,0,0,0,0,0,0.144358382982529,185.541421903409,23.3310688370159
8.7,"random_policy_SVM","SVM",80,6,3212,3121,91,700,407,293,0.878227708677528,0.68018018018018,1.59975090297671,471,228,243,52,1.1,17.89,1.4,0,0,0,0,0,0,0.099282332388369,149.739796003484,12.3612413786136
8.7,"random_policy_SVM","SVM",80,7,3112,3045,67,800,483,317,0.883688186456355,0.698198198198198,1.59975090297671,536,256,280,65,1.1,20.45,1.5,0,0,0,0,0,0,0.121932633646395,200.982169741167,14.1083719808222
8.7,"random_policy_SVM","SVM",80,8,3012,2950,62,900,578,322,0.900906096407821,0.684684684684685,1.66975807454188,561,271,290,25,1.1,23.01,1.8,0,0,0,0,0,0,0.0767511159235295,99.2076734294322,9.18222508605891
8.7,"random_policy_SVM","SVM",80,9,2912,2860,52,1000,668,332,0.91455988860832,0.689189189189189,1.68752177591957,587,281,306,26,1.1,25.56,2,0,0,0,0,0,0,0.0614378153226069,93.4152390631455,6.76895532585146
8.7,"random_policy_SVM","SVM",80,10,2812,2771,41,1100,757,343,0.919989193345592,0.689189189189189,1.68907709552871,616,294,322,29,1.1,28.12,2.2,0,0,0,0,0,0,0.0672879100242074,104.609942906097,7.82992661646302
8.7,"random_policy_SVM","SVM",80,11,2712,2674,38,1200,854,346,0.925818552116142,0.684684684684685,1.70218056142619,638,303,335,22,1.1,30.67,2.5,0,0,0,0,0,0,0.0570190130657067,75.4430075891273,6.09948316099552
8.7,"random_policy_SVM","SVM",80,12,2612,2577,35,1300,951,349,0.928078597628778,0.689189189189189,1.70871422893482,646,309,337,8,1.1,33.23,2.7,0,0,0,0,0,0,0.0488117683128229,62.8724749701508,5.24295430068268
8.7,"random_policy_SVM","SVM",80,13,2512,2479,33,1400,1049,351,0.929343703565163,0.689189189189189,1.72491057233704,649,311,338,3,1.1,35.79,3,0,0,0,0,0,0,0.046106819472964,59.6798508525589,5.03039394345196
8.7,"random_policy_SVM","SVM",80,14,2412,2381,31,1500,1147,353,0.931518023213531,0.693693693693694,1.72649742658942,655,315,340,6,1.1,38.34,3.2,0,0,0,0,0,0,0.0368373942152943,46.9944454772241,3.97658127393791
8.7,"random_policy_SVM","SVM",80,15,2312,2286,26,1600,1242,358,0.932819497698407,0.684684684684685,1.74270867003158,673,319,354,18,1.1,40.9,3.5,0,0,0,0,0,0,0.0394113362282988,48.8952368276113,4.54328714789348
8.7,"random_policy_SVM","SVM",80,16,2212,2193,19,1700,1335,365,0.937065525733359,0.689189189189189,1.75242645960878,691,327,364,18,1.1,43.46,3.7,0,0,0,0,0,0,0.0405534982320429,42.3172264768891,4.59729142272479
8.7,"random_policy_SVM","SVM",80,17,2112,2095,17,1800,1433,367,0.938300757504926,0.689189189189189,1.75404159920289,697,330,367,6,1.1,46.01,3.9,0,0,0,0,0,0,0.0340598308445693,37.8340375460873,3.75422241130315
8.7,"random_policy_SVM","SVM",80,18,2012,1999,13,1900,1529,371,0.938887849787519,0.689189189189189,1.75242645960878,710,335,375,13,1.1,48.57,4.1,0,0,0,0,0,0,0.0314622938313117,31.7019571102203,3.2500342298931
8.7,"random_policy_SVM","SVM",80,19,1912,1899,13,2000,1629,371,0.937786402319278,0.675675675675676,1.77187104459832,730,353,377,20,1.1,51.12,4.4,0,0,0,0,0,0,0.0227778809542053,15.1501632414093,2.93601389060275
8.7,"random_policy_SVM","SVM",80,20,1812,1800,12,2100,1728,372,0.937698078701542,0.675675675675676,1.77513115691589,730,352,378,0,1.1,53.68,4.6,0,0,0,0,0,0,0.0147811912702706,11.4826409068636,1.84309676516432
8.7,"random_policy_SVM","SVM",80,21,1712,1703,9,2200,1825,375,0.937344784230598,0.675675675675676,1.77840328808071,741,357,384,11,1.1,56.24,4.9,0,0,0,0,0,0,0.0125313167838854,10.8652640248082,1.41065068255814
8.7,"random_policy_SVM","SVM",80,22,1612,1603,9,2300,1925,375,0.936926545923084,0.675675675675676,1.77840328808071,740,358,382,-1,1.1,58.79,5.1,0,0,0,0,0,0,0.0115108854851195,9.6057926559417,1.18695932078104
8.7,"random_policy_SVM","SVM",80,23,1512,1506,6,2400,2022,378,0.937139561707031,0.671171171171171,1.77187104459832,759,369,390,19,1.1,61.35,5.3,0,0,0,0,0,0,0.00883087634834192,7.12921411939627,1.03179159637341
8.7,"random_policy_SVM","SVM",80,24,1412,1407,5,2500,2121,379,0.937435705601793,0.675675675675676,1.77513115691589,765,370,395,6,1.1,63.91,5.6,0,0,0,0,0,0,0.00829061003866484,6.07780913213541,0.853581212037892
8.7,"random_policy_SVM","SVM",80,25,1312,1307,5,2600,2221,379,0.938534555316567,0.675675675675676,1.77513115691589,764,372,392,-1,1.1,66.46,5.9,0,0,0,0,0,0,0.00568671770879468,3.78272671403145,0.651399184266816
8.7,"random_policy_SVM","SVM",80,26,1212,1207,5,2700,2321,379,0.938465714849801,0.671171171171171,1.77349960254372,763,372,391,-1,1.1,69.02,6.1,0,0,0,0,0,0,0.0050734638554151,3.08513746435637,0.523439605407588
8.7,"random_policy_SVM","SVM",80,27,1112,1107,5,2800,2421,379,0.938932011596381,0.671171171171171,1.77349960254372,770,374,396,7,1.1,71.57,6.4,0,0,0,0,0,0,0.00443962419345553,2.42037512918396,0.490204102628535
8.7,"random_policy_SVM","SVM",80,28,1012,1008,4,2900,2520,380,0.938773548635149,0.671171171171171,1.77349960254372,770,375,395,0,1.1,74.13,6.6,0,0,0,0,0,0,0.00365085286119467,1.74397084221861,0.381483791395052
8.7,"random_policy_SVM","SVM",80,29,912,910,2,3000,2618,382,0.9380643619398,0.671171171171171,1.77840328808071,780,380,400,10,1.1,76.69,6.9,0,0,0,0,0,0,0.00309624882095543,1.43603213433479,0.354889023873945
8.7,"random_policy_SVM","SVM",80,30,812,810,2,3100,2718,382,0.93811112150213,0.671171171171171,1.77513115691589,782,380,402,2,1.1,79.24,7.1,0,0,0,0,0,0,0.00276278708425504,1.09446131558425,0.294129038146699
8.7,"random_policy_SVM","SVM",80,31,712,710,2,3200,2818,382,0.938228020407959,0.666666666666667,1.77676571599224,783,380,403,1,1.1,81.8,7.4,0,0,0,0,0,0,0.00200454021462183,0.698351742896189,0.226285526976748
8.7,"random_policy_SVM","SVM",80,32,612,610,2,3300,2918,382,0.938253997942586,0.671171171171171,1.77676571599224,782,380,402,-1,1.1,84.36,7.6,0,0,0,0,0,0,0.00154290202052564,0.505843922314806,0.184504175285088
8.7,"random_policy_SVM","SVM",80,33,512,510,2,3400,3018,382,0.938292964244529,0.666666666666667,1.77513115691589,785,381,404,3,1.1,86.91,7.9,0,0,0,0,0,0,0.000998417310435021,0.305041701695369,0.123264242958872
8.7,"random_policy_SVM","SVM",80,34,412,412,0,3500,3116,384,0.938391678876107,0.666666666666667,1.77513115691589,792,383,409,7,1.1,89.47,8.1,0,0,0,0,0,0,0.00133912809489971,0.38546897324345,0.182127443779789
8.7,"random_policy_SVM","SVM",80,35,312,312,0,3600,3216,384,0.93906709477644,0.666666666666667,1.77840328808071,792,383,409,0,1.1,92.02,8.4,0,0,0,0,0,0,0.000768504278758499,0.18845239076069,0.0984124380973461
8.7,"random_policy_SVM","SVM",80,36,212,212,0,3700,3316,384,0.939506115111655,0.666666666666667,1.77187104459832,795,384,411,3,1.1,94.58,8.6,0,0,0,0,0,0,0.000327107201895548,0.0700775367939041,0.0453868235717418
8.7,"random_policy_SVM","SVM",80,37,112,112,0,3800,3416,384,0.940080218626933,0.666666666666667,1.77840328808071,793,384,409,-2,1.1,97.14,8.9,0,0,0,0,0,0,0.000143205077699616,0.02457834741772,0.0230706436804616
8.7,"random_policy_SVM","SVM",80,38,12,12,0,3900,3516,384,0.940472479399816,0.666666666666667,1.77349960254372,793,384,409,0,1.1,99.69,9.2,0,0,0,0,0,0,7.53788251395424e-05,0.00117100069288038,0.00117100069288038
8.7,"random_policy_SVM","SVM",80,39,0,0,0,3912,3528,384,0.940543917620043,0.666666666666667,1.77349960254372,793,384,409,0,1.1,100,9.2,0,0,0,0,0,0,0,0,0
8.7,"random_policy_SVM","SVM",81,0,3812,3404,408,100,91,9,0.827714447408839,0.455026455026455,1.62153463535952,23,9,14,0,1.6,2.56,10.1,0,0,0,0,0,0,0.246585973372929,384.422073999427,27.1936072801352
8.7,"random_policy_SVM","SVM",81,1,3712,3365,347,200,130,70,0.855404640633837,0.53968253968254,1.63308577253531,94,46,48,71,1,5.11,1.9,0,0,0,0,0,0,0.794078948041593,317.852764214364,88.1402054823829
8.7,"random_policy_SVM","SVM",81,2,3612,3318,294,300,177,123,0.85102990451038,0.555555555555556,1.59145254172878,171,85,86,77,1,7.67,1.4,0,0,0,0,0,0,0.614851074143579,239.434418517869,76.7561427206232
8.7,"random_policy_SVM","SVM",81,3,3512,3292,220,400,203,197,0.872665534804746,0.603174603174603,1.68830370858021,229,116,113,58,1,10.22,1,0,0,0,0,0,0,0.564774734923595,233.025746800813,75.0949357435901
8.7,"random_policy_SVM","SVM",81,4,3412,3239,173,500,256,244,0.849930980378061,0.597883597883598,1.57239322985179,306,155,151,77,1,12.78,1,0,0,0,0,0,0,0.269089086993998,122.478511219842,51.4698946398846
8.7,"random_policy_SVM","SVM",81,5,3312,3180,132,600,315,285,0.846761467587721,0.608465608465608,1.55855816461877,399,197,202,93,1,15.34,1.1,0,0,0,0,0,0,0.141349100020794,100.155295525985,26.4484224279453
8.7,"random_policy_SVM","SVM",81,6,3212,3109,103,700,386,314,0.831969409784903,0.608465608465608,1.53568868407578,460,225,235,61,1,17.89,1.2,0,0,0,0,0,0,0.10676022847494,88.6177202143752,14.3424922548284
8.7,"random_policy_SVM","SVM",81,7,3112,3030,82,800,465,335,0.832226923341791,0.619047619047619,1.52474495015931,512,247,265,52,1.1,20.45,1.4,0,0,0,0,0,0,0.0750729779174266,79.6903902423906,9.45447059669404
8.7,"random_policy_SVM","SVM",81,8,3012,2941,71,900,554,346,0.844473789012542,0.619047619047619,1.5533339179748,539,259,280,27,1.1,23.01,1.6,0,0,0,0,0,0,0.0600069681134674,65.4307486900339,6.77256804815266
8.7,"random_policy_SVM","SVM",81,9,2912,2849,63,1000,646,354,0.849246772846081,0.619047619047619,1.55190490793067,559,268,291,20,1.1,25.56,1.8,0,0,0,0,0,0,0.0537310144461184,68.4184202290773,6.1421379518961
8.7,"random_policy_SVM","SVM",81,10,2812,2759,53,1100,736,364,0.860819911187757,0.634920634920635,1.57384244020189,581,280,301,22,1.1,28.12,2,0,0,0,0,0,0,0.044088433574989,58.6914649385199,5.02548191965288
8.7,"random_policy_SVM","SVM",81,11,2712,2665,47,1200,830,370,0.886080194512565,0.634920634920635,1.60903024196492,619,301,318,38,1.1,30.67,2.2,0,0,0,0,0,0,0.0411574244667349,43.7122137618428,4.96350130009665
8.7,"random_policy_SVM","SVM",81,12,2612,2573,39,1300,922,378,0.89678497318565,0.64021164021164,1.66615557599918,636,308,328,17,1.1,33.23,2.4,0,0,0,0,0,0,0.0360518618842026,46.5187766546202,4.01239671632318
8.7,"random_policy_SVM","SVM",81,13,2512,2480,32,1400,1015,385,0.914511487799533,0.62962962962963,1.69627875705224,658,320,338,22,1.1,35.79,2.6,0,0,0,0,0,0,0.0579137435543563,60.0335750972552,6.7738842591704
8.7,"random_policy_SVM","SVM",81,14,2412,2385,27,1500,1110,390,0.92127271583977,0.62962962962963,1.75507278180089,684,331,353,26,1.1,38.34,2.8,0,0,0,0,0,0,0.0606803891333027,52.1794751262526,6.9172809407352
8.7,"random_policy_SVM","SVM",81,15,2312,2290,22,1600,1205,395,0.922555792108698,0.624338624338624,1.76298634862171,696,337,359,12,1.1,40.9,3.1,0,0,0,0,0,0,0.0535352007424152,43.5519356623435,5.86713038973052
8.7,"random_policy_SVM","SVM",81,16,2212,2191,21,1700,1304,396,0.922416555127355,0.624338624338624,1.75023342670401,706,338,368,10,1.1,43.46,3.3,0,0,0,0,0,0,0.0398611497243344,31.5436835382587,4.35929562300317
8.7,"random_policy_SVM","SVM",81,17,2112,2093,19,1800,1402,398,0.923079802253535,0.624338624338624,1.75023342670401,711,342,369,5,1.1,46.01,3.5,0,0,0,0,0,0,0.0336446341116788,27.5922626453752,3.8636922185096
8.7,"random_policy_SVM","SVM",81,18,2012,1996,16,1900,1499,401,0.923228022265931,0.613756613756614,1.75507278180089,714,345,369,3,1.1,48.57,3.7,0,0,0,0,0,0,0.0293294724231492,25.2935345863336,3.55263266004616
8.7,"random_policy_SVM","SVM",81,19,1912,1901,11,2000,1594,406,0.923078305081693,0.608465608465608,1.75507278180089,732,352,380,18,1.1,51.12,3.9,0,0,0,0,0,0,0.0236537447989868,21.5470475921132,2.88137745150602
8.7,"random_policy_SVM","SVM",81,20,1812,1803,9,2100,1692,408,0.922985480427465,0.603174603174603,1.75507278180089,738,355,383,6,1.1,53.68,4.1,0,0,0,0,0,0,0.0201402691134337,18.5687690019377,2.22325980953829
8.7,"random_policy_SVM","SVM",81,21,1712,1704,8,2200,1791,409,0.923338812982269,0.608465608465608,1.75184357705057,742,358,384,4,1.1,56.24,4.4,0,0,0,0,0,0,0.0175801722894495,15.1653587702559,1.78661520842405
8.7,"random_policy_SVM","SVM",81,22,1612,1604,8,2300,1891,409,0.923967625156074,0.608465608465608,1.76601135867191,760,374,386,18,1,58.79,4.6,0,0,0,0,0,0,0.0124860049908886,7.82089890440226,1.63600558094981
8.7,"random_policy_SVM","SVM",81,23,1512,1507,5,2400,1988,412,0.924356889835095,0.613756613756614,1.77414965986395,768,378,390,8,1,61.35,4.8,0,0,0,0,0,0,0.00841670740065518,6.31366325686535,1.02040077147361
8.7,"random_policy_SVM","SVM",81,24,1412,1407,5,2500,2088,412,0.924386833271943,0.613756613756614,1.77414965986395,765,376,389,-3,1,63.91,5.1,0,0,0,0,0,0,0.00751684659213936,5.70678030610766,0.798545078770525
8.7,"random_policy_SVM","SVM",81,25,1312,1307,5,2600,2188,412,0.924587454298823,0.608465608465608,1.77088535506199,777,381,396,12,1,66.46,5.3,0,0,0,0,0,0,0.0054773384453241,3.93976480280585,0.597838497267171
8.7,"random_policy_SVM","SVM",81,26,1212,1207,5,2700,2288,412,0.924827001793606,0.608465608465608,1.76763304036031,778,381,397,1,1,69.02,5.6,0,0,0,0,0,0,0.00465282726647926,2.96055385983931,0.478584148523375
8.7,"random_policy_SVM","SVM",81,27,1112,1107,5,2800,2388,412,0.924425759739845,0.613756613756614,1.77088535506199,785,384,401,7,1,71.57,5.8,0,0,0,0,0,0,0.00405024682594052,2.36596994452551,0.433848293860528
8.7,"random_policy_SVM","SVM",81,28,1012,1007,5,2900,2488,412,0.924461691864062,0.613756613756614,1.77088535506199,785,384,401,0,1,74.13,6,0,0,0,0,0,0,0.00380545099946711,1.94521142048662,0.39467682166796
8.7,"random_policy_SVM","SVM",81,29,912,907,5,3000,2588,412,0.92414728577716,0.613756613756614,1.76763304036031,789,386,403,4,1,76.69,6.3,0,0,0,0,0,0,0.00317227078013069,1.44211619613692,0.344187477706689
8.7,"random_policy_SVM","SVM",81,30,812,809,3,3100,2686,414,0.924496126816437,0.608465608465608,1.7725160045602,796,390,406,7,1,79.24,6.5,0,0,0,0,0,0,0.00296362920376476,1.23814379652805,0.322447080478521
8.7,"random_policy_SVM","SVM",81,31,712,709,3,3200,2786,414,0.92425358497797,0.608465608465608,1.76925770308123,794,390,404,-2,1,81.8,6.7,0,0,0,0,0,0,0.00253863738805458,0.92914542272187,0.27655167551796
8.7,"random_policy_SVM","SVM",81,32,612,609,3,3300,2886,414,0.924264065180867,0.608465608465608,1.7725160045602,792,390,402,-2,1,84.36,7,0,0,0,0,0,0,0.00216437619873859,0.696160520882758,0.241819081789864
8.7,"random_policy_SVM","SVM",81,33,512,510,2,3400,2985,415,0.924431748427215,0.608465608465608,1.77088535506199,796,391,405,4,1,86.91,7.2,0,0,0,0,0,0,0.00150900056009626,0.452882419000273,0.184770982926902
8.7,"random_policy_SVM","SVM",81,34,412,410,2,3500,3085,415,0.924479657926171,0.608465608465608,1.7725160045602,797,392,405,1,1,89.47,7.4,0,0,0,0,0,0,0.000854455501215876,0.245617559394297,0.111141586370933
8.7,"random_policy_SVM","SVM",81,35,312,312,0,3600,3183,417,0.924371861553519,0.603174603174603,1.77088535506199,806,396,410,9,1,92.02,7.6,0,0,0,0,0,0,0.00108635781506434,0.269791565332487,0.136601889058626
8.7,"random_policy_SVM","SVM",81,36,212,212,0,3700,3283,417,0.924683273296736,0.603174603174603,1.77387863180714,811,398,413,5,1,94.58,7.9,0,0,0,0,0,0,0.000666163710927423,0.135460577393923,0.0840024996161183
8.7,"random_policy_SVM","SVM",81,37,112,112,0,3800,3383,417,0.924886888667302,0.608465608465608,1.78368809889547,819,400,419,8,1,97.14,8.1,0,0,0,0,0,0,0.000301119039802341,0.0486695874919496,0.0454268444347573
8.7,"random_policy_SVM","SVM",81,38,12,12,0,3900,3483,417,0.925114458787345,0.608465608465608,1.78368809889547,821,401,420,2,1,99.69,8.4,0,0,0,0,0,0,0.000211977342677939,0.00316896246099145,0.00316896246099145
8.7,"random_policy_SVM","SVM",81,39,0,0,0,3912,3495,417,0.925210277785258,0.608465608465608,1.78368809889547,821,401,420,0,1,100,8.4,0,0,0,0,0,0,0,0,0
8.7,"random_policy_SVM","SVM",82,0,3812,3424,388,100,93,7,0.88525916973343,0.502369668246445,1.73655555990756,25,7,18,0,2.6,2.56,13.3,0,0,0,0,0,0,0.449898647076956,316.467650285841,56.9392007629919
8.7,"random_policy_SVM","SVM",82,1,3712,3375,337,200,142,58,0.900775404337363,0.530805687203792,1.73868174466554,96,46,50,71,1.1,5.11,2.4,0,0,0,0,0,0,0.724568689448829,442.051809686768,80.9262472973887
8.7,"random_policy_SVM","SVM",82,2,3612,3329,283,300,188,112,0.918434525183674,0.601895734597156,1.75358061441646,162,81,81,66,1,7.67,1.7,0,0,0,0,0,0,0.520622099116702,241.319219223707,71.5937332309359
8.7,"random_policy_SVM","SVM",82,3,3512,3281,231,400,236,164,0.917011366259743,0.630331753554502,1.76209314167091,239,119,120,77,1,10.22,1.4,0,0,0,0,0,0,0.33369391678373,188.840960161123,55.6241421650933
8.7,"random_policy_SVM","SVM",82,4,3412,3238,174,500,279,221,0.905406102744466,0.630331753554502,1.75150151789809,314,158,156,75,1,12.78,1.3,0,0,0,0,0,0,0.185585951709207,109.176566040036,31.323275506956
8.7,"random_policy_SVM","SVM",82,5,3312,3175,137,600,342,258,0.909230163364511,0.639810426540284,1.75842475976015,380,186,194,66,1,15.34,1.3,0,0,0,0,0,0,0.114680444913304,88.8462357145741,17.3801145265625
8.7,"random_policy_SVM","SVM",82,6,3212,3104,108,700,413,287,0.919275112372501,0.672985781990521,1.73281663219083,447,220,227,67,1,17.89,1.4,0,0,0,0,0,0,0.0883036177942141,80.3585265480154,13.1300842978403
8.7,"random_policy_SVM","SVM",82,7,3112,3029,83,800,488,312,0.908665245318376,0.682464454976303,1.65294814608308,503,241,262,56,1.1,20.45,1.6,0,0,0,0,0,0,0.0886989453947832,118.062759514331,13.8265513914057
8.7,"random_policy_SVM","SVM",82,8,3012,2946,66,900,571,329,0.910517524681215,0.691943127962085,1.67850919988849,553,264,289,50,1.1,23.01,1.7,0,0,0,0,0,0,0.0798359327305797,109.807660447173,9.14270439219396
8.7,"random_policy_SVM","SVM",82,9,2912,2853,59,1000,664,336,0.920683333559661,0.682464454976303,1.68858155626382,570,273,297,17,1.1,25.56,2,0,0,0,0,0,0,0.068931207503758,89.2715429198498,7.69673060484981
8.7,"random_policy_SVM","SVM",82,10,2812,2765,47,1100,752,348,0.92150219313136,0.687203791469194,1.66998884862002,610,289,321,40,1.1,28.12,2.2,0,0,0,0,0,0,0.0652185473906245,88.9602145891655,7.5325413436144
8.7,"random_policy_SVM","SVM",82,11,2712,2672,40,1200,845,355,0.926327082116812,0.687203791469194,1.6986724620984,625,300,325,15,1.1,30.67,2.4,0,0,0,0,0,0,0.0644560489593466,84.5615395999106,7.26156122947003
8.7,"random_policy_SVM","SVM",82,12,2612,2581,31,1300,936,364,0.934287537853588,0.687203791469194,1.75842475976015,657,314,343,32,1.1,33.23,2.6,0,0,0,0,0,0,0.0676965838579705,78.1837897822488,7.4489007893933
8.7,"random_policy_SVM","SVM",82,13,2512,2482,30,1400,1035,365,0.935759583916133,0.682464454976303,1.75680707368862,661,315,346,4,1.1,35.79,2.8,0,0,0,0,0,0,0.0574519314476839,62.3610732282861,6.14428720964827
8.7,"random_policy_SVM","SVM",82,14,2412,2388,24,1500,1129,371,0.936604245033196,0.696682464454976,1.75519236130471,672,322,350,11,1.1,38.34,3,0,0,0,0,0,0,0.0534749657147919,58.0328635932807,6.1604085859935
8.7,"random_policy_SVM","SVM",82,15,2312,2290,22,1600,1227,373,0.937454338054558,0.691943127962085,1.7600454277415,678,324,354,6,1.1,40.9,3.3,0,0,0,0,0,0,0.0410708859491521,46.3322399754533,4.56949092979462
8.7,"random_policy_SVM","SVM",82,16,2212,2192,20,1700,1325,375,0.937128423797165,0.691943127962085,1.7600454277415,692,329,363,14,1.1,43.46,3.5,0,0,0,0,0,0,0.0344448190487327,39.9405547185493,3.68662312736947
8.7,"random_policy_SVM","SVM",82,17,2112,2094,18,1800,1423,377,0.937478781623865,0.687203791469194,1.7600454277415,699,332,367,7,1.1,46.01,3.8,0,0,0,0,0,0,0.0305556903096787,34.6986408903163,3.25667771933611
8.7,"random_policy_SVM","SVM",82,18,2012,1994,18,1900,1523,377,0.937158299270766,0.687203791469194,1.7600454277415,705,334,371,6,1.1,48.57,4,0,0,0,0,0,0,0.023869877405445,24.9066122456726,2.51102731624734
8.7,"random_policy_SVM","SVM",82,19,1912,1895,17,2000,1622,378,0.939439699072497,0.687203791469194,1.77713324742831,717,341,376,12,1.1,51.12,4.3,0,0,0,0,0,0,0.0182623981889451,17.6018465020862,2.14764406814827
8.7,"random_policy_SVM","SVM",82,20,1812,1800,12,2100,1717,383,0.93832344274093,0.687203791469194,1.7685893375849,722,344,378,5,1.1,53.68,4.5,0,0,0,0,0,0,0.019477428060619,18.3032056648242,2.00514467578685
8.7,"random_policy_SVM","SVM",82,21,1712,1701,11,2200,1816,384,0.941186056301666,0.677725118483412,1.79091983240102,744,360,384,22,1.1,56.24,4.7,0,0,0,0,0,0,0.0139140051257971,10.4522451819285,1.81194307619719
8.7,"random_policy_SVM","SVM",82,22,1612,1601,11,2300,1916,384,0.941129021306622,0.677725118483412,1.79422106711512,743,359,384,-1,1.1,58.79,5,0,0,0,0,0,0,0.0105010874420181,8.69861793173964,1.2073352717403
8.7,"random_policy_SVM","SVM",82,23,1512,1503,9,2400,2014,386,0.941123589402331,0.677725118483412,1.78239164272292,748,362,386,5,1.1,61.35,5.2,0,0,0,0,0,0,0.00989823837512061,7.70254960511182,1.016135659716
8.7,"random_policy_SVM","SVM",82,24,1412,1403,9,2500,2114,386,0.941689865424554,0.672985781990521,1.79256892985258,752,366,386,4,1.1,63.91,5.5,0,0,0,0,0,0,0.00726479325645958,5.21009863429804,0.837404623028196
8.7,"random_policy_SVM","SVM",82,25,1312,1304,8,2600,2213,387,0.941753690299959,0.672985781990521,1.79091983240102,755,367,388,3,1.1,66.46,5.7,0,0,0,0,0,0,0.00728308805717492,4.54349519135967,0.74493555796842
8.7,"random_policy_SVM","SVM",82,26,1212,1204,8,2700,2313,387,0.942685261885669,0.672985781990521,1.78435367352879,766,373,393,11,1.1,69.02,6,0,0,0,0,0,0,0.00636351340713396,3.81341888630807,0.703010969646571
8.7,"random_policy_SVM","SVM",82,27,1112,1105,7,2800,2412,388,0.942720569263553,0.66824644549763,1.78763072343426,769,374,395,3,1.1,71.57,6.2,0,0,0,0,0,0,0.00545006141066572,2.83365435668802,0.574981835128395
8.7,"random_policy_SVM","SVM",82,28,1012,1006,6,2900,2511,389,0.942878094487959,0.66824644549763,1.78763072343426,772,378,394,3,1,74.13,6.5,0,0,0,0,0,0,0.00484056259829616,2.31400005508323,0.523029106320489
8.7,"random_policy_SVM","SVM",82,29,912,907,5,3000,2610,390,0.942628226890626,0.66824644549763,1.79091983240102,775,380,395,3,1,76.69,6.7,0,0,0,0,0,0,0.00514817602248883,2.25246470805777,0.54675180384646
8.7,"random_policy_SVM","SVM",82,30,812,808,4,3100,2709,391,0.942567117967364,0.663507109004739,1.78271965001823,779,381,398,4,1,79.24,6.9,0,0,0,0,0,0,0.00364287757990263,1.4670295430425,0.401779126312441
8.7,"random_policy_SVM","SVM",82,31,712,708,4,3200,2809,391,0.942783036162886,0.663507109004739,1.79091983240102,781,382,399,2,1,81.8,7.2,0,0,0,0,0,0,0.0027645545900538,0.97868019430946,0.306760004832516
8.7,"random_policy_SVM","SVM",82,32,612,608,4,3300,2909,391,0.942799331875755,0.663507109004739,1.79091983240102,784,382,402,3,1.1,84.36,7.4,0,0,0,0,0,0,0.00218878970689538,0.693194346318956,0.246373822386436
8.7,"random_policy_SVM","SVM",82,33,512,509,3,3400,3008,392,0.943134751965656,0.663507109004739,1.79256892985258,786,384,402,2,1,86.91,7.7,0,0,0,0,0,0,0.00146568616711602,0.472172499591942,0.184240801635794
8.7,"random_policy_SVM","SVM",82,34,412,410,2,3500,3107,393,0.943110308396354,0.663507109004739,1.78271965001823,788,385,403,2,1,89.47,7.9,0,0,0,0,0,0,0.00115610595899126,0.339569973273957,0.142997174906262
8.7,"random_policy_SVM","SVM",82,35,312,311,1,3600,3206,394,0.943519059194169,0.654028436018957,1.79091983240102,793,387,406,5,1,92.02,8.1,0,0,0,0,0,0,0.0011125284117552,0.2780999587223,0.138319120657497
8.7,"random_policy_SVM","SVM",82,36,212,212,0,3700,3305,395,0.943418568964807,0.654028436018957,1.79256892985258,801,390,411,8,1.1,94.58,8.4,0,0,0,0,0,0,0.000725507401452431,0.154072087565132,0.0972376788446766
8.7,"random_policy_SVM","SVM",82,37,112,112,0,3800,3405,395,0.94336424992191,0.654028436018957,1.79091983240102,802,393,409,1,1,97.14,8.6,0,0,0,0,0,0,0.000303236424429217,0.0481690424340171,0.0448244874907446
8.7,"random_policy_SVM","SVM",82,38,12,12,0,3900,3505,395,0.943445728486258,0.658767772511848,1.79091983240102,805,393,412,3,1,99.69,8.9,0,0,0,0,0,0,0.000190110838364666,0.00262191207335369,0.00262191207335369
8.7,"random_policy_SVM","SVM",82,39,0,0,0,3912,3517,395,0.943331658496171,0.658767772511848,1.78763072343426,803,393,410,-2,1,100,8.9,0,0,0,0,0,0,0,0,0
8.7,"random_policy_SVM","SVM",83,0,3812,3431,381,100,86,14,0.899902225722781,0.597156398104265,1.72861883431384,40,14,26,0,1.9,2.56,6.1,0,0,0,0,0,0,0.647296111343801,485.02211371881,70.9880583083066
8.7,"random_policy_SVM","SVM",83,1,3712,3404,308,200,113,87,0.900408750797808,0.62085308056872,1.73496238966912,104,50,54,64,1.1,5.11,1.3,0,0,0,0,0,0,0.633750836904501,333.834089394542,76.7411985393696
8.7,"random_policy_SVM","SVM",83,2,3612,3363,249,300,154,146,0.893450481402516,0.611374407582938,1.73655555990756,178,90,88,74,1,7.67,1.1,0,0,0,0,0,0,0.510985755746927,299.224044721076,67.5787262777915
8.7,"random_policy_SVM","SVM",83,3,3512,3308,204,400,209,191,0.881834354078668,0.62085308056872,1.72269431497622,256,128,128,78,1,10.22,1.1,0,0,0,0,0,0,0.348493878190909,217.126053281444,52.652896358746
8.7,"random_policy_SVM","SVM",83,4,3412,3255,157,500,262,238,0.879523078803349,0.635071090047393,1.71416612529812,329,163,166,73,1,12.78,1.1,0,0,0,0,0,0,0.193249724997028,180.035440819817,28.2616669155318
8.7,"random_policy_SVM","SVM",83,5,3312,3187,125,600,330,270,0.872285066337119,0.658767772511848,1.61034638974073,403,197,206,74,1,15.34,1.2,0,0,0,0,0,0,0.113186172011736,129.980701833304,15.3901436279946
8.7,"random_policy_SVM","SVM",83,6,3212,3116,96,700,401,299,0.874330178302257,0.663507109004739,1.58478533593532,476,227,249,73,1.1,17.89,1.3,0,0,0,0,0,0,0.129841015192857,171.829929500274,18.3860206617163
8.7,"random_policy_SVM","SVM",83,7,3112,3038,74,800,479,321,0.85737177310936,0.658767772511848,1.54644768165637,524,253,271,48,1.1,20.45,1.5,0,0,0,0,0,0,0.121443295816409,182.023905710319,17.9993029739088
8.7,"random_policy_SVM","SVM",83,8,3012,2941,71,900,576,324,0.885006586183954,0.658767772511848,1.58892446166611,551,265,286,27,1.1,23.01,1.8,0,0,0,0,0,0,0.0736816326349877,85.8816654215662,9.38564614091462
8.7,"random_policy_SVM","SVM",83,9,2912,2855,57,1000,662,338,0.891448824671704,0.658767772511848,1.63188678009042,573,280,293,22,1,25.56,2,0,0,0,0,0,0,0.0608517227425878,85.7506012476899,6.93629138588771
8.7,"random_policy_SVM","SVM",83,10,2812,2766,46,1100,751,349,0.907555778867191,0.66824644549763,1.66998884862002,604,291,313,31,1.1,28.12,2.2,0,0,0,0,0,0,0.074826561778997,97.1899744056125,8.73296980896157
8.7,"random_policy_SVM","SVM",83,11,2712,2669,43,1200,848,352,0.913469764662745,0.663507109004739,1.72269431497622,616,298,318,12,1.1,30.67,2.4,0,0,0,0,0,0,0.0569571420015843,65.4647038410996,6.16396248269985
8.7,"random_policy_SVM","SVM",83,12,2612,2575,37,1300,942,358,0.922287103301252,0.663507109004739,1.74135267471394,637,304,333,21,1.1,33.23,2.6,0,0,0,0,0,0,0.0589366810280796,63.5384488386444,6.44638525517297
8.7,"random_policy_SVM","SVM",83,13,2512,2481,31,1400,1036,364,0.927868384959068,0.663507109004739,1.74988871723705,652,310,342,15,1.1,35.79,2.8,0,0,0,0,0,0,0.0517644020804621,54.5664983529866,5.90863161936111
8.7,"random_policy_SVM","SVM",83,14,2412,2386,26,1500,1131,369,0.930588411032209,0.663507109004739,1.74988871723705,662,315,347,10,1.1,38.34,3.1,0,0,0,0,0,0,0.0451079923326397,51.3268358693813,5.20623011217242
8.7,"random_policy_SVM","SVM",83,15,2312,2290,22,1600,1227,373,0.931388258938889,0.663507109004739,1.74988871723705,669,318,351,7,1.1,40.9,3.3,0,0,0,0,0,0,0.0363443920311481,43.0852180595714,4.07037937079598
8.7,"random_policy_SVM","SVM",83,16,2212,2192,20,1700,1325,375,0.93127283097273,0.658767772511848,1.75150151789809,678,322,356,9,1.1,43.46,3.5,0,0,0,0,0,0,0.0339758204644596,38.5209718508442,3.46699524582012
8.7,"random_policy_SVM","SVM",83,17,2112,2094,18,1800,1423,377,0.932156873395896,0.654028436018957,1.76696080228326,710,344,366,32,1.1,46.01,3.8,0,0,0,0,0,0,0.0239021183349453,16.1515552600439,3.11137177904369
8.7,"random_policy_SVM","SVM",83,18,2012,1998,14,1900,1519,381,0.932681052159863,0.658767772511848,1.76696080228326,721,350,371,11,1.1,48.57,4,0,0,0,0,0,0,0.0179675846723937,13.7332744448504,2.09198723269733
8.7,"random_policy_SVM","SVM",83,19,1912,1902,10,2000,1615,385,0.9329404255897,0.654028436018957,1.7685893375849,732,354,378,11,1.1,51.12,4.2,0,0,0,0,0,0,0.0146472954567488,13.2185709630757,1.69540276829243
8.7,"random_policy_SVM","SVM",83,20,1812,1803,9,2100,1714,386,0.932592783715148,0.654028436018957,1.76533526336672,734,356,378,2,1.1,53.68,4.4,0,0,0,0,0,0,0.0138361725261461,12.4112272481352,1.42515856106225
8.7,"random_policy_SVM","SVM",83,21,1712,1704,8,2200,1813,387,0.933095234861966,0.649289099526066,1.76696080228326,747,364,383,13,1.1,56.24,4.7,0,0,0,0,0,0,0.00988160386098422,8.05308267928005,1.17861002307119
8.7,"random_policy_SVM","SVM",83,22,1612,1606,6,2300,1911,389,0.932834503456053,0.644549763033175,1.7685893375849,754,366,388,7,1.1,58.79,4.9,0,0,0,0,0,0,0.0100672544621044,7.95259324439893,1.04193217136759
8.7,"random_policy_SVM","SVM",83,23,1512,1506,6,2400,2011,389,0.933377693885038,0.644549763033175,1.77713324742831,762,373,389,8,1,61.35,5.2,0,0,0,0,0,0,0.00768044991010527,5.65200541282073,0.858198869974489
8.7,"random_policy_SVM","SVM",83,24,1412,1407,5,2500,2110,390,0.934178899767796,0.644549763033175,1.77713324742831,765,373,392,3,1.1,63.91,5.4,0,0,0,0,0,0,0.00729093343874053,4.6068743226869,0.76242266183712
8.7,"random_policy_SVM","SVM",83,25,1312,1307,5,2600,2210,390,0.934514319857694,0.644549763033175,1.77549684480637,763,375,388,-2,1,66.46,5.7,0,0,0,0,0,0,0.00589924746422889,3.69029459812498,0.656620045638534
8.7,"random_policy_SVM","SVM",83,26,1212,1208,4,2700,2309,391,0.934430125341202,0.644549763033175,1.77549684480637,769,377,392,6,1,69.02,5.9,0,0,0,0,0,0,0.00571561002190651,3.36281905429502,0.611604802883995
8.7,"random_policy_SVM","SVM",83,27,1112,1108,4,2800,2409,391,0.934521109738057,0.644549763033175,1.77713324742831,772,379,393,3,1,71.57,6.2,0,0,0,0,0,0,0.00439170704036783,2.34379459876749,0.471081952255293
8.7,"random_policy_SVM","SVM",83,28,1012,1010,2,2900,2507,393,0.934119148820609,0.639810426540284,1.77386345304482,781,382,399,9,1,74.13,6.4,0,0,0,0,0,0,0.0039332589998353,2.03354820606481,0.431360093815067
8.7,"random_policy_SVM","SVM",83,29,912,911,1,3000,2606,394,0.933999646926233,0.644549763033175,1.77386345304482,783,383,400,2,1,76.69,6.6,0,0,0,0,0,0,0.00366682838391061,1.83456035091397,0.400960906419499
8.7,"random_policy_SVM","SVM",83,30,812,811,1,3100,2706,394,0.933969771452639,0.644549763033175,1.77060566892536,783,383,400,0,1,79.24,6.9,0,0,0,0,0,0,0.00306275695823814,1.40017261435417,0.331772470753762
8.7,"random_policy_SVM","SVM",83,31,712,711,1,3200,2806,394,0.933977919309074,0.639810426540284,1.77713324742831,783,383,400,0,1,81.8,7.1,0,0,0,0,0,0,0.00202539067874435,0.82158221226288,0.222019688194632
8.7,"random_policy_SVM","SVM",83,32,612,611,1,3300,2906,394,0.93388829288829,0.639810426540284,1.77713324742831,782,383,399,-1,1,84.36,7.4,0,0,0,0,0,0,0.0021263747313753,0.792770082231856,0.236143375536995
8.7,"random_policy_SVM","SVM",83,33,512,511,1,3400,3006,394,0.933882860984,0.639810426540284,1.77713324742831,786,385,401,4,1,86.91,7.6,0,0,0,0,0,0,0.00150876800796377,0.505276751644262,0.174356085554791
8.7,"random_policy_SVM","SVM",83,34,412,412,0,3500,3105,395,0.933486331970839,0.635071090047393,1.77060566892536,796,387,409,10,1.1,89.47,7.9,0,0,0,0,0,0,0.00116733767607967,0.34319833611561,0.136547062134353
8.7,"random_policy_SVM","SVM",83,35,312,312,0,3600,3205,395,0.933499911731563,0.639810426540284,1.77386345304482,796,388,408,0,1.1,92.02,8.1,0,0,0,0,0,0,0.000983957860796981,0.246095760059581,0.119757382183072
8.7,"random_policy_SVM","SVM",83,36,212,212,0,3700,3305,395,0.933452382569027,0.639810426540284,1.77549684480637,797,388,409,1,1.1,94.58,8.4,0,0,0,0,0,0,0.000447963222343527,0.0945819053353292,0.0600258678309333
8.7,"random_policy_SVM","SVM",83,37,112,112,0,3800,3405,395,0.933554230774461,0.644549763033175,1.77386345304482,800,389,411,3,1.1,97.14,8.6,0,0,0,0,0,0,0.000174198122509859,0.0313205364945034,0.029474075474238
8.7,"random_policy_SVM","SVM",83,38,12,12,0,3900,3505,395,0.933787802658924,0.644549763033175,1.77713324742831,799,390,409,-1,1,99.69,8.9,0,0,0,0,0,0,0.000161838637442428,0.00216942484344237,0.00216942484344237
8.7,"random_policy_SVM","SVM",83,39,0,0,0,3912,3517,395,0.933766075041764,0.644549763033175,1.77060566892536,799,390,409,0,1,100,8.9,0,0,0,0,0,0,0,0,0
8.7,"random_policy_SVM","SVM",84,0,3812,3426,386,100,91,9,0.865696166433548,0.535545023696682,1.66606241946404,22,9,13,0,1.4,2.56,10.1,0,0,0,0,0,0,0.268625030039687,320.279392732882,29.343849054084
8.7,"random_policy_SVM","SVM",84,1,3712,3391,321,200,126,74,0.889949619087705,0.611374407582938,1.70878196868107,100,50,50,78,1,5.11,1.7,0,0,0,0,0,0,0.697274627424781,234.815510431383,80.1120650345295
8.7,"random_policy_SVM","SVM",84,2,3612,3350,262,300,167,133,0.870842895748176,0.601895734597156,1.64745620695975,175,92,83,75,0.9,7.67,1.3,0,0,0,0,0,0,0.480481774892453,137.225046152889,70.308160902507
8.7,"random_policy_SVM","SVM",84,3,3512,3310,202,400,207,193,0.880151821724895,0.635071090047393,1.65599224948286,254,128,126,79,1,10.22,1.1,0,0,0,0,0,0,0.280323048562186,107.470634319276,49.6769957890735
8.7,"random_policy_SVM","SVM",84,4,3412,3265,147,500,252,248,0.890137019785711,0.635071090047393,1.67152517690762,343,173,170,89,1,12.78,1,0,0,0,0,0,0,0.218445237893679,116.452210019478,33.4475434510822
8.7,"random_policy_SVM","SVM",84,5,3312,3197,115,600,320,280,0.893426037833218,0.649289099526066,1.65143028736307,417,207,210,74,1,15.34,1.1,0,0,0,0,0,0,0.127836236271502,90.8053629503359,17.8699898869546
8.7,"random_policy_SVM","SVM",84,6,3212,3124,88,700,393,307,0.88657097461942,0.677725118483412,1.62888422851712,483,232,251,66,1.1,17.89,1.3,0,0,0,0,0,0,0.0870783694886089,87.9827390852599,12.6440036058475
8.7,"random_policy_SVM","SVM",84,7,3112,3042,70,800,475,325,0.884599193362213,0.682464454976303,1.62184807939043,521,248,273,38,1.1,20.45,1.5,0,0,0,0,0,0,0.0688610123899765,96.4115654958182,8.76457123782196
8.7,"random_policy_SVM","SVM",84,8,3012,2955,57,900,562,338,0.89402083135294,0.677725118483412,1.65751850962063,555,267,288,34,1.1,23.01,1.7,0,0,0,0,0,0,0.0597902195683404,86.2588762863346,7.2110222212379
8.7,"random_policy_SVM","SVM",84,9,2912,2859,53,1000,658,342,0.901427232852154,0.677725118483412,1.66606241946404,573,274,299,18,1.1,25.56,1.9,0,0,0,0,0,0,0.0474413819186406,69.0946022492868,5.24435131077649
8.7,"random_policy_SVM","SVM",84,10,2812,2763,49,1100,754,346,0.910723937044238,0.682464454976303,1.69013641957529,599,288,311,26,1.1,28.12,2.2,0,0,0,0,0,0,0.039285764877725,54.5022920747101,4.47440533801589
8.7,"random_policy_SVM","SVM",84,11,2712,2668,44,1200,849,351,0.920623582612471,0.672985781990521,1.70878196868107,609,294,315,10,1.1,30.67,2.4,0,0,0,0,0,0,0.0386518119603352,51.7106838395042,4.32462948990906
8.7,"random_policy_SVM","SVM",84,12,2612,2574,38,1300,943,357,0.925658957889151,0.677725118483412,1.71416612529812,626,302,324,17,1.1,33.23,2.6,0,0,0,0,0,0,0.046520617710743,56.2292415527513,5.32697526128489
8.7,"random_policy_SVM","SVM",84,13,2512,2478,34,1400,1039,361,0.930193239995107,0.682464454976303,1.73281663219083,647,311,336,21,1.1,35.79,2.9,0,0,0,0,0,0,0.045401896200074,47.433137338608,5.12551713987786
8.7,"random_policy_SVM","SVM",84,14,2412,2380,32,1500,1137,363,0.932177243036979,0.677725118483412,1.75150151789809,661,318,343,14,1.1,38.34,3.1,0,0,0,0,0,0,0.0370523755456461,36.1083132871998,4.05774267108483
8.7,"random_policy_SVM","SVM",84,15,2312,2281,31,1600,1236,364,0.932337484213532,0.677725118483412,1.74988871723705,666,320,346,5,1.1,40.9,3.4,0,0,0,0,0,0,0.0347517517685864,34.2905399599575,3.83122317281247
8.7,"random_policy_SVM","SVM",84,16,2212,2186,26,1700,1331,369,0.932337484213531,0.677725118483412,1.74506808716201,678,324,354,12,1.1,43.46,3.6,0,0,0,0,0,0,0.0345496173105524,29.5629002646701,4.25976501836732
8.7,"random_policy_SVM","SVM",84,17,2112,2096,16,1800,1421,379,0.93034125938701,0.677725118483412,1.73496238966912,713,337,376,35,1.1,46.01,3.7,0,0,0,0,0,0,0.0337861210281569,30.0137017669763,4.37087629295574
8.7,"random_policy_SVM","SVM",84,18,2012,2001,11,1900,1516,384,0.930047936555357,0.677725118483412,1.73975069433242,725,342,383,12,1.1,48.57,3.9,0,0,0,0,0,0,0.0265115391593394,25.7243195009221,2.9973151494926
8.7,"random_policy_SVM","SVM",84,19,1912,1902,10,2000,1615,385,0.929874115618083,0.672985781990521,1.73975069433242,730,343,387,5,1.1,51.12,4.2,0,0,0,0,0,0,0.0218183559158977,21.6330729005363,2.35764557412964
8.7,"random_policy_SVM","SVM",84,20,1812,1802,10,2100,1715,385,0.930839636605604,0.672985781990521,1.74988871723705,733,348,385,3,1.1,53.68,4.5,0,0,0,0,0,0,0.0162522720355973,15.1686995963534,1.86288358512889
8.7,"random_policy_SVM","SVM",84,21,1712,1703,9,2200,1814,386,0.930739146376244,0.66824644549763,1.74988871723705,739,352,387,6,1.1,56.24,4.7,0,0,0,0,0,0,0.0123287578508734,10.4180677135398,1.29643623840783
8.7,"random_policy_SVM","SVM",84,22,1612,1604,8,2300,1913,387,0.93078803351486,0.658767772511848,1.75842475976015,754,364,390,15,1.1,58.79,4.9,0,0,0,0,0,0,0.0085736398815818,6.4686388405154,1.09246072975977
8.7,"random_policy_SVM","SVM",84,23,1512,1507,5,2400,2010,390,0.930868154103136,0.654028436018957,1.75680707368862,759,367,392,5,1.1,61.35,5.2,0,0,0,0,0,0,0.0079732442835617,5.9350645021485,0.833730254678673
8.7,"random_policy_SVM","SVM",84,24,1412,1408,4,2500,2109,391,0.930739146376254,0.649289099526066,1.75842475976015,775,374,401,16,1.1,63.91,5.4,0,0,0,0,0,0,0.00649749687625491,4.70127023164313,0.761965508672861
8.7,"random_policy_SVM","SVM",84,25,1312,1309,3,2600,2208,392,0.93072149268731,0.644549763033175,1.75519236130471,778,375,403,3,1.1,66.46,5.6,0,0,0,0,0,0,0.00608758652762064,4.02817244142072,0.62893750859061
8.7,"random_policy_SVM","SVM",84,26,1212,1209,3,2700,2308,392,0.931256535259847,0.649289099526066,1.75680707368862,788,382,406,10,1.1,69.02,5.9,0,0,0,0,0,0,0.00480369415259507,2.94627328167765,0.535188665713473
8.7,"random_policy_SVM","SVM",84,27,1112,1109,3,2800,2408,392,0.931183204551937,0.649289099526066,1.75680707368862,789,381,408,1,1.1,71.57,6.1,0,0,0,0,0,0,0.00448607858286536,2.40453757075332,0.460123485261746
8.7,"random_policy_SVM","SVM",84,28,1012,1009,3,2900,2508,392,0.931902931870334,0.644549763033175,1.75680707368862,791,384,407,2,1.1,74.13,6.4,0,0,0,0,0,0,0.00295092875611497,1.43858323081801,0.333070008820829
8.7,"random_policy_SVM","SVM",84,29,912,909,3,3000,2608,392,0.932295386955277,0.644549763033175,1.75842475976015,791,384,407,0,1.1,76.69,6.7,0,0,0,0,0,0,0.00262136730288683,1.07451318539947,0.276050916375969
8.7,"random_policy_SVM","SVM",84,30,812,810,2,3100,2707,393,0.93244340634718,0.644549763033175,1.75842475976015,795,386,409,4,1.1,79.24,6.9,0,0,0,0,0,0,0.00204245486169499,0.723914360806321,0.224656328657192
8.7,"random_policy_SVM","SVM",84,31,712,711,1,3200,2806,394,0.933040915819067,0.644549763033175,1.7600454277415,797,389,408,2,1,81.8,7.1,0,0,0,0,0,0,0.00174851530666486,0.558507051866126,0.195073327655431
8.7,"random_policy_SVM","SVM",84,32,612,611,1,3300,2906,394,0.933472752210113,0.644549763033175,1.75680707368862,800,389,411,3,1.1,84.36,7.4,0,0,0,0,0,0,0.00132824986170438,0.400580727491947,0.159388008243066
8.7,"random_policy_SVM","SVM",84,33,512,511,1,3400,3006,394,0.933593612080565,0.644549763033175,1.75842475976015,800,389,411,0,1.1,86.91,7.6,0,0,0,0,0,0,0.000693616344216179,0.198295407218054,0.092311660021823
8.7,"random_policy_SVM","SVM",84,34,412,412,0,3500,3105,395,0.933994215021946,0.644549763033175,1.75842475976015,804,391,413,4,1.1,89.47,7.9,0,0,0,0,0,0,0.000477300308150982,0.137399823694257,0.0637959986465679
8.7,"random_policy_SVM","SVM",84,35,312,312,0,3600,3205,395,0.934545553307367,0.644549763033175,1.7600454277415,805,391,414,1,1.1,92.02,8.1,0,0,0,0,0,0,0.000368713326887827,0.0947317489912788,0.0493050768412667
8.7,"random_policy_SVM","SVM",84,36,212,212,0,3700,3305,395,0.934398891891541,0.639810426540284,1.75842475976015,809,393,416,4,1.1,94.58,8.4,0,0,0,0,0,0,0.000126794524533589,0.0270156261673303,0.0174783701448143
8.7,"random_policy_SVM","SVM",84,37,112,112,0,3800,3405,395,0.934700362579626,0.635071090047393,1.75519236130471,810,394,416,1,1.1,97.14,8.6,0,0,0,0,0,0,4.11382780250104e-05,0.00739557882582239,0.00700114200952739
8.7,"random_policy_SVM","SVM",84,38,12,12,0,3900,3505,395,0.935053436358467,0.635071090047393,1.7685893375849,810,395,415,0,1.1,99.69,8.9,0,0,0,0,0,0,2.00062946819329e-05,0.000305748224959315,0.000305748224959315
8.7,"random_policy_SVM","SVM",84,39,0,0,0,3912,3517,395,0.93514306277925,0.635071090047393,1.7685893375849,810,395,415,0,1.1,100,8.9,0,0,0,0,0,0,0,0,0
8.7,"random_policy_SVM","SVM",85,0,3812,3423,389,100,94,6,0.837156941294698,0.5260663507109,1.6062550505602,24,6,18,0,3,2.56,15.7,0,0,0,0,0,0,0.142352373328418,265.230780220632,15.2939880778356
8.7,"random_policy_SVM","SVM",85,1,3712,3385,327,200,132,68,0.896495063756969,0.582938388625592,1.67696786912642,81,42,39,57,0.9,5.11,1.9,0,0,0,0,0,0,0.686044835975415,262.225182763181,79.5678817543043
8.7,"random_policy_SVM","SVM",85,2,3612,3335,277,300,182,118,0.896098534743811,0.597156398104265,1.7296313074993,159,82,77,78,0.9,7.67,1.5,0,0,0,0,0,0,0.5,171.783029763837,66.0238000207353
8.7,"random_policy_SVM","SVM",85,3,3512,3306,206,400,211,189,0.893109629408314,0.597156398104265,1.71574454714462,222,113,109,63,1,10.22,1.1,0,0,0,0,0,0,0.380853910957663,160.493720583494,57.0763884026197
8.7,"random_policy_SVM","SVM",85,4,3412,3248,164,500,269,231,0.895302760765345,0.597156398104265,1.72804303265311,316,155,161,94,1,12.78,1.2,0,0,0,0,0,0,0.197762179624908,113.194783532822,33.0283083047077
8.7,"random_policy_SVM","SVM",85,5,3312,3183,129,600,334,266,0.881494860060562,0.62085308056872,1.68005336658572,389,191,198,73,1,15.34,1.3,0,0,0,0,0,0,0.116739975075341,70.1822437911618,18.6520586300618
8.7,"random_policy_SVM","SVM",85,6,3212,3111,101,700,406,294,0.887271690272813,0.630331753554502,1.65751850962063,449,216,233,60,1.1,17.89,1.4,0,0,0,0,0,0,0.0814754859628379,59.8237484839496,12.3330328357479
8.7,"random_policy_SVM","SVM",85,7,3112,3032,80,800,485,315,0.891421665150259,0.644549763033175,1.64043068993382,497,238,259,48,1.1,20.45,1.5,0,0,0,0,0,0,0.0657160158179008,69.1650987298602,9.10716746734585
8.7,"random_policy_SVM","SVM",85,8,3012,2951,61,900,566,334,0.88219557571395,0.663507109004739,1.61479896040361,539,257,282,42,1.1,23.01,1.7,0,0,0,0,0,0,0.0711345225576746,117.105976394267,10.3138324710438
8.7,"random_policy_SVM","SVM",85,9,2912,2858,54,1000,659,341,0.896291367346107,0.658767772511848,1.64745620695975,561,272,289,22,1.1,25.56,1.9,0,0,0,0,0,0,0.0524369148088061,75.9982609171011,6.01321804970985
8.7,"random_policy_SVM","SVM",85,10,2812,2764,48,1100,753,347,0.89878732736729,0.658767772511848,1.66606241946404,581,279,302,20,1.1,28.12,2.2,0,0,0,0,0,0,0.0482533994863287,72.6801872385273,5.33966056650404
8.7,"random_policy_SVM","SVM",85,11,2712,2671,41,1200,846,354,0.911161205339565,0.654028436018957,1.68315023915085,610,298,312,29,1,30.67,2.4,0,0,0,0,0,0,0.043877593034922,62.3045546474035,4.96256533712075
8.7,"random_policy_SVM","SVM",85,12,2612,2579,33,1300,938,362,0.91442849576991,0.654028436018957,1.69710974594192,626,304,322,16,1.1,33.23,2.6,0,0,0,0,0,0,0.0656443946868156,69.9648781672235,7.90913153135495
8.7,"random_policy_SVM","SVM",85,13,2512,2483,29,1400,1034,366,0.919287334157165,0.654028436018957,1.71259060496236,651,314,337,25,1.1,35.79,2.8,0,0,0,0,0,0,0.0520347191736272,52.0007636702944,5.85850544507872
8.7,"random_policy_SVM","SVM",85,14,2412,2387,25,1500,1130,370,0.921060850907803,0.654028436018957,1.71259060496236,671,322,349,20,1.1,38.34,3.1,0,0,0,0,0,0,0.0461544611105298,45.3553518165729,5.31995098139756
8.7,"random_policy_SVM","SVM",85,15,2312,2289,23,1600,1228,372,0.921650212523254,0.654028436018957,1.71101797814422,676,324,352,5,1.1,40.9,3.3,0,0,0,0,0,0,0.0404830119067148,37.2988303891047,4.56003399556688
8.7,"random_policy_SVM","SVM",85,16,2212,2195,17,1700,1322,378,0.919549423539146,0.654028436018957,1.72111095623083,692,332,360,16,1.1,43.46,3.5,0,0,0,0,0,0,0.0423935353446823,35.224245122478,5.42483424614337
8.7,"random_policy_SVM","SVM",85,17,2112,2101,11,1800,1416,384,0.918896237048289,0.654028436018957,1.72111095623083,717,339,378,25,1.1,46.01,3.7,0,0,0,0,0,0,0.0342013221860491,28.61987117931,4.01645261031918
8.7,"random_policy_SVM","SVM",85,18,2012,2004,8,1900,1513,387,0.918301443528552,0.654028436018957,1.71574454714462,718,341,377,1,1.1,48.57,3.9,0,0,0,0,0,0,0.0298005846428974,26.9280158815909,3.31331925030296
8.7,"random_policy_SVM","SVM",85,19,1912,1906,6,2000,1611,389,0.918996727277653,0.649289099526066,1.71416612529812,729,345,384,11,1.1,51.12,4.1,0,0,0,0,0,0,0.0224388913466246,20.885335749719,2.47021933533093
8.7,"random_policy_SVM","SVM",85,20,1812,1806,6,2100,1711,389,0.919182769999583,0.649289099526066,1.71795295447628,735,350,385,6,1.1,53.68,4.4,0,0,0,0,0,0,0.0178487007955856,16.5436375420917,1.93990533893757
8.7,"random_policy_SVM","SVM",85,21,1712,1707,5,2200,1810,390,0.919873979820463,0.649289099526066,1.71101797814422,738,353,385,3,1.1,56.24,4.6,0,0,0,0,0,0,0.0159320281176827,13.8467464479145,1.65594322417468
8.7,"random_policy_SVM","SVM",85,22,1612,1607,5,2300,1910,390,0.920688765463953,0.639810426540284,1.74135267471394,752,364,388,14,1.1,58.79,4.9,0,0,0,0,0,0,0.0117448477873564,8.31114847892727,1.53959144678714
8.7,"random_policy_SVM","SVM",85,23,1512,1509,3,2400,2008,392,0.921097516261764,0.639810426540284,1.74346710726553,753,365,388,1,1.1,61.35,5.1,0,0,0,0,0,0,0.00795607945433833,6.27842888899877,0.912902749104615
8.7,"random_policy_SVM","SVM",85,24,1412,1409,3,2500,2108,392,0.92106764078817,0.639810426540284,1.74988871723705,755,366,389,2,1.1,63.91,5.4,0,0,0,0,0,0,0.00766373588165788,5.65012105785262,0.791429538692962
8.7,"random_policy_SVM","SVM",85,25,1312,1309,3,2600,2208,392,0.921711321446525,0.639810426540284,1.74988871723705,760,370,390,5,1.1,66.46,5.6,0,0,0,0,0,0,0.00519877434615176,3.59716029356396,0.596909636205727
8.7,"random_policy_SVM","SVM",85,26,1212,1209,3,2700,2308,392,0.921863414766641,0.639810426540284,1.74988871723705,760,370,390,0,1.1,69.02,5.9,0,0,0,0,0,0,0.00482941380468777,2.86231406380682,0.487951864893963
8.7,"random_policy_SVM","SVM",85,27,1112,1109,3,2800,2408,392,0.922725729572654,0.644549763033175,1.75150151789809,769,377,392,9,1,71.57,6.1,0,0,0,0,0,0,0.0030497231849691,1.63209402183385,0.363120402206805
8.7,"random_policy_SVM","SVM",85,28,1012,1010,2,2900,2507,393,0.923053001806117,0.639810426540284,1.74988871723705,776,378,398,7,1.1,74.13,6.4,0,0,0,0,0,0,0.00287025719418338,1.37558201825251,0.298457405609111
8.7,"random_policy_SVM","SVM",85,29,912,910,2,3000,2607,393,0.924108149214408,0.639810426540284,1.74667201003624,773,379,394,-3,1,76.69,6.6,0,0,0,0,0,0,0.00273910452404574,1.12305522074927,0.287471670161356
8.7,"random_policy_SVM","SVM",85,30,812,810,2,3100,2707,393,0.925061448417281,0.639810426540284,1.75150151789809,778,380,398,5,1,79.24,6.9,0,0,0,0,0,0,0.00192783951562787,0.653404839241675,0.205371053374185
8.7,"random_policy_SVM","SVM",85,31,712,710,2,3200,2807,393,0.925548961827297,0.639810426540284,1.74667201003624,779,382,397,1,1,81.8,7.1,0,0,0,0,0,0,0.00149405108775352,0.456889871188727,0.173332692469932
8.7,"random_policy_SVM","SVM",85,32,612,610,2,3300,2907,393,0.925695623243121,0.639810426540284,1.74667201003624,781,383,398,2,1,84.36,7.4,0,0,0,0,0,0,0.0010518920949993,0.313026429453767,0.138866463240532
8.7,"random_policy_SVM","SVM",85,33,512,510,2,3400,3007,393,0.926012031668005,0.639810426540284,1.74827888401052,783,383,400,2,1,86.91,7.7,0,0,0,0,0,0,0.000517393068820855,0.153524542527351,0.0717874655066596
8.7,"random_policy_SVM","SVM",85,34,412,411,1,3500,3106,394,0.9268159535029,0.639810426540284,1.74988871723705,787,386,401,4,1,89.47,7.9,0,0,0,0,0,0,0.000392054135766544,0.11339250816942,0.050651901175876
8.7,"random_policy_SVM","SVM",85,35,312,312,0,3600,3205,395,0.928216026833601,0.644549763033175,1.74346710726553,794,389,405,7,1,92.02,8.1,0,0,0,0,0,0,0.000300444724659902,0.0768602222164613,0.0382764279204008
8.7,"random_policy_SVM","SVM",85,36,212,212,0,3700,3305,395,0.928977851410247,0.644549763033175,1.74506808716201,797,390,407,3,1,94.58,8.4,0,0,0,0,0,0,0.000183239695267764,0.0367882837849164,0.023246517402274
8.7,"random_policy_SVM","SVM",85,37,112,112,0,3800,3405,395,0.929199201510055,0.644549763033175,1.74667201003624,802,391,411,5,1.1,97.14,8.6,0,0,0,0,0,0,5.93632249368402e-05,0.0103019690626944,0.00969899009424439
8.7,"random_policy_SVM","SVM",85,38,12,12,0,3900,3505,395,0.929325493284793,0.644549763033175,1.74667201003624,801,391,410,-1,1,99.69,8.9,0,0,0,0,0,0,4.95534444345765e-05,0.000716716698391467,0.000716716698391467
8.7,"random_policy_SVM","SVM",85,39,0,0,0,3912,3517,395,0.929442279227024,0.644549763033175,1.75150151789809,801,391,410,0,1,100,8.9,0,0,0,0,0,0,0,0,0
8.7,"random_policy_SVM","SVM",86,0,3812,3427,385,100,91,9,0.883511662627633,0.5,1.75174332666725,26,9,17,0,1.9,2.56,10.1,0,0,0,0,0,0,0.266667281617535,321.762884933825,31.4692749305106
8.7,"random_policy_SVM","SVM",86,1,3712,3380,332,200,138,62,0.909315767266749,0.537735849056604,1.75539331298557,93,46,47,67,1,5.11,2.2,0,0,0,0,0,0,0.768104054758585,360.711802943141,84.4123994971346
8.7,"random_policy_SVM","SVM",86,2,3612,3336,276,300,182,118,0.920691697680432,0.594339622641509,1.76387347391787,163,81,82,70,1,7.67,1.5,0,0,0,0,0,0,0.551635549650566,258.010018654925,71.8419435857916
8.7,"random_policy_SVM","SVM",86,3,3512,3297,215,400,221,179,0.921642396572585,0.594339622641509,1.75700821023763,241,120,121,78,1,10.22,1.2,0,0,0,0,0,0,0.345193634210998,151.472503182266,61.0904081301907
8.7,"random_policy_SVM","SVM",86,4,3412,3253,159,500,265,235,0.909511857365413,0.60377358490566,1.72836426009668,324,161,163,83,1,12.78,1.1,0,0,0,0,0,0,0.240989305099365,160.975547122115,37.6358554285482
8.7,"random_policy_SVM","SVM",86,5,3312,3185,127,600,333,267,0.896431971611546,0.636792452830189,1.67753001715266,393,194,199,69,1,15.34,1.2,0,0,0,0,0,0,0.174974235959161,154.239516975963,25.3695119410107
8.7,"random_policy_SVM","SVM",86,6,3212,3106,106,700,412,288,0.906337902458009,0.655660377358491,1.69065985614511,436,211,225,43,1.1,17.89,1.4,0,0,0,0,0,0,0.10035744550281,105.178265408275,14.036187423085
8.7,"random_policy_SVM","SVM",86,7,3112,3032,80,800,486,314,0.896802514280762,0.660377358490566,1.63817673708146,493,236,257,57,1.1,20.45,1.5,0,0,0,0,0,0,0.0925518550717307,135.583360551666,14.4922771841943
8.7,"random_policy_SVM","SVM",86,8,3012,2954,58,900,564,336,0.892537216548374,0.665094339622642,1.62968877471316,540,258,282,47,1.1,23.01,1.7,0,0,0,0,0,0,0.0816722109969073,135.446294814451,10.5933564335804
8.7,"random_policy_SVM","SVM",86,9,2912,2864,48,1000,654,346,0.901153009780147,0.669811320754717,1.68755202552719,578,278,300,38,1.1,25.56,1.9,0,0,0,0,0,0,0.0764390747425319,123.760990200817,8.28207355906347
8.7,"random_policy_SVM","SVM",86,10,2812,2771,41,1100,747,353,0.910244828630772,0.669811320754717,1.68910451129125,608,293,315,30,1.1,28.12,2.1,0,0,0,0,0,0,0.0680761551465351,89.0250423285348,7.57497335876301
8.7,"random_policy_SVM","SVM",86,11,2712,2673,39,1200,845,355,0.913144257400032,0.669811320754717,1.68910451129125,616,298,318,8,1.1,30.67,2.4,0,0,0,0,0,0,0.0523198359084116,67.061499583184,5.73152383488911
8.7,"random_policy_SVM","SVM",86,12,2612,2577,35,1300,941,359,0.917981597282328,0.674528301886792,1.70451234739179,629,302,327,13,1.1,33.23,2.6,0,0,0,0,0,0,0.0468352381513229,64.2959617751642,5.04444443516399
8.7,"random_policy_SVM","SVM",86,13,2512,2480,32,1400,1038,362,0.921718127921067,0.665094339622642,1.70451234739179,635,310,325,6,1,35.79,2.9,0,0,0,0,0,0,0.0388231317360599,50.0361864259672,4.25819632050399
8.7,"random_policy_SVM","SVM",86,14,2412,2381,31,1500,1137,363,0.924119893543363,0.669811320754717,1.70294713862467,644,311,333,9,1.1,38.34,3.1,0,0,0,0,0,0,0.0333497648628541,41.9724502897893,3.66234478701911
8.7,"random_policy_SVM","SVM",86,15,2312,2284,28,1600,1234,366,0.929615825688075,0.669811320754717,1.75174332666725,659,316,343,15,1.1,40.9,3.4,0,0,0,0,0,0,0.0422008628081859,41.879216203678,4.94024085910748
8.7,"random_policy_SVM","SVM",86,16,2212,2187,25,1700,1331,369,0.933215769430503,0.665094339622642,1.77725415181289,664,323,341,5,1.1,43.46,3.6,0,0,0,0,0,0,0.0366680918755391,32.927777391894,4.13418222821595
8.7,"random_policy_SVM","SVM",86,17,2112,2091,21,1800,1427,373,0.935030617102303,0.655660377358491,1.78931395671476,677,329,348,13,1.1,46.01,3.8,0,0,0,0,0,0,0.0321742991694705,27.3902494042489,3.71586959369855
8.7,"random_policy_SVM","SVM",86,18,2012,1997,15,1900,1521,379,0.935593192833646,0.660377358490566,1.79426136857665,697,336,361,20,1.1,48.57,4,0,0,0,0,0,0,0.0306840276170434,25.3977026777063,3.96546960558346
8.7,"random_policy_SVM","SVM",86,19,1912,1900,12,2000,1618,382,0.935609420979741,0.660377358490566,1.79426136857665,703,339,364,6,1.1,51.12,4.2,0,0,0,0,0,0,0.0244816955079403,23.0717133400395,2.92062763111747
8.7,"random_policy_SVM","SVM",86,20,1812,1802,10,2100,1716,384,0.935514756794176,0.660377358490566,1.79096005971082,713,342,371,10,1.1,53.68,4.5,0,0,0,0,0,0,0.0226919194179897,19.9544420145873,2.3400386046685
8.7,"random_policy_SVM","SVM",86,21,1712,1702,10,2200,1816,384,0.935764940713176,0.64622641509434,1.78931395671476,730,351,379,17,1.1,56.24,4.7,0,0,0,0,0,0,0.0152655177008361,11.7120389649612,1.94890474994717
8.7,"random_policy_SVM","SVM",86,22,1612,1604,8,2300,1914,386,0.935525575558251,0.64622641509434,1.7876708768647,734,353,381,4,1.1,58.79,5,0,0,0,0,0,0,0.0130796456047957,10.0075544922564,1.36184931599357
8.7,"random_policy_SVM","SVM",86,23,1512,1504,8,2400,2014,386,0.935598602215685,0.641509433962264,1.79944802207912,741,360,381,7,1.1,61.35,5.2,0,0,0,0,0,0,0.00889106199432489,6.25667096921784,1.05955613138609
8.7,"random_policy_SVM","SVM",86,24,1412,1405,7,2500,2113,387,0.935647286653975,0.641509433962264,1.79944802207912,744,361,383,3,1.1,63.91,5.5,0,0,0,0,0,0,0.00775504487625034,5.25322913717085,0.808660822025584
8.7,"random_policy_SVM","SVM",86,25,1312,1305,7,2600,2213,387,0.935679742946168,0.64622641509434,1.79614325068871,746,362,384,2,1.1,66.46,5.7,0,0,0,0,0,0,0.00583490928206124,3.69927907626629,0.638807637904861
8.7,"random_policy_SVM","SVM",86,26,1212,1205,7,2700,2313,387,0.935679742946168,0.64622641509434,1.79449541284404,747,363,384,1,1.1,69.02,6,0,0,0,0,0,0,0.00592266174736223,3.35635322837897,0.612461455512861
8.7,"random_policy_SVM","SVM",86,27,1112,1105,7,2800,2413,387,0.93538763631643,0.64622641509434,1.79614325068871,750,366,384,3,1,71.57,6.2,0,0,0,0,0,0,0.00437474819104691,2.24990394207296,0.47610990139341
8.7,"random_policy_SVM","SVM",86,28,1012,1006,6,2900,2512,388,0.935292972130866,0.641509433962264,1.79944802207912,755,367,388,5,1.1,74.13,6.5,0,0,0,0,0,0,0.00460404838109352,2.13607555172411,0.495739582390756
8.7,"random_policy_SVM","SVM",86,29,912,906,6,3000,2612,388,0.93540115977151,0.636792452830189,1.78956999085087,756,369,387,1,1,76.69,6.7,0,0,0,0,0,0,0.00362909948355152,1.47226406802244,0.393398107919965
8.7,"random_policy_SVM","SVM",86,30,812,807,5,3100,2711,389,0.935294324476375,0.636792452830189,1.79449541284404,759,371,388,3,1,79.24,7,0,0,0,0,0,0,0.00329252198661778,1.24757339957012,0.371228900360476
8.7,"random_policy_SVM","SVM",86,31,712,708,4,3200,2810,390,0.935087415613643,0.632075471698113,1.79944802207912,762,372,390,3,1,81.8,7.2,0,0,0,0,0,0,0.00230707896234091,0.766462839826983,0.25850153996698
8.7,"random_policy_SVM","SVM",86,32,612,609,3,3300,2909,391,0.934981932664015,0.632075471698113,1.79779411764706,765,374,391,3,1,84.36,7.4,0,0,0,0,0,0,0.00230350820656307,0.741398795853855,0.26604408450979
8.7,"random_policy_SVM","SVM",86,33,512,509,3,3400,3009,391,0.934868335641339,0.636792452830189,1.79944802207912,768,375,393,3,1,86.91,7.7,0,0,0,0,0,0,0.00140339248091527,0.416855674748105,0.171793313416075
8.7,"random_policy_SVM","SVM",86,34,412,410,2,3500,3108,392,0.934581638393633,0.627358490566038,1.79944802207912,774,377,397,6,1.1,89.47,7.9,0,0,0,0,0,0,0.00105946042233087,0.306306664167454,0.13782586791465
8.7,"random_policy_SVM","SVM",86,35,312,312,0,3600,3206,394,0.93448697420807,0.627358490566038,1.79614325068871,786,382,404,12,1.1,92.02,8.1,0,0,0,0,0,0,0.00124772370383308,0.319274202411976,0.158463750521152
8.7,"random_policy_SVM","SVM",86,36,212,212,0,3700,3306,394,0.934424766314699,0.632075471698113,1.79614325068871,789,384,405,3,1.1,94.58,8.4,0,0,0,0,0,0,0.00053043777936844,0.110847795177796,0.0683385305221103
8.7,"random_policy_SVM","SVM",86,37,112,112,0,3800,3406,394,0.934231380907048,0.636792452830189,1.79449541284404,790,385,405,1,1.1,97.14,8.6,0,0,0,0,0,0,0.000314574084838993,0.0487263403846517,0.0452747942984968
8.7,"random_policy_SVM","SVM",86,38,12,12,0,3900,3506,394,0.934261132508225,0.636792452830189,1.79779411764706,793,386,407,3,1.1,99.69,8.9,0,0,0,0,0,0,0.000184569845840231,0.00273412251655441,0.00273412251655441
8.7,"random_policy_SVM","SVM",86,39,0,0,0,3912,3518,394,0.934171877704694,0.636792452830189,1.79779411764706,794,386,408,1,1.1,100,8.9,0,0,0,0,0,0,0,0,0
8.7,"random_policy_SVM","SVM",87,0,3812,3420,392,100,95,5,0.896678653494822,0.588516746411483,1.74238528873503,16,5,11,0,2.2,2.56,19,0,0,0,0,0,0,0.128770065758169,195.602620113957,14.091553165633
8.7,"random_policy_SVM","SVM",87,1,3712,3383,329,200,132,68,0.909556505615902,0.588516746411483,1.73917942803819,91,44,47,75,1.1,5.11,1.9,0,0,0,0,0,0,0.767414760810525,288.670898158523,84.2074842057343
8.7,"random_policy_SVM","SVM",87,2,3612,3333,279,300,182,118,0.902287722219627,0.593301435406699,1.72195982974078,164,83,81,73,1,7.67,1.5,0,0,0,0,0,0,0.559210473910857,177.077604689002,70.3876678765374
8.7,"random_policy_SVM","SVM",87,3,3512,3301,211,400,214,186,0.89226918052271,0.61244019138756,1.6773677174219,227,114,113,63,1,10.22,1.2,0,0,0,0,0,0,0.28140621601247,108.598258190093,56.4816046976859
8.7,"random_policy_SVM","SVM",87,4,3412,3243,169,500,272,228,0.875915787282632,0.617224880382775,1.67183906526739,306,151,155,79,1,12.78,1.2,0,0,0,0,0,0,0.153119726362453,74.6345008755283,26.1415027200997
8.7,"random_policy_SVM","SVM",87,5,3312,3182,130,600,333,267,0.869731569909319,0.631578947368421,1.59848155324449,381,186,195,75,1,15.34,1.2,0,0,0,0,0,0,0.0890397058923222,60.1070818055196,15.4753689091058
8.7,"random_policy_SVM","SVM",87,6,3212,3109,103,700,406,294,0.863886964118939,0.636363636363636,1.56698344506411,435,211,224,54,1.1,17.89,1.4,0,0,0,0,0,0,0.0682023281479086,62.8635925527036,11.484766433861
8.7,"random_policy_SVM","SVM",87,7,3112,3034,78,800,481,319,0.868789421646957,0.645933014354067,1.59134886011821,485,236,249,50,1.1,20.45,1.5,0,0,0,0,0,0,0.0637410979564347,82.6787026736907,8.54702067493983
8.7,"random_policy_SVM","SVM",87,8,3012,2945,67,900,570,330,0.887257170871192,0.641148325358852,1.61566952693529,523,249,274,38,1.1,23.01,1.7,0,0,0,0,0,0,0.052133402811908,75.3099789198947,6.15533458501412
8.7,"random_policy_SVM","SVM",87,9,2912,2856,56,1000,659,341,0.896341780714997,0.641148325358852,1.62575640303968,548,266,282,25,1.1,25.56,1.9,0,0,0,0,0,0,0.0607215154947604,93.1517409433406,7.30456599203728
8.7,"random_policy_SVM","SVM",87,10,2812,2763,49,1100,752,348,0.908548626079424,0.641148325358852,1.69613043229467,587,285,302,39,1.1,28.12,2.2,0,0,0,0,0,0,0.0563377001593215,72.0567707068611,6.56435954915993
8.7,"random_policy_SVM","SVM",87,11,2712,2665,47,1200,850,350,0.918283701656691,0.631578947368421,1.70863438830604,600,292,308,13,1.1,30.67,2.4,0,0,0,0,0,0,0.0484955203390696,60.0558048025071,5.52432292444441
8.7,"random_policy_SVM","SVM",87,12,2612,2575,37,1300,940,360,0.923669557929784,0.626794258373206,1.72195982974078,628,303,325,28,1.1,33.23,2.6,0,0,0,0,0,0,0.0469854729701729,57.9559454263733,5.44451947711401
8.7,"random_policy_SVM","SVM",87,13,2512,2481,31,1400,1034,366,0.928845895766635,0.62200956937799,1.7445793296163,647,311,336,19,1.1,35.79,2.8,0,0,0,0,0,0,0.0519453197123393,53.3183624875001,5.85105582143733
8.7,"random_policy_SVM","SVM",87,14,2412,2384,28,1500,1131,369,0.930805509376288,0.626794258373206,1.75478468899522,658,316,342,11,1.1,38.34,3.1,0,0,0,0,0,0,0.0434722832829964,43.3675486853083,5.0013706092467
8.7,"random_policy_SVM","SVM",87,15,2312,2288,24,1600,1227,373,0.931592915264172,0.631578947368421,1.75801633667292,668,322,346,10,1.1,40.9,3.3,0,0,0,0,0,0,0.0370046081579438,37.5328710143982,4.39543442462626
8.7,"random_policy_SVM","SVM",87,16,2212,2192,20,1700,1323,377,0.933039003294781,0.631578947368421,1.7563990263356,679,325,354,11,1.1,43.46,3.5,0,0,0,0,0,0,0.0298921202963559,32.1400681610517,3.57949419187985
8.7,"random_policy_SVM","SVM",87,17,2112,2097,15,1800,1418,382,0.934150957348622,0.62200956937799,1.7563990263356,692,329,363,13,1.1,46.01,3.7,0,0,0,0,0,0,0.0265465390064512,29.8538135680701,2.88711474466118
8.7,"random_policy_SVM","SVM",87,18,2012,1998,14,1900,1517,383,0.933322469414421,0.62200956937799,1.75478468899522,699,333,366,7,1.1,48.57,4,0,0,0,0,0,0,0.0228267122515522,23.8876162187929,2.38020549210545
8.7,"random_policy_SVM","SVM",87,19,1912,1899,13,2000,1616,384,0.933293711981996,0.61244019138756,1.7855136374661,721,347,374,22,1.1,51.12,4.2,0,0,0,0,0,0,0.0169260676143683,14.1799611845995,2.27109277488886
8.7,"random_policy_SVM","SVM",87,20,1812,1800,12,2100,1715,385,0.9332690627542,0.61244019138756,1.78386951809458,721,347,374,0,1.1,53.68,4.5,0,0,0,0,0,0,0.0127151894320571,11.5755190038417,1.43237206386395
8.7,"random_policy_SVM","SVM",87,21,1712,1702,10,2200,1813,387,0.934178345379506,0.617224880382775,1.7855136374661,727,350,377,6,1.1,56.24,4.7,0,0,0,0,0,0,0.0121833033281507,10.5555349875836,1.25886057897317
8.7,"random_policy_SVM","SVM",87,22,1612,1604,8,2300,1911,389,0.933548420669198,0.617224880382775,1.78222842378171,747,362,385,20,1.1,58.79,4.9,0,0,0,0,0,0,0.00963950944298617,7.54387353728024,1.18866246244277
8.7,"random_policy_SVM","SVM",87,23,1512,1505,7,2400,2010,390,0.933781218931702,0.61244019138756,1.77732320793644,749,363,386,2,1.1,61.35,5.2,0,0,0,0,0,0,0.00834781910201387,6.4907322319989,0.881975292825761
8.7,"random_policy_SVM","SVM",87,24,1412,1405,7,2500,2110,390,0.93316498823684,0.607655502392344,1.7789552769979,749,367,382,0,1,63.91,5.4,0,0,0,0,0,0,0.00652686923747144,4.80428639973873,0.702772027436051
8.7,"random_policy_SVM","SVM",87,25,1312,1306,6,2600,2209,391,0.933573069896985,0.607655502392344,1.78222842378171,756,370,386,7,1,66.46,5.6,0,0,0,0,0,0,0.00548820910494873,3.77940545977278,0.587078837025931
8.7,"random_policy_SVM","SVM",87,26,1212,1207,5,2700,2308,392,0.934098920089934,0.607655502392344,1.7855136374661,760,372,388,4,1,69.02,5.9,0,0,0,0,0,0,0.00517940872891674,3.220921012416,0.540792999228978
8.7,"random_policy_SVM","SVM",87,27,1112,1108,4,2800,2407,393,0.934104397696107,0.602870813397129,1.78222842378171,773,377,396,13,1.1,71.57,6.1,0,0,0,0,0,0,0.00419356970759146,2.45284305658363,0.457509157715956
8.7,"random_policy_SVM","SVM",87,28,1012,1008,4,2900,2507,393,0.934290636306109,0.602870813397129,1.78222842378171,773,379,394,0,1,74.13,6.4,0,0,0,0,0,0,0.00423644306531448,2.24064961395063,0.447610228229281
8.7,"random_policy_SVM","SVM",87,29,912,909,3,3000,2606,394,0.933808606962575,0.602870813397129,1.7855136374661,778,381,397,5,1,76.69,6.6,0,0,0,0,0,0,0.00350382196252424,1.67011757272448,0.375965805906646
8.7,"random_policy_SVM","SVM",87,30,812,809,3,3100,2706,394,0.933914050881475,0.602870813397129,1.78059034618632,779,381,398,1,1,79.24,6.9,0,0,0,0,0,0,0.00284880831550002,1.21004945313607,0.308991966976358
8.7,"random_policy_SVM","SVM",87,31,712,709,3,3200,2806,394,0.933994845572579,0.602870813397129,1.78222842378171,780,381,399,1,1,81.8,7.1,0,0,0,0,0,0,0.00217447826420411,0.805835745643189,0.235306944612437
8.7,"random_policy_SVM","SVM",87,32,612,609,3,3300,2906,394,0.934105767097656,0.602870813397129,1.78386951809458,778,381,397,-2,1,84.36,7.4,0,0,0,0,0,0,0.00195612264777031,0.646098536289815,0.220367173599774
8.7,"random_policy_SVM","SVM",87,33,512,509,3,3400,3006,394,0.934096181286847,0.607655502392344,1.7789552769979,779,381,398,1,1,86.91,7.6,0,0,0,0,0,0,0.00127010856126466,0.39754991169994,0.157345469653507
8.7,"random_policy_SVM","SVM",87,34,412,409,3,3500,3106,394,0.934435792869793,0.607655502392344,1.7789552769979,779,381,398,0,1,89.47,7.9,0,0,0,0,0,0,0.000761557885109127,0.205600208030319,0.0936756933002617
8.7,"random_policy_SVM","SVM",87,35,312,312,0,3600,3203,397,0.934900019993262,0.607655502392344,1.78590931039024,792,388,404,13,1,92.02,8.1,0,0,0,0,0,0,0.000821203544804401,0.216200889332173,0.116884776138399
8.7,"random_policy_SVM","SVM",87,36,212,212,0,3700,3303,397,0.935206765939147,0.607655502392344,1.78590931039024,792,390,402,0,1,94.58,8.3,0,0,0,0,0,0,0.00045087956908878,0.0946761335227299,0.0596086583043239
8.7,"random_policy_SVM","SVM",87,37,112,112,0,3800,3403,397,0.935703858699668,0.607655502392344,1.79248724523514,792,389,403,0,1,97.14,8.6,0,0,0,0,0,0,0.000184862726008243,0.0291453326931687,0.0271610040390297
8.7,"random_policy_SVM","SVM",87,38,12,12,0,3900,3503,397,0.936285854355926,0.607655502392344,1.79248724523514,796,390,406,4,1,99.69,8.8,0,0,0,0,0,0,0.00011620445458869,0.00178698804976951,0.00178698804976951
8.7,"random_policy_SVM","SVM",87,39,0,0,0,3912,3515,397,0.936276268545117,0.607655502392344,1.7875492638433,797,391,406,1,1,100,8.9,0,0,0,0,0,0,0,0,0
8.7,"random_policy_SVM","SVM",88,0,3812,3429,383,100,91,9,0.900755925619939,0.55607476635514,1.76257047964779,23,9,14,0,1.6,2.56,10.1,0,0,0,0,0,0,0.774152685767712,428.440260940733,83.6226134156794
8.7,"random_policy_SVM","SVM",88,1,3712,3384,328,200,136,64,0.898092213268659,0.565420560747664,1.73217893714158,107,53,54,84,1,5.11,2.1,0,0,0,0,0,0,0.774232196767882,332.002334441717,84.3711715713315
8.7,"random_policy_SVM","SVM",88,2,3612,3337,275,300,183,117,0.899059250834268,0.598130841121495,1.70852481024423,163,81,82,56,1,7.67,1.6,0,0,0,0,0,0,0.607386579221642,207.87000472113,77.7325384207812
8.7,"random_policy_SVM","SVM",88,3,3512,3303,209,400,217,183,0.880146356642372,0.607476635514019,1.69169205349306,234,115,119,71,1,10.22,1.2,0,0,0,0,0,0,0.363167755387028,149.671610124481,63.2107243774835
8.7,"random_policy_SVM","SVM",88,4,3412,3257,155,500,263,237,0.874247561616807,0.61214953271028,1.65802653999071,318,156,162,84,1,12.78,1.1,0,0,0,0,0,0,0.175572658488623,102.918345437918,32.4464665734191
8.7,"random_policy_SVM","SVM",88,5,3312,3187,125,600,333,267,0.865870146034749,0.616822429906542,1.60900986261252,371,180,191,53,1.1,15.34,1.2,0,0,0,0,0,0,0.0863900110747479,58.482561323296,14.850967178774
8.7,"random_policy_SVM","SVM",88,6,3212,3121,91,700,399,301,0.863030730602923,0.621495327102804,1.59911189136159,459,220,239,88,1.1,17.89,1.3,0,0,0,0,0,0,0.0923990269528849,101.390338833995,13.2990544830383
8.7,"random_policy_SVM","SVM",88,7,3112,3036,76,800,484,316,0.869197774606477,0.635514018691589,1.61594464811277,489,232,257,30,1.1,20.45,1.5,0,0,0,0,0,0,0.0746024018291037,105.857775246607,10.4560356708835
8.7,"random_policy_SVM","SVM",88,8,3012,2949,63,900,571,329,0.875583441527079,0.649532710280374,1.61743399801886,529,249,280,40,1.1,23.01,1.7,0,0,0,0,0,0,0.0695173517126123,109.150290987359,10.2665618802305
8.7,"random_policy_SVM","SVM",88,9,2912,2854,58,1000,666,334,0.889887818277406,0.649532710280374,1.63277740486394,549,265,284,20,1.1,25.56,2,0,0,0,0,0,0,0.0536863063961217,62.2229028948487,6.81571572361966
8.7,"random_policy_SVM","SVM",88,10,2812,2762,50,1100,758,342,0.895661877528248,0.644859813084112,1.65497869708631,562,272,290,13,1.1,28.12,2.2,0,0,0,0,0,0,0.0405035464513995,56.3132184877127,4.75410891583384
8.7,"random_policy_SVM","SVM",88,11,2712,2669,43,1200,851,349,0.908379561573878,0.649532710280374,1.65650121658685,586,284,302,24,1.1,30.67,2.4,0,0,0,0,0,0,0.0520522787261276,64.3941491267767,6.40956382521258
8.7,"random_policy_SVM","SVM",88,12,2612,2573,39,1300,947,353,0.915497548204342,0.654205607476635,1.68327567511747,613,295,318,27,1.1,33.23,2.7,0,0,0,0,0,0,0.0452519107047851,48.8676066513087,5.16324154472339
8.7,"random_policy_SVM","SVM",88,13,2512,2477,35,1400,1043,357,0.922969623485737,0.654205607476635,1.73217893714158,627,301,326,14,1.1,35.79,2.9,0,0,0,0,0,0,0.0424551771426708,43.3743526040711,4.68192676976397
8.7,"random_policy_SVM","SVM",88,14,2412,2383,29,1500,1137,363,0.926293228322794,0.654205607476635,1.74058757275877,643,307,336,16,1.1,38.34,3.1,0,0,0,0,0,0,0.0419771226069138,39.0034831036815,4.81432197468594
8.7,"random_policy_SVM","SVM",88,15,2312,2286,26,1600,1234,366,0.928020751740943,0.654205607476635,1.74578409412734,650,311,339,7,1.1,40.9,3.4,0,0,0,0,0,0,0.039597190220589,36.0576073647073,4.62267125698057
8.7,"random_policy_SVM","SVM",88,16,2212,2190,22,1700,1330,370,0.929317735549432,0.649532710280374,1.75902308049775,660,316,344,10,1.1,43.46,3.6,0,0,0,0,0,0,0.0339939986926685,29.0805025018422,3.96741091224096
8.7,"random_policy_SVM","SVM",88,17,2112,2097,15,1800,1423,377,0.930287455604803,0.649532710280374,1.76064429992678,675,323,352,15,1.1,46.01,3.8,0,0,0,0,0,0,0.0275250094229632,26.0749872102608,3.6540093709181
8.7,"random_policy_SVM","SVM",88,18,2012,1998,14,1900,1522,378,0.930197592197182,0.644859813084112,1.75902308049775,673,324,349,-2,1.1,48.57,4,0,0,0,0,0,0,0.0228426297392165,23.392574403864,2.51568266016986
8.7,"random_policy_SVM","SVM",88,19,1912,1898,14,2000,1622,378,0.930303550543481,0.644859813084112,1.75417728688757,676,326,350,3,1.1,51.12,4.3,0,0,0,0,0,0,0.0196273058544679,18.5064298706535,1.99062385185608
8.7,"random_policy_SVM","SVM",88,20,1812,1800,12,2100,1720,380,0.929235919611144,0.64018691588785,1.76419048927982,718,346,372,42,1.1,53.68,4.5,0,0,0,0,0,0,0.0153304886056294,10.3935660914574,2.08601310894058
8.7,"random_policy_SVM","SVM",88,21,1712,1703,9,2200,1817,383,0.929211777203127,0.644859813084112,1.76906843533313,724,350,374,6,1.1,56.24,4.7,0,0,0,0,0,0,0.0106623825287005,8.64126711683632,1.29433638008501
8.7,"random_policy_SVM","SVM",88,22,1612,1605,7,2300,1915,385,0.92917019861154,0.644859813084112,1.76419048927982,725,352,373,1,1.1,58.79,5,0,0,0,0,0,0,0.0110315787845881,8.0704321845097,1.12806432696692
8.7,"random_policy_SVM","SVM",88,23,1512,1505,7,2400,2015,385,0.928730270287668,0.64018691588785,1.77259139637163,744,361,383,19,1.1,61.35,5.2,0,0,0,0,0,0,0.00778508551529003,5.20562767639398,0.970324077381826
8.7,"random_policy_SVM","SVM",88,24,1412,1405,7,2500,2115,385,0.929013272959428,0.64018691588785,1.77749257073948,740,360,380,-4,1.1,63.91,5.5,0,0,0,0,0,0,0.00622866046703536,4.19123694083976,0.679153741699756
8.7,"random_policy_SVM","SVM",88,25,1312,1306,6,2600,2214,386,0.928720881573438,0.630841121495327,1.77749257073948,745,363,382,5,1.1,66.46,5.7,0,0,0,0,0,0,0.00642967847727962,3.9322609244023,0.665814013315203
8.7,"random_policy_SVM","SVM",88,26,1212,1206,6,2700,2314,386,0.928042211659168,0.626168224299065,1.77422211522754,751,366,385,6,1.1,69.02,6,0,0,0,0,0,0,0.00555413808032238,3.09449515978803,0.585359175074266
8.7,"random_policy_SVM","SVM",88,27,1112,1106,6,2800,2414,386,0.927983196884013,0.626168224299065,1.77749257073948,753,367,386,2,1.1,71.57,6.3,0,0,0,0,0,0,0.00443491788776898,2.09008972213952,0.455768997068953
8.7,"random_policy_SVM","SVM",88,28,1012,1006,6,2900,2514,386,0.928003315557352,0.626168224299065,1.77259139637163,758,370,388,5,1,74.13,6.5,0,0,0,0,0,0,0.00367859170673422,1.52317545065278,0.391292134002995
8.7,"random_policy_SVM","SVM",88,29,912,906,6,3000,2614,386,0.928090496475191,0.626168224299065,1.78263075084473,758,370,388,0,1,76.69,6.8,0,0,0,0,0,0,0.00304386759013179,1.10086806864104,0.329902674687322
8.7,"random_policy_SVM","SVM",88,30,812,808,4,3100,2712,388,0.928707469124526,0.626168224299065,1.78263075084473,759,373,386,1,1,79.24,7,0,0,0,0,0,0,0.00272811276970336,0.952384694749657,0.311608965290944
8.7,"random_policy_SVM","SVM",88,31,712,708,4,3200,2812,388,0.928755753940561,0.626168224299065,1.77935686516825,758,373,385,-1,1,81.8,7.2,0,0,0,0,0,0,0.00205817365783835,0.663464378794048,0.239319890939519
8.7,"random_policy_SVM","SVM",88,32,612,609,3,3300,2911,389,0.928838911123732,0.626168224299065,1.78263075084473,765,374,391,7,1,84.36,7.5,0,0,0,0,0,0,0.00144243091973531,0.448184656222882,0.175270106808556
8.7,"random_policy_SVM","SVM",88,33,512,510,2,3400,3010,390,0.929143373713725,0.621495327102804,1.77772442767727,769,376,393,4,1,86.91,7.7,0,0,0,0,0,0,0.000973280104439443,0.304796387788361,0.124142939211291
8.7,"random_policy_SVM","SVM",88,34,412,410,2,3500,3110,390,0.929174222346189,0.621495327102804,1.77772442767727,772,377,395,3,1,89.47,8,0,0,0,0,0,0,0.000704264261296136,0.203160935853885,0.0884727130575802
8.7,"random_policy_SVM","SVM",88,35,312,312,0,3600,3208,392,0.92938077405923,0.621495327102804,1.78427221562452,777,381,396,5,1,92.02,8.2,0,0,0,0,0,0,0.000783196525867223,0.192958191117389,0.0964813429833418
8.7,"random_policy_SVM","SVM",88,36,212,212,0,3700,3308,392,0.929630245608745,0.621495327102804,1.78427221562452,785,383,402,8,1,94.58,8.4,0,0,0,0,0,0,0.000421070244369707,0.0892998290391006,0.0556584347574118
8.7,"random_policy_SVM","SVM",88,37,112,112,0,3800,3408,392,0.92959805573139,0.616822429906542,1.78263075084473,785,384,401,0,1,97.14,8.7,0,0,0,0,0,0,0.00014755801069327,0.0252946926482554,0.0236720902959485
8.7,"random_policy_SVM","SVM",88,38,12,12,0,3900,3508,392,0.929632928098526,0.616822429906542,1.77935686516825,785,385,400,0,1,99.69,8.9,0,0,0,0,0,0,9.91853963351318e-05,0.00164277003119974,0.00164277003119974
8.7,"random_policy_SVM","SVM",88,39,0,0,0,3912,3520,392,0.92969462536346,0.616822429906542,1.78591670614583,786,385,401,1,1,100,9,0,0,0,0,0,0,0,0,0
8.7,"random_policy_SVM","SVM",89,0,3812,3420,392,100,89,11,0.899862024003912,0.561576354679803,1.75190326914465,25,11,14,0,1.3,2.56,8.1,0,0,0,0,0,0,0.618790290149721,368.789342326373,67.1140582184195
8.7,"random_policy_SVM","SVM",89,1,3712,3367,345,200,142,58,0.909185941622947,0.610837438423645,1.73899790436274,109,54,55,84,1,5.11,2.4,0,0,0,0,0,0,0.606524303547501,240.699789740146,70.7923880426477
8.7,"random_policy_SVM","SVM",89,2,3612,3329,283,300,180,120,0.901406174917585,0.61576354679803,1.723776381796,180,92,88,71,1,7.67,1.5,0,0,0,0,0,0,0.441280912813055,160.123473107632,68.3172107096787
8.7,"random_policy_SVM","SVM",89,3,3512,3294,218,400,215,185,0.904023784701239,0.586206896551724,1.73420727652703,250,125,125,70,1,10.22,1.2,0,0,0,0,0,0,0.273960581213978,101.446809594194,49.9902534822295
8.7,"random_policy_SVM","SVM",89,4,3412,3245,167,500,264,236,0.901980840726244,0.600985221674877,1.73012546607517,328,167,161,78,1,12.78,1.1,0,0,0,0,0,0,0.147444159846177,62.9353810764264,26.4117374053505
8.7,"random_policy_SVM","SVM",89,5,3312,3187,125,600,322,278,0.89209490275644,0.625615763546798,1.68996729498297,399,199,200,71,1,15.34,1.2,0,0,0,0,0,0,0.130158009305792,68.604429550979,20.7104450793196
8.7,"random_policy_SVM","SVM",89,6,3212,3101,111,700,408,292,0.901290960745694,0.640394088669951,1.67689083634978,434,210,224,35,1.1,17.89,1.4,0,0,0,0,0,0,0.0723934027225475,38.7805977582056,9.70476239689694
8.7,"random_policy_SVM","SVM",89,7,3112,3028,84,800,481,319,0.89704770709748,0.665024630541872,1.66801839806222,499,240,259,65,1.1,20.45,1.5,0,0,0,0,0,0,0.0694800613405981,66.640804318101,10.870199308755
8.7,"random_policy_SVM","SVM",89,8,3012,2952,60,900,557,343,0.887902230939781,0.660098522167488,1.6368793171301,548,266,282,49,1.1,23.01,1.6,0,0,0,0,0,0,0.062934016166331,88.9063990290949,9.49816862806424
8.7,"random_policy_SVM","SVM",89,9,2912,2860,52,1000,649,351,0.900699434326509,0.660098522167488,1.66648388251662,582,279,303,34,1.1,25.56,1.8,0,0,0,0,0,0,0.0501123312005808,63.1126796965859,5.71163061408649
8.7,"random_policy_SVM","SVM",89,10,2812,2764,48,1100,745,355,0.90612152566045,0.665024630541872,1.66801839806222,600,287,313,18,1.1,28.12,2.1,0,0,0,0,0,0,0.0394058827913912,52.7706197836434,4.34634121321487
8.7,"random_policy_SVM","SVM",89,11,2712,2669,43,1200,840,360,0.908528377812566,0.665024630541872,1.65761960654579,609,294,315,9,1.1,30.67,2.3,0,0,0,0,0,0,0.0380716759308304,54.2820880672205,4.24987011910416
8.7,"random_policy_SVM","SVM",89,12,2612,2572,40,1300,937,363,0.914171062134162,0.665024630541872,1.68731697350798,622,301,321,13,1.1,33.23,2.6,0,0,0,0,0,0,0.0320466755062265,42.471060411023,3.54474578328612
8.7,"random_policy_SVM","SVM",89,13,2512,2481,31,1400,1028,372,0.923124046321714,0.665024630541872,1.71080526237079,650,311,339,28,1.1,35.79,2.8,0,0,0,0,0,0,0.0663829428941953,62.5460141708711,7.96063881586238
8.7,"random_policy_SVM","SVM",89,14,2412,2384,28,1500,1125,375,0.926549560359586,0.669950738916256,1.74305527283584,669,321,348,19,1.1,38.34,3,0,0,0,0,0,0,0.0573720603981136,47.9994869605342,6.24164710801851
8.7,"random_policy_SVM","SVM",89,15,2312,2291,21,1600,1218,382,0.92713687162613,0.665024630541872,1.74305527283584,688,330,358,19,1.1,40.9,3.2,0,0,0,0,0,0,0.0592188210879457,42.8023569588431,6.41277950416482
8.7,"random_policy_SVM","SVM",89,16,2212,2195,17,1700,1314,386,0.927365894919064,0.665024630541872,1.7478703426503,703,337,366,15,1.1,43.46,3.4,0,0,0,0,0,0,0.0523902356850681,34.891300013375,5.88052468902565
8.7,"random_policy_SVM","SVM",89,17,2112,2099,13,1800,1410,390,0.927187453457694,0.660098522167488,1.74626236625412,711,342,369,8,1.1,46.01,3.6,0,0,0,0,0,0,0.0414919948026712,28.0454562119142,5.01797721058223
8.7,"random_policy_SVM","SVM",89,18,2012,2002,10,1900,1507,393,0.927038518064742,0.660098522167488,1.7446573456969,718,345,373,7,1.1,48.57,3.8,0,0,0,0,0,0,0.0273291034951115,23.3442390925383,3.52841799301146
8.7,"random_policy_SVM","SVM",89,19,1912,1904,8,2000,1605,395,0.926933139248978,0.660098522167488,1.7446573456969,730,350,380,12,1.1,51.12,4.1,0,0,0,0,0,0,0.020100768721388,19.2147144176795,2.31582757784068
8.7,"random_policy_SVM","SVM",89,20,1812,1805,7,2100,1704,396,0.92781551119967,0.660098522167488,1.75351347435526,730,351,379,0,1.1,53.68,4.3,0,0,0,0,0,0,0.0160465367286783,15.4803399797888,1.68574600073676
8.7,"random_policy_SVM","SVM",89,21,1712,1705,7,2200,1804,396,0.927308287833106,0.655172413793103,1.74626236625412,744,357,387,14,1.1,56.24,4.6,0,0,0,0,0,0,0.0103957584504193,9.38940836561437,1.2586645980062
8.7,"random_policy_SVM","SVM",89,22,1612,1608,4,2300,1901,399,0.927371515122556,0.660098522167488,1.7446573456969,751,361,390,7,1.1,58.79,4.8,0,0,0,0,0,0,0.0115985591212571,9.37106195518895,1.16564773580909
8.7,"random_policy_SVM","SVM",89,23,1512,1508,4,2400,2001,399,0.926084488519322,0.650246305418719,1.75674278093787,767,372,395,16,1.1,61.35,5,0,0,0,0,0,0,0.00817740230029736,5.12101332838984,1.06505854579422
8.7,"random_policy_SVM","SVM",89,24,1412,1408,4,2500,2101,399,0.926208132996488,0.650246305418719,1.75674278093787,769,372,397,2,1.1,63.91,5.3,0,0,0,0,0,0,0.00538634903991188,3.64550584218949,0.644625642674288
8.7,"random_policy_SVM","SVM",89,25,1312,1309,3,2600,2200,400,0.926144905707027,0.645320197044335,1.75512664222495,773,373,400,4,1.1,66.46,5.5,0,0,0,0,0,0,0.00456285547444711,3.0405637403272,0.485479152987619
8.7,"random_policy_SVM","SVM",89,26,1212,1209,3,2700,2300,400,0.926057792552661,0.640394088669951,1.75351347435526,771,376,395,-2,1.1,69.02,5.8,0,0,0,0,0,0,0.0038160608241612,2.26698337297328,0.394585807816293
8.7,"random_policy_SVM","SVM",89,27,1112,1110,2,2800,2399,401,0.926313511812254,0.640394088669951,1.75351347435526,775,380,395,4,1,71.57,6,0,0,0,0,0,0,0.00336978831494147,1.8832443862049,0.36585369702276
8.7,"random_policy_SVM","SVM",89,28,1012,1011,1,2900,2498,402,0.92665915432797,0.645320197044335,1.75190326914465,780,385,395,5,1,74.13,6.2,0,0,0,0,0,0,0.00366176800120811,1.84835654700124,0.386475192386209
8.7,"random_policy_SVM","SVM",89,29,912,912,0,3000,2597,403,0.926906443282305,0.640394088669951,1.75190326914465,788,387,401,8,1,76.69,6.4,0,0,0,0,0,0,0.00262731632105909,1.20975304782761,0.292001668398677
8.7,"random_policy_SVM","SVM",89,30,812,812,0,3100,2697,403,0.926951404910366,0.640394088669951,1.75674278093787,787,387,400,-1,1,79.24,6.7,0,0,0,0,0,0,0.00229395063321005,0.926888856207934,0.248337021608462
8.7,"random_policy_SVM","SVM",89,31,712,712,0,3200,2797,403,0.927127036269978,0.640394088669951,1.75029601843901,788,389,399,1,1,81.8,6.9,0,0,0,0,0,0,0.00203702545491084,0.725445563176598,0.222003445598219
8.7,"random_policy_SVM","SVM",89,32,612,612,0,3300,2897,403,0.9272352251875,0.645320197044335,1.75836189870832,788,389,399,0,1,84.36,7.2,0,0,0,0,0,0,0.00125334895825043,0.400647594613727,0.145514624242509
8.7,"random_policy_SVM","SVM",89,33,512,512,0,3400,2997,403,0.927451603022541,0.645320197044335,1.75512664222495,788,389,399,0,1,86.91,7.4,0,0,0,0,0,0,0.000840666499988042,0.264776397894796,0.106623874923789
8.7,"random_policy_SVM","SVM",89,34,412,412,0,3500,3097,403,0.927725587943535,0.645320197044335,1.75674278093787,791,389,402,3,1,89.47,7.7,0,0,0,0,0,0,0.000538209470023781,0.163181626658908,0.0693992158542632
8.7,"random_policy_SVM","SVM",89,35,312,312,0,3600,3197,403,0.928269342632896,0.645320197044335,1.74709034807557,794,391,403,3,1,92.02,7.9,0,0,0,0,0,0,0.000333148439729181,0.0854083069258234,0.0415346983001319
8.7,"random_policy_SVM","SVM",89,36,212,212,0,3700,3297,403,0.92889318522224,0.645320197044335,1.74549191225848,798,391,407,4,1,94.58,8.2,0,0,0,0,0,0,0.000176126705881586,0.0373760865685345,0.0231102177678921
8.7,"random_policy_SVM","SVM",89,37,112,112,0,3800,3397,403,0.929376522723898,0.645320197044335,1.74869171411414,801,393,408,3,1,97.14,8.4,0,0,0,0,0,0,9.66825997645665e-05,0.0154552766861971,0.0144527143813877
8.7,"random_policy_SVM","SVM",89,38,12,12,0,3900,3497,403,0.929605546016833,0.645320197044335,1.75674278093787,806,393,413,5,1.1,99.69,8.7,0,0,0,0,0,0,5.79428842564255e-05,0.000812597199441244,0.000812597199441244
8.7,"random_policy_SVM","SVM",89,39,0,0,0,3912,3509,403,0.929761506664169,0.645320197044335,1.74709034807557,808,393,415,2,1.1,100,8.7,0,0,0,0,0,0,0,0,0
8.7,"random_policy_SVM","SVM",90,0,3812,3389,423,100,92,8,0.851996470682594,0.434285714285714,1.67914680710994,30,8,22,0,2.8,2.56,11.5,0,0,0,0,0,0,0.123317696028822,317.096119108566,13.8259288988648
8.7,"random_policy_SVM","SVM",90,1,3712,3343,369,200,138,62,0.924689179433705,0.565714285714286,1.7739868938401,113,54,59,83,1.1,5.11,2.2,0,0,0,0,0,0,0.669509189247948,439.413966763134,72.8483828584206
8.7,"random_policy_SVM","SVM",90,2,3612,3297,315,300,184,116,0.919246009464985,0.56,1.7739868938401,197,97,100,84,1,7.67,1.6,0,0,0,0,0,0,0.642534933692361,359.270605493062,73.5428080808006
8.7,"random_policy_SVM","SVM",90,3,3512,3262,250,400,219,181,0.919040667361835,0.56,1.77561589925226,259,129,130,62,1,10.22,1.2,0,0,0,0,0,0,0.543913828023194,236.16773476401,71.9608696825329
8.7,"random_policy_SVM","SVM",90,4,3412,3227,185,500,254,246,0.89662950188498,0.571428571428571,1.72747010119595,323,163,160,64,1,12.78,1,0,0,0,0,0,0,0.41325629230803,218.343806689178,60.8490075185132
8.7,"random_policy_SVM","SVM",90,5,3312,3165,147,600,316,284,0.890411486323886,0.577142857142857,1.66884529295589,399,198,201,76,1,15.34,1.1,0,0,0,0,0,0,0.168877017303943,112.344042492203,31.6376004207411
8.7,"random_policy_SVM","SVM",90,6,3212,3104,108,700,377,323,0.896119355097456,0.582857142857143,1.67605730056512,464,226,238,65,1.1,17.89,1.2,0,0,0,0,0,0,0.148711545446552,110.911713886654,21.8290865604785
8.7,"random_policy_SVM","SVM",90,7,3112,3032,80,800,449,351,0.901840057752461,0.594285714285714,1.67760063141279,525,258,267,61,1,20.45,1.3,0,0,0,0,0,0,0.0814192190278304,81.697002776665,12.4305305370152
8.7,"random_policy_SVM","SVM",90,8,3012,2953,59,900,528,372,0.902276409721654,0.617142857142857,1.65549218031279,575,275,300,50,1.1,23.01,1.4,0,0,0,0,0,0,0.0648464458970096,83.2568689515751,8.57946761608341
8.7,"random_policy_SVM","SVM",90,9,2912,2859,53,1000,622,378,0.90243683323974,0.617142857142857,1.66577474043895,594,287,307,19,1.1,25.56,1.6,0,0,0,0,0,0,0.0526971980621201,72.8297352127287,6.12943885820658
8.7,"random_policy_SVM","SVM",90,10,2812,2763,49,1100,718,382,0.911016282987082,0.617142857142857,1.68478991596639,607,296,311,13,1.1,28.12,1.9,0,0,0,0,0,0,0.0493656534875624,69.0803225831571,5.54118036137272
8.7,"random_policy_SVM","SVM",90,11,2712,2668,44,1200,813,387,0.915947701933107,0.617142857142857,1.71718754106979,622,302,320,15,1.1,30.67,2.1,0,0,0,0,0,0,0.0415374943757802,57.0165980038485,4.4935787654034
8.7,"random_policy_SVM","SVM",90,12,2612,2572,40,1300,909,391,0.93153445095051,0.605714285714286,1.76697478991597,648,318,330,26,1,33.23,2.3,0,0,0,0,0,0,0.0383123678125088,42.4876608502188,4.73411380389623
8.7,"random_policy_SVM","SVM",90,13,2512,2480,32,1400,1001,399,0.935007620117117,0.611428571428571,1.78052091554854,677,330,347,29,1.1,35.79,2.5,0,0,0,0,0,0,0.0519585771410298,46.1083464004204,5.93347787309541
8.7,"random_policy_SVM","SVM",90,14,2412,2382,30,1500,1099,401,0.934890510948912,0.605714285714286,1.77888290182678,683,332,351,6,1.1,38.34,2.7,0,0,0,0,0,0,0.0430668820734003,37.0501883932291,4.75411369100823
8.7,"random_policy_SVM","SVM",90,15,2312,2284,28,1600,1197,403,0.934734900136366,0.6,1.78052091554854,693,339,354,10,1,40.9,3,0,0,0,0,0,0,0.0347773071589541,27.8084642608203,3.83324154210299
8.7,"random_policy_SVM","SVM",90,16,2212,2187,25,1700,1294,406,0.933481992460098,0.605714285714286,1.77888290182678,707,343,364,14,1.1,43.46,3.2,0,0,0,0,0,0,0.0379935416721415,27.6026628430951,4.38531076613614
8.7,"random_policy_SVM","SVM",90,17,2112,2094,18,1800,1387,413,0.93044196679233,0.6,1.76697478991597,722,350,372,15,1.1,46.01,3.4,0,0,0,0,0,0,0.0322278006657783,24.1803669113311,4.50543204090456
8.7,"random_policy_SVM","SVM",90,18,2012,2002,10,1900,1479,421,0.927738830512548,0.594285714285714,1.76535222353404,748,361,387,26,1.1,48.57,3.5,0,0,0,0,0,0,0.0259890298378843,21.3139097108797,3.38861464143459
8.7,"random_policy_SVM","SVM",90,19,1912,1902,10,2000,1579,421,0.927645784872057,0.594285714285714,1.76535222353404,750,361,389,2,1.1,51.12,3.8,0,0,0,0,0,0,0.0184265366199737,15.7190871026056,2.07367625689792
8.7,"random_policy_SVM","SVM",90,20,1812,1803,9,2100,1678,422,0.928479987166116,0.594285714285714,1.77073783359498,757,363,394,7,1.1,53.68,4,0,0,0,0,0,0,0.0162120628051536,14.2905687806768,1.7725862610922
8.7,"random_policy_SVM","SVM",90,21,1712,1704,8,2200,1777,423,0.928492821047563,0.594285714285714,1.77888290182678,761,366,395,4,1.1,56.24,4.2,0,0,0,0,0,0,0.0135773878875326,11.5474479492259,1.40881506033902
8.7,"random_policy_SVM","SVM",90,22,1612,1604,8,2300,1877,423,0.928836127376274,0.588571428571429,1.79246346280448,760,370,390,-1,1.1,58.79,4.4,0,0,0,0,0,0,0.00980245826997906,7.80186869299675,1.19311740455062
8.7,"random_policy_SVM","SVM",90,23,1512,1504,8,2400,1977,423,0.928788000320847,0.588571428571429,1.78916546195295,759,370,389,-1,1.1,61.35,4.7,0,0,0,0,0,0,0.00915518967037047,6.58069392542416,0.923952460585283
8.7,"random_policy_SVM","SVM",90,24,1412,1404,8,2500,2077,423,0.930969760166837,0.594285714285714,1.78916546195295,774,379,395,15,1,63.91,4.9,0,0,0,0,0,0,0.00536162607932666,3.47410075692977,0.68149752657357
8.7,"random_policy_SVM","SVM",90,25,1312,1305,7,2600,2176,424,0.931146226036734,0.594285714285714,1.78587957497048,778,381,397,4,1,66.46,5.1,0,0,0,0,0,0,0.00535010526244371,3.26512995428841,0.552317791691207
8.7,"random_policy_SVM","SVM",90,26,1212,1205,7,2700,2276,424,0.932447260768426,0.594285714285714,1.78052091554854,789,385,404,11,1,69.02,5.4,0,0,0,0,0,0,0.00405817617536232,2.33279627847087,0.453689802455916
8.7,"random_policy_SVM","SVM",90,27,1112,1106,6,2800,2375,425,0.932883612737625,0.594285714285714,1.77724789915966,790,386,404,1,1,71.57,5.6,0,0,0,0,0,0,0.00395140679813803,1.94580145413671,0.40760760821677
8.7,"random_policy_SVM","SVM",90,28,1012,1006,6,2900,2475,425,0.933254191064407,0.594285714285714,1.78216194865043,796,390,406,6,1,74.13,5.8,0,0,0,0,0,0,0.00332459301440278,1.46707111574872,0.362329685044927
8.7,"random_policy_SVM","SVM",90,29,912,906,6,3000,2575,425,0.933300713884653,0.594285714285714,1.78052091554854,796,390,406,0,1,76.69,6.1,0,0,0,0,0,0,0.00277902988015227,1.05931523740741,0.300746964098615
8.7,"random_policy_SVM","SVM",90,30,812,807,5,3100,2674,426,0.933424239993581,0.594285714285714,1.77888290182678,797,391,406,1,1,79.24,6.3,0,0,0,0,0,0,0.00261986249319382,0.884483741646797,0.285450176040896
8.7,"random_policy_SVM","SVM",90,31,712,708,4,3200,2773,427,0.9337162107965,0.594285714285714,1.78752100840336,800,392,408,3,1,81.8,6.5,0,0,0,0,0,0,0.00186699888097339,0.591659465870799,0.218450532115779
8.7,"random_policy_SVM","SVM",90,32,612,608,4,3300,2873,427,0.933748295500118,0.6,1.77888290182678,800,392,408,0,1,84.36,6.7,0,0,0,0,0,0,0.00112591765981463,0.33957809953906,0.143571915754097
8.7,"random_policy_SVM","SVM",90,33,512,509,3,3400,2972,428,0.934239191465467,0.6,1.77724789915966,806,397,409,6,1,86.91,6.9,0,0,0,0,0,0,0.000856385484649036,0.265228897622338,0.112496100220668
8.7,"random_policy_SVM","SVM",90,34,412,411,1,3500,3070,430,0.93486805165637,0.6,1.79246346280448,816,402,414,10,1,89.47,7.1,0,0,0,0,0,0,0.00081580475888284,0.245807301463073,0.102296587825684
8.7,"random_policy_SVM","SVM",90,35,312,312,0,3600,3169,431,0.935272318921952,0.594285714285714,1.79081294396212,828,406,422,12,1,92.02,7.4,0,0,0,0,0,0,0.000708428433931369,0.177176633966626,0.0847367289742405
8.7,"random_policy_SVM","SVM",90,36,212,212,0,3700,3269,431,0.935528996550892,0.594285714285714,1.79246346280448,830,406,424,2,1,94.58,7.6,0,0,0,0,0,0,0.000379368018042171,0.0781812622394744,0.0487184130009405
8.7,"random_policy_SVM","SVM",90,37,112,112,0,3800,3369,431,0.935723109007778,0.594285714285714,1.78752100840336,831,408,423,1,1,97.14,7.8,0,0,0,0,0,0,0.000204523797391424,0.0315294276624919,0.0293225257213333
8.7,"random_policy_SVM","SVM",90,38,12,12,0,3900,3469,431,0.935753589476214,0.588571428571429,1.78916546195295,833,410,423,2,1,99.69,8,0,0,0,0,0,0,0.000149728229237735,0.00208614325617875,0.00208614325617875
8.7,"random_policy_SVM","SVM",90,39,0,0,0,3912,3481,431,0.935729525948501,0.588571428571429,1.78752100840336,834,411,423,1,1,100,8.1,0,0,0,0,0,0,0,0,0
8.7,"random_policy_SVM","SVM",91,0,3812,3423,389,100,92,8,0.887984323091124,0.478468899521531,1.76015100302884,27,8,19,0,2.4,2.56,11.5,0,0,0,0,0,0,0.452058282978407,329.54582200873,59.232383971786
8.7,"random_policy_SVM","SVM",91,1,3712,3373,339,200,142,58,0.907190179747641,0.574162679425837,1.76873710548264,104,51,53,77,1,5.11,2.4,0,0,0,0,0,0,0.728157798292943,378.765494820567,79.6719174763709
8.7,"random_policy_SVM","SVM",91,2,3612,3337,275,300,178,122,0.898690304363193,0.583732057416268,1.74078088239182,163,80,83,59,1,7.67,1.5,0,0,0,0,0,0,0.662834601682607,272.866356808297,79.6918299765259
8.7,"random_policy_SVM","SVM",91,3,3512,3292,220,400,223,177,0.900334955617694,0.593301435406699,1.71722049075984,237,120,117,74,1,10.22,1.3,0,0,0,0,0,0,0.5,192.89066924678,68.2217905115129
8.7,"random_policy_SVM","SVM",91,4,3412,3248,164,500,267,233,0.870323151376391,0.598086124401914,1.6561285912729,311,155,156,74,1,12.78,1.1,0,0,0,0,0,0,0.228494771473543,111.925030354372,39.7852616819412
8.7,"random_policy_SVM","SVM",91,5,3312,3186,126,600,329,271,0.867462471550688,0.602870813397129,1.63435828877005,391,192,199,80,1,15.34,1.2,0,0,0,0,0,0,0.112791616328546,70.7218739299152,18.0733631730884
8.7,"random_policy_SVM","SVM",91,6,3212,3115,97,700,400,300,0.869060563152675,0.617224880382775,1.63887725178048,456,219,237,65,1.1,17.89,1.3,0,0,0,0,0,0,0.0816004650867555,68.2275309653292,11.5808758211176
8.7,"random_policy_SVM","SVM",91,7,3112,3038,74,800,477,323,0.873874009580325,0.631578947368421,1.61715451730932,498,243,255,42,1,20.45,1.5,0,0,0,0,0,0,0.0717088070050261,82.0733694067072,10.7804235818672
8.7,"random_policy_SVM","SVM",91,8,3012,2950,62,900,565,335,0.879804887667994,0.631578947368421,1.62725203910504,531,256,275,33,1.1,23.01,1.7,0,0,0,0,0,0,0.0613630972664044,75.744441597883,7.30174450666821
8.7,"random_policy_SVM","SVM",91,9,2912,2858,54,1000,657,343,0.883880226663347,0.641148325358852,1.62875042956462,548,265,283,17,1.1,25.56,1.9,0,0,0,0,0,0,0.0514233707845792,74.1727893090416,7.92678343292605
8.7,"random_policy_SVM","SVM",91,10,2812,2765,47,1100,750,350,0.898034361023544,0.641148325358852,1.65460361098628,568,274,294,20,1.1,28.12,2.1,0,0,0,0,0,0,0.0402182183983122,52.8590989217008,4.70231853761128
8.7,"random_policy_SVM","SVM",91,11,2712,2674,38,1200,841,359,0.906085072701524,0.641148325358852,1.66016394596116,592,285,307,24,1.1,30.67,2.3,0,0,0,0,0,0,0.0536692802464478,65.385209919578,6.28958793072703
8.7,"random_policy_SVM","SVM",91,12,2612,2577,35,1300,938,362,0.913927635344787,0.636363636363636,1.71650827949639,610,295,315,18,1.1,33.23,2.6,0,0,0,0,0,0,0.0561620786811881,60.1170539644609,6.58110123346532
8.7,"random_policy_SVM","SVM",91,13,2512,2483,29,1400,1032,368,0.920596620864755,0.645933014354067,1.73917942803819,632,306,326,22,1.1,35.79,2.8,0,0,0,0,0,0,0.0517354290352059,47.8102791958404,5.75883471293563
8.7,"random_policy_SVM","SVM",91,14,2412,2387,25,1500,1128,372,0.922382320478303,0.641148325358852,1.75101095848125,644,312,332,12,1.1,38.34,3,0,0,0,0,0,0,0.0503666230856374,43.6308424288258,5.59329771082659
8.7,"random_policy_SVM","SVM",91,15,2312,2289,23,1600,1226,374,0.923327207543754,0.645933014354067,1.75101095848125,651,315,336,7,1.1,40.9,3.3,0,0,0,0,0,0,0.0399296013700453,33.4870661669493,4.50895208658699
8.7,"random_policy_SVM","SVM",91,16,2212,2193,19,1700,1322,378,0.92319437559397,0.645933014354067,1.74939860953237,666,321,345,15,1.1,43.46,3.5,0,0,0,0,0,0,0.0374045380774957,32.198121542348,4.53184378064385
8.7,"random_policy_SVM","SVM",91,17,2112,2098,14,1800,1417,383,0.92406942318067,0.645933014354067,1.75101095848125,679,328,351,13,1.1,46.01,3.7,0,0,0,0,0,0,0.0302355441550656,27.3718179115446,3.49301830897054
8.7,"random_policy_SVM","SVM",91,18,2012,2001,11,1900,1514,386,0.924593903972071,0.645933014354067,1.74618280326485,688,331,357,9,1.1,48.57,3.9,0,0,0,0,0,0,0.0241909135462446,22.6562273469945,2.67453467257835
8.7,"random_policy_SVM","SVM",91,19,1912,1902,10,2000,1613,387,0.924907496925679,0.645933014354067,1.75101095848125,687,333,354,-1,1.1,51.12,4.2,0,0,0,0,0,0,0.0216044966409252,20.3570768272275,2.32470310307536
8.7,"random_policy_SVM","SVM",91,20,1812,1803,9,2100,1712,388,0.924502154068616,0.645933014354067,1.75101095848125,695,336,359,8,1.1,53.68,4.4,0,0,0,0,0,0,0.0181886504075218,17.0549907663873,1.94844060956624
8.7,"random_policy_SVM","SVM",91,21,1712,1703,9,2200,1812,388,0.924231012562877,0.645933014354067,1.75101095848125,695,337,358,0,1.1,56.24,4.7,0,0,0,0,0,0,0.0156065899081773,14.8004868703188,1.6531019487722
8.7,"random_policy_SVM","SVM",91,22,1612,1605,7,2300,1910,390,0.92554837684834,0.641148325358852,1.7563990263356,701,340,361,6,1.1,58.79,4.9,0,0,0,0,0,0,0.0124128520114193,10.9587320017613,1.26974492212699
8.7,"random_policy_SVM","SVM",91,23,1512,1505,7,2400,2010,390,0.924137893257886,0.636363636363636,1.7445793296163,719,350,369,18,1.1,61.35,5.2,0,0,0,0,0,0,0.00874534438213176,6.85671933614673,1.04244306351688
8.7,"random_policy_SVM","SVM",91,24,1412,1406,6,2500,2109,391,0.923707901173022,0.636363636363636,1.74778922718689,724,351,373,5,1.1,63.91,5.4,0,0,0,0,0,0,0.00780499089663989,5.91973903577195,0.810302015161566
8.7,"random_policy_SVM","SVM",91,25,1312,1306,6,2600,2209,391,0.9233162523314,0.62200956937799,1.75101095848125,724,353,371,0,1.1,66.46,5.6,0,0,0,0,0,0,0.00570873449660199,3.9397144212974,0.633354713485731
8.7,"random_policy_SVM","SVM",91,26,1212,1206,6,2700,2309,391,0.923317621732945,0.62200956937799,1.74618280326485,728,354,374,4,1.1,69.02,5.9,0,0,0,0,0,0,0.00519233210054798,3.0322667636381,0.522046390711373
8.7,"random_policy_SVM","SVM",91,27,1112,1107,5,2800,2408,392,0.923932483026267,0.617224880382775,1.75101095848125,740,362,378,12,1,71.57,6.1,0,0,0,0,0,0,0.00389090497429533,2.1422541561925,0.459516796190416
8.7,"random_policy_SVM","SVM",91,28,1012,1008,4,2900,2507,393,0.924105027620828,0.61244019138756,1.75101095848125,744,364,380,4,1,74.13,6.4,0,0,0,0,0,0,0.00391122164454263,1.76004650880137,0.397338526576091
8.7,"random_policy_SVM","SVM",91,29,912,908,4,3000,2607,393,0.924485721250094,0.61244019138756,1.74778922718689,759,370,389,15,1.1,76.69,6.6,0,0,0,0,0,0,0.00302617346770979,1.2765966311911,0.351836627991624
8.7,"random_policy_SVM","SVM",91,30,812,809,3,3100,2706,394,0.924554191327301,0.61244019138756,1.75101095848125,760,371,389,1,1,79.24,6.9,0,0,0,0,0,0,0.00235934651782192,0.850948790628315,0.25748114454223
8.7,"random_policy_SVM","SVM",91,31,712,710,2,3200,2805,395,0.924591165168993,0.61244019138756,1.74939860953237,763,375,388,3,1,81.8,7.1,0,0,0,0,0,0,0.00224578443823719,0.746494270699705,0.253379726389126
8.7,"random_policy_SVM","SVM",91,32,612,610,2,3300,2905,395,0.92461718379833,0.61244019138756,1.75101095848125,765,376,389,2,1,84.36,7.4,0,0,0,0,0,0,0.00171116707131554,0.505834741109573,0.200875314378944
8.7,"random_policy_SVM","SVM",91,33,512,510,2,3400,3005,395,0.92488558650098,0.61244019138756,1.75101095848125,764,376,388,-1,1,86.91,7.6,0,0,0,0,0,0,0.000803323959397526,0.254670680539927,0.112976939833382
8.7,"random_policy_SVM","SVM",91,34,412,412,0,3500,3103,397,0.924978705805983,0.61244019138756,1.7563990263356,770,377,393,6,1,89.47,7.8,0,0,0,0,0,0,0.000741162665464469,0.239195947934596,0.0995453103420454
8.7,"random_policy_SVM","SVM",91,35,312,312,0,3600,3203,397,0.925295037562672,0.61244019138756,1.75801633667292,774,379,395,4,1,92.02,8.1,0,0,0,0,0,0,0.000688841022047222,0.179573596464359,0.0811410954030496
8.7,"random_policy_SVM","SVM",91,36,212,212,0,3700,3303,397,0.925522358218996,0.61244019138756,1.75801633667292,779,383,396,5,1,94.58,8.3,0,0,0,0,0,0,0.000368044536653109,0.0742898200471746,0.0449612166048662
8.7,"random_policy_SVM","SVM",91,37,112,112,0,3800,3403,397,0.925379940458405,0.61244019138756,1.75801633667292,781,383,398,2,1,97.14,8.6,0,0,0,0,0,0,0.000140176843964445,0.0248947166007225,0.0233754903636148
8.7,"random_policy_SVM","SVM",91,38,12,12,0,3900,3503,397,0.925545638045245,0.607655502392344,1.75801633667292,782,383,399,1,1,99.69,8.8,0,0,0,0,0,0,8.91585967164023e-05,0.00124645496988529,0.00124645496988529
8.7,"random_policy_SVM","SVM",91,39,0,0,0,3912,3515,397,0.925545638045244,0.607655502392344,1.7563990263356,782,383,399,0,1,100,8.9,0,0,0,0,0,0,0,0,0
8.7,"random_policy_SVM","SVM",92,0,3812,3415,397,100,87,13,0.908395176252323,0.556122448979592,1.74275960384154,31,13,18,0,1.4,2.56,6.7,0,0,0,0,0,0,0.798974249196387,597.290102958624,82.8880234708005
8.7,"random_policy_SVM","SVM",92,1,3712,3369,343,200,133,67,0.887731910946197,0.591836734693878,1.67701130038792,103,50,53,72,1.1,5.11,2,0,0,0,0,0,0,0.725055834012305,422.342700847835,78.9126064981276
8.7,"random_policy_SVM","SVM",92,2,3612,3321,291,300,181,119,0.88761305658627,0.622448979591837,1.66938025210084,177,88,89,74,1,7.67,1.5,0,0,0,0,0,0,0.653665660909063,356.083223179535,74.8351847235455
8.7,"random_policy_SVM","SVM",92,3,3512,3279,233,400,223,177,0.885683847402606,0.607142857142857,1.64186299519808,249,123,126,72,1,10.22,1.3,0,0,0,0,0,0,0.535440520701292,298.826941490513,68.2066070587248
8.7,"random_policy_SVM","SVM",92,4,3412,3243,169,500,259,241,0.881568877551017,0.642857142857143,1.63720492805417,334,167,167,85,1,12.78,1.1,0,0,0,0,0,0,0.347196793522327,261.847416103994,53.7323784546803
8.7,"random_policy_SVM","SVM",92,5,3312,3188,124,600,314,286,0.889184253246758,0.647959183673469,1.63419259148001,415,208,207,81,1,15.34,1.1,0,0,0,0,0,0,0.186102789833901,158.305142924966,31.2803635727175
8.7,"random_policy_SVM","SVM",92,6,3212,3122,90,700,380,320,0.87995419758813,0.642857142857143,1.60812943962115,495,243,252,80,1,17.89,1.2,0,0,0,0,0,0,0.122752243391536,129.36558214346,19.037260365641
8.7,"random_policy_SVM","SVM",92,7,3112,3037,75,800,465,335,0.892578849721698,0.658163265306122,1.62800714755948,535,258,277,40,1.1,20.45,1.4,0,0,0,0,0,0,0.0774055091083502,87.3602595496152,9.76579970330206
8.7,"random_policy_SVM","SVM",92,8,3012,2949,63,900,553,347,0.896251739332086,0.647959183673469,1.64488668395535,565,271,294,30,1.1,23.01,1.6,0,0,0,0,0,0,0.0553372825659646,71.2828869173004,6.47990777562719
8.7,"random_policy_SVM","SVM",92,9,2912,2855,57,1000,647,353,0.902874246289413,0.637755102040816,1.6540759950389,575,278,297,10,1.1,25.56,1.8,0,0,0,0,0,0,0.0430322439858139,58.882789695704,4.86052268790786
8.7,"random_policy_SVM","SVM",92,10,2812,2763,49,1100,739,361,0.912676832096482,0.647959183673469,1.6831938305276,600,287,313,25,1.1,28.12,2,0,0,0,0,0,0,0.0554261004305626,77.1494857190267,6.2642947851728
8.7,"random_policy_SVM","SVM",92,11,2712,2672,40,1200,830,370,0.925774002782935,0.653061224489796,1.73838051349572,637,304,333,37,1.1,30.67,2.2,0,0,0,0,0,0,0.0686688069341639,78.414214349667,7.88226617725577
8.7,"random_policy_SVM","SVM",92,12,2612,2581,31,1300,921,379,0.925858070500936,0.637755102040816,1.74757829399041,663,318,345,26,1.1,33.23,2.4,0,0,0,0,0,0,0.0774843243828826,70.5723408482319,8.49819021921986
8.7,"random_policy_SVM","SVM",92,13,2512,2482,30,1400,1020,380,0.925482664656782,0.63265306122449,1.74275960384154,667,320,347,4,1.1,35.79,2.7,0,0,0,0,0,0,0.0607966447356959,51.4212070182524,6.53593309362089
8.7,"random_policy_SVM","SVM",92,14,2412,2385,27,1500,1117,383,0.924791280148432,0.63265306122449,1.74436287854608,674,323,351,7,1.1,38.34,2.9,0,0,0,0,0,0,0.0535158664541724,43.8054691805022,6.04388212805871
8.7,"random_policy_SVM","SVM",92,15,2312,2288,24,1600,1214,386,0.924052064007427,0.63265306122449,1.74596910587439,682,328,354,8,1.1,40.9,3.1,0,0,0,0,0,0,0.0381905096746561,32.4856922927966,4.47957367721847
8.7,"random_policy_SVM","SVM",92,16,2212,2194,18,1700,1308,392,0.923538961038965,0.627551020408163,1.73838051349572,696,335,361,14,1.1,43.46,3.3,0,0,0,0,0,0,0.0345639761673293,33.3395935804198,4.11245258948135
8.7,"random_policy_SVM","SVM",92,17,2112,2096,16,1800,1406,394,0.923112824675329,0.622448979591837,1.73838051349572,702,337,365,6,1.1,46.01,3.6,0,0,0,0,0,0,0.0290110983026531,30.3173014527505,3.20676774540776
8.7,"random_policy_SVM","SVM",92,18,2012,1996,16,1900,1506,394,0.922830183209651,0.627551020408163,1.73677979479084,698,337,361,-4,1.1,48.57,3.8,0,0,0,0,0,0,0.0224008342539387,23.2587487502346,2.41066192116289
8.7,"random_policy_SVM","SVM",92,19,1912,1899,13,2000,1603,397,0.923753478664201,0.622448979591837,1.73677979479084,710,345,365,12,1.1,51.12,4,0,0,0,0,0,0,0.0182789334794939,19.4475913468976,2.0041436086914
8.7,"random_policy_SVM","SVM",92,20,1812,1801,11,2100,1701,399,0.924602852504646,0.61734693877551,1.74757829399041,715,347,368,5,1.1,53.68,4.3,0,0,0,0,0,0,0.0168654580577043,16.9655914725095,1.74903183345831
8.7,"random_policy_SVM","SVM",92,21,1712,1704,8,2200,1798,402,0.92543773191094,0.607142857142857,1.76272459305709,747,362,385,32,1.1,56.24,4.5,0,0,0,0,0,0,0.0120895916564467,8.96114487740538,1.54623791192358
8.7,"random_policy_SVM","SVM",92,22,1612,1607,5,2300,1895,405,0.925536294063076,0.602040816326531,1.76272459305709,754,367,387,7,1.1,58.79,4.7,0,0,0,0,0,0,0.00934733250662394,8.24191239251146,1.09688535977821
8.7,"random_policy_SVM","SVM",92,23,1512,1507,5,2400,1995,405,0.925062326066788,0.607142857142857,1.75787305747987,757,367,390,3,1.1,61.35,4.9,0,0,0,0,0,0,0.00699834503034007,6.11892136128956,0.750045516860419
8.7,"random_policy_SVM","SVM",92,24,1412,1407,5,2500,2095,405,0.924581110853433,0.607142857142857,1.76434772804149,759,367,392,2,1.1,63.91,5.2,0,0,0,0,0,0,0.00678065019415116,5.3846213865257,0.695749223614028
8.7,"random_policy_SVM","SVM",92,25,1312,1307,5,2600,2195,405,0.924001333487948,0.607142857142857,1.76110444177671,771,374,397,12,1.1,66.46,5.4,0,0,0,0,0,0,0.00421424040270879,3.04225918397501,0.495175474449678
8.7,"random_policy_SVM","SVM",92,26,1212,1207,5,2700,2295,405,0.923970895176259,0.607142857142857,1.76272459305709,771,374,397,0,1.1,69.02,5.7,0,0,0,0,0,0,0.0037582986878707,2.49251468526138,0.388160270517542
8.7,"random_policy_SVM","SVM",92,27,1112,1107,5,2800,2395,405,0.923825950834887,0.61734693877551,1.76110444177671,773,376,397,2,1.1,71.57,5.9,0,0,0,0,0,0,0.00318744511745877,1.91828062809625,0.345857814808026
8.7,"random_policy_SVM","SVM",92,28,1012,1009,3,2900,2493,407,0.923792613636373,0.612244897959184,1.76434772804149,783,380,403,10,1.1,74.13,6.1,0,0,0,0,0,0,0.00327384930177501,1.71684529333692,0.333427068779126
8.7,"random_policy_SVM","SVM",92,29,912,909,3,3000,2593,407,0.923465039424869,0.607142857142857,1.76434772804149,788,384,404,5,1.1,76.69,6.4,0,0,0,0,0,0,0.0025801453106325,1.22543635979286,0.29610611059401
8.7,"random_policy_SVM","SVM",92,30,812,809,3,3100,2693,407,0.923689703153996,0.607142857142857,1.76597385497978,789,384,405,1,1.1,79.24,6.6,0,0,0,0,0,0,0.0022090662118097,0.875643790612299,0.235152382071397
8.7,"random_policy_SVM","SVM",92,31,712,709,3,3200,2793,407,0.92451153756956,0.612244897959184,1.76110444177671,794,387,407,5,1.1,81.8,6.9,0,0,0,0,0,0,0.00161995099666992,0.557232688514344,0.181645906193251
8.7,"random_policy_SVM","SVM",92,32,612,610,2,3300,2892,408,0.92499420222633,0.607142857142857,1.76434772804149,797,389,408,3,1,84.36,7.1,0,0,0,0,0,0,0.00130388050627266,0.409001548582887,0.152824584014228
8.7,"random_policy_SVM","SVM",92,33,512,511,1,3400,2991,409,0.92553484461965,0.612244897959184,1.76434772804149,801,390,411,4,1.1,86.91,7.3,0,0,0,0,0,0,0.00100291675059936,0.315072200464399,0.124996926620675
8.7,"random_policy_SVM","SVM",92,34,412,412,0,3500,3090,410,0.925843576066773,0.612244897959184,1.76110444177671,806,393,413,5,1.1,89.47,7.5,0,0,0,0,0,0,0.000786006190249015,0.240212828259883,0.098361415693165
8.7,"random_policy_SVM","SVM",92,35,312,312,0,3600,3190,410,0.926153756957308,0.612244897959184,1.75787305747987,807,395,412,1,1,92.02,7.8,0,0,0,0,0,0,0.00041939741394282,0.109716132264752,0.0521488046123616
8.7,"random_policy_SVM","SVM",92,36,212,212,0,3700,3290,410,0.926211734693857,0.61734693877551,1.76272459305709,808,395,413,1,1,94.58,8,0,0,0,0,0,0,0.000233886022142445,0.0484894137694422,0.0300326972875941
8.7,"random_policy_SVM","SVM",92,37,112,112,0,3800,3390,410,0.9263639262523,0.612244897959184,1.76110444177671,813,397,416,5,1,97.14,8.3,0,0,0,0,0,0,0.000114353531707565,0.0191763546269896,0.0179454396728234
8.7,"random_policy_SVM","SVM",92,38,12,12,0,3900,3490,410,0.926623376623359,0.612244897959184,1.76597385497978,817,400,417,4,1,99.69,8.5,0,0,0,0,0,0,7.56774586272422e-05,0.00116391791332905,0.00116391791332905
8.7,"random_policy_SVM","SVM",92,39,0,0,0,3912,3502,410,0.926701646567701,0.612244897959184,1.76597385497978,818,400,418,1,1,100,8.5,0,0,0,0,0,0,0,0,0
8.7,"random_policy_SVM","SVM",93,0,3812,3425,387,100,88,12,0.917208729349833,0.618357487922705,1.74729010839566,30,12,18,0,1.5,2.56,7.3,0,0,0,0,0,0,0.458904577690195,470.960141296528,50.8877196557188
8.7,"random_policy_SVM","SVM",93,1,3712,3406,306,200,107,93,0.914140033090005,0.608695652173913,1.72121115155394,80,41,39,50,1,5.11,1.2,0,0,0,0,0,0,0.677019664779296,358.999024339273,74.8657863986913
8.7,"random_policy_SVM","SVM",93,2,3612,3359,253,300,154,146,0.922828227586236,0.623188405797101,1.76305413469736,175,89,86,95,1,7.67,1.1,0,0,0,0,0,0,0.546195931731261,258.005961814322,67.9297367542351
8.7,"random_policy_SVM","SVM",93,3,3512,3316,196,400,197,203,0.906801125833149,0.613526570048309,1.66905323787049,252,127,125,77,1,10.22,1,0,0,0,0,0,0,0.385826810322613,217.092148517608,54.3429938700021
8.7,"random_policy_SVM","SVM",93,4,3412,3261,151,500,252,248,0.894192126349634,0.642512077294686,1.6614110527154,341,174,167,89,1,12.78,1,0,0,0,0,0,0,0.24555440715381,230.960805728363,35.1043327496843
8.7,"random_policy_SVM","SVM",93,5,3312,3196,116,600,317,283,0.893431167016079,0.657004830917874,1.65014919011083,423,211,212,82,1,15.34,1.1,0,0,0,0,0,0,0.144969299434997,160.879506922754,19.0778902378843
8.7,"random_policy_SVM","SVM",93,6,3212,3116,96,700,397,303,0.892617727728476,0.666666666666667,1.66036025225658,477,231,246,54,1.1,17.89,1.3,0,0,0,0,0,0,0.105952308731239,116.852392260958,12.7289696502332
8.7,"random_policy_SVM","SVM",93,7,3112,3031,81,800,482,318,0.897574321282276,0.671497584541063,1.66188912910027,515,248,267,38,1.1,20.45,1.5,0,0,0,0,0,0,0.0811047018356585,107.402161626301,10.2564137010324
8.7,"random_policy_SVM","SVM",93,8,3012,2950,62,900,563,337,0.893653516295034,0.671497584541063,1.65471181459961,558,267,291,43,1.1,23.01,1.7,0,0,0,0,0,0,0.0766914811007183,126.413726503935,13.047896248662
8.7,"random_policy_SVM","SVM",93,9,2912,2857,55,1000,656,344,0.910735741334581,0.671497584541063,1.69046669325888,583,281,302,25,1.1,25.56,1.9,0,0,0,0,0,0,0.060741187601771,87.6974538284348,6.97504456981971
8.7,"random_policy_SVM","SVM",93,10,2812,2765,47,1100,748,352,0.914887181909334,0.671497584541063,1.68799209971442,598,288,310,15,1.1,28.12,2.1,0,0,0,0,0,0,0.0561255301147724,86.6880820366308,6.50413453260918
8.7,"random_policy_SVM","SVM",93,11,2712,2671,41,1200,842,358,0.92762738127793,0.676328502415459,1.71251816594003,631,304,327,33,1.1,30.67,2.4,0,0,0,0,0,0,0.0522213774830679,73.4340002251471,5.93320047116353
8.7,"random_policy_SVM","SVM",93,12,2612,2579,33,1300,934,366,0.932452774946651,0.652173913043478,1.75051091965538,656,313,343,25,1.1,33.23,2.6,0,0,0,0,0,0,0.0572830829457254,65.8305282114172,6.48478971120993
8.7,"random_policy_SVM","SVM",93,13,2512,2481,31,1400,1032,368,0.937077916159166,0.652173913043478,1.77500200176155,664,321,343,8,1.1,35.79,2.8,0,0,0,0,0,0,0.0502992349319271,55.1854223474342,5.46770544011346
8.7,"random_policy_SVM","SVM",93,14,2412,2383,29,1500,1130,370,0.938507304381009,0.652173913043478,1.77173913043478,674,323,351,10,1.1,38.34,3.1,0,0,0,0,0,0,0.0484439205448917,53.1202594017768,5.29400168464592
8.7,"random_policy_SVM","SVM",93,15,2312,2285,27,1600,1228,372,0.939547236101827,0.652173913043478,1.77500200176155,681,326,355,7,1.1,40.9,3.3,0,0,0,0,0,0,0.0384515565293175,40.0539576553083,4.23757191612272
8.7,"random_policy_SVM","SVM",93,16,2212,2189,23,1700,1324,376,0.940136945059044,0.652173913043478,1.77663794830695,692,333,359,11,1.1,43.46,3.5,0,0,0,0,0,0,0.0371653443629426,36.5236562705264,4.2863054067989
8.7,"random_policy_SVM","SVM",93,17,2112,2097,15,1800,1416,384,0.939291741588732,0.652173913043478,1.77011218908452,712,343,369,20,1.1,46.01,3.7,0,0,0,0,0,0,0.0331217667699968,33.6797167088275,4.39141668953177
8.7,"random_policy_SVM","SVM",93,18,2012,2001,11,1900,1512,388,0.937698008247664,0.652173913043478,1.77500200176155,724,347,377,12,1.1,48.57,3.9,0,0,0,0,0,0,0.0282780374025812,28.7804715297584,3.12863596654329
8.7,"random_policy_SVM","SVM",93,19,1912,1901,11,2000,1612,388,0.937181495015811,0.652173913043478,1.77336906523739,727,348,379,3,1.1,51.12,4.2,0,0,0,0,0,0,0.0260363091088751,25.9953371288033,2.68151483616734
8.7,"random_policy_SVM","SVM",93,20,1812,1802,10,2100,1711,389,0.935087821059967,0.657004830917874,1.77500200176155,745,358,387,18,1.1,53.68,4.4,0,0,0,0,0,0,0.0173960026873861,14.4398489945864,2.15376330921217
8.7,"random_policy_SVM","SVM",93,21,1712,1704,8,2200,1809,391,0.935449656532549,0.661835748792271,1.77173913043478,748,360,388,3,1.1,56.24,4.6,0,0,0,0,0,0,0.013566975357315,12.1409777368629,1.49258442978722
8.7,"random_policy_SVM","SVM",93,22,1612,1607,5,2300,1906,394,0.935311551390337,0.657004830917874,1.77878920961925,759,364,395,11,1.1,58.79,4.8,0,0,0,0,0,0,0.0148214024168717,12.1518183557833,1.50040989538525
8.7,"random_policy_SVM","SVM",93,23,1512,1507,5,2400,2006,394,0.934640360399206,0.652173913043478,1.78042412617221,774,378,396,15,1,61.35,5.1,0,0,0,0,0,0,0.0115042647316146,8.06724464925434,1.45149884894854
8.7,"random_policy_SVM","SVM",93,24,1412,1407,5,2500,2106,394,0.934574069930946,0.652173913043478,1.7820620508513,770,376,394,-4,1,63.91,5.3,0,0,0,0,0,0,0.00811559584468581,5.79464965663259,0.893655000560618
8.7,"random_policy_SVM","SVM",93,25,1312,1307,5,2600,2206,394,0.934633455142095,0.652173913043478,1.78370299196626,770,376,394,0,1,66.46,5.6,0,0,0,0,0,0,0.00746120400602909,4.84676080529825,0.764704962838874
8.7,"random_policy_SVM","SVM",93,26,1212,1207,5,2700,2306,394,0.935188637813766,0.652173913043478,1.78370299196626,774,378,396,4,1,69.02,5.9,0,0,0,0,0,0,0.00612732714966034,3.50248851732349,0.643910448042535
8.7,"random_policy_SVM","SVM",93,27,1112,1107,5,2800,2406,394,0.935482801766666,0.652173913043478,1.78534695785748,779,379,400,5,1.1,71.57,6.1,0,0,0,0,0,0,0.00536882175193544,2.64953447813422,0.55412802128537
8.7,"random_policy_SVM","SVM",93,28,1012,1008,4,2900,2505,395,0.935582237469055,0.647342995169082,1.78534695785748,788,383,405,9,1.1,74.13,6.3,0,0,0,0,0,0,0.00553766757174809,2.47366777718417,0.593144084757347
8.7,"random_policy_SVM","SVM",93,29,912,908,4,3000,2605,395,0.935590523777587,0.647342995169082,1.7820620508513,793,384,409,5,1.1,76.69,6.6,0,0,0,0,0,0,0.00410953478574314,1.60638680542858,0.451615604718458
8.7,"random_policy_SVM","SVM",93,30,812,810,2,3100,2703,397,0.935518709103641,0.652173913043478,1.78534695785748,800,386,414,7,1.1,79.24,6.8,0,0,0,0,0,0,0.0034077753534332,1.23809000281778,0.386508967084976
8.7,"random_policy_SVM","SVM",93,31,712,710,2,3200,2803,397,0.935520090155063,0.647342995169082,1.78370299196626,798,386,412,-2,1.1,81.8,7.1,0,0,0,0,0,0,0.00248829173844232,0.787145296753666,0.28354277370054
8.7,"random_policy_SVM","SVM",93,32,612,610,2,3300,2903,397,0.935626431114562,0.647342995169082,1.7820620508513,798,386,412,0,1.1,84.36,7.3,0,0,0,0,0,0,0.00163833852006818,0.523268801328301,0.209174722046797
8.7,"random_policy_SVM","SVM",93,33,512,510,2,3400,3003,397,0.935625050063139,0.642512077294686,1.78370299196626,799,388,411,1,1.1,86.91,7.6,0,0,0,0,0,0,0.000977208189761982,0.301911038573899,0.130894281954765
8.7,"random_policy_SVM","SVM",93,34,412,411,1,3500,3102,398,0.93551318489795,0.647342995169082,1.78534695785748,804,390,414,5,1.1,89.47,7.8,0,0,0,0,0,0,0.000641805587211506,0.18726626906531,0.081585135527787
8.7,"random_policy_SVM","SVM",93,35,312,312,0,3600,3201,399,0.936050413901133,0.647342995169082,1.78042412617221,804,392,412,0,1.1,92.02,8,0,0,0,0,0,0,0.000537721688580146,0.134230628342739,0.0668351814761821
8.7,"random_policy_SVM","SVM",93,36,212,212,0,3700,3301,399,0.936065605466775,0.647342995169082,1.78042412617221,808,394,414,4,1.1,94.58,8.3,0,0,0,0,0,0,0.000288489968036066,0.06049843938341,0.0385789382758793
8.7,"random_policy_SVM","SVM",93,37,112,112,0,3800,3401,399,0.936243761100221,0.647342995169082,1.78370299196626,811,395,416,3,1.1,97.14,8.5,0,0,0,0,0,0,0.000108741536829562,0.0178055095769817,0.0167107449466107
8.7,"random_policy_SVM","SVM",93,38,12,12,0,3900,3501,399,0.936435727247888,0.647342995169082,1.78042412617221,811,396,415,0,1,99.69,8.8,0,0,0,0,0,0,7.7058262025548e-05,0.00108198348312077,0.00108198348312077
8.7,"random_policy_SVM","SVM",93,39,0,0,0,3912,3513,399,0.936449537762108,0.647342995169082,1.78370299196626,813,396,417,2,1.1,100,8.8,0,0,0,0,0,0,0,0,0
8.7,"random_policy_SVM","SVM",94,0,3812,3425,387,100,87,13,0.910846047156727,0.597087378640777,1.75254754072053,31,13,18,0,1.4,2.56,6.7,0,0,0,0,0,0,0.904025346192065,614.76774697557,92.6619801801258
8.7,"random_policy_SVM","SVM",94,1,3712,3377,335,200,135,65,0.898251040221914,0.58252427184466,1.71367269216328,103,50,53,72,1.1,5.11,2.1,0,0,0,0,0,0,0.691539689171338,389.589327155456,75.6299655973216
8.7,"random_policy_SVM","SVM",94,2,3612,3324,288,300,188,112,0.910959778085993,0.640776699029126,1.70336099177392,174,85,89,71,1,7.67,1.7,0,0,0,0,0,0,0.569598305815156,336.231842823046,69.1203111005328
8.7,"random_policy_SVM","SVM",94,3,3512,3292,220,400,220,180,0.916915395284311,0.66504854368932,1.76126668271417,245,124,121,71,1,10.22,1.2,0,0,0,0,0,0,0.45066645617786,258.007985468935,64.4748496087246
8.7,"random_policy_SVM","SVM",94,4,3412,3247,165,500,265,235,0.910393897364751,0.655339805825243,1.72956654549352,330,165,165,85,1,12.78,1.1,0,0,0,0,0,0,0.268532596648498,235.393753403328,45.0855922035326
8.7,"random_policy_SVM","SVM",94,5,3312,3187,125,600,325,275,0.892420249653255,0.674757281553398,1.61749718392963,408,203,205,78,1,15.34,1.2,0,0,0,0,0,0,0.144250071887111,187.754325314488,22.3776093504715
8.7,"random_policy_SVM","SVM",94,6,3212,3115,97,700,397,303,0.893783633841875,0.689320388349515,1.63347951518832,470,227,243,62,1.1,17.89,1.3,0,0,0,0,0,0,0.117876794395835,181.215189728118,16.0121632669748
8.7,"random_policy_SVM","SVM",94,7,3112,3033,79,800,479,321,0.909424410540909,0.694174757281553,1.66688677898344,512,250,262,42,1,20.45,1.5,0,0,0,0,0,0,0.0875401302439884,127.652086202659,10.7497725950918
8.7,"random_policy_SVM","SVM",94,8,3012,2950,62,900,562,338,0.918701803051307,0.699029126213592,1.6961862361208,553,268,285,41,1.1,23.01,1.7,0,0,0,0,0,0,0.0867395759012872,141.805835569242,9.95565841773894
8.7,"random_policy_SVM","SVM",94,9,2912,2860,52,1000,652,348,0.926603328710114,0.679611650485437,1.72797687035979,586,280,306,33,1.1,25.56,1.9,0,0,0,0,0,0,0.0903311246841413,126.823229019657,9.96976164404664
8.7,"random_policy_SVM","SVM",94,10,2812,2765,47,1100,747,353,0.931079056865462,0.674757281553398,1.75900854547895,612,292,320,26,1.1,28.12,2.1,0,0,0,0,0,0,0.084122882700484,106.690627383838,9.09943750414774
8.7,"random_policy_SVM","SVM",94,11,2712,2672,40,1200,840,360,0.933517337031899,0.660194174757282,1.75254754072053,631,300,331,19,1.1,30.67,2.3,0,0,0,0,0,0,0.0724554649659188,89.2519662646508,7.77627854421585
8.7,"random_policy_SVM","SVM",94,12,2612,2579,33,1300,933,367,0.935339805825225,0.669902912621359,1.7438283987269,648,310,338,17,1.1,33.23,2.5,0,0,0,0,0,0,0.0631702224465403,75.8777068420491,7.22588151555063
8.7,"random_policy_SVM","SVM",94,13,2512,2483,29,1400,1029,371,0.93521775312065,0.669902912621359,1.74222855615926,656,312,344,8,1.1,35.79,2.8,0,0,0,0,0,0,0.0569740382865011,66.6683202760777,6.10767400809279
8.7,"random_policy_SVM","SVM",94,14,2412,2388,24,1500,1124,376,0.936080443828001,0.674757281553398,1.74864560424824,668,319,349,12,1.1,38.34,3,0,0,0,0,0,0,0.050460063075166,60.8038108352416,5.62702198363408
8.7,"random_policy_SVM","SVM",94,15,2312,2295,17,1600,1217,383,0.936205270457684,0.669902912621359,1.74150597288712,689,330,359,21,1.1,40.9,3.2,0,0,0,0,0,0,0.0447689703318855,53.9119277743107,4.94259371223421
8.7,"random_policy_SVM","SVM",94,16,2212,2196,16,1700,1316,384,0.936307905686534,0.674757281553398,1.74150597288712,684,329,355,-5,1.1,43.46,3.4,0,0,0,0,0,0,0.0372563683144492,44.5172036502378,3.98419983935461
8.7,"random_policy_SVM","SVM",94,17,2112,2097,15,1800,1415,385,0.936227461858512,0.66504854368932,1.74864560424824,691,332,359,7,1.1,46.01,3.7,0,0,0,0,0,0,0.0316069935343679,37.0912601302747,3.36502337774407
8.7,"random_policy_SVM","SVM",94,18,2012,1997,15,1900,1515,385,0.935789181692078,0.660194174757282,1.74703691463992,694,332,362,3,1.1,48.57,3.9,0,0,0,0,0,0,0.0260484698921987,28.6620506245473,2.74123856584802
8.7,"random_policy_SVM","SVM",94,19,1912,1899,13,2000,1613,387,0.936772538141454,0.660194174757282,1.74864560424824,703,337,366,9,1.1,51.12,4.2,0,0,0,0,0,0,0.0246764991293437,26.4470837191089,2.5596326157566
8.7,"random_policy_SVM","SVM",94,20,1812,1799,13,2100,1713,387,0.936174757281549,0.640776699029126,1.75965084172085,720,348,372,17,1.1,53.68,4.4,0,0,0,0,0,0,0.0167598514551154,14.1286147493218,2.01035048972659
8.7,"random_policy_SVM","SVM",94,21,1712,1701,11,2200,1811,389,0.936518723994444,0.645631067961165,1.76450728378632,723,351,372,3,1.1,56.24,4.7,0,0,0,0,0,0,0.0130431165305199,11.6269176659328,1.44330977902432
8.7,"random_policy_SVM","SVM",94,22,1612,1604,8,2300,1908,392,0.937486823855752,0.640776699029126,1.76775983177486,729,352,377,6,1.1,58.79,4.9,0,0,0,0,0,0,0.0133111093044434,12.4717810977174,1.47973383762517
8.7,"random_policy_SVM","SVM",94,23,1512,1505,7,2400,2007,393,0.938108183079058,0.640776699029126,1.76126668271417,732,355,377,3,1.1,61.35,5.1,0,0,0,0,0,0,0.0122774826402851,10.4979529595798,1.27886011595091
8.7,"random_policy_SVM","SVM",94,24,1412,1405,7,2500,2107,393,0.937120665742023,0.635922330097087,1.76836198450165,743,360,383,11,1.1,63.91,5.4,0,0,0,0,0,0,0.00944200368497213,7.35020604109337,1.06280465464522
8.7,"random_policy_SVM","SVM",94,25,1312,1306,6,2600,2206,394,0.93724826629681,0.635922330097087,1.77324246835952,746,361,385,3,1.1,66.46,5.6,0,0,0,0,0,0,0.00934354450975311,6.5792623766446,0.951046775173503
8.7,"random_policy_SVM","SVM",94,26,1212,1207,5,2700,2305,395,0.937015256588069,0.631067961165049,1.7699858247078,768,374,394,22,1.1,69.02,5.8,0,0,0,0,0,0,0.00690380127633923,4.2983190585664,0.795575404722661
8.7,"random_policy_SVM","SVM",94,27,1112,1107,5,2800,2405,395,0.936965325936196,0.631067961165049,1.76836198450165,763,372,391,-5,1.1,71.57,6.1,0,0,0,0,0,0,0.0063491059869757,3.42897030718759,0.648765569926197
8.7,"random_policy_SVM","SVM",94,28,1012,1007,5,2900,2505,395,0.936771151178911,0.631067961165049,1.78197765293272,770,374,396,7,1.1,74.13,6.3,0,0,0,0,0,0,0.00499017035329906,2.35048639612322,0.540769133397271
8.7,"random_policy_SVM","SVM",94,29,912,908,4,3000,2604,396,0.937230235783615,0.635922330097087,1.78361851633321,774,376,398,4,1.1,76.69,6.6,0,0,0,0,0,0,0.00419521509246537,1.66997990483968,0.43907458265508
8.7,"random_policy_SVM","SVM",94,30,812,808,4,3100,2704,396,0.937170596393877,0.631067961165049,1.78197765293272,777,379,398,3,1.1,79.24,6.8,0,0,0,0,0,0,0.00350491958409571,1.183238442274,0.381123294322637
8.7,"random_policy_SVM","SVM",94,31,712,709,3,3200,2803,397,0.93751872399443,0.621359223300971,1.77707312728244,778,381,397,1,1,81.8,7.1,0,0,0,0,0,0,0.00275564764177961,0.871450595387278,0.330448836740706
8.7,"random_policy_SVM","SVM",94,32,612,611,1,3300,2901,399,0.93745214979193,0.631067961165049,1.78033980582524,785,383,402,7,1,84.36,7.3,0,0,0,0,0,0,0.00224024649199839,0.708832904975546,0.277517811994216
8.7,"random_policy_SVM","SVM",94,33,512,511,1,3400,3001,399,0.937428571428544,0.631067961165049,1.78033980582524,788,385,403,3,1,86.91,7.5,0,0,0,0,0,0,0.00125419423010751,0.400338522706239,0.17043323014326
8.7,"random_policy_SVM","SVM",94,34,412,412,0,3500,3100,400,0.937353675450738,0.631067961165049,1.77870496670144,797,388,409,9,1.1,89.47,7.8,0,0,0,0,0,0,0.000916862859913729,0.26593851320381,0.116346467856971
8.7,"random_policy_SVM","SVM",94,35,312,312,0,3600,3200,400,0.93743689320386,0.631067961165049,1.77707312728244,799,389,410,2,1.1,92.02,8,0,0,0,0,0,0,0.000567366117294084,0.138857084665709,0.0707292493041989
8.7,"random_policy_SVM","SVM",94,36,212,212,0,3700,3300,400,0.937413314840476,0.62621359223301,1.78361851633321,802,391,411,3,1.1,94.58,8.2,0,0,0,0,0,0,0.00027128286348838,0.0575300214145498,0.036595201655476
8.7,"random_policy_SVM","SVM",94,37,112,112,0,3800,3400,400,0.93752565880719,0.631067961165049,1.78197765293272,802,391,411,0,1.1,97.14,8.5,0,0,0,0,0,0,0.000111973402827878,0.0187501687550836,0.0176042871257309
8.7,"random_policy_SVM","SVM",94,38,12,12,0,3900,3500,400,0.937583911234375,0.631067961165049,1.78197765293272,804,392,412,2,1.1,99.69,8.8,0,0,0,0,0,0,7.23549619345378e-05,0.00117233890976687,0.00117233890976687
8.7,"random_policy_SVM","SVM",94,39,0,0,0,3912,3512,400,0.937520110956982,0.631067961165049,1.79071283750592,804,392,412,0,1.1,100,8.8,0,0,0,0,0,0,0,0,0
8.7,"random_policy_SVM","SVM",95,0,3812,3429,383,100,90,10,0.909682997583901,0.539906103286385,1.77737392094502,23,10,13,0,1.3,2.56,9,0,0,0,0,0,0,0.384416132806947,327.666479908062,43.0270325578251
8.7,"random_policy_SVM","SVM",95,1,3712,3390,322,200,129,71,0.886637091626068,0.572769953051643,1.71496689428198,104,52,52,81,1,5.11,1.8,0,0,0,0,0,0,0.764034631160186,293.67963273048,82.9919592876204
8.7,"random_policy_SVM","SVM",95,2,3612,3341,271,300,178,122,0.90121990308653,0.553990610328638,1.72551348420495,173,86,87,69,1,7.67,1.5,0,0,0,0,0,0,0.54442927556659,193.898017066254,70.8313320673509
8.7,"random_policy_SVM","SVM",95,3,3512,3298,214,400,221,179,0.885555636361678,0.55868544600939,1.69963426970664,248,125,123,75,1,10.22,1.2,0,0,0,0,0,0,0.330300339540532,149.181923447206,58.1132390551995
8.7,"random_policy_SVM","SVM",95,4,3412,3251,161,500,268,232,0.888581825625775,0.572769953051643,1.66812249644657,320,158,162,72,1,12.78,1.2,0,0,0,0,0,0,0.137913519986912,72.8626643039575,26.8315733745839
8.7,"random_policy_SVM","SVM",95,5,3312,3182,130,600,337,263,0.882563116315035,0.596244131455399,1.67118889809445,376,187,189,56,1,15.34,1.3,0,0,0,0,0,0,0.0805268777478691,45.7467328678427,12.3135376482448
8.7,"random_policy_SVM","SVM",95,6,3212,3111,101,700,408,292,0.883538176852283,0.615023474178404,1.64586785418393,448,215,233,72,1.1,17.89,1.4,0,0,0,0,0,0,0.0768816275821743,61.2539274925983,10.7823183252001
8.7,"random_policy_SVM","SVM",95,7,3112,3028,84,800,491,309,0.890219496362376,0.629107981220657,1.65888232621536,483,235,248,35,1.1,20.45,1.6,0,0,0,0,0,0,0.058580620797999,55.1743965272807,7.73444280603621
8.7,"random_policy_SVM","SVM",95,8,3012,2942,70,900,577,323,0.879806280790504,0.643192488262911,1.61507535081576,512,247,265,29,1.1,23.01,1.8,0,0,0,0,0,0,0.0603333519074878,78.7462440827974,7.60389753867096
8.7,"random_policy_SVM","SVM",95,9,2912,2855,57,1000,664,336,0.8798089743279,0.661971830985915,1.60219351000401,562,266,296,50,1.1,25.56,2,0,0,0,0,0,0,0.066293239325538,90.2576868875439,8.66866675734363
8.7,"random_policy_SVM","SVM",95,10,2812,2760,52,1100,759,341,0.88649702768149,0.652582159624413,1.62502758486402,578,273,305,16,1.1,28.12,2.2,0,0,0,0,0,0,0.0524289681537278,67.2096351709845,5.91882768521316
8.7,"random_policy_SVM","SVM",95,11,2712,2661,51,1200,858,342,0.889713111331997,0.652582159624413,1.64195495553969,577,275,302,-1,1.1,30.67,2.5,0,0,0,0,0,0,0.0391364190026049,50.7261581271015,4.23436986808203
8.7,"random_policy_SVM","SVM",95,12,2612,2562,50,1300,957,343,0.893687425759391,0.647887323943662,1.64889891837211,583,278,305,6,1.1,33.23,2.8,0,0,0,0,0,0,0.0294464031897006,36.7170962638124,3.18383206500567
8.7,"random_policy_SVM","SVM",95,13,2512,2466,46,1400,1053,347,0.899439474867945,0.643192488262911,1.64975923367888,598,287,311,15,1.1,35.79,3,0,0,0,0,0,0,0.0248477370111421,31.8040669835102,2.67318110132717
8.7,"random_policy_SVM","SVM",95,14,2412,2372,40,1500,1147,353,0.907743650658976,0.63849765258216,1.68272248592846,617,299,318,19,1.1,38.34,3.2,0,0,0,0,0,0,0.0290453179974255,35.9604387995679,3.3123974110568
8.7,"random_policy_SVM","SVM",95,15,2312,2277,35,1600,1242,358,0.912683598242732,0.652582159624413,1.68651948421475,630,305,325,13,1.1,40.9,3.5,0,0,0,0,0,0,0.0281189507445037,36.1971081925336,3.15487293921484
8.7,"random_policy_SVM","SVM",95,16,2212,2185,27,1700,1334,366,0.919643698873284,0.657276995305164,1.7318631198414,659,318,341,29,1.1,43.46,3.6,0,0,0,0,0,0,0.0591459305246374,46.2102262944075,6.81251130757576
8.7,"random_policy_SVM","SVM",95,17,2112,2086,26,1800,1433,367,0.921084741379994,0.657276995305164,1.74191372915208,670,325,345,11,1.1,46.01,3.9,0,0,0,0,0,0,0.0404185828354926,33.6738282188899,4.6254245869556
8.7,"random_policy_SVM","SVM",95,18,2012,1990,22,1900,1529,371,0.921960141033609,0.652582159624413,1.74031123262112,683,333,350,13,1.1,48.57,4.1,0,0,0,0,0,0,0.0458949632113578,32.2986655752206,5.06097461555267
8.7,"random_policy_SVM","SVM",95,19,1912,1899,13,2000,1620,380,0.921981689332779,0.657276995305164,1.73505549425586,715,342,373,32,1.1,51.12,4.3,0,0,0,0,0,0,0.0471664177100707,26.7197512000767,5.67513494623266
8.7,"random_policy_SVM","SVM",95,20,1812,1805,7,2100,1714,386,0.922237575385374,0.657276995305164,1.72868247132012,726,349,377,11,1.1,53.68,4.4,0,0,0,0,0,0,0.0310713001209308,23.4421930378844,4.23102103415832
8.7,"random_policy_SVM","SVM",95,21,1712,1706,6,2200,1813,387,0.922186398174855,0.657276995305164,1.72709652409872,733,351,382,7,1.1,56.24,4.7,0,0,0,0,0,0,0.0225753022852085,17.771796550439,2.57015737785189
8.7,"random_policy_SVM","SVM",95,22,1612,1606,6,2300,1913,387,0.922248349534957,0.657276995305164,1.73027133388567,735,353,382,2,1.1,58.79,4.9,0,0,0,0,0,0,0.0156588135572,12.8930083223588,1.72749797731566
8.7,"random_policy_SVM","SVM",95,23,1512,1506,6,2400,2013,387,0.922341276575108,0.652582159624413,1.72709652409872,737,354,383,2,1.1,61.35,5.2,0,0,0,0,0,0,0.0138722527319822,10.6943056364632,1.40840550672191
8.7,"random_policy_SVM","SVM",95,24,1412,1407,5,2500,2112,388,0.925033467202131,0.643192488262911,1.74715202982601,754,364,390,17,1.1,63.91,5.4,0,0,0,0,0,0,0.0108235433862046,7.40681194002125,1.34044106332929
8.7,"random_policy_SVM","SVM",95,25,1312,1307,5,2600,2212,388,0.924966128767237,0.643192488262911,1.74875934540083,753,363,390,-1,1.1,66.46,5.7,0,0,0,0,0,0,0.00862742035890794,5.75664228996075,0.901362784293151
8.7,"random_policy_SVM","SVM",95,26,1212,1207,5,2700,2312,388,0.925301474173008,0.647887323943662,1.75882551293025,751,367,384,-2,1,69.02,6,0,0,0,0,0,0,0.00582266091623979,3.60184408380597,0.65595474913605
8.7,"random_policy_SVM","SVM",95,27,1112,1107,5,2800,2412,388,0.925317635397382,0.647887323943662,1.75882551293025,750,367,383,-1,1,71.57,6.2,0,0,0,0,0,0,0.00615328365317412,3.17454026886068,0.620686583052114
8.7,"random_policy_SVM","SVM",95,28,1012,1007,5,2900,2512,388,0.926520299844587,0.647887323943662,1.76241286100441,759,373,386,9,1,74.13,6.5,0,0,0,0,0,0,0.00482487600470661,2.29774020865336,0.571160247432228
8.7,"random_policy_SVM","SVM",95,29,912,908,4,3000,2611,389,0.926479896783647,0.643192488262911,1.75398026358334,766,375,391,7,1,76.69,6.7,0,0,0,0,0,0,0.00502363581106869,1.88463710580537,0.519608091502505
8.7,"random_policy_SVM","SVM",95,30,812,809,3,3100,2710,390,0.926695379775308,0.643192488262911,1.75237110737821,771,377,394,5,1,79.24,6.9,0,0,0,0,0,0,0.00370935293642423,1.18041998754076,0.414393555805131
8.7,"random_policy_SVM","SVM",95,31,712,709,3,3200,2810,390,0.926816588958117,0.643192488262911,1.75559237779619,771,377,394,0,1,81.8,7.2,0,0,0,0,0,0,0.00249613848042899,0.688159130730881,0.290175711276001
8.7,"random_policy_SVM","SVM",95,32,612,610,2,3300,2909,391,0.92704957994285,0.643192488262911,1.75882551293025,779,378,401,8,1.1,84.36,7.4,0,0,0,0,0,0,0.0014458287705702,0.445805884548638,0.204268048117279
8.7,"random_policy_SVM","SVM",95,33,512,511,1,3400,3008,392,0.927671787081265,0.63849765258216,1.76728140481934,787,383,404,8,1.1,86.91,7.7,0,0,0,0,0,0,0.000973885617789979,0.316228882592422,0.131826287271366
8.7,"random_policy_SVM","SVM",95,34,412,412,0,3500,3107,393,0.928004438949638,0.633802816901408,1.76403272576636,790,385,405,3,1.1,89.47,7.9,0,0,0,0,0,0,0.000699652405942517,0.204603883431075,0.0905921451645604
8.7,"random_policy_SVM","SVM",95,35,312,312,0,3600,3207,393,0.928574122108832,0.629107981220657,1.76403272576636,794,386,408,4,1.1,92.02,8.2,0,0,0,0,0,0,0.000592037749566437,0.151635412611524,0.0764729043384601
8.7,"random_policy_SVM","SVM",95,36,212,212,0,3700,3307,393,0.928658968536796,0.624413145539906,1.76403272576636,797,387,410,3,1.1,94.58,8.4,0,0,0,0,0,0,0.000235601376646698,0.0494913136335738,0.0318280326662955
8.7,"random_policy_SVM","SVM",95,37,112,112,0,3800,3407,393,0.928900040133712,0.624413145539906,1.76403272576636,796,388,408,-1,1.1,97.14,8.7,0,0,0,0,0,0,8.27773953459921e-05,0.0149314373399,0.0140339084425986
8.7,"random_policy_SVM","SVM",95,38,12,12,0,3900,3507,393,0.929073773295734,0.619718309859155,1.76241286100441,796,389,407,0,1,99.69,8.9,0,0,0,0,0,0,8.41719147112585e-05,0.00116782230451476,0.00116782230451476
8.7,"random_policy_SVM","SVM",95,39,0,0,0,3912,3519,393,0.929022596085216,0.619718309859155,1.76241286100441,797,390,407,1,1,100,9,0,0,0,0,0,0,0,0,0
8.7,"random_policy_SVM","SVM",96,0,3812,3403,409,100,85,15,0.919583235254031,0.56043956043956,1.76007158440827,33,15,18,0,1.2,2.56,5.7,0,0,0,0,0,0,0.711796019922025,691.247811832627,73.9796822003437
8.7,"random_policy_SVM","SVM",96,1,3712,3380,332,200,108,92,0.921379635021118,0.56043956043956,1.76978679094594,91,49,42,58,0.9,5.11,1.2,0,0,0,0,0,0,0.679538769946334,478.249713340791,72.5255158452778
8.7,"random_policy_SVM","SVM",96,2,3612,3333,279,300,155,145,0.920047821400699,0.593406593406593,1.75184156502838,162,82,80,71,1,7.67,1.1,0,0,0,0,0,0,0.676634291093474,446.755819979438,76.7337921709779
8.7,"random_policy_SVM","SVM",96,3,3512,3286,226,400,202,198,0.922644857960523,0.593406593406593,1.75828215901745,243,123,120,81,1,10.22,1,0,0,0,0,0,0,0.543745484790202,277.59685592221,66.894051532274
8.7,"random_policy_SVM","SVM",96,4,3412,3239,173,500,249,251,0.924545015300365,0.626373626373626,1.76816014867485,332,167,165,89,1,12.78,1,0,0,0,0,0,0,0.363356007650416,256.145146683069,53.3136481630698
8.7,"random_policy_SVM","SVM",96,5,3312,3179,133,600,309,291,0.920918146115448,0.631868131868132,1.73342786246012,412,205,207,80,1,15.34,1.1,0,0,0,0,0,0,0.223265768292037,188.711014952081,32.9731747776554
8.7,"random_policy_SVM","SVM",96,6,3212,3111,101,700,377,323,0.924278652576302,0.648351648351648,1.75323846660252,489,243,246,77,1,17.89,1.2,0,0,0,0,0,0,0.128433853955158,125.70757467399,16.776904073109
8.7,"random_policy_SVM","SVM",96,7,3112,3033,79,800,455,345,0.9143984538573,0.648351648351648,1.68390135210412,534,262,272,45,1,20.45,1.3,0,0,0,0,0,0,0.111685585539941,146.022025826857,14.8914640542199
8.7,"random_policy_SVM","SVM",96,8,3012,2945,67,900,543,357,0.920664172355267,0.659340659340659,1.70371195624652,568,275,293,34,1.1,23.01,1.5,0,0,0,0,0,0,0.0723976644824649,94.0636207999755,8.66281995529504
8.7,"random_policy_SVM","SVM",96,9,2912,2857,55,1000,631,369,0.925913995812525,0.653846153846154,1.74172788537429,608,293,315,40,1.1,25.56,1.7,0,0,0,0,0,0,0.0932791392609673,105.339111678593,10.3100909016093
8.7,"random_policy_SVM","SVM",96,10,2812,2764,48,1100,724,376,0.930847900690064,0.642857142857143,1.75828215901745,639,306,333,31,1.1,28.12,1.9,0,0,0,0,0,0,0.0768985195544457,76.2303671727526,8.46834480599116
8.7,"random_policy_SVM","SVM",96,11,2712,2669,43,1200,819,381,0.930473134531764,0.642857142857143,1.76314376867372,656,315,341,17,1.1,30.67,2.1,0,0,0,0,0,0,0.0770187920285638,73.7021085726697,8.39461145050757
8.7,"random_policy_SVM","SVM",96,12,2612,2572,40,1300,916,384,0.931039929630697,0.642857142857143,1.76314376867372,667,318,349,11,1.1,33.23,2.4,0,0,0,0,0,0,0.0603962518641634,50.6674621846491,6.43325351724694
8.7,"random_policy_SVM","SVM",96,13,2512,2476,36,1400,1012,388,0.930826220003232,0.642857142857143,1.75989971390155,676,324,352,9,1.1,35.79,2.6,0,0,0,0,0,0,0.0514626647586073,43.3587227475155,5.71631564186276
8.7,"random_policy_SVM","SVM",96,14,2412,2383,29,1500,1105,395,0.931470446126598,0.653846153846154,1.76314376867372,706,332,374,30,1.1,38.34,2.8,0,0,0,0,0,0,0.0436495327999659,36.792876775819,5.17643235463661
8.7,"random_policy_SVM","SVM",96,15,2312,2288,24,1600,1200,400,0.932656689421069,0.653846153846154,1.76314376867372,704,336,368,-2,1.1,40.9,3,0,0,0,0,0,0,0.0407361365195997,36.7021592938551,4.57599816270649
8.7,"random_policy_SVM","SVM",96,16,2212,2193,19,1700,1295,405,0.934335394031005,0.659340659340659,1.76314376867372,720,343,377,16,1.1,43.46,3.2,0,0,0,0,0,0,0.0331172696515683,33.2234693123765,3.71062609177074
8.7,"random_policy_SVM","SVM",96,17,2112,2095,17,1800,1393,407,0.934366366440782,0.664835164835165,1.75989971390155,724,347,377,4,1.1,46.01,3.4,0,0,0,0,0,0,0.0255097928542135,25.7340396162838,2.79646055371218
8.7,"random_policy_SVM","SVM",96,18,2012,1996,16,1900,1492,408,0.934329199549051,0.664835164835165,1.75989971390155,733,352,381,9,1.1,48.57,3.7,0,0,0,0,0,0,0.0201091512339237,20.2911234472682,2.20179653205149
8.7,"random_policy_SVM","SVM",96,19,1912,1899,13,2000,1589,411,0.934648215369758,0.659340659340659,1.76152024770809,741,358,383,8,1.1,51.12,3.9,0,0,0,0,0,0,0.020251810087372,20.5757069110032,2.15379969113249
8.7,"random_policy_SVM","SVM",96,20,1812,1799,13,2100,1689,411,0.934858827756248,0.659340659340659,1.76314376867372,744,360,384,3,1.1,53.68,4.1,0,0,0,0,0,0,0.0166718870947258,16.9344758973293,1.79827736476352
8.7,"random_policy_SVM","SVM",96,21,1712,1702,10,2200,1786,414,0.935244434257981,0.664835164835165,1.76152024770809,760,366,394,16,1.1,56.24,4.3,0,0,0,0,0,0,0.0162706522617831,14.2835772041517,1.64466225771997
8.7,"random_policy_SVM","SVM",96,22,1612,1603,9,2300,1885,415,0.935261469083359,0.642857142857143,1.76653649380922,788,383,405,28,1.1,58.79,4.5,0,0,0,0,0,0,0.011463160178137,6.98989877661756,1.58080279641224
8.7,"random_policy_SVM","SVM",96,23,1512,1505,7,2400,1983,417,0.934967231190473,0.642857142857143,1.76653649380922,796,386,410,8,1.1,61.35,4.8,0,0,0,0,0,0,0.00841608670505717,6.1422361976411,1.05496899782385
8.7,"random_policy_SVM","SVM",96,24,1412,1406,6,2500,2082,418,0.935167003233538,0.648351648351648,1.77141642887499,796,387,409,0,1.1,63.91,5,0,0,0,0,0,0,0.00649737631295415,4.95872544912316,0.730680036709129
8.7,"random_policy_SVM","SVM",96,25,1312,1307,5,2600,2181,419,0.935639332482642,0.648351648351648,1.77141642887499,798,389,409,2,1.1,66.46,5.2,0,0,0,0,0,0,0.00605244840381402,4.36032156053462,0.631378931289538
8.7,"random_policy_SVM","SVM",96,26,1212,1207,5,2700,2281,419,0.93683177025907,0.637362637362637,1.77141642887499,804,396,408,6,1,69.02,5.4,0,0,0,0,0,0,0.00463058362130956,3.11269737281398,0.520877987172458
8.7,"random_policy_SVM","SVM",96,27,1112,1110,2,2800,2378,422,0.937661830841105,0.631868131868132,1.76978679094594,814,400,414,10,1,71.57,5.6,0,0,0,0,0,0,0.00556807831808949,3.26552168787444,0.572242407093928
8.7,"random_policy_SVM","SVM",96,28,1012,1010,2,2900,2478,422,0.938354064199624,0.631868131868132,1.76491581812683,818,401,417,4,1,74.13,5.9,0,0,0,0,0,0,0.00385026756867388,2.06795513639436,0.436219928066602
8.7,"random_policy_SVM","SVM",96,29,912,910,2,3000,2578,422,0.938327737651314,0.626373626373626,1.76816014867485,817,401,416,-1,1,76.69,6.1,0,0,0,0,0,0,0.00348413320266155,1.62736395810613,0.362836948697044
8.7,"random_policy_SVM","SVM",96,30,812,810,2,3100,2678,422,0.938575516929528,0.626373626373626,1.7632981134356,828,405,423,11,1,79.24,6.3,0,0,0,0,0,0,0.00287198070734085,1.15695105832975,0.311852984568013
8.7,"random_policy_SVM","SVM",96,31,712,710,2,3200,2778,422,0.938860463099477,0.626373626373626,1.7632981134356,826,404,422,-2,1,81.8,6.6,0,0,0,0,0,0,0.00229936950324801,0.823445413822608,0.256351309697182
8.7,"random_policy_SVM","SVM",96,32,612,611,1,3300,2877,423,0.939538758873597,0.631868131868132,1.76653649380922,831,406,425,5,1,84.36,6.8,0,0,0,0,0,0,0.00207280733146339,0.697319316818072,0.241611658122171
8.7,"random_policy_SVM","SVM",96,33,512,511,1,3400,2977,423,0.939678134717593,0.631868131868132,1.76653649380922,833,408,425,2,1,86.91,7,0,0,0,0,0,0,0.00136872685489285,0.425265850778952,0.166616468952915
8.7,"random_policy_SVM","SVM",96,34,412,412,0,3500,3076,424,0.940012636743187,0.626373626373626,1.76816014867485,836,409,427,3,1,89.47,7.3,0,0,0,0,0,0,0.00110766930815946,0.319345159697191,0.134500259651726
8.7,"random_policy_SVM","SVM",96,35,312,312,0,3600,3176,424,0.940201568442828,0.626373626373626,1.76978679094594,836,410,426,0,1,92.02,7.5,0,0,0,0,0,0,0.000667610662511456,0.171581726165641,0.0856286555639322
8.7,"random_policy_SVM","SVM",96,36,212,212,0,3700,3276,424,0.940350236009759,0.626373626373626,1.76978679094594,838,412,426,2,1,94.58,7.7,0,0,0,0,0,0,0.000424627220550247,0.0851381642981562,0.0528265967029083
8.7,"random_policy_SVM","SVM",96,37,112,112,0,3800,3376,424,0.940605758390422,0.631868131868132,1.77141642887499,845,413,432,7,1,97.14,8,0,0,0,0,0,0,0.00019415656364835,0.0319283726276312,0.0298923365137707
8.7,"random_policy_SVM","SVM",96,38,12,12,0,3900,3476,424,0.940550008052824,0.631868131868132,1.77141642887499,844,413,431,-1,1,99.69,8.2,0,0,0,0,0,0,9.72065067892824e-05,0.00154117325347555,0.00154117325347555
8.7,"random_policy_SVM","SVM",96,39,0,0,0,3912,3488,424,0.940553105293801,0.631868131868132,1.77141642887499,845,413,432,1,1,100,8.2,0,0,0,0,0,0,0,0,0
8.7,"random_policy_SVM","SVM",97,0,3812,3412,400,100,92,8,0.819646981763023,0.44949494949495,1.58424801005446,26,8,18,0,2.2,2.56,11.5,0,0,0,0,0,0,0.401973299866205,349.744387489009,52.6301469661184
8.7,"random_policy_SVM","SVM",97,1,3712,3341,371,200,163,37,0.869384976040261,0.55050505050505,1.65708699902248,84,37,47,58,1.3,5.11,4.4,0,0,0,0,0,0,0.410101306272471,422.302328742285,47.1565983913757
8.7,"random_policy_SVM","SVM",97,2,3612,3325,287,300,179,121,0.874515921444249,0.535353535353535,1.70699643493761,128,63,65,44,1,7.67,1.5,0,0,0,0,0,0,0.615242988368652,301.000968584072,74.3448582640437
8.7,"random_policy_SVM","SVM",97,3,3512,3267,245,400,237,163,0.883286792843107,0.585858585858586,1.7208211143695,221,109,112,93,1,10.22,1.5,0,0,0,0,0,0,0.393735055126054,233.047862348574,58.497582596397
8.7,"random_policy_SVM","SVM",97,4,3412,3224,188,500,280,220,0.884280805782515,0.606060606060606,1.67529674626449,303,153,150,82,1,12.78,1.3,0,0,0,0,0,0,0.306369863547467,189.670062133007,46.5248597320944
8.7,"random_policy_SVM","SVM",97,5,3312,3174,138,600,330,270,0.854644281265444,0.626262626262626,1.56648057106352,382,192,190,79,1,15.34,1.2,0,0,0,0,0,0,0.192925098402341,143.467504601729,28.7312276602715
8.7,"random_policy_SVM","SVM",97,6,3212,3109,103,700,395,305,0.84852506866159,0.641414141414141,1.55549974886991,462,226,236,80,1,17.89,1.3,0,0,0,0,0,0,0.118196622897578,113.080423734299,16.1098749797686
8.7,"random_policy_SVM","SVM",97,7,3112,3028,84,800,476,324,0.841759460360144,0.651515151515151,1.54498062501742,512,246,266,50,1.1,20.45,1.5,0,0,0,0,0,0,0.0840696652740813,105.450468137936,12.092491848248
8.7,"random_policy_SVM","SVM",97,8,3012,2942,70,900,562,338,0.850852093172908,0.646464646464647,1.54356060606061,540,258,282,28,1.1,23.01,1.7,0,0,0,0,0,0,0.0651087946334648,97.1916440071848,8.44362845384484
8.7,"random_policy_SVM","SVM",97,9,2912,2856,56,1000,648,352,0.859125958102068,0.646464646464647,1.57514313643346,585,278,307,45,1.1,25.56,1.8,0,0,0,0,0,0,0.0657435705593331,106.156145397202,7.94379804291013
8.7,"random_policy_SVM","SVM",97,10,2812,2766,46,1100,738,362,0.869666517277441,0.646464646464647,1.59042123163558,607,291,316,22,1.1,28.12,2,0,0,0,0,0,0,0.0566881166723694,79.2480454208872,6.06514208747984
8.7,"random_policy_SVM","SVM",97,11,2712,2669,43,1200,835,365,0.896036588869366,0.646464646464647,1.64646464646465,637,312,325,30,1,30.67,2.3,0,0,0,0,0,0,0.0503152239916368,45.471396709294,6.25454403249982
8.7,"random_policy_SVM","SVM",97,12,2612,2574,38,1300,930,370,0.8965134852507,0.651515151515151,1.65854879065888,642,316,326,5,1,33.23,2.5,0,0,0,0,0,0,0.0408829738794101,42.1693802031705,4.56225171082893
8.7,"random_policy_SVM","SVM",97,13,2512,2481,31,1400,1023,377,0.906384665770327,0.651515151515151,1.67975713012478,659,321,338,17,1.1,35.79,2.7,0,0,0,0,0,0,0.0357644699221327,44.1117906255745,4.32427826544867
8.7,"random_policy_SVM","SVM",97,14,2412,2386,26,1500,1118,382,0.913839762815858,0.646464646464647,1.7085668088428,682,330,352,23,1.1,38.34,2.9,0,0,0,0,0,0,0.0517942170073794,47.2354876625797,6.09258717881457
8.7,"random_policy_SVM","SVM",97,15,2312,2288,24,1600,1216,384,0.916044690362089,0.646464646464647,1.7251559714795,690,337,353,8,1,40.9,3.2,0,0,0,0,0,0,0.0403779115817246,34.1196591195549,4.55392377574158
8.7,"random_policy_SVM","SVM",97,16,2212,2193,19,1700,1311,389,0.919064076487266,0.646464646464647,1.7647190133378,713,346,367,23,1.1,43.46,3.4,0,0,0,0,0,0,0.0470108571268377,34.1323766731181,5.36529408258323
8.7,"random_policy_SVM","SVM",97,17,2112,2099,13,1800,1405,395,0.919714781489506,0.641414141414141,1.76309553678459,723,350,373,10,1.1,46.01,3.6,0,0,0,0,0,0,0.0443223610402683,28.4511694969703,5.2704426152512
8.7,"random_policy_SVM","SVM",97,18,2012,2002,10,1900,1502,398,0.919246503717473,0.636363636363636,1.75078609789354,733,353,380,10,1.1,48.57,3.8,0,0,0,0,0,0,0.0339086740280012,22.8034813087995,4.10924491615011
8.7,"random_policy_SVM","SVM",97,19,1912,1905,7,2000,1599,401,0.918400443571073,0.636363636363636,1.75562252357832,736,356,380,3,1.1,51.12,4,0,0,0,0,0,0,0.0234050775085384,19.0113891396543,2.90077892055931
8.7,"random_policy_SVM","SVM",97,20,1812,1805,7,2100,1699,401,0.918567070017563,0.636363636363636,1.75562252357832,739,358,381,3,1.1,53.68,4.2,0,0,0,0,0,0,0.0185024484611395,15.7530892429151,2.05230953881487
8.7,"random_policy_SVM","SVM",97,21,1712,1705,7,2200,1799,401,0.918565633582681,0.636363636363636,1.75400741546096,739,358,381,0,1.1,56.24,4.5,0,0,0,0,0,0,0.0149562938017105,13.0076975193895,1.62551054995372
8.7,"random_policy_SVM","SVM",97,22,1612,1606,6,2300,1898,402,0.919028165615177,0.636363636363636,1.75562252357832,745,361,384,6,1.1,58.79,4.7,0,0,0,0,0,0,0.0136717282243713,11.0019555607798,1.39824133476974
8.7,"random_policy_SVM","SVM",97,23,1512,1507,5,2400,1997,403,0.92084381930797,0.646464646464647,1.76147504456328,761,371,390,16,1.1,61.35,5,0,0,0,0,0,0,0.0102033302979773,6.78211676267318,1.30256992181097
8.7,"random_policy_SVM","SVM",97,24,1412,1407,5,2500,2097,403,0.920802162696348,0.646464646464647,1.76147504456328,764,371,393,3,1.1,63.91,5.2,0,0,0,0,0,0,0.00735217703440006,5.25163043652559,0.816613714645295
8.7,"random_policy_SVM","SVM",97,25,1312,1308,4,2600,2196,404,0.921464359177658,0.641414141414141,1.76309553678459,772,375,397,8,1.1,66.46,5.4,0,0,0,0,0,0,0.00693363895712846,4.49337529306456,0.72136615759243
8.7,"random_policy_SVM","SVM",97,26,1212,1208,4,2700,2296,404,0.922057606784559,0.641414141414141,1.7647190133378,781,379,402,9,1.1,69.02,5.7,0,0,0,0,0,0,0.00561258396145115,3.27838853215573,0.598996544327661
8.7,"random_policy_SVM","SVM",97,27,1112,1108,4,2800,2396,404,0.922257271233371,0.646464646464647,1.76309553678459,784,381,403,3,1.1,71.57,5.9,0,0,0,0,0,0,0.00499318650975564,2.53517823402861,0.517061523109389
8.7,"random_policy_SVM","SVM",97,28,1012,1008,4,2900,2496,404,0.922176830879894,0.646464646464647,1.75663139182846,781,382,399,-3,1,74.13,6.2,0,0,0,0,0,0,0.00414363987007962,1.83792591299544,0.43592760959576
8.7,"random_policy_SVM","SVM",97,29,912,908,4,3000,2596,404,0.922426770549628,0.646464646464647,1.75985752845257,786,383,403,5,1.1,76.69,6.4,0,0,0,0,0,0,0.0034750380250748,1.32000872141625,0.368847105929599
8.7,"random_policy_SVM","SVM",97,30,812,808,4,3100,2696,404,0.922531630296126,0.646464646464647,1.75824298026133,786,383,403,0,1.1,79.24,6.7,0,0,0,0,0,0,0.00283288486291891,0.951080100539213,0.313365756994771
8.7,"random_policy_SVM","SVM",97,31,712,710,2,3200,2794,406,0.923202445386735,0.646464646464647,1.75663139182846,794,386,408,8,1.1,81.8,6.9,0,0,0,0,0,0,0.00252697321378371,0.864207741237753,0.304794089886381
8.7,"random_policy_SVM","SVM",97,32,612,610,2,3300,2894,406,0.923271394261144,0.646464646464647,1.75021447350214,798,386,412,4,1.1,84.36,7.1,0,0,0,0,0,0,0.00165276480085516,0.511117038574058,0.199328569364734
8.7,"random_policy_SVM","SVM",97,33,512,510,2,3400,2994,406,0.923381999747176,0.646464646464647,1.75502275502276,799,387,412,1,1.1,86.91,7.4,0,0,0,0,0,0,0.00103692483918268,0.322012255591573,0.134668526625774
8.7,"random_policy_SVM","SVM",97,34,412,412,0,3500,3092,408,0.923857459693626,0.646464646464647,1.77381550309727,806,391,415,7,1.1,89.47,7.6,0,0,0,0,0,0,0.000953636274248177,0.276028501722595,0.116897706563901
8.7,"random_policy_SVM","SVM",97,35,312,312,0,3600,3192,408,0.924331483205193,0.646464646464647,1.76730608840701,806,392,414,0,1.1,92.02,7.8,0,0,0,0,0,0,0.000650684801406123,0.161061582439081,0.0805962401651073
8.7,"random_policy_SVM","SVM",97,36,212,212,0,3700,3292,408,0.924794015237692,0.641414141414141,1.7689289590116,807,394,413,1,1,94.58,8.1,0,0,0,0,0,0,0.000356976467571896,0.0732753710468754,0.0461391244666104
8.7,"random_policy_SVM","SVM",97,37,112,112,0,3800,3392,408,0.925611346686425,0.641414141414141,1.77055481283422,807,395,412,0,1,97.14,8.3,0,0,0,0,0,0,0.000173690335081545,0.0284250092513411,0.0265896610810395
8.7,"random_policy_SVM","SVM",97,38,12,12,0,3900,3492,408,0.926167246986354,0.636363636363636,1.7689289590116,816,398,418,9,1.1,99.69,8.6,0,0,0,0,0,0,0.00012859705353231,0.00182498681172062,0.00182498681172062
8.7,"random_policy_SVM","SVM",97,39,0,0,0,3912,3504,408,0.926241941600298,0.636363636363636,1.7689289590116,816,398,418,0,1.1,100,8.6,0,0,0,0,0,0,0,0,0
8.7,"random_policy_SVM","SVM",98,0,3812,3394,418,100,90,10,0.911916558183037,0.539325842696629,1.76063070333354,25,10,15,0,1.5,2.56,9,0,0,0,0,0,0,0.663450197251427,384.11375887368,72.2488268248342
8.7,"random_policy_SVM","SVM",98,1,3712,3365,347,200,119,81,0.916224832850953,0.550561797752809,1.76063070333354,93,47,46,68,1,5.11,1.5,0,0,0,0,0,0,0.641750815408532,258.197518440572,73.5850824481554
8.7,"random_policy_SVM","SVM",98,2,3612,3327,285,300,157,143,0.91785050745061,0.561797752808989,1.76587117342991,163,85,78,70,0.9,7.67,1.1,0,0,0,0,0,0,0.579235891346711,274.493883466972,70.5660535306487
8.7,"random_policy_SVM","SVM",98,3,3512,3285,227,400,199,201,0.913256278358469,0.573033707865168,1.73027500155193,241,122,119,78,1,10.22,1,0,0,0,0,0,0,0.433872573091768,215.768754427174,61.8728482470122
8.7,"random_policy_SVM","SVM",98,4,3412,3235,177,500,249,251,0.903837160804329,0.584269662921348,1.73719431592862,319,162,157,78,1,12.78,1,0,0,0,0,0,0,0.191935067127878,102.341090773297,34.1535127748518
8.7,"random_policy_SVM","SVM",98,5,3312,3174,138,600,310,290,0.885940521479749,0.595505617977528,1.67110236628178,396,195,201,77,1,15.34,1.1,0,0,0,0,0,0,0.155042007477998,86.5948090061454,25.3470937188163
8.7,"random_policy_SVM","SVM",98,6,3212,3093,119,700,391,309,0.895647173316809,0.617977528089888,1.65944503072816,435,212,223,39,1.1,17.89,1.3,0,0,0,0,0,0,0.0728748003425009,46.3903558558085,10.4372669546473
8.7,"random_policy_SVM","SVM",98,7,3112,3020,92,800,464,336,0.887393991481396,0.634831460674157,1.64071868689484,498,237,261,63,1.1,20.45,1.4,0,0,0,0,0,0,0.0801116682517452,83.8060590248522,10.1894718798651
8.7,"random_policy_SVM","SVM",98,8,3012,2932,80,900,552,348,0.895520784621012,0.646067415730337,1.67110236628178,531,255,276,33,1.1,23.01,1.6,0,0,0,0,0,0,0.061943553530789,73.9820582039309,7.58158071653739
8.7,"random_policy_SVM","SVM",98,9,2912,2844,68,1000,640,360,0.901893934606485,0.646067415730337,1.67968216524924,561,269,292,30,1.1,25.56,1.8,0,0,0,0,0,0,0.0574307399788666,80.9426548285184,9.42580161101093
8.7,"random_policy_SVM","SVM",98,10,2812,2752,60,1100,732,368,0.914024089685413,0.634831460674157,1.71003786703085,581,278,303,20,1.1,28.12,2,0,0,0,0,0,0,0.0463440307421458,62.4889138366036,5.58256602838408
8.7,"random_policy_SVM","SVM",98,11,2712,2657,55,1200,827,373,0.917679882711292,0.640449438202247,1.71003786703085,590,281,309,9,1.1,30.67,2.2,0,0,0,0,0,0,0.039804641281081,57.3024038418937,4.34080565967045
8.7,"random_policy_SVM","SVM",98,12,2612,2563,49,1300,921,379,0.923244145043661,0.629213483146067,1.71699438202247,622,300,322,32,1.1,33.23,2.4,0,0,0,0,0,0,0.0345940599755509,47.9494669518558,3.84026913052367
8.7,"random_policy_SVM","SVM",98,13,2512,2468,44,1400,1016,384,0.927212750091624,0.623595505617977,1.72392536851871,639,314,325,17,1,35.79,2.6,0,0,0,0,0,0,0.0282622605572028,31.6428427079155,3.32458232895634
8.7,"random_policy_SVM","SVM",98,14,2412,2373,39,1500,1111,389,0.928759431756415,0.623595505617977,1.73027500155193,656,320,336,17,1.1,38.34,2.9,0,0,0,0,0,0,0.0317916764234593,39.4824190786284,3.48428519573638
8.7,"random_policy_SVM","SVM",98,15,2312,2277,35,1600,1207,393,0.933766003968602,0.612359550561798,1.73879247077308,672,324,348,16,1.1,40.9,3.1,0,0,0,0,0,0,0.0477726166314912,41.5355872433967,5.76622125807816
8.7,"random_policy_SVM","SVM",98,16,2212,2182,30,1700,1302,398,0.936368031243276,0.606741573033708,1.76101987899741,692,336,356,20,1.1,43.46,3.3,0,0,0,0,0,0,0.0524407017917579,37.1113871247277,5.84622685943979
8.7,"random_policy_SVM","SVM",98,17,2112,2086,26,1800,1398,402,0.936559194145665,0.612359550561798,1.7691202464261,706,343,363,14,1.1,46.01,3.5,0,0,0,0,0,0,0.0443475700786941,28.4906347093081,5.18399121430784
8.7,"random_policy_SVM","SVM",98,18,2012,1994,18,1900,1490,410,0.934969856296038,0.617977528089888,1.7622534044426,728,352,376,22,1.1,48.57,3.6,0,0,0,0,0,0,0.0427922981465358,27.0686708458234,5.21157869505906
8.7,"random_policy_SVM","SVM",98,19,1912,1900,12,2000,1584,416,0.934239961577825,0.617977528089888,1.75901098787509,745,359,386,17,1.1,51.12,3.8,0,0,0,0,0,0,0.029752602769667,24.0924269179522,4.33672148968482
8.7,"random_policy_SVM","SVM",98,20,1812,1803,9,2100,1681,419,0.934222583132153,0.612359550561798,1.75739424983477,754,363,391,9,1.1,53.68,4,0,0,0,0,0,0,0.0230853820888086,19.8046033615757,2.65224814531845
8.7,"random_policy_SVM","SVM",98,21,1712,1703,9,2200,1781,419,0.934119892316817,0.612359550561798,1.75416967322956,755,365,390,1,1.1,56.24,4.3,0,0,0,0,0,0,0.0161862453657794,13.7864140806967,1.69454354490062
8.7,"random_policy_SVM","SVM",98,22,1612,1603,9,2300,1881,419,0.932871803945844,0.606741573033708,1.76263401270868,764,370,394,9,1.1,58.79,4.5,0,0,0,0,0,0,0.0121292163488597,9.61964586428953,1.52959632773308
8.7,"random_policy_SVM","SVM",98,23,1512,1506,6,2400,1978,422,0.933353660848563,0.612359550561798,1.77074927059408,774,374,400,10,1.1,61.35,4.7,0,0,0,0,0,0,0.0115298018040355,8.62339925681903,1.18434567901638
8.7,"random_policy_SVM","SVM",98,24,1412,1406,6,2500,2078,422,0.931800659748981,0.606741573033708,1.76425110813318,788,386,402,14,1,63.91,4.9,0,0,0,0,0,0,0.00803746402420411,5.38888150017672,1.02793053189011
8.7,"random_policy_SVM","SVM",98,25,1312,1306,6,2600,2178,422,0.93195548590133,0.606741573033708,1.76425110813318,788,385,403,0,1,66.46,5.2,0,0,0,0,0,0,0.00636717826045718,4.2204388590554,0.688864955114992
8.7,"random_policy_SVM","SVM",98,26,1212,1207,5,2700,2277,423,0.932434183086654,0.606741573033708,1.76749421678784,790,388,402,2,1,69.02,5.4,0,0,0,0,0,0,0.00607004063668483,3.54652045569106,0.62198370307402
8.7,"random_policy_SVM","SVM",98,27,1112,1108,4,2800,2376,424,0.933089824446093,0.601123595505618,1.76587117342991,802,393,409,12,1,71.57,5.6,0,0,0,0,0,0,0.00562374728863315,3.04900949814594,0.610586510658615
8.7,"random_policy_SVM","SVM",98,28,1012,1009,3,2900,2475,425,0.933051907837355,0.606741573033708,1.76587117342991,804,394,410,2,1,74.13,5.8,0,0,0,0,0,0,0.00505555996869764,2.38998769590757,0.523627192442627
8.7,"random_policy_SVM","SVM",98,29,912,909,3,3000,2575,425,0.933066126565632,0.601123595505618,1.76749421678784,806,397,409,2,1,76.69,6.1,0,0,0,0,0,0,0.00428326688946488,1.75770492684397,0.45543315255924
8.7,"random_policy_SVM","SVM",98,30,812,810,2,3100,2674,426,0.933141959783108,0.601123595505618,1.76425110813318,811,399,412,5,1,79.24,6.3,0,0,0,0,0,0,0.00349112369581976,1.29490833441254,0.381194668624622
8.7,"random_policy_SVM","SVM",98,31,712,711,1,3200,2773,427,0.933415275337764,0.601123595505618,1.7691202464261,815,402,413,4,1,81.8,6.5,0,0,0,0,0,0,0.00317610665349693,1.11029639025231,0.357070961106639
8.7,"random_policy_SVM","SVM",98,32,612,611,1,3300,2873,427,0.933617497251035,0.601123595505618,1.76749421678784,812,400,412,-3,1,84.36,6.7,0,0,0,0,0,0,0.00220076188017567,0.686583058315059,0.257997132061688
8.7,"random_policy_SVM","SVM",98,33,512,511,1,3400,2973,427,0.933762844251199,0.595505617977528,1.77238129757158,811,400,411,-1,1,86.91,7,0,0,0,0,0,0,0.00144850267014695,0.452481324460399,0.185347508975092
8.7,"random_policy_SVM","SVM",98,34,412,412,0,3500,3072,428,0.934386888436684,0.595505617977528,1.76749421678784,820,404,416,9,1,89.47,7.2,0,0,0,0,0,0,0.000999886030011232,0.289730401418641,0.126260535812533
8.7,"random_policy_SVM","SVM",98,35,312,312,0,3600,3172,428,0.935042529796118,0.595505617977528,1.7691202464261,824,405,419,4,1,92.02,7.4,0,0,0,0,0,0,0.00059143615773655,0.154634328093855,0.077928697630109
8.7,"random_policy_SVM","SVM",98,36,212,212,0,3700,3272,428,0.935440654187868,0.589887640449438,1.7691202464261,829,408,421,5,1,94.58,7.6,0,0,0,0,0,0,0.000362303311409689,0.0767618840932999,0.0476861754468767
8.7,"random_policy_SVM","SVM",98,37,112,112,0,3800,3372,428,0.935627077514165,0.595505617977528,1.7691202464261,830,410,420,1,1,97.14,7.9,0,0,0,0,0,0,0.000166596675163813,0.0266895961456041,0.0249876626555283
8.7,"random_policy_SVM","SVM",98,38,12,12,0,3900,3472,428,0.935712389883827,0.595505617977528,1.76587117342991,831,411,420,1,1,99.69,8.1,0,0,0,0,0,0,0.000133869348301022,0.00183832302928191,0.00183832302928191
8.7,"random_policy_SVM","SVM",98,39,0,0,0,3912,3484,428,0.935608119209796,0.595505617977528,1.76587117342991,833,412,421,2,1,100,8.1,0,0,0,0,0,0,0,0,0
8.7,"random_policy_SVM","SVM",99,0,3812,3399,413,100,88,12,0.916414286825929,0.513812154696133,1.79449541284404,28,12,16,0,1.3,2.56,7.3,0,0,0,0,0,0,0.859865226713408,592.376844457125,89.1951503714325
8.7,"random_policy_SVM","SVM",99,1,3712,3354,358,200,133,67,0.898222706404179,0.530386740331492,1.75135069137084,91,45,46,63,1,5.11,2,0,0,0,0,0,0,0.79567038839714,359.321051483396,85.0659424680445
8.7,"random_policy_SVM","SVM",99,2,3612,3311,301,300,176,124,0.894339740098065,0.552486187845304,1.71312472948545,161,82,79,70,1,7.67,1.4,0,0,0,0,0,0,0.698587863498251,303.362097218592,79.0951207105067
8.7,"random_policy_SVM","SVM",99,3,3512,3270,242,400,217,183,0.885166913080692,0.546961325966851,1.69164555416501,229,112,117,68,1,10.22,1.2,0,0,0,0,0,0,0.61031195475864,214.58910161576,73.752127038965
8.7,"random_policy_SVM","SVM",99,4,3412,3219,193,500,268,232,0.906015096101484,0.552486187845304,1.74139983516987,304,152,152,75,1,12.78,1.2,0,0,0,0,0,0,0.248765837966591,122.705059817776,52.6673164770181
8.7,"random_policy_SVM","SVM",99,5,3312,3175,137,600,312,288,0.885920161855105,0.585635359116022,1.66026419716692,383,191,192,79,1,15.34,1.1,0,0,0,0,0,0,0.159535785628577,105.696090390564,26.0155078976234
8.7,"random_policy_SVM","SVM",99,6,3212,3103,109,700,384,316,0.890041241926702,0.596685082872928,1.66332459200041,438,211,227,55,1.1,17.89,1.2,0,0,0,0,0,0,0.0880189064360622,73.8106300623193,12.5155183336524
8.7,"random_policy_SVM","SVM",99,7,3112,3025,87,800,462,338,0.89370321375769,0.607734806629834,1.64880565485863,483,236,247,45,1,20.45,1.4,0,0,0,0,0,0,0.0658442669523778,72.6991676147413,9.30758158990157
8.7,"random_policy_SVM","SVM",99,8,3012,2944,68,900,543,357,0.887898218037516,0.61878453038674,1.63586598408434,531,256,275,48,1.1,23.01,1.5,0,0,0,0,0,0,0.0591909598007715,74.9462703818332,7.47230143547562
8.7,"random_policy_SVM","SVM",99,9,2912,2856,56,1000,631,369,0.883794257256256,0.613259668508287,1.64038079360803,571,276,295,40,1.1,25.56,1.7,0,0,0,0,0,0,0.053849233004592,74.5253796725427,6.76027192374438
8.7,"random_policy_SVM","SVM",99,10,2812,2760,52,1100,727,373,0.886816590148638,0.61878453038674,1.65032249538748,588,281,307,17,1.1,28.12,1.9,0,0,0,0,0,0,0.0457094708776926,63.4831830399324,4.91160680211128
8.7,"random_policy_SVM","SVM",99,11,2712,2665,47,1200,822,378,0.903048789977437,0.613259668508287,1.66026419716692,608,293,315,20,1.1,30.67,2.2,0,0,0,0,0,0,0.035583521188976,44.3921278978302,4.28082087913136
8.7,"random_policy_SVM","SVM",99,12,2612,2574,38,1300,913,387,0.911228698155799,0.61878453038674,1.68014760072581,630,306,324,22,1.1,33.23,2.4,0,0,0,0,0,0,0.0374442218644425,52.8680094641355,4.64879091574678
8.7,"random_policy_SVM","SVM",99,13,2512,2479,33,1400,1008,392,0.918485720955583,0.613259668508287,1.73183170420739,655,317,338,25,1.1,35.79,2.6,0,0,0,0,0,0,0.0422508346077541,49.8528968986546,5.03210307241558
8.7,"random_policy_SVM","SVM",99,14,2412,2384,28,1500,1103,397,0.923364718698948,0.607734806629834,1.75968121496135,670,325,345,15,1.1,38.34,2.8,0,0,0,0,0,0,0.0439571051210485,41.4356822511042,5.02033070833763
8.7,"random_policy_SVM","SVM",99,15,2312,2286,26,1600,1201,399,0.92413975566105,0.602209944751381,1.75644947719282,677,327,350,7,1.1,40.9,3,0,0,0,0,0,0,0.0355383292362437,31.7463905076566,3.96602480954307
8.7,"random_policy_SVM","SVM",99,16,2212,2189,23,1700,1298,402,0.924451015485188,0.607734806629834,1.75968121496135,684,331,353,7,1.1,43.46,3.2,0,0,0,0,0,0,0.0342289305061413,28.3906962014567,4.00637362028651
8.7,"random_policy_SVM","SVM",99,17,2112,2095,17,1800,1392,408,0.923977900552498,0.602209944751381,1.76130154757181,708,343,365,24,1.1,46.01,3.4,0,0,0,0,0,0,0.0326062553376271,25.7633645423632,4.17570974422984
8.7,"random_policy_SVM","SVM",99,18,2012,2002,10,1900,1485,415,0.922636370710471,0.602209944751381,1.73819873253169,726,353,373,18,1.1,48.57,3.6,0,0,0,0,0,0,0.0254817417512273,24.422445130104,3.50724176618812
8.7,"random_policy_SVM","SVM",99,19,1912,1904,8,2000,1583,417,0.922402925842367,0.602209944751381,1.73819873253169,734,356,378,8,1.1,51.12,3.8,0,0,0,0,0,0,0.0202152966413298,20.2391526899532,2.24483748769363
8.7,"random_policy_SVM","SVM",99,20,1812,1804,8,2100,1683,417,0.923191969496555,0.602209944751381,1.74813129671758,736,355,381,2,1.1,53.68,4,0,0,0,0,0,0,0.0166365003859979,16.9234069770367,1.80327516756174
8.7,"random_policy_SVM","SVM",99,21,1712,1705,7,2200,1782,418,0.923781806863296,0.602209944751381,1.75968121496135,743,360,383,7,1.1,56.24,4.3,0,0,0,0,0,0,0.016047723934031,15.0011967027618,1.61968616402189
8.7,"random_policy_SVM","SVM",99,22,1612,1605,7,2300,1882,418,0.924746712318115,0.580110497237569,1.76130154757181,754,368,386,11,1,58.79,4.5,0,0,0,0,0,0,0.0102255156222383,7.14256961249786,1.3157880319786
8.7,"random_policy_SVM","SVM",99,23,1512,1506,6,2400,1981,419,0.924924130417875,0.580110497237569,1.76130154757181,755,369,386,1,1,61.35,4.7,0,0,0,0,0,0,0.00789103430178773,6.03057414479428,0.903405312477066
8.7,"random_policy_SVM","SVM",99,24,1412,1406,6,2500,2081,419,0.924896117033702,0.580110497237569,1.76130154757181,755,369,386,0,1,63.91,5,0,0,0,0,0,0,0.0068701515266406,5.18068716220662,0.73424545793583
8.7,"random_policy_SVM","SVM",99,25,1312,1306,6,2600,2181,419,0.925057972142254,0.580110497237569,1.75968121496135,755,369,386,0,1,66.46,5.2,0,0,0,0,0,0,0.00649085646150016,4.44160611251027,0.663820428861953
8.7,"random_policy_SVM","SVM",99,26,1212,1208,4,2700,2279,421,0.926741887790841,0.585635359116022,1.76637292056679,776,378,398,21,1.1,69.02,5.4,0,0,0,0,0,0,0.00642537185533977,4.10765519333904,0.682120991534041
8.7,"random_policy_SVM","SVM",99,27,1112,1108,4,2800,2379,421,0.92689907400203,0.580110497237569,1.76799642508937,780,381,399,4,1,71.57,5.7,0,0,0,0,0,0,0.00455241356973297,2.45151592191661,0.468744376816946
8.7,"random_policy_SVM","SVM",99,28,1012,1008,4,2900,2479,421,0.926692086218978,0.574585635359116,1.77125240377278,782,383,399,2,1,74.13,5.9,0,0,0,0,0,0,0.00412089206493788,1.93891728043408,0.432093183575
8.7,"random_policy_SVM","SVM",99,29,912,908,4,3000,2579,421,0.926936425180926,0.574585635359116,1.77125240377278,784,383,401,2,1,76.69,6.1,0,0,0,0,0,0,0.00321145809309403,1.2677498963404,0.338652972810842
8.7,"random_policy_SVM","SVM",99,30,812,809,3,3100,2678,422,0.927271029491874,0.574585635359116,1.77125240377278,791,386,405,7,1,79.24,6.3,0,0,0,0,0,0,0.00320386116900087,1.10910425258331,0.347485572835721
8.7,"random_policy_SVM","SVM",99,31,712,709,3,3200,2778,422,0.927096723990356,0.580110497237569,1.77125240377278,793,388,405,2,1,81.8,6.6,0,0,0,0,0,0,0.00206099666948835,0.64686103338749,0.247473504042851
8.7,"random_policy_SVM","SVM",99,32,612,609,3,3300,2878,422,0.927379970430321,0.574585635359116,1.7728848944675,791,387,404,-2,1,84.36,6.8,0,0,0,0,0,0,0.00131785732718172,0.425909808080512,0.171763823936129
8.7,"random_policy_SVM","SVM",99,33,512,509,3,3400,2978,422,0.927722356236872,0.580110497237569,1.7728848944675,792,388,404,1,1,86.91,7.1,0,0,0,0,0,0,0.00072986636427918,0.219114135059391,0.0945779758246164
8.7,"random_policy_SVM","SVM",99,34,412,411,1,3500,3076,424,0.929409384483701,0.574585635359116,1.77956461852023,804,395,409,12,1,89.47,7.3,0,0,0,0,0,0,0.000760910074532284,0.230857958061368,0.0960165868397053
8.7,"random_policy_SVM","SVM",99,35,312,312,0,3600,3175,425,0.930240448214149,0.574585635359116,1.77956461852023,809,397,412,5,1,92.02,7.5,0,0,0,0,0,0,0.000742672991010154,0.191851661852642,0.0893363129097931
8.7,"random_policy_SVM","SVM",99,36,212,212,0,3700,3275,425,0.930450548595442,0.574585635359116,1.77792898927527,811,397,414,2,1,94.58,7.7,0,0,0,0,0,0,0.000402064402794216,0.081493461385,0.0495808577321
8.7,"random_policy_SVM","SVM",99,37,112,112,0,3800,3375,425,0.930645085985527,0.574585635359116,1.78284492196451,820,401,419,9,1,97.14,7.9,0,0,0,0,0,0,0.000205681752479162,0.0318064725894803,0.029642538747358
8.7,"random_policy_SVM","SVM",99,38,12,12,0,3900,3475,425,0.930783596607268,0.574585635359116,1.77792898927527,820,403,417,0,1,99.69,8.2,0,0,0,0,0,0,0.000130490281681044,0.00180818338368247,0.00180818338368247
8.7,"random_policy_SVM","SVM",99,39,0,0,0,3912,3487,425,0.930903431639561,0.574585635359116,1.77956461852023,820,403,417,0,1,100,8.2,0,0,0,0,0,0,0,0,0
8.7,"random_policy_SVM","SVM",100,0,3812,3428,384,100,91,9,0.827678251571006,0.300469483568075,1.65888232621536,33,9,24,0,2.7,2.56,10.1,0,0,0,0,0,0,0.178122064453556,321.136991135032,27.9968177392736
8.7,"random_policy_SVM","SVM",100,1,3712,3350,362,200,169,31,0.910049318669719,0.563380281690141,1.75398026358334,69,31,38,36,1.2,5.11,5.5,0,0,0,0,0,0,0.615598385270227,330.724784287844,72.4127719828711
8.7,"random_policy_SVM","SVM",100,2,3612,3306,306,300,213,87,0.924536509552634,0.68075117370892,1.71339063794532,153,76,77,84,1,7.67,2.4,0,0,0,0,0,0,0.690110609565183,359.653972389258,75.8093121860424
8.7,"random_policy_SVM","SVM",100,3,3512,3251,261,400,268,132,0.90520229812611,0.68075117370892,1.66274855012427,245,120,125,92,1,10.22,2,0,0,0,0,0,0,0.517763171264396,223.093970540705,64.4515864114882
8.7,"random_policy_SVM","SVM",100,4,3412,3221,191,500,298,202,0.918494905174022,0.685446009389671,1.71339063794532,318,158,160,73,1,12.78,1.5,0,0,0,0,0,0,0.346175550109483,170.887999516857,55.792612371025
8.7,"random_policy_SVM","SVM",100,5,3312,3176,136,600,343,257,0.924949967542884,0.713615023474178,1.70182194081923,395,197,198,77,1,15.34,1.3,0,0,0,0,0,0,0.247522818054286,131.445423370097,37.2085348195375
8.7,"random_policy_SVM","SVM",100,6,3212,3108,104,700,411,289,0.895005912314579,0.685446009389671,1.65583010482398,473,235,238,78,1,17.89,1.4,0,0,0,0,0,0,0.122695654786587,82.6165272798231,19.5854666633036
8.7,"random_policy_SVM","SVM",100,7,3112,3028,84,800,491,309,0.895660441901752,0.704225352112676,1.6573548102612,523,256,267,50,1,20.45,1.6,0,0,0,0,0,0,0.0693436774620527,64.963458604995,9.59568301805093
8.7,"random_policy_SVM","SVM",100,8,3012,2939,73,900,580,320,0.897376225222825,0.704225352112676,1.6573548102612,554,267,287,31,1.1,23.01,1.8,0,0,0,0,0,0,0.0487228443976572,47.9329530024694,5.85091334718934
8.7,"random_policy_SVM","SVM",100,9,2912,2855,57,1000,664,336,0.90437134183952,0.704225352112676,1.6696542893726,593,287,306,39,1.1,25.56,2,0,0,0,0,0,0,0.0491922173835088,67.7432036366464,5.75767230773338
8.7,"random_policy_SVM","SVM",100,10,2812,2759,53,1100,760,340,0.909534853027125,0.708920187793427,1.6696542893726,606,293,313,13,1.1,28.12,2.2,0,0,0,0,0,0,0.0430109024711483,62.2016960061186,4.64297116607032
8.7,"random_policy_SVM","SVM",100,11,2712,2664,48,1200,855,345,0.919737972682146,0.694835680751174,1.66812249644657,628,307,321,22,1,30.67,2.5,0,0,0,0,0,0,0.0374978536410723,44.0284240224077,4.67005422565668
8.7,"random_policy_SVM","SVM",100,12,2612,2573,39,1300,946,354,0.926170139983134,0.694835680751174,1.69807066872255,654,318,336,26,1.1,33.23,2.7,0,0,0,0,0,0,0.0495168521846433,52.9220728743813,5.92680759283702
8.7,"random_policy_SVM","SVM",100,13,2512,2482,30,1400,1037,363,0.931507384332768,0.694835680751174,1.75559237779619,685,331,354,31,1.1,35.79,2.9,0,0,0,0,0,0,0.067674879568715,59.5983003577916,8.00946629242655
8.7,"random_policy_SVM","SVM",100,14,2412,2385,27,1500,1134,366,0.932322179394973,0.685446009389671,1.76044655026936,698,338,360,13,1.1,38.34,3.1,0,0,0,0,0,0,0.0564170543583388,44.0566173345033,6.09980648429964
8.7,"random_policy_SVM","SVM",100,15,2312,2289,23,1600,1230,370,0.932925531771621,0.685446009389671,1.75398026358334,710,345,365,12,1.1,40.9,3.3,0,0,0,0,0,0,0.0423615887462021,31.7457210075841,4.80319745290786
8.7,"random_policy_SVM","SVM",100,16,2212,2194,18,1700,1325,375,0.933834600642676,0.685446009389671,1.75559237779619,722,350,372,12,1.1,43.46,3.5,0,0,0,0,0,0,0.0400916384305253,28.3759924374219,4.6951843806133
8.7,"random_policy_SVM","SVM",100,17,2112,2102,10,1800,1417,383,0.933577367821383,0.694835680751174,1.75720745818055,745,361,384,23,1.1,46.01,3.7,0,0,0,0,0,0,0.032573309641497,25.8362082129974,4.47077297936398
8.7,"random_policy_SVM","SVM",100,18,2012,2004,8,1900,1515,385,0.933768608976479,0.694835680751174,1.75559237779619,747,363,384,2,1.1,48.57,3.9,0,0,0,0,0,0,0.0237199368958958,21.884321010823,2.84879189445702
8.7,"random_policy_SVM","SVM",100,19,1912,1904,8,2000,1615,385,0.9337551412895,0.694835680751174,1.75882551293025,747,363,384,0,1.1,51.12,4.2,0,0,0,0,0,0,0.0208242314191779,18.6638190683197,2.14470588210342
8.7,"random_policy_SVM","SVM",100,20,1812,1804,8,2100,1715,385,0.933461545713365,0.694835680751174,1.75882551293025,767,368,399,20,1.1,53.68,4.5,0,0,0,0,0,0,0.0144946519283301,11.4750468509526,1.80816961264199
8.7,"random_policy_SVM","SVM",100,21,1712,1706,6,2200,1813,387,0.933573327515289,0.694835680751174,1.75882551293025,770,371,399,3,1.1,56.24,4.7,0,0,0,0,0,0,0.0118252298122806,9.37657513903686,1.24306246065039
8.7,"random_policy_SVM","SVM",100,22,1612,1607,5,2300,1912,388,0.934195534653706,0.694835680751174,1.75882551293025,777,377,400,7,1.1,58.79,4.9,0,0,0,0,0,0,0.00823498968050487,6.26480494278324,0.977957602343326
8.7,"random_policy_SVM","SVM",100,23,1512,1508,4,2400,2011,389,0.934140317137096,0.694835680751174,1.76044655026936,780,378,402,3,1.1,61.35,5.2,0,0,0,0,0,0,0.00828681601225103,5.97851860440209,0.868401555508222
8.7,"random_policy_SVM","SVM",100,24,1412,1408,4,2500,2111,389,0.934627847405723,0.694835680751174,1.75559237779619,782,381,401,2,1.1,63.91,5.4,0,0,0,0,0,0,0.00605808433611489,4.13645039299784,0.670532497889575
8.7,"random_policy_SVM","SVM",100,25,1312,1309,3,2600,2210,390,0.934607645875255,0.694835680751174,1.75882551293025,786,382,404,4,1.1,66.46,5.7,0,0,0,0,0,0,0.00522040516471735,3.25942933843853,0.548814038229223
8.7,"random_policy_SVM","SVM",100,26,1212,1209,3,2700,2310,390,0.934816395023426,0.694835680751174,1.75398026358334,785,384,401,-1,1,69.02,5.9,0,0,0,0,0,0,0.00489208619757107,2.83478101129244,0.522456179704003
8.7,"random_policy_SVM","SVM",100,27,1112,1110,2,2800,2409,391,0.935019757096801,0.699530516431925,1.75559237779619,789,385,404,4,1,71.57,6.2,0,0,0,0,0,0,0.00409291698300843,2.11920751739622,0.432156878387707
8.7,"random_policy_SVM","SVM",100,28,1012,1010,2,2900,2509,391,0.935182716109243,0.694835680751174,1.75720745818055,791,387,404,2,1,74.13,6.4,0,0,0,0,0,0,0.0032363185513387,1.46837567679247,0.348436873722251
8.7,"random_policy_SVM","SVM",100,29,912,910,2,3000,2609,391,0.935198877333618,0.694835680751174,1.75882551293025,792,387,405,1,1,76.69,6.7,0,0,0,0,0,0,0.00261165124612254,1.063874353336,0.286491822020316
8.7,"random_policy_SVM","SVM",100,30,812,810,2,3100,2709,391,0.935287764067677,0.694835680751174,1.75882551293025,790,387,403,-2,1,79.24,6.9,0,0,0,0,0,0,0.0022498087301474,0.820699346254004,0.25251623890946
8.7,"random_policy_SVM","SVM",100,31,712,711,1,3200,2808,392,0.935589440255994,0.699530516431925,1.75076490104698,793,388,405,3,1,81.8,7.2,0,0,0,0,0,0,0.0016007292356962,0.530310325353204,0.183521664010783
8.7,"random_policy_SVM","SVM",100,32,612,611,1,3300,2908,392,0.935745665424945,0.694835680751174,1.75237110737821,797,389,408,4,1,84.36,7.4,0,0,0,0,0,0,0.00128948033696127,0.408880792212795,0.158325558644787
8.7,"random_policy_SVM","SVM",100,33,512,511,1,3400,3008,392,0.935901890593897,0.694835680751174,1.75559237779619,800,390,410,3,1.1,86.91,7.7,0,0,0,0,0,0,0.000691647368968681,0.210221990755671,0.0892191564797022
8.7,"random_policy_SVM","SVM",100,34,412,412,0,3500,3107,393,0.936283026135389,0.694835680751174,1.75559237779619,800,391,409,0,1,89.47,7.9,0,0,0,0,0,0,0.000447699981887911,0.124998480327772,0.0568143106469961
8.7,"random_policy_SVM","SVM",100,35,312,312,0,3600,3207,393,0.93644733191653,0.685446009389671,1.75559237779619,804,392,412,4,1.1,92.02,8.2,0,0,0,0,0,0,0.00041168472779332,0.100447165994086,0.051869553063417
8.7,"random_policy_SVM","SVM",100,36,212,212,0,3700,3307,393,0.936703217969126,0.68075117370892,1.75559237779619,806,393,413,2,1.1,94.58,8.4,0,0,0,0,0,0,9.37126533815085e-05,0.0197213239115512,0.0130378641480862
8.7,"random_policy_SVM","SVM",100,37,112,112,0,3800,3407,393,0.937019708613124,0.671361502347418,1.76044655026936,807,393,414,1,1.1,97.14,8.7,0,0,0,0,0,0,3.97253112993012e-05,0.00810480332145825,0.00766918143002258
8.7,"random_policy_SVM","SVM",100,38,12,12,0,3900,3507,393,0.937138224258535,0.666666666666667,1.75882551293025,806,393,413,-1,1.1,99.69,8.9,0,0,0,0,0,0,1.7760914189801e-05,0.000272282073658208,0.000272282073658208
8.7,"random_policy_SVM","SVM",100,39,0,0,0,3912,3519,393,0.937111288884578,0.666666666666667,1.75237110737821,805,393,412,-1,1,100,9,0,0,0,0,0,0,0,0,0
8.7,"max_tuv_SVM","SVM",1,0,3812,3438,374,100,92,8,0.891300313427912,0.540178571428571,1.76398863933142,23,8,15,0,1.9,2.56,11.5,0,0,0,0,0,0,0.649057055194634,442.015649889589,76.7469440673465
8.7,"max_tuv_SVM","SVM",1,1,3712,3397,315,200,133,67,0.90757742906632,0.580357142857143,1.73199527744982,98,49,49,75,1,5.11,2,0,0,0,0,0,0,0.788637673984353,494.501111171059,83.3373445902054
8.7,"max_tuv_SVM","SVM",1,2,3612,3327,285,300,203,97,0.922585110112187,0.633928571428571,1.77371651785714,188,89,99,90,1.1,7.67,2.1,0,0,0,0,0,0,0.786041120024943,374.137431021266,84.6580098933683
8.7,"max_tuv_SVM","SVM",1,3,3512,3256,256,400,274,126,0.916547241009577,0.660714285714286,1.73358718487395,259,126,133,71,1.1,10.22,2.2,0,0,0,0,0,0,0.738773459419621,318.304203222843,82.9974973946118
8.7,"max_tuv_SVM","SVM",1,4,3412,3205,207,500,325,175,0.920899404074564,0.660714285714286,1.74642857142857,355,171,184,96,1.1,12.78,1.9,0,0,0,0,0,0,0.63639699721835,306.535719525029,75.7200142019906
8.7,"max_tuv_SVM","SVM",1,5,3312,3148,164,600,382,218,0.905298890630163,0.65625,1.6613543855042,439,212,227,84,1.1,15.34,1.8,0,0,0,0,0,0,0.277021993213502,282.735175323651,71.1556396340039
8.7,"max_tuv_SVM","SVM",1,6,3212,3088,124,700,442,258,0.885627165127023,0.669642857142857,1.61468326981206,506,242,264,67,1.1,17.89,1.7,0,0,0,0,0,0,0.133517500681595,182.22461547949,51.332234534686
8.7,"max_tuv_SVM","SVM",1,7,3112,3020,92,800,510,290,0.880067428241511,0.678571428571429,1.59714745273109,535,255,280,29,1.1,20.45,1.8,0,0,0,0,0,0,0.0837725018505349,134.239613101184,33.854899205233
8.7,"max_tuv_SVM","SVM",1,8,3012,2938,74,900,592,308,0.879817407621254,0.6875,1.59058351951636,564,268,296,29,1.1,23.01,1.9,0,0,0,0,0,0,0.0655750934775942,114.660776717221,24.1369248149519
8.7,"max_tuv_SVM","SVM",1,9,2912,2848,64,1000,682,318,0.891658590399218,0.678571428571429,1.64029202841358,577,275,302,13,1.1,25.56,2.1,0,0,0,0,0,0,0.0534827150213403,94.9389039618762,19.4189647800912
8.7,"max_tuv_SVM","SVM",1,10,2812,2765,47,1100,765,335,0.925701346502827,0.678571428571429,1.76090173638516,616,297,319,39,1.1,28.12,2.3,0,0,0,0,0,0,0.0579258396537696,68.548281806808,12.6125839457671
8.7,"max_tuv_SVM","SVM",1,11,2712,2678,34,1200,852,348,0.921630134444105,0.674107142857143,1.74642857142857,635,307,328,19,1.1,30.67,2.4,0,0,0,0,0,0,0.0873730735010219,73.0720783953494,10.8385400341259
8.7,"max_tuv_SVM","SVM",1,12,2612,2579,33,1300,951,349,0.923235936984513,0.674107142857143,1.76731502168485,640,311,329,5,1.1,33.23,2.7,0,0,0,0,0,0,0.0651467494151525,54.6961515712671,8.18124202892134
8.7,"max_tuv_SVM","SVM",1,13,2512,2481,31,1400,1049,351,0.922380196304869,0.669642857142857,1.77057274522712,650,316,334,10,1.1,35.79,3,0,0,0,0,0,0,0.053474519660177,39.392253901059,6.74588811526855
8.7,"max_tuv_SVM","SVM",1,14,2412,2388,24,1500,1142,358,0.922350554684947,0.665178571428571,1.7656906512605,673,325,348,23,1.1,38.34,3.2,0,0,0,0,0,0,0.0544997467972111,34.8871735078099,7.09903340694129
8.7,"max_tuv_SVM","SVM",1,15,2312,2294,18,1600,1236,364,0.921354338502172,0.665178571428571,1.74001377410468,687,330,357,14,1.1,40.9,3.4,0,0,0,0,0,0,0.0420003431617047,28.901668036688,6.11052662822276
8.7,"max_tuv_SVM","SVM",1,16,2212,2198,14,1700,1332,368,0.921019259320378,0.660714285714286,1.74161305147059,703,334,369,16,1.1,43.46,3.6,0,0,0,0,0,0,0.0286840493336705,23.7807548162906,4.40147682085053
8.7,"max_tuv_SVM","SVM",1,17,2112,2100,12,1800,1430,370,0.920802746618297,0.665178571428571,1.74642857142857,703,334,369,0,1.1,46.01,3.9,0,0,0,0,0,0,0.0219672197954517,19.373624214094,2.46510728286815
8.7,"max_tuv_SVM","SVM",1,18,2012,2001,11,1900,1529,371,0.921325985648318,0.660714285714286,1.74001377410468,706,337,369,3,1.1,48.57,4.1,0,0,0,0,0,0,0.0175558300967714,15.7455943849729,1.94050617314116
8.7,"max_tuv_SVM","SVM",1,19,1912,1904,8,2000,1626,374,0.922372463708367,0.660714285714286,1.74482044198895,721,345,376,15,1.1,51.12,4.3,0,0,0,0,0,0,0.0161548443426756,15.1484302642686,1.7672907316331
8.7,"max_tuv_SVM","SVM",1,20,1812,1805,7,2100,1725,375,0.921828604420999,0.660714285714286,1.74321527138914,725,346,379,4,1.1,53.68,4.6,0,0,0,0,0,0,0.0151756463764607,12.7184504565969,1.53267063690887
8.7,"max_tuv_SVM","SVM",1,21,1712,1705,7,2200,1825,375,0.922404682860462,0.647321428571429,1.76894238358327,739,359,380,14,1.1,56.24,4.9,0,0,0,0,0,0,0.0106067252994908,7.43898521647337,1.39281997904256
8.7,"max_tuv_SVM","SVM",1,22,1612,1606,6,2300,1924,376,0.922540003299261,0.651785714285714,1.7656906512605,741,360,381,2,1.1,58.79,5.1,0,0,0,0,0,0,0.00742268971198341,5.7165517597731,0.851669314814813
8.7,"max_tuv_SVM","SVM",1,23,1512,1507,5,2400,2023,377,0.92248845265591,0.65625,1.7656906512605,744,360,384,3,1.1,61.35,5.4,0,0,0,0,0,0,0.0078517884666261,5.41039580895381,0.807907571313328
8.7,"max_tuv_SVM","SVM",1,24,1412,1407,5,2500,2123,377,0.92267919003631,0.65625,1.77057274522712,748,366,382,4,1,63.91,5.6,0,0,0,0,0,0,0.00550904024454736,3.43228515779788,0.642529636575947
8.7,"max_tuv_SVM","SVM",1,25,1312,1308,4,2600,2222,378,0.922889258907969,0.65625,1.76894238358327,753,367,386,5,1.1,66.46,5.9,0,0,0,0,0,0,0.00507048642027388,3.01446249626337,0.528493025291736
8.7,"max_tuv_SVM","SVM",1,26,1212,1209,3,2700,2321,379,0.923279755031361,0.660714285714286,1.76406926406926,757,368,389,4,1.1,69.02,6.1,0,0,0,0,0,0,0.00525744650269482,2.82955568971119,0.548147912031989
8.7,"max_tuv_SVM","SVM",1,27,1112,1109,3,2800,2421,379,0.923571016166301,0.665178571428571,1.76406926406926,764,370,394,7,1.1,71.57,6.4,0,0,0,0,0,0,0.00424032265350409,1.99596036375674,0.444738571084689
8.7,"max_tuv_SVM","SVM",1,28,1012,1009,3,2900,2521,379,0.923589058891474,0.660714285714286,1.7656906512605,764,370,394,0,1.1,74.13,6.7,0,0,0,0,0,0,0.00335435380640257,1.35286224699012,0.355318749145876
8.7,"max_tuv_SVM","SVM",1,29,912,910,2,3000,2620,380,0.923741133289361,0.65625,1.76731502168485,768,373,395,4,1.1,76.69,6.9,0,0,0,0,0,0,0.00276044265256051,1.00987509048078,0.306385932232083
8.7,"max_tuv_SVM","SVM",1,30,812,810,2,3100,2720,380,0.923787528868378,0.65625,1.77057274522712,770,373,397,2,1.1,79.24,7.2,0,0,0,0,0,0,0.00213233491243737,0.662298864377719,0.233279821110318
8.7,"max_tuv_SVM","SVM",1,31,712,710,2,3200,2820,380,0.924031105658216,0.651785714285714,1.7656906512605,770,373,397,0,1.1,81.8,7.4,0,0,0,0,0,0,0.00172245162697331,0.509650507849513,0.208681050285733
8.7,"max_tuv_SVM","SVM",1,32,612,610,2,3300,2920,380,0.924261794787216,0.651785714285714,1.76731502168485,771,374,397,1,1.1,84.36,7.7,0,0,0,0,0,0,0.000863000271067437,0.269696846837948,0.120990473531336
8.7,"max_tuv_SVM","SVM",1,33,512,511,1,3400,3019,381,0.924824985565836,0.647321428571429,1.76894238358327,778,377,401,7,1.1,86.91,7.9,0,0,0,0,0,0,0.000597927225124522,0.182229726830679,0.081020140246069
8.7,"max_tuv_SVM","SVM",1,34,412,412,0,3500,3118,382,0.925934613163986,0.638392857142857,1.76894238358327,783,379,404,5,1.1,89.47,8.2,0,0,0,0,0,0,0.000459347136645777,0.131166511598821,0.0598143182536168
8.7,"max_tuv_SVM","SVM",1,35,312,312,0,3600,3218,382,0.926609926591897,0.638392857142857,1.76894238358327,784,380,404,1,1.1,92.02,8.4,0,0,0,0,0,0,0.000212249916153795,0.0512959931775118,0.0270474427336198
8.7,"max_tuv_SVM","SVM",1,36,212,212,0,3700,3318,382,0.927287817551975,0.638392857142857,1.77057274522712,785,381,404,1,1.1,94.58,8.7,0,0,0,0,0,0,0.000100415086523829,0.0215151843043877,0.0141339703324345
8.7,"max_tuv_SVM","SVM",1,37,112,112,0,3800,3418,382,0.928160312190707,0.638392857142857,1.76894238358327,783,381,402,-2,1.1,97.14,8.9,0,0,0,0,0,0,2.37543985928153e-05,0.00489797967992374,0.00464197703045
8.7,"max_tuv_SVM","SVM",1,38,12,12,0,3900,3518,382,0.928617824150455,0.638392857142857,1.76731502168485,785,382,403,2,1.1,99.69,9.2,0,0,0,0,0,0,1.55924858550313e-05,0.00021007704002571,0.00021007704002571
8.7,"max_tuv_SVM","SVM",1,39,0,0,0,3912,3530,382,0.92862942304521,0.638392857142857,1.7656906512605,785,382,403,0,1.1,100,9.2,0,0,0,0,0,0,0,0,0
8.7,"max_tuv_SVM","SVM",2,0,3812,3426,386,100,87,13,0.918857704747778,0.579710144927536,1.77878920961925,30,13,17,0,1.3,2.56,6.7,0,0,0,0,0,0,0.70659886270428,488.667041672181,75.5993051321643
8.7,"max_tuv_SVM","SVM",2,1,3712,3367,345,200,146,54,0.89712962272438,0.570048309178744,1.6960237829803,114,54,60,84,1.1,5.11,2.7,0,0,0,0,0,0,0.52058693206029,498.084393545585,56.7308762601953
8.7,"max_tuv_SVM","SVM",2,2,3612,3312,300,300,201,99,0.915034954411514,0.603864734299517,1.74180191010486,186,92,94,72,1,7.67,2,0,0,0,0,0,0,0.690154579541768,247.460086733799,81.5355650625787
8.7,"max_tuv_SVM","SVM",2,3,3512,3257,255,400,256,144,0.910922183276593,0.628019323671498,1.7401980409427,277,137,140,91,1,10.22,1.8,0,0,0,0,0,0,0.582558031453692,192.1964880307,78.1471489522337
8.7,"max_tuv_SVM","SVM",2,4,3412,3207,205,500,306,194,0.915184107965088,0.63768115942029,1.73540410694561,340,168,172,63,1,12.78,1.6,0,0,0,0,0,0,0.205831477839218,158.027698740473,59.3294237133526
8.7,"max_tuv_SVM","SVM",2,5,3312,3154,158,600,359,241,0.914543300105234,0.647342995169082,1.74180191010486,408,201,207,68,1,15.34,1.5,0,0,0,0,0,0,0.135573826984376,122.02501200335,40.7576544514508
8.7,"max_tuv_SVM","SVM",2,6,3212,3091,121,700,422,278,0.920255328786929,0.666666666666667,1.71962915601023,478,232,246,70,1.1,17.89,1.5,0,0,0,0,0,0,0.112271286882811,133.079774471998,33.4424658050775
8.7,"max_tuv_SVM","SVM",2,7,3112,3018,94,800,495,305,0.911074098933007,0.681159420289855,1.66036025225658,515,245,270,37,1.1,20.45,1.6,0,0,0,0,0,0,0.0988694912323649,153.002058445014,23.5367718200202
8.7,"max_tuv_SVM","SVM",2,8,3012,2936,76,900,577,323,0.91047196051299,0.695652173913043,1.68954785280171,570,269,301,55,1.1,23.01,1.8,0,0,0,0,0,0,0.0980157928516365,147.037108055773,23.3470972594628
8.7,"max_tuv_SVM","SVM",2,9,2912,2849,63,1000,664,336,0.921581138152112,0.685990338164251,1.72438389100381,608,292,316,38,1.1,25.56,2,0,0,0,0,0,0,0.0745160820169077,107.099939193055,19.6476179915502
8.7,"max_tuv_SVM","SVM",2,10,2812,2757,55,1100,756,344,0.928690790872921,0.676328502415459,1.73859712278176,619,300,319,11,1.1,28.12,2.2,0,0,0,0,0,0,0.0644663188673277,92.7901319009255,15.647536181079
8.7,"max_tuv_SVM","SVM",2,11,2712,2668,44,1200,845,355,0.936228569534572,0.676328502415459,1.75275814801506,635,309,326,16,1.1,30.67,2.4,0,0,0,0,0,0,0.059579248941565,72.8944222895016,11.1946971728681
8.7,"max_tuv_SVM","SVM",2,12,2612,2577,35,1300,936,364,0.940665887753684,0.666666666666667,1.77500200176155,661,319,342,26,1.1,33.23,2.6,0,0,0,0,0,0,0.0720041638346229,76.9380387946115,12.2180408212896
8.7,"max_tuv_SVM","SVM",2,13,2512,2480,32,1400,1033,367,0.942354913642878,0.666666666666667,1.78534695785748,673,324,349,12,1.1,35.79,2.8,0,0,0,0,0,0,0.0620415579633127,64.0194635577698,11.4121924309332
8.7,"max_tuv_SVM","SVM",2,14,2412,2386,26,1500,1127,373,0.945285504760505,0.661835748792271,1.78370299196626,696,332,364,23,1.1,38.34,3,0,0,0,0,0,0,0.0577848519439408,55.368945092093,10.9844840857427
8.7,"max_tuv_SVM","SVM",2,15,2312,2289,23,1600,1224,376,0.945712249649928,0.661835748792271,1.78370299196626,704,334,370,8,1.1,40.9,3.3,0,0,0,0,0,0,0.0442158761917948,49.7381316328455,9.74434067666268
8.7,"max_tuv_SVM","SVM",2,16,2212,2193,19,1700,1320,380,0.945371129948676,0.666666666666667,1.77663794830695,713,337,376,9,1.1,43.46,3.5,0,0,0,0,0,0,0.0358085597999221,42.9074188157871,7.66597071789638
8.7,"max_tuv_SVM","SVM",2,17,2112,2094,18,1800,1419,381,0.945279980554818,0.661835748792271,1.77663794830695,711,339,372,-2,1.1,46.01,3.7,0,0,0,0,0,0,0.0286662259751424,35.0072271187918,6.83464330915881
8.7,"max_tuv_SVM","SVM",2,18,2012,1997,15,1900,1516,384,0.944230381474044,0.661835748792271,1.77663794830695,715,341,374,4,1.1,48.57,3.9,0,0,0,0,0,0,0.0286226762289643,30.4142348199255,4.83685038759533
8.7,"max_tuv_SVM","SVM",2,19,1912,1897,15,2000,1616,384,0.944405775004652,0.642512077294686,1.78582635287861,743,358,385,28,1.1,51.12,4.2,0,0,0,0,0,0,0.0213677410781264,14.4503571842373,4.70008348062008
8.7,"max_tuv_SVM","SVM",2,20,1812,1802,10,2100,1711,389,0.944219333062672,0.642512077294686,1.78910912190963,751,361,390,8,1.1,53.68,4.4,0,0,0,0,0,0,0.0143315504747965,9.57689899374206,1.71274397576108
8.7,"max_tuv_SVM","SVM",2,21,1712,1702,10,2200,1811,389,0.944213808856983,0.642512077294686,1.79075503646521,751,361,390,0,1.1,56.24,4.7,0,0,0,0,0,0,0.00973949436296275,7.66658262435754,1.14816271820276
8.7,"max_tuv_SVM","SVM",2,22,1612,1606,6,2300,1907,393,0.944233143576891,0.642512077294686,1.79075503646521,763,369,394,12,1.1,58.79,4.9,0,0,0,0,0,0,0.00934827813367081,7.89471957471611,1.04551790402578
8.7,"max_tuv_SVM","SVM",2,23,1512,1506,6,2400,2007,393,0.944216570959826,0.642512077294686,1.794055967408,765,369,396,2,1.1,61.35,5.1,0,0,0,0,0,0,0.00854127156191043,6.62919480703196,0.872481746013776
8.7,"max_tuv_SVM","SVM",2,24,1412,1406,6,2500,2107,393,0.944476208627176,0.63768115942029,1.794055967408,777,374,403,12,1.1,63.91,5.4,0,0,0,0,0,0,0.00581368129793554,4.08596071392117,0.692696884268737
8.7,"max_tuv_SVM","SVM",2,25,1312,1306,6,2600,2207,393,0.944536974889748,0.63768115942029,1.79240398217098,776,373,403,-1,1.1,66.46,5.6,0,0,0,0,0,0,0.00481701390231025,3.18872146190199,0.498684391112004
8.7,"max_tuv_SVM","SVM",2,26,1212,1206,6,2700,2307,393,0.944198617291341,0.642512077294686,1.79240398217098,782,378,404,6,1.1,69.02,5.9,0,0,0,0,0,0,0.00377119242990422,2.28844903325231,0.406879401148328
8.7,"max_tuv_SVM","SVM",2,27,1112,1107,5,2800,2406,394,0.943990078526608,0.642512077294686,1.79075503646521,784,380,404,2,1.1,71.57,6.1,0,0,0,0,0,0,0.00363925312634547,1.98420254014221,0.376818630696686
8.7,"max_tuv_SVM","SVM",2,28,1012,1007,5,2900,2506,394,0.943523283145949,0.642512077294686,1.794055967408,784,381,403,0,1.1,74.13,6.4,0,0,0,0,0,0,0.00314648871540608,1.49859733327603,0.328072975582729
8.7,"max_tuv_SVM","SVM",2,29,912,907,5,3000,2606,394,0.94328298019851,0.642512077294686,1.79240398217098,785,383,402,1,1,76.69,6.6,0,0,0,0,0,0,0.00276317790976631,1.1365694010146,0.293751179101918
8.7,"max_tuv_SVM","SVM",2,30,812,809,3,3100,2704,396,0.943039915148224,0.63768115942029,1.79240398217098,794,386,408,9,1.1,79.24,6.8,0,0,0,0,0,0,0.00217889213803506,0.813721057601363,0.238336227353054
8.7,"max_tuv_SVM","SVM",2,31,712,709,3,3200,2804,396,0.943034390942535,0.63768115942029,1.79075503646521,793,386,407,-1,1.1,81.8,7.1,0,0,0,0,0,0,0.00240861721130224,0.807558305309524,0.268396107270647
8.7,"max_tuv_SVM","SVM",2,32,612,610,2,3300,2903,397,0.943143494004878,0.63768115942029,1.78910912190963,797,387,410,4,1.1,84.36,7.3,0,0,0,0,0,0,0.00131985423567833,0.409878182657898,0.159483483820234
8.7,"max_tuv_SVM","SVM",2,33,512,510,2,3400,3003,397,0.943213927627404,0.63768115942029,1.78746623015398,796,388,408,-1,1.1,86.91,7.6,0,0,0,0,0,0,0.000822662910494679,0.244991178590007,0.105364691400334
8.7,"max_tuv_SVM","SVM",2,34,412,412,0,3500,3101,399,0.943171115033319,0.63768115942029,1.78582635287861,807,394,413,11,1,89.47,7.8,0,0,0,0,0,0,0.000848218860969658,0.251765043968322,0.107767983622391
8.7,"max_tuv_SVM","SVM",2,35,312,312,0,3600,3201,399,0.943340984358233,0.63768115942029,1.79240398217098,807,394,413,0,1,92.02,8,0,0,0,0,0,0,0.000454523648295558,0.112405758532584,0.0566889236678136
8.7,"max_tuv_SVM","SVM",2,36,212,212,0,3700,3301,399,0.943423847443556,0.632850241545894,1.794055967408,809,395,414,2,1,94.58,8.3,0,0,0,0,0,0,0.000302396342444011,0.0616495599359158,0.0399260291284937
8.7,"max_tuv_SVM","SVM",2,37,112,112,0,3800,3401,399,0.943825733407377,0.632850241545894,1.79240398217098,810,396,414,1,1,97.14,8.5,0,0,0,0,0,0,9.17703210755405e-05,0.0174180658129048,0.0164357459098126
8.7,"max_tuv_SVM","SVM",2,38,12,12,0,3900,3501,399,0.944081227920458,0.628019323671498,1.78746623015398,812,396,416,2,1.1,99.69,8.8,0,0,0,0,0,0,7.05084082998788e-05,0.000982199142183991,0.000982199142183991
8.7,"max_tuv_SVM","SVM",2,39,0,0,0,3912,3513,399,0.944140613131607,0.628019323671498,1.78582635287861,814,398,416,2,1,100,8.8,0,0,0,0,0,0,0,0,0
8.7,"max_tuv_SVM","SVM",3,0,3812,3422,390,100,84,16,0.880196469248293,0.475,1.68527956003666,42,16,26,0,1.6,2.56,5.2,0,0,0,0,0,0,0.545189454700446,556.848945402155,68.4373209448846
8.7,"max_tuv_SVM","SVM",3,1,3712,3376,336,200,130,70,0.907434510250574,0.605,1.68959780621572,110,55,55,68,1,5.11,1.9,0,0,0,0,0,0,0.723507339439257,467.785039891338,79.1107919111439
8.7,"max_tuv_SVM","SVM",3,2,3612,3317,295,300,189,111,0.914683940774478,0.65,1.73010082493126,205,101,104,95,1,7.67,1.7,0,0,0,0,0,0,0.670612885992284,486.062933050504,76.0866059945683
8.7,"max_tuv_SVM","SVM",3,3,3512,3262,250,400,244,156,0.913382687927108,0.645,1.74546458141674,298,147,151,93,1,10.22,1.6,0,0,0,0,0,0,0.630774886429235,495.271666077307,72.8767035599625
8.7,"max_tuv_SVM","SVM",3,4,3412,3204,208,500,302,198,0.90606492027335,0.67,1.66602209944751,376,185,191,78,1,12.78,1.5,0,0,0,0,0,0,0.615050095648739,426.252905028908,75.5412933901258
8.7,"max_tuv_SVM","SVM",3,5,3312,3145,167,600,361,239,0.878217539863328,0.665,1.58205882352941,453,219,234,77,1.1,15.34,1.5,0,0,0,0,0,0,0.218878395869924,319.617238331413,68.1552751976655
8.7,"max_tuv_SVM","SVM",3,6,3212,3083,129,700,423,277,0.888832574031894,0.69,1.61050597976081,518,248,270,65,1.1,17.89,1.5,0,0,0,0,0,0,0.143801063801526,255.566440443743,52.7278980998274
8.7,"max_tuv_SVM","SVM",3,7,3112,2998,114,800,508,292,0.906136104783599,0.68,1.66602209944751,564,270,294,46,1.1,20.45,1.7,0,0,0,0,0,0,0.112706679281088,177.80687561815,48.2538729920766
8.7,"max_tuv_SVM","SVM",3,8,3012,2926,86,900,580,320,0.905149487471525,0.69,1.65701657458564,582,275,307,18,1.1,23.01,1.8,0,0,0,0,0,0,0.0750961745744039,125.780846628406,25.3428241463046
8.7,"max_tuv_SVM","SVM",3,9,2912,2836,76,1000,670,330,0.907104214123007,0.685,1.65093577981651,598,284,314,16,1.1,25.56,2,0,0,0,0,0,0,0.065672731201285,111.004372761024,20.2270645447598
8.7,"max_tuv_SVM","SVM",3,10,2812,2746,66,1100,760,340,0.908206150341699,0.68,1.65245179063361,608,290,318,10,1.1,28.12,2.2,0,0,0,0,0,0,0.0478261486986655,74.3343062523271,13.3165955949368
8.7,"max_tuv_SVM","SVM",3,11,2712,2654,58,1200,852,348,0.911828018223242,0.675,1.69735537190083,625,297,328,17,1.1,30.67,2.4,0,0,0,0,0,0,0.0528355783735295,81.9092107353804,11.6311204509539
8.7,"max_tuv_SVM","SVM",3,12,2612,2559,53,1300,947,353,0.925760250569483,0.67,1.7126267281106,649,310,339,24,1.1,33.23,2.7,0,0,0,0,0,0,0.0500761127010945,61.7336868228618,11.1300255494561
8.7,"max_tuv_SVM","SVM",3,13,2512,2465,47,1400,1041,359,0.931341116173123,0.67,1.73966820276498,667,319,348,18,1.1,35.79,2.9,0,0,0,0,0,0,0.0514452754807158,55.45467819437,11.0436396950697
8.7,"max_tuv_SVM","SVM",3,14,2412,2372,40,1500,1134,366,0.935586560364489,0.665,1.7560773480663,688,327,361,21,1.1,38.34,3.1,0,0,0,0,0,0,0.0577810242153208,50.807925697846,11.8047751332082
8.7,"max_tuv_SVM","SVM",3,15,2312,2277,35,1600,1229,371,0.936640091116197,0.66,1.76022038567493,700,332,368,12,1.1,40.9,3.3,0,0,0,0,0,0,0.0485075853524377,42.8770365225506,11.1275682290954
8.7,"max_tuv_SVM","SVM",3,16,2212,2182,30,1700,1324,376,0.937343394077471,0.665,1.76670967741935,704,338,366,4,1.1,43.46,3.5,0,0,0,0,0,0,0.0405754939061778,42.5602613618201,10.4423119185523
8.7,"max_tuv_SVM","SVM",3,17,2112,2090,22,1800,1416,384,0.937626708428269,0.66,1.76508287292818,722,345,377,18,1.1,46.01,3.7,0,0,0,0,0,0,0.0309565955340988,34.4654982822048,7.43167981737699
8.7,"max_tuv_SVM","SVM",3,18,2012,1992,20,1900,1514,386,0.937779043280205,0.66,1.76508287292818,728,348,380,6,1.1,48.57,3.9,0,0,0,0,0,0,0.0283086072912453,32.5797067206647,6.77218461556307
8.7,"max_tuv_SVM","SVM",3,19,1912,1895,17,2000,1611,389,0.937380410022802,0.66,1.76670967741935,743,356,387,15,1.1,51.12,4.1,0,0,0,0,0,0,0.0210728512135054,22.6791355175511,5.29276656602578
8.7,"max_tuv_SVM","SVM",3,20,1812,1801,11,2100,1705,395,0.93740603644649,0.66,1.75699358386801,748,363,385,5,1.1,53.68,4.3,0,0,0,0,0,0,0.0174346098421181,14.6119213234404,1.82928349405279
8.7,"max_tuv_SVM","SVM",3,21,1712,1702,10,2200,1804,396,0.937491457858787,0.65,1.77245630174793,767,370,397,19,1.1,56.24,4.6,0,0,0,0,0,0,0.0121089570946983,9.11497228103403,1.4661429673622
8.7,"max_tuv_SVM","SVM",3,22,1612,1605,7,2300,1901,399,0.938382687927127,0.655,1.76595783684693,775,374,401,8,1.1,58.79,4.8,0,0,0,0,0,0,0.0112759037459603,8.73758866345937,1.20914778527695
8.7,"max_tuv_SVM","SVM",3,23,1512,1506,6,2400,2000,400,0.938280182232363,0.66,1.77408839779006,780,379,401,5,1.1,61.35,5,0,0,0,0,0,0,0.00824228654313292,6.09361156537977,0.949786656156656
8.7,"max_tuv_SVM","SVM",3,24,1412,1408,4,2500,2098,402,0.938362756264255,0.67,1.76920110192837,784,383,401,4,1,63.91,5.2,0,0,0,0,0,0,0.00864579106424379,6.0466608538469,0.912840617625584
8.7,"max_tuv_SVM","SVM",3,25,1312,1308,4,2600,2198,402,0.938590546697054,0.665,1.76920110192837,796,389,407,12,1,66.46,5.5,0,0,0,0,0,0,0.00664390705021549,4.39056607433164,0.742199039433482
8.7,"max_tuv_SVM","SVM",3,26,1212,1208,4,2700,2298,402,0.938564920273364,0.66,1.77082720588235,795,389,406,-1,1,69.02,5.7,0,0,0,0,0,0,0.0055809460726296,3.30906451303052,0.577803381335544
8.7,"max_tuv_SVM","SVM",3,27,1112,1108,4,2800,2398,402,0.938650341685664,0.66,1.76920110192837,794,388,406,-1,1,71.57,6,0,0,0,0,0,0,0.00441172458149421,2.37580660071372,0.47720195140029
8.7,"max_tuv_SVM","SVM",3,28,1012,1009,3,2900,2497,403,0.938781321184526,0.665,1.76920110192837,799,390,409,5,1,74.13,6.2,0,0,0,0,0,0,0.00418157669909646,2.09025333172755,0.451228775160633
8.7,"max_tuv_SVM","SVM",3,29,912,909,3,3000,2597,403,0.938855353075187,0.665,1.77082720588235,797,390,407,-2,1,76.69,6.4,0,0,0,0,0,0,0.00324097118549959,1.4470563612373,0.348835448482415
8.7,"max_tuv_SVM","SVM",3,30,812,809,3,3100,2697,403,0.938977790432818,0.665,1.77245630174793,800,391,409,3,1,79.24,6.7,0,0,0,0,0,0,0.00294194488428531,1.18865549492653,0.320246365669915
8.7,"max_tuv_SVM","SVM",3,31,712,709,3,3200,2797,403,0.938970671981793,0.66,1.77408839779006,801,391,410,1,1,81.8,6.9,0,0,0,0,0,0,0.00221496501081299,0.780565223093267,0.243235680430821
8.7,"max_tuv_SVM","SVM",3,32,612,609,3,3300,2897,403,0.939037585421429,0.66,1.77082720588235,802,391,411,1,1.1,84.36,7.2,0,0,0,0,0,0,0.00181081242611586,0.567870254419823,0.205516500091039
8.7,"max_tuv_SVM","SVM",3,33,512,510,2,3400,2996,404,0.939436218678831,0.66,1.76757798165138,807,393,414,5,1.1,86.91,7.4,0,0,0,0,0,0,0.00141525894328276,0.441132095934321,0.175422876864362
8.7,"max_tuv_SVM","SVM",3,34,412,411,1,3500,3095,405,0.93935933940776,0.66,1.76920110192837,811,396,415,4,1,89.47,7.6,0,0,0,0,0,0,0.001085518648873,0.303042631558714,0.133895420987037
8.7,"max_tuv_SVM","SVM",3,35,312,312,0,3600,3194,406,0.93950740318908,0.66,1.77408839779006,816,398,418,5,1.1,92.02,7.9,0,0,0,0,0,0,0.00080343240456709,0.208781027084884,0.105875578330498
8.7,"max_tuv_SVM","SVM",3,36,212,212,0,3700,3294,406,0.939832004555822,0.655,1.76920110192837,821,400,421,5,1.1,94.58,8.1,0,0,0,0,0,0,0.000555459246069916,0.116321642566435,0.072225303741868
8.7,"max_tuv_SVM","SVM",3,37,112,112,0,3800,3394,406,0.939904612756277,0.65,1.77408839779006,823,400,423,2,1.1,97.14,8.4,0,0,0,0,0,0,0.000233862376018684,0.0371811646084126,0.0346624565644863
8.7,"max_tuv_SVM","SVM",3,38,12,12,0,3900,3494,406,0.940327448747164,0.65,1.77245630174793,825,401,424,2,1.1,99.69,8.6,0,0,0,0,0,0,0.000179052124642012,0.00246747476803348,0.00246747476803348
8.7,"max_tuv_SVM","SVM",3,39,0,0,0,3912,3506,406,0.940219248291583,0.645,1.77245630174793,825,401,424,0,1.1,100,8.6,0,0,0,0,0,0,0,0,0
8.7,"max_tuv_SVM","SVM",4,0,3812,3425,387,100,91,9,0.925849560901107,0.604761904761905,1.76679821099711,23,9,14,0,1.6,2.56,10.1,0,0,0,0,0,0,0.407202147833007,312.242198637218,45.6804154176481
8.7,"max_tuv_SVM","SVM",4,1,3712,3388,324,200,128,72,0.899198167239381,0.580952380952381,1.75822152065246,104,52,52,81,1,5.11,1.8,0,0,0,0,0,0,0.731208939413899,280.160983151969,84.1923694159546
8.7,"max_tuv_SVM","SVM",4,2,3612,3324,288,300,192,108,0.909616538482533,0.638095238095238,1.73249144961852,189,90,99,85,1.1,7.67,1.8,0,0,0,0,0,0,0.648501219136911,259.410416030807,79.197899017281
8.7,"max_tuv_SVM","SVM",4,3,3512,3273,239,400,243,157,0.913058419243985,0.666666666666667,1.73627180899908,272,132,140,83,1.1,10.22,1.5,0,0,0,0,0,0,0.5,208.728912363382,75.0112440932498
8.7,"max_tuv_SVM","SVM",4,4,3412,3211,201,500,305,195,0.894428080510549,0.676190476190476,1.64824226464779,359,176,183,87,1,12.78,1.6,0,0,0,0,0,0,0.182941062472351,136.911063351258,65.5617556634112
8.7,"max_tuv_SVM","SVM",4,5,3312,3155,157,600,361,239,0.892936235204278,0.680952380952381,1.62248847926267,421,202,219,62,1.1,15.34,1.5,0,0,0,0,0,0,0.106999821207754,107.845391686308,42.4148900947446
8.7,"max_tuv_SVM","SVM",4,6,3212,3080,132,700,436,264,0.896004472808592,0.69047619047619,1.64520962018662,464,222,242,43,1.1,17.89,1.7,0,0,0,0,0,0,0.0681286523172302,84.7720625113401,30.0511025072132
8.7,"max_tuv_SVM","SVM",4,7,3112,3001,111,800,515,285,0.90225004090984,0.69047619047619,1.6623472203969,493,235,258,29,1.1,20.45,1.8,0,0,0,0,0,0,0.056063366821148,83.6458426237444,23.0976177622113
8.7,"max_tuv_SVM","SVM",4,8,3012,2919,93,900,597,303,0.909990181639673,0.704761904761905,1.68650210084034,523,250,273,30,1.1,23.01,2,0,0,0,0,0,0,0.0568607648068826,87.6218069635845,16.984722578377
8.7,"max_tuv_SVM","SVM",4,9,2912,2830,82,1000,686,314,0.91139611629303,0.70952380952381,1.68650210084034,549,262,287,26,1.1,25.56,2.2,0,0,0,0,0,0,0.0616620449023873,100.589559797168,17.5710639092989
8.7,"max_tuv_SVM","SVM",4,10,2812,2736,76,1100,780,320,0.921594938089791,0.69047619047619,1.68805362071231,576,275,301,27,1.1,28.12,2.4,0,0,0,0,0,0,0.0520828722465688,83.3664068317927,16.2814942070343
8.7,"max_tuv_SVM","SVM",4,11,2712,2655,57,1200,861,339,0.924038618883977,0.704761904761905,1.69040199031033,603,290,313,27,1.1,30.67,2.5,0,0,0,0,0,0,0.0440062135038417,62.3220375604206,8.51729647347728
8.7,"max_tuv_SVM","SVM",4,12,2612,2564,48,1300,952,348,0.938557519227616,0.695238095238095,1.75498949579832,649,316,333,46,1.1,33.23,2.7,0,0,0,0,0,0,0.0451382815482436,45.4666254079334,8.23126181656118
8.7,"max_tuv_SVM","SVM",4,13,2512,2474,38,1400,1042,358,0.93990208912887,0.695238095238095,1.74642857142857,667,323,344,18,1.1,35.79,2.9,0,0,0,0,0,0,0.0411091124155571,42.7375058146523,4.83102593674599
8.7,"max_tuv_SVM","SVM",4,14,2412,2380,32,1500,1136,364,0.942277586865202,0.695238095238095,1.76679821099711,687,334,353,20,1.1,38.34,3.1,0,0,0,0,0,0,0.0590772266035286,47.2334501797982,6.66192895658465
8.7,"max_tuv_SVM","SVM",4,15,2312,2281,31,1600,1235,365,0.942186221567656,0.69047619047619,1.76679821099711,690,338,352,3,1,40.9,3.4,0,0,0,0,0,0,0.0408573479504335,31.3820048719003,4.47057838375209
8.7,"max_tuv_SVM","SVM",4,16,2212,2187,25,1700,1329,371,0.942497136311564,0.685714285714286,1.76355042016807,710,344,366,20,1.1,43.46,3.6,0,0,0,0,0,0,0.042713526311454,28.036805843011,4.80487331357694
8.7,"max_tuv_SVM","SVM",4,17,2112,2090,22,1800,1426,374,0.942227131402384,0.685714285714286,1.76679821099711,714,347,367,4,1.1,46.01,3.8,0,0,0,0,0,0,0.0384513547930985,24.8372507276182,4.50421820871661
8.7,"max_tuv_SVM","SVM",4,18,2012,1999,13,1900,1517,383,0.939906180112354,0.680952380952381,1.76517282165856,740,359,381,26,1.1,48.57,4,0,0,0,0,0,0,0.0346276685184896,23.4839034518489,4.79868477327733
8.7,"max_tuv_SVM","SVM",4,19,1912,1901,11,2000,1615,385,0.939617083946968,0.685714285714286,1.76679821099711,742,360,382,2,1.1,51.12,4.2,0,0,0,0,0,0,0.023383109425552,19.0120450677887,2.80805620229291
8.7,"max_tuv_SVM","SVM",4,20,1812,1802,10,2100,1714,386,0.939626629575067,0.685714285714286,1.75498949579832,742,360,382,0,1.1,53.68,4.4,0,0,0,0,0,0,0.019300736707392,15.9963042926559,2.12708653455227
8.7,"max_tuv_SVM","SVM",4,21,1712,1703,9,2200,1813,387,0.939824360442905,0.685714285714286,1.75660402155342,748,363,385,6,1.1,56.24,4.7,0,0,0,0,0,0,0.0160986596747054,13.363704014381,1.7405294699685
8.7,"max_tuv_SVM","SVM",4,22,1612,1605,7,2300,1911,389,0.939822996781753,0.676190476190476,1.75176933158585,755,366,389,7,1.1,58.79,4.9,0,0,0,0,0,0,0.0158144663722901,12.3538029249428,1.60808166655854
8.7,"max_tuv_SVM","SVM",4,23,1512,1505,7,2400,2011,389,0.941335297005397,0.676190476190476,1.76355042016807,763,372,391,8,1.1,61.35,5.2,0,0,0,0,0,0,0.0110163362493789,7.52974587404364,1.32365563677681
8.7,"max_tuv_SVM","SVM",4,24,1412,1405,7,2500,2111,389,0.941200294550808,0.676190476190476,1.75498949579832,761,372,389,-2,1,63.91,5.4,0,0,0,0,0,0,0.00867122313980028,5.84679766202065,0.927343766134063
8.7,"max_tuv_SVM","SVM",4,25,1312,1305,7,2600,2211,389,0.941411662030215,0.676190476190476,1.76355042016807,765,373,392,4,1.1,66.46,5.7,0,0,0,0,0,0,0.00788881656121364,4.73080252281562,0.814192233599565
8.7,"max_tuv_SVM","SVM",4,26,1212,1206,6,2700,2310,390,0.941689848906336,0.676190476190476,1.76193099829463,777,377,400,12,1.1,69.02,5.9,0,0,0,0,0,0,0.00643006845400513,3.49097429376396,0.68288837372076
8.7,"max_tuv_SVM","SVM",4,27,1112,1106,6,2800,2410,390,0.941938035236993,0.676190476190476,1.76885976408912,779,378,401,2,1.1,71.57,6.2,0,0,0,0,0,0,0.00547414658148569,2.59055973712661,0.571004270220488
8.7,"max_tuv_SVM","SVM",4,28,1012,1006,6,2900,2510,390,0.942118038509777,0.676190476190476,1.77048406139315,782,379,403,3,1.1,74.13,6.4,0,0,0,0,0,0,0.00426208473582648,1.71597093845402,0.446598983029847
8.7,"max_tuv_SVM","SVM",4,29,912,906,6,3000,2610,390,0.942435771559463,0.671428571428571,1.76885976408912,787,380,407,5,1.1,76.69,6.7,0,0,0,0,0,0,0.00365294288458951,1.26366055983126,0.394984076543464
8.7,"max_tuv_SVM","SVM",4,30,812,807,5,3100,2709,391,0.942508045600808,0.671428571428571,1.77211134453782,788,381,407,1,1.1,79.24,6.9,0,0,0,0,0,0,0.00292555112931912,0.901100121673398,0.336404268761891
8.7,"max_tuv_SVM","SVM",4,31,712,708,4,3200,2808,392,0.942820324005869,0.671428571428571,1.76885976408912,793,383,410,5,1.1,81.8,7.2,0,0,0,0,0,0,0.00184500703323822,0.568904603816954,0.23506248072022
8.7,"max_tuv_SVM","SVM",4,32,612,609,3,3300,2907,393,0.94284623356786,0.671428571428571,1.77048406139315,793,385,408,0,1.1,84.36,7.4,0,0,0,0,0,0,0.00113595741557265,0.352284375932856,0.149812341256301
8.7,"max_tuv_SVM","SVM",4,33,512,510,2,3400,3006,394,0.943318060328346,0.671428571428571,1.7770111915734,799,388,411,6,1.1,86.91,7.6,0,0,0,0,0,0,0.000963623846801388,0.295740293313779,0.124825413687143
8.7,"max_tuv_SVM","SVM",4,34,412,411,1,3500,3105,395,0.94347897234493,0.676190476190476,1.77537490134175,804,390,414,5,1.1,89.47,7.9,0,0,0,0,0,0,0.00057909208442035,0.167074574714235,0.0735701742716848
8.7,"max_tuv_SVM","SVM",4,35,312,312,0,3600,3204,396,0.943915343915321,0.671428571428571,1.77252646712848,807,393,414,3,1.1,92.02,8.1,0,0,0,0,0,0,0.000623633480565386,0.148251384044256,0.0743680351930493
8.7,"max_tuv_SVM","SVM",4,36,212,212,0,3700,3304,396,0.943802160039251,0.671428571428571,1.76885976408912,809,394,415,2,1.1,94.58,8.3,0,0,0,0,0,0,0.000207193057821853,0.0432852116964936,0.0284766645816774
8.7,"max_tuv_SVM","SVM",4,37,112,112,0,3800,3404,396,0.943868979435968,0.666666666666667,1.76723844441535,814,396,418,5,1.1,97.14,8.6,0,0,0,0,0,0,9.11235230811216e-05,0.0167703076789016,0.0158072960590394
8.7,"max_tuv_SVM","SVM",4,38,12,12,0,3900,3504,396,0.943803523700409,0.666666666666667,1.76723844441535,814,396,418,0,1.1,99.69,8.8,0,0,0,0,0,0,4.49797850594325e-05,0.000734938476605912,0.000734938476605912
8.7,"max_tuv_SVM","SVM",4,39,0,0,0,3912,3516,396,0.943849888179764,0.666666666666667,1.7737416217637,813,396,417,-1,1.1,100,8.9,0,0,0,0,0,0,0,0,0
8.7,"max_tuv_SVM","SVM",5,0,3812,3412,400,100,88,12,0.914375065822582,0.556701030927835,1.77488716803649,34,12,22,0,1.8,2.56,7.3,0,0,0,0,0,0,0.296610892390413,447.695517156522,33.7145039555752
8.7,"max_tuv_SVM","SVM",5,1,3712,3388,324,200,112,88,0.914857764723801,0.608247422680412,1.74219223771983,97,47,50,63,1.1,5.11,1.3,0,0,0,0,0,0,0.823726556707059,381.59145738647,87.178112058856
8.7,"max_tuv_SVM","SVM",5,2,3612,3316,296,300,184,116,0.893630714862457,0.608247422680412,1.66031544305238,184,91,93,87,1,7.67,1.6,0,0,0,0,0,0,0.69615005775017,320.740755460632,79.2225415810633
8.7,"max_tuv_SVM","SVM",5,3,3512,3263,249,400,237,163,0.861686286670486,0.639175257731959,1.59392055791389,275,137,138,91,1,10.22,1.5,0,0,0,0,0,0,0.715954237926617,315.162495024385,81.7287545200412
8.7,"max_tuv_SVM","SVM",5,4,3412,3200,212,500,300,200,0.872160852826571,0.654639175257732,1.60171537303684,352,174,178,77,1,12.78,1.5,0,0,0,0,0,0,0.677648799370473,280.133691577298,80.0577642267377
8.7,"max_tuv_SVM","SVM",5,5,3312,3148,164,600,352,248,0.890358601401872,0.654639175257732,1.65256023238594,431,211,220,79,1,15.34,1.4,0,0,0,0,0,0,0.197018604626148,204.194643853783,65.4660701238593
8.7,"max_tuv_SVM","SVM",5,6,3212,3095,117,700,405,295,0.880238014440009,0.65979381443299,1.62321342197858,492,238,254,61,1.1,17.89,1.4,0,0,0,0,0,0,0.117701744446443,165.194173164723,36.6981395383736
8.7,"max_tuv_SVM","SVM",5,7,3112,3022,90,800,478,322,0.886757375054127,0.675257731958763,1.64327618613658,531,254,277,39,1.1,20.45,1.5,0,0,0,0,0,0,0.0909157333051447,148.516625957416,24.6779073369807
8.7,"max_tuv_SVM","SVM",5,8,3012,2939,73,900,561,339,0.890229881694886,0.675257731958763,1.65256023238594,553,267,286,22,1.1,23.01,1.7,0,0,0,0,0,0,0.0730131795473516,122.124081256214,16.731053935695
8.7,"max_tuv_SVM","SVM",5,9,2912,2848,64,1000,652,348,0.907898124202828,0.670103092783505,1.66959094832083,574,278,296,21,1.1,25.56,1.9,0,0,0,0,0,0,0.0604129202657276,101.252556199501,13.6477618488476
8.7,"max_tuv_SVM","SVM",5,10,2812,2761,51,1100,739,361,0.916121558210565,0.664948453608247,1.69430007668058,592,283,309,18,1.1,28.12,2,0,0,0,0,0,0,0.06032318387165,98.2597946747195,9.0537664051993
8.7,"max_tuv_SVM","SVM",5,11,2712,2663,49,1200,837,363,0.922583872590895,0.65979381443299,1.70355854704496,606,295,311,14,1.1,30.67,2.3,0,0,0,0,0,0,0.0539591308036456,82.8963749641012,8.50351052652447
8.7,"max_tuv_SVM","SVM",5,12,2612,2569,43,1300,931,369,0.930731244953599,0.664948453608247,1.71281701740933,625,305,320,19,1,33.23,2.5,0,0,0,0,0,0,0.0555298757121498,69.3611583053605,7.11687980280559
8.7,"max_tuv_SVM","SVM",5,13,2512,2473,39,1400,1027,373,0.932385585733177,0.65979381443299,1.74540069487954,643,311,332,18,1.1,35.79,2.8,0,0,0,0,0,0,0.0531236388158884,55.251086018549,6.86811476820504
8.7,"max_tuv_SVM","SVM",5,14,2412,2375,37,1500,1125,375,0.932577202569708,0.65979381443299,1.74379499046842,651,316,335,8,1.1,38.34,3,0,0,0,0,0,0,0.0437715106156958,44.5303189736536,5.65804323344468
8.7,"max_tuv_SVM","SVM",5,15,2312,2281,31,1600,1219,381,0.931603028423633,0.65979381443299,1.76072619769557,675,324,351,24,1.1,40.9,3.2,0,0,0,0,0,0,0.0529898404185132,43.3790982172565,7.07525934439131
8.7,"max_tuv_SVM","SVM",5,16,2212,2190,22,1700,1310,390,0.930859964660569,0.65979381443299,1.76234600100532,696,335,361,21,1.1,43.46,3.4,0,0,0,0,0,0,0.0535512700643703,41.5512165222865,6.96935077543932
8.7,"max_tuv_SVM","SVM",5,17,2112,2098,14,1800,1402,398,0.932626935183758,0.654639175257732,1.76559456506247,719,344,375,23,1.1,46.01,3.5,0,0,0,0,0,0,0.0396019169428356,35.5526728081706,5.91695300827928
8.7,"max_tuv_SVM","SVM",5,18,2012,2000,12,1900,1500,400,0.933375849842593,0.65979381443299,1.76234600100532,719,345,374,0,1.1,48.57,3.8,0,0,0,0,0,0,0.02930153645217,29.9926496138382,4.26730748164891
8.7,"max_tuv_SVM","SVM",5,19,1912,1902,10,2000,1598,402,0.933343669915843,0.649484536082474,1.75910936923121,722,347,375,3,1.1,51.12,4,0,0,0,0,0,0,0.0247140425871618,24.6222828635346,2.64777592188576
8.7,"max_tuv_SVM","SVM",5,20,1812,1802,10,2100,1698,402,0.932966287138539,0.644329896907217,1.76234600100532,725,349,376,3,1.1,53.68,4.2,0,0,0,0,0,0,0.0198360321180688,19.6200017584414,2.13801309402673
8.7,"max_tuv_SVM","SVM",5,21,1712,1703,9,2200,1797,403,0.933018945200487,0.644329896907217,1.76234600100532,733,353,380,8,1.1,56.24,4.5,0,0,0,0,0,0,0.0177853299071058,15.9313149149636,1.80191835593871
8.7,"max_tuv_SVM","SVM",5,22,1612,1604,8,2300,1896,404,0.931123254970322,0.644329896907217,1.77162150627377,760,367,393,27,1.1,58.79,4.7,0,0,0,0,0,0,0.0118419378075968,8.05559930390297,1.55010053549724
8.7,"max_tuv_SVM","SVM",5,23,1512,1506,6,2400,1994,406,0.931295856395598,0.639175257731959,1.76836783959558,761,371,390,1,1.1,61.35,4.9,0,0,0,0,0,0,0.00892270896383271,6.83237615661239,1.03973451548816
8.7,"max_tuv_SVM","SVM",5,24,1412,1406,6,2500,2094,406,0.931314871806858,0.639175257731959,1.76999317768344,761,371,390,0,1.1,63.91,5.2,0,0,0,0,0,0,0.00702440526418962,5.28163595340216,0.745478492282419
8.7,"max_tuv_SVM","SVM",5,25,1312,1308,4,2600,2192,408,0.931110090454832,0.639175257731959,1.77325283362761,772,373,399,11,1.1,66.46,5.4,0,0,0,0,0,0,0.00665056460326468,4.83303705074699,0.737719656120039
8.7,"max_tuv_SVM","SVM",5,26,1212,1209,3,2700,2291,409,0.930816082942285,0.639175257731959,1.76836783959558,773,377,396,1,1.1,69.02,5.6,0,0,0,0,0,0,0.00496941550470003,3.3021390571191,0.542861128750555
8.7,"max_tuv_SVM","SVM",5,27,1112,1110,2,2800,2390,410,0.93087459190001,0.634020618556701,1.77162150627377,780,383,397,7,1,71.57,5.8,0,0,0,0,0,0,0.00490497241597199,2.96035909126663,0.51055707885501
8.7,"max_tuv_SVM","SVM",5,28,1012,1010,2,2900,2490,410,0.931728822682751,0.628865979381443,1.76836783959558,784,385,399,4,1,74.13,6.1,0,0,0,0,0,0,0.0040666992585095,2.23474471116361,0.440607794747995
8.7,"max_tuv_SVM","SVM",5,29,912,910,2,3000,2590,410,0.932021367471362,0.628865979381443,1.76836783959558,788,386,402,4,1,76.69,6.3,0,0,0,0,0,0,0.00364513415078289,1.71371084234606,0.377260922679865
8.7,"max_tuv_SVM","SVM",5,30,812,810,2,3100,2690,410,0.932770282130208,0.628865979381443,1.76999317768344,790,386,404,2,1,79.24,6.6,0,0,0,0,0,0,0.00279709709296791,1.13548228573423,0.301326675913448
8.7,"max_tuv_SVM","SVM",5,31,712,710,2,3200,2790,410,0.932852194671019,0.628865979381443,1.76836783959558,791,387,404,1,1,81.8,6.8,0,0,0,0,0,0,0.0022579676771553,0.795231905470735,0.249795707237884
8.7,"max_tuv_SVM","SVM",5,32,612,610,2,3300,2890,410,0.93294873445126,0.628865979381443,1.76836783959558,792,388,404,1,1,84.36,7,0,0,0,0,0,0,0.00151256099897282,0.46997335687445,0.180694517982295
8.7,"max_tuv_SVM","SVM",5,33,512,510,2,3400,2990,410,0.933127186772312,0.628865979381443,1.76512610203445,790,388,402,-2,1,86.91,7.3,0,0,0,0,0,0,0.000954828374678073,0.305929377101025,0.128570137943054
8.7,"max_tuv_SVM","SVM",5,34,412,412,0,3500,3088,412,0.933036497887849,0.628865979381443,1.76999317768344,800,391,409,10,1,89.47,7.5,0,0,0,0,0,0,0.00114780687937758,0.340146478410531,0.140860345084665
8.7,"max_tuv_SVM","SVM",5,35,312,312,0,3600,3188,412,0.93339340252995,0.623711340206186,1.77325283362761,805,393,412,5,1,92.02,7.7,0,0,0,0,0,0,0.000705453649823829,0.179018693058544,0.0878078971316673
8.7,"max_tuv_SVM","SVM",5,36,212,212,0,3700,3288,412,0.93361573656929,0.618556701030928,1.77162150627377,810,395,415,5,1.1,94.58,8,0,0,0,0,0,0,0.000382954759581594,0.0801995847351916,0.050004538001835
8.7,"max_tuv_SVM","SVM",5,37,112,112,0,3800,3388,412,0.933955088524073,0.618556701030928,1.77162150627377,815,397,418,5,1.1,97.14,8.2,0,0,0,0,0,0,0.000180192662540907,0.0297056026128272,0.0277972941381026
8.7,"max_tuv_SVM","SVM",5,38,12,12,0,3900,3488,412,0.934183273459185,0.623711340206186,1.76999317768344,815,398,417,0,1,99.69,8.5,0,0,0,0,0,0,9.66432913253039e-05,0.00142531502646609,0.00142531502646609
8.7,"max_tuv_SVM","SVM",5,39,0,0,0,3912,3500,412,0.934221304281703,0.623711340206186,1.77162150627377,815,398,417,0,1,100,8.5,0,0,0,0,0,0,0,0,0
8.7,"max_tuv_SVM","SVM",6,0,3812,3396,416,100,91,9,0.894834643218441,0.524861878453039,1.74300481197647,23,9,14,0,1.6,2.56,10.1,0,0,0,0,0,0,0.282126655902208,341.67125683949,32.0732791941071
8.7,"max_tuv_SVM","SVM",6,1,3712,3361,351,200,126,74,0.893899307446907,0.524861878453039,1.72149812276793,93,47,46,70,1,5.11,1.7,0,0,0,0,0,0,0.839708607299613,358.269775949699,90.0888926237323
8.7,"max_tuv_SVM","SVM",6,2,3612,3301,311,300,186,114,0.90238580655202,0.607734806629834,1.71312472948545,157,77,80,64,1,7.67,1.6,0,0,0,0,0,0,0.750315244295172,294.584954690957,85.0060802748415
8.7,"max_tuv_SVM","SVM",6,3,3512,3246,266,400,241,159,0.879333903976352,0.624309392265193,1.65873821904452,247,121,126,90,1,10.22,1.5,0,0,0,0,0,0,0.713186924481668,208.646419352132,84.4719190475162
8.7,"max_tuv_SVM","SVM",6,4,3412,3183,229,500,304,196,0.893076025212054,0.640883977900553,1.6533645645034,336,164,172,89,1,12.78,1.6,0,0,0,0,0,0,0.568466672573894,180.003825277233,79.214829102773
8.7,"max_tuv_SVM","SVM",6,5,3312,3134,178,600,353,247,0.888625009726864,0.635359116022099,1.64729160007914,424,207,217,88,1,15.34,1.4,0,0,0,0,0,0,0.186882827269711,125.396957695191,61.918140940695
8.7,"max_tuv_SVM","SVM",6,6,3212,3079,133,700,408,292,0.88514201229477,0.640883977900553,1.63344450950938,469,226,243,45,1.1,17.89,1.4,0,0,0,0,0,0,0.0953748111820158,88.4129121305669,35.6022153387225
8.7,"max_tuv_SVM","SVM",6,7,3112,3002,110,800,485,315,0.887085829896515,0.651933701657459,1.62894052648684,492,237,255,23,1.1,20.45,1.5,0,0,0,0,0,0,0.0606646040874466,68.9793848549138,20.6868979144175
8.7,"max_tuv_SVM","SVM",6,8,3012,2928,84,900,559,341,0.888444479028878,0.662983425414365,1.6533645645034,552,264,288,60,1.1,23.01,1.6,0,0,0,0,0,0,0.0605731426504666,92.9128876483051,16.8498311964312
8.7,"max_tuv_SVM","SVM",6,9,2912,2838,74,1000,649,351,0.901789743988796,0.662983425414365,1.6617929855621,574,276,298,22,1.1,25.56,1.8,0,0,0,0,0,0,0.0487545942026562,72.7099563876048,13.7241660306692
8.7,"max_tuv_SVM","SVM",6,10,2812,2754,58,1100,733,367,0.912851918138662,0.679558011049724,1.69164555416501,603,287,316,29,1.1,28.12,2,0,0,0,0,0,0,0.0480214723648935,73.1216986121388,7.73853792428465
8.7,"max_tuv_SVM","SVM",6,11,2712,2662,50,1200,825,375,0.916619718309855,0.662983425414365,1.71312472948545,635,305,330,32,1.1,30.67,2.2,0,0,0,0,0,0,0.0457067920270685,66.4841934781552,6.9787736416881
8.7,"max_tuv_SVM","SVM",6,12,2612,2568,44,1300,919,381,0.921497159754112,0.662983425414365,1.71312472948545,649,314,335,14,1.1,33.23,2.4,0,0,0,0,0,0,0.0489078266480602,68.0856802588136,7.55289416879601
8.7,"max_tuv_SVM","SVM",6,13,2512,2474,38,1400,1013,387,0.929389152595149,0.657458563535912,1.73819873253169,663,323,340,14,1.1,35.79,2.6,0,0,0,0,0,0,0.0527829823481484,55.968577706797,7.71233525798972
8.7,"max_tuv_SVM","SVM",6,14,2412,2378,34,1500,1109,391,0.931678468601689,0.657458563535912,1.73304478447947,683,330,353,20,1.1,38.34,2.8,0,0,0,0,0,0,0.0506793591310424,47.8389541247493,7.4264559962814
8.7,"max_tuv_SVM","SVM",6,15,2312,2281,31,1600,1206,394,0.931977278032859,0.651933701657459,1.72985610962302,690,335,355,7,1.1,40.9,3.1,0,0,0,0,0,0,0.0441903623971002,39.4172571155466,6.82132081624105
8.7,"max_tuv_SVM","SVM",6,16,2212,2185,27,1700,1302,398,0.932316551241169,0.651933701657459,1.73979781140246,707,339,368,17,1.1,43.46,3.3,0,0,0,0,0,0,0.0437112848272428,38.143887259006,7.06499722641336
8.7,"max_tuv_SVM","SVM",6,17,2112,2096,16,1800,1391,409,0.931401447358207,0.646408839779006,1.72985610962302,733,349,384,26,1.1,46.01,3.4,0,0,0,0,0,0,0.0358236723938389,35.4665019123321,5.67708295097237
8.7,"max_tuv_SVM","SVM",6,18,2012,1999,13,1900,1488,412,0.931469924519518,0.646408839779006,1.72826616834579,740,351,389,7,1.1,48.57,3.6,0,0,0,0,0,0,0.0265405196505261,28.3039847641067,2.9430529240001
8.7,"max_tuv_SVM","SVM",6,19,1912,1900,12,2000,1587,413,0.932641817757395,0.640883977900553,1.74139983516987,750,358,392,10,1.1,51.12,3.8,0,0,0,0,0,0,0.022408798465121,22.1755955990522,2.38606060731749
8.7,"max_tuv_SVM","SVM",6,20,1812,1801,11,2100,1686,414,0.933763909423407,0.640883977900553,1.75322958814206,768,368,400,18,1.1,53.68,4.1,0,0,0,0,0,0,0.0159406619924997,13.9388402822814,1.96864200045416
8.7,"max_tuv_SVM","SVM",6,21,1712,1704,8,2200,1783,417,0.934003579487994,0.640883977900553,1.76292486697049,773,370,403,5,1.1,56.24,4.3,0,0,0,0,0,0,0.0136419390380297,12.4840881660998,1.50284863592944
8.7,"max_tuv_SVM","SVM",6,22,1612,1605,7,2300,1882,418,0.933931989728441,0.640883977900553,1.75806386090348,780,373,407,7,1.1,58.79,4.5,0,0,0,0,0,0,0.0128214187879231,10.6210423163197,1.30344550607118
8.7,"max_tuv_SVM","SVM",6,23,1512,1505,7,2400,1982,418,0.934576297564401,0.635359116022099,1.76292486697049,793,386,407,13,1.1,61.35,4.7,0,0,0,0,0,0,0.00849430117800173,5.99360929208529,1.05072394763808
8.7,"max_tuv_SVM","SVM",6,24,1412,1406,6,2500,2081,419,0.934669675511643,0.640883977900553,1.75968121496135,798,387,411,5,1.1,63.91,5,0,0,0,0,0,0,0.00732009506610777,5.11692170138336,0.783821187876745
8.7,"max_tuv_SVM","SVM",6,25,1312,1307,5,2600,2180,420,0.934520270796057,0.635359116022099,1.75968121496135,797,388,409,-1,1.1,66.46,5.2,0,0,0,0,0,0,0.00735779602981417,4.88522626552466,0.763254257570017
8.7,"max_tuv_SVM","SVM",6,26,1212,1207,5,2700,2280,420,0.935167691230262,0.635359116022099,1.76292486697049,800,392,408,3,1,69.02,5.4,0,0,0,0,0,0,0.00523957597254349,3.12466611300776,0.564132870534561
8.7,"max_tuv_SVM","SVM",6,27,1112,1108,4,2800,2379,421,0.935840012450399,0.635359116022099,1.76292486697049,806,394,412,6,1,71.57,5.7,0,0,0,0,0,0,0.00545677701749324,2.85976981553977,0.562143161857226
8.7,"max_tuv_SVM","SVM",6,28,1012,1008,4,2900,2479,421,0.936032993541365,0.635359116022099,1.76130154757181,812,399,413,6,1,74.13,5.9,0,0,0,0,0,0,0.00472461351981104,2.23042542989098,0.520357056920183
8.7,"max_tuv_SVM","SVM",6,29,912,908,4,3000,2579,421,0.936098358104434,0.635359116022099,1.76292486697049,815,399,416,3,1,76.69,6.1,0,0,0,0,0,0,0.00362598851802319,1.4439486548443,0.389787716142457
8.7,"max_tuv_SVM","SVM",6,30,812,808,4,3100,2679,421,0.936473426192519,0.635359116022099,1.76130154757181,818,399,419,3,1.1,79.24,6.4,0,0,0,0,0,0,0.0029638301728707,1.01805276936197,0.327273832911666
8.7,"max_tuv_SVM","SVM",6,31,712,708,4,3200,2779,421,0.936425180919778,0.635359116022099,1.75806386090348,817,399,418,-1,1,81.8,6.6,0,0,0,0,0,0,0.00201042442929269,0.619569984143373,0.234116700377217
8.7,"max_tuv_SVM","SVM",6,32,612,610,2,3300,2877,423,0.937103727336398,0.635359116022099,1.75968121496135,827,404,423,10,1,84.36,6.8,0,0,0,0,0,0,0.00170700663860168,0.534208561977552,0.209597000960758
8.7,"max_tuv_SVM","SVM",6,33,512,510,2,3400,2977,423,0.937464788732398,0.635359116022099,1.76292486697049,826,404,422,-1,1,86.91,7,0,0,0,0,0,0,0.0009992630714569,0.314698501751427,0.130720674669977
8.7,"max_tuv_SVM","SVM",6,34,412,411,1,3500,3076,424,0.937951910357174,0.629834254143646,1.76475239495159,833,407,426,7,1,89.47,7.3,0,0,0,0,0,0,0.000820693619951404,0.250251717683308,0.10512688524556
8.7,"max_tuv_SVM","SVM",6,35,312,312,0,3600,3175,425,0.938174461131433,0.629834254143646,1.77629636394076,838,409,429,5,1,92.02,7.5,0,0,0,0,0,0,0.000726305172524133,0.18428924885135,0.0864980582988982
8.7,"max_tuv_SVM","SVM",6,36,212,212,0,3700,3275,425,0.938288070967244,0.635359116022099,1.77792898927527,837,409,428,-1,1,94.58,7.7,0,0,0,0,0,0,0.000393071355279209,0.080560938212739,0.0495463532820657
8.7,"max_tuv_SVM","SVM",6,37,112,112,0,3800,3375,425,0.938339428838227,0.629834254143646,1.77956461852023,843,412,431,6,1,97.14,7.9,0,0,0,0,0,0,0.000192392418274136,0.0306970243003371,0.0286978378169768
8.7,"max_tuv_SVM","SVM",6,38,12,12,0,3900,3475,425,0.93830519025757,0.629834254143646,1.77956461852023,844,412,432,1,1,99.69,8.2,0,0,0,0,0,0,0.000146848478321177,0.00203542557770758,0.00203542557770758
8.7,"max_tuv_SVM","SVM",6,39,0,0,0,3912,3487,425,0.938373667418881,0.629834254143646,1.77956461852023,845,412,433,1,1.1,100,8.2,0,0,0,0,0,0,0,0,0
8.7,"max_tuv_SVM","SVM",7,0,3812,3423,389,100,95,5,0.835378981305163,0.424528301886792,1.66670724284845,28,5,23,0,4.6,2.56,19,0,0,0,0,0,0,0.0821781270840772,211.908162702491,9.8099240710381
8.7,"max_tuv_SVM","SVM",7,1,3712,3369,343,200,149,51,0.899385494201131,0.55188679245283,1.75217240782413,104,49,55,76,1.1,5.11,2.9,0,0,0,0,0,0,0.717992651395468,355.837283288539,77.9857433062743
8.7,"max_tuv_SVM","SVM",7,2,3612,3318,294,300,200,100,0.916446685130678,0.613207547169811,1.75056638361897,195,95,100,91,1.1,7.67,2,0,0,0,0,0,0,0.691923937809755,431.385761548502,77.2453359998343
8.7,"max_tuv_SVM","SVM",7,3,3512,3260,252,400,258,142,0.897424593214456,0.547169811320755,1.75013030334619,278,134,144,83,1.1,10.22,1.8,0,0,0,0,0,0,0.710729285045045,328.97845161623,82.7843512648399
8.7,"max_tuv_SVM","SVM",7,4,3412,3192,220,500,326,174,0.892380344469444,0.617924528301887,1.66670724284845,350,169,181,72,1.1,12.78,1.9,0,0,0,0,0,0,0.657914378654208,270.516859460133,80.0614523510351
8.7,"max_tuv_SVM","SVM",7,5,3312,3138,174,600,380,220,0.910105537043446,0.613207547169811,1.71299250832408,440,210,230,90,1.1,15.34,1.7,0,0,0,0,0,0,0.234600367330649,203.147652060335,78.6059988044043
8.7,"max_tuv_SVM","SVM",7,6,3212,3073,139,700,445,255,0.892669746408172,0.617924528301887,1.66364062418635,484,232,252,44,1.1,17.89,1.7,0,0,0,0,0,0,0.0947042891679667,148.694732856862,62.163522034243
8.7,"max_tuv_SVM","SVM",7,7,3112,3012,100,800,506,294,0.887257659684947,0.627358490566038,1.62371374712485,531,252,279,47,1.1,20.45,1.7,0,0,0,0,0,0,0.0709322191129727,140.620855378484,43.0397805964538
8.7,"max_tuv_SVM","SVM",7,8,3012,2927,85,900,591,309,0.895744980093464,0.627358490566038,1.64364052185665,538,260,278,7,1.1,23.01,1.9,0,0,0,0,0,0,0.0596722881158791,117.580264913773,33.239607660386
8.7,"max_tuv_SVM","SVM",7,9,2912,2839,73,1000,679,321,0.907426540592005,0.622641509433962,1.68600239097666,554,267,287,16,1.1,25.56,2.1,0,0,0,0,0,0,0.059489155038804,115.222323246044,26.738154516879
8.7,"max_tuv_SVM","SVM",7,10,2812,2741,71,1100,777,323,0.916599500173087,0.617924528301887,1.71299250832408,575,279,296,21,1.1,28.12,2.4,0,0,0,0,0,0,0.0428686173733923,62.0737313080585,23.9263808169551
8.7,"max_tuv_SVM","SVM",7,11,2712,2667,45,1200,851,349,0.921569369915174,0.608490566037736,1.70828217145427,586,286,300,11,1,30.67,2.4,0,0,0,0,0,0,0.0341574745435572,50.3591251713476,5.7326988694766
8.7,"max_tuv_SVM","SVM",7,12,2612,2576,36,1300,942,358,0.924417409555129,0.613207547169811,1.72305636076444,608,294,314,22,1.1,33.23,2.6,0,0,0,0,0,0,0.0472180118438762,62.5836320660503,5.36963612171819
8.7,"max_tuv_SVM","SVM",7,13,2512,2478,34,1400,1040,360,0.927687380993584,0.599056603773585,1.74370780682015,621,302,319,13,1.1,35.79,2.9,0,0,0,0,0,0,0.048099906901609,46.8859919604933,5.55102793359552
8.7,"max_tuv_SVM","SVM",7,14,2412,2378,34,1500,1140,360,0.927995715769418,0.599056603773585,1.74852024786933,622,303,319,1,1.1,38.34,3.2,0,0,0,0,0,0,0.0351866714881546,36.4935031517108,3.83848310583394
8.7,"max_tuv_SVM","SVM",7,15,2312,2287,25,1600,1231,369,0.929970140211171,0.60377358490566,1.76549617260593,652,313,339,30,1.1,40.9,3.3,0,0,0,0,0,0,0.04830551557586,35.2914752572186,5.64479844112919
8.7,"max_tuv_SVM","SVM",7,16,2212,2196,16,1700,1322,378,0.931024969707453,0.599056603773585,1.75902322605192,681,323,358,29,1.1,43.46,3.5,0,0,0,0,0,0,0.0447018114256107,33.6626725921096,5.47231558272267
8.7,"max_tuv_SVM","SVM",7,17,2112,2102,10,1800,1416,384,0.932232614246144,0.60377358490566,1.76387347391787,693,328,365,12,1.1,46.01,3.7,0,0,0,0,0,0,0.0287137860078373,28.3233556786164,3.73290502698911
8.7,"max_tuv_SVM","SVM",7,18,2012,2003,9,1900,1515,385,0.932780314176903,0.60377358490566,1.76875054343101,694,331,363,1,1.1,48.57,3.9,0,0,0,0,0,0,0.0215623558810866,23.3499606496938,2.39680617968414
8.7,"max_tuv_SVM","SVM",7,19,1912,1904,8,2000,1614,386,0.932542301367485,0.60377358490566,1.76225375539269,694,333,361,0,1.1,51.12,4.2,0,0,0,0,0,0,0.0206270243525985,19.9174004217235,2.07901249297797
8.7,"max_tuv_SVM","SVM",7,20,1812,1804,8,2100,1714,386,0.931333304483268,0.599056603773585,1.77725415181289,726,352,374,32,1.1,53.68,4.4,0,0,0,0,0,0,0.0174060624559864,10.8440930652121,2.28761911021495
8.7,"max_tuv_SVM","SVM",7,21,1712,1704,8,2200,1814,386,0.931295438809043,0.599056603773585,1.77398413497422,727,351,376,1,1.1,56.24,4.7,0,0,0,0,0,0,0.00998867574564426,7.25670583080331,1.19892085376239
8.7,"max_tuv_SVM","SVM",7,22,1612,1605,7,2300,1913,387,0.931390102994608,0.599056603773585,1.77398413497422,731,352,379,4,1.1,58.79,4.9,0,0,0,0,0,0,0.00857037499147977,6.50797967334015,0.943100516359731
8.7,"max_tuv_SVM","SVM",7,23,1512,1507,5,2400,2011,389,0.931495585944235,0.60377358490566,1.77398413497422,736,353,383,5,1.1,61.35,5.2,0,0,0,0,0,0,0.00789386131406684,6.13756469208005,0.852276543057994
8.7,"max_tuv_SVM","SVM",7,24,1412,1407,5,2500,2111,389,0.931530746927445,0.60377358490566,1.77398413497422,737,354,383,1,1.1,63.91,5.4,0,0,0,0,0,0,0.00762888903562306,5.46706281724885,0.780583432961939
8.7,"max_tuv_SVM","SVM",7,25,1312,1307,5,2600,2211,389,0.931200774623482,0.599056603773585,1.77725415181289,740,359,381,3,1.1,66.46,5.7,0,0,0,0,0,0,0.00551257664831416,3.61080172222836,0.635564251560568
8.7,"max_tuv_SVM","SVM",7,26,1212,1207,5,2700,2311,389,0.931296791154553,0.599056603773585,1.77561763786094,740,359,381,0,1.1,69.02,5.9,0,0,0,0,0,0,0.00490951384859012,2.87560328930425,0.505432051777636
8.7,"max_tuv_SVM","SVM",7,27,1112,1107,5,2800,2411,389,0.93164569629563,0.589622641509434,1.77235363485017,744,361,383,4,1.1,71.57,6.2,0,0,0,0,0,0,0.00393736297734986,2.05797477242633,0.427180501547163
8.7,"max_tuv_SVM","SVM",7,28,1012,1007,5,2900,2511,389,0.931763350354831,0.589622641509434,1.77398413497422,746,362,384,2,1.1,74.13,6.5,0,0,0,0,0,0,0.00378425637931274,1.66345015386219,0.390697264818444
8.7,"max_tuv_SVM","SVM",7,29,912,907,5,3000,2611,389,0.932227204864092,0.589622641509434,1.76910160983209,751,364,387,5,1.1,76.69,6.7,0,0,0,0,0,0,0.00278792016756764,1.0621826939191,0.304038554438767
8.7,"max_tuv_SVM","SVM",7,30,812,808,4,3100,2710,390,0.93243140903581,0.589622641509434,1.77235363485017,757,367,390,6,1.1,79.24,6.9,0,0,0,0,0,0,0.00231850155394688,0.759216041723068,0.257509445672538
8.7,"max_tuv_SVM","SVM",7,31,712,708,4,3200,2810,390,0.932504435693245,0.589622641509434,1.7707261292167,756,367,389,-1,1.1,81.8,7.2,0,0,0,0,0,0,0.00162991886619345,0.476269826078906,0.193962426205871
8.7,"max_tuv_SVM","SVM",7,32,612,610,2,3300,2908,392,0.932523368530359,0.589622641509434,1.77235363485017,761,370,391,5,1.1,84.36,7.4,0,0,0,0,0,0,0.00122003249969864,0.386461019657652,0.163066306750718
8.7,"max_tuv_SVM","SVM",7,33,512,511,1,3400,3007,393,0.932485502856134,0.589622641509434,1.77398413497422,766,373,393,5,1.1,86.91,7.7,0,0,0,0,0,0,0.000904586947055704,0.287033108897045,0.119398926356464
8.7,"max_tuv_SVM","SVM",7,34,412,412,0,3500,3106,394,0.932766790721807,0.584905660377358,1.77398413497422,772,377,395,6,1,89.47,7.9,0,0,0,0,0,0,0.000689966131227459,0.208880626954293,0.0847820127359057
8.7,"max_tuv_SVM","SVM",7,35,312,312,0,3600,3206,394,0.93313868573652,0.584905660377358,1.77235363485017,773,379,394,1,1,92.02,8.1,0,0,0,0,0,0,0.000482517187364916,0.123291260831902,0.058174973133046
8.7,"max_tuv_SVM","SVM",7,36,212,212,0,3700,3306,394,0.933012917604271,0.589622641509434,1.77398413497422,778,381,397,5,1,94.58,8.4,0,0,0,0,0,0,0.000322146449285342,0.0650873503128297,0.0397615348005287
8.7,"max_tuv_SVM","SVM",7,37,112,112,0,3800,3406,394,0.933112991171867,0.589622641509434,1.77725415181289,776,381,395,-2,1,97.14,8.6,0,0,0,0,0,0,8.87360768278524e-05,0.0159458319195242,0.0150194078556123
8.7,"max_tuv_SVM","SVM",7,38,12,12,0,3900,3506,394,0.933253635104705,0.589622641509434,1.78575776019477,780,381,399,4,1,99.69,8.9,0,0,0,0,0,0,6.67806201487654e-05,0.000983064644266569,0.000983064644266569
8.7,"max_tuv_SVM","SVM",7,39,0,0,0,3912,3518,394,0.933130571663472,0.589622641509434,1.78411341603252,780,381,399,0,1,100,8.9,0,0,0,0,0,0,0,0,0
8.7,"max_tuv_SVM","SVM",8,0,3812,3428,384,100,89,11,0.908722280313421,0.578199052132701,1.7600454277415,32,11,21,0,1.9,2.56,8.1,0,0,0,0,0,0,0.290900071072158,386.018460423964,33.7053799950705
8.7,"max_tuv_SVM","SVM",8,1,3712,3401,311,200,116,84,0.908515867950399,0.568720379146919,1.71101797814422,102,53,49,70,0.9,5.11,1.4,0,0,0,0,0,0,0.670390434081587,392.755408894926,75.6976493915822
8.7,"max_tuv_SVM","SVM",8,2,3612,3340,272,300,177,123,0.906495199554585,0.601895734597156,1.75150151789809,196,98,98,94,1,7.67,1.4,0,0,0,0,0,0,0.588055409927598,307.546020246963,71.5371362189669
8.7,"max_tuv_SVM","SVM",8,3,3512,3292,220,400,225,175,0.893992313855425,0.606635071090047,1.72111095623083,287,143,144,91,1,10.22,1.3,0,0,0,0,0,0,0.477255094196972,301.000282469773,70.200768863674
8.7,"max_tuv_SVM","SVM",8,4,3412,3232,180,500,285,215,0.906997650701386,0.616113744075829,1.73020037030131,361,177,184,74,1,12.78,1.3,0,0,0,0,0,0,0.24997960611108,212.59847330072,63.1077514939276
8.7,"max_tuv_SVM","SVM",8,5,3312,3183,129,600,334,266,0.909602248808376,0.630331753554502,1.74295760805469,437,215,222,76,1,15.34,1.3,0,0,0,0,0,0,0.150640364476179,182.234240671016,42.1276189870665
8.7,"max_tuv_SVM","SVM",8,6,3212,3100,112,700,417,283,0.902266462064937,0.649289099526066,1.66299698722952,480,227,253,43,1.1,17.89,1.5,0,0,0,0,0,0,0.106435452997715,163.819578329087,33.3802965897389
8.7,"max_tuv_SVM","SVM",8,7,3112,3026,86,800,491,309,0.892994201442173,0.639810426540284,1.63741241819522,522,245,277,42,1.1,20.45,1.6,0,0,0,0,0,0,0.0812198326263864,156.301222829132,24.6113634737899
8.7,"max_tuv_SVM","SVM",8,8,3012,2943,69,900,574,326,0.900406034845672,0.644549763033175,1.64594060787332,562,266,296,40,1.1,23.01,1.8,0,0,0,0,0,0,0.0814883115239184,139.911926360589,20.1871691832862
8.7,"max_tuv_SVM","SVM",8,9,2912,2846,66,1000,671,329,0.908423525577487,0.635071090047393,1.68858155626382,574,274,300,12,1.1,25.56,2,0,0,0,0,0,0,0.0734031158012863,112.099059185175,19.1491122488231
8.7,"max_tuv_SVM","SVM",8,10,2812,2754,58,1100,763,337,0.913602846317853,0.635071090047393,1.72586978836788,585,283,302,11,1.1,28.12,2.3,0,0,0,0,0,0,0.0547606564119562,74.0158259983927,12.2207503493128
8.7,"max_tuv_SVM","SVM",8,11,2712,2669,43,1200,848,352,0.920956286750236,0.635071090047393,1.74135267471394,605,291,314,20,1.1,30.67,2.4,0,0,0,0,0,0,0.059324564423768,70.291730474509,6.53008619341075
8.7,"max_tuv_SVM","SVM",8,12,2612,2576,36,1300,941,359,0.926799657790041,0.639810426540284,1.75680707368862,625,301,324,20,1.1,33.23,2.6,0,0,0,0,0,0,0.061211689433869,65.8086675234295,6.76356459467933
8.7,"max_tuv_SVM","SVM",8,13,2512,2479,33,1400,1038,362,0.927269517511112,0.639810426540284,1.75680707368862,635,305,330,10,1.1,35.79,2.9,0,0,0,0,0,0,0.0470868695738461,48.929961900186,5.23354170269614
8.7,"max_tuv_SVM","SVM",8,14,2412,2383,29,1500,1134,366,0.929112291041441,0.635071090047393,1.75519236130471,644,310,334,9,1.1,38.34,3.1,0,0,0,0,0,0,0.0417133591695834,43.7170657377084,4.8011383913241
8.7,"max_tuv_SVM","SVM",8,15,2312,2293,19,1600,1224,376,0.929800784910167,0.639810426540284,1.75150151789809,673,321,352,29,1.1,40.9,3.3,0,0,0,0,0,0,0.0425778787004813,45.5223642179041,5.24966264352043
8.7,"max_tuv_SVM","SVM",8,16,2212,2199,13,1700,1318,382,0.929469438748487,0.635071090047393,1.74827888401052,691,329,362,18,1.1,43.46,3.5,0,0,0,0,0,0,0.0357554691968832,40.7193193811843,4.20412833110351
8.7,"max_tuv_SVM","SVM",8,17,2112,2099,13,1800,1418,382,0.929446353155255,0.635071090047393,1.74988871723705,690,331,359,-1,1.1,46.01,3.7,0,0,0,0,0,0,0.0276496861370396,30.6984267042074,3.01008703977779
8.7,"max_tuv_SVM","SVM",8,18,2012,2000,12,1900,1517,383,0.929980037751736,0.635071090047393,1.74988871723705,699,334,365,9,1.1,48.57,4,0,0,0,0,0,0,0.0242044474485631,27.2472777681354,2.62826974790276
8.7,"max_tuv_SVM","SVM",8,19,1912,1904,8,2000,1613,387,0.929564497073562,0.635071090047393,1.75150151789809,709,340,369,10,1.1,51.12,4.2,0,0,0,0,0,0,0.0222908397898061,24.0882342129389,2.33212001143865
8.7,"max_tuv_SVM","SVM",8,20,1812,1805,7,2100,1712,388,0.929444995179178,0.625592417061611,1.7685893375849,721,350,371,12,1.1,53.68,4.4,0,0,0,0,0,0,0.015418997190423,14.0979818114201,1.86771550222587
8.7,"max_tuv_SVM","SVM",8,21,1712,1705,7,2200,1812,388,0.929567213025699,0.625592417061611,1.76696080228326,720,349,371,-1,1.1,56.24,4.7,0,0,0,0,0,0,0.0127447007112769,12.3394461573473,1.33289806805321
8.7,"max_tuv_SVM","SVM",8,22,1612,1606,6,2300,1911,389,0.930371134860605,0.62085308056872,1.76533526336672,733,358,375,13,1,58.79,4.9,0,0,0,0,0,0,0.00919982134216588,7.59480043454869,1.16201975702846
8.7,"max_tuv_SVM","SVM",8,23,1512,1507,5,2400,2010,390,0.930429527831721,0.62085308056872,1.76371271257318,735,358,377,2,1.1,61.35,5.2,0,0,0,0,0,0,0.0082885761898389,7.16548529676774,0.896045638622561
8.7,"max_tuv_SVM","SVM",8,24,1412,1408,4,2500,2109,391,0.930178302258318,0.616113744075829,1.76533526336672,739,362,377,4,1,63.91,5.4,0,0,0,0,0,0,0.0081756003147893,6.34418769748165,0.835533496109535
8.7,"max_tuv_SVM","SVM",8,25,1312,1308,4,2600,2209,391,0.931764418310956,0.62085308056872,1.76533526336672,760,372,388,21,1,66.46,5.6,0,0,0,0,0,0,0.00564066326785292,3.84268833744125,0.685489819017072
8.7,"max_tuv_SVM","SVM",8,26,1212,1208,4,2700,2309,391,0.931716889148421,0.62085308056872,1.76696080228326,761,371,390,1,1.1,69.02,5.9,0,0,0,0,0,0,0.00449592332440939,3.04822776378089,0.479896392573507
8.7,"max_tuv_SVM","SVM",8,27,1112,1108,4,2800,2409,391,0.931867624492459,0.62085308056872,1.76696080228326,765,375,390,4,1,71.57,6.2,0,0,0,0,0,0,0.00392898024596458,2.39046886258619,0.406775021016441
8.7,"max_tuv_SVM","SVM",8,28,1012,1009,3,2900,2508,392,0.932133787802651,0.625592417061611,1.76696080228326,771,378,393,6,1,74.13,6.4,0,0,0,0,0,0,0.00369632642574762,2.06187507048396,0.388462965169424
8.7,"max_tuv_SVM","SVM",8,29,912,909,3,3000,2608,392,0.932082184711894,0.625592417061611,1.7685893375849,771,378,393,0,1,76.69,6.7,0,0,0,0,0,0,0.00301856289347782,1.48626037284174,0.318406876456241
8.7,"max_tuv_SVM","SVM",8,30,812,809,3,3100,2708,392,0.932010211980053,0.62085308056872,1.76371271257318,771,378,393,0,1,79.24,6.9,0,0,0,0,0,0,0.00217135140632168,0.952000535197445,0.234788243028151
8.7,"max_tuv_SVM","SVM",8,31,712,710,2,3200,2807,393,0.932056383166519,0.62085308056872,1.76696080228326,776,379,397,5,1,81.8,7.1,0,0,0,0,0,0,0.0020628311434354,0.853570442893093,0.229286767714998
8.7,"max_tuv_SVM","SVM",8,32,612,610,2,3300,2907,393,0.932143293635156,0.62085308056872,1.76696080228326,776,380,396,0,1,84.36,7.4,0,0,0,0,0,0,0.0016222188204831,0.588828311953961,0.179124035792253
8.7,"max_tuv_SVM","SVM",8,33,512,511,1,3400,3006,394,0.93214193565909,0.616113744075829,1.76533526336672,780,382,398,4,1,86.91,7.6,0,0,0,0,0,0,0.00165864026930493,0.569705766772016,0.187133690269268
8.7,"max_tuv_SVM","SVM",8,34,412,412,0,3500,3105,395,0.932068604951185,0.62085308056872,1.76533526336672,781,384,397,1,1,89.47,7.9,0,0,0,0,0,0,0.00132945057569181,0.405569203274708,0.155731702440303
8.7,"max_tuv_SVM","SVM",8,35,312,312,0,3600,3205,395,0.932473281820772,0.62085308056872,1.77713324742831,789,386,403,8,1,92.02,8.1,0,0,0,0,0,0,0.000905343891016368,0.232381445858837,0.109959264554662
8.7,"max_tuv_SVM","SVM",8,36,212,212,0,3700,3305,395,0.932660682518773,0.62085308056872,1.77386345304482,791,386,405,2,1,94.58,8.4,0,0,0,0,0,0,0.00054841667023449,0.117290911349574,0.070674837599868
8.7,"max_tuv_SVM","SVM",8,37,112,112,0,3800,3405,395,0.93298388082402,0.62085308056872,1.77713324742831,793,386,407,2,1.1,97.14,8.6,0,0,0,0,0,0,0.000302204550985255,0.0448705105572833,0.0415799843371851
8.7,"max_tuv_SVM","SVM",8,38,12,12,0,3900,3505,395,0.933135974144135,0.616113744075829,1.77223306384165,796,388,408,3,1.1,99.69,8.9,0,0,0,0,0,0,0.000161586387228936,0.00289729490807813,0.00289729490807813
8.7,"max_tuv_SVM","SVM",8,39,0,0,0,3912,3517,395,0.933106098670541,0.616113744075829,1.76898126005478,799,389,410,3,1.1,100,8.9,0,0,0,0,0,0,0,0,0
8.7,"max_tuv_SVM","SVM",9,0,3812,3417,395,100,91,9,0.907555008636557,0.569306930693069,1.74029292330155,26,9,17,0,1.9,2.56,10.1,0,0,0,0,0,0,0.2185421421063,294.060743148403,23.4529229963418
8.7,"max_tuv_SVM","SVM",9,1,3712,3391,321,200,117,83,0.919825406143815,0.569306930693069,1.77672813152875,92,46,46,66,1,5.11,1.4,0,0,0,0,0,0,0.628424995371959,264.938163771793,76.9381830721159
8.7,"max_tuv_SVM","SVM",9,2,3612,3338,274,300,170,130,0.916939498967002,0.613861386138614,1.74687193994125,180,91,89,88,1,7.67,1.3,0,0,0,0,0,0,0.614925958766621,298.177876557013,75.3690793969751
8.7,"max_tuv_SVM","SVM",9,3,3512,3272,240,400,236,164,0.905074116305601,0.618811881188119,1.72659435061153,269,133,136,89,1,10.22,1.4,0,0,0,0,0,0,0.453065458235156,314.470148901344,65.4720060010144
8.7,"max_tuv_SVM","SVM",9,4,3412,3222,190,500,286,214,0.905548280027554,0.648514851485149,1.68944167143987,355,174,181,86,1,12.78,1.3,0,0,0,0,0,0,0.207440758422327,176.452393293801,53.4501534023278
8.7,"max_tuv_SVM","SVM",9,5,3312,3173,139,600,335,265,0.903205685448816,0.663366336633663,1.66582564420195,423,208,215,68,1,15.34,1.3,0,0,0,0,0,0,0.140224046667706,150.989149985104,33.3230121784407
8.7,"max_tuv_SVM","SVM",9,6,3212,3106,106,700,402,298,0.906386533750288,0.668316831683168,1.65971812579975,491,237,254,68,1.1,17.89,1.3,0,0,0,0,0,0,0.123467537814618,171.097516259548,27.9942072107451
8.7,"max_tuv_SVM","SVM",9,7,3112,3033,79,800,475,325,0.905954706074938,0.673267326732673,1.65387447835693,547,263,284,56,1.1,20.45,1.5,0,0,0,0,0,0,0.109475685664321,192.27141735675,23.9298818429672
8.7,"max_tuv_SVM","SVM",9,8,3012,2942,70,900,566,334,0.908150535692109,0.673267326732673,1.655394583576,558,272,286,11,1.1,23.01,1.7,0,0,0,0,0,0,0.078413487345038,137.85140849977,18.1363235499851
8.7,"max_tuv_SVM","SVM",9,9,2912,2852,60,1000,656,344,0.913178646827047,0.678217821782178,1.66706560765967,589,282,307,31,1.1,25.56,1.9,0,0,0,0,0,0,0.073973628113601,125.654838021992,14.0312874380281
8.7,"max_tuv_SVM","SVM",9,10,2812,2755,57,1100,753,347,0.930614042019948,0.653465346534653,1.72659435061153,624,306,318,35,1,28.12,2.2,0,0,0,0,0,0,0.0616547652379816,64.3181694416028,13.7731749622598
8.7,"max_tuv_SVM","SVM",9,11,2712,2670,42,1200,838,362,0.936213689784034,0.658415841584158,1.74599907092825,643,314,329,19,1,30.67,2.3,0,0,0,0,0,0,0.0523799174069729,58.2576920710168,6.03308292991376
8.7,"max_tuv_SVM","SVM",9,12,2612,2576,36,1300,932,368,0.936519920521132,0.663366336633663,1.73869044363,659,320,339,16,1.1,33.23,2.5,0,0,0,0,0,0,0.0547596133714945,58.1202062661252,6.33230229239647
8.7,"max_tuv_SVM","SVM",9,13,2512,2478,34,1400,1030,370,0.938722806146068,0.658415841584158,1.76381538797854,666,323,343,7,1.1,35.79,2.8,0,0,0,0,0,0,0.0463514424451986,43.6484107375594,5.18606198184977
8.7,"max_tuv_SVM","SVM",9,14,2412,2382,30,1500,1126,374,0.939580816690574,0.663366336633663,1.77109420500874,678,328,350,12,1.1,38.34,3,0,0,0,0,0,0,0.0488346297285079,40.2969230042952,5.41339108420345
8.7,"max_tuv_SVM","SVM",9,15,2312,2286,26,1600,1222,378,0.93888227192162,0.668316831683168,1.7621942341293,695,334,361,17,1.1,40.9,3.2,0,0,0,0,0,0,0.0441962033899266,32.4513956660895,5.15720377342252
8.7,"max_tuv_SVM","SVM",9,16,2212,2195,17,1700,1313,387,0.938923196766669,0.673267326732673,1.76706666058311,711,344,367,16,1.1,43.46,3.4,0,0,0,0,0,0,0.0384679603974424,30.7019801061429,5.28646127661308
8.7,"max_tuv_SVM","SVM",9,17,2112,2098,14,1800,1410,390,0.939379014868433,0.673267326732673,1.76543952737815,718,348,370,7,1.1,46.01,3.6,0,0,0,0,0,0,0.0279463509866842,26.7112219497473,3.4488902107695
8.7,"max_tuv_SVM","SVM",9,18,2012,2000,12,1900,1508,392,0.940441649638182,0.668316831683168,1.77109420500874,723,351,372,5,1.1,48.57,3.8,0,0,0,0,0,0,0.0218953590368252,22.1106334684325,2.43205995867233
8.7,"max_tuv_SVM","SVM",9,19,1912,1900,12,2000,1608,392,0.940091671652925,0.668316831683168,1.7694678558765,725,352,373,2,1.1,51.12,4.1,0,0,0,0,0,0,0.0200235637838554,19.1368152504235,2.05608678326507
8.7,"max_tuv_SVM","SVM",9,20,1812,1800,12,2100,1708,392,0.938513948316163,0.648514851485149,1.77599123967696,743,360,383,18,1.1,53.68,4.4,0,0,0,0,0,0,0.0131309194331506,10.6756512404626,1.66566878847908
8.7,"max_tuv_SVM","SVM",9,21,1712,1704,8,2200,1804,396,0.939448163744547,0.653465346534653,1.78163170502883,757,365,392,14,1.1,56.24,4.6,0,0,0,0,0,0,0.0116217285642723,10.0001190089334,1.24095108893971
8.7,"max_tuv_SVM","SVM",9,22,1612,1604,8,2300,1904,396,0.938883683123166,0.648514851485149,1.77835965414723,757,368,389,0,1.1,58.79,4.8,0,0,0,0,0,0,0.00942029823948211,7.64934986707856,1.00413487812719
8.7,"max_tuv_SVM","SVM",9,23,1512,1504,8,2400,2004,396,0.938722806146072,0.653465346534653,1.78491581877082,758,370,388,1,1,61.35,5.1,0,0,0,0,0,0,0.00744150997931157,5.5643438702134,0.782345067842617
8.7,"max_tuv_SVM","SVM",9,24,1412,1404,8,2500,2104,396,0.938779254208209,0.653465346534653,1.77835965414723,765,375,390,7,1,63.91,5.3,0,0,0,0,0,0,0.00616541136125508,4.29014184682217,0.650527605505377
8.7,"max_tuv_SVM","SVM",9,25,1312,1306,6,2600,2202,398,0.938762319789568,0.648514851485149,1.77999417588818,769,377,392,4,1,66.46,5.5,0,0,0,0,0,0,0.00631367825956146,4.08084771829825,0.682108619437527
8.7,"max_tuv_SVM","SVM",9,26,1212,1206,6,2700,2302,398,0.938553461959658,0.648514851485149,1.77835965414723,778,379,399,9,1.1,69.02,5.8,0,0,0,0,0,0,0.00513366072152585,3.03044784129421,0.549398124465439
8.7,"max_tuv_SVM","SVM",9,27,1112,1106,6,2800,2402,398,0.938386940176351,0.648514851485149,1.78163170502883,779,379,400,1,1.1,71.57,6,0,0,0,0,0,0,0.00443750462484152,2.25338852851015,0.459244583705701
8.7,"max_tuv_SVM","SVM",9,28,1012,1006,6,2900,2502,398,0.938121634284302,0.648514851485149,1.77835965414723,777,381,396,-2,1,74.13,6.3,0,0,0,0,0,0,0.00371103278869715,1.66508779152292,0.397392037218355
8.7,"max_tuv_SVM","SVM",9,29,912,907,5,3000,2601,399,0.938234530408578,0.648514851485149,1.77835965414723,781,382,399,4,1,76.69,6.5,0,0,0,0,0,0,0.00360311628901968,1.48185625502862,0.392183773981661
8.7,"max_tuv_SVM","SVM",9,30,812,808,4,3100,2700,400,0.938353071339068,0.653465346534653,1.78163170502883,785,385,400,4,1,79.24,6.8,0,0,0,0,0,0,0.00334984352234402,1.25729191965838,0.368526628002044
8.7,"max_tuv_SVM","SVM",9,31,712,708,4,3200,2800,400,0.938288156067609,0.648514851485149,1.77672813152875,786,385,401,1,1,81.8,7,0,0,0,0,0,0,0.00216435017769553,0.708468664406414,0.239991253907139
8.7,"max_tuv_SVM","SVM",9,32,612,609,3,3300,2899,401,0.93841516420742,0.648514851485149,1.77999417588818,791,385,406,5,1.1,84.36,7.2,0,0,0,0,0,0,0.00184805679945335,0.560611919910562,0.219392684842346
8.7,"max_tuv_SVM","SVM",9,33,512,509,3,3400,2999,401,0.938652246068399,0.648514851485149,1.77835965414723,792,386,406,1,1.1,86.91,7.5,0,0,0,0,0,0,0.000997723063310186,0.319494499452317,0.134179984316647
8.7,"max_tuv_SVM","SVM",9,34,412,409,3,3500,3099,401,0.938736918161606,0.648514851485149,1.78163170502883,796,387,409,4,1.1,89.47,7.7,0,0,0,0,0,0,0.000714010352658143,0.208928592864253,0.0902137780735161
8.7,"max_tuv_SVM","SVM",9,35,312,312,0,3600,3196,404,0.939772740101838,0.653465346534653,1.79053986355397,807,396,411,11,1,92.02,7.9,0,0,0,0,0,0,0.000980260196287573,0.249847880094007,0.124483292452152
8.7,"max_tuv_SVM","SVM",9,36,212,212,0,3700,3296,404,0.940039457195439,0.653465346534653,1.78889414676762,814,396,418,7,1.1,94.58,8.2,0,0,0,0,0,0,0.000535412944991895,0.114504671882561,0.0722021368241588
8.7,"max_tuv_SVM","SVM",9,37,112,112,0,3800,3396,404,0.940213034986513,0.653465346534653,1.79053986355397,814,397,417,0,1.1,97.14,8.4,0,0,0,0,0,0,0.000258147672882982,0.0418435870130976,0.039033390884388
8.7,"max_tuv_SVM","SVM",9,38,12,12,0,3900,3496,404,0.940317463901469,0.653465346534653,1.78725145241797,812,397,415,-2,1,99.69,8.7,0,0,0,0,0,0,0.000172190537890758,0.00258611302254672,0.00258611302254672
8.7,"max_tuv_SVM","SVM",9,39,0,0,0,3912,3508,404,0.940369678358946,0.653465346534653,1.78889414676762,813,397,416,1,1,100,8.7,0,0,0,0,0,0,0,0,0
8.7,"max_tuv_SVM","SVM",10,0,3812,3411,401,100,89,11,0.897027159858188,0.541237113402062,1.67580850162406,28,11,17,0,1.5,2.56,8.1,0,0,0,0,0,0,0.535637693659268,405.021371525579,58.2543814328756
8.7,"max_tuv_SVM","SVM",10,1,3712,3391,321,200,109,91,0.906533402763973,0.551546391752577,1.74219223771983,73,38,35,45,0.9,5.11,1.2,0,0,0,0,0,0,0.736038089743572,271.272341760028,84.5958757068409
8.7,"max_tuv_SVM","SVM",10,2,3612,3333,279,300,167,133,0.929642978339991,0.618556701030928,1.7841797710105,169,84,85,96,1,7.67,1.3,0,0,0,0,0,0,0.70585049909767,252.212770489787,83.0473855265152
8.7,"max_tuv_SVM","SVM",10,3,3512,3270,242,400,230,170,0.895938893244561,0.603092783505155,1.67578313595183,260,129,131,91,1,10.22,1.4,0,0,0,0,0,0,0.600440748051977,210.798173545076,77.8492752370997
8.7,"max_tuv_SVM","SVM",10,4,3412,3217,195,500,283,217,0.881740231929496,0.628865979381443,1.64952243784112,346,170,176,86,1,12.78,1.3,0,0,0,0,0,0,0.414294530115872,217.664047958437,72.3287894995845
8.7,"max_tuv_SVM","SVM",10,5,3312,3148,164,600,352,248,0.890112863779437,0.634020618556701,1.67112832488466,400,194,206,54,1.1,15.34,1.4,0,0,0,0,0,0,0.186316135931609,136.976218963803,58.4154376988275
8.7,"max_tuv_SVM","SVM",10,6,3212,3075,137,700,425,275,0.895245562095549,0.644329896907217,1.66959094832083,445,215,230,45,1.1,17.89,1.5,0,0,0,0,0,0,0.0951252934901299,89.0205085741728,37.2323737467212
8.7,"max_tuv_SVM","SVM",10,7,3112,3017,95,800,483,317,0.895748739131956,0.649484536082474,1.65408332937432,502,239,263,57,1.1,20.45,1.5,0,0,0,0,0,0,0.0742036361504211,83.1735948346816,18.8189455713545
8.7,"max_tuv_SVM","SVM",10,8,3012,2940,72,900,560,340,0.890930526463596,0.654639175257732,1.64176443251548,547,262,285,45,1.1,23.01,1.6,0,0,0,0,0,0,0.0634653693731699,88.5715634857958,11.1164580243433
8.7,"max_tuv_SVM","SVM",10,9,2912,2851,61,1000,649,351,0.894458616614197,0.65979381443299,1.65103993778393,572,274,298,25,1.1,25.56,1.8,0,0,0,0,0,0,0.051609810065151,70.5518204173397,5.83359469109532
8.7,"max_tuv_SVM","SVM",10,10,2812,2755,57,1100,745,355,0.898457703874461,0.654639175257732,1.6618442786353,576,282,294,4,1,28.12,2.1,0,0,0,0,0,0,0.0445375523903194,57.6837306767863,4.94601343944246
8.7,"max_tuv_SVM","SVM",10,11,2712,2656,56,1200,844,356,0.897275822928485,0.65979381443299,1.67266853532234,586,284,302,10,1.1,30.67,2.4,0,0,0,0,0,0,0.0368489962582069,45.3524740801206,4.08155588905955
8.7,"max_tuv_SVM","SVM",10,12,2612,2561,51,1300,939,361,0.906104824648646,0.654639175257732,1.67112832488466,607,295,312,21,1.1,33.23,2.6,0,0,0,0,0,0,0.0311521817169151,35.8475394857175,3.55873542790312
8.7,"max_tuv_SVM","SVM",10,13,2512,2467,45,1400,1033,367,0.917395590764946,0.65979381443299,1.7082645098821,627,303,324,20,1.1,35.79,2.8,0,0,0,0,0,0,0.0332138706333314,42.6931301872392,3.80167851067124
8.7,"max_tuv_SVM","SVM",10,14,2412,2376,36,1500,1124,376,0.93724914284377,0.644329896907217,1.73740160828522,674,331,343,47,1,38.34,3,0,0,0,0,0,0,0.0451000095139919,41.7443848374572,5.38960370998843
8.7,"max_tuv_SVM","SVM",10,15,2312,2284,28,1600,1216,384,0.945395052482536,0.639175257731959,1.79449541284404,702,343,359,28,1,40.9,3.2,0,0,0,0,0,0,0.0654549527686954,45.1942085063348,7.63290882642903
8.7,"max_tuv_SVM","SVM",10,16,2212,2185,27,1700,1315,385,0.944613957896954,0.634020618556701,1.79779411764706,713,348,365,11,1,43.46,3.4,0,0,0,0,0,0,0.0490957919990618,32.5560396279158,5.41263778322721
8.7,"max_tuv_SVM","SVM",10,17,2112,2087,25,1800,1413,387,0.944188305229531,0.628865979381443,1.80276497695853,717,350,367,4,1,46.01,3.7,0,0,0,0,0,0,0.0405188671461379,25.949755339184,4.6417085962726
8.7,"max_tuv_SVM","SVM",10,18,2012,1992,20,1900,1508,392,0.943626619235405,0.623711340206186,1.80276497695853,731,356,375,14,1.1,48.57,3.8,0,0,0,0,0,0,0.0395142436407079,22.2645642555692,4.80526283213832
8.7,"max_tuv_SVM","SVM",10,19,1912,1896,16,2000,1604,396,0.943636858303006,0.628865979381443,1.80110497237569,740,362,378,9,1,51.12,4.1,0,0,0,0,0,0,0.0287204357849093,18.9636459940148,3.69829472281601
8.7,"max_tuv_SVM","SVM",10,20,1812,1801,11,2100,1699,401,0.942877704576573,0.628865979381443,1.79944802207912,753,367,386,13,1.1,53.68,4.2,0,0,0,0,0,0,0.0215566002773984,16.2381320986911,2.6188449359559
8.7,"max_tuv_SVM","SVM",10,21,1712,1701,11,2200,1799,401,0.942851375545599,0.634020618556701,1.79614325068871,754,367,387,1,1.1,56.24,4.5,0,0,0,0,0,0,0.0156800652715802,12.4501440110077,1.7536175577614
8.7,"max_tuv_SVM","SVM",10,22,1612,1603,9,2300,1897,403,0.943053231449738,0.634020618556701,1.79779411764706,762,370,392,8,1.1,58.79,4.7,0,0,0,0,0,0,0.0137639011892297,11.5308206492543,1.49879518087394
8.7,"max_tuv_SVM","SVM",10,23,1512,1504,8,2400,1996,404,0.943111740407459,0.634020618556701,1.80276497695853,766,371,395,4,1.1,61.35,4.9,0,0,0,0,0,0,0.0116266545526221,8.98754637434461,1.18474771597121
8.7,"max_tuv_SVM","SVM",10,24,1412,1404,8,2500,2096,404,0.942705103151294,0.634020618556701,1.80110497237569,784,380,404,18,1.1,63.91,5.2,0,0,0,0,0,0,0.0082864421752463,5.5046926641714,1.00337461922196
8.7,"max_tuv_SVM","SVM",10,25,1312,1304,8,2600,2196,404,0.942669997776662,0.634020618556701,1.80110497237569,784,380,404,0,1.1,66.46,5.4,0,0,0,0,0,0,0.00685406035543511,4.76422133095456,0.751048346018326
8.7,"max_tuv_SVM","SVM",10,26,1212,1204,8,2700,2296,404,0.942708028599181,0.634020618556701,1.79944802207912,784,380,404,0,1.1,69.02,5.7,0,0,0,0,0,0,0.00606408448795158,3.68263978610158,0.615378012627652
8.7,"max_tuv_SVM","SVM",10,27,1112,1104,8,2800,2396,404,0.942623190610483,0.634020618556701,1.79944802207912,789,383,406,5,1.1,71.57,5.9,0,0,0,0,0,0,0.00475945009631204,2.68725363115346,0.526214719799052
8.7,"max_tuv_SVM","SVM",10,28,1012,1005,7,2900,2495,405,0.942494470903496,0.634020618556701,1.79944802207912,790,385,405,1,1.1,74.13,6.2,0,0,0,0,0,0,0.00457376774729999,2.17415693561647,0.466717743962166
8.7,"max_tuv_SVM","SVM",10,29,912,906,6,3000,2594,406,0.942247270557124,0.623711340206186,1.80110497237569,794,389,405,4,1,76.69,6.4,0,0,0,0,0,0,0.00430894734998445,1.87953331788656,0.470633910000185
8.7,"max_tuv_SVM","SVM",10,30,812,806,6,3100,2694,406,0.942450589185206,0.628865979381443,1.79944802207912,798,389,409,4,1.1,79.24,6.6,0,0,0,0,0,0,0.00350114924371626,1.28610939683081,0.377894149404687
8.7,"max_tuv_SVM","SVM",10,31,712,707,5,3200,2793,407,0.942462290976751,0.623711340206186,1.80276497695853,805,394,411,7,1,81.8,6.9,0,0,0,0,0,0,0.00365433554339481,1.18311665947533,0.404470680237498
8.7,"max_tuv_SVM","SVM",10,32,612,608,4,3300,2892,408,0.942523725382359,0.618556701030928,1.80276497695853,811,394,417,6,1.1,84.36,7.1,0,0,0,0,0,0,0.00276439305983383,0.807599410846341,0.321999201737345
8.7,"max_tuv_SVM","SVM",10,33,512,508,4,3400,2992,408,0.942719730390725,0.623711340206186,1.80110497237569,813,394,419,2,1.1,86.91,7.3,0,0,0,0,0,0,0.00159689533730163,0.455803213298894,0.207888724746438
8.7,"max_tuv_SVM","SVM",10,34,412,411,1,3500,3089,411,0.942785552968162,0.623711340206186,1.80110497237569,822,399,423,9,1.1,89.47,7.5,0,0,0,0,0,0,0.00142534904544058,0.422492507059483,0.181125116301486
8.7,"max_tuv_SVM","SVM",10,35,312,312,0,3600,3188,412,0.942684625016093,0.623711340206186,1.80276497695853,825,402,423,3,1.1,92.02,7.7,0,0,0,0,0,0,0.00095498523979735,0.237245335870892,0.117252636879547
8.7,"max_tuv_SVM","SVM",10,36,212,212,0,3700,3288,412,0.942671460500606,0.623711340206186,1.80110497237569,830,404,426,5,1.1,94.58,8,0,0,0,0,0,0,0.000529782848629423,0.10991140859764,0.0693120344682683
8.7,"max_tuv_SVM","SVM",10,37,112,112,0,3800,3388,412,0.942731432182271,0.623711340206186,1.79944802207912,834,404,430,4,1.1,97.14,8.2,0,0,0,0,0,0,0.000245099098955931,0.0406956135792187,0.0381037942477867
8.7,"max_tuv_SVM","SVM",10,38,12,12,0,3900,3488,412,0.942690475911866,0.623711340206186,1.80276497695853,835,405,430,1,1.1,99.69,8.5,0,0,0,0,0,0,0.000148051954155697,0.00207551734073836,0.00207551734073836
8.7,"max_tuv_SVM","SVM",10,39,0,0,0,3912,3500,412,0.94270217770341,0.623711340206186,1.80276497695853,834,405,429,-1,1.1,100,8.5,0,0,0,0,0,0,0,0,0
8.7,"max_tuv_SVM","SVM",11,0,3812,3410,402,100,94,6,0.898734213580625,0.55050505050505,1.7026113671275,17,6,11,0,1.8,2.56,15.7,0,0,0,0,0,0,0.198603767043443,202.592988885481,22.2717265784433
8.7,"max_tuv_SVM","SVM",11,1,3712,3372,340,200,132,68,0.905488330403002,0.565656565656566,1.71765493016643,97,50,47,80,0.9,5.11,1.9,0,0,0,0,0,0,0.602648563265744,222.064408245567,72.5382234890041
8.7,"max_tuv_SVM","SVM",11,2,3612,3328,284,300,176,124,0.906413394467986,0.580808080808081,1.73903086161151,183,93,90,86,1,7.67,1.4,0,0,0,0,0,0,0.642089624310665,248.599942551653,76.0708030850673
8.7,"max_tuv_SVM","SVM",11,3,3512,3277,235,400,227,173,0.872881258546779,0.590909090909091,1.68285060550254,261,130,131,78,1,10.22,1.3,0,0,0,0,0,0,0.479922432713589,244.452775706276,74.0071794365427
8.7,"max_tuv_SVM","SVM",11,4,3412,3225,187,500,279,221,0.883709104698855,0.611111111111111,1.67529674626449,353,176,177,92,1,12.78,1.3,0,0,0,0,0,0,0.298741706743342,217.224390692085,66.42075655756
8.7,"max_tuv_SVM","SVM",11,5,3312,3165,147,600,339,261,0.885131175233545,0.611111111111111,1.66312620222464,435,211,224,82,1.1,15.34,1.3,0,0,0,0,0,0,0.185813371635499,148.342365377951,57.0552730215406
8.7,"max_tuv_SVM","SVM",11,6,3212,3089,123,700,415,285,0.887031578584486,0.626262626262626,1.63736815670517,477,232,245,42,1.1,17.89,1.5,0,0,0,0,0,0,0.118913743978059,124.485247142526,45.0308023524438
8.7,"max_tuv_SVM","SVM",11,7,3112,3025,87,800,479,321,0.888406246768028,0.646464646464647,1.64646464646465,516,249,267,39,1.1,20.45,1.5,0,0,0,0,0,0,0.07547302594811,99.6653295974125,25.1986726177056
8.7,"max_tuv_SVM","SVM",11,8,3012,2941,71,900,563,337,0.893090460923221,0.651515151515151,1.64646464646465,548,265,283,32,1.1,23.01,1.7,0,0,0,0,0,0,0.0639790365312085,91.5329939653959,16.9703272719781
8.7,"max_tuv_SVM","SVM",11,9,2912,2854,58,1000,650,350,0.891718665609455,0.661616161616162,1.63736815670517,573,273,300,25,1.1,25.56,1.9,0,0,0,0,0,0,0.0601304685820697,94.7338145891285,11.95226069201
8.7,"max_tuv_SVM","SVM",11,10,2812,2756,56,1100,748,352,0.898245825720226,0.651515151515151,1.64798212540148,585,277,308,12,1.1,28.12,2.1,0,0,0,0,0,0,0.0465679945383988,70.1654058080446,9.50894409171684
8.7,"max_tuv_SVM","SVM",11,11,2712,2662,50,1200,842,358,0.900535502924583,0.641414141414141,1.65251782531194,592,282,310,7,1.1,30.67,2.4,0,0,0,0,0,0,0.0391929905973044,59.1423922387646,6.05318523824553
8.7,"max_tuv_SVM","SVM",11,12,2612,2567,45,1300,937,363,0.899958056101402,0.641414141414141,1.65556113622412,604,290,314,12,1.1,33.23,2.6,0,0,0,0,0,0,0.0409117911037459,53.1931130320719,4.72857568648265
8.7,"max_tuv_SVM","SVM",11,13,2512,2468,44,1400,1036,364,0.904658071040321,0.636363636363636,1.67529674626449,605,291,314,1,1.1,35.79,2.8,0,0,0,0,0,0,0.0311991048420596,41.3915864011756,3.43215940821732
8.7,"max_tuv_SVM","SVM",11,14,2412,2371,41,1500,1133,367,0.922084899047353,0.631313131313131,1.7208211143695,634,308,326,29,1.1,38.34,3.1,0,0,0,0,0,0,0.0266828574353876,27.7326120122743,3.18265939594616
8.7,"max_tuv_SVM","SVM",11,15,2312,2275,37,1600,1229,371,0.925693223474804,0.636363636363636,1.72674305149006,646,312,334,12,1.1,40.9,3.3,0,0,0,0,0,0,0.0269586911846208,31.4095831024052,3.29420233791624
8.7,"max_tuv_SVM","SVM",11,16,2212,2181,31,1700,1323,377,0.930792567311327,0.636363636363636,1.77218365810822,663,323,340,17,1.1,43.46,3.5,0,0,0,0,0,0,0.0502853202206487,34.3760601732109,5.95873338231629
8.7,"max_tuv_SVM","SVM",11,17,2112,2083,29,1800,1421,379,0.931470564576356,0.636363636363636,1.76406926406926,676,330,346,13,1,46.01,3.7,0,0,0,0,0,0,0.0379632304690531,26.0341103202622,4.38441788177497
8.7,"max_tuv_SVM","SVM",11,18,2012,1986,26,1900,1518,382,0.93091035497178,0.636363636363636,1.77218365810822,690,337,353,14,1,48.57,4,0,0,0,0,0,0,0.0344233325109582,22.0390115164114,3.96968817686997
8.7,"max_tuv_SVM","SVM",11,19,1912,1895,17,2000,1609,391,0.928734156123228,0.631313131313131,1.77055481283422,714,346,368,24,1.1,51.12,4.1,0,0,0,0,0,0,0.0403263121919691,21.5483284577738,5.13720251092204
8.7,"max_tuv_SVM","SVM",11,20,1812,1801,11,2100,1703,397,0.928261569046546,0.626262626262626,1.7689289590116,729,352,377,15,1.1,53.68,4.3,0,0,0,0,0,0,0.0273101075662817,17.1973995267183,3.9224225482993
8.7,"max_tuv_SVM","SVM",11,21,1712,1703,9,2200,1801,399,0.928617804897663,0.626262626262626,1.76730608840701,736,355,381,7,1.1,56.24,4.5,0,0,0,0,0,0,0.0184715532665186,13.6137319758171,2.24085269213871
8.7,"max_tuv_SVM","SVM",11,22,1612,1603,9,2300,1901,399,0.928577584720924,0.621212121212121,1.76568619281727,737,356,381,1,1.1,58.79,4.8,0,0,0,0,0,0,0.0133286746963576,10.2187940433952,1.48625198125891
8.7,"max_tuv_SVM","SVM",11,23,1512,1504,8,2400,2000,400,0.929109065627832,0.626262626262626,1.77218365810822,741,358,383,4,1.1,61.35,5,0,0,0,0,0,0,0.0100266316810735,7.74387344446411,1.08573743179684
8.7,"max_tuv_SVM","SVM",11,24,1412,1406,6,2500,2098,402,0.930044184737011,0.626262626262626,1.77381550309727,745,361,384,4,1.1,63.91,5.2,0,0,0,0,0,0,0.00945932356004135,7.55977573443319,1.03025046877866
8.7,"max_tuv_SVM","SVM",11,25,1312,1307,5,2600,2197,403,0.93048373381137,0.631313131313131,1.77055481283422,751,364,387,6,1.1,66.46,5.5,0,0,0,0,0,0,0.00842554698489877,6.5602651353585,0.89535884842002
8.7,"max_tuv_SVM","SVM",11,26,1212,1207,5,2700,2297,403,0.930801185920632,0.626262626262626,1.77218365810822,755,366,389,4,1.1,69.02,5.7,0,0,0,0,0,0,0.00647566257896159,4.44681093357502,0.666010254503146
8.7,"max_tuv_SVM","SVM",11,27,1112,1107,5,2800,2397,403,0.931407361441487,0.626262626262626,1.7689289590116,769,375,394,14,1.1,71.57,5.9,0,0,0,0,0,0,0.00544395387931049,3.4052274547786,0.651451824468389
8.7,"max_tuv_SVM","SVM",11,28,1012,1008,4,2900,2496,404,0.931329793957777,0.626262626262626,1.77055481283422,769,374,395,0,1.1,74.13,6.2,0,0,0,0,0,0,0.00460825963334473,2.52117086934844,0.470812713770688
8.7,"max_tuv_SVM","SVM",11,29,912,908,4,3000,2596,404,0.93212270601349,0.611111111111111,1.77218365810822,775,381,394,6,1,76.69,6.4,0,0,0,0,0,0,0.00328010131731613,1.65455001920143,0.379822192912056
8.7,"max_tuv_SVM","SVM",11,30,812,809,3,3100,2695,405,0.931660173980993,0.606060606060606,1.77218365810822,784,384,400,9,1,79.24,6.7,0,0,0,0,0,0,0.00354643055245425,1.48777738966756,0.364650967446052
8.7,"max_tuv_SVM","SVM",11,31,712,709,3,3200,2795,405,0.931796635294928,0.601010101010101,1.77055481283422,787,385,402,3,1,81.8,6.9,0,0,0,0,0,0,0.00261363387530204,0.946812489282177,0.289503235541445
8.7,"max_tuv_SVM","SVM",11,32,612,610,2,3300,2894,406,0.931950333827464,0.601010101010101,1.77218365810822,791,386,405,4,1,84.36,7.1,0,0,0,0,0,0,0.00277280704905648,0.811315157299123,0.295394410252098
8.7,"max_tuv_SVM","SVM",11,33,512,510,2,3400,2994,406,0.931976189655367,0.595959595959596,1.77055481283422,800,391,409,9,1,86.91,7.4,0,0,0,0,0,0,0.00171350411969082,0.467715495290181,0.220254583931178
8.7,"max_tuv_SVM","SVM",11,34,412,410,2,3500,3094,406,0.93214425253674,0.601010101010101,1.77381550309727,801,391,410,1,1,89.47,7.6,0,0,0,0,0,0,0.000753117356611925,0.234250045840211,0.116321550065815
8.7,"max_tuv_SVM","SVM",11,35,312,312,0,3600,3192,408,0.932879707197108,0.601010101010101,1.78291199285674,810,394,416,9,1.1,92.02,7.8,0,0,0,0,0,0,0.000858789053344701,0.219131086000296,0.110418783799652
8.7,"max_tuv_SVM","SVM",11,36,212,212,0,3700,3292,408,0.933225888004039,0.590909090909091,1.78455522971652,811,395,416,1,1.1,94.58,8.1,0,0,0,0,0,0,0.000466260961003596,0.0982002672227278,0.0614412234362909
8.7,"max_tuv_SVM","SVM",11,37,112,112,0,3800,3392,408,0.933724330908625,0.590909090909091,1.78291199285674,810,397,413,-1,1,97.14,8.3,0,0,0,0,0,0,0.000177065821201344,0.0286918681284965,0.0268214912222048
8.7,"max_tuv_SVM","SVM",11,38,12,12,0,3900,3492,408,0.934234265292279,0.590909090909091,1.78127177943185,812,398,414,2,1,99.69,8.6,0,0,0,0,0,0,0.000134198120238703,0.00197798075618417,0.00197798075618417
8.7,"max_tuv_SVM","SVM",11,39,0,0,0,3912,3504,408,0.934258684685299,0.595959595959596,1.78291199285674,812,398,414,0,1,100,8.6,0,0,0,0,0,0,0,0,0
8.7,"max_tuv_SVM","SVM",12,0,3812,3429,383,100,83,17,0.886604715672676,0.519417475728155,1.67817134321989,40,17,23,0,1.4,2.56,4.9,0,0,0,0,0,0,0.755082958750557,602.92772327674,80.8889930204038
8.7,"max_tuv_SVM","SVM",12,1,3712,3385,327,200,127,73,0.922359223300966,0.616504854368932,1.74864560424824,115,58,57,75,1,5.11,1.7,0,0,0,0,0,0,0.684099987978378,440.748355692824,76.9476778654406
8.7,"max_tuv_SVM","SVM",12,2,3612,3324,288,300,188,112,0.904900138696258,0.62621359223301,1.70492946414204,209,103,106,94,1,7.67,1.7,0,0,0,0,0,0,0.557101896336147,468.398960646652,67.9818213745407
8.7,"max_tuv_SVM","SVM",12,3,3512,3272,240,400,240,160,0.898671289875183,0.655339805825243,1.66995655205707,296,146,150,87,1,10.22,1.5,0,0,0,0,0,0,0.488259830116539,412.026515492194,65.7246612511093
8.7,"max_tuv_SVM","SVM",12,4,3412,3209,203,500,303,197,0.885450762829393,0.660194174757282,1.68024696881571,349,171,178,53,1,12.78,1.5,0,0,0,0,0,0,0.284647651469799,296.840135939666,60.8439515140919
8.7,"max_tuv_SVM","SVM",12,5,3312,3146,166,600,366,234,0.900843273231614,0.679611650485437,1.67715543805432,418,201,217,69,1.1,15.34,1.6,0,0,0,0,0,0,0.1511171819009,161.949531507149,49.8058520583299
8.7,"max_tuv_SVM","SVM",12,6,3212,3079,133,700,433,267,0.908811373092917,0.689320388349515,1.68744300809955,466,224,242,48,1.1,17.89,1.6,0,0,0,0,0,0,0.103515535227062,125.401625384974,39.6240720066055
8.7,"max_tuv_SVM","SVM",12,7,3112,3009,103,800,503,297,0.903264909847418,0.70873786407767,1.67869978007831,517,246,271,51,1.1,20.45,1.7,0,0,0,0,0,0,0.0922430081396984,156.679222188686,32.8577828006769
8.7,"max_tuv_SVM","SVM",12,8,3012,2923,89,900,589,311,0.908958391123421,0.694174757281553,1.67869978007831,556,264,292,39,1.1,23.01,1.9,0,0,0,0,0,0,0.0709289604951304,123.737995804573,26.762918104831
8.7,"max_tuv_SVM","SVM",12,9,2912,2840,72,1000,672,328,0.916271844660179,0.694174757281553,1.68899825511163,584,279,305,28,1.1,25.56,2,0,0,0,0,0,0,0.0617897946780931,102.239684509592,17.321135480951
8.7,"max_tuv_SVM","SVM",12,10,2812,2747,65,1100,765,335,0.921764216366143,0.689320388349515,1.69306824671616,593,287,306,9,1.1,28.12,2.3,0,0,0,0,0,0,0.0581199510876734,88.4425797794194,14.5393889155492
8.7,"max_tuv_SVM","SVM",12,11,2712,2656,56,1200,856,344,0.933647711511798,0.674757281553398,1.73115914820576,626,303,323,33,1.1,30.67,2.5,0,0,0,0,0,0,0.0613167349429179,82.2921123988188,14.8098432738962
8.7,"max_tuv_SVM","SVM",12,12,2612,2565,47,1300,947,353,0.939117891816932,0.674757281553398,1.7367040262707,651,312,339,25,1.1,33.23,2.7,0,0,0,0,0,0,0.0620822987560318,79.0082567476033,13.1031637138855
8.7,"max_tuv_SVM","SVM",12,13,2512,2472,40,1400,1040,360,0.944540915395297,0.674757281553398,1.77651111807078,666,320,346,15,1.1,35.79,2.9,0,0,0,0,0,0,0.0563872507833565,62.8883297650895,11.518968189385
8.7,"max_tuv_SVM","SVM",12,14,2412,2377,35,1500,1135,365,0.945151178918181,0.674757281553398,1.77651111807078,677,325,352,11,1.1,38.34,3.1,0,0,0,0,0,0,0.0546209911783703,58.793445382434,10.4578245399157
8.7,"max_tuv_SVM","SVM",12,15,2312,2280,32,1600,1232,368,0.945625520110969,0.679611650485437,1.77651111807078,689,330,359,12,1.1,40.9,3.3,0,0,0,0,0,0,0.0497077575278872,51.5175683077722,10.1019389423361
8.7,"max_tuv_SVM","SVM",12,16,2212,2186,26,1700,1326,374,0.946210818307915,0.679611650485437,1.77651111807078,705,336,369,16,1.1,43.46,3.5,0,0,0,0,0,0,0.0409224461498932,41.4089644184012,8.4653073224968
8.7,"max_tuv_SVM","SVM",12,17,2112,2092,20,1800,1420,380,0.947281553398068,0.674757281553398,1.77487528831197,715,342,373,10,1.1,46.01,3.7,0,0,0,0,0,0,0.0376060723690383,42.0782773922983,7.90662493480227
8.7,"max_tuv_SVM","SVM",12,18,2012,1995,17,1900,1517,383,0.947570041608887,0.679611650485437,1.77161264991433,721,344,377,6,1.1,48.57,4,0,0,0,0,0,0,0.0291442518793122,33.1225320383829,5.95360543247522
8.7,"max_tuv_SVM","SVM",12,19,1912,1896,16,2000,1616,384,0.947736477115126,0.674757281553398,1.77324246835952,729,349,380,8,1.1,51.12,4.2,0,0,0,0,0,0,0.028998413439413,30.8228461335629,5.77346075284778
8.7,"max_tuv_SVM","SVM",12,20,1812,1798,14,2100,1714,386,0.948481276005549,0.674757281553398,1.78361851633321,746,363,383,17,1.1,53.68,4.4,0,0,0,0,0,0,0.0194970451469708,13.1213955352707,3.4991815639073
8.7,"max_tuv_SVM","SVM",12,21,1712,1702,10,2200,1810,390,0.94909570041609,0.669902912621359,1.78033980582524,754,366,388,8,1.1,56.24,4.6,0,0,0,0,0,0,0.0134624982491264,10.0066772639983,1.63708799833896
8.7,"max_tuv_SVM","SVM",12,22,1612,1604,8,2300,1908,392,0.949398058252429,0.679611650485437,1.78526240436669,760,368,392,6,1.1,58.79,4.9,0,0,0,0,0,0,0.0107604443894694,8.93282575334119,1.21411951197771
8.7,"max_tuv_SVM","SVM",12,23,1512,1505,7,2400,2007,393,0.949700416088767,0.679611650485437,1.78526240436669,763,369,394,3,1.1,61.35,5.1,0,0,0,0,0,0,0.0101436984762601,7.92892053222181,1.04360576301613
8.7,"max_tuv_SVM","SVM",12,24,1412,1407,5,2500,2105,395,0.949298196948675,0.679611650485437,1.78526240436669,782,380,402,19,1.1,63.91,5.3,0,0,0,0,0,0,0.00797986821272915,6.14949901926595,0.954028581796327
8.7,"max_tuv_SVM","SVM",12,25,1312,1308,4,2600,2204,396,0.949081830790559,0.684466019417476,1.78526240436669,785,382,403,3,1.1,66.46,5.6,0,0,0,0,0,0,0.00814088744103913,5.5752423384099,0.830443863955516
8.7,"max_tuv_SVM","SVM",12,26,1212,1208,4,2700,2304,396,0.948854368932011,0.674757281553398,1.77544427931977,795,386,409,10,1.1,69.02,5.8,0,0,0,0,0,0,0.00567383011464709,3.47201866911163,0.658011356014816
8.7,"max_tuv_SVM","SVM",12,27,1112,1108,4,2800,2404,396,0.948932038834924,0.674757281553398,1.78361851633321,795,385,410,0,1.1,71.57,6.1,0,0,0,0,0,0,0.00501857024807818,2.83603272667685,0.520977687000073
8.7,"max_tuv_SVM","SVM",12,28,1012,1008,4,2900,2504,396,0.948809986130347,0.679611650485437,1.77870496670144,795,387,408,0,1.1,74.13,6.3,0,0,0,0,0,0,0.00458646040883874,2.29716749055204,0.479569703024
8.7,"max_tuv_SVM","SVM",12,29,912,908,4,3000,2604,396,0.948693481275978,0.674757281553398,1.78033980582524,796,388,408,1,1.1,76.69,6.6,0,0,0,0,0,0,0.00365698868984375,1.60010141987966,0.388780777970491
8.7,"max_tuv_SVM","SVM",12,30,812,808,4,3100,2704,396,0.948651872399418,0.679611650485437,1.77870496670144,796,389,407,0,1,79.24,6.8,0,0,0,0,0,0,0.00265985045337907,0.979224661554134,0.287079806847277
8.7,"max_tuv_SVM","SVM",12,31,712,708,4,3200,2804,396,0.948680998613011,0.674757281553398,1.78033980582524,797,389,408,1,1,81.8,7.1,0,0,0,0,0,0,0.00242744490818868,0.781315519490857,0.271061547792585
8.7,"max_tuv_SVM","SVM",12,32,612,611,1,3300,2901,399,0.948699029126187,0.684466019417476,1.78361851633321,807,393,414,10,1.1,84.36,7.3,0,0,0,0,0,0,0.00188957585439685,0.585005703819553,0.230700919879852
8.7,"max_tuv_SVM","SVM",12,33,512,511,1,3400,3001,399,0.948768377253788,0.684466019417476,1.78033980582524,807,393,414,0,1.1,86.91,7.5,0,0,0,0,0,0,0.00108773073010478,0.347279703201124,0.149064283191763
8.7,"max_tuv_SVM","SVM",12,34,412,412,0,3500,3100,400,0.948746185852957,0.689320388349515,1.78033980582524,809,395,414,2,1,89.47,7.8,0,0,0,0,0,0,0.00100871406359916,0.293874111011122,0.123576876200952
8.7,"max_tuv_SVM","SVM",12,35,312,312,0,3600,3200,400,0.948735090152541,0.689320388349515,1.77870496670144,810,396,414,1,1,92.02,8,0,0,0,0,0,0,0.000726970854598714,0.17627742074534,0.0879230513515715
8.7,"max_tuv_SVM","SVM",12,36,212,212,0,3700,3300,400,0.94876837725379,0.684466019417476,1.78033980582524,813,397,416,3,1,94.58,8.2,0,0,0,0,0,0,0.000296842037040227,0.0632855453966989,0.0405344779692751
8.7,"max_tuv_SVM","SVM",12,37,112,112,0,3800,3400,400,0.948538141470156,0.684466019417476,1.77707312728244,818,399,419,5,1.1,97.14,8.5,0,0,0,0,0,0,0.000102190779886951,0.018503548773694,0.0173913834498842
8.7,"max_tuv_SVM","SVM",12,38,12,12,0,3900,3500,400,0.948413314840475,0.669902912621359,1.77870496670144,820,400,420,2,1.1,99.69,8.8,0,0,0,0,0,0,7.35054607185004e-05,0.00103991632769253,0.00103991632769253
8.7,"max_tuv_SVM","SVM",12,39,0,0,0,3912,3512,400,0.948327323162251,0.669902912621359,1.77870496670144,820,400,420,0,1.1,100,8.8,0,0,0,0,0,0,0,0,0
8.7,"max_tuv_SVM","SVM",13,0,3812,3427,385,100,90,10,0.875036325859933,0.507109004739337,1.74295760805469,24,10,14,0,1.4,2.56,9,0,0,0,0,0,0,0.369456367874115,345.579456557964,41.32063982017
8.7,"max_tuv_SVM","SVM",13,1,3712,3371,341,200,146,54,0.887503904181201,0.511848341232227,1.6754293664942,113,54,59,89,1.1,5.11,2.7,0,0,0,0,0,0,0.660337426530411,440.108242784953,71.5240754928279
8.7,"max_tuv_SVM","SVM",13,2,3612,3329,283,300,188,112,0.876418745501696,0.597156398104265,1.6399059951955,185,94,91,72,1,7.67,1.7,0,0,0,0,0,0,0.648013552155142,305.773134464376,77.2519678961675
8.7,"max_tuv_SVM","SVM",13,3,3512,3270,242,400,247,153,0.8808674751151,0.62085308056872,1.66452829200597,270,136,134,85,1,10.22,1.6,0,0,0,0,0,0,0.592683964776078,272.059572317567,74.3982069836843
8.7,"max_tuv_SVM","SVM",13,4,3412,3232,180,500,285,215,0.882067925963141,0.639810426540284,1.65994281461752,365,181,184,95,1,12.78,1.3,0,0,0,0,0,0,0.31296957942053,253.432270424371,66.6134010023811
8.7,"max_tuv_SVM","SVM",13,5,3312,3167,145,600,350,250,0.878871250288571,0.644549763033175,1.63038412191354,441,215,226,76,1.1,15.34,1.4,0,0,0,0,0,0,0.191472379104232,203.284069092836,56.9211301598045
8.7,"max_tuv_SVM","SVM",13,6,3212,3095,117,700,422,278,0.889940113255213,0.654028436018957,1.64991521370494,488,237,251,47,1.1,17.89,1.5,0,0,0,0,0,0,0.12575995019361,150.518181553109,38.8616553375831
8.7,"max_tuv_SVM","SVM",13,7,3112,3021,91,800,496,304,0.884267847200531,0.682464454976303,1.62035603883902,522,250,272,34,1.1,20.45,1.6,0,0,0,0,0,0,0.101799479335403,157.789850894722,30.0144711855455
8.7,"max_tuv_SVM","SVM",13,8,3012,2941,71,900,576,324,0.882499762354179,0.682464454976303,1.61331203686732,563,266,297,41,1.1,23.01,1.8,0,0,0,0,0,0,0.0781479584813984,138.37859231157,21.7766758561617
8.7,"max_tuv_SVM","SVM",13,9,2912,2845,67,1000,672,328,0.895131655780229,0.677725118483412,1.64043068993382,574,276,298,11,1.1,25.56,2,0,0,0,0,0,0,0.0516635738083128,81.942209960638,18.2743589183302
8.7,"max_tuv_SVM","SVM",13,10,2812,2756,56,1100,761,339,0.90568856176754,0.677725118483412,1.68315023915085,583,280,303,9,1.1,28.12,2.2,0,0,0,0,0,0,0.0508227805446848,83.1044867783795,11.8539841690046
8.7,"max_tuv_SVM","SVM",13,11,2712,2664,48,1200,853,347,0.91928461820503,0.672985781990521,1.6986724620984,600,288,312,17,1.1,30.67,2.5,0,0,0,0,0,0,0.0462001528447483,72.129723635927,9.15914876512524
8.7,"max_tuv_SVM","SVM",13,12,2612,2570,42,1300,947,353,0.925419954100406,0.658767772511848,1.69554990242543,635,302,333,35,1.1,33.23,2.7,0,0,0,0,0,0,0.0538629994772313,66.144311145502,9.69925393275592
8.7,"max_tuv_SVM","SVM",13,13,2512,2475,37,1400,1042,358,0.929371664471265,0.663507109004739,1.72586978836788,648,311,337,13,1.1,35.79,2.9,0,0,0,0,0,0,0.0482316131301258,56.2621329791225,8.04204036698565
8.7,"max_tuv_SVM","SVM",13,14,2412,2378,34,1500,1139,361,0.931568869756504,0.658767772511848,1.74988871723705,658,315,343,10,1.1,38.34,3.2,0,0,0,0,0,0,0.0447692548896343,49.4793539854333,7.66378899421067
8.7,"max_tuv_SVM","SVM",13,15,2312,2282,30,1600,1235,365,0.9315688697565,0.663507109004739,1.75150151789809,661,321,340,3,1.1,40.9,3.4,0,0,0,0,0,0,0.0397247441199814,42.3901650148677,7.35824867606674
8.7,"max_tuv_SVM","SVM",13,16,2212,2189,23,1700,1328,372,0.929806216814444,0.658767772511848,1.7600454277415,682,326,356,21,1.1,43.46,3.6,0,0,0,0,0,0,0.0398389747988397,38.7642023736,6.81382168957028
8.7,"max_tuv_SVM","SVM",13,17,2112,2094,18,1800,1423,377,0.930061516316067,0.658767772511848,1.7600454277415,696,333,363,14,1.1,46.01,3.8,0,0,0,0,0,0,0.0350981680612466,35.3233266996095,5.90486091215389
8.7,"max_tuv_SVM","SVM",13,18,2012,1996,16,1900,1521,379,0.930515080324268,0.654028436018957,1.75680707368862,705,337,368,9,1.1,48.57,4,0,0,0,0,0,0,0.0277166910559208,28.3719288737302,4.88730013622132
8.7,"max_tuv_SVM","SVM",13,19,1912,1898,14,2000,1619,381,0.930544955797862,0.654028436018957,1.75842475976015,703,336,367,-2,1.1,51.12,4.2,0,0,0,0,0,0,0.0218058446609508,21.3679083057415,2.38793549002769
8.7,"max_tuv_SVM","SVM",13,20,1812,1800,12,2100,1717,383,0.930941484811022,0.654028436018957,1.75680707368862,709,338,371,6,1.1,53.68,4.5,0,0,0,0,0,0,0.0205280447198051,19.0009650934572,2.10644452660353
8.7,"max_tuv_SVM","SVM",13,21,1712,1701,11,2200,1816,384,0.931270115020564,0.625592417061611,1.78239164272292,731,353,378,22,1.1,56.24,4.7,0,0,0,0,0,0,0.0145665698816254,9.33743799271546,1.93704540666108
8.7,"max_tuv_SVM","SVM",13,22,1612,1603,9,2300,1914,386,0.931981694482521,0.630331753554502,1.77386345304482,736,356,380,5,1.1,58.79,5,0,0,0,0,0,0,0.0104416490443043,7.92707894012878,1.25329433872864
8.7,"max_tuv_SVM","SVM",13,23,1512,1503,9,2400,2014,386,0.931894784013883,0.630331753554502,1.77386345304482,734,356,378,-2,1.1,61.35,5.2,0,0,0,0,0,0,0.00798237726499353,6.335127699235,0.887991470102908
8.7,"max_tuv_SVM","SVM",13,24,1412,1406,6,2500,2111,389,0.932082184711882,0.630331753554502,1.77911819617981,744,362,382,10,1.1,63.91,5.4,0,0,0,0,0,0,0.00895165244366174,6.16202679412998,0.920440169205016
8.7,"max_tuv_SVM","SVM",13,25,1312,1306,6,2600,2211,389,0.932579203954405,0.625592417061611,1.78075341511012,756,368,388,12,1.1,66.46,5.7,0,0,0,0,0,0,0.00585997190229891,3.87323082277105,0.703898606234586
8.7,"max_tuv_SVM","SVM",13,26,1212,1207,5,2700,2310,390,0.932717717513796,0.625592417061611,1.7774859776512,759,370,389,3,1.1,69.02,5.9,0,0,0,0,0,0,0.00567596564804953,3.39314801356141,0.589724662126642
8.7,"max_tuv_SVM","SVM",13,27,1112,1107,5,2800,2410,390,0.93269191596842,0.62085308056872,1.78075341511012,764,371,393,5,1.1,71.57,6.2,0,0,0,0,0,0,0.00392595358433615,2.15264812570587,0.43253887524958
8.7,"max_tuv_SVM","SVM",13,28,1012,1007,5,2900,2510,390,0.932644386805884,0.62085308056872,1.78239164272292,762,371,391,-2,1.1,74.13,6.4,0,0,0,0,0,0,0.00363446806426065,1.74459867156716,0.386495302195922
8.7,"max_tuv_SVM","SVM",13,29,912,907,5,3000,2610,390,0.933293499368521,0.62085308056872,1.78239164272292,770,376,394,8,1,76.69,6.7,0,0,0,0,0,0,0.00305032594591697,1.29805957064752,0.332281371157739
8.7,"max_tuv_SVM","SVM",13,30,812,809,3,3100,2708,392,0.933089802957653,0.625592417061611,1.79422106711512,776,380,396,6,1,79.24,6.9,0,0,0,0,0,0,0.00287607085550517,1.15874650674715,0.323279998453685
8.7,"max_tuv_SVM","SVM",13,31,712,710,2,3200,2807,393,0.932956721302552,0.625592417061611,1.79256892985258,780,382,398,4,1,81.8,7.1,0,0,0,0,0,0,0.00226019602356331,0.811773794466056,0.25058016495964
8.7,"max_tuv_SVM","SVM",13,32,612,610,2,3300,2907,393,0.932884748570712,0.625592417061611,1.78927376637859,778,382,396,-2,1,84.36,7.4,0,0,0,0,0,0,0.00180427419107771,0.595553770884611,0.211582796739741
8.7,"max_tuv_SVM","SVM",13,33,512,510,2,3400,3007,393,0.932896970355364,0.625592417061611,1.78599069524762,780,382,398,2,1,86.91,7.7,0,0,0,0,0,0,0.00128212129175411,0.403015736739043,0.161052596273576
8.7,"max_tuv_SVM","SVM",13,34,412,410,2,3500,3107,393,0.932989312728291,0.630331753554502,1.78435367352879,780,382,398,0,1,89.47,7.9,0,0,0,0,0,0,0.000705378095101974,0.205331986575895,0.0913196603959807
8.7,"max_tuv_SVM","SVM",13,35,312,312,0,3600,3205,395,0.933609907793407,0.630331753554502,1.78599069524762,785,386,399,5,1,92.02,8.1,0,0,0,0,0,0,0.000927091740911935,0.239455565052143,0.117050476818382
8.7,"max_tuv_SVM","SVM",13,36,212,212,0,3700,3305,395,0.933869281223248,0.635071090047393,1.79422106711512,789,388,401,4,1,94.58,8.4,0,0,0,0,0,0,0.000475731210439842,0.0964359441460527,0.0596975447503896
8.7,"max_tuv_SVM","SVM",13,37,112,112,0,3800,3405,395,0.934064829777685,0.635071090047393,1.78763072343426,794,389,405,5,1,97.14,8.6,0,0,0,0,0,0,0.00018765524449944,0.0311663592562636,0.0292312099992816
8.7,"max_tuv_SVM","SVM",13,38,12,12,0,3900,3505,395,0.934123222748802,0.635071090047393,1.78599069524762,795,390,405,1,1,99.69,8.9,0,0,0,0,0,0,0.000139206429588637,0.00208026330890346,0.00208026330890346
8.7,"max_tuv_SVM","SVM",13,39,0,0,0,3912,3517,395,0.934216923097802,0.635071090047393,1.78435367352879,795,390,405,0,1,100,8.9,0,0,0,0,0,0,0,0,0
8.7,"max_tuv_SVM","SVM",14,0,3812,3414,398,100,87,13,0.89815955386652,0.533333333333333,1.7636517328825,32,13,19,0,1.5,2.56,6.7,0,0,0,0,0,0,0.696650548181584,532.295199723732,75.8883714316644
8.7,"max_tuv_SVM","SVM",14,1,3712,3382,330,200,119,81,0.917366298286216,0.564102564102564,1.78693225965953,87,43,44,55,1,5.11,1.5,0,0,0,0,0,0,0.772075829509568,354.280206707232,84.9409807276272
8.7,"max_tuv_SVM","SVM",14,2,3612,3319,293,300,182,118,0.894748030693502,0.57948717948718,1.73325791855204,191,95,96,104,1,7.67,1.5,0,0,0,0,0,0,0.651794123911971,347.025912330903,74.0409211457639
8.7,"max_tuv_SVM","SVM",14,3,3512,3265,247,400,236,164,0.872415148735421,0.594871794871795,1.65180100488288,272,135,137,81,1,10.22,1.4,0,0,0,0,0,0,0.572538673995039,360.61447733929,71.5724239628777
8.7,"max_tuv_SVM","SVM",14,4,3412,3213,199,500,288,212,0.874427408669329,0.615384615384615,1.62711095356257,361,179,182,89,1,12.78,1.4,0,0,0,0,0,0,0.400329885433885,288.879024460092,70.8882005968244
8.7,"max_tuv_SVM","SVM",14,5,3312,3152,160,600,349,251,0.88412178395143,0.646153846153846,1.65180100488288,430,210,220,69,1,15.34,1.4,0,0,0,0,0,0,0.195297185581797,178.584571288263,57.3542049981591
8.7,"max_tuv_SVM","SVM",14,6,3212,3088,124,700,413,287,0.878871270694111,0.651282051282051,1.64876739422194,490,234,256,60,1.1,17.89,1.4,0,0,0,0,0,0,0.115591008791066,145.900619767662,39.7212845901489
8.7,"max_tuv_SVM","SVM",14,7,3112,3015,97,800,486,314,0.878830501317736,0.646153846153846,1.61786600496278,523,254,269,33,1.1,20.45,1.5,0,0,0,0,0,0,0.0809064968544793,129.543405942468,26.3743815241032
8.7,"max_tuv_SVM","SVM",14,8,3012,2939,73,900,562,338,0.878393686570868,0.656410256410256,1.62411718915859,570,275,295,47,1.1,23.01,1.7,0,0,0,0,0,0,0.0739241631163211,121.537485017541,19.1719335194123
8.7,"max_tuv_SVM","SVM",14,9,2912,2844,68,1000,657,343,0.888756388415686,0.651282051282051,1.65028280542986,585,282,303,15,1.1,25.56,1.9,0,0,0,0,0,0,0.0631881814964956,90.1897266194661,17.702312130698
8.7,"max_tuv_SVM","SVM",14,10,2812,2753,59,1100,748,352,0.889517902124377,0.646153846153846,1.63955640319277,591,285,306,6,1.1,28.12,2.1,0,0,0,0,0,0,0.050158760217765,69.4379665336217,11.0043013754064
8.7,"max_tuv_SVM","SVM",14,11,2712,2658,54,1200,843,357,0.894986822755143,0.641025641025641,1.63805222300635,602,291,311,11,1.1,30.67,2.4,0,0,0,0,0,0,0.04216761145477,53.5056014596478,7.20806767825371
8.7,"max_tuv_SVM","SVM",14,12,2612,2565,47,1300,936,364,0.911690618675279,0.641025641025641,1.66718937628029,633,307,326,31,1.1,33.23,2.6,0,0,0,0,0,0,0.0409974336594744,35.3288174001024,5.98999272906488
8.7,"max_tuv_SVM","SVM",14,13,2512,2470,42,1400,1031,369,0.914317331353101,0.641025641025641,1.68716063348416,641,311,330,8,1.1,35.79,2.8,0,0,0,0,0,0,0.0283218599902372,28.2473091139006,3.33934359350962
8.7,"max_tuv_SVM","SVM",14,14,2412,2375,37,1500,1126,374,0.917051791668476,0.646153846153846,1.68716063348416,658,319,339,17,1.1,38.34,3,0,0,0,0,0,0,0.0244029308387398,27.9112152443597,2.8057733110734
8.7,"max_tuv_SVM","SVM",14,15,2312,2284,28,1600,1217,383,0.921836369195808,0.635897435897436,1.71324433142615,685,334,351,27,1.1,40.9,3.2,0,0,0,0,0,0,0.058146526280158,43.5045333100672,8.20180538633983
8.7,"max_tuv_SVM","SVM",14,16,2212,2186,26,1700,1315,385,0.924946490193494,0.641025641025641,1.725624513481,694,339,355,9,1,43.46,3.4,0,0,0,0,0,0,0.0428501673619013,34.145264094769,4.87346219994384
8.7,"max_tuv_SVM","SVM",14,17,2112,2091,21,1800,1410,390,0.927535345593259,0.646153846153846,1.75330832920529,712,346,366,18,1.1,46.01,3.6,0,0,0,0,0,0,0.0396677709271541,29.1027465639212,4.51866638814727
8.7,"max_tuv_SVM","SVM",14,18,2012,1995,17,1900,1506,394,0.928242985483184,0.635897435897436,1.75008829554284,721,350,371,9,1.1,48.57,3.8,0,0,0,0,0,0,0.0380912420701751,25.5071366673159,4.46246022915343
8.7,"max_tuv_SVM","SVM",14,19,1912,1899,13,2000,1602,398,0.928344908924121,0.630769230769231,1.75008829554284,738,357,381,17,1.1,51.12,4,0,0,0,0,0,0,0.0323284933760722,21.2522239976965,3.98747952436478
8.7,"max_tuv_SVM","SVM",14,20,1812,1803,9,2100,1698,402,0.928078451928533,0.646153846153846,1.75492279359683,748,360,388,10,1.1,53.68,4.2,0,0,0,0,0,0,0.0213601391098594,17.16351351748,2.87173740792815
8.7,"max_tuv_SVM","SVM",14,21,1712,1706,6,2200,1795,405,0.927890621587381,0.635897435897436,1.7472952853598,755,364,391,7,1.1,56.24,4.4,0,0,0,0,0,0,0.0166902535899136,14.1408504596009,1.88937310819613
8.7,"max_tuv_SVM","SVM",14,22,1612,1606,6,2300,1895,405,0.928866174522047,0.630769230769231,1.75654023395959,761,367,394,6,1.1,58.79,4.7,0,0,0,0,0,0,0.0154677651630203,11.9274530610161,1.59836672379153
8.7,"max_tuv_SVM","SVM",14,23,1512,1506,6,2400,1995,405,0.930456180200645,0.620512820512821,1.75169683257919,773,376,397,12,1.1,61.35,4.9,0,0,0,0,0,0,0.0104183584215584,7.1239043875156,1.28328958483492
8.7,"max_tuv_SVM","SVM",14,24,1412,1409,3,2500,2092,408,0.930440163659927,0.635897435897436,1.7484827099506,778,380,398,5,1,63.91,5.1,0,0,0,0,0,0,0.0107630378905331,6.99490186298918,1.10870851589245
8.7,"max_tuv_SVM","SVM",14,25,1312,1309,3,2600,2192,408,0.931123050714192,0.625641025641026,1.75929928657201,784,383,401,6,1,66.46,5.4,0,0,0,0,0,0,0.00814976468521558,5.09757080254605,0.931871295104116
8.7,"max_tuv_SVM","SVM",14,26,1212,1209,3,2700,2292,408,0.931172556385503,0.625641025641026,1.75607417330607,784,383,401,0,1,69.02,5.6,0,0,0,0,0,0,0.00707694622761881,3.88798779859778,0.732156484568535
8.7,"max_tuv_SVM","SVM",14,27,1112,1109,3,2800,2392,408,0.931342914136779,0.625641025641026,1.75446604677374,789,387,402,5,1,71.57,5.9,0,0,0,0,0,0,0.00593691460177298,2.99231958102121,0.63272931381432
8.7,"max_tuv_SVM","SVM",14,28,1012,1009,3,2900,2492,408,0.931498711396493,0.625641025641026,1.75929928657201,788,387,401,-1,1,74.13,6.1,0,0,0,0,0,0,0.00505620416019985,2.20706048737984,0.530760772779184
8.7,"max_tuv_SVM","SVM",14,29,912,909,3,3000,2592,408,0.931507447691429,0.625641025641026,1.75286086283342,794,387,407,6,1.1,76.69,6.4,0,0,0,0,0,0,0.00458901252747447,1.79273217352978,0.495707774262598
8.7,"max_tuv_SVM","SVM",14,30,812,809,3,3100,2692,408,0.931731679261485,0.625641025641026,1.76253626778006,792,387,405,-2,1,79.24,6.6,0,0,0,0,0,0,0.00319424608737157,1.12267237208572,0.359307114394974
8.7,"max_tuv_SVM","SVM",14,31,712,709,3,3200,2792,408,0.931929701946731,0.625641025641026,1.76253626778006,794,387,407,2,1.1,81.8,6.8,0,0,0,0,0,0,0.00255432620567965,0.785973014335533,0.286568638567767
8.7,"max_tuv_SVM","SVM",14,32,612,609,3,3300,2892,408,0.931987943912979,0.625641025641026,1.7641592293526,793,387,406,-1,1,84.36,7.1,0,0,0,0,0,0,0.00168928732003302,0.517093881497592,0.210221118920192
8.7,"max_tuv_SVM","SVM",14,33,512,510,2,3400,2991,409,0.932121900435347,0.625641025641026,1.75929928657201,800,390,410,7,1.1,86.91,7.3,0,0,0,0,0,0,0.00118478499108197,0.367720672456406,0.151698435977554
8.7,"max_tuv_SVM","SVM",14,34,412,411,1,3500,3090,410,0.932466984085368,0.615384615384615,1.75768525052929,803,391,412,3,1.1,89.47,7.5,0,0,0,0,0,0,0.000946683593136909,0.281605133531129,0.116801297700738
8.7,"max_tuv_SVM","SVM",14,35,312,312,0,3600,3189,411,0.933183360270225,0.615384615384615,1.75768525052929,812,394,418,9,1.1,92.02,7.8,0,0,0,0,0,0,0.000675623299672486,0.172407971527621,0.0852527136290163
8.7,"max_tuv_SVM","SVM",14,36,212,212,0,3700,3289,411,0.93326635507213,0.615384615384615,1.7641592293526,814,395,419,2,1.1,94.58,8,0,0,0,0,0,0,0.000453988344380589,0.0922709826523366,0.057764109601002
8.7,"max_tuv_SVM","SVM",14,37,112,112,0,3800,3389,411,0.933219761499131,0.615384615384615,1.7641592293526,818,397,421,4,1.1,97.14,8.2,0,0,0,0,0,0,0.000163901776651106,0.0266087321185797,0.0248510154312039
8.7,"max_tuv_SVM","SVM",14,38,12,12,0,3900,3489,411,0.933407591840285,0.615384615384615,1.75768525052929,821,398,423,3,1.1,99.69,8.5,0,0,0,0,0,0,0.000141803977364187,0.00194444697968734,0.00194444697968734
8.7,"max_tuv_SVM","SVM",14,39,0,0,0,3912,3501,411,0.933457097511597,0.615384615384615,1.75768525052929,821,399,422,0,1.1,100,8.5,0,0,0,0,0,0,0,0,0
8.7,"max_tuv_SVM","SVM",15,0,3812,3411,401,100,88,12,0.912040533828636,0.575129533678757,1.76540197225472,29,12,17,0,1.4,2.56,7.3,0,0,0,0,0,0,0.368483395418629,434.906486859486,41.6095247714058
8.7,"max_tuv_SVM","SVM",15,1,3712,3372,340,200,127,73,0.915340960856284,0.595854922279793,1.7714773274354,95,47,48,66,1,5.11,1.7,0,0,0,0,0,0,0.671976395410229,423.451480427796,74.4586433922939
8.7,"max_tuv_SVM","SVM",15,2,3612,3302,310,300,197,103,0.864282796340427,0.564766839378238,1.60070797470703,175,85,90,80,1.1,7.67,1.9,0,0,0,0,0,0,0.651525694146501,360.443992441014,75.8158824872062
8.7,"max_tuv_SVM","SVM",15,3,3512,3254,258,400,245,155,0.869393608986089,0.616580310880829,1.6114942090826,258,127,131,83,1,10.22,1.6,0,0,0,0,0,0,0.515149522825074,287.487447686007,76.9782693767143
8.7,"max_tuv_SVM","SVM",15,4,3412,3203,209,500,296,204,0.907238309640592,0.652849740932642,1.72327415422127,348,170,178,90,1,12.78,1.5,0,0,0,0,0,0,0.294023445031422,249.279398774811,66.3083263612925
8.7,"max_tuv_SVM","SVM",15,5,3312,3151,161,600,348,252,0.900399401632297,0.678756476683938,1.64397220696736,412,202,210,64,1,15.34,1.4,0,0,0,0,0,0,0.158413313773347,194.153852744812,48.772769178664
8.7,"max_tuv_SVM","SVM",15,6,3212,3088,124,700,411,289,0.898821192091906,0.673575129533679,1.62230028933558,479,233,246,67,1.1,17.89,1.4,0,0,0,0,0,0,0.126549539266701,210.505009958678,33.9564073295823
8.7,"max_tuv_SVM","SVM",15,7,3112,3011,101,800,488,312,0.905948115994002,0.673575129533679,1.63943919536727,537,256,281,58,1.1,20.45,1.6,0,0,0,0,0,0,0.0972415667159512,171.870076767095,27.9072312045202
8.7,"max_tuv_SVM","SVM",15,8,3012,2928,84,900,571,329,0.914106607025836,0.673575129533679,1.68133521167116,566,274,292,29,1.1,23.01,1.7,0,0,0,0,0,0,0.0804129281889559,139.838437966507,22.3375532555435
8.7,"max_tuv_SVM","SVM",15,9,2912,2849,63,1000,650,350,0.920522308006561,0.673575129533679,1.65959454886053,600,286,314,34,1.1,25.56,1.9,0,0,0,0,0,0,0.0781701283629852,132.755241263927,14.2179719896222
8.7,"max_tuv_SVM","SVM",15,10,2812,2754,58,1100,745,355,0.929644770601224,0.66839378238342,1.73737971872687,618,299,319,18,1.1,28.12,2.1,0,0,0,0,0,0,0.0648297942295674,104.226350688917,13.3681390557017
8.7,"max_tuv_SVM","SVM",15,11,2712,2668,44,1200,831,369,0.933945905912846,0.663212435233161,1.75121914050594,640,309,331,22,1.1,30.67,2.3,0,0,0,0,0,0,0.0785186766122074,102.027701249214,9.93628478989899
8.7,"max_tuv_SVM","SVM",15,12,2612,2571,41,1300,928,372,0.93764162006003,0.66839378238342,1.75606122107877,651,316,335,11,1.1,33.23,2.5,0,0,0,0,0,0,0.0608399856744291,72.9805302498005,7.55099400532651
8.7,"max_tuv_SVM","SVM",15,13,2512,2479,33,1400,1020,380,0.942361553992709,0.673575129533679,1.78244067214382,672,326,346,21,1.1,35.79,2.7,0,0,0,0,0,0,0.0613244935476903,70.3956638247428,7.59268110627309
8.7,"max_tuv_SVM","SVM",15,14,2412,2385,27,1500,1114,386,0.942714226515688,0.66839378238342,1.78080089231664,693,335,358,21,1.1,38.34,2.9,0,0,0,0,0,0,0.0607128464372716,65.0666187988872,7.72040890189867
8.7,"max_tuv_SVM","SVM",15,15,2312,2292,20,1600,1207,393,0.944239535177621,0.66839378238342,1.7714773274354,715,341,374,22,1.1,40.9,3.1,0,0,0,0,0,0,0.0509237229568006,59.6316564881426,6.74075993438703
8.7,"max_tuv_SVM","SVM",15,16,2212,2196,16,1700,1303,397,0.944817036434014,0.66839378238342,1.76984913136239,723,345,378,8,1.1,43.46,3.3,0,0,0,0,0,0,0.0423721788668157,50.6542239009834,5.52500562369449
8.7,"max_tuv_SVM","SVM",15,17,2112,2098,14,1800,1401,399,0.944545184697539,0.673575129533679,1.77310852202788,730,347,383,7,1.1,46.01,3.5,0,0,0,0,0,0,0.0377233697325597,46.5996526945196,4.97235872114637
8.7,"max_tuv_SVM","SVM",15,18,2012,1999,13,1900,1500,400,0.943232949018246,0.673575129533679,1.76984913136239,728,349,379,-2,1.1,48.57,3.8,0,0,0,0,0,0,0.0317656863596432,34.8816753358335,3.27834237080317
8.7,"max_tuv_SVM","SVM",15,19,1912,1901,11,2000,1598,402,0.942073538098923,0.658031088082902,1.79614325068871,755,362,393,27,1.1,51.12,4,0,0,0,0,0,0,0.0226069680201158,19.8962835136012,2.87590067619085
8.7,"max_tuv_SVM","SVM",15,20,1812,1803,9,2100,1696,404,0.941936877496264,0.663212435233161,1.79779411764706,757,364,393,2,1.1,53.68,4.2,0,0,0,0,0,0,0.0182785926466238,18.4330522154186,2.06119578674998
8.7,"max_tuv_SVM","SVM",15,21,1712,1705,7,2200,1794,406,0.941177162102991,0.652849740932642,1.79285059578368,769,371,398,12,1.1,56.24,4.4,0,0,0,0,0,0,0.0160505291056813,15.4011685082725,1.68100279519947
8.7,"max_tuv_SVM","SVM",15,22,1612,1606,6,2300,1893,407,0.939928113584065,0.658031088082902,1.79614325068871,778,377,401,9,1.1,58.79,4.7,0,0,0,0,0,0,0.011820362391234,10.042358909374,1.35753850583999
8.7,"max_tuv_SVM","SVM",15,23,1512,1506,6,2400,1993,407,0.940001587026354,0.658031088082902,1.79779411764706,777,376,401,-1,1.1,61.35,4.9,0,0,0,0,0,0,0.0103130629369576,8.65451510033503,1.07227273325325
8.7,"max_tuv_SVM","SVM",15,24,1412,1406,6,2500,2093,407,0.939450536209183,0.647668393782383,1.79449541284404,787,384,403,10,1,63.91,5.1,0,0,0,0,0,0,0.00737616581846311,5.729606493944,0.83433823318382
8.7,"max_tuv_SVM","SVM",15,25,1312,1307,5,2600,2192,408,0.939619525126448,0.647668393782383,1.79285059578368,789,386,403,2,1,66.46,5.4,0,0,0,0,0,0,0.00737235622470332,5.28800655592641,0.754676048161006
8.7,"max_tuv_SVM","SVM",15,26,1212,1207,5,2700,2292,408,0.939228646413466,0.647668393782383,1.79944802207912,795,387,408,6,1.1,69.02,5.6,0,0,0,0,0,0,0.00560528570037165,3.67732774374123,0.620900958396763
8.7,"max_tuv_SVM","SVM",15,27,1112,1109,3,2800,2390,410,0.93929330304268,0.647668393782383,1.79012445719788,800,390,410,5,1.1,71.57,5.8,0,0,0,0,0,0,0.00594811892250307,3.54061811866699,0.61444245126651
8.7,"max_tuv_SVM","SVM",15,28,1012,1009,3,2900,2490,410,0.938545343400173,0.637305699481865,1.79177282225975,804,392,412,4,1.1,74.13,6.1,0,0,0,0,0,0,0.00476432500253425,2.57456868241445,0.520587118508189
8.7,"max_tuv_SVM","SVM",15,29,912,909,3,3000,2590,410,0.938554160213248,0.637305699481865,1.79177282225975,804,392,412,0,1.1,76.69,6.3,0,0,0,0,0,0,0.00386349257162637,1.81291187256717,0.409790780699013
8.7,"max_tuv_SVM","SVM",15,30,812,809,3,3100,2690,410,0.938091277526825,0.637305699481865,1.79177282225975,805,393,412,1,1,79.24,6.6,0,0,0,0,0,0,0.00323628798760019,1.30901777263533,0.34831123883419
8.7,"max_tuv_SVM","SVM",15,31,712,709,3,3200,2790,410,0.938132422654507,0.637305699481865,1.79177282225975,804,393,411,-1,1,81.8,6.8,0,0,0,0,0,0,0.00251367907009357,0.927403751308938,0.281123468876477
8.7,"max_tuv_SVM","SVM",15,32,612,609,3,3300,2890,410,0.938144178405273,0.637305699481865,1.79342422578257,805,394,411,1,1,84.36,7,0,0,0,0,0,0,0.00209635758155861,0.707621166629327,0.243279924885103
8.7,"max_tuv_SVM","SVM",15,33,512,510,2,3400,2989,411,0.93823234653602,0.637305699481865,1.79342422578257,811,396,415,6,1,86.91,7.3,0,0,0,0,0,0,0.00159390268819421,0.534707404040372,0.190707303299332
8.7,"max_tuv_SVM","SVM",15,34,412,412,0,3500,3087,413,0.93873196594359,0.642487046632124,1.79012445719788,819,400,419,8,1,89.47,7.5,0,0,0,0,0,0,0.00197769930245018,0.604891584523365,0.230813653735134
8.7,"max_tuv_SVM","SVM",15,35,312,312,0,3600,3187,413,0.938476278364421,0.642487046632124,1.79177282225975,824,402,422,5,1,92.02,7.7,0,0,0,0,0,0,0.00105717883090573,0.277927397083048,0.129583022140456
8.7,"max_tuv_SVM","SVM",15,36,212,212,0,3700,3287,413,0.938470400489038,0.642487046632124,1.79342422578257,826,405,421,2,1,94.58,8,0,0,0,0,0,0,0.000713656555751715,0.146314152223427,0.0868923096611006
8.7,"max_tuv_SVM","SVM",15,37,112,112,0,3800,3387,413,0.938502728803645,0.642487046632124,1.79012445719788,828,406,422,2,1,97.14,8.2,0,0,0,0,0,0,0.000356669016486617,0.0544080969606771,0.0504296181084104
8.7,"max_tuv_SVM","SVM",15,38,12,12,0,3900,3487,413,0.938580610652472,0.642487046632124,1.79177282225975,831,407,424,3,1,99.69,8.4,0,0,0,0,0,0,0.000203698023589649,0.00266881153216066,0.00266881153216066
8.7,"max_tuv_SVM","SVM",15,39,0,0,0,3912,3499,413,0.938617347373616,0.642487046632124,1.78847912221884,831,407,424,0,1,100,8.5,0,0,0,0,0,0,0,0,0
8.7,"max_tuv_SVM","SVM",16,0,3812,3417,395,100,93,7,0.897584833019978,0.568627450980392,1.73206831119545,23,7,16,0,2.3,2.56,13.3,0,0,0,0,0,0,0.342362663425692,267.415636606286,40.3163616014308
8.7,"max_tuv_SVM","SVM",16,1,3712,3378,334,200,132,68,0.910771443280515,0.593137254901961,1.74652308025326,115,57,58,92,1,5.11,1.9,0,0,0,0,0,0,0.622030075465714,312.154016466397,71.9131591025654
8.7,"max_tuv_SVM","SVM",16,2,3612,3310,302,300,200,100,0.902430835347845,0.602941176470588,1.70809701290985,204,99,105,89,1.1,7.67,2,0,0,0,0,0,0,0.580651564988796,321.323910932307,70.4524519963473
8.7,"max_tuv_SVM","SVM",16,3,3512,3264,248,400,246,154,0.901440370668822,0.602941176470588,1.73770225661562,293,147,146,89,1,10.22,1.6,0,0,0,0,0,0,0.268405741901037,166.424004147113,67.8852753795354
8.7,"max_tuv_SVM","SVM",16,4,3412,3225,187,500,285,215,0.887755730145955,0.632352941176471,1.66137164543237,345,172,173,52,1,12.78,1.3,0,0,0,0,0,0,0.137372736536807,109.522022115818,43.1436029471204
8.7,"max_tuv_SVM","SVM",16,5,3312,3168,144,600,342,258,0.89093696839468,0.647058823529412,1.64949402023919,421,209,212,76,1,15.34,1.3,0,0,0,0,0,0,0.139999332608624,139.208099890478,40.6624051009872
8.7,"max_tuv_SVM","SVM",16,6,3212,3096,116,700,414,286,0.888790961590119,0.661764705882353,1.63335499945835,483,232,251,62,1.1,17.89,1.4,0,0,0,0,0,0,0.107267304946311,159.075102673955,35.5707982654957
8.7,"max_tuv_SVM","SVM",16,7,3112,3013,99,800,497,303,0.896786026054272,0.676470588235294,1.64797794117647,531,255,276,48,1.1,20.45,1.6,0,0,0,0,0,0,0.0887671158757371,139.334803728499,31.9956262834047
8.7,"max_tuv_SVM","SVM",16,8,3012,2932,80,900,578,322,0.897391776345255,0.676470588235294,1.64949402023919,554,267,287,23,1.1,23.01,1.8,0,0,0,0,0,0,0.0620530840487283,114.134494560974,22.7804953067398
8.7,"max_tuv_SVM","SVM",16,9,2912,2846,66,1000,664,336,0.909060513474808,0.67156862745098,1.66867078323042,584,283,301,30,1.1,25.56,2,0,0,0,0,0,0,0.0610985463796935,112.987691992993,21.2674488869727
8.7,"max_tuv_SVM","SVM",16,10,2812,2755,57,1100,755,345,0.910986883337825,0.661764705882353,1.67020872865275,615,298,317,31,1.1,28.12,2.2,0,0,0,0,0,0,0.0597878183680239,103.60408556582,19.5149443830766
8.7,"max_tuv_SVM","SVM",16,11,2712,2668,44,1200,842,358,0.920136090966081,0.656862745098039,1.6935981384274,649,309,340,34,1.1,30.67,2.4,0,0,0,0,0,0,0.0606475608572141,91.6551597976788,13.7725258846192
8.7,"max_tuv_SVM","SVM",16,12,2612,2577,35,1300,933,367,0.928767682872244,0.647058823529412,1.74090539441583,659,320,339,10,1.1,33.23,2.5,0,0,0,0,0,0,0.060541042441826,75.6421132420463,11.851280407679
8.7,"max_tuv_SVM","SVM",16,13,2512,2479,33,1400,1031,369,0.930000167875377,0.651960784313726,1.72974574445163,663,321,342,4,1.1,35.79,2.8,0,0,0,0,0,0,0.0481742783190444,59.8758547204997,9.75425536073141
8.7,"max_tuv_SVM","SVM",16,14,2412,2382,30,1500,1128,372,0.930572343092496,0.651960784313726,1.74011969590769,668,322,346,5,1.1,38.34,3,0,0,0,0,0,0,0.041476039793462,50.9832636475399,7.22812349326961
8.7,"max_tuv_SVM","SVM",16,15,2312,2286,26,1600,1224,376,0.932437158653422,0.647058823529412,1.75373053633218,670,325,345,2,1.1,40.9,3.3,0,0,0,0,0,0,0.0342198300678557,40.8427780817805,5.63014418213654
8.7,"max_tuv_SVM","SVM",16,16,2212,2193,19,1700,1317,383,0.933896275405146,0.651960784313726,1.75212013179928,694,333,361,24,1.1,43.46,3.4,0,0,0,0,0,0,0.0354154434394861,37.1148390221938,5.3642016971692
8.7,"max_tuv_SVM","SVM",16,17,2112,2100,12,1800,1410,390,0.933498970364408,0.642156862745098,1.7585795608566,712,341,371,18,1.1,46.01,3.6,0,0,0,0,0,0,0.0307125787929,36.0312553419965,4.64239424808658
8.7,"max_tuv_SVM","SVM",16,18,2012,2003,9,1900,1507,393,0.933403840988457,0.637254901960784,1.7585795608566,719,345,374,7,1.1,48.57,3.8,0,0,0,0,0,0,0.0264115410993769,30.6411730400516,3.74739291663384
8.7,"max_tuv_SVM","SVM",16,19,1912,1904,8,2000,1606,394,0.93291420449459,0.642156862745098,1.7553439038909,721,345,376,2,1.1,51.12,4.1,0,0,0,0,0,0,0.0228646174631292,24.0213620445994,2.36134469301222
8.7,"max_tuv_SVM","SVM",16,20,1812,1805,7,2100,1705,395,0.93013866505507,0.632352941176471,1.76416472752855,746,358,388,25,1.1,53.68,4.3,0,0,0,0,0,0,0.0179011696461393,14.5599273343947,2.24331740392925
8.7,"max_tuv_SVM","SVM",16,21,1712,1705,7,2200,1805,395,0.930054727370407,0.632352941176471,1.76416472752855,743,358,385,-3,1.1,56.24,4.6,0,0,0,0,0,0,0.010559090490464,9.54030410011217,1.22559282830914
8.7,"max_tuv_SVM","SVM",16,22,1612,1608,4,2300,1902,398,0.930056126331817,0.632352941176471,1.76254325259516,753,362,391,10,1.1,58.79,4.8,0,0,0,0,0,0,0.0109640103385716,9.75884378511467,1.16743564001083
8.7,"max_tuv_SVM","SVM",16,23,1512,1508,4,2400,2002,398,0.929990375145498,0.637254901960784,1.76254325259516,759,367,392,6,1.1,61.35,5,0,0,0,0,0,0,0.0076009868224243,6.44896857479925,0.890814875818811
8.7,"max_tuv_SVM","SVM",16,24,1412,1409,3,2500,2101,399,0.929612655564515,0.637254901960784,1.76578918860362,765,371,394,6,1.1,63.91,5.3,0,0,0,0,0,0,0.00840841798233167,6.12553378629579,0.861975423263877
8.7,"max_tuv_SVM","SVM",16,25,1312,1309,3,2600,2201,399,0.930169442206111,0.647058823529412,1.76416472752855,781,378,403,16,1.1,66.46,5.5,0,0,0,0,0,0,0.00501261340232587,3.13737311359213,0.591316485427899
8.7,"max_tuv_SVM","SVM",16,26,1212,1210,2,2700,2300,400,0.93055555555556,0.642156862745098,1.76578918860362,783,379,404,2,1.1,69.02,5.8,0,0,0,0,0,0,0.00435124168425961,2.79147002728778,0.475006978095414
8.7,"max_tuv_SVM","SVM",16,27,1112,1111,1,2800,2399,401,0.93088850837139,0.642156862745098,1.76254325259516,789,381,408,6,1.1,71.57,6,0,0,0,0,0,0,0.00491750656973117,2.88268696430218,0.507431865655596
8.7,"max_tuv_SVM","SVM",16,28,1012,1011,1,2900,2499,401,0.930575141015314,0.642156862745098,1.76092475557716,786,383,403,-3,1.1,74.13,6.2,0,0,0,0,0,0,0.0038336214819227,2.05295148062375,0.424462431269885
8.7,"max_tuv_SVM","SVM",16,29,912,911,1,3000,2599,401,0.930776591458505,0.642156862745098,1.76254325259516,785,383,402,-1,1,76.69,6.5,0,0,0,0,0,0,0.0030951334113627,1.39629453252307,0.324482755135246
8.7,"max_tuv_SVM","SVM",16,30,812,811,1,3100,2699,401,0.930997627361451,0.651960784313726,1.76254325259516,790,386,404,5,1,79.24,6.7,0,0,0,0,0,0,0.00244083370003189,0.960064695757945,0.266012216891764
8.7,"max_tuv_SVM","SVM",16,31,712,711,1,3200,2799,401,0.931034000358138,0.647058823529412,1.7560870502047,791,387,404,1,1,81.8,7,0,0,0,0,0,0,0.0021515498066083,0.71483386449467,0.233988943549718
8.7,"max_tuv_SVM","SVM",16,32,612,611,1,3300,2899,401,0.931127730772679,0.651960784313726,1.75930922827847,792,387,405,1,1,84.36,7.2,0,0,0,0,0,0,0.00165149834884886,0.495856778003314,0.193281244892239
8.7,"max_tuv_SVM","SVM",16,33,512,511,1,3400,2999,401,0.931178093383476,0.651960784313726,1.75930922827847,792,387,405,0,1,86.91,7.5,0,0,0,0,0,0,0.000928586775699276,0.272687976699119,0.121142808804881
8.7,"max_tuv_SVM","SVM",16,34,412,412,0,3500,3098,402,0.931652341301822,0.651960784313726,1.76648514584569,794,390,404,2,1,89.47,7.7,0,0,0,0,0,0,0.000644921423857272,0.191742348362481,0.086685671836349
8.7,"max_tuv_SVM","SVM",16,35,312,312,0,3600,3198,402,0.931506849315072,0.642156862745098,1.76648514584569,796,392,404,2,1,92.02,8,0,0,0,0,0,0,0.000472134451478158,0.119815075419701,0.0608298153521485
8.7,"max_tuv_SVM","SVM",16,36,212,212,0,3700,3298,402,0.931285813412127,0.642156862745098,1.76972937935505,800,391,409,4,1,94.58,8.2,0,0,0,0,0,0,0.000238425601226826,0.0506009669301725,0.0322558031803584
8.7,"max_tuv_SVM","SVM",16,37,112,112,0,3800,3398,402,0.931319388485992,0.642156862745098,1.76972937935505,801,392,409,1,1,97.14,8.5,0,0,0,0,0,0,9.80499950771606e-05,0.0167488826689462,0.0157296183308061
8.7,"max_tuv_SVM","SVM",16,38,12,12,0,3900,3498,402,0.931467678395563,0.647058823529412,1.77625372729737,803,394,409,2,1,99.69,8.7,0,0,0,0,0,0,5.68871558493212e-05,0.000815384684236722,0.000815384684236722
8.7,"max_tuv_SVM","SVM",16,39,0,0,0,3912,3510,402,0.931491460739551,0.647058823529412,1.76810577441986,804,394,410,1,1,100,8.7,0,0,0,0,0,0,0,0,0
8.7,"max_tuv_SVM","SVM",17,0,3812,3410,402,100,92,8,0.865674281076056,0.418367346938776,1.72600116403507,33,8,25,0,3.1,2.56,11.5,0,0,0,0,0,0,0.340341623501196,310.881095736015,46.3713393623594
8.7,"max_tuv_SVM","SVM",17,1,3712,3347,365,200,155,45,0.910963589981447,0.494897959183673,1.78436941596915,99,45,54,66,1.2,5.11,3.4,0,0,0,0,0,0,0.354781577116482,472.133237816209,43.0988229175496
8.7,"max_tuv_SVM","SVM",17,2,3612,3301,311,300,201,99,0.933345895176236,0.612244897959184,1.77781525833474,195,95,100,96,1.1,7.67,2,0,0,0,0,0,0,0.562441669772053,379.033507281452,68.1954752856569
8.7,"max_tuv_SVM","SVM",17,3,3512,3248,264,400,254,146,0.93053977272725,0.622448979591837,1.7719054503126,284,138,146,89,1.1,10.22,1.7,0,0,0,0,0,0,0.409016742962591,347.791852669284,63.7609963521098
8.7,"max_tuv_SVM","SVM",17,4,3412,3207,205,500,295,205,0.905815166975878,0.61734693877551,1.69845859226855,349,171,178,65,1,12.78,1.4,0,0,0,0,0,0,0.297807827627526,275.41069761594,55.3510414068583
8.7,"max_tuv_SVM","SVM",17,5,3312,3149,163,600,353,247,0.932290700371042,0.658163265306122,1.76272459305709,430,210,220,81,1,15.34,1.4,0,0,0,0,0,0,0.249632637571115,251.453347478194,49.7150482581504
8.7,"max_tuv_SVM","SVM",17,6,3212,3091,121,700,411,289,0.914871289424851,0.668367346938776,1.69239161102229,493,238,255,63,1.1,17.89,1.4,0,0,0,0,0,0,0.149695397235543,190.779576137885,37.3998739087071
8.7,"max_tuv_SVM","SVM",17,7,3112,3022,90,800,480,320,0.883464749536181,0.683673469387755,1.60961158657011,549,265,284,56,1.1,20.45,1.5,0,0,0,0,0,0,0.133688634335187,218.742360512795,33.9953187020191
8.7,"max_tuv_SVM","SVM",17,8,3012,2931,81,900,571,329,0.906371753246753,0.673469387755102,1.67399605003292,593,283,310,44,1.1,23.01,1.7,0,0,0,0,0,0,0.0943749265326201,146.40724187961,27.7658028460129
8.7,"max_tuv_SVM","SVM",17,9,2912,2851,61,1000,651,349,0.911418715213347,0.668367346938776,1.66173516324653,614,295,319,21,1.1,25.56,1.9,0,0,0,0,0,0,0.089492436926507,141.602169393367,17.8649857673836
8.7,"max_tuv_SVM","SVM",17,10,2812,2759,53,1100,743,357,0.920886479591825,0.668367346938776,1.70450328891887,635,306,329,21,1.1,28.12,2.1,0,0,0,0,0,0,0.0765581810368485,110.757880317049,14.2438705905638
8.7,"max_tuv_SVM","SVM",17,11,2712,2668,44,1200,834,366,0.922127203153972,0.668367346938776,1.71524234693878,647,311,336,12,1.1,30.67,2.3,0,0,0,0,0,0,0.0663234939537661,88.0265663440508,10.0013551053789
8.7,"max_tuv_SVM","SVM",17,12,2612,2570,42,1300,932,368,0.923796961966588,0.663265306122449,1.71967302044558,656,313,343,9,1.1,33.23,2.5,0,0,0,0,0,0,0.0598302005491736,70.4633960675663,8.00810152391739
8.7,"max_tuv_SVM","SVM",17,13,2512,2475,37,1400,1027,373,0.927617694805184,0.663265306122449,1.75354373580159,670,319,351,14,1.1,35.79,2.8,0,0,0,0,0,0,0.0594987060995575,59.3763320406676,8.37582466954686
8.7,"max_tuv_SVM","SVM",17,14,2412,2380,32,1500,1122,378,0.928867115027816,0.663265306122449,1.75515841695794,690,327,363,20,1.1,38.34,3,0,0,0,0,0,0,0.0527887720267639,52.8081690653109,7.74604123187909
8.7,"max_tuv_SVM","SVM",17,15,2312,2293,19,1600,1209,391,0.928322124304255,0.668367346938776,1.75032326980379,720,339,381,30,1.1,40.9,3.1,0,0,0,0,0,0,0.0525058551626813,54.7158866835175,7.95093530977403
8.7,"max_tuv_SVM","SVM",17,16,2212,2198,14,1700,1304,396,0.927846706864556,0.663265306122449,1.75677607448509,733,344,389,13,1.1,43.46,3.3,0,0,0,0,0,0,0.0432244142114775,49.3455234294711,6.66649238671342
8.7,"max_tuv_SVM","SVM",17,17,2112,2098,14,1800,1404,396,0.927704661410009,0.663265306122449,1.75354373580159,729,344,385,-4,1.1,46.01,3.5,0,0,0,0,0,0,0.0338679799896019,37.1720612230048,5.46857181483377
8.7,"max_tuv_SVM","SVM",17,18,2012,1999,13,1900,1503,397,0.927613346474943,0.668367346938776,1.75515841695794,731,345,386,2,1.1,48.57,3.8,0,0,0,0,0,0,0.0273952455000042,28.9685409412028,3.86033197909928
8.7,"max_tuv_SVM","SVM",17,19,1912,1902,10,2000,1600,400,0.926962546382179,0.658163265306122,1.75032326980379,729,349,380,-2,1.1,51.12,4,0,0,0,0,0,0,0.0241480171293227,24.232386635538,2.57729673466135
8.7,"max_tuv_SVM","SVM",17,20,1812,1803,9,2100,1699,401,0.926692949907227,0.658163265306122,1.75193202280912,736,352,384,7,1.1,53.68,4.2,0,0,0,0,0,0,0.0226090849876952,21.661898406067,2.34218197910361
8.7,"max_tuv_SVM","SVM",17,21,1712,1704,8,2200,1798,402,0.929513566790332,0.653061224489796,1.75515841695794,758,366,392,22,1.1,56.24,4.5,0,0,0,0,0,0,0.0142550806525329,11.1711376576533,1.8676339469078
8.7,"max_tuv_SVM","SVM",17,22,1612,1605,7,2300,1897,403,0.928806238404433,0.653061224489796,1.75354373580159,759,367,392,1,1.1,58.79,4.7,0,0,0,0,0,0,0.0121207804965316,10.2053734489284,1.3360998665351
8.7,"max_tuv_SVM","SVM",17,23,1512,1505,7,2400,1997,403,0.928817833951743,0.653061224489796,1.75354373580159,759,368,391,0,1.1,61.35,5,0,0,0,0,0,0,0.0110034751727678,8.21955344760639,1.11054481954179
8.7,"max_tuv_SVM","SVM",17,24,1412,1405,7,2500,2097,403,0.930864448051939,0.642857142857143,1.76865126215776,776,376,400,17,1.1,63.91,5.2,0,0,0,0,0,0,0.00661320873558553,4.42742251983227,0.83772787928506
8.7,"max_tuv_SVM","SVM",17,25,1312,1306,6,2600,2196,404,0.931078965677171,0.647959183673469,1.7719054503126,781,378,403,5,1.1,66.46,5.4,0,0,0,0,0,0,0.00579226286563445,3.67094704008406,0.606083206547235
8.7,"max_tuv_SVM","SVM",17,26,1212,1207,5,2700,2295,405,0.931813833487935,0.642857142857143,1.77618423516195,793,384,409,12,1.1,69.02,5.7,0,0,0,0,0,0,0.00450681947597854,2.69170580981596,0.50503382273315
8.7,"max_tuv_SVM","SVM",17,27,1112,1107,5,2800,2395,405,0.931989216140997,0.642857142857143,1.77455620194916,791,383,408,-2,1.1,71.57,5.9,0,0,0,0,0,0,0.00437917255192057,2.22762276958524,0.446729593200766
8.7,"max_tuv_SVM","SVM",17,28,1012,1007,5,2900,2495,405,0.931851519016694,0.642857142857143,1.77618423516195,797,388,409,6,1.1,74.13,6.2,0,0,0,0,0,0,0.00331097738849253,1.47750097884635,0.368881594813006
8.7,"max_tuv_SVM","SVM",17,29,912,908,4,3000,2594,406,0.93258783627087,0.637755102040816,1.77618423516195,797,389,408,0,1,76.69,6.4,0,0,0,0,0,0,0.00377956816839844,1.40099256878761,0.407428801470691
8.7,"max_tuv_SVM","SVM",17,30,812,808,4,3100,2694,406,0.932774814471242,0.637755102040816,1.78108630756811,803,393,410,6,1,79.24,6.6,0,0,0,0,0,0,0.00219126188345174,0.695348969224681,0.252664471888667
8.7,"max_tuv_SVM","SVM",17,31,712,708,4,3200,2794,406,0.93307339981447,0.637755102040816,1.77781525833474,803,393,410,0,1,81.8,6.9,0,0,0,0,0,0,0.00170897153769422,0.487559449337462,0.20128224291272
8.7,"max_tuv_SVM","SVM",17,32,612,609,3,3300,2893,407,0.933129928107605,0.637755102040816,1.77618423516195,805,394,411,2,1,84.36,7.1,0,0,0,0,0,0,0.00115346686157096,0.344835803853031,0.152349765002453
8.7,"max_tuv_SVM","SVM",17,33,512,509,3,3400,2993,407,0.933557513914655,0.637755102040816,1.77618423516195,805,395,410,0,1,86.91,7.4,0,0,0,0,0,0,0.000605333741901309,0.184655426347584,0.0858464773977997
8.7,"max_tuv_SVM","SVM",17,34,412,411,1,3500,3091,409,0.935162047773654,0.642857142857143,1.78272635020859,812,399,413,7,1,89.47,7.6,0,0,0,0,0,0,0.000582090081016696,0.167156184253128,0.0745648128934908
8.7,"max_tuv_SVM","SVM",17,35,312,312,0,3600,3190,410,0.935830241187383,0.642857142857143,1.785339824003,817,402,415,5,1,92.02,7.8,0,0,0,0,0,0,0.000330052724489402,0.0826121521358688,0.0424093905326303
8.7,"max_tuv_SVM","SVM",17,36,212,212,0,3700,3290,410,0.936410018552875,0.642857142857143,1.78370339886642,820,402,418,3,1,94.58,8,0,0,0,0,0,0,0.000210302362086426,0.0437414857581605,0.027962769564543
8.7,"max_tuv_SVM","SVM",17,37,112,112,0,3800,3390,410,0.937039076994433,0.647959183673469,1.78697925451172,824,404,420,4,1,97.14,8.3,0,0,0,0,0,0,8.815438704432e-05,0.0154838292169577,0.0145368730009592
8.7,"max_tuv_SVM","SVM",17,38,12,12,0,3900,3490,410,0.937317370129869,0.647959183673469,1.78697925451172,826,405,421,2,1,99.69,8.5,0,0,0,0,0,0,3.53604847374554e-05,0.000578929126752889,0.000578929126752889
8.7,"max_tuv_SVM","SVM",17,39,0,0,0,3912,3502,410,0.937357954545454,0.647959183673469,1.78697925451172,828,406,422,2,1,100,8.5,0,0,0,0,0,0,0,0,0
8.7,"max_tuv_SVM","SVM",18,0,3812,3418,394,100,89,11,0.905183484287965,0.577114427860697,1.74985622346981,28,11,17,0,1.5,2.56,8.1,0,0,0,0,0,0,0.6138522508259,407.531231802674,65.8651464313482
8.7,"max_tuv_SVM","SVM",18,1,3712,3349,363,200,158,42,0.888365862992739,0.582089552238806,1.71729587357331,97,42,55,69,1.3,5.11,3.8,0,0,0,0,0,0,0.769635489593548,344.526618206197,84.1783187194811
8.7,"max_tuv_SVM","SVM",18,2,3612,3289,323,300,218,82,0.856390412609325,0.592039800995025,1.60544741729142,177,82,95,80,1.2,7.67,2.7,0,0,0,0,0,0,0.712018805813571,330.377698522115,80.4770607760907
8.7,"max_tuv_SVM","SVM",18,3,3512,3240,272,400,267,133,0.861121741718751,0.606965174129353,1.61441639727629,275,133,142,98,1.1,10.22,2,0,0,0,0,0,0,0.690178434107402,321.323919090017,78.769371604769
8.7,"max_tuv_SVM","SVM",18,4,3412,3192,220,500,315,185,0.868188969681518,0.597014925373134,1.59354103447802,370,182,188,95,1,12.78,1.7,0,0,0,0,0,0,0.683055617530738,247.502049899696,84.3874986936995
8.7,"max_tuv_SVM","SVM",18,5,3312,3124,188,600,383,217,0.865317288202859,0.621890547263682,1.57854047733682,427,206,221,57,1.1,15.34,1.8,0,0,0,0,0,0,0.131957548787623,149.392395648725,78.3402878646324
8.7,"max_tuv_SVM","SVM",18,6,3212,3054,158,700,453,247,0.861714220918196,0.641791044776119,1.57854047733682,448,217,231,21,1.1,17.89,1.8,0,0,0,0,0,0,0.0728236038170618,122.369098478909,61.8425380433609
8.7,"max_tuv_SVM","SVM",18,7,3112,2987,125,800,520,280,0.870479511275531,0.641791044776119,1.59354103447802,483,233,250,35,1.1,20.45,1.9,0,0,0,0,0,0,0.0618028636201285,112.166483257177,40.3786385355562
8.7,"max_tuv_SVM","SVM",18,8,3012,2915,97,900,592,308,0.875732448866773,0.641791044776119,1.62039846764338,524,249,275,41,1.1,23.01,1.9,0,0,0,0,0,0,0.0716069873163379,128.043800981482,33.6447510384607
8.7,"max_tuv_SVM","SVM",18,9,2912,2821,91,1000,686,314,0.892846309761729,0.626865671641791,1.6413233372309,540,262,278,16,1.1,25.56,2.2,0,0,0,0,0,0,0.0509945787542483,81.3279684741659,30.1590263206738
8.7,"max_tuv_SVM","SVM",18,10,2812,2749,63,1100,758,342,0.897520942297066,0.63681592039801,1.64725590080874,566,272,294,26,1.1,28.12,2.2,0,0,0,0,0,0,0.0385345179015262,62.9597950023444,11.9482261355173
8.7,"max_tuv_SVM","SVM",18,11,2712,2656,56,1200,851,349,0.909398874573001,0.626865671641791,1.68581473931899,589,284,305,23,1.1,30.67,2.4,0,0,0,0,0,0,0.0385790210962181,59.1498921718157,10.8245145352306
8.7,"max_tuv_SVM","SVM",18,12,2612,2563,49,1300,944,356,0.914541253844727,0.626865671641791,1.70678288995792,604,293,311,15,1.1,33.23,2.7,0,0,0,0,0,0,0.0425418921293896,52.2418706196801,8.47819435433001
8.7,"max_tuv_SVM","SVM",18,13,2512,2471,41,1400,1036,364,0.916134427577219,0.621890547263682,1.71887572258304,635,310,325,31,1,35.79,2.8,0,0,0,0,0,0,0.0613244420039587,54.6596908413569,10.3672403360313
8.7,"max_tuv_SVM","SVM",18,14,2412,2377,35,1500,1130,370,0.917724766480994,0.616915422885572,1.72782820030482,652,316,336,17,1.1,38.34,3.1,0,0,0,0,0,0,0.0567696981754176,45.9605952949923,9.88563929071894
8.7,"max_tuv_SVM","SVM",18,15,2312,2284,28,1600,1223,377,0.917858003430149,0.621890547263682,1.72941920233089,668,322,346,16,1.1,40.9,3.2,0,0,0,0,0,0,0.0551024670302899,42.6219023906006,9.86763498691974
8.7,"max_tuv_SVM","SVM",18,16,2212,2191,21,1700,1316,384,0.917268359059412,0.621890547263682,1.72782820030482,686,329,357,18,1.1,43.46,3.4,0,0,0,0,0,0,0.0499065020497677,38.6871119057592,9.43581228309593
8.7,"max_tuv_SVM","SVM",18,17,2112,2096,16,1800,1411,389,0.916416493033414,0.626865671641791,1.72941920233089,704,336,368,18,1.1,46.01,3.6,0,0,0,0,0,0,0.0386082737107101,34.4432290989717,8.31250361286222
8.7,"max_tuv_SVM","SVM",18,18,2012,1999,13,1900,1508,392,0.916188289322624,0.626865671641791,1.73101313707958,707,337,370,3,1.1,48.57,3.8,0,0,0,0,0,0,0.0276049906433103,25.6698208667351,4.99348724494901
8.7,"max_tuv_SVM","SVM",18,19,1912,1902,10,2000,1605,395,0.917016059304618,0.626865671641791,1.73101313707958,714,340,374,7,1.1,51.12,4.1,0,0,0,0,0,0,0.0231261049114731,22.1962027651212,3.50444219169307
8.7,"max_tuv_SVM","SVM",18,20,1812,1803,9,2100,1704,396,0.917126617624133,0.621890547263682,1.72941920233089,718,342,376,4,1.1,53.68,4.3,0,0,0,0,0,0,0.0186986032966514,16.7284574820007,1.95432989733903
8.7,"max_tuv_SVM","SVM",18,21,1712,1703,9,2200,1804,396,0.917947300534374,0.606965174129353,1.72624012291484,727,351,376,9,1.1,56.24,4.6,0,0,0,0,0,0,0.0125684728571946,10.6110346874838,1.59471702233191
8.7,"max_tuv_SVM","SVM",18,22,1612,1608,4,2300,1899,401,0.918923899023409,0.616915422885572,1.72465496210408,737,356,381,10,1.1,58.79,4.7,0,0,0,0,0,0,0.016250786345082,12.1009634156337,1.6321064340504
8.7,"max_tuv_SVM","SVM",18,23,1512,1508,4,2400,1999,401,0.92131365962213,0.601990049751244,1.75468563347018,757,373,384,20,1,61.35,5,0,0,0,0,0,0,0.0106067228452527,6.8091392860761,1.3945411945374
8.7,"max_tuv_SVM","SVM",18,24,1412,1408,4,2500,2099,401,0.921407208969411,0.606965174129353,1.75307287093942,759,372,387,2,1,63.91,5.2,0,0,0,0,0,0,0.00839926870203459,5.63052596776192,0.93955406573452
8.7,"max_tuv_SVM","SVM",18,25,1312,1308,4,2600,2199,401,0.921353347224007,0.601990049751244,1.75468563347018,759,373,386,0,1,66.46,5.5,0,0,0,0,0,0,0.00692649538607607,3.9844076879723,0.706212087525316
8.7,"max_tuv_SVM","SVM",18,26,1212,1208,4,2700,2299,401,0.92141854828423,0.601990049751244,1.75792007703418,768,375,393,9,1,69.02,5.7,0,0,0,0,0,0,0.00556487160590212,2.95561534720808,0.616584295646872
8.7,"max_tuv_SVM","SVM",18,27,1112,1108,4,2800,2399,401,0.921446896571284,0.597014925373134,1.75792007703418,768,375,393,0,1,71.57,6,0,0,0,0,0,0,0.00484462370574199,2.12504516283924,0.498811448351993
8.7,"max_tuv_SVM","SVM",18,28,1012,1008,4,2900,2499,401,0.92275942226191,0.597014925373134,1.75630136609769,779,381,398,11,1,74.13,6.2,0,0,0,0,0,0,0.00382553928864231,1.55657566077436,0.424900440238622
8.7,"max_tuv_SVM","SVM",18,29,912,908,4,3000,2599,401,0.92282178849343,0.597014925373134,1.75792007703418,781,382,399,2,1,76.69,6.5,0,0,0,0,0,0,0.00303550019287553,1.10147536941431,0.338579849419672
8.7,"max_tuv_SVM","SVM",18,30,812,808,4,3100,2699,401,0.922912503012006,0.601990049751244,1.75792007703418,780,382,398,-1,1,79.24,6.7,0,0,0,0,0,0,0.00215875073658294,0.692211332616639,0.245957302855219
8.7,"max_tuv_SVM","SVM",18,31,712,708,4,3200,2799,401,0.922901163697186,0.597014925373134,1.75792007703418,778,382,396,-2,1,81.8,7,0,0,0,0,0,0,0.00166011742121757,0.500719821467612,0.204284768140783
8.7,"max_tuv_SVM","SVM",18,32,612,609,3,3300,2898,402,0.923258352114075,0.592039800995025,1.75468563347018,783,383,400,5,1,84.36,7.2,0,0,0,0,0,0,0.00108077905066675,0.328085575430032,0.142195882736975
8.7,"max_tuv_SVM","SVM",18,33,512,510,2,3400,2997,403,0.924012416549729,0.597014925373134,1.75792007703418,785,385,400,2,1,86.91,7.4,0,0,0,0,0,0,0.000612719761877181,0.19887353181258,0.086020723007194
8.7,"max_tuv_SVM","SVM",18,34,412,411,1,3500,3096,404,0.924324247707336,0.597014925373134,1.75792007703418,790,387,403,5,1,89.47,7.7,0,0,0,0,0,0,0.000464386010875395,0.132464639487549,0.0579067408572726
8.7,"max_tuv_SVM","SVM",18,35,312,312,0,3600,3195,405,0.924946492608187,0.592039800995025,1.75630136609769,796,389,407,6,1,92.02,7.9,0,0,0,0,0,0,0.000453023414116491,0.112759204242521,0.0563712875460494
8.7,"max_tuv_SVM","SVM",18,36,212,212,0,3700,3295,405,0.925322107411661,0.592039800995025,1.75630136609769,798,391,407,2,1,94.58,8.1,0,0,0,0,0,0,0.000232894950500558,0.047370700912852,0.0301899480363567
8.7,"max_tuv_SVM","SVM",18,37,112,112,0,3800,3395,405,0.925582911652565,0.582089552238806,1.75630136609769,805,394,411,7,1,97.14,8.4,0,0,0,0,0,0,7.52504766358319e-05,0.0136295091332884,0.0128769092522138
8.7,"max_tuv_SVM","SVM",18,38,12,12,0,3900,3495,405,0.926076171847321,0.592039800995025,1.75792007703418,810,397,413,5,1,99.69,8.6,0,0,0,0,0,0,5.6666261103899e-05,0.000775563953348068,0.000775563953348068
8.7,"max_tuv_SVM","SVM",18,39,0,0,0,3912,3507,405,0.926081841504732,0.592039800995025,1.75792007703418,810,397,413,0,1,100,8.7,0,0,0,0,0,0,0,0,0
8.7,"max_tuv_SVM","SVM",19,0,3812,3396,416,100,94,6,0.817523800176664,0.451086956521739,1.61660989781607,21,6,15,0,2.5,2.56,15.7,0,0,0,0,0,0,0.163894700627114,253.31235034679,18.7508529398677
8.7,"max_tuv_SVM","SVM",19,1,3712,3369,343,200,121,79,0.896432427127295,0.521739130434783,1.75216190247418,74,36,38,53,1.1,5.11,1.5,0,0,0,0,0,0,0.752436359139501,338.405403459391,84.9451038785631
8.7,"max_tuv_SVM","SVM",19,2,3612,3311,301,300,179,121,0.905714802728422,0.576086956521739,1.76848225703325,151,72,79,77,1.1,7.67,1.5,0,0,0,0,0,0,0.79742824847658,303.23545173857,88.8292372180057
8.7,"max_tuv_SVM","SVM",19,3,3512,3243,269,400,247,153,0.88137022769654,0.597826086956522,1.67385299063176,235,118,117,84,1,10.22,1.6,0,0,0,0,0,0,0.706976411234539,236.64439743216,83.1990611920408
8.7,"max_tuv_SVM","SVM",19,4,3412,3193,219,500,297,203,0.894233364412607,0.619565217391304,1.6723131074757,326,160,166,91,1,12.78,1.5,0,0,0,0,0,0,0.711093541433528,178.946083574799,84.9455236514956
8.7,"max_tuv_SVM","SVM",19,5,3312,3135,177,600,355,245,0.880033001275893,0.630434782608696,1.64448714869085,406,199,207,80,1,15.34,1.4,0,0,0,0,0,0,0.161324601615964,162.978525804707,63.5622580186011
8.7,"max_tuv_SVM","SVM",19,6,3212,3069,143,700,421,279,0.869730837177345,0.641304347826087,1.62490992073024,465,226,239,59,1.1,17.89,1.5,0,0,0,0,0,0,0.112170422537462,183.81718786389,50.4332633853892
8.7,"max_tuv_SVM","SVM",19,7,3112,3001,111,800,489,311,0.885381906958493,0.641304347826087,1.62341506339746,521,254,267,56,1.1,20.45,1.6,0,0,0,0,0,0,0.0933906747287959,158.19440503827,36.0344449993929
8.7,"max_tuv_SVM","SVM",19,8,3012,2929,83,900,561,339,0.885452448719212,0.641304347826087,1.62640753356041,554,266,288,33,1.1,23.01,1.7,0,0,0,0,0,0,0.0743526755993271,131.135814714401,22.4875423672149
8.7,"max_tuv_SVM","SVM",19,9,2912,2836,76,1000,654,346,0.887007434488175,0.630434782608696,1.63469853471055,573,276,297,19,1.1,25.56,1.9,0,0,0,0,0,0,0.0566895331219692,98.9445270727552,18.5601525715344
8.7,"max_tuv_SVM","SVM",19,10,2812,2749,63,1100,741,359,0.895268488075377,0.619565217391304,1.63469853471055,609,291,318,36,1.1,28.12,2.1,0,0,0,0,0,0,0.0475327329334595,60.2216048729459,12.5240482293022
8.7,"max_tuv_SVM","SVM",19,11,2712,2661,51,1200,829,371,0.899579203062127,0.625,1.64518633540373,621,297,324,12,1.1,30.67,2.2,0,0,0,0,0,0,0.0413678697418038,56.8087768811707,7.31313606767989
8.7,"max_tuv_SVM","SVM",19,12,2612,2566,46,1300,924,376,0.905958631857894,0.630434782608696,1.68258482835435,629,303,326,8,1.1,33.23,2.5,0,0,0,0,0,0,0.0398772281049769,53.515396850519,6.10116399500494
8.7,"max_tuv_SVM","SVM",19,13,2512,2471,41,1400,1019,381,0.920300078516051,0.603260869565217,1.73757336207929,666,324,342,37,1.1,35.79,2.7,0,0,0,0,0,0,0.0368035026163614,35.1814857647428,6.24383911372552
8.7,"max_tuv_SVM","SVM",19,14,2412,2379,33,1500,1111,389,0.925219599568169,0.608695652173913,1.74094037153427,679,331,348,13,1.1,38.34,2.9,0,0,0,0,0,0,0.0312620531207112,32.5577072722318,3.78065251070364
8.7,"max_tuv_SVM","SVM",19,15,2312,2287,25,1600,1203,397,0.927144162822643,0.608695652173913,1.77173913043478,709,343,366,30,1.1,40.9,3,0,0,0,0,0,0,0.0619558223112673,41.0487007547628,7.70246756805637
8.7,"max_tuv_SVM","SVM",19,16,2212,2187,25,1700,1303,397,0.926952473255466,0.614130434782609,1.77337206972551,714,344,370,5,1.1,43.46,3.3,0,0,0,0,0,0,0.0418155938265305,29.469165944229,4.78245353491513
8.7,"max_tuv_SVM","SVM",19,17,2112,2091,21,1800,1399,401,0.926121307292174,0.608695652173913,1.77337206972551,731,352,379,17,1.1,46.01,3.5,0,0,0,0,0,0,0.0377865677581191,24.8672143528469,4.41844669258383
8.7,"max_tuv_SVM","SVM",19,18,2012,1996,16,1900,1494,406,0.925468029247224,0.603260869565217,1.77337206972551,740,359,381,9,1.1,48.57,3.7,0,0,0,0,0,0,0.0315457481887767,19.5037217599177,4.01189269701311
8.7,"max_tuv_SVM","SVM",19,19,1912,1900,12,2000,1590,410,0.924931298459119,0.603260869565217,1.77173913043478,754,362,392,14,1.1,51.12,3.9,0,0,0,0,0,0,0.0213013352217355,16.3785573829133,2.9502942452632
8.7,"max_tuv_SVM","SVM",19,20,1812,1802,10,2100,1688,412,0.92467366768083,0.603260869565217,1.77010919563217,757,364,393,3,1.1,53.68,4.1,0,0,0,0,0,0,0.0152123991214064,12.9583370373904,1.75867157046093
8.7,"max_tuv_SVM","SVM",19,21,1712,1703,9,2200,1787,413,0.924886826479536,0.603260869565217,1.77173913043478,759,365,394,2,1.1,56.24,4.3,0,0,0,0,0,0,0.0122862283729215,10.670634662671,1.33630538260889
8.7,"max_tuv_SVM","SVM",19,22,1612,1603,9,2300,1887,413,0.924756477573855,0.603260869565217,1.77173913043478,760,366,394,1,1.1,58.79,4.6,0,0,0,0,0,0,0.0127414153374898,10.0189109724177,1.29236123170571
8.7,"max_tuv_SVM","SVM",19,23,1512,1504,8,2400,1986,414,0.924520316027092,0.603260869565217,1.77010919563217,786,382,404,26,1.1,61.35,4.8,0,0,0,0,0,0,0.00915313045328612,6.49907277281129,1.08906934795468
8.7,"max_tuv_SVM","SVM",19,24,1412,1405,7,2500,2085,415,0.924972703405638,0.608695652173913,1.76848225703325,787,381,406,1,1.1,63.91,5,0,0,0,0,0,0,0.00792687062454021,5.3671564161713,0.827496759435667
8.7,"max_tuv_SVM","SVM",19,25,1312,1306,6,2600,2184,416,0.925544705074104,0.603260869565217,1.76361933606982,789,384,405,2,1.1,66.46,5.2,0,0,0,0,0,0,0.0070106269296251,4.51205934425316,0.76566306423919
8.7,"max_tuv_SVM","SVM",19,26,1212,1206,6,2700,2284,416,0.925428157817258,0.603260869565217,1.76523733546071,789,384,405,0,1.1,69.02,5.5,0,0,0,0,0,0,0.00651038107734054,3.6386283005037,0.666672895093609
8.7,"max_tuv_SVM","SVM",19,27,1112,1106,6,2800,2384,416,0.92609677102758,0.608695652173913,1.77173913043478,793,388,405,4,1,71.57,5.7,0,0,0,0,0,0,0.00506596199165908,2.58320822639298,0.551719423823758
8.7,"max_tuv_SVM","SVM",19,28,1012,1007,5,2900,2483,417,0.926417275983906,0.603260869565217,1.76848225703325,799,392,407,6,1,74.13,6,0,0,0,0,0,0,0.00472284243566981,2.10956314989639,0.500025861525495
8.7,"max_tuv_SVM","SVM",19,29,912,908,4,3000,2582,418,0.927096623809991,0.603260869565217,1.77337206972551,803,393,410,4,1,76.69,6.2,0,0,0,0,0,0,0.00438771291201983,1.81460449046239,0.478894171707597
8.7,"max_tuv_SVM","SVM",19,30,812,809,3,3100,2681,419,0.927309782608695,0.592391304347826,1.76848225703325,807,396,411,4,1,79.24,6.4,0,0,0,0,0,0,0.00351399289048787,1.32296415793046,0.388610219810919
8.7,"max_tuv_SVM","SVM",19,31,712,709,3,3200,2781,419,0.927410994700168,0.592391304347826,1.76848225703325,804,396,408,-3,1,81.8,6.6,0,0,0,0,0,0,0.00249779315713836,0.857107002668201,0.289064260995147
8.7,"max_tuv_SVM","SVM",19,32,612,609,3,3300,2881,419,0.927414061733243,0.592391304347826,1.76848225703325,806,396,410,2,1,84.36,6.9,0,0,0,0,0,0,0.00174134357116929,0.588751055749293,0.213166942668422
8.7,"max_tuv_SVM","SVM",19,33,512,510,2,3400,2980,420,0.92763642163118,0.592391304347826,1.77010919563217,811,398,413,5,1,86.91,7.1,0,0,0,0,0,0,0.00134962319335587,0.447511783041206,0.1630760358584
8.7,"max_tuv_SVM","SVM",19,34,412,411,1,3500,3079,421,0.928372509569157,0.592391304347826,1.77010919563217,815,399,416,4,1,89.47,7.3,0,0,0,0,0,0,0.00114804283943605,0.35270597660571,0.136009969347796
8.7,"max_tuv_SVM","SVM",19,35,312,312,0,3600,3178,422,0.930540901953098,0.597826086956522,1.77661995448557,820,404,416,5,1,92.02,7.5,0,0,0,0,0,0,0.00099059847936427,0.250856987212982,0.11735339195094
8.7,"max_tuv_SVM","SVM",19,36,212,212,0,3700,3278,422,0.930612977230361,0.597826086956522,1.78152774441509,823,404,419,3,1,94.58,7.8,0,0,0,0,0,0,0.000546007502536563,0.115285921924126,0.0705304572700494
8.7,"max_tuv_SVM","SVM",19,37,112,112,0,3800,3378,422,0.930686586024159,0.597826086956522,1.77825287723785,831,405,426,8,1.1,97.14,8,0,0,0,0,0,0,0.00037504229756761,0.0569387034653617,0.0528418455812329
8.7,"max_tuv_SVM","SVM",19,38,12,12,0,3900,3478,422,0.931178844832685,0.58695652173913,1.78316970546985,829,405,424,-2,1,99.69,8.2,0,0,0,0,0,0,0.000242159117979958,0.00365594983973575,0.00365594983973575
8.7,"max_tuv_SVM","SVM",19,39,0,0,0,3912,3490,422,0.931209515163435,0.58695652173913,1.78152774441509,829,405,424,0,1,100,8.3,0,0,0,0,0,0,0,0,0
8.7,"max_tuv_SVM","SVM",20,0,3812,3410,402,100,86,14,0.89801215950409,0.589473684210526,1.72526897353882,32,14,18,0,1.3,2.56,6.1,0,0,0,0,0,0,0.787886458988797,473.946215214795,86.4329500119651
8.7,"max_tuv_SVM","SVM",20,1,3712,3368,344,200,128,72,0.915145735232785,0.568421052631579,1.73942293750906,113,58,55,81,0.9,5.11,1.8,0,0,0,0,0,0,0.742494475894583,373.837091699713,81.3401690420043
8.7,"max_tuv_SVM","SVM",20,2,3612,3304,308,300,192,108,0.908067592537406,0.631578947368421,1.73155959752322,213,104,109,100,1,7.67,1.8,0,0,0,0,0,0,0.672983946886547,375.779367688896,76.2874907277085
8.7,"max_tuv_SVM","SVM",20,3,3512,3251,261,400,245,155,0.877110031590874,0.615789473684211,1.66532507739938,304,149,155,91,1,10.22,1.6,0,0,0,0,0,0,0.645473734041226,406.037193153481,76.8619292755758
8.7,"max_tuv_SVM","SVM",20,4,3412,3188,224,500,308,192,0.873654407820228,0.642105263157895,1.58525736890347,372,182,190,68,1,12.78,1.6,0,0,0,0,0,0,0.651364581368842,307.73859511007,79.4436427188948
8.7,"max_tuv_SVM","SVM",20,5,3312,3115,197,600,381,219,0.883763485724503,0.668421052631579,1.63197671598351,424,205,219,52,1.1,15.34,1.7,0,0,0,0,0,0,0.279063093295016,204.186721183438,76.9260917953109
8.7,"max_tuv_SVM","SVM",20,6,3212,3067,145,700,429,271,0.888123621624852,0.668421052631579,1.63393529695799,483,234,249,59,1.1,17.89,1.6,0,0,0,0,0,0,0.112722779783278,139.843854292549,48.6192146638006
8.7,"max_tuv_SVM","SVM",20,7,3112,3000,112,800,496,304,0.888505096262743,0.673684210526316,1.63693885448916,522,250,272,39,1.1,20.45,1.6,0,0,0,0,0,0,0.0838093354152068,140.943675586324,37.1402782677653
8.7,"max_tuv_SVM","SVM",20,8,3012,2920,92,900,576,324,0.892617869702571,0.663157894736842,1.64146495270434,555,267,288,33,1.1,23.01,1.8,0,0,0,0,0,0,0.0631615500045496,115.319985398417,28.1066893319826
8.7,"max_tuv_SVM","SVM",20,9,2912,2838,74,1000,658,342,0.902425940275388,0.678947368421053,1.66044142614601,582,279,303,27,1.1,25.56,1.9,0,0,0,0,0,0,0.0606140995302658,101.141390760608,19.9312124183069
8.7,"max_tuv_SVM","SVM",20,10,2812,2746,66,1100,750,350,0.908285152291828,0.673684210526316,1.66044142614601,598,286,312,16,1.1,28.12,2.1,0,0,0,0,0,0,0.0500836045596557,83.9587424607581,16.336713150734
8.7,"max_tuv_SVM","SVM",20,11,2712,2660,52,1200,836,364,0.917456935089704,0.673684210526316,1.6937113003096,621,300,321,23,1.1,30.67,2.3,0,0,0,0,0,0,0.0559616762642005,91.0598101495589,12.0081262539697
8.7,"max_tuv_SVM","SVM",20,12,2612,2571,41,1300,925,375,0.924816713357577,0.663157894736842,1.69849003811086,654,315,339,33,1.1,33.23,2.5,0,0,0,0,0,0,0.0646607100415692,80.6058873019299,11.92427487092
8.7,"max_tuv_SVM","SVM",20,13,2512,2475,37,1400,1021,379,0.928714907313604,0.652631578947368,1.73634731991268,675,322,353,21,1.1,35.79,2.7,0,0,0,0,0,0,0.0611993143590155,69.325120903195,11.0805199607144
8.7,"max_tuv_SVM","SVM",20,14,2412,2377,35,1500,1119,381,0.92978780473269,0.647368421052632,1.73782713664896,675,324,351,0,1.1,38.34,2.9,0,0,0,0,0,0,0.0502161765122363,55.750933456055,9.94282651455455
8.7,"max_tuv_SVM","SVM",20,15,2312,2281,31,1600,1215,385,0.930348095607094,0.647368421052632,1.75209412676125,689,330,359,14,1.1,40.9,3.2,0,0,0,0,0,0,0.0476457650842037,49.3249463909573,8.97251048005054
8.7,"max_tuv_SVM","SVM",20,16,2212,2191,21,1700,1305,395,0.929781844191465,0.647368421052632,1.75532379335435,709,338,371,20,1.1,43.46,3.3,0,0,0,0,0,0,0.047307939008061,44.1187010599039,7.41169701325645
8.7,"max_tuv_SVM","SVM",20,17,2112,2098,14,1800,1398,402,0.928986111938982,0.642105263157895,1.74262334769767,726,346,380,17,1.1,46.01,3.5,0,0,0,0,0,0,0.041314793538894,42.2175903439448,6.83944335559454
8.7,"max_tuv_SVM","SVM",20,18,2012,2001,11,1900,1495,405,0.928956309232894,0.647368421052632,1.74583555663352,734,350,384,8,1.1,48.57,3.7,0,0,0,0,0,0,0.0331118598806877,34.4826739364944,5.49376695166095
8.7,"max_tuv_SVM","SVM",20,19,1912,1901,11,2000,1595,405,0.929057638433588,0.647368421052632,1.74262334769767,739,351,388,5,1.1,51.12,3.9,0,0,0,0,0,0,0.0267785501376738,28.8418874082957,4.74605194809459
8.7,"max_tuv_SVM","SVM",20,20,1812,1802,10,2100,1694,406,0.929026345592194,0.652631578947368,1.75370747310265,742,354,388,3,1.1,53.68,4.2,0,0,0,0,0,0,0.0228248148573683,22.8677053275182,3.32798606845798
8.7,"max_tuv_SVM","SVM",20,21,1712,1704,8,2200,1792,408,0.92865530190142,0.647368421052632,1.76481203007519,755,365,390,13,1.1,56.24,4.4,0,0,0,0,0,0,0.0156107269851508,13.9670418127455,1.85891141968218
8.7,"max_tuv_SVM","SVM",20,22,1612,1605,7,2300,1891,409,0.929245395481921,0.647368421052632,1.76481203007519,760,366,394,5,1.1,58.79,4.6,0,0,0,0,0,0,0.0148025077417295,12.2745497765047,1.50424925009182
8.7,"max_tuv_SVM","SVM",20,23,1512,1505,7,2400,1991,409,0.930002384216503,0.621052631578947,1.77430026679602,775,374,401,15,1.1,61.35,4.9,0,0,0,0,0,0,0.0108490152395037,7.52834990698663,1.36520388146358
8.7,"max_tuv_SVM","SVM",20,24,1412,1407,5,2500,2089,411,0.9298280383859,0.636842105263158,1.77266647281186,780,379,401,5,1.1,63.91,5.1,0,0,0,0,0,0,0.00897312886727166,6.51560175970126,0.967812048614885
8.7,"max_tuv_SVM","SVM",20,25,1312,1308,4,2600,2188,412,0.929912976098246,0.626315789473684,1.77430026679602,781,380,401,1,1.1,66.46,5.3,0,0,0,0,0,0,0.00875533790731307,5.77210313265723,0.902050116029738
8.7,"max_tuv_SVM","SVM",20,26,1212,1208,4,2700,2288,412,0.930175239911797,0.626315789473684,1.77103568488839,788,383,405,7,1.1,69.02,5.6,0,0,0,0,0,0,0.0069039385047911,4.14430115767109,0.769031776195809
8.7,"max_tuv_SVM","SVM",20,27,1112,1109,3,2800,2387,413,0.930312332359792,0.626315789473684,1.77103568488839,792,386,406,4,1.1,71.57,5.8,0,0,0,0,0,0,0.00691288847420803,3.60114723845292,0.702486112521816
8.7,"max_tuv_SVM","SVM",20,28,1012,1009,3,2900,2487,413,0.930827919175074,0.626315789473684,1.77266647281186,795,387,408,3,1.1,74.13,6,0,0,0,0,0,0,0.00520684936514894,2.41786230041696,0.580387707475352
8.7,"max_tuv_SVM","SVM",20,29,912,909,3,3000,2587,413,0.930842820528116,0.626315789473684,1.77266647281186,793,386,407,-2,1.1,76.69,6.3,0,0,0,0,0,0,0.00469799444387206,1.83715982193655,0.492511709169304
8.7,"max_tuv_SVM","SVM",20,30,812,809,3,3100,2687,413,0.930827919175073,0.621052631578947,1.77266647281186,796,387,409,3,1.1,79.24,6.5,0,0,0,0,0,0,0.00365576211099993,1.25522255218514,0.408223940548315
8.7,"max_tuv_SVM","SVM",20,31,712,710,2,3200,2786,414,0.93145973654409,0.621052631578947,1.77103568488839,801,390,411,5,1.1,81.8,6.7,0,0,0,0,0,0,0.00294328688430344,0.90941946449866,0.334237960594888
8.7,"max_tuv_SVM","SVM",20,32,612,612,0,3300,2884,416,0.932021517553806,0.626315789473684,1.76940789473684,808,393,415,7,1.1,84.36,6.9,0,0,0,0,0,0,0.00215632066803893,0.691323083272881,0.270661084902454
8.7,"max_tuv_SVM","SVM",20,33,512,512,0,3400,2984,416,0.932054300530499,0.626315789473684,1.77266647281186,811,394,417,3,1.1,86.91,7.2,0,0,0,0,0,0,0.0013113551575108,0.419346565621734,0.171761345791223
8.7,"max_tuv_SVM","SVM",20,34,412,412,0,3500,3084,416,0.932189902843188,0.621052631578947,1.77430026679602,814,396,418,3,1.1,89.47,7.4,0,0,0,0,0,0,0.000767280592119977,0.225666846956767,0.0964636813056638
8.7,"max_tuv_SVM","SVM",20,35,312,312,0,3600,3184,416,0.931918698217807,0.626315789473684,1.77430026679602,816,398,418,2,1.1,92.02,7.7,0,0,0,0,0,0,0.000527211148614262,0.133565008437791,0.0662127536699913
8.7,"max_tuv_SVM","SVM",20,36,212,212,0,3700,3284,416,0.932033438636235,0.621052631578947,1.77266647281186,817,401,416,1,1,94.58,7.9,0,0,0,0,0,0,0.00027418684929159,0.0576289384735786,0.0362576907643539
8.7,"max_tuv_SVM","SVM",20,37,112,112,0,3800,3384,416,0.932550515586815,0.621052631578947,1.77103568488839,822,405,417,5,1,97.14,8.1,0,0,0,0,0,0,0.000125158225923013,0.0212638045033554,0.0198877636806258
8.7,"max_tuv_SVM","SVM",20,38,12,12,0,3900,3484,416,0.932946891577754,0.621052631578947,1.77103568488839,823,404,419,1,1,99.69,8.4,0,0,0,0,0,0,0.000102259424502872,0.00145721900496923,0.00145721900496923
8.7,"max_tuv_SVM","SVM",20,39,0,0,0,3912,3496,416,0.932890266436191,0.621052631578947,1.77103568488839,824,404,420,1,1,100,8.4,0,0,0,0,0,0,0,0,0
8.7,"max_tuv_SVM","SVM",21,0,3812,3418,394,100,87,13,0.88999636772365,0.517587939698492,1.7302920130607,30,13,17,0,1.3,2.56,6.7,0,0,0,0,0,0,0.392420183688337,426.693800661515,42.8765365072936
8.7,"max_tuv_SVM","SVM",21,1,3712,3371,341,200,134,66,0.916503404901563,0.603015075376884,1.71648684599468,120,59,61,90,1,5.11,2,0,0,0,0,0,0,0.683527397394954,513.224979905892,73.3201595530946
8.7,"max_tuv_SVM","SVM",21,2,3612,3309,303,300,196,104,0.901975729529826,0.603015075376884,1.69841856340526,208,102,106,88,1,7.67,1.9,0,0,0,0,0,0,0.642245233262943,382.564168868726,71.5204425104837
8.7,"max_tuv_SVM","SVM",21,3,3512,3266,246,400,239,161,0.906553255749438,0.603015075376884,1.76327821259009,284,141,143,76,1,10.22,1.5,0,0,0,0,0,0,0.659409439286929,380.485553738506,77.6552664087955
8.7,"max_tuv_SVM","SVM",21,4,3412,3215,197,500,290,210,0.904542633486142,0.638190954773869,1.71491064136108,369,180,189,85,1.1,12.78,1.4,0,0,0,0,0,0,0.403287773650256,286.142699231866,75.9278901464946
8.7,"max_tuv_SVM","SVM",21,5,3312,3151,161,600,354,246,0.892272975577925,0.64321608040201,1.63064168770118,436,214,222,67,1,15.34,1.4,0,0,0,0,0,0,0.18737872979058,212.463111326121,61.8302572277391
8.7,"max_tuv_SVM","SVM",21,6,3212,3090,122,700,415,285,0.883695655282661,0.658291457286432,1.61252344672672,503,245,258,67,1.1,17.89,1.5,0,0,0,0,0,0,0.1279302274051,200.858584033298,47.3333319931703
8.7,"max_tuv_SVM","SVM",21,7,3112,3014,98,800,491,309,0.879464196337399,0.668341708542714,1.60807715045817,553,264,289,50,1.1,20.45,1.6,0,0,0,0,0,0,0.124858682083802,242.426293987196,36.6427441640487
8.7,"max_tuv_SVM","SVM",21,8,3012,2926,86,900,579,321,0.89114039177102,0.673366834170854,1.6351795743423,573,274,299,20,1.1,23.01,1.8,0,0,0,0,0,0,0.0819666546273372,137.580170112827,25.9552517165082
8.7,"max_tuv_SVM","SVM",21,9,2912,2842,70,1000,663,337,0.895356120385637,0.678391959798995,1.64119680973676,589,282,307,16,1.1,25.56,2,0,0,0,0,0,0,0.0672577835440946,122.355390084182,16.9164719846384
8.7,"max_tuv_SVM","SVM",21,10,2812,2747,65,1100,758,342,0.900547129500658,0.678391959798995,1.65172972299514,593,285,308,4,1.1,28.12,2.2,0,0,0,0,0,0,0.0556339283451446,96.521666507356,13.9159147940241
8.7,"max_tuv_SVM","SVM",21,11,2712,2656,56,1200,849,351,0.910111170536805,0.673366834170854,1.68189614123978,619,299,320,26,1.1,30.67,2.4,0,0,0,0,0,0,0.0561616518478179,83.1230691017273,11.3467851970634
8.7,"max_tuv_SVM","SVM",21,12,2612,2560,52,1300,945,355,0.918854374318932,0.663316582914573,1.71806595072881,637,307,330,18,1.1,33.23,2.7,0,0,0,0,0,0,0.0550958343951132,69.3212184004735,11.2408441402543
8.7,"max_tuv_SVM","SVM",21,13,2512,2467,45,1400,1038,362,0.920922197784579,0.663316582914573,1.71176690049699,648,313,335,11,1.1,35.79,2.9,0,0,0,0,0,0,0.0618365468414924,62.0536761332011,9.63941540449955
8.7,"max_tuv_SVM","SVM",21,14,2412,2373,39,1500,1132,368,0.923822298744702,0.663316582914573,1.7302920130607,665,320,345,17,1.1,38.34,3.1,0,0,0,0,0,0,0.0578900121060716,50.5304021650532,8.9267930504609
8.7,"max_tuv_SVM","SVM",21,15,2312,2281,31,1600,1224,376,0.923390429666813,0.653266331658292,1.72710840310106,685,328,357,20,1.1,40.9,3.3,0,0,0,0,0,0,0.0553842054287939,44.644044345249,8.9448846321545
8.7,"max_tuv_SVM","SVM",21,16,2212,2187,25,1700,1318,382,0.923098703534731,0.653266331658292,1.72710840310106,700,336,364,15,1.1,43.46,3.5,0,0,0,0,0,0,0.0425750945655152,39.5438956130204,8.1735432677789
8.7,"max_tuv_SVM","SVM",21,17,2112,2092,20,1800,1413,387,0.923002891520765,0.653266331658292,1.72869874233044,716,342,374,16,1.1,46.01,3.7,0,0,0,0,0,0,0.036510214278312,39.4278390661823,7.07793954111298
8.7,"max_tuv_SVM","SVM",21,18,2012,1994,18,1900,1511,389,0.923144464496625,0.648241206030151,1.7302920130607,720,343,377,4,1.1,48.57,3.9,0,0,0,0,0,0,0.0275150027577781,30.9331045905285,5.81199336184422
8.7,"max_tuv_SVM","SVM",21,19,1912,1898,14,2000,1607,393,0.923825158804817,0.658291457286432,1.72710840310106,731,350,381,11,1.1,51.12,4.1,0,0,0,0,0,0,0.025674688885959,28.5119647068587,4.61558489518125
8.7,"max_tuv_SVM","SVM",21,20,1812,1803,9,2100,1702,398,0.925632716799687,0.663316582914573,1.73615085547332,744,355,389,13,1.1,53.68,4.3,0,0,0,0,0,0,0.0229820246712989,21.5383415141331,2.38715033343812
8.7,"max_tuv_SVM","SVM",21,21,1712,1704,8,2200,1801,399,0.927660499423685,0.648241206030151,1.73774952108609,765,367,398,21,1.1,56.24,4.5,0,0,0,0,0,0,0.0168226424567883,11.5523244293828,2.07063440884727
8.7,"max_tuv_SVM","SVM",21,22,1612,1605,7,2300,1900,400,0.928189610545602,0.658291457286432,1.74680029984175,768,368,400,3,1.1,58.79,4.8,0,0,0,0,0,0,0.0115674001050365,9.0644487720286,1.34829747328677
8.7,"max_tuv_SVM","SVM",21,23,1512,1506,6,2400,1999,401,0.928615759503253,0.658291457286432,1.75746937452238,766,369,397,-2,1.1,61.35,5,0,0,0,0,0,0,0.00998549091590719,7.60993659908713,1.04713620355827
8.7,"max_tuv_SVM","SVM",21,24,1412,1406,6,2500,2099,401,0.929430876637028,0.653266331658292,1.75746937452238,773,372,401,7,1.1,63.91,5.2,0,0,0,0,0,0,0.00835337515621788,5.99975135168572,0.919329580985105
8.7,"max_tuv_SVM","SVM",21,25,1312,1307,5,2600,2198,402,0.929114839993937,0.653266331658292,1.75585107859741,776,374,402,3,1.1,66.46,5.5,0,0,0,0,0,0,0.00775177446669564,4.74022514056102,0.785754335192411
8.7,"max_tuv_SVM","SVM",21,26,1212,1207,5,2700,2298,402,0.929496658019752,0.64321608040201,1.76165755246822,787,382,405,11,1.1,69.02,5.7,0,0,0,0,0,0,0.0061908980562884,3.29000348674426,0.700689343841325
8.7,"max_tuv_SVM","SVM",21,27,1112,1109,3,2800,2396,404,0.929287873631104,0.648241206030151,1.75101402328447,793,384,409,6,1.1,71.57,5.9,0,0,0,0,0,0,0.00590222138881161,3.04967315961383,0.638977515669018
8.7,"max_tuv_SVM","SVM",21,28,1012,1009,3,2900,2496,404,0.929266423180214,0.648241206030151,1.74940758840072,793,384,409,0,1.1,74.13,6.2,0,0,0,0,0,0,0.00496038024861295,2.16204318246126,0.51364777090352
8.7,"max_tuv_SVM","SVM",21,29,912,909,3,3000,2596,404,0.929924237007455,0.64321608040201,1.75262341117351,797,386,411,4,1.1,76.69,6.4,0,0,0,0,0,0,0.00367494184119095,1.3428488289238,0.394806099311446
8.7,"max_tuv_SVM","SVM",21,30,812,809,3,3100,2696,404,0.930095840614564,0.64321608040201,1.74940758840072,798,386,412,1,1.1,79.24,6.7,0,0,0,0,0,0,0.00355677521791047,1.12018937582781,0.397951696524038
8.7,"max_tuv_SVM","SVM",21,31,712,709,3,3200,2796,404,0.930211673049366,0.638190954773869,1.76165755246822,800,388,412,2,1.1,81.8,6.9,0,0,0,0,0,0,0.00203227570192377,0.593142093771243,0.253909128768114
8.7,"max_tuv_SVM","SVM",21,32,612,609,3,3300,2896,404,0.930494819001094,0.633165829145729,1.76327821259009,803,388,415,3,1.1,84.36,7.2,0,0,0,0,0,0,0.00111419656237065,0.336607429997733,0.151145832419637
8.7,"max_tuv_SVM","SVM",21,33,512,509,3,3400,2996,404,0.931098291686089,0.633165829145729,1.76165755246822,803,389,414,0,1.1,86.91,7.4,0,0,0,0,0,0,0.000608358655022106,0.178422019983876,0.0856528900038407
8.7,"max_tuv_SVM","SVM",21,34,412,411,1,3500,3094,406,0.932312387206362,0.633165829145729,1.75842515328938,807,394,413,4,1,89.47,7.6,0,0,0,0,0,0,0.000627395500862624,0.188319964108099,0.0863361632245551
8.7,"max_tuv_SVM","SVM",21,35,312,312,0,3600,3193,407,0.932925870101772,0.633165829145729,1.75681339787849,812,397,415,5,1,92.02,7.8,0,0,0,0,0,0,0.000576704275606572,0.14159030512354,0.0712744208782044
8.7,"max_tuv_SVM","SVM",21,36,212,212,0,3700,3293,407,0.933532202846892,0.628140703517588,1.76327821259009,814,398,416,2,1,94.58,8.1,0,0,0,0,0,0,0.000243926265257711,0.0501719893248876,0.0316366010062681
8.7,"max_tuv_SVM","SVM",21,37,112,112,0,3800,3393,407,0.933996962616148,0.633165829145729,1.75842515328938,815,400,415,1,1,97.14,8.3,0,0,0,0,0,0,0.000113348539443457,0.0202642956006062,0.0190697013723674
8.7,"max_tuv_SVM","SVM",21,38,12,12,0,3900,3493,407,0.93433301968007,0.628140703517588,1.76906571424616,820,401,419,5,1,99.69,8.6,0,0,0,0,0,0,8.29623495964777e-05,0.00115275852462265,0.00115275852462265
8.7,"max_tuv_SVM","SVM",21,39,0,0,0,3912,3505,407,0.934350180040781,0.628140703517588,1.76744271817805,822,401,421,2,1,100,8.6,0,0,0,0,0,0,0,0,0
8.7,"max_tuv_SVM","SVM",22,0,3812,3413,399,100,92,8,0.845322228673242,0.412060301507538,1.65781904916286,31,8,23,0,2.9,2.56,11.5,0,0,0,0,0,0,0.171624429982717,328.657608016088,20.2736806113329
8.7,"max_tuv_SVM","SVM",22,1,3712,3346,366,200,159,41,0.873682584807925,0.522613065326633,1.70311465159901,92,41,51,61,1.2,5.11,3.9,0,0,0,0,0,0,0.32777205305317,320.759926436193,43.2157618529029
8.7,"max_tuv_SVM","SVM",22,2,3612,3299,313,300,206,94,0.868554497015519,0.547738693467337,1.59610898529344,182,90,92,90,1,7.67,2.2,0,0,0,0,0,0,0.480577071202602,329.283934058978,59.6604654579047
8.7,"max_tuv_SVM","SVM",22,3,3512,3252,260,400,253,147,0.904642735590287,0.638190954773869,1.72123289257347,265,131,134,83,1,10.22,1.7,0,0,0,0,0,0,0.380643846529232,270.744092925356,60.3250114250229
8.7,"max_tuv_SVM","SVM",22,4,3412,3219,193,500,286,214,0.914349779632356,0.613065326633166,1.74198817780362,353,175,178,88,1,12.78,1.3,0,0,0,0,0,0,0.414365043160176,284.678167521838,62.1301673119548
8.7,"max_tuv_SVM","SVM",22,5,3312,3152,160,600,353,247,0.890166541300699,0.658291457286432,1.64724173352953,428,211,217,75,1,15.34,1.4,0,0,0,0,0,0,0.238101027095314,246.550715105754,51.8509094222317
8.7,"max_tuv_SVM","SVM",22,6,3212,3083,129,700,422,278,0.883778597026112,0.668341708542714,1.63819095477387,485,236,249,57,1.1,17.89,1.5,0,0,0,0,0,0,0.118107552764457,140.510066175771,38.3247999709642
8.7,"max_tuv_SVM","SVM",22,7,3112,3019,93,800,486,314,0.880255002960149,0.683417085427136,1.63064168770118,535,256,279,50,1.1,20.45,1.5,0,0,0,0,0,0,0.088026398647447,129.382050765071,26.4473131433058
8.7,"max_tuv_SVM","SVM",22,8,3012,2934,78,900,571,329,0.88476531776697,0.693467336683417,1.62914017601821,574,274,300,39,1.1,23.01,1.7,0,0,0,0,0,0,0.0798921486081355,142.10953774468,23.4468126665325
8.7,"max_tuv_SVM","SVM",22,9,2912,2843,69,1000,662,338,0.890794324496705,0.693467336683417,1.64421371563701,594,286,308,20,1.1,25.56,2,0,0,0,0,0,0,0.0641587546998449,112.558387729893,19.0855279628967
8.7,"max_tuv_SVM","SVM",22,10,2812,2754,58,1100,751,349,0.909945287049946,0.683417085427136,1.68189614123978,612,298,314,18,1.1,28.12,2.2,0,0,0,0,0,0,0.0519309292283566,74.4288226940295,13.1176769474105
8.7,"max_tuv_SVM","SVM",22,11,2712,2673,39,1200,832,368,0.922612493314597,0.693467336683417,1.71059718481912,636,309,327,24,1.1,30.67,2.3,0,0,0,0,0,0,0.0607966273987308,80.8475605850879,6.81866657109295
8.7,"max_tuv_SVM","SVM",22,12,2612,2581,31,1300,924,376,0.930443337918945,0.678391959798995,1.75423576021783,668,321,347,32,1.1,33.23,2.5,0,0,0,0,0,0,0.0770457597792849,79.547281607098,8.50843723582876
8.7,"max_tuv_SVM","SVM",22,13,2512,2484,28,1400,1021,379,0.930640682067121,0.673366834170854,1.75423576021783,681,327,354,13,1.1,35.79,2.7,0,0,0,0,0,0,0.0638920205255746,61.9740578055142,6.94136774783867
8.7,"max_tuv_SVM","SVM",22,14,2412,2387,25,1500,1118,382,0.930717903690325,0.673366834170854,1.76490185735306,689,332,357,8,1.1,38.34,2.9,0,0,0,0,0,0,0.0619501254684587,54.6950475249287,6.75709157024264
8.7,"max_tuv_SVM","SVM",22,15,2312,2293,19,1600,1212,388,0.930343235814813,0.673366834170854,1.75423576021783,706,340,366,17,1.1,40.9,3.1,0,0,0,0,0,0,0.0599751131457132,46.2003027399691,6.61372375257934
8.7,"max_tuv_SVM","SVM",22,16,2212,2197,15,1700,1308,392,0.930263154131494,0.678391959798995,1.75746937452238,714,344,370,8,1.1,43.46,3.3,0,0,0,0,0,0,0.0440151155922058,37.3063662259405,5.31658557549016
8.7,"max_tuv_SVM","SVM",22,17,2112,2102,10,1800,1403,397,0.929433736697138,0.673366834170854,1.75423576021783,726,348,378,12,1.1,46.01,3.5,0,0,0,0,0,0,0.0365415392223604,36.0400369906285,4.39083726062782
8.7,"max_tuv_SVM","SVM",22,18,2012,2003,9,1900,1502,398,0.928764482629416,0.678391959798995,1.75423576021783,732,350,382,6,1.1,48.57,3.8,0,0,0,0,0,0,0.026699588110639,27.2385311149639,2.95810860818234
8.7,"max_tuv_SVM","SVM",22,19,1912,1903,9,2000,1602,398,0.928429855595557,0.678391959798995,1.75101402328447,736,352,384,4,1.1,51.12,4,0,0,0,0,0,0,0.0233890884889693,23.0387772693866,2.43802314720086
8.7,"max_tuv_SVM","SVM",22,20,1812,1803,9,2100,1702,398,0.927443134854684,0.658291457286432,1.76652849500961,748,359,389,12,1.1,53.68,4.3,0,0,0,0,0,0,0.0165467487534074,14.7526735703437,2.04376110609194
8.7,"max_tuv_SVM","SVM",22,21,1712,1705,7,2200,1800,400,0.927404524043085,0.658291457286432,1.76165755246822,753,361,392,5,1.1,56.24,4.5,0,0,0,0,0,0,0.0141495579364274,12.4489616438154,1.46827761264269
8.7,"max_tuv_SVM","SVM",22,22,1612,1606,6,2300,1899,401,0.927676229754336,0.653266331658292,1.77395263610872,763,368,395,10,1.1,58.79,4.7,0,0,0,0,0,0,0.0113896694643862,8.88794042878211,1.3454029362653
8.7,"max_tuv_SVM","SVM",22,23,1512,1507,5,2400,1998,402,0.927893594323339,0.653266331658292,1.77395263610872,765,369,396,2,1.1,61.35,5,0,0,0,0,0,0,0.00918630138881663,7.26599449771522,0.99011604319925
8.7,"max_tuv_SVM","SVM",22,24,1412,1407,5,2500,2098,402,0.927946505435531,0.653266331658292,1.77558761549684,769,369,400,4,1.1,63.91,5.2,0,0,0,0,0,0,0.00884453816208325,6.41515109045431,0.897933254902314
8.7,"max_tuv_SVM","SVM",22,25,1312,1307,5,2600,2198,402,0.928053757689972,0.653266331658292,1.77069169376293,780,375,405,11,1.1,66.46,5.5,0,0,0,0,0,0,0.0071141317215991,4.65473214339932,0.798610875427269
8.7,"max_tuv_SVM","SVM",22,26,1212,1207,5,2700,2298,402,0.927960805736121,0.648241206030151,1.76906571424616,779,375,404,-1,1.1,69.02,5.7,0,0,0,0,0,0,0.00603038236371548,3.65821337051789,0.624970776341309
8.7,"max_tuv_SVM","SVM",22,27,1112,1107,5,2800,2398,402,0.928366934272943,0.648241206030151,1.77395263610872,781,378,403,2,1.1,71.57,6,0,0,0,0,0,0,0.00473932722448561,2.51034293179212,0.497070413004219
8.7,"max_tuv_SVM","SVM",22,28,1012,1008,4,2900,2497,403,0.928509937278865,0.64321608040201,1.77395263610872,784,380,404,3,1.1,74.13,6.2,0,0,0,0,0,0,0.00476964839776623,2.19785810746443,0.492419162982094
8.7,"max_tuv_SVM","SVM",22,29,912,908,4,3000,2597,403,0.928725871817809,0.638190954773869,1.77069169376293,788,383,405,4,1.1,76.69,6.4,0,0,0,0,0,0,0.00373711872871429,1.46956366276041,0.396088707640272
8.7,"max_tuv_SVM","SVM",22,30,812,810,2,3100,2695,405,0.929419436396537,0.638190954773869,1.76582269735478,798,387,411,10,1.1,79.24,6.7,0,0,0,0,0,0,0.00347766181083378,1.21329801648853,0.382688261161784
8.7,"max_tuv_SVM","SVM",22,31,712,710,2,3200,2795,405,0.929452327087899,0.638190954773869,1.77395263610872,801,389,412,3,1.1,81.8,6.9,0,0,0,0,0,0,0.00298676600158587,0.953860266980647,0.350033420242026
8.7,"max_tuv_SVM","SVM",22,32,612,611,1,3300,2894,406,0.929552429192046,0.638190954773869,1.77395263610872,805,391,414,4,1.1,84.36,7.1,0,0,0,0,0,0,0.00174448039468843,0.579667802199199,0.233047010830944
8.7,"max_tuv_SVM","SVM",22,33,512,512,0,3400,2993,407,0.929445176937603,0.638190954773869,1.76906571424616,804,392,412,-1,1.1,86.91,7.4,0,0,0,0,0,0,0.00121387449127108,0.39888547125346,0.155655947269868
8.7,"max_tuv_SVM","SVM",22,34,412,412,0,3500,3093,407,0.92969400216791,0.638190954773869,1.76906571424616,809,392,417,5,1.1,89.47,7.6,0,0,0,0,0,0,0.000811390862425651,0.243276978765994,0.1026908746569
8.7,"max_tuv_SVM","SVM",22,35,312,312,0,3600,3193,407,0.929888486255966,0.633165829145729,1.76906571424616,809,393,416,0,1.1,92.02,7.8,0,0,0,0,0,0,0.000476949694612604,0.123294324774143,0.0586071341801776
8.7,"max_tuv_SVM","SVM",22,36,212,212,0,3700,3293,407,0.930177352327932,0.628140703517588,1.76906571424616,813,394,419,4,1.1,94.58,8.1,0,0,0,0,0,0,0.000301652141205526,0.0620449200149852,0.0377016430319195
8.7,"max_tuv_SVM","SVM",22,37,112,112,0,3800,3393,407,0.930457638219543,0.628140703517588,1.77069169376293,814,396,418,1,1.1,97.14,8.3,0,0,0,0,0,0,0.000139678123487541,0.023152091067892,0.0216556698659814
8.7,"max_tuv_SVM","SVM",22,38,12,12,0,3900,3493,407,0.930936698289392,0.628140703517588,1.77069169376293,817,397,420,3,1.1,99.69,8.6,0,0,0,0,0,0,8.81277374377557e-05,0.00121887885895937,0.00121887885895937
8.7,"max_tuv_SVM","SVM",22,39,0,0,0,3912,3505,407,0.9309610088004,0.628140703517588,1.77232066496235,817,397,420,0,1.1,100,8.6,0,0,0,0,0,0,0,0,0
8.7,"max_tuv_SVM","SVM",23,0,3812,3427,385,100,84,16,0.897494114861201,0.585365853658537,1.75394548063128,32,15,17,0,1.1,2.56,5.2,0,0,0,0,0,0,0.957209950854811,501.075429093022,96.9466611522504
8.7,"max_tuv_SVM","SVM",23,1,3712,3354,358,200,157,43,0.876845287013704,0.604878048780488,1.65326739350343,98,43,55,66,1.3,5.11,3.7,0,0,0,0,0,0,0.890642801249685,349.028154908645,92.4465542722596
8.7,"max_tuv_SVM","SVM",23,2,3612,3282,330,300,229,71,0.88302712039114,0.634146341463415,1.62239956958393,161,71,90,63,1.3,7.67,3.2,0,0,0,0,0,0,0.82599228768664,285.831451827956,88.0308144173951
8.7,"max_tuv_SVM","SVM",23,3,3512,3224,288,400,287,113,0.886747642462143,0.6,1.6487087517934,246,113,133,85,1.2,10.22,2.5,0,0,0,0,0,0,0.822338514977391,263.674913530636,88.5881675977518
8.7,"max_tuv_SVM","SVM",23,4,3412,3166,246,500,345,155,0.869710687969244,0.653658536585366,1.57122534610811,342,155,187,96,1.2,12.78,2.2,0,0,0,0,0,0,0.669791995726685,329.841640940644,76.7118307972148
8.7,"max_tuv_SVM","SVM",23,5,3312,3132,180,600,379,221,0.857769079689665,0.668292682926829,1.53752863495486,436,207,229,94,1.1,15.34,1.7,0,0,0,0,0,0,0.269881888073272,276.199446925617,76.2095906165857
8.7,"max_tuv_SVM","SVM",23,6,3212,3088,124,700,423,277,0.864228106587179,0.663414634146341,1.54631451286889,498,239,259,62,1.1,17.89,1.5,0,0,0,0,0,0,0.110086738782352,149.678189528422,46.9095848138001
8.7,"max_tuv_SVM","SVM",23,7,3112,3014,98,800,497,303,0.866990291262137,0.673170731707317,1.56388626869694,522,248,274,24,1.1,20.45,1.6,0,0,0,0,0,0,0.0719117766882761,114.126880477705,29.8439156049856
8.7,"max_tuv_SVM","SVM",23,8,3012,2935,77,900,576,324,0.874658383362815,0.668292682926829,1.58586306524222,558,264,294,36,1.1,23.01,1.8,0,0,0,0,0,0,0.056536854404673,98.6747022068642,21.4158707565975
8.7,"max_tuv_SVM","SVM",23,9,2912,2850,62,1000,661,339,0.903107631875866,0.673170731707317,1.63993902439024,588,278,310,30,1.1,25.56,1.9,0,0,0,0,0,0,0.0605129603584104,112.408229033925,20.004105559675
8.7,"max_tuv_SVM","SVM",23,10,2812,2761,51,1100,750,350,0.926052012090659,0.663414634146341,1.73163130714717,616,291,325,28,1.1,28.12,2.1,0,0,0,0,0,0,0.102553567924248,147.969770137231,22.7293723430588
8.7,"max_tuv_SVM","SVM",23,11,2712,2667,45,1200,844,356,0.927047958657776,0.653658536585366,1.75394548063128,640,304,336,24,1.1,30.67,2.4,0,0,0,0,0,0,0.0944482107735585,99.2493165145212,21.9351059362913
8.7,"max_tuv_SVM","SVM",23,12,2612,2572,40,1300,939,361,0.927819643130761,0.648780487804878,1.75717558280555,656,314,342,16,1.1,33.23,2.6,0,0,0,0,0,0,0.0817872928830451,79.5473912420057,20.9356034479291
8.7,"max_tuv_SVM","SVM",23,13,2512,2477,35,1400,1034,366,0.928141410483214,0.648780487804878,1.75394548063128,678,322,356,22,1.1,35.79,2.8,0,0,0,0,0,0,0.0712099881549009,66.3986082213823,19.8955094189928
8.7,"max_tuv_SVM","SVM",23,14,2412,2380,32,1500,1131,369,0.92859550640053,0.648780487804878,1.75555904593085,675,323,352,-3,1.1,38.34,3.1,0,0,0,0,0,0,0.0566254867556933,52.6047259747235,16.79515892634
8.7,"max_tuv_SVM","SVM",23,15,2312,2287,25,1600,1224,376,0.92896324051762,0.648780487804878,1.75717558280555,685,329,356,10,1.1,40.9,3.3,0,0,0,0,0,0,0.0390772541388939,43.0486903869181,13.7867324778725
8.7,"max_tuv_SVM","SVM",23,16,2212,2198,14,1700,1313,387,0.928454820242098,0.648780487804878,1.75717558280555,694,332,362,9,1.1,43.46,3.4,0,0,0,0,0,0,0.0289011778833938,30.8105513894896,5.22903252963343
8.7,"max_tuv_SVM","SVM",23,17,2112,2102,10,1800,1409,391,0.929144321711641,0.648780487804878,1.75879509947173,702,336,366,8,1.1,46.01,3.6,0,0,0,0,0,0,0.0220955894208198,23.429572898536,2.45657632365649
8.7,"max_tuv_SVM","SVM",23,18,2012,2003,9,1900,1508,392,0.929960580016999,0.648780487804878,1.75879509947173,706,339,367,4,1.1,48.57,3.8,0,0,0,0,0,0,0.0192664990557225,20.3370793491034,2.10004034295904
8.7,"max_tuv_SVM","SVM",23,19,1912,1903,9,2000,1608,392,0.929723781532509,0.64390243902439,1.75879509947173,708,340,368,2,1.1,51.12,4.1,0,0,0,0,0,0,0.0147863446001144,15.3460234215453,1.57432083555616
8.7,"max_tuv_SVM","SVM",23,20,1812,1803,9,2100,1708,392,0.929843573707018,0.64390243902439,1.75879509947173,710,341,369,2,1.1,53.68,4.4,0,0,0,0,0,0,0.0133880496778257,13.1089645649828,1.41074180167526
8.7,"max_tuv_SVM","SVM",23,21,1712,1705,7,2200,1806,394,0.929528771015873,0.639024390243902,1.75555904593085,711,344,367,1,1.1,56.24,4.6,0,0,0,0,0,0,0.0115853998747158,11.3600416089978,1.24418162280555
8.7,"max_tuv_SVM","SVM",23,22,1612,1607,5,2300,1904,396,0.928620579181244,0.634146341463415,1.76271520803443,728,352,376,17,1.1,58.79,4.8,0,0,0,0,0,0,0.00979704720250203,9.06844553460944,1.11806253052026
8.7,"max_tuv_SVM","SVM",23,23,1512,1507,5,2400,2004,396,0.928358707916043,0.634146341463415,1.76596146071958,729,353,376,1,1.1,61.35,5.1,0,0,0,0,0,0,0.00824984306372803,6.98100178490278,0.848143336800037
8.7,"max_tuv_SVM","SVM",23,24,1412,1407,5,2500,2104,396,0.927890682676111,0.634146341463415,1.76758907496909,752,364,388,23,1.1,63.91,5.3,0,0,0,0,0,0,0.00568645082504364,3.92757488806974,0.726243133672479
8.7,"max_tuv_SVM","SVM",23,25,1312,1307,5,2600,2204,396,0.927918541321346,0.634146341463415,1.76758907496909,749,363,386,-3,1.1,66.46,5.6,0,0,0,0,0,0,0.00434652678962343,3.24417663254498,0.477987586061852
8.7,"max_tuv_SVM","SVM",23,26,1212,1208,4,2700,2303,397,0.928492429413167,0.634146341463415,1.76271520803443,751,365,386,2,1.1,69.02,5.8,0,0,0,0,0,0,0.0042206497418524,2.92410500883035,0.446150583354049
8.7,"max_tuv_SVM","SVM",23,27,1112,1108,4,2800,2403,397,0.928123302363815,0.634146341463415,1.76596146071958,759,368,391,8,1.1,71.57,6.1,0,0,0,0,0,0,0.00298484387141683,1.90543576116515,0.335597496014424
8.7,"max_tuv_SVM","SVM",23,28,1012,1009,3,2900,2502,398,0.927932470643961,0.629268292682927,1.75948086820318,760,369,391,1,1.1,74.13,6.3,0,0,0,0,0,0,0.00298892342709563,1.69512025760279,0.306872364388502
8.7,"max_tuv_SVM","SVM",23,29,912,909,3,3000,2602,398,0.927846108843736,0.634146341463415,1.76109655311429,770,373,397,10,1.1,76.69,6.5,0,0,0,0,0,0,0.00206444050393364,1.03780225043904,0.232561954230533
8.7,"max_tuv_SVM","SVM",23,30,812,810,2,3100,2701,399,0.927915755456821,0.634146341463415,1.75625837577057,772,375,397,2,1.1,79.24,6.8,0,0,0,0,0,0,0.00231618050879759,1.00284526528469,0.238683093374243
8.7,"max_tuv_SVM","SVM",23,31,712,710,2,3200,2801,399,0.928138624618692,0.634146341463415,1.7643368411605,776,380,396,4,1,81.8,7,0,0,0,0,0,0,0.00183116007731462,0.665506708634443,0.199054537613181
8.7,"max_tuv_SVM","SVM",23,32,612,610,2,3300,2901,399,0.928413032274247,0.624390243902439,1.75948086820318,778,380,398,2,1,84.36,7.3,0,0,0,0,0,0,0.00137696051872418,0.424916275583367,0.154798117438263
8.7,"max_tuv_SVM","SVM",23,33,512,511,1,3400,3000,400,0.928747336017056,0.629268292682927,1.75948086820318,784,383,401,6,1,86.91,7.5,0,0,0,0,0,0,0.00109503260612897,0.331358789609702,0.134005880979177
8.7,"max_tuv_SVM","SVM",23,34,412,412,0,3500,3099,401,0.92868604699754,0.629268292682927,1.75948086820318,789,386,403,5,1,89.47,7.7,0,0,0,0,0,0,0.000789139802300231,0.235355518850823,0.101210276792633
8.7,"max_tuv_SVM","SVM",23,35,312,312,0,3600,3199,401,0.928656795420045,0.629268292682927,1.76109655311429,791,387,404,2,1,92.02,8,0,0,0,0,0,0,0.000431364102314726,0.115002780597765,0.0560735770689108
8.7,"max_tuv_SVM","SVM",23,36,212,212,0,3700,3299,401,0.928550932568154,0.629268292682927,1.76338116171647,795,390,405,4,1,94.58,8.2,0,0,0,0,0,0,0.000311100935107852,0.0649145222547646,0.039266311937685
8.7,"max_tuv_SVM","SVM",23,37,112,112,0,3800,3399,401,0.928715298575034,0.629268292682927,1.76338116171647,796,391,405,1,1,97.14,8.5,0,0,0,0,0,0,0.000143155219662787,0.022570001100244,0.0210527186656854
8.7,"max_tuv_SVM","SVM",23,38,12,12,0,3900,3499,401,0.92872922789765,0.624390243902439,1.77311463639015,798,391,407,2,1,99.69,8.7,0,0,0,0,0,0,9.91044111523016e-05,0.00135656603241731,0.00135656603241731
8.7,"max_tuv_SVM","SVM",23,39,0,0,0,3912,3511,401,0.928738978423482,0.624390243902439,1.77474733863361,798,391,407,0,1,100,8.8,0,0,0,0,0,0,0,0,0
8.7,"max_tuv_SVM","SVM",24,0,3812,3436,376,100,86,14,0.886230842911903,0.560185185185185,1.71544221817446,31,14,17,0,1.2,2.56,6.1,0,0,0,0,0,0,0.525731502636804,485.66316279636,56.9019325893044
8.7,"max_tuv_SVM","SVM",24,1,3712,3397,315,200,125,75,0.889921243082186,0.555555555555556,1.72961942658912,112,59,53,81,0.9,5.11,1.7,0,0,0,0,0,0,0.739482078168346,355.917396278413,83.3169194367223
8.7,"max_tuv_SVM","SVM",24,2,3612,3334,278,300,188,112,0.875526819923384,0.592592592592593,1.69426523297491,206,102,104,94,1,7.67,1.7,0,0,0,0,0,0,0.68195306062985,349.456615650009,78.2838249117055
8.7,"max_tuv_SVM","SVM",24,3,3512,3276,236,400,246,154,0.884051724137956,0.601851851851852,1.70780946539916,294,146,148,88,1,10.22,1.6,0,0,0,0,0,0,0.659372334803983,217.382912548004,78.8577620496544
8.7,"max_tuv_SVM","SVM",24,4,3412,3224,188,500,298,202,0.888540336313325,0.592592592592593,1.71456290849673,371,182,189,77,1,12.78,1.5,0,0,0,0,0,0,0.245504695193269,195.651215432893,72.4854875883378
8.7,"max_tuv_SVM","SVM",24,5,3312,3154,158,600,368,232,0.872240847169008,0.611111111111111,1.64646464646465,419,204,215,48,1.1,15.34,1.6,0,0,0,0,0,0,0.128590042123938,124.806154791869,57.2959122270644
8.7,"max_tuv_SVM","SVM",24,6,3212,3095,117,700,427,273,0.863739889314601,0.62037037037037,1.59803921568627,451,219,232,32,1.1,17.89,1.6,0,0,0,0,0,0,0.0859671897428987,92.8840605523137,35.0635416547183
8.7,"max_tuv_SVM","SVM",24,7,3112,3027,85,800,495,305,0.857770593869727,0.625,1.55928995293636,490,239,251,39,1.1,20.45,1.6,0,0,0,0,0,0,0.0755593266575406,105.950639749201,21.8324230612806
8.7,"max_tuv_SVM","SVM",24,8,3012,2941,71,900,581,319,0.863157194550881,0.648148148148148,1.60932064661346,531,257,274,41,1.1,23.01,1.8,0,0,0,0,0,0,0.0708506189323623,125.638699778863,19.6163623046876
8.7,"max_tuv_SVM","SVM",24,9,2912,2852,60,1000,670,330,0.87562127501065,0.643518518518518,1.61468545751634,557,266,291,26,1.1,25.56,2,0,0,0,0,0,0,0.0677405891718289,119.17322017364,17.5864156894982
8.7,"max_tuv_SVM","SVM",24,10,2812,2756,56,1100,766,334,0.887837909748838,0.638888888888889,1.62749615975422,575,278,297,18,1.1,28.12,2.3,0,0,0,0,0,0,0.0543097692370471,83.761845867693,15.6705420242058
8.7,"max_tuv_SVM","SVM",24,11,2712,2674,38,1200,848,352,0.89862042358451,0.638888888888889,1.65101289134438,603,290,313,28,1.1,30.67,2.4,0,0,0,0,0,0,0.0610407565553969,87.2681483185047,10.4056611233979
8.7,"max_tuv_SVM","SVM",24,12,2612,2578,34,1300,944,356,0.907662835249045,0.634259259259259,1.67448635387918,619,298,321,16,1.1,33.23,2.7,0,0,0,0,0,0,0.0600574822162496,75.8873643370516,9.98366470927833
8.7,"max_tuv_SVM","SVM",24,13,2512,2481,31,1400,1041,359,0.913505747126441,0.638888888888889,1.71614024327916,628,303,325,9,1.1,35.79,2.9,0,0,0,0,0,0,0.0525759205312976,63.3834361695777,9.25877980350452
8.7,"max_tuv_SVM","SVM",24,14,2412,2386,26,1500,1136,364,0.915304384844624,0.643518518518518,1.72764976958525,641,309,332,13,1.1,38.34,3.1,0,0,0,0,0,0,0.044872223464503,52.0446946998122,7.5916098099464
8.7,"max_tuv_SVM","SVM",24,15,2312,2292,20,1600,1230,370,0.91778150276715,0.638888888888889,1.72961942658912,658,314,344,17,1.1,40.9,3.3,0,0,0,0,0,0,0.0524974520150991,47.920472973637,8.77526972255275
8.7,"max_tuv_SVM","SVM",24,16,2212,2195,17,1700,1327,373,0.917773520647094,0.643518518518518,1.73280179903915,669,317,352,11,1.1,43.46,3.6,0,0,0,0,0,0,0.0403243792929172,42.063744191266,7.61329553328765
8.7,"max_tuv_SVM","SVM",24,17,2112,2100,12,1800,1422,378,0.918409429544503,0.648148148148148,1.74434203789042,673,322,351,4,1.1,46.01,3.8,0,0,0,0,0,0,0.0305752161361051,34.6248300840369,5.3586325011544
8.7,"max_tuv_SVM","SVM",24,18,2012,2002,10,1900,1520,380,0.917919859514702,0.643518518518518,1.74434203789042,677,323,354,4,1.1,48.57,4,0,0,0,0,0,0,0.0239471842678048,26.1803738114221,3.53656963689466
8.7,"max_tuv_SVM","SVM",24,19,1912,1903,9,2000,1619,381,0.917983716475109,0.634259259259259,1.74113257691915,693,329,364,16,1.1,51.12,4.2,0,0,0,0,0,0,0.0209368456873235,22.9784277408279,3.20606262254101
8.7,"max_tuv_SVM","SVM",24,20,1812,1805,7,2100,1717,383,0.917801458067273,0.638888888888889,1.73953227124183,695,330,365,2,1.1,53.68,4.5,0,0,0,0,0,0,0.0194515805585103,18.6341321373157,1.97404608720246
8.7,"max_tuv_SVM","SVM",24,21,1712,1705,7,2200,1817,383,0.916653363133246,0.634259259259259,1.76288133863891,713,348,365,18,1,56.24,4.7,0,0,0,0,0,0,0.0129902758385079,8.93885956005579,1.75855638451017
8.7,"max_tuv_SVM","SVM",24,22,1612,1606,6,2300,1916,384,0.916244944657298,0.634259259259259,1.76126401630989,714,349,365,1,1,58.79,5,0,0,0,0,0,0,0.00929525782796703,7.32158766493561,1.08750594968896
8.7,"max_tuv_SVM","SVM",24,23,1512,1507,5,2400,2015,385,0.916671988080033,0.634259259259259,1.76775117659096,717,350,367,3,1,61.35,5.2,0,0,0,0,0,0,0.00834062073806859,6.67329879832773,0.893419515831435
8.7,"max_tuv_SVM","SVM",24,24,1412,1407,5,2500,2115,385,0.916323435504469,0.634259259259259,1.76612491055913,721,353,368,4,1,63.91,5.5,0,0,0,0,0,0,0.006277557503002,4.6664880584801,0.667653336456939
8.7,"max_tuv_SVM","SVM",24,25,1312,1307,5,2600,2215,385,0.915926990208599,0.62962962962963,1.76612491055913,732,360,372,11,1,66.46,5.8,0,0,0,0,0,0,0.00494558406560672,3.40932386238637,0.55706258790074
8.7,"max_tuv_SVM","SVM",24,26,1212,1210,2,2700,2312,388,0.917390378884635,0.625,1.76450163398693,738,364,374,6,1,69.02,6,0,0,0,0,0,0,0.00533814381173403,3.3449505713774,0.571405591429833
8.7,"max_tuv_SVM","SVM",24,27,1112,1110,2,2800,2412,388,0.917688378033218,0.625,1.76288133863891,747,367,380,9,1,71.57,6.2,0,0,0,0,0,0,0.00369718070917115,2.17238857034531,0.415829422476769
8.7,"max_tuv_SVM","SVM",24,28,1012,1011,1,2900,2511,389,0.917856002554283,0.625,1.76450163398693,750,368,382,3,1,74.13,6.5,0,0,0,0,0,0,0.00419511603508135,1.96087542095807,0.439596449107357
8.7,"max_tuv_SVM","SVM",24,29,912,911,1,3000,2611,389,0.917620530012783,0.625,1.76450163398693,753,370,383,3,1,76.69,6.7,0,0,0,0,0,0,0.00340190763294491,1.51625151365024,0.374769734702389
8.7,"max_tuv_SVM","SVM",24,30,812,811,1,3100,2711,389,0.917752234993626,0.625,1.76450163398693,754,370,384,1,1,79.24,7,0,0,0,0,0,0,0.00322867018676199,1.29240438755808,0.351343917546084
8.7,"max_tuv_SVM","SVM",24,31,712,711,1,3200,2811,389,0.917792145593881,0.625,1.76288133863891,753,371,382,-1,1,81.8,7.2,0,0,0,0,0,0,0.00202610434750587,0.706621604675352,0.224580158693899
8.7,"max_tuv_SVM","SVM",24,32,612,611,1,3300,2911,389,0.917889261387835,0.625,1.76126401630989,755,371,384,2,1,84.36,7.5,0,0,0,0,0,0,0.00155455402096591,0.499312729840992,0.182505273515454
8.7,"max_tuv_SVM","SVM",24,33,512,511,1,3400,3011,389,0.917950457641558,0.62037037037037,1.76775117659096,759,371,388,4,1,86.91,7.7,0,0,0,0,0,0,0.00098705160557851,0.330122239542747,0.130847850670533
8.7,"max_tuv_SVM","SVM",24,34,412,412,0,3500,3110,390,0.917871966794387,0.615740740740741,1.76450163398693,769,375,394,10,1.1,89.47,8,0,0,0,0,0,0,0.00106050630894531,0.313545852567615,0.127909204882778
8.7,"max_tuv_SVM","SVM",24,35,312,312,0,3600,3210,390,0.917911877394641,0.615740740740741,1.76288133863891,764,375,389,-5,1,92.02,8.2,0,0,0,0,0,0,0.000597032678267506,0.146726053249295,0.0728676327046403
8.7,"max_tuv_SVM","SVM",24,36,212,212,0,3700,3310,390,0.918953544061304,0.615740740740741,1.76450163398693,769,377,392,5,1,94.58,8.5,0,0,0,0,0,0,0.000400733551001368,0.0826481903691237,0.0524005072827115
8.7,"max_tuv_SVM","SVM",24,37,112,112,0,3800,3410,390,0.919651979565772,0.615740740740741,1.76288133863891,773,378,395,4,1,97.14,8.7,0,0,0,0,0,0,0.000157853638173175,0.0259368624630642,0.0242470935364675
8.7,"max_tuv_SVM","SVM",24,38,12,12,0,3900,3510,390,0.92015485312899,0.611111111111111,1.76288133863891,775,378,397,2,1.1,99.69,9,0,0,0,0,0,0,0.0001152007131469,0.0018690270526886,0.0018690270526886
8.7,"max_tuv_SVM","SVM",24,39,0,0,0,3912,3522,390,0.920204076202638,0.611111111111111,1.76450163398693,776,379,397,1,1,100,9,0,0,0,0,0,0,0,0,0
8.7,"max_tuv_SVM","SVM",25,0,3812,3411,401,100,88,12,0.873513999629693,0.481865284974093,1.69067596284711,34,12,22,0,1.8,2.56,7.3,0,0,0,0,0,0,0.229091724399752,438.617826080053,26.4656192305619
8.7,"max_tuv_SVM","SVM",25,1,3712,3348,364,200,151,49,0.909601215544621,0.559585492227979,1.74030460040823,107,49,58,73,1.2,5.11,3.1,0,0,0,0,0,0,0.644338635887895,450.548886097765,75.231706230879
8.7,"max_tuv_SVM","SVM",25,2,3612,3309,303,300,190,110,0.91531157147938,0.621761658031088,1.73099815869481,187,93,94,80,1,7.67,1.7,0,0,0,0,0,0,0.630463123200508,449.998203119114,74.5894820049442
8.7,"max_tuv_SVM","SVM",25,3,3512,3255,257,400,244,156,0.905238362541484,0.61139896373057,1.71711562133226,286,140,146,99,1,10.22,1.6,0,0,0,0,0,0,0.579225529797869,399.390421103472,72.9835240809333
8.7,"max_tuv_SVM","SVM",25,4,3412,3198,214,500,301,199,0.877452176136409,0.637305699481865,1.58500602981062,360,175,185,74,1.1,12.78,1.5,0,0,0,0,0,0,0.513490557870205,431.264035120567,72.9336222008837
8.7,"max_tuv_SVM","SVM",25,5,3312,3142,170,600,357,243,0.873672702265048,0.642487046632124,1.59726845108761,445,217,228,85,1.1,15.34,1.5,0,0,0,0,0,0,0.304820012405828,276.149471992136,65.5262112425617
8.7,"max_tuv_SVM","SVM",25,6,3212,3066,146,700,433,267,0.896114430477955,0.663212435233161,1.6237941201729,497,239,258,52,1.1,17.89,1.6,0,0,0,0,0,0,0.153115297916102,204.391060350012,52.6824109833225
8.7,"max_tuv_SVM","SVM",25,7,3112,3003,109,800,496,304,0.905186931131878,0.678756476683938,1.65027098397929,531,255,276,34,1.1,20.45,1.6,0,0,0,0,0,0,0.090505853918745,144.82167962692,31.0650615499545
8.7,"max_tuv_SVM","SVM",25,8,3012,2923,89,900,576,324,0.911933262602907,0.689119170984456,1.66112272063665,571,274,297,40,1.1,23.01,1.8,0,0,0,0,0,0,0.0889566551113486,148.890180723756,28.2069217647109
8.7,"max_tuv_SVM","SVM",25,9,2912,2832,80,1000,667,333,0.913871492010497,0.694300518134715,1.68756524350425,600,289,311,29,1.1,25.56,2,0,0,0,0,0,0,0.0742317468346879,117.848703928506,24.9680850209414
8.7,"max_tuv_SVM","SVM",25,10,2812,2741,71,1100,758,342,0.916625276627511,0.694300518134715,1.69067596284711,609,296,313,9,1.1,28.12,2.2,0,0,0,0,0,0,0.0601325913809888,91.0669415712551,18.6561434130103
8.7,"max_tuv_SVM","SVM",25,11,2712,2656,56,1200,843,357,0.920325399181218,0.689119170984456,1.70001671402307,620,303,317,11,1,30.67,2.4,0,0,0,0,0,0,0.0485497895533067,69.0650899279445,9.82076497933107
8.7,"max_tuv_SVM","SVM",25,12,2612,2560,52,1300,939,361,0.922335632562246,0.683937823834197,1.69845132110039,636,306,330,16,1.1,33.23,2.6,0,0,0,0,0,0,0.0506111237294863,72.0743451148364,9.01487754481484
8.7,"max_tuv_SVM","SVM",25,13,2512,2464,48,1400,1035,365,0.927126100999542,0.689119170984456,1.7264477714482,650,311,339,14,1.1,35.79,2.8,0,0,0,0,0,0,0.0423725381589607,55.2757565087676,7.70445361983684
8.7,"max_tuv_SVM","SVM",25,14,2412,2374,38,1500,1125,375,0.934273597465464,0.683937823834197,1.74672046990282,679,325,354,29,1.1,38.34,3,0,0,0,0,0,0,0.0523280984321127,55.3673732869713,8.61080056111976
8.7,"max_tuv_SVM","SVM",25,15,2312,2279,33,1600,1220,380,0.934805545187644,0.673575129533679,1.75606122107877,690,331,359,11,1.1,40.9,3.2,0,0,0,0,0,0,0.0556385736221128,51.5907966855678,8.84539919945241
8.7,"max_tuv_SVM","SVM",25,16,2212,2185,27,1700,1314,386,0.934132528456271,0.66839378238342,1.75444422179601,709,338,371,19,1.1,43.46,3.4,0,0,0,0,0,0,0.0534724133295465,48.0675154984618,8.83510883853924
8.7,"max_tuv_SVM","SVM",25,17,2112,2091,21,1800,1408,392,0.933192068394961,0.66839378238342,1.74511207168007,727,345,382,18,1.1,46.01,3.6,0,0,0,0,0,0,0.0487552031827245,46.196081271963,8.41449634206691
8.7,"max_tuv_SVM","SVM",25,18,2012,1996,16,1900,1503,397,0.93268657111201,0.673575129533679,1.74672046990282,737,351,386,10,1.1,48.57,3.8,0,0,0,0,0,0,0.0366367007008703,36.0120768335356,6.90743019309939
8.7,"max_tuv_SVM","SVM",25,19,1912,1896,16,2000,1603,397,0.932674815361244,0.673575129533679,1.74672046990282,738,353,385,1,1.1,51.12,4,0,0,0,0,0,0,0.0291439116357266,29.9304143440991,5.94423955538657
8.7,"max_tuv_SVM","SVM",25,20,1812,1799,13,2100,1700,400,0.932751227741225,0.673575129533679,1.74672046990282,738,355,383,0,1.1,53.68,4.2,0,0,0,0,0,0,0.0241284863169508,24.2990785295787,4.47359471932436
8.7,"max_tuv_SVM","SVM",25,21,1712,1703,9,2200,1796,404,0.932896705156962,0.673575129533679,1.75121914050594,759,364,395,21,1.1,56.24,4.4,0,0,0,0,0,0,0.0177013917267481,15.7847142711754,2.06898232609645
8.7,"max_tuv_SVM","SVM",25,22,1612,1604,8,2300,1895,405,0.932880540999653,0.66839378238342,1.75283019767292,759,366,393,0,1.1,58.79,4.7,0,0,0,0,0,0,0.0175479485916933,14.1183676545553,1.76238399060654
8.7,"max_tuv_SVM","SVM",25,23,1512,1504,8,2400,1995,405,0.93230744814979,0.66839378238342,1.77474272343067,785,380,405,26,1.1,61.35,4.9,0,0,0,0,0,0,0.0106841817473768,6.53107629537433,1.48403294420309
8.7,"max_tuv_SVM","SVM",25,24,1412,1406,6,2500,2093,407,0.932198707455202,0.66839378238342,1.77474272343067,791,383,408,6,1.1,63.91,5.1,0,0,0,0,0,0,0.00825050116746197,5.60255813645672,0.973228126910358
8.7,"max_tuv_SVM","SVM",25,25,1312,1307,5,2600,2192,408,0.932338306995552,0.66839378238342,1.77310852202788,790,384,406,-1,1.1,66.46,5.4,0,0,0,0,0,0,0.00653858746596617,4.46866113394237,0.715706862847268
8.7,"max_tuv_SVM","SVM",25,26,1212,1207,5,2700,2292,408,0.932330959651323,0.66839378238342,1.7714773274354,789,384,405,-1,1.1,69.02,5.6,0,0,0,0,0,0,0.00634428002285094,3.93471244879183,0.651129323667916
8.7,"max_tuv_SVM","SVM",25,27,1112,1107,5,2800,2392,408,0.932017962787167,0.66839378238342,1.76984913136239,797,386,411,8,1.1,71.57,5.9,0,0,0,0,0,0,0.00466394152244793,2.62708090482104,0.510535997163732
8.7,"max_tuv_SVM","SVM",25,28,1012,1007,5,2900,2492,408,0.932001798629863,0.66839378238342,1.7714773274354,796,387,409,-1,1.1,74.13,6.1,0,0,0,0,0,0,0.00424324521059453,1.99960282315581,0.43329189640715
8.7,"max_tuv_SVM","SVM",25,29,912,907,5,3000,2592,408,0.932239852582874,0.663212435233161,1.7714773274354,805,391,414,9,1.1,76.69,6.4,0,0,0,0,0,0,0.00383692183680635,1.54815884764936,0.418382168451648
8.7,"max_tuv_SVM","SVM",25,30,812,807,5,3100,2692,408,0.932316264962855,0.663212435233161,1.76498245180777,807,392,415,2,1.1,79.24,6.6,0,0,0,0,0,0,0.00328105850987149,1.07380457330322,0.348466149937947
8.7,"max_tuv_SVM","SVM",25,31,712,707,5,3200,2792,408,0.932233974707489,0.663212435233161,1.77474272343067,808,394,414,1,1.1,81.8,6.8,0,0,0,0,0,0,0.00214314034467382,0.625988516015427,0.257850961629406
8.7,"max_tuv_SVM","SVM",25,32,612,610,2,3300,2889,411,0.933211171489938,0.66839378238342,1.76984913136239,821,399,422,13,1.1,84.36,7,0,0,0,0,0,0,0.00192427039881011,0.610761352885603,0.249701586091821
8.7,"max_tuv_SVM","SVM",25,33,512,511,1,3400,2988,412,0.933812184247869,0.66839378238342,1.76984913136239,829,402,427,8,1.1,86.91,7.3,0,0,0,0,0,0,0.00114916493810679,0.365795590843775,0.15618992185598
8.7,"max_tuv_SVM","SVM",25,34,412,411,1,3500,3088,412,0.934103139079334,0.66839378238342,1.76984913136239,830,404,426,1,1.1,89.47,7.5,0,0,0,0,0,0,0.000582597482714212,0.164355561628213,0.0754803904782131
8.7,"max_tuv_SVM","SVM",25,35,312,312,0,3600,3187,413,0.934626269988435,0.658031088082902,1.7714773274354,834,407,427,4,1,92.02,7.7,0,0,0,0,0,0,0.000484815448325949,0.124540926937811,0.0635690172027473
8.7,"max_tuv_SVM","SVM",25,36,212,212,0,3700,3287,413,0.934640964676893,0.658031088082902,1.7714773274354,838,407,431,4,1.1,94.58,8,0,0,0,0,0,0,0.000238113354390324,0.0493744729956111,0.0311824002981359
8.7,"max_tuv_SVM","SVM",25,37,112,112,0,3800,3387,413,0.934854037659533,0.658031088082902,1.76660170176356,840,409,431,2,1.1,97.14,8.2,0,0,0,0,0,0,8.24208346222267e-05,0.0146376309885969,0.0137487506598586
8.7,"max_tuv_SVM","SVM",25,38,12,12,0,3900,3487,413,0.935093561081398,0.658031088082902,1.7714773274354,841,409,432,1,1.1,99.69,8.4,0,0,0,0,0,0,6.14439468083403e-05,0.00084236198071531,0.00084236198071531
8.7,"max_tuv_SVM","SVM",25,39,0,0,0,3912,3499,413,0.935250794247898,0.658031088082902,1.77310852202788,841,409,432,0,1.1,100,8.5,0,0,0,0,0,0,0,0,0
8.7,"max_tuv_SVM","SVM",26,0,3812,3410,402,100,88,12,0.902382133408902,0.536458333333333,1.76807851239669,29,12,17,0,1.4,2.56,7.3,0,0,0,0,0,0,0.72513446404959,479.946993405817,77.3368638548639
8.7,"max_tuv_SVM","SVM",26,1,3712,3347,365,200,151,49,0.884240067554798,0.572916666666667,1.71667817679558,110,49,61,81,1.2,5.11,3.1,0,0,0,0,0,0,0.746646564222463,456.994036567229,81.3634243373747
8.7,"max_tuv_SVM","SVM",26,2,3612,3303,309,300,195,105,0.896329365079361,0.572916666666667,1.73682401466544,191,95,96,81,1,7.67,1.9,0,0,0,0,0,0,0.61302480518039,440.527105604997,73.5812441256281
8.7,"max_tuv_SVM","SVM",26,3,3512,3240,272,400,258,142,0.874219045256994,0.59375,1.6697744014733,280,138,142,89,1,10.22,1.8,0,0,0,0,0,0,0.603192919080904,345.536901786468,71.3608678454055
8.7,"max_tuv_SVM","SVM",26,4,3412,3202,210,500,296,204,0.867304126511709,0.614583333333333,1.64194139194139,364,182,182,84,1,12.78,1.5,0,0,0,0,0,0,0.330595743078437,292.26944576034,69.2284714511926
8.7,"max_tuv_SVM","SVM",26,5,3312,3146,166,600,352,248,0.873184169501129,0.609375,1.61348987108656,436,219,217,72,1,15.34,1.4,0,0,0,0,0,0,0.243070844945668,224.468892980516,62.8723699843656
8.7,"max_tuv_SVM","SVM",26,6,3212,3075,137,700,423,277,0.872466695011338,0.630208333333333,1.59822247706422,480,235,245,44,1,17.89,1.5,0,0,0,0,0,0,0.126126152404452,153.55626218803,53.3825652150382
8.7,"max_tuv_SVM","SVM",26,7,3112,3011,101,800,487,313,0.86767172146636,0.625,1.59326126954922,526,254,272,46,1.1,20.45,1.6,0,0,0,0,0,0,0.0960106488831163,146.526355334493,38.2724161363821
8.7,"max_tuv_SVM","SVM",26,8,3012,2932,80,900,566,334,0.873472045068028,0.640625,1.59472836095764,560,268,292,34,1.1,23.01,1.7,0,0,0,0,0,0,0.0724329975218114,123.558627525247,26.7575393352764
8.7,"max_tuv_SVM","SVM",26,9,2912,2850,62,1000,648,352,0.88112363000756,0.630208333333333,1.61348987108656,580,278,302,20,1.1,25.56,1.8,0,0,0,0,0,0,0.067283794003952,118.097164973396,19.0228685686917
8.7,"max_tuv_SVM","SVM",26,10,2812,2761,51,1100,737,363,0.893090395880569,0.630208333333333,1.6401218951242,606,288,318,26,1.1,28.12,2,0,0,0,0,0,0,0.0613567203246269,103.713182177592,16.6157285778836
8.7,"max_tuv_SVM","SVM",26,11,2712,2667,45,1200,831,369,0.903817082388506,0.614583333333333,1.64043915827996,628,300,328,22,1.1,30.67,2.3,0,0,0,0,0,0,0.0611719471862687,98.1400335761862,16.4081972726941
8.7,"max_tuv_SVM","SVM",26,12,2612,2575,37,1300,923,377,0.911915981670447,0.604166666666667,1.66517447199265,647,313,334,19,1.1,33.23,2.4,0,0,0,0,0,0,0.0591926073219386,80.2272641460702,13.4712423062113
8.7,"max_tuv_SVM","SVM",26,13,2512,2480,32,1400,1018,382,0.921913383408931,0.604166666666667,1.75872359963269,664,319,345,17,1.1,35.79,2.7,0,0,0,0,0,0,0.0525406572820022,64.4907120291954,12.002717332805
8.7,"max_tuv_SVM","SVM",26,14,2412,2386,26,1500,1112,388,0.924217864229039,0.604166666666667,1.76970358455882,667,320,347,3,1.1,38.34,2.9,0,0,0,0,0,0,0.0455198968108419,50.0792214454359,7.74163710255328
8.7,"max_tuv_SVM","SVM",26,15,2312,2289,23,1600,1209,391,0.926100127551036,0.604166666666667,1.7774334251607,678,324,354,11,1.1,40.9,3.1,0,0,0,0,0,0,0.0396982386469074,40.5247397258051,6.31263345436602
8.7,"max_tuv_SVM","SVM",26,16,2212,2194,18,1700,1304,396,0.926878129724127,0.604166666666667,1.78234346224678,687,331,356,9,1.1,43.46,3.3,0,0,0,0,0,0,0.0360210521023228,36.2642072319479,6.14604018428803
8.7,"max_tuv_SVM","SVM",26,17,2112,2099,13,1800,1399,401,0.926380621693135,0.604166666666667,1.77459677419355,708,336,372,21,1.1,46.01,3.5,0,0,0,0,0,0,0.0297228930189497,31.3536632570936,4.46881309217511
8.7,"max_tuv_SVM","SVM",26,18,2012,2001,11,1900,1497,403,0.926294997165546,0.604166666666667,1.77296270718232,710,337,373,2,1.1,48.57,3.7,0,0,0,0,0,0,0.0251456184053193,25.9257596103082,2.68857361394615
8.7,"max_tuv_SVM","SVM",26,19,1912,1901,11,2000,1597,403,0.926543013038562,0.604166666666667,1.78234346224678,707,339,368,-3,1.1,51.12,4,0,0,0,0,0,0,0.0185647754015041,19.3203008993747,2.01833670031239
8.7,"max_tuv_SVM","SVM",26,20,1812,1803,9,2100,1695,405,0.926994756235839,0.609375,1.7774334251607,712,342,370,5,1.1,53.68,4.2,0,0,0,0,0,0,0.0170560064309905,17.8839498368058,1.82983403161023
8.7,"max_tuv_SVM","SVM",26,21,1712,1704,8,2200,1794,406,0.927050855064257,0.604166666666667,1.77906709558824,722,350,372,10,1.1,56.24,4.4,0,0,0,0,0,0,0.0138170004104054,13.7292869352133,1.44357258625687
8.7,"max_tuv_SVM","SVM",26,22,1612,1605,7,2300,1893,407,0.926788076341644,0.59375,1.7774334251607,737,360,377,15,1,58.79,4.7,0,0,0,0,0,0,0.0115416132239324,9.93828938503885,1.40073783716128
8.7,"max_tuv_SVM","SVM",26,23,1512,1505,7,2400,1993,407,0.926770360922144,0.59375,1.77580275229358,737,360,377,0,1,61.35,4.9,0,0,0,0,0,0,0.00967074941691556,8.3946095626772,1.00451639182039
8.7,"max_tuv_SVM","SVM",26,24,1412,1406,6,2500,2092,408,0.927520313681007,0.59375,1.7774334251607,748,366,382,11,1,63.91,5.1,0,0,0,0,0,0,0.00690500272342008,5.71844074225522,0.795485579576257
8.7,"max_tuv_SVM","SVM",26,25,1312,1307,5,2600,2191,409,0.927455357142838,0.59375,1.78070377184913,753,367,386,5,1.1,66.46,5.4,0,0,0,0,0,0,0.00690370000970482,5.24068864629216,0.708521750183154
8.7,"max_tuv_SVM","SVM",26,26,1212,1207,5,2700,2291,409,0.92704199735448,0.59375,1.7774334251607,761,373,388,8,1,69.02,5.6,0,0,0,0,0,0,0.00532696878216855,3.76754281521651,0.613782554504379
8.7,"max_tuv_SVM","SVM",26,27,1112,1108,4,2800,2390,410,0.926956372826892,0.59375,1.78070377184913,764,374,390,3,1,71.57,5.8,0,0,0,0,0,0,0.0047487934916955,3.0087900192363,0.489711358377516
8.7,"max_tuv_SVM","SVM",26,28,1012,1008,4,2900,2490,410,0.926345190854104,0.588541666666667,1.78070377184913,772,378,394,8,1,74.13,6.1,0,0,0,0,0,0,0.00475513768858798,2.77514477346276,0.505525920875659
8.7,"max_tuv_SVM","SVM",26,29,912,909,3,3000,2589,411,0.926176894368843,0.583333333333333,1.7774334251607,776,381,395,4,1,76.69,6.3,0,0,0,0,0,0,0.00400919173084907,2.03607890553924,0.426731651065016
8.7,"max_tuv_SVM","SVM",26,30,812,809,3,3100,2689,411,0.925748771730899,0.583333333333333,1.78070377184913,777,382,395,1,1,79.24,6.5,0,0,0,0,0,0,0.00317674076241814,1.40829233359414,0.341198333948206
8.7,"max_tuv_SVM","SVM",26,31,712,710,2,3200,2788,412,0.925914115646243,0.583333333333333,1.78514908256881,778,382,396,1,1,81.8,6.8,0,0,0,0,0,0,0.00306291822587442,1.24571421654355,0.332282721684898
8.7,"max_tuv_SVM","SVM",26,32,612,610,2,3300,2888,412,0.925922973355994,0.583333333333333,1.79007589696412,778,382,396,0,1,84.36,7,0,0,0,0,0,0,0.00270493042145651,0.975711615611149,0.295616765896967
8.7,"max_tuv_SVM","SVM",26,33,512,510,2,3400,2988,412,0.925990882464082,0.583333333333333,1.7867883379247,780,383,397,2,1,86.91,7.3,0,0,0,0,0,0,0.00192557451953272,0.627522134906585,0.22148138968763
8.7,"max_tuv_SVM","SVM",26,34,412,412,0,3500,3086,414,0.926249232331809,0.588541666666667,1.78843060661765,788,387,401,8,1,89.47,7.5,0,0,0,0,0,0,0.00202553753849272,0.630199273090727,0.245326458641137
8.7,"max_tuv_SVM","SVM",26,35,312,312,0,3600,3186,414,0.926168036659096,0.583333333333333,1.79337557603687,787,388,399,-1,1,92.02,7.7,0,0,0,0,0,0,0.0014073504825311,0.36762204484132,0.169714004736618
8.7,"max_tuv_SVM","SVM",26,36,212,212,0,3700,3286,414,0.926323046579731,0.583333333333333,1.78843060661765,792,389,403,5,1,94.58,7.9,0,0,0,0,0,0,0.000756834038483479,0.161838154385894,0.0965342468879581
8.7,"max_tuv_SVM","SVM",26,37,112,112,0,3800,3386,414,0.926182799508681,0.578125,1.79337557603687,797,391,406,5,1,97.14,8.2,0,0,0,0,0,0,0.000459464488125293,0.0703183404346163,0.065457394753132
8.7,"max_tuv_SVM","SVM",26,38,12,12,0,3900,3486,414,0.926101603835968,0.578125,1.79172421731123,798,391,407,1,1,99.69,8.4,0,0,0,0,0,0,0.000270992260603133,0.00406233160968141,0.00406233160968141
8.7,"max_tuv_SVM","SVM",26,39,0,0,0,3912,3498,414,0.926135558390012,0.578125,1.7867883379247,798,391,407,0,1,100,8.4,0,0,0,0,0,0,0,0,0
8.7,"max_tuv_SVM","SVM",27,0,3812,3405,407,100,86,14,0.855345124910353,0.432432432432432,1.71506289699838,37,14,23,0,1.6,2.56,6.1,0,0,0,0,0,0,0.364922117690811,482.172054330704,43.7506726299466
8.7,"max_tuv_SVM","SVM",27,1,3712,3360,352,200,131,69,0.907940238375025,0.518918918918919,1.7426907570554,131,64,67,94,1,5.11,1.9,0,0,0,0,0,0,0.574623740232214,589.821977288737,63.5220701189794
8.7,"max_tuv_SVM","SVM",27,2,3612,3323,289,300,168,132,0.897622354144106,0.594594594594595,1.67809571038929,203,100,103,72,1,7.67,1.3,0,0,0,0,0,0,0.69645435220219,490.704127074577,76.9405493567869
8.7,"max_tuv_SVM","SVM",27,3,3512,3266,246,400,225,175,0.897558258427833,0.583783783783784,1.67809571038929,302,151,151,99,1,10.22,1.3,0,0,0,0,0,0,0.6224229644563,501.523146342709,71.5663018032197
8.7,"max_tuv_SVM","SVM",27,4,3412,3208,204,500,283,217,0.847363682146297,0.616216216216216,1.5660061165121,395,193,202,93,1,12.78,1.3,0,0,0,0,0,0,0.591665051008755,416.273537833016,78.4223204252443
8.7,"max_tuv_SVM","SVM",27,5,3312,3135,177,600,356,244,0.873464373464371,0.637837837837838,1.62586232641481,457,221,236,62,1.1,15.34,1.5,0,0,0,0,0,0,0.301286516445951,263.837596883438,78.2638399730851
8.7,"max_tuv_SVM","SVM",27,6,3212,3090,122,700,401,299,0.875049979397799,0.637837837837838,1.61019588395735,517,251,266,60,1.1,17.89,1.3,0,0,0,0,0,0,0.148066147581334,203.218523633741,46.6906784517439
8.7,"max_tuv_SVM","SVM",27,7,3112,3014,98,800,477,323,0.871762784806256,0.659459459459459,1.60639092130805,564,270,294,47,1.1,20.45,1.5,0,0,0,0,0,0,0.119151394945401,206.794765735303,40.2383284661443
8.7,"max_tuv_SVM","SVM",27,8,3012,2929,83,900,562,338,0.873398751659617,0.654054054054054,1.60491310077327,583,280,303,19,1.1,23.01,1.7,0,0,0,0,0,0,0.0737979867944638,128.829553112139,28.0102077671156
8.7,"max_tuv_SVM","SVM",27,9,2912,2842,70,1000,649,351,0.875948845514059,0.654054054054054,1.61315580286169,605,290,315,22,1.1,25.56,1.8,0,0,0,0,0,0,0.0603544507642053,101.168850629516,20.5664711373525
8.7,"max_tuv_SVM","SVM",27,10,2812,2750,62,1100,741,359,0.883864666473358,0.643243243243243,1.61463984683856,624,298,326,19,1.1,28.12,2.1,0,0,0,0,0,0,0.0558414347040778,90.9746827055806,17.4373850793223
8.7,"max_tuv_SVM","SVM",27,11,2712,2656,56,1200,835,365,0.892276466189519,0.637837837837838,1.62436659290385,633,303,330,9,1.1,30.67,2.3,0,0,0,0,0,0,0.0391185514895998,59.1360511693483,12.5966862752825
8.7,"max_tuv_SVM","SVM",27,12,2612,2572,40,1300,919,381,0.904765974331204,0.632432432432432,1.66327357716502,655,311,344,22,1.1,33.23,2.4,0,0,0,0,0,0,0.0581260995872089,74.2480241537564,7.52677579630556
8.7,"max_tuv_SVM","SVM",27,13,2512,2474,38,1400,1017,383,0.911158758984854,0.643243243243243,1.7040689040689,665,324,341,10,1.1,35.79,2.7,0,0,0,0,0,0,0.0364666327815613,46.5973142886522,5.14707219289075
8.7,"max_tuv_SVM","SVM",27,14,2412,2382,30,1500,1109,391,0.920429746516727,0.637837837837838,1.73948728139905,691,332,359,26,1.1,38.34,2.8,0,0,0,0,0,0,0.0469309637928146,46.0335601133925,5.59427436140642
8.7,"max_tuv_SVM","SVM",27,15,2312,2284,28,1600,1207,393,0.922505226853073,0.637837837837838,1.74108754568736,695,335,360,4,1.1,40.9,3.1,0,0,0,0,0,0,0.0370746429969876,35.4619974368355,4.20385393876824
8.7,"max_tuv_SVM","SVM",27,16,2212,2190,22,1700,1301,399,0.926518839562337,0.643243243243243,1.74759883850793,712,343,369,17,1.1,43.46,3.3,0,0,0,0,0,0,0.0402149941680518,37.2754764697927,4.51658946007773
8.7,"max_tuv_SVM","SVM",27,17,2112,2096,16,1800,1395,405,0.930138721443092,0.643243243243243,1.77353095030514,732,353,379,20,1.1,46.01,3.4,0,0,0,0,0,0,0.0405248087359655,35.8995768165983,4.97238161853579
8.7,"max_tuv_SVM","SVM",27,18,2012,2000,12,1900,1491,409,0.931148992018578,0.637837837837838,1.77189786471554,747,357,390,15,1.1,48.57,3.6,0,0,0,0,0,0,0.0313680269991973,29.2144870193931,3.81145506661489
8.7,"max_tuv_SVM","SVM",27,19,1912,1900,12,2000,1591,409,0.931176461611264,0.637837837837838,1.77026778388324,745,358,387,-2,1.1,51.12,3.9,0,0,0,0,0,0,0.025636977139052,23.681633528777,2.64317481188749
8.7,"max_tuv_SVM","SVM",27,20,1812,1800,12,2100,1691,409,0.930935339631007,0.627027027027027,1.76377734287908,754,367,387,9,1.1,53.68,4.1,0,0,0,0,0,0,0.0179983474775516,13.8367811837344,2.35104453825675
8.7,"max_tuv_SVM","SVM",27,21,1712,1701,11,2200,1790,410,0.93104827017872,0.621621621621622,1.76864069952305,755,368,387,1,1.1,56.24,4.4,0,0,0,0,0,0,0.0140735916475616,11.321516812049,1.49791162160829
8.7,"max_tuv_SVM","SVM",27,22,1612,1603,9,2300,1888,412,0.931503044546534,0.621621621621622,1.77026778388324,783,384,399,28,1,58.79,4.6,0,0,0,0,0,0,0.0105114388940577,7.86129362446716,1.23125236167703
8.7,"max_tuv_SVM","SVM",27,23,1512,1504,8,2400,1987,413,0.931651075129348,0.621621621621622,1.76864069952305,778,382,396,-5,1,61.35,4.8,0,0,0,0,0,0,0.0098424184843985,7.02504803608252,1.01481754267013
8.7,"max_tuv_SVM","SVM",27,24,1412,1404,8,2500,2087,413,0.932107375585641,0.610810810810811,1.76864069952305,785,385,400,7,1,63.91,5.1,0,0,0,0,0,0,0.00688080439692731,4.63376911238822,0.8355763030091
8.7,"max_tuv_SVM","SVM",27,25,1312,1305,7,2600,2186,414,0.931786897004296,0.610810810810811,1.76701660338024,790,386,404,5,1,66.46,5.3,0,0,0,0,0,0,0.00636135830212187,3.81344906596166,0.661976875048015
8.7,"max_tuv_SVM","SVM",27,26,1212,1205,7,2700,2286,414,0.933019976498234,0.616216216216216,1.76701660338024,791,389,402,1,1,69.02,5.5,0,0,0,0,0,0,0.00515199724673434,3.039105515341,0.598456088425253
8.7,"max_tuv_SVM","SVM",27,27,1112,1108,4,2800,2383,417,0.933276359363313,0.616216216216216,1.76377734287908,802,394,408,11,1,71.57,5.7,0,0,0,0,0,0,0.00560725622523704,2.9415459413947,0.621074971374934
8.7,"max_tuv_SVM","SVM",27,28,1012,1009,3,2900,2482,418,0.934082134082129,0.610810810810811,1.76701660338024,807,397,410,5,1,74.13,5.9,0,0,0,0,0,0,0.00436737253425701,2.12547453901767,0.491753580311049
8.7,"max_tuv_SVM","SVM",27,29,912,909,3,3000,2582,418,0.933961573092003,0.610810810810811,1.76864069952305,808,397,411,1,1,76.69,6.2,0,0,0,0,0,0,0.00388235295558667,1.74290843239971,0.419548808027113
8.7,"max_tuv_SVM","SVM",27,30,812,809,3,3100,2682,418,0.934155386329294,0.610810810810811,1.76701660338024,809,397,412,1,1,79.24,6.4,0,0,0,0,0,0,0.00307084955690471,1.24430680620114,0.333931475463029
8.7,"max_tuv_SVM","SVM",27,31,712,709,3,3200,2782,418,0.934251529903698,0.610810810810811,1.76864069952305,808,397,411,-1,1,81.8,6.7,0,0,0,0,0,0,0.00247111256428031,0.902100506834682,0.273074907147605
8.7,"max_tuv_SVM","SVM",27,32,612,609,3,3300,2882,418,0.934259160346112,0.610810810810811,1.77026778388324,810,397,413,2,1,84.36,6.9,0,0,0,0,0,0,0.00177814891107926,0.60182966480508,0.209447911390154
8.7,"max_tuv_SVM","SVM",27,33,512,509,3,3400,2982,418,0.934271369053974,0.610810810810811,1.76701660338024,811,399,412,1,1,86.91,7.1,0,0,0,0,0,0,0.00139861383212829,0.43259748441094,0.166303519980282
8.7,"max_tuv_SVM","SVM",27,34,412,411,1,3500,3080,420,0.933828803394016,0.610810810810811,1.76377734287908,818,402,416,7,1,89.47,7.3,0,0,0,0,0,0,0.00151789902233901,0.455913293704416,0.192654921995776
8.7,"max_tuv_SVM","SVM",27,35,312,312,0,3600,3179,421,0.933932577410833,0.605405405405405,1.76701660338024,828,406,422,10,1,92.02,7.6,0,0,0,0,0,0,0.00145006255249507,0.363945344055325,0.175767357604155
8.7,"max_tuv_SVM","SVM",27,36,212,212,0,3700,3279,421,0.933831855570981,0.605405405405405,1.77353095030514,830,408,422,2,1,94.58,7.8,0,0,0,0,0,0,0.000654519781489562,0.139106638548545,0.0861989066134297
8.7,"max_tuv_SVM","SVM",27,37,112,112,0,3800,3379,421,0.933746394615955,0.605405405405405,1.77353095030514,834,409,425,4,1,97.14,8,0,0,0,0,0,0,0.000320844443170506,0.0527339297529452,0.0491107542857445
8.7,"max_tuv_SVM","SVM",27,38,12,12,0,3900,3479,421,0.933758603323816,0.605405405405405,1.77353095030514,835,409,426,1,1,99.69,8.3,0,0,0,0,0,0,0.00024286129629932,0.00329953853744027,0.00329953853744027
8.7,"max_tuv_SVM","SVM",27,39,0,0,0,3912,3491,421,0.933709768492373,0.605405405405405,1.77353095030514,835,409,426,0,1,100,8.3,0,0,0,0,0,0,0,0,0
8.7,"max_tuv_SVM","SVM",28,0,3812,3424,388,100,89,11,0.906384048303665,0.584541062801932,1.72438389100381,26,11,15,0,1.4,2.56,8.1,0,0,0,0,0,0,0.376779011708992,433.854934481663,42.1197810542578
8.7,"max_tuv_SVM","SVM",28,1,3712,3386,326,200,127,73,0.926279475089984,0.599033816425121,1.77011218908452,99,48,51,73,1.1,5.11,1.7,0,0,0,0,0,0,0.801375869138653,439.567292862835,85.2665721570998
8.7,"max_tuv_SVM","SVM",28,2,3612,3318,294,300,195,105,0.895937775347131,0.632850241545894,1.68083884325119,183,89,94,84,1.1,7.67,1.9,0,0,0,0,0,0,0.705972695588266,272.617393571873,80.6313674916209
8.7,"max_tuv_SVM","SVM",28,3,3512,3266,246,400,247,153,0.879802951583098,0.661835748792271,1.66188912910027,272,134,138,89,1,10.22,1.6,0,0,0,0,0,0,0.640651419770089,285.134164259858,75.3889769890282
8.7,"max_tuv_SVM","SVM",28,4,3412,3218,194,500,295,205,0.869236527152859,0.647342995169082,1.60524879892469,358,176,182,86,1,12.78,1.4,0,0,0,0,0,0,0.517099846787562,267.965756627868,76.1872023524077
8.7,"max_tuv_SVM","SVM",28,5,3312,3150,162,600,363,237,0.882950367773997,0.657004830917874,1.63127986052887,427,209,218,69,1,15.34,1.5,0,0,0,0,0,0,0.263396902980677,209.200708213097,70.6741226922189
8.7,"max_tuv_SVM","SVM",28,6,3212,3086,126,700,427,273,0.880174454415634,0.661835748792271,1.62558830980094,489,235,254,62,1.1,17.89,1.6,0,0,0,0,0,0,0.119278852787695,137.016582474463,45.8095315228916
8.7,"max_tuv_SVM","SVM",28,7,3112,3018,94,800,495,305,0.88862925122154,0.666666666666667,1.63729379549856,517,249,268,28,1.1,20.45,1.6,0,0,0,0,0,0,0.0889456090164176,110.293648909118,25.2545624879059
8.7,"max_tuv_SVM","SVM",28,8,3012,2940,72,900,573,327,0.88932253903541,0.671497584541063,1.61838417807671,554,265,289,37,1.1,23.01,1.8,0,0,0,0,0,0,0.0715579705925586,105.562710817578,16.1548542681512
8.7,"max_tuv_SVM","SVM",28,9,2912,2853,59,1000,660,340,0.888463525050889,0.676328502415459,1.61116676684699,583,280,303,29,1.1,25.56,1.9,0,0,0,0,0,0,0.0637990525013706,108.447904770876,14.0678248032074
8.7,"max_tuv_SVM","SVM",28,10,2812,2762,50,1100,751,349,0.901467505241087,0.666666666666667,1.66188912910027,596,288,308,13,1.1,28.12,2.2,0,0,0,0,0,0,0.0543789467413369,78.8935977488458,9.55899813331546
8.7,"max_tuv_SVM","SVM",28,11,2712,2669,43,1200,844,356,0.908850606143479,0.676328502415459,1.68954785280171,605,293,312,9,1.1,30.67,2.4,0,0,0,0,0,0,0.049583286346234,72.1296792260087,6.23255153938324
8.7,"max_tuv_SVM","SVM",28,12,2612,2570,42,1300,943,357,0.919115961363707,0.671497584541063,1.71409507032856,616,301,315,11,1,33.23,2.6,0,0,0,0,0,0,0.0349117082690682,42.713643859985,4.98642811328645
8.7,"max_tuv_SVM","SVM",28,13,2512,2475,37,1400,1038,362,0.925762961858138,0.666666666666667,1.71805006587615,620,301,319,4,1.1,35.79,2.9,0,0,0,0,0,0,0.0440770772123549,51.8856872261784,5.11271248524598
8.7,"max_tuv_SVM","SVM",28,14,2412,2383,29,1500,1130,370,0.933735771717727,0.647342995169082,1.76630101155684,657,319,338,37,1.1,38.34,3.1,0,0,0,0,0,0,0.0647076809108618,56.7339748031394,7.46168838861138
8.7,"max_tuv_SVM","SVM",28,15,2312,2285,27,1600,1228,372,0.934239855486788,0.657004830917874,1.77011218908452,674,328,346,17,1.1,40.9,3.3,0,0,0,0,0,0,0.0577669752032011,42.9231880229206,6.11165440521341
8.7,"max_tuv_SVM","SVM",28,16,2212,2188,24,1700,1325,375,0.934156992401463,0.652173913043478,1.76630101155684,681,331,350,7,1.1,43.46,3.5,0,0,0,0,0,0,0.0538206325114917,37.3389136977226,5.90265370425839
8.7,"max_tuv_SVM","SVM",28,17,2112,2091,21,1800,1422,378,0.934057556699072,0.657004830917874,1.76467607962348,690,332,358,9,1.1,46.01,3.8,0,0,0,0,0,0,0.0432330825660822,30.5317284786815,5.24290488526587
8.7,"max_tuv_SVM","SVM",28,18,2012,1998,14,1900,1515,385,0.933523089798731,0.661835748792271,1.76305413469736,716,342,374,26,1.1,48.57,3.9,0,0,0,0,0,0,0.0342886822253211,26.9082772203533,4.49579441331182
8.7,"max_tuv_SVM","SVM",28,19,1912,1900,12,2000,1613,387,0.932570164317505,0.661835748792271,1.76630101155684,721,344,377,5,1.1,51.12,4.2,0,0,0,0,0,0,0.0245723944221056,20.0437654030733,2.83720568647007
8.7,"max_tuv_SVM","SVM",28,20,1812,1800,12,2100,1713,387,0.933030054441055,0.661835748792271,1.76630101155684,721,346,375,0,1.1,53.68,4.4,0,0,0,0,0,0,0.0195237262287607,16.3134296729925,2.129886978543
8.7,"max_tuv_SVM","SVM",28,21,1712,1700,12,2200,1813,387,0.933162635377579,0.661835748792271,1.77663794830695,722,346,376,1,1.1,56.24,4.7,0,0,0,0,0,0,0.0145551136000236,12.6238623814643,1.6000755168443
8.7,"max_tuv_SVM","SVM",28,22,1612,1601,11,2300,1912,388,0.932524589620584,0.657004830917874,1.77500200176155,727,350,377,5,1.1,58.79,4.9,0,0,0,0,0,0,0.0142915248542927,10.7527729727786,1.43480130122884
8.7,"max_tuv_SVM","SVM",28,23,1512,1501,11,2400,2012,388,0.932751082053806,0.652173913043478,1.78370299196626,747,364,383,20,1.1,61.35,5.2,0,0,0,0,0,0,0.00895310771820298,5.12048834267013,1.27755164060613
8.7,"max_tuv_SVM","SVM",28,24,1412,1402,10,2500,2111,389,0.932864328270415,0.657004830917874,1.78534695785748,749,365,384,2,1.1,63.91,5.4,0,0,0,0,0,0,0.00620720071500985,3.90855042402868,0.748425675155381
8.7,"max_tuv_SVM","SVM",28,25,1312,1304,8,2600,2209,391,0.933273119491348,0.657004830917874,1.7820620508513,760,368,392,11,1.1,66.46,5.6,0,0,0,0,0,0,0.0052349914641171,3.3080825255146,0.562205030274033
8.7,"max_tuv_SVM","SVM",28,26,1212,1204,8,2700,2309,391,0.933419510942086,0.657004830917874,1.78534695785748,759,369,390,-1,1.1,69.02,5.9,0,0,0,0,0,0,0.00447466403371385,2.5533781611529,0.469459205943
8.7,"max_tuv_SVM","SVM",28,27,1112,1105,7,2800,2408,392,0.933800681134577,0.657004830917874,1.78370299196626,767,374,393,8,1.1,71.57,6.1,0,0,0,0,0,0,0.00450107507977458,2.27308884184958,0.473961942858892
8.7,"max_tuv_SVM","SVM",28,28,1012,1006,6,2900,2507,393,0.934007838847888,0.657004830917874,1.79240398217098,768,377,391,1,1,74.13,6.4,0,0,0,0,0,0,0.00381295977622684,1.62496647546775,0.409864089922546
8.7,"max_tuv_SVM","SVM",28,29,912,906,6,3000,2607,393,0.934331004880652,0.647342995169082,1.79075503646521,775,379,396,7,1,76.69,6.6,0,0,0,0,0,0,0.00313635121865329,1.21224517192291,0.346209485015588
8.7,"max_tuv_SVM","SVM",28,30,812,807,5,3100,2706,394,0.934220520766887,0.647342995169082,1.79240398217098,776,379,397,1,1,79.24,6.9,0,0,0,0,0,0,0.00243081638843756,0.8214197387561,0.271384110345325
8.7,"max_tuv_SVM","SVM",28,31,712,708,4,3200,2805,395,0.934459442662906,0.652173913043478,1.79240398217098,783,383,400,7,1,81.8,7.1,0,0,0,0,0,0,0.00227833669574565,0.698844480385789,0.25560367390139
8.7,"max_tuv_SVM","SVM",28,32,612,609,3,3300,2904,396,0.934811610775535,0.652173913043478,1.794055967408,782,383,399,-1,1,84.36,7.3,0,0,0,0,0,0,0.00167316657628389,0.503439771703132,0.212102858070307
8.7,"max_tuv_SVM","SVM",28,33,512,510,2,3400,3003,397,0.934677648787596,0.647342995169082,1.79240398217098,787,385,402,5,1,86.91,7.6,0,0,0,0,0,0,0.00108208096898727,0.344640698081715,0.147238434486219
8.7,"max_tuv_SVM","SVM",28,34,412,410,2,3500,3103,397,0.934803324467003,0.642512077294686,1.79075503646521,791,386,405,4,1,89.47,7.8,0,0,0,0,0,0,0.00062992780702066,0.176825196161249,0.0799287788473014
8.7,"max_tuv_SVM","SVM",28,35,312,312,0,3600,3201,399,0.935272881950508,0.642512077294686,1.79240398217098,804,392,412,13,1.1,92.02,8,0,0,0,0,0,0,0.000626402947138306,0.154365244733432,0.0825486591288349
8.7,"max_tuv_SVM","SVM",28,36,212,212,0,3700,3301,399,0.935355745035832,0.642512077294686,1.78582635287861,809,393,416,5,1.1,94.58,8.3,0,0,0,0,0,0,0.000254955259342545,0.0543447155019662,0.0353647985035353
8.7,"max_tuv_SVM","SVM",28,37,112,112,0,3800,3401,399,0.935817016210803,0.647342995169082,1.794055967408,812,394,418,3,1.1,97.14,8.5,0,0,0,0,0,0,0.000129227138038334,0.0224349371841451,0.0211066472264975
8.7,"max_tuv_SVM","SVM",28,38,12,12,0,3900,3501,399,0.936122228575081,0.642512077294686,1.78582635287861,812,395,417,0,1.1,99.69,8.8,0,0,0,0,0,0,6.06257172246843e-05,0.00101457538858486,0.00101457538858486
8.7,"max_tuv_SVM","SVM",28,39,0,0,0,3912,3513,399,0.936210615866093,0.642512077294686,1.78582635287861,812,395,417,0,1.1,100,8.8,0,0,0,0,0,0,0,0,0
8.7,"max_tuv_SVM","SVM",29,0,3812,3411,401,100,87,13,0.906131897203331,0.520833333333333,1.76520737327189,35,13,22,0,1.7,2.56,6.7,0,0,0,0,0,0,0.414230258737418,509.352499160239,45.7212500793063
8.7,"max_tuv_SVM","SVM",29,1,3712,3365,347,200,133,67,0.901874291383225,0.572916666666667,1.70568389752973,120,58,62,85,1.1,5.11,2,0,0,0,0,0,0,0.684053056981475,580.385133283157,75.1026272972581
8.7,"max_tuv_SVM","SVM",29,2,3612,3317,295,300,181,119,0.879744779856383,0.536458333333333,1.66517447199265,208,100,108,88,1.1,7.67,1.5,0,0,0,0,0,0,0.719912761329957,546.904652143176,79.7062790476591
8.7,"max_tuv_SVM","SVM",29,3,3512,3248,264,400,250,150,0.877583498677246,0.588541666666667,1.62477085242896,274,134,140,66,1,10.22,1.7,0,0,0,0,0,0,0.694475371570238,409.394560748919,79.9248998239192
8.7,"max_tuv_SVM","SVM",29,4,3412,3185,227,500,313,187,0.882151124338638,0.635416666666667,1.6041091160221,359,174,185,85,1.1,12.78,1.7,0,0,0,0,0,0,0.680793011311124,376.124776038593,78.3127170829407
8.7,"max_tuv_SVM","SVM",29,5,3312,3136,176,600,362,238,0.873353942271355,0.640625,1.61988740808824,440,217,223,81,1,15.34,1.5,0,0,0,0,0,0,0.329088517614103,393.730675077029,73.9073107713407
8.7,"max_tuv_SVM","SVM",29,6,3212,3069,143,700,429,271,0.880218667328049,0.625,1.63225138121547,507,246,261,67,1.1,17.89,1.6,0,0,0,0,0,0,0.188621043207365,283.399885707745,64.5785570179294
8.7,"max_tuv_SVM","SVM",29,7,3112,3005,107,800,493,307,0.891218466553286,0.635416666666667,1.64646464646465,540,260,280,33,1.1,20.45,1.6,0,0,0,0,0,0,0.0930449097426034,166.145643464951,39.7850148959845
8.7,"max_tuv_SVM","SVM",29,8,3012,2923,89,900,575,325,0.894424957482991,0.630208333333333,1.65886614535419,560,270,290,20,1.1,23.01,1.8,0,0,0,0,0,0,0.070425368959364,128.59857436858,28.089126602017
8.7,"max_tuv_SVM","SVM",29,9,2912,2842,70,1000,656,344,0.896627574640966,0.625,1.6713133640553,580,276,304,20,1.1,25.56,1.9,0,0,0,0,0,0,0.0642393204231138,107.723728918198,14.904424028566
8.7,"max_tuv_SVM","SVM",29,10,2812,2755,57,1100,743,357,0.894327522675739,0.630208333333333,1.67606847426471,604,289,315,24,1.1,28.12,2.1,0,0,0,0,0,0,0.0588117671747865,82.0855350865642,10.1162129211732
8.7,"max_tuv_SVM","SVM",29,11,2712,2655,57,1200,843,357,0.896456325585796,0.635416666666667,1.67452938475666,604,290,314,0,1.1,30.67,2.4,0,0,0,0,0,0,0.0432225143304708,61.360174256103,8.37354171931589
8.7,"max_tuv_SVM","SVM",29,12,2612,2561,51,1300,937,363,0.90113024376417,0.635416666666667,1.68698252069917,613,296,317,9,1.1,33.23,2.6,0,0,0,0,0,0,0.0378884594984627,50.894026870124,4.81973775427828
8.7,"max_tuv_SVM","SVM",29,13,2512,2463,49,1400,1035,365,0.92096560846561,0.625,1.71509889604416,644,314,330,31,1.1,35.79,2.8,0,0,0,0,0,0,0.037452678591749,29.6817038187567,5.76960757707402
8.7,"max_tuv_SVM","SVM",29,14,2412,2369,43,1500,1129,371,0.923980182350718,0.625,1.72447102115915,656,319,337,12,1.1,38.34,3,0,0,0,0,0,0,0.0281582835134552,24.0768117042629,3.14921689082576
8.7,"max_tuv_SVM","SVM",29,15,2312,2276,36,1600,1222,378,0.928711675642475,0.625,1.74161305147059,679,329,350,23,1.1,40.9,3.2,0,0,0,0,0,0,0.0251597366492116,25.7843688399174,2.96051413450822
8.7,"max_tuv_SVM","SVM",29,16,2212,2189,23,1700,1309,391,0.928152163643233,0.630208333333333,1.76520737327189,714,348,366,35,1.1,43.46,3.3,0,0,0,0,0,0,0.0695972354468411,44.2185386227905,8.84443815616301
8.7,"max_tuv_SVM","SVM",29,17,2112,2089,23,1800,1409,391,0.928355890967498,0.630208333333333,1.75711009174312,721,352,369,7,1,46.01,3.6,0,0,0,0,0,0,0.0512016293725469,32.1500101534093,5.62955331614835
8.7,"max_tuv_SVM","SVM",29,18,2012,1991,21,1900,1507,393,0.92877515589569,0.630208333333333,1.76195952161914,729,356,373,8,1,48.57,3.8,0,0,0,0,0,0,0.0405589444454937,23.7575619254029,4.51067801821463
8.7,"max_tuv_SVM","SVM",29,19,1912,1899,13,2000,1599,401,0.927867240646256,0.635416666666667,1.76358195211786,750,364,386,21,1.1,51.12,4,0,0,0,0,0,0,0.0416961535195326,21.2885185688176,5.1593905526308
8.7,"max_tuv_SVM","SVM",29,20,1812,1804,8,2100,1694,406,0.927452404572937,0.635416666666667,1.76195952161914,758,368,390,8,1.1,53.68,4.2,0,0,0,0,0,0,0.0245396386857652,18.0229573467146,3.58973198144022
8.7,"max_tuv_SVM","SVM",29,21,1712,1706,6,2200,1792,408,0.927836238662131,0.635416666666667,1.76520737327189,768,370,398,10,1.1,56.24,4.4,0,0,0,0,0,0,0.0160763928855641,13.1808897138875,1.89389791362448
8.7,"max_tuv_SVM","SVM",29,22,1612,1606,6,2300,1892,408,0.927942531179138,0.635416666666667,1.75711009174312,766,370,396,-2,1.1,58.79,4.6,0,0,0,0,0,0,0.0117970830198092,10.1327671263308,1.30656445671984
8.7,"max_tuv_SVM","SVM",29,23,1512,1507,5,2400,1991,409,0.927935149754344,0.630208333333333,1.76358195211786,772,373,399,6,1.1,61.35,4.9,0,0,0,0,0,0,0.0113633590426283,9.18319085898575,1.16422368907835
8.7,"max_tuv_SVM","SVM",29,24,1412,1408,4,2500,2090,410,0.928810586734696,0.625,1.75872359963269,789,382,407,17,1.1,63.91,5.1,0,0,0,0,0,0,0.00827586306348589,6.04831834177765,0.989381500511394
8.7,"max_tuv_SVM","SVM",29,25,1312,1308,4,2600,2190,410,0.928786966175361,0.625,1.76034007352941,789,382,407,0,1.1,66.46,5.3,0,0,0,0,0,0,0.00761928348033688,5.17061912988489,0.788565630204795
8.7,"max_tuv_SVM","SVM",29,26,1212,1208,4,2700,2290,410,0.928984788359789,0.619791666666667,1.76358195211786,793,385,408,4,1.1,69.02,5.6,0,0,0,0,0,0,0.00588928945686113,3.68814319907272,0.644733240283697
8.7,"max_tuv_SVM","SVM",29,27,1112,1109,3,2800,2389,411,0.929228375377929,0.619791666666667,1.76358195211786,794,385,409,1,1.1,71.57,5.8,0,0,0,0,0,0,0.00592495697859127,3.36312872338138,0.614925966126083
8.7,"max_tuv_SVM","SVM",29,28,1012,1009,3,2900,2489,411,0.929438007842028,0.619791666666667,1.75420119705341,804,389,415,10,1.1,74.13,6.1,0,0,0,0,0,0,0.00446867489161469,2.2522792222986,0.486917900314294
8.7,"max_tuv_SVM","SVM",29,29,912,910,2,3000,2588,412,0.929671260865458,0.614583333333333,1.75420119705341,806,391,415,2,1.1,76.69,6.3,0,0,0,0,0,0,0.00421857538332095,1.90540943919112,0.447402751811824
8.7,"max_tuv_SVM","SVM",29,30,812,810,2,3100,2688,412,0.929622543461833,0.614583333333333,1.75258739650414,808,392,416,2,1.1,79.24,6.5,0,0,0,0,0,0,0.00349031043316542,1.33612169524431,0.373800899063226
8.7,"max_tuv_SVM","SVM",29,31,712,710,2,3200,2788,412,0.929681594860171,0.614583333333333,1.75258739650414,808,393,415,0,1.1,81.8,6.8,0,0,0,0,0,0,0.00284859572439668,0.947624509921629,0.314881564202882
8.7,"max_tuv_SVM","SVM",29,32,612,610,2,3300,2888,412,0.929746551398343,0.614583333333333,1.75581797235023,809,393,416,1,1.1,84.36,7,0,0,0,0,0,0,0.00193939312424078,0.588403788151969,0.237310625778247
8.7,"max_tuv_SVM","SVM",29,33,512,511,1,3400,2987,413,0.930106764928201,0.614583333333333,1.74936868686869,808,394,414,-1,1.1,86.91,7.2,0,0,0,0,0,0,0.0011798675782062,0.38607649480999,0.15864346990087
8.7,"max_tuv_SVM","SVM",29,34,412,412,0,3500,3086,414,0.930565889550272,0.614583333333333,1.7509765625,817,398,419,9,1.1,89.47,7.5,0,0,0,0,0,0,0.00104340711957366,0.317985886472781,0.127516811688169
8.7,"max_tuv_SVM","SVM",29,35,312,312,0,3600,3186,414,0.93119035808769,0.604166666666667,1.75581797235023,824,399,425,7,1.1,92.02,7.7,0,0,0,0,0,0,0.000698603109261836,0.17190661750097,0.0830627940497227
8.7,"max_tuv_SVM","SVM",29,36,212,212,0,3700,3286,414,0.931746917517021,0.604166666666667,1.75420119705341,827,402,425,3,1.1,94.58,7.9,0,0,0,0,0,0,0.000381538308374944,0.078447424326579,0.0496290276750354
8.7,"max_tuv_SVM","SVM",29,37,112,112,0,3800,3386,414,0.931801540060481,0.598958333333333,1.75581797235023,826,403,423,-1,1,97.14,8.2,0,0,0,0,0,0,0.000174412155245605,0.0285626793200401,0.0266692857697335
8.7,"max_tuv_SVM","SVM",29,38,12,12,0,3900,3486,414,0.932067271352998,0.598958333333333,1.75581797235023,827,404,423,1,1,99.69,8.4,0,0,0,0,0,0,0.0001171299128853,0.00157531267182496,0.00157531267182496
8.7,"max_tuv_SVM","SVM",29,39,0,0,0,3912,3498,414,0.932020030234328,0.59375,1.74616177818515,827,404,423,0,1,100,8.4,0,0,0,0,0,0,0,0,0
8.7,"max_tuv_SVM","SVM",30,0,3812,3413,399,100,89,11,0.895785018552878,0.510204081632653,1.76646059883808,30,11,19,0,1.7,2.56,8.1,0,0,0,0,0,0,0.556675881395441,413.890762576428,60.690153567206
8.7,"max_tuv_SVM","SVM",30,1,3712,3383,329,200,119,81,0.906352910482375,0.510204081632653,1.79449541284404,100,51,49,70,1,5.11,1.5,0,0,0,0,0,0,0.629387791162532,349.753529117619,68.4598324782009
8.7,"max_tuv_SVM","SVM",30,2,3612,3321,291,300,181,119,0.88316616419295,0.556122448979592,1.70606992797119,185,93,92,85,1,7.67,1.5,0,0,0,0,0,0,0.622650880381425,332.820290987062,73.0365274912496
8.7,"max_tuv_SVM","SVM",30,3,3512,3271,241,400,231,169,0.872376507421154,0.576530612244898,1.68927773501305,275,134,141,90,1.1,10.22,1.4,0,0,0,0,0,0,0.54634131631014,201.887159483303,73.5721261066181
8.7,"max_tuv_SVM","SVM",30,4,3412,3221,191,500,281,219,0.860047541743973,0.571428571428571,1.66173516324653,361,180,181,86,1,12.78,1.3,0,0,0,0,0,0,0.407066657267488,204.900493726279,70.1244005913622
8.7,"max_tuv_SVM","SVM",30,5,3312,3150,162,600,352,248,0.873765074211517,0.596938775510204,1.64337344873552,414,205,209,53,1,15.34,1.4,0,0,0,0,0,0,0.146801998610783,115.347499492373,56.0382145287747
8.7,"max_tuv_SVM","SVM",30,6,3212,3096,116,700,406,294,0.875039134972181,0.602040816326531,1.6356973728718,460,224,236,46,1.1,17.89,1.4,0,0,0,0,0,0,0.0773307316650371,68.5374536214835,29.0158015307686
8.7,"max_tuv_SVM","SVM",30,7,3112,3027,85,800,475,325,0.873027307513923,0.612244897959184,1.6173187507047,502,246,256,42,1,20.45,1.5,0,0,0,0,0,0,0.054720383021884,56.9367984399918,17.336800602383
8.7,"max_tuv_SVM","SVM",30,8,3012,2953,59,900,549,351,0.874504290352499,0.612244897959184,1.62800714755948,547,268,279,45,1,23.01,1.6,0,0,0,0,0,0,0.050299613611009,62.243164742926,11.0256167994152
8.7,"max_tuv_SVM","SVM",30,9,2912,2867,45,1000,635,365,0.886598446196667,0.61734693877551,1.63419259148001,578,281,297,31,1.1,25.56,1.7,0,0,0,0,0,0,0.0496200604593171,70.6474769649144,7.67661492434657
8.7,"max_tuv_SVM","SVM",30,10,2812,2774,38,1100,728,372,0.896501043599256,0.607142857142857,1.64488668395535,598,292,306,20,1,28.12,2,0,0,0,0,0,0,0.042471884662319,61.20305970031,6.17561652886103
8.7,"max_tuv_SVM","SVM",30,11,2712,2684,28,1200,818,382,0.906394944341363,0.602040816326531,1.69533929274189,629,303,326,31,1.1,30.67,2.1,0,0,0,0,0,0,0.0638277062772213,69.1749761915857,8.39908274830419
8.7,"max_tuv_SVM","SVM",30,12,2612,2585,27,1300,917,383,0.907455936920214,0.602040816326531,1.6968975090036,647,313,334,18,1.1,33.23,2.4,0,0,0,0,0,0,0.0525910659998004,51.7575036850982,6.73723273474659
8.7,"max_tuv_SVM","SVM",30,13,2512,2487,25,1400,1015,385,0.909711270871979,0.602040816326531,1.71840117262375,655,318,337,8,1.1,35.79,2.6,0,0,0,0,0,0,0.0442089565770422,40.5824489469355,5.83456229869073
8.7,"max_tuv_SVM","SVM",30,14,2412,2391,21,1500,1111,389,0.909470663265298,0.607142857142857,1.72600116403507,666,321,345,11,1.1,38.34,2.9,0,0,0,0,0,0,0.0399130991603955,34.1170796158217,4.93436704194587
8.7,"max_tuv_SVM","SVM",30,15,2312,2298,14,1600,1204,396,0.91053890306122,0.602040816326531,1.73677979479084,680,331,349,14,1.1,40.9,3,0,0,0,0,0,0,0.0362317249133279,31.7303183339801,4.4757353684888
8.7,"max_tuv_SVM","SVM",30,16,2212,2205,7,1700,1297,403,0.910573689703147,0.596938775510204,1.72759048370729,702,338,364,22,1.1,43.46,3.2,0,0,0,0,0,0,0.0274302941073918,26.9777231849026,3.32297051094294
8.7,"max_tuv_SVM","SVM",30,17,2112,2106,6,1800,1396,404,0.910209879406301,0.596938775510204,1.72600116403507,705,341,364,3,1.1,46.01,3.5,0,0,0,0,0,0,0.0229845910886379,23.2762852085771,2.51979199548661
8.7,"max_tuv_SVM","SVM",30,18,2012,2006,6,1900,1496,404,0.909827226345077,0.596938775510204,1.72441476590636,705,341,364,0,1.1,48.57,3.7,0,0,0,0,0,0,0.0168649727555637,16.793245655502,1.83494159823789
8.7,"max_tuv_SVM","SVM",30,19,1912,1907,5,2000,1595,405,0.909908395176248,0.612244897959184,1.73358718487395,713,344,369,8,1.1,51.12,3.9,0,0,0,0,0,0,0.0147523913124794,14.7036976802601,1.58977731445863
8.7,"max_tuv_SVM","SVM",30,20,1812,1807,5,2100,1695,405,0.910004058441557,0.607142857142857,1.74275960384154,715,346,369,2,1.1,53.68,4.2,0,0,0,0,0,0,0.0111526802525163,10.0564268653278,1.16853104458792
8.7,"max_tuv_SVM","SVM",30,21,1712,1707,5,2200,1795,405,0.911282467532459,0.596938775510204,1.76597385497978,726,357,369,11,1,56.24,4.4,0,0,0,0,0,0,0.00694826754942967,5.6238945432454,0.922238190082056
8.7,"max_tuv_SVM","SVM",30,22,1612,1607,5,2300,1895,405,0.911396973562144,0.596938775510204,1.76434772804149,726,357,369,0,1,58.79,4.7,0,0,0,0,0,0,0.00624907268418395,4.960323996031,0.64761730550221
8.7,"max_tuv_SVM","SVM",30,23,1512,1507,5,2400,1995,405,0.913327632189228,0.596938775510204,1.76434772804149,738,362,376,12,1,61.35,4.9,0,0,0,0,0,0,0.00478934414875266,3.57575045570169,0.59118165640278
8.7,"max_tuv_SVM","SVM",30,24,1412,1407,5,2500,2095,405,0.913282699443402,0.596938775510204,1.76272459305709,734,361,373,-4,1,63.91,5.2,0,0,0,0,0,0,0.00394808252620783,2.70569714292749,0.403015980428729
8.7,"max_tuv_SVM","SVM",30,25,1312,1307,5,2600,2195,405,0.913740723562143,0.591836734693878,1.76434772804149,748,369,379,14,1,66.46,5.4,0,0,0,0,0,0,0.00322516134603893,2.11865002516741,0.384713394321232
8.7,"max_tuv_SVM","SVM",30,26,1212,1207,5,2700,2295,405,0.913955241187375,0.596938775510204,1.76434772804149,748,369,379,0,1,69.02,5.7,0,0,0,0,0,0,0.00257085669841595,1.51381535709276,0.264951888189664
8.7,"max_tuv_SVM","SVM",30,27,1112,1107,5,2800,2395,405,0.914366883116878,0.591836734693878,1.76597385497978,754,372,382,6,1,71.57,5.9,0,0,0,0,0,0,0.00227002169832471,1.26788954604753,0.252755075891799
8.7,"max_tuv_SVM","SVM",30,28,1012,1008,4,2900,2494,406,0.914911873840439,0.591836734693878,1.76110444177671,757,372,385,3,1,74.13,6.1,0,0,0,0,0,0,0.00195219194557228,0.916889003594412,0.209980600400091
8.7,"max_tuv_SVM","SVM",30,29,912,908,4,3000,2594,406,0.915204661410013,0.586734693877551,1.75948726598077,758,374,384,1,1,76.69,6.4,0,0,0,0,0,0,0.00170222978064652,0.706931135909484,0.183639287180113
8.7,"max_tuv_SVM","SVM",30,30,812,809,3,3100,2693,407,0.915326414656767,0.591836734693878,1.75948726598077,764,375,389,6,1,79.24,6.6,0,0,0,0,0,0,0.00166759966454655,0.659006476826444,0.185437404894297
8.7,"max_tuv_SVM","SVM",30,31,712,709,3,3200,2793,407,0.915584415584411,0.586734693877551,1.75787305747987,765,375,390,1,1,81.8,6.9,0,0,0,0,0,0,0.00122870283265069,0.438100854221005,0.138440407688929
8.7,"max_tuv_SVM","SVM",30,32,612,609,3,3300,2893,407,0.915572820037101,0.586734693877551,1.75948726598077,765,375,390,0,1,84.36,7.1,0,0,0,0,0,0,0.000951666089470651,0.30660594404235,0.110292836889548
8.7,"max_tuv_SVM","SVM",30,33,512,509,3,3400,2993,407,0.915810528756952,0.586734693877551,1.76272459305709,767,376,391,2,1,86.91,7.4,0,0,0,0,0,0,0.000588780696089817,0.175702200060838,0.0726335755156304
8.7,"max_tuv_SVM","SVM",30,34,412,411,1,3500,3091,409,0.916071428571423,0.586734693877551,1.78108630756811,777,380,397,10,1,89.47,7.6,0,0,0,0,0,0,0.000595256121323729,0.181445508515446,0.0757106516480191
8.7,"max_tuv_SVM","SVM",30,35,312,312,0,3600,3190,410,0.916333777829307,0.586734693877551,1.77944927971188,784,382,402,7,1.1,92.02,7.8,0,0,0,0,0,0,0.000537123223236626,0.136344062207897,0.0647598448806356
8.7,"max_tuv_SVM","SVM",30,36,212,212,0,3700,3290,410,0.916555542671608,0.586734693877551,1.78272635020859,787,385,402,3,1,94.58,8,0,0,0,0,0,0,0.000325646844092394,0.0700585508276036,0.0426996919662775
8.7,"max_tuv_SVM","SVM",30,37,112,112,0,3800,3390,410,0.916570037105747,0.581632653061224,1.78436941596915,788,388,400,1,1,97.14,8.3,0,0,0,0,0,0,0.000166978047255248,0.0251715495002315,0.023371717929762
8.7,"max_tuv_SVM","SVM",30,38,12,12,0,3900,3490,410,0.916684543135433,0.581632653061224,1.78272635020859,791,389,402,3,1,99.69,8.5,0,0,0,0,0,0,0.000120634790221941,0.00161752653488874,0.00161752653488874
8.7,"max_tuv_SVM","SVM",30,39,0,0,0,3912,3502,410,0.916790352504635,0.581632653061224,1.78108630756811,792,389,403,1,1,100,8.5,0,0,0,0,0,0,0,0,0
8.7,"max_tuv_SVM","SVM",31,0,3812,3393,419,100,93,7,0.90400400400401,0.572222222222222,1.74267281105991,20,7,13,0,1.9,2.56,13.3,0,0,0,0,0,0,0.237837734096459,282.155498849517,26.4060794932687
8.7,"max_tuv_SVM","SVM",31,1,3712,3358,354,200,128,72,0.923124687187188,0.533333333333333,1.79109883364027,91,45,46,71,1,5.11,1.8,0,0,0,0,0,0,0.791340224251517,413.968973143107,84.2860510736464
8.7,"max_tuv_SVM","SVM",31,2,3612,3292,320,300,194,106,0.910335335335354,0.572222222222222,1.76108041743401,178,88,90,87,1,7.67,1.8,0,0,0,0,0,0,0.677307514144321,294.780189570712,76.0986419386773
8.7,"max_tuv_SVM","SVM",31,3,3512,3238,274,400,248,152,0.902549424424431,0.611111111111111,1.71631466176921,269,132,137,91,1,10.22,1.6,0,0,0,0,0,0,0.633971257852279,285.647246571438,73.0718722199855
8.7,"max_tuv_SVM","SVM",31,4,3412,3202,210,500,284,216,0.863166291291288,0.611111111111111,1.57096378146102,352,175,177,83,1,12.78,1.3,0,0,0,0,0,0,0.485087443382473,283.308669413896,74.1586255932134
8.7,"max_tuv_SVM","SVM",31,5,3312,3135,177,600,351,249,0.878512887887888,0.605555555555556,1.61950321987121,421,208,213,69,1,15.34,1.4,0,0,0,0,0,0,0.183549014666947,153.707215269291,66.8803060174318
8.7,"max_tuv_SVM","SVM",31,6,3212,3087,125,700,399,301,0.856093593593595,0.616666666666667,1.53670033670034,484,236,248,63,1.1,17.89,1.3,0,0,0,0,0,0,0.114544432108545,180.256022307422,42.4935206138743
8.7,"max_tuv_SVM","SVM",31,7,3112,3006,106,800,480,320,0.864120370370364,0.638888888888889,1.56807598039216,528,258,270,44,1,20.45,1.5,0,0,0,0,0,0,0.0854795438917125,129.568165118895,32.98773543205
8.7,"max_tuv_SVM","SVM",31,8,3012,2923,89,900,563,337,0.874038100600598,0.633333333333333,1.60802696078431,546,264,282,18,1.1,23.01,1.7,0,0,0,0,0,0,0.0696090954581034,108.46297862281,21.6341507049797
8.7,"max_tuv_SVM","SVM",31,9,2912,2840,72,1000,646,354,0.88368524774775,0.644444444444444,1.63100061387354,567,273,294,21,1.1,25.56,1.8,0,0,0,0,0,0,0.056528860880222,84.3353900173759,13.2675974665319
8.7,"max_tuv_SVM","SVM",31,10,2812,2754,58,1100,732,368,0.900075075075077,0.633333333333333,1.65644322007958,600,289,311,33,1.1,28.12,2,0,0,0,0,0,0,0.0558803843702365,79.0700939200557,9.53754179194104
8.7,"max_tuv_SVM","SVM",31,11,2712,2665,47,1200,821,379,0.927155280280289,0.627777777777778,1.73786764705882,640,313,327,40,1,30.67,2.2,0,0,0,0,0,0,0.0478333932785462,48.2438076214271,7.55583533257817
8.7,"max_tuv_SVM","SVM",31,12,2612,2571,41,1300,915,385,0.932229104104116,0.627777777777778,1.73308890925756,651,318,333,11,1,33.23,2.4,0,0,0,0,0,0,0.0376090478271901,44.0367734351491,4.45637466803182
8.7,"max_tuv_SVM","SVM",31,13,2512,2474,38,1400,1012,388,0.93590152652655,0.633333333333333,1.76945722171113,663,325,338,12,1,35.79,2.6,0,0,0,0,0,0,0.0381590494032222,43.703533419714,4.69900679159597
8.7,"max_tuv_SVM","SVM",31,14,2412,2378,34,1500,1108,392,0.93850725725728,0.633333333333333,1.78109269490485,678,331,347,15,1,38.34,2.8,0,0,0,0,0,0,0.043026214899901,38.9749314239901,5.06413381267804
8.7,"max_tuv_SVM","SVM",31,15,2312,2279,33,1600,1207,393,0.938751251251283,0.633333333333333,1.76783088235294,682,335,347,4,1,40.9,3.1,0,0,0,0,0,0,0.0305989826865685,26.3258418730055,3.41229585991116
8.7,"max_tuv_SVM","SVM",31,16,2212,2184,28,1700,1302,398,0.937540665665698,0.627777777777778,1.77271889400922,699,342,357,17,1,43.46,3.3,0,0,0,0,0,0,0.0415112732767035,28.0430477197966,4.71128317017358
8.7,"max_tuv_SVM","SVM",31,17,2112,2088,24,1800,1398,402,0.935967217217245,0.633333333333333,1.76620752984389,712,347,365,13,1.1,46.01,3.5,0,0,0,0,0,0,0.0361398357588453,23.8402154503263,4.53170555463592
8.7,"max_tuv_SVM","SVM",31,18,2012,1993,19,1900,1493,407,0.935194569569591,0.633333333333333,1.76620752984389,726,354,372,14,1.1,48.57,3.7,0,0,0,0,0,0,0.023242343247154,18.7554724030156,3.31673264588767
8.7,"max_tuv_SVM","SVM",31,19,1912,1899,13,2000,1587,413,0.934730042542564,0.622222222222222,1.7645871559633,745,359,386,19,1.1,51.12,3.8,0,0,0,0,0,0,0.0197474791876576,17.3335559312207,2.30265027780001
8.7,"max_tuv_SVM","SVM",31,20,1812,1799,13,2100,1687,413,0.934568943943966,0.622222222222222,1.76945722171113,747,362,385,2,1.1,53.68,4.1,0,0,0,0,0,0,0.0153203233332673,14.2026426407973,1.70528604624734
8.7,"max_tuv_SVM","SVM",31,21,1712,1701,11,2200,1785,415,0.934618993994011,0.622222222222222,1.77271889400922,755,364,391,8,1.1,56.24,4.3,0,0,0,0,0,0,0.0133344014458423,11.8168048161172,1.37916808457641
8.7,"max_tuv_SVM","SVM",31,22,1612,1603,9,2300,1883,417,0.935282157157163,0.622222222222222,1.77945415516713,771,379,392,16,1,58.79,4.5,0,0,0,0,0,0,0.00978113696617522,7.52933998474375,1.25523672988472
8.7,"max_tuv_SVM","SVM",31,23,1512,1504,8,2400,1982,418,0.935376001001007,0.627777777777778,1.77781862745098,775,380,395,4,1,61.35,4.7,0,0,0,0,0,0,0.0082761209392358,6.74817858351747,0.902402349842686
8.7,"max_tuv_SVM","SVM",31,24,1412,1404,8,2500,2082,418,0.935510510510516,0.627777777777778,1.77945415516713,779,381,398,4,1,63.91,5,0,0,0,0,0,0,0.0075900642657425,5.58324544097963,0.776320915870782
8.7,"max_tuv_SVM","SVM",31,25,1312,1304,8,2600,2182,418,0.935518330830837,0.616666666666667,1.77781862745098,792,384,408,13,1.1,66.46,5.2,0,0,0,0,0,0,0.00569914982549056,3.82741535325472,0.638963749427151
8.7,"max_tuv_SVM","SVM",31,26,1212,1205,7,2700,2281,419,0.935795170170173,0.616666666666667,1.77781862745098,791,385,406,-1,1.1,69.02,5.4,0,0,0,0,0,0,0.00585935724374246,3.52897135816307,0.602106793305354
8.7,"max_tuv_SVM","SVM",31,27,1112,1105,7,2800,2381,419,0.936029779779783,0.616666666666667,1.78273425499232,796,389,407,5,1,71.57,5.7,0,0,0,0,0,0,0.0046117467867725,2.49567587721601,0.501295021189578
8.7,"max_tuv_SVM","SVM",31,28,1012,1007,5,2900,2479,421,0.936025087587591,0.611111111111111,1.77781862745098,802,392,410,6,1,74.13,5.9,0,0,0,0,0,0,0.00485133496313019,2.41143616965342,0.522540632292018
8.7,"max_tuv_SVM","SVM",31,29,912,907,5,3000,2579,421,0.936229979979984,0.611111111111111,1.77781862745098,808,395,413,6,1,76.69,6.1,0,0,0,0,0,0,0.00372085381187663,1.67814844457402,0.413002887976358
8.7,"max_tuv_SVM","SVM",31,30,812,807,5,3100,2679,421,0.936392642642647,0.616666666666667,1.77455657492355,809,396,413,1,1,79.24,6.4,0,0,0,0,0,0,0.00286832211650821,1.12362836297785,0.30991325303165
8.7,"max_tuv_SVM","SVM",31,31,712,708,4,3200,2778,422,0.936480230230236,0.616666666666667,1.77945415516713,812,397,415,3,1,81.8,6.6,0,0,0,0,0,0,0.00267026856619613,0.930299764061752,0.291143783099588
8.7,"max_tuv_SVM","SVM",31,32,612,609,3,3300,2877,423,0.93665853353354,0.616666666666667,1.77781862745098,820,400,420,8,1.1,84.36,6.8,0,0,0,0,0,0,0.00208992646559755,0.688614668739473,0.241573428286554
8.7,"max_tuv_SVM","SVM",31,33,512,510,2,3400,2976,424,0.936774274274281,0.622222222222222,1.77945415516713,821,401,420,1,1,86.91,7,0,0,0,0,0,0,0.00164782604035419,0.575254938394213,0.207227731818336
8.7,"max_tuv_SVM","SVM",31,34,412,412,0,3500,3074,426,0.937027652652662,0.622222222222222,1.77781862745098,827,404,423,6,1,89.47,7.2,0,0,0,0,0,0,0.00192010106755682,0.599862599265002,0.230980165929702
8.7,"max_tuv_SVM","SVM",31,35,312,312,0,3600,3174,426,0.937421796796808,0.616666666666667,1.78273425499232,831,409,422,4,1,92.02,7.5,0,0,0,0,0,0,0.00125245527340036,0.31267987340867,0.144970917887844
8.7,"max_tuv_SVM","SVM",31,36,212,212,0,3700,3274,426,0.937887887887901,0.616666666666667,1.77618610345883,837,411,426,6,1,94.58,7.7,0,0,0,0,0,0,0.000762582745668363,0.15312270599233,0.0953363974370336
8.7,"max_tuv_SVM","SVM",31,37,112,112,0,3800,3374,426,0.938228853853874,0.616666666666667,1.78273425499232,839,412,427,2,1,97.14,7.9,0,0,0,0,0,0,0.000390889520259718,0.0621499422772565,0.0579584154476925
8.7,"max_tuv_SVM","SVM",31,38,12,12,0,3900,3474,426,0.938582332332352,0.616666666666667,1.77945415516713,841,413,428,2,1,99.69,8.2,0,0,0,0,0,0,0.000227779916477379,0.00309281794789307,0.00309281794789307
8.7,"max_tuv_SVM","SVM",31,39,0,0,0,3912,3486,426,0.938652715215235,0.616666666666667,1.77781862745098,842,414,428,1,1,100,8.2,0,0,0,0,0,0,0,0,0
8.7,"max_tuv_SVM","SVM",32,0,3812,3432,380,100,94,6,0.189717741935484,0,0.221248428990364,23,6,17,0,2.8,2.56,15.7,0,0,0,0,0,0,0.0665416712521658,237.620195604712,6.69775328286609
8.7,"max_tuv_SVM","SVM",32,1,3712,3371,341,200,155,45,0.895567134478421,0.540909090909091,1.72765602866428,90,43,47,67,1.1,5.11,3.4,0,0,0,0,0,0,0.660015634705242,367.489867633826,73.8600471557853
8.7,"max_tuv_SVM","SVM",32,2,3612,3321,291,300,205,95,0.88487641390866,0.55,1.70286288297338,175,84,91,85,1.1,7.67,2.2,0,0,0,0,0,0,0.658137965783858,358.892825018449,75.0275283419547
8.7,"max_tuv_SVM","SVM",32,3,3512,3259,253,400,267,133,0.889558022622552,0.577272727272727,1.71765493016643,244,117,127,69,1.1,10.22,2,0,0,0,0,0,0,0.62930042808752,276.786262499012,77.5237398360511
8.7,"max_tuv_SVM","SVM",32,4,3412,3194,218,500,332,168,0.895684960201096,0.604545454545454,1.72742340532396,315,150,165,71,1.1,12.78,2,0,0,0,0,0,0,0.456594112312776,177.014683999315,77.8565497696718
8.7,"max_tuv_SVM","SVM",32,5,3312,3142,170,600,384,216,0.877801633850029,0.618181818181818,1.68184322564488,399,194,205,84,1.1,15.34,1.8,0,0,0,0,0,0,0.20692711024187,176.25324648148,65.2113642707933
8.7,"max_tuv_SVM","SVM",32,6,3212,3079,133,700,447,253,0.883632697947218,0.627272727272727,1.69623795559279,441,212,229,42,1.1,17.89,1.8,0,0,0,0,0,0,0.0984551099287989,100.204948146635,41.9988393042387
8.7,"max_tuv_SVM","SVM",32,7,3112,3007,105,800,519,281,0.884473188102214,0.636363636363636,1.68184322564488,467,221,246,26,1.1,20.45,1.8,0,0,0,0,0,0,0.0629471996094922,73.4623837733268,23.5833154966908
8.7,"max_tuv_SVM","SVM",32,8,3012,2940,72,900,586,314,0.875459520318385,0.645454545454546,1.6098429144385,496,239,257,29,1.1,23.01,1.9,0,0,0,0,0,0,0.0701861938427625,98.6945824828692,12.0420848292416
8.7,"max_tuv_SVM","SVM",32,9,2912,2851,61,1000,675,325,0.883059279430245,0.659090909090909,1.64102178812923,541,260,281,45,1.1,25.56,2.1,0,0,0,0,0,0,0.0739544498791746,97.7902796191882,12.2818633135436
8.7,"max_tuv_SVM","SVM",32,10,2812,2763,49,1100,763,337,0.888615416841216,0.654545454545455,1.65070187165775,586,281,305,45,1.1,28.12,2.3,0,0,0,0,0,0,0.0683211453324415,95.917352464197,11.6810670785975
8.7,"max_tuv_SVM","SVM",32,11,2712,2671,41,1200,855,345,0.901866883116878,0.654545454545455,1.66551465063862,607,291,316,21,1.1,30.67,2.5,0,0,0,0,0,0,0.0555127334528809,71.9628805809203,9.79922735347247
8.7,"max_tuv_SVM","SVM",32,12,2612,2581,31,1300,945,355,0.908408829074142,0.654545454545455,1.6783023606228,635,300,335,28,1.1,33.23,2.7,0,0,0,0,0,0,0.0591859815440186,79.116801643363,9.00579191963444
8.7,"max_tuv_SVM","SVM",32,13,2512,2487,25,1400,1039,361,0.913108766233766,0.654545454545455,1.69156082887701,654,307,347,19,1.1,35.79,2.9,0,0,0,0,0,0,0.0601180327066277,66.4820488503425,8.61223291155793
8.7,"max_tuv_SVM","SVM",32,14,2412,2390,22,1500,1136,364,0.915402440301638,0.654545454545455,1.71607620320856,664,312,352,10,1.1,38.34,3.1,0,0,0,0,0,0,0.0496158808840267,56.0934920180367,7.47587418924928
8.7,"max_tuv_SVM","SVM",32,15,2312,2294,18,1600,1232,368,0.916807184750744,0.654545454545455,1.71923656454043,667,316,351,3,1.1,40.9,3.3,0,0,0,0,0,0,0.0446287600060862,49.295089965838,6.74577784781669
8.7,"max_tuv_SVM","SVM",32,16,2212,2196,16,1700,1330,370,0.917702660242992,0.654545454545455,1.71923656454043,674,319,355,7,1.1,43.46,3.6,0,0,0,0,0,0,0.0406483355432556,47.5470551810415,6.21378194560177
8.7,"max_tuv_SVM","SVM",32,17,2112,2102,10,1800,1424,376,0.918456744868041,0.654545454545455,1.71923656454043,686,326,360,12,1.1,46.01,3.8,0,0,0,0,0,0,0.0336625779300607,36.521930703451,3.59074676720877
8.7,"max_tuv_SVM","SVM",32,18,2012,2003,9,1900,1523,377,0.918285242982828,0.65,1.71923656454043,691,329,362,5,1.1,48.57,4,0,0,0,0,0,0,0.0274791767627995,27.9202941122015,2.86148534073141
8.7,"max_tuv_SVM","SVM",32,19,1912,1904,8,2000,1622,378,0.920512149141172,0.65,1.73241978609626,699,336,363,8,1.1,51.12,4.3,0,0,0,0,0,0,0.0204063976892303,17.9400115955989,2.39310963240427
8.7,"max_tuv_SVM","SVM",32,20,1812,1804,8,2100,1722,378,0.920408724340165,0.65,1.73561024610748,699,336,363,0,1.1,53.68,4.6,0,0,0,0,0,0,0.0175148494972953,14.9460288499332,1.78716866721184
8.7,"max_tuv_SVM","SVM",32,21,1712,1704,8,2200,1822,378,0.920633902387925,0.640909090909091,1.76017076845806,720,350,370,21,1.1,56.24,4.8,0,0,0,0,0,0,0.0120897575199025,8.39121629120555,1.5324969993129
8.7,"max_tuv_SVM","SVM",32,22,1612,1606,6,2300,1920,380,0.92085646208629,0.640909090909091,1.76017076845806,726,351,375,6,1.1,58.79,5.1,0,0,0,0,0,0,0.0088215329408226,6.96637640792456,1.00875686930649
8.7,"max_tuv_SVM","SVM",32,23,1512,1508,4,2400,2018,382,0.920310536237945,0.645454545454546,1.75855147612277,733,355,378,7,1.1,61.35,5.3,0,0,0,0,0,0,0.0100782421724123,6.53684995913385,1.0323679779529
8.7,"max_tuv_SVM","SVM",32,24,1412,1408,4,2500,2118,382,0.920624738165056,0.636363636363636,1.75532181317305,745,362,383,12,1.1,63.91,5.5,0,0,0,0,0,0,0.00709688455620537,4.39776160836375,0.856442004471656
8.7,"max_tuv_SVM","SVM",32,25,1312,1308,4,2600,2218,382,0.920734708839543,0.640909090909091,1.75532181317305,745,362,383,0,1.1,66.46,5.8,0,0,0,0,0,0,0.00573451872598608,3.32874945824952,0.601483675366253
8.7,"max_tuv_SVM","SVM",32,26,1212,1208,4,2700,2318,382,0.920653540008379,0.636363636363636,1.75532181317305,752,365,387,7,1.1,69.02,6.1,0,0,0,0,0,0,0.00465030504312931,2.45537004411291,0.495552234319741
8.7,"max_tuv_SVM","SVM",32,27,1112,1109,3,2800,2417,383,0.921130079597823,0.631818181818182,1.76348610067618,756,368,388,4,1.1,71.57,6.3,0,0,0,0,0,0,0.00415011836431224,1.95405101148816,0.440853117922164
8.7,"max_tuv_SVM","SVM",32,28,1012,1009,3,2900,2517,383,0.921166736489325,0.631818181818182,1.76835760924159,757,368,389,1,1.1,74.13,6.6,0,0,0,0,0,0,0.00357540773655668,1.49973797299728,0.384000211586662
8.7,"max_tuv_SVM","SVM",32,29,912,909,3,3000,2617,383,0.921350020946805,0.631818181818182,1.76673078531404,758,368,390,1,1.1,76.69,6.8,0,0,0,0,0,0,0.00297882759370679,1.13487360806707,0.330258437916117
8.7,"max_tuv_SVM","SVM",32,30,812,809,3,3100,2717,383,0.921459991621292,0.636363636363636,1.76673078531404,757,368,389,-1,1.1,79.24,7.1,0,0,0,0,0,0,0.00217603876077036,0.737814352719134,0.247797292134733
8.7,"max_tuv_SVM","SVM",32,31,712,709,3,3200,2817,383,0.921521522832016,0.636363636363636,1.76835760924159,758,368,390,1,1.1,81.8,7.4,0,0,0,0,0,0,0.00140374647067133,0.426287588425393,0.166549379838717
8.7,"max_tuv_SVM","SVM",32,32,612,609,3,3300,2917,383,0.921902492668632,0.636363636363636,1.76835760924159,760,370,390,2,1.1,84.36,7.6,0,0,0,0,0,0,0.000940141382449606,0.296125474186807,0.12709788477821
8.7,"max_tuv_SVM","SVM",32,33,512,509,3,3400,3017,383,0.922295245077515,0.631818181818182,1.76835760924159,762,372,390,2,1,86.91,7.9,0,0,0,0,0,0,0.000580898836183494,0.175474443095226,0.0780253889015621
8.7,"max_tuv_SVM","SVM",32,34,412,412,0,3500,3114,386,0.924194857561801,0.627272727272727,1.76510695187166,770,377,393,8,1,89.47,8.1,0,0,0,0,0,0,0.000736679078000624,0.216472990797826,0.0960154330301983
8.7,"max_tuv_SVM","SVM",32,35,312,312,0,3600,3214,386,0.924700198994558,0.627272727272727,1.7618682235196,773,380,393,3,1,92.02,8.3,0,0,0,0,0,0,0.000443442376430731,0.109786104274934,0.0554599525965968
8.7,"max_tuv_SVM","SVM",32,36,212,212,0,3700,3314,386,0.924934541265189,0.631818181818182,1.76673078531404,775,380,395,2,1,94.58,8.6,0,0,0,0,0,0,0.000211297088797089,0.0446353161504444,0.0279533922344205
8.7,"max_tuv_SVM","SVM",32,37,112,112,0,3800,3414,386,0.925264453288649,0.627272727272727,1.76673078531404,777,381,396,2,1,97.14,8.8,0,0,0,0,0,0,9.77212528598158e-05,0.0157162074366119,0.0147103083819748
8.7,"max_tuv_SVM","SVM",32,38,12,12,0,3900,3514,386,0.925536761625473,0.627272727272727,1.76348610067618,775,382,393,-2,1,99.69,9.1,0,0,0,0,0,0,5.25085847992362e-05,0.000820853795744787,0.000820853795744787
8.7,"max_tuv_SVM","SVM",32,39,0,0,0,3912,3526,386,0.92561531210725,0.627272727272727,1.76348610067618,776,382,394,1,1,100,9.1,0,0,0,0,0,0,0,0,0
8.7,"max_tuv_SVM","SVM",33,0,3812,3422,390,100,89,11,0.914733044532049,0.55609756097561,1.78517702596381,27,11,16,0,1.5,2.56,8.1,0,0,0,0,0,0,0.404179822711031,400.493228006006,46.7048926603172
8.7,"max_tuv_SVM","SVM",33,1,3712,3376,336,200,135,65,0.920304773578858,0.629268292682927,1.74357320432708,114,57,57,87,1,5.11,2.1,0,0,0,0,0,0,0.679957607992262,435.27257082135,74.3350188457535
8.7,"max_tuv_SVM","SVM",33,2,3612,3310,302,300,201,99,0.909662771099443,0.604878048780488,1.71816114504838,204,99,105,90,1.1,7.67,2,0,0,0,0,0,0,0.478664764343957,614.715614702173,52.3718523679632
8.7,"max_tuv_SVM","SVM",33,3,3512,3270,242,400,241,159,0.904111936036561,0.64390243902439,1.70446031532139,283,140,143,79,1,10.22,1.5,0,0,0,0,0,0,0.524502698119476,262.441860819986,72.0870212781974
8.7,"max_tuv_SVM","SVM",33,4,3412,3211,201,500,300,200,0.909668342828501,0.663414634146341,1.75879509947173,368,183,185,85,1,12.78,1.5,0,0,0,0,0,0,0.265599553341464,209.239098887461,58.6513912709776
8.7,"max_tuv_SVM","SVM",33,5,3312,3155,157,600,356,244,0.899853742112532,0.668292682926829,1.69567443740736,445,219,226,77,1,15.34,1.5,0,0,0,0,0,0,0.195884417223592,176.01931312378,48.7532707280212
8.7,"max_tuv_SVM","SVM",33,6,3212,3076,136,700,435,265,0.901607443830008,0.68780487804878,1.65747847919656,484,237,247,39,1,17.89,1.6,0,0,0,0,0,0,0.133594815149443,147.437386821583,40.2973454380367
8.7,"max_tuv_SVM","SVM",33,7,3112,3004,108,800,507,293,0.894485381175912,0.692682926829268,1.62389211748603,534,258,276,50,1.1,20.45,1.7,0,0,0,0,0,0,0.0924172656440646,132.607199104714,33.7965457165116
8.7,"max_tuv_SVM","SVM",33,8,3012,2925,87,900,586,314,0.900196403448897,0.702439024390244,1.66206136900079,565,272,293,31,1.1,23.01,1.9,0,0,0,0,0,0,0.0663291948085756,102.945224459483,25.0992049179105
8.7,"max_tuv_SVM","SVM",33,9,2912,2847,65,1000,664,336,0.902113078241015,0.702439024390244,1.64144770794534,594,286,308,29,1.1,25.56,2,0,0,0,0,0,0,0.060933783942408,104.369550899539,14.816942858244
8.7,"max_tuv_SVM","SVM",33,10,2812,2757,55,1100,754,346,0.911791171595337,0.697560975609756,1.66206136900079,624,298,326,30,1.1,28.12,2.2,0,0,0,0,0,0,0.0660052902860717,105.423219487155,14.6038156759309
8.7,"max_tuv_SVM","SVM",33,11,2712,2663,49,1200,848,352,0.924018330988579,0.697560975609756,1.71482522198494,648,315,333,24,1.1,30.67,2.4,0,0,0,0,0,0,0.0632328948632499,90.2187185451583,14.1811977530525
8.7,"max_tuv_SVM","SVM",33,12,2612,2569,43,1300,942,358,0.927029850538382,0.68780487804878,1.72203207114944,664,323,341,16,1.1,33.23,2.6,0,0,0,0,0,0,0.0686570598346641,81.7643664714329,14.4799760172421
8.7,"max_tuv_SVM","SVM",33,13,2512,2473,39,1400,1038,362,0.930604114721912,0.68780487804878,1.74838970489152,676,329,347,12,1.1,35.79,2.9,0,0,0,0,0,0,0.0587471398259446,61.7644990118846,13.3949754048427
8.7,"max_tuv_SVM","SVM",33,14,2412,2378,34,1500,1133,367,0.929999582120332,0.68780487804878,1.74838970489152,697,335,362,21,1.1,38.34,3.1,0,0,0,0,0,0,0.0606702882005296,61.1006948109841,13.687946060475
8.7,"max_tuv_SVM","SVM",33,15,2312,2286,26,1600,1225,375,0.929512055828737,0.682926829268293,1.74120714847701,719,345,374,22,1.1,40.9,3.3,0,0,0,0,0,0,0.0602149083777741,57.9446334133131,14.1154566765397
8.7,"max_tuv_SVM","SVM",33,16,2212,2191,21,1700,1320,380,0.928991099162862,0.682926829268293,1.73081794906347,736,351,385,17,1.1,43.46,3.5,0,0,0,0,0,0,0.0456295338632438,50.4317637176936,12.6942663373408
8.7,"max_tuv_SVM","SVM",33,17,2112,2097,15,1800,1414,386,0.929757211906799,0.678048780487805,1.73081794906347,746,353,393,10,1.1,46.01,3.7,0,0,0,0,0,0,0.0366296826806935,40.0683843480201,8.69528982931497
8.7,"max_tuv_SVM","SVM",33,18,2012,1999,13,1900,1512,388,0.930319956540526,0.673170731707317,1.73800345547154,748,355,393,2,1.1,48.57,3.9,0,0,0,0,0,0,0.0268834415843917,28.6155789880237,5.7264561725107
8.7,"max_tuv_SVM","SVM",33,19,1912,1903,9,2000,1608,392,0.930602721789651,0.673170731707317,1.7396038269775,746,358,388,-2,1.1,51.12,4.1,0,0,0,0,0,0,0.021144503569909,20.0555264960601,2.27500632486885
8.7,"max_tuv_SVM","SVM",33,20,1812,1803,9,2100,1708,392,0.931019208535899,0.673170731707317,1.74838970489152,749,358,391,3,1.1,53.68,4.4,0,0,0,0,0,0,0.0180006453757877,17.4048264114406,1.9506803630929
8.7,"max_tuv_SVM","SVM",33,21,1712,1703,9,2200,1808,392,0.931132036049097,0.673170731707317,1.74838970489152,747,359,388,-2,1.1,56.24,4.6,0,0,0,0,0,0,0.0146989017930752,13.7416914368396,1.54283908671393
8.7,"max_tuv_SVM","SVM",33,22,1612,1603,9,2300,1908,392,0.933320332632234,0.673170731707317,1.75233487872069,755,363,392,8,1.1,58.79,4.9,0,0,0,0,0,0,0.0101803253825365,8.90460578177159,1.21579375268616
8.7,"max_tuv_SVM","SVM",33,23,1512,1505,7,2400,2006,394,0.933990333050113,0.673170731707317,1.76271520803443,765,370,395,10,1.1,61.35,5.1,0,0,0,0,0,0,0.00900989032760009,7.27565219746401,0.940174496197758
8.7,"max_tuv_SVM","SVM",33,24,1412,1406,6,2500,2105,395,0.936264991433473,0.668292682926829,1.76758907496909,779,379,400,14,1.1,63.91,5.3,0,0,0,0,0,0,0.0065466859053681,4.65817627678025,0.824477446177673
8.7,"max_tuv_SVM","SVM",33,25,1312,1307,5,2600,2204,396,0.937322227020105,0.673170731707317,1.76596146071958,780,379,401,1,1.1,66.46,5.6,0,0,0,0,0,0,0.00605447609599232,3.92912485443077,0.621402917533024
8.7,"max_tuv_SVM","SVM",33,26,1212,1207,5,2700,2304,396,0.938855845440238,0.663414634146341,1.76596146071958,789,386,403,9,1,69.02,5.8,0,0,0,0,0,0,0.00393295661351261,2.31332176471216,0.488525664623043
8.7,"max_tuv_SVM","SVM",33,27,1112,1108,4,2800,2403,397,0.938964494156652,0.663414634146341,1.7643368411605,792,387,405,3,1,71.57,6.1,0,0,0,0,0,0,0.0037563319114089,2.12132433199931,0.393762114917586
8.7,"max_tuv_SVM","SVM",33,28,1012,1008,4,2900,2503,397,0.939151147079719,0.663414634146341,1.76109655311429,795,389,406,3,1,74.13,6.3,0,0,0,0,0,0,0.00309649354862755,1.60376792658671,0.340273279844087
8.7,"max_tuv_SVM","SVM",33,29,912,908,4,3000,2603,397,0.939180398657214,0.668292682926829,1.76271520803443,795,389,406,0,1,76.69,6.6,0,0,0,0,0,0,0.00258163683004739,1.12492268126689,0.268871427587778
8.7,"max_tuv_SVM","SVM",33,30,812,808,4,3100,2703,397,0.93935730105445,0.668292682926829,1.76758907496909,797,391,406,2,1,79.24,6.8,0,0,0,0,0,0,0.00193907605753521,0.728339988559867,0.210731306235209
8.7,"max_tuv_SVM","SVM",33,31,712,709,3,3200,2802,398,0.9395773843518,0.663414634146341,1.76758907496909,801,393,408,4,1,81.8,7,0,0,0,0,0,0,0.00171346561032318,0.565394111143751,0.190721639480745
8.7,"max_tuv_SVM","SVM",33,32,612,610,2,3300,2901,399,0.939794681784626,0.658536585365854,1.76758907496909,805,395,410,4,1,84.36,7.3,0,0,0,0,0,0,0.00148615463061409,0.472349407553505,0.176009904234753
8.7,"max_tuv_SVM","SVM",33,33,512,510,2,3400,3001,399,0.939920045688179,0.663414634146341,1.76758907496909,806,395,411,1,1,86.91,7.5,0,0,0,0,0,0,0.000937832093097059,0.290604320359826,0.11725213808482
8.7,"max_tuv_SVM","SVM",33,34,412,412,0,3500,3099,401,0.940349068824784,0.668292682926829,1.76596146071958,817,398,419,11,1.1,89.47,7.7,0,0,0,0,0,0,0.00104850812575286,0.317595746846977,0.129525420380068
8.7,"max_tuv_SVM","SVM",33,35,312,312,0,3600,3199,401,0.94032121017955,0.668292682926829,1.76758907496909,815,399,416,-2,1,92.02,8,0,0,0,0,0,0,0.000535090407987086,0.131843175156337,0.0646997015431709
8.7,"max_tuv_SVM","SVM",33,36,212,212,0,3700,3299,401,0.940138736053266,0.668292682926829,1.76596146071958,820,400,420,5,1.1,94.58,8.2,0,0,0,0,0,0,0.000260572201103016,0.0531115043160319,0.0340598217398716
8.7,"max_tuv_SVM","SVM",33,37,112,112,0,3800,3399,401,0.940067696507919,0.668292682926829,1.77148493543759,821,401,420,1,1,97.14,8.5,0,0,0,0,0,0,8.40583476324906e-05,0.0148729340693077,0.014009562087597
8.7,"max_tuv_SVM","SVM",33,38,12,12,0,3900,3499,401,0.940034266133637,0.668292682926829,1.77311463639015,822,401,421,1,1,99.69,8.7,0,0,0,0,0,0,3.31681455748872e-05,0.000517714728182474,0.000517714728182474
8.7,"max_tuv_SVM","SVM",33,39,0,0,0,3912,3511,401,0.940042623727207,0.668292682926829,1.77148493543759,822,401,421,0,1,100,8.8,0,0,0,0,0,0,0,0,0
8.7,"max_tuv_SVM","SVM",34,0,3812,3408,404,100,92,8,0.892712124226213,0.5,1.70054634424438,28,8,20,0,2.5,2.56,11.5,0,0,0,0,0,0,0.156338876969005,312.260875318506,16.9257936909768
8.7,"max_tuv_SVM","SVM",34,1,3712,3376,336,200,124,76,0.907795733526807,0.572164948453608,1.75910936923121,104,52,52,76,1,5.11,1.6,0,0,0,0,0,0,0.691628596253888,384.555194846204,75.7501913156015
8.7,"max_tuv_SVM","SVM",34,2,3612,3310,302,300,190,110,0.895804322641796,0.592783505154639,1.72816011036881,202,100,102,98,1,7.67,1.7,0,0,0,0,0,0,0.595999265511641,270.204969736555,70.1637279396532
8.7,"max_tuv_SVM","SVM",34,3,3512,3268,244,400,232,168,0.914410171197215,0.587628865979381,1.72524397993152,287,142,145,85,1,10.22,1.4,0,0,0,0,0,0,0.578456885404286,267.731063642846,76.1791281672071
8.7,"max_tuv_SVM","SVM",34,4,3412,3218,194,500,282,218,0.891091426097333,0.623711340206186,1.67886645358928,376,187,189,89,1,12.78,1.3,0,0,0,0,0,0,0.351272507430562,258.071009768782,71.1869841330484
8.7,"max_tuv_SVM","SVM",34,5,3312,3151,161,600,349,251,0.903899036942559,0.628865979381443,1.67266853532234,449,219,230,73,1.1,15.34,1.4,0,0,0,0,0,0,0.175468138050364,191.382715301467,57.4429537677035
8.7,"max_tuv_SVM","SVM",34,6,3212,3102,110,700,398,302,0.893344020969626,0.634020618556701,1.65878941782899,496,239,257,47,1.1,17.89,1.3,0,0,0,0,0,0,0.115929294756417,153.775151491024,34.0537373637804
8.7,"max_tuv_SVM","SVM",34,7,3112,3027,85,800,473,327,0.878011748598722,0.623711340206186,1.61691291747826,534,260,274,38,1.1,20.45,1.4,0,0,0,0,0,0,0.0837591302021401,136.857480259147,27.0731530035626
8.7,"max_tuv_SVM","SVM",34,8,3012,2938,74,900,562,338,0.886551130978152,0.628865979381443,1.62620552045228,571,278,293,37,1.1,23.01,1.7,0,0,0,0,0,0,0.0758195051102159,124.162604341781,23.9172866148141
8.7,"max_tuv_SVM","SVM",34,9,2912,2849,63,1000,651,349,0.889894917911924,0.628865979381443,1.64176443251548,582,283,299,11,1.1,25.56,1.9,0,0,0,0,0,0,0.0541461977677554,90.0050040637847,15.7424322894342
8.7,"max_tuv_SVM","SVM",34,10,2812,2760,52,1100,740,360,0.891147009607176,0.634020618556701,1.64327618613658,606,293,313,24,1.1,28.12,2.1,0,0,0,0,0,0,0.0565734200112053,91.3818709163764,12.1891006192079
8.7,"max_tuv_SVM","SVM",34,11,2712,2662,50,1200,838,362,0.915782206255799,0.61340206185567,1.72842415316642,643,314,329,37,1,30.67,2.3,0,0,0,0,0,0,0.0521674492738412,44.9469550169009,12.576054747201
8.7,"max_tuv_SVM","SVM",34,12,2612,2573,39,1300,927,373,0.915036217044846,0.618556701030928,1.72683260238082,645,316,329,2,1,33.23,2.5,0,0,0,0,0,0,0.0347601803820115,30.6243167886126,4.05054413480575
8.7,"max_tuv_SVM","SVM",34,13,2512,2476,36,1400,1024,376,0.916671542413147,0.623711340206186,1.71754855613146,651,318,333,6,1,35.79,2.7,0,0,0,0,0,0,0.027314428447137,27.7098737918877,3.11990535814664
8.7,"max_tuv_SVM","SVM",34,14,2412,2382,30,1500,1118,382,0.917986531237922,0.618556701030928,1.71124562565024,663,324,339,12,1,38.34,2.9,0,0,0,0,0,0,0.0286955714801982,34.4176650018044,3.22229527981053
8.7,"max_tuv_SVM","SVM",34,15,2312,2293,19,1600,1207,393,0.92045414652983,0.608247422680412,1.74700935911445,699,341,358,36,1,40.9,3.1,0,0,0,0,0,0,0.076746047006327,48.9885897927361,8.90688280206155
8.7,"max_tuv_SVM","SVM",34,16,2212,2193,19,1700,1307,393,0.92036930854113,0.603092783505155,1.74700935911445,711,348,363,12,1,43.46,3.3,0,0,0,0,0,0,0.0580020262828224,33.7323619912578,6.18386492919073
8.7,"max_tuv_SVM","SVM",34,17,2112,2095,17,1800,1405,395,0.920577015341044,0.603092783505155,1.74540069487954,713,348,365,2,1,46.01,3.6,0,0,0,0,0,0,0.0469792605407438,26.205231590516,5.26214742489953
8.7,"max_tuv_SVM","SVM",34,18,2012,2000,12,1900,1500,400,0.919816398890667,0.597938144329897,1.74700935911445,728,354,374,15,1.1,48.57,3.8,0,0,0,0,0,0,0.0436732594975287,22.6846537574594,5.06790682707419
8.7,"max_tuv_SVM","SVM",34,19,1912,1906,6,2000,1594,406,0.919304445510608,0.597938144329897,1.74059242850246,740,359,381,12,1.1,51.12,3.9,0,0,0,0,0,0,0.0204608047734832,16.8713760804277,3.47628110950118
8.7,"max_tuv_SVM","SVM",34,20,1812,1809,3,2100,1691,409,0.918675474215104,0.592783505154639,1.74379499046842,753,364,389,13,1.1,53.68,4.1,0,0,0,0,0,0,0.0153845918652772,13.089333308331,1.77881329975176
8.7,"max_tuv_SVM","SVM",34,21,1712,1709,3,2200,1791,409,0.918754461308027,0.597938144329897,1.74059242850246,753,365,388,0,1.1,56.24,4.4,0,0,0,0,0,0,0.0129029788010465,10.886595673247,1.33869736108642
8.7,"max_tuv_SVM","SVM",34,22,1612,1609,3,2300,1891,409,0.919011900721996,0.597938144329897,1.74059242850246,765,370,395,12,1.1,58.79,4.6,0,0,0,0,0,0,0.00985557127878337,7.44815653832527,1.17591605630605
8.7,"max_tuv_SVM","SVM",34,23,1512,1509,3,2400,1991,409,0.919125993189553,0.597938144329897,1.74059242850246,763,370,393,-2,1.1,61.35,4.9,0,0,0,0,0,0,0.00800472355036875,5.95359963549469,0.836081491649287
8.7,"max_tuv_SVM","SVM",34,24,1412,1409,3,2500,2091,409,0.919635021121726,0.592783505154639,1.74379499046842,770,373,397,7,1.1,63.91,5.1,0,0,0,0,0,0,0.00590599973814673,4.073078240181,0.639228178380739
8.7,"max_tuv_SVM","SVM",34,25,1312,1309,3,2600,2191,409,0.92038101033267,0.587628865979381,1.74379499046842,774,375,399,4,1.1,66.46,5.4,0,0,0,0,0,0,0.00562307579076845,3.60121938368306,0.590970574609987
8.7,"max_tuv_SVM","SVM",34,26,1212,1209,3,2700,2291,409,0.921088968721094,0.587628865979381,1.75468474112889,777,377,400,3,1.1,69.02,5.6,0,0,0,0,0,0,0.00461404623143836,2.64750713113651,0.483216163560275
8.7,"max_tuv_SVM","SVM",34,27,1112,1109,3,2800,2391,409,0.921097745064753,0.587628865979381,1.75307049573687,779,377,402,2,1.1,71.57,5.8,0,0,0,0,0,0,0.0038618035862616,1.97765570964686,0.407518598076473
8.7,"max_tuv_SVM","SVM",34,28,1012,1010,2,2900,2490,410,0.921314228208322,0.587628865979381,1.7514592177077,783,381,402,4,1.1,74.13,6.1,0,0,0,0,0,0,0.00331447753341845,1.52185901080692,0.351898298293777
8.7,"max_tuv_SVM","SVM",34,29,912,911,1,3000,2589,411,0.921252793802716,0.587628865979381,1.75468474112889,788,383,405,5,1.1,76.69,6.3,0,0,0,0,0,0,0.00308515517084631,1.27847948726244,0.33042935254434
8.7,"max_tuv_SVM","SVM",34,30,812,811,1,3100,2689,411,0.921358109926615,0.587628865979381,1.75468474112889,789,385,404,1,1,79.24,6.5,0,0,0,0,0,0,0.00278764547042031,1.04825566093323,0.310166397363218
8.7,"max_tuv_SVM","SVM",34,31,712,712,0,3200,2788,412,0.921440022467425,0.587628865979381,1.75468474112889,795,387,408,6,1.1,81.8,6.8,0,0,0,0,0,0,0.00196202139431038,0.671778059675938,0.227145452130491
8.7,"max_tuv_SVM","SVM",34,32,612,612,0,3300,2888,412,0.921375662613931,0.587628865979381,1.75307049573687,796,387,409,1,1.1,84.36,7,0,0,0,0,0,0,0.00152600420919692,0.481051624623654,0.179934628642812
8.7,"max_tuv_SVM","SVM",34,33,512,512,0,3400,2988,412,0.921147477678817,0.587628865979381,1.75307049573687,798,388,410,2,1.1,86.91,7.3,0,0,0,0,0,0,0.000865649037105694,0.274280077249008,0.11303317182032
8.7,"max_tuv_SVM","SVM",34,34,412,412,0,3500,3088,412,0.921050937898577,0.587628865979381,1.75468474112889,801,389,412,3,1.1,89.47,7.5,0,0,0,0,0,0,0.000521393887975659,0.153537692680604,0.0670540607159066
8.7,"max_tuv_SVM","SVM",34,35,312,312,0,3600,3188,412,0.920983652597198,0.587628865979381,1.74985089886683,805,391,414,4,1.1,92.02,7.7,0,0,0,0,0,0,0.00038818557386873,0.100003165718136,0.048584959799283
8.7,"max_tuv_SVM","SVM",34,36,212,212,0,3700,3288,412,0.921030459763376,0.587628865979381,1.76234600100532,805,391,414,0,1.1,94.58,8,0,0,0,0,0,0,0.000211664299526261,0.0437463115059798,0.0279880322690379
8.7,"max_tuv_SVM","SVM",34,37,112,112,0,3800,3388,412,0.921124074095731,0.587628865979381,1.76396878737825,808,391,417,3,1.1,97.14,8.2,0,0,0,0,0,0,9.399464666682e-05,0.015984125660108,0.0150299583731289
8.7,"max_tuv_SVM","SVM",34,38,12,12,0,3900,3488,412,0.921334706343532,0.587628865979381,1.76559456506247,811,394,417,3,1.1,99.69,8.5,0,0,0,0,0,0,6.52121800029597e-05,0.000915298930981927,0.000915298930981927
8.7,"max_tuv_SVM","SVM",34,39,0,0,0,3912,3500,412,0.921333243619589,0.587628865979381,1.76396878737825,811,394,417,0,1.1,100,8.5,0,0,0,0,0,0,0,0,0
8.7,"max_tuv_SVM","SVM",35,0,3812,3433,379,100,91,9,0.877318651618951,0.440366972477064,1.77795628461506,36,9,27,0,3,2.56,10.1,0,0,0,0,0,0,0.0972761610448968,347.746257061292,9.86904056021919
8.7,"max_tuv_SVM","SVM",35,1,3712,3363,349,200,161,39,0.877664403880882,0.568807339449541,1.68543768057175,87,39,48,51,1.2,5.11,4.1,0,0,0,0,0,0,0.43143493438031,343.400847707703,55.6374944761305
8.7,"max_tuv_SVM","SVM",35,2,3612,3333,279,300,191,109,0.913804752905889,0.642201834862385,1.72833889992813,166,81,85,79,1,7.67,1.8,0,0,0,0,0,0,0.577522765548433,339.162570706846,72.6747549258976
8.7,"max_tuv_SVM","SVM",35,3,3512,3269,243,400,255,145,0.910545180055097,0.646788990825688,1.73660846404262,263,131,132,97,1,10.22,1.8,0,0,0,0,0,0,0.400372186027851,265.822638163531,68.0670343037476
8.7,"max_tuv_SVM","SVM",35,4,3412,3226,186,500,298,202,0.895772848681914,0.637614678899083,1.69727298000859,365,180,185,102,1,12.78,1.5,0,0,0,0,0,0,0.34478752097551,351.3901072226,59.7050769799327
8.7,"max_tuv_SVM","SVM",35,5,3312,3160,152,600,364,236,0.900775699158583,0.655963302752294,1.66891378174261,427,208,219,62,1.1,15.34,1.5,0,0,0,0,0,0,0.194886820664348,232.483996707525,49.607327602181
8.7,"max_tuv_SVM","SVM",35,6,3212,3092,120,700,432,268,0.915565186178352,0.68348623853211,1.69214148865238,486,235,251,59,1.1,17.89,1.6,0,0,0,0,0,0,0.0985805647356645,129.136342458945,34.8734722368362
8.7,"max_tuv_SVM","SVM",35,7,3112,3022,90,800,502,298,0.921345319411741,0.692660550458716,1.69883297355639,539,254,285,53,1.1,20.45,1.7,0,0,0,0,0,0,0.106964739771002,158.691994446846,26.6615309955157
8.7,"max_tuv_SVM","SVM",35,8,3012,2935,77,900,589,311,0.924245943349425,0.706422018348624,1.70353020758466,572,274,298,33,1.1,23.01,1.9,0,0,0,0,0,0,0.0888689142469665,132.499425554874,23.4848396808588
8.7,"max_tuv_SVM","SVM",35,9,2912,2849,63,1000,675,325,0.928294675943038,0.706422018348624,1.73500937705915,597,289,308,25,1.1,25.56,2.1,0,0,0,0,0,0,0.0785684097063039,109.724032424458,17.9250561467179
8.7,"max_tuv_SVM","SVM",35,10,2812,2758,54,1100,766,334,0.932111147475225,0.701834862385321,1.75817627845345,627,298,329,30,1.1,28.12,2.3,0,0,0,0,0,0,0.0749274453213352,99.2460952101589,17.6459714667908
8.7,"max_tuv_SVM","SVM",35,11,2712,2667,45,1200,857,343,0.932982126455599,0.701834862385321,1.74992192972832,648,312,336,21,1.1,30.67,2.5,0,0,0,0,0,0,0.0776983517959488,92.6130992261782,17.1882664804647
8.7,"max_tuv_SVM","SVM",35,12,2612,2571,41,1300,953,347,0.933486238532115,0.697247706422018,1.74670811534865,655,315,340,7,1.1,33.23,2.7,0,0,0,0,0,0,0.0641459880683515,78.0243318721897,15.8845813496389
8.7,"max_tuv_SVM","SVM",35,13,2512,2473,39,1400,1051,349,0.933701343946963,0.697247706422018,1.75153327588829,656,315,341,1,1.1,35.79,3,0,0,0,0,0,0,0.051585692302841,63.5834187523951,13.7257049125549
8.7,"max_tuv_SVM","SVM",35,14,2412,2378,34,1500,1146,354,0.933810876152067,0.697247706422018,1.74992192972832,669,320,349,13,1.1,38.34,3.2,0,0,0,0,0,0,0.0488243458284475,61.34417765111,13.451622878146
8.7,"max_tuv_SVM","SVM",35,15,2312,2283,29,1600,1241,359,0.934296512916878,0.697247706422018,1.74670811534865,689,326,363,20,1.1,40.9,3.5,0,0,0,0,0,0,0.0434802051260585,54.8321060002564,13.0042204265517
8.7,"max_tuv_SVM","SVM",35,16,2212,2187,25,1700,1337,363,0.934259562293468,0.692660550458716,1.74350608397312,692,328,364,3,1.1,43.46,3.7,0,0,0,0,0,0,0.0372013108471204,44.1916857963586,8.56447152735694
8.7,"max_tuv_SVM","SVM",35,17,2112,2087,25,1800,1437,363,0.934091964823002,0.692660550458716,1.75153327588829,698,328,370,6,1.1,46.01,4,0,0,0,0,0,0,0.0300321583980901,34.8801543758685,7.86181471424345
8.7,"max_tuv_SVM","SVM",35,18,2012,1990,22,1900,1534,366,0.933804277826454,0.697247706422018,1.75153327588829,701,330,371,3,1.1,48.57,4.2,0,0,0,0,0,0,0.0243367909621118,24.909733567089,4.47556470482503
8.7,"max_tuv_SVM","SVM",35,19,1912,1893,19,2000,1631,369,0.933907211705951,0.697247706422018,1.75979522530285,706,333,373,5,1.1,51.12,4.4,0,0,0,0,0,0,0.0205124426882113,19.2802754685574,2.19317130339999
8.7,"max_tuv_SVM","SVM",35,20,1812,1798,14,2100,1726,374,0.934681855132436,0.697247706422018,1.76141715638608,712,340,372,6,1.1,53.68,4.6,0,0,0,0,0,0,0.0182444726165706,17.5868361192129,1.96894560089739
8.7,"max_tuv_SVM","SVM",35,21,1712,1701,11,2200,1823,377,0.935518522819642,0.692660550458716,1.75656030760928,732,348,384,20,1.1,56.24,4.8,0,0,0,0,0,0,0.0153408332592616,13.8609104189175,1.70303778917042
8.7,"max_tuv_SVM","SVM",35,22,1612,1604,8,2300,1920,380,0.935584506075731,0.701834862385321,1.75494730457199,742,356,386,10,1.1,58.79,5.1,0,0,0,0,0,0,0.0119030669037044,10.3824533361193,1.39419584011722
8.7,"max_tuv_SVM","SVM",35,23,1512,1506,6,2400,2018,382,0.935600342057191,0.701834862385321,1.75173016927488,749,360,389,7,1.1,61.35,5.3,0,0,0,0,0,0,0.0123622706826953,10.0934233420866,1.25879855810359
8.7,"max_tuv_SVM","SVM",35,24,1412,1406,6,2500,2118,382,0.936361788832446,0.697247706422018,1.75656030760928,759,369,390,10,1.1,63.91,5.5,0,0,0,0,0,0,0.00830137049846783,5.66773342379977,1.00797759797965
8.7,"max_tuv_SVM","SVM",35,25,1312,1308,4,2600,2216,384,0.936708860759483,0.697247706422018,1.76805717471742,767,371,396,8,1.1,66.46,5.8,0,0,0,0,0,0,0.00631701818907005,4.29887343524346,0.673288144092203
8.7,"max_tuv_SVM","SVM",35,26,1212,1208,4,2700,2316,384,0.937358135999386,0.697247706422018,1.76643062717858,771,372,399,4,1.1,69.02,6,0,0,0,0,0,0,0.00588943068373556,3.63146163421482,0.614761845745017
8.7,"max_tuv_SVM","SVM",35,27,1112,1108,4,2800,2416,384,0.937206374510379,0.697247706422018,1.76805717471742,769,374,395,-2,1.1,71.57,6.3,0,0,0,0,0,0,0.00403486413818661,2.24233469387914,0.440314355391471
8.7,"max_tuv_SVM","SVM",35,28,1012,1008,4,2900,2516,384,0.937323824706216,0.701834862385321,1.76968672050057,775,377,398,6,1.1,74.13,6.6,0,0,0,0,0,0,0.0036983965428538,1.75858634721619,0.380409926236628
8.7,"max_tuv_SVM","SVM",35,29,912,908,4,3000,2616,384,0.937404324278643,0.701834862385321,1.76480706961684,775,378,397,0,1.1,76.69,6.8,0,0,0,0,0,0,0.00304536968638811,1.22859936843345,0.325993185582244
8.7,"max_tuv_SVM","SVM",35,30,812,809,3,3100,2715,385,0.937421479925227,0.701834862385321,1.75673384422975,779,379,400,4,1.1,79.24,7.1,0,0,0,0,0,0,0.00236175796526946,0.824226355055239,0.257808270427922
8.7,"max_tuv_SVM","SVM",35,31,712,709,3,3200,2815,385,0.937532331795457,0.706422018348624,1.76318649379533,781,380,401,2,1.1,81.8,7.3,0,0,0,0,0,0,0.00177842346625578,0.573651675595474,0.208211421026345
8.7,"max_tuv_SVM","SVM",35,32,612,610,2,3300,2914,386,0.93779362548957,0.701834862385321,1.77142568301868,785,382,403,4,1.1,84.36,7.5,0,0,0,0,0,0,0.00107348424407456,0.351837458087483,0.139655536107422
8.7,"max_tuv_SVM","SVM",35,33,512,512,0,3400,3012,388,0.937595675721305,0.701834862385321,1.77468497590372,797,386,411,12,1.1,86.91,7.8,0,0,0,0,0,0,0.000926702005378865,0.307891524595917,0.117782499412914
8.7,"max_tuv_SVM","SVM",35,34,412,412,0,3500,3112,388,0.937734240559092,0.697247706422018,1.77803215217574,794,387,407,-3,1.1,89.47,8,0,0,0,0,0,0,0.000694526523381588,0.207579874322111,0.0849358274579608
8.7,"max_tuv_SVM","SVM",35,35,312,312,0,3600,3212,388,0.937566643088627,0.697247706422018,1.77142568301868,795,387,408,1,1.1,92.02,8.3,0,0,0,0,0,0,0.000571527862871419,0.145298670562942,0.068089601016863
8.7,"max_tuv_SVM","SVM",35,36,212,212,0,3700,3312,388,0.937426758585719,0.697247706422018,1.77468497590372,799,388,411,4,1.1,94.58,8.5,0,0,0,0,0,0,0.000218470348449464,0.0433335926696512,0.0275287539524396
8.7,"max_tuv_SVM","SVM",35,37,112,112,0,3800,3412,388,0.937368693320361,0.688073394495413,1.77305383162439,802,388,414,3,1.1,97.14,8.8,0,0,0,0,0,0,7.37647354847917e-05,0.0134913191580386,0.0127099629570841
8.7,"max_tuv_SVM","SVM",35,38,12,12,0,3900,3512,388,0.93809978779783,0.688073394495413,1.77468497590372,798,388,410,-4,1.1,99.69,9.1,0,0,0,0,0,0,4.98995534151931e-05,0.000676924971572496,0.000676924971572496
8.7,"max_tuv_SVM","SVM",35,39,0,0,0,3912,3524,388,0.93821063966806,0.688073394495413,1.77142568301868,798,388,410,0,1.1,100,9.1,0,0,0,0,0,0,0,0,0
8.7,"max_tuv_SVM","SVM",36,0,3812,3413,399,100,91,9,0.892885050734876,0.505050505050505,1.75663139182846,24,9,15,0,1.7,2.56,10.1,0,0,0,0,0,0,0.651123089206591,353.962972401427,75.7077147022456
8.7,"max_tuv_SVM","SVM",36,1,3712,3376,336,200,128,72,0.910036083244262,0.590909090909091,1.75078609789354,107,54,53,83,1,5.11,1.8,0,0,0,0,0,0,0.731120392251524,322.206710912697,82.1869563584774
8.7,"max_tuv_SVM","SVM",36,2,3612,3314,298,300,190,110,0.892347824088448,0.595959595959596,1.7283330542999,198,99,99,91,1,7.67,1.7,0,0,0,0,0,0,0.655741051102392,285.592452561986,77.586688422461
8.7,"max_tuv_SVM","SVM",36,3,3512,3260,252,400,244,156,0.893201066409263,0.631313131313131,1.71014007478096,285,141,144,87,1,10.22,1.6,0,0,0,0,0,0,0.619852994657541,186.562021110552,80.2283924903518
8.7,"max_tuv_SVM","SVM",36,4,3412,3221,191,500,283,217,0.883648774433748,0.621212121212121,1.66914322286223,363,181,182,78,1,12.78,1.3,0,0,0,0,0,0,0.309013102593042,165.432335903418,66.3495445244978
8.7,"max_tuv_SVM","SVM",36,5,3312,3148,164,600,356,244,0.885260454373086,0.631313131313131,1.63887725178048,425,208,217,62,1,15.34,1.5,0,0,0,0,0,0,0.109868385561215,98.6365908337796,50.3273967156512
8.7,"max_tuv_SVM","SVM",36,6,3212,3090,122,700,414,286,0.881565943852644,0.656565656565657,1.62977237815947,463,224,239,38,1.1,17.89,1.4,0,0,0,0,0,0,0.0697981887304853,74.3160801059271,25.4934210532211
8.7,"max_tuv_SVM","SVM",36,7,3112,3012,100,800,492,308,0.886064857907871,0.661616161616162,1.63736815670517,503,241,262,40,1.1,20.45,1.6,0,0,0,0,0,0,0.0588491974628613,64.4871647846961,17.7738133482711
8.7,"max_tuv_SVM","SVM",36,8,3012,2938,74,900,566,334,0.886829041265907,0.676767676767677,1.60245775729647,550,265,285,47,1.1,23.01,1.7,0,0,0,0,0,0,0.0529232678106596,77.7721125376629,14.7040133834115
8.7,"max_tuv_SVM","SVM",36,9,2912,2852,60,1000,652,348,0.901224991668671,0.661616161616162,1.65403808090101,588,281,307,38,1.1,25.56,1.9,0,0,0,0,0,0,0.0550273286707111,78.8713121495401,11.7850671659744
8.7,"max_tuv_SVM","SVM",36,10,2812,2764,48,1100,740,360,0.909814872272211,0.671717171717172,1.68285060550254,613,293,320,25,1.1,28.12,2.1,0,0,0,0,0,0,0.0539358142271638,83.270574723572,7.84918697257516
8.7,"max_tuv_SVM","SVM",36,11,2712,2669,43,1200,835,365,0.923007090242587,0.666666666666667,1.7283330542999,629,304,325,16,1.1,30.67,2.3,0,0,0,0,0,0,0.0409671619242774,58.9763424901223,6.4648206804598
8.7,"max_tuv_SVM","SVM",36,12,2612,2579,33,1300,925,375,0.928738465427875,0.661616161616162,1.74813573523251,652,315,337,23,1.1,33.23,2.5,0,0,0,0,0,0,0.0615892040875313,68.1864015174059,7.97275491017366
8.7,"max_tuv_SVM","SVM",36,13,2512,2482,30,1400,1022,378,0.930511026074156,0.651515151515151,1.74011676396998,672,320,352,20,1.1,35.79,2.7,0,0,0,0,0,0,0.0542274338630885,56.4398039521076,6.75562346203249
8.7,"max_tuv_SVM","SVM",36,14,2412,2385,27,1500,1119,381,0.929367623906866,0.651515151515151,1.75562252357832,684,325,359,12,1.1,38.34,2.9,0,0,0,0,0,0,0.0456524381528365,44.4943458804374,6.01379367295869
8.7,"max_tuv_SVM","SVM",36,15,2312,2290,22,1600,1214,386,0.927992955723324,0.661616161616162,1.75562252357832,704,331,373,20,1.1,40.9,3.1,0,0,0,0,0,0,0.0471592825323092,41.2889845611714,6.51080244197997
8.7,"max_tuv_SVM","SVM",36,16,2212,2195,17,1700,1309,391,0.926471771181662,0.661616161616162,1.74813573523251,716,338,378,12,1.1,43.46,3.3,0,0,0,0,0,0,0.0381209494888944,37.0592869120679,5.69280916929641
8.7,"max_tuv_SVM","SVM",36,17,2112,2100,12,1800,1404,396,0.92637409360958,0.661616161616162,1.74491929413733,727,344,383,11,1.1,46.01,3.5,0,0,0,0,0,0,0.0280189258752181,30.1267472514148,4.25357496878254
8.7,"max_tuv_SVM","SVM",36,18,2012,2002,10,1900,1502,398,0.926371220739814,0.661616161616162,1.74813573523251,730,346,384,3,1.1,48.57,3.8,0,0,0,0,0,0,0.0269248359978302,28.4390803770277,3.7327865782537
8.7,"max_tuv_SVM","SVM",36,19,1912,1903,9,2000,1601,399,0.9287542662116,0.646464646464647,1.77381550309727,742,361,381,12,1.1,51.12,4,0,0,0,0,0,0,0.0146727160111319,12.0449953830878,1.89215689558824
8.7,"max_tuv_SVM","SVM",36,20,1812,1805,7,2100,1699,401,0.928683880902306,0.646464646464647,1.77055481283422,749,362,387,7,1.1,53.68,4.2,0,0,0,0,0,0,0.012272168831773,11.289152167215,1.38823586183602
8.7,"max_tuv_SVM","SVM",36,21,1712,1705,7,2200,1799,401,0.928770066995318,0.646464646464647,1.77055481283422,750,363,387,1,1.1,56.24,4.5,0,0,0,0,0,0,0.0102993204548533,8.63202998233246,1.04871185328489
8.7,"max_tuv_SVM","SVM",36,22,1612,1605,7,2300,1899,401,0.930419094241621,0.641414141414141,1.77055481283422,763,375,388,13,1,58.79,4.7,0,0,0,0,0,0,0.00694598905103875,4.92188601061989,0.880685028373172
8.7,"max_tuv_SVM","SVM",36,23,1512,1505,7,2400,1999,401,0.930245285620713,0.646464646464647,1.77055481283422,760,372,388,-3,1,61.35,5,0,0,0,0,0,0,0.00527875987171062,3.98774411687164,0.584647920495738
8.7,"max_tuv_SVM","SVM",36,24,1412,1405,7,2500,2099,401,0.930414784936971,0.641414141414141,1.76730608840701,766,375,391,6,1,63.91,5.2,0,0,0,0,0,0,0.00509901754862031,3.48909506289543,0.524220464876418
8.7,"max_tuv_SVM","SVM",36,25,1312,1305,7,2600,2199,401,0.931451890922879,0.641414141414141,1.76730608840701,779,381,398,13,1,66.46,5.5,0,0,0,0,0,0,0.00355356263444447,2.19260738382221,0.403834806169033
8.7,"max_tuv_SVM","SVM",36,26,1212,1206,6,2700,2298,402,0.931911550085611,0.636363636363636,1.77381550309727,782,382,400,3,1,69.02,5.7,0,0,0,0,0,0,0.00349702284458488,2.0110185635985,0.365176082694025
8.7,"max_tuv_SVM","SVM",36,27,1112,1106,6,2800,2398,402,0.932280713850679,0.631313131313131,1.78127177943185,780,381,399,-2,1,71.57,6,0,0,0,0,0,0,0.00294822319445399,1.48374803532264,0.309964671455683
8.7,"max_tuv_SVM","SVM",36,28,1012,1006,6,2900,2498,402,0.932685788487836,0.631313131313131,1.78127177943185,783,383,400,3,1,74.13,6.2,0,0,0,0,0,0,0.00243508794427516,1.07050481166456,0.255427920004223
8.7,"max_tuv_SVM","SVM",36,29,912,907,5,3000,2597,403,0.933254616701716,0.626262626262626,1.77963458110517,792,387,405,9,1,76.69,6.4,0,0,0,0,0,0,0.00218083310486543,0.832603102338708,0.237398763554759
8.7,"max_tuv_SVM","SVM",36,30,812,809,3,3100,2695,405,0.933564886636559,0.626262626262626,1.78127177943185,800,390,410,8,1.1,79.24,6.7,0,0,0,0,0,0,0.0019648696947867,0.689776321276181,0.220311861692416
8.7,"max_tuv_SVM","SVM",36,31,712,709,3,3200,2795,405,0.933682674297009,0.626262626262626,1.77963458110517,801,390,411,1,1.1,81.8,6.9,0,0,0,0,0,0,0.00158634134965133,0.507396951021653,0.182945288542727
8.7,"max_tuv_SVM","SVM",36,32,612,609,3,3300,2895,405,0.933817699176062,0.626262626262626,1.78127177943185,802,390,412,1,1.1,84.36,7.1,0,0,0,0,0,0,0.00113833720395472,0.350782173067843,0.14179820399952
8.7,"max_tuv_SVM","SVM",36,33,512,510,2,3400,2994,406,0.934150952069041,0.636363636363636,1.78127177943185,805,394,411,3,1,86.91,7.4,0,0,0,0,0,0,0.00082430250924846,0.262184397602149,0.108005239923872
8.7,"max_tuv_SVM","SVM",36,34,412,411,1,3500,3093,407,0.934584755403868,0.636363636363636,1.77963458110517,809,395,414,4,1,89.47,7.6,0,0,0,0,0,0,0.000621816083645982,0.185914910686483,0.0774528866812765
8.7,"max_tuv_SVM","SVM",36,35,312,312,0,3600,3192,408,0.934834695073604,0.631313131313131,1.78127177943185,814,400,414,5,1,92.02,7.8,0,0,0,0,0,0,0.000538676943595184,0.134928228440078,0.0639249950546917
8.7,"max_tuv_SVM","SVM",36,36,212,212,0,3700,3292,408,0.934870605945692,0.636363636363636,1.79200848261622,816,402,414,2,1,94.58,8.1,0,0,0,0,0,0,0.000228256475360271,0.049360675724266,0.0308171587701588
8.7,"max_tuv_SVM","SVM",36,37,112,112,0,3800,3392,408,0.935098999092174,0.636363636363636,1.78871434937611,819,402,417,3,1,97.14,8.3,0,0,0,0,0,0,0.000120478417964079,0.0182349545107494,0.0169509792570209
8.7,"max_tuv_SVM","SVM",36,38,12,12,0,3900,3492,408,0.935432251985154,0.636363636363636,1.78543230469836,822,404,418,3,1,99.69,8.6,0,0,0,0,0,0,8.14450582523984e-05,0.00113509651861276,0.00113509651861276
8.7,"max_tuv_SVM","SVM",36,39,0,0,0,3912,3504,408,0.935380540329347,0.636363636363636,1.79200848261622,822,404,418,0,1,100,8.6,0,0,0,0,0,0,0,0,0
8.7,"max_tuv_SVM","SVM",37,0,3812,3417,395,100,89,11,0.900808656036458,0.505,1.75769585253456,33,11,22,0,2,2.56,8.1,0,0,0,0,0,0,0.26322907211477,405.478133580062,30.8796965028928
8.7,"max_tuv_SVM","SVM",37,1,3712,3382,330,200,124,76,0.922423120728938,0.595,1.76508287292818,106,52,54,73,1,5.11,1.6,0,0,0,0,0,0,0.687149140269114,355.233126055567,76.5888581244366
8.7,"max_tuv_SVM","SVM",37,2,3612,3324,288,300,182,118,0.915879840546692,0.64,1.73646734130635,194,95,99,88,1,7.67,1.5,0,0,0,0,0,0,0.609792300715865,347.028305413969,70.5975304661168
8.7,"max_tuv_SVM","SVM",37,3,3512,3271,241,400,235,165,0.895264806378127,0.585,1.70047838086477,282,137,145,88,1.1,10.22,1.4,0,0,0,0,0,0,0.534662316792099,355.260782775558,72.2249503974119
8.7,"max_tuv_SVM","SVM",37,4,3412,3214,198,500,292,208,0.913341400911166,0.66,1.69303867403315,369,184,185,87,1,12.78,1.4,0,0,0,0,0,0,0.345637296855174,263.672312803547,73.2666391835433
8.7,"max_tuv_SVM","SVM",37,5,3312,3155,157,600,351,249,0.899171412300671,0.665,1.63150230414747,444,217,227,75,1,15.34,1.4,0,0,0,0,0,0,0.192270022403719,238.735720298795,57.1090196041341
8.7,"max_tuv_SVM","SVM",37,6,3212,3082,130,700,424,276,0.904587129840542,0.685,1.637497700092,496,239,257,52,1.1,17.89,1.5,0,0,0,0,0,0,0.118468828708074,183.086922671834,44.4115671620089
8.7,"max_tuv_SVM","SVM",37,7,3112,3006,106,800,500,300,0.906492027334854,0.68,1.64649494020239,518,246,272,22,1.1,20.45,1.7,0,0,0,0,0,0,0.0771686894232915,132.848458646064,28.9835431834112
8.7,"max_tuv_SVM","SVM",37,8,3012,2924,88,900,582,318,0.914755125284749,0.68,1.68248390064397,550,262,288,32,1.1,23.01,1.8,0,0,0,0,0,0,0.0774314014250529,136.303251069438,22.3017863954152
8.7,"max_tuv_SVM","SVM",37,9,2912,2834,78,1000,672,328,0.933599088838281,0.67,1.73646734130635,578,282,296,28,1,25.56,2,0,0,0,0,0,0,0.0679108541142054,102.822628132353,19.7369460415855
8.7,"max_tuv_SVM","SVM",37,10,2812,2756,56,1100,750,350,0.941524772209579,0.665,1.7560773480663,608,294,314,30,1.1,28.12,2.1,0,0,0,0,0,0,0.0874634907960223,114.888101230857,12.6268478452826
8.7,"max_tuv_SVM","SVM",37,11,2712,2662,50,1200,844,356,0.943391230068355,0.66,1.76670967741935,630,306,324,22,1.1,30.67,2.4,0,0,0,0,0,0,0.0716403865108036,85.5036870029339,10.5428055012819
8.7,"max_tuv_SVM","SVM",37,12,2612,2570,42,1300,936,364,0.9461332574032,0.665,1.76670967741935,653,314,339,23,1.1,33.23,2.6,0,0,0,0,0,0,0.0627817081214727,71.4180179527205,9.56088665774602
8.7,"max_tuv_SVM","SVM",37,13,2512,2472,40,1400,1034,366,0.94663866742598,0.665,1.76508287292818,657,317,340,4,1.1,35.79,2.8,0,0,0,0,0,0,0.0551593082906216,58.2887772734429,8.62876653760465
8.7,"max_tuv_SVM","SVM",37,14,2412,2375,37,1500,1131,369,0.946714123006845,0.665,1.77245630174793,665,321,344,8,1.1,38.34,3.1,0,0,0,0,0,0,0.0514269735433611,53.0576059024092,8.41163437876946
8.7,"max_tuv_SVM","SVM",37,15,2312,2288,24,1600,1218,382,0.946227220956734,0.65,1.77245630174793,703,336,367,38,1.1,40.9,3.2,0,0,0,0,0,0,0.0546470956806285,56.6559001820727,9.55485783097721
8.7,"max_tuv_SVM","SVM",37,16,2212,2195,17,1700,1311,389,0.945560933940792,0.65,1.76345906163753,724,343,381,21,1.1,43.46,3.4,0,0,0,0,0,0,0.0443081844005692,51.8325642545953,7.91977641345836
8.7,"max_tuv_SVM","SVM",37,17,2112,2097,15,1800,1409,391,0.945481207289314,0.66,1.76022038567493,727,345,382,3,1.1,46.01,3.6,0,0,0,0,0,0,0.0386760719412626,43.2314893539205,6.75192224633902
8.7,"max_tuv_SVM","SVM",37,18,2012,1998,14,1900,1508,392,0.944179954441925,0.65,1.77818181818182,755,363,392,28,1.1,48.57,3.8,0,0,0,0,0,0,0.0277056724996009,21.6818031055464,5.48774335485672
8.7,"max_tuv_SVM","SVM",37,19,1912,1901,11,2000,1605,395,0.944111617312084,0.65,1.77818181818182,757,365,392,2,1.1,51.12,4.1,0,0,0,0,0,0,0.0180098732724306,14.7929280763197,2.17862349097406
8.7,"max_tuv_SVM","SVM",37,20,1812,1802,10,2100,1704,396,0.943964977220963,0.65,1.77082720588235,759,366,393,2,1.1,53.68,4.3,0,0,0,0,0,0,0.0140247752537809,12.1191054770648,1.55588605037269
8.7,"max_tuv_SVM","SVM",37,21,1712,1704,8,2200,1802,398,0.944396355353076,0.645,1.77408839779006,765,369,396,6,1.1,56.24,4.5,0,0,0,0,0,0,0.0130228218702713,11.135731017793,1.39610532211752
8.7,"max_tuv_SVM","SVM",37,22,1612,1606,6,2300,1900,400,0.944773633257407,0.64,1.78880514705882,785,377,408,20,1.1,58.79,4.8,0,0,0,0,0,0,0.00989467619801347,8.26185380575413,1.15403673808244
8.7,"max_tuv_SVM","SVM",37,23,1512,1507,5,2400,1999,401,0.944359339407748,0.645,1.78880514705882,794,381,413,9,1.1,61.35,5,0,0,0,0,0,0,0.0109766320953313,7.71692044442648,1.1280024231996
8.7,"max_tuv_SVM","SVM",37,24,1412,1407,5,2500,2099,401,0.943920842824608,0.64,1.78880514705882,799,387,412,5,1.1,63.91,5.2,0,0,0,0,0,0,0.00700157504742706,4.53680207987713,0.828673645526968
8.7,"max_tuv_SVM","SVM",37,25,1312,1307,5,2600,2199,401,0.943949316628708,0.64,1.78716253443526,798,386,412,-1,1.1,66.46,5.5,0,0,0,0,0,0,0.00599072785184537,3.67451516817772,0.631559810293755
8.7,"max_tuv_SVM","SVM",37,26,1212,1207,5,2700,2299,401,0.944068906605928,0.64,1.78388634280477,798,388,410,0,1.1,69.02,5.7,0,0,0,0,0,0,0.004954349074023,2.77535219815366,0.522461987276433
8.7,"max_tuv_SVM","SVM",37,27,1112,1108,4,2800,2398,402,0.94448177676538,0.635,1.78880514705882,802,390,412,4,1.1,71.57,6,0,0,0,0,0,0,0.0041136893125843,2.06149530175251,0.43190826771
8.7,"max_tuv_SVM","SVM",37,28,1012,1008,4,2900,2498,402,0.94454726651481,0.63,1.79209944751381,804,392,412,2,1.1,74.13,6.2,0,0,0,0,0,0,0.00430430403131475,1.98761262234251,0.461011086190171
8.7,"max_tuv_SVM","SVM",37,29,912,909,3,3000,2597,403,0.944706719817771,0.635,1.78716253443526,810,394,416,6,1.1,76.69,6.4,0,0,0,0,0,0,0.00331701800421622,1.37797509066817,0.360683778765885
8.7,"max_tuv_SVM","SVM",37,30,812,809,3,3100,2697,403,0.944720956719821,0.635,1.79045078196872,808,394,414,-2,1.1,79.24,6.7,0,0,0,0,0,0,0.0025098135472571,0.9455001140185,0.280933483689155
8.7,"max_tuv_SVM","SVM",37,31,712,710,2,3200,2796,404,0.94473234624146,0.635,1.79375115207373,814,395,419,6,1.1,81.8,6.9,0,0,0,0,0,0,0.0019968598688274,0.675250319489622,0.223232316335652
8.7,"max_tuv_SVM","SVM",37,32,612,610,2,3300,2896,404,0.94473804100228,0.64,1.79045078196872,814,395,419,0,1.1,84.36,7.2,0,0,0,0,0,0,0.00155476801983243,0.485574235947048,0.182650649379847
8.7,"max_tuv_SVM","SVM",37,33,512,510,2,3400,2996,404,0.944730922551254,0.64,1.79209944751381,814,396,418,0,1.1,86.91,7.4,0,0,0,0,0,0,0.000981441358322127,0.288278295886163,0.124742493146897
8.7,"max_tuv_SVM","SVM",37,34,412,411,1,3500,3095,405,0.94484339407745,0.64,1.79045078196872,816,397,419,2,1.1,89.47,7.6,0,0,0,0,0,0,0.000843594823369194,0.243314361315033,0.10929100536774
8.7,"max_tuv_SVM","SVM",37,35,312,312,0,3600,3194,406,0.945472665148065,0.635,1.79045078196872,822,402,420,6,1,92.02,7.9,0,0,0,0,0,0,0.000596566279659684,0.145166200728434,0.0741887360314959
8.7,"max_tuv_SVM","SVM",37,36,212,212,0,3700,3294,406,0.945498291571755,0.635,1.79045078196872,826,402,424,4,1.1,94.58,8.1,0,0,0,0,0,0,0.000226026066245717,0.051607675320245,0.0336324495184842
8.7,"max_tuv_SVM","SVM",37,37,112,112,0,3800,3394,406,0.945666287015946,0.635,1.80276497695853,829,402,427,3,1.1,97.14,8.4,0,0,0,0,0,0,0.000106115835884754,0.0188720718903835,0.0177209231666599
8.7,"max_tuv_SVM","SVM",37,38,12,12,0,3900,3494,406,0.945881264236903,0.63,1.79779411764706,833,404,429,4,1.1,99.69,8.6,0,0,0,0,0,0,6.05760693431588e-05,0.000880641453370743,0.000880641453370743
8.7,"max_tuv_SVM","SVM",37,39,0,0,0,3912,3506,406,0.945802961275627,0.63,1.80110497237569,835,404,431,2,1.1,100,8.6,0,0,0,0,0,0,0,0,0
8.7,"max_tuv_SVM","SVM",38,0,3812,3418,394,100,91,9,0.90675520360593,0.551724137931034,1.75836189870832,23,9,14,0,1.6,2.56,10.1,0,0,0,0,0,0,0.345760198404571,319.15800283929,38.7181480056156
8.7,"max_tuv_SVM","SVM",38,1,3712,3391,321,200,118,82,0.919563647399677,0.596059113300493,1.76075126545346,87,46,41,64,0.9,5.11,1.4,0,0,0,0,0,0,0.712664024832911,261.18167834874,80.0343431164944
8.7,"max_tuv_SVM","SVM",38,2,3612,3327,285,300,182,118,0.907817422068861,0.596059113300493,1.70507820480806,179,91,88,92,1,7.67,1.5,0,0,0,0,0,0,0.619735758712054,187.28814877497,75.4952430479959
8.7,"max_tuv_SVM","SVM",38,3,3512,3277,235,400,232,168,0.909378433593086,0.635467980295567,1.7478703426503,264,129,135,85,1,10.22,1.4,0,0,0,0,0,0,0.371630947821783,175.583298493405,69.5933207832914
8.7,"max_tuv_SVM","SVM",38,4,3412,3216,196,500,293,207,0.889346623241241,0.625615763546798,1.68731697350798,343,170,173,79,1,12.78,1.4,0,0,0,0,0,0,0.222360655832316,148.282312751619,58.2327507009361
8.7,"max_tuv_SVM","SVM",38,5,3312,3157,155,600,352,248,0.892566999851069,0.650246305418719,1.65457530974772,406,201,205,63,1,15.34,1.4,0,0,0,0,0,0,0.111396428295891,94.3311335462353,39.2126602949836
8.7,"max_tuv_SVM","SVM",38,6,3212,3091,121,700,418,282,0.894764499422522,0.669950738916256,1.64140108319952,473,225,248,67,1.1,17.89,1.5,0,0,0,0,0,0,0.0817300549043727,85.3589967224352,27.9035401228445
8.7,"max_tuv_SVM","SVM",38,7,3112,3016,96,800,493,307,0.895497935980273,0.679802955665025,1.64572731343891,508,245,263,35,1.1,20.45,1.6,0,0,0,0,0,0,0.0594230268127868,75.1676329636915,18.7530564990258
8.7,"max_tuv_SVM","SVM",38,8,3012,2935,77,900,574,326,0.900275108961707,0.694581280788177,1.65027352148709,549,261,288,41,1.1,23.01,1.8,0,0,0,0,0,0,0.0564787820110165,89.391443169457,14.0735652683693
8.7,"max_tuv_SVM","SVM",38,9,2912,2848,64,1000,661,339,0.912900896141457,0.689655172413793,1.67534815848745,579,281,298,30,1.1,25.56,1.9,0,0,0,0,0,0,0.0553694961697008,91.7911905103477,13.5081869724884
8.7,"max_tuv_SVM","SVM",38,10,2812,2760,52,1100,749,351,0.917877586347418,0.689655172413793,1.68421243445829,605,292,313,26,1.1,28.12,2.1,0,0,0,0,0,0,0.0619257857957331,96.1448728517007,11.3622563291575
8.7,"max_tuv_SVM","SVM",38,11,2712,2663,49,1200,846,354,0.932813277168794,0.684729064039409,1.73012546607517,635,306,329,30,1.1,30.67,2.4,0,0,0,0,0,0,0.063743529512147,83.8331162549376,11.4540996341956
8.7,"max_tuv_SVM","SVM",38,12,2612,2572,40,1300,937,363,0.938144040195724,0.679802955665025,1.7446573456969,655,315,340,20,1.1,33.23,2.6,0,0,0,0,0,0,0.059699732289958,63.0791959028226,8.24186928691832
8.7,"max_tuv_SVM","SVM",38,13,2512,2478,34,1400,1031,369,0.941122748054742,0.67487684729064,1.76399091819578,670,321,349,15,1.1,35.79,2.8,0,0,0,0,0,0,0.0584902231779517,57.9054926378419,8.06160132338008
8.7,"max_tuv_SVM","SVM",38,14,2412,2382,30,1500,1127,373,0.941940487665092,0.684729064039409,1.75913589732002,677,325,352,7,1.1,38.34,3,0,0,0,0,0,0,0.057849530837961,51.1848968358162,7.97712306578054
8.7,"max_tuv_SVM","SVM",38,15,2312,2287,25,1600,1222,378,0.942075372549269,0.689655172413793,1.76399091819578,693,330,363,16,1.1,40.9,3.2,0,0,0,0,0,0,0.0576732879399952,45.1931144843945,8.23632962720425
8.7,"max_tuv_SVM","SVM",38,16,2212,2192,20,1700,1317,383,0.94197420888613,0.684729064039409,1.76075126545346,708,335,373,15,1.1,43.46,3.4,0,0,0,0,0,0,0.0423119030104627,40.1342072644076,7.11343357248483
8.7,"max_tuv_SVM","SVM",38,17,2112,2096,16,1800,1413,387,0.941816843187917,0.684729064039409,1.76236960301362,717,339,378,9,1.1,46.01,3.7,0,0,0,0,0,0,0.0320667805994718,34.1532516838077,5.47809663299358
8.7,"max_tuv_SVM","SVM",38,18,2012,1999,13,1900,1510,390,0.941915196749303,0.684729064039409,1.76399091819578,725,343,382,8,1.1,48.57,3.9,0,0,0,0,0,0,0.0272774878910539,27.338024155947,3.74899041267224
8.7,"max_tuv_SVM","SVM",38,19,1912,1900,12,2000,1609,391,0.941991069496654,0.665024630541872,1.78401881944977,742,358,384,17,1.1,51.12,4.1,0,0,0,0,0,0,0.0201432400512218,14.5971345028189,2.50535761397779
8.7,"max_tuv_SVM","SVM",38,20,1812,1801,11,2100,1708,392,0.941915196749302,0.669950738916256,1.79058374610828,744,359,385,2,1.1,53.68,4.4,0,0,0,0,0,0,0.0142717728548816,12.1627541816389,1.6688200780503
8.7,"max_tuv_SVM","SVM",38,21,1712,1702,10,2200,1807,393,0.942030410921207,0.669950738916256,1.78401881944977,746,360,386,2,1.1,56.24,4.6,0,0,0,0,0,0,0.0119072863302125,10.1257105719441,1.27709122792972
8.7,"max_tuv_SVM","SVM",38,22,1612,1603,9,2300,1906,394,0.941811222984411,0.669950738916256,1.78401881944977,749,363,386,3,1.1,58.79,4.8,0,0,0,0,0,0,0.0115466220725805,9.18342639707497,1.18318044925675
8.7,"max_tuv_SVM","SVM",38,23,1512,1505,7,2400,2004,396,0.941232342023128,0.655172413793103,1.7889379889887,764,370,394,15,1.1,61.35,5.1,0,0,0,0,0,0,0.0104583422219164,7.64662207576004,1.15101360935243
8.7,"max_tuv_SVM","SVM",38,24,1412,1405,7,2500,2104,396,0.940982242967039,0.655172413793103,1.79223253408813,770,373,397,6,1.1,63.91,5.3,0,0,0,0,0,0,0.00785568973634824,5.3693712818914,0.86985282727826
8.7,"max_tuv_SVM","SVM",38,25,1312,1306,6,2600,2203,397,0.94100472378107,0.655172413793103,1.7889379889887,773,375,398,3,1.1,66.46,5.5,0,0,0,0,0,0,0.0069674143258898,4.28605626717751,0.723756497488641
8.7,"max_tuv_SVM","SVM",38,26,1212,1206,6,2700,2303,397,0.940751814623229,0.650246305418719,1.79223253408813,778,380,398,5,1,69.02,5.8,0,0,0,0,0,0,0.00497682983009857,2.82415711996763,0.55703386524425
8.7,"max_tuv_SVM","SVM",38,27,1112,1106,6,2800,2403,397,0.940883889405657,0.650246305418719,1.79223253408813,780,380,400,2,1.1,71.57,6.1,0,0,0,0,0,0,0.00467903043050429,2.28975343648649,0.482026799405997
8.7,"max_tuv_SVM","SVM",38,28,1012,1006,6,2900,2503,397,0.940777105539013,0.650246305418719,1.79058374610828,782,382,400,2,1,74.13,6.3,0,0,0,0,0,0,0.00357320980085545,1.58238021668262,0.397991232414857
8.7,"max_tuv_SVM","SVM",38,29,912,907,5,3000,2602,398,0.941046875307374,0.650246305418719,1.7889379889887,786,384,402,4,1,76.69,6.5,0,0,0,0,0,0,0.00347952569404017,1.29768592000855,0.367977549829842
8.7,"max_tuv_SVM","SVM",38,30,812,808,4,3100,2701,399,0.940882484354776,0.645320197044335,1.79223253408813,791,387,404,5,1,79.24,6.8,0,0,0,0,0,0,0.00273941873044305,0.917424535576183,0.306494779249606
8.7,"max_tuv_SVM","SVM",38,31,712,709,3,3200,2800,400,0.941209861209089,0.640394088669951,1.78729525437989,793,388,405,2,1,81.8,7,0,0,0,0,0,0,0.00230699806438388,0.727872333837312,0.272791558241059
8.7,"max_tuv_SVM","SVM",38,32,612,609,3,3300,2900,400,0.941274493549424,0.645320197044335,1.79388436130848,794,388,406,1,1,84.36,7.2,0,0,0,0,0,0,0.00160204780962117,0.483683166537501,0.202989234973186
8.7,"max_tuv_SVM","SVM",38,33,512,509,3,3400,3000,400,0.941586414844092,0.645320197044335,1.79058374610828,795,388,407,1,1,86.91,7.5,0,0,0,0,0,0,0.000811179548268448,0.247347814599185,0.11050495888531
8.7,"max_tuv_SVM","SVM",38,34,412,412,0,3500,3097,403,0.942345142317609,0.640394088669951,1.78729525437989,807,394,413,12,1,89.47,7.7,0,0,0,0,0,0,0.000953961859753331,0.280915464871587,0.118939349896407
8.7,"max_tuv_SVM","SVM",38,35,312,312,0,3600,3197,403,0.942536229236863,0.640394088669951,1.79388436130848,813,394,419,6,1.1,92.02,7.9,0,0,0,0,0,0,0.000595091288335017,0.145656381684641,0.0729195625687263
8.7,"max_tuv_SVM","SVM",38,36,212,212,0,3700,3297,403,0.942918403075375,0.640394088669951,1.79223253408813,818,397,421,5,1.1,94.58,8.2,0,0,0,0,0,0,0.000322584898937449,0.0685796291951751,0.043380027436413
8.7,"max_tuv_SVM","SVM",38,37,112,112,0,3800,3397,403,0.943221894064781,0.640394088669951,1.79388436130848,817,398,419,-1,1.1,97.14,8.4,0,0,0,0,0,0,0.00012717110065307,0.0205423658924222,0.0191621508644092
8.7,"max_tuv_SVM","SVM",38,38,12,12,0,3900,3497,403,0.943365209254224,0.640394088669951,1.79388436130848,816,398,418,-1,1.1,99.69,8.7,0,0,0,0,0,0,9.40181217128504e-05,0.00133347262214677,0.00133347262214677
8.7,"max_tuv_SVM","SVM",38,39,0,0,0,3912,3509,403,0.943396120373515,0.640394088669951,1.79388436130848,816,398,418,0,1.1,100,8.7,0,0,0,0,0,0,0,0,0
8.7,"max_tuv_SVM","SVM",39,0,3812,3413,399,100,90,10,0.870981146994559,0.49746192893401,1.69295188191537,30,10,20,0,2,2.56,9,0,0,0,0,0,0,0.176498268652868,377.576770250191,19.3456102049907
8.7,"max_tuv_SVM","SVM",39,1,3712,3366,346,200,137,63,0.903256060925246,0.573604060913706,1.70496846638979,113,55,58,83,1.1,5.11,2.2,0,0,0,0,0,0,0.671963785634744,382.565358655871,73.7402386918189
8.7,"max_tuv_SVM","SVM",39,2,3612,3309,303,300,194,106,0.901481286956399,0.614213197969543,1.73232090167946,204,100,104,91,1,7.67,1.8,0,0,0,0,0,0,0.610871501793925,394.253676052565,68.9600965816561
8.7,"max_tuv_SVM","SVM",39,3,3512,3261,251,400,242,158,0.876129434409824,0.568527918781726,1.66849855267022,275,135,140,71,1,10.22,1.5,0,0,0,0,0,0,0.573683438731246,300.060734309859,74.3479734008765
8.7,"max_tuv_SVM","SVM",39,4,3412,3208,204,500,295,205,0.88804783520862,0.619289340101523,1.67310766469417,363,178,185,88,1,12.78,1.4,0,0,0,0,0,0,0.29371282007942,228.237979077276,64.9721974460907
8.7,"max_tuv_SVM","SVM",39,5,3312,3161,151,600,342,258,0.913460289793167,0.649746192893401,1.70053565919735,431,214,217,68,1,15.34,1.3,0,0,0,0,0,0,0.16529755249658,171.923187414095,46.1818269845012
8.7,"max_tuv_SVM","SVM",39,6,3212,3091,121,700,412,288,0.910776485254939,0.67005076142132,1.69139299436296,477,232,245,46,1.1,17.89,1.4,0,0,0,0,0,0,0.0966767284224779,118.063705466058,34.1679336780224
8.7,"max_tuv_SVM","SVM",39,7,3112,3012,100,800,491,309,0.911601827295728,0.66497461928934,1.69429516136544,494,240,254,17,1.1,20.45,1.6,0,0,0,0,0,0,0.0722785942482109,104.304149337212,20.2794586293396
8.7,"max_tuv_SVM","SVM",39,8,3012,2939,73,900,564,336,0.909394181627192,0.6751269035533,1.68983697504892,536,257,279,42,1.1,23.01,1.7,0,0,0,0,0,0,0.0754573606418038,127.520622375345,13.0716791723992
8.7,"max_tuv_SVM","SVM",39,9,2912,2848,64,1000,655,345,0.913353514773901,0.67005076142132,1.68983697504892,566,274,292,30,1.1,25.56,1.9,0,0,0,0,0,0,0.0596491879798253,96.4266775414483,10.0500992748699
8.7,"max_tuv_SVM","SVM",39,10,2812,2754,58,1100,749,351,0.923873739982621,0.680203045685279,1.70967832403175,587,286,301,21,1.1,28.12,2.1,0,0,0,0,0,0,0.0530675951643135,81.5735070598544,8.70221972458779
8.7,"max_tuv_SVM","SVM",39,11,2712,2660,52,1200,843,357,0.929260106832723,0.680203045685279,1.71723973680647,602,292,310,15,1.1,30.67,2.4,0,0,0,0,0,0,0.0471716581990845,70.5889420115928,7.83337231888221
8.7,"max_tuv_SVM","SVM",39,12,2612,2570,42,1300,933,367,0.940086228042578,0.67005076142132,1.74894984399013,636,307,329,34,1.1,33.23,2.5,0,0,0,0,0,0,0.0640052257626042,77.2066700191211,10.3033979273262
8.7,"max_tuv_SVM","SVM",39,13,2512,2472,40,1400,1031,369,0.943604032055588,0.66497461928934,1.76716807153169,645,312,333,9,1.1,35.79,2.8,0,0,0,0,0,0,0.051212072159735,58.1691618941171,8.36320555646464
8.7,"max_tuv_SVM","SVM",39,14,2412,2375,37,1500,1128,372,0.944869460324418,0.67005076142132,1.77204526032157,655,316,339,10,1.1,38.34,3,0,0,0,0,0,0,0.0434259854191628,50.0545238562142,6.49849513611138
8.7,"max_tuv_SVM","SVM",39,15,2312,2280,32,1600,1223,377,0.947276226974827,0.67005076142132,1.78866825918185,662,321,341,7,1.1,40.9,3.2,0,0,0,0,0,0,0.0441113592181287,45.900287400465,5.87161609534417
8.7,"max_tuv_SVM","SVM",39,16,2212,2183,29,1700,1320,380,0.948488267734023,0.67005076142132,1.79031376815993,673,325,348,11,1.1,43.46,3.5,0,0,0,0,0,0,0.0363810695327352,35.8638383967071,5.17205167921596
8.7,"max_tuv_SVM","SVM",39,17,2112,2089,23,1800,1414,386,0.950049491664324,0.65989847715736,1.79361388570493,691,330,361,18,1.1,46.01,3.7,0,0,0,0,0,0,0.0356826188029785,36.5060091439285,5.24021028470853
8.7,"max_tuv_SVM","SVM",39,18,2012,1994,18,1900,1509,391,0.9503871315901,0.654822335025381,1.78702577225881,709,338,371,18,1.1,48.57,3.9,0,0,0,0,0,0,0.0316526179512965,31.645536049,4.47038770537633
8.7,"max_tuv_SVM","SVM",39,19,1912,1896,16,2000,1607,393,0.950138951815598,0.654822335025381,1.7919623075413,712,341,371,3,1.1,51.12,4.1,0,0,0,0,0,0,0.0267600431363149,24.7004286852332,2.75659437684294
8.7,"max_tuv_SVM","SVM",39,20,1812,1796,16,2100,1707,393,0.94763118176859,0.649746192893401,1.78866825918185,723,352,371,11,1.1,53.68,4.3,0,0,0,0,0,0,0.0186627748471227,13.7266872614878,2.32241040583089
8.7,"max_tuv_SVM","SVM",39,21,1712,1698,14,2200,1805,395,0.94758068007029,0.644670050761421,1.78866825918185,729,355,374,6,1.1,56.24,4.6,0,0,0,0,0,0,0.0133425899705433,11.2437580358776,1.52827034250419
8.7,"max_tuv_SVM","SVM",39,22,1612,1601,11,2300,1902,398,0.946675978217888,0.654822335025381,1.79361388570493,742,362,380,13,1,58.79,4.8,0,0,0,0,0,0,0.0113248054339429,9.08564866476961,1.21208267972245
8.7,"max_tuv_SVM","SVM",39,23,1512,1502,10,2400,2001,399,0.946615376179933,0.644670050761421,1.79031376815993,752,368,384,10,1,61.35,5,0,0,0,0,0,0,0.00953263680983767,7.03861137229956,1.14900768695046
8.7,"max_tuv_SVM","SVM",39,24,1412,1403,9,2500,2100,400,0.94671060795387,0.649746192893401,1.79031376815993,755,369,386,3,1,63.91,5.2,0,0,0,0,0,0,0.00800280043055502,6.00957532853094,0.855760046695211
8.7,"max_tuv_SVM","SVM",39,25,1312,1303,9,2600,2200,400,0.946697621802879,0.639593908629442,1.7919623075413,764,373,391,9,1,66.46,5.5,0,0,0,0,0,0,0.00616268302349586,4.10231173346944,0.642233688447524
8.7,"max_tuv_SVM","SVM",39,26,1212,1204,8,2700,2299,401,0.947039590445653,0.639593908629442,1.79361388570493,777,377,400,13,1.1,69.02,5.7,0,0,0,0,0,0,0.00607709181913294,3.73349564536163,0.641447391245052
8.7,"max_tuv_SVM","SVM",39,27,1112,1105,7,2800,2398,402,0.94770044124055,0.644670050761421,1.79779411764706,777,379,398,0,1.1,71.57,6,0,0,0,0,0,0,0.00499474988367483,2.73045060105053,0.524861141684307
8.7,"max_tuv_SVM","SVM",39,28,1012,1006,6,2900,2497,403,0.948511354224681,0.644670050761421,1.79944802207912,782,381,401,5,1.1,74.13,6.2,0,0,0,0,0,0,0.00467051800801085,2.30855357624529,0.493320729478284
8.7,"max_tuv_SVM","SVM",39,29,912,908,4,3000,2595,405,0.949036571887001,0.644670050761421,1.79944802207912,792,387,405,10,1,76.69,6.4,0,0,0,0,0,0,0.00432306207721532,1.87508428234688,0.471667533260863
8.7,"max_tuv_SVM","SVM",39,30,812,809,3,3100,2694,406,0.949121703321278,0.639593908629442,1.79779411764706,797,390,407,5,1,79.24,6.6,0,0,0,0,0,0,0.00379453553586166,1.48331909544136,0.420861909829448
8.7,"max_tuv_SVM","SVM",39,31,712,709,3,3200,2794,406,0.949088516490967,0.639593908629442,1.79944802207912,797,389,408,0,1,81.8,6.9,0,0,0,0,0,0,0.00268422831621922,0.944747467435046,0.307867091192713
8.7,"max_tuv_SVM","SVM",39,32,612,609,3,3300,2894,406,0.949170762113912,0.639593908629442,1.79779411764706,799,389,410,2,1.1,84.36,7.1,0,0,0,0,0,0,0.0019536628500047,0.664341280856586,0.236518233763676
8.7,"max_tuv_SVM","SVM",39,33,512,509,3,3400,2994,406,0.949219820906546,0.639593908629442,1.80110497237569,801,390,411,2,1.1,86.91,7.4,0,0,0,0,0,0,0.00144743130237773,0.474130895582563,0.1774622181371
8.7,"max_tuv_SVM","SVM",39,34,412,411,1,3500,3092,408,0.950263041702857,0.639593908629442,1.79944802207912,810,395,415,9,1.1,89.47,7.6,0,0,0,0,0,0,0.0014596645220024,0.440466898854939,0.17993336285685
8.7,"max_tuv_SVM","SVM",39,35,312,312,0,3600,3191,409,0.950459276873395,0.639593908629442,1.80276497695853,820,398,422,10,1.1,92.02,7.8,0,0,0,0,0,0,0.00134946518269187,0.35288490474053,0.166043958338881
8.7,"max_tuv_SVM","SVM",39,36,212,212,0,3700,3291,409,0.950361159288126,0.639593908629442,1.79944802207912,823,398,425,3,1.1,94.58,8,0,0,0,0,0,0,0.000881360555332685,0.187582456379745,0.112231014105179
8.7,"max_tuv_SVM","SVM",39,37,112,112,0,3800,3391,409,0.950252941363197,0.639593908629442,1.80110497237569,827,401,426,4,1.1,97.14,8.3,0,0,0,0,0,0,0.000477115301380796,0.07095390106155,0.0657471442853759
8.7,"max_tuv_SVM","SVM",39,38,12,12,0,3900,3491,409,0.950065363626655,0.639593908629442,1.79779411764706,830,402,428,3,1.1,99.69,8.5,0,0,0,0,0,0,0.000352936811659253,0.00473161967602039,0.00473161967602039
8.7,"max_tuv_SVM","SVM",39,39,0,0,0,3912,3503,409,0.950032176796343,0.639593908629442,1.80276497695853,829,402,427,-1,1.1,100,8.6,0,0,0,0,0,0,0,0,0
8.7,"max_tuv_SVM","SVM",40,0,3812,3413,399,100,92,8,0.902326086894346,0.557788944723618,1.72123289257347,20,8,12,0,1.5,2.56,11.5,0,0,0,0,0,0,0.256292674406765,287.34660918553,28.3491076034404
8.7,"max_tuv_SVM","SVM",40,1,3712,3381,331,200,124,76,0.900487068238142,0.582914572864322,1.74680029984175,90,45,45,70,1,5.11,1.6,0,0,0,0,0,0,0.756598132857461,297.894195714676,84.1377476769896
8.7,"max_tuv_SVM","SVM",40,2,3612,3325,287,300,180,120,0.887173488386719,0.597989949748744,1.69685895039938,188,93,95,98,1,7.67,1.5,0,0,0,0,0,0,0.672345970178794,306.870273418742,77.3633487282347
8.7,"max_tuv_SVM","SVM",40,3,3512,3268,244,400,237,163,0.875288508564451,0.557788944723618,1.68938442211055,288,143,145,100,1,10.22,1.5,0,0,0,0,0,0,0.633975262400227,305.636957332734,77.1093320102753
8.7,"max_tuv_SVM","SVM",40,4,3412,3209,203,500,296,204,0.864250106537244,0.582914572864322,1.65324785693172,351,173,178,63,1,12.78,1.5,0,0,0,0,0,0,0.521625615094173,294.44809003552,75.4483430146517
8.7,"max_tuv_SVM","SVM",40,5,3312,3144,168,600,361,239,0.861681772550847,0.603015075376884,1.61252344672672,418,205,213,67,1,15.34,1.5,0,0,0,0,0,0,0.188106852507281,159.248539933766,67.2911058863666
8.7,"max_tuv_SVM","SVM",40,6,3212,3096,116,700,409,291,0.865963282548184,0.618090452261307,1.62008939726256,474,230,244,56,1.1,17.89,1.4,0,0,0,0,0,0,0.0987382752001821,106.9982508743,37.5928727106537
8.7,"max_tuv_SVM","SVM",40,7,3112,3024,88,800,481,319,0.860203121469616,0.628140703517588,1.58388628223993,512,250,262,38,1,20.45,1.5,0,0,0,0,0,0,0.0824294335545,121.911247077574,28.8572722911768
8.7,"max_tuv_SVM","SVM",40,8,3012,2932,80,900,573,327,0.868032536043908,0.638190954773869,1.60198783975124,534,257,277,22,1.1,23.01,1.8,0,0,0,0,0,0,0.061222195197194,99.4149658209491,23.5307236911027
8.7,"max_tuv_SVM","SVM",40,9,2912,2847,65,1000,658,342,0.881958168760703,0.633165829145729,1.61711129175288,553,269,284,19,1.1,25.56,1.9,0,0,0,0,0,0,0.0476395796412926,78.6511786459478,16.8074399398542
8.7,"max_tuv_SVM","SVM",40,10,2812,2759,53,1100,746,354,0.893898919755287,0.638190954773869,1.64421371563701,581,280,301,28,1.1,28.12,2.1,0,0,0,0,0,0,0.0457091194049226,75.0288296928384,13.6938621999239
8.7,"max_tuv_SVM","SVM",40,11,2712,2671,41,1200,834,366,0.90168543342781,0.628140703517588,1.65476878412301,619,300,319,38,1.1,30.67,2.3,0,0,0,0,0,0,0.0640868704097623,88.7657147892578,15.301358983084
8.7,"max_tuv_SVM","SVM",40,12,2612,2573,39,1300,932,368,0.908589618553779,0.613065326633166,1.69405553111178,639,306,333,20,1.1,33.23,2.5,0,0,0,0,0,0,0.0439694985180325,59.3652276125881,13.1613303353355
8.7,"max_tuv_SVM","SVM",40,13,2512,2475,37,1400,1030,370,0.910394316488525,0.608040201005025,1.70311465159901,637,306,331,-2,1.1,35.79,2.8,0,0,0,0,0,0,0.0367683743522237,49.5784107524355,10.458209298309
8.7,"max_tuv_SVM","SVM",40,14,2412,2380,32,1500,1125,375,0.912842527949925,0.608040201005025,1.71806595072881,647,310,337,10,1.1,38.34,3,0,0,0,0,0,0,0.0334088935034375,43.1755975285769,8.32705220071462
8.7,"max_tuv_SVM","SVM",40,15,2312,2283,29,1600,1222,378,0.914730167628103,0.608040201005025,1.72710840310106,654,313,341,7,1.1,40.9,3.2,0,0,0,0,0,0,0.0275932742557396,34.7857921755356,6.83910345984019
8.7,"max_tuv_SVM","SVM",40,16,2212,2190,22,1700,1315,385,0.917770411534041,0.613065326633166,1.74358926987881,679,323,356,25,1.1,43.46,3.4,0,0,0,0,0,0,0.0300321372901875,33.8942369519613,7.6070073348253
8.7,"max_tuv_SVM","SVM",40,17,2112,2094,18,1800,1411,389,0.917861933457834,0.613065326633166,1.74680029984175,693,329,364,14,1.1,46.01,3.6,0,0,0,0,0,0,0.0260554895061691,33.5394070495569,6.78566063118076
8.7,"max_tuv_SVM","SVM",40,18,2012,1999,13,1900,1506,394,0.918129349078909,0.613065326633166,1.74680029984175,699,333,366,6,1.1,48.57,3.8,0,0,0,0,0,0,0.0193694369134827,22.6863002545564,3.05499077876898
8.7,"max_tuv_SVM","SVM",40,19,1912,1900,12,2000,1605,395,0.917956315441736,0.613065326633166,1.74519330784558,701,335,366,2,1.1,51.12,4.1,0,0,0,0,0,0,0.0155753917433033,16.6767940903458,1.6614292286843
8.7,"max_tuv_SVM","SVM",40,20,1812,1800,12,2100,1705,395,0.917342832546328,0.608040201005025,1.75585107859741,704,345,359,3,1,53.68,4.3,0,0,0,0,0,0,0.0105171912965898,8.93401422310693,1.29064222722726
8.7,"max_tuv_SVM","SVM",40,21,1712,1703,9,2200,1802,398,0.917774701624216,0.608040201005025,1.75262341117351,712,350,362,8,1,56.24,4.5,0,0,0,0,0,0,0.00966669230832941,9.58941941652488,1.08467328144944
8.7,"max_tuv_SVM","SVM",40,22,1612,1606,6,2300,1899,401,0.918445385721996,0.608040201005025,1.75423576021783,719,354,365,7,1,58.79,4.7,0,0,0,0,0,0,0.0100341447683231,9.62531589563978,1.10367891907671
8.7,"max_tuv_SVM","SVM",40,23,1512,1506,6,2400,1999,401,0.917833332856651,0.592964824120603,1.75423576021783,741,361,380,22,1.1,61.35,5,0,0,0,0,0,0,0.00761703423162113,6.37715280931891,0.942226689696181
8.7,"max_tuv_SVM","SVM",40,24,1412,1408,4,2500,2097,403,0.917804732255465,0.597989949748744,1.74940758840072,748,363,385,7,1.1,63.91,5.2,0,0,0,0,0,0,0.00657089964234722,5.43462191195691,0.733040079921978
8.7,"max_tuv_SVM","SVM",40,25,1312,1308,4,2600,2197,403,0.918063567696189,0.592964824120603,1.75585107859741,758,369,389,10,1.1,66.46,5.5,0,0,0,0,0,0,0.00485559557048642,3.78043471027168,0.558349357683746
8.7,"max_tuv_SVM","SVM",40,26,1212,1208,4,2700,2297,403,0.918296662595844,0.592964824120603,1.75423576021783,758,369,389,0,1.1,69.02,5.7,0,0,0,0,0,0,0.00413060186468125,2.83802898951968,0.421456678421715
8.7,"max_tuv_SVM","SVM",40,27,1112,1110,2,2800,2395,405,0.919792474037813,0.592964824120603,1.75262341117351,777,381,396,19,1,71.57,5.9,0,0,0,0,0,0,0.00375400606541315,2.49195076236451,0.434979007781828
8.7,"max_tuv_SVM","SVM",40,28,1012,1011,1,2900,2494,406,0.92096223862626,0.597989949748744,1.75423576021783,777,381,396,0,1,74.13,6.1,0,0,0,0,0,0,0.00392092356238018,2.2577508119391,0.402518400258025
8.7,"max_tuv_SVM","SVM",40,29,912,911,1,3000,2594,406,0.92122250409704,0.603015075376884,1.75423576021783,776,383,393,-1,1,76.69,6.4,0,0,0,0,0,0,0.00334182876244434,1.77586624195945,0.365562439743326
8.7,"max_tuv_SVM","SVM",40,30,812,812,0,3100,2693,407,0.921451308906517,0.603015075376884,1.75262341117351,783,385,398,7,1,79.24,6.6,0,0,0,0,0,0,0.00335480705542583,1.65310297657531,0.361229728722993
8.7,"max_tuv_SVM","SVM",40,31,712,712,0,3200,2793,407,0.921515660259182,0.603015075376884,1.75262341117351,786,387,399,3,1,81.8,6.9,0,0,0,0,0,0,0.00280887098856196,1.26053439242148,0.302928551822953
8.7,"max_tuv_SVM","SVM",40,32,612,612,0,3300,2893,407,0.92187173774393,0.603015075376884,1.75262341117351,784,386,398,-2,1,84.36,7.1,0,0,0,0,0,0,0.00216135103054778,0.854303412238692,0.233989809906359
8.7,"max_tuv_SVM","SVM",40,33,512,512,0,3400,2993,407,0.92183455696239,0.603015075376884,1.75101402328447,784,386,398,0,1,86.91,7.4,0,0,0,0,0,0,0.00164237526525805,0.569492952913142,0.179940204008109
8.7,"max_tuv_SVM","SVM",40,34,412,412,0,3500,3093,407,0.922214944958146,0.603015075376884,1.75101402328447,788,386,402,4,1,89.47,7.6,0,0,0,0,0,0,0.00129343503276385,0.384200615182768,0.146703217470685
8.7,"max_tuv_SVM","SVM",40,35,312,312,0,3600,3193,407,0.922349367783714,0.603015075376884,1.75746937452238,790,389,401,2,1,92.02,7.8,0,0,0,0,0,0,0.000944760582157817,0.235847970921532,0.113306820519009
8.7,"max_tuv_SVM","SVM",40,36,212,212,0,3700,3293,407,0.922621073494966,0.597989949748744,1.75101402328447,791,390,401,1,1,94.58,8.1,0,0,0,0,0,0,0.000489927518542708,0.101513788260126,0.0624639050411048
8.7,"max_tuv_SVM","SVM",40,37,112,112,0,3800,3393,407,0.92317020503771,0.597989949748744,1.75585107859741,792,391,401,1,1,97.14,8.3,0,0,0,0,0,0,0.000237525529079867,0.0378228703678042,0.0353729241483077
8.7,"max_tuv_SVM","SVM",40,38,12,12,0,3900,3493,407,0.923913820668508,0.603015075376884,1.75423576021783,797,391,406,5,1,99.69,8.6,0,0,0,0,0,0,0.000155748438126524,0.00260067435985271,0.00260067435985271
8.7,"max_tuv_SVM","SVM",40,39,0,0,0,3912,3505,407,0.923968161810759,0.603015075376884,1.75423576021783,797,391,406,0,1,100,8.6,0,0,0,0,0,0,0,0,0
8.7,"max_tuv_SVM","SVM",41,0,3812,3423,389,100,90,10,0.880097115536009,0.516908212560386,1.69825686235223,28,10,18,0,1.8,2.56,9,0,0,0,0,0,0,0.367270340324376,346.0675698736,43.4052475384897
8.7,"max_tuv_SVM","SVM",41,1,3712,3376,336,200,137,63,0.913098720317759,0.550724637681159,1.75436913895993,115,57,58,87,1,5.11,2.2,0,0,0,0,0,0,0.597772074696151,294.645806110025,69.0342742608483
8.7,"max_tuv_SVM","SVM",41,2,3612,3329,283,300,184,116,0.898219272296391,0.541062801932367,1.72990413716785,200,101,99,85,1,7.67,1.6,0,0,0,0,0,0,0.637167002136154,303.775652688817,72.7033423726379
8.7,"max_tuv_SVM","SVM",41,3,3512,3268,244,400,245,155,0.899650041569663,0.565217391304348,1.74729010839566,270,133,137,70,1,10.22,1.6,0,0,0,0,0,0,0.480541486871077,207.78246571309,72.8040456898037
8.7,"max_tuv_SVM","SVM",41,4,3412,3210,202,500,303,197,0.905183914617902,0.57487922705314,1.74568414322251,361,178,183,91,1,12.78,1.5,0,0,0,0,0,0,0.291670094566599,202.93495636571,61.9737376868406
8.7,"max_tuv_SVM","SVM",41,5,3312,3165,147,600,348,252,0.902054452095469,0.603864734299517,1.74248105305146,412,205,207,51,1,15.34,1.4,0,0,0,0,0,0,0.170536757529494,115.480835693845,45.4795652484584
8.7,"max_tuv_SVM","SVM",41,6,3212,3082,130,700,431,269,0.907382548481814,0.608695652173913,1.70225916453538,435,213,222,23,1,17.89,1.6,0,0,0,0,0,0,0.083824562344441,79.9817288704716,34.6476202471495
8.7,"max_tuv_SVM","SVM",41,7,3112,3016,96,800,497,303,0.89196310935442,0.628019323671498,1.65166726664267,475,230,245,40,1.1,20.45,1.6,0,0,0,0,0,0,0.0664818384098918,82.9204899084237,20.5263121677473
8.7,"max_tuv_SVM","SVM",41,8,3012,2930,82,900,583,317,0.896155981471818,0.647342995169082,1.64297428102876,511,248,263,36,1.1,23.01,1.8,0,0,0,0,0,0,0.0541828114075152,80.4496834148421,16.4575477840746
8.7,"max_tuv_SVM","SVM",41,9,2912,2847,65,1000,666,334,0.895788621793555,0.652173913043478,1.64297428102876,557,269,288,46,1.1,25.56,2,0,0,0,0,0,0,0.0543340070464176,90.7151389065314,15.7375140691228
8.7,"max_tuv_SVM","SVM",41,10,2812,2753,59,1100,760,340,0.906479340851785,0.63768115942029,1.67059011930499,577,280,297,20,1.1,28.12,2.2,0,0,0,0,0,0,0.0405492662418555,62.467457849064,12.9230077747776
8.7,"max_tuv_SVM","SVM",41,11,2712,2663,49,1200,850,350,0.907708476617428,0.642512077294686,1.65883418584825,586,285,301,9,1.1,30.67,2.4,0,0,0,0,0,0,0.0356193222235967,54.8469105131161,6.60369942576866
8.7,"max_tuv_SVM","SVM",41,12,2612,2570,42,1300,943,357,0.91235295254984,0.628019323671498,1.69513219471221,605,294,311,19,1.1,33.23,2.6,0,0,0,0,0,0,0.028422717322593,42.0524586157827,4.06672193682119
8.7,"max_tuv_SVM","SVM",41,13,2512,2473,39,1400,1040,360,0.91389696803972,0.623188405797101,1.69513219471221,608,297,311,3,1,35.79,2.9,0,0,0,0,0,0,0.026690465032829,39.5404383042055,2.84831972425033
8.7,"max_tuv_SVM","SVM",41,14,2412,2376,36,1500,1137,363,0.92313067784766,0.623188405797101,1.73859712278176,623,303,320,15,1.1,38.34,3.1,0,0,0,0,0,0,0.0422856114524582,40.8829091355572,4.99481669102155
8.7,"max_tuv_SVM","SVM",41,15,2312,2278,34,1600,1235,365,0.924020074963469,0.623188405797101,1.75051091965538,640,309,331,17,1.1,40.9,3.4,0,0,0,0,0,0,0.0381587039072919,30.6956561493675,4.33552218339154
8.7,"max_tuv_SVM","SVM",41,16,2212,2182,30,1700,1331,369,0.925564090453346,0.628019323671498,1.75115011301689,653,315,338,13,1.1,43.46,3.6,0,0,0,0,0,0,0.0381842896723639,25.3168448554778,4.55129323939857
8.7,"max_tuv_SVM","SVM",41,17,2112,2093,19,1800,1420,380,0.926262902472909,0.623188405797101,1.74729010839566,681,326,355,28,1.1,46.01,3.7,0,0,0,0,0,0,0.0420843508364405,26.4135482238168,5.02283151240385
8.7,"max_tuv_SVM","SVM",41,18,2012,2000,12,1900,1513,387,0.926834657761645,0.623188405797101,1.74408112748034,697,333,364,16,1.1,48.57,3.9,0,0,0,0,0,0,0.0315241773565605,23.2686895163275,4.15501836234047
8.7,"max_tuv_SVM","SVM",41,19,1912,1901,11,2000,1612,388,0.926612308482691,0.623188405797101,1.74889903114741,698,335,363,1,1.1,51.12,4.2,0,0,0,0,0,0,0.0221400739473015,17.8472929340409,2.54085011968866
8.7,"max_tuv_SVM","SVM",41,20,1812,1802,10,2100,1711,389,0.927867684225347,0.623188405797101,1.75051091965538,702,337,365,4,1.1,53.68,4.4,0,0,0,0,0,0,0.0154034245353433,13.9835059865571,1.74167221658681
8.7,"max_tuv_SVM","SVM",41,21,1712,1703,9,2200,1810,390,0.928435296359812,0.623188405797101,1.74568414322251,709,342,367,7,1.1,56.24,4.6,0,0,0,0,0,0,0.0145508229755205,13.1966995168065,1.49887943811119
8.7,"max_tuv_SVM","SVM",41,22,1612,1603,9,2300,1910,390,0.927353933096342,0.613526570048309,1.76467607962348,726,355,371,17,1,58.79,4.9,0,0,0,0,0,0,0.00848877455651024,6.58328136361517,1.19051934944827
8.7,"max_tuv_SVM","SVM",41,23,1512,1505,7,2400,2008,392,0.927251735291109,0.613526570048309,1.76305413469736,734,357,377,8,1.1,61.35,5.1,0,0,0,0,0,0,0.0077539335047511,6.51012861027543,0.872894262192396
8.7,"max_tuv_SVM","SVM",41,24,1412,1406,6,2500,2107,393,0.927103962788947,0.608695652173913,1.76305413469736,739,361,378,5,1,63.91,5.4,0,0,0,0,0,0,0.00738207941361953,5.50133401971548,0.754404172928966
8.7,"max_tuv_SVM","SVM",41,25,1312,1307,5,2600,2206,394,0.928237806006462,0.613526570048309,1.76792893875643,760,370,390,21,1.1,66.46,5.6,0,0,0,0,0,0,0.00526888916962969,3.23611618483082,0.634132156967098
8.7,"max_tuv_SVM","SVM",41,26,1212,1208,4,2700,2305,395,0.928105225069945,0.613526570048309,1.76467607962348,764,371,393,4,1.1,69.02,5.8,0,0,0,0,0,0,0.00430888591953495,2.78511422321449,0.478080861535079
8.7,"max_tuv_SVM","SVM",41,27,1112,1109,3,2800,2404,396,0.9279146399737,0.613526570048309,1.76630101155684,766,373,393,2,1.1,71.57,6.1,0,0,0,0,0,0,0.00404435220088303,2.35064186363905,0.415248555753083
8.7,"max_tuv_SVM","SVM",41,28,1012,1009,3,2900,2504,396,0.928933855923188,0.613526570048309,1.75820613982651,773,375,398,7,1.1,74.13,6.3,0,0,0,0,0,0,0.00313020181973865,1.61292913894157,0.347555692843781
8.7,"max_tuv_SVM","SVM",41,29,912,909,3,3000,2604,396,0.928965620105896,0.613526570048309,1.76305413469736,774,375,399,1,1.1,76.69,6.6,0,0,0,0,0,0,0.00296267149229921,1.27836880723063,0.306236395245798
8.7,"max_tuv_SVM","SVM",41,30,812,809,3,3100,2704,396,0.929262546161644,0.608695652173913,1.76305413469736,780,380,400,6,1.1,79.24,6.8,0,0,0,0,0,0,0.00263938669117578,0.972533113651249,0.289178313326535
8.7,"max_tuv_SVM","SVM",41,31,712,710,2,3200,2803,397,0.929197636744807,0.599033816425121,1.76305413469736,784,381,403,4,1.1,81.8,7.1,0,0,0,0,0,0,0.00246147137214009,0.793274201914573,0.27391618295143
8.7,"max_tuv_SVM","SVM",41,32,612,610,2,3300,2903,397,0.92929016719009,0.599033816425121,1.76143516854979,785,382,403,1,1.1,84.36,7.3,0,0,0,0,0,0,0.00152283329166036,0.459035171911481,0.189634523828043
8.7,"max_tuv_SVM","SVM",41,33,512,511,1,3400,3002,398,0.92988540035301,0.603864734299517,1.75981917298232,789,385,404,4,1,86.91,7.5,0,0,0,0,0,0,0.000918652321903651,0.268793118702644,0.121674285840325
8.7,"max_tuv_SVM","SVM",41,34,412,411,1,3500,3102,398,0.929998646569622,0.599033816425121,1.76305413469736,793,386,407,4,1.1,89.47,7.8,0,0,0,0,0,0,0.000631504185494184,0.181828710897802,0.083312580000015
8.7,"max_tuv_SVM","SVM",41,35,312,312,0,3600,3201,399,0.93006079388362,0.603864734299517,1.76630101155684,794,389,405,1,1,92.02,8,0,0,0,0,0,0,0.000393443156843936,0.0999211377015091,0.051053232330309
8.7,"max_tuv_SVM","SVM",41,36,212,212,0,3700,3301,399,0.930243092671338,0.599033816425121,1.76467607962348,798,391,407,4,1,94.58,8.3,0,0,0,0,0,0,0.000208537006355239,0.0439565073048095,0.0280672222344686
8.7,"max_tuv_SVM","SVM",41,37,112,112,0,3800,3401,399,0.930361863093637,0.599033816425121,1.76467607962348,802,393,409,4,1,97.14,8.5,0,0,0,0,0,0,7.13414570448417e-05,0.0131693174821529,0.0124230055737569
8.7,"max_tuv_SVM","SVM",41,38,12,12,0,3900,3501,399,0.930400532533453,0.594202898550725,1.76630101155684,806,394,412,4,1,99.69,8.8,0,0,0,0,0,0,4.09683075870151e-05,0.000607452891327474,0.000607452891327474
8.7,"max_tuv_SVM","SVM",41,39,0,0,0,3912,3513,399,0.930392246224921,0.594202898550725,1.76630101155684,807,394,413,1,1,100,8.8,0,0,0,0,0,0,0,0,0
8.7,"max_tuv_SVM","SVM",42,0,3812,3415,397,100,91,9,0.83546412300684,0.32,1.74868202764977,33,9,24,0,2.7,2.56,10.1,0,0,0,0,0,0,0.160213703157086,336.610007476141,21.571556131723
8.7,"max_tuv_SVM","SVM",42,1,3712,3347,365,200,159,41,0.913556378132126,0.505,1.76920110192837,94,41,53,61,1.3,5.11,3.9,0,0,0,0,0,0,0.420989311514771,355.537049774873,54.4390092150025
8.7,"max_tuv_SVM","SVM",42,2,3612,3307,305,300,199,101,0.933263097949893,0.59,1.79209944751381,179,89,90,85,1,7.67,2,0,0,0,0,0,0,0.672722728217425,418.333606578918,74.6169510168403
8.7,"max_tuv_SVM","SVM",42,3,3512,3251,261,400,255,145,0.923910876993183,0.615,1.76508287292818,279,137,142,100,1,10.22,1.8,0,0,0,0,0,0,0.637655860809431,414.183183513859,71.5675848345204
8.7,"max_tuv_SVM","SVM",42,4,3412,3205,207,500,301,199,0.936449316628703,0.615,1.79944802207912,370,183,187,91,1,12.78,1.5,0,0,0,0,0,0,0.500630841109302,389.559447907666,66.6715868097675
8.7,"max_tuv_SVM","SVM",42,5,3312,3137,175,600,369,231,0.910501138952174,0.63,1.6704132231405,428,209,219,58,1,15.34,1.6,0,0,0,0,0,0,0.313452425665111,270.323657701776,67.0522871707174
8.7,"max_tuv_SVM","SVM",42,6,3212,3079,133,700,427,273,0.911876423690212,0.655,1.67657142857143,498,240,258,70,1.1,17.89,1.6,0,0,0,0,0,0,0.137332975915136,153.163823356671,49.7909247293357
8.7,"max_tuv_SVM","SVM",42,7,3112,3021,91,800,485,315,0.912941343963552,0.66,1.6704132231405,538,256,282,40,1.1,20.45,1.5,0,0,0,0,0,0,0.101933930084111,143.889265486096,29.5371823092331
8.7,"max_tuv_SVM","SVM",42,8,3012,2942,70,900,564,336,0.918433940774479,0.66,1.68248390064397,567,273,294,29,1.1,23.01,1.7,0,0,0,0,0,0,0.0772235808423267,118.257418640661,18.9924780923643
8.7,"max_tuv_SVM","SVM",42,9,2912,2854,58,1000,652,348,0.924975797266502,0.655,1.70204419889503,583,282,301,16,1.1,25.56,1.9,0,0,0,0,0,0,0.069065915062347,101.029288412632,13.9588073323383
8.7,"max_tuv_SVM","SVM",42,10,2812,2759,53,1100,747,353,0.934584282460148,0.65,1.75123966942149,618,297,321,35,1.1,28.12,2.1,0,0,0,0,0,0,0.0663030751930146,80.6656674877319,11.7665540131353
8.7,"max_tuv_SVM","SVM",42,11,2712,2666,46,1200,840,360,0.936847949886113,0.64,1.76183823529412,627,303,324,9,1.1,30.67,2.3,0,0,0,0,0,0,0.0520273512833485,56.6298403821565,7.55896241267586
8.7,"max_tuv_SVM","SVM",42,12,2612,2581,31,1300,925,375,0.942746298405477,0.64,1.78880514705882,663,319,344,36,1.1,33.23,2.5,0,0,0,0,0,0,0.067680781436752,70.8264896922011,9.32663845787332
8.7,"max_tuv_SVM","SVM",42,13,2512,2486,26,1400,1020,380,0.943261674259695,0.645,1.78880514705882,677,325,352,14,1.1,35.79,2.7,0,0,0,0,0,0,0.0611958353446979,55.9963814644732,8.60580945793837
8.7,"max_tuv_SVM","SVM",42,14,2412,2386,26,1500,1120,380,0.943154897494319,0.64,1.78716253443526,678,325,353,1,1.1,38.34,2.9,0,0,0,0,0,0,0.0477586643602994,45.2049045392137,7.16807871164757
8.7,"max_tuv_SVM","SVM",42,15,2312,2289,23,1600,1217,383,0.943443906605936,0.64,1.78552293577982,687,328,359,9,1.1,40.9,3.2,0,0,0,0,0,0,0.0355550619138772,37.267940396419,5.94704085474851
8.7,"max_tuv_SVM","SVM",42,16,2212,2194,18,1700,1312,388,0.942528473804117,0.645,1.78145354185833,697,334,363,10,1.1,43.46,3.4,0,0,0,0,0,0,0.0316627966047435,36.7735708373906,4.63192511614349
8.7,"max_tuv_SVM","SVM",42,17,2112,2097,15,1800,1409,391,0.942497152619608,0.64,1.77818181818182,710,341,369,13,1.1,46.01,3.6,0,0,0,0,0,0,0.0263502080685922,31.1108786891957,3.92239844646985
8.7,"max_tuv_SVM","SVM",42,18,2012,2000,12,1900,1506,394,0.942294988610496,0.64,1.78309392265193,719,343,376,9,1.1,48.57,3.8,0,0,0,0,0,0,0.0224161195231315,25.7238895142598,2.38745771078672
8.7,"max_tuv_SVM","SVM",42,19,1912,1900,12,2000,1606,394,0.941762528473822,0.635,1.7765504587156,715,344,371,-4,1.1,51.12,4.1,0,0,0,0,0,0,0.0199773995186713,21.5360931740749,2.07802661089138
8.7,"max_tuv_SVM","SVM",42,20,1812,1800,12,2100,1706,394,0.941604498861061,0.625,1.78880514705882,725,352,373,10,1.1,53.68,4.3,0,0,0,0,0,0,0.013133450378588,11.1740072098263,1.677271569534
8.7,"max_tuv_SVM","SVM",42,21,1712,1702,10,2200,1804,396,0.942041571754002,0.63,1.79045078196872,729,355,374,4,1.1,56.24,4.6,0,0,0,0,0,0,0.010317060091039,9.7935238331459,1.14221058566854
8.7,"max_tuv_SVM","SVM",42,22,1612,1603,9,2300,1903,397,0.9420130979499,0.63,1.77818181818182,730,355,375,1,1.1,58.79,4.8,0,0,0,0,0,0,0.0106138866389755,9.40106761277674,1.07125157730445
8.7,"max_tuv_SVM","SVM",42,23,1512,1503,9,2400,2003,397,0.942061503416864,0.625,1.78145354185833,751,367,384,21,1,61.35,5,0,0,0,0,0,0,0.00672934433448265,4.94058916557538,0.837279266793704
8.7,"max_tuv_SVM","SVM",42,24,1412,1406,6,2500,2100,400,0.942118451025064,0.625,1.79375115207373,762,373,389,11,1,63.91,5.2,0,0,0,0,0,0,0.00636129159844262,5.22575704808298,0.692802726814056
8.7,"max_tuv_SVM","SVM",42,25,1312,1306,6,2600,2200,400,0.942161161731214,0.625,1.79209944751381,762,376,386,0,1,66.46,5.5,0,0,0,0,0,0,0.00604865963849323,4.52875591909932,0.625983439264399
8.7,"max_tuv_SVM","SVM",42,26,1212,1206,6,2700,2300,400,0.9416742596811,0.625,1.79209944751381,765,377,388,3,1,69.02,5.8,0,0,0,0,0,0,0.00439331956862225,3.02253069477167,0.487322662850685
8.7,"max_tuv_SVM","SVM",42,27,1112,1107,5,2800,2399,401,0.942010250569483,0.625,1.80276497695853,768,378,390,3,1,71.57,6,0,0,0,0,0,0,0.00419007419536672,2.54653609063709,0.434050732391829
8.7,"max_tuv_SVM","SVM",42,28,1012,1008,4,2900,2498,402,0.941810933940783,0.63,1.79614325068871,779,382,397,11,1,74.13,6.2,0,0,0,0,0,0,0.00350054429935109,1.8953491264109,0.369925050074589
8.7,"max_tuv_SVM","SVM",42,29,912,908,4,3000,2598,402,0.941892084282468,0.63,1.79779411764706,780,383,397,1,1,76.69,6.5,0,0,0,0,0,0,0.00290527638835232,1.37341810980847,0.304864059677666
8.7,"max_tuv_SVM","SVM",42,30,812,809,3,3100,2697,403,0.942033029612763,0.63,1.79779411764706,785,385,400,5,1,79.24,6.7,0,0,0,0,0,0,0.00270689438973813,1.17406097990094,0.291469664285189
8.7,"max_tuv_SVM","SVM",42,31,712,709,3,3200,2797,403,0.941983200455588,0.63,1.79779411764706,787,385,402,2,1,81.8,6.9,0,0,0,0,0,0,0.00237345170909744,0.911113643182386,0.257331182854086
8.7,"max_tuv_SVM","SVM",42,32,612,609,3,3300,2897,403,0.942088553530758,0.63,1.79779411764706,786,385,401,-1,1,84.36,7.2,0,0,0,0,0,0,0.00166658134326254,0.583413577670367,0.187598408264995
8.7,"max_tuv_SVM","SVM",42,33,512,511,1,3400,2995,405,0.942297835990894,0.625,1.79779411764706,795,388,407,9,1,86.91,7.4,0,0,0,0,0,0,0.0019433377000231,0.729253318114835,0.241102911442101
8.7,"max_tuv_SVM","SVM",42,34,412,412,0,3500,3094,406,0.942468678815494,0.63,1.80110497237569,802,392,410,7,1,89.47,7.6,0,0,0,0,0,0,0.00177535136029088,0.559212062505315,0.200043383553489
8.7,"max_tuv_SVM","SVM",42,35,312,312,0,3600,3194,406,0.942359054669708,0.63,1.79779411764706,803,392,411,1,1,92.02,7.9,0,0,0,0,0,0,0.00122711968457255,0.308520428973589,0.140009627949826
8.7,"max_tuv_SVM","SVM",42,36,212,212,0,3700,3294,406,0.942257972665152,0.63,1.80276497695853,807,394,413,4,1,94.58,8.1,0,0,0,0,0,0,0.000780284193722239,0.163254969416267,0.0997037625295332
8.7,"max_tuv_SVM","SVM",42,37,112,112,0,3800,3394,406,0.942400341685654,0.63,1.79779411764706,813,395,418,6,1.1,97.14,8.4,0,0,0,0,0,0,0.000336440782927371,0.0535185888552367,0.0497700584602193
8.7,"max_tuv_SVM","SVM",42,38,12,12,0,3900,3494,406,0.942421697038729,0.63,1.79449541284404,814,396,418,1,1.1,99.69,8.6,0,0,0,0,0,0,0.000341377603324191,0.00465282229370645,0.00465282229370645
8.7,"max_tuv_SVM","SVM",42,39,0,0,0,3912,3506,406,0.942290717539868,0.63,1.79449541284404,814,396,418,0,1.1,100,8.6,0,0,0,0,0,0,0,0,0
8.7,"max_tuv_SVM","SVM",43,0,3812,3422,390,100,93,7,0.917403176463824,0.583732057416268,1.7789552769979,19,7,12,0,1.7,2.56,13.3,0,0,0,0,0,0,0.820616908890698,611.355629772365,85.1710831185143
8.7,"max_tuv_SVM","SVM",43,1,3712,3352,360,200,163,37,0.888237662376793,0.516746411483254,1.71722049075984,80,37,43,61,1.2,5.11,4.4,0,0,0,0,0,0,0.521497410982146,395.583462670092,60.0331435190214
8.7,"max_tuv_SVM","SVM",43,2,3612,3296,316,300,219,81,0.890124697704603,0.578947368421053,1.74238528873503,168,81,87,88,1.1,7.67,2.7,0,0,0,0,0,0,0.550045522929013,359.445889810096,64.3428051662355
8.7,"max_tuv_SVM","SVM",43,3,3512,3262,250,400,253,147,0.886273940562495,0.61244019138756,1.70474023144337,247,121,126,79,1,10.22,1.7,0,0,0,0,0,0,0.437071852841191,199.414352459196,69.8687137984309
8.7,"max_tuv_SVM","SVM",43,4,3412,3214,198,500,301,199,0.88367755523481,0.631578947368421,1.6561285912729,343,170,173,96,1,12.78,1.5,0,0,0,0,0,0,0.267434416970094,181.985914300051,60.0525686293725
8.7,"max_tuv_SVM","SVM",43,5,3312,3158,154,600,357,243,0.889209937473139,0.626794258373206,1.66322133812683,411,203,208,68,1,15.34,1.5,0,0,0,0,0,0,0.137473403906092,115.789256030076,48.3091654131765
8.7,"max_tuv_SVM","SVM",43,6,3212,3084,128,700,431,269,0.885489273477705,0.641148325358852,1.62875042956462,468,222,246,57,1.1,17.89,1.6,0,0,0,0,0,0,0.0938373220699998,106.412780715868,37.7941793407157
8.7,"max_tuv_SVM","SVM",43,7,3112,3010,102,800,505,295,0.882831265080535,0.650717703349282,1.62725203910504,500,239,261,32,1.1,20.45,1.7,0,0,0,0,0,0,0.0701824754907552,105.987481966068,28.3060496491992
8.7,"max_tuv_SVM","SVM",43,8,3012,2933,79,900,582,318,0.883088712570829,0.655502392344498,1.62162591228805,545,261,284,45,1.1,23.01,1.8,0,0,0,0,0,0,0.07419759554397,136.74609161632,23.7190493694597
8.7,"max_tuv_SVM","SVM",43,9,2912,2844,68,1000,671,329,0.893572850792755,0.655502392344498,1.63736815670517,572,273,299,27,1.1,25.56,2,0,0,0,0,0,0,0.0635711834894058,116.428926356667,20.1797709075714
8.7,"max_tuv_SVM","SVM",43,10,2812,2752,60,1100,763,337,0.908050163917367,0.650717703349282,1.68045679240794,590,285,305,18,1.1,28.12,2.3,0,0,0,0,0,0,0.051269208421785,69.4397983053451,14.8226876212182
8.7,"max_tuv_SVM","SVM",43,11,2712,2667,45,1200,848,352,0.917055348471597,0.655502392344498,1.69146218339845,610,294,316,20,1.1,30.67,2.4,0,0,0,0,0,0,0.0458872219000328,67.0549873970139,7.15493221039241
8.7,"max_tuv_SVM","SVM",43,12,2612,2579,33,1300,936,364,0.931130057542252,0.645933014354067,1.75101095848125,644,308,336,34,1.1,33.23,2.6,0,0,0,0,0,0,0.0738687005970109,78.3221003894574,8.66143119545195
8.7,"max_tuv_SVM","SVM",43,13,2512,2482,30,1400,1033,367,0.932562451557417,0.636363636363636,1.75963662822746,658,317,341,14,1.1,35.79,2.8,0,0,0,0,0,0,0.0607517291945983,60.0681305584838,6.55922367613895
8.7,"max_tuv_SVM","SVM",43,14,2412,2385,27,1500,1130,370,0.934164651364049,0.636363636363636,1.76826229797367,667,323,344,9,1.1,38.34,3.1,0,0,0,0,0,0,0.0530316033291913,47.982871259513,5.8048160380479
8.7,"max_tuv_SVM","SVM",43,15,2312,2287,25,1600,1228,372,0.935279344220971,0.626794258373206,1.77525179095403,673,324,349,6,1.1,40.9,3.3,0,0,0,0,0,0,0.0450496095404175,39.1771025473212,4.98512935874842
8.7,"max_tuv_SVM","SVM",43,16,2212,2191,21,1700,1324,376,0.936647376363564,0.631578947368421,1.77198846045595,688,330,358,15,1.1,43.46,3.5,0,0,0,0,0,0,0.0446561439388541,36.2794773430256,5.31701274887035
8.7,"max_tuv_SVM","SVM",43,17,2112,2102,10,1800,1413,387,0.938437184181758,0.641148325358852,1.7617673033071,721,342,379,33,1.1,46.01,3.7,0,0,0,0,0,0,0.0388835003422527,34.5556302766182,5.6825001590605
8.7,"max_tuv_SVM","SVM",43,18,2012,2003,9,1900,1512,388,0.93896988138243,0.641148325358852,1.76338657472558,716,341,375,-5,1.1,48.57,3.9,0,0,0,0,0,0,0.0270630498453472,26.8884490636334,3.06738531228231
8.7,"max_tuv_SVM","SVM",43,19,1912,1903,9,2000,1612,388,0.938772687560073,0.641148325358852,1.76015100302884,722,343,379,6,1.1,51.12,4.2,0,0,0,0,0,0,0.022625856355734,23.0100825606205,2.43962888119452
8.7,"max_tuv_SVM","SVM",43,20,1812,1803,9,2100,1712,388,0.938538519896025,0.636363636363636,1.76015100302884,726,346,380,4,1.1,53.68,4.4,0,0,0,0,0,0,0.021971312431675,20.9593639174591,2.23219347669209
8.7,"max_tuv_SVM","SVM",43,21,1712,1703,9,2200,1812,388,0.936133850784506,0.62200956937799,1.76711589823655,731,355,376,5,1.1,56.24,4.7,0,0,0,0,0,0,0.0143004615224257,11.0895150657752,1.7821530352189
8.7,"max_tuv_SVM","SVM",43,22,1612,1605,7,2300,1910,390,0.936244772309581,0.62200956937799,1.77525179095403,738,358,380,7,1.1,58.79,4.9,0,0,0,0,0,0,0.0131002255765055,10.5780818679157,1.41310147313337
8.7,"max_tuv_SVM","SVM",43,23,1512,1507,5,2400,2008,392,0.936693936016063,0.62200956937799,1.77198846045595,743,358,385,5,1.1,61.35,5.1,0,0,0,0,0,0,0.0113026658039017,8.85538809420568,1.18013793881756
8.7,"max_tuv_SVM","SVM",43,24,1412,1407,5,2500,2108,392,0.936429641518052,0.62200956937799,1.7703612901525,754,364,390,11,1.1,63.91,5.4,0,0,0,0,0,0,0.00829257616332308,6.05709760006521,0.925877994209104
8.7,"max_tuv_SVM","SVM",43,25,1312,1307,5,2600,2208,392,0.936307764780624,0.62200956937799,1.76873710548264,754,364,390,0,1.1,66.46,5.6,0,0,0,0,0,0,0.0078190620293415,5.01374955175138,0.796496791934934
8.7,"max_tuv_SVM","SVM",43,26,1212,1207,5,2700,2308,392,0.935613478197748,0.617224880382775,1.76873710548264,754,370,384,0,1,69.02,5.9,0,0,0,0,0,0,0.0051463711623862,2.91691484683797,0.58365108667124
8.7,"max_tuv_SVM","SVM",43,27,1112,1107,5,2800,2408,392,0.935742201942897,0.617224880382775,1.7703612901525,754,370,384,0,1,71.57,6.1,0,0,0,0,0,0,0.00482907066864488,2.47980241541617,0.497625450357826
8.7,"max_tuv_SVM","SVM",43,28,1012,1007,5,2900,2508,392,0.935807933217008,0.61244019138756,1.77198846045595,757,370,387,3,1,74.13,6.4,0,0,0,0,0,0,0.00340763524749175,1.49192853544625,0.363101351545785
8.7,"max_tuv_SVM","SVM",43,29,912,908,4,3000,2607,393,0.935859970475681,0.61244019138756,1.7654976602345,760,372,388,3,1,76.69,6.6,0,0,0,0,0,0,0.00391254407716756,1.46197804230725,0.408228052887194
8.7,"max_tuv_SVM","SVM",43,30,812,808,4,3100,2707,393,0.93564771323634,0.617224880382775,1.76873710548264,764,373,391,4,1,79.24,6.9,0,0,0,0,0,0,0.00279746065829581,0.884145963471425,0.31325222943693
8.7,"max_tuv_SVM","SVM",43,31,712,709,3,3200,2806,394,0.935801086209284,0.617224880382775,1.78059034618632,767,375,392,3,1,81.8,7.1,0,0,0,0,0,0,0.00214425503108006,0.653490703287605,0.266199673951966
8.7,"max_tuv_SVM","SVM",43,32,612,610,2,3300,2905,395,0.935731246730532,0.61244019138756,1.77406803722593,774,380,394,7,1,84.36,7.4,0,0,0,0,0,0,0.00126504498757909,0.39442610312367,0.1703712965349
8.7,"max_tuv_SVM","SVM",43,33,512,511,1,3400,3004,396,0.935609369993102,0.61244019138756,1.77732320793644,777,382,395,3,1,86.91,7.6,0,0,0,0,0,0,0.00112809264253394,0.353410201512389,0.142632297839118
8.7,"max_tuv_SVM","SVM",43,34,412,412,0,3500,3103,397,0.93587366449112,0.617224880382775,1.7789552769979,784,384,400,7,1,89.47,7.8,0,0,0,0,0,0,0.000706561308159796,0.212431110498644,0.0905570041688343
8.7,"max_tuv_SVM","SVM",43,35,312,312,0,3600,3203,397,0.93564908263788,0.617224880382775,1.78222842378171,790,384,406,6,1.1,92.02,8.1,0,0,0,0,0,0,0.000463861358313403,0.121387697772785,0.059665183790824
8.7,"max_tuv_SVM","SVM",43,36,212,212,0,3700,3303,397,0.935801086209279,0.61244019138756,1.78059034618632,796,388,408,6,1.1,94.58,8.3,0,0,0,0,0,0,0.000256354062718325,0.0541782884472325,0.0333032243939632
8.7,"max_tuv_SVM","SVM",43,37,112,112,0,3800,3403,397,0.935773698178397,0.61244019138756,1.78059034618632,797,388,409,1,1.1,97.14,8.6,0,0,0,0,0,0,0.000120943415438771,0.0182589170695633,0.0170632998315237
8.7,"max_tuv_SVM","SVM",43,38,12,12,0,3900,3503,397,0.935892836112736,0.61244019138756,1.7855136374661,799,389,410,2,1.1,99.69,8.8,0,0,0,0,0,0,6.35222381240246e-05,0.000969587829368209,0.000969587829368209
8.7,"max_tuv_SVM","SVM",43,39,0,0,0,3912,3515,397,0.935805194413912,0.61244019138756,1.78059034618632,799,389,410,0,1.1,100,8.9,0,0,0,0,0,0,0,0,0
8.7,"max_tuv_SVM","SVM",44,0,3812,3403,409,100,85,15,0.910045281663098,0.5,1.7748656453036,37,15,22,0,1.5,2.56,5.7,0,0,0,0,0,0,0.714286760749304,670.433591407082,74.8602076343814
8.7,"max_tuv_SVM","SVM",44,1,3712,3328,384,200,160,40,0.832700979967052,0.445054945054945,1.6823507983729,102,40,62,65,1.6,5.11,4,0,0,0,0,0,0,0.367671382782762,589.327789256331,44.5625890870121
8.7,"max_tuv_SVM","SVM",44,2,3612,3283,329,300,205,95,0.898261828363283,0.554945054945055,1.68449149384071,203,94,109,101,1.2,7.67,2.2,0,0,0,0,0,0,0.564518424288313,546.526335300344,64.2417113541529
8.7,"max_tuv_SVM","SVM",44,3,3512,3233,279,400,255,145,0.865675756036527,0.604395604395604,1.59475363346331,287,136,151,84,1.1,10.22,1.8,0,0,0,0,0,0,0.697977197888824,445.937799333959,78.8779033674845
8.7,"max_tuv_SVM","SVM",44,4,3412,3185,227,500,303,197,0.874890047945291,0.615384615384615,1.6130775302046,377,183,194,90,1.1,12.78,1.5,0,0,0,0,0,0,0.643273922528676,373.933516299286,77.6406433436737
8.7,"max_tuv_SVM","SVM",44,5,3312,3140,172,600,348,252,0.867543392346098,0.615384615384615,1.59876487149214,447,219,228,70,1,15.34,1.4,0,0,0,0,0,0,0.327915492324834,330.925240183626,77.4394021389501
8.7,"max_tuv_SVM","SVM",44,6,3212,3074,138,700,414,286,0.870885315361076,0.631868131868132,1.60023432449903,526,251,275,79,1.1,17.89,1.4,0,0,0,0,0,0,0.16036634291362,221.464757367423,68.6444448897864
8.7,"max_tuv_SVM","SVM",44,7,3112,2995,117,800,493,307,0.873782784295748,0.626373626373626,1.6031813490377,558,267,291,32,1.1,20.45,1.6,0,0,0,0,0,0,0.102834630373256,184.327963704739,54.6457854972867
8.7,"max_tuv_SVM","SVM",44,8,3012,2925,87,900,563,337,0.877851010320003,0.626373626373626,1.62148063528008,577,276,301,19,1.1,23.01,1.7,0,0,0,0,0,0,0.0788561869837137,146.831216557952,34.0498215634695
8.7,"max_tuv_SVM","SVM",44,9,2912,2837,75,1000,651,349,0.885253416256797,0.615384615384615,1.6625584360391,599,284,315,22,1.1,25.56,1.9,0,0,0,0,0,0,0.0664614237361734,112.676642564281,26.526956598287
8.7,"max_tuv_SVM","SVM",44,10,2812,2747,65,1100,741,359,0.891280647199481,0.615384615384615,1.6526622548722,611,287,324,12,1.1,28.12,2.1,0,0,0,0,0,0,0.0598922735751967,96.6134661226852,20.8616495247947
8.7,"max_tuv_SVM","SVM",44,11,2712,2648,64,1200,840,360,0.899101180668275,0.60989010989011,1.69069017459082,627,301,326,16,1.1,30.67,2.3,0,0,0,0,0,0,0.0518823357533276,71.8918724213071,19.9558990972723
8.7,"max_tuv_SVM","SVM",44,12,2612,2563,49,1300,925,375,0.900355563264257,0.615384615384615,1.68913623141564,637,305,332,10,1.1,33.23,2.5,0,0,0,0,0,0,0.0428455127578804,56.7539938504808,9.22018360026088
8.7,"max_tuv_SVM","SVM",44,13,2512,2470,42,1400,1018,382,0.900389632915004,0.615384615384615,1.69069017459082,640,308,332,3,1.1,35.79,2.7,0,0,0,0,0,0,0.0392240070259979,43.1799575078756,3.93245547373216
8.7,"max_tuv_SVM","SVM",44,14,2412,2371,41,1500,1117,383,0.925760682384139,0.593406593406593,1.74840416936005,675,333,342,35,1,38.34,2.9,0,0,0,0,0,0,0.0444223248201758,27.3519711048358,5.80585884046027
8.7,"max_tuv_SVM","SVM",44,15,2312,2275,37,1600,1213,387,0.92727678184274,0.593406593406593,1.75666757484939,684,334,350,9,1,40.9,3.1,0,0,0,0,0,0,0.027613919430842,20.0414255499366,3.31323125716082
8.7,"max_tuv_SVM","SVM",44,16,2212,2181,31,1700,1307,393,0.930270265247727,0.604395604395604,1.74840416936005,699,341,358,15,1,43.46,3.3,0,0,0,0,0,0,0.0242374648062993,20.3087191271483,2.82050873836801
8.7,"max_tuv_SVM","SVM",44,17,2112,2088,24,1800,1400,400,0.933285429339555,0.598901098901099,1.78131261004189,714,350,364,15,1,46.01,3.5,0,0,0,0,0,0,0.0435894411502222,29.4029067615621,5.55392010724266
8.7,"max_tuv_SVM","SVM",44,18,2012,1990,22,1900,1498,402,0.933197157971691,0.60989010989011,1.77803813833226,732,358,374,18,1,48.57,3.7,0,0,0,0,0,0,0.0356992337230402,22.0987977357895,4.07057880001933
8.7,"max_tuv_SVM","SVM",44,19,1912,1893,19,2000,1595,405,0.933163088320935,0.615384615384615,1.77803813833226,741,362,379,9,1,51.12,3.9,0,0,0,0,0,0,0.0304111483998847,18.6523904725664,3.47878918645074
8.7,"max_tuv_SVM","SVM",44,20,1812,1799,13,2100,1689,411,0.933046941784264,0.615384615384615,1.78295437281612,754,368,386,13,1,53.68,4.1,0,0,0,0,0,0,0.0293483054706777,16.3642725420059,3.58480540362423
8.7,"max_tuv_SVM","SVM",44,21,1712,1702,10,2200,1786,414,0.93322967900195,0.615384615384615,1.77477568303256,761,374,387,7,1,56.24,4.3,0,0,0,0,0,0,0.0190731563250194,11.80475353814,2.64913066009444
8.7,"max_tuv_SVM","SVM",44,22,1612,1606,6,2300,1882,418,0.93325290830928,0.60989010989011,1.77803813833226,772,379,393,11,1,58.79,4.5,0,0,0,0,0,0,0.0153542951616359,11.2534634593767,2.0567559984507
8.7,"max_tuv_SVM","SVM",44,23,1512,1507,5,2400,1981,419,0.933164636941413,0.615384615384615,1.77803813833226,775,380,395,3,1,61.35,4.7,0,0,0,0,0,0,0.0120023823975207,9.30749267402766,1.35440567668477
8.7,"max_tuv_SVM","SVM",44,24,1412,1407,5,2500,2081,419,0.933099594880882,0.615384615384615,1.77803813833226,776,380,396,1,1,63.91,5,0,0,0,0,0,0,0.0105376419706197,7.40338590175559,1.08179478431916
8.7,"max_tuv_SVM","SVM",44,25,1312,1307,5,2600,2181,419,0.932839426638751,0.615384615384615,1.77803813833226,785,385,400,9,1,66.46,5.2,0,0,0,0,0,0,0.00839551434516518,5.57940476394828,0.976238073099943
8.7,"max_tuv_SVM","SVM",44,26,1212,1207,5,2700,2281,419,0.932946281452484,0.615384615384615,1.77803813833226,782,385,397,-3,1,69.02,5.4,0,0,0,0,0,0,0.00688795104076822,4.19006073444773,0.715726331824781
8.7,"max_tuv_SVM","SVM",44,27,1112,1107,5,2800,2381,419,0.932704696656221,0.615384615384615,1.77803813833226,785,385,400,3,1,71.57,5.7,0,0,0,0,0,0,0.00584775784326671,3.22853502691199,0.618800461452387
8.7,"max_tuv_SVM","SVM",44,28,1012,1007,5,2900,2481,419,0.932721731481599,0.615384615384615,1.77967386799034,787,385,402,2,1,74.13,5.9,0,0,0,0,0,0,0.00551456012250186,2.67090324406328,0.572976565947834
8.7,"max_tuv_SVM","SVM",44,29,912,907,5,3000,2581,419,0.932638105975201,0.615384615384615,1.78131261004189,792,389,403,5,1,76.69,6.2,0,0,0,0,0,0,0.00464161259912866,1.97052695392234,0.492523729471025
8.7,"max_tuv_SVM","SVM",44,30,812,809,3,3100,2679,421,0.932718634240623,0.615384615384615,1.78131261004189,799,392,407,7,1,79.24,6.4,0,0,0,0,0,0,0.00411104355142167,1.62736367493429,0.453995675684956
8.7,"max_tuv_SVM","SVM",44,31,712,709,3,3200,2779,421,0.932827037674845,0.60989010989011,1.77967386799034,800,394,406,1,1,81.8,6.6,0,0,0,0,0,0,0.00308683590011396,1.06939567849344,0.346103140606843
8.7,"max_tuv_SVM","SVM",44,32,612,610,2,3300,2878,422,0.933022163856446,0.604395604395604,1.77967386799034,805,395,410,5,1,84.36,6.8,0,0,0,0,0,0,0.00264854622179776,0.86477552308933,0.306279055928741
8.7,"max_tuv_SVM","SVM",44,33,512,510,2,3400,2978,422,0.933257554170755,0.604395604395604,1.78295437281612,805,395,410,0,1,86.91,7.1,0,0,0,0,0,0,0.00163079966260408,0.520045460130761,0.203182716052438
8.7,"max_tuv_SVM","SVM",44,34,412,411,1,3500,3077,423,0.933387638291824,0.598901098901099,1.77803813833226,809,397,412,4,1,89.47,7.3,0,0,0,0,0,0,0.00131238963811866,0.374583994339308,0.15887709997102
8.7,"max_tuv_SVM","SVM",44,35,312,312,0,3600,3176,424,0.933753112727204,0.598901098901099,1.77967386799034,815,400,415,6,1,92.02,7.5,0,0,0,0,0,0,0.00106843522019686,0.266295795720115,0.134914022594746
8.7,"max_tuv_SVM","SVM",44,36,212,212,0,3700,3276,424,0.934313713344174,0.598901098901099,1.77640541276905,816,401,415,1,1,94.58,7.7,0,0,0,0,0,0,0.000466871185066903,0.103782704114477,0.066743206739365
8.7,"max_tuv_SVM","SVM",44,37,112,112,0,3800,3376,424,0.934741132599102,0.598901098901099,1.77967386799034,822,403,419,6,1,97.14,8,0,0,0,0,0,0,0.000307926308065838,0.0483388716488654,0.0449601388306986
8.7,"max_tuv_SVM","SVM",44,38,12,12,0,3900,3476,424,0.935075634624696,0.598901098901099,1.77803813833226,826,404,422,4,1,99.69,8.2,0,0,0,0,0,0,0.000217781364876666,0.00310725521339324,0.00310725521339324
8.7,"max_tuv_SVM","SVM",44,39,0,0,0,3912,3488,424,0.935106607034474,0.598901098901099,1.77314894088496,826,404,422,0,1,100,8.2,0,0,0,0,0,0,0,0,0
8.7,"max_tuv_SVM","SVM",45,0,3812,3420,392,100,90,10,0.914674545617339,0.622549019607843,1.7585795608566,22,10,12,0,1.2,2.56,9,0,0,0,0,0,0,0.417457345513292,305.371835393403,45.7179714656499
8.7,"max_tuv_SVM","SVM",45,1,3712,3402,310,200,108,92,0.907832225355905,0.607843137254902,1.71281551294551,81,42,39,59,0.9,5.11,1.2,0,0,0,0,0,0,0.660883223269667,218.849188965961,75.2265848286104
8.7,"max_tuv_SVM","SVM",45,2,3612,3347,265,300,163,137,0.909807558868305,0.598039215686274,1.74171613599568,172,88,84,91,1,7.67,1.2,0,0,0,0,0,0,0.567246793953229,184.340624858795,71.4499685992962
8.7,"max_tuv_SVM","SVM",45,3,3512,3298,214,400,212,188,0.886200085056859,0.647058823529412,1.66713566751448,268,135,133,96,1,10.22,1.1,0,0,0,0,0,0,0.302142823455068,134.512602190202,63.2282857435557
8.7,"max_tuv_SVM","SVM",45,4,3412,3243,169,500,267,233,0.863731365834012,0.661764705882353,1.59510164359862,363,182,181,95,1,12.78,1.1,0,0,0,0,0,0,0.208488358184409,163.178724109584,43.9737349646957
8.7,"max_tuv_SVM","SVM",45,5,3312,3176,136,600,334,266,0.86116427164474,0.67156862745098,1.59656907841333,429,207,222,66,1.1,15.34,1.3,0,0,0,0,0,0,0.107078386229196,93.2021613552294,28.0310413872227
8.7,"max_tuv_SVM","SVM",45,6,3212,3103,109,700,407,293,0.865642347121506,0.686274509803922,1.57747621107266,464,221,243,35,1.1,17.89,1.4,0,0,0,0,0,0,0.0751273890555266,70.0746181503738,12.6164672864048
8.7,"max_tuv_SVM","SVM",45,7,3112,3029,83,800,481,319,0.863504734085423,0.686274509803922,1.5627234319142,518,248,270,54,1.1,20.45,1.5,0,0,0,0,0,0,0.0788944257508242,114.412576323048,14.0737557723598
8.7,"max_tuv_SVM","SVM",45,8,3012,2945,67,900,565,335,0.872078968573739,0.696078431372549,1.58038132380024,554,266,288,36,1.1,23.01,1.7,0,0,0,0,0,0,0.0638354829012171,96.1559657327015,10.366900265624
8.7,"max_tuv_SVM","SVM",45,9,2912,2855,57,1000,655,345,0.874289327603194,0.686274509803922,1.57300081322852,585,278,307,31,1.1,25.56,1.9,0,0,0,0,0,0,0.060650166771013,92.5698963775678,8.4129436755022
8.7,"max_tuv_SVM","SVM",45,10,2812,2756,56,1100,754,346,0.875761035007617,0.681372549019608,1.58774825477569,589,283,306,4,1.1,28.12,2.2,0,0,0,0,0,0,0.0472967207391022,68.0310115062045,7.02496005496129
8.7,"max_tuv_SVM","SVM",45,11,2712,2661,51,1200,849,351,0.875947096875285,0.676470588235294,1.59803921568627,594,288,306,5,1.1,30.67,2.4,0,0,0,0,0,0,0.0388711337975616,52.2327026806168,4.21193241435764
8.7,"max_tuv_SVM","SVM",45,12,2612,2564,48,1300,946,354,0.880327245053275,0.681372549019608,1.60834914611006,607,294,313,13,1.1,33.23,2.7,0,0,0,0,0,0,0.035525177699457,45.5811710141309,3.70776572655709
8.7,"max_tuv_SVM","SVM",45,13,2512,2466,46,1400,1044,356,0.901174568000721,0.661764705882353,1.64646464646465,627,307,320,20,1,35.79,2.9,0,0,0,0,0,0,0.0338650880013505,27.8099762121357,4.07353294068352
8.7,"max_tuv_SVM","SVM",45,14,2412,2374,38,1500,1136,364,0.903675911003676,0.661764705882353,1.64646464646465,646,316,330,19,1,38.34,3.1,0,0,0,0,0,0,0.0267344176174555,25.7501771386439,3.05602641672518
8.7,"max_tuv_SVM","SVM",45,15,2312,2277,35,1600,1233,367,0.908906627719591,0.661764705882353,1.6598418372874,655,320,335,9,1,40.9,3.4,0,0,0,0,0,0,0.0225637548766818,24.815256363904,2.53077044186669
8.7,"max_tuv_SVM","SVM",45,16,2212,2181,31,1700,1329,371,0.913812785388143,0.666666666666667,1.6728785177983,667,327,340,12,1,43.46,3.6,0,0,0,0,0,0,0.0210449513711724,25.3606243657324,2.36611451263396
8.7,"max_tuv_SVM","SVM",45,17,2112,2085,27,1800,1425,375,0.924304995971001,0.666666666666667,1.73291958985429,681,334,347,14,1,46.01,3.8,0,0,0,0,0,0,0.0276519230796569,29.959083105869,3.25754518492032
8.7,"max_tuv_SVM","SVM",45,18,2012,1989,23,1900,1521,379,0.930927679290901,0.666666666666667,1.76578918860362,700,343,357,19,1,48.57,4,0,0,0,0,0,0,0.031561685124081,26.7325898044651,3.63126664522033
8.7,"max_tuv_SVM","SVM",45,19,1912,1894,18,2000,1616,384,0.932414775270845,0.661764705882353,1.77135596885813,723,350,373,23,1.1,51.12,4.2,0,0,0,0,0,0,0.0447451298989506,27.9789694118006,4.99378744786376
8.7,"max_tuv_SVM","SVM",45,20,1812,1796,16,2100,1714,386,0.932305656280783,0.661764705882353,1.77135596885813,730,353,377,7,1.1,53.68,4.4,0,0,0,0,0,0,0.0381052216130386,22.3592105603061,4.37417002638702
8.7,"max_tuv_SVM","SVM",45,21,1712,1701,11,2200,1809,391,0.931946123198143,0.656862745098039,1.77135596885813,747,362,385,17,1.1,56.24,4.6,0,0,0,0,0,0,0.0252139106915043,16.2320365234266,3.5799822700201
8.7,"max_tuv_SVM","SVM",45,22,1612,1605,7,2300,1905,395,0.931456486704277,0.661764705882353,1.76972937935505,756,365,391,9,1.1,58.79,4.8,0,0,0,0,0,0,0.0160882899620948,13.3200056136731,2.07484161005092
8.7,"max_tuv_SVM","SVM",45,23,1512,1506,6,2400,2004,396,0.931227057032865,0.661764705882353,1.76972937935505,757,366,391,1,1.1,61.35,5.1,0,0,0,0,0,0,0.0126677121357988,10.366023383961,1.34586878016201
8.7,"max_tuv_SVM","SVM",45,24,1412,1406,6,2500,2104,396,0.930947264750656,0.661764705882353,1.76648514584569,765,372,393,8,1.1,63.91,5.3,0,0,0,0,0,0,0.00931829377811486,7.21335602717515,1.04880157916359
8.7,"max_tuv_SVM","SVM",45,25,1312,1306,6,2600,2204,396,0.930810166532372,0.666666666666667,1.77625372729737,765,373,392,0,1.1,66.46,5.6,0,0,0,0,0,0,0.00739454717135987,5.21366829938217,0.778304288685915
8.7,"max_tuv_SVM","SVM",45,26,1212,1207,5,2700,2303,397,0.930481410600776,0.661764705882353,1.76486748545572,769,376,393,4,1,69.02,5.8,0,0,0,0,0,0,0.00737416688125964,4.96221193656652,0.788796638713076
8.7,"max_tuv_SVM","SVM",45,27,1112,1108,4,2800,2402,398,0.930531773211574,0.656862745098039,1.76486748545572,774,381,393,5,1,71.57,6,0,0,0,0,0,0,0.00621125609092469,3.71677437667414,0.645669645495268
8.7,"max_tuv_SVM","SVM",45,28,1012,1009,3,2900,2501,399,0.930826954069305,0.642156862745098,1.77135596885813,785,384,401,11,1,74.13,6.3,0,0,0,0,0,0,0.00565082801763984,3.0675445697584,0.592498557166922
8.7,"max_tuv_SVM","SVM",45,29,912,909,3,3000,2601,399,0.931292808219183,0.642156862745098,1.76810577441986,791,386,405,6,1,76.69,6.5,0,0,0,0,0,0,0.00494310387654436,2.4050032071208,0.522162695103425
8.7,"max_tuv_SVM","SVM",45,30,812,810,2,3100,2700,400,0.931490061778141,0.647058823529412,1.76972937935505,794,387,407,3,1.1,79.24,6.8,0,0,0,0,0,0,0.00399040420065616,1.71581817871112,0.423051215359522
8.7,"max_tuv_SVM","SVM",45,31,712,710,2,3200,2800,400,0.931305398871883,0.647058823529412,1.77135596885813,794,387,407,0,1.1,81.8,7,0,0,0,0,0,0,0.00353614489133684,1.35829402796596,0.383123718930785
8.7,"max_tuv_SVM","SVM",45,32,612,610,2,3300,2900,400,0.931280217566484,0.647058823529412,1.77298555116619,795,388,407,1,1,84.36,7.2,0,0,0,0,0,0,0.00272770985218247,0.927755679839747,0.306931784693978
8.7,"max_tuv_SVM","SVM",45,33,512,510,2,3400,3000,400,0.93112773077268,0.647058823529412,1.77461813454664,794,387,407,-1,1.1,86.91,7.5,0,0,0,0,0,0,0.00203652962107373,0.606023292589554,0.236536144061906
8.7,"max_tuv_SVM","SVM",45,34,412,410,2,3500,3100,400,0.931143119348201,0.647058823529412,1.76972937935505,794,387,407,0,1.1,89.47,7.8,0,0,0,0,0,0,0.00116685385791016,0.338356415184779,0.147721014030843
8.7,"max_tuv_SVM","SVM",45,35,312,312,0,3600,3198,402,0.931218663264398,0.647058823529412,1.76972937935505,797,391,406,3,1,92.02,8,0,0,0,0,0,0,0.00142044261308416,0.364529673061316,0.183646881825715
8.7,"max_tuv_SVM","SVM",45,36,212,212,0,3700,3298,402,0.931697108066976,0.642156862745098,1.76003223207091,799,392,407,2,1,94.58,8.2,0,0,0,0,0,0,0.000805459612520116,0.169560387117718,0.10398673368925
8.7,"max_tuv_SVM","SVM",45,37,112,112,0,3800,3398,402,0.931948921120964,0.642156862745098,1.76325278510306,803,393,410,4,1,97.14,8.5,0,0,0,0,0,0,0.000425231867823643,0.0677147171769105,0.0630761814049395
8.7,"max_tuv_SVM","SVM",45,38,12,12,0,3900,3498,402,0.932105604799002,0.642156862745098,1.76810577441986,808,396,412,5,1,99.69,8.7,0,0,0,0,0,0,0.00023904123497361,0.00373447690775974,0.00373447690775974
8.7,"max_tuv_SVM","SVM",45,39,0,0,0,3912,3510,402,0.932111200644646,0.642156862745098,1.76486748545572,808,396,412,0,1,100,8.7,0,0,0,0,0,0,0,0,0
8.7,"max_tuv_SVM","SVM",46,0,3812,3417,395,100,89,11,0.898758542141231,0.535,1.74707182320442,25,11,14,0,1.3,2.56,8.1,0,0,0,0,0,0,0.744770888691527,390.068000991904,81.0780867842172
8.7,"max_tuv_SVM","SVM",46,1,3712,3365,347,200,141,59,0.893231776765383,0.565,1.74707182320442,121,59,62,96,1.1,5.11,2.4,0,0,0,0,0,0,0.750126165578914,419.181857119722,80.5817916555778
8.7,"max_tuv_SVM","SVM",46,2,3612,3308,304,300,198,102,0.863292995444194,0.57,1.64498161764706,210,102,108,89,1.1,7.67,1.9,0,0,0,0,0,0,0.695218328418165,429.550914520337,76.4220166378233
8.7,"max_tuv_SVM","SVM",46,3,3512,3245,267,400,261,139,0.869609908883824,0.61,1.61347465437788,288,139,149,78,1.1,10.22,1.9,0,0,0,0,0,0,0.695550788931792,361.503709791032,75.4386972857901
8.7,"max_tuv_SVM","SVM",46,4,3412,3196,216,500,310,190,0.883997722095675,0.62,1.62700367647059,378,185,193,90,1,12.78,1.6,0,0,0,0,0,0,0.733228205262102,247.400226425218,82.6793629774449
8.7,"max_tuv_SVM","SVM",46,5,3312,3146,166,600,360,240,0.881561788154908,0.62,1.60902573529412,450,220,230,72,1,15.34,1.5,0,0,0,0,0,0,0.256248903782182,256.882239309598,71.8712388623762
8.7,"max_tuv_SVM","SVM",46,6,3212,3086,126,700,420,280,0.870281890660591,0.63,1.57626373626374,499,238,261,49,1.1,17.89,1.5,0,0,0,0,0,0,0.111655072680375,153.691042653107,51.9841890473366
8.7,"max_tuv_SVM","SVM",46,7,3112,3022,90,800,484,316,0.873935079726648,0.63,1.58351425942962,540,257,283,41,1.1,20.45,1.5,0,0,0,0,0,0,0.0917066949013194,137.696405319233,34.5770443750019
8.7,"max_tuv_SVM","SVM",46,8,3012,2935,77,900,571,329,0.882420273348522,0.645,1.61347465437788,567,267,300,27,1.1,23.01,1.7,0,0,0,0,0,0,0.0659450250289325,115.130669801255,29.5795517038961
8.7,"max_tuv_SVM","SVM",46,9,2912,2857,55,1000,649,351,0.898221810933942,0.65,1.64801104972376,600,284,316,33,1.1,25.56,1.8,0,0,0,0,0,0,0.0615516918541101,109.167356187309,17.7368659453101
8.7,"max_tuv_SVM","SVM",46,10,2812,2763,49,1100,743,357,0.908590546697043,0.645,1.69148114075437,610,293,317,10,1.1,28.12,2.1,0,0,0,0,0,0,0.0521868414654265,85.8720727761878,15.5587303814089
8.7,"max_tuv_SVM","SVM",46,11,2712,2670,42,1200,836,364,0.918068052391806,0.64,1.70204419889503,628,301,327,18,1.1,30.67,2.3,0,0,0,0,0,0,0.0573835712232124,76.2303200825663,13.3534983495215
8.7,"max_tuv_SVM","SVM",46,12,2612,2573,39,1300,933,367,0.921745444191356,0.63,1.72164055299539,637,306,331,9,1.1,33.23,2.5,0,0,0,0,0,0,0.0489116169523613,58.3319058481048,11.7237986708878
8.7,"max_tuv_SVM","SVM",46,13,2512,2474,38,1400,1032,368,0.921322608200467,0.63,1.71689338235294,637,308,329,0,1.1,35.79,2.8,0,0,0,0,0,0,0.0357308330376229,43.7307735899037,9.40154920367067
8.7,"max_tuv_SVM","SVM",46,14,2412,2385,27,1500,1121,379,0.92543707289295,0.63,1.74707182320442,652,316,336,15,1.1,38.34,3,0,0,0,0,0,0,0.040342996217401,39.8312774422173,5.57783528402609
8.7,"max_tuv_SVM","SVM",46,15,2312,2289,23,1600,1217,383,0.924503132118468,0.635,1.74707182320442,674,321,353,22,1.1,40.9,3.2,0,0,0,0,0,0,0.0373950442685655,34.6877922635069,5.60122944034074
8.7,"max_tuv_SVM","SVM",46,16,2212,2194,18,1700,1312,388,0.926517653758556,0.635,1.74868202764977,682,326,356,8,1.1,43.46,3.4,0,0,0,0,0,0,0.0263723614623098,27.2901373787892,4.18625849605017
8.7,"max_tuv_SVM","SVM",46,17,2112,2100,12,1800,1406,394,0.927058656036451,0.63,1.73966820276498,694,332,362,12,1.1,46.01,3.6,0,0,0,0,0,0,0.0239336958940172,24.8776377127262,2.73314532122524
8.7,"max_tuv_SVM","SVM",46,18,2012,2002,10,1900,1504,396,0.927870159453314,0.63,1.74868202764977,696,336,360,2,1.1,48.57,3.8,0,0,0,0,0,0,0.0212597183123446,22.0240241053469,2.28208076718755
8.7,"max_tuv_SVM","SVM",46,19,1912,1903,9,2000,1603,397,0.927420273348532,0.63,1.74868202764977,700,340,360,4,1.1,51.12,4,0,0,0,0,0,0,0.0184125834831416,17.9701913405166,1.93087274801586
8.7,"max_tuv_SVM","SVM",46,20,1812,1803,9,2100,1703,397,0.925952448747168,0.62,1.7560773480663,720,347,373,20,1.1,53.68,4.3,0,0,0,0,0,0,0.0123095398633205,10.7790915241768,1.51999993592517
8.7,"max_tuv_SVM","SVM",46,21,1712,1704,8,2200,1802,398,0.926573177676556,0.62,1.7560773480663,726,349,377,6,1.1,56.24,4.5,0,0,0,0,0,0,0.0113486241907282,9.54304428394901,1.16065160890543
8.7,"max_tuv_SVM","SVM",46,22,1612,1605,7,2300,1901,399,0.925365888382703,0.615,1.76183823529412,739,360,379,13,1.1,58.79,4.8,0,0,0,0,0,0,0.00834334062054188,6.45099641503209,1.0423527905958
8.7,"max_tuv_SVM","SVM",46,23,1512,1506,6,2400,2000,400,0.9257061503417,0.62,1.76508287292818,743,361,382,4,1.1,61.35,5,0,0,0,0,0,0,0.00692252438405538,4.92149172041212,0.706199711995256
8.7,"max_tuv_SVM","SVM",46,24,1412,1406,6,2500,2100,400,0.925552391799556,0.605,1.76345906163753,761,369,392,18,1.1,63.91,5.2,0,0,0,0,0,0,0.00549836559981752,3.75340929724116,0.664188578087884
8.7,"max_tuv_SVM","SVM",46,25,1312,1306,6,2600,2200,400,0.925563781321196,0.61,1.76508287292818,760,369,391,-1,1.1,66.46,5.5,0,0,0,0,0,0,0.00494463202053154,2.84572312629785,0.504033530332775
8.7,"max_tuv_SVM","SVM",46,26,1212,1206,6,2700,2300,400,0.925250569476091,0.6,1.77245630174793,757,371,386,-3,1,69.02,5.8,0,0,0,0,0,0,0.0042970329904559,2.36428379494559,0.482114852988397
8.7,"max_tuv_SVM","SVM",46,27,1112,1108,4,2800,2398,402,0.926044988610487,0.6,1.77408839779006,766,376,390,9,1,71.57,6,0,0,0,0,0,0,0.00415698245840642,1.99163813810845,0.432933060347005
8.7,"max_tuv_SVM","SVM",46,28,1012,1008,4,2900,2498,402,0.925815774487479,0.605,1.77082720588235,773,379,394,7,1,74.13,6.2,0,0,0,0,0,0,0.00338898416441198,1.42903738397904,0.364040060468963
8.7,"max_tuv_SVM","SVM",46,29,912,908,4,3000,2598,402,0.925948177676545,0.605,1.77572350230415,773,379,394,0,1,76.69,6.5,0,0,0,0,0,0,0.0030072596702824,1.14709201464829,0.330711997191442
8.7,"max_tuv_SVM","SVM",46,30,812,808,4,3100,2698,402,0.926056378132126,0.605,1.77245630174793,774,380,394,1,1,79.24,6.7,0,0,0,0,0,0,0.00219479721022074,0.733026404771219,0.244260927910932
8.7,"max_tuv_SVM","SVM",46,31,712,709,3,3200,2797,403,0.926398063781328,0.605,1.76920110192837,780,381,399,6,1,81.8,6.9,0,0,0,0,0,0,0.00161645084658935,0.486039841177943,0.188540622887535
8.7,"max_tuv_SVM","SVM",46,32,612,609,3,3300,2897,403,0.92660022779044,0.605,1.77245630174793,779,382,397,-1,1,84.36,7.2,0,0,0,0,0,0,0.00113111466161207,0.348669574887056,0.152289387277131
8.7,"max_tuv_SVM","SVM",46,33,512,509,3,3400,2997,403,0.926803815489756,0.605,1.77408839779006,780,383,397,1,1,86.91,7.4,0,0,0,0,0,0,0.000662585570949749,0.201098397056504,0.0884995448255822
8.7,"max_tuv_SVM","SVM",46,34,412,411,1,3500,3095,405,0.928334282460144,0.6,1.77572350230415,792,385,407,12,1.1,89.47,7.6,0,0,0,0,0,0,0.000538560784914701,0.159982899028929,0.0693138313320141
8.7,"max_tuv_SVM","SVM",46,35,312,312,0,3600,3194,406,0.929054669703879,0.605,1.77082720588235,797,390,407,5,1,92.02,7.9,0,0,0,0,0,0,0.000463091730789068,0.117510216254334,0.0567897749499669
8.7,"max_tuv_SVM","SVM",46,36,212,212,0,3700,3294,406,0.929036161731212,0.605,1.77082720588235,799,390,409,2,1,94.58,8.1,0,0,0,0,0,0,0.000295064861442976,0.0618512687103656,0.0389212875841439
8.7,"max_tuv_SVM","SVM",46,37,112,112,0,3800,3394,406,0.929246867881553,0.605,1.77082720588235,799,390,409,0,1,97.14,8.4,0,0,0,0,0,0,0.000119151184728491,0.0216531195836042,0.0202987626986223
8.7,"max_tuv_SVM","SVM",46,38,12,12,0,3900,3494,406,0.929319476082007,0.605,1.76920110192837,806,394,412,7,1,99.69,8.6,0,0,0,0,0,0,9.6031499715612e-05,0.00127412822480234,0.00127412822480234
8.7,"max_tuv_SVM","SVM",46,39,0,0,0,3912,3506,406,0.929258257403192,0.605,1.77082720588235,807,394,413,1,1,100,8.6,0,0,0,0,0,0,0,0,0
8.7,"max_tuv_SVM","SVM",47,0,3812,3410,402,100,88,12,0.903229520975051,0.557291666666667,1.74001377410468,28,12,16,0,1.3,2.56,7.3,0,0,0,0,0,0,0.5,361.483256160904,56.2647559067461
8.7,"max_tuv_SVM","SVM",47,1,3712,3383,329,200,115,85,0.918125236205587,0.557291666666667,1.75549954170486,91,45,46,63,1,5.11,1.4,0,0,0,0,0,0,0.646091861677812,276.617329216096,77.4005583598378
8.7,"max_tuv_SVM","SVM",47,2,3612,3329,283,300,169,131,0.908561862244909,0.578125,1.75258739650414,183,92,91,92,1,7.67,1.3,0,0,0,0,0,0,0.657887849197784,266.305574249665,77.0223884166381
8.7,"max_tuv_SVM","SVM",47,3,3512,3263,249,400,235,165,0.900347812736204,0.588541666666667,1.71667817679558,256,123,133,73,1.1,10.22,1.4,0,0,0,0,0,0,0.545785940358334,220.098767988839,74.6373763024846
8.7,"max_tuv_SVM","SVM",47,4,3412,3199,213,500,299,201,0.893863969198786,0.609375,1.69791666666667,329,159,170,73,1.1,12.78,1.5,0,0,0,0,0,0,0.225633446065066,144.949312130231,66.7673659254309
8.7,"max_tuv_SVM","SVM",47,5,3312,3156,156,600,342,258,0.880308720710514,0.619791666666667,1.6401218951242,405,196,209,76,1.1,15.34,1.3,0,0,0,0,0,0,0.145359020969216,124.662135459382,39.0247710350973
8.7,"max_tuv_SVM","SVM",47,6,3212,3085,127,700,413,287,0.881787958238841,0.640625,1.624366359447,451,220,231,46,1.1,17.89,1.4,0,0,0,0,0,0,0.106315926101119,117.791801223661,30.0769909384922
8.7,"max_tuv_SVM","SVM",47,7,3112,3013,99,800,485,315,0.879696062452757,0.661458333333333,1.61348987108656,496,239,257,45,1.1,20.45,1.5,0,0,0,0,0,0,0.0807877155408173,120.177042769971,18.452586001151
8.7,"max_tuv_SVM","SVM",47,8,3012,2943,69,900,555,345,0.867025108654571,0.666666666666667,1.60263339466421,561,266,295,65,1.1,23.01,1.6,0,0,0,0,0,0,0.0953365519642426,153.430481989735,15.1148315150953
8.7,"max_tuv_SVM","SVM",47,9,2912,2849,63,1000,649,351,0.892281391723357,0.666666666666667,1.6401218951242,587,284,303,26,1.1,25.56,1.8,0,0,0,0,0,0,0.0680231073783656,93.5148651838761,11.8041776684578
8.7,"max_tuv_SVM","SVM",47,10,2812,2754,58,1100,744,356,0.893924496882081,0.666666666666667,1.62626146788991,601,291,310,14,1.1,28.12,2.1,0,0,0,0,0,0,0.0511497741998195,72.837460115641,8.1628139067694
8.7,"max_tuv_SVM","SVM",47,11,2712,2663,49,1200,835,365,0.911027258125464,0.65625,1.69323921028466,630,307,323,29,1.1,30.67,2.3,0,0,0,0,0,0,0.0504519385944798,57.3667070950993,5.97519151723828
8.7,"max_tuv_SVM","SVM",47,12,2612,2572,40,1300,926,374,0.923960990646255,0.661458333333333,1.70103211009174,647,315,332,17,1.1,33.23,2.5,0,0,0,0,0,0,0.0456672479799367,60.3076496949616,5.51228275768755
8.7,"max_tuv_SVM","SVM",47,13,2512,2475,37,1400,1023,377,0.930714994331054,0.651041666666667,1.73703917050691,669,323,346,22,1.1,35.79,2.7,0,0,0,0,0,0,0.0468352879359862,52.3818936403251,5.46409452190948
8.7,"max_tuv_SVM","SVM",47,14,2412,2378,34,1500,1120,380,0.933927390400598,0.651041666666667,1.73224954044118,680,330,350,11,1.1,38.34,2.9,0,0,0,0,0,0,0.0398748801330838,41.9642855866825,4.42895429011541
8.7,"max_tuv_SVM","SVM",47,15,2312,2282,30,1600,1216,384,0.937824782690856,0.651041666666667,1.76195952161914,690,333,357,10,1.1,40.9,3.2,0,0,0,0,0,0,0.0415544976729176,36.4847095604572,4.64879928554065
8.7,"max_tuv_SVM","SVM",47,16,2212,2185,27,1700,1313,387,0.938816846182918,0.645833333333333,1.75872359963269,699,338,361,9,1.1,43.46,3.4,0,0,0,0,0,0,0.0355488214727604,31.1593853321193,4.10325745629015
8.7,"max_tuv_SVM","SVM",47,17,2112,2091,21,1800,1407,393,0.939780860260774,0.645833333333333,1.75711009174312,714,346,368,15,1.1,46.01,3.6,0,0,0,0,0,0,0.0346434969996014,28.8560082972794,4.33304130573622
8.7,"max_tuv_SVM","SVM",47,18,2012,1997,15,1900,1501,399,0.940219316893425,0.645833333333333,1.75872359963269,730,355,375,16,1.1,48.57,3.8,0,0,0,0,0,0,0.0280582294864578,24.6279531200513,3.71056695566733
8.7,"max_tuv_SVM","SVM",47,19,1912,1899,13,2000,1599,401,0.940392042233561,0.651041666666667,1.75711009174312,737,357,380,7,1.1,51.12,4,0,0,0,0,0,0,0.023955202019543,22.3695931250771,2.68022504710989
8.7,"max_tuv_SVM","SVM",47,20,1812,1801,11,2100,1697,403,0.94049685846561,0.65625,1.75549954170486,740,360,380,3,1.1,53.68,4.2,0,0,0,0,0,0,0.0213403651675173,19.5154580016138,2.20531148067923
8.7,"max_tuv_SVM","SVM",47,21,1712,1703,9,2200,1795,405,0.940585435563109,0.645833333333333,1.77133164673413,759,368,391,19,1.1,56.24,4.4,0,0,0,0,0,0,0.0141664017325175,11.6926284376232,1.74769865084172
8.7,"max_tuv_SVM","SVM",47,22,1612,1604,8,2300,1894,406,0.940632676681777,0.645833333333333,1.76807851239669,758,368,390,-1,1.1,58.79,4.7,0,0,0,0,0,0,0.0129460474383779,10.4653199345125,1.34301002439521
8.7,"max_tuv_SVM","SVM",47,23,1512,1505,7,2400,1993,407,0.940538194444437,0.635416666666667,1.76807851239669,778,378,400,20,1.1,61.35,4.9,0,0,0,0,0,0,0.0113401282349717,8.66912145190034,1.31458460476196
8.7,"max_tuv_SVM","SVM",47,24,1412,1406,6,2500,2092,408,0.941471206538152,0.645833333333333,1.76807851239669,782,379,403,4,1.1,63.91,5.1,0,0,0,0,0,0,0.00914008200656105,6.62377629763398,0.948433553637339
8.7,"max_tuv_SVM","SVM",47,25,1312,1306,6,2600,2192,408,0.941326530612229,0.635416666666667,1.76970358455882,782,383,399,0,1,66.46,5.4,0,0,0,0,0,0,0.00803658588914322,5.43679351078416,0.870117108523111
8.7,"max_tuv_SVM","SVM",47,26,1212,1206,6,2700,2292,408,0.941388534580484,0.635416666666667,1.7774334251607,780,383,397,-2,1,69.02,5.6,0,0,0,0,0,0,0.00687689623692566,4.05936701563851,0.705207262948811
8.7,"max_tuv_SVM","SVM",47,27,1112,1107,5,2800,2391,409,0.940552957294012,0.640625,1.77417506874427,790,387,403,10,1,71.57,5.8,0,0,0,0,0,0,0.00643839427507819,3.38082573929595,0.684369229740307
8.7,"max_tuv_SVM","SVM",47,28,1012,1007,5,2900,2491,409,0.940529336734677,0.640625,1.78070377184913,795,388,407,5,1,74.13,6.1,0,0,0,0,0,0,0.0057141724260571,2.63979143927175,0.604914882302219
8.7,"max_tuv_SVM","SVM",47,29,912,908,4,3000,2590,410,0.940361040249417,0.640625,1.77255036630037,798,390,408,3,1,76.69,6.3,0,0,0,0,0,0,0.00479151849068271,1.96947678878495,0.515945656712049
8.7,"max_tuv_SVM","SVM",47,30,812,808,4,3100,2690,410,0.940368421674209,0.640625,1.77580275229358,797,390,407,-1,1,79.24,6.6,0,0,0,0,0,0,0.0035631939686494,1.27621569565046,0.393018657188382
8.7,"max_tuv_SVM","SVM",47,31,712,708,4,3200,2790,410,0.940384660808753,0.640625,1.77092863677951,799,391,408,2,1,81.8,6.8,0,0,0,0,0,0,0.00327030702220716,1.1029942297737,0.376148637176242
8.7,"max_tuv_SVM","SVM",47,32,612,609,3,3300,2889,411,0.940431901927423,0.635416666666667,1.7774334251607,805,393,412,6,1,84.36,7,0,0,0,0,0,0,0.00206987236010281,0.695669239709355,0.257982866005534
8.7,"max_tuv_SVM","SVM",47,33,512,510,2,3400,2988,412,0.94065039210127,0.630208333333333,1.7867883379247,808,395,413,3,1,86.91,7.3,0,0,0,0,0,0,0.00155335256754899,0.526320576394719,0.192830520811779
8.7,"max_tuv_SVM","SVM",47,34,412,411,1,3500,3087,413,0.940591340702932,0.635416666666667,1.7867883379247,814,400,414,6,1,89.47,7.5,0,0,0,0,0,0,0.00122732128254592,0.372693577338125,0.145523679389675
8.7,"max_tuv_SVM","SVM",47,35,312,312,0,3600,3186,414,0.940412710222962,0.635416666666667,1.78843060661765,821,403,418,7,1,92.02,7.7,0,0,0,0,0,0,0.00107416119845832,0.27543464579915,0.129337528315385
8.7,"max_tuv_SVM","SVM",47,36,212,212,0,3700,3286,414,0.940561815003764,0.635416666666667,1.79337557603687,825,405,420,4,1,94.58,7.9,0,0,0,0,0,0,0.000562652903548662,0.119495303803892,0.0730275593900405
8.7,"max_tuv_SVM","SVM",47,37,112,112,0,3800,3386,414,0.940623818972018,0.635416666666667,1.79007589696412,830,406,424,5,1,97.14,8.2,0,0,0,0,0,0,0.000310007115160257,0.0455021925203392,0.042247740281886
8.7,"max_tuv_SVM","SVM",47,38,12,12,0,3900,3486,414,0.940552957294014,0.635416666666667,1.79007589696412,829,406,423,-1,1,99.69,8.4,0,0,0,0,0,0,0.000218398052020594,0.00300025669126374,0.00300025669126374
8.7,"max_tuv_SVM","SVM",47,39,0,0,0,3912,3498,414,0.940579530423266,0.635416666666667,1.7867883379247,829,406,423,0,1,100,8.4,0,0,0,0,0,0,0,0,0
8.7,"max_tuv_SVM","SVM",48,0,3812,3422,390,100,90,10,0.914812760055477,0.611650485436893,1.71525211399937,27,10,17,0,1.7,2.56,9,0,0,0,0,0,0,0.170828659946224,372.542819513071,17.956769387119
8.7,"max_tuv_SVM","SVM",48,1,3712,3393,319,200,119,81,0.9151761442441,0.621359223300971,1.74703691463992,88,44,44,61,1,5.11,1.5,0,0,0,0,0,0,0.715718120607553,318.116992634178,82.1246588285787
8.7,"max_tuv_SVM","SVM",48,2,3612,3340,272,300,172,128,0.896353675450751,0.606796116504854,1.69867284225528,178,88,90,90,1,7.67,1.3,0,0,0,0,0,0,0.736437919593752,258.79577436785,86.7906325165142
8.7,"max_tuv_SVM","SVM",48,3,3512,3277,235,400,235,165,0.904560332871029,0.62621359223301,1.71525211399937,259,125,134,81,1.1,10.22,1.4,0,0,0,0,0,0,0.688187805163555,206.007104572189,84.7902504956636
8.7,"max_tuv_SVM","SVM",48,4,3412,3217,195,500,295,205,0.908183079056858,0.631067961165049,1.70492946414204,340,167,173,81,1,12.78,1.4,0,0,0,0,0,0,0.351434122165156,195.695989941043,75.7240297694233
8.7,"max_tuv_SVM","SVM",48,5,3312,3152,160,600,360,240,0.908402219140078,0.645631067961165,1.68589062262752,415,198,217,75,1.1,15.34,1.5,0,0,0,0,0,0,0.128217633189371,136.800323523727,51.965913028112
8.7,"max_tuv_SVM","SVM",48,6,3212,3089,123,700,423,277,0.903148404993067,0.669902912621359,1.65663697879055,473,225,248,58,1.1,17.89,1.5,0,0,0,0,0,0,0.0973776040650706,137.414427256123,32.6774104770535
8.7,"max_tuv_SVM","SVM",48,7,3112,3003,109,800,509,291,0.91099583911233,0.679611650485437,1.66842025348112,501,237,264,28,1.1,20.45,1.7,0,0,0,0,0,0,0.0812172158216346,125.274811276991,29.2165932562356
8.7,"max_tuv_SVM","SVM",48,8,3012,2926,86,900,586,314,0.91211650485436,0.679611650485437,1.69774954140754,545,259,286,44,1.1,23.01,1.9,0,0,0,0,0,0,0.0980122451266724,128.382310263644,24.7028364434399
8.7,"max_tuv_SVM","SVM",48,9,2912,2833,79,1000,679,321,0.912814147018026,0.674757281553398,1.69306824671616,575,276,299,30,1.1,25.56,2.1,0,0,0,0,0,0,0.0933696124540468,112.256401065581,23.5948122449874
8.7,"max_tuv_SVM","SVM",48,10,2812,2741,71,1100,771,329,0.921109570041596,0.66504854368932,1.71209617634712,605,288,317,30,1.1,28.12,2.3,0,0,0,0,0,0,0.0828748359427487,96.5087653571419,23.4549390416651
8.7,"max_tuv_SVM","SVM",48,11,2712,2652,60,1200,860,340,0.924155339805812,0.669902912621359,1.71924971444889,632,302,330,27,1.1,30.67,2.5,0,0,0,0,0,0,0.0771949296615392,81.2355305299548,22.2851265870391
8.7,"max_tuv_SVM","SVM",48,12,2612,2558,54,1300,954,346,0.924327323162259,0.66504854368932,1.72400340029529,646,307,339,14,1.1,33.23,2.8,0,0,0,0,0,0,0.0662065894786663,69.8958822994866,21.3309741163976
8.7,"max_tuv_SVM","SVM",48,13,2512,2465,47,1400,1047,353,0.925337031900123,0.669902912621359,1.72083136092032,658,313,345,12,1.1,35.79,3,0,0,0,0,0,0,0.0518940308356271,55.9749224402121,17.4750176404342
8.7,"max_tuv_SVM","SVM",48,14,2412,2377,35,1500,1135,365,0.925251040221902,0.669902912621359,1.72083136092032,679,321,358,21,1.1,38.34,3.1,0,0,0,0,0,0,0.0501755860240793,58.1905698988986,13.8425719825292
8.7,"max_tuv_SVM","SVM",48,15,2312,2284,28,1600,1228,372,0.925553398058236,0.669902912621359,1.72241592018452,694,329,365,15,1.1,40.9,3.3,0,0,0,0,0,0,0.0418599035612909,54.1222895957537,12.9046411171214
8.7,"max_tuv_SVM","SVM",48,16,2212,2191,21,1700,1321,379,0.927822468793331,0.669902912621359,1.72083136092032,708,337,371,14,1.1,43.46,3.5,0,0,0,0,0,0,0.035275274683719,44.9488132728918,9.39290993893143
8.7,"max_tuv_SVM","SVM",48,17,2112,2096,16,1800,1416,384,0.92946740638003,0.669902912621359,1.72083136092032,727,341,386,19,1.1,46.01,3.7,0,0,0,0,0,0,0.0338128177119413,41.4230507621797,7.4383800042392
8.7,"max_tuv_SVM","SVM",48,18,2012,2001,11,1900,1511,389,0.930669902912631,0.669902912621359,1.72797687035979,733,348,385,6,1.1,48.57,3.9,0,0,0,0,0,0,0.0300201261303334,35.3320383931659,6.07647524404608
8.7,"max_tuv_SVM","SVM",48,19,1912,1902,10,2000,1610,390,0.930464632454932,0.669902912621359,1.72480627059767,738,350,388,5,1.1,51.12,4.1,0,0,0,0,0,0,0.0245607389825424,28.4507262688669,5.4596605592094
8.7,"max_tuv_SVM","SVM",48,20,1812,1805,7,2100,1707,393,0.930212205270466,0.669902912621359,1.73115914820576,738,351,387,0,1.1,53.68,4.3,0,0,0,0,0,0,0.0196906365215058,19.7611194905999,2.08476894625942
8.7,"max_tuv_SVM","SVM",48,21,1712,1705,7,2200,1807,393,0.930167822468798,0.669902912621359,1.72797687035979,740,352,388,2,1.1,56.24,4.6,0,0,0,0,0,0,0.0192587633529356,18.1595406228149,1.9697158566934
8.7,"max_tuv_SVM","SVM",48,22,1612,1605,7,2300,1907,393,0.931353675450755,0.660194174757282,1.75025725918303,758,366,392,18,1.1,58.79,4.9,0,0,0,0,0,0,0.0118118328756448,8.16963091198641,1.57978159330488
8.7,"max_tuv_SVM","SVM",48,23,1512,1507,5,2400,2005,395,0.931056865464626,0.655339805825243,1.75025725918303,763,368,395,5,1.1,61.35,5.1,0,0,0,0,0,0,0.00999460190716606,8.04145342780583,1.1747381742196
8.7,"max_tuv_SVM","SVM",48,24,1412,1408,4,2500,2104,396,0.931461858529813,0.655339805825243,1.75025725918303,763,368,395,0,1.1,63.91,5.3,0,0,0,0,0,0,0.00840639990284179,6.3812665330275,0.861019963258465
8.7,"max_tuv_SVM","SVM",48,25,1312,1308,4,2600,2204,396,0.932757281553405,0.655339805825243,1.74703691463992,771,376,395,8,1.1,66.46,5.6,0,0,0,0,0,0,0.00592653715766885,3.93074228400511,0.715111880697407
8.7,"max_tuv_SVM","SVM",48,26,1212,1208,4,2700,2304,396,0.932693481276012,0.655339805825243,1.74703691463992,770,375,395,-1,1.1,69.02,5.8,0,0,0,0,0,0,0.00498927839359936,3.11161576440907,0.520817264832302
8.7,"max_tuv_SVM","SVM",48,27,1112,1109,3,2800,2403,397,0.933772538141474,0.655339805825243,1.75900854547895,784,381,403,14,1.1,71.57,6.1,0,0,0,0,0,0,0.00436577269086021,2.54887317051023,0.479263541880932
8.7,"max_tuv_SVM","SVM",48,28,1012,1010,2,2900,2502,398,0.934346740638002,0.650485436893204,1.75577209921312,792,386,406,8,1.1,74.13,6.3,0,0,0,0,0,0,0.00372056577820869,1.91653354414576,0.394724078278344
8.7,"max_tuv_SVM","SVM",48,29,912,911,1,3000,2601,399,0.934488210818305,0.650485436893204,1.75577209921312,800,389,411,8,1.1,76.69,6.5,0,0,0,0,0,0,0.00304390501135796,1.32950020253597,0.315776883143549
8.7,"max_tuv_SVM","SVM",48,30,812,811,1,3100,2701,399,0.934760055478494,0.650485436893204,1.75577209921312,800,391,409,0,1,79.24,6.8,0,0,0,0,0,0,0.00263733498859271,0.955046587937957,0.280214153600692
8.7,"max_tuv_SVM","SVM",48,31,712,712,0,3200,2800,400,0.934834951456302,0.650485436893204,1.75577209921312,806,393,413,6,1.1,81.8,7,0,0,0,0,0,0,0.00197527488706026,0.606541109322086,0.217421386739632
8.7,"max_tuv_SVM","SVM",48,32,612,612,0,3300,2900,400,0.935023578363375,0.655339805825243,1.75577209921312,804,393,411,-2,1,84.36,7.2,0,0,0,0,0,0,0.00153228594912791,0.435718725604499,0.187256105358309
8.7,"max_tuv_SVM","SVM",48,33,512,512,0,3400,3000,400,0.935206657420241,0.655339805825243,1.75415833809252,808,393,415,4,1.1,86.91,7.5,0,0,0,0,0,0,0.000739928152441855,0.228549751832008,0.10392246563464
8.7,"max_tuv_SVM","SVM",48,34,412,412,0,3500,3100,400,0.935818307905682,0.655339805825243,1.7477328496746,813,396,417,5,1.1,89.47,7.8,0,0,0,0,0,0,0.000354899481064141,0.101584769497379,0.0487498370556109
8.7,"max_tuv_SVM","SVM",48,35,312,312,0,3600,3200,400,0.936391123439663,0.655339805825243,1.75093969894006,812,396,416,-1,1.1,92.02,8,0,0,0,0,0,0,0.00020899862083712,0.0525920777847696,0.0283318659622178
8.7,"max_tuv_SVM","SVM",48,36,212,212,0,3700,3300,400,0.93663800277392,0.650485436893204,1.75415833809252,814,397,417,2,1.1,94.58,8.2,0,0,0,0,0,0,8.51929472116434e-05,0.0189280370465063,0.0125196414390283
8.7,"max_tuv_SVM","SVM",48,37,112,112,0,3800,3400,400,0.936907073509011,0.650485436893204,1.75254754072053,816,398,418,2,1.1,97.14,8.5,0,0,0,0,0,0,2.67099219412709e-05,0.0051890201370678,0.00491260864348463
8.7,"max_tuv_SVM","SVM",48,38,12,12,0,3900,3500,400,0.937031900138693,0.650485436893204,1.75254754072053,819,399,420,3,1.1,99.69,8.8,0,0,0,0,0,0,2.29419815914028e-05,0.000346229584602747,0.000346229584602747
8.7,"max_tuv_SVM","SVM",48,39,0,0,0,3912,3512,400,0.937051317614421,0.650485436893204,1.75254754072053,819,399,420,0,1.1,100,8.8,0,0,0,0,0,0,0,0,0
8.7,"max_tuv_SVM","SVM",49,0,3812,3421,391,100,90,10,0.869816550821141,0.521951219512195,1.69255738880918,31,10,21,0,2.1,2.56,9,0,0,0,0,0,0,0.543555033684984,392.245797248581,64.4605945477831
8.7,"max_tuv_SVM","SVM",49,1,3712,3360,352,200,151,49,0.890206293267976,0.595121951219512,1.71167006978257,107,49,58,76,1.2,5.11,3.1,0,0,0,0,0,0,0.670716573253867,370.038904870753,78.2780220480064
8.7,"max_tuv_SVM","SVM",49,2,3612,3299,313,300,212,88,0.895917315540953,0.590243902439024,1.72922566024188,186,88,98,79,1.1,7.67,2.4,0,0,0,0,0,0,0.614942262019494,407.410839211883,70.8055250175
8.7,"max_tuv_SVM","SVM",49,3,3512,3255,257,400,256,144,0.905938070231655,0.648780487804878,1.7396038269775,256,128,128,70,1,10.22,1.8,0,0,0,0,0,0,0.599203631181926,243.746899197994,77.6082135799591
8.7,"max_tuv_SVM","SVM",49,4,3412,3193,219,500,318,182,0.917194355838478,0.64390243902439,1.77148493543759,352,171,181,96,1.1,12.78,1.7,0,0,0,0,0,0,0.363526054994466,171.189543787158,71.5439911253331
8.7,"max_tuv_SVM","SVM",49,5,3312,3150,162,600,361,239,0.913950216600972,0.653658536585366,1.75000112397437,419,205,214,67,1,15.34,1.5,0,0,0,0,0,0,0.139455016055919,112.758702779277,45.6565891774017
8.7,"max_tuv_SVM","SVM",49,6,3212,3088,124,700,423,277,0.915412795475768,0.648780487804878,1.73241317297966,468,228,240,49,1.1,17.89,1.5,0,0,0,0,0,0,0.0884250010098493,87.8043133717252,30.4798533123004
8.7,"max_tuv_SVM","SVM",49,7,3112,3015,97,800,496,304,0.9073658257999,0.682926829268293,1.67501793400287,500,243,257,32,1.1,20.45,1.6,0,0,0,0,0,0,0.067166037151628,90.8181003847958,20.8729526372671
8.7,"max_tuv_SVM","SVM",49,8,3012,2929,83,900,582,318,0.914239946511422,0.678048780487805,1.70132711621234,525,255,270,25,1.1,23.01,1.8,0,0,0,0,0,0,0.0590858509845987,88.8659232176287,14.8795244077217
8.7,"max_tuv_SVM","SVM",49,9,2912,2849,63,1000,662,338,0.914596537170408,0.682926829268293,1.69723727099022,571,277,294,46,1.1,25.56,2,0,0,0,0,0,0,0.102731649688809,143.02436376426,17.6665149878783
8.7,"max_tuv_SVM","SVM",49,10,2812,2757,55,1100,754,346,0.922469390313569,0.682926829268293,1.70852650675267,606,294,312,35,1.1,28.12,2.2,0,0,0,0,0,0,0.067179376853703,92.4031638856846,13.095300475409
8.7,"max_tuv_SVM","SVM",49,11,2712,2667,45,1200,844,356,0.930200164366018,0.678048780487805,1.72763629842181,640,307,333,34,1.1,30.67,2.4,0,0,0,0,0,0,0.0667525952668348,85.960209919033,12.7371303648929
8.7,"max_tuv_SVM","SVM",49,12,2612,2573,39,1300,938,362,0.934922204733189,0.702439024390244,1.74517575322812,658,314,344,18,1.1,33.23,2.6,0,0,0,0,0,0,0.0612632152111227,73.9005332757848,11.8462868712781
8.7,"max_tuv_SVM","SVM",49,13,2512,2479,33,1400,1032,368,0.935856862280791,0.692682926829268,1.74838970489152,679,322,357,21,1.1,35.79,2.8,0,0,0,0,0,0,0.0588857532796841,65.181329134732,10.9081035435755
8.7,"max_tuv_SVM","SVM",49,14,2412,2385,27,1500,1126,374,0.937045033500028,0.692682926829268,1.75786814513425,689,330,359,10,1.1,38.34,3,0,0,0,0,0,0,0.0528617886794858,58.1827776205643,10.4407900752644
8.7,"max_tuv_SVM","SVM",49,15,2312,2289,23,1600,1222,378,0.938254098703186,0.692682926829268,1.75948086820318,699,333,366,10,1.1,40.9,3.2,0,0,0,0,0,0,0.0431223478064968,49.5387806830126,8.51338100030384
8.7,"max_tuv_SVM","SVM",49,16,2212,2196,16,1700,1315,385,0.939120502569964,0.68780487804878,1.75233487872069,711,340,371,12,1.1,43.46,3.4,0,0,0,0,0,0,0.0364207425403566,42.026283597779,5.98896263513975
8.7,"max_tuv_SVM","SVM",49,17,2112,2098,14,1800,1413,387,0.939940939672117,0.682926829268293,1.76271520803443,725,343,382,14,1.1,46.01,3.7,0,0,0,0,0,0,0.0318485070848979,36.2685078804753,5.26364240860887
8.7,"max_tuv_SVM","SVM",49,18,2012,1998,14,1900,1513,387,0.938981209343805,0.682926829268293,1.7643368411605,727,346,381,2,1.1,48.57,3.9,0,0,0,0,0,0,0.026001506309762,27.8345581908175,4.6881975375225
8.7,"max_tuv_SVM","SVM",49,19,1912,1900,12,2000,1611,389,0.938886489950007,0.663414634146341,1.77638305046645,736,352,384,9,1.1,51.12,4.1,0,0,0,0,0,0,0.018480882822516,17.0597952057752,2.23998353842305
8.7,"max_tuv_SVM","SVM",49,20,1812,1802,10,2100,1709,391,0.938939421375952,0.663414634146341,1.77311463639015,739,354,385,3,1.1,53.68,4.4,0,0,0,0,0,0,0.0174473597808849,15.6508238651383,1.79359903042709
8.7,"max_tuv_SVM","SVM",49,21,1712,1702,10,2200,1809,391,0.939779359529756,0.663414634146341,1.78353321654763,756,364,392,17,1.1,56.24,4.6,0,0,0,0,0,0,0.0114319843689429,9.3561753917662,1.42924873280339
8.7,"max_tuv_SVM","SVM",49,22,1612,1604,8,2300,1907,393,0.940087197559592,0.668292682926829,1.78189243161981,763,366,397,7,1.1,58.79,4.9,0,0,0,0,0,0,0.0109091440053631,8.42827438318398,1.13054429046567
8.7,"max_tuv_SVM","SVM",49,23,1512,1504,8,2400,2007,393,0.940580295580234,0.658536585365854,1.78353321654763,769,374,395,6,1.1,61.35,5.1,0,0,0,0,0,0,0.00722633348742235,5.14585628776317,0.887405385997924
8.7,"max_tuv_SVM","SVM",49,24,1412,1405,7,2500,2106,394,0.940718195874143,0.658536585365854,1.78353321654763,772,374,398,3,1.1,63.91,5.3,0,0,0,0,0,0,0.00685510816803546,4.85968907953052,0.736465246033221
8.7,"max_tuv_SVM","SVM",49,25,1312,1306,6,2600,2205,395,0.941400732682378,0.653658536585366,1.78025466284075,778,378,400,6,1.1,66.46,5.6,0,0,0,0,0,0,0.00536796150513304,3.56431974779166,0.582260570747092
8.7,"max_tuv_SVM","SVM",49,26,1212,1207,5,2700,2304,396,0.94154141884081,0.653658536585366,1.78517702596381,784,382,402,6,1.1,69.02,5.8,0,0,0,0,0,0,0.006004236811604,3.4832594312863,0.63158121742213
8.7,"max_tuv_SVM","SVM",49,27,1112,1107,5,2800,2404,396,0.941538632976286,0.653658536585366,1.77535937045897,788,385,403,4,1,71.57,6.1,0,0,0,0,0,0,0.00418381798018773,2.21147558793798,0.463500370556592
8.7,"max_tuv_SVM","SVM",49,28,1012,1008,4,2900,2503,397,0.941815826496365,0.658536585365854,1.78353321654763,791,386,405,3,1,74.13,6.3,0,0,0,0,0,0,0.00439431687159273,2.12658089243918,0.468394797425761
8.7,"max_tuv_SVM","SVM",49,29,912,908,4,3000,2603,397,0.941831148751244,0.658536585365854,1.77535937045897,793,387,406,2,1,76.69,6.6,0,0,0,0,0,0,0.00317887246962635,1.35148523060643,0.344373144135139
8.7,"max_tuv_SVM","SVM",49,30,812,808,4,3100,2703,397,0.941904974161114,0.658536585365854,1.77698814052361,794,388,406,1,1,79.24,6.8,0,0,0,0,0,0,0.00248363098870068,0.966503523836356,0.275712674768434
8.7,"max_tuv_SVM","SVM",49,31,712,708,4,3200,2803,397,0.942129236255248,0.658536585365854,1.7786199019015,793,389,404,-1,1,81.8,7.1,0,0,0,0,0,0,0.00217178325873615,0.76459170360526,0.243532178926971
8.7,"max_tuv_SVM","SVM",49,32,612,609,3,3300,2902,398,0.942439860149607,0.653658536585366,1.78025466284075,798,389,409,5,1.1,84.36,7.3,0,0,0,0,0,0,0.00176515299567974,0.570847852905487,0.201702045027645
8.7,"max_tuv_SVM","SVM",49,33,512,509,3,3400,3002,398,0.94271983953421,0.658536585365854,1.78189243161981,803,390,413,5,1.1,86.91,7.5,0,0,0,0,0,0,0.00104049908384958,0.320954562267294,0.129008724480524
8.7,"max_tuv_SVM","SVM",49,34,412,410,2,3500,3101,399,0.943190650638665,0.658536585365854,1.7786199019015,808,392,416,5,1.1,89.47,7.8,0,0,0,0,0,0,0.000832277616592695,0.238809764407686,0.105767534717144
8.7,"max_tuv_SVM","SVM",49,35,312,311,1,3600,3200,400,0.943764538730486,0.658536585365854,1.78189243161981,811,394,417,3,1.1,92.02,8,0,0,0,0,0,0,0.00053050167540456,0.130261343235904,0.0676490785139161
8.7,"max_tuv_SVM","SVM",49,36,212,212,0,3700,3299,401,0.944260422615652,0.658536585365854,1.7786199019015,813,397,416,2,1,94.58,8.2,0,0,0,0,0,0,0.000380966942893229,0.0826887254174319,0.0521569421730872
8.7,"max_tuv_SVM","SVM",49,37,112,112,0,3800,3399,401,0.944376035993373,0.658536585365854,1.78025466284075,813,397,416,0,1,97.14,8.5,0,0,0,0,0,0,0.000153119514016245,0.0252506090913386,0.0235706927212505
8.7,"max_tuv_SVM","SVM",49,38,12,12,0,3900,3499,401,0.944547366661563,0.653658536585366,1.78189243161981,814,398,416,1,1,99.69,8.7,0,0,0,0,0,0,0.000180037112983379,0.00238588266441056,0.00238588266441056
8.7,"max_tuv_SVM","SVM",49,39,0,0,0,3912,3511,401,0.944530651474422,0.653658536585366,1.78025466284075,815,398,417,1,1,100,8.8,0,0,0,0,0,0,0,0,0
8.7,"max_tuv_SVM","SVM",50,0,3812,3431,381,100,95,5,0.856103372434023,0.490909090909091,1.67165479681609,24,5,19,0,3.8,2.56,19,0,0,0,0,0,0,0.0714586583893139,207.385456297345,7.70051916671777
8.7,"max_tuv_SVM","SVM",50,1,3712,3357,355,200,169,31,0.879252199413508,0.463636363636364,1.75359865940511,72,31,41,48,1.3,5.11,5.5,0,0,0,0,0,0,0.209429115487484,196.296683901954,31.4226703291865
8.7,"max_tuv_SVM","SVM",50,2,3612,3301,311,300,225,75,0.897917103058243,0.640909090909091,1.74059157754011,158,73,85,86,1.2,7.67,3,0,0,0,0,0,0,0.312999352865563,148.447932976042,42.356050070279
8.7,"max_tuv_SVM","SVM",50,3,3512,3269,243,400,257,143,0.900686007540863,0.659090909090909,1.71135738688443,237,114,123,79,1.1,10.22,1.8,0,0,0,0,0,0,0.505215288952251,203.263081373697,63.4055422580371
8.7,"max_tuv_SVM","SVM",50,4,3412,3222,190,500,304,196,0.863259321323827,0.640909090909091,1.5824186822352,319,157,162,82,1,12.78,1.6,0,0,0,0,0,0,0.350986428555104,221.020266210176,56.1258847269673
8.7,"max_tuv_SVM","SVM",50,5,3312,3156,156,600,370,230,0.912374319229162,0.681818181818182,1.70790441176471,390,191,199,71,1,15.34,1.6,0,0,0,0,0,0,0.226208676390159,160.38621944863,47.6182711509562
8.7,"max_tuv_SVM","SVM",50,6,3212,3098,114,700,428,272,0.881471250523671,0.677272727272727,1.60167112299465,450,217,233,60,1.1,17.89,1.6,0,0,0,0,0,0,0.122471993654994,123.50578614487,25.7100472605014
8.7,"max_tuv_SVM","SVM",50,7,3112,3026,86,800,500,300,0.878173439463769,0.695454545454545,1.5934993315508,494,238,256,44,1.1,20.45,1.7,0,0,0,0,0,0,0.0861415493675659,107.563566103137,15.3539792592122
8.7,"max_tuv_SVM","SVM",50,8,3012,2944,68,900,582,318,0.874371596145786,0.695454545454545,1.5949652922974,538,255,283,44,1.1,23.01,1.8,0,0,0,0,0,0,0.0747906036218404,123.031278449389,15.7708786230346
8.7,"max_tuv_SVM","SVM",50,9,2912,2855,57,1000,671,329,0.874901811897777,0.7,1.6128076343546,577,272,305,39,1.1,25.56,2,0,0,0,0,0,0,0.0639435260157997,91.9100798077312,10.7947563024794
8.7,"max_tuv_SVM","SVM",50,10,2812,2760,52,1100,766,334,0.881509216589855,0.686363636363636,1.61429409300377,587,281,306,10,1.1,28.12,2.3,0,0,0,0,0,0,0.0536013376260862,73.7773409882154,7.72923349887556
8.7,"max_tuv_SVM","SVM",50,11,2712,2668,44,1200,858,342,0.891283514872223,0.681818181818182,1.62469321312297,605,290,315,18,1.1,30.67,2.5,0,0,0,0,0,0,0.0485935957838177,69.7205351244074,6.34743198224467
8.7,"max_tuv_SVM","SVM",50,12,2612,2574,38,1300,952,348,0.910401392961884,0.677272727272727,1.67011551983928,641,310,331,36,1.1,33.23,2.7,0,0,0,0,0,0,0.0501666690213975,54.9629253122927,6.78102392044067
8.7,"max_tuv_SVM","SVM",50,13,2512,2481,31,1400,1045,355,0.919805194805206,0.677272727272727,1.68690942421465,659,316,343,18,1.1,35.79,2.9,0,0,0,0,0,0,0.0426651203674852,53.5720455961556,4.99725223063463
8.7,"max_tuv_SVM","SVM",50,14,2412,2388,24,1500,1138,362,0.933321114369518,0.677272727272727,1.75359865940511,676,327,349,17,1.1,38.34,3.1,0,0,0,0,0,0,0.0540675678016904,51.5169726659423,6.11732369566295
8.7,"max_tuv_SVM","SVM",50,15,2312,2290,22,1600,1236,364,0.936243192291591,0.677272727272727,1.77818181818182,688,333,355,12,1.1,40.9,3.4,0,0,0,0,0,0,0.0480063006450363,44.3293259337937,5.311503222481
8.7,"max_tuv_SVM","SVM",50,16,2212,2191,21,1700,1335,365,0.937167469627159,0.677272727272727,1.77491009450531,692,335,357,4,1.1,43.46,3.7,0,0,0,0,0,0,0.0440844229498592,39.4275334403543,4.81583020068601
8.7,"max_tuv_SVM","SVM",50,17,2112,2095,17,1800,1431,369,0.938378456221207,0.677272727272727,1.78473129080864,702,340,362,10,1.1,46.01,3.9,0,0,0,0,0,0,0.0438634074251543,33.3528779861028,5.10720210827134
8.7,"max_tuv_SVM","SVM",50,18,2012,1999,13,1900,1527,373,0.937890134059503,0.672727272727273,1.77165038817931,717,345,372,15,1.1,48.57,4.1,0,0,0,0,0,0,0.0359360699115971,28.8744014819402,4.59078429445401
8.7,"max_tuv_SVM","SVM",50,19,1912,1902,10,2000,1624,376,0.936614997905337,0.677272727272727,1.77818181818182,727,350,377,10,1.1,51.12,4.3,0,0,0,0,0,0,0.0263988057358799,24.1163357008198,3.23567255872659
8.7,"max_tuv_SVM","SVM",50,20,1812,1802,10,2100,1724,376,0.936713186007557,0.677272727272727,1.77654445002511,726,349,377,-1,1.1,53.68,4.6,0,0,0,0,0,0,0.0201942443054541,19.9224471408485,2.19482254081606
8.7,"max_tuv_SVM","SVM",50,21,1712,1704,8,2200,1822,378,0.937274821952253,0.672727272727273,1.79457059069962,740,356,384,14,1.1,56.24,4.8,0,0,0,0,0,0,0.0124052351388082,11.5364350282346,1.49917850102937
8.7,"max_tuv_SVM","SVM",50,22,1612,1605,7,2300,1921,379,0.936905634687905,0.668181818181818,1.79291813159216,741,359,382,1,1.1,58.79,5.1,0,0,0,0,0,0,0.0104574120363963,8.86115641263376,1.06627740159144
8.7,"max_tuv_SVM","SVM",50,23,1512,1505,7,2400,2021,379,0.937191034771694,0.672727272727273,1.78797896318557,751,365,386,10,1.1,61.35,5.3,0,0,0,0,0,0,0.00777181387235655,5.62223018637115,0.940937255677225
8.7,"max_tuv_SVM","SVM",50,24,1412,1405,7,2500,2121,379,0.937256493506508,0.672727272727273,1.79126871288785,749,365,384,-2,1.1,63.91,5.6,0,0,0,0,0,0,0.00515042209675138,3.98250605802181,0.57223758535068
8.7,"max_tuv_SVM","SVM",50,25,1312,1306,6,2600,2220,380,0.937170087976553,0.668181818181818,1.79126871288785,756,367,389,7,1.1,66.46,5.8,0,0,0,0,0,0,0.00530034277139784,3.80401705756255,0.551194976402003
8.7,"max_tuv_SVM","SVM",50,26,1212,1207,5,2700,2319,381,0.936988112693768,0.668181818181818,1.78633861551293,767,374,393,11,1.1,69.02,6.1,0,0,0,0,0,0,0.00403799657108072,2.71268456166637,0.468676226283279
8.7,"max_tuv_SVM","SVM",50,27,1112,1108,4,2800,2418,382,0.936599287808976,0.668181818181818,1.79126871288785,769,375,394,2,1.1,71.57,6.3,0,0,0,0,0,0,0.00369089464602789,2.3391465327851,0.388131315211696
8.7,"max_tuv_SVM","SVM",50,28,1012,1008,4,2900,2518,382,0.936501099706754,0.663636363636364,1.78962232620321,770,375,395,1,1.1,74.13,6.6,0,0,0,0,0,0,0.00374947724603331,2.23793458275848,0.395440666320915
8.7,"max_tuv_SVM","SVM",50,29,912,909,3,3000,2617,383,0.936021941767919,0.663636363636364,1.78962232620321,776,378,398,6,1.1,76.69,6.8,0,0,0,0,0,0,0.00329427166384104,1.75294542451732,0.346127648219544
8.7,"max_tuv_SVM","SVM",50,30,812,809,3,3100,2717,383,0.935968265605371,0.659090909090909,1.78797896318557,776,378,398,0,1.1,79.24,7.1,0,0,0,0,0,0,0.00227149616043887,1.06282473715704,0.240846849262336
8.7,"max_tuv_SVM","SVM",50,31,712,709,3,3200,2817,383,0.935986594051119,0.659090909090909,1.78797896318557,778,379,399,2,1.1,81.8,7.4,0,0,0,0,0,0,0.00189670157889239,0.779063332087465,0.202772972867031
8.7,"max_tuv_SVM","SVM",50,32,612,610,2,3300,2916,384,0.935875314201934,0.659090909090909,1.78962232620321,784,381,403,6,1.1,84.36,7.6,0,0,0,0,0,0,0.00177181187513216,0.686165982863835,0.19646222772373
8.7,"max_tuv_SVM","SVM",50,33,512,511,1,3400,3015,385,0.935981357352332,0.659090909090909,1.78797896318557,790,382,408,6,1.1,86.91,7.8,0,0,0,0,0,0,0.0013292896011597,0.473141157168391,0.151957129588826
8.7,"max_tuv_SVM","SVM",50,34,412,412,0,3500,3114,386,0.936577031839136,0.659090909090909,1.78633861551293,795,384,411,5,1.1,89.47,8.1,0,0,0,0,0,0,0.0012888164950132,0.386625945775453,0.144468540523551
8.7,"max_tuv_SVM","SVM",50,35,312,312,0,3600,3214,386,0.936625471302898,0.659090909090909,1.79457059069962,799,384,415,4,1.1,92.02,8.3,0,0,0,0,0,0,0.000731383565361558,0.182774152120361,0.0864670389445445
8.7,"max_tuv_SVM","SVM",50,36,212,212,0,3700,3314,386,0.936620234604113,0.659090909090909,1.79126871288785,801,385,416,2,1.1,94.58,8.6,0,0,0,0,0,0,0.000465381930391449,0.0987014306918434,0.0599542567823179
8.7,"max_tuv_SVM","SVM",50,37,112,112,0,3800,3414,386,0.936507645580233,0.659090909090909,1.79126871288785,799,385,414,-2,1.1,97.14,8.8,0,0,0,0,0,0,0.000263440395992463,0.0410591969457568,0.0381401716426846
8.7,"max_tuv_SVM","SVM",50,38,12,12,0,3900,3514,386,0.936654273146215,0.659090909090909,1.78633861551293,803,385,418,4,1.1,99.69,9.1,0,0,0,0,0,0,0.000192360531125912,0.00260513303575053,0.00260513303575053
8.7,"max_tuv_SVM","SVM",50,39,0,0,0,3912,3526,386,0.936647727272734,0.659090909090909,1.79291813159216,804,385,419,1,1.1,100,9.1,0,0,0,0,0,0,0,0,0
8.7,"max_tuv_SVM","SVM",51,0,3812,3421,391,100,90,10,0.882079926453187,0.492682926829268,1.70603124648758,35,10,25,0,2.5,2.56,9,0,0,0,0,0,0,0.281765652677818,372.651202437565,32.2397542202664
8.7,"max_tuv_SVM","SVM",51,1,3712,3378,334,200,133,67,0.917801674304587,0.6,1.76596146071958,108,53,55,73,1,5.11,2,0,0,0,0,0,0,0.757955251315456,403.188822555119,82.044917432229
8.7,"max_tuv_SVM","SVM",51,2,3612,3315,297,300,196,104,0.909554122383041,0.619512195121951,1.71728818114627,198,97,101,90,1,7.67,1.9,0,0,0,0,0,0,0.648395361562174,306.919745131224,73.3994837142734
8.7,"max_tuv_SVM","SVM",51,3,3512,3267,245,400,244,156,0.894134362245971,0.604878048780488,1.69411447932327,284,140,144,86,1,10.22,1.6,0,0,0,0,0,0,0.574077006336971,299.275943853918,75.0560733707065
8.7,"max_tuv_SVM","SVM",51,4,3412,3213,199,500,298,202,0.897501079522515,0.614634146341463,1.71324619323541,370,183,187,86,1,12.78,1.5,0,0,0,0,0,0,0.271605533709271,185.848594012081,70.3753282218858
8.7,"max_tuv_SVM","SVM",51,5,3312,3156,156,600,355,245,0.909258820743572,0.634146341463415,1.7236191974823,437,213,224,67,1.1,15.34,1.4,0,0,0,0,0,0,0.140789351532503,133.265899609499,48.6083355581049
8.7,"max_tuv_SVM","SVM",51,6,3212,3087,125,700,424,276,0.912353916229083,0.64390243902439,1.70695905124189,477,232,245,40,1.1,17.89,1.5,0,0,0,0,0,0,0.101914745405788,117.17697070331,35.5390142460404
8.7,"max_tuv_SVM","SVM",51,7,3112,3014,98,800,497,303,0.915645415163487,0.663414634146341,1.71009684361549,516,248,268,39,1.1,20.45,1.6,0,0,0,0,0,0,0.0890977974839178,116.9036480474,24.5424080021577
8.7,"max_tuv_SVM","SVM",51,8,3012,2936,76,900,575,325,0.916752796311533,0.68780487804878,1.69723727099022,559,268,291,43,1.1,23.01,1.8,0,0,0,0,0,0,0.0784525843195014,130.263234175892,20.6858657142093
8.7,"max_tuv_SVM","SVM",51,9,2912,2850,62,1000,661,339,0.910331378585064,0.702439024390244,1.65900329840465,597,285,312,38,1.1,25.56,1.9,0,0,0,0,0,0,0.0651739886462395,111.123199645357,17.1798454266247
8.7,"max_tuv_SVM","SVM",51,10,2812,2751,61,1100,760,340,0.919928681868221,0.697560975609756,1.70289227455292,611,297,314,14,1.1,28.12,2.2,0,0,0,0,0,0,0.0501539461309165,76.0678572118397,14.6240896825676
8.7,"max_tuv_SVM","SVM",51,11,2712,2661,51,1200,850,350,0.924308060899017,0.697560975609756,1.71728818114627,614,299,315,3,1.1,30.67,2.4,0,0,0,0,0,0,0.0465640754989494,69.1503997992615,6.8749589787215
8.7,"max_tuv_SVM","SVM",51,12,2612,2566,46,1300,945,355,0.931265757546227,0.707317073170732,1.73081794906347,630,305,325,16,1.1,33.23,2.7,0,0,0,0,0,0,0.0439952000688212,66.3072562252577,6.79577375809543
8.7,"max_tuv_SVM","SVM",51,13,2512,2475,37,1400,1036,364,0.939949297265676,0.697560975609756,1.74838970489152,661,319,342,31,1.1,35.79,2.8,0,0,0,0,0,0,0.0619026656973366,67.1512174807406,8.8604309817635
8.7,"max_tuv_SVM","SVM",51,14,2412,2378,34,1500,1133,367,0.94183114875124,0.68780487804878,1.76758907496909,677,323,354,16,1.1,38.34,3.1,0,0,0,0,0,0,0.0579471639403156,59.6059357470513,8.03602173674684
8.7,"max_tuv_SVM","SVM",51,15,2312,2282,30,1600,1229,371,0.941663996879842,0.682926829268293,1.7643368411605,690,329,361,13,1.1,40.9,3.3,0,0,0,0,0,0,0.0551723121738065,51.2371453297805,7.84452314846305
8.7,"max_tuv_SVM","SVM",51,16,2212,2188,24,1700,1323,377,0.940683372567602,0.682926829268293,1.76985822750789,708,337,371,18,1.1,43.46,3.5,0,0,0,0,0,0,0.0533079350463488,43.2702210249103,7.9606502106531
8.7,"max_tuv_SVM","SVM",51,17,2112,2092,20,1800,1419,381,0.940425680099186,0.68780487804878,1.77148493543759,717,342,375,9,1.1,46.01,3.7,0,0,0,0,0,0,0.0436566898649151,39.5273139341115,7.12729209356874
8.7,"max_tuv_SVM","SVM",51,18,2012,1997,15,1900,1514,386,0.939063392347239,0.682926829268293,1.76596146071958,733,347,386,16,1.1,48.57,3.9,0,0,0,0,0,0,0.0353180130778709,33.8161586401542,5.97914444927813
8.7,"max_tuv_SVM","SVM",51,19,1912,1900,12,2000,1611,389,0.938905991001666,0.682926829268293,1.76109655311429,735,349,386,2,1.1,51.12,4.1,0,0,0,0,0,0,0.0299859296353436,28.6839317838788,3.31825729028985
8.7,"max_tuv_SVM","SVM",51,20,1812,1802,10,2100,1709,391,0.939301583763988,0.68780487804878,1.76758907496909,738,352,386,3,1.1,53.68,4.4,0,0,0,0,0,0,0.0256456481704776,23.5022840332133,2.67559643799141
8.7,"max_tuv_SVM","SVM",51,21,1712,1702,10,2200,1809,391,0.939811396971772,0.682926829268293,1.77474733863361,748,358,390,10,1.1,56.24,4.6,0,0,0,0,0,0,0.0179910566132522,15.2549169641909,2.16523395904562
8.7,"max_tuv_SVM","SVM",51,22,1612,1604,8,2300,1907,393,0.940088590491851,0.682926829268293,1.77474733863361,755,362,393,7,1.1,58.79,4.9,0,0,0,0,0,0,0.0177988342371744,13.7282410181311,1.78922003048363
8.7,"max_tuv_SVM","SVM",51,23,1512,1504,8,2400,2007,393,0.939750107952256,0.673170731707317,1.78517702596381,772,374,398,17,1.1,61.35,5.1,0,0,0,0,0,0,0.0123146848456071,7.58843879555026,1.59567192206994
8.7,"max_tuv_SVM","SVM",51,24,1412,1407,5,2500,2104,396,0.939677675474648,0.673170731707317,1.78353321654763,780,378,402,8,1.1,63.91,5.3,0,0,0,0,0,0,0.00910287355238012,6.43695646402628,1.07136683483852
8.7,"max_tuv_SVM","SVM",51,25,1312,1307,5,2600,2204,396,0.939679068406909,0.673170731707317,1.78353321654763,780,378,402,0,1.1,66.46,5.6,0,0,0,0,0,0,0.00883292346220882,5.55459574530626,0.899365958834674
8.7,"max_tuv_SVM","SVM",51,26,1212,1207,5,2700,2304,396,0.939868507194499,0.663414634146341,1.77698814052361,786,383,403,6,1.1,69.02,5.8,0,0,0,0,0,0,0.00730107643411438,4.25128870758484,0.842323638260918
8.7,"max_tuv_SVM","SVM",51,27,1112,1107,5,2800,2404,396,0.940014765081978,0.663414634146341,1.78189243161981,786,382,404,0,1.1,71.57,6.1,0,0,0,0,0,0,0.00540615603820017,2.91250428421906,0.564790245367677
8.7,"max_tuv_SVM","SVM",51,28,1012,1007,5,2900,2504,396,0.939761251410348,0.658536585365854,1.78025466284075,786,385,401,0,1,74.13,6.3,0,0,0,0,0,0,0.00449567539924383,2.10635238383428,0.471881137403627
8.7,"max_tuv_SVM","SVM",51,29,912,907,5,3000,2604,396,0.939645638032626,0.658536585365854,1.78353321654763,788,385,403,2,1,76.69,6.6,0,0,0,0,0,0,0.00379470162761907,1.54549478735997,0.405522611989896
8.7,"max_tuv_SVM","SVM",51,30,812,808,4,3100,2703,397,0.940070482372446,0.658536585365854,1.79397100146117,792,388,404,4,1,79.24,6.8,0,0,0,0,0,0,0.00307041313898731,1.12759699420823,0.340389118312443
8.7,"max_tuv_SVM","SVM",51,31,712,709,3,3200,2802,398,0.94036856987645,0.658536585365854,1.79397100146117,797,389,408,5,1,81.8,7,0,0,0,0,0,0,0.00252551013504598,0.846737730599927,0.287561480995541
8.7,"max_tuv_SVM","SVM",51,32,612,610,2,3300,2901,399,0.940365784011926,0.653658536585366,1.79397100146117,800,391,409,3,1,84.36,7.3,0,0,0,0,0,0,0.00211618856374484,0.696776356207863,0.255609043021552
8.7,"max_tuv_SVM","SVM",51,33,512,510,2,3400,3001,399,0.940608154225462,0.653658536585366,1.78517702596381,802,391,411,2,1.1,86.91,7.5,0,0,0,0,0,0,0.0012759664001603,0.401462964446067,0.16158858362135
8.7,"max_tuv_SVM","SVM",51,34,412,411,1,3500,3100,400,0.940828237522811,0.653658536585366,1.78517702596381,806,393,413,4,1.1,89.47,7.8,0,0,0,0,0,0,0.000987101299193713,0.300345517867639,0.123746916514708
8.7,"max_tuv_SVM","SVM",51,35,312,312,0,3600,3199,401,0.94091738518756,0.658536585365854,1.78025466284075,812,396,416,6,1.1,92.02,8,0,0,0,0,0,0,0.000956476135584376,0.241569938522482,0.113379333892099
8.7,"max_tuv_SVM","SVM",51,36,212,212,0,3700,3299,401,0.940956387290888,0.653658536585366,1.78353321654763,815,398,417,3,1,94.58,8.2,0,0,0,0,0,0,0.000499832011031491,0.105167589038912,0.0649203985054125
8.7,"max_tuv_SVM","SVM",51,37,112,112,0,3800,3399,401,0.940998175258739,0.648780487804878,1.78189243161981,814,399,415,-1,1,97.14,8.5,0,0,0,0,0,0,0.000210603265356729,0.0332254286492601,0.0310550661742485
8.7,"max_tuv_SVM","SVM",51,38,12,12,0,3900,3499,401,0.940812915267932,0.648780487804878,1.78353321654763,820,400,420,6,1.1,99.69,8.7,0,0,0,0,0,0,0.000140854482357944,0.00191328194335638,0.00191328194335638
8.7,"max_tuv_SVM","SVM",51,39,0,0,0,3912,3511,401,0.940870025490662,0.648780487804878,1.78353321654763,820,400,420,0,1.1,100,8.8,0,0,0,0,0,0,0,0,0
8.7,"max_tuv_SVM","SVM",52,0,3812,3410,402,100,89,11,0.906750445983799,0.559585492227979,1.74961104212164,24,11,13,0,1.2,2.56,8.1,0,0,0,0,0,0,0.757039661687439,449.164763787727,80.5137498137845
8.7,"max_tuv_SVM","SVM",52,1,3712,3345,367,200,154,46,0.897704395769103,0.585492227979275,1.7216917169814,98,46,52,74,1.1,5.11,3.3,0,0,0,0,0,0,0.583114964516178,368.093482690787,64.1598329357504
8.7,"max_tuv_SVM","SVM",52,2,3612,3296,316,300,203,97,0.897013745411593,0.616580310880829,1.71869821637497,201,97,104,103,1.1,7.67,2.1,0,0,0,0,0,0,0.742764505466761,297.053818484632,81.9937243774014
8.7,"max_tuv_SVM","SVM",52,3,3512,3245,267,400,254,146,0.904898915238097,0.606217616580311,1.76215376255416,285,140,145,84,1,10.22,1.7,0,0,0,0,0,0,0.807375693072436,219.455043120666,86.5406810038969
8.7,"max_tuv_SVM","SVM",52,4,3412,3178,234,500,321,179,0.903358911887711,0.61139896373057,1.7325891496495,371,177,194,86,1.1,12.78,1.8,0,0,0,0,0,0,0.748953372330725,188.595736288471,82.8019810852468
8.7,"max_tuv_SVM","SVM",52,5,3312,3137,175,600,362,238,0.894483320059131,0.61139896373057,1.66585306670092,435,212,223,64,1.1,15.34,1.5,0,0,0,0,0,0,0.14137574456246,135.479781248855,60.3977615446103
8.7,"max_tuv_SVM","SVM",52,6,3212,3081,131,700,418,282,0.893469386555536,0.621761658031088,1.66265370931926,474,227,247,39,1.1,17.89,1.5,0,0,0,0,0,0,0.0950110916204668,111.730793865751,37.1561397390967
8.7,"max_tuv_SVM","SVM",52,7,3112,3012,100,800,487,313,0.894039540467707,0.637305699481865,1.65179057052071,525,254,271,51,1.1,20.45,1.6,0,0,0,0,0,0,0.079261635055233,125.154105935385,28.8774863993991
8.7,"max_tuv_SVM","SVM",52,8,3012,2932,80,900,567,333,0.903344217199246,0.658031088082902,1.66891811374177,564,271,293,39,1.1,23.01,1.7,0,0,0,0,0,0,0.0644297246124444,114.006038192125,21.0668645844254
8.7,"max_tuv_SVM","SVM",52,9,2912,2847,65,1000,652,348,0.916910353583593,0.652849740932642,1.69688880838549,592,286,306,28,1.1,25.56,1.9,0,0,0,0,0,0,0.0619726548495402,105.490852510463,15.6881336558793
8.7,"max_tuv_SVM","SVM",52,10,2812,2765,47,1100,734,366,0.92851034065228,0.652849740932642,1.73737971872687,622,299,323,30,1.1,28.12,2,0,0,0,0,0,0,0.0755417491947184,94.2029043844851,12.1739229961575
8.7,"max_tuv_SVM","SVM",52,11,2712,2668,44,1200,831,369,0.930003320999614,0.647668393782383,1.74672046990282,638,308,330,16,1.1,30.67,2.3,0,0,0,0,0,0,0.0617649323838,72.654679762579,10.2354678882048
8.7,"max_tuv_SVM","SVM",52,12,2612,2568,44,1300,931,369,0.929724121918914,0.647668393782383,1.74672046990282,641,311,330,3,1.1,33.23,2.5,0,0,0,0,0,0,0.0484619610012519,56.7260340602097,8.83126722458603
8.7,"max_tuv_SVM","SVM",52,13,2512,2477,35,1400,1022,378,0.930109122756519,0.647668393782383,1.75606122107877,661,322,339,20,1.1,35.79,2.7,0,0,0,0,0,0,0.0507707392538559,46.8537068020702,6.62331003759141
8.7,"max_tuv_SVM","SVM",52,14,2412,2382,30,1500,1117,383,0.929067269344854,0.647668393782383,1.75444422179601,678,326,352,17,1.1,38.34,2.9,0,0,0,0,0,0,0.046725297067203,44.6882225956491,6.3671272005519
8.7,"max_tuv_SVM","SVM",52,15,2312,2290,22,1600,1209,391,0.929092250315231,0.647668393782383,1.74961104212164,693,334,359,15,1.1,40.9,3.1,0,0,0,0,0,0,0.0401291653239365,40.1864955007608,5.68127598150147
8.7,"max_tuv_SVM","SVM",52,16,2212,2192,20,1700,1307,393,0.929794656423519,0.652849740932642,1.75891748383505,700,336,364,7,1.1,43.46,3.3,0,0,0,0,0,0,0.0296833670788123,34.6669896375316,4.32032473874113
8.7,"max_tuv_SVM","SVM",52,17,2112,2096,16,1800,1403,397,0.929480190090519,0.652849740932642,1.75121914050594,711,340,371,11,1.1,46.01,3.5,0,0,0,0,0,0,0.029355460888509,34.0825792497546,3.12596473212532
8.7,"max_tuv_SVM","SVM",52,18,2012,1996,16,1900,1503,397,0.92695564261345,0.637305699481865,1.76053413593417,725,348,377,14,1.1,48.57,3.8,0,0,0,0,0,0,0.0197627556561738,19.2320024367711,2.37518747853547
8.7,"max_tuv_SVM","SVM",52,19,1912,1900,12,2000,1599,401,0.927634537220207,0.637305699481865,1.76215376255416,736,353,383,11,1.1,51.12,4,0,0,0,0,0,0,0.0196852180810824,19.7796550852747,2.106222076155
8.7,"max_tuv_SVM","SVM",52,20,1812,1802,10,2100,1697,403,0.927321540356053,0.637305699481865,1.75730379807007,744,356,388,8,1.1,53.68,4.2,0,0,0,0,0,0,0.0174111381278867,17.5571598983443,1.83782308480587
8.7,"max_tuv_SVM","SVM",52,21,1712,1702,10,2200,1797,403,0.92517758531004,0.637305699481865,1.76377637191195,746,361,385,2,1.1,56.24,4.5,0,0,0,0,0,0,0.0121308644073102,10.8225445634973,1.4338839593737
8.7,"max_tuv_SVM","SVM",52,22,1612,1604,8,2300,1895,405,0.925493521111887,0.637305699481865,1.76053413593417,754,364,390,8,1.1,58.79,4.7,0,0,0,0,0,0,0.0121634965932292,11.1457189274173,1.2966756418415
8.7,"max_tuv_SVM","SVM",52,23,1512,1506,6,2400,1993,407,0.925018882674694,0.637305699481865,1.75283019767292,762,368,394,8,1.1,61.35,4.9,0,0,0,0,0,0,0.0107626598882691,9.38704444630238,1.16095436977473
8.7,"max_tuv_SVM","SVM",52,24,1412,1407,5,2500,2092,408,0.92575949497297,0.632124352331606,1.75283019767292,767,372,395,5,1.1,63.91,5.1,0,0,0,0,0,0,0.00837832673304643,6.67918715247799,0.887027987515009
8.7,"max_tuv_SVM","SVM",52,25,1312,1308,4,2600,2191,409,0.925862357792176,0.632124352331606,1.75283019767292,776,376,400,9,1.1,66.46,5.4,0,0,0,0,0,0,0.00722218939929358,5.22523527826403,0.760566448734528
8.7,"max_tuv_SVM","SVM",52,26,1212,1208,4,2700,2291,409,0.927043810744186,0.626943005181347,1.76377637191195,788,381,407,12,1.1,69.02,5.6,0,0,0,0,0,0,0.00615781612728482,4.10081136343764,0.673073916270079
8.7,"max_tuv_SVM","SVM",52,27,1112,1109,3,2800,2390,410,0.92731419301181,0.626943005181347,1.76540197225472,790,382,408,2,1.1,71.57,5.8,0,0,0,0,0,0,0.00560591880455366,3.22965698944165,0.568796322707481
8.7,"max_tuv_SVM","SVM",52,28,1012,1009,3,2900,2490,410,0.928115053532762,0.621761658031088,1.76377637191195,789,387,402,-1,1,74.13,6.1,0,0,0,0,0,0,0.00419158008989831,2.16010903146161,0.468030017489743
8.7,"max_tuv_SVM","SVM",52,29,912,909,3,3000,2590,410,0.928109175657377,0.621761658031088,1.76053413593417,790,387,403,1,1,76.69,6.3,0,0,0,0,0,0,0.00391029460941299,1.68278678894144,0.407123764609871
8.7,"max_tuv_SVM","SVM",52,30,812,809,3,3100,2690,410,0.929079025095593,0.626943005181347,1.76377637191195,793,388,405,3,1,79.24,6.6,0,0,0,0,0,0,0.00296103853807241,1.10203310653417,0.327824219225481
8.7,"max_tuv_SVM","SVM",52,31,712,709,3,3200,2790,410,0.929130456505194,0.626943005181347,1.75891748383505,794,389,405,1,1,81.8,6.8,0,0,0,0,0,0,0.00224351710940016,0.726734355907401,0.254205129715275
8.7,"max_tuv_SVM","SVM",52,32,612,611,1,3300,2888,412,0.929985687373441,0.621761658031088,1.76377637191195,804,394,410,10,1,84.36,7,0,0,0,0,0,0,0.00207994145174691,0.667674925265478,0.256430505497733
8.7,"max_tuv_SVM","SVM",52,33,512,511,1,3400,2988,412,0.930520574033304,0.616580310880829,1.76377637191195,807,395,412,3,1,86.91,7.3,0,0,0,0,0,0,0.001188027049836,0.393485019772048,0.159456571957602
8.7,"max_tuv_SVM","SVM",52,34,412,411,1,3500,3088,412,0.930870307618599,0.616580310880829,1.76377637191195,811,395,416,4,1.1,89.47,7.5,0,0,0,0,0,0,0.000684824529506638,0.19724246284915,0.0852064536090219
8.7,"max_tuv_SVM","SVM",52,35,312,312,0,3600,3187,413,0.931317026147718,0.626943005181347,1.76215376255416,813,397,416,2,1,92.02,7.7,0,0,0,0,0,0,0.000625084074392291,0.159146571593493,0.0775876429174001
8.7,"max_tuv_SVM","SVM",52,36,212,212,0,3700,3287,413,0.931437522593072,0.626943005181347,1.76215376255416,818,400,418,5,1,94.58,8,0,0,0,0,0,0,0.000334929735809498,0.0693060393331884,0.0426358267073901
8.7,"max_tuv_SVM","SVM",52,37,112,112,0,3800,3387,413,0.931503648691134,0.626943005181347,1.76377637191195,822,402,420,4,1,97.14,8.2,0,0,0,0,0,0,0.00016129372705426,0.0265325835521499,0.024785121915716
8.7,"max_tuv_SVM","SVM",52,38,12,12,0,3900,3487,413,0.931531568599207,0.626943005181347,1.76377637191195,822,403,419,0,1,99.69,8.4,0,0,0,0,0,0,0.000114915610338313,0.00161081123342045,0.00161081123342045
8.7,"max_tuv_SVM","SVM",52,39,0,0,0,3912,3499,413,0.931516873910749,0.626943005181347,1.76215376255416,821,403,418,-1,1,100,8.5,0,0,0,0,0,0,0,0,0
8.7,"max_tuv_SVM","SVM",53,0,3812,3416,396,100,83,17,0.909802532776505,0.533678756476684,1.75121914050594,38,17,21,0,1.2,2.56,4.9,0,0,0,0,0,0,0.918703796895496,718.127182779799,94.1830576139833
8.7,"max_tuv_SVM","SVM",53,1,3712,3334,378,200,165,35,0.900593371519953,0.55440414507772,1.74350663279168,88,35,53,50,1.5,5.11,4.7,0,0,0,0,0,0,0.690038203479625,462.153891544341,77.1124219545561
8.7,"max_tuv_SVM","SVM",53,2,3612,3288,324,300,211,89,0.892093963715899,0.606217616580311,1.65959454886053,189,88,101,101,1.1,7.67,2.4,0,0,0,0,0,0,0.72404446699391,409.622317279934,78.9263707385954
8.7,"max_tuv_SVM","SVM",53,3,3512,3230,282,400,269,131,0.899088635421843,0.632124352331606,1.66891811374177,272,131,141,83,1.1,10.22,2.1,0,0,0,0,0,0,0.752941098755458,376.736302393059,83.4969613377327
8.7,"max_tuv_SVM","SVM",53,4,3412,3174,238,500,325,175,0.885659159640159,0.652849740932642,1.64875419079549,360,175,185,88,1.1,12.78,1.9,0,0,0,0,0,0,0.726571254505236,337.868318532294,82.3233827226072
8.7,"max_tuv_SVM","SVM",53,5,3312,3110,202,600,389,211,0.879750425411227,0.66839378238342,1.61594995343951,432,208,224,72,1.1,15.34,1.8,0,0,0,0,0,0,0.733163304053692,350.162634632832,82.9678652068567
8.7,"max_tuv_SVM","SVM",53,6,3212,3050,162,700,449,251,0.893733890947777,0.678756476683938,1.63943919536727,508,242,266,76,1.1,17.89,1.8,0,0,0,0,0,0,0.184513900437479,253.887777241908,75.6261544457309
8.7,"max_tuv_SVM","SVM",53,7,3112,3008,104,800,491,309,0.890389379854752,0.683937823834197,1.62230028933558,560,268,292,52,1.1,20.45,1.6,0,0,0,0,0,0,0.115650816937792,205.05581102694,43.02457585209
8.7,"max_tuv_SVM","SVM",53,8,3012,2921,91,900,578,322,0.895015267781314,0.683937823834197,1.66585306670092,593,286,307,33,1.1,23.01,1.8,0,0,0,0,0,0,0.0849445150546171,155.891628820717,35.2034223464487
8.7,"max_tuv_SVM","SVM",53,9,2912,2841,71,1000,658,342,0.905333878016456,0.683937823834197,1.67208863855473,617,298,319,24,1.1,25.56,1.9,0,0,0,0,0,0,0.0782256664496928,142.550234636438,24.6176108031727
8.7,"max_tuv_SVM","SVM",53,10,2812,2752,60,1100,747,353,0.916907414645913,0.678756476683938,1.68601417250838,632,306,326,15,1.1,28.12,2.1,0,0,0,0,0,0,0.0650681496184452,105.588919559235,18.4256354880416
8.7,"max_tuv_SVM","SVM",53,11,2712,2664,48,1200,835,365,0.921089522981046,0.678756476683938,1.69688880838549,655,316,339,23,1.1,30.67,2.3,0,0,0,0,0,0,0.061033715578592,92.2222426548816,13.7672189071504
8.7,"max_tuv_SVM","SVM",53,12,2612,2569,43,1300,930,370,0.927446445207927,0.66839378238342,1.72803896755092,667,321,346,12,1.1,33.23,2.5,0,0,0,0,0,0,0.0586941213760263,80.6711583910479,13.4576447906173
8.7,"max_tuv_SVM","SVM",53,13,2512,2472,40,1400,1027,373,0.933056877261152,0.673575129533679,1.74350663279168,678,327,351,11,1.1,35.79,2.8,0,0,0,0,0,0,0.0541115416002979,70.1635277881695,13.0652385428267
8.7,"max_tuv_SVM","SVM",53,14,2412,2376,36,1500,1123,377,0.934056116076289,0.673575129533679,1.75606122107877,695,333,362,17,1.1,38.34,3,0,0,0,0,0,0,0.0502407475441275,65.852794359797,12.7978879288298
8.7,"max_tuv_SVM","SVM",53,15,2312,2281,31,1600,1218,382,0.93599581495273,0.66839378238342,1.74350663279168,713,340,373,18,1.1,40.9,3.2,0,0,0,0,0,0,0.0447581590058793,59.5472585646744,12.4021679901079
8.7,"max_tuv_SVM","SVM",53,16,2212,2186,26,1700,1313,387,0.936388163134558,0.66839378238342,1.74511207168007,725,347,378,12,1.1,43.46,3.4,0,0,0,0,0,0,0.0389488597717677,52.0370386896735,11.8477746145528
8.7,"max_tuv_SVM","SVM",53,17,2112,2092,20,1800,1407,393,0.937932574891485,0.678756476683938,1.74672046990282,737,354,383,12,1.1,46.01,3.6,0,0,0,0,0,0,0.0371707018096543,49.6868597269723,11.4458934605252
8.7,"max_tuv_SVM","SVM",53,18,2012,1996,16,1900,1503,397,0.938690820815918,0.683937823834197,1.75606122107877,740,354,386,3,1.1,48.57,3.8,0,0,0,0,0,0,0.0304651364669812,35.5177275798313,6.90481812482065
8.7,"max_tuv_SVM","SVM",53,19,1912,1900,12,2000,1599,401,0.939543112746469,0.66839378238342,1.76540197225472,761,368,393,21,1.1,51.12,4,0,0,0,0,0,0,0.0241897550825476,22.2645704323093,3.92718098490899
8.7,"max_tuv_SVM","SVM",53,20,1812,1801,11,2100,1698,402,0.939331509232675,0.66839378238342,1.76215376255416,764,369,395,3,1.1,53.68,4.2,0,0,0,0,0,0,0.0154136268517855,14.107049072817,1.70827561452932
8.7,"max_tuv_SVM","SVM",53,21,1712,1701,11,2200,1798,402,0.939046432276592,0.66839378238342,1.76377637191195,765,370,395,1,1.1,56.24,4.5,0,0,0,0,0,0,0.0145945736729797,12.4271498089169,1.48353734938715
8.7,"max_tuv_SVM","SVM",53,22,1612,1601,11,2300,1898,402,0.93910814996812,0.663212435233161,1.77474272343067,776,376,400,11,1.1,58.79,4.7,0,0,0,0,0,0,0.010733767406063,7.64981444720156,1.30377680053783
8.7,"max_tuv_SVM","SVM",53,23,1512,1505,7,2400,1994,406,0.939548990621859,0.663212435233161,1.7714773274354,781,380,401,5,1.1,61.35,4.9,0,0,0,0,0,0,0.00939633427804414,7.41974763642574,1.04535764765847
8.7,"max_tuv_SVM","SVM",53,24,1412,1406,6,2500,2093,407,0.939516662307251,0.66839378238342,1.77474272343067,788,381,407,7,1.1,63.91,5.1,0,0,0,0,0,0,0.00860792977456122,6.1107571264584,0.884966451846388
8.7,"max_tuv_SVM","SVM",53,25,1312,1308,4,2600,2191,409,0.939957502960987,0.652849740932642,1.77474272343067,798,390,408,10,1,66.46,5.4,0,0,0,0,0,0,0.00714923570023713,4.72691656398612,0.768815690033208
8.7,"max_tuv_SVM","SVM",53,26,1212,1208,4,2700,2291,409,0.940033915340968,0.647668393782383,1.77474272343067,798,390,408,0,1,69.02,5.6,0,0,0,0,0,0,0.00614425900896481,3.57572790145059,0.63417523604392
8.7,"max_tuv_SVM","SVM",53,27,1112,1108,4,2800,2391,409,0.940042732154043,0.647668393782383,1.77474272343067,804,392,412,6,1.1,71.57,5.8,0,0,0,0,0,0,0.005682624120378,2.94066917663179,0.596519938900696
8.7,"max_tuv_SVM","SVM",53,28,1012,1009,3,2900,2490,410,0.940051548967117,0.647668393782383,1.77474272343067,814,395,419,10,1.1,74.13,6.1,0,0,0,0,0,0,0.00528201453410402,2.39684147429322,0.553381090584264
8.7,"max_tuv_SVM","SVM",53,29,912,910,2,3000,2589,411,0.940377771050882,0.647668393782383,1.77474272343067,818,396,422,4,1.1,76.69,6.3,0,0,0,0,0,0,0.00467194395994945,1.98952613315279,0.50742143579529
8.7,"max_tuv_SVM","SVM",53,30,812,810,2,3100,2689,411,0.940662848006966,0.647668393782383,1.77474272343067,818,397,421,0,1.1,79.24,6.5,0,0,0,0,0,0,0.00369107051871235,1.3877614137515,0.403501570521644
8.7,"max_tuv_SVM","SVM",53,31,712,710,2,3200,2789,411,0.940565863063144,0.647668393782383,1.77474272343067,817,397,420,-1,1.1,81.8,6.8,0,0,0,0,0,0,0.00273460142039763,0.927314283279868,0.30939775995016
8.7,"max_tuv_SVM","SVM",53,32,612,610,2,3300,2889,411,0.940637867036589,0.647668393782383,1.77310852202788,818,397,421,1,1.1,84.36,7,0,0,0,0,0,0,0.00186391853718692,0.628019878669282,0.235755093978171
8.7,"max_tuv_SVM","SVM",53,33,512,510,2,3400,2989,411,0.940649622787356,0.647668393782383,1.77310852202788,818,399,419,0,1.1,86.91,7.3,0,0,0,0,0,0,0.00124289224345587,0.390868177649258,0.153057931271933
8.7,"max_tuv_SVM","SVM",53,34,412,412,0,3500,3087,413,0.940821550642317,0.652849740932642,1.76822392554847,833,403,430,15,1.1,89.47,7.5,0,0,0,0,0,0,0.00124942307713058,0.374921515665764,0.150602564049155
8.7,"max_tuv_SVM","SVM",53,35,312,312,0,3600,3187,413,0.941268269171438,0.652849740932642,1.76984913136239,836,405,431,3,1.1,92.02,7.7,0,0,0,0,0,0,0.000811236892108032,0.202313170034439,0.0971478080444784
8.7,"max_tuv_SVM","SVM",53,36,212,212,0,3700,3287,413,0.941672373104033,0.652849740932642,1.76984913136239,839,405,434,3,1.1,94.58,8,0,0,0,0,0,0,0.000412302677372198,0.0857773579892369,0.0541146966719746
8.7,"max_tuv_SVM","SVM",53,37,112,112,0,3800,3387,413,0.942155828354301,0.652849740932642,1.77474272343067,841,407,434,2,1.1,97.14,8.2,0,0,0,0,0,0,0.000157685254006816,0.0252867128650706,0.023589777583587
8.7,"max_tuv_SVM","SVM",53,38,12,12,0,3900,3487,413,0.942135255790459,0.658031088082902,1.76822392554847,840,408,432,-1,1.1,99.69,8.4,0,0,0,0,0,0,0.000106557073729531,0.00149236060152037,0.00149236060152037
8.7,"max_tuv_SVM","SVM",53,39,0,0,0,3912,3499,413,0.942113213757772,0.658031088082902,1.77310852202788,840,408,432,0,1.1,100,8.5,0,0,0,0,0,0,0,0,0
8.7,"max_tuv_SVM","SVM",54,0,3812,3414,398,100,92,8,0.864161446469255,0.515,1.67785321100917,22,8,14,0,1.8,2.56,11.5,0,0,0,0,0,0,0.5,297.763357953031,58.0653463763868
8.7,"max_tuv_SVM","SVM",54,1,3712,3380,332,200,126,74,0.89936645785878,0.545,1.73487132352941,99,50,49,77,1,5.11,1.7,0,0,0,0,0,0,0.745194803389875,317.080438959116,82.5626856604542
8.7,"max_tuv_SVM","SVM",54,2,3612,3319,293,300,187,113,0.895108200455595,0.56,1.73806629834254,185,92,93,86,1,7.67,1.7,0,0,0,0,0,0,0.704294514592377,289.044797619518,80.7004942671782
8.7,"max_tuv_SVM","SVM",54,3,3512,3271,241,400,235,165,0.883516514806379,0.565,1.69303867403315,265,133,132,80,1,10.22,1.4,0,0,0,0,0,0,0.605216025645152,228.781109478943,77.2672069084571
8.7,"max_tuv_SVM","SVM",54,4,3412,3213,199,500,293,207,0.873248861047832,0.585,1.64649494020239,350,170,180,85,1.1,12.78,1.4,0,0,0,0,0,0,0.256522314920804,162.970013082155,73.0049407566843
8.7,"max_tuv_SVM","SVM",54,5,3312,3162,150,600,344,256,0.871230068337121,0.585,1.64801104972376,397,194,203,47,1,15.34,1.3,0,0,0,0,0,0,0.100710890509287,84.1701592362171,41.6134973493943
8.7,"max_tuv_SVM","SVM",54,6,3212,3089,123,700,417,283,0.870223519362185,0.6,1.60607339449541,438,210,228,41,1.1,17.89,1.5,0,0,0,0,0,0,0.0773614157229078,87.7090848985465,30.7424803104638
8.7,"max_tuv_SVM","SVM",54,7,3112,3018,94,800,488,312,0.871005125284739,0.62,1.61198895027624,485,231,254,47,1.1,20.45,1.6,0,0,0,0,0,0,0.0784783454249669,121.777620680694,22.4649642183897
8.7,"max_tuv_SVM","SVM",54,8,3012,2929,83,900,577,323,0.871134681093393,0.62,1.61198895027624,516,243,273,31,1.1,23.01,1.8,0,0,0,0,0,0,0.056315150945322,95.2077035096491,18.8340410849809
8.7,"max_tuv_SVM","SVM",54,9,2912,2843,69,1000,663,337,0.88565774487472,0.62,1.64347107438017,541,259,282,25,1.1,25.56,2,0,0,0,0,0,0,0.0517282308520115,87.9141724813713,16.7272522709927
8.7,"max_tuv_SVM","SVM",54,10,2812,2754,58,1100,752,348,0.907455865603645,0.615,1.69891544117647,592,285,307,51,1.1,28.12,2.2,0,0,0,0,0,0,0.0430279486965326,64.3668505801264,15.39671763686
8.7,"max_tuv_SVM","SVM",54,11,2712,2666,46,1200,840,360,0.911537585421411,0.615,1.73065437788018,602,289,313,10,1.1,30.67,2.3,0,0,0,0,0,0,0.0417681497015271,63.186156905945,7.35030659714451
8.7,"max_tuv_SVM","SVM",54,12,2612,2571,41,1300,935,365,0.917018792710718,0.61,1.69735537190083,618,297,321,16,1.1,33.23,2.6,0,0,0,0,0,0,0.0557723595290523,62.5469209179267,9.00986570872412
8.7,"max_tuv_SVM","SVM",54,13,2512,2478,34,1400,1028,372,0.920122437357656,0.615,1.7126267281106,637,308,329,19,1.1,35.79,2.8,0,0,0,0,0,0,0.0520683185038235,50.1112753524558,8.68435704509768
8.7,"max_tuv_SVM","SVM",54,14,2412,2384,28,1500,1122,378,0.920454157175423,0.615,1.72005524861878,655,316,339,18,1.1,38.34,3,0,0,0,0,0,0,0.0503877927748002,44.8884060901044,8.33431241151768
8.7,"max_tuv_SVM","SVM",54,15,2312,2290,22,1600,1216,384,0.920116742596831,0.615,1.73065437788018,674,324,350,19,1.1,40.9,3.2,0,0,0,0,0,0,0.0504162381943912,42.1859299026685,8.66101345833313
8.7,"max_tuv_SVM","SVM",54,16,2212,2195,17,1700,1311,389,0.920205011389543,0.61,1.73065437788018,684,329,355,10,1.1,43.46,3.4,0,0,0,0,0,0,0.0394796670057543,36.0050503941002,7.64961826133949
8.7,"max_tuv_SVM","SVM",54,17,2112,2099,13,1800,1407,393,0.91984624145788,0.62,1.73065437788018,693,332,361,9,1.1,46.01,3.6,0,0,0,0,0,0,0.0255156979741086,30.2276756664234,6.16985666606196
8.7,"max_tuv_SVM","SVM",54,18,2012,2001,11,1900,1505,395,0.919638382687948,0.615,1.72906077348066,697,334,363,4,1.1,48.57,3.8,0,0,0,0,0,0,0.0267795658529858,27.6832774291655,4.58538400545385
8.7,"max_tuv_SVM","SVM",54,19,1912,1901,11,2000,1605,395,0.918758542141249,0.585,1.76183823529412,731,355,376,34,1.1,51.12,4.1,0,0,0,0,0,0,0.0181277567456616,12.057305258074,4.42519569946993
8.7,"max_tuv_SVM","SVM",54,20,1812,1803,9,2100,1703,397,0.918853929384985,0.585,1.76183823529412,730,355,375,-1,1.1,53.68,4.3,0,0,0,0,0,0,0.011408895014035,7.63543174019155,1.46109847239312
8.7,"max_tuv_SVM","SVM",54,21,1712,1704,8,2200,1802,398,0.91878701594535,0.58,1.76183823529412,732,354,378,2,1.1,56.24,4.5,0,0,0,0,0,0,0.00825166089164647,6.19691455474308,0.947466573695526
8.7,"max_tuv_SVM","SVM",54,22,1612,1606,6,2300,1900,400,0.919178530751729,0.58,1.76183823529412,741,357,384,9,1.1,58.79,4.8,0,0,0,0,0,0,0.00786290818660536,6.21410704382931,0.867500848656025
8.7,"max_tuv_SVM","SVM",54,23,1512,1506,6,2400,2000,400,0.919168564920294,0.58,1.76508287292818,739,359,380,-2,1.1,61.35,5,0,0,0,0,0,0,0.00619211432568011,4.55284498041424,0.639554069474127
8.7,"max_tuv_SVM","SVM",54,24,1412,1407,5,2500,2099,401,0.918200455580883,0.585,1.76345906163753,752,366,386,13,1.1,63.91,5.2,0,0,0,0,0,0,0.0055995061132929,3.56269963376045,0.585636285903909
8.7,"max_tuv_SVM","SVM",54,25,1312,1307,5,2600,2199,401,0.918532175398651,0.58,1.76508287292818,759,370,389,7,1.1,66.46,5.5,0,0,0,0,0,0,0.00404991129655146,2.41695998361246,0.461344247140331
8.7,"max_tuv_SVM","SVM",54,26,1212,1208,4,2700,2298,402,0.919083143507989,0.585,1.76345906163753,762,372,390,3,1,69.02,5.7,0,0,0,0,0,0,0.00396112158005042,2.12450916978692,0.41503921445416
8.7,"max_tuv_SVM","SVM",54,27,1112,1108,4,2800,2398,402,0.919179954441929,0.585,1.76022038567493,766,374,392,4,1,71.57,6,0,0,0,0,0,0,0.00334234153578816,1.59698888916809,0.354847135189759
8.7,"max_tuv_SVM","SVM",54,28,1012,1009,3,2900,2497,403,0.919449031890675,0.585,1.76508287292818,770,376,394,4,1,74.13,6.2,0,0,0,0,0,0,0.00306328484268268,1.3609292224497,0.331425099744952
8.7,"max_tuv_SVM","SVM",54,29,912,910,2,3000,2596,404,0.919712414578603,0.585,1.77408839779006,772,377,395,2,1,76.69,6.4,0,0,0,0,0,0,0.0027643227887208,1.11171176806262,0.301104164726261
8.7,"max_tuv_SVM","SVM",54,30,812,810,2,3100,2696,404,0.919732346241473,0.585,1.77408839779006,775,378,397,3,1.1,79.24,6.7,0,0,0,0,0,0,0.00234511142226129,0.852973591618795,0.260722731579169
8.7,"max_tuv_SVM","SVM",54,31,712,710,2,3200,2796,404,0.919824886104798,0.585,1.77408839779006,775,378,397,0,1.1,81.8,6.9,0,0,0,0,0,0,0.00175618915603829,0.559392930474992,0.199156558421145
8.7,"max_tuv_SVM","SVM",54,32,612,610,2,3300,2896,404,0.919937357630994,0.585,1.77572350230415,773,378,395,-2,1,84.36,7.2,0,0,0,0,0,0,0.00110266602844713,0.346695372294231,0.141447448921756
8.7,"max_tuv_SVM","SVM",54,33,512,510,2,3400,2996,404,0.920029897494319,0.585,1.77408839779006,776,379,397,3,1,86.91,7.4,0,0,0,0,0,0,0.000737204921185786,0.23265780288734,0.0957726658724134
8.7,"max_tuv_SVM","SVM",54,34,412,412,0,3500,3094,406,0.920612186788167,0.585,1.77082720588235,784,384,400,8,1,89.47,7.6,0,0,0,0,0,0,0.000610090134674521,0.190488605256701,0.077907436003644
8.7,"max_tuv_SVM","SVM",54,35,312,312,0,3600,3194,406,0.920459851936229,0.585,1.77408839779006,787,385,402,3,1,92.02,7.9,0,0,0,0,0,0,0.000402785575926806,0.104648808171094,0.0495862619288334
8.7,"max_tuv_SVM","SVM",54,36,212,212,0,3700,3294,406,0.920797266514816,0.585,1.77572350230415,790,387,403,3,1,94.58,8.1,0,0,0,0,0,0,0.000257118962212658,0.0532370143327524,0.0329464291275832
8.7,"max_tuv_SVM","SVM",54,37,112,112,0,3800,3394,406,0.921205865603653,0.585,1.77408839779006,797,390,407,7,1,97.14,8.4,0,0,0,0,0,0,0.000122723681526016,0.021793986681822,0.0204940981680796
8.7,"max_tuv_SVM","SVM",54,38,12,12,0,3900,3494,406,0.921267084282469,0.585,1.76920110192837,804,391,413,7,1.1,99.69,8.6,0,0,0,0,0,0,8.42989548164727e-05,0.00119532362284165,0.00119532362284165
8.7,"max_tuv_SVM","SVM",54,39,0,0,0,3912,3506,406,0.921210136674269,0.585,1.77245630174793,804,391,413,0,1.1,100,8.6,0,0,0,0,0,0,0,0,0
8.7,"max_tuv_SVM","SVM",55,0,3812,3396,416,100,91,9,0.876347365963746,0.513812154696133,1.7183336041599,25,9,16,0,1.8,2.56,10.1,0,0,0,0,0,0,0.422029551268737,372.041256197126,50.5409237027617
8.7,"max_tuv_SVM","SVM",55,1,3712,3327,385,200,160,40,0.874688351101091,0.574585635359116,1.61900796230094,90,40,50,65,1.2,5.11,4,0,0,0,0,0,0,0.708475424338891,403.30207465551,76.2384302400811
8.7,"max_tuv_SVM","SVM",55,2,3612,3287,325,300,200,100,0.873475994086068,0.569060773480663,1.64729160007914,177,86,91,87,1.1,7.67,2,0,0,0,0,0,0,0.689499937690491,289.977108505822,80.2709775999505
8.7,"max_tuv_SVM","SVM",55,3,3512,3234,278,400,253,147,0.862933623842515,0.61878453038674,1.61055568826971,272,135,137,95,1,10.22,1.7,0,0,0,0,0,0,0.716763940212039,230.585846827841,82.5759150603757
8.7,"max_tuv_SVM","SVM",55,4,3412,3183,229,500,304,196,0.872808341763294,0.613259668508287,1.63194041695919,367,181,186,95,1,12.78,1.6,0,0,0,0,0,0,0.62696753762405,239.991798594335,81.5568285831689
8.7,"max_tuv_SVM","SVM",55,5,3312,3123,189,600,364,236,0.874238580655209,0.624309392265193,1.62198956075822,429,212,217,62,1,15.34,1.5,0,0,0,0,0,0,0.217732121163153,173.56719907464,73.4891063770201
8.7,"max_tuv_SVM","SVM",55,6,3212,3051,161,700,436,264,0.873868181464485,0.629834254143646,1.62348448201237,483,235,248,54,1.1,17.89,1.7,0,0,0,0,0,0,0.116328853594546,128.673119900581,57.5971815068179
8.7,"max_tuv_SVM","SVM",55,7,3112,3003,109,800,484,316,0.862155474282158,0.668508287292818,1.58364437202434,525,251,274,42,1.1,20.45,1.5,0,0,0,0,0,0,0.0949491839226909,148.657434818878,36.0595820869743
8.7,"max_tuv_SVM","SVM",55,8,3012,2923,89,900,564,336,0.869961870671554,0.646408839779006,1.58775093983532,576,277,299,51,1.1,23.01,1.7,0,0,0,0,0,0,0.0735929148762202,127.895737662656,33.0361104047737
8.7,"max_tuv_SVM","SVM",55,9,2912,2844,68,1000,643,357,0.877603299354142,0.651933701657459,1.60907539811505,608,293,315,32,1.1,25.56,1.8,0,0,0,0,0,0,0.0652200935809022,117.847357207834,22.8577954973131
8.7,"max_tuv_SVM","SVM",55,10,2812,2757,55,1100,730,370,0.886804139755663,0.646408839779006,1.62348448201237,625,302,323,17,1.1,28.12,2,0,0,0,0,0,0,0.0619397423413171,105.165098578959,18.0888208688156
8.7,"max_tuv_SVM","SVM",55,11,2712,2663,49,1200,824,376,0.890956345809668,0.640883977900553,1.63887309067273,645,314,331,20,1.1,30.67,2.2,0,0,0,0,0,0,0.0542309282145811,91.453208198785,16.4837384878655
8.7,"max_tuv_SVM","SVM",55,12,2612,2571,41,1300,916,384,0.912844136643076,0.640883977900553,1.70159641036598,668,324,344,23,1.1,33.23,2.4,0,0,0,0,0,0,0.0438536119613847,58.2734038636083,10.5713863728359
8.7,"max_tuv_SVM","SVM",55,13,2512,2482,30,1400,1005,395,0.917318496615063,0.629834254143646,1.68853591160221,683,329,354,15,1.1,35.79,2.5,0,0,0,0,0,0,0.0384518470187494,53.4805289599022,4.28876250350607
8.7,"max_tuv_SVM","SVM",55,14,2412,2386,26,1500,1101,399,0.924202007625873,0.629834254143646,1.70997270606413,696,336,360,13,1.1,38.34,2.8,0,0,0,0,0,0,0.0439271238754618,51.7476843404702,5.16850946998107
8.7,"max_tuv_SVM","SVM",55,15,2312,2289,23,1600,1198,402,0.930386740331502,0.635359116022099,1.76637292056679,710,343,367,14,1.1,40.9,3,0,0,0,0,0,0,0.0470013180868789,45.5870141094313,5.31374594911916
8.7,"max_tuv_SVM","SVM",55,16,2212,2192,20,1700,1295,405,0.932422379581361,0.629834254143646,1.76962291674079,722,347,375,12,1.1,43.46,3.2,0,0,0,0,0,0,0.0413920675808665,35.1595260893822,4.61714991979339
8.7,"max_tuv_SVM","SVM",55,17,2112,2097,15,1800,1390,410,0.933381059839708,0.629834254143646,1.78120325997375,740,355,385,18,1.1,46.01,3.4,0,0,0,0,0,0,0.0397204696631314,31.0761678177066,4.79553558938561
8.7,"max_tuv_SVM","SVM",55,18,2012,2002,10,1900,1485,415,0.933928877130191,0.624309392265193,1.7728848944675,750,364,386,10,1.1,48.57,3.6,0,0,0,0,0,0,0.0318179469797132,27.2758809358108,4.06666686182677
8.7,"max_tuv_SVM","SVM",55,19,1912,1905,7,2000,1582,418,0.934090732238741,0.61878453038674,1.7728848944675,756,366,390,6,1.1,51.12,3.8,0,0,0,0,0,0,0.0251906618832694,23.3373182447493,2.89303340447707
8.7,"max_tuv_SVM","SVM",55,20,1812,1806,6,2100,1681,419,0.934285269628828,0.624309392265193,1.77125240377278,760,367,393,4,1.1,53.68,4,0,0,0,0,0,0,0.0214966826738893,20.448006503718,2.33443475401708
8.7,"max_tuv_SVM","SVM",55,21,1712,1706,6,2200,1781,419,0.934566959769673,0.61878453038674,1.78120325997375,761,367,394,1,1.1,56.24,4.3,0,0,0,0,0,0,0.0161565795240476,15.2940450247243,1.72981537028935
8.7,"max_tuv_SVM","SVM",55,22,1612,1606,6,2300,1881,419,0.934615205042415,0.61878453038674,1.78120325997375,760,367,393,-1,1.1,58.79,4.5,0,0,0,0,0,0,0.0151006677705602,13.3460334678959,1.53507394795203
8.7,"max_tuv_SVM","SVM",55,23,1512,1506,6,2400,1981,419,0.93436464088398,0.624309392265193,1.78786155346116,779,379,400,19,1.1,61.35,4.7,0,0,0,0,0,0,0.0108845171973686,7.34478301000405,1.35392125729045
8.7,"max_tuv_SVM","SVM",55,24,1412,1406,6,2500,2081,419,0.934537390086377,0.624309392265193,1.79115411617472,778,379,399,-1,1.1,63.91,5,0,0,0,0,0,0,0.00787720233684088,5.99709379045965,0.92151254644701
8.7,"max_tuv_SVM","SVM",55,25,1312,1307,5,2600,2180,420,0.93465722511867,0.624309392265193,1.78458107354656,781,380,401,3,1.1,66.46,5.2,0,0,0,0,0,0,0.00638661513279582,4.81698423700886,0.674841219954475
8.7,"max_tuv_SVM","SVM",55,26,1212,1207,5,2700,2280,420,0.934937358960394,0.624309392265193,1.78786155346116,792,385,407,11,1.1,69.02,5.4,0,0,0,0,0,0,0.00486851858188361,3.37915676243043,0.532052687697824
8.7,"max_tuv_SVM","SVM",55,27,1112,1107,5,2800,2380,420,0.935055637693566,0.624309392265193,1.79944802207912,795,386,409,3,1.1,71.57,5.7,0,0,0,0,0,0,0.00453859559732834,2.81874695277374,0.470015038369447
8.7,"max_tuv_SVM","SVM",55,28,1012,1007,5,2900,2480,420,0.935117889658394,0.61878453038674,1.78950632029967,800,392,408,5,1,74.13,5.9,0,0,0,0,0,0,0.00332505374440081,1.85613021570607,0.362711004848319
8.7,"max_tuv_SVM","SVM",55,29,912,908,4,3000,2579,421,0.93574040930667,0.61878453038674,1.79944802207912,805,394,411,5,1,76.69,6.1,0,0,0,0,0,0,0.00360050403366687,1.76717060336445,0.372433292719665
8.7,"max_tuv_SVM","SVM",55,30,812,809,3,3100,2678,422,0.935970741576533,0.61878453038674,1.80276497695853,815,397,418,10,1.1,79.24,6.3,0,0,0,0,0,0,0.00321170194755805,1.35547111924275,0.338154852616327
8.7,"max_tuv_SVM","SVM",55,31,712,709,3,3200,2778,422,0.935880476227533,0.624309392265193,1.80276497695853,816,397,419,1,1.1,81.8,6.6,0,0,0,0,0,0,0.00254632852500955,0.885362991731269,0.268659292800301
8.7,"max_tuv_SVM","SVM",55,32,612,609,3,3300,2878,422,0.935992529764222,0.624309392265193,1.80276497695853,817,399,418,1,1,84.36,6.8,0,0,0,0,0,0,0.00207160870998734,0.632924542546843,0.236926995647862
8.7,"max_tuv_SVM","SVM",55,33,512,509,3,3400,2978,422,0.935880476227532,0.624309392265193,1.80276497695853,817,398,419,0,1.1,86.91,7.1,0,0,0,0,0,0,0.00121798743071634,0.368704419216263,0.156040102359279
8.7,"max_tuv_SVM","SVM",55,34,412,411,1,3500,3076,424,0.936397167535601,0.624309392265193,1.80110497237569,827,403,424,10,1.1,89.47,7.3,0,0,0,0,0,0,0.00104170902924323,0.315909723141912,0.131153531850336
8.7,"max_tuv_SVM","SVM",55,35,312,312,0,3600,3175,425,0.936549684849429,0.61878453038674,1.80276497695853,834,407,427,7,1,92.02,7.5,0,0,0,0,0,0,0.000948592891684397,0.244872826706025,0.113776578241422
8.7,"max_tuv_SVM","SVM",55,36,212,212,0,3700,3275,425,0.936692864368533,0.61878453038674,1.80110497237569,841,408,433,7,1.1,94.58,7.7,0,0,0,0,0,0,0.000565381669611932,0.118275228707963,0.0720015871975661
8.7,"max_tuv_SVM","SVM",55,37,112,112,0,3800,3375,425,0.936688195471171,0.61878453038674,1.79779411764706,843,409,434,2,1.1,97.14,7.9,0,0,0,0,0,0,0.000217354295734734,0.0338227628244534,0.0316140167976583
8.7,"max_tuv_SVM","SVM",55,38,12,12,0,3900,3475,425,0.936689751770292,0.61878453038674,1.79449541284404,843,409,434,0,1.1,99.69,8.2,0,0,0,0,0,0,0.00014794232507235,0.00243188615645653,0.00243188615645653
8.7,"max_tuv_SVM","SVM",55,39,0,0,0,3912,3487,425,0.936688195471171,0.61878453038674,1.79779411764706,843,409,434,0,1.1,100,8.2,0,0,0,0,0,0,0,0,0
8.7,"max_tuv_SVM","SVM",56,0,3812,3412,400,100,87,13,0.877078931049587,0.393782383419689,1.72803896755092,38,13,25,0,1.9,2.56,6.7,0,0,0,0,0,0,0.18493387509154,508.241866409453,21.3736075438508
8.7,"max_tuv_SVM","SVM",56,1,3712,3357,355,200,142,58,0.894644961632159,0.559585492227979,1.73393569061716,110,51,59,72,1.2,5.11,2.4,0,0,0,0,0,0,0.708600522964726,593.937706826005,77.2286088157387
8.7,"max_tuv_SVM","SVM",56,2,3612,3304,308,300,195,105,0.907250065391375,0.606217616580311,1.72327415422127,198,96,102,88,1.1,7.67,1.9,0,0,0,0,0,0,0.653757012015014,545.899377591788,71.9823516556587
8.7,"max_tuv_SVM","SVM",56,3,3512,3239,273,400,260,140,0.891611977934467,0.595854922279793,1.66598055220385,280,136,144,82,1.1,10.22,1.9,0,0,0,0,0,0,0.523534606703509,593.271016714412,61.1590744490478
8.7,"max_tuv_SVM","SVM",56,4,3412,3198,214,500,301,199,0.892489250835415,0.637305699481865,1.64271479815521,350,173,177,70,1,12.78,1.5,0,0,0,0,0,0,0.518225766886427,398.157807100754,68.1328232607041
8.7,"max_tuv_SVM","SVM",56,5,3312,3144,168,600,355,245,0.904317005575168,0.663212435233161,1.63943919536727,444,218,226,94,1,15.34,1.4,0,0,0,0,0,0,0.286696426740573,329.605024332907,62.6370440159321
8.7,"max_tuv_SVM","SVM",56,6,3212,3090,122,700,409,291,0.906985560999132,0.647668393782383,1.68911917098446,516,251,265,72,1.1,17.89,1.4,0,0,0,0,0,0,0.215171552535211,270.252298027455,52.4088534337239
8.7,"max_tuv_SVM","SVM",56,7,3112,3024,88,800,475,325,0.894724312949847,0.663212435233161,1.64094741909805,578,276,302,62,1.1,20.45,1.5,0,0,0,0,0,0,0.117326350283473,185.338261974512,36.0155064579658
8.7,"max_tuv_SVM","SVM",56,8,3012,2945,67,900,554,346,0.906982622061441,0.658031088082902,1.66112272063665,610,289,321,32,1.1,23.01,1.6,0,0,0,0,0,0,0.0923671564329137,159.46052605109,24.2979066001126
8.7,"max_tuv_SVM","SVM",56,9,2912,2852,60,1000,647,353,0.913251376157576,0.652849740932642,1.67978702086852,617,294,323,7,1.1,25.56,1.8,0,0,0,0,0,0,0.0660044113086482,118.709775287108,19.3395573341062
8.7,"max_tuv_SVM","SVM",56,10,2812,2762,50,1100,737,363,0.927931369927032,0.652849740932642,1.69845132110039,633,306,327,16,1.1,28.12,2,0,0,0,0,0,0,0.0688309228656903,111.531794260314,16.393534344841
8.7,"max_tuv_SVM","SVM",56,11,2712,2668,44,1200,831,369,0.93504653807835,0.663212435233161,1.73577992156414,659,320,339,26,1.1,30.67,2.3,0,0,0,0,0,0,0.066745788395811,90.4357619736088,15.2230691495149
8.7,"max_tuv_SVM","SVM",56,12,2612,2577,35,1300,922,378,0.941497506311384,0.658031088082902,1.7714773274354,678,330,348,19,1.1,33.23,2.4,0,0,0,0,0,0,0.066074207922979,75.9684955412776,13.3393426624493
8.7,"max_tuv_SVM","SVM",56,13,2512,2479,33,1400,1020,380,0.941738499202092,0.652849740932642,1.77474272343067,684,335,349,6,1,35.79,2.7,0,0,0,0,0,0,0.0601881792764977,66.4428841518024,12.609060080975
8.7,"max_tuv_SVM","SVM",56,14,2412,2383,29,1500,1116,384,0.940565863063155,0.658031088082902,1.7714773274354,701,339,362,17,1.1,38.34,2.9,0,0,0,0,0,0,0.0582882786252495,56.302566055578,12.7015221425868
8.7,"max_tuv_SVM","SVM",56,15,2312,2288,24,1600,1211,389,0.940418916178576,0.647668393782383,1.77474272343067,715,345,370,14,1.1,40.9,3.1,0,0,0,0,0,0,0.0513235849217409,50.019568478812,12.0416295475845
8.7,"max_tuv_SVM","SVM",56,16,2212,2195,17,1700,1304,396,0.939355020734222,0.642487046632124,1.7714773274354,727,350,377,12,1.1,43.46,3.3,0,0,0,0,0,0,0.0411878377771706,43.0586685194038,9.53785216337409
8.7,"max_tuv_SVM","SVM",56,17,2112,2103,9,1800,1396,404,0.939090516341978,0.647668393782383,1.76215376255416,738,354,384,11,1.1,46.01,3.5,0,0,0,0,0,0,0.0294809567976786,32.3769214948329,3.39706240667617
8.7,"max_tuv_SVM","SVM",56,18,2012,2003,9,1900,1496,404,0.938740782756682,0.647668393782383,1.76540197225472,740,355,385,2,1.1,48.57,3.7,0,0,0,0,0,0,0.0268695040719131,30.1794254947183,2.8832803919862
8.7,"max_tuv_SVM","SVM",56,19,1912,1904,8,2000,1595,405,0.938523301367504,0.647668393782383,1.77310852202788,748,358,390,8,1.1,51.12,3.9,0,0,0,0,0,0,0.0213115962077809,23.0450687844788,2.33389826643261
8.7,"max_tuv_SVM","SVM",56,20,1812,1804,8,2100,1695,405,0.9382632053818,0.647668393782383,1.76984913136239,750,359,391,2,1.1,53.68,4.2,0,0,0,0,0,0,0.0180507535751915,18.4911091710142,1.87948968290927
8.7,"max_tuv_SVM","SVM",56,21,1712,1704,8,2200,1795,405,0.937829712072295,0.647668393782383,1.77916412679061,750,362,388,0,1.1,56.24,4.4,0,0,0,0,0,0,0.0127263449484007,11.5861024708622,1.56885756821325
8.7,"max_tuv_SVM","SVM",56,22,1612,1605,7,2300,1894,406,0.937994292583026,0.642487046632124,1.77916412679061,756,365,391,6,1.1,58.79,4.7,0,0,0,0,0,0,0.0112147433844748,9.65651077358384,1.13650728022576
8.7,"max_tuv_SVM","SVM",56,23,1512,1505,7,2400,1994,406,0.93750055105084,0.647668393782383,1.79012445719788,772,375,397,16,1.1,61.35,4.9,0,0,0,0,0,0,0.00788415790117911,5.42274680679075,0.997482944400654
8.7,"max_tuv_SVM","SVM",56,24,1412,1406,6,2500,2093,407,0.937462344860849,0.642487046632124,1.79177282225975,771,375,396,-1,1.1,63.91,5.1,0,0,0,0,0,0,0.00564323301383033,4.37202047318236,0.647311335795213
8.7,"max_tuv_SVM","SVM",56,25,1312,1307,5,2600,2192,408,0.937773872256157,0.642487046632124,1.79012445719788,776,378,398,5,1.1,66.46,5.4,0,0,0,0,0,0,0.00566935987795085,4.06835256486606,0.592204061022606
8.7,"max_tuv_SVM","SVM",56,26,1212,1207,5,2700,2292,408,0.93793698329804,0.637305699481865,1.78847912221884,789,385,404,13,1,69.02,5.6,0,0,0,0,0,0,0.00436946356382799,2.82058724579307,0.501555367885938
8.7,"max_tuv_SVM","SVM",56,27,1112,1108,4,2800,2391,409,0.938088338589156,0.637305699481865,1.79012445719788,789,385,404,0,1,71.57,5.8,0,0,0,0,0,0,0.00436138242101101,2.6458108683126,0.450939782671226
8.7,"max_tuv_SVM","SVM",56,28,1012,1008,4,2900,2491,409,0.938144178405297,0.642487046632124,1.79342422578257,793,387,406,4,1,74.13,6.1,0,0,0,0,0,0,0.00325197951441917,1.77049719233976,0.35646561859911
8.7,"max_tuv_SVM","SVM",56,29,912,910,2,3000,2589,411,0.938620286311333,0.642487046632124,1.79177282225975,798,390,408,5,1,76.69,6.3,0,0,0,0,0,0,0.00353410412668968,1.73209745141415,0.373283654750878
8.7,"max_tuv_SVM","SVM",56,30,812,810,2,3100,2689,411,0.938464522613679,0.637305699481865,1.79012445719788,803,393,410,5,1,79.24,6.5,0,0,0,0,0,0,0.00257503113096757,1.09896795697382,0.276418038300807
8.7,"max_tuv_SVM","SVM",56,31,712,711,1,3200,2788,412,0.938720210192847,0.637305699481865,1.79012445719788,808,395,413,5,1,81.8,6.8,0,0,0,0,0,0,0.0025961939691049,1.00682757530776,0.281273623979788
8.7,"max_tuv_SVM","SVM",56,32,612,611,1,3300,2888,412,0.938515954023281,0.632124352331606,1.78847912221884,808,395,413,0,1,84.36,7,0,0,0,0,0,0,0.00166757832524604,0.574269178157591,0.189973607472656
8.7,"max_tuv_SVM","SVM",56,33,512,511,1,3400,2988,412,0.938532118180585,0.632124352331606,1.79177282225975,809,396,413,1,1,86.91,7.3,0,0,0,0,0,0,0.00115682196168657,0.346176925734366,0.13361211791756
8.7,"max_tuv_SVM","SVM",56,34,412,411,1,3500,3088,412,0.938643797812865,0.632124352331606,1.78847912221884,811,397,414,2,1,89.47,7.5,0,0,0,0,0,0,0.000700987300627254,0.201921544260505,0.0894850888023779
8.7,"max_tuv_SVM","SVM",56,35,312,312,0,3600,3187,413,0.939089046873138,0.637305699481865,1.79177282225975,816,401,415,5,1,92.02,7.7,0,0,0,0,0,0,0.000626363729760978,0.160554164741639,0.0787854563414671
8.7,"max_tuv_SVM","SVM",56,36,212,212,0,3700,3287,413,0.939357959671917,0.642487046632124,1.79342422578257,823,402,421,7,1,94.58,8,0,0,0,0,0,0,0.000320346192703501,0.0663775464473906,0.0412956836929922
8.7,"max_tuv_SVM","SVM",56,37,112,112,0,3800,3387,413,0.939397635330752,0.647668393782383,1.79177282225975,826,403,423,3,1,97.14,8.2,0,0,0,0,0,0,0.000131549933851121,0.0226272326337486,0.0211670661074375
8.7,"max_tuv_SVM","SVM",56,38,12,12,0,3900,3487,413,0.939440249927279,0.642487046632124,1.78683680897529,828,405,423,2,1,99.69,8.4,0,0,0,0,0,0,9.02667075511776e-05,0.00129603745193794,0.00129603745193794
8.7,"max_tuv_SVM","SVM",56,39,0,0,0,3912,3499,413,0.939454944615737,0.642487046632124,1.78683680897529,828,405,423,0,1,100,8.5,0,0,0,0,0,0,0,0,0
8.7,"max_tuv_SVM","SVM",57,0,3812,3402,410,100,82,18,0.924305810088348,0.601123595505618,1.77270620706701,39,18,21,0,1.2,2.56,4.6,0,0,0,0,0,0,0.755876255800252,607.331870956833,79.9353635333235
8.7,"max_tuv_SVM","SVM",57,1,3712,3332,380,200,152,48,0.917243841710796,0.623595505617977,1.75212551131362,111,48,63,72,1.3,5.11,3.2,0,0,0,0,0,0,0.681729455868378,412.869294506276,73.9931130725393
8.7,"max_tuv_SVM","SVM",57,2,3612,3269,343,300,215,85,0.909627342930428,0.657303370786517,1.68980073250978,193,85,108,82,1.3,7.67,2.5,0,0,0,0,0,0,0.667604122105553,418.225068857215,77.3777640476948
8.7,"max_tuv_SVM","SVM",57,3,3512,3246,266,400,238,162,0.918239152690179,0.674157303370786,1.74199761818464,263,132,131,70,1,10.22,1.5,0,0,0,0,0,0,0.727582289206383,297.75240115204,84.958882374415
8.7,"max_tuv_SVM","SVM",57,4,3412,3180,232,500,304,196,0.886229635621398,0.674157303370786,1.63920789620709,352,173,179,89,1,12.78,1.6,0,0,0,0,0,0,0.682237876667882,259.781338306582,81.0971185607437
8.7,"max_tuv_SVM","SVM",57,5,3312,3115,197,600,369,231,0.889890168223358,0.662921348314607,1.63059079376586,430,207,223,78,1.1,15.34,1.6,0,0,0,0,0,0,0.230708524961949,179.288038626811,74.7491233179403
8.7,"max_tuv_SVM","SVM",57,6,3212,3058,154,700,426,274,0.888932773852703,0.691011235955056,1.63059079376586,491,237,254,61,1.1,17.89,1.6,0,0,0,0,0,0,0.108480446780992,136.393877771579,48.9089845404513
8.7,"max_tuv_SVM","SVM",57,7,3112,3001,111,800,483,317,0.892902958759363,0.713483146067416,1.62908932894655,527,254,273,36,1.1,20.45,1.5,0,0,0,0,0,0,0.0829980951560763,115.133532368459,26.5451147358093
8.7,"max_tuv_SVM","SVM",57,8,3012,2923,89,900,561,339,0.904010945261048,0.719101123595506,1.64071868689484,584,278,306,57,1.1,23.01,1.7,0,0,0,0,0,0,0.0686329797057625,113.565989941656,21.7944044599672
8.7,"max_tuv_SVM","SVM",57,9,2912,2841,71,1000,643,357,0.911164545443057,0.707865168539326,1.67110236628178,613,295,318,29,1.1,25.56,1.8,0,0,0,0,0,0,0.0714077124263355,112.084947531805,16.5115925931941
8.7,"max_tuv_SVM","SVM",57,10,2812,2748,64,1100,736,364,0.91805904879868,0.707865168539326,1.68824617801805,633,307,326,20,1.1,28.12,2,0,0,0,0,0,0,0.0614742157761877,98.0144891831529,14.7259956798262
8.7,"max_tuv_SVM","SVM",57,11,2712,2659,53,1200,825,375,0.923773397707312,0.702247191011236,1.66649454725711,652,315,337,19,1.1,30.67,2.2,0,0,0,0,0,0,0.0607052431954081,85.8033206334255,12.2333718617576
8.7,"max_tuv_SVM","SVM",57,12,2612,2571,41,1300,913,387,0.93441848561066,0.691011235955056,1.750512136073,688,336,352,36,1,33.23,2.4,0,0,0,0,0,0,0.0696401081304001,83.2786326657156,11.4695273855016
8.7,"max_tuv_SVM","SVM",57,13,2512,2479,33,1400,1005,395,0.937818341527544,0.679775280898876,1.750512136073,709,343,366,21,1.1,35.79,2.5,0,0,0,0,0,0,0.0722350068890986,77.5175778104364,11.6567437091031
8.7,"max_tuv_SVM","SVM",57,14,2412,2384,28,1500,1100,400,0.939124884670318,0.674157303370786,1.75901098787509,731,350,381,22,1.1,38.34,2.8,0,0,0,0,0,0,0.0679648663011094,61.7614347477955,11.0380006396921
8.7,"max_tuv_SVM","SVM",57,15,2312,2287,25,1600,1197,403,0.939614640866521,0.674157303370786,1.76587117342991,741,356,385,10,1.1,40.9,3,0,0,0,0,0,0,0.0617556686247467,55.0052515496418,10.4570240756392
8.7,"max_tuv_SVM","SVM",57,16,2212,2192,20,1700,1292,408,0.940055421443104,0.674157303370786,1.77074927059408,765,361,404,24,1.1,43.46,3.2,0,0,0,0,0,0,0.0471186397202797,42.3353943443419,9.12372992423797
8.7,"max_tuv_SVM","SVM",57,17,2112,2098,14,1800,1386,414,0.940082279040961,0.674157303370786,1.77238129757158,776,368,408,11,1.1,46.01,3.3,0,0,0,0,0,0,0.0369561300108738,39.4271647486842,7.15238531698889
8.7,"max_tuv_SVM","SVM",57,18,2012,2001,11,1900,1483,417,0.940012765258272,0.674157303370786,1.7691202464261,781,369,412,5,1.1,48.57,3.6,0,0,0,0,0,0,0.0271974021547877,29.319586989649,3.93275767169806
8.7,"max_tuv_SVM","SVM",57,19,1912,1903,9,2000,1581,419,0.939655717192652,0.668539325842697,1.77238129757158,779,371,408,-2,1.1,51.12,3.8,0,0,0,0,0,0,0.0219877910037294,22.6177541845469,2.38108421735974
8.7,"max_tuv_SVM","SVM",57,20,1812,1803,9,2100,1681,419,0.93904589173544,0.679775280898876,1.77074927059408,782,374,408,3,1.1,53.68,4,0,0,0,0,0,0,0.0213690899763048,21.7366135736912,2.28181323600933
8.7,"max_tuv_SVM","SVM",57,21,1712,1705,7,2200,1779,421,0.93866356593066,0.679775280898876,1.77238129757158,787,377,410,5,1.1,56.24,4.2,0,0,0,0,0,0,0.0158934270159866,15.6367035879303,1.68533950580224
8.7,"max_tuv_SVM","SVM",57,22,1612,1605,7,2300,1879,421,0.937263811124729,0.679775280898876,1.75901098787509,794,380,414,7,1.1,58.79,4.5,0,0,0,0,0,0,0.0121656942871319,10.9683502777852,1.43374527765248
8.7,"max_tuv_SVM","SVM",57,23,1512,1507,5,2400,1977,423,0.93668084326538,0.668539325842697,1.75739424983477,797,382,415,3,1.1,61.35,4.7,0,0,0,0,0,0,0.0118704425727796,10.2691670762389,1.20954973092173
8.7,"max_tuv_SVM","SVM",57,24,1412,1407,5,2500,2077,423,0.936529176830418,0.674157303370786,1.75739424983477,812,398,414,15,1,63.91,4.9,0,0,0,0,0,0,0.00813372947340441,5.43384215473449,1.03332204357123
8.7,"max_tuv_SVM","SVM",57,25,1312,1308,4,2600,2176,424,0.936445444319456,0.674157303370786,1.75578048101031,815,399,416,3,1,66.46,5.1,0,0,0,0,0,0,0.00661228616537879,4.98347331211821,0.760215184403578
8.7,"max_tuv_SVM","SVM",57,26,1212,1209,3,2700,2275,425,0.936328534775847,0.674157303370786,1.75578048101031,816,400,416,1,1,69.02,5.4,0,0,0,0,0,0,0.00593869443114553,4.07874777159852,0.606694500902139
8.7,"max_tuv_SVM","SVM",57,27,1112,1110,2,2800,2374,426,0.937251172255145,0.668539325842697,1.75901098787509,827,405,422,11,1,71.57,5.6,0,0,0,0,0,0,0.00520528421513727,3.31028138523607,0.553415845663901
8.7,"max_tuv_SVM","SVM",57,28,1012,1010,2,2900,2474,426,0.937827820679712,0.668539325842697,1.75739424983477,832,407,425,5,1,74.13,5.8,0,0,0,0,0,0,0.00369104269180178,2.00653647045112,0.383771430408653
8.7,"max_tuv_SVM","SVM",57,29,912,910,2,3000,2574,426,0.938251222810627,0.662921348314607,1.75095690826028,836,409,427,4,1,76.69,6,0,0,0,0,0,0,0.00316874040514446,1.48412934433837,0.330110629534318
8.7,"max_tuv_SVM","SVM",57,30,812,811,1,3100,2673,427,0.939921133453819,0.662921348314607,1.75256181835034,847,411,436,11,1.1,79.24,6.3,0,0,0,0,0,0,0.00272906513803195,1.1292064247462,0.291513729226209
8.7,"max_tuv_SVM","SVM",57,31,712,711,1,3200,2773,427,0.940385611910873,0.657303370786517,1.75739424983477,847,412,435,0,1.1,81.8,6.5,0,0,0,0,0,0,0.00210868680838778,0.762615606721259,0.231132207469868
8.7,"max_tuv_SVM","SVM",57,32,612,611,1,3300,2873,427,0.940357174454319,0.657303370786517,1.75578048101031,849,413,436,2,1.1,84.36,6.7,0,0,0,0,0,0,0.00156780032234306,0.501381891244604,0.176807817482274
8.7,"max_tuv_SVM","SVM",57,33,512,511,1,3400,2973,427,0.94046144512835,0.657303370786517,1.75578048101031,847,414,433,-2,1,86.91,7,0,0,0,0,0,0,0.00109615922430688,0.344239292280527,0.138909316301906
8.7,"max_tuv_SVM","SVM",57,34,412,412,0,3500,3072,428,0.940553076932803,0.662921348314607,1.76063070333354,848,415,433,1,1,89.47,7.2,0,0,0,0,0,0,0.000888307195226732,0.270792737947045,0.110901327771798
8.7,"max_tuv_SVM","SVM",57,35,312,312,0,3600,3172,428,0.940905385422332,0.662921348314607,1.75739424983477,852,417,435,4,1,92.02,7.4,0,0,0,0,0,0,0.000526105203684643,0.135418856267161,0.0648856555672402
8.7,"max_tuv_SVM","SVM",57,36,212,212,0,3700,3272,428,0.941219777303122,0.662921348314607,1.75901098787509,854,418,436,2,1,94.58,7.6,0,0,0,0,0,0,0.000344526957422533,0.0738005668601767,0.0451921640018215
8.7,"max_tuv_SVM","SVM",57,37,112,112,0,3800,3372,428,0.941804325021176,0.662921348314607,1.75578048101031,853,419,434,-1,1,97.14,7.9,0,0,0,0,0,0,0.000163646254365113,0.0266236304961544,0.0249130108362324
8.7,"max_tuv_SVM","SVM",57,38,12,12,0,3900,3472,428,0.942268803478222,0.662921348314607,1.75901098787509,855,419,436,2,1,99.69,8.1,0,0,0,0,0,0,0.000139416912944109,0.00191813779828508,0.00191813779828508
8.7,"max_tuv_SVM","SVM",57,39,0,0,0,3912,3484,428,0.942290921499986,0.662921348314607,1.75416967322956,855,419,436,0,1,100,8.1,0,0,0,0,0,0,0,0,0
8.7,"max_tuv_SVM","SVM",58,0,3812,3412,400,100,90,10,0.874426020408169,0.51530612244898,1.73838051349572,29,10,19,0,1.9,2.56,9,0,0,0,0,0,0,0.255380503038351,376.151040832649,28.927346195351
8.7,"max_tuv_SVM","SVM",58,1,3712,3361,351,200,141,59,0.898718692022255,0.561224489795918,1.75193202280912,109,53,56,80,1.1,5.11,2.4,0,0,0,0,0,0,0.70646516251124,538.825858719199,77.5333918136071
8.7,"max_tuv_SVM","SVM",58,2,3612,3296,316,300,206,94,0.89707357374767,0.581632653061224,1.71209511327467,188,91,97,79,1.1,7.67,2.2,0,0,0,0,0,0,0.692309467343079,406.725681957771,77.33931904837
8.7,"max_tuv_SVM","SVM",58,3,3512,3254,258,400,248,152,0.905004928107595,0.586734693877551,1.73040629095675,278,135,143,90,1.1,10.22,1.6,0,0,0,0,0,0,0.674917316795726,365.826185353018,78.0254992618787
8.7,"max_tuv_SVM","SVM",58,4,3412,3191,221,500,311,189,0.909789540816319,0.607142857142857,1.73358718487395,361,176,185,83,1.1,12.78,1.6,0,0,0,0,0,0,0.631198092382356,269.946241602159,77.5823225212208
8.7,"max_tuv_SVM","SVM",58,5,3312,3131,181,600,371,229,0.906389146567713,0.612244897959184,1.67701130038792,431,209,222,70,1.1,15.34,1.6,0,0,0,0,0,0,0.244671833142988,198.619418300973,70.202871490339
8.7,"max_tuv_SVM","SVM",58,6,3212,3083,129,700,419,281,0.893468807977738,0.61734693877551,1.65560048904354,474,226,248,43,1.1,17.89,1.5,0,0,0,0,0,0,0.119622244407134,121.128189824515,43.252130655796
8.7,"max_tuv_SVM","SVM",58,7,3112,3002,110,800,500,300,0.891388856679032,0.627551020408163,1.64186299519808,504,239,265,30,1.1,20.45,1.7,0,0,0,0,0,0,0.0749102950828976,95.6407143144221,34.9218713831077
8.7,"max_tuv_SVM","SVM",58,8,3012,2926,86,900,576,324,0.899281076066785,0.637755102040816,1.62800714755948,544,259,285,40,1.1,23.01,1.8,0,0,0,0,0,0,0.0685126856567912,111.931241146569,26.4631711116886
8.7,"max_tuv_SVM","SVM",58,9,2912,2844,68,1000,658,342,0.905394828385899,0.647959183673469,1.64337344873552,577,273,304,33,1.1,25.56,1.9,0,0,0,0,0,0,0.0778873693293932,141.569940309746,22.2401867639483
8.7,"max_tuv_SVM","SVM",58,10,2812,2747,65,1100,755,345,0.918923933209638,0.647959183673469,1.68927773501305,591,285,306,14,1.1,28.12,2.2,0,0,0,0,0,0,0.059265268736225,93.7152995472212,20.5494942569878
8.7,"max_tuv_SVM","SVM",58,11,2712,2658,54,1200,844,356,0.932021103896085,0.647959183673469,1.73040629095675,604,292,312,13,1.1,30.67,2.4,0,0,0,0,0,0,0.072697943199897,91.0186458703139,16.8777706853319
8.7,"max_tuv_SVM","SVM",58,12,2612,2563,49,1300,939,361,0.937904394712417,0.647959183673469,1.77293115048217,634,305,329,30,1.1,33.23,2.6,0,0,0,0,0,0,0.072908067359244,78.2607914113288,16.7370867772728
8.7,"max_tuv_SVM","SVM",58,13,2512,2466,46,1400,1036,364,0.938797251855275,0.647959183673469,1.77944927971188,641,309,332,7,1.1,35.79,2.8,0,0,0,0,0,0,0.0616397315527912,64.1750009973751,15.4435604896756
8.7,"max_tuv_SVM","SVM",58,14,2412,2371,41,1500,1131,369,0.938595779220767,0.653061224489796,1.78108630756811,654,315,339,13,1.1,38.34,3.1,0,0,0,0,0,0,0.054496451574266,50.0141805115218,14.0262851616824
8.7,"max_tuv_SVM","SVM",58,15,2312,2274,38,1600,1228,372,0.939114679962881,0.647959183673469,1.78108630756811,664,317,347,10,1.1,40.9,3.3,0,0,0,0,0,0,0.049758063070779,47.2434059909611,13.7105034453374
8.7,"max_tuv_SVM","SVM",58,16,2212,2182,30,1700,1320,380,0.939421961966587,0.653061224489796,1.77353703912504,682,324,358,18,1.1,43.46,3.5,0,0,0,0,0,0,0.0383352111389481,37.2522512642828,10.0623973592181
8.7,"max_tuv_SVM","SVM",58,17,2112,2091,21,1800,1411,389,0.939311804267142,0.647959183673469,1.77517163547447,697,331,366,15,1.1,46.01,3.6,0,0,0,0,0,0,0.032391366627151,33.3002484772923,6.73337217681747
8.7,"max_tuv_SVM","SVM",58,18,2012,1996,16,1900,1506,394,0.938853780148402,0.647959183673469,1.7719054503126,698,333,365,1,1.1,48.57,3.8,0,0,0,0,0,0,0.0253502228265554,24.1673243360775,2.7851788881915
8.7,"max_tuv_SVM","SVM",58,19,1912,1898,14,2000,1604,396,0.938691442486067,0.637755102040816,1.76865126215776,703,337,366,5,1.1,51.12,4.1,0,0,0,0,0,0,0.021773163376504,21.01680176724,2.34540413088933
8.7,"max_tuv_SVM","SVM",58,20,1812,1799,13,2100,1703,397,0.938517509276424,0.63265306122449,1.77944927971188,711,341,370,8,1.1,53.68,4.3,0,0,0,0,0,0,0.0180184632216876,17.2869663611359,1.92990366390741
8.7,"max_tuv_SVM","SVM",58,21,1712,1701,11,2200,1801,399,0.938279800556573,0.627551020408163,1.77944927971188,719,345,374,8,1.1,56.24,4.5,0,0,0,0,0,0,0.0151428714660147,13.1451723487159,1.56729707737808
8.7,"max_tuv_SVM","SVM",58,22,1612,1602,10,2300,1900,400,0.937520292207782,0.627551020408163,1.78272635020859,731,356,375,12,1.1,58.79,4.8,0,0,0,0,0,0,0.0113660170634626,8.17747057601336,1.45708974766922
8.7,"max_tuv_SVM","SVM",58,23,1512,1504,8,2400,1998,402,0.9379551252319,0.627551020408163,1.78436941596915,739,359,380,8,1.1,61.35,5,0,0,0,0,0,0,0.00937101331627059,7.47212786359025,1.03437113075504
8.7,"max_tuv_SVM","SVM",58,24,1412,1405,7,2500,2097,403,0.937792787569565,0.627551020408163,1.78108630756811,748,364,384,9,1.1,63.91,5.2,0,0,0,0,0,0,0.00718284600260852,5.37322484336476,0.826900386398625
8.7,"max_tuv_SVM","SVM",58,25,1312,1305,7,2600,2197,403,0.937334763450827,0.627551020408163,1.78108630756811,750,367,383,2,1,66.46,5.5,0,0,0,0,0,0,0.00664116572946818,4.38091299833284,0.678733200750039
8.7,"max_tuv_SVM","SVM",58,26,1212,1206,6,2700,2296,404,0.937415932282,0.61734693877551,1.78108630756811,760,372,388,10,1,69.02,5.7,0,0,0,0,0,0,0.00555983826869488,3.49229004785046,0.656516261777497
8.7,"max_tuv_SVM","SVM",58,27,1112,1106,6,2800,2396,404,0.937455067254171,0.61734693877551,1.78272635020859,760,372,388,0,1,71.57,5.9,0,0,0,0,0,0,0.00530321220725461,2.98807781969041,0.54373468089921
8.7,"max_tuv_SVM","SVM",58,28,1012,1006,6,2900,2496,404,0.937391291743966,0.612244897959184,1.77944927971188,761,373,388,1,1,74.13,6.2,0,0,0,0,0,0,0.00375570622089642,1.88853610354462,0.407012199243835
8.7,"max_tuv_SVM","SVM",58,29,912,907,5,3000,2595,405,0.937442022263447,0.607142857142857,1.78108630756811,766,376,390,5,1,76.69,6.4,0,0,0,0,0,0,0.0033824330391149,1.49731189595004,0.360332623345909
8.7,"max_tuv_SVM","SVM",58,30,812,810,2,3100,2692,408,0.937778293135433,0.61734693877551,1.77944927971188,785,382,403,19,1.1,79.24,6.6,0,0,0,0,0,0,0.00346053738837126,1.42692191913248,0.398257175701554
8.7,"max_tuv_SVM","SVM",58,31,712,710,2,3200,2792,408,0.937868158627085,0.612244897959184,1.78108630756811,783,382,401,-2,1,81.8,6.8,0,0,0,0,0,0,0.00320993951296626,1.14376104012104,0.351583976881198
8.7,"max_tuv_SVM","SVM",58,32,612,610,2,3300,2892,408,0.937821776437846,0.612244897959184,1.77293115048217,785,382,403,2,1.1,84.36,7.1,0,0,0,0,0,0,0.0020603185058806,0.67822263060988,0.245670010521536
8.7,"max_tuv_SVM","SVM",58,33,512,510,2,3400,2992,408,0.938020350185527,0.612244897959184,1.77293115048217,784,383,401,-1,1,86.91,7.3,0,0,0,0,0,0,0.00127663550161737,0.408436370316101,0.164761752241512
8.7,"max_tuv_SVM","SVM",58,34,412,412,0,3500,3090,410,0.938320384972169,0.61734693877551,1.78436941596915,792,386,406,8,1.1,89.47,7.5,0,0,0,0,0,0,0.00130730876318792,0.380195218210493,0.158358187092736
8.7,"max_tuv_SVM","SVM",58,35,312,312,0,3600,3190,410,0.938314587198514,0.61734693877551,1.77781525833474,798,389,409,6,1.1,92.02,7.8,0,0,0,0,0,0,0.000970770768164588,0.247186610510299,0.119843984239087
8.7,"max_tuv_SVM","SVM",58,36,212,212,0,3700,3290,410,0.938389958256028,0.612244897959184,1.78436941596915,801,392,409,3,1,94.58,8,0,0,0,0,0,0,0.000495389622030056,0.101118677146048,0.0618916196964911
8.7,"max_tuv_SVM","SVM",58,37,112,112,0,3800,3390,410,0.938501565398885,0.612244897959184,1.78272635020859,804,393,411,3,1,97.14,8.3,0,0,0,0,0,0,0.000216008861643275,0.0360303826089892,0.0336972377699363
8.7,"max_tuv_SVM","SVM",58,38,12,12,0,3900,3490,410,0.938607374768087,0.61734693877551,1.78108630756811,804,393,411,0,1,99.69,8.5,0,0,0,0,0,0,0.000180067606435636,0.00250607484658592,0.00250607484658592
8.7,"max_tuv_SVM","SVM",58,39,0,0,0,3912,3502,410,0.938618970315397,0.61734693877551,1.78108630756811,805,394,411,1,1,100,8.5,0,0,0,0,0,0,0,0,0
8.7,"max_tuv_SVM","SVM",59,0,3812,3427,385,100,92,8,0.896196455843497,0.596244131455399,1.72659180891802,26,8,18,0,2.2,2.56,11.5,0,0,0,0,0,0,0.24232533131299,310.053811828802,31.3101250628722
8.7,"max_tuv_SVM","SVM",59,1,3712,3392,320,200,127,73,0.910672872576839,0.596244131455399,1.77247307373654,93,46,47,67,1,5.11,1.7,0,0,0,0,0,0,0.795837837831496,451.400718781133,85.4681421578785
8.7,"max_tuv_SVM","SVM",59,2,3612,3321,291,300,198,102,0.908938234493971,0.629107981220657,1.75559237779619,176,85,91,83,1.1,7.67,1.9,0,0,0,0,0,0,0.658509731636775,325.096540772618,76.0359985291551
8.7,"max_tuv_SVM","SVM",59,3,3512,3263,249,400,256,144,0.90104212961841,0.657276995305164,1.69807066872255,266,128,138,90,1.1,10.22,1.8,0,0,0,0,0,0,0.612570306389224,300.157618430143,72.8145515536289
8.7,"max_tuv_SVM","SVM",59,4,3412,3215,197,500,304,196,0.911678908794133,0.643192488262911,1.70867920631027,338,166,172,72,1,12.78,1.6,0,0,0,0,0,0,0.458580297275922,316.594873618145,72.700433751036
8.7,"max_tuv_SVM","SVM",59,5,3312,3158,154,600,361,239,0.904725542007058,0.652582159624413,1.67118889809445,421,206,215,83,1,15.34,1.5,0,0,0,0,0,0,0.212543858762756,202.967266756018,62.0737799894606
8.7,"max_tuv_SVM","SVM",59,6,3212,3104,108,700,415,285,0.902054899679195,0.685446009389671,1.65583010482398,492,237,255,71,1.1,17.89,1.5,0,0,0,0,0,0,0.127040469601782,166.618835464992,40.6293837066558
8.7,"max_tuv_SVM","SVM",59,7,3112,3033,79,800,486,314,0.905446063260414,0.690140845070423,1.6573548102612,543,260,283,51,1.1,20.45,1.5,0,0,0,0,0,0,0.0917383730289556,136.281021208393,24.3679710243357
8.7,"max_tuv_SVM","SVM",59,8,3012,2949,63,900,570,330,0.910399478531167,0.685446009389671,1.65583010482398,563,267,296,20,1.1,23.01,1.7,0,0,0,0,0,0,0.0719060605664652,119.201911409528,14.9880502673969
8.7,"max_tuv_SVM","SVM",59,9,2912,2866,46,1000,653,347,0.903819166673412,0.690140845070423,1.6573548102612,596,283,313,33,1.1,25.56,1.9,0,0,0,0,0,0,0.0825731506965443,140.338794843402,12.6984247634146
8.7,"max_tuv_SVM","SVM",59,10,2812,2768,44,1100,751,349,0.916562292092584,0.666666666666667,1.70338467905689,613,296,317,17,1.1,28.12,2.2,0,0,0,0,0,0,0.0601739989853448,80.0398873415995,10.1847183046196
8.7,"max_tuv_SVM","SVM",59,11,2712,2677,35,1200,842,358,0.920799226416064,0.666666666666667,1.69807066872255,626,301,325,13,1.1,30.67,2.4,0,0,0,0,0,0,0.0572695977878399,78.4352068753812,7.48522679397728
8.7,"max_tuv_SVM","SVM",59,12,2612,2582,30,1300,937,363,0.924908217713246,0.671361502347418,1.72183098591549,646,308,338,20,1.1,33.23,2.6,0,0,0,0,0,0,0.056994909323229,67.3902392807008,7.23558187107185
8.7,"max_tuv_SVM","SVM",59,13,2512,2484,28,1400,1035,365,0.92631693777121,0.666666666666667,1.73871168185584,652,313,339,6,1.1,35.79,2.8,0,0,0,0,0,0,0.0479437902158912,56.1284945418653,5.99816342516419
8.7,"max_tuv_SVM","SVM",59,14,2412,2388,24,1500,1131,369,0.926777532665881,0.666666666666667,1.73871168185584,662,318,344,10,1.1,38.34,3.1,0,0,0,0,0,0,0.0427110885263055,43.3406209982094,4.82851108858448
8.7,"max_tuv_SVM","SVM",59,15,2312,2296,16,1600,1223,377,0.92618360767012,0.657276995305164,1.72024987389904,690,328,362,28,1.1,40.9,3.2,0,0,0,0,0,0,0.046296540105414,43.6515933640222,5.7507259890289
8.7,"max_tuv_SVM","SVM",59,16,2212,2202,10,1700,1317,383,0.926259026717203,0.652582159624413,1.72024987389904,704,334,370,14,1.1,43.46,3.4,0,0,0,0,0,0,0.035850155762847,38.6786927198648,4.51234719664465
8.7,"max_tuv_SVM","SVM",59,17,2112,2106,6,1800,1413,387,0.926261720254597,0.657276995305164,1.7250019453739,712,338,374,8,1.1,46.01,3.7,0,0,0,0,0,0,0.0305534398612111,34.0880002232876,3.36784037185077
8.7,"max_tuv_SVM","SVM",59,18,2012,2006,6,1900,1513,387,0.926487977395834,0.652582159624413,1.72183098591549,710,339,371,-2,1.1,48.57,3.9,0,0,0,0,0,0,0.0248990673787188,26.7803517544538,2.63630090355028
8.7,"max_tuv_SVM","SVM",59,19,1912,1906,6,2000,1613,387,0.926917596610447,0.647887323943662,1.74191372915208,716,343,373,6,1.1,51.12,4.2,0,0,0,0,0,0,0.0201115438681643,20.481738749906,2.09779264007661
8.7,"max_tuv_SVM","SVM",59,20,1812,1806,6,2100,1713,387,0.927366070586829,0.647887323943662,1.75398026358334,721,348,373,5,1.1,53.68,4.4,0,0,0,0,0,0,0.0145036220261734,13.0840839077832,1.72917895654516
8.7,"max_tuv_SVM","SVM",59,21,1712,1707,5,2200,1812,388,0.927273143546676,0.647887323943662,1.75882551293025,725,351,374,4,1.1,56.24,4.7,0,0,0,0,0,0,0.0122790663865132,10.6471676569018,1.25362722695564
8.7,"max_tuv_SVM","SVM",59,22,1612,1608,4,2300,1911,389,0.927083249160278,0.652582159624413,1.76079596847138,753,364,389,28,1.1,58.79,4.9,0,0,0,0,0,0,0.00932567476173692,7.10907520581231,1.20967534452443
8.7,"max_tuv_SVM","SVM",59,23,1512,1509,3,2400,2010,390,0.926778879434561,0.647887323943662,1.76565557096026,758,364,394,5,1.1,61.35,5.2,0,0,0,0,0,0,0.00834826330120207,6.40638462074896,0.882040745128599
8.7,"max_tuv_SVM","SVM",59,24,1412,1409,3,2500,2110,390,0.926636121952588,0.647887323943662,1.76565557096026,754,366,388,-4,1.1,63.91,5.4,0,0,0,0,0,0,0.00572187066388743,4.08140560925872,0.638884794258079
8.7,"max_tuv_SVM","SVM",59,25,1312,1309,3,2600,2210,390,0.926734436067533,0.647887323943662,1.76728140481934,755,366,389,1,1.1,66.46,5.7,0,0,0,0,0,0,0.00571605791283405,3.64777317302492,0.583927290236153
8.7,"max_tuv_SVM","SVM",59,26,1212,1209,3,2700,2310,390,0.926962039977475,0.652582159624413,1.76565557096026,755,370,385,0,1,69.02,5.9,0,0,0,0,0,0,0.00408651736834968,2.26618424280854,0.467500074690091
8.7,"max_tuv_SVM","SVM",59,27,1112,1110,2,2800,2409,391,0.927084595928981,0.647887323943662,1.76403272576636,761,371,390,6,1.1,71.57,6.2,0,0,0,0,0,0,0.00340309946324122,1.84629027722846,0.37432610990682
8.7,"max_tuv_SVM","SVM",59,28,1012,1010,2,2900,2509,391,0.927207151880488,0.647887323943662,1.76403272576636,761,371,390,0,1.1,74.13,6.4,0,0,0,0,0,0,0.00306383167667945,1.43160653405889,0.319089849302565
8.7,"max_tuv_SVM","SVM",59,29,912,910,2,3000,2609,391,0.927982890650466,0.643192488262911,1.76565557096026,763,373,390,2,1,76.69,6.7,0,0,0,0,0,0,0.00260445151235511,1.06488456628884,0.287910535874113
8.7,"max_tuv_SVM","SVM",59,30,812,811,1,3100,2708,392,0.928466380612998,0.643192488262911,1.76728140481934,769,374,395,6,1.1,79.24,6.9,0,0,0,0,0,0,0.00235581236340114,0.83396657052023,0.254578583351259
8.7,"max_tuv_SVM","SVM",59,31,712,712,0,3200,2807,393,0.929001047786054,0.63849765258216,1.76403272576636,777,379,398,8,1.1,81.8,7.1,0,0,0,0,0,0,0.00206587433480327,0.67948459181605,0.237913946213287
8.7,"max_tuv_SVM","SVM",59,32,612,612,0,3300,2907,393,0.929108789281884,0.643192488262911,1.76565557096026,775,379,396,-2,1,84.36,7.4,0,0,0,0,0,0,0.00132393105047658,0.418570637452532,0.16730682186614
8.7,"max_tuv_SVM","SVM",59,33,512,512,0,3400,3007,393,0.929372755946667,0.643192488262911,1.76565557096026,776,379,397,1,1,86.91,7.7,0,0,0,0,0,0,0.000782563198678831,0.242715012719768,0.10284324303849
8.7,"max_tuv_SVM","SVM",59,34,412,412,0,3500,3107,393,0.929642109686241,0.647887323943662,1.76241286100441,779,380,399,3,1.1,89.47,7.9,0,0,0,0,0,0,0.000430902450169474,0.126216651825177,0.0560336962806575
8.7,"max_tuv_SVM","SVM",59,35,312,312,0,3600,3207,393,0.929747157644676,0.643192488262911,1.75596304266588,779,381,398,0,1,92.02,8.2,0,0,0,0,0,0,0.000279283291660183,0.0721536518881381,0.0351506511427664
8.7,"max_tuv_SVM","SVM",59,36,212,212,0,3700,3307,393,0.930013817846853,0.63849765258216,1.75275580423178,781,382,399,2,1,94.58,8.4,0,0,0,0,0,0,0.000169407067796138,0.0362694655860901,0.0228838389224926
8.7,"max_tuv_SVM","SVM",59,37,112,112,0,3800,3407,393,0.93007846274435,0.633802816901408,1.76891023560719,785,383,402,4,1,97.14,8.7,0,0,0,0,0,0,6.67537659591142e-05,0.0110902717017591,0.0104182526208953
8.7,"max_tuv_SVM","SVM",59,38,12,12,0,3900,3507,393,0.930385526007462,0.633802816901408,1.76241286100441,788,385,403,3,1,99.69,8.9,0,0,0,0,0,0,6.30449555932066e-05,0.000837517675366974,0.000837517675366974
8.7,"max_tuv_SVM","SVM",59,39,0,0,0,3912,3519,393,0.930478453047615,0.633802816901408,1.76079596847138,788,386,402,0,1,100,9,0,0,0,0,0,0,0,0,0
8.7,"max_tuv_SVM","SVM",60,0,3812,3426,386,100,90,10,0.931879670539454,0.60952380952381,1.7770111915734,28,10,18,0,1.8,2.56,9,0,0,0,0,0,0,0.212360420462179,380.401072589846,22.8462713152514
8.7,"max_tuv_SVM","SVM",60,1,3712,3395,317,200,121,79,0.940716194839907,0.628571428571429,1.78759018759019,97,49,48,69,1,5.11,1.5,0,0,0,0,0,0,0.624133234983766,312.923418234705,69.6487717205954
8.7,"max_tuv_SVM","SVM",60,2,3612,3325,287,300,191,109,0.923555882834237,0.59047619047619,1.7737416217637,181,90,91,84,1,7.67,1.8,0,0,0,0,0,0,0.512554371275495,251.569048447369,66.7429551137431
8.7,"max_tuv_SVM","SVM",60,3,3512,3272,240,400,244,156,0.923564064801187,0.647619047619048,1.76679821099711,276,135,141,95,1,10.22,1.6,0,0,0,0,0,0,0.319631868540511,191.251682235884,59.4348943917372
8.7,"max_tuv_SVM","SVM",60,4,3412,3237,175,500,279,221,0.909000163639337,0.647619047619048,1.72232882113287,360,177,183,84,1,12.78,1.3,0,0,0,0,0,0,0.210615987453159,143.788131702842,42.8202144109923
8.7,"max_tuv_SVM","SVM",60,5,3312,3166,146,600,350,250,0.907581956035556,0.671428571428571,1.70676137858458,418,204,214,58,1,15.34,1.4,0,0,0,0,0,0,0.133534657325551,111.014092926855,32.9416562163158
8.7,"max_tuv_SVM","SVM",60,6,3212,3090,122,700,426,274,0.908211967490327,0.671428571428571,1.66541145490454,467,224,243,49,1.1,17.89,1.6,0,0,0,0,0,0,0.0785843523428598,71.5376638851262,22.9018571574715
8.7,"max_tuv_SVM","SVM",60,7,3112,3014,98,800,502,298,0.90453826433209,0.676190476190476,1.65530123651671,514,249,265,47,1.1,20.45,1.7,0,0,0,0,0,0,0.075172374354275,101.141426728689,19.8242286036852
8.7,"max_tuv_SVM","SVM",60,8,3012,2931,81,900,585,315,0.905660557464682,0.695238095238095,1.62957116548277,553,265,288,39,1.1,23.01,1.9,0,0,0,0,0,0,0.0609017781096653,103.845412256144,18.2702941209097
8.7,"max_tuv_SVM","SVM",60,9,2912,2844,68,1000,672,328,0.912131129656905,0.695238095238095,1.66938025210084,591,280,311,38,1.1,25.56,2,0,0,0,0,0,0,0.0618237283683888,101.968634255045,14.875808474665
8.7,"max_tuv_SVM","SVM",60,10,2812,2746,66,1100,770,330,0.919134893361699,0.69047619047619,1.69818468823994,605,288,317,14,1.1,28.12,2.3,0,0,0,0,0,0,0.0481042895771039,68.7906585080437,13.4916176728744
8.7,"max_tuv_SVM","SVM",60,11,2712,2658,54,1200,858,342,0.927886870670378,0.695238095238095,1.70519122092259,612,291,321,7,1.1,30.67,2.5,0,0,0,0,0,0,0.0480013208356849,69.997101992141,5.30525003208286
8.7,"max_tuv_SVM","SVM",60,12,2612,2563,49,1300,953,347,0.936797032673317,0.685714285714286,1.73786764705882,626,301,325,14,1.1,33.23,2.7,0,0,0,0,0,0,0.0447130314905509,57.5847046910824,5.15740104573925
8.7,"max_tuv_SVM","SVM",60,13,2512,2468,44,1400,1048,352,0.941608029236893,0.685714285714286,1.76679821099711,653,310,343,27,1.1,35.79,3,0,0,0,0,0,0,0.0600829127938339,57.0124334026972,6.55748842942714
8.7,"max_tuv_SVM","SVM",60,14,2412,2373,39,1500,1143,357,0.943293514427528,0.69047619047619,1.7737416217637,666,318,348,13,1.1,38.34,3.2,0,0,0,0,0,0,0.0600841717023763,52.8064489940165,6.48451111011123
8.7,"max_tuv_SVM","SVM",60,15,2312,2280,32,1600,1236,364,0.943219876725027,0.676190476190476,1.77048406139315,683,327,356,17,1.1,40.9,3.4,0,0,0,0,0,0,0.0551398649298322,41.2743179863636,6.04387306844226
8.7,"max_tuv_SVM","SVM",60,16,2212,2189,23,1700,1327,373,0.9429416898489,0.676190476190476,1.76517282165856,707,337,370,24,1.1,43.46,3.6,0,0,0,0,0,0,0.0524035901400375,39.1194315506134,5.92156990072296
8.7,"max_tuv_SVM","SVM",60,17,2112,2093,19,1800,1423,377,0.942591228931429,0.676190476190476,1.76355042016807,721,341,380,14,1.1,46.01,3.8,0,0,0,0,0,0,0.0381155360642226,33.5876829828019,4.72601532835384
8.7,"max_tuv_SVM","SVM",60,18,2012,1994,18,1900,1522,378,0.942603501881846,0.676190476190476,1.76193099829463,719,342,377,-2,1.1,48.57,4,0,0,0,0,0,0,0.0285430796438646,26.9892315628888,3.17987419949917
8.7,"max_tuv_SVM","SVM",60,19,1912,1896,16,2000,1620,380,0.943249877270492,0.671428571428571,1.76355042016807,732,344,388,13,1.1,51.12,4.3,0,0,0,0,0,0,0.0260295489021312,26.0467901137253,2.82862943137569
8.7,"max_tuv_SVM","SVM",60,20,1812,1797,15,2100,1719,381,0.944661266568477,0.671428571428571,1.76885976408912,739,346,393,7,1.1,53.68,4.5,0,0,0,0,0,0,0.0215534766878281,19.3961490602158,2.18494566587036
8.7,"max_tuv_SVM","SVM",60,21,1712,1698,14,2200,1818,382,0.944893088965243,0.657142857142857,1.78923319327731,756,359,397,17,1.1,56.24,4.8,0,0,0,0,0,0,0.0138924003804489,9.15869092046884,1.84612136988788
8.7,"max_tuv_SVM","SVM",60,22,1612,1602,10,2300,1914,386,0.944838542518943,0.652380952380952,1.78923319327731,762,364,398,6,1.1,58.79,5,0,0,0,0,0,0,0.0103696064878564,8.07159896644271,1.22790922544518
8.7,"max_tuv_SVM","SVM",60,23,1512,1503,9,2400,2013,387,0.944504445535362,0.652380952380952,1.78923319327731,768,365,403,6,1.1,61.35,5.2,0,0,0,0,0,0,0.00925051193679198,7.10694490806387,0.969551380353458
8.7,"max_tuv_SVM","SVM",60,24,1412,1403,9,2500,2113,387,0.944580810560188,0.652380952380952,1.79252828203104,768,370,398,0,1.1,63.91,5.5,0,0,0,0,0,0,0.00749119203143143,5.43443939699223,0.824460274736809
8.7,"max_tuv_SVM","SVM",60,25,1312,1304,8,2600,2212,388,0.944856270114002,0.647619047619048,1.78923319327731,776,372,404,8,1.1,66.46,5.7,0,0,0,0,0,0,0.00702370570672807,4.57175542720304,0.727100437316336
8.7,"max_tuv_SVM","SVM",60,26,1212,1204,8,2700,2312,388,0.945194458081058,0.647619047619048,1.78759018759019,778,376,402,2,1.1,69.02,6,0,0,0,0,0,0,0.00426824136862667,2.44388989690341,0.475289098649429
8.7,"max_tuv_SVM","SVM",60,27,1112,1105,7,2800,2411,389,0.945696285387008,0.647619047619048,1.78923319327731,781,377,404,3,1.1,71.57,6.2,0,0,0,0,0,0,0.00466269444403566,2.35034661307155,0.484413623320751
8.7,"max_tuv_SVM","SVM",60,28,1012,1006,6,2900,2510,390,0.945963562973873,0.642857142857143,1.78759018759019,791,384,407,10,1.1,74.13,6.4,0,0,0,0,0,0,0.00370316735535219,1.66879764320088,0.404901030522812
8.7,"max_tuv_SVM","SVM",60,29,912,906,6,3000,2610,390,0.94596492663503,0.642857142857143,1.78923319327731,791,384,407,0,1.1,76.69,6.7,0,0,0,0,0,0,0.00304957085891878,1.1639424423741,0.327640807825264
8.7,"max_tuv_SVM","SVM",60,30,812,806,6,3100,2710,390,0.945947199039983,0.642857142857143,1.79087922197398,792,385,407,1,1.1,79.24,6.9,0,0,0,0,0,0,0.00233690930027174,0.744369393819099,0.257749236177338
8.7,"max_tuv_SVM","SVM",60,31,712,709,3,3200,2807,393,0.94655811923853,0.647619047619048,1.79944802207912,804,389,415,12,1.1,81.8,7.1,0,0,0,0,0,0,0.00216628228899968,0.664103194007505,0.258689658975992
8.7,"max_tuv_SVM","SVM",60,32,612,609,3,3300,2907,393,0.946661757486498,0.647619047619048,1.79614325068871,805,389,416,1,1.1,84.36,7.4,0,0,0,0,0,0,0.00113839794296271,0.353751803346285,0.155114197785685
8.7,"max_tuv_SVM","SVM",60,33,512,509,3,3400,3007,393,0.946765395734466,0.647619047619048,1.79614325068871,804,389,415,-1,1.1,86.91,7.7,0,0,0,0,0,0,0.000576442713234174,0.165714391041391,0.0777877216255863
8.7,"max_tuv_SVM","SVM",60,34,412,411,1,3500,3105,395,0.946800850924559,0.652380952380952,1.79944802207912,810,392,418,6,1.1,89.47,7.9,0,0,0,0,0,0,0.000550507702610673,0.162332213506001,0.0747035599870634
8.7,"max_tuv_SVM","SVM",60,35,312,312,0,3600,3204,396,0.947175857742867,0.652380952380952,1.80110497237569,816,396,420,6,1.1,92.02,8.1,0,0,0,0,0,0,0.000369291104020437,0.0903827753520157,0.0473775982397054
8.7,"max_tuv_SVM","SVM",60,36,212,212,0,3700,3304,396,0.947220858561063,0.652380952380952,1.79614325068871,818,396,422,2,1.1,94.58,8.3,0,0,0,0,0,0,0.000148907712941132,0.0326099262135776,0.0214295928061616
8.7,"max_tuv_SVM","SVM",60,37,112,112,0,3800,3404,396,0.947358588337968,0.652380952380952,1.80110497237569,817,396,421,-1,1.1,97.14,8.6,0,0,0,0,0,0,4.88732919180382e-05,0.00881956023411325,0.00829495757590446
8.7,"max_tuv_SVM","SVM",60,38,12,12,0,3900,3504,396,0.947572683139692,0.652380952380952,1.80110497237569,816,396,420,-1,1.1,99.69,8.8,0,0,0,0,0,0,4.92782901006272e-05,0.000662215046370003,0.000662215046370003
8.7,"max_tuv_SVM","SVM",60,39,0,0,0,3912,3516,396,0.947621774941361,0.652380952380952,1.79944802207912,816,396,420,0,1.1,100,8.9,0,0,0,0,0,0,0,0,0
8.7,"max_tuv_SVM","SVM",61,0,3812,3410,402,100,91,9,0.905974169687957,0.58974358974359,1.73450629882469,25,9,16,0,1.8,2.56,10.1,0,0,0,0,0,0,0.482083110021826,330.356507242472,53.337716595223
8.7,"max_tuv_SVM","SVM",61,1,3712,3377,335,200,124,76,0.904509384236795,0.58974358974359,1.725624513481,89,46,43,64,0.9,5.11,1.6,0,0,0,0,0,0,0.785160718877025,334.577787325045,85.0314328156868
8.7,"max_tuv_SVM","SVM",61,2,3612,3316,296,300,185,115,0.917934157457119,0.605128205128205,1.77935520361991,175,87,88,86,1,7.67,1.6,0,0,0,0,0,0,0.693945117561895,261.509711987671,80.525051528679
8.7,"max_tuv_SVM","SVM",61,3,3512,3251,261,400,250,150,0.885309920062893,0.58974358974359,1.70559954751131,257,126,131,82,1,10.22,1.7,0,0,0,0,0,0,0.52742145082211,202.654701453245,71.9445593572799
8.7,"max_tuv_SVM","SVM",61,4,3412,3205,207,500,296,204,0.855412862738244,0.564102564102564,1.64408556452755,351,173,178,94,1,12.78,1.5,0,0,0,0,0,0,0.374953042061524,198.817363192271,67.5030059937979
8.7,"max_tuv_SVM","SVM",61,5,3312,3145,167,600,356,244,0.886346627062133,0.630769230769231,1.65180100488288,405,197,208,54,1.1,15.34,1.5,0,0,0,0,0,0,0.142784759786656,103.353058337099,52.1603562339303
8.7,"max_tuv_SVM","SVM",61,6,3212,3095,117,700,406,294,0.889841145037062,0.635897435897436,1.65484579936193,470,227,243,65,1.1,17.89,1.4,0,0,0,0,0,0,0.0935054198372892,85.6858690719273,26.8854568109399
8.7,"max_tuv_SVM","SVM",61,7,3112,3024,88,800,477,323,0.893685114809491,0.641025641025641,1.65332200028333,516,247,269,46,1.1,20.45,1.5,0,0,0,0,0,0,0.066624881038893,70.3886543305701,14.2623528668102
8.7,"max_tuv_SVM","SVM",61,8,3012,2945,67,900,556,344,0.902639817120231,0.661538461538462,1.65332200028333,551,266,285,35,1.1,23.01,1.6,0,0,0,0,0,0,0.0590107669200265,75.115270957165,9.15084372659364
8.7,"max_tuv_SVM","SVM",61,9,2912,2859,53,1000,642,358,0.914314419254781,0.682051282051282,1.69171543397025,593,286,307,42,1.1,25.56,1.8,0,0,0,0,0,0,0.0614893672337679,102.178909810736,9.09763429750066
8.7,"max_tuv_SVM","SVM",61,10,2812,2762,50,1100,739,361,0.922526536495862,0.671794871794872,1.70874061481796,601,292,309,8,1.1,28.12,2,0,0,0,0,0,0,0.0432268769436665,64.7973525139023,5.89427834130913
8.7,"max_tuv_SVM","SVM",61,11,2712,2667,45,1200,834,366,0.931370579070733,0.671794871794872,1.71956043956044,616,296,320,15,1.1,30.67,2.3,0,0,0,0,0,0,0.0491264626474913,68.0776880506101,5.57635071140692
8.7,"max_tuv_SVM","SVM",61,12,2612,2572,40,1300,929,371,0.934750069162312,0.666666666666667,1.72403846153846,648,313,335,32,1.1,33.23,2.5,0,0,0,0,0,0,0.0540132795021957,58.2945506379088,5.99953402498965
8.7,"max_tuv_SVM","SVM",61,13,2512,2476,36,1400,1025,375,0.941300834316165,0.666666666666667,1.7641592293526,653,318,335,5,1.1,35.79,2.7,0,0,0,0,0,0,0.0461083867297373,43.7764481302512,5.26482336375945
8.7,"max_tuv_SVM","SVM",61,14,2412,2377,35,1500,1124,376,0.941423142445287,0.666666666666667,1.76578518255938,660,320,340,7,1.1,38.34,3,0,0,0,0,0,0,0.0388651845257754,36.8869877695489,4.24983516336116
8.7,"max_tuv_SVM","SVM",61,15,2312,2281,31,1600,1220,380,0.942966554550881,0.666666666666667,1.78427507975895,676,326,350,16,1.1,40.9,3.2,0,0,0,0,0,0,0.0413382981943383,34.6857684226164,4.79401145563619
8.7,"max_tuv_SVM","SVM",61,16,2212,2189,23,1700,1312,388,0.94321699500575,0.656410256410256,1.78263210086415,697,333,364,21,1.1,43.46,3.4,0,0,0,0,0,0,0.0432067774588676,34.2064666835145,5.41662117495078
8.7,"max_tuv_SVM","SVM",61,17,2112,2092,20,1800,1409,391,0.944274086693164,0.656410256410256,1.78263210086415,706,335,371,9,1.1,46.01,3.6,0,0,0,0,0,0,0.0284796311183436,26.0974501605557,3.40977236210653
8.7,"max_tuv_SVM","SVM",61,18,2012,1999,13,1900,1502,398,0.945907773846434,0.656410256410256,1.79352002835874,725,344,381,19,1.1,48.57,3.8,0,0,0,0,0,0,0.0278505062859536,27.2880554883738,3.08294983931622
8.7,"max_tuv_SVM","SVM",61,19,1912,1899,13,2000,1602,398,0.945666069686503,0.661538461538462,1.79022008350435,727,347,380,2,1.1,51.12,4,0,0,0,0,0,0,0.0203266289811723,19.4568937823437,2.17113707240681
8.7,"max_tuv_SVM","SVM",61,20,1812,1799,13,2100,1702,398,0.945088018171485,0.661538461538462,1.78857466063348,730,349,381,3,1.1,53.68,4.3,0,0,0,0,0,0,0.0168327569077409,15.8717857312386,1.82897798356464
8.7,"max_tuv_SVM","SVM",61,21,1712,1699,13,2200,1802,398,0.944642467129683,0.661538461538462,1.78857466063348,729,349,380,-1,1.1,56.24,4.5,0,0,0,0,0,0,0.0131956570684047,11.937824860106,1.378111221124
8.7,"max_tuv_SVM","SVM",61,22,1612,1599,13,2300,1902,398,0.943815431208961,0.656410256410256,1.79186853661992,736,354,382,7,1.1,58.79,4.8,0,0,0,0,0,0,0.0095511810325728,7.81787752911812,1.18338818031382
8.7,"max_tuv_SVM","SVM",61,23,1512,1503,9,2400,1998,402,0.945256919873618,0.661538461538462,1.80110497237569,748,361,387,12,1.1,61.35,5,0,0,0,0,0,0,0.0105320927065624,8.40345195819858,1.08142314606935
8.7,"max_tuv_SVM","SVM",61,24,1412,1403,9,2500,2098,402,0.942200672694712,0.641025641025641,1.80276497695853,761,371,390,13,1.1,63.91,5.2,0,0,0,0,0,0,0.00691313427674697,4.81494062560307,0.915225219520924
8.7,"max_tuv_SVM","SVM",61,25,1312,1304,8,2600,2197,403,0.942397239330802,0.641025641025641,1.80110497237569,765,372,393,4,1.1,66.46,5.5,0,0,0,0,0,0,0.00642047881776597,4.1562587634044,0.662697560395159
8.7,"max_tuv_SVM","SVM",61,26,1212,1204,8,2700,2297,403,0.941897814470218,0.641025641025641,1.79944802207912,775,377,398,10,1.1,69.02,5.7,0,0,0,0,0,0,0.00465249807132426,2.86809389564809,0.530814467845694
8.7,"max_tuv_SVM","SVM",61,27,1112,1106,6,2800,2395,405,0.942238529972773,0.641025641025641,1.80276497695853,784,380,404,9,1.1,71.57,5.9,0,0,0,0,0,0,0.00546157898693971,2.69865026623435,0.56172148069422
8.7,"max_tuv_SVM","SVM",61,28,1012,1006,6,2900,2495,405,0.941482840460695,0.641025641025641,1.79779411764706,789,384,405,5,1.1,74.13,6.2,0,0,0,0,0,0,0.00386426505141233,1.85049671875478,0.433137598937393
8.7,"max_tuv_SVM","SVM",61,29,912,907,5,3000,2594,406,0.941542538476101,0.641025641025641,1.80276497695853,794,387,407,5,1.1,76.69,6.4,0,0,0,0,0,0,0.00343990320222518,1.487559714435,0.374952683921813
8.7,"max_tuv_SVM","SVM",61,30,812,808,4,3100,2693,407,0.941115916073329,0.635897435897436,1.79449541284404,800,389,411,6,1.1,79.24,6.6,0,0,0,0,0,0,0.00289397574341714,1.16721982693143,0.320713555688544
8.7,"max_tuv_SVM","SVM",61,31,712,709,3,3200,2792,408,0.941041657566361,0.635897435897436,1.80110497237569,803,390,413,3,1.1,81.8,6.8,0,0,0,0,0,0,0.00269916351900068,1.02677226191785,0.308016933956086
8.7,"max_tuv_SVM","SVM",61,32,612,609,3,3300,2892,408,0.94099215189505,0.635897435897436,1.79779411764706,802,391,411,-1,1.1,84.36,7.1,0,0,0,0,0,0,0.00203547945792971,0.693281887219318,0.233911494552448
8.7,"max_tuv_SVM","SVM",61,33,512,509,3,3400,2992,408,0.941006712386612,0.635897435897436,1.80110497237569,804,392,412,2,1.1,86.91,7.3,0,0,0,0,0,0,0.00143364512344626,0.447933962494275,0.170085714022566
8.7,"max_tuv_SVM","SVM",61,34,412,410,2,3500,3091,409,0.940954294616989,0.635897435897436,1.79779411764706,812,395,417,8,1.1,89.47,7.6,0,0,0,0,0,0,0.00111072686501289,0.326011926278678,0.133312968076935
8.7,"max_tuv_SVM","SVM",61,35,312,312,0,3600,3189,411,0.94118435038367,0.635897435897436,1.79285059578368,819,399,420,7,1.1,92.02,7.8,0,0,0,0,0,0,0.00120077074515549,0.309229937894136,0.152124358454333
8.7,"max_tuv_SVM","SVM",61,36,212,212,0,3700,3289,411,0.941040201517205,0.635897435897436,1.79449541284404,823,402,421,4,1,94.58,8,0,0,0,0,0,0,0.000657430054115664,0.134169661617295,0.0819831000065477
8.7,"max_tuv_SVM","SVM",61,37,112,112,0,3800,3389,411,0.941021272878174,0.635897435897436,1.79944802207912,828,404,424,5,1,97.14,8.2,0,0,0,0,0,0,0.000308243556027372,0.0502828882265096,0.0469997892564895
8.7,"max_tuv_SVM","SVM",61,38,12,12,0,3900,3489,411,0.941044569664673,0.630769230769231,1.79944802207912,827,405,422,-1,1,99.69,8.5,0,0,0,0,0,0,0.00015776169786583,0.00227063728808454,0.00227063728808454
8.7,"max_tuv_SVM","SVM",61,39,0,0,0,3912,3501,411,0.941019816829017,0.630769230769231,1.79449541284404,827,405,422,0,1,100,8.5,0,0,0,0,0,0,0,0,0
8.7,"max_tuv_SVM","SVM",62,0,3812,3410,402,100,89,11,0.778211597635913,0.373056994818653,1.53134430336503,32,11,21,0,1.9,2.56,8.1,0,0,0,0,0,0,0.756770990022506,596.273641008579,87.7684299285339
8.7,"max_tuv_SVM","SVM",62,1,3712,3351,361,200,148,52,0.916172680223013,0.601036269430052,1.77310852202788,100,48,52,68,1.1,5.11,2.8,0,0,0,0,0,0,0.702845178510325,383.90847181167,76.4236037963205
8.7,"max_tuv_SVM","SVM",62,2,3612,3291,321,300,208,92,0.89990272116241,0.621761658031088,1.70621237326673,187,90,97,87,1.1,7.67,2.3,0,0,0,0,0,0,0.675222065416608,336.540813449919,75.8779741109288
8.7,"max_tuv_SVM","SVM",62,3,3512,3247,265,400,252,148,0.905404412521049,0.621761658031088,1.72803896755092,276,135,141,89,1,10.22,1.7,0,0,0,0,0,0,0.690841229668901,317.610444489655,78.9130714936135
8.7,"max_tuv_SVM","SVM",62,4,3412,3185,227,500,314,186,0.904649105534334,0.626943005181347,1.73418306791044,363,175,188,87,1.1,12.78,1.7,0,0,0,0,0,0,0.676447090607089,238.77552987289,77.8189209595049
8.7,"max_tuv_SVM","SVM",62,5,3312,3129,183,600,370,230,0.904731395789691,0.637305699481865,1.69688880838549,431,210,221,68,1.1,15.34,1.6,0,0,0,0,0,0,0.180945192179391,155.074220301855,62.6643556681336
8.7,"max_tuv_SVM","SVM",62,6,3212,3083,129,700,416,284,0.893119652970234,0.642487046632124,1.67045487075258,478,233,245,47,1.1,17.89,1.5,0,0,0,0,0,0,0.105842262956733,111.989294051685,35.8997478446292
8.7,"max_tuv_SVM","SVM",62,7,3112,3007,105,800,492,308,0.896749241019343,0.647668393782383,1.65179057052071,509,247,262,31,1.1,20.45,1.6,0,0,0,0,0,0,0.077734806260445,91.3742426448435,22.5553631058865
8.7,"max_tuv_SVM","SVM",62,8,3012,2928,84,900,571,329,0.904277329916329,0.647668393782383,1.64875419079549,546,265,281,37,1.1,23.01,1.7,0,0,0,0,0,0,0.0657917365057728,100.80726384772,17.3934735410184
8.7,"max_tuv_SVM","SVM",62,9,2912,2848,64,1000,651,349,0.910481427383269,0.66839378238342,1.65179057052071,593,285,308,47,1.1,25.56,1.9,0,0,0,0,0,0,0.0782498074673313,123.113040888955,14.9058293521553
8.7,"max_tuv_SVM","SVM",62,10,2812,2758,54,1100,741,359,0.916798673951319,0.66839378238342,1.70621237326673,630,298,332,37,1.1,28.12,2.1,0,0,0,0,0,0,0.0843188539951134,113.811761097386,15.2423428009216
8.7,"max_tuv_SVM","SVM",62,11,2712,2665,47,1200,834,366,0.924049033236441,0.66839378238342,1.7325891496495,657,312,345,27,1.1,30.67,2.3,0,0,0,0,0,0,0.0698966093885164,88.1670368771934,13.72697975363
8.7,"max_tuv_SVM","SVM",62,12,2612,2572,40,1300,927,373,0.925490582174162,0.658031088082902,1.75444422179601,671,319,352,14,1.1,33.23,2.5,0,0,0,0,0,0,0.0692135990294699,82.8062335543574,12.76592364199
8.7,"max_tuv_SVM","SVM",62,13,2512,2476,36,1400,1023,377,0.924757317220112,0.663212435233161,1.75283019767292,682,324,358,11,1.1,35.79,2.7,0,0,0,0,0,0,0.06357244888554,69.0108240776973,12.2042503354701
8.7,"max_tuv_SVM","SVM",62,14,2412,2382,30,1500,1117,383,0.92289403072365,0.663212435233161,1.73418306791044,698,330,368,16,1.1,38.34,2.9,0,0,0,0,0,0,0.060675584490365,63.3963924626635,12.2253192146127
8.7,"max_tuv_SVM","SVM",62,15,2312,2289,23,1600,1210,390,0.921637634860495,0.66839378238342,1.72327415422127,713,337,376,15,1.1,40.9,3.1,0,0,0,0,0,0,0.0505088680173495,53.7831313590385,10.2169244372083
8.7,"max_tuv_SVM","SVM",62,16,2212,2195,17,1700,1304,396,0.921192385800227,0.663212435233161,1.7108142796026,727,343,384,14,1.1,43.46,3.3,0,0,0,0,0,0,0.0410943263889361,45.1845521657824,7.45673682467295
8.7,"max_tuv_SVM","SVM",62,17,2112,2097,15,1800,1402,398,0.924125445616422,0.66839378238342,1.74672046990282,730,349,381,3,1.1,46.01,3.5,0,0,0,0,0,0,0.0341994921884859,39.1310669645623,6.5509090140282
8.7,"max_tuv_SVM","SVM",62,18,2012,1999,13,1900,1500,400,0.923326054564312,0.66839378238342,1.73737971872687,734,351,383,4,1.1,48.57,3.8,0,0,0,0,0,0,0.0304218817571408,33.9320724915916,5.17120985932106
8.7,"max_tuv_SVM","SVM",62,19,1912,1901,11,2000,1598,402,0.924043155361055,0.663212435233161,1.74511207168007,734,354,380,0,1.1,51.12,4,0,0,0,0,0,0,0.0235558885659124,23.3251622035125,2.56334707236896
8.7,"max_tuv_SVM","SVM",62,20,1812,1802,10,2100,1697,403,0.925996079457124,0.663212435233161,1.73577992156414,748,358,390,14,1.1,53.68,4.2,0,0,0,0,0,0,0.0216152165191807,21.3630904158174,2.34742919584157
8.7,"max_tuv_SVM","SVM",62,21,1712,1704,8,2200,1795,405,0.92801659912009,0.658031088082902,1.75606122107877,752,361,391,4,1.1,56.24,4.4,0,0,0,0,0,0,0.0176568888641967,17.3710067233623,1.92102639073204
8.7,"max_tuv_SVM","SVM",62,22,1612,1605,7,2300,1894,406,0.929309731704394,0.652849740932642,1.76540197225472,759,364,395,7,1.1,58.79,4.7,0,0,0,0,0,0,0.0158891213736707,14.6203986655658,1.62715395452069
8.7,"max_tuv_SVM","SVM",62,23,1512,1506,6,2400,1993,407,0.928354576954627,0.652849740932642,1.76215376255416,784,379,405,25,1.1,61.35,4.9,0,0,0,0,0,0,0.0105897115127847,8.03643358109431,1.39624820308154
8.7,"max_tuv_SVM","SVM",62,24,1412,1406,6,2500,2093,407,0.928442745085375,0.652849740932642,1.76215376255416,783,379,404,-1,1.1,63.91,5.1,0,0,0,0,0,0,0.00956085672743745,7.65010381155543,1.0515717988051
8.7,"max_tuv_SVM","SVM",62,25,1312,1307,5,2600,2192,408,0.928369271643084,0.652849740932642,1.76540197225472,787,380,407,4,1.1,66.46,5.4,0,0,0,0,0,0,0.00831929157545621,6.00945719490223,0.849294751760593
8.7,"max_tuv_SVM","SVM",62,26,1212,1208,4,2700,2291,409,0.929359693645137,0.658031088082902,1.76540197225472,797,387,410,10,1.1,69.02,5.6,0,0,0,0,0,0,0.00557879934447233,3.59168153942517,0.671514728700623
8.7,"max_tuv_SVM","SVM",62,27,1112,1108,4,2800,2391,409,0.929168662695185,0.658031088082902,1.76377637191195,793,387,406,-4,1,71.57,5.8,0,0,0,0,0,0,0.00467509745398276,2.90000195464924,0.495199585814477
8.7,"max_tuv_SVM","SVM",62,28,1012,1008,4,2900,2491,409,0.930041527189577,0.658031088082902,1.76540197225472,802,391,411,9,1.1,74.13,6.1,0,0,0,0,0,0,0.00403129376012212,2.20592562238066,0.424860559618678
8.7,"max_tuv_SVM","SVM",62,29,912,908,4,3000,2591,409,0.930380974492952,0.658031088082902,1.76377637191195,806,391,415,4,1.1,76.69,6.3,0,0,0,0,0,0,0.00346172682143418,1.61609735636348,0.358882327626412
8.7,"max_tuv_SVM","SVM",62,30,812,808,4,3100,2691,409,0.930445631122165,0.658031088082902,1.76377637191195,811,395,416,5,1.1,79.24,6.6,0,0,0,0,0,0,0.00278309174603661,1.0919802293355,0.291529108372627
8.7,"max_tuv_SVM","SVM",62,31,712,709,3,3200,2790,410,0.930909983277436,0.652849740932642,1.76377637191195,810,396,414,-1,1,81.8,6.8,0,0,0,0,0,0,0.00245980173090963,0.764466915319934,0.263168715214415
8.7,"max_tuv_SVM","SVM",62,32,612,610,2,3300,2889,411,0.931405194278468,0.658031088082902,1.75891748383505,816,398,418,6,1.1,84.36,7,0,0,0,0,0,0,0.00171984567886286,0.497843046653473,0.211370422647667
8.7,"max_tuv_SVM","SVM",62,33,512,510,2,3400,2989,411,0.931696149109934,0.658031088082902,1.76053413593417,815,398,417,-1,1,86.91,7.3,0,0,0,0,0,0,0.000991807173054382,0.298661129788941,0.137902160504554
8.7,"max_tuv_SVM","SVM",62,34,412,412,0,3500,3087,413,0.932864376842344,0.658031088082902,1.76053413593417,831,405,426,16,1.1,89.47,7.5,0,0,0,0,0,0,0.00107676843119202,0.287404412588791,0.136008350248787
8.7,"max_tuv_SVM","SVM",62,35,312,312,0,3600,3187,413,0.933547679855648,0.658031088082902,1.76215376255416,833,405,428,2,1.1,92.02,7.7,0,0,0,0,0,0,0.000455839839981687,0.119472761463481,0.0647042807332386
8.7,"max_tuv_SVM","SVM",62,36,212,212,0,3700,3287,413,0.933797489559437,0.658031088082902,1.76540197225472,836,408,428,3,1,94.58,8,0,0,0,0,0,0,0.0002035640599375,0.0439395806906231,0.028207196627749
8.7,"max_tuv_SVM","SVM",62,37,112,112,0,3800,3387,413,0.934361765596223,0.658031088082902,1.76053413593417,838,409,429,2,1,97.14,8.2,0,0,0,0,0,0,7.20262934998719e-05,0.0131033574901594,0.0123373083575948
8.7,"max_tuv_SVM","SVM",62,38,12,12,0,3900,3487,413,0.934826117751493,0.652849740932642,1.76053413593417,839,409,430,1,1.1,99.69,8.4,0,0,0,0,0,0,4.04959936800876e-05,0.000664767674855005,0.000664767674855005
8.7,"max_tuv_SVM","SVM",62,39,0,0,0,3912,3499,413,0.934854037659563,0.652849740932642,1.76377637191195,840,409,431,1,1.1,100,8.5,0,0,0,0,0,0,0,0,0
8.7,"max_tuv_SVM","SVM",63,0,3812,3428,384,100,88,12,0.884309714722079,0.538095238095238,1.71061261970353,33,12,21,0,1.8,2.56,7.3,0,0,0,0,0,0,0.567290857009803,532.090868794213,63.3302770419819
8.7,"max_tuv_SVM","SVM",63,1,3712,3382,330,200,134,66,0.914614356624664,0.638095238095238,1.73786764705882,112,53,59,79,1.1,5.11,2,0,0,0,0,0,0,0.724598775146678,544.230140903425,78.5252572568645
8.7,"max_tuv_SVM","SVM",63,2,3612,3317,295,300,199,101,0.893413516609394,0.619047619047619,1.67640036730946,205,99,106,93,1.1,7.67,2,0,0,0,0,0,0,0.65224590978465,585.405173972894,73.7135184384014
8.7,"max_tuv_SVM","SVM",63,3,3512,3267,245,400,249,151,0.90023454971909,0.628571428571429,1.70049803407602,292,143,149,87,1,10.22,1.6,0,0,0,0,0,0,0.612913876022509,570.614345310282,71.2625863920938
8.7,"max_tuv_SVM","SVM",63,4,3412,3214,198,500,302,198,0.865177548682711,0.647619047619048,1.56664915966387,377,182,195,85,1.1,12.78,1.5,0,0,0,0,0,0,0.587804838639356,500.641497184797,75.0224792489067
8.7,"max_tuv_SVM","SVM",63,5,3312,3148,164,600,368,232,0.891460753831892,0.666666666666667,1.6265756302521,445,217,228,68,1.1,15.34,1.6,0,0,0,0,0,0,0.277410118411841,336.248383748889,69.5129323995751
8.7,"max_tuv_SVM","SVM",63,6,3212,3107,105,700,409,291,0.887024764086614,0.7,1.6094537815126,521,254,267,76,1.1,17.89,1.4,0,0,0,0,0,0,0.15088652212174,220.189761046831,41.3941403674711
8.7,"max_tuv_SVM","SVM",63,7,3112,3032,80,800,484,316,0.896387661593847,0.7,1.66387792686135,569,276,293,48,1.1,20.45,1.5,0,0,0,0,0,0,0.11180236215431,203.129951419042,34.7627801745703
8.7,"max_tuv_SVM","SVM",63,8,3012,2949,63,900,567,333,0.897721322205855,0.7,1.65530123651671,607,293,314,38,1.1,23.01,1.7,0,0,0,0,0,0,0.123017527048509,195.149807976701,31.1005160818877
8.7,"max_tuv_SVM","SVM",63,9,2912,2852,60,1000,664,336,0.914983908798338,0.69047619047619,1.68805362071231,636,308,328,29,1.1,25.56,2,0,0,0,0,0,0,0.0862819870585479,139.416173124891,27.8554392999669
8.7,"max_tuv_SVM","SVM",63,10,2812,2765,47,1100,751,349,0.920254459171984,0.685714285714286,1.72391475927388,646,312,334,10,1.1,28.12,2.2,0,0,0,0,0,0,0.0770228927624705,113.475274375988,19.5113232449415
8.7,"max_tuv_SVM","SVM",63,11,2712,2671,41,1200,845,355,0.924022254950083,0.685714285714286,1.74267281105991,658,317,341,12,1.1,30.67,2.4,0,0,0,0,0,0,0.062244213792627,83.6555369714359,15.5838547514915
8.7,"max_tuv_SVM","SVM",63,12,2612,2574,38,1300,942,358,0.92552637320678,0.685714285714286,1.73786764705882,665,318,347,7,1.1,33.23,2.6,0,0,0,0,0,0,0.0613079628263029,78.1599452284262,14.4497031065308
8.7,"max_tuv_SVM","SVM",63,13,2512,2478,34,1400,1038,362,0.925759559264706,0.685714285714286,1.75822152065246,668,321,347,3,1.1,35.79,2.9,0,0,0,0,0,0,0.0505996900097922,59.898926818053,11.7894214909135
8.7,"max_tuv_SVM","SVM",63,14,2412,2387,25,1500,1129,371,0.928512791141649,0.676190476190476,1.76355042016807,689,330,359,21,1.1,38.34,3,0,0,0,0,0,0,0.0493704751698621,55.4993691434643,9.15626154382908
8.7,"max_tuv_SVM","SVM",63,15,2312,2293,19,1600,1223,377,0.93004963726613,0.676190476190476,1.76842659644503,700,335,365,11,1.1,40.9,3.2,0,0,0,0,0,0,0.0365170859492329,42.0111201491658,8.02710875633275
8.7,"max_tuv_SVM","SVM",63,16,2212,2197,15,1700,1319,381,0.93072601320024,0.676190476190476,1.76842659644503,716,339,377,16,1.1,43.46,3.5,0,0,0,0,0,0,0.0329440003243552,40.1774267893817,7.30006063666654
8.7,"max_tuv_SVM","SVM",63,17,2112,2100,12,1800,1416,384,0.930625102274587,0.676190476190476,1.76842659644503,719,340,379,3,1.1,46.01,3.7,0,0,0,0,0,0,0.0257824096693373,30.5337888793547,3.79944637207406
8.7,"max_tuv_SVM","SVM",63,18,2012,2002,10,1900,1514,386,0.930382370588558,0.676190476190476,1.76842659644503,725,343,382,6,1.1,48.57,3.9,0,0,0,0,0,0,0.0225478714713914,24.3707467183366,2.32189258676214
8.7,"max_tuv_SVM","SVM",63,19,1912,1903,9,2000,1613,387,0.928375061364756,0.666666666666667,1.7737416217637,740,358,382,15,1.1,51.12,4.2,0,0,0,0,0,0,0.0151332645301473,12.3929762922563,1.98256006949916
8.7,"max_tuv_SVM","SVM",63,20,1812,1804,8,2100,1712,388,0.928557791959857,0.666666666666667,1.77048406139315,742,358,384,2,1.1,53.68,4.4,0,0,0,0,0,0,0.0128009427670137,11.9359191257157,1.4451059216488
8.7,"max_tuv_SVM","SVM",63,21,1712,1705,7,2200,1811,389,0.928612338406158,0.666666666666667,1.7737416217637,744,359,385,2,1.1,56.24,4.7,0,0,0,0,0,0,0.0102713779066688,9.6030744141263,1.09324790126017
8.7,"max_tuv_SVM","SVM",63,22,1612,1605,7,2300,1911,389,0.928560519282174,0.666666666666667,1.7737416217637,747,360,387,3,1.1,58.79,4.9,0,0,0,0,0,0,0.00932922769498758,8.12413291825481,0.954285213176284
8.7,"max_tuv_SVM","SVM",63,23,1512,1505,7,2400,2011,389,0.928574155893749,0.666666666666667,1.76193099829463,756,367,389,9,1.1,61.35,5.2,0,0,0,0,0,0,0.00759573104085767,6.10752830779148,0.849873459314936
8.7,"max_tuv_SVM","SVM",63,24,1412,1407,5,2500,2109,391,0.928775977745058,0.676190476190476,1.77048406139315,760,368,392,4,1.1,63.91,5.4,0,0,0,0,0,0,0.00789993271280045,5.87072487107625,0.806512802926804
8.7,"max_tuv_SVM","SVM",63,25,1312,1307,5,2600,2209,391,0.928958708340157,0.666666666666667,1.76885976408912,768,375,393,8,1,66.46,5.6,0,0,0,0,0,0,0.00620725722049603,4.26825551311118,0.722999410276848
8.7,"max_tuv_SVM","SVM",63,26,1212,1207,5,2700,2309,391,0.928945071728582,0.666666666666667,1.76885976408912,770,375,395,2,1.1,69.02,5.9,0,0,0,0,0,0,0.00501734547194993,2.98422774130242,0.512207373053389
8.7,"max_tuv_SVM","SVM",63,27,1112,1107,5,2800,2409,391,0.928942344406266,0.666666666666667,1.77537490134175,773,377,396,3,1.1,71.57,6.2,0,0,0,0,0,0,0.00383896574179154,2.02191888775013,0.41021114611438
8.7,"max_tuv_SVM","SVM",63,28,1012,1008,4,2900,2508,392,0.929045982654234,0.666666666666667,1.7737416217637,776,378,398,3,1.1,74.13,6.4,0,0,0,0,0,0,0.00385343818795538,1.76075827238226,0.398803486435113
8.7,"max_tuv_SVM","SVM",63,29,912,909,3,3000,2607,393,0.928803250968204,0.666666666666667,1.7770111915734,782,382,400,6,1,76.69,6.6,0,0,0,0,0,0,0.00307759158654346,1.24147817301338,0.330627386015204
8.7,"max_tuv_SVM","SVM",63,30,812,810,2,3100,2706,394,0.928650520918567,0.666666666666667,1.77048406139315,792,385,407,10,1.1,79.24,6.9,0,0,0,0,0,0,0.00313997280880419,1.18144765903327,0.349514567982416
8.7,"max_tuv_SVM","SVM",63,31,712,710,2,3200,2806,394,0.928666884852457,0.666666666666667,1.7770111915734,793,385,408,1,1.1,81.8,7.1,0,0,0,0,0,0,0.002328402813147,0.788902477636643,0.266196723795788
8.7,"max_tuv_SVM","SVM",63,32,612,611,1,3300,2905,395,0.929329624174989,0.666666666666667,1.7737416217637,794,386,408,1,1.1,84.36,7.4,0,0,0,0,0,0,0.00153175544314971,0.521763209810114,0.195876567024536
8.7,"max_tuv_SVM","SVM",63,33,512,511,1,3400,3005,395,0.929423716794856,0.657142857142857,1.77537490134175,796,386,410,2,1.1,86.91,7.6,0,0,0,0,0,0,0.00100535949322884,0.322107669146197,0.126264253324079
8.7,"max_tuv_SVM","SVM",63,34,412,412,0,3500,3104,396,0.929888725249556,0.657142857142857,1.7737416217637,802,389,413,6,1.1,89.47,7.8,0,0,0,0,0,0,0.00078214759903994,0.234915961969807,0.095489214932731
8.7,"max_tuv_SVM","SVM",63,35,312,312,0,3600,3204,396,0.930008727431415,0.661904761904762,1.76885976408912,808,391,417,6,1.1,92.02,8.1,0,0,0,0,0,0,0.000477649684403787,0.117887521103859,0.056986668189116
8.7,"max_tuv_SVM","SVM",63,36,212,212,0,3700,3304,396,0.930286914307541,0.657142857142857,1.77537490134175,807,391,416,-1,1.1,94.58,8.3,0,0,0,0,0,0,0.000216518881228844,0.0458296402079708,0.029513377949807
8.7,"max_tuv_SVM","SVM",63,37,112,112,0,3800,3404,396,0.930657830142375,0.657142857142857,1.7770111915734,808,393,415,1,1.1,97.14,8.6,0,0,0,0,0,0,0.000103383649020904,0.0165058350714107,0.0154465290708718
8.7,"max_tuv_SVM","SVM",63,38,12,12,0,3900,3504,396,0.931012382043324,0.657142857142857,1.7737416217637,812,394,418,4,1.1,99.69,8.8,0,0,0,0,0,0,6.65374397583508e-05,0.000955576636082232,0.000955576636082232
8.7,"max_tuv_SVM","SVM",63,39,0,0,0,3912,3516,396,0.931116020291293,0.657142857142857,1.77048406139315,815,394,421,3,1.1,100,8.9,0,0,0,0,0,0,0,0,0
8.7,"max_tuv_SVM","SVM",64,0,3812,3415,397,100,85,15,0.901570380425259,0.541237113402062,1.74700935911445,37,15,22,0,1.5,2.56,5.7,0,0,0,0,0,0,0.299161710392923,469.447952311288,32.84948517805
8.7,"max_tuv_SVM","SVM",64,1,3712,3384,328,200,116,84,0.934968756216586,0.577319587628866,1.7759954601343,106,54,52,69,1,5.11,1.4,0,0,0,0,0,0,0.662284621961085,358.551682246345,73.9065708638191
8.7,"max_tuv_SVM","SVM",64,2,3612,3323,289,300,177,123,0.926322594989303,0.61340206185567,1.75307049573687,199,98,101,93,1,7.67,1.4,0,0,0,0,0,0,0.581766878882421,362.950117685398,68.423100919341
8.7,"max_tuv_SVM","SVM",64,3,3512,3269,243,400,231,169,0.906448564775287,0.597938144329897,1.71439129775622,291,144,147,92,1,10.22,1.4,0,0,0,0,0,0,0.427889392021428,272.582868982554,65.1200434474841
8.7,"max_tuv_SVM","SVM",64,4,3412,3225,187,500,275,225,0.914282914214169,0.639175257731959,1.71754855613146,354,176,178,63,1,12.78,1.2,0,0,0,0,0,0,0.276165071090926,234.662729086304,54.9522847779234
8.7,"max_tuv_SVM","SVM",64,5,3312,3146,166,600,354,246,0.900196882642733,0.649484536082474,1.69898046363274,408,199,209,54,1.1,15.34,1.4,0,0,0,0,0,0,0.159983384521584,167.998632397527,42.8923479439876
8.7,"max_tuv_SVM","SVM",64,6,3212,3074,138,700,426,274,0.901418257135173,0.670103092783505,1.69125374127037,464,221,243,56,1.1,17.89,1.6,0,0,0,0,0,0,0.111063587331254,151.916354213128,31.5563221573185
8.7,"max_tuv_SVM","SVM",64,7,3112,3000,112,800,500,300,0.896894051979357,0.664948453608247,1.65878941782899,508,246,262,44,1.1,20.45,1.7,0,0,0,0,0,0,0.130873141815981,177.953771108753,29.6727638933238
8.7,"max_tuv_SVM","SVM",64,8,3012,2913,99,900,587,313,0.896149525492356,0.654639175257732,1.65103993778393,554,266,288,46,1.1,23.01,1.9,0,0,0,0,0,0,0.0968232927713993,142.463186593458,26.4196844894261
8.7,"max_tuv_SVM","SVM",64,9,2912,2830,82,1000,670,330,0.903471921551202,0.654639175257732,1.67266853532234,584,281,303,30,1.1,25.56,2,0,0,0,0,0,0,0.0771613100851889,108.754461749847,19.6087071854223
8.7,"max_tuv_SVM","SVM",64,10,2812,2748,64,1100,752,348,0.906409071228811,0.654639175257732,1.66959094832083,621,298,323,37,1.1,28.12,2.2,0,0,0,0,0,0,0.0883312280246018,116.493075778119,18.021000690757
8.7,"max_tuv_SVM","SVM",64,11,2712,2657,55,1200,843,357,0.908331090489955,0.65979381443299,1.67112832488466,645,308,337,24,1.1,30.67,2.4,0,0,0,0,0,0,0.0858375952292922,98.8906553086657,17.9278551753142
8.7,"max_tuv_SVM","SVM",64,12,2612,2560,52,1300,940,360,0.908293059667444,0.65979381443299,1.68196113829636,652,312,340,7,1.1,33.23,2.6,0,0,0,0,0,0,0.0709673642010378,79.6849090983865,16.3800161777142
8.7,"max_tuv_SVM","SVM",64,13,2512,2465,47,1400,1035,365,0.907946394092943,0.65979381443299,1.68041237113402,662,317,345,10,1.1,35.79,2.8,0,0,0,0,0,0,0.0630122497511334,71.3782580119918,15.8267335304831
8.7,"max_tuv_SVM","SVM",64,14,2412,2373,39,1500,1127,373,0.908579753560278,0.664948453608247,1.68041237113402,682,324,358,20,1.1,38.34,3,0,0,0,0,0,0,0.0590552234546559,67.9028174416108,15.3895944127211
8.7,"max_tuv_SVM","SVM",64,15,2312,2280,32,1600,1220,380,0.913617374820091,0.65979381443299,1.69741746412618,698,331,367,16,1.1,40.9,3.2,0,0,0,0,0,0,0.0530325982405698,65.0019909161824,13.278569581653
8.7,"max_tuv_SVM","SVM",64,16,2212,2184,28,1700,1316,384,0.921539487695568,0.65979381443299,1.70669296939463,709,338,371,11,1.1,43.46,3.4,0,0,0,0,0,0,0.0452000653602738,57.3671394609461,12.2799125561425
8.7,"max_tuv_SVM","SVM",64,17,2112,2090,22,1800,1410,390,0.923167499444168,0.670103092783505,1.69887844114648,728,345,383,19,1.1,46.01,3.6,0,0,0,0,0,0,0.0372830100256748,46.3097022685964,10.4770701687459
8.7,"max_tuv_SVM","SVM",64,18,2012,1995,17,1900,1505,395,0.924524907263301,0.664948453608247,1.71439129775622,740,354,386,12,1.1,48.57,3.8,0,0,0,0,0,0,0.0266098030440201,29.844796898062,6.92787499132881
8.7,"max_tuv_SVM","SVM",64,19,1912,1903,9,2000,1597,403,0.925736042688133,0.675257731958763,1.71754855613146,751,362,389,11,1.1,51.12,4,0,0,0,0,0,0,0.0252503722325901,23.8280457307421,2.61945500396021
8.7,"max_tuv_SVM","SVM",64,20,1812,1805,7,2100,1695,405,0.92977169804698,0.65979381443299,1.73133395813808,776,374,402,25,1.1,53.68,4.2,0,0,0,0,0,0,0.0186412622636784,16.1925843721315,2.3010374293478
8.7,"max_tuv_SVM","SVM",64,21,1712,1705,7,2200,1795,405,0.929663456475196,0.65979381443299,1.73611664863018,775,374,401,-1,1.1,56.24,4.4,0,0,0,0,0,0,0.0151961206721331,12.7709369973975,1.60029595898421
8.7,"max_tuv_SVM","SVM",64,22,1612,1607,5,2300,1893,407,0.930099348210226,0.649484536082474,1.74540069487954,784,379,405,9,1.1,58.79,4.7,0,0,0,0,0,0,0.0139058683442679,11.0778540978973,1.46102913235652
8.7,"max_tuv_SVM","SVM",64,23,1512,1507,5,2400,1993,407,0.93088921913946,0.649484536082474,1.74540069487954,789,381,408,5,1.1,61.35,4.9,0,0,0,0,0,0,0.0104712777654379,7.88426286563738,1.17959633116068
8.7,"max_tuv_SVM","SVM",64,24,1412,1408,4,2500,2092,408,0.93104426787742,0.649484536082474,1.74540069487954,796,384,412,7,1.1,63.91,5.1,0,0,0,0,0,0,0.0095303153320525,6.5440890188284,0.994249143968511
8.7,"max_tuv_SVM","SVM",64,25,1312,1308,4,2600,2192,408,0.93244555741484,0.654639175257732,1.75307049573687,805,391,414,9,1.1,66.46,5.4,0,0,0,0,0,0,0.0068446408395072,4.4217434867969,0.791011428357035
8.7,"max_tuv_SVM","SVM",64,26,1212,1208,4,2700,2292,408,0.932346092186714,0.654639175257732,1.75307049573687,804,390,414,-1,1.1,69.02,5.6,0,0,0,0,0,0,0.00613186418949335,3.44807531982863,0.629864650339138
8.7,"max_tuv_SVM","SVM",64,27,1112,1108,4,2800,2392,408,0.933377312566549,0.649484536082474,1.7514592177077,808,394,414,4,1.1,71.57,5.9,0,0,0,0,0,0,0.00489367484123979,2.49242863146427,0.531313971059873
8.7,"max_tuv_SVM","SVM",64,28,1012,1008,4,2900,2492,408,0.933405104321466,0.649484536082474,1.75307049573687,808,394,414,0,1.1,74.13,6.1,0,0,0,0,0,0,0.00429329621011327,1.85920717092584,0.450169561408399
8.7,"max_tuv_SVM","SVM",64,29,912,908,4,3000,2592,408,0.933664006459383,0.644329896907217,1.75468474112889,809,394,415,1,1.1,76.69,6.4,0,0,0,0,0,0,0.00359526996886879,1.35455818396476,0.392178707441079
8.7,"max_tuv_SVM","SVM",64,30,812,809,3,3100,2691,409,0.933760546239622,0.644329896907217,1.74824553106971,812,397,415,3,1,79.24,6.6,0,0,0,0,0,0,0.00325432626879232,1.10825847481891,0.366821516836909
8.7,"max_tuv_SVM","SVM",64,31,712,709,3,3200,2791,409,0.933766397135394,0.644329896907217,1.7514592177077,813,397,416,1,1,81.8,6.8,0,0,0,0,0,0,0.00216455637574553,0.693271904331213,0.260019760942
8.7,"max_tuv_SVM","SVM",64,32,612,610,2,3300,2890,410,0.93412622722538,0.644329896907217,1.75468474112889,818,399,419,5,1.1,84.36,7,0,0,0,0,0,0,0.00181105259315528,0.544294710497079,0.221008419143335
8.7,"max_tuv_SVM","SVM",64,33,512,510,2,3400,2990,410,0.934329545853463,0.644329896907217,1.74985089886683,816,399,417,-2,1,86.91,7.3,0,0,0,0,0,0,0.000953276573273292,0.296713881431222,0.130059109870784
8.7,"max_tuv_SVM","SVM",64,34,412,411,1,3500,3089,411,0.934651345120933,0.649484536082474,1.7514592177077,823,401,422,7,1.1,89.47,7.5,0,0,0,0,0,0,0.000704940834285501,0.205703245063664,0.091330583525378
8.7,"max_tuv_SVM","SVM",64,35,312,312,0,3600,3188,412,0.934905859087024,0.649484536082474,1.75910936923121,830,405,425,7,1,92.02,7.7,0,0,0,0,0,0,0.00052979424092436,0.130586439570291,0.0663989947512649
8.7,"max_tuv_SVM","SVM",64,36,212,212,0,3700,3288,412,0.935170612120718,0.644329896907217,1.76999317768344,836,406,430,6,1.1,94.58,8,0,0,0,0,0,0,0.000268504985244181,0.0556078509122253,0.0360378813094289
8.7,"max_tuv_SVM","SVM",64,37,112,112,0,3800,3388,412,0.935552383069856,0.644329896907217,1.76559456506247,834,407,427,-2,1,97.14,8.2,0,0,0,0,0,0,9.98918251708381e-05,0.0184684825638948,0.0174063817775869
8.7,"max_tuv_SVM","SVM",64,38,12,12,0,3900,3488,412,0.935637221058556,0.644329896907217,1.75910936923121,836,407,429,2,1.1,99.69,8.5,0,0,0,0,0,0,5.20623812340688e-05,0.000733448974177216,0.000733448974177216
8.7,"max_tuv_SVM","SVM",64,39,0,0,0,3912,3500,412,0.935610892027582,0.644329896907217,1.75427665118387,836,407,429,0,1.1,100,8.5,0,0,0,0,0,0,0,0,0
8.7,"max_tuv_SVM","SVM",65,0,3812,3425,387,100,88,12,0.892628776139863,0.51207729468599,1.72438389100381,32,12,20,0,1.7,2.56,7.3,0,0,0,0,0,0,0.330568169579672,399.805860686291,35.6145341340338
8.7,"max_tuv_SVM","SVM",65,1,3712,3395,317,200,118,82,0.925174633952323,0.57487922705314,1.79944802207912,98,49,49,66,1,5.11,1.4,0,0,0,0,0,0,0.625487642304616,345.090474513943,69.7382015266232
8.7,"max_tuv_SVM","SVM",65,2,3612,3331,281,300,182,118,0.916421530039268,0.589371980676328,1.74729010839566,189,92,97,91,1.1,7.67,1.5,0,0,0,0,0,0,0.642100801237964,286.699083797774,76.6784021273315
8.7,"max_tuv_SVM","SVM",65,3,3512,3268,244,400,245,155,0.920501155940042,0.594202898550725,1.72831415174766,274,135,139,85,1,10.22,1.6,0,0,0,0,0,0,0.518118708248871,207.317033016989,69.4016545637767
8.7,"max_tuv_SVM","SVM",65,4,3412,3222,190,500,291,209,0.917631331085002,0.618357487922705,1.7401980409427,356,176,180,82,1,12.78,1.4,0,0,0,0,0,0,0.20208895008417,136.565887799689,54.2194448147285
8.7,"max_tuv_SVM","SVM",65,5,3312,3162,150,600,351,249,0.927602522352331,0.63768115942029,1.77336906523739,410,201,209,54,1,15.34,1.4,0,0,0,0,0,0,0.122408321563327,91.1656466319162,37.1702050554819
8.7,"max_tuv_SVM","SVM",65,6,3212,3097,115,700,416,284,0.925497799985093,0.642512077294686,1.74568414322251,460,221,239,50,1.1,17.89,1.5,0,0,0,0,0,0,0.0987539929390162,82.3639820474492,20.9252882133748
8.7,"max_tuv_SVM","SVM",65,7,3112,3018,94,800,495,305,0.924180276928422,0.647342995169082,1.73309290055433,501,239,262,41,1.1,20.45,1.6,0,0,0,0,0,0,0.0780908520686417,88.4925044099996,16.1731216048242
8.7,"max_tuv_SVM","SVM",65,8,3012,2939,73,900,574,326,0.92015865518737,0.666666666666667,1.70382518032612,551,267,284,50,1.1,23.01,1.8,0,0,0,0,0,0,0.0691026623591529,110.730398500735,13.0014076795752
8.7,"max_tuv_SVM","SVM",65,9,2912,2851,61,1000,662,338,0.933521708747306,0.661835748792271,1.70937304534142,583,282,301,32,1.1,25.56,2,0,0,0,0,0,0,0.0819043013592083,121.828336592741,14.3381533476836
8.7,"max_tuv_SVM","SVM",65,10,2812,2765,47,1100,748,352,0.946024367271296,0.671497584541063,1.77500200176155,637,302,335,54,1.1,28.12,2.1,0,0,0,0,0,0,0.0832140183059733,109.108531437607,13.7522814639396
8.7,"max_tuv_SVM","SVM",65,11,2712,2666,46,1200,847,353,0.948841712172315,0.666666666666667,1.79240398217098,639,304,335,2,1.1,30.67,2.4,0,0,0,0,0,0,0.0706654281615541,89.0708710142377,11.8610880863095
8.7,"max_tuv_SVM","SVM",65,12,2612,2571,41,1300,942,358,0.949619244122938,0.657004830917874,1.79240398217098,652,312,340,13,1.1,33.23,2.6,0,0,0,0,0,0,0.063338728112857,73.5216969602059,10.4175515003731
8.7,"max_tuv_SVM","SVM",65,13,2512,2475,37,1400,1038,362,0.949646865151384,0.652173913043478,1.79075503646521,667,319,348,15,1.1,35.79,2.9,0,0,0,0,0,0,0.0600871374591638,58.7942716396906,10.1696178410581
8.7,"max_tuv_SVM","SVM",65,14,2412,2378,34,1500,1135,365,0.949757349265149,0.652173913043478,1.794055967408,670,321,349,3,1.1,38.34,3.1,0,0,0,0,0,0,0.0504917237375257,50.9482716238274,8.23256711598328
8.7,"max_tuv_SVM","SVM",65,15,2312,2286,26,1600,1227,373,0.95144499410292,0.652173913043478,1.78746623015398,683,328,355,13,1.1,40.9,3.3,0,0,0,0,0,0,0.0460220579220032,48.7083789666166,7.02751052541355
8.7,"max_tuv_SVM","SVM",65,16,2212,2192,20,1700,1321,379,0.951984985208948,0.647342995169082,1.78910912190963,702,334,368,19,1.1,43.46,3.5,0,0,0,0,0,0,0.0369619546458567,41.2002274143015,6.17190578883835
8.7,"max_tuv_SVM","SVM",65,17,2112,2095,17,1800,1418,382,0.951806829575501,0.642512077294686,1.78910912190963,711,337,374,9,1.1,46.01,3.7,0,0,0,0,0,0,0.0301832053095835,33.4587057161708,3.32590631321106
8.7,"max_tuv_SVM","SVM",65,18,2012,1997,15,1900,1516,384,0.95183859375821,0.647342995169082,1.78910912190963,716,340,376,5,1.1,48.57,3.9,0,0,0,0,0,0,0.0272711282990417,29.0090276853552,2.82197967606907
8.7,"max_tuv_SVM","SVM",65,19,1912,1899,13,2000,1614,386,0.951801305369806,0.657004830917874,1.79944802207912,734,356,378,18,1.1,51.12,4.2,0,0,0,0,0,0,0.0208058352285567,15.7778655885397,2.6184096320071
8.7,"max_tuv_SVM","SVM",65,20,1812,1800,12,2100,1713,387,0.951790256958431,0.657004830917874,1.79944802207912,737,357,380,3,1.1,53.68,4.4,0,0,0,0,0,0,0.0148234013587158,13.0427618854219,1.73037070239344
8.7,"max_tuv_SVM","SVM",65,21,1712,1704,8,2200,1809,391,0.951758492775723,0.657004830917874,1.79779411764706,746,362,384,9,1.1,56.24,4.6,0,0,0,0,0,0,0.0134373174239627,12.3887761933375,1.51046858601688
8.7,"max_tuv_SVM","SVM",65,22,1612,1605,7,2300,1908,392,0.951414610971627,0.657004830917874,1.80276497695853,752,365,387,6,1.1,58.79,4.9,0,0,0,0,0,0,0.0134819561202153,11.4245944903492,1.37134510179193
8.7,"max_tuv_SVM","SVM",65,23,1512,1505,7,2400,2008,392,0.949641340945693,0.647342995169082,1.79944802207912,765,374,391,13,1,61.35,5.1,0,0,0,0,0,0,0.0103135673406318,7.82247038751266,1.31084406066573
8.7,"max_tuv_SVM","SVM",65,24,1412,1405,7,2500,2108,392,0.949863690224646,0.647342995169082,1.79779411764706,765,374,391,0,1,63.91,5.4,0,0,0,0,0,0,0.00781614271907831,5.83750196489363,0.845502793925429
8.7,"max_tuv_SVM","SVM",65,25,1312,1307,5,2600,2206,394,0.950347058222369,0.647342995169082,1.79779411764706,775,376,399,10,1.1,66.46,5.6,0,0,0,0,0,0,0.00793189114863312,5.70812824395276,0.843650888248445
8.7,"max_tuv_SVM","SVM",65,26,1212,1207,5,2700,2306,394,0.950157854177546,0.642512077294686,1.80110497237569,782,381,401,7,1.1,69.02,5.9,0,0,0,0,0,0,0.00663161791640394,4.32019416505063,0.71328156296212
8.7,"max_tuv_SVM","SVM",65,27,1112,1109,3,2800,2404,396,0.950384346610764,0.642512077294686,1.80110497237569,788,384,404,6,1.1,71.57,6.1,0,0,0,0,0,0,0.00617174986243957,3.5965002545715,0.640525463353083
8.7,"max_tuv_SVM","SVM",65,28,1012,1009,3,2900,2504,396,0.950105374223507,0.642512077294686,1.80110497237569,797,387,410,9,1.1,74.13,6.3,0,0,0,0,0,0,0.00476379458917491,2.40234300601808,0.504693797801343
8.7,"max_tuv_SVM","SVM",65,29,912,909,3,3000,2604,396,0.950005938521119,0.642512077294686,1.80110497237569,797,387,410,0,1.1,76.69,6.6,0,0,0,0,0,0,0.00429571275878491,1.87507526228311,0.454812687472277
8.7,"max_tuv_SVM","SVM",65,30,812,809,3,3100,2704,396,0.949916170178684,0.642512077294686,1.79779411764706,796,389,407,-1,1,79.24,6.8,0,0,0,0,0,0,0.00315252067551277,1.21786875713449,0.343787281733228
8.7,"max_tuv_SVM","SVM",65,31,712,709,3,3200,2804,396,0.950011462726807,0.642512077294686,1.80110497237569,797,389,408,1,1,81.8,7.1,0,0,0,0,0,0,0.00275645770326683,0.96485683211935,0.313483323549546
8.7,"max_tuv_SVM","SVM",65,32,612,609,3,3300,2904,396,0.950130233149105,0.642512077294686,1.79614325068871,798,389,409,1,1.1,84.36,7.3,0,0,0,0,0,0,0.00206119146445981,0.651512326825265,0.239303951964753
8.7,"max_tuv_SVM","SVM",65,33,512,509,3,3400,3004,396,0.950236574108604,0.642512077294686,1.79120879120879,800,389,411,2,1.1,86.91,7.6,0,0,0,0,0,0,0.00112264920319494,0.355126501852494,0.148540663051648
8.7,"max_tuv_SVM","SVM",65,34,412,412,0,3500,3101,399,0.950527975958659,0.647342995169082,1.79779411764706,812,394,418,12,1.1,89.47,7.8,0,0,0,0,0,0,0.00129375467187473,0.387281966191611,0.174802944985526
8.7,"max_tuv_SVM","SVM",65,35,312,312,0,3600,3201,399,0.950740657877658,0.642512077294686,1.79449541284404,818,396,422,6,1.1,92.02,8,0,0,0,0,0,0,0.00102627427984726,0.27171428681897,0.132581999914268
8.7,"max_tuv_SVM","SVM",65,36,212,212,0,3700,3301,399,0.950884287225554,0.63768115942029,1.80276497695853,817,397,420,-1,1.1,94.58,8.3,0,0,0,0,0,0,0.000304773587004537,0.0630415801250048,0.0392844131940148
8.7,"max_tuv_SVM","SVM",65,37,112,112,0,3800,3401,399,0.95115497330428,0.632850241545894,1.79944802207912,815,398,417,-2,1,97.14,8.5,0,0,0,0,0,0,0.000127422940691947,0.0206659984393572,0.0193206061456741
8.7,"max_tuv_SVM","SVM",65,38,12,12,0,3900,3501,399,0.951138400687215,0.63768115942029,1.79614325068871,816,399,417,1,1,99.69,8.8,0,0,0,0,0,0,0.00013717822451643,0.00184288555015858,0.00184288555015858
8.7,"max_tuv_SVM","SVM",65,39,0,0,0,3912,3513,399,0.951157735407124,0.63768115942029,1.80276497695853,817,399,418,1,1,100,8.8,0,0,0,0,0,0,0,0,0
8.7,"max_tuv_SVM","SVM",66,0,3812,3404,408,100,94,6,0.901080050075587,0.541666666666667,1.73703917050691,20,6,14,0,2.3,2.56,15.7,0,0,0,0,0,0,0.164782213421215,256.544012523125,18.5143926293423
8.7,"max_tuv_SVM","SVM",66,1,3712,3367,345,200,131,69,0.919944019274374,0.604166666666667,1.76807851239669,92,46,46,72,1,5.11,1.9,0,0,0,0,0,0,0.755829755027699,304.431440207534,83.4704228495546
8.7,"max_tuv_SVM","SVM",66,2,3612,3301,311,300,197,103,0.903722600151177,0.614583333333333,1.74161305147059,183,93,90,91,1,7.67,1.9,0,0,0,0,0,0,0.651917164479787,197.179414903136,77.2443823256336
8.7,"max_tuv_SVM","SVM",66,3,3512,3258,254,400,240,160,0.903338766061968,0.598958333333333,1.71814848762603,267,133,134,84,1,10.22,1.5,0,0,0,0,0,0,0.566667714402347,193.404238593271,74.2231878117695
8.7,"max_tuv_SVM","SVM",66,4,3412,3210,202,500,288,212,0.905009920634921,0.619791666666667,1.72605893186004,343,169,174,76,1,12.78,1.4,0,0,0,0,0,0,0.226403316884341,133.782153626302,63.3386474711494
8.7,"max_tuv_SVM","SVM",66,5,3312,3158,154,600,340,260,0.885283801020411,0.645833333333333,1.65253456221198,420,207,213,77,1,15.34,1.3,0,0,0,0,0,0,0.165265329471664,126.179187303022,46.5787821287759
8.7,"max_tuv_SVM","SVM",66,6,3212,3082,130,700,416,284,0.897756932634168,0.661458333333333,1.64797794117647,455,225,230,35,1,17.89,1.5,0,0,0,0,0,0,0.0981422926230086,92.757641615301,35.1793253102978
8.7,"max_tuv_SVM","SVM",66,7,3112,3012,100,800,486,314,0.898058094765678,0.666666666666667,1.65101289134438,505,243,262,50,1.1,20.45,1.5,0,0,0,0,0,0,0.0816189976481626,97.3196202657185,24.0883688963646
8.7,"max_tuv_SVM","SVM",66,8,3012,2936,76,900,562,338,0.892942767384736,0.692708333333333,1.64314516129032,558,265,293,53,1.1,23.01,1.7,0,0,0,0,0,0,0.0659620975505777,104.726071855359,19.7299709536853
8.7,"max_tuv_SVM","SVM",66,9,2912,2844,68,1000,654,346,0.906226379440665,0.682291666666667,1.65581955922865,580,278,302,22,1.1,25.56,1.9,0,0,0,0,0,0,0.0568462345497863,86.1271982810032,15.3211147172778
8.7,"max_tuv_SVM","SVM",66,10,2812,2761,51,1100,737,363,0.912104946145127,0.682291666666667,1.68070276497696,612,293,319,32,1.1,28.12,2,0,0,0,0,0,0,0.0563113143505918,78.5723090960552,7.44572108308651
8.7,"max_tuv_SVM","SVM",66,11,2712,2667,45,1200,831,369,0.932217852418756,0.651041666666667,1.73841743119266,648,314,334,36,1.1,30.67,2.3,0,0,0,0,0,0,0.0500338365219672,52.5230234725901,7.02974710491868
8.7,"max_tuv_SVM","SVM",66,12,2612,2577,35,1300,921,379,0.935825892857166,0.651041666666667,1.76358195211786,670,326,344,22,1.1,33.23,2.4,0,0,0,0,0,0,0.0525116242229145,54.1998698221162,6.26275455950816
8.7,"max_tuv_SVM","SVM",66,13,2512,2480,32,1400,1018,382,0.936950821995488,0.645833333333333,1.78398617511521,682,331,351,12,1.1,35.79,2.7,0,0,0,0,0,0,0.050910759608852,45.6913701435923,5.66708140287001
8.7,"max_tuv_SVM","SVM",66,14,2412,2384,28,1500,1114,386,0.937125023620582,0.645833333333333,1.78234346224678,700,340,360,18,1.1,38.34,2.9,0,0,0,0,0,0,0.0490167919089486,37.3815342750652,5.37169963516302
8.7,"max_tuv_SVM","SVM",66,15,2312,2287,25,1600,1211,389,0.937437996031769,0.645833333333333,1.78234346224678,708,345,363,8,1.1,40.9,3.1,0,0,0,0,0,0,0.043882896097587,30.2358648002911,4.94908442873542
8.7,"max_tuv_SVM","SVM",66,16,2212,2192,20,1700,1306,394,0.938179091080899,0.645833333333333,1.78398617511521,730,351,379,22,1.1,43.46,3.3,0,0,0,0,0,0,0.0386143521588241,26.2661887348227,4.69440572164493
8.7,"max_tuv_SVM","SVM",66,17,2112,2096,16,1800,1402,398,0.937748015873042,0.645833333333333,1.77459677419355,736,355,381,6,1.1,46.01,3.5,0,0,0,0,0,0,0.0296009548714054,23.0186191001799,3.61501303701213
8.7,"max_tuv_SVM","SVM",66,18,2012,1999,13,1900,1499,401,0.937966506046886,0.645833333333333,1.77459677419355,741,357,384,5,1.1,48.57,3.7,0,0,0,0,0,0,0.0230857410600138,20.5153152128538,2.6963209220935
8.7,"max_tuv_SVM","SVM",66,19,1912,1899,13,2000,1599,401,0.93788678665913,0.645833333333333,1.77459677419355,742,358,384,1,1.1,51.12,4,0,0,0,0,0,0,0.0173908482204583,15.8840637909963,1.92180556538633
8.7,"max_tuv_SVM","SVM",66,20,1812,1800,12,2100,1698,402,0.93799012660622,0.645833333333333,1.77459677419355,747,359,388,5,1.1,53.68,4.2,0,0,0,0,0,0,0.0146924654692672,13.5050671568793,1.55434007632467
8.7,"max_tuv_SVM","SVM",66,21,1712,1702,10,2200,1796,404,0.938007842025719,0.640625,1.78398617511521,758,368,390,11,1.1,56.24,4.4,0,0,0,0,0,0,0.0112472954560334,9.82476665050181,1.26977097440601
8.7,"max_tuv_SVM","SVM",66,22,1612,1603,9,2300,1895,405,0.937851355820127,0.640625,1.78398617511521,766,372,394,8,1.1,58.79,4.7,0,0,0,0,0,0,0.0115286192455633,9.09870370789123,1.17302845062183
8.7,"max_tuv_SVM","SVM",66,23,1512,1504,8,2400,1994,406,0.936832719198811,0.640625,1.78398617511521,781,380,401,15,1.1,61.35,4.9,0,0,0,0,0,0,0.00750052057853848,5.0737662954124,0.918164863096869
8.7,"max_tuv_SVM","SVM",66,24,1412,1405,7,2500,2093,407,0.937030541383241,0.645833333333333,1.78398617511521,781,381,400,0,1,63.91,5.1,0,0,0,0,0,0,0.00711950695036812,5.01748293278658,0.766564659918129
8.7,"max_tuv_SVM","SVM",66,25,1312,1306,6,2600,2192,408,0.937266746976589,0.640625,1.78398617511521,786,385,401,5,1,66.46,5.4,0,0,0,0,0,0,0.00572040521959185,3.82523099620597,0.613240713925903
8.7,"max_tuv_SVM","SVM",66,26,1212,1207,5,2700,2291,409,0.937145691609997,0.640625,1.78070377184913,796,387,409,10,1.1,69.02,5.6,0,0,0,0,0,0,0.00613169261498641,3.53300904573278,0.63656439627979
8.7,"max_tuv_SVM","SVM",66,27,1112,1107,5,2800,2391,409,0.93729332010584,0.645833333333333,1.77580275229358,805,394,411,9,1,71.57,5.8,0,0,0,0,0,0,0.00456893074995649,2.40629000852596,0.498553176909579
8.7,"max_tuv_SVM","SVM",66,28,1012,1008,4,2900,2490,410,0.937344990079385,0.640625,1.77906709558824,809,393,416,4,1.1,74.13,6.1,0,0,0,0,0,0,0.00445214685884509,2.1097497343592,0.472471123812731
8.7,"max_tuv_SVM","SVM",66,29,912,909,3,3000,2589,411,0.937364181783845,0.645833333333333,1.7774334251607,815,396,419,6,1.1,76.69,6.3,0,0,0,0,0,0,0.00380786963340251,1.6043948058495,0.41146678726773
8.7,"max_tuv_SVM","SVM",66,30,812,809,3,3100,2689,411,0.93736861063872,0.645833333333333,1.77580275229358,816,396,420,1,1.1,79.24,6.5,0,0,0,0,0,0,0.00307537798125851,1.15450753686363,0.339823107434161
8.7,"max_tuv_SVM","SVM",66,31,712,710,2,3200,2788,412,0.937505905139855,0.645833333333333,1.78070377184913,821,398,423,5,1.1,81.8,6.8,0,0,0,0,0,0,0.00243147283183251,0.863592365779097,0.27679725446192
8.7,"max_tuv_SVM","SVM",66,32,612,611,1,3300,2887,413,0.937432090891933,0.645833333333333,1.78398617511521,825,402,423,4,1.1,84.36,7,0,0,0,0,0,0,0.00185418171825619,0.603584147777954,0.214990226032329
8.7,"max_tuv_SVM","SVM",66,33,512,511,1,3400,2987,413,0.937451282596392,0.645833333333333,1.77906709558824,823,402,421,-2,1,86.91,7.2,0,0,0,0,0,0,0.00137470015265383,0.431279703756212,0.165755449237253
8.7,"max_tuv_SVM","SVM",66,34,412,411,1,3500,3087,413,0.937401088907806,0.645833333333333,1.78234346224678,822,401,421,-1,1,89.47,7.5,0,0,0,0,0,0,0.000784481162616921,0.229074772181556,0.0987632648071112
8.7,"max_tuv_SVM","SVM",66,35,312,312,0,3600,3186,414,0.937758349867745,0.645833333333333,1.77906709558824,828,405,423,6,1,92.02,7.7,0,0,0,0,0,0,0.000783082233861802,0.197677539443584,0.0986253799117452
8.7,"max_tuv_SVM","SVM",66,36,212,212,0,3700,3286,414,0.937895644368878,0.645833333333333,1.7774334251607,834,407,427,6,1,94.58,7.9,0,0,0,0,0,0,0.000347221228168392,0.0747531034545006,0.0475436504988184
8.7,"max_tuv_SVM","SVM",66,37,112,112,0,3800,3386,414,0.93808165627364,0.645833333333333,1.78398617511521,837,409,428,3,1,97.14,8.2,0,0,0,0,0,0,0.000123539494384713,0.0195923709699558,0.0182747789307405
8.7,"max_tuv_SVM","SVM",66,38,12,12,0,3900,3486,414,0.938424154383994,0.645833333333333,1.78398617511521,837,410,427,0,1,99.69,8.4,0,0,0,0,0,0,9.45406623867318e-05,0.00131400384262906,0.00131400384262906
8.7,"max_tuv_SVM","SVM",66,39,0,0,0,3912,3498,414,0.938409391534409,0.645833333333333,1.78398617511521,837,410,427,0,1,100,8.4,0,0,0,0,0,0,0,0,0
8.7,"max_tuv_SVM","SVM",67,0,3812,3414,398,100,87,13,0.856905313123366,0.420512820512821,1.68258064516129,42,13,29,0,2.2,2.56,6.7,0,0,0,0,0,0,0.167666471854909,507.1664596909,18.1653596490019
8.7,"max_tuv_SVM","SVM",67,1,3712,3352,360,200,149,51,0.909212423011404,0.528205128205128,1.75768525052929,108,49,59,66,1.2,5.11,2.9,0,0,0,0,0,0,0.804766582791965,510.066508386589,85.0540807423026
8.7,"max_tuv_SVM","SVM",67,2,3612,3280,332,300,221,79,0.929067109305605,0.656410256410256,1.77503013115916,176,78,98,68,1.3,7.67,2.8,0,0,0,0,0,0,0.707195518525876,426.441976372237,78.5980996005999
8.7,"max_tuv_SVM","SVM",67,3,3512,3225,287,400,276,124,0.919315948106398,0.635897435897436,1.73644992208528,256,121,135,80,1.1,10.22,2.2,0,0,0,0,0,0,0.593689517202607,436.915106573222,67.8576783365903
8.7,"max_tuv_SVM","SVM",67,4,3412,3177,235,500,324,176,0.918992705193724,0.635897435897436,1.73644992208528,326,157,169,70,1.1,12.78,1.8,0,0,0,0,0,0,0.650850752019073,289.095059477127,80.0569491312886
8.7,"max_tuv_SVM","SVM",67,5,3312,3114,198,600,387,213,0.917281847435161,0.666666666666667,1.71797705057374,413,201,212,87,1.1,15.34,1.8,0,0,0,0,0,0,0.339469094512506,258.847439154302,76.0652316874687
8.7,"max_tuv_SVM","SVM",67,6,3212,3061,151,700,440,260,0.915914617277471,0.676923076923077,1.68406492589979,482,231,251,69,1.1,17.89,1.7,0,0,0,0,0,0,0.141673275331586,202.667057589478,55.1646186756123
8.7,"max_tuv_SVM","SVM",67,7,3112,3001,111,800,500,300,0.916801351213607,0.682051282051282,1.70107054236086,540,258,282,58,1.1,20.45,1.7,0,0,0,0,0,0,0.111818754524877,177.385954069511,39.4673783406376
8.7,"max_tuv_SVM","SVM",67,8,3012,2915,97,900,586,314,0.920764717016818,0.666666666666667,1.71031549096065,569,274,295,29,1.1,23.01,1.9,0,0,0,0,0,0,0.081616127762307,124.658255536771,33.3620929994209
8.7,"max_tuv_SVM","SVM",67,9,2912,2841,71,1000,660,340,0.927529521396609,0.656410256410256,1.72245532245532,605,289,316,36,1.1,25.56,1.9,0,0,0,0,0,0,0.0923349346550624,128.984688875137,22.7188893738268
8.7,"max_tuv_SVM","SVM",67,10,2812,2747,65,1100,754,346,0.933519707625312,0.656410256410256,1.74568635784105,626,301,325,21,1.1,28.12,2.2,0,0,0,0,0,0,0.0812339917692962,102.788784189337,21.523441049286
8.7,"max_tuv_SVM","SVM",67,11,2712,2658,54,1200,843,357,0.936771065391155,0.661538461538462,1.75169683257919,650,312,338,24,1.1,30.67,2.4,0,0,0,0,0,0,0.0825943931453805,94.2517926770388,20.0383720473837
8.7,"max_tuv_SVM","SVM",67,12,2612,2566,46,1300,935,365,0.939239068710949,0.666666666666667,1.76253626778006,667,321,346,17,1.1,33.23,2.6,0,0,0,0,0,0,0.0768031304011291,88.1611965758846,19.403266044754
8.7,"max_tuv_SVM","SVM",67,13,2512,2474,38,1400,1027,373,0.940098137713122,0.666666666666667,1.7641592293526,684,326,358,17,1.1,35.79,2.8,0,0,0,0,0,0,0.0696675358305532,81.5337289552976,17.0623311340319
8.7,"max_tuv_SVM","SVM",67,14,2412,2378,34,1500,1123,377,0.940007862665441,0.661538461538462,1.76091628959276,695,331,364,11,1.1,38.34,3,0,0,0,0,0,0,0.058461209409896,71.0228082893413,15.9351331447427
8.7,"max_tuv_SVM","SVM",67,15,2312,2287,25,1600,1214,386,0.939975829583999,0.641025641025641,1.75492279359683,706,339,367,11,1.1,40.9,3.1,0,0,0,0,0,0,0.0500543172947576,62.4173967291574,11.9023046341389
8.7,"max_tuv_SVM","SVM",67,16,2212,2195,17,1700,1306,394,0.940456325805554,0.651282051282051,1.75654023395959,724,344,380,18,1.1,43.46,3.3,0,0,0,0,0,0,0.0420126585497867,52.0146686841599,8.27334780620435
8.7,"max_tuv_SVM","SVM",67,17,2112,2097,15,1800,1404,396,0.939638026179765,0.651282051282051,1.75654023395959,729,347,382,5,1.1,46.01,3.5,0,0,0,0,0,0,0.0337588330679862,39.8111266133798,6.39376216997803
8.7,"max_tuv_SVM","SVM",67,18,2012,1999,13,1900,1502,398,0.939122584778461,0.641025641025641,1.75654023395959,733,349,384,4,1.1,48.57,3.8,0,0,0,0,0,0,0.029819296803513,35.1593707520898,6.02161734518094
8.7,"max_tuv_SVM","SVM",67,19,1912,1902,10,2000,1599,401,0.9387687648335,0.646153846153846,1.75169683257919,736,351,385,3,1.1,51.12,4,0,0,0,0,0,0,0.0247208665763107,26.191359242672,2.63145918914742
8.7,"max_tuv_SVM","SVM",67,20,1812,1803,9,2100,1698,402,0.938330494037473,0.646153846153846,1.76578518255938,740,355,385,4,1.1,53.68,4.2,0,0,0,0,0,0,0.0209825048098947,20.5881407301279,2.20739758587352
8.7,"max_tuv_SVM","SVM",67,21,1712,1703,9,2200,1798,402,0.938071317287666,0.666666666666667,1.77176420635482,749,363,386,9,1.1,56.24,4.5,0,0,0,0,0,0,0.0162538352278607,13.0543097464701,2.08206789664883
8.7,"max_tuv_SVM","SVM",67,22,1612,1605,7,2300,1896,404,0.938180520974378,0.661538461538462,1.77339566510837,758,367,391,9,1.1,58.79,4.7,0,0,0,0,0,0,0.0123385085525291,11.3234553306491,1.39225111164124
8.7,"max_tuv_SVM","SVM",67,23,1512,1505,7,2400,1996,404,0.938110630614879,0.661538461538462,1.77013574660633,764,370,394,6,1.1,61.35,4.9,0,0,0,0,0,0,0.0108564689890438,8.93035756160033,1.09786448147959
8.7,"max_tuv_SVM","SVM",67,24,1412,1406,6,2500,2095,405,0.939393409921521,0.661538461538462,1.76851027760119,780,379,401,16,1.1,63.91,5.2,0,0,0,0,0,0,0.00773318854953072,5.42726311446474,0.938261715401041
8.7,"max_tuv_SVM","SVM",67,25,1312,1307,5,2600,2194,406,0.93930895907046,0.666666666666667,1.76526827892547,781,379,402,1,1.1,66.46,5.4,0,0,0,0,0,0,0.00683437999106482,5.04659738079213,0.752457990167138
8.7,"max_tuv_SVM","SVM",67,26,1212,1208,4,2700,2293,407,0.939410882511396,0.666666666666667,1.76526827892547,784,380,404,3,1.1,69.02,5.6,0,0,0,0,0,0,0.00694409806341873,4.61206424617285,0.706475969984388
8.7,"max_tuv_SVM","SVM",67,27,1112,1108,4,2800,2393,407,0.939323519562011,0.671794871794872,1.76851027760119,799,386,413,15,1.1,71.57,5.9,0,0,0,0,0,0,0.00473714574473041,2.74455745703992,0.538171986600404
8.7,"max_tuv_SVM","SVM",67,28,1012,1009,3,2900,2492,408,0.939322063512854,0.671794871794872,1.77013574660633,799,388,411,0,1.1,74.13,6.1,0,0,0,0,0,0,0.00523252947058276,2.8286583947607,0.540394694992659
8.7,"max_tuv_SVM","SVM",67,29,912,909,3,3000,2592,408,0.939279838087321,0.671794871794872,1.76851027760119,802,389,413,3,1.1,76.69,6.4,0,0,0,0,0,0,0.00377878188045192,1.76256137577249,0.400715794957163
8.7,"max_tuv_SVM","SVM",67,30,812,809,3,3100,2692,408,0.939125496876761,0.671794871794872,1.76851027760119,801,389,412,-1,1.1,79.24,6.6,0,0,0,0,0,0,0.00323315314396261,1.23800049157512,0.334557977221486
8.7,"max_tuv_SVM","SVM",67,31,712,709,3,3200,2792,408,0.939105112188572,0.671794871794872,1.77013574660633,804,391,413,3,1.1,81.8,6.8,0,0,0,0,0,0,0.00269655455320472,0.887872469458933,0.297149782316362
8.7,"max_tuv_SVM","SVM",67,32,612,609,3,3300,2892,408,0.939340992151879,0.671794871794872,1.76851027760119,804,391,413,0,1.1,84.36,7.1,0,0,0,0,0,0,0.00199106520376853,0.601462114142345,0.241131661911841
8.7,"max_tuv_SVM","SVM",67,33,512,509,3,3400,2992,408,0.939227420317693,0.666666666666667,1.76851027760119,806,392,414,2,1.1,86.91,7.3,0,0,0,0,0,0,0.00102343622054317,0.304921152338994,0.135190342490675
8.7,"max_tuv_SVM","SVM",67,34,412,412,0,3500,3089,411,0.938767308784328,0.661538461538462,1.77503013115916,818,398,420,12,1.1,89.47,7.5,0,0,0,0,0,0,0.00125449688854507,0.384207074262255,0.16249143751599
8.7,"max_tuv_SVM","SVM",67,35,312,312,0,3600,3189,411,0.938614423622925,0.656410256410256,1.77339566510837,823,399,424,5,1.1,92.02,7.8,0,0,0,0,0,0,0.000872027857049493,0.225810512870626,0.107336438410235
8.7,"max_tuv_SVM","SVM",67,36,212,212,0,3700,3289,411,0.938615879672084,0.656410256410256,1.76851027760119,822,401,421,-1,1,94.58,8,0,0,0,0,0,0,0.000427718348198958,0.089568764950182,0.0553856529409732
8.7,"max_tuv_SVM","SVM",67,37,112,112,0,3800,3389,411,0.939081815402083,0.656410256410256,1.757215047726,824,403,421,2,1,97.14,8.2,0,0,0,0,0,0,0.000162632742671296,0.026468582431546,0.0248330834468876
8.7,"max_tuv_SVM","SVM",67,38,12,12,0,3900,3489,411,0.939145881564958,0.651282051282051,1.7636517328825,827,404,423,3,1,99.69,8.5,0,0,0,0,0,0,9.27862375862544e-05,0.00155887785093822,0.00155887785093822
8.7,"max_tuv_SVM","SVM",67,39,0,0,0,3912,3501,411,0.939073079107147,0.651282051282051,1.77176420635482,828,404,424,1,1,100,8.5,0,0,0,0,0,0,0,0,0
8.7,"max_tuv_SVM","SVM",68,0,3812,3398,414,100,89,11,0.897159754104749,0.50828729281768,1.76475239495159,27,11,16,0,1.5,2.56,8.1,0,0,0,0,0,0,0.810355503878333,571.005451453336,84.5173941895423
8.7,"max_tuv_SVM","SVM",68,1,3712,3327,385,200,160,40,0.861688584545963,0.50828729281768,1.64340453700639,99,40,59,72,1.5,5.11,4,0,0,0,0,0,0,0.380590394382066,568.036329931162,42.3044745668566
8.7,"max_tuv_SVM","SVM",68,2,3612,3303,309,300,184,116,0.859203174850213,0.56353591160221,1.57223527975337,176,87,89,77,1,7.67,1.6,0,0,0,0,0,0,0.671779284818208,389.563680741025,74.2331418975085
8.7,"max_tuv_SVM","SVM",68,3,3512,3254,258,400,233,167,0.85867558944829,0.607734806629834,1.60759782658326,265,130,135,89,1,10.22,1.4,0,0,0,0,0,0,0.659360336074618,406.65919215786,74.8805374465161
8.7,"max_tuv_SVM","SVM",68,4,3412,3195,217,500,292,208,0.863679091121323,0.591160220994475,1.59213699215531,357,176,181,92,1,12.78,1.4,0,0,0,0,0,0,0.587780483599834,370.984675106237,71.0951387893623
8.7,"max_tuv_SVM","SVM",68,5,3312,3150,162,600,337,263,0.848074079838146,0.591160220994475,1.55233356735142,433,212,221,76,1,15.34,1.3,0,0,0,0,0,0,0.302584682624855,291.894677679204,67.9835793441671
8.7,"max_tuv_SVM","SVM",68,6,3212,3077,135,700,410,290,0.861184343630854,0.613259668508287,1.57927770555736,495,239,256,62,1.1,17.89,1.4,0,0,0,0,0,0,0.150896963681162,215.533897844676,51.7335240584805
8.7,"max_tuv_SVM","SVM",68,7,3112,3023,89,800,464,336,0.856207299042877,0.61878453038674,1.57078888115194,553,263,290,58,1.1,20.45,1.4,0,0,0,0,0,0,0.108227094076935,183.662195565171,27.3333956284218
8.7,"max_tuv_SVM","SVM",68,8,3012,2940,72,900,547,353,0.862438720722135,0.613259668508287,1.56646560900198,575,273,302,22,1.1,23.01,1.5,0,0,0,0,0,0,0.0883983553178511,140.51696778167,17.9446836291374
8.7,"max_tuv_SVM","SVM",68,9,2912,2844,68,1000,643,357,0.869463854952934,0.607734806629834,1.61055568826971,580,279,301,5,1.1,25.56,1.8,0,0,0,0,0,0,0.0618572430140337,90.3713000562653,12.981683776767
8.7,"max_tuv_SVM","SVM",68,10,2812,2755,57,1100,732,368,0.87889502762431,0.602209944751381,1.63344450950938,589,284,305,9,1.1,28.12,2,0,0,0,0,0,0,0.0498925644035321,69.0182689065582,6.36100722612176
8.7,"max_tuv_SVM","SVM",68,11,2712,2663,49,1200,824,376,0.889826472648039,0.61878453038674,1.6274447133312,610,291,319,21,1.1,30.67,2.2,0,0,0,0,0,0,0.0435619223878368,63.3657247229479,4.76041763459287
8.7,"max_tuv_SVM","SVM",68,12,2612,2572,40,1300,915,385,0.897785386351264,0.61878453038674,1.64578032338182,632,305,327,22,1.1,33.23,2.4,0,0,0,0,0,0,0.045136672711988,66.4729133189068,4.78067619783695
8.7,"max_tuv_SVM","SVM",68,13,2512,2473,39,1400,1014,386,0.908376001867572,0.602209944751381,1.68543768057175,645,317,328,13,1,35.79,2.6,0,0,0,0,0,0,0.033792254582402,42.3548209192101,4.04699319409732
8.7,"max_tuv_SVM","SVM",68,14,2412,2377,35,1500,1110,390,0.912957746478887,0.607734806629834,1.68543768057175,654,320,334,9,1,38.34,2.8,0,0,0,0,0,0,0.0305779457606741,41.9510416792424,3.30489864091456
8.7,"max_tuv_SVM","SVM",68,15,2312,2283,29,1600,1204,396,0.921708816434538,0.613259668508287,1.73979781140246,679,329,350,25,1.1,40.9,3,0,0,0,0,0,0,0.056474433781122,50.6708551289084,6.63987086318658
8.7,"max_tuv_SVM","SVM",68,16,2212,2187,25,1700,1300,400,0.92388452260526,0.596685082872928,1.7497395131819,697,338,359,18,1.1,43.46,3.2,0,0,0,0,0,0,0.0470816599215097,38.7404227438179,5.33537665666741
8.7,"max_tuv_SVM","SVM",68,17,2112,2089,23,1800,1398,402,0.924924130417879,0.602209944751381,1.74652603381885,706,345,361,9,1,46.01,3.5,0,0,0,0,0,0,0.0387867650514274,31.1040291162441,4.40148618479603
8.7,"max_tuv_SVM","SVM",68,18,2012,1995,17,1900,1492,408,0.925864135086779,0.596685082872928,1.75990860978704,725,353,372,19,1.1,48.57,3.7,0,0,0,0,0,0,0.0347844101849371,26.7786720744489,4.15405483338858
8.7,"max_tuv_SVM","SVM",68,19,1912,1903,9,2000,1584,416,0.925475060306608,0.591160220994475,1.76637292056679,743,360,383,18,1.1,51.12,3.8,0,0,0,0,0,0,0.0284837367341454,24.9634084744477,3.91913768086218
8.7,"max_tuv_SVM","SVM",68,20,1812,1803,9,2100,1684,416,0.925565325655608,0.591160220994475,1.76637292056679,744,360,384,1,1.1,53.68,4,0,0,0,0,0,0,0.0223826062602982,22.0296988198219,2.52486178988306
8.7,"max_tuv_SVM","SVM",68,21,1712,1703,9,2200,1784,416,0.925338105983987,0.596685082872928,1.76799642508937,746,362,384,2,1.1,56.24,4.3,0,0,0,0,0,0,0.017716183550273,15.2873264587835,1.78666592379398
8.7,"max_tuv_SVM","SVM",68,22,1612,1603,9,2300,1884,416,0.926542681503399,0.596685082872928,1.77956461852023,768,376,392,22,1,58.79,4.5,0,0,0,0,0,0,0.012638219166759,8.23051109115537,1.63551505839612
8.7,"max_tuv_SVM","SVM",68,23,1512,1506,6,2400,1981,419,0.92665784763833,0.596685082872928,1.77956461852023,778,379,399,10,1.1,61.35,4.7,0,0,0,0,0,0,0.0106729045065439,7.9216361774114,1.24166331664403
8.7,"max_tuv_SVM","SVM",68,24,1412,1407,5,2500,2080,420,0.92714808186135,0.607734806629834,1.77792898927527,780,380,400,2,1.1,63.91,5,0,0,0,0,0,0,0.00951812105697564,6.82071714152321,0.987022909608421
8.7,"max_tuv_SVM","SVM",68,25,1312,1307,5,2600,2180,420,0.92757762041866,0.607734806629834,1.77792898927527,789,387,402,9,1,66.46,5.2,0,0,0,0,0,0,0.00711657725148412,4.91935196215781,0.817923469798464
8.7,"max_tuv_SVM","SVM",68,26,1212,1208,4,2700,2279,421,0.927445334993401,0.607734806629834,1.77956461852023,793,390,403,4,1,69.02,5.4,0,0,0,0,0,0,0.00700162019752067,4.3401906952479,0.724930383795671
8.7,"max_tuv_SVM","SVM",68,27,1112,1108,4,2800,2379,421,0.927476460975816,0.607734806629834,1.77956461852023,798,392,406,5,1,71.57,5.7,0,0,0,0,0,0,0.0055129959602323,3.15911502711313,0.594012576774865
8.7,"max_tuv_SVM","SVM",68,28,1012,1009,3,2900,2478,422,0.92784841646566,0.607734806629834,1.78120325997375,807,395,412,9,1,74.13,5.9,0,0,0,0,0,0,0.00498679019575037,2.51732549972824,0.531827736305902
8.7,"max_tuv_SVM","SVM",68,29,912,910,2,3000,2577,423,0.927379970430332,0.613259668508287,1.77956461852023,810,396,414,3,1,76.69,6.1,0,0,0,0,0,0,0.00457544951464944,2.12483249273007,0.490822116683265
8.7,"max_tuv_SVM","SVM",68,30,812,811,1,3100,2676,424,0.927090498793883,0.613259668508287,1.77956461852023,811,399,412,1,1,79.24,6.3,0,0,0,0,0,0,0.00378973537489054,1.64592884421056,0.41564913727246
8.7,"max_tuv_SVM","SVM",68,31,712,711,1,3200,2776,424,0.927246128705953,0.613259668508287,1.77629636394076,814,399,415,3,1,81.8,6.5,0,0,0,0,0,0,0.00332878383168344,1.26157547871664,0.357942990583132
8.7,"max_tuv_SVM","SVM",68,32,612,611,1,3300,2876,424,0.927126293673659,0.613259668508287,1.77792898927527,814,399,415,0,1,84.36,6.8,0,0,0,0,0,0,0.00255717358555772,0.8729510409075,0.286132232318608
8.7,"max_tuv_SVM","SVM",68,33,512,511,1,3400,2976,424,0.927269473192763,0.613259668508287,1.77792898927527,813,399,414,-1,1,86.91,7,0,0,0,0,0,0,0.00173028469465091,0.520698253308426,0.200969560855881
8.7,"max_tuv_SVM","SVM",68,34,412,412,0,3500,3075,425,0.9276258656914,0.607734806629834,1.77304009196287,819,399,420,6,1.1,89.47,7.2,0,0,0,0,0,0,0.00139293066526215,0.41857590253492,0.174467804078993
8.7,"max_tuv_SVM","SVM",68,35,312,312,0,3600,3175,425,0.927723912536003,0.607734806629834,1.77466673424908,823,401,422,4,1.1,92.02,7.5,0,0,0,0,0,0,0.000954672921414278,0.236936193596635,0.112671109263164
8.7,"max_tuv_SVM","SVM",68,36,212,212,0,3700,3275,425,0.927806396389399,0.607734806629834,1.77956461852023,821,401,420,-2,1,94.58,7.7,0,0,0,0,0,0,0.000520431182653027,0.112429906859645,0.0691912143636836
8.7,"max_tuv_SVM","SVM",68,37,112,112,0,3800,3375,425,0.927865535755985,0.607734806629834,1.77956461852023,824,402,422,3,1,97.14,7.9,0,0,0,0,0,0,0.000275313401760824,0.0415987756423114,0.0386711205754986
8.7,"max_tuv_SVM","SVM",68,38,12,12,0,3900,3475,425,0.928004046377727,0.607734806629834,1.77792898927527,825,403,422,1,1,99.69,8.2,0,0,0,0,0,0,0.000207878474398337,0.00307294058519602,0.00307294058519602
8.7,"max_tuv_SVM","SVM",68,39,0,0,0,3912,3487,425,0.928112987316175,0.607734806629834,1.77466673424908,825,403,422,0,1,100,8.2,0,0,0,0,0,0,0,0,0
8.7,"max_tuv_SVM","SVM",69,0,3812,3412,400,100,89,11,0.863192533379924,0.502564102564103,1.64560085076214,31,11,20,0,1.8,2.56,8.1,0,0,0,0,0,0,0.220414870647783,355.376130539197,25.1059949756755
8.7,"max_tuv_SVM","SVM",69,1,3712,3376,336,200,125,75,0.919562020413791,0.625641025641026,1.725624513481,110,53,57,79,1.1,5.11,1.7,0,0,0,0,0,0,0.707606451144214,397.675959569013,79.7565361678717
8.7,"max_tuv_SVM","SVM",69,2,3612,3323,289,300,178,122,0.898190130898805,0.61025641025641,1.67025688203241,202,99,103,92,1,7.67,1.5,0,0,0,0,0,0,0.713884890141012,448.437795770056,80.0627010288077
8.7,"max_tuv_SVM","SVM",69,3,3512,3266,246,400,235,165,0.852509500720735,0.6,1.59790338574869,277,135,142,75,1.1,10.22,1.4,0,0,0,0,0,0,0.675385435901612,427.926025838766,80.8386760848317
8.7,"max_tuv_SVM","SVM",69,4,3412,3207,205,500,294,206,0.870030140217524,0.635897435897436,1.59790338574869,362,178,184,85,1,12.78,1.4,0,0,0,0,0,0,0.69009446807963,275.18442519493,83.1544632534898
8.7,"max_tuv_SVM","SVM",69,5,3312,3146,166,600,355,245,0.883280187539146,0.671794871794872,1.62711095356257,446,215,231,84,1.1,15.34,1.4,0,0,0,0,0,0,0.225173483554246,178.569525993136,70.4219281653622
8.7,"max_tuv_SVM","SVM",69,6,3212,3087,125,700,414,286,0.881634851992614,0.666666666666667,1.61637625726024,517,247,270,71,1.1,17.89,1.4,0,0,0,0,0,0,0.118789875116221,149.068807351351,50.7398218026337
8.7,"max_tuv_SVM","SVM",69,7,3112,3017,95,800,484,316,0.88182413838292,0.671794871794872,1.61044460127029,553,262,291,36,1.1,20.45,1.5,0,0,0,0,0,0,0.0768631566880443,120.377580160714,32.6667082136442
8.7,"max_tuv_SVM","SVM",69,8,3012,2933,79,900,568,332,0.884712939908853,0.676923076923077,1.61192343010525,565,270,295,12,1.1,23.01,1.7,0,0,0,0,0,0,0.0573167164421624,92.8158461848075,20.4592071374219
8.7,"max_tuv_SVM","SVM",69,9,2912,2848,64,1000,653,347,0.891189446555727,0.682051282051282,1.62561269301601,594,283,311,29,1.1,25.56,1.9,0,0,0,0,0,0,0.0492001192062273,74.3763759801384,13.3342256620065
8.7,"max_tuv_SVM","SVM",69,10,2812,2753,59,1100,748,352,0.921431587530373,0.646153846153846,1.69638009049774,631,310,321,37,1,28.12,2.1,0,0,0,0,0,0,0.0521631631483895,46.664098580928,13.4615039463291
8.7,"max_tuv_SVM","SVM",69,11,2712,2670,42,1200,831,369,0.930360080956312,0.646153846153846,1.72690898844745,652,320,332,21,1,30.67,2.3,0,0,0,0,0,0,0.0388192828117694,37.5316236257934,4.71874131450805
8.7,"max_tuv_SVM","SVM",69,12,2612,2578,34,1300,923,377,0.939594344705075,0.651282051282051,1.77013574660633,673,329,344,21,1,33.23,2.4,0,0,0,0,0,0,0.0476751872030624,49.6798464462504,5.93238584362444
8.7,"max_tuv_SVM","SVM",69,13,2512,2483,29,1400,1018,382,0.944396394822291,0.646153846153846,1.80110497237569,695,337,358,22,1.1,35.79,2.7,0,0,0,0,0,0,0.0585811217419984,49.4227932216089,6.54826029248762
8.7,"max_tuv_SVM","SVM",69,14,2412,2385,27,1500,1116,384,0.944472109378416,0.651282051282051,1.79944802207912,703,342,361,8,1.1,38.34,2.9,0,0,0,0,0,0,0.0444859017367923,36.4250355030859,4.90441714121535
8.7,"max_tuv_SVM","SVM",69,15,2312,2289,23,1600,1212,388,0.944748758718097,0.646153846153846,1.79944802207912,715,348,367,12,1.1,40.9,3.1,0,0,0,0,0,0,0.0460389195672874,32.6263843719273,5.11787344452253
8.7,"max_tuv_SVM","SVM",69,16,2212,2193,19,1700,1308,392,0.944654115522943,0.646153846153846,1.80110497237569,731,353,378,16,1.1,43.46,3.3,0,0,0,0,0,0,0.0379527586161076,24.6660558442866,4.61708749650323
8.7,"max_tuv_SVM","SVM",69,17,2112,2096,16,1800,1405,395,0.945048704844278,0.641025641025641,1.79614325068871,730,356,374,-1,1.1,46.01,3.6,0,0,0,0,0,0,0.0267990956826787,21.558183855968,3.47504924299246
8.7,"max_tuv_SVM","SVM",69,18,2012,1999,13,1900,1502,398,0.944745846619783,0.641025641025641,1.78857466063348,738,359,379,8,1.1,48.57,3.8,0,0,0,0,0,0,0.0214315265881642,18.9627301021265,2.59569593336365
8.7,"max_tuv_SVM","SVM",69,19,1912,1900,12,2000,1601,399,0.944673044161969,0.641025641025641,1.79186853661992,744,360,384,6,1.1,51.12,4,0,0,0,0,0,0,0.0175694341475244,15.9262375841359,1.94094925356189
8.7,"max_tuv_SVM","SVM",69,20,1812,1801,11,2100,1700,400,0.944847770060719,0.641025641025641,1.79352002835874,742,361,381,-2,1.1,53.68,4.2,0,0,0,0,0,0,0.0156969711514951,14.5967271941271,1.68316946541332
8.7,"max_tuv_SVM","SVM",69,21,1712,1701,11,2200,1800,400,0.944805544635188,0.646153846153846,1.78857466063348,747,362,385,5,1.1,56.24,4.5,0,0,0,0,0,0,0.0127436685232007,10.9274039871047,1.30234251061193
8.7,"max_tuv_SVM","SVM",69,22,1612,1602,10,2300,1899,401,0.943994525255175,0.646153846153846,1.80276497695853,758,370,388,11,1,58.79,4.7,0,0,0,0,0,0,0.00991424212649163,7.78654882375723,1.15758585159753
8.7,"max_tuv_SVM","SVM",69,23,1512,1504,8,2400,1997,403,0.943764469488492,0.646153846153846,1.80276497695853,760,373,387,2,1,61.35,5,0,0,0,0,0,0,0.00984382859167579,7.35674399287779,1.02430757472974
8.7,"max_tuv_SVM","SVM",69,24,1412,1404,8,2500,2097,403,0.943005867878101,0.641025641025641,1.80110497237569,773,378,395,13,1,63.91,5.2,0,0,0,0,0,0,0.00771297919927795,5.35555278748175,0.866083867621019
8.7,"max_tuv_SVM","SVM",69,25,1312,1304,8,2600,2197,403,0.943150016744567,0.641025641025641,1.79779411764706,770,377,393,-3,1,66.46,5.5,0,0,0,0,0,0,0.00631279619179975,4.06724674685732,0.658561875898657
8.7,"max_tuv_SVM","SVM",69,26,1212,1204,8,2700,2297,403,0.942905400486323,0.635897435897436,1.80276497695853,773,378,395,3,1,69.02,5.7,0,0,0,0,0,0,0.0055512621430487,3.27376830696246,0.589560652454135
8.7,"max_tuv_SVM","SVM",69,27,1112,1104,8,2800,2397,403,0.942896664191385,0.635897435897436,1.80276497695853,775,379,396,2,1,71.57,5.9,0,0,0,0,0,0,0.00496154259010152,2.54247201460563,0.51302779401506
8.7,"max_tuv_SVM","SVM",69,28,1012,1004,8,2900,2497,403,0.942892296043915,0.630769230769231,1.80110497237569,782,384,398,7,1,74.13,6.2,0,0,0,0,0,0,0.0042226945377111,1.90934218997578,0.451612388319351
8.7,"max_tuv_SVM","SVM",69,29,912,907,5,3000,2594,406,0.942812213340323,0.630769230769231,1.80276497695853,795,387,408,13,1.1,76.69,6.4,0,0,0,0,0,0,0.00436419273614758,1.83195583854682,0.471710136562599
8.7,"max_tuv_SVM","SVM",69,30,812,807,5,3100,2694,406,0.942602542261828,0.630769230769231,1.79944802207912,796,388,408,1,1.1,79.24,6.6,0,0,0,0,0,0,0.0031816782966728,1.17445218945078,0.354513714180971
8.7,"max_tuv_SVM","SVM",69,31,712,708,4,3200,2793,407,0.942825317782729,0.635897435897436,1.79449541284404,798,389,409,2,1.1,81.8,6.9,0,0,0,0,0,0,0.00251447213793244,0.819106329930171,0.289068748854908
8.7,"max_tuv_SVM","SVM",69,32,612,608,4,3300,2893,407,0.942949081961008,0.635897435897436,1.79944802207912,796,389,407,-2,1,84.36,7.1,0,0,0,0,0,0,0.0018060195990245,0.57264877626551,0.224216958384232
8.7,"max_tuv_SVM","SVM",69,33,512,510,2,3400,2991,409,0.943199522415878,0.641025641025641,1.79449541284404,805,393,412,9,1,86.91,7.3,0,0,0,0,0,0,0.00131649433096236,0.443085151923036,0.169229718398782
8.7,"max_tuv_SVM","SVM",69,34,412,411,1,3500,3090,410,0.943432490280873,0.641025641025641,1.79285059578368,810,395,415,5,1.1,89.47,7.5,0,0,0,0,0,0,0.00106815838532306,0.32739845228505,0.127839836405722
8.7,"max_tuv_SVM","SVM",69,35,312,312,0,3600,3189,411,0.943755733193554,0.635897435897436,1.79449541284404,814,398,416,4,1,92.02,7.8,0,0,0,0,0,0,0.00120538336103513,0.3132564664577,0.144992627476135
8.7,"max_tuv_SVM","SVM",69,36,212,212,0,3700,3289,411,0.943816887258115,0.630769230769231,1.79614325068871,820,401,419,6,1,94.58,8,0,0,0,0,0,0,0.000628602193233896,0.129264430198329,0.078469750239915
8.7,"max_tuv_SVM","SVM",69,37,112,112,0,3800,3389,411,0.943712051718868,0.625641025641026,1.79614325068871,824,403,421,4,1,97.14,8.2,0,0,0,0,0,0,0.000248620020947581,0.0404009354495381,0.0377473418196963
8.7,"max_tuv_SVM","SVM",69,38,12,12,0,3900,3489,411,0.943732436407055,0.625641025641026,1.79614325068871,826,403,423,2,1,99.69,8.5,0,0,0,0,0,0,0.000156586509799456,0.00244427546035374,0.00244427546035374
8.7,"max_tuv_SVM","SVM",69,39,0,0,0,3912,3501,411,0.943675650489962,0.625641025641026,1.79449541284404,826,403,423,0,1,100,8.5,0,0,0,0,0,0,0,0,0
8.7,"max_tuv_SVM","SVM",70,0,3812,3435,377,100,88,12,0.91082061569364,0.580645161290323,1.77958893501415,29,12,17,0,1.4,2.56,7.3,0,0,0,0,0,0,0.572969111815125,393.948807687284,63.1975184480038
8.7,"max_tuv_SVM","SVM",70,1,3712,3404,308,200,119,81,0.921669586048445,0.599078341013825,1.75798608608651,88,43,45,59,1,5.11,1.5,0,0,0,0,0,0,0.669271882817479,286.837777799211,76.5828359517198
8.7,"max_tuv_SVM","SVM",70,2,3612,3340,272,300,183,117,0.906915887355137,0.617511520737327,1.72640476614813,185,94,91,97,1,7.67,1.6,0,0,0,0,0,0,0.561368869963984,199.484720408516,72.830812723554
8.7,"max_tuv_SVM","SVM",70,3,3512,3288,224,400,235,165,0.873815132909145,0.622119815668203,1.65170455992056,266,131,135,81,1,10.22,1.4,0,0,0,0,0,0,0.34768562625653,178.739155705559,66.2004551350246
8.7,"max_tuv_SVM","SVM",70,4,3412,3230,182,500,293,207,0.88480057663309,0.640552995391705,1.65322686827072,347,170,177,81,1,12.78,1.4,0,0,0,0,0,0,0.164303665862758,128.780990536192,47.8577830123768
8.7,"max_tuv_SVM","SVM",70,5,3312,3176,136,600,347,253,0.881665664095295,0.649769585253456,1.62680449117804,400,196,204,53,1,15.34,1.4,0,0,0,0,0,0,0.0922957126695321,75.9781515656709,25.4035035748889
8.7,"max_tuv_SVM","SVM",70,6,3212,3107,105,700,416,284,0.884169884169869,0.649769585253456,1.6306000939432,454,218,236,54,1.1,17.89,1.5,0,0,0,0,0,0,0.0759705093707914,78.6392864434043,16.5331640261579
8.7,"max_tuv_SVM","SVM",70,7,3112,3024,88,800,499,301,0.889761317352244,0.672811059907834,1.64189266530721,493,235,258,39,1.1,20.45,1.7,0,0,0,0,0,0,0.0674461679241047,95.4580925221153,13.9564072984889
8.7,"max_tuv_SVM","SVM",70,8,3012,2943,69,900,580,320,0.888966326852384,0.682027649769585,1.62232293610593,525,256,269,32,1.1,23.01,1.8,0,0,0,0,0,0,0.0718776982628668,115.801198853918,12.2552150493904
8.7,"max_tuv_SVM","SVM",70,9,2912,2852,60,1000,671,329,0.8888550281824,0.682027649769585,1.62232293610593,559,269,290,34,1.1,25.56,2,0,0,0,0,0,0,0.0688153265618214,102.779795296097,10.0726692399501
8.7,"max_tuv_SVM","SVM",70,10,2812,2754,58,1100,769,331,0.913274486369876,0.672811059907834,1.6750622141013,600,292,308,41,1.1,28.12,2.3,0,0,0,0,0,0,0.0594196904421748,49.5266643051335,10.0383487131013
8.7,"max_tuv_SVM","SVM",70,11,2712,2662,50,1200,861,339,0.915193063442881,0.672811059907834,1.68335460129982,605,296,309,5,1,30.67,2.5,0,0,0,0,0,0,0.0402965861174685,37.5571895781129,4.67847059896401
8.7,"max_tuv_SVM","SVM",70,12,2612,2569,43,1300,954,346,0.925379541714469,0.67741935483871,1.70823176289538,622,305,317,17,1,33.23,2.8,0,0,0,0,0,0,0.0350380016041699,40.9430397007731,4.31527340554374
8.7,"max_tuv_SVM","SVM",70,13,2512,2480,32,1400,1043,357,0.937622395412372,0.672811059907834,1.75475746150233,659,319,340,37,1.1,35.79,2.9,0,0,0,0,0,0,0.06507796036578,55.2994136127844,7.78820300780129
8.7,"max_tuv_SVM","SVM",70,14,2412,2383,29,1500,1140,360,0.938602883695538,0.672811059907834,1.78450492654734,668,324,344,9,1.1,38.34,3.2,0,0,0,0,0,0,0.0543064326410195,45.0116080106789,6.1113507306425
8.7,"max_tuv_SVM","SVM",70,15,2312,2285,27,1600,1238,362,0.939169976918774,0.67741935483871,1.78122458660884,678,330,348,10,1.1,40.9,3.4,0,0,0,0,0,0,0.0430215891854703,33.7098799388612,4.77861897371202
8.7,"max_tuv_SVM","SVM",70,16,2212,2189,23,1700,1334,366,0.939705270522015,0.672811059907834,1.77784195884389,691,336,355,13,1.1,43.46,3.6,0,0,0,0,0,0,0.0400959776554757,28.9825089715569,4.40280627858637
8.7,"max_tuv_SVM","SVM",70,17,2112,2096,16,1800,1427,373,0.940508210926877,0.658986175115207,1.77784195884389,715,345,370,24,1.1,46.01,3.8,0,0,0,0,0,0,0.0438839134337387,29.0965390077651,5.54648024458605
8.7,"max_tuv_SVM","SVM",70,18,2012,2000,12,1900,1523,377,0.940420761971892,0.654377880184332,1.76627847328503,723,349,374,8,1.1,48.57,4,0,0,0,0,0,0,0.0274197273841847,23.2782639445302,3.75284575554075
8.7,"max_tuv_SVM","SVM",70,19,1912,1900,12,2000,1623,377,0.94043268682939,0.654377880184332,1.76465505557062,720,349,371,-3,1.1,51.12,4.3,0,0,0,0,0,0,0.0192912964258438,17.7851644133132,2.14621450906678
8.7,"max_tuv_SVM","SVM",70,20,1812,1800,12,2100,1723,377,0.940166365011936,0.654377880184332,1.75980265853422,721,351,370,1,1.1,53.68,4.6,0,0,0,0,0,0,0.0177623511087702,15.1547613071095,1.80759935548696
8.7,"max_tuv_SVM","SVM",70,21,1712,1700,12,2200,1823,377,0.940859331730984,0.640552995391705,1.78622584872955,732,359,373,11,1,56.24,4.8,0,0,0,0,0,0,0.0123407782711657,9.50006459898391,1.60053816804082
8.7,"max_tuv_SVM","SVM",70,22,1612,1602,10,2300,1921,379,0.941007729957625,0.63594470046083,1.78450492654734,736,361,375,4,1,58.79,5.1,0,0,0,0,0,0,0.010920121885376,8.81638512631595,1.1952610529073
8.7,"max_tuv_SVM","SVM",70,23,1512,1504,8,2400,2019,381,0.940328013080242,0.640552995391705,1.78786609285143,745,365,380,9,1,61.35,5.3,0,0,0,0,0,0,0.0114044742527063,8.19257163839572,1.17624177014411
8.7,"max_tuv_SVM","SVM",70,24,1412,1404,8,2500,2119,381,0.940097465835282,0.640552995391705,1.7911556348806,756,369,387,11,1,63.91,5.6,0,0,0,0,0,0,0.00866922165297592,5.71830129623706,0.946771224784542
8.7,"max_tuv_SVM","SVM",70,25,1312,1306,6,2600,2217,383,0.940929555891806,0.640552995391705,1.7911556348806,763,370,393,7,1.1,66.46,5.8,0,0,0,0,0,0,0.00761943191429516,4.70743147483953,0.795656405609607
8.7,"max_tuv_SVM","SVM",70,26,1212,1206,6,2700,2317,383,0.940628784486024,0.63594470046083,1.79280494946152,764,372,392,1,1.1,69.02,6,0,0,0,0,0,0,0.00665823820672971,3.72557527552705,0.697482568192467
8.7,"max_tuv_SVM","SVM",70,27,1112,1106,6,2800,2417,383,0.940752008013503,0.63594470046083,1.78786609285143,764,372,392,0,1.1,71.57,6.3,0,0,0,0,0,0,0.00633770908754215,3.02995429115089,0.652619403899245
8.7,"max_tuv_SVM","SVM",70,28,1012,1006,6,2900,2517,383,0.941226352345088,0.63594470046083,1.79445730425365,766,374,392,2,1,74.13,6.6,0,0,0,0,0,0,0.00517340059443765,2.1653213462932,0.556249583411776
8.7,"max_tuv_SVM","SVM",70,29,912,906,6,3000,2617,383,0.941275376759247,0.63594470046083,1.78950935212795,767,375,392,1,1,76.69,6.8,0,0,0,0,0,0,0.00413108747676986,1.49985167483614,0.454609888262074
8.7,"max_tuv_SVM","SVM",70,30,812,806,6,3100,2717,383,0.941319101236739,0.63594470046083,1.7911556348806,767,375,392,0,1,79.24,7.1,0,0,0,0,0,0,0.00302590957226851,0.963853196738744,0.339044692041637
8.7,"max_tuv_SVM","SVM",70,31,712,707,5,3200,2816,384,0.94158674803836,0.63594470046083,1.78950935212795,773,376,397,6,1.1,81.8,7.3,0,0,0,0,0,0,0.00250438491642397,0.784166571726937,0.30135516399845
8.7,"max_tuv_SVM","SVM",70,32,612,609,3,3300,2914,386,0.94151254892504,0.640552995391705,1.78622584872955,776,380,396,3,1,84.36,7.5,0,0,0,0,0,0,0.00193370600560229,0.628448019824993,0.244008468970633
8.7,"max_tuv_SVM","SVM",70,33,512,509,3,3400,3014,386,0.941656972199182,0.640552995391705,1.78622584872955,778,381,397,2,1,86.91,7.8,0,0,0,0,0,0,0.00109448353877111,0.352514643070202,0.144993513426492
8.7,"max_tuv_SVM","SVM",70,34,412,411,1,3500,3112,388,0.941900769285807,0.640552995391705,1.79280494946152,789,386,403,11,1,89.47,8,0,0,0,0,0,0,0.000813996520546295,0.234733073774626,0.103106640938634
8.7,"max_tuv_SVM","SVM",70,35,312,312,0,3600,3211,389,0.942270439868243,0.640552995391705,1.78950935212795,793,388,405,4,1,92.02,8.3,0,0,0,0,0,0,0.000684385239929723,0.167881419897413,0.0852708411957859
8.7,"max_tuv_SVM","SVM",70,36,212,212,0,3700,3311,389,0.942437387873215,0.640552995391705,1.7911556348806,796,388,408,3,1.1,94.58,8.5,0,0,0,0,0,0,0.000357712223525969,0.0771946445239559,0.0492170676623224
8.7,"max_tuv_SVM","SVM",70,37,112,112,0,3800,3411,389,0.942564586353193,0.63594470046083,1.78622584872955,800,389,411,4,1.1,97.14,8.8,0,0,0,0,0,0,0.000132202916719191,0.0223114445118842,0.0208950220121837
8.7,"max_tuv_SVM","SVM",70,38,12,12,0,3900,3511,389,0.942516886923201,0.63594470046083,1.78622584872955,801,389,412,1,1.1,99.69,9,0,0,0,0,0,0,0.00010199204520186,0.00140693826342472,0.00140693826342472
8.7,"max_tuv_SVM","SVM",70,39,0,0,0,3912,3523,389,0.942612285783184,0.63594470046083,1.78786609285143,800,389,411,-1,1.1,100,9.1,0,0,0,0,0,0,0,0,0
8.7,"max_tuv_SVM","SVM",71,0,3812,3403,409,100,92,8,0.774732530250351,0.259259259259259,1.56430400117036,29,8,21,0,2.6,2.56,11.5,0,0,0,0,0,0,0.136431150535283,328.311055703934,15.1107188473388
8.7,"max_tuv_SVM","SVM",71,1,3712,3322,390,200,173,27,0.851396711611757,0.439153439153439,1.70738058664326,80,27,53,51,2,5.11,6.4,0,0,0,0,0,0,0.253595609508759,326.523697322719,42.7729669031582
8.7,"max_tuv_SVM","SVM",71,2,3612,3287,325,300,208,92,0.924734177139379,0.555555555555556,1.77414965986395,151,72,79,71,1.1,7.67,2.3,0,0,0,0,0,0,0.767882496481138,405.332220090531,82.6282026235013
8.7,"max_tuv_SVM","SVM",71,3,3512,3227,285,400,268,132,0.928596880492744,0.587301587301587,1.76601135867191,245,117,128,94,1.1,10.22,2,0,0,0,0,0,0,0.740138904957814,310.07697941587,82.2474429777239
8.7,"max_tuv_SVM","SVM",71,4,3412,3168,244,500,327,173,0.922458475938942,0.62962962962963,1.74392703674472,335,163,172,90,1.1,12.78,1.9,0,0,0,0,0,0,0.679825197561886,300.972178543917,78.5154885375636
8.7,"max_tuv_SVM","SVM",71,5,3312,3107,205,600,388,212,0.911415336429478,0.603174603174603,1.74862623347472,402,196,206,67,1.1,15.34,1.8,0,0,0,0,0,0,0.36040721048756,273.746839432225,71.6723446334088
8.7,"max_tuv_SVM","SVM",71,6,3212,3054,158,700,441,259,0.90770534460404,0.634920634920635,1.71376002102773,480,235,245,78,1,17.89,1.7,0,0,0,0,0,0,0.166474643148617,216.368069924457,57.4927938884951
8.7,"max_tuv_SVM","SVM",71,7,3112,3000,112,800,495,305,0.908317687887572,0.645502645502645,1.68055919615553,523,251,272,43,1.1,20.45,1.6,0,0,0,0,0,0,0.103389360139122,166.463512315929,37.8510628474871
8.7,"max_tuv_SVM","SVM",71,8,3012,2931,81,900,564,336,0.906411788132214,0.666666666666667,1.67567646500489,576,275,301,53,1.1,23.01,1.7,0,0,0,0,0,0,0.100749031139716,171.129011182976,26.7235844887951
8.7,"max_tuv_SVM","SVM",71,9,2912,2839,73,1000,656,344,0.915879902863488,0.661375661375661,1.68364845938375,600,291,309,24,1.1,25.56,1.9,0,0,0,0,0,0,0.0848055526244389,141.93266282146,24.5267769444063
8.7,"max_tuv_SVM","SVM",71,10,2812,2760,52,1100,735,365,0.916074535202994,0.656084656084656,1.72961942658912,624,300,324,24,1.1,28.12,2,0,0,0,0,0,0,0.0674132084913976,111.073328613803,12.746623224933
8.7,"max_tuv_SVM","SVM",71,11,2712,2665,47,1200,830,370,0.927863266289969,0.656084656084656,1.76461122083242,650,314,336,26,1.1,30.67,2.2,0,0,0,0,0,0,0.0770673006739002,102.131196769207,13.6822354479158
8.7,"max_tuv_SVM","SVM",71,12,2612,2567,45,1300,928,372,0.929782640591914,0.656084656084656,1.76461122083242,656,318,338,6,1.1,33.23,2.5,0,0,0,0,0,0,0.0595083812853675,71.0912843126717,11.6388189836473
8.7,"max_tuv_SVM","SVM",71,13,2512,2473,39,1400,1022,378,0.931169021717967,0.650793650793651,1.75184357705057,673,325,348,17,1.1,35.79,2.7,0,0,0,0,0,0,0.0581677442706909,65.5085867644591,11.5681968014443
8.7,"max_tuv_SVM","SVM",71,14,2412,2378,34,1500,1117,383,0.931210942529553,0.64021164021164,1.75345669268321,686,329,357,13,1.1,38.34,2.9,0,0,0,0,0,0,0.0564573729530872,60.7784925464668,11.5243326229733
8.7,"max_tuv_SVM","SVM",71,15,2312,2284,28,1600,1211,389,0.933447717262084,0.645502645502645,1.75507278180089,700,336,364,14,1.1,40.9,3.1,0,0,0,0,0,0,0.0468111138572695,53.8191310042118,10.9459291511813
8.7,"max_tuv_SVM","SVM",71,16,2212,2194,18,1700,1301,399,0.93632079002763,0.645502645502645,1.75345669268321,722,343,379,22,1.1,43.46,3.3,0,0,0,0,0,0,0.0400624064670103,48.7342574844594,8.29104342608448
8.7,"max_tuv_SVM","SVM",71,17,2112,2097,15,1800,1398,402,0.935687486338299,0.645502645502645,1.75345669268321,731,347,384,9,1.1,46.01,3.5,0,0,0,0,0,0,0.0379576135482269,44.9971930211837,7.5805647027015
8.7,"max_tuv_SVM","SVM",71,18,2012,1998,14,1900,1497,403,0.934142404996955,0.64021164021164,1.76298634862171,759,365,394,28,1.1,48.57,3.7,0,0,0,0,0,0,0.0270750005986509,24.2967462969007,7.24615562747944
8.7,"max_tuv_SVM","SVM",71,19,1912,1902,10,2000,1593,407,0.934220257932759,0.634920634920635,1.76298634862171,753,364,389,-6,1.1,51.12,3.9,0,0,0,0,0,0,0.0192324206945975,16.8668731472162,2.22253815280096
8.7,"max_tuv_SVM","SVM",71,20,1812,1804,8,2100,1691,409,0.933950767001129,0.64021164021164,1.76298634862171,759,365,394,6,1.1,53.68,4.1,0,0,0,0,0,0,0.0179673849039589,15.3783160508279,1.86367590820729
8.7,"max_tuv_SVM","SVM",71,21,1712,1704,8,2200,1791,409,0.934277150462771,0.64021164021164,1.77414965986395,772,375,397,13,1.1,56.24,4.4,0,0,0,0,0,0,0.0121845806740014,9.5626547261648,1.47092407860685
8.7,"max_tuv_SVM","SVM",71,22,1612,1605,7,2300,1890,410,0.934606528268097,0.634920634920635,1.77414965986395,771,374,397,-1,1.1,58.79,4.6,0,0,0,0,0,0,0.0110090071946656,8.22510855766116,1.13617308803281
8.7,"max_tuv_SVM","SVM",71,23,1512,1506,6,2400,1989,411,0.934870030512358,0.634920634920635,1.77414965986395,783,383,400,12,1,61.35,4.8,0,0,0,0,0,0,0.00842960919430448,6.05103013385973,0.958898696028427
8.7,"max_tuv_SVM","SVM",71,24,1412,1406,6,2500,2089,411,0.934843081419195,0.64021164021164,1.77414965986395,780,381,399,-3,1,63.91,5.1,0,0,0,0,0,0,0.00770845318294176,4.94308166376305,0.790620698780579
8.7,"max_tuv_SVM","SVM",71,25,1312,1307,5,2600,2188,412,0.935787796851743,0.645502645502645,1.76601135867191,790,386,404,10,1,66.46,5.3,0,0,0,0,0,0,0.00583116620515887,3.51343253872752,0.638790818026365
8.7,"max_tuv_SVM","SVM",71,26,1212,1208,4,2700,2287,413,0.935642571183031,0.645502645502645,1.77088535506199,790,388,402,0,1,69.02,5.5,0,0,0,0,0,0,0.00537487194248992,2.85503276544559,0.559372956194984
8.7,"max_tuv_SVM","SVM",71,27,1112,1108,4,2800,2387,413,0.935900084739922,0.650793650793651,1.76763304036031,797,390,407,7,1,71.57,5.8,0,0,0,0,0,0,0.00465435733207057,2.21926579741403,0.502560335870748
8.7,"max_tuv_SVM","SVM",71,28,1012,1008,4,2900,2487,413,0.935915056458346,0.645502645502645,1.76601135867191,797,390,407,0,1,74.13,6,0,0,0,0,0,0,0.00366027145596089,1.48076323174768,0.390370427352087
8.7,"max_tuv_SVM","SVM",71,29,912,908,4,3000,2587,413,0.935965960300988,0.650793650793651,1.76763304036031,798,390,408,1,1,76.69,6.3,0,0,0,0,0,0,0.00308480000732134,1.12975437039996,0.342282524314842
8.7,"max_tuv_SVM","SVM",71,30,812,809,3,3100,2686,414,0.936238445576303,0.650793650793651,1.76763304036031,802,392,410,4,1,79.24,6.5,0,0,0,0,0,0,0.00275915679745178,0.921866073001994,0.312742039405361
8.7,"max_tuv_SVM","SVM",71,31,712,709,3,3200,2786,414,0.936292343762629,0.650793650793651,1.76925770308123,802,392,410,0,1,81.8,6.7,0,0,0,0,0,0,0.00184167630803619,0.564514582028179,0.221855975393597
8.7,"max_tuv_SVM","SVM",71,32,612,609,3,3300,2886,414,0.936445055290553,0.645502645502645,1.77088535506199,804,392,412,2,1.1,84.36,7,0,0,0,0,0,0,0.00112868596611936,0.355664810352367,0.150366737530077
8.7,"max_tuv_SVM","SVM",71,33,512,509,3,3400,2986,414,0.93665615652033,0.64021164021164,1.76925770308123,807,393,414,3,1.1,86.91,7.2,0,0,0,0,0,0,0.000595111593731223,0.187023895792845,0.0796822502692747
8.7,"max_tuv_SVM","SVM",71,34,412,411,1,3500,3084,416,0.937406239613367,0.634920634920635,1.77088535506199,816,398,418,9,1.1,89.47,7.4,0,0,0,0,0,0,0.00072141082359863,0.215194283367274,0.0917796538427495
8.7,"max_tuv_SVM","SVM",71,35,312,312,0,3600,3183,417,0.938620445977546,0.634920634920635,1.76601135867191,823,404,419,7,1,92.02,7.6,0,0,0,0,0,0,0.000536996355720696,0.134945188293548,0.0661438436441992
8.7,"max_tuv_SVM","SVM",71,36,212,212,0,3700,3283,417,0.938852507613117,0.624338624338624,1.76277690563405,824,404,420,1,1,94.58,7.9,0,0,0,0,0,0,0.000280210749888593,0.0583782225451165,0.0366110880160083
8.7,"max_tuv_SVM","SVM",71,37,112,112,0,3800,3383,417,0.939310642196889,0.62962962962963,1.77387863180714,827,404,423,3,1,97.14,8.1,0,0,0,0,0,0,0.00013060921290629,0.0222041128178548,0.0208078235639645
8.7,"max_tuv_SVM","SVM",71,38,12,12,0,3900,3483,417,0.939640020002214,0.62962962962963,1.77387863180714,826,405,421,-1,1,99.69,8.4,0,0,0,0,0,0,0.000105277426921758,0.00151142050133355,0.00151142050133355
8.7,"max_tuv_SVM","SVM",71,39,0,0,0,3912,3495,417,0.939695415360382,0.62962962962963,1.77550604339595,826,405,421,0,1,100,8.4,0,0,0,0,0,0,0,0,0
8.7,"max_tuv_SVM","SVM",72,0,3812,3416,396,100,92,8,0.823692945121199,0.48019801980198,1.60642423689374,24,8,16,0,2,2.56,11.5,0,0,0,0,0,0,0.243149698717409,304.142423575217,37.2782022844935
8.7,"max_tuv_SVM","SVM",72,1,3712,3359,353,200,149,51,0.881505639161421,0.54950495049505,1.69099446709377,88,43,45,64,1,5.11,2.9,0,0,0,0,0,0,0.675986252054906,362.019965611492,74.7198236338229
8.7,"max_tuv_SVM","SVM",72,2,3612,3300,312,300,208,92,0.870307754834787,0.52970297029703,1.66582564420195,172,85,87,84,1,7.67,2.3,0,0,0,0,0,0,0.597418715724887,300.353211448022,67.5411186362145
8.7,"max_tuv_SVM","SVM",72,3,3512,3245,267,400,263,137,0.846042144123197,0.589108910891089,1.60494502488923,257,124,133,85,1.1,10.22,1.9,0,0,0,0,0,0,0.608142606930879,238.697353412014,74.0068160545068
8.7,"max_tuv_SVM","SVM",72,4,3412,3199,213,500,309,191,0.828627916953617,0.589108910891089,1.56036321864231,349,172,177,92,1,12.78,1.6,0,0,0,0,0,0,0.5,208.393690965301,77.9472285494367
8.7,"max_tuv_SVM","SVM",72,5,3312,3140,172,600,368,232,0.854239813947191,0.599009900990099,1.57072592051832,412,205,207,63,1,15.34,1.6,0,0,0,0,0,0,0.264196297628299,155.373559498562,69.2294793923608
8.7,"max_tuv_SVM","SVM",72,6,3212,3084,128,700,424,276,0.854341420459045,0.608910891089109,1.57072592051832,481,237,244,69,1,17.89,1.5,0,0,0,0,0,0,0.120394254585857,104.848265725753,48.9489104474979
8.7,"max_tuv_SVM","SVM",72,7,3112,3024,88,800,484,316,0.8560405071294,0.613861386138614,1.59749965779988,515,252,263,34,1,20.45,1.5,0,0,0,0,0,0,0.0861889560804524,77.8310185434523,28.1982153645252
8.7,"max_tuv_SVM","SVM",72,8,3012,2947,65,900,561,339,0.861290176908233,0.618811881188119,1.60642423689374,545,266,279,30,1,23.01,1.7,0,0,0,0,0,0,0.0595441488006677,61.8456809007641,14.966886409426
8.7,"max_tuv_SVM","SVM",72,9,2912,2859,53,1000,649,351,0.862680210438383,0.628712871287129,1.61386138613861,565,276,289,20,1,25.56,1.8,0,0,0,0,0,0,0.0463052039915557,56.0199097621625,10.7840352574796
8.7,"max_tuv_SVM","SVM",72,10,2812,2771,41,1100,737,363,0.873710161780153,0.643564356435644,1.61386138613861,599,290,309,34,1.1,28.12,2,0,0,0,0,0,0,0.0429194277957258,58.942930160518,6.92507858539164
8.7,"max_tuv_SVM","SVM",72,11,2712,2673,39,1200,835,365,0.878738272915093,0.643564356435644,1.622777747388,598,292,306,-1,1,30.67,2.3,0,0,0,0,0,0,0.0345669580877424,47.6955751927783,5.65286996140933
8.7,"max_tuv_SVM","SVM",72,12,2612,2576,36,1300,932,368,0.877826636711565,0.643564356435644,1.61534881598759,608,296,312,10,1.1,33.23,2.5,0,0,0,0,0,0,0.0317224978431923,43.2190542311118,4.384473994573
8.7,"max_tuv_SVM","SVM",72,13,2512,2479,33,1400,1029,371,0.882195716721047,0.643564356435644,1.6331979741753,618,300,318,10,1.1,35.79,2.8,0,0,0,0,0,0,0.0271710950079907,34.5436226190272,2.96963564669841
8.7,"max_tuv_SVM","SVM",72,14,2412,2383,29,1500,1125,375,0.898818259819149,0.638613861386139,1.66735955363492,640,309,331,22,1.1,38.34,3,0,0,0,0,0,0,0.0222534047583433,25.2041285522832,2.59499942192267
8.7,"max_tuv_SVM","SVM",72,15,2312,2286,26,1600,1222,378,0.911238244691073,0.638613861386139,1.71351918601998,646,316,330,6,1,40.9,3.2,0,0,0,0,0,0,0.027388769381433,28.7244792629918,3.25291902966902
8.7,"max_tuv_SVM","SVM",72,16,2212,2190,22,1700,1318,382,0.917455998735569,0.638613861386139,1.74760680487938,667,327,340,21,1,43.46,3.5,0,0,0,0,0,0,0.0334742662923063,29.4895572780267,3.93980704216785
8.7,"max_tuv_SVM","SVM",72,17,2112,2092,20,1800,1416,384,0.918857321878154,0.638613861386139,1.76543952737815,678,329,349,11,1.1,46.01,3.7,0,0,0,0,0,0,0.0354373439153041,25.2482004463879,4.08584598915536
8.7,"max_tuv_SVM","SVM",72,18,2012,1993,19,1900,1515,385,0.9187740609865,0.638613861386139,1.76543952737815,691,337,354,13,1.1,48.57,3.9,0,0,0,0,0,0,0.0260965833969051,17.7962231839364,2.9763881759895
8.7,"max_tuv_SVM","SVM",72,19,1912,1897,15,2000,1611,389,0.91897162920398,0.638613861386139,1.7621942341293,704,343,361,13,1.1,51.12,4.1,0,0,0,0,0,0,0.024715665851493,15.1150719995286,3.11034382957866
8.7,"max_tuv_SVM","SVM",72,20,1812,1801,11,2100,1707,393,0.919287738351954,0.628712871287129,1.76543952737815,714,347,367,10,1.1,53.68,4.3,0,0,0,0,0,0,0.01635208868949,12.7995047141517,2.31579241808413
8.7,"max_tuv_SVM","SVM",72,21,1712,1705,7,2200,1803,397,0.916693949896712,0.628712871287129,1.76381538797854,725,352,373,11,1.1,56.24,4.5,0,0,0,0,0,0,0.0132625880021951,12.0039851041423,1.65132125904155
8.7,"max_tuv_SVM","SVM",72,22,1612,1606,6,2300,1902,398,0.917481400363537,0.633663366336634,1.76381538797854,728,353,375,3,1.1,58.79,4.8,0,0,0,0,0,0,0.0125222932781796,10.1765382078262,1.26318333592924
8.7,"max_tuv_SVM","SVM",72,23,1512,1506,6,2400,2002,398,0.919050656490973,0.623762376237624,1.76706666058311,753,366,387,25,1.1,61.35,5,0,0,0,0,0,0,0.00725652794455057,4.76945673612391,1.02194393187561
8.7,"max_tuv_SVM","SVM",72,24,1412,1407,5,2500,2101,399,0.919352653623412,0.628712871287129,1.76543952737815,750,367,383,-3,1,63.91,5.3,0,0,0,0,0,0,0.00599003725199259,4.22233347842613,0.651652821955562
8.7,"max_tuv_SVM","SVM",72,25,1312,1307,5,2600,2201,399,0.919476839360113,0.618811881188119,1.76543952737815,762,370,392,12,1.1,66.46,5.5,0,0,0,0,0,0,0.00455825655277954,3.04116417744206,0.501936804417726
8.7,"max_tuv_SVM","SVM",72,26,1212,1208,4,2700,2300,400,0.9194711945539,0.618811881188119,1.77109420500874,768,372,396,6,1.1,69.02,5.8,0,0,0,0,0,0,0.00480994702376285,2.96708510836797,0.501513163348358
8.7,"max_tuv_SVM","SVM",72,27,1112,1108,4,2800,2400,400,0.919157907809033,0.618811881188119,1.77599123967696,770,375,395,2,1.1,71.57,6,0,0,0,0,0,0,0.00386321881547232,2.22866782861469,0.418959013832218
8.7,"max_tuv_SVM","SVM",72,28,1012,1009,3,2900,2499,401,0.91919318784787,0.618811881188119,1.77435588862754,778,380,398,8,1,74.13,6.2,0,0,0,0,0,0,0.00356647114655011,1.83170647019373,0.373180159223993
8.7,"max_tuv_SVM","SVM",72,29,912,909,3,3000,2599,401,0.919282093545737,0.618811881188119,1.77599123967696,778,380,398,0,1,76.69,6.5,0,0,0,0,0,0,0.00357044732242589,1.69294883915339,0.385839009039818
8.7,"max_tuv_SVM","SVM",72,30,812,810,2,3100,2698,402,0.919406279282441,0.618811881188119,1.77599123967696,778,380,398,0,1,79.24,6.7,0,0,0,0,0,0,0.00256264781324673,1.11486595976125,0.281256091038087
8.7,"max_tuv_SVM","SVM",72,31,712,710,2,3200,2798,402,0.919668762771383,0.618811881188119,1.77435588862754,779,382,397,1,1,81.8,7,0,0,0,0,0,0,0.00184456728147224,0.701607868774894,0.201160987730894
8.7,"max_tuv_SVM","SVM",72,32,612,610,2,3300,2898,402,0.919922779051004,0.618811881188119,1.77435588862754,781,383,398,2,1,84.36,7.2,0,0,0,0,0,0,0.00167874817652872,0.578351089036919,0.18865274509245
8.7,"max_tuv_SVM","SVM",72,33,512,510,2,3400,2998,402,0.920182440136839,0.618811881188119,1.77435588862754,779,383,396,-2,1,86.91,7.5,0,0,0,0,0,0,0.00109637704144044,0.336748091222141,0.128356339391516
8.7,"max_tuv_SVM","SVM",72,34,412,410,2,3500,3098,402,0.920300981067329,0.618811881188119,1.77599123967696,778,383,395,-1,1,89.47,7.7,0,0,0,0,0,0,0.00089118601618789,0.257393858837916,0.107942642009656
8.7,"max_tuv_SVM","SVM",72,35,312,312,0,3600,3196,404,0.921870237194765,0.618811881188119,1.77272354650368,791,388,403,13,1,92.02,7.9,0,0,0,0,0,0,0.000968779037903595,0.247193834739668,0.121513438931707
8.7,"max_tuv_SVM","SVM",72,36,212,212,0,3700,3296,404,0.922447418630127,0.618811881188119,1.77435588862754,794,391,403,3,1,94.58,8.2,0,0,0,0,0,0,0.000506362997692525,0.105660094029249,0.0650665885961756
8.7,"max_tuv_SVM","SVM",72,37,112,112,0,3800,3396,404,0.922573015568384,0.618811881188119,1.77599123967696,794,392,402,0,1,97.14,8.4,0,0,0,0,0,0,0.000257188223262505,0.0419307480278611,0.0390958483188299
8.7,"max_tuv_SVM","SVM",72,38,12,12,0,3900,3496,404,0.923100804949376,0.618811881188119,1.77109420500874,797,394,403,3,1,99.69,8.7,0,0,0,0,0,0,0.000179718989272441,0.00233779309811436,0.00233779309811436
8.7,"max_tuv_SVM","SVM",72,39,0,0,0,3912,3508,404,0.923320952391714,0.618811881188119,1.77272354650368,797,394,403,0,1,100,8.7,0,0,0,0,0,0,0,0,0
8.7,"max_tuv_SVM","SVM",73,0,3812,3414,398,100,94,6,0.908913995732527,0.504950495049505,1.76543952737815,18,6,12,0,2,2.56,15.7,0,0,0,0,0,0,0.467379312529605,279.480722786005,54.1118281910473
8.7,"max_tuv_SVM","SVM",73,1,3712,3377,335,200,131,69,0.920484437269273,0.579207920792079,1.7492175023954,90,45,45,72,1,5.11,1.9,0,0,0,0,0,0,0.654725907151712,252.756731358011,78.3352828857681
8.7,"max_tuv_SVM","SVM",73,2,3612,3331,281,300,177,123,0.923662463167644,0.618811881188119,1.77599123967696,169,84,85,79,1,7.67,1.4,0,0,0,0,0,0,0.707765207287213,276.485013580814,80.4159186227677
8.7,"max_tuv_SVM","SVM",73,3,3512,3271,241,400,237,163,0.911876107793239,0.613861386138614,1.72085772113123,252,123,129,83,1,10.22,1.5,0,0,0,0,0,0,0.575882016853275,216.254895904076,79.275899788775
8.7,"max_tuv_SVM","SVM",73,4,3412,3204,208,500,304,196,0.921500502387766,0.618811881188119,1.74760680487938,326,161,165,74,1,12.78,1.6,0,0,0,0,0,0,0.328091957666083,175.577743744994,70.5234975741315
8.7,"max_tuv_SVM","SVM",73,5,3312,3141,171,600,367,233,0.922685911692665,0.623762376237624,1.72500886452282,403,195,208,77,1.1,15.34,1.6,0,0,0,0,0,0,0.123102261179062,102.712519838395,52.0692394264895
8.7,"max_tuv_SVM","SVM",73,6,3212,3086,126,700,422,278,0.920396942772965,0.638613861386139,1.71036643682768,441,213,228,38,1.1,17.89,1.5,0,0,0,0,0,0,0.0872456901815215,81.0951611643969,27.2106547519039
8.7,"max_tuv_SVM","SVM",73,7,3112,3007,105,800,501,299,0.910860042674731,0.643564356435644,1.68519227613369,487,235,252,46,1.1,20.45,1.7,0,0,0,0,0,0,0.0622527980133053,87.9235666510085,22.8864583139356
8.7,"max_tuv_SVM","SVM",73,8,3012,2925,87,900,583,317,0.92054653013762,0.658415841584158,1.68054987316914,520,252,268,33,1.1,23.01,1.8,0,0,0,0,0,0,0.0556853875394636,84.9577062924703,16.6288623393551
8.7,"max_tuv_SVM","SVM",73,9,2912,2845,67,1000,663,337,0.927016889260211,0.653465346534653,1.71194135988184,555,266,289,35,1.1,25.56,2,0,0,0,0,0,0,0.0512182543750482,79.0976681685098,8.45534826179004
8.7,"max_tuv_SVM","SVM",73,10,2812,2755,57,1100,753,347,0.937475303972825,0.648514851485149,1.7492175023954,587,281,306,32,1.1,28.12,2.2,0,0,0,0,0,0,0.0560314565923405,82.2914413758507,8.87176751013232
8.7,"max_tuv_SVM","SVM",73,11,2712,2665,47,1200,843,357,0.942290323673188,0.653465346534653,1.73709091240311,625,301,324,38,1.1,30.67,2.4,0,0,0,0,0,0,0.0571060781165209,69.2666090489128,8.17726447011607
8.7,"max_tuv_SVM","SVM",73,12,2612,2572,40,1300,936,364,0.945064745927273,0.653465346534653,1.78491581877082,648,311,337,23,1.1,33.23,2.6,0,0,0,0,0,0,0.0581429539637462,64.1688875117022,8.05182442145763
8.7,"max_tuv_SVM","SVM",73,13,2512,2472,40,1400,1036,364,0.94496031701232,0.653465346534653,1.77835965414723,649,311,338,1,1.1,35.79,2.8,0,0,0,0,0,0,0.0470956697478634,54.1251899988073,6.90384895465642
8.7,"max_tuv_SVM","SVM",73,14,2412,2378,34,1500,1130,370,0.945253846935443,0.653465346534653,1.78491581877082,656,314,342,7,1.1,38.34,3.1,0,0,0,0,0,0,0.0453582013427093,42.4867332186833,5.18072019014889
8.7,"max_tuv_SVM","SVM",73,15,2312,2285,27,1600,1223,377,0.945095792361457,0.653465346534653,1.78327224987692,677,323,354,21,1.1,40.9,3.2,0,0,0,0,0,0,0.0533315859668725,42.4230572704798,6.10524097228282
8.7,"max_tuv_SVM","SVM",73,16,2212,2195,17,1700,1313,387,0.945750589882257,0.648514851485149,1.78491581877082,706,335,371,29,1.1,43.46,3.4,0,0,0,0,0,0,0.0395236391215726,38.4283925644862,5.43898794220203
8.7,"max_tuv_SVM","SVM",73,17,2112,2097,15,1800,1411,389,0.945846551587892,0.648514851485149,1.78491581877082,711,337,374,5,1.1,46.01,3.6,0,0,0,0,0,0,0.0270076497638188,29.4548361547713,3.03221223979911
8.7,"max_tuv_SVM","SVM",73,18,2012,1997,15,1900,1511,389,0.945356864648845,0.643564356435644,1.78327224987692,712,338,374,1,1.1,48.57,3.9,0,0,0,0,0,0,0.0237111601408702,23.6253214080099,2.46680387915572
8.7,"max_tuv_SVM","SVM",73,19,1912,1898,14,2000,1610,390,0.943465854567219,0.638613861386139,1.79218861112631,729,354,375,17,1.1,51.12,4.1,0,0,0,0,0,0,0.0164499026286342,13.6170044600071,2.11942822057635
8.7,"max_tuv_SVM","SVM",73,20,1812,1800,12,2100,1708,392,0.943780552513637,0.633663366336634,1.79384039786467,732,355,377,3,1.1,53.68,4.4,0,0,0,0,0,0,0.0135415341240638,12.3064345968786,1.50782124462585
8.7,"max_tuv_SVM","SVM",73,21,1712,1701,11,2200,1807,393,0.942640301658449,0.638613861386139,1.78491581877082,741,359,382,9,1.1,56.24,4.6,0,0,0,0,0,0,0.012970578229253,10.0654508232723,1.31227139141166
8.7,"max_tuv_SVM","SVM",73,22,1612,1601,11,2300,1907,393,0.94234677173533,0.648514851485149,1.78561177218639,765,370,395,24,1.1,58.79,4.9,0,0,0,0,0,0,0.0100071041811972,6.72063220599194,1.28075685559124
8.7,"max_tuv_SVM","SVM",73,23,1512,1504,8,2400,2004,396,0.94302132607788,0.648514851485149,1.78397509778476,771,373,398,6,1.1,61.35,5.1,0,0,0,0,0,0,0.00796576241626822,5.64485985560724,0.886258005890207
8.7,"max_tuv_SVM","SVM",73,24,1412,1405,7,2500,2103,397,0.943193492667401,0.648514851485149,1.78071073347042,774,375,399,3,1.1,63.91,5.3,0,0,0,0,0,0,0.00771964274728376,5.16997009205941,0.802087482567696
8.7,"max_tuv_SVM","SVM",73,25,1312,1305,7,2600,2203,397,0.94337694886935,0.648514851485149,1.79384039786467,778,377,401,4,1.1,66.46,5.5,0,0,0,0,0,0,0.00584433780432553,3.59919872705117,0.640489121985668
8.7,"max_tuv_SVM","SVM",73,26,1212,1205,7,2700,2303,397,0.943374126466243,0.648514851485149,1.79384039786467,776,377,399,-2,1.1,69.02,5.8,0,0,0,0,0,0,0.00614387326127394,3.21734214641713,0.625532951506087
8.7,"max_tuv_SVM","SVM",73,27,1112,1105,7,2800,2403,397,0.943869458211504,0.648514851485149,1.80110497237569,781,380,401,5,1.1,71.57,6.1,0,0,0,0,0,0,0.0046439202016094,2.20645206842573,0.519539717120588
8.7,"max_tuv_SVM","SVM",73,28,1012,1005,7,2900,2503,397,0.943852523792862,0.648514851485149,1.79779411764706,782,379,403,1,1.1,74.13,6.3,0,0,0,0,0,0,0.00369484161933159,1.5008920196238,0.393038612768964
8.7,"max_tuv_SVM","SVM",73,29,912,905,7,3000,2603,397,0.943924495072088,0.648514851485149,1.79944802207912,783,381,402,1,1.1,76.69,6.6,0,0,0,0,0,0,0.00323308194589724,1.12496666300746,0.350886874752449
8.7,"max_tuv_SVM","SVM",73,30,812,805,7,3100,2703,397,0.943987999141993,0.648514851485149,1.80110497237569,785,381,404,2,1.1,79.24,6.8,0,0,0,0,0,0,0.00262601341187295,0.853675531624422,0.308171740922208
8.7,"max_tuv_SVM","SVM",73,31,712,706,6,3200,2802,398,0.944091016855395,0.653465346534653,1.79944802207912,787,383,404,2,1.1,81.8,7,0,0,0,0,0,0,0.00175051288449053,0.532277185355534,0.215535231525019
8.7,"max_tuv_SVM","SVM",73,32,612,608,4,3300,2900,400,0.944709123135806,0.648514851485149,1.79449541284404,793,385,408,6,1.1,84.36,7.2,0,0,0,0,0,0,0.00122644687823148,0.391786149520269,0.163355396020193
8.7,"max_tuv_SVM","SVM",73,33,512,509,3,3400,2999,401,0.945203043679515,0.648514851485149,1.79614325068871,803,391,412,10,1.1,86.91,7.5,0,0,0,0,0,0,0.000968861084166243,0.287873751549755,0.122016396863856
8.7,"max_tuv_SVM","SVM",73,34,412,411,1,3500,3097,403,0.945651805773512,0.648514851485149,1.78793418647166,812,394,418,9,1.1,89.47,7.7,0,0,0,0,0,0,0.000876883633094453,0.256428852183491,0.107163599098549
8.7,"max_tuv_SVM","SVM",73,35,312,312,0,3600,3196,404,0.945726599455845,0.648514851485149,1.79779411764706,818,397,421,6,1.1,92.02,7.9,0,0,0,0,0,0,0.0007128396615467,0.172199947622228,0.0857496173352595
8.7,"max_tuv_SVM","SVM",73,36,212,212,0,3700,3296,404,0.945558666470985,0.648514851485149,1.79120879120879,822,398,424,4,1.1,94.58,8.2,0,0,0,0,0,0,0.000355614292685715,0.0752970132732911,0.0475365136325381
8.7,"max_tuv_SVM","SVM",73,37,112,112,0,3800,3396,404,0.94578163631643,0.648514851485149,1.79944802207912,818,400,418,-4,1,97.14,8.4,0,0,0,0,0,0,0.000140266351038394,0.0221355037579193,0.0206365854782779
8.7,"max_tuv_SVM","SVM",73,38,12,12,0,3900,3496,404,0.945812682750606,0.648514851485149,1.79285059578368,817,400,417,-1,1,99.69,8.7,0,0,0,0,0,0,7.82828308318937e-05,0.00114241765383246,0.00114241765383246
8.7,"max_tuv_SVM","SVM",73,39,0,0,0,3912,3508,404,0.945753412285362,0.648514851485149,1.79285059578368,817,400,417,0,1,100,8.7,0,0,0,0,0,0,0,0,0
8.7,"max_tuv_SVM","SVM",74,0,3812,3424,388,100,89,11,0.892170267067732,0.541062801932367,1.74408112748034,30,11,19,0,1.7,2.56,8.1,0,0,0,0,0,0,0.472664452814757,405.940817233799,54.0514672349883
8.7,"max_tuv_SVM","SVM",74,1,3712,3376,336,200,137,63,0.919564803075879,0.57487922705314,1.7755283678051,108,53,55,78,1,5.11,2.2,0,0,0,0,0,0,0.650335489572191,468.375212818119,72.50049301715
8.7,"max_tuv_SVM","SVM",74,2,3612,3318,294,300,195,105,0.907441933692955,0.642512077294686,1.76143516854979,197,97,100,89,1,7.67,1.9,0,0,0,0,0,0,0.632439426834919,310.240040440174,73.048906781748
8.7,"max_tuv_SVM","SVM",74,3,3512,3266,246,400,247,153,0.892588725648625,0.608695652173913,1.70539408012384,291,143,148,94,1,10.22,1.6,0,0,0,0,0,0,0.585949545762926,322.491593014469,71.6320699090744
8.7,"max_tuv_SVM","SVM",74,4,3412,3212,200,500,301,199,0.903395453026311,0.628019323671498,1.73309290055433,365,179,186,74,1,12.78,1.5,0,0,0,0,0,0,0.363955287001647,289.221911597624,68.9932791630685
8.7,"max_tuv_SVM","SVM",74,5,3312,3146,166,600,367,233,0.908035785804452,0.628019323671498,1.7592199292059,425,207,218,60,1.1,15.34,1.6,0,0,0,0,0,0,0.148664193102766,140.723772817584,56.4216795726064
8.7,"max_tuv_SVM","SVM",74,6,3212,3096,116,700,417,283,0.898953991652917,0.647342995169082,1.68954785280171,479,233,246,54,1.1,17.89,1.5,0,0,0,0,0,0,0.122909967349658,152.887115540487,35.1579585649038
8.7,"max_tuv_SVM","SVM",74,7,3112,3024,88,800,489,311,0.910292423828102,0.657004830917874,1.69513219471221,541,259,282,62,1.1,20.45,1.6,0,0,0,0,0,0,0.100752864041014,136.266157343543,28.7909819293305
8.7,"max_tuv_SVM","SVM",74,8,3012,2940,72,900,573,327,0.90929530470139,0.657004830917874,1.6762041773231,586,280,306,45,1.1,23.01,1.8,0,0,0,0,0,0,0.0965571778906488,151.562537993954,26.7739268830474
8.7,"max_tuv_SVM","SVM",74,9,2912,2846,66,1000,667,333,0.914797413566909,0.661835748792271,1.69513219471221,604,288,316,18,1.1,25.56,2,0,0,0,0,0,0,0.07395672766174,116.410296347639,23.5565669415715
8.7,"max_tuv_SVM","SVM",74,10,2812,2760,52,1100,753,347,0.924090508585994,0.671497584541063,1.72279606053327,628,301,327,24,1.1,28.12,2.2,0,0,0,0,0,0,0.066183955663065,94.5723698703559,18.8805533372096
8.7,"max_tuv_SVM","SVM",74,11,2712,2668,44,1200,845,355,0.926572257991469,0.666666666666667,1.73309290055433,651,311,340,23,1.1,30.67,2.4,0,0,0,0,0,0,0.0628168917979778,86.2535958754791,17.2624664735036
8.7,"max_tuv_SVM","SVM",74,12,2612,2570,42,1300,943,357,0.927533469781227,0.661835748792271,1.73859712278176,664,314,350,13,1.1,33.23,2.6,0,0,0,0,0,0,0.052091219677005,66.4254919339503,16.273324656993
8.7,"max_tuv_SVM","SVM",74,13,2512,2479,33,1400,1034,366,0.926823609350283,0.661835748792271,1.74889903114741,676,320,356,12,1.1,35.79,2.8,0,0,0,0,0,0,0.0561670379693386,58.0422120321996,12.923744487579
8.7,"max_tuv_SVM","SVM",74,14,2412,2383,29,1500,1130,370,0.927765486420133,0.666666666666667,1.74729010839566,686,325,361,10,1.1,38.34,3.1,0,0,0,0,0,0,0.0420598729880187,46.6350408397971,11.3305650357955
8.7,"max_tuv_SVM","SVM",74,15,2312,2293,19,1600,1220,380,0.927870446328206,0.676328502415459,1.74889903114741,705,331,374,19,1.1,40.9,3.2,0,0,0,0,0,0,0.0377189772714628,40.2639458010355,7.23168445118097
8.7,"max_tuv_SVM","SVM",74,16,2212,2198,14,1700,1315,385,0.927334598376442,0.671497584541063,1.74729010839566,714,337,377,9,1.1,43.46,3.4,0,0,0,0,0,0,0.031465728576184,34.4715435386652,5.32308372268515
8.7,"max_tuv_SVM","SVM",74,17,2112,2099,13,1800,1414,386,0.926989335520929,0.666666666666667,1.74408112748034,714,339,375,0,1.1,46.01,3.7,0,0,0,0,0,0,0.0240168535247813,26.0388875673373,3.56436096719799
8.7,"max_tuv_SVM","SVM",74,18,2012,2001,11,1900,1512,388,0.926710363133673,0.671497584541063,1.74729010839566,722,341,381,8,1.1,48.57,3.9,0,0,0,0,0,0,0.0204959412656395,21.4922008526371,2.19416150325652
8.7,"max_tuv_SVM","SVM",74,19,1912,1902,10,2000,1611,389,0.925917639617411,0.666666666666667,1.7592199292059,731,344,387,9,1.1,51.12,4.1,0,0,0,0,0,0,0.0199038975472042,20.033342211212,2.09096499566922
8.7,"max_tuv_SVM","SVM",74,20,1812,1802,10,2100,1711,389,0.92545636844244,0.652173913043478,1.7592199292059,740,355,385,9,1.1,53.68,4.4,0,0,0,0,0,0,0.0133741342293614,12.6012517265891,1.58651024076012
8.7,"max_tuv_SVM","SVM",74,21,1712,1703,9,2200,1810,390,0.925091770867016,0.652173913043478,1.7592199292059,739,356,383,-1,1.1,56.24,4.6,0,0,0,0,0,0,0.0125469738223671,10.5156256148519,1.25886660920091
8.7,"max_tuv_SVM","SVM",74,22,1612,1603,9,2300,1910,390,0.928080366144363,0.652173913043478,1.7820620508513,754,368,386,15,1,58.79,4.9,0,0,0,0,0,0,0.0103428108160894,6.65401894869161,1.33135766820037
8.7,"max_tuv_SVM","SVM",74,23,1512,1504,8,2400,2009,391,0.927860778968255,0.647342995169082,1.78370299196626,757,369,388,3,1.1,61.35,5.1,0,0,0,0,0,0,0.00708539662560751,5.10466245728608,0.823105310628104
8.7,"max_tuv_SVM","SVM",74,24,1412,1405,7,2500,2108,392,0.928386959560062,0.647342995169082,1.78534695785748,759,370,389,2,1.1,63.91,5.4,0,0,0,0,0,0,0.00634793090271225,4.40854437398269,0.670449850315178
8.7,"max_tuv_SVM","SVM",74,25,1312,1305,7,2600,2208,392,0.928834420220808,0.647342995169082,1.78370299196626,763,375,388,4,1,66.46,5.6,0,0,0,0,0,0,0.00551949754405628,3.50507673657564,0.579478054911161
8.7,"max_tuv_SVM","SVM",74,26,1212,1205,7,2700,2308,392,0.929008432699988,0.642512077294686,1.77878920961925,769,376,393,6,1,69.02,5.9,0,0,0,0,0,0,0.00424101972137977,2.40878763190553,0.445111164450633
8.7,"max_tuv_SVM","SVM",74,27,1112,1105,7,2800,2408,392,0.929433796537982,0.642512077294686,1.77878920961925,772,377,395,3,1,71.57,6.1,0,0,0,0,0,0,0.00375057529428129,1.84415360465405,0.38830768830931
8.7,"max_tuv_SVM","SVM",74,28,1012,1005,7,2900,2508,392,0.92985363617029,0.642512077294686,1.7820620508513,776,378,398,4,1.1,74.13,6.4,0,0,0,0,0,0,0.00333421535794229,1.4474930804439,0.356140123157316
8.7,"max_tuv_SVM","SVM",74,29,912,907,5,3000,2606,394,0.929831539347536,0.642512077294686,1.77878920961925,781,382,399,5,1,76.69,6.6,0,0,0,0,0,0,0.00289169941100606,1.15589609243341,0.325368980289758
8.7,"max_tuv_SVM","SVM",74,30,812,808,4,3100,2705,395,0.929867446684509,0.642512077294686,1.77878920961925,783,384,399,2,1,79.24,6.8,0,0,0,0,0,0,0.00259298792895052,0.933404547074579,0.28735617702224
8.7,"max_tuv_SVM","SVM",74,31,712,708,4,3200,2805,395,0.929995884466762,0.642512077294686,1.78042412617221,784,384,400,1,1,81.8,7.1,0,0,0,0,0,0,0.00198194627687952,0.657743618127882,0.231311805684582
8.7,"max_tuv_SVM","SVM",74,32,612,609,3,3300,2904,396,0.929861922478821,0.63768115942029,1.77878920961925,786,386,400,2,1,84.36,7.3,0,0,0,0,0,0,0.0016820637952845,0.534088336527589,0.204063785971373
8.7,"max_tuv_SVM","SVM",74,33,512,509,3,3400,3004,396,0.930226520054247,0.63768115942029,1.7820620508513,796,388,408,10,1.1,86.91,7.6,0,0,0,0,0,0,0.000898683103817653,0.275065377561748,0.116982562160532
8.7,"max_tuv_SVM","SVM",74,34,412,411,1,3500,3102,398,0.930831420577114,0.63768115942029,1.7820620508513,803,390,413,7,1.1,89.47,7.8,0,0,0,0,0,0,0.000925516225730627,0.269316217395158,0.116196638518819
8.7,"max_tuv_SVM","SVM",74,35,312,312,0,3600,3201,399,0.93155509152228,0.63768115942029,1.77878920961925,809,393,416,6,1.1,92.02,8,0,0,0,0,0,0,0.000795343335710767,0.202836604010706,0.099882177740972
8.7,"max_tuv_SVM","SVM",74,36,212,212,0,3700,3301,399,0.931762249235591,0.63768115942029,1.7820620508513,808,394,414,-1,1.1,94.58,8.3,0,0,0,0,0,0,0.000281007809358631,0.0588401045378975,0.0380297409153192
8.7,"max_tuv_SVM","SVM",74,37,112,112,0,3800,3401,399,0.932103368936841,0.63768115942029,1.77390242607634,810,396,414,2,1,97.14,8.5,0,0,0,0,0,0,0.000153461060080962,0.0261498561324947,0.0245617506368143
8.7,"max_tuv_SVM","SVM",74,38,12,12,0,3900,3501,399,0.932215234102027,0.63768115942029,1.77878920961925,812,396,416,2,1.1,99.69,8.8,0,0,0,0,0,0,9.76167242930991e-05,0.00136097884175312,0.00136097884175312
8.7,"max_tuv_SVM","SVM",74,39,0,0,0,3912,3513,399,0.932249760387578,0.63768115942029,1.78370299196626,813,396,417,1,1.1,100,8.8,0,0,0,0,0,0,0,0,0
8.7,"max_tuv_SVM","SVM",75,0,3812,3432,380,100,84,16,0.909376534118801,0.533333333333333,1.75337793519612,36,16,20,0,1.2,2.56,5.2,0,0,0,0,0,0,0.7498680792689,510.145312070324,79.0786785779939
8.7,"max_tuv_SVM","SVM",75,1,3712,3400,312,200,116,84,0.915652102765502,0.566666666666667,1.76842659644503,110,57,53,74,0.9,5.11,1.4,0,0,0,0,0,0,0.77906455169972,327.849003123176,84.3641785266746
8.7,"max_tuv_SVM","SVM",75,2,3612,3337,275,300,179,121,0.891002563682985,0.585714285714286,1.71376002102773,207,104,103,97,1,7.67,1.5,0,0,0,0,0,0,0.688938693365118,418.621017966758,76.7459738046176
8.7,"max_tuv_SVM","SVM",75,3,3512,3275,237,400,241,159,0.875124093165333,0.580952380952381,1.64218811491539,302,147,155,95,1.1,10.22,1.5,0,0,0,0,0,0,0.756798045400433,252.897650518225,85.4804399749722
8.7,"max_tuv_SVM","SVM",75,4,3412,3212,200,500,304,196,0.88749113620247,0.60952380952381,1.64672454617206,363,179,184,61,1,12.78,1.6,0,0,0,0,0,0,0.694484549024203,198.975261286574,84.7364658613332
8.7,"max_tuv_SVM","SVM",75,5,3312,3161,151,600,355,245,0.882337860688371,0.633333333333333,1.62807201997634,449,221,228,86,1,15.34,1.4,0,0,0,0,0,0,0.143478776621141,161.585058316392,63.30409797147
8.7,"max_tuv_SVM","SVM",75,6,3212,3100,112,700,416,284,0.871112202040036,0.638095238095238,1.59086973632428,498,242,256,49,1.1,17.89,1.5,0,0,0,0,0,0,0.100692281858168,149.711338082733,48.9135489144714
8.7,"max_tuv_SVM","SVM",75,7,3112,3007,105,800,509,291,0.884806087383403,0.642857142857143,1.63965766951942,515,250,265,17,1.1,20.45,1.7,0,0,0,0,0,0,0.0667628689376206,102.842566669695,42.9316221671323
8.7,"max_tuv_SVM","SVM",75,8,3012,2931,81,900,585,315,0.884324714994814,0.638095238095238,1.62099447513812,526,254,272,11,1.1,23.01,1.9,0,0,0,0,0,0,0.0485248459103895,75.9861685768782,24.3713436445263
8.7,"max_tuv_SVM","SVM",75,9,2912,2841,71,1000,675,325,0.884702449135437,0.638095238095238,1.61801470588235,534,258,276,8,1.1,25.56,2.1,0,0,0,0,0,0,0.0382574539520906,58.3453096808991,16.2751344800079
8.7,"max_tuv_SVM","SVM",75,10,2812,2748,64,1100,768,332,0.885779741449844,0.642857142857143,1.64824226464779,552,264,288,18,1.1,28.12,2.3,0,0,0,0,0,0,0.0364917908443254,57.3984806803753,13.4220468302533
8.7,"max_tuv_SVM","SVM",75,11,2712,2653,59,1200,863,337,0.887045219003984,0.647619047619048,1.65682685977617,572,274,298,20,1.1,30.67,2.6,0,0,0,0,0,0,0.0379381685494968,52.5964324675875,13.1549059781276
8.7,"max_tuv_SVM","SVM",75,12,2612,2553,59,1300,963,337,0.914668903070966,0.628571428571429,1.72391475927388,611,301,310,39,1,33.23,2.9,0,0,0,0,0,0,0.037170317665625,28.7969664117275,13.7243317713512
8.7,"max_tuv_SVM","SVM",75,13,2512,2469,43,1400,1047,353,0.917561228385971,0.633333333333333,1.71758846657929,625,307,318,14,1,35.79,3,0,0,0,0,0,0,0.0249082809597752,16.2640868963309,3.11953036465146
8.7,"max_tuv_SVM","SVM",75,14,2412,2376,36,1500,1140,360,0.922144493536251,0.633333333333333,1.74642857142857,644,317,327,19,1,38.34,3.2,0,0,0,0,0,0,0.0205710490862612,16.0524793609133,2.50498608138965
8.7,"max_tuv_SVM","SVM",75,15,2312,2279,33,1600,1237,363,0.924556810123817,0.633333333333333,1.74964483030781,647,318,329,3,1,40.9,3.4,0,0,0,0,0,0,0.0168267753331398,14.9132074388416,1.94611079989074
8.7,"max_tuv_SVM","SVM",75,16,2212,2186,26,1700,1330,370,0.927387770686749,0.642857142857143,1.76355042016807,667,326,341,20,1,43.46,3.6,0,0,0,0,0,0,0.0334476321050988,23.7965086124428,4.30283190265354
8.7,"max_tuv_SVM","SVM",75,17,2112,2087,25,1800,1429,371,0.928124147711789,0.633333333333333,1.77211134453782,680,331,349,13,1.1,46.01,3.9,0,0,0,0,0,0,0.0251022066167068,16.2446435972502,2.80526295742101
8.7,"max_tuv_SVM","SVM",75,18,2012,1992,20,1900,1524,376,0.928346424480458,0.638095238095238,1.77537490134175,698,341,357,18,1,48.57,4.1,0,0,0,0,0,0,0.0300933618990826,15.6458995614914,3.53546951275902
8.7,"max_tuv_SVM","SVM",75,19,1912,1896,16,2000,1620,380,0.928546882670607,0.638095238095238,1.76679821099711,708,346,362,10,1,51.12,4.3,0,0,0,0,0,0,0.0281658367011516,13.2574208909003,3.35732229445836
8.7,"max_tuv_SVM","SVM",75,20,1812,1800,12,2100,1716,384,0.927387770686752,0.638095238095238,1.7770111915734,719,351,368,11,1,53.68,4.5,0,0,0,0,0,0,0.0200092786804728,10.588973955817,2.87360608416005
8.7,"max_tuv_SVM","SVM",75,21,1712,1705,7,2200,1811,389,0.925792287132504,0.638095238095238,1.76193099829463,731,357,374,12,1,56.24,4.7,0,0,0,0,0,0,0.0117039612718135,8.24346342028323,1.79619543233434
8.7,"max_tuv_SVM","SVM",75,22,1612,1606,6,2300,1910,390,0.925649102710968,0.642857142857143,1.76031454783748,735,358,377,4,1.1,58.79,4.9,0,0,0,0,0,0,0.00956541851532234,6.67657910193675,1.07656056869078
8.7,"max_tuv_SVM","SVM",75,23,1512,1506,6,2400,2010,390,0.925600010909299,0.642857142857143,1.7570905285191,737,358,379,2,1.1,61.35,5.2,0,0,0,0,0,0,0.00723833937467221,5.1390320486786,0.790894487308146
8.7,"max_tuv_SVM","SVM",75,24,1412,1407,5,2500,2109,391,0.925814105711022,0.642857142857143,1.76193099829463,744,361,383,7,1.1,63.91,5.4,0,0,0,0,0,0,0.0062616135729332,4.47040801245566,0.660282312172869
8.7,"max_tuv_SVM","SVM",75,25,1312,1307,5,2600,2209,391,0.926174112256595,0.642857142857143,1.76355042016807,740,361,379,-4,1,66.46,5.6,0,0,0,0,0,0,0.00525703095771979,3.45591731783638,0.553846554778908
8.7,"max_tuv_SVM","SVM",75,26,1212,1207,5,2700,2309,391,0.92666366661213,0.638095238095238,1.76355042016807,748,364,384,8,1.1,69.02,5.9,0,0,0,0,0,0,0.00400282579664128,2.35169952530506,0.424971197047394
8.7,"max_tuv_SVM","SVM",75,27,1112,1108,4,2800,2408,392,0.926896852670058,0.638095238095238,1.76679821099711,754,367,387,6,1.1,71.57,6.1,0,0,0,0,0,0,0.00424215926176844,2.24297416292091,0.440365993633607
8.7,"max_tuv_SVM","SVM",75,28,1012,1008,4,2900,2508,392,0.927177766868497,0.638095238095238,1.76679821099711,757,370,387,3,1,74.13,6.4,0,0,0,0,0,0,0.0036195407031827,1.66320880080403,0.3830863095625
8.7,"max_tuv_SVM","SVM",75,29,912,909,3,3000,2607,393,0.92759231986037,0.633333333333333,1.76679821099711,765,374,391,8,1,76.69,6.6,0,0,0,0,0,0,0.00359197163916932,1.39954973127002,0.393303438861206
8.7,"max_tuv_SVM","SVM",75,30,812,809,3,3100,2707,393,0.927712322042227,0.628571428571429,1.76193099829463,769,374,395,4,1.1,79.24,6.9,0,0,0,0,0,0,0.00255150868470586,0.855641333146124,0.288115863982705
8.7,"max_tuv_SVM","SVM",75,31,712,710,2,3200,2806,394,0.927982326951406,0.628571428571429,1.76193099829463,772,375,397,3,1.1,81.8,7.1,0,0,0,0,0,0,0.00199221164170692,0.619187368166282,0.238072347863706
8.7,"max_tuv_SVM","SVM",75,32,612,610,2,3300,2906,394,0.928244149893642,0.633333333333333,1.75548294340609,773,375,398,1,1.1,84.36,7.4,0,0,0,0,0,0,0.00110378644738948,0.343839213629188,0.140228025103705
8.7,"max_tuv_SVM","SVM",75,33,512,511,1,3400,3005,395,0.928636884306997,0.638095238095238,1.7587010606259,775,376,399,2,1.1,86.91,7.6,0,0,0,0,0,0,0.000930512376512074,0.293757577858799,0.116914967273016
8.7,"max_tuv_SVM","SVM",75,34,412,412,0,3500,3104,396,0.929273714067545,0.638095238095238,1.76031454783748,781,380,401,6,1.1,89.47,7.8,0,0,0,0,0,0,0.000761091521948057,0.215736742427152,0.0902740465519815
8.7,"max_tuv_SVM","SVM",75,35,312,312,0,3600,3204,396,0.929774177712341,0.633333333333333,1.76355042016807,785,382,403,4,1.1,92.02,8.1,0,0,0,0,0,0,0.000413396656936874,0.100236488721335,0.0513343367081638
8.7,"max_tuv_SVM","SVM",75,36,212,212,0,3700,3304,396,0.929812360224751,0.628571428571429,1.76193099829463,787,383,404,2,1.1,94.58,8.3,0,0,0,0,0,0,0.00025507266188923,0.0547969848808533,0.0346077418429027
8.7,"max_tuv_SVM","SVM",75,37,112,112,0,3800,3404,396,0.929782359679287,0.628571428571429,1.76031454783748,789,384,405,2,1.1,97.14,8.6,0,0,0,0,0,0,0.000126459831861356,0.0208660116901696,0.0194898884624705
8.7,"max_tuv_SVM","SVM",75,38,12,12,0,3900,3504,396,0.929954180985128,0.628571428571429,1.76031454783748,789,385,404,0,1,99.69,8.8,0,0,0,0,0,0,0.000103183182675419,0.00138273340305508,0.00138273340305508
8.7,"max_tuv_SVM","SVM",75,39,0,0,0,3912,3516,396,0.930090547100876,0.628571428571429,1.76517282165856,790,385,405,1,1.1,100,8.9,0,0,0,0,0,0,0,0,0
8.7,"max_tuv_SVM","SVM",76,0,3812,3420,392,100,87,13,0.900001417414346,0.537313432835821,1.73200054772012,30,13,17,0,1.3,2.56,6.7,0,0,0,0,0,0,0.610335393897266,482.475797991788,66.8645845410798
8.7,"max_tuv_SVM","SVM",76,1,3712,3373,339,200,134,66,0.899824240620258,0.537313432835821,1.76201712028095,123,60,63,93,1.1,5.11,2,0,0,0,0,0,0,0.66520750114793,519.615140926412,74.4968926381116
8.7,"max_tuv_SVM","SVM",76,2,3612,3319,293,300,188,112,0.904473359697239,0.606965174129353,1.73773987206823,203,99,104,80,1.1,7.67,1.7,0,0,0,0,0,0,0.654401312395273,448.266589765867,73.51323722334
8.7,"max_tuv_SVM","SVM",76,3,3512,3262,250,400,245,155,0.903301158027518,0.621890547263682,1.71100541249795,291,144,147,88,1,10.22,1.6,0,0,0,0,0,0,0.646410928497114,309.950346555894,76.2144817235601
8.7,"max_tuv_SVM","SVM",76,4,3412,3208,204,500,299,201,0.878745871780697,0.606965174129353,1.6352946013733,384,189,195,93,1,12.78,1.5,0,0,0,0,0,0,0.591076277942006,325.330423216204,75.6093684158359
8.7,"max_tuv_SVM","SVM",76,5,3312,3146,166,600,361,239,0.885798925599915,0.641791044776119,1.6352946013733,451,221,230,67,1,15.34,1.5,0,0,0,0,0,0,0.252708441996074,209.413212599645,70.6190826555772
8.7,"max_tuv_SVM","SVM",76,6,3212,3088,124,700,419,281,0.883114342815834,0.63681592039801,1.62189054726368,523,248,275,72,1.1,17.89,1.5,0,0,0,0,0,0,0.140262147455617,193.054841151042,51.6407207124704
8.7,"max_tuv_SVM","SVM",76,7,3112,3023,89,800,484,316,0.886276594236803,0.666666666666667,1.63981198977488,571,271,300,48,1.1,20.45,1.5,0,0,0,0,0,0,0.105548956922261,165.145680022609,36.8495942548815
8.7,"max_tuv_SVM","SVM",76,8,3012,2931,81,900,576,324,0.888010091990205,0.656716417910448,1.64574187884109,594,282,312,23,1.1,23.01,1.8,0,0,0,0,0,0,0.0726905949798715,126.084909313728,32.9047957073073
8.7,"max_tuv_SVM","SVM",76,9,2912,2849,63,1000,658,342,0.893992997973105,0.656716417910448,1.64877271103048,599,288,311,5,1.1,25.56,1.9,0,0,0,0,0,0,0.0584481678562964,97.7460415832775,20.2973885942162
8.7,"max_tuv_SVM","SVM",76,10,2812,2763,49,1100,744,356,0.901184958398901,0.646766169154229,1.6815188762072,614,292,322,15,1.1,28.12,2.1,0,0,0,0,0,0,0.0483916555118494,77.3088153396362,10.7115891812709
8.7,"max_tuv_SVM","SVM",76,11,2712,2672,40,1200,835,365,0.915408711428628,0.626865671641791,1.72204415709471,629,305,324,15,1.1,30.67,2.3,0,0,0,0,0,0,0.045015639941186,61.7434080129694,7.20786639201484
8.7,"max_tuv_SVM","SVM",76,12,2612,2575,37,1300,932,368,0.92318039432468,0.631840796019901,1.72941920233089,640,310,330,11,1.1,33.23,2.5,0,0,0,0,0,0,0.0420247745315772,49.1351900485338,6.62820667275905
8.7,"max_tuv_SVM","SVM",76,13,2512,2480,32,1400,1027,373,0.924369604966612,0.626865671641791,1.73101313707958,661,317,344,21,1.1,35.79,2.8,0,0,0,0,0,0,0.0457466719645407,45.0071210926528,7.00003804820975
8.7,"max_tuv_SVM","SVM",76,14,2412,2381,31,1500,1126,374,0.924772150642789,0.626865671641791,1.72782820030482,662,318,344,1,1.1,38.34,3,0,0,0,0,0,0,0.0374457808698026,38.2570600526095,6.06164019200196
8.7,"max_tuv_SVM","SVM",76,15,2312,2283,29,1600,1224,376,0.924688523195981,0.626865671641791,1.72941920233089,664,320,344,2,1.1,40.9,3.3,0,0,0,0,0,0,0.0326630296817076,33.4942694307139,5.67320212495592
8.7,"max_tuv_SVM","SVM",76,16,2212,2191,21,1700,1316,384,0.925767175518411,0.63681592039801,1.73837992358649,684,328,356,20,1.1,43.46,3.4,0,0,0,0,0,0,0.0320688903993626,31.7734354311206,5.07719417353715
8.7,"max_tuv_SVM","SVM",76,17,2112,2099,13,1800,1408,392,0.927521934487104,0.63681592039801,1.73837992358649,708,339,369,24,1.1,46.01,3.6,0,0,0,0,0,0,0.026910396393879,28.3649255300786,4.26410300833498
8.7,"max_tuv_SVM","SVM",76,18,2012,1999,13,1900,1508,392,0.92762965797791,0.63681592039801,1.73837992358649,707,338,369,-1,1.1,48.57,3.8,0,0,0,0,0,0,0.0220920281787066,23.822357303982,3.34332968583562
8.7,"max_tuv_SVM","SVM",76,19,1912,1903,9,2000,1604,396,0.927411376167584,0.641791044776119,1.73998211706445,717,344,373,10,1.1,51.12,4.1,0,0,0,0,0,0,0.0208595657562549,21.7210486987217,2.23732211052475
8.7,"max_tuv_SVM","SVM",76,20,1812,1803,9,2100,1704,396,0.926388003004905,0.631840796019901,1.73678067802661,720,345,375,3,1.1,53.68,4.3,0,0,0,0,0,0,0.0175010740599296,16.8014114259218,1.83152103558146
8.7,"max_tuv_SVM","SVM",76,21,1712,1704,8,2200,1803,397,0.926548170826761,0.621890547263682,1.76526208735329,744,360,384,24,1.1,56.24,4.5,0,0,0,0,0,0,0.0128076648667574,9.90458585323876,1.53144673513028
8.7,"max_tuv_SVM","SVM",76,22,1612,1605,7,2300,1902,398,0.926531161854529,0.621890547263682,1.76526208735329,749,361,388,5,1.1,58.79,4.8,0,0,0,0,0,0,0.00984129412394032,8.46471512467368,1.12863905972122
8.7,"max_tuv_SVM","SVM",76,23,1512,1507,5,2400,2000,400,0.927054187750689,0.626865671641791,1.77259058891376,756,365,391,7,1.1,61.35,5,0,0,0,0,0,0,0.00932202152993734,7.33849730507745,0.945341004501862
8.7,"max_tuv_SVM","SVM",76,24,1412,1407,5,2500,2100,400,0.927735964054356,0.616915422885572,1.77422280860889,769,375,394,13,1.1,63.91,5.2,0,0,0,0,0,0,0.00597381686699753,3.85570277006646,0.774597599325589
8.7,"max_tuv_SVM","SVM",76,25,1312,1309,3,2600,2198,402,0.928040708140193,0.616915422885572,1.77585803700392,778,378,400,9,1.1,66.46,5.5,0,0,0,0,0,0,0.00496837828693299,3.51379891901066,0.571550589034491
8.7,"max_tuv_SVM","SVM",76,26,1212,1209,3,2700,2298,402,0.927989681223494,0.616915422885572,1.77096136962248,779,378,401,1,1.1,69.02,5.7,0,0,0,0,0,0,0.00465210991253546,2.90651942112674,0.472092067338756
8.7,"max_tuv_SVM","SVM",76,27,1112,1109,3,2800,2398,402,0.928190954061579,0.611940298507463,1.77585803700392,780,381,399,1,1,71.57,6,0,0,0,0,0,0,0.00323983711052196,1.82524371049982,0.369064046855255
8.7,"max_tuv_SVM","SVM",76,28,1012,1010,2,2900,2497,403,0.928366713441319,0.616915422885572,1.77585803700392,782,383,399,2,1,74.13,6.2,0,0,0,0,0,0,0.00302091098534557,1.49129201172031,0.311505602899814
8.7,"max_tuv_SVM","SVM",76,29,912,910,2,3000,2597,403,0.928617595781754,0.616915422885572,1.77096136962248,786,385,401,4,1,76.69,6.4,0,0,0,0,0,0,0.00258953533438352,1.1127359928472,0.275331656005649
8.7,"max_tuv_SVM","SVM",76,30,812,810,2,3100,2697,403,0.928746580487854,0.616915422885572,1.76933514246947,791,387,404,5,1,79.24,6.7,0,0,0,0,0,0,0.00229215004662302,0.862248736713983,0.247328986508432
8.7,"max_tuv_SVM","SVM",76,31,712,710,2,3200,2797,403,0.928648778897516,0.616915422885572,1.77096136962248,792,388,404,1,1,81.8,6.9,0,0,0,0,0,0,0.00194805854127504,0.646274280302031,0.217064043313576
8.7,"max_tuv_SVM","SVM",76,32,612,610,2,3300,2897,403,0.928644526654459,0.616915422885572,1.77585803700392,791,388,403,-1,1,84.36,7.2,0,0,0,0,0,0,0.00120760586379743,0.382569223984304,0.149476323967345
8.7,"max_tuv_SVM","SVM",76,33,512,510,2,3400,2997,403,0.92876358946009,0.616915422885572,1.77259058891376,790,388,402,-1,1,86.91,7.4,0,0,0,0,0,0,0.000761829107405372,0.230027556813762,0.0940265435999107
8.7,"max_tuv_SVM","SVM",76,34,412,412,0,3500,3095,405,0.929344729344721,0.606965174129353,1.77096136962248,799,392,407,9,1,89.47,7.6,0,0,0,0,0,0,0.00082855887465069,0.253219668563371,0.103381653769032
8.7,"max_tuv_SVM","SVM",76,35,312,312,0,3600,3195,405,0.929693413275506,0.606965174129353,1.76363811119197,806,393,413,7,1.1,92.02,7.9,0,0,0,0,0,0,0.000574504530408806,0.151066152129672,0.0694328442769784
8.7,"max_tuv_SVM","SVM",76,36,212,212,0,3700,3295,405,0.929877677141365,0.606965174129353,1.76363811119197,808,396,412,2,1,94.58,8.1,0,0,0,0,0,0,0.000257069289878917,0.0523457836046492,0.0321470435424009
8.7,"max_tuv_SVM","SVM",76,37,112,112,0,3800,3395,405,0.930064775835928,0.601990049751244,1.76201712028095,810,396,414,2,1,97.14,8.4,0,0,0,0,0,0,0.000109510725955446,0.0185002047435196,0.0173805983166785
8.7,"max_tuv_SVM","SVM",76,38,12,12,0,3900,3495,405,0.930005244433114,0.601990049751244,1.76688905701905,813,398,415,3,1,99.69,8.6,0,0,0,0,0,0,7.78504219807731e-05,0.00107355323917413,0.00107355323917413
8.7,"max_tuv_SVM","SVM",76,39,0,0,0,3912,3507,405,0.929983983217822,0.601990049751244,1.76201712028095,812,398,414,-1,1,100,8.7,0,0,0,0,0,0,0,0,0
8.7,"max_tuv_SVM","SVM",77,0,3812,3414,398,100,90,10,0.881574562461925,0.53030303030303,1.74813573523251,29,10,19,0,1.9,2.56,9,0,0,0,0,0,0,0.388231885193586,403.134624519562,47.0793730155116
8.7,"max_tuv_SVM","SVM",77,1,3712,3362,350,200,142,58,0.912661886211365,0.616161616161616,1.76147504456328,116,56,60,87,1.1,5.11,2.4,0,0,0,0,0,0,0.637618792278906,499.235838022694,69.4258960293758
8.7,"max_tuv_SVM","SVM",77,2,3612,3306,306,300,198,102,0.881890578136305,0.606060606060606,1.67375411574307,202,97,105,86,1.1,7.67,1.9,0,0,0,0,0,0,0.591211472218546,508.404967395232,65.9911171897908
8.7,"max_tuv_SVM","SVM",77,3,3512,3248,264,400,256,144,0.899742590868855,0.626262626262626,1.69480122324159,259,128,131,57,1,10.22,1.8,0,0,0,0,0,0,0.639882495541166,263.791522747632,77.3120620049905
8.7,"max_tuv_SVM","SVM",77,4,3412,3185,227,500,319,181,0.900699256501317,0.636363636363636,1.68883689839572,345,168,177,86,1.1,12.78,1.8,0,0,0,0,0,0,0.455064800025467,224.763536503935,70.8186210270859
8.7,"max_tuv_SVM","SVM",77,5,3312,3140,172,600,364,236,0.872493421128243,0.641414141414141,1.59657177838996,413,204,209,68,1,15.34,1.5,0,0,0,0,0,0,0.15799555578408,157.511288881989,56.6980570707485
8.7,"max_tuv_SVM","SVM",77,6,3212,3084,128,700,420,280,0.874958343388388,0.656565656565657,1.59042123163558,480,235,245,67,1,17.89,1.5,0,0,0,0,0,0,0.118292304502101,181.090868754255,39.3578547933283
8.7,"max_tuv_SVM","SVM",77,7,3112,3013,99,800,491,309,0.882256869031609,0.676767676767677,1.60098219766728,535,259,276,55,1.1,20.45,1.6,0,0,0,0,0,0,0.111456743958598,190.671486122082,35.2909048089558
8.7,"max_tuv_SVM","SVM",77,8,3012,2930,82,900,574,326,0.898383723469042,0.676767676767677,1.64646464646465,582,277,305,47,1.1,23.01,1.8,0,0,0,0,0,0,0.0813829355750055,139.171642166134,29.7495613405855
8.7,"max_tuv_SVM","SVM",77,9,2912,2851,61,1000,653,347,0.903404063386997,0.676767676767677,1.65556113622412,609,291,318,27,1.1,25.56,1.9,0,0,0,0,0,0,0.0718433699610763,128.082558521884,19.2516117477892
8.7,"max_tuv_SVM","SVM",77,10,2812,2762,50,1100,742,358,0.90942416198389,0.666666666666667,1.67529674626449,638,305,333,29,1.1,28.12,2.1,0,0,0,0,0,0,0.0686615286636042,117.195493516738,17.8990437946388
8.7,"max_tuv_SVM","SVM",77,11,2712,2674,38,1200,830,370,0.920277863963874,0.656565656565657,1.7208211143695,654,313,341,16,1.1,30.67,2.2,0,0,0,0,0,0,0.0657943148797079,96.8745946320388,12.4925961370553
8.7,"max_tuv_SVM","SVM",77,12,2612,2576,36,1300,928,372,0.924634570965624,0.651515151515151,1.7251559714795,660,318,342,6,1.1,33.23,2.5,0,0,0,0,0,0,0.0587020622167786,81.0623785452206,11.4351414090202
8.7,"max_tuv_SVM","SVM",77,13,2512,2479,33,1400,1025,375,0.926410004481668,0.651515151515151,1.7283330542999,662,320,342,2,1.1,35.79,2.7,0,0,0,0,0,0,0.0475773595362498,64.4512520777974,8.71240956448836
8.7,"max_tuv_SVM","SVM",77,14,2412,2381,31,1500,1123,377,0.928517254455799,0.661616161616162,1.73583117281369,667,323,344,5,1.1,38.34,3,0,0,0,0,0,0,0.0423030092597949,55.0356999360975,8.26257887764679
8.7,"max_tuv_SVM","SVM",77,15,2312,2285,27,1600,1219,381,0.931174658990326,0.656565656565657,1.75724060885351,681,327,354,14,1.1,40.9,3.2,0,0,0,0,0,0,0.036577644981567,46.6712572638681,7.90221474404485
8.7,"max_tuv_SVM","SVM",77,16,2212,2194,18,1700,1310,390,0.933441353236545,0.646464646464647,1.75724060885351,716,340,376,35,1.1,43.46,3.4,0,0,0,0,0,0,0.0396262447908573,48.9214960657039,7.45321257272433
8.7,"max_tuv_SVM","SVM",77,17,2112,2097,15,1800,1407,393,0.934142333459711,0.646464646464647,1.75724060885351,718,342,376,2,1.1,46.01,3.6,0,0,0,0,0,0,0.0346546927305815,40.4898163023052,6.40513557364152
8.7,"max_tuv_SVM","SVM",77,18,2012,1999,13,1900,1505,395,0.933352294273774,0.636363636363636,1.76309553678459,727,352,375,9,1.1,48.57,3.8,0,0,0,0,0,0,0.0255805805832735,24.7222668597506,3.95294648718955
8.7,"max_tuv_SVM","SVM",77,19,1912,1901,11,2000,1603,397,0.933432734627252,0.636363636363636,1.76309553678459,734,353,381,7,1.1,51.12,4,0,0,0,0,0,0,0.0202176206923186,18.5989340544043,2.07705805559757
8.7,"max_tuv_SVM","SVM",77,20,1812,1801,11,2100,1703,397,0.931449018053092,0.626262626262626,1.7647190133378,751,364,387,17,1.1,53.68,4.3,0,0,0,0,0,0,0.0156166393219098,11.3024583305713,1.97453727203399
8.7,"max_tuv_SVM","SVM",77,21,1712,1703,9,2200,1801,399,0.931507911883317,0.626262626262626,1.76634548247451,754,365,389,3,1.1,56.24,4.5,0,0,0,0,0,0,0.0118140850656856,9.76537893039252,1.35373648851008
8.7,"max_tuv_SVM","SVM",77,22,1612,1608,4,2300,1896,404,0.930911791406649,0.621212121212121,1.7647190133378,769,372,397,15,1.1,58.79,4.7,0,0,0,0,0,0,0.0138390695514726,11.0344260801238,1.4606741048539
8.7,"max_tuv_SVM","SVM",77,23,1512,1508,4,2400,1996,404,0.931062617069421,0.616161616161616,1.75824298026133,784,378,406,15,1.1,61.35,4.9,0,0,0,0,0,0,0.0100658588916333,7.51415573740143,1.19023547157821
8.7,"max_tuv_SVM","SVM",77,24,1412,1409,3,2500,2095,405,0.930962066627573,0.621212121212121,1.76309553678459,788,380,408,4,1.1,63.91,5.2,0,0,0,0,0,0,0.00859556631030386,6.13312054985228,0.894367565919134
8.7,"max_tuv_SVM","SVM",77,25,1312,1309,3,2600,2195,405,0.930904609232233,0.621212121212121,1.76309553678459,787,382,405,-1,1.1,66.46,5.4,0,0,0,0,0,0,0.0064369022502851,4.31865905064135,0.707525740620143
8.7,"max_tuv_SVM","SVM",77,26,1212,1209,3,2700,2295,405,0.930979303846177,0.621212121212121,1.76309553678459,786,382,404,-1,1.1,69.02,5.7,0,0,0,0,0,0,0.0060961649761695,3.58115008822386,0.629231351364913
8.7,"max_tuv_SVM","SVM",77,27,1112,1109,3,2800,2395,405,0.930857206881077,0.626262626262626,1.76147504456328,791,385,406,5,1.1,71.57,5.9,0,0,0,0,0,0,0.00533292032791813,2.85838172268431,0.580453338604805
8.7,"max_tuv_SVM","SVM",77,28,1012,1010,2,2900,2494,406,0.930855770446194,0.631313131313131,1.75985752845257,794,386,408,3,1.1,74.13,6.1,0,0,0,0,0,0,0.00482096376713522,2.27629824273989,0.510031095727703
8.7,"max_tuv_SVM","SVM",77,29,912,911,1,3000,2593,407,0.9307767665276,0.631313131313131,1.7647190133378,798,388,410,4,1.1,76.69,6.4,0,0,0,0,0,0,0.00420348990286253,1.78507980637582,0.44826852011544
8.7,"max_tuv_SVM","SVM",77,30,812,811,1,3100,2693,407,0.930795440181086,0.631313131313131,1.76147504456328,797,389,408,-1,1,79.24,6.6,0,0,0,0,0,0,0.00330577986093304,1.2636204078189,0.363478417332276
8.7,"max_tuv_SVM","SVM",77,31,712,712,0,3200,2792,408,0.930778202962484,0.631313131313131,1.76309553678459,803,391,412,6,1.1,81.8,6.8,0,0,0,0,0,0,0.0028507225870323,1.03539834138631,0.325040246727459
8.7,"max_tuv_SVM","SVM",77,32,612,612,0,3300,2892,408,0.930903172797351,0.636363636363636,1.76147504456328,805,391,414,2,1.1,84.36,7.1,0,0,0,0,0,0,0.00213982919257737,0.715177212778356,0.248700781365273
8.7,"max_tuv_SVM","SVM",77,33,512,512,0,3400,2992,408,0.930913227841537,0.631313131313131,1.76634548247451,806,391,415,1,1.1,86.91,7.3,0,0,0,0,0,0,0.00122145629127417,0.411302887370913,0.156500046147643
8.7,"max_tuv_SVM","SVM",77,34,412,412,0,3500,3092,408,0.930913227841537,0.626262626262626,1.76309553678459,807,392,415,1,1.1,89.47,7.6,0,0,0,0,0,0,0.000817589375473759,0.23997579978958,0.0978929659590237
8.7,"max_tuv_SVM","SVM",77,35,312,312,0,3600,3192,408,0.930913227841537,0.621212121212121,1.7647190133378,810,394,416,3,1.1,92.02,7.8,0,0,0,0,0,0,0.000570429845886859,0.145025057595553,0.0696565795255404
8.7,"max_tuv_SVM","SVM",77,36,212,212,0,3700,3292,408,0.931059744199659,0.631313131313131,1.75985752845257,812,396,416,2,1.1,94.58,8.1,0,0,0,0,0,0,0.000354212639242587,0.0741606592407599,0.0461753321768875
8.7,"max_tuv_SVM","SVM",77,37,112,112,0,3800,3392,408,0.931209133427547,0.631313131313131,1.76147504456328,814,396,418,2,1.1,97.14,8.3,0,0,0,0,0,0,0.000140676818122039,0.0235190673135555,0.0220292736687438
8.7,"max_tuv_SVM","SVM",77,38,12,12,0,3900,3492,408,0.931482056055418,0.626262626262626,1.7647190133378,816,398,418,2,1.1,99.69,8.6,0,0,0,0,0,0,9.60888113209711e-05,0.00133133167634954,0.00133133167634954
8.7,"max_tuv_SVM","SVM",77,39,0,0,0,3912,3504,408,0.931573987887964,0.626262626262626,1.76309553678459,816,398,418,0,1.1,100,8.6,0,0,0,0,0,0,0,0,0
8.7,"max_tuv_SVM","SVM",78,0,3812,3421,391,100,90,10,0.912970985220989,0.565853658536585,1.76499597963013,24,10,14,0,1.4,2.56,9,0,0,0,0,0,0,0.845574334713019,544.426383824792,87.6373931145661
8.7,"max_tuv_SVM","SVM",78,1,3712,3339,373,200,172,28,0.89827415692776,0.604878048780488,1.72044786501223,79,28,51,55,1.8,5.11,6.1,0,0,0,0,0,0,0.800987704124021,348.080293573717,87.5938392681096
8.7,"max_tuv_SVM","SVM",78,2,3612,3289,323,300,222,78,0.89273585825523,0.609756097560976,1.70603124648758,166,78,88,87,1.1,7.67,2.8,0,0,0,0,0,0,0.714544608724056,334.0673023955,77.573953409427
8.7,"max_tuv_SVM","SVM",78,3,3512,3237,275,400,274,126,0.889154629410395,0.619512195121951,1.68688855949333,262,126,136,96,1.1,10.22,2.2,0,0,0,0,0,0,0.707786044137089,322.699681529353,79.3286165381567
8.7,"max_tuv_SVM","SVM",78,4,3412,3171,241,500,340,160,0.906913122814847,0.619512195121951,1.73163130714717,332,160,172,70,1.1,12.78,2.1,0,0,0,0,0,0,0.649223408634715,219.586524925834,76.6667684781875
8.7,"max_tuv_SVM","SVM",78,5,3312,3148,164,600,363,237,0.909113955788344,0.624390243902439,1.72922566024188,395,191,204,63,1.1,15.34,1.5,0,0,0,0,0,0,0.168191827283652,124.851181658316,51.3585278569668
8.7,"max_tuv_SVM","SVM",78,6,3212,3083,129,700,428,272,0.900973659650941,0.634146341463415,1.67347980917826,460,222,238,65,1.1,17.89,1.6,0,0,0,0,0,0,0.105471441383731,111.81241211013,38.1236026994022
8.7,"max_tuv_SVM","SVM",78,7,3112,3005,107,800,506,294,0.897608335306662,0.648780487804878,1.63993902439024,496,240,256,36,1.1,20.45,1.7,0,0,0,0,0,0,0.0884878812456681,129.691777463298,32.7116690198585
8.7,"max_tuv_SVM","SVM",78,8,3012,2933,79,900,578,322,0.891133986154265,0.648780487804878,1.62090976281664,538,256,282,42,1.1,23.01,1.8,0,0,0,0,0,0,0.0695425360840288,122.402113647385,21.9912523959798
8.7,"max_tuv_SVM","SVM",78,9,2912,2843,69,1000,668,332,0.911218676435788,0.64390243902439,1.71009684361549,564,271,293,26,1.1,25.56,2,0,0,0,0,0,0,0.0567487414628687,95.282094911779,18.4295529730587
8.7,"max_tuv_SVM","SVM",78,10,2812,2757,55,1100,754,346,0.92362830995531,0.648780487804878,1.71324619323541,604,290,314,40,1.1,28.12,2.2,0,0,0,0,0,0,0.0562643047362123,93.8526610313525,16.4637882065279
8.7,"max_tuv_SVM","SVM",78,11,2712,2664,48,1200,847,353,0.92986307475869,0.64390243902439,1.72288569448481,617,296,321,13,1.1,30.67,2.4,0,0,0,0,0,0,0.0480908131038025,75.5535609091722,12.5065386914306
8.7,"max_tuv_SVM","SVM",78,12,2612,2572,40,1300,939,361,0.935777465141876,0.639024390243902,1.73321995972253,628,302,326,11,1.1,33.23,2.6,0,0,0,0,0,0,0.0469531435197161,61.2696069866781,7.97182237122997
8.7,"max_tuv_SVM","SVM",78,13,2512,2476,36,1400,1035,365,0.941474558092251,0.629268292682927,1.77311463639015,645,310,335,17,1.1,35.79,2.8,0,0,0,0,0,0,0.0540537740954128,54.8138217817694,8.70908373365696
8.7,"max_tuv_SVM","SVM",78,14,2412,2378,34,1500,1133,367,0.94229360226213,0.624390243902439,1.78025466284075,652,312,340,7,1.1,38.34,3.1,0,0,0,0,0,0,0.0431447901533539,41.0786399618324,7.62977227487032
8.7,"max_tuv_SVM","SVM",78,15,2312,2285,27,1600,1226,374,0.944862169352709,0.634146341463415,1.7890243902439,674,322,352,22,1.1,40.9,3.3,0,0,0,0,0,0,0.0429923450016062,38.7745663119977,8.0639424674018
8.7,"max_tuv_SVM","SVM",78,16,2212,2192,20,1700,1319,381,0.945461130225242,0.639024390243902,1.79231909446166,689,329,360,15,1.1,43.46,3.5,0,0,0,0,0,0,0.0348725808155457,36.4415836545779,7.38402288488907
8.7,"max_tuv_SVM","SVM",78,17,2112,2093,19,1800,1418,382,0.945433271580009,0.639024390243902,1.79231909446166,692,331,361,3,1.1,46.01,3.7,0,0,0,0,0,0,0.0280610199148766,32.2396563796018,5.78738694590218
8.7,"max_tuv_SVM","SVM",78,18,2012,1994,18,1900,1517,383,0.943513810923379,0.639024390243902,1.79067022684946,717,347,370,25,1.1,48.57,4,0,0,0,0,0,0,0.0176046176870748,15.6127976358706,4.18246326857012
8.7,"max_tuv_SVM","SVM",78,19,1912,1898,14,2000,1613,387,0.943552813026706,0.639024390243902,1.79231909446166,722,348,374,5,1.1,51.12,4.2,0,0,0,0,0,0,0.0132991279916504,11.8050716913492,1.50054588767005
8.7,"max_tuv_SVM","SVM",78,20,1812,1800,12,2100,1711,389,0.94318786477414,0.634146341463415,1.79397100146117,724,351,373,2,1.1,53.68,4.4,0,0,0,0,0,0,0.0126746663272447,11.7540772888288,1.34557695300262
8.7,"max_tuv_SVM","SVM",78,21,1712,1701,11,2200,1810,390,0.942555473527326,0.634146341463415,1.79397100146117,732,358,374,8,1,56.24,4.6,0,0,0,0,0,0,0.009032049034418,8.11275664061183,1.04986143470974
8.7,"max_tuv_SVM","SVM",78,22,1612,1603,9,2300,1908,392,0.942388321655921,0.634146341463415,1.79397100146117,738,360,378,6,1.1,58.79,4.9,0,0,0,0,0,0,0.00994800428529722,8.06402854778721,1.01934424186271
8.7,"max_tuv_SVM","SVM",78,23,1512,1503,9,2400,2008,392,0.940865846693879,0.629268292682927,1.7890243902439,757,369,388,19,1.1,61.35,5.1,0,0,0,0,0,0,0.00733486236249072,5.31952154273195,0.885222535519495
8.7,"max_tuv_SVM","SVM",78,24,1412,1404,8,2500,2107,393,0.941540025908545,0.629268292682927,1.79231909446166,757,368,389,0,1.1,63.91,5.4,0,0,0,0,0,0,0.00651881565849519,4.75417623449468,0.714994497458939
8.7,"max_tuv_SVM","SVM",78,25,1312,1306,6,2600,2205,395,0.941963477316102,0.634146341463415,1.78574177668382,760,372,388,3,1,66.46,5.6,0,0,0,0,0,0,0.00590226675858944,3.87646719562243,0.613852162215824
8.7,"max_tuv_SVM","SVM",78,26,1212,1206,6,2700,2305,395,0.941776824393034,0.634146341463415,1.78574177668382,766,373,393,6,1.1,69.02,5.8,0,0,0,0,0,0,0.00511175357119271,3.059918642304,0.55754228898928
8.7,"max_tuv_SVM","SVM",78,27,1112,1107,5,2800,2404,396,0.941769859731726,0.629268292682927,1.79067022684946,768,374,394,2,1.1,71.57,6.1,0,0,0,0,0,0,0.00491970713858245,2.66291610386231,0.512160042160291
8.7,"max_tuv_SVM","SVM",78,28,1012,1007,5,2900,2504,396,0.941439734785701,0.624390243902439,1.7890243902439,771,376,395,3,1.1,74.13,6.3,0,0,0,0,0,0,0.00395538081870636,1.92929486842851,0.429238829423574
8.7,"max_tuv_SVM","SVM",78,29,912,907,5,3000,2604,396,0.941560919892469,0.624390243902439,1.79067022684946,769,376,393,-2,1,76.69,6.6,0,0,0,0,0,0,0.00349145331283018,1.48769439448833,0.372394162731722
8.7,"max_tuv_SVM","SVM",78,30,812,807,5,3100,2704,396,0.941424412530822,0.629268292682927,1.7873815762951,772,378,394,3,1,79.24,6.8,0,0,0,0,0,0,0.00270232092920986,0.989548898711533,0.293244244307438
8.7,"max_tuv_SVM","SVM",78,31,712,708,4,3200,2803,397,0.941597136131274,0.629268292682927,1.79067022684946,780,380,400,8,1.1,81.8,7.1,0,0,0,0,0,0,0.00229793972749637,0.791801495078856,0.262230236170444
8.7,"max_tuv_SVM","SVM",78,32,612,609,3,3300,2902,398,0.941838113412549,0.624390243902439,1.79231909446166,783,382,401,3,1,84.36,7.3,0,0,0,0,0,0,0.00176771206620105,0.564117844733702,0.207036740414437
8.7,"max_tuv_SVM","SVM",78,33,512,509,3,3400,3002,398,0.941996907690383,0.629268292682927,1.7890243902439,784,382,402,1,1.1,86.91,7.5,0,0,0,0,0,0,0.00128348291655944,0.385759988326859,0.157138573438701
8.7,"max_tuv_SVM","SVM",78,34,412,409,3,3500,3102,398,0.94228106587177,0.624390243902439,1.7890243902439,783,382,401,-1,1,89.47,7.8,0,0,0,0,0,0,0.000721363747004173,0.20795217827659,0.0943018579624466
8.7,"max_tuv_SVM","SVM",78,35,312,312,0,3600,3199,401,0.94264183532755,0.629268292682927,1.78410498312133,801,391,410,18,1,92.02,8,0,0,0,0,0,0,0.00107166206456497,0.278071512311259,0.14357562473329
8.7,"max_tuv_SVM","SVM",78,36,212,212,0,3700,3299,401,0.942559652324109,0.624390243902439,1.7890243902439,802,391,411,1,1.1,94.58,8.2,0,0,0,0,0,0,0.000491105089359699,0.104024096106879,0.0645937146007995
8.7,"max_tuv_SVM","SVM",78,37,112,112,0,3800,3399,401,0.942448217743172,0.624390243902439,1.7890243902439,806,393,413,4,1.1,97.14,8.5,0,0,0,0,0,0,0.000229879125168091,0.0370988900878082,0.0346671351811836
8.7,"max_tuv_SVM","SVM",78,38,12,12,0,3900,3499,401,0.942400858046274,0.624390243902439,1.78574177668382,806,393,413,0,1.1,99.69,8.7,0,0,0,0,0,0,0.000152905640318267,0.0020946882500618,0.0020946882500618
8.7,"max_tuv_SVM","SVM",78,39,0,0,0,3912,3511,401,0.942320067975095,0.624390243902439,1.7890243902439,807,393,414,1,1.1,100,8.8,0,0,0,0,0,0,0,0,0
8.7,"max_tuv_SVM","SVM",79,0,3812,3413,399,100,93,7,0.851551822323469,0.51,1.67657142857143,35,7,28,0,4,2.56,13.3,0,0,0,0,0,0,0.0773896274652111,271.728453024796,7.99710967937972
8.7,"max_tuv_SVM","SVM",79,1,3712,3352,360,200,154,46,0.902945615034186,0.57,1.73487132352941,94,44,50,59,1.1,5.11,3.3,0,0,0,0,0,0,0.534545002718753,434.919466365072,59.9486063409925
8.7,"max_tuv_SVM","SVM",79,2,3612,3322,290,300,184,116,0.903661731207294,0.575,1.73010082493126,164,82,82,70,1,7.67,1.6,0,0,0,0,0,0,0.583123158800064,384.290746981459,72.2816123478357
8.7,"max_tuv_SVM","SVM",79,3,3512,3265,247,400,241,159,0.90383257403188,0.605,1.71847286108556,255,126,129,91,1,10.22,1.5,0,0,0,0,0,0,0.484620581902961,300.684819220206,69.2348303563058
8.7,"max_tuv_SVM","SVM",79,4,3412,3202,210,500,304,196,0.888246013667424,0.66,1.66448942042318,336,165,171,81,1,12.78,1.6,0,0,0,0,0,0,0.34545284050787,207.186511968235,64.8347763766466
8.7,"max_tuv_SVM","SVM",79,5,3312,3153,159,600,353,247,0.89328445330297,0.665,1.65701657458564,421,208,213,85,1,15.34,1.4,0,0,0,0,0,0,0.18616219174881,163.149971562645,47.9370855601929
8.7,"max_tuv_SVM","SVM",79,6,3212,3083,129,700,423,277,0.893301537585411,0.67,1.65701657458564,460,227,233,39,1,17.89,1.5,0,0,0,0,0,0,0.104272781408077,112.456324088512,29.0736337322841
8.7,"max_tuv_SVM","SVM",79,7,3112,3009,103,800,497,303,0.897512813211851,0.67,1.64801104972376,491,238,253,31,1.1,20.45,1.6,0,0,0,0,0,0,0.0770617612635312,102.106587564627,16.5649695649341
8.7,"max_tuv_SVM","SVM",79,8,3012,2927,85,900,579,321,0.903745728929391,0.68,1.64498161764706,534,259,275,43,1.1,23.01,1.8,0,0,0,0,0,0,0.0763343435878112,123.743048312304,16.4328458069091
8.7,"max_tuv_SVM","SVM",79,9,2912,2841,71,1000,665,335,0.910239179954449,0.685,1.65549218031279,577,274,303,43,1.1,25.56,2,0,0,0,0,0,0,0.0614027229784217,94.0113019492879,13.9081992107702
8.7,"max_tuv_SVM","SVM",79,10,2812,2754,58,1100,752,348,0.924789293849665,0.68,1.72005524861878,607,290,317,30,1.1,28.12,2.2,0,0,0,0,0,0,0.0723410672526255,98.814358929593,12.3323432845982
8.7,"max_tuv_SVM","SVM",79,11,2712,2667,45,1200,839,361,0.930048405466988,0.68,1.76345906163753,643,306,337,36,1.1,30.67,2.3,0,0,0,0,0,0,0.0774547870292994,78.7134159403769,10.4442416609183
8.7,"max_tuv_SVM","SVM",79,12,2612,2573,39,1300,933,367,0.931511958997741,0.68,1.76022038567493,658,317,341,15,1.1,33.23,2.5,0,0,0,0,0,0,0.0637266372868971,65.8228698171701,8.8778713008771
8.7,"max_tuv_SVM","SVM",79,13,2512,2478,34,1400,1028,372,0.931830865603664,0.675,1.75284926470588,668,322,346,10,1.1,35.79,2.8,0,0,0,0,0,0,0.0595785410185641,57.0495025048509,8.12286370631935
8.7,"max_tuv_SVM","SVM",79,14,2412,2386,26,1500,1120,380,0.931455011389537,0.67,1.75769585253456,691,329,362,23,1.1,38.34,2.9,0,0,0,0,0,0,0.0613553263255955,57.6801115888032,9.0098621913184
8.7,"max_tuv_SVM","SVM",79,15,2312,2290,22,1600,1216,384,0.931164578587715,0.675,1.74868202764977,698,334,364,7,1.1,40.9,3.2,0,0,0,0,0,0,0.0461931439738526,46.5916662470766,7.31439542824738
8.7,"max_tuv_SVM","SVM",79,16,2212,2194,18,1700,1312,388,0.931474943052407,0.675,1.74546458141674,710,338,372,12,1.1,43.46,3.4,0,0,0,0,0,0,0.0350894994169373,40.231464875981,5.97949438798424
8.7,"max_tuv_SVM","SVM",79,17,2112,2097,15,1800,1409,391,0.932232346241475,0.67,1.75446182152714,715,343,372,5,1.1,46.01,3.6,0,0,0,0,0,0,0.0278974672051323,32.6178992736593,3.98941997715107
8.7,"max_tuv_SVM","SVM",79,18,2012,2001,11,1900,1505,395,0.93235051252849,0.67,1.75284926470588,724,347,377,9,1.1,48.57,3.8,0,0,0,0,0,0,0.0265096905175124,31.1205431696189,2.85123805542463
8.7,"max_tuv_SVM","SVM",79,19,1912,1902,10,2000,1604,396,0.9324088838269,0.675,1.76183823529412,730,351,379,6,1.1,51.12,4.1,0,0,0,0,0,0,0.0203474102015625,22.0445122433781,2.20603068374348
8.7,"max_tuv_SVM","SVM",79,20,1812,1803,9,2100,1703,397,0.932011674259701,0.675,1.76508287292818,731,354,377,1,1.1,53.68,4.3,0,0,0,0,0,0,0.0200085662514223,21.0042422161133,2.10548274240195
8.7,"max_tuv_SVM","SVM",79,21,1712,1704,8,2200,1802,398,0.931456435079746,0.675,1.76508287292818,742,358,384,11,1.1,56.24,4.5,0,0,0,0,0,0,0.0158585181252848,15.0162120980574,1.62059564222232
8.7,"max_tuv_SVM","SVM",79,22,1612,1605,7,2300,1901,399,0.929063211845121,0.665,1.75769585253456,764,368,396,22,1.1,58.79,4.8,0,0,0,0,0,0,0.0118553320140862,8.45361580776894,1.47987341373933
8.7,"max_tuv_SVM","SVM",79,23,1512,1506,6,2400,2000,400,0.929410592255143,0.67,1.7560773480663,766,370,396,2,1.1,61.35,5,0,0,0,0,0,0,0.00827013389502088,6.74038476145429,0.966483898630924
8.7,"max_tuv_SVM","SVM",79,24,1412,1407,5,2500,2099,401,0.929476082004568,0.67,1.75123966942149,770,369,401,4,1.1,63.91,5.2,0,0,0,0,0,0,0.00784237631039676,6.10198696964837,0.805600873217956
8.7,"max_tuv_SVM","SVM",79,25,1312,1308,4,2600,2198,402,0.929486047836007,0.665,1.7560773480663,777,380,397,7,1,66.46,5.5,0,0,0,0,0,0,0.00572131080608372,4.04746353308842,0.660802703303176
8.7,"max_tuv_SVM","SVM",79,26,1212,1209,3,2700,2297,403,0.929720956719838,0.665,1.75769585253456,780,381,399,3,1,69.02,5.7,0,0,0,0,0,0,0.00553059245843315,3.72901561661113,0.566949078841657
8.7,"max_tuv_SVM","SVM",79,27,1112,1109,3,2800,2397,403,0.930015660592274,0.665,1.7560773480663,790,385,405,10,1.1,71.57,5.9,0,0,0,0,0,0,0.00378947046044015,2.31879239908549,0.426565117350424
8.7,"max_tuv_SVM","SVM",79,28,1012,1010,2,2900,2496,404,0.93039009111619,0.655,1.75446182152714,793,386,407,3,1.1,74.13,6.2,0,0,0,0,0,0,0.00380764837182154,2.05815355949052,0.390158303037658
8.7,"max_tuv_SVM","SVM",79,29,912,910,2,3000,2596,404,0.929846241457874,0.65,1.75769585253456,801,389,412,8,1.1,76.69,6.4,0,0,0,0,0,0,0.0029540855122162,1.35305469633839,0.317168280597008
8.7,"max_tuv_SVM","SVM",79,30,812,810,2,3100,2696,404,0.929738041002293,0.65,1.75769585253456,801,389,412,0,1.1,79.24,6.7,0,0,0,0,0,0,0.00283141060439264,1.05141665118128,0.292055771103012
8.7,"max_tuv_SVM","SVM",79,31,712,710,2,3200,2796,404,0.929746583143523,0.65,1.75769585253456,805,392,413,4,1.1,81.8,6.9,0,0,0,0,0,0,0.00202902195241578,0.62735024772227,0.225597934240431
8.7,"max_tuv_SVM","SVM",79,32,612,610,2,3300,2896,404,0.929757972665163,0.655,1.75769585253456,805,392,413,0,1.1,84.36,7.2,0,0,0,0,0,0,0.00140333972321832,0.433856740619295,0.181492842588425
8.7,"max_tuv_SVM","SVM",79,33,512,510,2,3400,2996,404,0.930066913439651,0.65,1.7560773480663,806,392,414,1,1.1,86.91,7.4,0,0,0,0,0,0,0.000745360633437971,0.229463614109751,0.10248354597107
8.7,"max_tuv_SVM","SVM",79,34,412,412,0,3500,3094,406,0.930933940774503,0.655,1.76345906163753,813,395,418,7,1.1,89.47,7.6,0,0,0,0,0,0,0.000986950613078672,0.297012019314772,0.124993762813389
8.7,"max_tuv_SVM","SVM",79,35,312,312,0,3600,3194,406,0.931469248291587,0.655,1.76508287292818,817,397,420,4,1.1,92.02,7.9,0,0,0,0,0,0,0.000472327901822045,0.117233570650171,0.0588807548344752
8.7,"max_tuv_SVM","SVM",79,36,212,212,0,3700,3294,406,0.93177961275628,0.655,1.76345906163753,821,398,423,4,1.1,94.58,8.1,0,0,0,0,0,0,0.000255271652317495,0.0552832008621284,0.0351265783436719
8.7,"max_tuv_SVM","SVM",79,37,112,112,0,3800,3394,406,0.931903473804116,0.65,1.76508287292818,825,400,425,4,1.1,97.14,8.4,0,0,0,0,0,0,9.80260027967943e-05,0.0160514406253641,0.0150650129496897
8.7,"max_tuv_SVM","SVM",79,38,12,12,0,3900,3494,406,0.932246583143523,0.65,1.76670967741935,824,400,424,-1,1.1,99.69,8.6,0,0,0,0,0,0,6.39608390264488e-05,0.000997408315485952,0.000997408315485952
8.7,"max_tuv_SVM","SVM",79,39,0,0,0,3912,3506,406,0.932248006833728,0.65,1.76508287292818,826,400,426,2,1.1,100,8.6,0,0,0,0,0,0,0,0,0
8.7,"max_tuv_SVM","SVM",80,0,3812,3440,372,100,88,12,0.903480470089481,0.572072072072072,1.71052371052371,28,12,16,0,1.3,2.56,7.3,0,0,0,0,0,0,0.540043118208197,446.149974141468,61.9748589170459
8.7,"max_tuv_SVM","SVM",80,1,3712,3395,317,200,133,67,0.892655631409958,0.648648648648649,1.67018117018117,117,58,59,89,1,5.11,2,0,0,0,0,0,0,0.64194947906486,395.984762290007,72.7977126732331
8.7,"max_tuv_SVM","SVM",80,2,3612,3344,268,300,184,116,0.916475731787159,0.662162162162162,1.71997411776417,208,104,104,91,1,7.67,1.6,0,0,0,0,0,0,0.693826757204198,337.970492434498,81.8123357475589
8.7,"max_tuv_SVM","SVM",80,3,3512,3284,228,400,244,156,0.902058200068584,0.617117117117117,1.68941234812794,302,149,153,94,1,10.22,1.6,0,0,0,0,0,0,0.584237498338336,443.505412702944,71.3794617690795
8.7,"max_tuv_SVM","SVM",80,4,3412,3219,193,500,309,191,0.882508806384234,0.653153153153153,1.64035371777307,358,177,181,56,1,12.78,1.6,0,0,0,0,0,0,0.353997523891855,327.625208818432,71.2316673039001
8.7,"max_tuv_SVM","SVM",80,5,3312,3163,149,600,365,235,0.886880825462137,0.693693693693694,1.61814707269253,429,210,219,71,1,15.34,1.6,0,0,0,0,0,0,0.178553737157266,249.553319019343,54.6175271550267
8.7,"max_tuv_SVM","SVM",80,6,3212,3103,109,700,425,275,0.888026434739237,0.684684684684685,1.62112434421542,476,231,245,47,1.1,17.89,1.5,0,0,0,0,0,0,0.100348592480804,162.569518207545,29.9961863354794
8.7,"max_tuv_SVM","SVM",80,7,3112,3029,83,800,499,301,0.881615179193028,0.698198198198198,1.58870185733111,544,263,281,68,1.1,20.45,1.7,0,0,0,0,0,0,0.123893525074239,214.094883380991,30.2049088179185
8.7,"max_tuv_SVM","SVM",80,8,3012,2931,81,900,597,303,0.90255047434977,0.684684684684685,1.66318251953611,565,274,291,21,1.1,23.01,2,0,0,0,0,0,0,0.0824404547858647,120.266993077809,26.5247285700564
8.7,"max_tuv_SVM","SVM",80,9,2912,2851,61,1000,677,323,0.915669129336938,0.684684684684685,1.69719765848798,589,283,306,24,1.1,25.56,2.1,0,0,0,0,0,0,0.0619520928918005,102.20424938936,15.8401530069361
8.7,"max_tuv_SVM","SVM",80,10,2812,2761,51,1100,767,333,0.920869831769487,0.684684684684685,1.69096369096369,615,293,322,26,1.1,28.12,2.3,0,0,0,0,0,0,0.0668937674534709,108.000073422473,15.5595404370866
8.7,"max_tuv_SVM","SVM",80,11,2712,2665,47,1200,863,337,0.924149495516292,0.684684684684685,1.7006160572337,632,302,330,17,1.1,30.67,2.6,0,0,0,0,0,0,0.0566570413195565,83.19677215172,13.2506453978713
8.7,"max_tuv_SVM","SVM",80,12,2612,2570,42,1300,958,342,0.926855055747799,0.689189189189189,1.70871422893482,644,308,336,12,1.1,33.23,2.8,0,0,0,0,0,0,0.0511476094286214,72.4967943292279,11.833662146708
8.7,"max_tuv_SVM","SVM",80,13,2512,2474,38,1400,1054,346,0.928383833660657,0.689189189189189,1.71997411776417,650,312,338,6,1.1,35.79,3,0,0,0,0,0,0,0.0454365148860797,62.3778470974113,9.5402391197282
8.7,"max_tuv_SVM","SVM",80,14,2412,2377,35,1500,1151,349,0.929895726176011,0.689189189189189,1.71997411776417,659,316,343,9,1.1,38.34,3.3,0,0,0,0,0,0,0.0374993387128338,52.6109701700138,8.68585220412663
8.7,"max_tuv_SVM","SVM",80,15,2312,2281,31,1600,1247,353,0.932128495277298,0.684684684684685,1.74431337414763,674,320,354,15,1.1,40.9,3.5,0,0,0,0,0,0,0.0390431763838431,51.792544197331,9.1170759341041
8.7,"max_tuv_SVM","SVM",80,16,2212,2189,23,1700,1339,361,0.936532986273481,0.684684684684685,1.75242645960878,696,330,366,22,1.1,43.46,3.7,0,0,0,0,0,0,0.0453310094611156,52.1181537515253,9.76116732095773
8.7,"max_tuv_SVM","SVM",80,17,2112,2091,21,1800,1437,363,0.937540914617055,0.689189189189189,1.74920508744038,703,332,371,7,1.1,46.01,4,0,0,0,0,0,0,0.0347906246768951,42.3971186284267,8.55789020885477
8.7,"max_tuv_SVM","SVM",80,18,2012,1994,18,1900,1534,366,0.938134501283304,0.689189189189189,1.75081429175265,709,335,374,6,1.1,48.57,4.2,0,0,0,0,0,0,0.035319881729872,40.6821087648705,8.32345092016727
8.7,"max_tuv_SVM","SVM",80,19,1912,1895,17,2000,1633,367,0.937095399898169,0.68018018018018,1.77187104459832,733,355,378,24,1.1,51.12,4.4,0,0,0,0,0,0,0.0264620919915726,22.0589030058353,7.95383763151796
8.7,"max_tuv_SVM","SVM",80,20,1812,1801,11,2100,1727,373,0.937139561707037,0.68018018018018,1.77513115691589,734,355,379,1,1.1,53.68,4.6,0,0,0,0,0,0,0.0165683534864223,12.5566423660596,2.02584901101382
8.7,"max_tuv_SVM","SVM",80,21,1712,1703,9,2200,1825,375,0.937292829161341,0.675675675675676,1.77513115691589,740,358,382,6,1.1,56.24,4.9,0,0,0,0,0,0,0.0115244420758636,9.75257246210744,1.30652117593258
8.7,"max_tuv_SVM","SVM",80,22,1612,1603,9,2300,1925,375,0.936944730197325,0.675675675675676,1.77840328808071,740,358,382,0,1.1,58.79,5.1,0,0,0,0,0,0,0.0112054200935845,9.4371581792732,1.16983282717694
8.7,"max_tuv_SVM","SVM",80,23,1512,1506,6,2400,2022,378,0.937235678585155,0.68018018018018,1.77187104459832,757,369,388,17,1.1,61.35,5.3,0,0,0,0,0,0,0.0098937955021,8.07821070363522,1.09443283504892
8.7,"max_tuv_SVM","SVM",80,24,1412,1407,5,2500,2121,379,0.937555202261083,0.671171171171171,1.77513115691589,765,369,396,8,1.1,63.91,5.6,0,0,0,0,0,0,0.00803323536927249,5.97102084076081,0.847622022372177
8.7,"max_tuv_SVM","SVM",80,25,1312,1307,5,2600,2221,379,0.938265687833163,0.671171171171171,1.77349960254372,765,372,393,0,1.1,66.46,5.9,0,0,0,0,0,0,0.00606988501720775,4.16971737856234,0.658931244511538
8.7,"max_tuv_SVM","SVM",80,26,1212,1207,5,2700,2321,379,0.938344919313779,0.671171171171171,1.77676571599224,764,372,392,-1,1.1,69.02,6.1,0,0,0,0,0,0,0.00560807913557844,3.39636233281844,0.574432447291351
8.7,"max_tuv_SVM","SVM",80,27,1112,1107,5,2800,2421,379,0.939122946475899,0.666666666666667,1.77676571599224,769,374,395,5,1.1,71.57,6.4,0,0,0,0,0,0,0.00420105510841455,2.19432288505057,0.465603148864514
8.7,"max_tuv_SVM","SVM",80,28,1012,1008,4,2900,2520,380,0.938887849787513,0.671171171171171,1.77349960254372,770,375,395,1,1.1,74.13,6.6,0,0,0,0,0,0,0.00353961177886337,1.69963009755532,0.372092928346491
8.7,"max_tuv_SVM","SVM",80,29,912,910,2,3000,2618,382,0.938069557446725,0.666666666666667,1.77840328808071,780,380,400,10,1.1,76.69,6.9,0,0,0,0,0,0,0.00306718604881782,1.41091001955944,0.336415226859392
8.7,"max_tuv_SVM","SVM",80,30,812,810,2,3100,2718,382,0.938222824901031,0.671171171171171,1.77840328808071,782,380,402,2,1.1,79.24,7.1,0,0,0,0,0,0,0.00265251904261018,1.04621898550213,0.282339698112929
8.7,"max_tuv_SVM","SVM",80,31,712,710,2,3200,2818,382,0.938308550765305,0.666666666666667,1.77840328808071,783,380,403,1,1.1,81.8,7.4,0,0,0,0,0,0,0.00218610879316595,0.762516452895014,0.24389340337793
8.7,"max_tuv_SVM","SVM",80,32,612,610,2,3300,2918,382,0.938292964244529,0.671171171171171,1.77840328808071,782,380,402,-1,1.1,84.36,7.6,0,0,0,0,0,0,0.00163559655446915,0.536219086424631,0.194738098593747
8.7,"max_tuv_SVM","SVM",80,33,512,510,2,3400,3018,382,0.938394276629579,0.671171171171171,1.77840328808071,786,381,405,4,1.1,86.91,7.9,0,0,0,0,0,0,0.00119286581116196,0.369869418786663,0.147244024516
8.7,"max_tuv_SVM","SVM",80,34,412,412,0,3500,3116,384,0.93849558901462,0.666666666666667,1.77349960254372,792,383,409,6,1.1,89.47,8.1,0,0,0,0,0,0,0.00162726859281766,0.473754894591556,0.218558882237678
8.7,"max_tuv_SVM","SVM",80,35,312,312,0,3600,3216,384,0.939072290283366,0.666666666666667,1.77187104459832,792,383,409,0,1.1,92.02,8.4,0,0,0,0,0,0,0.000670021041560671,0.162878159850557,0.085893613993518
8.7,"max_tuv_SVM","SVM",80,36,212,212,0,3700,3316,384,0.939545081413597,0.666666666666667,1.77187104459832,794,384,410,2,1.1,94.58,8.6,0,0,0,0,0,0,0.00034173674281239,0.0734275146233246,0.0474918109897472
8.7,"max_tuv_SVM","SVM",80,37,112,112,0,3800,3416,384,0.939976308488421,0.666666666666667,1.77024547483263,793,384,409,-1,1.1,97.14,8.9,0,0,0,0,0,0,0.000105625837537734,0.0186368581726847,0.0175303257808517
8.7,"max_tuv_SVM","SVM",80,38,12,12,0,3900,3516,384,0.940472479399816,0.666666666666667,1.77349960254372,793,384,409,0,1.1,99.69,9.2,0,0,0,0,0,0,7.53788251395424e-05,0.00117100069288038,0.00117100069288038
8.7,"max_tuv_SVM","SVM",80,39,0,0,0,3912,3528,384,0.940543917620043,0.666666666666667,1.77349960254372,793,384,409,0,1.1,100,9.2,0,0,0,0,0,0,0,0,0
8.7,"max_tuv_SVM","SVM",81,0,3812,3404,408,100,91,9,0.827714447408839,0.455026455026455,1.62153463535952,23,9,14,0,1.6,2.56,10.1,0,0,0,0,0,0,0.246585973372929,384.422073999427,27.1936072801352
8.7,"max_tuv_SVM","SVM",81,1,3712,3365,347,200,130,70,0.855404640633837,0.53968253968254,1.63308577253531,94,46,48,71,1,5.11,1.9,0,0,0,0,0,0,0.794078948041593,317.852764214364,88.1402054823829
8.7,"max_tuv_SVM","SVM",81,2,3612,3306,306,300,189,111,0.86588334635873,0.587301587301587,1.63107307439105,180,87,93,86,1.1,7.67,1.7,0,0,0,0,0,0,0.770999180354498,400.631648568014,83.5945572252963
8.7,"max_tuv_SVM","SVM",81,3,3512,3242,270,400,253,147,0.855358228306729,0.576719576719577,1.61199619632799,267,130,137,87,1.1,10.22,1.7,0,0,0,0,0,0,0.750436546212196,259.446568329905,85.6825873868566
8.7,"max_tuv_SVM","SVM",81,4,3412,3196,216,500,299,201,0.862565613555985,0.603174603174603,1.66768978923675,359,176,183,92,1,12.78,1.5,0,0,0,0,0,0,0.719255062164559,228.365939672054,82.0308439144773
8.7,"max_tuv_SVM","SVM",81,5,3312,3138,174,600,357,243,0.834775109817543,0.603174603174603,1.52615024504425,422,208,214,63,1,15.34,1.5,0,0,0,0,0,0,0.178015126994731,164.50851932726,68.467400963219
8.7,"max_tuv_SVM","SVM",81,6,3212,3079,133,700,416,284,0.827642583160393,0.608465608465608,1.49753492794967,475,231,244,53,1.1,17.89,1.5,0,0,0,0,0,0,0.104024458565158,108.966201803212,45.2336662314388
8.7,"max_tuv_SVM","SVM",81,7,3112,2996,116,800,499,301,0.829865883346343,0.619047619047619,1.50291783380019,512,246,266,37,1.1,20.45,1.7,0,0,0,0,0,0,0.0690452810213245,99.438097917568,39.2241469340806
8.7,"max_tuv_SVM","SVM",81,8,3012,2920,92,900,575,325,0.8453870638364,0.619047619047619,1.55476556213883,538,259,279,26,1.1,23.01,1.8,0,0,0,0,0,0,0.0607270508324992,84.1674736648839,25.147017092046
8.7,"max_tuv_SVM","SVM",81,9,2912,2839,73,1000,656,344,0.850324736572602,0.619047619047619,1.5628635739133,559,268,291,21,1.1,25.56,1.9,0,0,0,0,0,0,0.0520817793445117,74.4311271143063,14.8939919576764
8.7,"max_tuv_SVM","SVM",81,10,2812,2749,63,1100,746,354,0.861137311618344,0.62962962962963,1.57094668594209,581,280,301,22,1.1,28.12,2.1,0,0,0,0,0,0,0.0512085450613969,80.0847707580194,14.8300613821234
8.7,"max_tuv_SVM","SVM",81,11,2712,2657,55,1200,838,362,0.887816913849735,0.62962962962963,1.64711379798776,620,302,318,39,1.1,30.67,2.3,0,0,0,0,0,0,0.0413524654730559,52.8650032171106,13.0404923628097
8.7,"max_tuv_SVM","SVM",81,12,2612,2574,38,1300,921,379,0.900171575893136,0.64021164021164,1.6851973540106,638,309,329,18,1.1,33.23,2.4,0,0,0,0,0,0,0.0360310409912161,47.8770764567399,4.12422174343675
8.7,"max_tuv_SVM","SVM",81,13,2512,2483,29,1400,1012,388,0.919799498746857,0.62962962962963,1.73599590373784,670,324,346,32,1.1,35.79,2.6,0,0,0,0,0,0,0.0728487530751086,69.8219650257212,9.16526298358442
8.7,"max_tuv_SVM","SVM",81,14,2412,2386,26,1500,1109,391,0.92147932555402,0.624338624338624,1.74232268804486,692,333,359,22,1.1,38.34,2.8,0,0,0,0,0,0,0.0580810674928962,50.7331108831382,6.42216899162289
8.7,"max_tuv_SVM","SVM",81,15,2312,2290,22,1600,1205,395,0.92249440806316,0.624338624338624,1.75023342670401,696,337,359,4,1.1,40.9,3.1,0,0,0,0,0,0,0.0532411703108527,45.398557268942,5.80965482364372
8.7,"max_tuv_SVM","SVM",81,16,2212,2192,20,1700,1303,397,0.923081299425377,0.624338624338624,1.75184357705057,707,340,367,11,1.1,43.46,3.3,0,0,0,0,0,0,0.041093795585236,33.1412125086772,4.60633426008418
8.7,"max_tuv_SVM","SVM",81,17,2112,2094,18,1800,1401,399,0.923162146704866,0.624338624338624,1.75345669268321,713,343,370,6,1.1,46.01,3.5,0,0,0,0,0,0,0.0336783507139334,27.0417414044028,3.8208325787773
8.7,"max_tuv_SVM","SVM",81,18,2012,1999,13,1900,1496,404,0.923436129152024,0.608465608465608,1.75345669268321,728,349,379,15,1.1,48.57,3.7,0,0,0,0,0,0,0.0303091654125633,25.8933167846275,3.94781187946684
8.7,"max_tuv_SVM","SVM",81,19,1912,1903,9,2000,1592,408,0.922991469114834,0.603174603174603,1.75507278180089,739,355,384,11,1.1,51.12,3.9,0,0,0,0,0,0,0.0271786204890426,24.4043151714352,3.10022626920644
8.7,"max_tuv_SVM","SVM",81,20,1812,1803,9,2100,1692,408,0.922961525677987,0.608465608465608,1.75507278180089,738,355,383,-1,1.1,53.68,4.1,0,0,0,0,0,0,0.0195598743913114,18.6100021465133,2.20042324681207
8.7,"max_tuv_SVM","SVM",81,21,1712,1704,8,2200,1791,409,0.923237005296987,0.608465608465608,1.75184357705057,743,358,385,5,1.1,56.24,4.4,0,0,0,0,0,0,0.0178920905931821,15.4499653416325,1.80572075261365
8.7,"max_tuv_SVM","SVM",81,22,1612,1604,8,2300,1891,409,0.924018528998715,0.608465608465608,1.76925770308123,762,374,388,19,1,58.79,4.6,0,0,0,0,0,0,0.012309346638787,7.51147272986983,1.59489490785386
8.7,"max_tuv_SVM","SVM",81,23,1512,1507,5,2400,1988,412,0.924377850240888,0.608465608465608,1.77088535506199,769,378,391,7,1,61.35,4.8,0,0,0,0,0,0,0.00878939985117902,6.54609827272645,1.07298270036205
8.7,"max_tuv_SVM","SVM",81,24,1412,1407,5,2500,2088,412,0.924374855897204,0.613756613756614,1.77414965986395,766,377,389,-3,1,63.91,5.1,0,0,0,0,0,0,0.00723685038634244,5.52743335677829,0.778880931648451
8.7,"max_tuv_SVM","SVM",81,25,1312,1307,5,2600,2188,412,0.92449762398828,0.608465608465608,1.77088535506199,777,381,396,11,1,66.46,5.3,0,0,0,0,0,0,0.00560166766592023,4.00655885055616,0.600015116595654
8.7,"max_tuv_SVM","SVM",81,26,1212,1207,5,2700,2288,412,0.924788075325704,0.608465608465608,1.76763304036031,778,381,397,1,1,69.02,5.6,0,0,0,0,0,0,0.00474145717581191,3.04557823045666,0.49134602904322
8.7,"max_tuv_SVM","SVM",81,27,1112,1107,5,2800,2388,412,0.924455703176693,0.613756613756614,1.77088535506199,785,384,401,7,1,71.57,5.8,0,0,0,0,0,0,0.00417983640439275,2.42510331148282,0.436749123308784
8.7,"max_tuv_SVM","SVM",81,28,1012,1007,5,2900,2488,412,0.924356889835095,0.608465608465608,1.77088535506199,787,384,403,2,1,74.13,6,0,0,0,0,0,0,0.00403846143540321,2.08928320538124,0.417782243427808
8.7,"max_tuv_SVM","SVM",81,29,912,907,5,3000,2588,412,0.924217652853753,0.613756613756614,1.76925770308123,788,385,403,1,1,76.69,6.3,0,0,0,0,0,0,0.00334041219137599,1.52177348087775,0.355463476176698
8.7,"max_tuv_SVM","SVM",81,30,812,809,3,3100,2686,414,0.924484149441698,0.608465608465608,1.7725160045602,796,390,406,8,1,79.24,6.5,0,0,0,0,0,0,0.00316530979845034,1.33142053347702,0.34357633881292
8.7,"max_tuv_SVM","SVM",81,31,712,709,3,3200,2786,414,0.92425358497797,0.608465608465608,1.76925770308123,794,390,404,-2,1,81.8,6.7,0,0,0,0,0,0,0.00253883138850239,0.929013086854039,0.276528924629803
8.7,"max_tuv_SVM","SVM",81,32,612,609,3,3300,2886,414,0.924264065180867,0.608465608465608,1.7725160045602,792,390,402,-2,1,84.36,7,0,0,0,0,0,0,0.00216437619873859,0.696160520882758,0.241819081789864
8.7,"max_tuv_SVM","SVM",81,33,512,510,2,3400,2985,415,0.924431748427215,0.608465608465608,1.77088535506199,796,391,405,4,1,86.91,7.2,0,0,0,0,0,0,0.00150900056009626,0.452882419000273,0.184770982926902
8.7,"max_tuv_SVM","SVM",81,34,412,410,2,3500,3085,415,0.924479657926171,0.608465608465608,1.7725160045602,797,392,405,1,1,89.47,7.4,0,0,0,0,0,0,0.000854455501215876,0.245617559394297,0.111141586370933
8.7,"max_tuv_SVM","SVM",81,35,312,312,0,3600,3183,417,0.924371861553519,0.603174603174603,1.77088535506199,806,396,410,9,1,92.02,7.6,0,0,0,0,0,0,0.00108635781506434,0.269791565332487,0.136601889058626
8.7,"max_tuv_SVM","SVM",81,36,212,212,0,3700,3283,417,0.924683273296736,0.603174603174603,1.77387863180714,811,398,413,5,1,94.58,7.9,0,0,0,0,0,0,0.000666163710927423,0.135460577393923,0.0840024996161183
8.7,"max_tuv_SVM","SVM",81,37,112,112,0,3800,3383,417,0.924886888667302,0.608465608465608,1.78368809889547,819,400,419,8,1,97.14,8.1,0,0,0,0,0,0,0.000301119039802341,0.0486695874919496,0.0454268444347573
8.7,"max_tuv_SVM","SVM",81,38,12,12,0,3900,3483,417,0.925114458787345,0.608465608465608,1.78368809889547,821,401,420,2,1,99.69,8.4,0,0,0,0,0,0,0.000211977342677939,0.00316896246099145,0.00316896246099145
8.7,"max_tuv_SVM","SVM",81,39,0,0,0,3912,3495,417,0.925210277785258,0.608465608465608,1.78368809889547,821,401,420,0,1,100,8.4,0,0,0,0,0,0,0,0,0
8.7,"max_tuv_SVM","SVM",82,0,3812,3424,388,100,93,7,0.88525916973343,0.502369668246445,1.73655555990756,25,7,18,0,2.6,2.56,13.3,0,0,0,0,0,0,0.449898647076956,316.467650285841,56.9392007629919
8.7,"max_tuv_SVM","SVM",82,1,3712,3385,327,200,132,68,0.926703241488886,0.601895734597156,1.79256892985258,99,49,50,74,1,5.11,1.9,0,0,0,0,0,0,0.694563980160001,353.389413342665,80.0402713847294
8.7,"max_tuv_SVM","SVM",82,2,3612,3322,290,300,195,105,0.925696981219189,0.635071090047393,1.77911819617981,188,93,95,89,1,7.67,1.9,0,0,0,0,0,0,0.62145265113866,330.266323033732,71.9662691713435
8.7,"max_tuv_SVM","SVM",82,3,3512,3258,254,400,259,141,0.868822227352355,0.62085308056872,1.65386800102332,273,134,139,85,1,10.22,1.8,0,0,0,0,0,0,0.581847936387196,333.106334709865,75.3670101482798
8.7,"max_tuv_SVM","SVM",82,4,3412,3192,220,500,325,175,0.877980417985037,0.654028436018957,1.61738017834528,338,163,175,65,1.1,12.78,1.9,0,0,0,0,0,0,0.334852061046098,222.23227822489,73.3187904562694
8.7,"max_tuv_SVM","SVM",82,5,3312,3148,164,600,369,231,0.881902252882295,0.677725118483412,1.60182603847226,405,199,206,67,1,15.34,1.6,0,0,0,0,0,0,0.143825173432935,138.987575551733,54.1563552277596
8.7,"max_tuv_SVM","SVM",82,6,3212,3090,122,700,427,273,0.875723461752598,0.682464454976303,1.57063182425179,467,227,240,62,1.1,17.89,1.6,0,0,0,0,0,0,0.100183988986226,140.157736365834,35.4662814936325
8.7,"max_tuv_SVM","SVM",82,7,3112,3015,97,800,502,298,0.88257580901424,0.706161137440758,1.56343369490141,527,253,274,60,1.1,20.45,1.7,0,0,0,0,0,0,0.0855630303248004,149.047942353477,30.2582902240199
8.7,"max_tuv_SVM","SVM",82,8,3012,2930,82,900,587,313,0.888216841619249,0.706161137440758,1.6062550505602,545,263,282,18,1.1,23.01,1.9,0,0,0,0,0,0,0.0656075866352324,119.689691023912,22.1643128502843
8.7,"max_tuv_SVM","SVM",82,9,2912,2842,70,1000,675,325,0.909230163364514,0.710900473933649,1.64594060787332,570,276,294,25,1.1,25.56,2.1,0,0,0,0,0,0,0.0702254222192792,119.627705613066,21.0635756932679
8.7,"max_tuv_SVM","SVM",82,10,2812,2760,52,1100,757,343,0.915229701652654,0.701421800947867,1.66146849735155,615,294,321,45,1.1,28.12,2.2,0,0,0,0,0,0,0.0655191210864264,106.9249917228,15.5420117303638
8.7,"max_tuv_SVM","SVM",82,11,2712,2668,44,1200,849,351,0.925398226483252,0.691943127962085,1.68702955115696,643,308,335,28,1.1,30.67,2.4,0,0,0,0,0,0,0.0701364308146684,99.062908845649,15.8060968944038
8.7,"max_tuv_SVM","SVM",82,12,2612,2572,40,1300,945,355,0.930563967462896,0.691943127962085,1.73815165876777,653,314,339,10,1.1,33.23,2.7,0,0,0,0,0,0,0.0599410493494475,77.8087922059832,14.3788571722369
8.7,"max_tuv_SVM","SVM",82,13,2512,2475,37,1400,1042,358,0.93583834652833,0.691943127962085,1.75358061441646,662,317,345,9,1.1,35.79,2.9,0,0,0,0,0,0,0.0600368554481146,70.0157222996748,14.4377327917086
8.7,"max_tuv_SVM","SVM",82,14,2412,2377,35,1500,1140,360,0.936286478632242,0.691943127962085,1.7600454277415,670,320,350,8,1.1,38.34,3.2,0,0,0,0,0,0,0.0521274720590333,61.5450775059095,13.8518639678533
8.7,"max_tuv_SVM","SVM",82,15,2312,2282,30,1600,1235,365,0.936354377435864,0.691943127962085,1.7600454277415,680,326,354,10,1.1,40.9,3.4,0,0,0,0,0,0,0.0436860279529311,55.2209676071278,12.3894826430704
8.7,"max_tuv_SVM","SVM",82,16,2212,2185,27,1700,1332,368,0.936650416219661,0.691943127962085,1.7600454277415,687,327,360,7,1.1,43.46,3.6,0,0,0,0,0,0,0.0341449865249971,44.443646122043,9.27977924661757
8.7,"max_tuv_SVM","SVM",82,17,2112,2093,19,1800,1424,376,0.937065956897837,0.691943127962085,1.7600454277415,698,332,366,11,1.1,46.01,3.8,0,0,0,0,0,0,0.02965214506874,33.8375004008136,4.16120965402762
8.7,"max_tuv_SVM","SVM",82,18,2012,1993,19,1900,1524,376,0.937139287605751,0.687203791469194,1.7600454277415,698,332,366,0,1.1,48.57,4.1,0,0,0,0,0,0,0.026210924312352,27.9057651385174,3.60716142636287
8.7,"max_tuv_SVM","SVM",82,19,1912,1895,17,2000,1622,378,0.939906842841418,0.687203791469194,1.78567715727171,717,343,374,19,1.1,51.12,4.3,0,0,0,0,0,0,0.0197012305669352,14.9523977057599,2.44959220476759
8.7,"max_tuv_SVM","SVM",82,20,1812,1799,13,2100,1718,382,0.939901410937126,0.691943127962085,1.77713324742831,726,349,377,9,1.1,53.68,4.5,0,0,0,0,0,0,0.0158708296462473,13.7375025625342,1.85238116303258
8.7,"max_tuv_SVM","SVM",82,21,1712,1701,11,2200,1816,384,0.939241434565908,0.687203791469194,1.77713324742831,728,350,378,2,1.1,56.24,4.7,0,0,0,0,0,0,0.0148230536933459,13.3315701647259,1.53447087870194
8.7,"max_tuv_SVM","SVM",82,22,1612,1601,11,2300,1916,384,0.941148032971638,0.677725118483412,1.79091983240102,745,361,384,17,1.1,58.79,5,0,0,0,0,0,0,0.0108148393501848,8.54920793899443,1.28127803114183
8.7,"max_tuv_SVM","SVM",82,23,1512,1503,9,2400,2014,386,0.941211857847043,0.677725118483412,1.79256892985258,747,362,385,2,1.1,61.35,5.2,0,0,0,0,0,0,0.00907079763932697,7.06381635491986,0.944693801557059
8.7,"max_tuv_SVM","SVM",82,24,1412,1404,8,2500,2113,387,0.941748258395669,0.672985781990521,1.79091983240102,755,367,388,8,1.1,63.91,5.5,0,0,0,0,0,0,0.00854891362813826,6.14457962070988,0.908871267550921
8.7,"max_tuv_SVM","SVM",82,25,1312,1304,8,2600,2213,387,0.942038865275177,0.672985781990521,1.78763072343426,756,368,388,1,1.1,66.46,5.7,0,0,0,0,0,0,0.00698255469238876,4.42881083826352,0.722229765737311
8.7,"max_tuv_SVM","SVM",82,26,1212,1204,8,2700,2313,387,0.942549464278422,0.672985781990521,1.79091983240102,766,372,394,10,1.1,69.02,6,0,0,0,0,0,0,0.00660985601439204,3.93218325849877,0.699074195410768
8.7,"max_tuv_SVM","SVM",82,27,1112,1105,7,2800,2412,388,0.942792541995393,0.66824644549763,1.78927376637859,769,374,395,3,1.1,71.57,6.2,0,0,0,0,0,0,0.00536936732763701,2.77966761800681,0.561626096303762
8.7,"max_tuv_SVM","SVM",82,28,1012,1006,6,2900,2511,389,0.942865872703307,0.66824644549763,1.78927376637859,771,378,393,2,1,74.13,6.5,0,0,0,0,0,0,0.00495281296053798,2.36900608485787,0.53123728806726
8.7,"max_tuv_SVM","SVM",82,29,912,907,5,3000,2610,390,0.94274093890464,0.66824644549763,1.78599069524762,775,380,395,4,1,76.69,6.7,0,0,0,0,0,0,0.00476246782533588,2.0696728779836,0.507637532448757
8.7,"max_tuv_SVM","SVM",82,30,812,808,4,3100,2709,391,0.942577981775944,0.663507109004739,1.78927376637859,779,381,398,4,1,79.24,6.9,0,0,0,0,0,0,0.00350762780364796,1.40783341424985,0.388865837008816
8.7,"max_tuv_SVM","SVM",82,31,712,708,4,3200,2809,391,0.942821059492915,0.663507109004739,1.79091983240102,781,382,399,2,1,81.8,7.2,0,0,0,0,0,0,0.00275165553390563,0.975085602012419,0.306373680102704
8.7,"max_tuv_SVM","SVM",82,32,612,608,4,3300,2909,391,0.94280747973219,0.663507109004739,1.79091983240102,784,382,402,3,1.1,84.36,7.4,0,0,0,0,0,0,0.00214509731101218,0.677575190255355,0.241956166360089
8.7,"max_tuv_SVM","SVM",82,33,512,509,3,3400,3008,392,0.943122530181004,0.663507109004739,1.78435367352879,786,384,402,2,1,86.91,7.7,0,0,0,0,0,0,0.00164077143265961,0.531847088580363,0.205104979443652
8.7,"max_tuv_SVM","SVM",82,34,412,410,2,3500,3107,393,0.943110308396354,0.663507109004739,1.78271965001823,788,385,403,2,1,89.47,7.9,0,0,0,0,0,0,0.00115610595899126,0.339569973273957,0.142997174906262
8.7,"max_tuv_SVM","SVM",82,35,312,311,1,3600,3206,394,0.943519059194169,0.654028436018957,1.79091983240102,793,387,406,5,1,92.02,8.1,0,0,0,0,0,0,0.0011125284117552,0.2780999587223,0.138319120657497
8.7,"max_tuv_SVM","SVM",82,36,212,212,0,3700,3305,395,0.943418568964807,0.654028436018957,1.79256892985258,801,390,411,8,1.1,94.58,8.4,0,0,0,0,0,0,0.000725507401452431,0.154072087565132,0.0972376788446766
8.7,"max_tuv_SVM","SVM",82,37,112,112,0,3800,3405,395,0.94336424992191,0.654028436018957,1.79091983240102,802,393,409,1,1,97.14,8.6,0,0,0,0,0,0,0.000303236424429217,0.0481690424340171,0.0448244874907446
8.7,"max_tuv_SVM","SVM",82,38,12,12,0,3900,3505,395,0.943445728486258,0.658767772511848,1.79091983240102,805,393,412,3,1,99.69,8.9,0,0,0,0,0,0,0.000190110838364666,0.00262191207335369,0.00262191207335369
8.7,"max_tuv_SVM","SVM",82,39,0,0,0,3912,3517,395,0.943331658496171,0.658767772511848,1.78763072343426,803,393,410,-2,1,100,8.9,0,0,0,0,0,0,0,0,0
8.7,"max_tuv_SVM","SVM",83,0,3812,3431,381,100,86,14,0.899902225722781,0.597156398104265,1.72861883431384,40,14,26,0,1.9,2.56,6.1,0,0,0,0,0,0,0.647296111343801,485.02211371881,70.9880583083066
8.7,"max_tuv_SVM","SVM",83,1,3712,3399,313,200,118,82,0.888989530004468,0.606635071090047,1.71259060496236,111,55,56,71,1,5.11,1.4,0,0,0,0,0,0,0.638850039312465,345.840953996934,77.2170115238234
8.7,"max_tuv_SVM","SVM",83,2,3612,3338,274,300,179,121,0.887210581349566,0.601895734597156,1.69013641957529,205,101,104,94,1,7.67,1.5,0,0,0,0,0,0,0.563119474019579,397.668734140266,68.4116262290485
8.7,"max_tuv_SVM","SVM",83,3,3512,3287,225,400,230,170,0.877040698542888,0.62085308056872,1.6484029174504,294,144,150,89,1,10.22,1.4,0,0,0,0,0,0,0.466531718648889,313.101073231227,74.3630188152756
8.7,"max_tuv_SVM","SVM",83,4,3412,3215,197,500,302,198,0.85887233666943,0.635071090047393,1.60182603847226,360,174,186,66,1.1,12.78,1.5,0,0,0,0,0,0,0.261576258592353,277.864076516891,65.2481502204592
8.7,"max_tuv_SVM","SVM",83,5,3312,3161,151,600,356,244,0.870246744252368,0.672985781990521,1.60477599434422,427,206,221,67,1.1,15.34,1.5,0,0,0,0,0,0,0.157181624104144,220.623183994845,46.8563403227347
8.7,"max_tuv_SVM","SVM",83,6,3212,3102,110,700,415,285,0.855677018970929,0.672985781990521,1.53507414205801,498,239,259,71,1.1,17.89,1.5,0,0,0,0,0,0,0.165390335817359,272.242806333091,38.9963729807144
8.7,"max_tuv_SVM","SVM",83,7,3112,3010,102,800,507,293,0.874652018631444,0.658767772511848,1.58478533593532,531,253,278,33,1.1,20.45,1.7,0,0,0,0,0,0,0.0990708699977799,149.032427799792,32.1496564748801
8.7,"max_tuv_SVM","SVM",83,8,3012,2930,82,900,587,313,0.881266720080392,0.654028436018957,1.60477599434422,551,264,287,20,1.1,23.01,1.9,0,0,0,0,0,0,0.0699103399587204,112.682816116073,21.5927295413785
8.7,"max_tuv_SVM","SVM",83,9,2912,2848,64,1000,669,331,0.896712339928563,0.649289099526066,1.64745620695975,578,280,298,27,1.1,25.56,2,0,0,0,0,0,0,0.0656299866004337,101.614702717081,14.9853600805725
8.7,"max_tuv_SVM","SVM",83,10,2812,2758,54,1100,759,341,0.902771629163899,0.663507109004739,1.64897459977723,593,289,304,15,1.1,28.12,2.2,0,0,0,0,0,0,0.0595986149007428,86.7600390177133,10.7534383764788
8.7,"max_tuv_SVM","SVM",83,11,2712,2664,48,1200,853,347,0.91236708809191,0.658767772511848,1.71259060496236,611,296,315,18,1.1,30.67,2.5,0,0,0,0,0,0,0.0587454404054457,75.3790298806375,9.85327448305504
8.7,"max_tuv_SVM","SVM",83,12,2612,2572,40,1300,945,355,0.922613017558641,0.663507109004739,1.74135267471394,640,305,335,29,1.1,33.23,2.7,0,0,0,0,0,0,0.0608393716746874,70.4225755113699,10.3266661130088
8.7,"max_tuv_SVM","SVM",83,13,2512,2478,34,1400,1039,361,0.926180420700997,0.663507109004739,1.75150151789809,651,312,339,11,1.1,35.79,2.9,0,0,0,0,0,0,0.054230365763432,64.3422182718664,9.63970814290109
8.7,"max_tuv_SVM","SVM",83,14,2412,2385,27,1500,1132,368,0.930729640543745,0.663507109004739,1.74827888401052,662,317,345,11,1.1,38.34,3.1,0,0,0,0,0,0,0.0470930091466186,57.5611578371461,8.17455527524292
8.7,"max_tuv_SVM","SVM",83,15,2312,2288,24,1600,1229,371,0.931380111082454,0.663507109004739,1.74988871723705,673,319,354,11,1.1,40.9,3.3,0,0,0,0,0,0,0.0385226945987071,50.3654174358487,7.03782722861948
8.7,"max_tuv_SVM","SVM",83,16,2212,2191,21,1700,1326,374,0.930881733863859,0.658767772511848,1.75150151789809,683,325,358,10,1.1,43.46,3.5,0,0,0,0,0,0,0.0366837331049316,43.6539819897795,5.59376465667835
8.7,"max_tuv_SVM","SVM",83,17,2112,2094,18,1800,1423,377,0.932424394682172,0.658767772511848,1.76533526336672,718,348,370,35,1.1,46.01,3.8,0,0,0,0,0,0,0.025665312011048,17.619017836696,4.35410416911611
8.7,"max_tuv_SVM","SVM",83,18,2012,1997,15,1900,1520,380,0.932545254552618,0.658767772511848,1.76371271257318,722,351,371,4,1.1,48.57,4,0,0,0,0,0,0,0.0185038867936849,13.3995123726848,2.18836695951343
8.7,"max_tuv_SVM","SVM",83,19,1912,1902,10,2000,1615,385,0.932729939298469,0.654028436018957,1.76696080228326,735,354,381,13,1.1,51.12,4.2,0,0,0,0,0,0,0.0157400886031378,13.3031904594477,1.80089990376955
8.7,"max_tuv_SVM","SVM",83,20,1812,1803,9,2100,1714,386,0.932603647523729,0.654028436018957,1.7685893375849,737,356,381,2,1.1,53.68,4.4,0,0,0,0,0,0,0.0132115222662638,11.8979600152506,1.42755897325579
8.7,"max_tuv_SVM","SVM",83,21,1712,1704,8,2200,1813,387,0.932641670853758,0.654028436018957,1.76209314167091,743,361,382,6,1.1,56.24,4.7,0,0,0,0,0,0,0.0110282590362487,9.27114670788624,1.15970726091507
8.7,"max_tuv_SVM","SVM",83,22,1612,1606,6,2300,1911,389,0.933274487703531,0.644549763033175,1.77713324742831,758,369,389,15,1.1,58.79,4.9,0,0,0,0,0,0,0.00931125827465477,7.45319615924769,1.06582359293678
8.7,"max_tuv_SVM","SVM",83,23,1512,1506,6,2400,2011,389,0.93332880674643,0.644549763033175,1.77713324742831,761,370,391,3,1.1,61.35,5.2,0,0,0,0,0,0,0.00908186998821244,6.57103908358393,0.932835592006518
8.7,"max_tuv_SVM","SVM",83,24,1412,1407,5,2500,2110,390,0.934301117614316,0.644549763033175,1.77713324742831,763,374,389,2,1,63.91,5.4,0,0,0,0,0,0,0.00668654414769364,4.31394143912292,0.712808860890377
8.7,"max_tuv_SVM","SVM",83,25,1312,1307,5,2600,2210,390,0.934265810236433,0.644549763033175,1.77713324742831,763,375,388,0,1,66.46,5.7,0,0,0,0,0,0,0.0063039149249778,3.89382417252469,0.673110893792369
8.7,"max_tuv_SVM","SVM",83,26,1212,1207,5,2700,2310,390,0.934502098073042,0.644549763033175,1.77713324742831,762,376,386,-1,1,69.02,5.9,0,0,0,0,0,0,0.00477872263041033,2.72369060605369,0.513213225373521
8.7,"max_tuv_SVM","SVM",83,27,1112,1108,4,2800,2409,391,0.934531973546637,0.644549763033175,1.77386345304482,772,379,393,10,1,71.57,6.2,0,0,0,0,0,0,0.00466973576818024,2.5121776286024,0.502297341237857
8.7,"max_tuv_SVM","SVM",83,28,1012,1010,2,2900,2507,393,0.934116432868464,0.639810426540284,1.77386345304482,780,381,399,8,1,74.13,6.4,0,0,0,0,0,0,0.00394617866501504,2.03113040198869,0.432446566686454
8.7,"max_tuv_SVM","SVM",83,29,912,911,1,3000,2606,394,0.933986067165509,0.644549763033175,1.77386345304482,783,383,400,3,1,76.69,6.6,0,0,0,0,0,0,0.00367229628666,1.83546475156717,0.400832487127079
8.7,"max_tuv_SVM","SVM",83,30,812,811,1,3100,2706,394,0.933965697524422,0.644549763033175,1.77549684480637,782,383,399,-1,1,79.24,6.9,0,0,0,0,0,0,0.00278168344783389,1.2621620062483,0.302782858114936
8.7,"max_tuv_SVM","SVM",83,31,712,711,1,3200,2806,394,0.933991499069798,0.639810426540284,1.77713324742831,783,383,400,1,1,81.8,7.1,0,0,0,0,0,0,0.00204442994507284,0.829808002047048,0.224547637048064
8.7,"max_tuv_SVM","SVM",83,32,612,611,1,3300,2906,394,0.93388829288829,0.639810426540284,1.77713324742831,782,383,399,-1,1,84.36,7.4,0,0,0,0,0,0,0.0021263747313753,0.792770082231856,0.236143375536995
8.7,"max_tuv_SVM","SVM",83,33,512,511,1,3400,3006,394,0.933882860984,0.639810426540284,1.77713324742831,786,385,401,4,1,86.91,7.6,0,0,0,0,0,0,0.00150876800796377,0.505276751644262,0.174356085554791
8.7,"max_tuv_SVM","SVM",83,34,412,412,0,3500,3105,395,0.933486331970839,0.635071090047393,1.77060566892536,796,387,409,10,1.1,89.47,7.9,0,0,0,0,0,0,0.00116733767607967,0.34319833611561,0.136547062134353
8.7,"max_tuv_SVM","SVM",83,35,312,312,0,3600,3205,395,0.933499911731563,0.639810426540284,1.77386345304482,796,388,408,0,1.1,92.02,8.1,0,0,0,0,0,0,0.000983957860796981,0.246095760059581,0.119757382183072
8.7,"max_tuv_SVM","SVM",83,36,212,212,0,3700,3305,395,0.933452382569027,0.639810426540284,1.77549684480637,797,388,409,1,1.1,94.58,8.4,0,0,0,0,0,0,0.000447963222343527,0.0945819053353292,0.0600258678309333
8.7,"max_tuv_SVM","SVM",83,37,112,112,0,3800,3405,395,0.933554230774461,0.644549763033175,1.77386345304482,800,389,411,3,1.1,97.14,8.6,0,0,0,0,0,0,0.000174198122509859,0.0313205364945034,0.029474075474238
8.7,"max_tuv_SVM","SVM",83,38,12,12,0,3900,3505,395,0.933787802658924,0.644549763033175,1.77713324742831,799,390,409,-1,1,99.69,8.9,0,0,0,0,0,0,0.000161838637442428,0.00216942484344237,0.00216942484344237
8.7,"max_tuv_SVM","SVM",83,39,0,0,0,3912,3517,395,0.933766075041764,0.644549763033175,1.77060566892536,799,390,409,0,1,100,8.9,0,0,0,0,0,0,0,0,0
8.7,"max_tuv_SVM","SVM",84,0,3812,3426,386,100,91,9,0.865696166433548,0.535545023696682,1.66606241946404,22,9,13,0,1.4,2.56,10.1,0,0,0,0,0,0,0.268625030039687,320.279392732882,29.343849054084
8.7,"max_tuv_SVM","SVM",84,1,3712,3384,328,200,133,67,0.900008147856441,0.635071090047393,1.71259060496236,101,50,51,79,1,5.11,2,0,0,0,0,0,0,0.697295958593314,240.175822833034,80.2983560604039
8.7,"max_tuv_SVM","SVM",84,2,3612,3330,282,300,187,113,0.892323361262353,0.611374407582938,1.69243880168703,191,94,97,90,1,7.67,1.7,0,0,0,0,0,0,0.65400547827006,312.139453716708,75.5069846197076
8.7,"max_tuv_SVM","SVM",84,3,3512,3276,236,400,241,159,0.889534078409535,0.62085308056872,1.70878196868107,273,135,138,82,1,10.22,1.5,0,0,0,0,0,0,0.47884226248384,191.033037988824,74.6125988799334
8.7,"max_tuv_SVM","SVM",84,4,3412,3224,188,500,293,207,0.888666331699227,0.630331753554502,1.67850919988849,362,178,184,89,1,12.78,1.4,0,0,0,0,0,0,0.305225382436256,172.618518701904,70.4120143241712
8.7,"max_tuv_SVM","SVM",84,5,3312,3159,153,600,358,242,0.892501256127863,0.639810426540284,1.65235623868234,434,212,222,72,1,15.34,1.5,0,0,0,0,0,0,0.138540410837967,116.722831516525,52.0028064851082
8.7,"max_tuv_SVM","SVM",84,6,3212,3095,117,700,422,278,0.889172856774272,0.658767772511848,1.63892016443665,470,224,246,36,1.1,17.89,1.5,0,0,0,0,0,0,0.0760561187662629,84.4597684942933,31.7634740419645
8.7,"max_tuv_SVM","SVM",84,7,3112,3024,88,800,493,307,0.886655169135924,0.66824644549763,1.63741241819522,505,241,264,35,1.1,20.45,1.6,0,0,0,0,0,0,0.0551538615595848,71.9005287964608,18.37108956588
8.7,"max_tuv_SVM","SVM",84,8,3012,2941,71,900,576,324,0.889811105528317,0.682464454976303,1.64291776010863,545,261,284,40,1.1,23.01,1.8,0,0,0,0,0,0,0.0595554106970759,94.3640025781833,18.7511149940162
8.7,"max_tuv_SVM","SVM",84,9,2912,2849,63,1000,668,332,0.903380002444358,0.677725118483412,1.66452829200597,577,277,300,32,1.1,25.56,2,0,0,0,0,0,0,0.0484794209821517,77.1629996741968,15.8189676353459
8.7,"max_tuv_SVM","SVM",84,10,2812,2759,53,1100,758,342,0.907842311818471,0.687203791469194,1.69710974594192,598,285,313,21,1.1,28.12,2.2,0,0,0,0,0,0,0.0479727521231245,76.0186026050342,10.7544023032347
8.7,"max_tuv_SVM","SVM",84,11,2712,2663,49,1200,854,346,0.921045913171014,0.672985781990521,1.70720850462151,611,295,316,13,1.1,30.67,2.5,0,0,0,0,0,0,0.0381290988580375,53.6973585756676,8.94816901494641
8.7,"max_tuv_SVM","SVM",84,12,2612,2572,40,1300,945,355,0.924347153003152,0.677725118483412,1.71416612529812,623,300,323,12,1.1,33.23,2.7,0,0,0,0,0,0,0.0397987295465088,49.9464259051424,5.53719265303653
8.7,"max_tuv_SVM","SVM",84,13,2512,2476,36,1400,1041,359,0.929075625687473,0.682464454976303,1.73441369821128,645,310,335,22,1.1,35.79,2.9,0,0,0,0,0,0,0.0415456688043403,44.3215390580072,5.62280542389104
8.7,"max_tuv_SVM","SVM",84,14,2412,2378,34,1500,1139,361,0.931283694781296,0.677725118483412,1.74988871723705,659,317,342,14,1.1,38.34,3.2,0,0,0,0,0,0,0.0366516007897072,37.1158262069356,4.98137849981265
8.7,"max_tuv_SVM","SVM",84,15,2312,2280,32,1600,1237,363,0.932251931720968,0.677725118483412,1.74988871723705,663,319,344,4,1.1,40.9,3.4,0,0,0,0,0,0,0.0314905965488713,31.1643538103454,3.4403199244579
8.7,"max_tuv_SVM","SVM",84,16,2212,2184,28,1700,1333,367,0.932128355898373,0.672985781990521,1.74988871723705,674,324,350,11,1.1,43.46,3.6,0,0,0,0,0,0,0.0327581455935069,29.9071385988843,3.95942984821383
8.7,"max_tuv_SVM","SVM",84,17,2112,2095,17,1800,1422,378,0.930474341042111,0.677725118483412,1.73655555990756,707,337,370,33,1.1,46.01,3.8,0,0,0,0,0,0,0.0376602180726661,31.1613046617066,5.08000844769448
8.7,"max_tuv_SVM","SVM",84,18,2012,2002,10,1900,1515,385,0.929711158489386,0.672985781990521,1.73815165876777,728,343,385,21,1.1,48.57,3.9,0,0,0,0,0,0,0.0275594149892898,25.3656498006067,3.34288438818862
8.7,"max_tuv_SVM","SVM",84,19,1912,1902,10,2000,1615,385,0.929849672048779,0.672985781990521,1.74135267471394,730,343,387,2,1.1,51.12,4.2,0,0,0,0,0,0,0.021289717251273,20.8256187987675,2.36005460776131
8.7,"max_tuv_SVM","SVM",84,20,1812,1802,10,2100,1715,385,0.93001534512962,0.66824644549763,1.73975069433242,733,348,385,3,1.1,53.68,4.5,0,0,0,0,0,0,0.0205198555002058,18.6544755057866,2.08842649546281
8.7,"max_tuv_SVM","SVM",84,21,1712,1702,10,2200,1815,385,0.931039259088265,0.658767772511848,1.75358061441646,747,361,386,14,1.1,56.24,4.7,0,0,0,0,0,0,0.0120216338953356,7.98910234188167,1.68098514104331
8.7,"max_tuv_SVM","SVM",84,22,1612,1604,8,2300,1913,387,0.930783959586641,0.654028436018957,1.75358061441646,753,363,390,6,1.1,58.79,4.9,0,0,0,0,0,0,0.00826917141164684,6.41148813611876,0.994294047082579
8.7,"max_tuv_SVM","SVM",84,23,1512,1507,5,2400,2010,390,0.930764947921628,0.654028436018957,1.7600454277415,759,367,392,6,1.1,61.35,5.2,0,0,0,0,0,0,0.00862997002018045,6.34139841609121,0.888609864273873
8.7,"max_tuv_SVM","SVM",84,24,1412,1407,5,2500,2110,390,0.930527302108947,0.644549763033175,1.75842475976015,773,374,399,14,1.1,63.91,5.4,0,0,0,0,0,0,0.00649509533271795,4.22141309830063,0.794384928545479
8.7,"max_tuv_SVM","SVM",84,25,1312,1309,3,2600,2208,392,0.930830130773105,0.649289099526066,1.75680707368862,782,376,406,9,1.1,66.46,5.6,0,0,0,0,0,0,0.00588697151673687,4.03560308671624,0.654710683721018
8.7,"max_tuv_SVM","SVM",84,26,1212,1209,3,2700,2308,392,0.930786675538785,0.649289099526066,1.75680707368862,782,376,406,0,1.1,69.02,5.9,0,0,0,0,0,0,0.00533469773916064,3.23151049837849,0.546431755101776
8.7,"max_tuv_SVM","SVM",84,27,1112,1109,3,2800,2408,392,0.931723679028768,0.649289099526066,1.75519236130471,791,384,407,9,1.1,71.57,6.1,0,0,0,0,0,0,0.00354649414848188,1.95408258352297,0.393690711375869
8.7,"max_tuv_SVM","SVM",84,28,1012,1009,3,2900,2508,392,0.93189614198997,0.649289099526066,1.75519236130471,792,384,408,1,1.1,74.13,6.4,0,0,0,0,0,0,0.00327954500722227,1.52246351099429,0.337466975565298
8.7,"max_tuv_SVM","SVM",84,29,912,909,3,3000,2608,392,0.932152799467671,0.639810426540284,1.75842475976015,794,384,410,2,1.1,76.69,6.7,0,0,0,0,0,0,0.00234824895729831,0.984751484205549,0.261558629765078
8.7,"max_tuv_SVM","SVM",84,30,812,810,2,3100,2707,393,0.932505873246512,0.644549763033175,1.7600454277415,796,385,411,2,1.1,79.24,6.9,0,0,0,0,0,0,0.00204611676561885,0.730303899628109,0.223264397620217
8.7,"max_tuv_SVM","SVM",84,31,712,711,1,3200,2806,394,0.933178071402386,0.644549763033175,1.75842475976015,797,389,408,1,1,81.8,7.1,0,0,0,0,0,0,0.00165622429840378,0.52751528915186,0.185585066764969
8.7,"max_tuv_SVM","SVM",84,32,612,611,1,3300,2906,394,0.933445592688664,0.644549763033175,1.75842475976015,799,389,410,2,1.1,84.36,7.4,0,0,0,0,0,0,0.00132292355980319,0.393938809799979,0.1574019945513
8.7,"max_tuv_SVM","SVM",84,33,512,511,1,3400,3006,394,0.933518923396579,0.644549763033175,1.75680707368862,800,389,411,1,1.1,86.91,7.6,0,0,0,0,0,0,0.00076104535508624,0.21895483083938,0.101133037475044
8.7,"max_tuv_SVM","SVM",84,34,412,412,0,3500,3105,395,0.933994215021946,0.644549763033175,1.75842475976015,804,391,413,4,1.1,89.47,7.9,0,0,0,0,0,0,0.000477300308150982,0.137399823694257,0.0637959986465679
8.7,"max_tuv_SVM","SVM",84,35,312,312,0,3600,3205,395,0.934545553307367,0.644549763033175,1.7600454277415,805,391,414,1,1.1,92.02,8.1,0,0,0,0,0,0,0.000368713326887827,0.0947317489912788,0.0493050768412667
8.7,"max_tuv_SVM","SVM",84,36,212,212,0,3700,3305,395,0.934398891891541,0.639810426540284,1.75842475976015,809,393,416,4,1.1,94.58,8.4,0,0,0,0,0,0,0.000126794524533589,0.0270156261673303,0.0174783701448143
8.7,"max_tuv_SVM","SVM",84,37,112,112,0,3800,3405,395,0.934700362579626,0.635071090047393,1.75519236130471,810,394,416,1,1.1,97.14,8.6,0,0,0,0,0,0,4.11382780250104e-05,0.00739557882582239,0.00700114200952739
8.7,"max_tuv_SVM","SVM",84,38,12,12,0,3900,3505,395,0.935053436358467,0.635071090047393,1.7685893375849,810,395,415,0,1.1,99.69,8.9,0,0,0,0,0,0,2.00062946819329e-05,0.000305748224959315,0.000305748224959315
8.7,"max_tuv_SVM","SVM",84,39,0,0,0,3912,3517,395,0.93514306277925,0.635071090047393,1.7685893375849,810,395,415,0,1.1,100,8.9,0,0,0,0,0,0,0,0,0
8.7,"max_tuv_SVM","SVM",85,0,3812,3423,389,100,94,6,0.837156941294698,0.5260663507109,1.6062550505602,24,6,18,0,3,2.56,15.7,0,0,0,0,0,0,0.142352373328418,265.230780220632,15.2939880778356
8.7,"max_tuv_SVM","SVM",85,1,3712,3385,327,200,132,68,0.896495063756969,0.582938388625592,1.67696786912642,81,42,39,57,0.9,5.11,1.9,0,0,0,0,0,0,0.686044835975415,262.225182763181,79.5678817543043
8.7,"max_tuv_SVM","SVM",85,2,3612,3330,282,300,187,113,0.883512812504251,0.592417061611374,1.69169414899426,166,80,86,85,1.1,7.67,1.7,0,0,0,0,0,0,0.658666308528603,267.413482163626,75.7059267459845
8.7,"max_tuv_SVM","SVM",85,3,3512,3276,236,400,241,159,0.886455546653268,0.616113744075829,1.69243880168703,252,125,127,86,1,10.22,1.5,0,0,0,0,0,0,0.586249766229195,226.621070860921,73.0720855482807
8.7,"max_tuv_SVM","SVM",85,4,3412,3227,185,500,290,210,0.888762748000364,0.606635071090047,1.70563793562002,340,167,173,88,1,12.78,1.4,0,0,0,0,0,0,0.343278116159456,183.811502633632,65.9836663451456
8.7,"max_tuv_SVM","SVM",85,5,3312,3160,152,600,357,243,0.897578728662798,0.625592417061611,1.68702955115696,407,199,208,67,1,15.34,1.5,0,0,0,0,0,0,0.145972386769129,115.607236405245,49.5974015482905
8.7,"max_tuv_SVM","SVM",85,6,3212,3106,106,700,411,289,0.883550835834273,0.649289099526066,1.62334287024701,471,228,243,64,1.1,17.89,1.4,0,0,0,0,0,0,0.0893019271741732,91.266084857469,26.4197139898616
8.7,"max_tuv_SVM","SVM",85,7,3112,3029,83,800,488,312,0.881541031247034,0.66824644549763,1.58892446166611,519,246,273,48,1.1,20.45,1.6,0,0,0,0,0,0,0.083295361812761,119.888717524754,21.3615007134722
8.7,"max_tuv_SVM","SVM",85,8,3012,2951,61,900,566,334,0.889535436385603,0.658767772511848,1.63038412191354,555,266,289,36,1.1,23.01,1.7,0,0,0,0,0,0,0.0638743321345426,103.04857114293,10.9529348808274
8.7,"max_tuv_SVM","SVM",85,9,2912,2858,54,1000,659,341,0.894303290376032,0.663507109004739,1.63741241819522,573,276,297,18,1.1,25.56,1.9,0,0,0,0,0,0,0.0638125727933005,104.271974067106,10.7294967344982
8.7,"max_tuv_SVM","SVM",85,10,2812,2762,50,1100,755,345,0.903735792175333,0.654028436018957,1.66606241946404,592,286,306,19,1.1,28.12,2.2,0,0,0,0,0,0,0.0474227101155939,64.6575413150489,7.34631080520234
8.7,"max_tuv_SVM","SVM",85,11,2712,2672,40,1200,845,355,0.909906435448606,0.654028436018957,1.69169414899426,614,298,316,22,1.1,30.67,2.4,0,0,0,0,0,0,0.0506108893163645,72.5857579419855,5.84163063134637
8.7,"max_tuv_SVM","SVM",85,12,2612,2580,32,1300,937,363,0.917902198563265,0.649289099526066,1.70250545088977,646,313,333,32,1.1,33.23,2.6,0,0,0,0,0,0,0.0608725847612553,65.4980990222946,6.99685064537834
8.7,"max_tuv_SVM","SVM",85,13,2512,2485,27,1400,1032,368,0.919433995572993,0.649289099526066,1.70023805883766,662,320,342,16,1.1,35.79,2.8,0,0,0,0,0,0,0.0489612240655916,49.5456738308257,5.56429542799245
8.7,"max_tuv_SVM","SVM",85,14,2412,2388,24,1500,1129,371,0.920944064965567,0.654028436018957,1.70094351928345,671,324,347,9,1.1,38.34,3,0,0,0,0,0,0,0.0478666910962392,46.1329825127888,5.37795840412662
8.7,"max_tuv_SVM","SVM",85,15,2312,2292,20,1600,1225,375,0.919814228873283,0.654028436018957,1.71574454714462,684,330,354,13,1.1,40.9,3.3,0,0,0,0,0,0,0.0425998986152202,37.2446841576921,5.17952240175794
8.7,"max_tuv_SVM","SVM",85,16,2212,2199,13,1700,1318,382,0.918790314914639,0.649289099526066,1.71101797814422,708,337,371,24,1.1,43.46,3.5,0,0,0,0,0,0,0.0373251882775247,33.8846562671972,4.60591275274112
8.7,"max_tuv_SVM","SVM",85,17,2112,2103,9,1800,1414,386,0.917718871793461,0.654028436018957,1.70720850462151,716,339,377,8,1.1,46.01,3.7,0,0,0,0,0,0,0.0347310275796898,32.4928321723075,3.87615806410868
8.7,"max_tuv_SVM","SVM",85,18,2012,2004,8,1900,1513,387,0.918225396868495,0.654028436018957,1.71416612529812,717,341,376,1,1.1,48.57,3.9,0,0,0,0,0,0,0.02794436855694,26.1595526213821,3.02214079836219
8.7,"max_tuv_SVM","SVM",85,19,1912,1906,6,2000,1611,389,0.918706120398145,0.649289099526066,1.71101797814422,729,345,384,12,1.1,51.12,4.1,0,0,0,0,0,0,0.0219912153593055,21.1488769872984,2.4105556193796
8.7,"max_tuv_SVM","SVM",85,20,1812,1806,6,2100,1711,389,0.918748217656395,0.649289099526066,1.71574454714462,731,348,383,2,1.1,53.68,4.4,0,0,0,0,0,0,0.0183211566198321,17.4869311264458,1.97381274385542
8.7,"max_tuv_SVM","SVM",85,21,1712,1707,5,2200,1810,390,0.920129279322084,0.649289099526066,1.72586978836788,738,353,385,7,1.1,56.24,4.6,0,0,0,0,0,0,0.0167101445529163,14.7522071288716,1.72951572926034
8.7,"max_tuv_SVM","SVM",85,22,1612,1607,5,2300,1910,390,0.92061000285175,0.635071090047393,1.73975069433242,755,366,389,17,1.1,58.79,4.9,0,0,0,0,0,0,0.011345093904184,7.77726284154732,1.50112017114109
8.7,"max_tuv_SVM","SVM",85,23,1512,1509,3,2400,2008,392,0.921090726381402,0.639810426540284,1.74506808716201,755,367,388,0,1.1,61.35,5.1,0,0,0,0,0,0,0.00757244757412384,5.85141912385234,0.87973312071416
8.7,"max_tuv_SVM","SVM",85,24,1412,1409,3,2500,2108,392,0.921077146620678,0.639810426540284,1.74827888401052,756,367,389,1,1.1,63.91,5.4,0,0,0,0,0,0,0.00737080114449499,5.46220099234176,0.771683124509498
8.7,"max_tuv_SVM","SVM",85,25,1312,1309,3,2600,2208,392,0.921704531566162,0.639810426540284,1.74827888401052,760,370,390,4,1.1,66.46,5.6,0,0,0,0,0,0,0.0054986004712454,3.81532821235166,0.609112667703404
8.7,"max_tuv_SVM","SVM",85,26,1212,1209,3,2700,2308,392,0.921705889542236,0.639810426540284,1.74988871723705,761,370,391,1,1.1,69.02,5.9,0,0,0,0,0,0,0.0048052245478856,2.86099416380656,0.486455040222989
8.7,"max_tuv_SVM","SVM",85,27,1112,1109,3,2800,2408,392,0.922638819104017,0.644549763033175,1.75150151789809,769,376,393,8,1,71.57,6.1,0,0,0,0,0,0,0.00284963663484567,1.56167037375378,0.338121858822661
8.7,"max_tuv_SVM","SVM",85,28,1012,1010,2,2900,2507,393,0.922957943481045,0.639810426540284,1.74988871723705,775,378,397,6,1.1,74.13,6.4,0,0,0,0,0,0,0.00306827541176594,1.45933990052619,0.315646133344399
8.7,"max_tuv_SVM","SVM",85,29,912,910,2,3000,2607,393,0.924271106343104,0.639810426540284,1.74827888401052,774,380,394,-1,1,76.69,6.6,0,0,0,0,0,0,0.00265666181884528,1.10254785399221,0.285726782934741
8.7,"max_tuv_SVM","SVM",85,30,812,810,2,3100,2707,393,0.925016635206889,0.639810426540284,1.74667201003624,779,380,399,5,1.1,79.24,6.9,0,0,0,0,0,0,0.00191831282879704,0.65374018949045,0.204644703636284
8.7,"max_tuv_SVM","SVM",85,31,712,710,2,3200,2807,393,0.925536740042645,0.639810426540284,1.74827888401052,779,382,397,0,1,81.8,7.1,0,0,0,0,0,0,0.0015813879553019,0.484725734471022,0.182240934461728
8.7,"max_tuv_SVM","SVM",85,32,612,610,2,3300,2907,393,0.925675253602035,0.639810426540284,1.74827888401052,781,383,398,2,1,84.36,7.4,0,0,0,0,0,0,0.00104437069653095,0.309433989084084,0.13649497408017
8.7,"max_tuv_SVM","SVM",85,33,512,510,2,3400,3007,393,0.926012031668005,0.639810426540284,1.74827888401052,783,383,400,2,1,86.91,7.7,0,0,0,0,0,0,0.000517393068820855,0.153524542527351,0.0717874655066596
8.7,"max_tuv_SVM","SVM",85,34,412,411,1,3500,3106,394,0.9268159535029,0.639810426540284,1.74988871723705,787,386,401,4,1,89.47,7.9,0,0,0,0,0,0,0.000392054135766544,0.11339250816942,0.050651901175876
8.7,"max_tuv_SVM","SVM",85,35,312,312,0,3600,3205,395,0.928216026833601,0.644549763033175,1.74346710726553,794,389,405,7,1,92.02,8.1,0,0,0,0,0,0,0.000300444724659902,0.0768602222164613,0.0382764279204008
8.7,"max_tuv_SVM","SVM",85,36,212,212,0,3700,3305,395,0.928977851410247,0.644549763033175,1.74506808716201,797,390,407,3,1,94.58,8.4,0,0,0,0,0,0,0.000183239695267764,0.0367882837849164,0.023246517402274
8.7,"max_tuv_SVM","SVM",85,37,112,112,0,3800,3405,395,0.929199201510055,0.644549763033175,1.74667201003624,802,391,411,5,1.1,97.14,8.6,0,0,0,0,0,0,5.93632249368402e-05,0.0103019690626944,0.00969899009424439
8.7,"max_tuv_SVM","SVM",85,38,12,12,0,3900,3505,395,0.929325493284793,0.644549763033175,1.74667201003624,801,391,410,-1,1,99.69,8.9,0,0,0,0,0,0,4.95534444345765e-05,0.000716716698391467,0.000716716698391467
8.7,"max_tuv_SVM","SVM",85,39,0,0,0,3912,3517,395,0.929442279227024,0.644549763033175,1.75150151789809,801,391,410,0,1,100,8.9,0,0,0,0,0,0,0,0,0
8.7,"max_tuv_SVM","SVM",86,0,3812,3427,385,100,91,9,0.883511662627633,0.5,1.75174332666725,26,9,17,0,1.9,2.56,10.1,0,0,0,0,0,0,0.266667281617535,321.762884933825,31.4692749305106
8.7,"max_tuv_SVM","SVM",86,1,3712,3380,332,200,138,62,0.909315767266749,0.537735849056604,1.75539331298557,93,46,47,67,1,5.11,2.2,0,0,0,0,0,0,0.768104054758585,360.711802943141,84.4123994971346
8.7,"max_tuv_SVM","SVM",86,2,3612,3315,297,300,203,97,0.922781071490362,0.594339622641509,1.76225375539269,170,83,87,77,1,7.67,2.1,0,0,0,0,0,0,0.566235654432597,221.855525386176,72.6430514039907
8.7,"max_tuv_SVM","SVM",86,3,3512,3273,239,400,245,155,0.92029275575556,0.584905660377358,1.74323971828537,263,128,135,93,1.1,10.22,1.6,0,0,0,0,0,0,0.404088578995513,177.040844079305,72.9753779676827
8.7,"max_tuv_SVM","SVM",86,4,3412,3220,192,500,298,202,0.909057469274707,0.60377358490566,1.73154432313274,329,161,168,66,1,12.78,1.5,0,0,0,0,0,0,0.179677255022575,144.737025873965,56.8512387398866
8.7,"max_tuv_SVM","SVM",86,5,3312,3169,143,600,349,251,0.89698372857884,0.627358490566038,1.69759247365954,404,198,206,75,1,15.34,1.4,0,0,0,0,0,0,0.194123482634818,154.569708528853,45.6300341784091
8.7,"max_tuv_SVM","SVM",86,6,3212,3087,125,700,431,269,0.901400489008128,0.660377358490566,1.67212858655465,435,211,224,31,1.1,17.89,1.6,0,0,0,0,0,0,0.112753398522191,139.697566469877,37.4063710857153
8.7,"max_tuv_SVM","SVM",86,7,3112,3018,94,800,500,300,0.883211441924866,0.655660377358491,1.62418920093905,492,236,256,57,1.1,20.45,1.7,0,0,0,0,0,0,0.108125878574832,167.359675186482,29.4063575202489
8.7,"max_tuv_SVM","SVM",86,8,3012,2932,80,900,586,314,0.89288341699844,0.660377358490566,1.63118940894402,528,249,279,36,1.1,23.01,1.9,0,0,0,0,0,0,0.0755485990914298,122.71464097462,24.0701663821393
8.7,"max_tuv_SVM","SVM",86,9,2912,2851,61,1000,667,333,0.895707114419236,0.660377358490566,1.65667674345877,562,269,293,34,1.1,25.56,2,0,0,0,0,0,0,0.0614239268116487,103.791065521276,16.3203208201967
8.7,"max_tuv_SVM","SVM",86,10,2812,2763,49,1100,755,345,0.913620283018861,0.665094339622642,1.69065985614511,596,291,305,34,1,28.12,2.2,0,0,0,0,0,0,0.0605861293617607,67.7948569865443,12.3405222810985
8.7,"max_tuv_SVM","SVM",86,11,2712,2671,41,1200,847,353,0.916479141422881,0.674528301886792,1.68755202552719,608,296,312,12,1.1,30.67,2.4,0,0,0,0,0,0,0.0467238535833004,54.0390130560611,6.12875379717529
8.7,"max_tuv_SVM","SVM",86,12,2612,2575,37,1300,943,357,0.918686169292019,0.669811320754717,1.70608043602784,624,302,322,16,1.1,33.23,2.6,0,0,0,0,0,0,0.0452839709147361,56.9344062599368,5.8912653802164
8.7,"max_tuv_SVM","SVM",86,13,2512,2477,35,1400,1041,359,0.920536177947032,0.665094339622642,1.70451234739179,632,307,325,8,1.1,35.79,2.9,0,0,0,0,0,0,0.0344235506459356,43.1893470801797,4.65995271689766
8.7,"max_tuv_SVM","SVM",86,14,2412,2380,32,1500,1138,362,0.924462036956901,0.665094339622642,1.71299250832408,638,310,328,6,1.1,38.34,3.1,0,0,0,0,0,0,0.0340177330187598,40.2293508992431,3.8190191284139
8.7,"max_tuv_SVM","SVM",86,15,2312,2283,29,1600,1235,365,0.930283884369052,0.665094339622642,1.74852024786933,654,317,337,16,1.1,40.9,3.4,0,0,0,0,0,0,0.0384879642163738,36.9289772913477,4.37850835051945
8.7,"max_tuv_SVM","SVM",86,16,2212,2187,25,1700,1331,369,0.933760764670248,0.655660377358491,1.77561763786094,671,325,346,17,1.1,43.46,3.6,0,0,0,0,0,0,0.0382109892430211,31.0689739117578,4.34190396539469
8.7,"max_tuv_SVM","SVM",86,17,2112,2090,22,1800,1428,372,0.934706054180373,0.655660377358491,1.79096005971082,680,329,351,9,1.1,46.01,3.8,0,0,0,0,0,0,0.0339528904143818,27.3268163214782,3.9245000129154
8.7,"max_tuv_SVM","SVM",86,18,2012,1996,16,1900,1522,378,0.93499004673706,0.655660377358491,1.79096005971082,696,336,360,16,1.1,48.57,4,0,0,0,0,0,0,0.0338043127614905,26.1348783731283,4.28460651304871
8.7,"max_tuv_SVM","SVM",86,19,1912,1899,13,2000,1619,381,0.934923781807162,0.660377358490566,1.79260919420411,704,339,365,8,1.1,51.12,4.2,0,0,0,0,0,0,0.0235152753965909,21.0652504801301,2.87626653381959
8.7,"max_tuv_SVM","SVM",86,20,1812,1801,11,2100,1717,383,0.934803423056945,0.660377358490566,1.79426136857665,709,342,367,5,1.1,53.68,4.5,0,0,0,0,0,0,0.0200055036316887,17.8247403933041,2.19184504868388
8.7,"max_tuv_SVM","SVM",86,21,1712,1701,11,2200,1817,383,0.934871040332348,0.660377358490566,1.79260919420411,709,343,366,0,1.1,56.24,4.7,0,0,0,0,0,0,0.0166796798068891,13.8897448892576,1.70736348532947
8.7,"max_tuv_SVM","SVM",86,22,1612,1602,10,2300,1916,384,0.935503938030122,0.64622641509434,1.79426136857665,731,352,379,22,1.1,58.79,5,0,0,0,0,0,0,0.0115778265940597,8.38068465397959,1.49782532049127
8.7,"max_tuv_SVM","SVM",86,23,1512,1504,8,2400,2014,386,0.935509347412154,0.641509433962264,1.79426136857665,738,356,382,7,1.1,61.35,5.2,0,0,0,0,0,0,0.00953134969993747,7.22611401410418,1.02859471507325
8.7,"max_tuv_SVM","SVM",86,24,1412,1404,8,2500,2114,386,0.935549917777396,0.641509433962264,1.79096005971082,742,358,384,4,1.1,63.91,5.5,0,0,0,0,0,0,0.00692923630213986,4.91840471921311,0.761702704704543
8.7,"max_tuv_SVM","SVM",86,25,1312,1305,7,2600,2213,387,0.93572031331141,0.641509433962264,1.79449541284404,742,361,381,0,1.1,66.46,5.7,0,0,0,0,0,0,0.00677624282489061,4.11625715888672,0.701112425448376
8.7,"max_tuv_SVM","SVM",86,26,1212,1205,7,2700,2313,387,0.935574259996541,0.64622641509434,1.79944802207912,750,364,386,8,1.1,69.02,6,0,0,0,0,0,0,0.00580691780027817,3.42864126299639,0.66951205029944
8.7,"max_tuv_SVM","SVM",86,27,1112,1106,6,2800,2412,388,0.935470129392421,0.641509433962264,1.79779411764706,752,365,387,2,1.1,71.57,6.2,0,0,0,0,0,0,0.00519238136679307,2.65667689888201,0.537864861840243
8.7,"max_tuv_SVM","SVM",86,28,1012,1006,6,2900,2512,388,0.935275391639262,0.636792452830189,1.79449541284404,756,369,387,4,1,74.13,6.5,0,0,0,0,0,0,0.0042209188429621,1.95125232289687,0.449924838097476
8.7,"max_tuv_SVM","SVM",86,29,912,906,6,3000,2612,388,0.935274039293754,0.636792452830189,1.79285059578368,756,369,387,0,1,76.69,6.7,0,0,0,0,0,0,0.00359932688456455,1.45185430834924,0.384033059795944
8.7,"max_tuv_SVM","SVM",86,30,812,806,6,3100,2712,388,0.935336247187124,0.636792452830189,1.79285059578368,757,369,388,1,1.1,79.24,7,0,0,0,0,0,0,0.00330177668832972,1.1885871667243,0.364797283405658
8.7,"max_tuv_SVM","SVM",86,31,712,708,4,3200,2810,390,0.935141509433965,0.632075471698113,1.79285059578368,763,373,390,6,1,81.8,7.2,0,0,0,0,0,0,0.00249771652434487,0.835621425589476,0.280497933774418
8.7,"max_tuv_SVM","SVM",86,32,612,609,3,3300,2909,391,0.934971113899951,0.636792452830189,1.79944802207912,765,374,391,2,1,84.36,7.4,0,0,0,0,0,0,0.00221713246734911,0.70908204927105,0.257512529183908
8.7,"max_tuv_SVM","SVM",86,33,512,509,3,3400,3009,391,0.934857516877275,0.636792452830189,1.79944802207912,768,375,393,3,1,86.91,7.7,0,0,0,0,0,0,0.00138186100169053,0.406408403199467,0.168333341562039
8.7,"max_tuv_SVM","SVM",86,34,412,410,2,3500,3108,392,0.934566762593044,0.627358490566038,1.80110497237569,774,377,397,6,1.1,89.47,7.9,0,0,0,0,0,0,0.00103738857138842,0.300141160129439,0.135979221786479
8.7,"max_tuv_SVM","SVM",86,35,312,311,1,3600,3207,393,0.934546477410424,0.627358490566038,1.79614325068871,781,381,400,7,1,92.02,8.2,0,0,0,0,0,0,0.00105736981035318,0.271598416502355,0.13563524021131
8.7,"max_tuv_SVM","SVM",86,36,212,212,0,3700,3306,394,0.934400424095554,0.632075471698113,1.79614325068871,788,384,404,7,1.1,94.58,8.4,0,0,0,0,0,0,0.000477804375089968,0.0994184278264505,0.0613829690093261
8.7,"max_tuv_SVM","SVM",86,37,112,112,0,3800,3406,394,0.934247609053145,0.636792452830189,1.79449541284404,790,385,405,2,1.1,97.14,8.6,0,0,0,0,0,0,0.000318654430242081,0.0494328781398924,0.0459355102139137
8.7,"max_tuv_SVM","SVM",86,38,12,12,0,3900,3506,394,0.934261132508225,0.636792452830189,1.79779411764706,793,386,407,3,1.1,99.69,8.9,0,0,0,0,0,0,0.000184569845840231,0.00273412251655441,0.00273412251655441
8.7,"max_tuv_SVM","SVM",86,39,0,0,0,3912,3518,394,0.934171877704694,0.636792452830189,1.79779411764706,794,386,408,1,1.1,100,8.9,0,0,0,0,0,0,0,0,0
8.7,"max_tuv_SVM","SVM",87,0,3812,3420,392,100,95,5,0.896678653494822,0.588516746411483,1.74238528873503,16,5,11,0,2.2,2.56,19,0,0,0,0,0,0,0.128770065758169,195.602620113957,14.091553165633
8.7,"max_tuv_SVM","SVM",87,1,3712,3383,329,200,132,68,0.909556505615902,0.588516746411483,1.73917942803819,91,44,47,75,1.1,5.11,1.9,0,0,0,0,0,0,0.767414760810525,288.670898158523,84.2074842057343
8.7,"max_tuv_SVM","SVM",87,2,3612,3317,295,300,198,102,0.897114123185877,0.598086124401914,1.69613043229467,170,84,86,79,1,7.67,1.9,0,0,0,0,0,0,0.604457139743684,187.218622713727,72.9427394242784
8.7,"max_tuv_SVM","SVM",87,3,3512,3273,239,400,242,158,0.890527301758574,0.617224880382775,1.7063099738296,252,124,128,82,1,10.22,1.5,0,0,0,0,0,0,0.422883027168596,151.178338675396,74.7022192262374
8.7,"max_tuv_SVM","SVM",87,4,3412,3223,189,500,292,208,0.863341942304374,0.626794258373206,1.62128594546946,344,170,174,92,1,12.78,1.4,0,0,0,0,0,0,0.239479843594343,150.897870250121,60.7275557468702
8.7,"max_tuv_SVM","SVM",87,5,3312,3164,148,600,351,249,0.870309457360952,0.631578947368421,1.60142264165893,412,202,210,68,1,15.34,1.4,0,0,0,0,0,0,0.125495444546982,114.713316305356,43.6341119847911
8.7,"max_tuv_SVM","SVM",87,6,3212,3100,112,700,415,285,0.860835937478601,0.631578947368421,1.57414508865747,449,219,230,37,1.1,17.89,1.5,0,0,0,0,0,0,0.0855176944691091,106.296215307745,27.9958459048386
8.7,"max_tuv_SVM","SVM",87,7,3112,3015,97,800,500,300,0.873789106684595,0.645933014354067,1.60289724814296,483,234,249,34,1.1,20.45,1.7,0,0,0,0,0,0,0.0597091545891022,85.5782691338581,22.0049860276935
8.7,"max_tuv_SVM","SVM",87,8,3012,2937,75,900,578,322,0.888037729751341,0.641148325358852,1.61864223995633,519,250,269,36,1.1,23.01,1.8,0,0,0,0,0,0,0.0504704106698725,75.7563355649372,13.1711566829263
8.7,"max_tuv_SVM","SVM",87,9,2912,2850,62,1000,665,335,0.89806448785751,0.636363636363636,1.63025158203426,545,267,278,26,1,25.56,2,0,0,0,0,0,0,0.0510843862174326,82.1166410951194,10.9796647640291
8.7,"max_tuv_SVM","SVM",87,10,2812,2761,51,1100,754,346,0.903676295385379,0.641148325358852,1.64702064301659,579,280,299,34,1.1,28.12,2.2,0,0,0,0,0,0,0.0533519123885231,80.9589645060189,8.60702981620679
8.7,"max_tuv_SVM","SVM",87,11,2712,2665,47,1200,850,350,0.916603445962034,0.636363636363636,1.7102033822347,603,292,311,24,1.1,30.67,2.4,0,0,0,0,0,0,0.0536160260907259,70.7397581785787,8.89753120851244
8.7,"max_tuv_SVM","SVM",87,12,2612,2574,38,1300,941,359,0.923224502427929,0.631578947368421,1.73216315525126,630,305,325,27,1.1,33.23,2.6,0,0,0,0,0,0,0.0454026696425201,56.3908107359728,7.01260129971047
8.7,"max_tuv_SVM","SVM",87,13,2512,2481,31,1400,1034,366,0.929422413816723,0.626794258373206,1.74618280326485,643,312,331,13,1.1,35.79,2.8,0,0,0,0,0,0,0.0484597501134841,54.3576441881505,6.39592637692448
8.7,"max_tuv_SVM","SVM",87,14,2412,2384,28,1500,1131,369,0.932446052426171,0.62200956937799,1.76015100302884,653,318,335,10,1.1,38.34,3.1,0,0,0,0,0,0,0.0490541982709216,47.9994547815023,6.42280029274234
8.7,"max_tuv_SVM","SVM",87,15,2312,2287,25,1600,1228,372,0.933434760341029,0.636363636363636,1.76663406381348,664,321,343,11,1.1,40.9,3.3,0,0,0,0,0,0,0.0388842771693781,37.3614540814473,5.45139325303708
8.7,"max_tuv_SVM","SVM",87,16,2212,2191,21,1700,1324,376,0.934739800012587,0.631578947368421,1.77361862463301,672,324,348,8,1.1,43.46,3.5,0,0,0,0,0,0,0.0325408055811795,31.9393122454727,4.71810570182574
8.7,"max_tuv_SVM","SVM",87,17,2112,2097,15,1800,1418,382,0.935472429838703,0.631578947368421,1.76338657472558,688,330,358,16,1.1,46.01,3.7,0,0,0,0,0,0,0.0258810261439783,27.4450991842787,3.0963567746471
8.7,"max_tuv_SVM","SVM",87,18,2012,1999,13,1900,1516,384,0.935042437753851,0.626794258373206,1.75478468899522,699,332,367,11,1.1,48.57,3.9,0,0,0,0,0,0,0.0221251387418228,24.1467220564963,2.39983328309841
8.7,"max_tuv_SVM","SVM",87,19,1912,1899,13,2000,1616,384,0.935242370379292,0.626794258373206,1.77525179095403,701,333,368,2,1.1,51.12,4.2,0,0,0,0,0,0,0.0192986896953169,19.7088211673029,1.96729768195143
8.7,"max_tuv_SVM","SVM",87,20,1812,1799,13,2100,1716,384,0.9341564349548,0.617224880382775,1.78222842378171,727,347,380,26,1.1,53.68,4.5,0,0,0,0,0,0,0.0140747589810886,10.5901240301382,1.796209128514
8.7,"max_tuv_SVM","SVM",87,21,1712,1702,10,2200,1813,387,0.934211211016563,0.61244019138756,1.78222842378171,735,354,381,8,1.1,56.24,4.7,0,0,0,0,0,0,0.0103939537418038,9.25045944431056,1.22691311952333
8.7,"max_tuv_SVM","SVM",87,22,1612,1603,9,2300,1912,388,0.934715150784807,0.61244019138756,1.7789552769979,743,356,387,8,1.1,58.79,4.9,0,0,0,0,0,0,0.00954127210774631,7.89442999206679,0.97540159293521
8.7,"max_tuv_SVM","SVM",87,23,1512,1503,9,2400,2012,388,0.93336081265765,0.61244019138756,1.78386951809458,742,362,380,-1,1,61.35,5.2,0,0,0,0,0,0,0.00735093250586999,5.57366924656345,0.919102360484024
8.7,"max_tuv_SVM","SVM",87,24,1412,1404,8,2500,2111,389,0.933652495186551,0.61244019138756,1.78386951809458,746,362,384,4,1.1,63.91,5.4,0,0,0,0,0,0,0.00669498335005348,4.92000918797813,0.697616048944187
8.7,"max_tuv_SVM","SVM",87,25,1312,1305,7,2600,2210,390,0.93331562240669,0.607655502392344,1.78059034618632,753,368,385,7,1,66.46,5.7,0,0,0,0,0,0,0.00584896853181486,3.96718594849225,0.631525243153139
8.7,"max_tuv_SVM","SVM",87,26,1212,1206,6,2700,2309,391,0.933693577232865,0.602870813397129,1.78222842378171,757,371,386,4,1,69.02,5.9,0,0,0,0,0,0,0.00448275835112782,2.73901851407949,0.471759790927961
8.7,"max_tuv_SVM","SVM",87,27,1112,1108,4,2800,2407,393,0.93420847221346,0.602870813397129,1.78386951809458,769,374,395,12,1.1,71.57,6.1,0,0,0,0,0,0,0.00439073105194068,2.54819906470298,0.465089217655987
8.7,"max_tuv_SVM","SVM",87,28,1012,1008,4,2900,2507,393,0.934129046923902,0.602870813397129,1.7855136374661,776,379,397,7,1,74.13,6.4,0,0,0,0,0,0,0.00416594283340089,2.18836107232858,0.437228605724798
8.7,"max_tuv_SVM","SVM",87,29,912,909,3,3000,2606,394,0.933871599433605,0.602870813397129,1.7855136374661,778,381,397,2,1,76.69,6.6,0,0,0,0,0,0,0.00348570384838335,1.65964410408892,0.37253811592629
8.7,"max_tuv_SVM","SVM",87,30,812,809,3,3100,2706,394,0.933904465070666,0.602870813397129,1.78222842378171,778,381,397,0,1,79.24,6.9,0,0,0,0,0,0,0.00305663866156932,1.30802043400558,0.332448717438245
8.7,"max_tuv_SVM","SVM",87,31,712,709,3,3200,2806,394,0.93393185310155,0.602870813397129,1.78059034618632,780,381,399,2,1,81.8,7.1,0,0,0,0,0,0,0.00232685318165781,0.866571479242085,0.251599917701489
8.7,"max_tuv_SVM","SVM",87,32,612,609,3,3300,2906,394,0.934040035823537,0.602870813397129,1.78386951809458,778,381,397,-2,1,84.36,7.4,0,0,0,0,0,0,0.0019979846373522,0.660323470181041,0.224762367042434
8.7,"max_tuv_SVM","SVM",87,33,512,509,3,3400,3006,394,0.93423312144126,0.607655502392344,1.7789552769979,778,381,397,0,1,86.91,7.6,0,0,0,0,0,0,0.00126368165525577,0.395675996279508,0.156695751458489
8.7,"max_tuv_SVM","SVM",87,34,412,409,3,3500,3106,394,0.934474136113029,0.607655502392344,1.78222842378171,779,381,398,1,1,89.47,7.9,0,0,0,0,0,0,0.000770793073373083,0.207950343912588,0.0947785516437143
8.7,"max_tuv_SVM","SVM",87,35,312,312,0,3600,3203,397,0.934884956576276,0.607655502392344,1.78263841421736,792,388,404,13,1,92.02,8.1,0,0,0,0,0,0,0.000835213382386637,0.220801828584943,0.119177771809871
8.7,"max_tuv_SVM","SVM",87,36,212,212,0,3700,3303,397,0.935186224915985,0.607655502392344,1.7875492638433,792,390,402,0,1,94.58,8.3,0,0,0,0,0,0,0.000447003538993586,0.0941494368709652,0.0593796749530688
8.7,"max_tuv_SVM","SVM",87,37,112,112,0,3800,3403,397,0.935703858699668,0.607655502392344,1.79248724523514,792,389,403,0,1,97.14,8.6,0,0,0,0,0,0,0.000184862726008243,0.0291453326931687,0.0271610040390297
8.7,"max_tuv_SVM","SVM",87,38,12,12,0,3900,3503,397,0.936285854355926,0.607655502392344,1.79248724523514,796,390,406,4,1,99.69,8.8,0,0,0,0,0,0,0.00011620445458869,0.00178698804976951,0.00178698804976951
8.7,"max_tuv_SVM","SVM",87,39,0,0,0,3912,3515,397,0.936276268545117,0.607655502392344,1.7875492638433,797,391,406,1,1,100,8.9,0,0,0,0,0,0,0,0,0
8.7,"max_tuv_SVM","SVM",88,0,3812,3429,383,100,91,9,0.900755925619939,0.55607476635514,1.76257047964779,23,9,14,0,1.6,2.56,10.1,0,0,0,0,0,0,0.774152685767712,428.440260940733,83.6226134156794
8.7,"max_tuv_SVM","SVM",88,1,3712,3373,339,200,147,53,0.890681835252204,0.570093457943925,1.72741147217697,111,52,59,88,1.1,5.11,2.8,0,0,0,0,0,0,0.769366824035076,388.003010629395,82.9022370243141
8.7,"max_tuv_SVM","SVM",88,2,3612,3311,301,300,209,91,0.900578881294445,0.602803738317757,1.74418245734374,191,91,100,80,1.1,7.67,2.3,0,0,0,0,0,0,0.612835630138263,335.809708859568,70.061582267134
8.7,"max_tuv_SVM","SVM",88,3,3512,3259,253,400,261,139,0.881024872045238,0.616822429906542,1.67178051126993,285,138,147,94,1.1,10.22,1.9,0,0,0,0,0,0,0.679859235746702,254.816989841455,78.2828576473898
8.7,"max_tuv_SVM","SVM",88,4,3412,3220,192,500,300,200,0.877860875350051,0.607476635514019,1.62977597581088,352,174,178,67,1,12.78,1.5,0,0,0,0,0,0,0.203656425583707,145.93853641684,63.9474991162539
8.7,"max_tuv_SVM","SVM",88,5,3312,3153,159,600,367,233,0.86781495112504,0.616822429906542,1.59470662444324,416,200,216,64,1.1,15.34,1.6,0,0,0,0,0,0,0.120379239527157,123.485951606477,56.2242860354255
8.7,"max_tuv_SVM","SVM",88,6,3212,3089,123,700,431,269,0.860477000332624,0.635514018691589,1.59069551298601,474,225,249,58,1.1,17.89,1.6,0,0,0,0,0,0,0.10473713129739,162.429681399365,47.87486345599
8.7,"max_tuv_SVM","SVM",88,7,3112,3000,112,800,520,280,0.871178793308795,0.644859813084112,1.6060494028837,498,240,258,24,1.1,20.45,1.9,0,0,0,0,0,0,0.0755079677358941,139.036995669306,43.6572050021899
8.7,"max_tuv_SVM","SVM",88,8,3012,2923,89,900,597,303,0.878188139103189,0.644859813084112,1.62436102648836,529,251,278,31,1.1,23.01,2,0,0,0,0,0,0,0.0609850238717446,114.47204351568,30.893047624388
8.7,"max_tuv_SVM","SVM",88,9,2912,2837,75,1000,683,317,0.88879470369218,0.654205607476635,1.64270640423791,555,267,288,26,1.1,25.56,2.2,0,0,0,0,0,0,0.062219048755855,116.441451818057,28.4687950725139
8.7,"max_tuv_SVM","SVM",88,10,2812,2739,73,1100,781,319,0.908873139693328,0.658878504672897,1.6764029458633,585,285,300,30,1.1,28.12,2.4,0,0,0,0,0,0,0.0587081062797697,69.4499697640025,25.9033039826566
8.7,"max_tuv_SVM","SVM",88,11,2712,2667,45,1200,853,347,0.913320707748097,0.654205607476635,1.71009948748869,601,291,310,16,1.1,30.67,2.5,0,0,0,0,0,0,0.0441599788125105,48.3988139189249,6.91186019660064
8.7,"max_tuv_SVM","SVM",88,12,2612,2576,36,1300,944,356,0.920320664828275,0.654205607476635,1.70538413963716,617,299,318,16,1.1,33.23,2.7,0,0,0,0,0,0,0.0513595880347384,51.7205141107628,6.24277128476002
8.7,"max_tuv_SVM","SVM",88,13,2512,2482,30,1400,1038,362,0.925579686041402,0.649532710280374,1.74899620837596,642,310,332,25,1.1,35.79,2.9,0,0,0,0,0,0,0.0543901239362719,47.0303545974325,6.02482887485643
8.7,"max_tuv_SVM","SVM",88,14,2412,2386,26,1500,1134,366,0.928120003862786,0.649532710280374,1.75740484399316,658,317,341,16,1.1,38.34,3.1,0,0,0,0,0,0,0.0529420045459702,41.8838423378713,5.83603986170542
8.7,"max_tuv_SVM","SVM",88,15,2312,2287,25,1600,1233,367,0.928624311941371,0.649532710280374,1.76581347961035,661,318,343,3,1.1,40.9,3.4,0,0,0,0,0,0,0.0395123844753967,30.8799776838007,4.4882620972167
8.7,"max_tuv_SVM","SVM",88,16,2212,2191,21,1700,1329,371,0.929270791978284,0.644859813084112,1.75902308049775,673,325,348,12,1.1,43.46,3.6,0,0,0,0,0,0,0.0354691911456836,26.3825905899164,4.17885722382839
8.7,"max_tuv_SVM","SVM",88,17,2112,2097,15,1800,1423,377,0.929608785690529,0.644859813084112,1.75902308049775,684,330,354,11,1.1,46.01,3.8,0,0,0,0,0,0,0.0279729240661039,22.2562639929484,3.8699813347399
8.7,"max_tuv_SVM","SVM",88,18,2012,1999,13,1900,1521,379,0.929388821528594,0.64018691588785,1.75902308049775,688,331,357,4,1.1,48.57,4,0,0,0,0,0,0,0.0193974569519427,18.1326226121847,2.34205242914425
8.7,"max_tuv_SVM","SVM",88,19,1912,1900,12,2000,1620,380,0.929759005118193,0.64018691588785,1.75256794992712,693,333,360,5,1.1,51.12,4.3,0,0,0,0,0,0,0.0179386732243944,17.1920791777381,1.93515968481232
8.7,"max_tuv_SVM","SVM",88,20,1812,1803,9,2100,1717,383,0.929683895404364,0.64018691588785,1.75578958218802,702,338,364,9,1.1,53.68,4.5,0,0,0,0,0,0,0.0187133293531982,16.2016287638225,1.87991819614421
8.7,"max_tuv_SVM","SVM",88,21,1712,1703,9,2200,1817,383,0.928600169533352,0.64018691588785,1.77259139637163,730,353,377,28,1.1,56.24,4.7,0,0,0,0,0,0,0.0116167044076723,7.85610749699928,1.53213658145296
8.7,"max_tuv_SVM","SVM",88,22,1612,1605,7,2300,1915,385,0.928923409551808,0.64018691588785,1.76419048927982,732,356,376,2,1.1,58.79,5,0,0,0,0,0,0,0.00975788841221577,7.57846378820505,1.14195882587062
8.7,"max_tuv_SVM","SVM",88,23,1512,1505,7,2400,2015,385,0.928962305653614,0.64018691588785,1.76581347961035,732,356,376,0,1.1,61.35,5.2,0,0,0,0,0,0,0.00824914877360232,5.85038032772788,0.846538459291713
8.7,"max_tuv_SVM","SVM",88,24,1412,1405,7,2500,2115,385,0.92870746912454,0.64018691588785,1.77096367240802,743,361,382,11,1.1,63.91,5.5,0,0,0,0,0,0,0.00648359732924243,4.41986222039954,0.717971343831371
8.7,"max_tuv_SVM","SVM",88,25,1312,1306,6,2600,2214,386,0.928742341491676,0.630841121495327,1.77749257073948,746,363,383,3,1.1,66.46,5.7,0,0,0,0,0,0,0.00651824567445749,3.97501853136624,0.669755226367905
8.7,"max_tuv_SVM","SVM",88,26,1212,1206,6,2700,2314,386,0.927997950577802,0.626168224299065,1.77585583724893,751,366,385,5,1.1,69.02,6,0,0,0,0,0,0,0.00579771710042869,3.26318043479227,0.618952736928418
8.7,"max_tuv_SVM","SVM",88,27,1112,1106,6,2800,2414,386,0.92802209298582,0.626168224299065,1.77259139637163,753,367,386,2,1.1,71.57,6.3,0,0,0,0,0,0,0.00427599722543078,2.01267748902567,0.442397643599797
8.7,"max_tuv_SVM","SVM",88,28,1012,1006,6,2900,2514,386,0.928005998047131,0.626168224299065,1.77259139637163,758,370,388,5,1,74.13,6.5,0,0,0,0,0,0,0.00362861502060795,1.5053488910734,0.387984676742294
8.7,"max_tuv_SVM","SVM",88,29,912,906,6,3000,2614,386,0.928050259128496,0.626168224299065,1.78263075084473,758,370,388,0,1,76.69,6.8,0,0,0,0,0,0,0.00296132761038831,1.0678434028034,0.320710858474818
8.7,"max_tuv_SVM","SVM",88,30,812,808,4,3100,2712,388,0.928712834104085,0.630841121495327,1.78099230346344,759,373,386,1,1,79.24,7,0,0,0,0,0,0,0.0028412392368715,1.00011325232923,0.324567647969812
8.7,"max_tuv_SVM","SVM",88,31,712,708,4,3200,2812,388,0.928782578838358,0.626168224299065,1.78263075084473,758,373,385,-1,1,81.8,7.2,0,0,0,0,0,0,0.00191678593129947,0.614765202058569,0.223668890740556
8.7,"max_tuv_SVM","SVM",88,32,612,609,3,3300,2911,389,0.928825498674833,0.626168224299065,1.78263075084473,765,374,391,7,1,84.36,7.5,0,0,0,0,0,0,0.00143022286926429,0.445037373363393,0.174572255769194
8.7,"max_tuv_SVM","SVM",88,33,512,510,2,3400,3010,390,0.929129961264826,0.621495327102804,1.78099230346344,769,376,393,4,1,86.91,7.7,0,0,0,0,0,0,0.000997251570644871,0.312856699457203,0.126706081647208
8.7,"max_tuv_SVM","SVM",88,34,412,411,1,3500,3109,391,0.929199705999098,0.621495327102804,1.78427221562452,773,379,394,4,1,89.47,8,0,0,0,0,0,0,0.000798703545675944,0.234280591840704,0.099707470641628
8.7,"max_tuv_SVM","SVM",88,35,312,312,0,3600,3208,392,0.929370044100111,0.621495327102804,1.78427221562452,777,381,396,4,1,92.02,8.2,0,0,0,0,0,0,0.000759732429465877,0.184474003783547,0.0914778307521642
8.7,"max_tuv_SVM","SVM",88,36,212,212,0,3700,3308,392,0.929659752996322,0.621495327102804,1.78427221562452,784,383,401,7,1,94.58,8.4,0,0,0,0,0,0,0.000443720429212343,0.0938585394572687,0.0583531991731818
8.7,"max_tuv_SVM","SVM",88,37,112,112,0,3800,3408,392,0.92959805573139,0.616822429906542,1.78263075084473,785,384,401,1,1,97.14,8.7,0,0,0,0,0,0,0.00014755801069327,0.0252946926482554,0.0236720902959485
8.7,"max_tuv_SVM","SVM",88,38,12,12,0,3900,3508,392,0.929632928098526,0.616822429906542,1.77935686516825,785,385,400,0,1,99.69,8.9,0,0,0,0,0,0,9.91853963351318e-05,0.00164277003119974,0.00164277003119974
8.7,"max_tuv_SVM","SVM",88,39,0,0,0,3912,3520,392,0.92969462536346,0.616822429906542,1.78591670614583,786,385,401,1,1,100,9,0,0,0,0,0,0,0,0,0
8.7,"max_tuv_SVM","SVM",89,0,3812,3420,392,100,89,11,0.899862024003912,0.561576354679803,1.75190326914465,25,11,14,0,1.3,2.56,8.1,0,0,0,0,0,0,0.618790290149721,368.789342326373,67.1140582184195
8.7,"max_tuv_SVM","SVM",89,1,3712,3365,347,200,144,56,0.906371624716533,0.600985221674877,1.74145613955801,113,54,59,88,1.1,5.11,2.6,0,0,0,0,0,0,0.654191429366246,423.46576938103,71.3732177821963
8.7,"max_tuv_SVM","SVM",89,2,3612,3313,299,300,196,104,0.90107598796153,0.620689655172414,1.71080526237079,202,99,103,89,1,7.67,1.9,0,0,0,0,0,0,0.72560724524233,336.93589414222,79.1563088990644
8.7,"max_tuv_SVM","SVM",89,3,3512,3253,259,400,256,144,0.898576402451544,0.610837438423645,1.72694508838018,294,142,152,92,1.1,10.22,1.8,0,0,0,0,0,0,0.615777400967042,368.751152017075,70.7751629589948
8.7,"max_tuv_SVM","SVM",89,4,3412,3191,221,500,318,182,0.913884431755269,0.620689655172414,1.74626236625412,369,178,191,75,1.1,12.78,1.7,0,0,0,0,0,0,0.608632123444378,268.31841524471,71.8851519441781
8.7,"max_tuv_SVM","SVM",89,5,3312,3137,175,600,372,228,0.90231243273321,0.640394088669951,1.67534815848745,432,211,221,63,1,15.34,1.6,0,0,0,0,0,0,0.155870248531139,134.069350037167,63.3895365108712
8.7,"max_tuv_SVM","SVM",89,6,3212,3093,119,700,416,284,0.903829887680239,0.645320197044335,1.6695557422079,474,231,243,42,1.1,17.89,1.5,0,0,0,0,0,0,0.0947684798449068,87.8735164844981,33.5097454545631
8.7,"max_tuv_SVM","SVM",89,7,3112,3019,93,800,490,310,0.897993306337615,0.660098522167488,1.67534815848745,512,249,263,38,1.1,20.45,1.6,0,0,0,0,0,0,0.0645614324742242,79.6459617104119,23.6301279304526
8.7,"max_tuv_SVM","SVM",89,8,3012,2946,66,900,563,337,0.89532651977327,0.660098522167488,1.66648388251662,569,273,296,57,1.1,23.01,1.7,0,0,0,0,0,0,0.0673752273787713,106.539959047484,18.0959392776396
8.7,"max_tuv_SVM","SVM",89,9,2912,2851,61,1000,658,342,0.902371444870017,0.660098522167488,1.66648388251662,589,282,307,20,1.1,25.56,1.9,0,0,0,0,0,0,0.0598289878870308,91.6134161854495,16.0423900106342
8.7,"max_tuv_SVM","SVM",89,10,2812,2759,53,1100,750,350,0.906325258037601,0.660098522167488,1.65914595977465,600,288,312,11,1.1,28.12,2.1,0,0,0,0,0,0,0.0421141162955467,62.1444792794489,10.0666057143508
8.7,"max_tuv_SVM","SVM",89,11,2712,2668,44,1200,841,359,0.909613077089529,0.660098522167488,1.65914595977465,612,296,316,12,1.1,30.67,2.3,0,0,0,0,0,0,0.0396431401517766,58.8718637228219,6.23587907702908
8.7,"max_tuv_SVM","SVM",89,12,2612,2571,41,1300,938,362,0.915902084814488,0.665024630541872,1.6695557422079,626,302,324,14,1.1,33.23,2.6,0,0,0,0,0,0,0.0352497726828246,48.9209631894052,5.7381518706907
8.7,"max_tuv_SVM","SVM",89,13,2512,2480,32,1400,1029,371,0.922209358200857,0.660098522167488,1.70923283106346,647,311,336,21,1.1,35.79,2.8,0,0,0,0,0,0,0.0634549312294013,57.5203706096645,7.51011695589332
8.7,"max_tuv_SVM","SVM",89,14,2412,2384,28,1500,1125,375,0.925608176272064,0.665024630541872,1.74305527283584,667,321,346,20,1.1,38.34,3,0,0,0,0,0,0,0.0612242128250493,48.8333151540226,6.63205995438821
8.7,"max_tuv_SVM","SVM",89,15,2312,2289,23,1600,1220,380,0.926886772570041,0.660098522167488,1.75190326914465,682,329,353,15,1.1,40.9,3.2,0,0,0,0,0,0,0.0566379029391522,39.8854934759048,6.15883339692069
8.7,"max_tuv_SVM","SVM",89,16,2212,2195,17,1700,1314,386,0.927179023152436,0.665024630541872,1.75512664222495,703,339,364,21,1.1,43.46,3.4,0,0,0,0,0,0,0.0549019355305384,35.2459507906616,6.09072242539452
8.7,"max_tuv_SVM","SVM",89,17,2112,2098,14,1800,1411,389,0.926942974605118,0.660098522167488,1.73899790436274,708,340,368,5,1.1,46.01,3.6,0,0,0,0,0,0,0.0370053040701383,26.0032781776445,4.615162780349
8.7,"max_tuv_SVM","SVM",89,18,2012,2002,10,1900,1507,393,0.926282600692975,0.660098522167488,1.73739809028329,717,346,371,9,1.1,48.57,3.8,0,0,0,0,0,0,0.0248963247621957,21.9008852375928,3.1924458205187
8.7,"max_tuv_SVM","SVM",89,19,1912,1904,8,2000,1605,395,0.927076454438422,0.660098522167488,1.7478703426503,728,349,379,11,1.1,51.12,4.1,0,0,0,0,0,0,0.0186930425927536,18.0551428339753,2.13128462637497
8.7,"max_tuv_SVM","SVM",89,20,1812,1805,7,2100,1704,396,0.927783195029502,0.660098522167488,1.75512664222495,732,351,381,4,1.1,53.68,4.3,0,0,0,0,0,0,0.0159521753487296,15.3518647521035,1.65600494143305
8.7,"max_tuv_SVM","SVM",89,21,1712,1705,7,2200,1804,396,0.927342009054144,0.655172413793103,1.7478703426503,744,358,386,12,1.1,56.24,4.6,0,0,0,0,0,0,0.0111076362042441,9.69311037937477,1.37601285405291
8.7,"max_tuv_SVM","SVM",89,22,1612,1608,4,2300,1901,399,0.927170592847161,0.660098522167488,1.74305527283584,751,361,390,7,1.1,58.79,4.8,0,0,0,0,0,0,0.0107644479166044,8.75633230681964,1.09382972086694
8.7,"max_tuv_SVM","SVM",89,23,1512,1508,4,2400,2001,399,0.926234828963149,0.650246305418719,1.75674278093787,764,371,393,13,1.1,61.35,5,0,0,0,0,0,0,0.00818088035011471,5.27048662943689,1.03343432928839
8.7,"max_tuv_SVM","SVM",89,24,1412,1408,4,2500,2101,399,0.926299461303486,0.650246305418719,1.75836189870832,764,371,393,0,1.1,63.91,5.3,0,0,0,0,0,0,0.00520439148076072,3.6556269074697,0.614418532504746
8.7,"max_tuv_SVM","SVM",89,25,1312,1309,3,2600,2200,400,0.926232018861395,0.650246305418719,1.75512664222495,769,373,396,5,1.1,66.46,5.5,0,0,0,0,0,0,0.00453860734901559,2.9694611867892,0.469235802780473
8.7,"max_tuv_SVM","SVM",89,26,1212,1209,3,2700,2300,400,0.926056387501784,0.640394088669951,1.75351347435526,774,377,397,5,1.1,69.02,5.8,0,0,0,0,0,0,0.00345729551793297,2.14065008332634,0.392104184476769
8.7,"max_tuv_SVM","SVM",89,27,1112,1110,2,2800,2399,401,0.9263107017105,0.640394088669951,1.75190326914465,775,379,396,1,1,71.57,6,0,0,0,0,0,0,0.00417281392833109,2.21518100680235,0.425960523477777
8.7,"max_tuv_SVM","SVM",89,28,1012,1011,1,2900,2498,402,0.926661964429725,0.640394088669951,1.75190326914465,780,384,396,5,1,74.13,6.2,0,0,0,0,0,0,0.00346671771944725,1.83040555760696,0.408710586388839
8.7,"max_tuv_SVM","SVM",89,29,912,912,0,3000,2597,403,0.926864291755997,0.640394088669951,1.75190326914465,785,387,398,5,1,76.69,6.4,0,0,0,0,0,0,0.00258851444811114,1.17276838760461,0.279883412086869
8.7,"max_tuv_SVM","SVM",89,30,812,812,0,3100,2697,403,0.927142491829623,0.640394088669951,1.75190326914465,786,387,399,1,1,79.24,6.7,0,0,0,0,0,0,0.00226039921949549,0.912844197041207,0.247406053095047
8.7,"max_tuv_SVM","SVM",89,31,712,712,0,3200,2797,403,0.927134061524362,0.640394088669951,1.75190326914465,787,388,399,1,1,81.8,6.9,0,0,0,0,0,0,0.00206444005925186,0.746006960804358,0.22657047877607
8.7,"max_tuv_SVM","SVM",89,32,612,612,0,3300,2897,403,0.927260516103284,0.645320197044335,1.75190326914465,788,389,399,1,1,84.36,7.2,0,0,0,0,0,0,0.00126362642314162,0.404350103412944,0.14603869716221
8.7,"max_tuv_SVM","SVM",89,33,512,512,0,3400,2997,403,0.927451603022541,0.645320197044335,1.75512664222495,788,389,399,0,1,86.91,7.4,0,0,0,0,0,0,0.000840666499988042,0.264776397894796,0.106623874923789
8.7,"max_tuv_SVM","SVM",89,34,412,412,0,3500,3097,403,0.927725587943535,0.645320197044335,1.75674278093787,791,389,402,3,1,89.47,7.7,0,0,0,0,0,0,0.000538209470023781,0.163181626658908,0.0693992158542632
8.7,"max_tuv_SVM","SVM",89,35,312,312,0,3600,3197,403,0.928269342632896,0.645320197044335,1.74709034807557,794,391,403,3,1,92.02,7.9,0,0,0,0,0,0,0.000333148439729181,0.0854083069258234,0.0415346983001319
8.7,"max_tuv_SVM","SVM",89,36,212,212,0,3700,3297,403,0.92889318522224,0.645320197044335,1.74549191225848,798,391,407,4,1,94.58,8.2,0,0,0,0,0,0,0.000176126705881586,0.0373760865685345,0.0231102177678921
8.7,"max_tuv_SVM","SVM",89,37,112,112,0,3800,3397,403,0.929376522723898,0.645320197044335,1.74869171411414,801,393,408,3,1,97.14,8.4,0,0,0,0,0,0,9.66825997645665e-05,0.0154552766861971,0.0144527143813877
8.7,"max_tuv_SVM","SVM",89,38,12,12,0,3900,3497,403,0.929605546016833,0.645320197044335,1.75674278093787,806,393,413,5,1.1,99.69,8.7,0,0,0,0,0,0,5.79428842564255e-05,0.000812597199441244,0.000812597199441244
8.7,"max_tuv_SVM","SVM",89,39,0,0,0,3912,3509,403,0.929761506664169,0.645320197044335,1.74709034807557,808,393,415,2,1.1,100,8.7,0,0,0,0,0,0,0,0,0
8.7,"max_tuv_SVM","SVM",90,0,3812,3389,423,100,92,8,0.851996470682594,0.434285714285714,1.67914680710994,30,8,22,0,2.8,2.56,11.5,0,0,0,0,0,0,0.123317696028822,317.096119108566,13.8259288988648
8.7,"max_tuv_SVM","SVM",90,1,3712,3343,369,200,138,62,0.924689179433705,0.565714285714286,1.7739868938401,113,54,59,83,1.1,5.11,2.2,0,0,0,0,0,0,0.669509189247948,439.413966763134,72.8483828584206
8.7,"max_tuv_SVM","SVM",90,2,3612,3280,332,300,201,99,0.914731691666001,0.577142857142857,1.77561589925226,202,97,105,89,1.1,7.67,2,0,0,0,0,0,0,0.573220633140963,366.626566725182,66.5494952045554
8.7,"max_tuv_SVM","SVM",90,3,3512,3252,260,400,229,171,0.916961578567413,0.542857142857143,1.75728388613215,269,135,134,67,1,10.22,1.3,0,0,0,0,0,0,0.558395774810244,312.425028849777,73.425098961
8.7,"max_tuv_SVM","SVM",90,4,3412,3200,212,500,281,219,0.915110291168666,0.565714285714286,1.75508854781582,359,179,180,90,1,12.78,1.3,0,0,0,0,0,0,0.44045759568855,227.030604217113,72.1014322612159
8.7,"max_tuv_SVM","SVM",90,5,3312,3141,171,600,340,260,0.889994385176872,0.594285714285714,1.67605730056512,440,216,224,81,1,15.34,1.3,0,0,0,0,0,0,0.336342258148979,222.93604578402,66.638487248861
8.7,"max_tuv_SVM","SVM",90,6,3212,3070,142,700,411,289,0.909200288762322,0.6,1.69506302521008,481,237,244,41,1,17.89,1.4,0,0,0,0,0,0,0.166652925324082,127.156759186656,54.5801805262487
8.7,"max_tuv_SVM","SVM",90,7,3112,3011,101,800,470,330,0.900415496911841,0.611428571428571,1.67914680710994,535,261,274,54,1,20.45,1.4,0,0,0,0,0,0,0.0871548775255222,102.906135003777,33.9697623227529
8.7,"max_tuv_SVM","SVM",90,8,3012,2936,76,900,545,355,0.901143819683953,0.617142857142857,1.65245179063361,579,278,301,44,1.1,23.01,1.5,0,0,0,0,0,0,0.0669255442431263,99.2293759075817,25.3098567906314
8.7,"max_tuv_SVM","SVM",90,9,2912,2843,69,1000,638,362,0.905313226919064,0.617142857142857,1.67451680672269,590,286,304,11,1.1,25.56,1.8,0,0,0,0,0,0,0.0602713117762024,96.3543372396407,20.6432568155749
8.7,"max_tuv_SVM","SVM",90,10,2812,2760,52,1100,721,379,0.909006176305445,0.617142857142857,1.68169855832241,608,295,313,18,1.1,28.12,1.9,0,0,0,0,0,0,0.0516973330440942,76.5687890528613,8.30997968710952
8.7,"max_tuv_SVM","SVM",90,11,2712,2664,48,1200,817,383,0.919308574637033,0.611428571428571,1.70533613445378,618,301,317,10,1.1,30.67,2.1,0,0,0,0,0,0,0.0371983615150768,48.4203265160398,6.06376132583281
8.7,"max_tuv_SVM","SVM",90,12,2612,2573,39,1300,908,392,0.924495066976821,0.617142857142857,1.70690498094362,643,312,331,25,1.1,33.23,2.3,0,0,0,0,0,0,0.0415220586443121,54.5633694314355,4.96483945338198
8.7,"max_tuv_SVM","SVM",90,13,2512,2479,33,1400,1002,398,0.932944573674505,0.605714285714286,1.75993685872139,670,324,346,27,1.1,35.79,2.5,0,0,0,0,0,0,0.0505877874686885,50.0273368700425,5.80535054224933
8.7,"max_tuv_SVM","SVM",90,14,2412,2382,30,1500,1099,401,0.933773963263019,0.6,1.75831778157445,685,329,356,15,1.1,38.34,2.7,0,0,0,0,0,0,0.0394975897151808,38.5976870279853,4.40576495253707
8.7,"max_tuv_SVM","SVM",90,15,2312,2284,28,1600,1197,403,0.933369695997436,0.605714285714286,1.75670168067227,683,330,353,-2,1.1,40.9,3,0,0,0,0,0,0,0.0338152523617091,31.1930028118569,3.75816139145875
8.7,"max_tuv_SVM","SVM",90,16,2212,2188,24,1700,1293,407,0.931726959172216,0.605714285714286,1.75993685872139,698,336,362,15,1.1,43.46,3.2,0,0,0,0,0,0,0.0361691369365331,29.0455878808656,4.24412636782815
8.7,"max_tuv_SVM","SVM",90,17,2112,2097,15,1800,1384,416,0.928200850244646,0.594285714285714,1.76155892034233,723,347,376,25,1.1,46.01,3.3,0,0,0,0,0,0,0.0340428442274692,27.8913655090722,4.89316867555898
8.7,"max_tuv_SVM","SVM",90,18,2012,2002,10,1900,1479,421,0.927073072912489,0.594285714285714,1.75670168067227,736,352,384,13,1.1,48.57,3.5,0,0,0,0,0,0,0.0269767884686257,23.4536821372419,3.19212402618009
8.7,"max_tuv_SVM","SVM",90,19,1912,1902,10,2000,1579,421,0.927263976899013,0.594285714285714,1.75831778157445,741,354,387,5,1.1,51.12,3.8,0,0,0,0,0,0,0.0195571958340891,17.7520453309582,2.17410945623354
8.7,"max_tuv_SVM","SVM",90,20,1812,1802,10,2100,1679,421,0.927225475254672,0.588571428571429,1.75831778157445,742,355,387,1,1.1,53.68,4,0,0,0,0,0,0,0.0165471032801279,15.2122552652622,1.80682804880654
8.7,"max_tuv_SVM","SVM",90,21,1712,1703,9,2200,1778,422,0.927533488409398,0.588571428571429,1.75831778157445,748,359,389,6,1.1,56.24,4.2,0,0,0,0,0,0,0.0163780304486904,13.6292446870426,1.66276752310947
8.7,"max_tuv_SVM","SVM",90,22,1612,1604,8,2300,1877,423,0.928813668083742,0.6,1.79246346280448,766,373,393,18,1.1,58.79,4.4,0,0,0,0,0,0,0.0109239784892413,7.11839643349294,1.40527933547353
8.7,"max_tuv_SVM","SVM",90,23,1512,1504,8,2400,1977,423,0.928877837490977,0.6,1.79246346280448,765,373,392,-1,1.1,61.35,4.7,0,0,0,0,0,0,0.00778674593479583,5.76076878203791,0.871883845365373
8.7,"max_tuv_SVM","SVM",90,24,1412,1404,8,2500,2077,423,0.928982112777733,0.6,1.79081294396212,775,377,398,10,1.1,63.91,4.9,0,0,0,0,0,0,0.00584216291625075,3.90697007435505,0.61418302325322
8.7,"max_tuv_SVM","SVM",90,25,1312,1304,8,2600,2177,423,0.931175102269989,0.594285714285714,1.78916546195295,777,379,398,2,1.1,66.46,5.1,0,0,0,0,0,0,0.00481339585617406,3.08185296750225,0.547667408012503
8.7,"max_tuv_SVM","SVM",90,26,1212,1205,7,2700,2276,424,0.931837651399692,0.594285714285714,1.78752100840336,780,382,398,3,1,69.02,5.4,0,0,0,0,0,0,0.0047521501931982,2.5573268228474,0.487370208264894
8.7,"max_tuv_SVM","SVM",90,27,1112,1106,6,2800,2375,425,0.93322210636079,0.594285714285714,1.78216194865043,795,389,406,15,1,71.57,5.6,0,0,0,0,0,0,0.00384702403416695,1.97956031734015,0.435900053348789
8.7,"max_tuv_SVM","SVM",90,28,1012,1006,6,2900,2475,425,0.933321568942004,0.594285714285714,1.78916546195295,796,389,407,1,1,74.13,5.8,0,0,0,0,0,0,0.00367559075027051,1.62021868195076,0.389668809314999
8.7,"max_tuv_SVM","SVM",90,29,912,906,6,3000,2575,425,0.933249378358865,0.594285714285714,1.78052091554854,796,390,406,0,1,76.69,6.1,0,0,0,0,0,0,0.00276879469824379,1.05425816639067,0.304045635628588
8.7,"max_tuv_SVM","SVM",90,30,812,807,5,3100,2674,426,0.933430656934304,0.594285714285714,1.77888290182678,797,391,406,1,1,79.24,6.3,0,0,0,0,0,0,0.00259348315538145,0.879291801748395,0.283850930172125
8.7,"max_tuv_SVM","SVM",90,31,712,708,4,3200,2773,427,0.933645624448541,0.594285714285714,1.78752100840336,800,392,408,3,1,81.8,6.5,0,0,0,0,0,0,0.00180262547978492,0.568789351614156,0.210404088494706
8.7,"max_tuv_SVM","SVM",90,32,612,608,4,3300,2873,427,0.933873425844227,0.6,1.77724789915966,800,392,408,0,1,84.36,6.7,0,0,0,0,0,0,0.00118642761669692,0.36242318420884,0.151978471577158
8.7,"max_tuv_SVM","SVM",90,33,512,509,3,3400,2972,428,0.934269671933904,0.6,1.7739868938401,806,397,409,6,1,86.91,6.9,0,0,0,0,0,0,0.000878237479317292,0.271638457615171,0.114550088412845
8.7,"max_tuv_SVM","SVM",90,34,412,411,1,3500,3070,430,0.93486805165637,0.6,1.79246346280448,816,402,414,10,1,89.47,7.1,0,0,0,0,0,0,0.00081580475888284,0.245807301463073,0.102296587825684
8.7,"max_tuv_SVM","SVM",90,35,312,312,0,3600,3169,431,0.935272318921952,0.594285714285714,1.79081294396212,828,406,422,12,1,92.02,7.4,0,0,0,0,0,0,0.000708428433931369,0.177176633966626,0.0847367289742405
8.7,"max_tuv_SVM","SVM",90,36,212,212,0,3700,3269,431,0.935528996550892,0.594285714285714,1.79246346280448,830,406,424,2,1,94.58,7.6,0,0,0,0,0,0,0.000379368018042171,0.0781812622394744,0.0487184130009405
8.7,"max_tuv_SVM","SVM",90,37,112,112,0,3800,3369,431,0.935723109007778,0.594285714285714,1.78752100840336,831,408,423,1,1,97.14,7.8,0,0,0,0,0,0,0.000204523797391424,0.0315294276624919,0.0293225257213333
8.7,"max_tuv_SVM","SVM",90,38,12,12,0,3900,3469,431,0.935753589476214,0.588571428571429,1.78916546195295,833,410,423,2,1,99.69,8,0,0,0,0,0,0,0.000149728229237735,0.00208614325617875,0.00208614325617875
8.7,"max_tuv_SVM","SVM",90,39,0,0,0,3912,3481,431,0.935729525948501,0.588571428571429,1.78752100840336,834,411,423,1,1,100,8.1,0,0,0,0,0,0,0,0,0
8.7,"max_tuv_SVM","SVM",91,0,3812,3423,389,100,92,8,0.887984323091124,0.478468899521531,1.76015100302884,27,8,19,0,2.4,2.56,11.5,0,0,0,0,0,0,0.452058282978407,329.54582200873,59.232383971786
8.7,"max_tuv_SVM","SVM",91,1,3712,3380,332,200,135,65,0.898431487471329,0.559808612440191,1.75801633667292,89,43,46,62,1.1,5.11,2.1,0,0,0,0,0,0,0.748954509333345,314.31332553919,83.1406467415181
8.7,"max_tuv_SVM","SVM",91,2,3612,3321,291,300,194,106,0.893794693842885,0.559808612440191,1.70004828585225,182,91,91,93,1,7.67,1.8,0,0,0,0,0,0,0.625838154610691,262.007869795355,73.9913652179494
8.7,"max_tuv_SVM","SVM",91,3,3512,3266,246,400,249,151,0.883524182261862,0.598086124401914,1.68200560051154,255,125,130,73,1,10.22,1.6,0,0,0,0,0,0,0.65638196708466,229.416577718164,80.5180242853287
8.7,"max_tuv_SVM","SVM",91,4,3412,3208,204,500,307,193,0.859100905722173,0.593301435406699,1.62875042956462,346,169,177,91,1,12.78,1.6,0,0,0,0,0,0,0.257991289347847,151.756848685176,75.8424210810786
8.7,"max_tuv_SVM","SVM",91,5,3312,3154,158,600,361,239,0.869426193364972,0.61244019138756,1.62875042956462,408,196,212,62,1.1,15.34,1.5,0,0,0,0,0,0,0.106922603416305,97.8273951146974,48.7522107380117
8.7,"max_tuv_SVM","SVM",91,6,3212,3099,113,700,416,284,0.865557634002791,0.626794258373206,1.60707554008989,460,221,239,52,1.1,17.89,1.5,0,0,0,0,0,0,0.0924885062792808,100.5771591235,29.531430423489
8.7,"max_tuv_SVM","SVM",91,7,3112,3021,91,800,494,306,0.876707301375158,0.636363636363636,1.62725203910504,508,247,261,48,1.1,20.45,1.6,0,0,0,0,0,0,0.0699423724344328,87.157855072983,26.0282169115501
8.7,"max_tuv_SVM","SVM",91,8,3012,2933,79,900,582,318,0.881853512378022,0.631578947368421,1.63887725178048,531,256,275,23,1.1,23.01,1.8,0,0,0,0,0,0,0.052043397009298,71.9377486052172,20.4418904792392
8.7,"max_tuv_SVM","SVM",91,9,2912,2849,63,1000,666,334,0.884971639694025,0.641148325358852,1.63736815670517,548,265,283,17,1.1,25.56,2,0,0,0,0,0,0,0.0515824139813877,79.4261803709174,13.4339045011338
8.7,"max_tuv_SVM","SVM",91,10,2812,2758,54,1100,757,343,0.900322631003797,0.641148325358852,1.66322133812683,570,275,295,22,1.1,28.12,2.2,0,0,0,0,0,0,0.0421137839248201,66.8397732371166,12.1797835086637
8.7,"max_tuv_SVM","SVM",91,11,2712,2668,44,1200,847,353,0.906869739786318,0.641148325358852,1.67183906526739,594,286,308,24,1.1,30.67,2.4,0,0,0,0,0,0,0.055635714603841,79.4356120855948,11.590652732998
8.7,"max_tuv_SVM","SVM",91,12,2612,2572,40,1300,943,357,0.916343259668652,0.641148325358852,1.71335003059208,615,298,317,21,1.1,33.23,2.6,0,0,0,0,0,0,0.0543844635176337,60.3008876660131,11.5699853634302
8.7,"max_tuv_SVM","SVM",91,13,2512,2478,34,1400,1037,363,0.921585328779616,0.645933014354067,1.74238528873503,639,309,330,24,1.1,35.79,2.9,0,0,0,0,0,0,0.0516840881487346,54.0825862750749,11.0958011140829
8.7,"max_tuv_SVM","SVM",91,14,2412,2382,30,1500,1133,367,0.923239565844932,0.641148325358852,1.75101095848125,648,313,335,9,1.1,38.34,3.1,0,0,0,0,0,0,0.0510325137038617,50.7191675214486,10.1402119084273
8.7,"max_tuv_SVM","SVM",91,15,2312,2284,28,1600,1231,369,0.924105027620824,0.645933014354067,1.75101095848125,653,315,338,5,1.1,40.9,3.3,0,0,0,0,0,0,0.0377175274027532,37.6846117496557,8.88767487851714
8.7,"max_tuv_SVM","SVM",91,16,2212,2191,21,1700,1324,376,0.92415432607641,0.645933014354067,1.75101095848125,668,322,346,15,1.1,43.46,3.5,0,0,0,0,0,0,0.0366479553153367,35.5647697784984,8.35419477153051
8.7,"max_tuv_SVM","SVM",91,17,2112,2095,17,1800,1420,380,0.925082780323332,0.645933014354067,1.75101095848125,684,327,357,16,1.1,46.01,3.7,0,0,0,0,0,0,0.0304150114772208,32.6594767184757,7.18348215902118
8.7,"max_tuv_SVM","SVM",91,18,2012,2000,12,1900,1515,385,0.924814377620679,0.645933014354067,1.75101095848125,688,331,357,4,1.1,48.57,3.9,0,0,0,0,0,0,0.024166746384799,24.1843667791203,3.59590832212701
8.7,"max_tuv_SVM","SVM",91,19,1912,1901,11,2000,1614,386,0.925188224242228,0.645933014354067,1.74939860953237,689,334,355,1,1.1,51.12,4.2,0,0,0,0,0,0,0.0199938735806934,19.6709344019449,3.08317295101191
8.7,"max_tuv_SVM","SVM",91,20,1812,1803,9,2100,1712,388,0.924806161211415,0.645933014354067,1.75101095848125,695,336,359,6,1.1,53.68,4.4,0,0,0,0,0,0,0.0168259320085041,15.9239818310421,1.81138128844065
8.7,"max_tuv_SVM","SVM",91,21,1712,1703,9,2200,1812,388,0.924266617003025,0.645933014354067,1.75101095848125,695,337,358,0,1.1,56.24,4.7,0,0,0,0,0,0,0.0162444550717766,15.6070018356607,1.71797881408639
8.7,"max_tuv_SVM","SVM",91,22,1612,1605,7,2300,1910,390,0.92554837684834,0.641148325358852,1.7563990263356,701,340,361,6,1.1,58.79,4.9,0,0,0,0,0,0,0.0127602730513064,11.3261678568906,1.30618327123033
8.7,"max_tuv_SVM","SVM",91,23,1512,1505,7,2400,2010,390,0.924061206771414,0.636363636363636,1.74778922718689,718,350,368,17,1.1,61.35,5.2,0,0,0,0,0,0,0.00912218731711895,7.12593038299012,1.08601415054958
8.7,"max_tuv_SVM","SVM",91,24,1412,1406,6,2500,2109,391,0.923947546443247,0.631578947368421,1.74618280326485,723,351,372,5,1.1,63.91,5.4,0,0,0,0,0,0,0.00717590473072756,5.41019288151566,0.749492097949976
8.7,"max_tuv_SVM","SVM",91,25,1312,1306,6,2600,2209,391,0.92333953215765,0.62200956937799,1.74939860953237,723,353,370,0,1,66.46,5.6,0,0,0,0,0,0,0.00580681547304675,3.99869884672267,0.63380524933896
8.7,"max_tuv_SVM","SVM",91,26,1212,1206,6,2700,2309,391,0.923255998663458,0.62200956937799,1.75101095848125,728,354,374,5,1.1,69.02,5.9,0,0,0,0,0,0,0.00533846790222663,3.13556576907322,0.537811787657638
8.7,"max_tuv_SVM","SVM",91,27,1112,1107,5,2800,2408,392,0.923817453296558,0.617224880382775,1.74939860953237,740,362,378,12,1,71.57,6.1,0,0,0,0,0,0,0.00401488602823955,2.2053259965635,0.46750506857424
8.7,"max_tuv_SVM","SVM",91,28,1012,1008,4,2900,2507,393,0.923979042678768,0.617224880382775,1.74939860953237,745,364,381,5,1,74.13,6.4,0,0,0,0,0,0,0.00377051462279232,1.68545349567917,0.382049727507259
8.7,"max_tuv_SVM","SVM",91,29,912,908,4,3000,2607,393,0.924499415265536,0.61244019138756,1.74778922718689,759,370,389,14,1.1,76.69,6.6,0,0,0,0,0,0,0.00294465228552149,1.24068043955449,0.344753606134081
8.7,"max_tuv_SVM","SVM",91,30,812,809,3,3100,2706,394,0.924562407736566,0.61244019138756,1.75101095848125,760,371,389,1,1,79.24,6.9,0,0,0,0,0,0,0.00237293661736774,0.85378483673214,0.258466356347198
8.7,"max_tuv_SVM","SVM",91,31,712,710,2,3200,2805,395,0.924632247215317,0.61244019138756,1.74939860953237,764,376,388,4,1,81.8,7.1,0,0,0,0,0,0,0.00218840642488475,0.724207700460289,0.247102552399171
8.7,"max_tuv_SVM","SVM",91,32,612,610,2,3300,2905,395,0.924611706192154,0.61244019138756,1.75101095848125,765,376,389,1,1,84.36,7.4,0,0,0,0,0,0,0.00167913964139697,0.494024883646555,0.197095309409915
8.7,"max_tuv_SVM","SVM",91,33,512,510,2,3400,3005,395,0.924849982060832,0.61244019138756,1.74939860953237,764,376,388,-1,1,86.91,7.6,0,0,0,0,0,0,0.000788113367326149,0.250066469853779,0.111415532010401
8.7,"max_tuv_SVM","SVM",91,34,412,412,0,3500,3103,397,0.924978705805983,0.61244019138756,1.7563990263356,770,377,393,6,1,89.47,7.8,0,0,0,0,0,0,0.000741162665464469,0.239195947934596,0.0995453103420454
8.7,"max_tuv_SVM","SVM",91,35,312,312,0,3600,3203,397,0.925295037562672,0.61244019138756,1.75801633667292,774,379,395,4,1,92.02,8.1,0,0,0,0,0,0,0.000688841022047222,0.179573596464359,0.0811410954030496
8.7,"max_tuv_SVM","SVM",91,36,212,212,0,3700,3303,397,0.925522358218996,0.61244019138756,1.75801633667292,779,383,396,5,1,94.58,8.3,0,0,0,0,0,0,0.000368044536653109,0.0742898200471746,0.0449612166048662
8.7,"max_tuv_SVM","SVM",91,37,112,112,0,3800,3403,397,0.925379940458405,0.61244019138756,1.75801633667292,781,383,398,2,1,97.14,8.6,0,0,0,0,0,0,0.000140176843964445,0.0248947166007225,0.0233754903636148
8.7,"max_tuv_SVM","SVM",91,38,12,12,0,3900,3503,397,0.925545638045245,0.607655502392344,1.75801633667292,782,383,399,1,1,99.69,8.8,0,0,0,0,0,0,8.91585967164023e-05,0.00124645496988529,0.00124645496988529
8.7,"max_tuv_SVM","SVM",91,39,0,0,0,3912,3515,397,0.925545638045244,0.607655502392344,1.7563990263356,782,383,399,0,1,100,8.9,0,0,0,0,0,0,0,0,0
8.7,"max_tuv_SVM","SVM",92,0,3812,3415,397,100,87,13,0.908395176252323,0.556122448979592,1.74275960384154,31,13,18,0,1.4,2.56,6.7,0,0,0,0,0,0,0.798974249196387,597.290102958624,82.8880234708005
8.7,"max_tuv_SVM","SVM",92,1,3712,3348,364,200,154,46,0.894428339517616,0.581632653061224,1.73518202129058,107,46,61,76,1.3,5.11,3.3,0,0,0,0,0,0,0.849554100722761,493.281085250276,89.3539386449681
8.7,"max_tuv_SVM","SVM",92,2,3612,3280,332,300,222,78,0.913633464749522,0.596938775510204,1.74596910587439,175,78,97,68,1.2,7.67,2.8,0,0,0,0,0,0,0.553303731797626,482.324565767894,62.8425255514042
8.7,"max_tuv_SVM","SVM",92,3,3512,3231,281,400,271,129,0.903103258348782,0.612244897959184,1.66938025210084,266,127,139,91,1.1,10.22,2.1,0,0,0,0,0,0,0.720309763267421,361.052133184535,82.5674654938682
8.7,"max_tuv_SVM","SVM",92,4,3412,3181,231,500,321,179,0.885549049165112,0.607142857142857,1.6175712043059,364,177,187,98,1.1,12.78,1.8,0,0,0,0,0,0,0.63863602371385,403.144899553339,74.3012733579593
8.7,"max_tuv_SVM","SVM",92,5,3312,3134,178,600,368,232,0.891242462894243,0.63265306122449,1.64337344873552,444,219,225,80,1,15.34,1.6,0,0,0,0,0,0,0.318761053411442,268.388332212219,75.9765575994232
8.7,"max_tuv_SVM","SVM",92,6,3212,3075,137,700,427,273,0.891929499072357,0.647959183673469,1.62202732332602,509,248,261,65,1.1,17.89,1.6,0,0,0,0,0,0,0.133346184821537,154.214147679123,59.3023038853821
8.7,"max_tuv_SVM","SVM",92,7,3112,3009,103,800,493,307,0.894737070964739,0.642857142857143,1.64186299519808,558,267,291,49,1.1,20.45,1.6,0,0,0,0,0,0,0.0744885763002795,104.366973356685,38.6944505267626
8.7,"max_tuv_SVM","SVM",92,8,3012,2927,85,900,575,325,0.897153293135424,0.647959183673469,1.65560048904354,565,270,295,7,1.1,23.01,1.8,0,0,0,0,0,0,0.0567934312182025,89.9604387236573,27.5727988208605
8.7,"max_tuv_SVM","SVM",92,9,2912,2842,70,1000,660,340,0.903116303339512,0.642857142857143,1.65560048904354,577,278,299,12,1.1,25.56,1.9,0,0,0,0,0,0,0.0485140816318328,78.4898054070212,18.0071850338078
8.7,"max_tuv_SVM","SVM",92,10,2812,2752,60,1100,750,350,0.912575371057519,0.647959183673469,1.6831938305276,597,285,312,20,1.1,28.12,2.1,0,0,0,0,0,0,0.0500512989533488,75.6301775295735,14.8001818817543
8.7,"max_tuv_SVM","SVM",92,11,2712,2661,51,1200,841,359,0.924711560760675,0.642857142857143,1.73358718487395,634,304,330,37,1.1,30.67,2.3,0,0,0,0,0,0,0.0619531455959372,73.4875135771412,16.0932899511804
8.7,"max_tuv_SVM","SVM",92,12,2612,2568,44,1300,934,366,0.924991303339525,0.627551020408163,1.74757829399041,646,312,334,12,1.1,33.23,2.6,0,0,0,0,0,0,0.0688916746329567,71.0629284116574,16.4316889705388
8.7,"max_tuv_SVM","SVM",92,13,2512,2470,42,1400,1032,368,0.924512987012993,0.637755102040816,1.74596910587439,660,316,344,14,1.1,35.79,2.8,0,0,0,0,0,0,0.0607684680515002,58.3850896498391,15.4504808738219
8.7,"max_tuv_SVM","SVM",92,14,2412,2373,39,1500,1129,371,0.923431702226351,0.63265306122449,1.74757829399041,668,322,346,8,1.1,38.34,3,0,0,0,0,0,0,0.0500936556882586,46.8468888852246,14.8192915214366
8.7,"max_tuv_SVM","SVM",92,15,2312,2276,36,1600,1226,374,0.922849025974033,0.627551020408163,1.74757829399041,680,327,353,12,1.1,40.9,3.3,0,0,0,0,0,0,0.0419940078140681,42.7805259486155,14.0037085919631
8.7,"max_tuv_SVM","SVM",92,16,2212,2182,30,1700,1320,380,0.9226026205937,0.627551020408163,1.74596910587439,697,333,364,17,1.1,43.46,3.5,0,0,0,0,0,0,0.0332346362957196,39.1593304654539,13.1855986465321
8.7,"max_tuv_SVM","SVM",92,17,2112,2091,21,1800,1411,389,0.921622796846016,0.622448979591837,1.73838051349572,699,336,363,2,1.1,46.01,3.6,0,0,0,0,0,0,0.0266285043996478,29.8469895430881,6.73558129284105
8.7,"max_tuv_SVM","SVM",92,18,2012,1993,19,1900,1509,391,0.921712662337666,0.627551020408163,1.73838051349572,702,339,363,3,1.1,48.57,3.9,0,0,0,0,0,0,0.0219682947915801,24.8351191018576,5.23208465277593
8.7,"max_tuv_SVM","SVM",92,19,1912,1898,14,2000,1604,396,0.923275162337669,0.627551020408163,1.74757829399041,705,342,363,3,1.1,51.12,4.1,0,0,0,0,0,0,0.0183032428505508,19.1616207775357,2.03498684806102
8.7,"max_tuv_SVM","SVM",92,20,1812,1801,11,2100,1701,399,0.924553571428581,0.61734693877551,1.74757829399041,715,347,368,10,1.1,53.68,4.3,0,0,0,0,0,0,0.017266327203661,17.3765853251538,1.77540184907975
8.7,"max_tuv_SVM","SVM",92,21,1712,1704,8,2200,1798,402,0.925639204545448,0.607142857142857,1.76110444177671,744,362,382,29,1.1,56.24,4.5,0,0,0,0,0,0,0.0113539405277628,8.53071594731381,1.4580806171396
8.7,"max_tuv_SVM","SVM",92,22,1612,1607,5,2300,1895,405,0.925658047309828,0.607142857142857,1.76110444177671,752,365,387,8,1.1,58.79,4.7,0,0,0,0,0,0,0.00901051690607058,8.03477375833915,1.06240606037753
8.7,"max_tuv_SVM","SVM",92,23,1512,1507,5,2400,1995,405,0.925227562615952,0.607142857142857,1.75465350975555,756,367,389,4,1.1,61.35,4.9,0,0,0,0,0,0,0.00728895936812512,6.34349728131807,0.771243801398993
8.7,"max_tuv_SVM","SVM",92,24,1412,1407,5,2500,2095,405,0.924321660482376,0.607142857142857,1.76597385497978,763,369,394,7,1.1,63.91,5.2,0,0,0,0,0,0,0.00631178837641115,5.10504267015151,0.67832923455968
8.7,"max_tuv_SVM","SVM",92,25,1312,1307,5,2600,2195,405,0.924118738404456,0.607142857142857,1.75948726598077,765,370,395,2,1.1,66.46,5.4,0,0,0,0,0,0,0.00551002003899477,4.0753310955829,0.572413039394607
8.7,"max_tuv_SVM","SVM",92,26,1212,1207,5,2700,2295,405,0.923930310760675,0.612244897959184,1.76110444177671,769,374,395,4,1.1,69.02,5.7,0,0,0,0,0,0,0.00351034883243231,2.36882461583747,0.386680573563672
8.7,"max_tuv_SVM","SVM",92,27,1112,1107,5,2800,2395,405,0.923904220779228,0.612244897959184,1.76434772804149,770,374,396,1,1.1,71.57,5.9,0,0,0,0,0,0,0.00331702305860661,1.93375284900188,0.33619422233141
8.7,"max_tuv_SVM","SVM",92,28,1012,1008,4,2900,2494,406,0.923625927643794,0.607142857142857,1.76110444177671,781,381,400,11,1,74.13,6.1,0,0,0,0,0,0,0.00276507248575011,1.48950670879244,0.311241795504172
8.7,"max_tuv_SVM","SVM",92,29,912,909,3,3000,2593,407,0.923767973098339,0.612244897959184,1.75948726598077,786,383,403,5,1.1,76.69,6.4,0,0,0,0,0,0,0.00280330195118489,1.27323938455704,0.289202914607686
8.7,"max_tuv_SVM","SVM",92,30,812,809,3,3100,2693,407,0.923999884044526,0.607142857142857,1.76434772804149,794,387,407,8,1.1,79.24,6.6,0,0,0,0,0,0,0.00205707983185161,0.821209055344353,0.226412654760861
8.7,"max_tuv_SVM","SVM",92,31,712,709,3,3200,2793,407,0.924401379870119,0.607142857142857,1.76110444177671,794,387,407,0,1.1,81.8,6.9,0,0,0,0,0,0,0.00156765143785515,0.534015518396432,0.172645000796152
8.7,"max_tuv_SVM","SVM",92,32,612,610,2,3300,2892,408,0.925028988868259,0.607142857142857,1.76434772804149,797,389,408,3,1,84.36,7.1,0,0,0,0,0,0,0.00135853042788843,0.42735914269157,0.159022039308392
8.7,"max_tuv_SVM","SVM",92,33,512,511,1,3400,2991,409,0.92553484461965,0.612244897959184,1.76434772804149,801,390,411,4,1.1,86.91,7.3,0,0,0,0,0,0,0.00100291675059936,0.315072200464399,0.124996926620675
8.7,"max_tuv_SVM","SVM",92,34,412,412,0,3500,3090,410,0.925843576066773,0.612244897959184,1.76110444177671,806,393,413,5,1.1,89.47,7.5,0,0,0,0,0,0,0.000786006190249015,0.240212828259883,0.098361415693165
8.7,"max_tuv_SVM","SVM",92,35,312,312,0,3600,3190,410,0.926153756957308,0.612244897959184,1.75787305747987,807,395,412,1,1,92.02,7.8,0,0,0,0,0,0,0.00041939741394282,0.109716132264752,0.0521488046123616
8.7,"max_tuv_SVM","SVM",92,36,212,212,0,3700,3290,410,0.926211734693857,0.61734693877551,1.76272459305709,808,395,413,1,1,94.58,8,0,0,0,0,0,0,0.000233886022142445,0.0484894137694422,0.0300326972875941
8.7,"max_tuv_SVM","SVM",92,37,112,112,0,3800,3390,410,0.9263639262523,0.612244897959184,1.76110444177671,813,397,416,5,1,97.14,8.3,0,0,0,0,0,0,0.000114353531707565,0.0191763546269896,0.0179454396728234
8.7,"max_tuv_SVM","SVM",92,38,12,12,0,3900,3490,410,0.926623376623359,0.612244897959184,1.76597385497978,817,400,417,4,1,99.69,8.5,0,0,0,0,0,0,7.56774586272422e-05,0.00116391791332905,0.00116391791332905
8.7,"max_tuv_SVM","SVM",92,39,0,0,0,3912,3502,410,0.926701646567701,0.612244897959184,1.76597385497978,818,400,418,1,1,100,8.5,0,0,0,0,0,0,0,0,0
8.7,"max_tuv_SVM","SVM",93,0,3812,3425,387,100,88,12,0.917208729349833,0.618357487922705,1.74729010839566,30,12,18,0,1.5,2.56,7.3,0,0,0,0,0,0,0.458904577690195,470.960141296528,50.8877196557188
8.7,"max_tuv_SVM","SVM",93,1,3712,3406,306,200,107,93,0.914140033090005,0.608695652173913,1.72121115155394,80,41,39,50,1,5.11,1.2,0,0,0,0,0,0,0.677019664779296,358.999024339273,74.8657863986913
8.7,"max_tuv_SVM","SVM",93,2,3612,3343,269,300,170,130,0.917705907861778,0.632850241545894,1.72121115155394,184,92,92,104,1,7.67,1.3,0,0,0,0,0,0,0.564996050949853,293.073936637562,69.3498479461408
8.7,"max_tuv_SVM","SVM",93,3,3512,3289,223,400,224,176,0.888988324591283,0.623188405797101,1.68488917306053,256,127,129,72,1,10.22,1.3,0,0,0,0,0,0,0.491746625169306,307.377081209947,66.7965104813243
8.7,"max_tuv_SVM","SVM",93,4,3412,3234,178,500,279,221,0.878463331703692,0.642512077294686,1.60968318787199,348,168,180,92,1.1,12.78,1.3,0,0,0,0,0,0,0.263870727860278,213.087230479467,59.9247558900507
8.7,"max_tuv_SVM","SVM",93,5,3312,3165,147,600,348,252,0.897208342655438,0.652173913043478,1.68083884325119,401,196,205,53,1,15.34,1.4,0,0,0,0,0,0,0.112165981118301,117.490126790569,40.9571020636086
8.7,"max_tuv_SVM","SVM",93,6,3212,3109,103,700,404,296,0.895070475054073,0.657004830917874,1.67059011930499,467,228,239,66,1,17.89,1.4,0,0,0,0,0,0,0.107431051326282,123.231375722311,16.4708466467916
8.7,"max_tuv_SVM","SVM",93,7,3112,3031,81,800,482,318,0.894609203879103,0.666666666666667,1.64297428102876,517,246,271,50,1.1,20.45,1.5,0,0,0,0,0,0,0.0981936286786997,141.323277819628,14.1955304609506
8.7,"max_tuv_SVM","SVM",93,8,3012,2947,65,900,566,334,0.895733379736673,0.676328502415459,1.65471181459961,552,264,288,35,1.1,23.01,1.7,0,0,0,0,0,0,0.0785333545204341,128.21000563326,11.779325847029
8.7,"max_tuv_SVM","SVM",93,9,2912,2856,56,1000,657,343,0.907626994583508,0.666666666666667,1.69669308991913,574,278,296,22,1.1,25.56,1.9,0,0,0,0,0,0,0.0597560766498349,88.0515792462115,7.54811996078406
8.7,"max_tuv_SVM","SVM",93,10,2812,2765,47,1100,748,352,0.913745052383286,0.671497584541063,1.68954785280171,599,288,311,25,1.1,28.12,2.1,0,0,0,0,0,0,0.0567517443338076,86.5251375086676,6.34675414989876
8.7,"max_tuv_SVM","SVM",93,11,2712,2668,44,1200,845,355,0.923301928224004,0.666666666666667,1.70696587190276,625,300,325,26,1.1,30.67,2.4,0,0,0,0,0,0,0.0439257755273611,56.5966389566995,5.15797386064761
8.7,"max_tuv_SVM","SVM",93,12,2612,2575,37,1300,938,362,0.929798394113429,0.657004830917874,1.74180191010486,642,307,335,17,1.1,33.23,2.6,0,0,0,0,0,0,0.0513285594200913,66.2037286039262,5.91858518087997
8.7,"max_tuv_SVM","SVM",93,13,2512,2480,32,1400,1033,367,0.935937167684533,0.652173913043478,1.77500200176155,658,318,340,16,1.1,35.79,2.8,0,0,0,0,0,0,0.0528421356554578,56.7644317205358,5.91553814112677
8.7,"max_tuv_SVM","SVM",93,14,2412,2381,31,1500,1132,368,0.936485445099097,0.652173913043478,1.77173913043478,668,321,347,10,1.1,38.34,3.1,0,0,0,0,0,0,0.0419821451866366,43.8212280398286,4.62889458079674
8.7,"max_tuv_SVM","SVM",93,15,2312,2283,29,1600,1230,370,0.937540568385556,0.652173913043478,1.77336906523739,671,323,348,3,1.1,40.9,3.3,0,0,0,0,0,0,0.0357493067094212,38.0939464424242,3.97856877335168
8.7,"max_tuv_SVM","SVM",93,16,2212,2185,27,1700,1328,372,0.938327767696131,0.652173913043478,1.76467607962348,680,327,353,9,1.1,43.46,3.6,0,0,0,0,0,0,0.0313373647135791,32.9028457154618,3.49538861425239
8.7,"max_tuv_SVM","SVM",93,17,2112,2092,20,1800,1421,379,0.937581999928205,0.652173913043478,1.76630101155684,704,338,366,24,1.1,46.01,3.7,0,0,0,0,0,0,0.0366613609223763,33.5472461744314,4.73788962425707
8.7,"max_tuv_SVM","SVM",93,18,2012,1999,13,1900,1514,386,0.93586397195915,0.652173913043478,1.75659606094389,723,347,376,19,1.1,48.57,3.9,0,0,0,0,0,0,0.0319556255323015,30.3780479078538,3.76058127365883
8.7,"max_tuv_SVM","SVM",93,19,1912,1900,12,2000,1613,387,0.935158254682474,0.652173913043478,1.76630101155684,729,349,380,6,1.1,51.12,4.2,0,0,0,0,0,0,0.0234582460248866,22.4459423859161,2.52118601979019
8.7,"max_tuv_SVM","SVM",93,20,1812,1802,10,2100,1711,389,0.936670505989646,0.652173913043478,1.76848823294775,736,351,385,7,1.1,53.68,4.4,0,0,0,0,0,0,0.0230292719754632,20.4236256202173,2.33799484260565
8.7,"max_tuv_SVM","SVM",93,21,1712,1702,10,2200,1811,389,0.933832445317298,0.652173913043478,1.78042412617221,757,366,391,21,1.1,56.24,4.7,0,0,0,0,0,0,0.0162132561429129,10.231360464823,2.0875527749243
8.7,"max_tuv_SVM","SVM",93,22,1612,1605,7,2300,1908,392,0.934192899738457,0.652173913043478,1.78042412617221,759,368,391,2,1.1,58.79,4.9,0,0,0,0,0,0,0.01292709460084,9.8652503347158,1.53672159164418
8.7,"max_tuv_SVM","SVM",93,23,1512,1507,5,2400,2006,394,0.934478777382825,0.652173913043478,1.78042412617221,768,371,397,9,1.1,61.35,5.1,0,0,0,0,0,0,0.01103328261733,8.67096522738741,1.20047369585674
8.7,"max_tuv_SVM","SVM",93,24,1412,1407,5,2500,2106,394,0.934395914297501,0.652173913043478,1.77715729291318,766,371,395,-2,1.1,63.91,5.3,0,0,0,0,0,0,0.0105834789542724,7.61322728679014,1.07705567083814
8.7,"max_tuv_SVM","SVM",93,25,1312,1307,5,2600,2206,394,0.934735652947328,0.657004830917874,1.78042412617221,774,378,396,8,1,66.46,5.6,0,0,0,0,0,0,0.00757438933628647,5.00335234458573,0.860121795391144
8.7,"max_tuv_SVM","SVM",93,26,1212,1207,5,2700,2306,394,0.934721842433107,0.657004830917874,1.78042412617221,775,378,397,1,1.1,69.02,5.9,0,0,0,0,0,0,0.00656282510657484,3.69262602432106,0.664818440093935
8.7,"max_tuv_SVM","SVM",93,27,1112,1107,5,2800,2406,394,0.935535281720705,0.652173913043478,1.78370299196626,781,380,401,6,1.1,71.57,6.1,0,0,0,0,0,0,0.00527213107218652,2.63722437035009,0.563241884998203
8.7,"max_tuv_SVM","SVM",93,28,1012,1008,4,2900,2505,395,0.935587761674743,0.647342995169082,1.7820620508513,788,382,406,7,1.1,74.13,6.3,0,0,0,0,0,0,0.00525135091288311,2.31025922956698,0.551872471253583
8.7,"max_tuv_SVM","SVM",93,29,912,908,4,3000,2605,395,0.935695483685665,0.647342995169082,1.7820620508513,793,384,409,5,1.1,76.69,6.6,0,0,0,0,0,0,0.00404734210856365,1.57856016930453,0.446493021648392
8.7,"max_tuv_SVM","SVM",93,30,812,810,2,3100,2703,397,0.935511803846531,0.652173913043478,1.78370299196626,799,386,413,6,1.1,79.24,6.8,0,0,0,0,0,0,0.00346579102918307,1.26284785737755,0.393127566741373
8.7,"max_tuv_SVM","SVM",93,31,712,710,2,3200,2803,397,0.935549092234926,0.647342995169082,1.78534695785748,797,386,411,-2,1.1,81.8,7.1,0,0,0,0,0,0,0.00250997905710239,0.792913601913587,0.285974245513391
8.7,"max_tuv_SVM","SVM",93,32,612,610,2,3300,2903,397,0.935543568029238,0.647342995169082,1.78534695785748,798,386,412,1,1.1,84.36,7.3,0,0,0,0,0,0,0.00163468415372143,0.521871897715745,0.209212226385769
8.7,"max_tuv_SVM","SVM",93,33,512,510,2,3400,3003,397,0.935625050063139,0.642512077294686,1.78370299196626,799,388,411,1,1.1,86.91,7.6,0,0,0,0,0,0,0.000977208189761982,0.301911038573899,0.130894281954765
8.7,"max_tuv_SVM","SVM",93,34,412,411,1,3500,3102,398,0.93551318489795,0.647342995169082,1.78534695785748,804,390,414,5,1.1,89.47,7.8,0,0,0,0,0,0,0.000641805587211506,0.18726626906531,0.081585135527787
8.7,"max_tuv_SVM","SVM",93,35,312,312,0,3600,3201,399,0.936050413901133,0.647342995169082,1.78042412617221,804,392,412,0,1.1,92.02,8,0,0,0,0,0,0,0.000537721688580146,0.134230628342739,0.0668351814761821
8.7,"max_tuv_SVM","SVM",93,36,212,212,0,3700,3301,399,0.936065605466775,0.647342995169082,1.78042412617221,808,394,414,4,1.1,94.58,8.3,0,0,0,0,0,0,0.000288489968036066,0.06049843938341,0.0385789382758793
8.7,"max_tuv_SVM","SVM",93,37,112,112,0,3800,3401,399,0.936243761100221,0.647342995169082,1.78370299196626,811,395,416,3,1.1,97.14,8.5,0,0,0,0,0,0,0.000108741536829562,0.0178055095769817,0.0167107449466107
8.7,"max_tuv_SVM","SVM",93,38,12,12,0,3900,3501,399,0.936435727247888,0.647342995169082,1.78042412617221,811,396,415,0,1,99.69,8.8,0,0,0,0,0,0,7.7058262025548e-05,0.00108198348312077,0.00108198348312077
8.7,"max_tuv_SVM","SVM",93,39,0,0,0,3912,3513,399,0.936449537762108,0.647342995169082,1.78370299196626,813,396,417,2,1.1,100,8.8,0,0,0,0,0,0,0,0,0
8.7,"max_tuv_SVM","SVM",94,0,3812,3425,387,100,87,13,0.910846047156727,0.597087378640777,1.75254754072053,31,13,18,0,1.4,2.56,6.7,0,0,0,0,0,0,0.904025346192065,614.76774697557,92.6619801801258
8.7,"max_tuv_SVM","SVM",94,1,3712,3352,360,200,160,40,0.878822468793337,0.611650485436893,1.66078096660621,100,40,60,69,1.5,5.11,4,0,0,0,0,0,0,0.708552179884518,594.29016970506,78.3030046446777
8.7,"max_tuv_SVM","SVM",94,2,3612,3294,318,300,218,82,0.886676837725374,0.597087378640777,1.60713809857966,183,82,101,83,1.2,7.67,2.7,0,0,0,0,0,0,0.729120484289235,560.372570268024,82.3340611996017
8.7,"max_tuv_SVM","SVM",94,3,3512,3236,276,400,276,124,0.883345353675446,0.611650485436893,1.65094988433472,268,124,144,85,1.2,10.22,2.2,0,0,0,0,0,0,0.685426582338926,466.968595491099,79.5595006523074
8.7,"max_tuv_SVM","SVM",94,4,3412,3199,213,500,313,187,0.908447988904294,0.635922330097087,1.6961862361208,343,167,176,75,1.1,12.78,1.7,0,0,0,0,0,0,0.633415447041354,313.669411897582,81.391070877675
8.7,"max_tuv_SVM","SVM",94,5,3312,3152,160,600,360,240,0.90424133148404,0.669902912621359,1.65968506890792,419,206,213,76,1,15.34,1.5,0,0,0,0,0,0,0.210879531514645,256.490586507207,67.1516405080108
8.7,"max_tuv_SVM","SVM",94,6,3212,3080,132,700,432,268,0.903758668515942,0.679611650485437,1.64524182363205,490,236,254,71,1.1,17.89,1.6,0,0,0,0,0,0,0.135519436759872,235.446358202093,51.381588307224
8.7,"max_tuv_SVM","SVM",94,7,3112,3013,99,800,499,301,0.906285714285702,0.699029126213592,1.64943246716162,534,258,276,44,1.1,20.45,1.7,0,0,0,0,0,0,0.120133302994121,219.568178107572,36.7305611246205
8.7,"max_tuv_SVM","SVM",94,8,3012,2927,85,900,585,315,0.92233009708737,0.694174757281553,1.70650082770346,554,270,284,20,1.1,23.01,1.9,0,0,0,0,0,0,0.0946373111654976,170.526885615418,32.8670007728895
8.7,"max_tuv_SVM","SVM",94,9,2912,2841,71,1000,671,329,0.929414701803043,0.679611650485437,1.71209617634712,598,289,309,44,1.1,25.56,2,0,0,0,0,0,0,0.100133747191727,159.793683756106,30.4297030449431
8.7,"max_tuv_SVM","SVM",94,10,2812,2751,61,1100,761,339,0.933287101248257,0.679611650485437,1.739902376227,617,298,319,19,1.1,28.12,2.2,0,0,0,0,0,0,0.0888810280768998,144.063798552608,26.7183649902409
8.7,"max_tuv_SVM","SVM",94,11,2712,2662,50,1200,850,350,0.934811373092914,0.674757281553398,1.7367040262707,640,306,334,23,1.1,30.67,2.4,0,0,0,0,0,0,0.073917554162859,107.502209684297,20.8103727735037
8.7,"max_tuv_SVM","SVM",94,12,2612,2569,43,1300,943,357,0.936550624133132,0.674757281553398,1.75738883226948,646,309,337,6,1.1,33.23,2.6,0,0,0,0,0,0,0.0627759690375261,86.7334087174841,17.4169617847174
8.7,"max_tuv_SVM","SVM",94,13,2512,2474,38,1400,1038,362,0.936277392510387,0.674757281553398,1.74703691463992,658,315,343,12,1.1,35.79,2.9,0,0,0,0,0,0,0.0578327136987095,75.8257339932759,15.1416487319536
8.7,"max_tuv_SVM","SVM",94,14,2412,2380,32,1500,1132,368,0.937148404993048,0.679611650485437,1.74543118218161,677,323,354,19,1.1,38.34,3.1,0,0,0,0,0,0,0.0542246994414744,72.268722052798,14.9208263343215
8.7,"max_tuv_SVM","SVM",94,15,2312,2289,23,1600,1223,377,0.937636615811358,0.679611650485437,1.74703691463992,690,328,362,13,1.1,40.9,3.2,0,0,0,0,0,0,0.0476130027756881,62.4659290817135,11.6773820595144
8.7,"max_tuv_SVM","SVM",94,16,2212,2189,23,1700,1323,377,0.937400832177516,0.674757281553398,1.74543118218161,694,330,364,4,1.1,43.46,3.5,0,0,0,0,0,0,0.0385378911906546,51.7266631094762,10.5383509377209
8.7,"max_tuv_SVM","SVM",94,17,2112,2093,19,1800,1419,381,0.936565880721205,0.66504854368932,1.74864560424824,695,331,364,1,1.1,46.01,3.7,0,0,0,0,0,0,0.0323113581266281,40.5345156703996,7.14162717996501
8.7,"max_tuv_SVM","SVM",94,18,2012,1997,15,1900,1515,385,0.935841886269056,0.660194174757282,1.74703691463992,695,333,362,0,1.1,48.57,3.9,0,0,0,0,0,0,0.0285881893864166,32.4482241032402,3.96089260995763
8.7,"max_tuv_SVM","SVM",94,19,1912,1899,13,2000,1613,387,0.936515950069333,0.66504854368932,1.74703691463992,703,337,366,8,1.1,51.12,4.2,0,0,0,0,0,0,0.025495870042864,26.8379880204583,2.62794603664743
8.7,"max_tuv_SVM","SVM",94,20,1812,1800,12,2100,1712,388,0.936404993065184,0.640776699029126,1.76126668271417,725,350,375,22,1.1,53.68,4.4,0,0,0,0,0,0,0.0172891491410623,13.6641005778642,2.11066352154953
8.7,"max_tuv_SVM","SVM",94,21,1712,1702,10,2200,1810,390,0.936743411927873,0.645631067961165,1.76288549400343,727,352,375,2,1.1,56.24,4.6,0,0,0,0,0,0,0.0133589662593196,11.6654649831582,1.48779357159652
8.7,"max_tuv_SVM","SVM",94,22,1612,1604,8,2300,1908,392,0.93756449375867,0.640776699029126,1.76450728378632,733,354,379,6,1.1,58.79,4.9,0,0,0,0,0,0,0.0130816610307548,11.6663655309698,1.44054047760269
8.7,"max_tuv_SVM","SVM",94,23,1512,1505,7,2400,2007,393,0.938049930651873,0.640776699029126,1.76450728378632,735,355,380,2,1.1,61.35,5.1,0,0,0,0,0,0,0.0113249896081161,9.7100280225361,1.18805821975543
8.7,"max_tuv_SVM","SVM",94,24,1412,1405,7,2500,2107,393,0.937370319001385,0.635922330097087,1.7699858247078,744,360,384,9,1.1,63.91,5.4,0,0,0,0,0,0,0.00873550146373535,6.85968717034103,0.97825034051753
8.7,"max_tuv_SVM","SVM",94,25,1312,1306,6,2600,2206,394,0.937427184466019,0.635922330097087,1.77161264991433,747,361,386,3,1.1,66.46,5.6,0,0,0,0,0,0,0.00961827898680048,6.79277545920616,0.97849594350412
8.7,"max_tuv_SVM","SVM",94,26,1212,1207,5,2700,2305,395,0.937001386962549,0.631067961165049,1.76836198450165,765,373,392,18,1.1,69.02,5.8,0,0,0,0,0,0,0.0068671139285987,4.30211213188283,0.798176022180197
8.7,"max_tuv_SVM","SVM",94,27,1112,1107,5,2800,2405,395,0.936976421636613,0.631067961165049,1.7699858247078,764,372,392,-1,1.1,71.57,6.1,0,0,0,0,0,0,0.00652769982999564,3.55184047951452,0.666413302152606
8.7,"max_tuv_SVM","SVM",94,28,1012,1007,5,2900,2505,395,0.936782246879328,0.631067961165049,1.77870496670144,770,374,396,6,1.1,74.13,6.3,0,0,0,0,0,0,0.00503156844755778,2.38076269243512,0.542821814889946
8.7,"max_tuv_SVM","SVM",94,29,912,908,4,3000,2604,396,0.937126213592215,0.635922330097087,1.78361851633321,774,376,398,4,1.1,76.69,6.6,0,0,0,0,0,0,0.00435558805583518,1.7540140881885,0.456363024484759
8.7,"max_tuv_SVM","SVM",94,30,812,808,4,3100,2704,396,0.937273231622726,0.631067961165049,1.78197765293272,778,379,399,4,1.1,79.24,6.8,0,0,0,0,0,0,0.00341869583351927,1.15443651613017,0.371311138366843
8.7,"max_tuv_SVM","SVM",94,31,712,709,3,3200,2803,397,0.937514563106774,0.62621359223301,1.77870496670144,779,381,398,1,1,81.8,7.1,0,0,0,0,0,0,0.00271609009635535,0.851807205937049,0.324927883920601
8.7,"max_tuv_SVM","SVM",94,32,612,611,1,3300,2901,399,0.937442441054066,0.631067961165049,1.77870496670144,785,383,402,6,1,84.36,7.3,0,0,0,0,0,0,0.0020639193918897,0.650469355367266,0.258739097271537
8.7,"max_tuv_SVM","SVM",94,33,512,511,1,3400,3001,399,0.937441054091512,0.631067961165049,1.77707312728244,788,385,403,3,1,86.91,7.5,0,0,0,0,0,0,0.00125748245926438,0.401171825137962,0.171335348706992
8.7,"max_tuv_SVM","SVM",94,34,412,412,0,3500,3100,400,0.937434119278755,0.631067961165049,1.78033980582524,797,388,409,9,1.1,89.47,7.8,0,0,0,0,0,0,0.000896175628167372,0.259592997139505,0.114035540808092
8.7,"max_tuv_SVM","SVM",94,35,312,312,0,3600,3200,400,0.937445214979172,0.631067961165049,1.77870496670144,798,389,409,1,1.1,92.02,8,0,0,0,0,0,0,0.000549890430473153,0.134853771598131,0.0689430914464887
8.7,"max_tuv_SVM","SVM",94,36,212,212,0,3700,3300,400,0.937389736477092,0.62621359223301,1.78033980582524,802,391,411,4,1.1,94.58,8.2,0,0,0,0,0,0,0.000261669494080449,0.0557278239274913,0.0355739369167101
8.7,"max_tuv_SVM","SVM",94,37,112,112,0,3800,3400,400,0.93752565880719,0.631067961165049,1.78197765293272,802,391,411,0,1.1,97.14,8.5,0,0,0,0,0,0,0.000111973402827878,0.0187501687550836,0.0176042871257309
8.7,"max_tuv_SVM","SVM",94,38,12,12,0,3900,3500,400,0.937583911234375,0.631067961165049,1.78197765293272,804,392,412,2,1.1,99.69,8.8,0,0,0,0,0,0,7.23549619345378e-05,0.00117233890976687,0.00117233890976687
8.7,"max_tuv_SVM","SVM",94,39,0,0,0,3912,3512,400,0.937520110956982,0.631067961165049,1.79071283750592,804,392,412,0,1.1,100,8.8,0,0,0,0,0,0,0,0,0
8.7,"max_tuv_SVM","SVM",95,0,3812,3429,383,100,90,10,0.909682997583901,0.539906103286385,1.77737392094502,23,10,13,0,1.3,2.56,9,0,0,0,0,0,0,0.384416132806947,327.666479908062,43.0270325578251
8.7,"max_tuv_SVM","SVM",95,1,3712,3372,340,200,147,53,0.881163823637956,0.511737089201878,1.72868247132012,110,53,57,87,1.1,5.11,2.8,0,0,0,0,0,0,0.685891493625236,403.72613346887,74.6884484716937
8.7,"max_tuv_SVM","SVM",95,2,3612,3317,295,300,202,98,0.903687183341018,0.572769953051643,1.72659180891802,180,88,92,70,1,7.67,2.1,0,0,0,0,0,0,0.697847693094124,218.983665674705,81.3385108193372
8.7,"max_tuv_SVM","SVM",95,3,3512,3267,245,400,252,148,0.891628216420342,0.591549295774648,1.70338467905689,261,127,134,81,1.1,10.22,1.7,0,0,0,0,0,0,0.670463699036255,201.579981964425,82.8138640450254
8.7,"max_tuv_SVM","SVM",95,4,3412,3214,198,500,305,195,0.899630716023048,0.60093896713615,1.69807066872255,340,164,176,79,1.1,12.78,1.6,0,0,0,0,0,0,0.283264173180554,147.005535187864,77.360000699244
8.7,"max_tuv_SVM","SVM",95,5,3312,3158,154,600,361,239,0.874451528447792,0.615023474178404,1.62898715824358,408,198,210,68,1.1,15.34,1.5,0,0,0,0,0,0,0.1727806163071,134.07977235602,61.4768557674896
8.7,"max_tuv_SVM","SVM",95,6,3212,3083,129,700,436,264,0.874637382528109,0.629107981220657,1.60514142814569,459,221,238,51,1.1,17.89,1.7,0,0,0,0,0,0,0.100220102691996,111.3543901086,49.6589822735315
8.7,"max_tuv_SVM","SVM",95,7,3112,3007,105,800,512,288,0.878338302909833,0.633802816901408,1.61358954092541,489,237,252,30,1.1,20.45,1.8,0,0,0,0,0,0,0.0646335751986868,93.9424761679749,31.3326130659789
8.7,"max_tuv_SVM","SVM",95,8,3012,2933,79,900,586,314,0.878402947807328,0.63849765258216,1.59669331536598,525,251,274,36,1.1,23.01,1.9,0,0,0,0,0,0,0.0686749831623808,102.056482933804,17.7567964702283
8.7,"max_tuv_SVM","SVM",95,9,2912,2846,66,1000,673,327,0.883474878723494,0.652582159624413,1.61656389952619,560,268,292,35,1.1,25.56,2.1,0,0,0,0,0,0,0.0658323711010875,95.4395363652174,15.8099906599811
8.7,"max_tuv_SVM","SVM",95,10,2812,2750,62,1100,769,331,0.888933332255931,0.657276995305164,1.64044302648302,571,271,300,11,1.1,28.12,2.3,0,0,0,0,0,0,0.0474584470707343,68.8050009199145,13.5120813214615
8.7,"max_tuv_SVM","SVM",95,11,2712,2657,55,1200,862,338,0.888802695692242,0.652582159624413,1.63349127020186,577,275,302,6,1.1,30.67,2.6,0,0,0,0,0,0,0.0419103935773606,58.7331873806853,8.12703370992195
8.7,"max_tuv_SVM","SVM",95,12,2612,2558,54,1300,961,339,0.894515688508575,0.647887323943662,1.64738199204426,583,278,305,6,1.1,33.23,2.8,0,0,0,0,0,0,0.0307362678806383,41.2729128029716,7.09059299646058
8.7,"max_tuv_SVM","SVM",95,13,2512,2466,46,1400,1053,347,0.898292027937371,0.643192488262911,1.65583010482398,596,284,312,13,1.1,35.79,3,0,0,0,0,0,0,0.0273256962489987,33.8493395429754,2.80163338551594
8.7,"max_tuv_SVM","SVM",95,14,2412,2369,43,1500,1150,350,0.911657360494972,0.629107981220657,1.68427338222886,618,301,317,22,1.1,38.34,3.3,0,0,0,0,0,0,0.0233712700423829,21.0593624418949,2.70203625101855
8.7,"max_tuv_SVM","SVM",95,15,2312,2276,36,1600,1243,357,0.91440207510121,0.643192488262911,1.70120075290452,633,308,325,15,1.1,40.9,3.5,0,0,0,0,0,0,0.0262881962654512,28.9888598948534,3.14652130875521
8.7,"max_tuv_SVM","SVM",95,16,2212,2181,31,1700,1338,362,0.918493558405315,0.652582159624413,1.71812812358019,653,315,338,20,1.1,43.46,3.7,0,0,0,0,0,0,0.0258666090568779,28.1860296777336,2.9969761384701
8.7,"max_tuv_SVM","SVM",95,17,2112,2090,22,1800,1429,371,0.921060499543438,0.652582159624413,1.74351917959369,682,330,352,29,1.1,46.01,3.9,0,0,0,0,0,0,0.0764138528889617,46.8791589107098,9.03244394089653
8.7,"max_tuv_SVM","SVM",95,18,2012,1990,22,1900,1529,371,0.922878637285559,0.652582159624413,1.74031123262112,694,335,359,12,1.1,48.57,4.1,0,0,0,0,0,0,0.0549473073939494,32.2127395382503,6.06305550633845
8.7,"max_tuv_SVM","SVM",95,19,1912,1892,20,2000,1627,373,0.923892754115048,0.643192488262911,1.74191372915208,704,340,364,10,1.1,51.12,4.4,0,0,0,0,0,0,0.0438093369833517,23.2755819497186,4.87774960754817
8.7,"max_tuv_SVM","SVM",95,20,1812,1800,12,2100,1719,381,0.923102200889401,0.647887323943662,1.74031123262112,724,352,372,20,1.1,53.68,4.5,0,0,0,0,0,0,0.0352553243228888,19.2666296110033,4.85779522222443
8.7,"max_tuv_SVM","SVM",95,21,1712,1706,6,2200,1813,387,0.922723758885309,0.647887323943662,1.73871168185584,739,359,380,15,1.1,56.24,4.7,0,0,0,0,0,0,0.021765317943324,15.9951551749135,3.05768004897764
8.7,"max_tuv_SVM","SVM",95,22,1612,1607,5,2300,1912,388,0.922797831163692,0.643192488262911,1.72868247132012,739,358,381,0,1.1,58.79,4.9,0,0,0,0,0,0,0.0159445276757443,11.88528443921,1.78322083854747
8.7,"max_tuv_SVM","SVM",95,23,1512,1507,5,2400,2012,388,0.923243611602679,0.643192488262911,1.73871168185584,740,358,382,1,1.1,61.35,5.2,0,0,0,0,0,0,0.0121613638171903,9.40425578458748,1.32328366321688
8.7,"max_tuv_SVM","SVM",95,24,1412,1407,5,2500,2112,388,0.923646295443336,0.643192488262911,1.74191372915208,740,358,382,0,1.1,63.91,5.4,0,0,0,0,0,0,0.0115829715259644,8.52900374172532,1.19013450999191
8.7,"max_tuv_SVM","SVM",95,25,1312,1307,5,2600,2212,388,0.924687347646779,0.643192488262911,1.74715202982601,750,363,387,10,1.1,66.46,5.7,0,0,0,0,0,0,0.0087804830456676,5.98267968081545,0.960521502213752
8.7,"max_tuv_SVM","SVM",95,26,1212,1207,5,2700,2312,388,0.925186998833689,0.647887323943662,1.75198286493152,754,367,387,4,1.1,69.02,6,0,0,0,0,0,0,0.00667234955766804,4.10622029656591,0.712203958303197
8.7,"max_tuv_SVM","SVM",95,27,1112,1107,5,2800,2412,388,0.925340530465247,0.647887323943662,1.75720745818055,749,368,381,-5,1,71.57,6.2,0,0,0,0,0,0,0.00580292096731494,3.16326762534854,0.607476638122321
8.7,"max_tuv_SVM","SVM",95,28,1012,1007,5,2900,2512,388,0.925840181652156,0.647887323943662,1.76728140481934,755,371,384,6,1,74.13,6.5,0,0,0,0,0,0,0.00459621289969218,2.19104257118445,0.492392575119978
8.7,"max_tuv_SVM","SVM",95,29,912,907,5,3000,2612,388,0.926434106647922,0.647887323943662,1.76241286100441,756,372,384,1,1,76.69,6.7,0,0,0,0,0,0,0.00417290956646583,1.59536296664509,0.424603632163783
8.7,"max_tuv_SVM","SVM",95,30,812,808,4,3100,2711,389,0.926754637598017,0.63849765258216,1.76728140481934,767,375,392,11,1,79.24,7,0,0,0,0,0,0,0.00374274460302577,1.24535277544304,0.425994458977034
8.7,"max_tuv_SVM","SVM",95,31,712,709,3,3200,2810,390,0.926910862766967,0.643192488262911,1.75720745818055,772,377,395,5,1,81.8,7.2,0,0,0,0,0,0,0.00241611992395577,0.670213936410092,0.28528373397231
8.7,"max_tuv_SVM","SVM",95,32,612,610,2,3300,2909,391,0.927073821779412,0.643192488262911,1.74916163648558,780,378,402,8,1.1,84.36,7.4,0,0,0,0,0,0,0.00165577378463233,0.493380122031467,0.228783966354631
8.7,"max_tuv_SVM","SVM",95,33,512,511,1,3400,3008,392,0.927665053237776,0.63849765258216,1.76079596847138,787,383,404,7,1.1,86.91,7.7,0,0,0,0,0,0,0.000994107349514112,0.326886557736912,0.139050669080986
8.7,"max_tuv_SVM","SVM",95,34,412,412,0,3500,3107,393,0.927989624493961,0.633802816901408,1.76728140481934,790,385,405,3,1.1,89.47,7.9,0,0,0,0,0,0,0.000687907769545242,0.197945394319057,0.0880921072486674
8.7,"max_tuv_SVM","SVM",95,35,312,312,0,3600,3207,393,0.928477154762586,0.629107981220657,1.76403272576636,794,386,408,4,1.1,92.02,8.2,0,0,0,0,0,0,0.000524842978833504,0.13432007244826,0.0684318145225619
8.7,"max_tuv_SVM","SVM",95,36,212,212,0,3700,3307,393,0.928658968536796,0.624413145539906,1.76403272576636,797,387,410,3,1.1,94.58,8.4,0,0,0,0,0,0,0.000235601376646698,0.0494913136335738,0.0318280326662955
8.7,"max_tuv_SVM","SVM",95,37,112,112,0,3800,3407,393,0.928900040133712,0.624413145539906,1.76403272576636,796,388,408,-1,1.1,97.14,8.7,0,0,0,0,0,0,8.27773953459921e-05,0.0149314373399,0.0140339084425986
8.7,"max_tuv_SVM","SVM",95,38,12,12,0,3900,3507,393,0.929073773295734,0.619718309859155,1.76241286100441,796,389,407,0,1,99.69,8.9,0,0,0,0,0,0,8.41719147112585e-05,0.00116782230451476,0.00116782230451476
8.7,"max_tuv_SVM","SVM",95,39,0,0,0,3912,3519,393,0.929022596085216,0.619718309859155,1.76241286100441,797,390,407,1,1,100,9,0,0,0,0,0,0,0,0,0
8.7,"max_tuv_SVM","SVM",96,0,3812,3403,409,100,85,15,0.919583235254031,0.56043956043956,1.76007158440827,33,15,18,0,1.2,2.56,5.7,0,0,0,0,0,0,0.711796019922025,691.247811832627,73.9796822003437
8.7,"max_tuv_SVM","SVM",96,1,3712,3379,333,200,109,91,0.921069910923356,0.565934065934066,1.75828215901745,90,47,43,57,0.9,5.11,1.2,0,0,0,0,0,0,0.683049143313035,468.581380512988,72.8575619302969
8.7,"max_tuv_SVM","SVM",96,2,3612,3308,304,300,180,120,0.919834111773237,0.604395604395604,1.75162406654119,187,95,92,97,1,7.67,1.5,0,0,0,0,0,0,0.612959480777907,337.480577321651,70.5531228581364
8.7,"max_tuv_SVM","SVM",96,3,3512,3254,258,400,234,166,0.916681120457904,0.593406593406593,1.76978679094594,276,136,140,89,1,10.22,1.4,0,0,0,0,0,0,0.618907878491936,325.657791132309,73.074024806828
8.7,"max_tuv_SVM","SVM",96,4,3412,3195,217,500,293,207,0.91360401154652,0.593406593406593,1.77141642887499,360,180,180,84,1,12.78,1.4,0,0,0,0,0,0,0.38155908834352,272.885111569992,68.3892413281798
8.7,"max_tuv_SVM","SVM",96,5,3312,3151,161,600,337,263,0.923581773356301,0.615384615384615,1.73852617970265,424,211,213,64,1,15.34,1.3,0,0,0,0,0,0,0.186278639620411,136.576728145762,44.5252678785415
8.7,"max_tuv_SVM","SVM",96,6,3212,3083,129,700,405,295,0.924239937064072,0.620879120879121,1.74840416936005,487,241,246,63,1,17.89,1.4,0,0,0,0,0,0,0.134840276602748,133.830158750373,34.9311617556421
8.7,"max_tuv_SVM","SVM",96,7,3112,3012,100,800,476,324,0.920574352366905,0.642857142857143,1.70371195624652,532,260,272,45,1,20.45,1.5,0,0,0,0,0,0,0.101857864679963,131.193084615344,29.2527415318521
8.7,"max_tuv_SVM","SVM",96,8,3012,2929,83,900,559,341,0.921306849858149,0.653846153846154,1.70889221073045,578,279,299,46,1.1,23.01,1.6,0,0,0,0,0,0,0.0930566915035532,129.259635405993,25.5707696421142
8.7,"max_tuv_SVM","SVM",96,9,2912,2840,72,1000,648,352,0.925975940632093,0.648351648351648,1.75162406654119,618,296,322,40,1.1,25.56,1.8,0,0,0,0,0,0,0.0808806252322374,104.197715162266,23.389440289589
8.7,"max_tuv_SVM","SVM",96,10,2812,2752,60,1100,736,364,0.928918319560937,0.642857142857143,1.75323846660252,652,310,342,34,1.1,28.12,2,0,0,0,0,0,0,0.0938237099252279,110.184856611432,22.4637298256289
8.7,"max_tuv_SVM","SVM",96,11,2712,2658,54,1200,830,370,0.929556351202354,0.653846153846154,1.76152024770809,667,318,349,15,1.1,30.67,2.2,0,0,0,0,0,0,0.083644329679363,93.790965957186,20.9126820707897
8.7,"max_tuv_SVM","SVM",96,12,2612,2563,49,1300,925,375,0.930460745567859,0.648351648351648,1.76152024770809,675,321,354,8,1.1,33.23,2.5,0,0,0,0,0,0,0.0642488726963888,67.4799269601144,16.5508103308427
8.7,"max_tuv_SVM","SVM",96,13,2512,2465,47,1400,1023,377,0.931179305474693,0.642857142857143,1.75828215901745,674,322,352,-1,1.1,35.79,2.7,0,0,0,0,0,0,0.0515025582432632,52.3247417056462,15.5601839757055
8.7,"max_tuv_SVM","SVM",96,14,2412,2374,38,1500,1114,386,0.932195200515388,0.653846153846154,1.76152024770809,700,333,367,26,1.1,38.34,2.9,0,0,0,0,0,0,0.0489928309449596,52.610097148564,14.5265283413216
8.7,"max_tuv_SVM","SVM",96,15,2312,2280,32,1600,1208,392,0.933864613402387,0.659340659340659,1.75989971390155,708,340,368,8,1.1,40.9,3.1,0,0,0,0,0,0,0.0392010655126557,44.923406580241,13.6480253182163
8.7,"max_tuv_SVM","SVM",96,16,2212,2184,28,1700,1304,396,0.93439733885056,0.659340659340659,1.76314376867372,723,344,379,15,1.1,43.46,3.3,0,0,0,0,0,0,0.0324516286042839,40.5144579673975,11.9223596312649
8.7,"max_tuv_SVM","SVM",96,17,2112,2094,18,1800,1394,406,0.934307518862204,0.664835164835165,1.76314376867372,724,347,377,1,1.1,46.01,3.4,0,0,0,0,0,0,0.0275071666061686,29.1269387424813,3.93476974977648
8.7,"max_tuv_SVM","SVM",96,18,2012,1996,16,1900,1492,408,0.934329199549051,0.664835164835165,1.75989971390155,732,352,380,8,1.1,48.57,3.7,0,0,0,0,0,0,0.0200492441849947,20.1992149338096,2.20637139514674
8.7,"max_tuv_SVM","SVM",96,19,1912,1899,13,2000,1589,411,0.934756618803979,0.659340659340659,1.76314376867372,741,358,383,9,1.1,51.12,3.9,0,0,0,0,0,0,0.0196052603808423,19.8032211780029,2.0928452029053
8.7,"max_tuv_SVM","SVM",96,20,1812,1799,13,2100,1689,411,0.934837147069404,0.659340659340659,1.76314376867372,744,360,384,3,1.1,53.68,4.1,0,0,0,0,0,0,0.0166990706322294,16.9677816754934,1.79899599030938
8.7,"max_tuv_SVM","SVM",96,21,1712,1702,10,2200,1786,414,0.935244434257981,0.664835164835165,1.76152024770809,760,366,394,16,1.1,56.24,4.3,0,0,0,0,0,0,0.0162706522617831,14.2835772041517,1.64466225771997
8.7,"max_tuv_SVM","SVM",96,22,1612,1603,9,2300,1885,415,0.935261469083359,0.642857142857143,1.76653649380922,788,383,405,28,1.1,58.79,4.5,0,0,0,0,0,0,0.011463160178137,6.98989877661756,1.58080279641224
8.7,"max_tuv_SVM","SVM",96,23,1512,1505,7,2400,1983,417,0.934967231190473,0.642857142857143,1.76653649380922,796,386,410,8,1.1,61.35,4.8,0,0,0,0,0,0,0.00841608670505717,6.1422361976411,1.05496899782385
8.7,"max_tuv_SVM","SVM",96,24,1412,1406,6,2500,2082,418,0.935167003233538,0.648351648351648,1.77141642887499,796,387,409,0,1.1,63.91,5,0,0,0,0,0,0,0.00649737631295415,4.95872544912316,0.730680036709129
8.7,"max_tuv_SVM","SVM",96,25,1312,1307,5,2600,2181,419,0.935639332482642,0.648351648351648,1.77141642887499,798,389,409,2,1.1,66.46,5.2,0,0,0,0,0,0,0.00605244840381402,4.36032156053462,0.631378931289538
8.7,"max_tuv_SVM","SVM",96,26,1212,1207,5,2700,2281,419,0.93683177025907,0.637362637362637,1.77141642887499,804,396,408,6,1,69.02,5.4,0,0,0,0,0,0,0.00463058362130956,3.11269737281398,0.520877987172458
8.7,"max_tuv_SVM","SVM",96,27,1112,1110,2,2800,2378,422,0.937661830841105,0.631868131868132,1.76978679094594,814,400,414,10,1,71.57,5.6,0,0,0,0,0,0,0.00556807831808949,3.26552168787444,0.572242407093928
8.7,"max_tuv_SVM","SVM",96,28,1012,1010,2,2900,2478,422,0.938354064199624,0.631868131868132,1.76491581812683,818,401,417,4,1,74.13,5.9,0,0,0,0,0,0,0.00385026756867388,2.06795513639436,0.436219928066602
8.7,"max_tuv_SVM","SVM",96,29,912,910,2,3000,2578,422,0.938327737651314,0.626373626373626,1.76816014867485,817,401,416,-1,1,76.69,6.1,0,0,0,0,0,0,0.00348413320266155,1.62736395810613,0.362836948697044
8.7,"max_tuv_SVM","SVM",96,30,812,810,2,3100,2678,422,0.938575516929528,0.626373626373626,1.7632981134356,828,405,423,11,1,79.24,6.3,0,0,0,0,0,0,0.00287198070734085,1.15695105832975,0.311852984568013
8.7,"max_tuv_SVM","SVM",96,31,712,710,2,3200,2778,422,0.938860463099477,0.626373626373626,1.7632981134356,826,404,422,-2,1,81.8,6.6,0,0,0,0,0,0,0.00229936950324801,0.823445413822608,0.256351309697182
8.7,"max_tuv_SVM","SVM",96,32,612,611,1,3300,2877,423,0.939538758873597,0.631868131868132,1.76653649380922,831,406,425,5,1,84.36,6.8,0,0,0,0,0,0,0.00207280733146339,0.697319316818072,0.241611658122171
8.7,"max_tuv_SVM","SVM",96,33,512,511,1,3400,2977,423,0.939678134717593,0.631868131868132,1.76653649380922,833,408,425,2,1,86.91,7,0,0,0,0,0,0,0.00136872685489285,0.425265850778952,0.166616468952915
8.7,"max_tuv_SVM","SVM",96,34,412,412,0,3500,3076,424,0.940012636743187,0.626373626373626,1.76816014867485,836,409,427,3,1,89.47,7.3,0,0,0,0,0,0,0.00110766930815946,0.319345159697191,0.134500259651726
8.7,"max_tuv_SVM","SVM",96,35,312,312,0,3600,3176,424,0.940201568442828,0.626373626373626,1.76978679094594,836,410,426,0,1,92.02,7.5,0,0,0,0,0,0,0.000667610662511456,0.171581726165641,0.0856286555639322
8.7,"max_tuv_SVM","SVM",96,36,212,212,0,3700,3276,424,0.940350236009759,0.626373626373626,1.76978679094594,838,412,426,2,1,94.58,7.7,0,0,0,0,0,0,0.000424627220550247,0.0851381642981562,0.0528265967029083
8.7,"max_tuv_SVM","SVM",96,37,112,112,0,3800,3376,424,0.940605758390422,0.631868131868132,1.77141642887499,845,413,432,7,1,97.14,8,0,0,0,0,0,0,0.00019415656364835,0.0319283726276312,0.0298923365137707
8.7,"max_tuv_SVM","SVM",96,38,12,12,0,3900,3476,424,0.940550008052824,0.631868131868132,1.77141642887499,844,413,431,-1,1,99.69,8.2,0,0,0,0,0,0,9.72065067892824e-05,0.00154117325347555,0.00154117325347555
8.7,"max_tuv_SVM","SVM",96,39,0,0,0,3912,3488,424,0.940553105293801,0.631868131868132,1.77141642887499,845,413,432,1,1,100,8.2,0,0,0,0,0,0,0,0,0
8.7,"max_tuv_SVM","SVM",97,0,3812,3412,400,100,92,8,0.819646981763023,0.44949494949495,1.58424801005446,26,8,18,0,2.2,2.56,11.5,0,0,0,0,0,0,0.401973299866205,349.744387489009,52.6301469661184
8.7,"max_tuv_SVM","SVM",97,1,3712,3342,370,200,162,38,0.869586076923965,0.535353535353535,1.65251782531194,85,38,47,59,1.2,5.11,4.3,0,0,0,0,0,0,0.385354890609906,451.191199481129,44.5365248650429
8.7,"max_tuv_SVM","SVM",97,2,3612,3326,286,300,178,122,0.867490318428879,0.505050505050505,1.65251782531194,131,67,64,46,1,7.67,1.5,0,0,0,0,0,0,0.602936432561049,292.855351116183,73.113674523244
8.7,"max_tuv_SVM","SVM",97,3,3512,3270,242,400,234,166,0.885279128026575,0.575757575757576,1.71923656454043,225,112,113,94,1,10.22,1.4,0,0,0,0,0,0,0.622412618462979,327.107893654481,75.6242398362234
8.7,"max_tuv_SVM","SVM",97,4,3412,3221,191,500,283,217,0.893031567093005,0.611111111111111,1.7085668088428,312,154,158,87,1,12.78,1.3,0,0,0,0,0,0,0.54530069206471,285.891803100487,71.8792311475984
8.7,"max_tuv_SVM","SVM",97,5,3312,3153,159,600,351,249,0.83983751048597,0.641414141414141,1.53730676935097,398,194,204,86,1.1,15.34,1.4,0,0,0,0,0,0,0.302663183899085,264.862317754499,62.1094329045473
8.7,"max_tuv_SVM","SVM",97,6,3212,3085,127,700,419,281,0.843277772032028,0.641414141414141,1.53448083778966,461,225,236,63,1,17.89,1.5,0,0,0,0,0,0,0.131959729082601,145.868327280586,43.6076719344034
8.7,"max_tuv_SVM","SVM",97,7,3112,3019,93,800,485,315,0.840449431746368,0.656565656565657,1.53589250369379,513,245,268,52,1.1,20.45,1.5,0,0,0,0,0,0,0.0920826305914993,133.557629886628,26.8525431253831
8.7,"max_tuv_SVM","SVM",97,8,3012,2929,83,900,575,325,0.853901644430649,0.651515151515151,1.55264037433155,543,259,284,30,1.1,23.01,1.8,0,0,0,0,0,0,0.0694904166207709,109.838361938364,19.7008475551238
8.7,"max_tuv_SVM","SVM",97,9,2912,2851,61,1000,653,347,0.860137208260074,0.651515151515151,1.54782851557045,586,279,307,43,1.1,25.56,1.9,0,0,0,0,0,0,0.0694380997220743,116.9554422443,14.0419537555616
8.7,"max_tuv_SVM","SVM",97,10,2812,2761,51,1100,743,357,0.870623182909873,0.646464646464647,1.58424801005446,608,289,319,22,1.1,28.12,2.1,0,0,0,0,0,0,0.0608484476599805,93.3424090434051,10.90299492401
8.7,"max_tuv_SVM","SVM",97,11,2712,2665,47,1200,839,361,0.898544604176004,0.641414141414141,1.64494995957737,640,313,327,32,1,30.67,2.3,0,0,0,0,0,0,0.0579224392399414,57.4202092396177,11.0278403179869
8.7,"max_tuv_SVM","SVM",97,12,2612,2575,37,1300,929,371,0.899190999873599,0.651515151515151,1.66312620222464,645,318,327,5,1,33.23,2.5,0,0,0,0,0,0,0.0412482191001415,41.9622607434212,4.57583337546856
8.7,"max_tuv_SVM","SVM",97,13,2512,2481,31,1400,1023,377,0.906755265970276,0.646464646464647,1.69194709526201,665,324,341,20,1.1,35.79,2.7,0,0,0,0,0,0,0.0350969014474447,42.5068412605345,4.07753844057366
8.7,"max_tuv_SVM","SVM",97,14,2412,2387,25,1500,1117,383,0.912990829799691,0.646464646464647,1.71014007478096,682,333,349,17,1,38.34,2.9,0,0,0,0,0,0,0.0508026879369888,47.5114879357668,6.05538698269217
8.7,"max_tuv_SVM","SVM",97,15,2312,2289,23,1600,1215,385,0.916820365199193,0.651515151515151,1.7283330542999,693,341,352,11,1,40.9,3.2,0,0,0,0,0,0,0.0442501570350037,37.0574561520605,4.98975959195266
8.7,"max_tuv_SVM","SVM",97,16,2212,2194,18,1700,1310,390,0.919476333298841,0.646464646464647,1.7647190133378,715,349,366,22,1,43.46,3.4,0,0,0,0,0,0,0.0465031236465594,32.8049779505058,5.28999771041472
8.7,"max_tuv_SVM","SVM",97,17,2112,2099,13,1800,1405,395,0.919884280805763,0.646464646464647,1.75400741546096,729,355,374,14,1.1,46.01,3.6,0,0,0,0,0,0,0.0455177814718157,28.9453762162975,5.34557107638294
8.7,"max_tuv_SVM","SVM",97,18,2012,2003,9,1900,1501,399,0.919430367382567,0.636363636363636,1.75562252357832,741,360,381,12,1.1,48.57,3.8,0,0,0,0,0,0,0.034989666587158,22.9594770715631,4.22836517850889
8.7,"max_tuv_SVM","SVM",97,19,1912,1906,6,2000,1598,402,0.918804081773349,0.641414141414141,1.75239527629233,745,363,382,4,1.1,51.12,4,0,0,0,0,0,0,0.0231598651705999,19.2495800954251,3.05300776285866
8.7,"max_tuv_SVM","SVM",97,20,1812,1806,6,2100,1698,402,0.918870157777992,0.641414141414141,1.75400741546096,743,363,380,-2,1,53.68,4.2,0,0,0,0,0,0,0.016985218746123,14.703157029548,1.90049049152104
8.7,"max_tuv_SVM","SVM",97,21,1712,1706,6,2200,1798,402,0.918982199698908,0.641414141414141,1.75400741546096,746,363,383,3,1.1,56.24,4.5,0,0,0,0,0,0,0.0135960994279862,12.1064283924732,1.46525346852887
8.7,"max_tuv_SVM","SVM",97,22,1612,1607,5,2300,1897,403,0.919352799898859,0.641414141414141,1.75078609789354,748,364,384,2,1.1,58.79,4.7,0,0,0,0,0,0,0.0133223863858125,10.9069095056094,1.35470918475763
8.7,"max_tuv_SVM","SVM",97,23,1512,1507,5,2400,1997,403,0.921073648889337,0.646464646464647,1.75985752845257,764,371,393,16,1.1,61.35,5,0,0,0,0,0,0,0.00920845501451716,6.75386708154142,1.21731008760243
8.7,"max_tuv_SVM","SVM",97,24,1412,1408,4,2500,2096,404,0.92145286769859,0.646464646464647,1.7647190133378,770,372,398,6,1.1,63.91,5.2,0,0,0,0,0,0,0.00720004070577676,5.2375140801781,0.77658415435249
8.7,"max_tuv_SVM","SVM",97,25,1312,1308,4,2600,2196,404,0.921721481021812,0.641414141414141,1.7647190133378,772,376,396,2,1.1,66.46,5.4,0,0,0,0,0,0,0.00684845810442359,4.49282166112371,0.708123835268258
8.7,"max_tuv_SVM","SVM",97,26,1212,1208,4,2700,2296,404,0.92209495409153,0.641414141414141,1.7647190133378,783,380,403,11,1.1,69.02,5.7,0,0,0,0,0,0,0.00545975568930761,3.20176499076678,0.571911298804138
8.7,"max_tuv_SVM","SVM",97,27,1112,1108,4,2800,2396,404,0.922306110019411,0.646464646464647,1.76309553678459,784,381,403,1,1.1,71.57,5.9,0,0,0,0,0,0,0.00493685390634996,2.5345045231193,0.511432465349897
8.7,"max_tuv_SVM","SVM",97,28,1012,1008,4,2900,2496,404,0.922205559577564,0.646464646464647,1.75663139182846,781,382,399,-3,1,74.13,6.2,0,0,0,0,0,0,0.00404983539933571,1.80696289177556,0.425505438420046
8.7,"max_tuv_SVM","SVM",97,29,912,908,4,3000,2596,404,0.922426770549628,0.646464646464647,1.75985752845257,787,383,404,6,1.1,76.69,6.4,0,0,0,0,0,0,0.00335198281189208,1.28249567966305,0.357142126948118
8.7,"max_tuv_SVM","SVM",97,30,812,808,4,3100,2696,404,0.922498592293805,0.646464646464647,1.76309553678459,788,383,405,1,1.1,79.24,6.7,0,0,0,0,0,0,0.00276106561206066,0.921918018631361,0.30381509911666
8.7,"max_tuv_SVM","SVM",97,31,712,710,2,3200,2794,406,0.923173716689064,0.646464646464647,1.75663139182846,794,386,408,6,1.1,81.8,6.9,0,0,0,0,0,0,0.00250035498466338,0.85153577285685,0.300484388219894
8.7,"max_tuv_SVM","SVM",97,32,612,610,2,3300,2894,406,0.92326564852161,0.646464646464647,1.75502275502276,797,386,411,3,1.1,84.36,7.1,0,0,0,0,0,0,0.00168988771389135,0.524751420992512,0.203795054937904
8.7,"max_tuv_SVM","SVM",97,33,512,510,2,3400,2994,406,0.923381999747176,0.646464646464647,1.75502275502276,799,387,412,2,1.1,86.91,7.4,0,0,0,0,0,0,0.00103692483918268,0.322012255591573,0.134668526625774
8.7,"max_tuv_SVM","SVM",97,34,412,412,0,3500,3092,408,0.923857459693626,0.646464646464647,1.77381550309727,806,391,415,7,1.1,89.47,7.6,0,0,0,0,0,0,0.000953636274248177,0.276028501722595,0.116897706563901
8.7,"max_tuv_SVM","SVM",97,35,312,312,0,3600,3192,408,0.924331483205193,0.646464646464647,1.76730608840701,806,392,414,0,1.1,92.02,7.8,0,0,0,0,0,0,0.000650684801406123,0.161061582439081,0.0805962401651073
8.7,"max_tuv_SVM","SVM",97,36,212,212,0,3700,3292,408,0.924794015237692,0.641414141414141,1.7689289590116,807,394,413,1,1,94.58,8.1,0,0,0,0,0,0,0.000356976467571896,0.0732753710468754,0.0461391244666104
8.7,"max_tuv_SVM","SVM",97,37,112,112,0,3800,3392,408,0.925611346686425,0.641414141414141,1.77055481283422,807,395,412,0,1,97.14,8.3,0,0,0,0,0,0,0.000173690335081545,0.0284250092513411,0.0265896610810395
8.7,"max_tuv_SVM","SVM",97,38,12,12,0,3900,3492,408,0.926167246986354,0.636363636363636,1.7689289590116,816,398,418,9,1.1,99.69,8.6,0,0,0,0,0,0,0.00012859705353231,0.00182498681172062,0.00182498681172062
8.7,"max_tuv_SVM","SVM",97,39,0,0,0,3912,3504,408,0.926241941600298,0.636363636363636,1.7689289590116,816,398,418,0,1.1,100,8.6,0,0,0,0,0,0,0,0,0
8.7,"max_tuv_SVM","SVM",98,0,3812,3394,418,100,90,10,0.911916558183037,0.539325842696629,1.76063070333354,25,10,15,0,1.5,2.56,9,0,0,0,0,0,0,0.663450197251427,384.11375887368,72.2488268248342
8.7,"max_tuv_SVM","SVM",98,1,3712,3368,344,200,116,84,0.913534333489203,0.556179775280899,1.74890172932409,87,45,42,62,0.9,5.11,1.4,0,0,0,0,0,0,0.697520731286386,287.472825322223,79.4506558942389
8.7,"max_tuv_SVM","SVM",98,2,3612,3308,304,300,176,124,0.914027249402826,0.561797752808989,1.74199761818464,185,92,93,98,1,7.67,1.4,0,0,0,0,0,0,0.657364167491813,265.827497732738,76.1852192167712
8.7,"max_tuv_SVM","SVM",98,3,3512,3244,268,400,240,160,0.899047029233695,0.589887640449438,1.74039356881246,270,134,136,85,1,10.22,1.5,0,0,0,0,0,0,0.678024042516891,178.099134363461,79.7105749251493
8.7,"max_tuv_SVM","SVM",98,4,3412,3199,213,500,285,215,0.902443725433195,0.578651685393258,1.76063070333354,350,175,175,80,1,12.78,1.3,0,0,0,0,0,0,0.267078344993753,165.512808838826,66.3399853018392
8.7,"max_tuv_SVM","SVM",98,5,3312,3145,167,600,339,261,0.886144323251717,0.595505617977528,1.6695635979887,404,203,201,54,1,15.34,1.3,0,0,0,0,0,0,0.158686733661581,110.872406248738,50.6766275974597
8.7,"max_tuv_SVM","SVM",98,6,3212,3064,148,700,420,280,0.896585609383102,0.612359550561798,1.68123025941076,445,216,229,41,1.1,17.89,1.5,0,0,0,0,0,0,0.107479578398907,101.013572680932,42.5056083259963
8.7,"max_tuv_SVM","SVM",98,7,3112,3001,111,800,483,317,0.889981800027808,0.634831460674157,1.64071868689484,506,243,263,61,1.1,20.45,1.5,0,0,0,0,0,0,0.0825674173959542,100.681036202354,30.6286322526069
8.7,"max_tuv_SVM","SVM",98,8,3012,2911,101,900,573,327,0.896256998774017,0.623595505617977,1.66496424923391,538,255,283,32,1.1,23.01,1.8,0,0,0,0,0,0,0.0674313148637899,102.434595269674,28.5698106258591
8.7,"max_tuv_SVM","SVM",98,9,2912,2826,86,1000,658,342,0.902042441324046,0.640449438202247,1.67968216524924,563,273,290,25,1.1,25.56,1.9,0,0,0,0,0,0,0.0590696822398211,95.1819379336327,24.8409121843764
8.7,"max_tuv_SVM","SVM",98,10,2812,2738,74,1100,746,354,0.913572250097945,0.640449438202247,1.70846469512006,580,277,303,17,1.1,28.12,2.1,0,0,0,0,0,0,0.0464836612629053,76.6513493131307,18.8896911730073
8.7,"max_tuv_SVM","SVM",98,11,2712,2649,63,1200,835,365,0.917641966102553,0.646067415730337,1.71003786703085,591,281,310,11,1.1,30.67,2.3,0,0,0,0,0,0,0.0428405282047104,69.0795031656469,11.9104935007548
8.7,"max_tuv_SVM","SVM",98,12,2612,2557,55,1300,927,373,0.923192009706646,0.629213483146067,1.71699438202247,621,299,322,30,1.1,33.23,2.5,0,0,0,0,0,0,0.0366097695272732,56.5661899613441,9.5588653578516
8.7,"max_tuv_SVM","SVM",98,13,2512,2467,45,1400,1017,383,0.926977351145704,0.623595505617977,1.72709434897555,640,313,327,19,1,35.79,2.7,0,0,0,0,0,0,0.0291827566456191,35.0624990907863,4.35544085062829
8.7,"max_tuv_SVM","SVM",98,14,2412,2373,39,1500,1111,389,0.928065873788237,0.617977528089888,1.72550840375151,653,319,334,13,1,38.34,2.9,0,0,0,0,0,0,0.0330800950092596,41.8242309086892,3.6640928004787
8.7,"max_tuv_SVM","SVM",98,15,2312,2279,33,1600,1205,395,0.935074126970084,0.612359550561798,1.74890172932409,676,327,349,23,1.1,40.9,3.1,0,0,0,0,0,0,0.0514133103512991,42.1531385858823,6.03046642524395
8.7,"max_tuv_SVM","SVM",98,16,2212,2183,29,1700,1301,399,0.936393308982435,0.606741573033708,1.75739424983477,693,336,357,17,1.1,43.46,3.3,0,0,0,0,0,0,0.0511546219577434,35.5655941563594,5.71410004539629
8.7,"max_tuv_SVM","SVM",98,17,2112,2086,26,1800,1398,402,0.936309576471468,0.612359550561798,1.75739424983477,707,343,364,14,1.1,46.01,3.5,0,0,0,0,0,0,0.0433742555874218,29.1133830740578,5.08919629703576
8.7,"max_tuv_SVM","SVM",98,18,2012,1994,18,1900,1490,410,0.934856106469823,0.617977528089888,1.7622534044426,724,350,374,17,1.1,48.57,3.6,0,0,0,0,0,0,0.0402348727954914,25.9916232633671,4.89223288769529
8.7,"max_tuv_SVM","SVM",98,19,1912,1901,11,2000,1583,417,0.934130951327702,0.617977528089888,1.76063070333354,746,360,386,22,1.1,51.12,3.8,0,0,0,0,0,0,0.0288053494731906,23.5037519631369,4.09015952575325
8.7,"max_tuv_SVM","SVM",98,20,1812,1803,9,2100,1681,419,0.934299996208328,0.612359550561798,1.75901098787509,757,364,393,11,1.1,53.68,4,0,0,0,0,0,0,0.0238971517712891,21.2795405983599,2.73348745680767
8.7,"max_tuv_SVM","SVM",98,21,1712,1703,9,2200,1781,419,0.934217843556059,0.612359550561798,1.75578048101031,752,362,390,-5,1.1,56.24,4.3,0,0,0,0,0,0,0.0169615145860718,14.3610703128739,1.74673355015801
8.7,"max_tuv_SVM","SVM",98,22,1612,1603,9,2300,1881,419,0.932091353749309,0.606741573033708,1.76587117342991,770,372,398,18,1.1,58.79,4.5,0,0,0,0,0,0,0.0135209030617053,9.93060371358161,1.8236529032417
8.7,"max_tuv_SVM","SVM",98,23,1512,1505,7,2400,1979,421,0.93243576294535,0.606741573033708,1.7691202464261,773,374,399,3,1.1,61.35,4.7,0,0,0,0,0,0,0.00969745468761257,7.57237641301902,1.10094657707406
8.7,"max_tuv_SVM","SVM",98,24,1412,1406,6,2500,2078,422,0.932581109945515,0.606741573033708,1.76587117342991,774,375,399,1,1.1,63.91,4.9,0,0,0,0,0,0,0.00903978511426993,6.23028849583705,0.920061957222142
8.7,"max_tuv_SVM","SVM",98,25,1312,1306,6,2600,2178,422,0.931704288368439,0.601123595505618,1.76749421678784,791,387,404,17,1,66.46,5.2,0,0,0,0,0,0,0.00622170722944706,3.92463840524179,0.763845021553997
8.7,"max_tuv_SVM","SVM",98,26,1212,1207,5,2700,2277,423,0.932328332553927,0.601123595505618,1.76425110813318,793,388,405,2,1,69.02,5.4,0,0,0,0,0,0,0.00538221527872889,3.20812292000161,0.57434158353709
8.7,"max_tuv_SVM","SVM",98,27,1112,1108,4,2800,2376,424,0.932928678858954,0.601123595505618,1.76263401270868,800,393,407,7,1,71.57,5.6,0,0,0,0,0,0,0.00570247161962429,3.0025028967392,0.588674038033798
8.7,"max_tuv_SVM","SVM",98,28,1012,1008,4,2900,2476,424,0.933164077804873,0.606741573033708,1.77074927059408,803,395,408,3,1,74.13,5.8,0,0,0,0,0,0,0.00423179014102551,1.98745822315077,0.47185642005071
8.7,"max_tuv_SVM","SVM",98,29,912,909,3,3000,2575,425,0.933056647413447,0.606741573033708,1.77074927059408,805,396,409,2,1,76.69,6.1,0,0,0,0,0,0,0.00414567544749727,1.69651967527392,0.439090637265438
8.7,"max_tuv_SVM","SVM",98,30,812,810,2,3100,2674,426,0.933151438935292,0.601123595505618,1.76425110813318,813,400,413,8,1,79.24,6.3,0,0,0,0,0,0,0.0033938728378838,1.25628246429582,0.371093445079815
8.7,"max_tuv_SVM","SVM",98,31,712,711,1,3200,2773,427,0.933423174631251,0.601123595505618,1.77074927059408,814,402,412,1,1,81.8,6.5,0,0,0,0,0,0,0.00316088183777275,1.1064979821508,0.355955745223322
8.7,"max_tuv_SVM","SVM",98,32,612,611,1,3300,2873,427,0.933661733294564,0.601123595505618,1.7691202464261,812,400,412,-2,1,84.36,6.7,0,0,0,0,0,0,0.00222805447003915,0.693937590987581,0.259893455853473
8.7,"max_tuv_SVM","SVM",98,33,512,511,1,3400,2973,427,0.933794441425148,0.595505617977528,1.77074927059408,811,400,411,-1,1,86.91,7,0,0,0,0,0,0,0.00143580109027262,0.446013427355087,0.182691458212986
8.7,"max_tuv_SVM","SVM",98,34,412,412,0,3500,3072,428,0.934391628012777,0.595505617977528,1.7691202464261,820,404,416,9,1,89.47,7.2,0,0,0,0,0,0,0.00100951362188084,0.293271564065103,0.127723140967697
8.7,"max_tuv_SVM","SVM",98,35,312,312,0,3600,3172,428,0.935042529796117,0.595505617977528,1.7691202464261,824,405,419,4,1,92.02,7.4,0,0,0,0,0,0,0.000590182222956916,0.152850151168745,0.0771286526674725
8.7,"max_tuv_SVM","SVM",98,36,212,212,0,3700,3272,428,0.935369560546484,0.589887640449438,1.76749421678784,829,408,421,5,1,94.58,7.6,0,0,0,0,0,0,0.000407133984150261,0.0853033450353819,0.0529122138279623
8.7,"max_tuv_SVM","SVM",98,37,112,112,0,3800,3372,428,0.935510167970554,0.595505617977528,1.7691202464261,830,410,420,1,1,97.14,7.9,0,0,0,0,0,0,0.000166563848221662,0.0267158541167324,0.0250143686300003
8.7,"max_tuv_SVM","SVM",98,38,12,12,0,3900,3472,428,0.935712389883827,0.595505617977528,1.76587117342991,831,411,420,1,1,99.69,8.1,0,0,0,0,0,0,0.000133869348301022,0.00183832302928191,0.00183832302928191
8.7,"max_tuv_SVM","SVM",98,39,0,0,0,3912,3484,428,0.935608119209796,0.595505617977528,1.76587117342991,833,412,421,2,1,100,8.1,0,0,0,0,0,0,0,0,0
8.7,"max_tuv_SVM","SVM",99,0,3812,3399,413,100,88,12,0.916414286825929,0.513812154696133,1.79449541284404,28,12,16,0,1.3,2.56,7.3,0,0,0,0,0,0,0.859865226713408,592.376844457125,89.1951503714325
8.7,"max_tuv_SVM","SVM",99,1,3712,3326,386,200,161,39,0.897340284802746,0.535911602209945,1.75806386090348,93,39,54,65,1.4,5.11,4.1,0,0,0,0,0,0,0.749192054521844,415.228644436839,81.6599888018157
8.7,"max_tuv_SVM","SVM",99,2,3612,3288,324,300,199,101,0.904262703291582,0.535911602209945,1.7497395131819,181,88,93,88,1.1,7.67,2,0,0,0,0,0,0,0.718779646156878,288.223452277811,81.3830955828127
8.7,"max_tuv_SVM","SVM",99,3,3512,3230,282,400,257,143,0.882827795502298,0.558011049723757,1.69164555416501,274,134,140,93,1,10.22,1.8,0,0,0,0,0,0,0.732764475352616,278.987197967536,82.1145641274964
8.7,"max_tuv_SVM","SVM",99,4,3412,3173,239,500,314,186,0.898625787876433,0.580110497237569,1.68543768057175,365,177,188,91,1.1,12.78,1.7,0,0,0,0,0,0,0.708830599928797,241.799991484564,80.1024671702588
8.7,"max_tuv_SVM","SVM",99,5,3312,3128,184,600,359,241,0.899542448058531,0.585635359116022,1.65873821904452,430,212,218,65,1,15.34,1.5,0,0,0,0,0,0,0.182393015458363,165.144739530454,71.3373122783219
8.7,"max_tuv_SVM","SVM",99,6,3212,3071,141,700,416,284,0.900733016885859,0.596685082872928,1.67020589894636,480,234,246,50,1.1,17.89,1.5,0,0,0,0,0,0,0.128751066521697,154.469137869008,52.1728244477617
8.7,"max_tuv_SVM","SVM",99,7,3112,3010,102,800,477,323,0.890011672243416,0.61878453038674,1.65184212936113,502,247,255,22,1,20.45,1.5,0,0,0,0,0,0,0.0774185405683693,102.588869909132,29.6139300562387
8.7,"max_tuv_SVM","SVM",99,8,3012,2928,84,900,559,341,0.887130962571015,0.61878453038674,1.64038079360803,536,258,278,34,1.1,23.01,1.6,0,0,0,0,0,0,0.0641831723854189,94.27705647596,23.1919607138266
8.7,"max_tuv_SVM","SVM",99,9,2912,2843,69,1000,644,356,0.885574663450326,0.613259668508287,1.65184212936113,568,276,292,32,1.1,25.56,1.8,0,0,0,0,0,0,0.0565174899415962,88.2806407552358,18.1785287104858
8.7,"max_tuv_SVM","SVM",99,10,2812,2750,62,1100,737,363,0.888316862500982,0.61878453038674,1.65184212936113,588,282,306,20,1.1,28.12,2,0,0,0,0,0,0,0.0458970526737318,74.5468197547241,14.9093973971636
8.7,"max_tuv_SVM","SVM",99,11,2712,2662,50,1200,825,375,0.897156641506499,0.613259668508287,1.6617929855621,598,290,308,10,1.1,30.67,2.2,0,0,0,0,0,0,0.0383843226562565,55.6531921463908,6.94938579228299
8.7,"max_tuv_SVM","SVM",99,12,2612,2570,42,1300,917,383,0.917326278110665,0.602209944751381,1.70370332859002,635,308,327,37,1.1,33.23,2.4,0,0,0,0,0,0,0.0324322165072697,35.680372255589,5.13860175391253
8.7,"max_tuv_SVM","SVM",99,13,2512,2480,32,1400,1007,393,0.925521749280221,0.607734806629834,1.75806386090348,658,318,340,23,1.1,35.79,2.6,0,0,0,0,0,0,0.0517342429896288,49.265271430574,6.27884904571444
8.7,"max_tuv_SVM","SVM",99,14,2412,2384,28,1500,1103,397,0.92616450081707,0.596685082872928,1.76475239495159,677,328,349,19,1.1,38.34,2.8,0,0,0,0,0,0,0.047564225636993,38.5291940809406,5.47934791517136
8.7,"max_tuv_SVM","SVM",99,15,2312,2285,27,1600,1202,398,0.926225196482776,0.596685082872928,1.76475239495159,684,331,353,7,1.1,40.9,3,0,0,0,0,0,0,0.0365918020489699,28.6923210376931,4.01322922626577
8.7,"max_tuv_SVM","SVM",99,16,2212,2190,22,1700,1297,403,0.925537312271432,0.596685082872928,1.76799642508937,697,340,357,13,1.1,43.46,3.2,0,0,0,0,0,0,0.0378076072571649,25.8348605653597,4.33170614418067
8.7,"max_tuv_SVM","SVM",99,17,2112,2093,19,1800,1394,406,0.924653334370877,0.602209944751381,1.76130154757181,702,342,360,5,1.1,46.01,3.4,0,0,0,0,0,0,0.0302417973377076,20.9916439773915,3.76203847363365
8.7,"max_tuv_SVM","SVM",99,18,2012,2000,12,1900,1487,413,0.923780250564173,0.602209944751381,1.76130154757181,726,353,373,24,1.1,48.57,3.6,0,0,0,0,0,0,0.0253857736751576,20.1215949964694,3.63834211350276
8.7,"max_tuv_SVM","SVM",99,19,1912,1904,8,2000,1583,417,0.923495447825088,0.602209944751381,1.75968121496135,736,358,378,10,1.1,51.12,3.8,0,0,0,0,0,0,0.0194436623399825,17.2871758117001,2.26786826548522
8.7,"max_tuv_SVM","SVM",99,20,1812,1804,8,2100,1683,417,0.923453427748829,0.602209944751381,1.76130154757181,734,357,377,-2,1.1,53.68,4,0,0,0,0,0,0,0.0158540702443296,14.705676121863,1.7377922247636
8.7,"max_tuv_SVM","SVM",99,21,1712,1705,7,2200,1782,418,0.923868959614052,0.596685082872928,1.75968121496135,742,359,383,8,1.1,56.24,4.3,0,0,0,0,0,0,0.0135868880669679,12.7628810984133,1.47080169777807
8.7,"max_tuv_SVM","SVM",99,22,1612,1606,6,2300,1881,419,0.92420512022412,0.596685082872928,1.75968121496135,743,360,383,1,1.1,58.79,4.5,0,0,0,0,0,0,0.0112951560988377,9.99683814962411,1.16227748116711
8.7,"max_tuv_SVM","SVM",99,23,1512,1506,6,2400,1981,419,0.924601976499893,0.591160220994475,1.76130154757181,753,367,386,10,1.1,61.35,4.7,0,0,0,0,0,0,0.00803298758262772,6.43548979554621,0.939601216942644
8.7,"max_tuv_SVM","SVM",99,24,1412,1406,6,2500,2081,419,0.924580188312203,0.591160220994475,1.76130154757181,753,367,386,0,1.1,63.91,5,0,0,0,0,0,0,0.00709471009948466,5.31812168820106,0.731844278326199
8.7,"max_tuv_SVM","SVM",99,25,1312,1306,6,2600,2181,419,0.925804995720183,0.580110497237569,1.76130154757181,763,373,390,10,1,66.46,5.2,0,0,0,0,0,0,0.00605522186359222,4.11442536530001,0.676420889454267
8.7,"max_tuv_SVM","SVM",99,26,1212,1208,4,2700,2279,421,0.926552019298117,0.591160220994475,1.76962291674079,774,378,396,11,1,69.02,5.4,0,0,0,0,0,0,0.00651942399288378,4.0615669862183,0.664983942816161
8.7,"max_tuv_SVM","SVM",99,27,1112,1108,4,2800,2379,421,0.926785464166219,0.580110497237569,1.7728848944675,784,383,401,10,1,71.57,5.7,0,0,0,0,0,0,0.00434506262407672,2.39726670865923,0.489937361409876
8.7,"max_tuv_SVM","SVM",99,28,1012,1008,4,2900,2479,421,0.926959769667736,0.580110497237569,1.7728848944675,782,383,399,-2,1,74.13,5.9,0,0,0,0,0,0,0.00430445837946539,1.9967256042669,0.44116376923478
8.7,"max_tuv_SVM","SVM",99,29,912,908,4,3000,2579,421,0.926973776359821,0.580110497237569,1.77125240377278,785,383,402,3,1,76.69,6.1,0,0,0,0,0,0,0.00301106948034047,1.21100230674409,0.338309961096401
8.7,"max_tuv_SVM","SVM",99,30,812,809,3,3100,2678,422,0.92732861255934,0.574585635359116,1.77125240377278,790,386,404,5,1,79.24,6.3,0,0,0,0,0,0,0.00307569725902362,1.06845639390409,0.337501988589151
8.7,"max_tuv_SVM","SVM",99,31,712,709,3,3200,2778,422,0.927099836588597,0.580110497237569,1.77125240377278,793,388,405,3,1,81.8,6.6,0,0,0,0,0,0,0.00197016478232781,0.613694862770487,0.237272213168216
8.7,"max_tuv_SVM","SVM",99,32,612,609,3,3300,2878,422,0.927370632635597,0.574585635359116,1.77125240377278,791,387,404,-2,1,84.36,6.8,0,0,0,0,0,0,0.00129816198911465,0.41964967581597,0.169555496485788
8.7,"max_tuv_SVM","SVM",99,33,512,509,3,3400,2978,422,0.927722356236872,0.580110497237569,1.7728848944675,792,388,404,1,1,86.91,7.1,0,0,0,0,0,0,0.00072986636427918,0.219114135059391,0.0945779758246164
8.7,"max_tuv_SVM","SVM",99,34,412,411,1,3500,3076,424,0.929409384483701,0.574585635359116,1.77956461852023,804,395,409,12,1,89.47,7.3,0,0,0,0,0,0,0.000760910074532284,0.230857958061368,0.0960165868397053
8.7,"max_tuv_SVM","SVM",99,35,312,312,0,3600,3175,425,0.930240448214149,0.574585635359116,1.77956461852023,809,397,412,5,1,92.02,7.5,0,0,0,0,0,0,0.000742672991010154,0.191851661852642,0.0893363129097931
8.7,"max_tuv_SVM","SVM",99,36,212,212,0,3700,3275,425,0.930450548595442,0.574585635359116,1.77792898927527,811,397,414,2,1,94.58,7.7,0,0,0,0,0,0,0.000402064402794216,0.081493461385,0.0495808577321
8.7,"max_tuv_SVM","SVM",99,37,112,112,0,3800,3375,425,0.930645085985527,0.574585635359116,1.78284492196451,820,401,419,9,1,97.14,7.9,0,0,0,0,0,0,0.000205681752479162,0.0318064725894803,0.029642538747358
8.7,"max_tuv_SVM","SVM",99,38,12,12,0,3900,3475,425,0.930783596607268,0.574585635359116,1.77792898927527,820,403,417,0,1,99.69,8.2,0,0,0,0,0,0,0.000130490281681044,0.00180818338368247,0.00180818338368247
8.7,"max_tuv_SVM","SVM",99,39,0,0,0,3912,3487,425,0.930903431639561,0.574585635359116,1.77956461852023,820,403,417,0,1,100,8.2,0,0,0,0,0,0,0,0,0
8.7,"max_tuv_SVM","SVM",100,0,3812,3428,384,100,91,9,0.827678251571006,0.300469483568075,1.65888232621536,33,9,24,0,2.7,2.56,10.1,0,0,0,0,0,0,0.178122064453556,321.136991135032,27.9968177392736
8.7,"max_tuv_SVM","SVM",100,1,3712,3350,362,200,169,31,0.910049318669719,0.563380281690141,1.75398026358334,69,31,38,36,1.2,5.11,5.5,0,0,0,0,0,0,0.615598385270227,330.724784287844,72.4127719828711
8.7,"max_tuv_SVM","SVM",100,2,3612,3300,312,300,219,81,0.922519050043237,0.68075117370892,1.70399361433684,160,77,83,91,1.1,7.67,2.7,0,0,0,0,0,0,0.704492527558908,353.97123903936,77.0620216796956
8.7,"max_tuv_SVM","SVM",100,3,3512,3234,278,400,285,115,0.913041838716376,0.661971830985915,1.70555262038839,239,115,124,79,1.1,10.22,2.5,0,0,0,0,0,0,0.618382681706916,354.461681043807,71.5353026910387
8.7,"max_tuv_SVM","SVM",100,4,3412,3197,215,500,322,178,0.926935104603527,0.694835680751174,1.72341500706169,329,161,168,90,1,12.78,1.8,0,0,0,0,0,0,0.522845093147508,240.681329101167,70.6321212959743
8.7,"max_tuv_SVM","SVM",100,5,3312,3138,174,600,381,219,0.891059880029854,0.676056338028169,1.63893387926455,420,205,215,91,1,15.34,1.7,0,0,0,0,0,0,0.283311156792937,196.02498285257,60.8372751391385
8.7,"max_tuv_SVM","SVM",100,6,3212,3075,137,700,444,256,0.898741848682457,0.699530516431925,1.65278909453045,486,237,249,66,1.1,17.89,1.7,0,0,0,0,0,0,0.135596050810777,122.008956691843,44.0214986186532
8.7,"max_tuv_SVM","SVM",100,7,3112,3015,97,800,504,296,0.897801804131341,0.699530516431925,1.6543082021541,527,256,271,41,1.1,20.45,1.7,0,0,0,0,0,0,0.074837123145819,77.2193574346347,19.6835292804908
8.7,"max_tuv_SVM","SVM",100,8,3012,2936,76,900,583,317,0.900858969075491,0.708920187793427,1.66427821760369,561,272,289,34,1.1,23.01,1.8,0,0,0,0,0,0,0.0620009078208984,81.4214442056065,15.4844205869076
8.7,"max_tuv_SVM","SVM",100,9,2912,2849,63,1000,670,330,0.90493967823002,0.704225352112676,1.66659351157357,594,287,307,33,1.1,25.56,2,0,0,0,0,0,0,0.0507569620296852,75.1392960247913,11.2042208829942
8.7,"max_tuv_SVM","SVM",100,10,2812,2755,57,1100,764,336,0.909598151155926,0.704225352112676,1.66812249644657,606,293,313,12,1.1,28.12,2.3,0,0,0,0,0,0,0.0397194897796193,60.4606571582626,7.97407121563595
8.7,"max_tuv_SVM","SVM",100,11,2712,2663,49,1200,856,344,0.918979741905251,0.690140845070423,1.66812249644657,628,307,321,22,1,30.67,2.5,0,0,0,0,0,0,0.0352221888722445,46.1697741417059,5.23814784107374
8.7,"max_tuv_SVM","SVM",100,12,2612,2573,39,1300,946,354,0.925050975195213,0.694835680751174,1.69650994200497,654,317,337,26,1.1,33.23,2.7,0,0,0,0,0,0,0.0539847896088645,56.455059942662,6.37253952198104
8.7,"max_tuv_SVM","SVM",100,13,2512,2480,32,1400,1039,361,0.93076127447415,0.694835680751174,1.74394624628505,676,328,348,22,1.1,35.79,2.9,0,0,0,0,0,0,0.0612489390000983,54.8050024224662,7.13131054721957
8.7,"max_tuv_SVM","SVM",100,14,2412,2385,27,1500,1134,366,0.932145752695553,0.690140845070423,1.75559237779619,700,337,363,24,1.1,38.34,3.1,0,0,0,0,0,0,0.0561759709747371,46.2808916247899,6.06554046519538
8.7,"max_tuv_SVM","SVM",100,15,2312,2289,23,1600,1230,370,0.932664258644235,0.685446009389671,1.76044655026936,711,342,369,11,1.1,40.9,3.3,0,0,0,0,0,0,0.0413933487669143,32.9754980522001,4.73167871043752
8.7,"max_tuv_SVM","SVM",100,16,2212,2194,18,1700,1325,375,0.933717431765961,0.685446009389671,1.75882551293025,722,349,373,11,1.1,43.46,3.5,0,0,0,0,0,0,0.0402414870607036,30.6636813862248,4.77072982195166
8.7,"max_tuv_SVM","SVM",100,17,2112,2102,10,1800,1417,383,0.933897898771473,0.694835680751174,1.75398026358334,743,357,386,21,1.1,46.01,3.7,0,0,0,0,0,0,0.0322488531665913,26.8462887365057,4.3409605813911
8.7,"max_tuv_SVM","SVM",100,18,2012,2004,8,1900,1515,385,0.934331558292184,0.694835680751174,1.75237110737821,748,361,387,5,1.1,48.57,3.9,0,0,0,0,0,0,0.0234411954005222,22.6688111963962,2.78791626499958
8.7,"max_tuv_SVM","SVM",100,19,1912,1904,8,2000,1615,385,0.934284421387759,0.694835680751174,1.75559237779619,746,360,386,-2,1.1,51.12,4.2,0,0,0,0,0,0,0.0226020058847511,19.9336594361617,2.28195199790095
8.7,"max_tuv_SVM","SVM",100,20,1812,1804,8,2100,1715,385,0.933608343501433,0.690140845070423,1.75882551293025,772,371,401,26,1.1,53.68,4.5,0,0,0,0,0,0,0.0149983373137204,10.0892823488968,1.9253432155895
8.7,"max_tuv_SVM","SVM",100,21,1712,1705,7,2200,1814,386,0.933713391459866,0.690140845070423,1.75882551293025,773,372,401,1,1.1,56.24,4.7,0,0,0,0,0,0,0.0107040794763682,8.70461012538406,1.26943855354772
8.7,"max_tuv_SVM","SVM",100,22,1612,1607,5,2300,1912,388,0.933842681254863,0.694835680751174,1.75882551293025,775,376,399,2,1.1,58.79,4.9,0,0,0,0,0,0,0.00904370431674528,6.72789520484897,0.944548658052568
8.7,"max_tuv_SVM","SVM",100,23,1512,1508,4,2400,2011,389,0.934505291454217,0.694835680751174,1.75882551293025,782,381,401,7,1.1,61.35,5.2,0,0,0,0,0,0,0.00832439089511153,5.98088700583324,0.94696544896195
8.7,"max_tuv_SVM","SVM",100,24,1412,1409,3,2500,2110,390,0.934424485332346,0.694835680751174,1.75882551293025,783,382,401,1,1,63.91,5.4,0,0,0,0,0,0,0.00614769591185964,4.21744256955311,0.64885442136896
8.7,"max_tuv_SVM","SVM",100,25,1312,1309,3,2600,2210,390,0.934704613221502,0.694835680751174,1.75882551293025,785,382,403,2,1.1,66.46,5.7,0,0,0,0,0,0,0.00513633785567323,3.21303004113964,0.537208921119774
8.7,"max_tuv_SVM","SVM",100,26,1212,1209,3,2700,2310,390,0.934805620873844,0.694835680751174,1.75720745818055,784,383,401,-1,1,69.02,5.9,0,0,0,0,0,0,0.00469397596169961,2.71555222260957,0.492964305522517
8.7,"max_tuv_SVM","SVM",100,27,1112,1110,2,2800,2409,391,0.935122111517839,0.694835680751174,1.75559237779619,791,386,405,7,1,71.57,6.2,0,0,0,0,0,0,0.00423206460229936,2.19638166933034,0.444046475851756
8.7,"max_tuv_SVM","SVM",100,28,1012,1010,2,2900,2509,391,0.935157127503984,0.694835680751174,1.75882551293025,791,387,404,0,1,74.13,6.4,0,0,0,0,0,0,0.00322258284320693,1.46000739086792,0.340737187908913
8.7,"max_tuv_SVM","SVM",100,29,912,910,2,3000,2609,391,0.935220425632783,0.694835680751174,1.75882551293025,791,387,404,0,1,76.69,6.7,0,0,0,0,0,0,0.00265706820717738,1.07726297125291,0.291072570884369
8.7,"max_tuv_SVM","SVM",100,30,812,810,2,3100,2709,391,0.935239280394554,0.694835680751174,1.75882551293025,791,387,404,0,1,79.24,6.9,0,0,0,0,0,0,0.00200368199741696,0.724478623735194,0.225959451436772
8.7,"max_tuv_SVM","SVM",100,31,712,711,1,3200,2808,392,0.935659472228283,0.694835680751174,1.75076490104698,793,388,405,2,1,81.8,7.2,0,0,0,0,0,0,0.00172355586950085,0.573666902482014,0.196850652751445
8.7,"max_tuv_SVM","SVM",100,32,612,611,1,3300,2908,392,0.935775294336298,0.694835680751174,1.75720745818055,797,389,408,4,1,84.36,7.4,0,0,0,0,0,0,0.00114095195082048,0.358847021554327,0.141013103380664
8.7,"max_tuv_SVM","SVM",100,33,512,511,1,3400,3008,392,0.935901890593897,0.694835680751174,1.75559237779619,800,390,410,3,1.1,86.91,7.7,0,0,0,0,0,0,0.000691647368968681,0.210221990755671,0.0892191564797022
8.7,"max_tuv_SVM","SVM",100,34,412,412,0,3500,3107,393,0.936283026135389,0.694835680751174,1.75559237779619,800,391,409,0,1,89.47,7.9,0,0,0,0,0,0,0.000447699981887911,0.124998480327772,0.0568143106469961
8.7,"max_tuv_SVM","SVM",100,35,312,312,0,3600,3207,393,0.93644733191653,0.685446009389671,1.75559237779619,804,392,412,4,1.1,92.02,8.2,0,0,0,0,0,0,0.00041168472779332,0.100447165994086,0.051869553063417
8.7,"max_tuv_SVM","SVM",100,36,212,212,0,3700,3307,393,0.936703217969126,0.68075117370892,1.75559237779619,806,393,413,2,1.1,94.58,8.4,0,0,0,0,0,0,9.37126533815085e-05,0.0197213239115512,0.0130378641480862
8.7,"max_tuv_SVM","SVM",100,37,112,112,0,3800,3407,393,0.937019708613124,0.671361502347418,1.76044655026936,807,393,414,1,1.1,97.14,8.7,0,0,0,0,0,0,3.97253112993012e-05,0.00810480332145825,0.00766918143002258
8.7,"max_tuv_SVM","SVM",100,38,12,12,0,3900,3507,393,0.937138224258535,0.666666666666667,1.75882551293025,806,393,413,-1,1.1,99.69,8.9,0,0,0,0,0,0,1.7760914189801e-05,0.000272282073658208,0.000272282073658208
8.7,"max_tuv_SVM","SVM",100,39,0,0,0,3912,3519,393,0.937111288884578,0.666666666666667,1.75237110737821,805,393,412,-1,1,100,9,0,0,0,0,0,0,0,0,0
8.7,"greedy_SVM","SVM",1,0,3812,3438,374,100,92,8,0.891300313427912,0.540178571428571,1.76398863933142,23,8,15,0,1.9,2.56,11.5,0,0,0,0,0,0,0.649057055194634,442.015649889589,76.7469440673465
8.7,"greedy_SVM","SVM",1,1,3712,3366,346,200,164,36,0.84176530023094,0.4375,1.66441397000789,91,36,55,68,1.5,5.11,4.6,0,0,0,0,0,0,0.33961620209408,424.906506382033,41.8751386400068
8.7,"greedy_SVM","SVM",1,2,3612,3313,299,300,217,83,0.81366762207192,0.549107142857143,1.5154958677686,181,83,98,90,1.2,7.67,2.6,0,0,0,0,0,0,0.354948389760426,675.511296350008,41.8354473808545
8.7,"greedy_SVM","SVM",1,3,3512,3260,252,400,270,130,0.887190438386666,0.647321428571429,1.65029488859764,271,130,141,90,1.1,10.22,2.1,0,0,0,0,0,0,0.489648024846824,473.049375340521,59.7648189928272
8.7,"greedy_SVM","SVM",1,4,3412,3247,165,500,283,217,0.894942366380728,0.633928571428571,1.6789492706006,311,152,159,40,1,12.78,1.3,0,0,0,0,0,0,0.465042399555711,368.39862816735,58.6791025661903
8.7,"greedy_SVM","SVM",1,5,3312,3195,117,600,335,265,0.892724399950511,0.651785714285714,1.672454617206,400,198,202,89,1,15.34,1.3,0,0,0,0,0,0,0.290227418203955,299.194494546365,37.0859126852103
8.7,"greedy_SVM","SVM",1,6,3212,3124,88,700,406,294,0.878322438964036,0.669642857142857,1.59861676961493,484,234,250,84,1.1,17.89,1.4,0,0,0,0,0,0,0.172940945919954,224.43441851867,22.4853575701457
8.7,"greedy_SVM","SVM",1,7,3112,3042,70,800,488,312,0.889091368360282,0.6875,1.60812943962115,539,255,284,55,1.1,20.45,1.6,0,0,0,0,0,0,0.110983815529022,163.533969902356,14.4400082865518
8.7,"greedy_SVM","SVM",1,8,3012,2963,49,900,567,333,0.880325181458258,0.674107142857143,1.60156352863726,583,277,306,44,1.1,23.01,1.7,0,0,0,0,0,0,0.103232556313974,183.147846603457,15.3059579013091
8.7,"greedy_SVM","SVM",1,9,2912,2870,42,1000,660,340,0.895361215357981,0.674107142857143,1.65332851890756,601,286,315,18,1.1,25.56,1.9,0,0,0,0,0,0,0.0817796148451165,127.112820579397,10.2750843480562
8.7,"greedy_SVM","SVM",1,10,2812,2776,36,1100,754,346,0.911247834872989,0.665178571428571,1.73033245556287,617,297,320,16,1.1,28.12,2.2,0,0,0,0,0,0,0.074364297141585,95.5507647800946,8.26676269147957
8.7,"greedy_SVM","SVM",1,11,2712,2680,32,1200,850,350,0.917991947789523,0.669642857142857,1.72069850039463,633,305,328,16,1.1,30.67,2.4,0,0,0,0,0,0,0.0675646209083029,74.2040335893152,7.25701945163174
8.7,"greedy_SVM","SVM",1,12,2612,2583,29,1300,947,353,0.919783332646003,0.669642857142857,1.72069850039463,643,309,334,10,1.1,33.23,2.7,0,0,0,0,0,0,0.0666623804926959,73.307466199028,7.1435020851547
8.7,"greedy_SVM","SVM",1,13,2512,2487,25,1400,1043,357,0.919867102441446,0.669642857142857,1.71911552109344,653,313,340,10,1.1,35.79,2.9,0,0,0,0,0,0,0.0617848738154172,59.140810994246,6.76199885082773
8.7,"greedy_SVM","SVM",1,14,2412,2393,19,1500,1137,363,0.918678860112176,0.665178571428571,1.73033245556287,674,320,354,21,1.1,38.34,3.1,0,0,0,0,0,0,0.0599136252982926,53.3732313651982,6.63579734169631
8.7,"greedy_SVM","SVM",1,15,2312,2298,14,1600,1232,368,0.919408301715607,0.665178571428571,1.73033245556287,685,325,360,11,1.1,40.9,3.3,0,0,0,0,0,0,0.0479140609041121,46.0289488280195,5.56069975864855
8.7,"greedy_SVM","SVM",1,16,2212,2200,12,1700,1330,370,0.919725338172221,0.665178571428571,1.72873914759274,690,327,363,5,1.1,43.46,3.6,0,0,0,0,0,0,0.0359848439199203,37.6669991122307,4.01422967310806
8.7,"greedy_SVM","SVM",1,17,2112,2104,8,1800,1426,374,0.920722843121084,0.660714285714286,1.72873914759274,704,334,370,14,1.1,46.01,3.8,0,0,0,0,0,0,0.029890407343742,31.1068480282866,3.20218910774811
8.7,"greedy_SVM","SVM",1,18,2012,2004,8,1900,1526,374,0.920369721214124,0.660714285714286,1.73033245556287,708,337,371,4,1.1,48.57,4.1,0,0,0,0,0,0,0.0254822010279461,24.3538270199904,2.61846899193115
8.7,"greedy_SVM","SVM",1,19,1912,1904,8,2000,1626,374,0.922599286539119,0.660714285714286,1.74642857142857,721,348,373,13,1.1,51.12,4.3,0,0,0,0,0,0,0.017082514564345,12.9004793167365,2.23479180989817
8.7,"greedy_SVM","SVM",1,20,1812,1805,7,2100,1725,375,0.922667591141561,0.660714285714286,1.74482044198895,729,349,380,8,1.1,53.68,4.6,0,0,0,0,0,0,0.0121120018536649,10.0901582983884,1.3720808647102
8.7,"greedy_SVM","SVM",1,21,1712,1705,7,2200,1825,375,0.922523249340175,0.660714285714286,1.74482044198895,729,349,380,0,1.1,56.24,4.9,0,0,0,0,0,0,0.0109359795578757,9.02656388253705,1.17402904197989
8.7,"greedy_SVM","SVM",1,22,1612,1605,7,2300,1925,375,0.922405971626549,0.65625,1.74642857142857,731,351,380,2,1.1,58.79,5.1,0,0,0,0,0,0,0.00954033072961024,7.0706111204209,0.970147042169087
8.7,"greedy_SVM","SVM",1,23,1512,1505,7,2400,2025,375,0.922542580831428,0.651785714285714,1.76731502168485,739,360,379,8,1.1,61.35,5.4,0,0,0,0,0,0,0.00680458304078562,4.42771440219547,0.818916518338936
8.7,"greedy_SVM","SVM",1,24,1412,1407,5,2500,2123,377,0.922542580831428,0.65625,1.76731502168485,743,362,381,4,1.1,63.91,5.6,0,0,0,0,0,0,0.0064221701981778,4.10826205619693,0.668751540642117
8.7,"greedy_SVM","SVM",1,25,1312,1308,4,2600,2222,378,0.922913745463561,0.65625,1.76406926406926,753,367,386,10,1.1,66.46,5.9,0,0,0,0,0,0,0.00546330915120925,3.29406055181531,0.594337074159184
8.7,"greedy_SVM","SVM",1,26,1212,1209,3,2700,2321,379,0.923293931458283,0.65625,1.7656906512605,757,368,389,4,1.1,69.02,6.1,0,0,0,0,0,0,0.00474502363669827,2.48224823149618,0.493473937978862
8.7,"greedy_SVM","SVM",1,27,1112,1109,3,2800,2421,379,0.923504000329943,0.665178571428571,1.76406926406926,764,370,394,7,1.1,71.57,6.4,0,0,0,0,0,0,0.00387864924848667,1.83635020022001,0.417751809643191
8.7,"greedy_SVM","SVM",1,28,1012,1009,3,2900,2521,379,0.923452449686591,0.660714285714286,1.7656906512605,764,370,394,0,1.1,74.13,6.7,0,0,0,0,0,0,0.00344954495539042,1.39442388136555,0.365568017541713
8.7,"greedy_SVM","SVM",1,29,912,910,2,3000,2620,380,0.923741133289362,0.65625,1.76406926406926,768,373,395,4,1.1,76.69,6.9,0,0,0,0,0,0,0.00300804499424884,1.10125463790832,0.331102995197648
8.7,"greedy_SVM","SVM",1,30,812,810,2,3100,2720,380,0.923805571593551,0.65625,1.76245085190039,770,373,397,2,1.1,79.24,7.2,0,0,0,0,0,0,0.00224398223067919,0.703520113603173,0.245870099466035
8.7,"greedy_SVM","SVM",1,31,712,710,2,3200,2820,380,0.924053014681641,0.651785714285714,1.76245085190039,770,373,397,0,1.1,81.8,7.4,0,0,0,0,0,0,0.00157033169836321,0.456627345132701,0.191084071117185
8.7,"greedy_SVM","SVM",1,32,612,610,2,3300,2920,380,0.924242463295959,0.651785714285714,1.76894238358327,771,374,397,1,1.1,84.36,7.7,0,0,0,0,0,0,0.000832132795701569,0.258843444905586,0.11715609788559
8.7,"greedy_SVM","SVM",1,33,512,511,1,3400,3019,381,0.924848183355344,0.647321428571429,1.76894238358327,779,377,402,8,1.1,86.91,7.9,0,0,0,0,0,0,0.000552255864297173,0.168037075206801,0.0752792306501106
8.7,"greedy_SVM","SVM",1,34,412,412,0,3500,3118,382,0.925934613163986,0.638392857142857,1.76894238358327,783,379,404,4,1.1,89.47,8.2,0,0,0,0,0,0,0.000459347136645777,0.131166511598821,0.0598143182536168
8.7,"greedy_SVM","SVM",1,35,312,312,0,3600,3218,382,0.926609926591897,0.638392857142857,1.76894238358327,784,380,404,1,1.1,92.02,8.4,0,0,0,0,0,0,0.000212249916153795,0.0512959931775118,0.0270474427336198
8.7,"greedy_SVM","SVM",1,36,212,212,0,3700,3318,382,0.927287817551975,0.638392857142857,1.77057274522712,785,381,404,1,1.1,94.58,8.7,0,0,0,0,0,0,0.000100415086523829,0.0215151843043877,0.0141339703324345
8.7,"greedy_SVM","SVM",1,37,112,112,0,3800,3418,382,0.928160312190707,0.638392857142857,1.76894238358327,783,381,402,-2,1.1,97.14,8.9,0,0,0,0,0,0,2.37543985928153e-05,0.00489797967992374,0.00464197703045
8.7,"greedy_SVM","SVM",1,38,12,12,0,3900,3518,382,0.928617824150455,0.638392857142857,1.76731502168485,785,382,403,2,1.1,99.69,9.2,0,0,0,0,0,0,1.55924858550313e-05,0.00021007704002571,0.00021007704002571
8.7,"greedy_SVM","SVM",1,39,0,0,0,3912,3530,382,0.92862942304521,0.638392857142857,1.7656906512605,785,382,403,0,1.1,100,9.2,0,0,0,0,0,0,0,0,0
8.7,"greedy_SVM","SVM",2,0,3812,3426,386,100,87,13,0.918857704747778,0.579710144927536,1.77878920961925,30,13,17,0,1.3,2.56,6.7,0,0,0,0,0,0,0.70659886270428,488.667041672181,75.5993051321643
8.7,"greedy_SVM","SVM",2,1,3712,3411,301,200,102,98,0.921753769579862,0.579710144927536,1.78042412617221,63,34,29,33,0.9,5.11,1,0,0,0,0,0,0,0.689889330777338,304.071078883329,77.0444002597342
8.7,"greedy_SVM","SVM",2,2,3612,3358,254,300,155,145,0.895160243396507,0.599033816425121,1.69669308991913,154,79,75,91,0.9,7.67,1.1,0,0,0,0,0,0,0.362164841251677,131.431855462635,54.6373676414694
8.7,"greedy_SVM","SVM",2,3,3512,3308,204,400,205,195,0.895205818093427,0.599033816425121,1.69046669325888,249,128,121,95,0.9,10.22,1.1,0,0,0,0,0,0,0.288869965906273,142.197897103034,37.9730986240994
8.7,"greedy_SVM","SVM",2,4,3412,3240,172,500,273,227,0.90729139908796,0.623188405797101,1.7401980409427,322,161,161,73,1,12.78,1.2,0,0,0,0,0,0,0.139673059249842,78.4662125541673,20.5731672519661
8.7,"greedy_SVM","SVM",2,5,3312,3173,139,600,340,260,0.901276920144844,0.63768115942029,1.70937304534142,387,190,197,65,1,15.34,1.3,0,0,0,0,0,0,0.0890368683294784,59.3850940357229,13.2096105922069
8.7,"greedy_SVM","SVM",2,6,3212,3104,108,700,409,291,0.911170772532556,0.661835748792271,1.68954785280171,448,218,230,61,1.1,17.89,1.4,0,0,0,0,0,0,0.0893175918264937,78.6121661458538,13.6115482819556
8.7,"greedy_SVM","SVM",2,7,3112,3029,83,800,484,316,0.902155268849284,0.685990338164251,1.65471181459961,509,242,267,61,1.1,20.45,1.5,0,0,0,0,0,0,0.0832172761862336,112.356947435994,10.9207872673299
8.7,"greedy_SVM","SVM",2,8,3012,2948,64,900,565,335,0.899859961385813,0.695652173913043,1.62708516828142,565,264,301,56,1.1,23.01,1.7,0,0,0,0,0,0,0.099635007335159,142.307752822623,13.0052872477627
8.7,"greedy_SVM","SVM",2,9,2912,2860,52,1000,653,347,0.915113674342564,0.690821256038647,1.70539408012384,599,290,309,34,1.1,25.56,1.9,0,0,0,0,0,0,0.0661374451993557,93.4009325756958,8.08800130646912
8.7,"greedy_SVM","SVM",2,10,2812,2767,45,1100,746,354,0.927066674400567,0.676328502415459,1.73309290055433,620,301,319,21,1.1,28.12,2.1,0,0,0,0,0,0,0.0605830818508735,76.0369608167023,6.86528477681388
8.7,"greedy_SVM","SVM",2,11,2712,2669,43,1200,844,356,0.933228925845842,0.681159420289855,1.7592199292059,627,304,323,7,1.1,30.67,2.4,0,0,0,0,0,0,0.0547403608901098,64.7132426440775,5.99159362523166
8.7,"greedy_SVM","SVM",2,12,2612,2580,32,1300,933,367,0.94178315835414,0.676328502415459,1.77663794830695,654,316,338,27,1.1,33.23,2.5,0,0,0,0,0,0,0.0635496257158881,63.807045104347,7.04203945605825
8.7,"greedy_SVM","SVM",2,13,2512,2484,28,1400,1029,371,0.943501186323197,0.666666666666667,1.794055967408,666,321,345,12,1.1,35.79,2.8,0,0,0,0,0,0,0.0614369164902441,55.447629491871,6.83745435706897
8.7,"greedy_SVM","SVM",2,14,2412,2389,23,1500,1124,376,0.9458296390208,0.661835748792271,1.7820620508513,685,328,357,19,1.1,38.34,3,0,0,0,0,0,0,0.0606930633097515,53.1696782465231,6.73072644371717
8.7,"greedy_SVM","SVM",2,15,2312,2295,17,1600,1218,382,0.94583378217507,0.661835748792271,1.78370299196626,706,335,371,21,1.1,40.9,3.2,0,0,0,0,0,0,0.0476886261096846,45.7798754413841,5.68479697363805
8.7,"greedy_SVM","SVM",2,16,2212,2197,15,1700,1316,384,0.946053369351181,0.666666666666667,1.77336906523739,709,336,373,3,1.1,43.46,3.4,0,0,0,0,0,0,0.0340151553841746,35.6736170630976,3.8251678266037
8.7,"greedy_SVM","SVM",2,17,2112,2098,14,1800,1415,385,0.945630767616027,0.661835748792271,1.77500200176155,714,340,374,5,1.1,46.01,3.7,0,0,0,0,0,0,0.0283933982833591,30.8424814328366,3.06137152874506
8.7,"greedy_SVM","SVM",2,18,2012,1999,13,1900,1514,386,0.944186187828538,0.661835748792271,1.77663794830695,716,341,375,2,1.1,48.57,3.9,0,0,0,0,0,0,0.0278355601069247,27.7091296072819,2.87161144504814
8.7,"greedy_SVM","SVM",2,19,1912,1899,13,2000,1614,386,0.944329817176439,0.642512077294686,1.78910912190963,738,358,380,22,1.1,51.12,4.2,0,0,0,0,0,0,0.0204121413663189,12.6778958342904,2.76800824169468
8.7,"greedy_SVM","SVM",2,20,1812,1802,10,2100,1711,389,0.944340865587814,0.642512077294686,1.78746623015398,742,361,381,4,1.1,53.68,4.4,0,0,0,0,0,0,0.0143821837993684,10.2159696001681,1.71038685099124
8.7,"greedy_SVM","SVM",2,21,1712,1702,10,2200,1811,389,0.94438505923332,0.642512077294686,1.79075503646521,743,360,383,1,1.1,56.24,4.7,0,0,0,0,0,0,0.00987760087701964,7.96913756231214,1.13238912284111
8.7,"greedy_SVM","SVM",2,22,1612,1606,6,2300,1907,393,0.944322911919325,0.642512077294686,1.78582635287861,764,367,397,21,1.1,58.79,4.9,0,0,0,0,0,0,0.00937184581776793,8.02855886143933,1.03078609357159
8.7,"greedy_SVM","SVM",2,23,1512,1506,6,2400,2007,393,0.944275956170975,0.63768115942029,1.78910912190963,765,369,396,1,1.1,61.35,5.1,0,0,0,0,0,0,0.00838113606161497,6.53159486628373,0.868583355348438
8.7,"greedy_SVM","SVM",2,24,1412,1406,6,2500,2107,393,0.944514878066994,0.63768115942029,1.794055967408,775,373,402,10,1.1,63.91,5.4,0,0,0,0,0,0,0.0057231513645979,4.06381446574916,0.669649343154054
8.7,"greedy_SVM","SVM",2,25,1312,1306,6,2600,2207,393,0.944531450684059,0.63768115942029,1.78910912190963,776,373,403,1,1.1,66.46,5.6,0,0,0,0,0,0,0.00472764547395077,3.1094553950119,0.48660103486008
8.7,"greedy_SVM","SVM",2,26,1212,1206,6,2700,2307,393,0.944170996262899,0.642512077294686,1.79240398217098,782,378,404,6,1.1,69.02,5.9,0,0,0,0,0,0,0.00372156626116258,2.26924659860933,0.406887955228065
8.7,"greedy_SVM","SVM",2,27,1112,1107,5,2800,2406,394,0.944001126937984,0.642512077294686,1.79075503646521,785,380,405,3,1.1,71.57,6.1,0,0,0,0,0,0,0.00379721894561623,2.07503892976332,0.392264292860738
8.7,"greedy_SVM","SVM",2,28,1012,1007,5,2900,2506,394,0.943487375808976,0.642512077294686,1.794055967408,784,381,403,-1,1.1,74.13,6.4,0,0,0,0,0,0,0.00319097116688409,1.5243772478572,0.333087052320571
8.7,"greedy_SVM","SVM",2,29,912,907,5,3000,2606,394,0.943269169684289,0.642512077294686,1.79240398217098,785,383,402,1,1,76.69,6.6,0,0,0,0,0,0,0.0027394296024397,1.12713600541103,0.29034135387458
8.7,"greedy_SVM","SVM",2,30,812,809,3,3100,2704,396,0.943086870896574,0.63768115942029,1.79075503646521,794,386,408,9,1.1,79.24,6.8,0,0,0,0,0,0,0.00221484026753251,0.830141087969394,0.241616863297026
8.7,"greedy_SVM","SVM",2,31,712,709,3,3200,2804,396,0.943005388862672,0.63768115942029,1.79240398217098,793,386,407,-1,1.1,81.8,7.1,0,0,0,0,0,0,0.00209627197732118,0.695593080682462,0.234700877086615
8.7,"greedy_SVM","SVM",2,32,612,610,2,3300,2903,397,0.943190449753229,0.63768115942029,1.79240398217098,796,387,409,3,1.1,84.36,7.3,0,0,0,0,0,0,0.00146946910331497,0.459626525389924,0.176530194423185
8.7,"greedy_SVM","SVM",2,33,512,510,2,3400,3003,397,0.943213927627404,0.63768115942029,1.79075503646521,796,388,408,0,1.1,86.91,7.6,0,0,0,0,0,0,0.000831807203117521,0.246885866345754,0.106537274192495
8.7,"greedy_SVM","SVM",2,34,412,412,0,3500,3101,399,0.943197355010338,0.63768115942029,1.78746623015398,805,393,412,9,1,89.47,7.8,0,0,0,0,0,0,0.000842000944490967,0.249558082377558,0.107326294744743
8.7,"greedy_SVM","SVM",2,35,312,312,0,3600,3201,399,0.943287123352772,0.63768115942029,1.78910912190963,807,394,413,2,1,92.02,8,0,0,0,0,0,0,0.000519241708080584,0.128916011540334,0.0645760609082627
8.7,"greedy_SVM","SVM",2,36,212,212,0,3700,3301,399,0.943423847443556,0.632850241545894,1.794055967408,809,395,414,2,1,94.58,8.3,0,0,0,0,0,0,0.000302396342444011,0.0616495599359158,0.0399260291284937
8.7,"greedy_SVM","SVM",2,37,112,112,0,3800,3401,399,0.943825733407377,0.632850241545894,1.79240398217098,810,396,414,1,1,97.14,8.5,0,0,0,0,0,0,9.17703210755405e-05,0.0174180658129048,0.0164357459098126
8.7,"greedy_SVM","SVM",2,38,12,12,0,3900,3501,399,0.944081227920458,0.628019323671498,1.78746623015398,812,396,416,2,1.1,99.69,8.8,0,0,0,0,0,0,7.05084082998788e-05,0.000982199142183991,0.000982199142183991
8.7,"greedy_SVM","SVM",2,39,0,0,0,3912,3513,399,0.944140613131607,0.628019323671498,1.78582635287861,814,398,416,2,1,100,8.8,0,0,0,0,0,0,0,0,0
8.7,"greedy_SVM","SVM",3,0,3812,3422,390,100,84,16,0.880196469248293,0.475,1.68527956003666,42,16,26,0,1.6,2.56,5.2,0,0,0,0,0,0,0.545189454700446,556.848945402155,68.4373209448846
8.7,"greedy_SVM","SVM",3,1,3712,3351,361,200,155,45,0.865498291571754,0.51,1.63449035812672,101,43,58,59,1.3,5.11,3.4,0,0,0,0,0,0,0.424373364108476,511.943168777954,51.2842634913803
8.7,"greedy_SVM","SVM",3,2,3612,3313,299,300,193,107,0.9057659453303,0.59,1.7332782369146,179,86,93,78,1.1,7.67,1.8,0,0,0,0,0,0,0.539270807088046,372.97038574434,70.3451934860285
8.7,"greedy_SVM","SVM",3,3,3512,3289,223,400,217,183,0.916852220956722,0.62,1.72588235294118,223,111,112,44,1,10.22,1.2,0,0,0,0,0,0,0.419117763959534,248.637477962753,53.0313415779751
8.7,"greedy_SVM","SVM",3,4,3412,3239,173,500,267,233,0.89640802961276,0.61,1.6809375,319,158,161,96,1,12.78,1.1,0,0,0,0,0,0,0.352434162701831,258.947296781014,51.349839753124
8.7,"greedy_SVM","SVM",3,5,3312,3179,133,600,327,273,0.867803246013675,0.625,1.62099447513812,405,198,207,86,1,15.34,1.2,0,0,0,0,0,0,0.268352028569575,220.154655878611,39.3311094290189
8.7,"greedy_SVM","SVM",3,6,3212,3094,118,700,412,288,0.878361332574033,0.665,1.59397790055249,443,214,229,38,1.1,17.89,1.4,0,0,0,0,0,0,0.156688367347557,205.351148891899,22.9024870029955
8.7,"greedy_SVM","SVM",3,7,3112,3016,96,800,490,310,0.876796697038728,0.67,1.60298342541436,494,236,258,51,1.1,20.45,1.6,0,0,0,0,0,0,0.095166179833792,135.363403804566,12.4548607146207
8.7,"greedy_SVM","SVM",3,8,3012,2933,79,900,573,327,0.901138952164015,0.67,1.64952995391705,545,262,283,51,1.1,23.01,1.8,0,0,0,0,0,0,0.0708269517557046,95.3152072460668,10.2516955623882
8.7,"greedy_SVM","SVM",3,9,2912,2844,68,1000,662,338,0.902670842824601,0.695,1.64498161764706,579,272,307,34,1.1,25.56,2,0,0,0,0,0,0,0.0637599577081735,92.2200204045612,7.3103416186475
8.7,"greedy_SVM","SVM",3,10,2812,2753,59,1100,753,347,0.908072323462429,0.68,1.64045829514207,601,288,313,22,1.1,28.12,2.2,0,0,0,0,0,0,0.0553449286141904,75.5146114993761,6.28902811521524
8.7,"greedy_SVM","SVM",3,11,2712,2659,53,1200,847,353,0.912038724373585,0.68,1.68837465564738,619,294,325,18,1.1,30.67,2.4,0,0,0,0,0,0,0.0537145822168041,76.4192602285102,6.29903086199187
8.7,"greedy_SVM","SVM",3,12,2612,2562,50,1300,944,356,0.923787015945335,0.675,1.7126267281106,637,305,332,18,1.1,33.23,2.7,0,0,0,0,0,0,0.0461745268274292,57.5085902166287,5.35153671107944
8.7,"greedy_SVM","SVM",3,13,2512,2469,43,1400,1037,363,0.929073177676538,0.67,1.72906077348066,659,316,343,22,1.1,35.79,2.9,0,0,0,0,0,0,0.0470911503813953,51.4437828320521,5.20139621146828
8.7,"greedy_SVM","SVM",3,14,2412,2377,35,1500,1129,371,0.935085421412321,0.665,1.75446182152714,676,325,351,17,1.1,38.34,3,0,0,0,0,0,0,0.0609641071240941,52.3152339109938,6.78893510744483
8.7,"greedy_SVM","SVM",3,15,2312,2282,30,1600,1224,376,0.936116173120755,0.665,1.7560773480663,691,329,362,15,1.1,40.9,3.3,0,0,0,0,0,0,0.0515429199755127,42.6563608910311,5.91912337030193
8.7,"greedy_SVM","SVM",3,16,2212,2187,25,1700,1319,381,0.937357630979522,0.665,1.76022038567493,701,334,367,10,1.1,43.46,3.5,0,0,0,0,0,0,0.0362387111671704,34.0930592098651,4.47309432061039
8.7,"greedy_SVM","SVM",3,17,2112,2093,19,1800,1413,387,0.937238041002303,0.66,1.75284926470588,713,340,373,12,1.1,46.01,3.7,0,0,0,0,0,0,0.0315029075224931,32.7370685908843,3.67197321486646
8.7,"greedy_SVM","SVM",3,18,2012,1996,16,1900,1510,390,0.937697892938521,0.66,1.76508287292818,723,346,377,10,1.1,48.57,3.9,0,0,0,0,0,0,0.0292252828600813,28.8766926163356,2.9836980842125
8.7,"greedy_SVM","SVM",3,19,1912,1897,15,2000,1609,391,0.936019362186809,0.66,1.76345906163753,742,360,382,19,1.1,51.12,4.1,0,0,0,0,0,0,0.0201429969877734,14.9691413711069,2.70420303079802
8.7,"greedy_SVM","SVM",3,20,1812,1801,11,2100,1705,395,0.937239464692503,0.66,1.76183823529412,756,363,393,14,1.1,53.68,4.3,0,0,0,0,0,0,0.0148188094603235,12.7578371625726,1.71977049043604
8.7,"greedy_SVM","SVM",3,21,1712,1702,10,2200,1804,396,0.93750569476084,0.655,1.75860550458716,763,369,394,7,1.1,56.24,4.6,0,0,0,0,0,0,0.0117740339886845,9.712795325884,1.30965044175802
8.7,"greedy_SVM","SVM",3,22,1612,1606,6,2300,1900,400,0.938473804100249,0.66,1.76434065934066,781,374,407,18,1.1,58.79,4.8,0,0,0,0,0,0,0.012316941722213,9.47800029830268,1.29735197204655
8.7,"greedy_SVM","SVM",3,23,1512,1506,6,2400,2000,400,0.938160592255142,0.665,1.76920110192837,781,380,401,0,1.1,61.35,5,0,0,0,0,0,0,0.00837301249031057,6.12949958617286,0.985040103105427
8.7,"greedy_SVM","SVM",3,24,1412,1408,4,2500,2098,402,0.938402619589994,0.67,1.76920110192837,787,383,404,6,1.1,63.91,5.2,0,0,0,0,0,0,0.00840591189466182,6.05095101572367,0.893103888737705
8.7,"greedy_SVM","SVM",3,25,1312,1308,4,2600,2198,402,0.938613325740334,0.665,1.77245630174793,796,389,407,9,1,66.46,5.5,0,0,0,0,0,0,0.0068010119897131,4.53332180897854,0.752886438579506
8.7,"greedy_SVM","SVM",3,26,1212,1208,4,2700,2298,402,0.938523633257419,0.66,1.77408839779006,795,389,406,-1,1,69.02,5.7,0,0,0,0,0,0,0.00547201004554775,3.25484785107095,0.566475623222002
8.7,"greedy_SVM","SVM",3,27,1112,1108,4,2800,2398,402,0.938681662870174,0.66,1.76920110192837,794,388,406,-1,1,71.57,6,0,0,0,0,0,0,0.00453120990854705,2.45111541198719,0.489784833043069
8.7,"greedy_SVM","SVM",3,28,1012,1009,3,2900,2497,403,0.938831150341701,0.665,1.76757798165138,799,390,409,5,1,74.13,6.2,0,0,0,0,0,0,0.0044116145402777,2.21346607012682,0.474966841063446
8.7,"greedy_SVM","SVM",3,29,912,909,3,3000,2597,403,0.938849658314366,0.665,1.76920110192837,797,390,407,-2,1,76.69,6.4,0,0,0,0,0,0,0.00345157539765031,1.54958917260633,0.371364045400868
8.7,"greedy_SVM","SVM",3,30,812,809,3,3100,2697,403,0.938977790432818,0.665,1.77245630174793,800,391,409,3,1,79.24,6.7,0,0,0,0,0,0,0.00294194488428531,1.18865549492653,0.320246365669915
8.7,"greedy_SVM","SVM",3,31,712,709,3,3200,2797,403,0.938970671981793,0.66,1.77408839779006,801,391,410,1,1,81.8,6.9,0,0,0,0,0,0,0.00221496501081299,0.780565223093267,0.243235680430821
8.7,"greedy_SVM","SVM",3,32,612,609,3,3300,2897,403,0.939037585421429,0.66,1.77082720588235,802,391,411,1,1.1,84.36,7.2,0,0,0,0,0,0,0.00181081242611586,0.567870254419823,0.205516500091039
8.7,"greedy_SVM","SVM",3,33,512,510,2,3400,2996,404,0.939436218678831,0.66,1.76757798165138,807,393,414,5,1.1,86.91,7.4,0,0,0,0,0,0,0.00141525894328276,0.441132095934321,0.175422876864362
8.7,"greedy_SVM","SVM",3,34,412,411,1,3500,3095,405,0.93935933940776,0.66,1.76920110192837,811,396,415,4,1,89.47,7.6,0,0,0,0,0,0,0.001085518648873,0.303042631558714,0.133895420987037
8.7,"greedy_SVM","SVM",3,35,312,312,0,3600,3194,406,0.93950740318908,0.66,1.77408839779006,816,398,418,5,1.1,92.02,7.9,0,0,0,0,0,0,0.00080343240456709,0.208781027084884,0.105875578330498
8.7,"greedy_SVM","SVM",3,36,212,212,0,3700,3294,406,0.939832004555822,0.655,1.76920110192837,821,400,421,5,1.1,94.58,8.1,0,0,0,0,0,0,0.000555459246069916,0.116321642566435,0.072225303741868
8.7,"greedy_SVM","SVM",3,37,112,112,0,3800,3394,406,0.939904612756277,0.65,1.77408839779006,823,400,423,2,1.1,97.14,8.4,0,0,0,0,0,0,0.000233862376018684,0.0371811646084126,0.0346624565644863
8.7,"greedy_SVM","SVM",3,38,12,12,0,3900,3494,406,0.940327448747164,0.65,1.77245630174793,825,401,424,2,1.1,99.69,8.6,0,0,0,0,0,0,0.000179052124642012,0.00246747476803348,0.00246747476803348
8.7,"greedy_SVM","SVM",3,39,0,0,0,3912,3506,406,0.940219248291583,0.645,1.77245630174793,825,401,424,0,1.1,100,8.6,0,0,0,0,0,0,0,0,0
8.7,"greedy_SVM","SVM",4,0,3812,3425,387,100,91,9,0.925849560901107,0.604761904761905,1.76679821099711,23,9,14,0,1.6,2.56,10.1,0,0,0,0,0,0,0.407202147833007,312.242198637218,45.6804154176481
8.7,"greedy_SVM","SVM",4,1,3712,3407,305,200,109,91,0.923525882288754,0.623809523809524,1.75984200131666,72,39,33,49,0.8,5.11,1.2,0,0,0,0,0,0,0.658651248022953,207.167936853733,77.8504523146934
8.7,"greedy_SVM","SVM",4,2,3612,3368,244,300,148,152,0.919598538155227,0.619047619047619,1.72771874590056,152,81,71,80,0.9,7.67,1,0,0,0,0,0,0,0.431900472278215,157.070785458941,56.1849594821137
8.7,"greedy_SVM","SVM",4,3,3512,3319,193,400,197,203,0.915095729013252,0.647619047619048,1.73408821593153,246,127,119,94,0.9,10.22,1,0,0,0,0,0,0,0.187106594285559,68.5943656551219,29.3447882529282
8.7,"greedy_SVM","SVM",4,4,3412,3249,163,500,267,233,0.885324278623244,0.671428571428571,1.62099447513812,327,162,165,81,1,12.78,1.1,0,0,0,0,0,0,0.119759027230705,72.6394355731694,19.0887369420282
8.7,"greedy_SVM","SVM",4,5,3312,3179,133,600,337,263,0.888696612665699,0.685714285714286,1.61241778479348,397,192,205,70,1.1,15.34,1.3,0,0,0,0,0,0,0.0775383636179862,52.9476411545548,11.1986707989178
8.7,"greedy_SVM","SVM",4,6,3212,3101,111,700,415,285,0.886835215185731,0.685714285714286,1.61950321987121,449,217,232,52,1.1,17.89,1.5,0,0,0,0,0,0,0.0604896101480585,59.3505333410474,9.50356137551893
8.7,"greedy_SVM","SVM",4,7,3112,3015,97,800,501,299,0.894286259750178,0.69047619047619,1.64520962018662,483,231,252,34,1.1,20.45,1.7,0,0,0,0,0,0,0.0608743207768072,80.1862683542363,8.41945035728616
8.7,"greedy_SVM","SVM",4,8,3012,2928,84,900,588,312,0.904895543555343,0.7,1.68258064516129,516,248,268,33,1.1,23.01,1.9,0,0,0,0,0,0,0.0568517095670247,76.7179673034908,6.43374260284507
8.7,"greedy_SVM","SVM",4,9,2912,2838,74,1000,678,322,0.914779359624715,0.704761904761905,1.68258064516129,545,258,287,29,1.1,25.56,2.1,0,0,0,0,0,0,0.0536205075076006,77.3414662126094,6.19867765007762
8.7,"greedy_SVM","SVM",4,10,2812,2746,66,1100,770,330,0.919511263841165,0.704761904761905,1.68805362071231,571,270,301,26,1.1,28.12,2.3,0,0,0,0,0,0,0.0555038020650083,78.7097814621451,6.29596235611219
8.7,"greedy_SVM","SVM",4,11,2712,2656,56,1200,860,340,0.931015109365625,0.695238095238095,1.70904325032765,613,296,317,42,1.1,30.67,2.5,0,0,0,0,0,0,0.0452837377242192,42.5503881302198,5.98265050907761
8.7,"greedy_SVM","SVM",4,12,2612,2564,48,1300,952,348,0.932119674903177,0.69047619047619,1.71691902567479,632,305,327,19,1.1,33.23,2.7,0,0,0,0,0,0,0.0324400818297459,36.4835294657795,3.77655333122002
8.7,"greedy_SVM","SVM",4,13,2512,2472,40,1400,1044,356,0.935572464953889,0.695238095238095,1.72550362080316,652,313,339,20,1.1,35.79,2.9,0,0,0,0,0,0,0.0431814381283726,46.8999682538406,5.3472548665169
8.7,"greedy_SVM","SVM",4,14,2412,2379,33,1500,1137,363,0.940619374897713,0.695238095238095,1.75498949579832,683,328,355,31,1.1,38.34,3.1,0,0,0,0,0,0,0.0523087955214522,42.7445691026553,6.04740611828254
8.7,"greedy_SVM","SVM",4,15,2312,2280,32,1600,1236,364,0.940821196749021,0.695238095238095,1.75498949579832,686,333,353,3,1.1,40.9,3.4,0,0,0,0,0,0,0.0384919253799769,31.8388287473903,4.31450082853646
8.7,"greedy_SVM","SVM",4,16,2212,2184,28,1700,1332,368,0.941466208476506,0.69047619047619,1.75660402155342,701,341,360,15,1.1,43.46,3.6,0,0,0,0,0,0,0.0370207332341188,27.882692643636,4.15699822788587
8.7,"greedy_SVM","SVM",4,17,2112,2090,22,1800,1426,374,0.941467572137658,0.685714285714286,1.75176933158585,710,345,365,9,1.1,46.01,3.8,0,0,0,0,0,0,0.0392903638321235,26.3984772777938,4.59715806237548
8.7,"greedy_SVM","SVM",4,18,2012,1999,13,1900,1517,383,0.939840724376791,0.685714285714286,1.75822152065246,734,353,381,24,1.1,48.57,4,0,0,0,0,0,0,0.0370628512791714,27.2261240466511,4.93058331810496
8.7,"greedy_SVM","SVM",4,19,1912,1901,11,2000,1615,385,0.939488899798162,0.69047619047619,1.75660402155342,738,354,384,4,1.1,51.12,4.2,0,0,0,0,0,0,0.0263986218183591,22.8306070854936,3.13517397217561
8.7,"greedy_SVM","SVM",4,20,1812,1801,11,2100,1715,385,0.939611629302335,0.685714285714286,1.75337793519612,741,357,384,3,1.1,53.68,4.5,0,0,0,0,0,0,0.0206829602419004,18.5278166107964,2.2530903738004
8.7,"greedy_SVM","SVM",4,21,1712,1703,9,2200,1813,387,0.940034364261159,0.685714285714286,1.75984200131666,743,359,384,2,1.1,56.24,4.7,0,0,0,0,0,0,0.0190052802460257,15.7904205064144,1.93173456086469
8.7,"greedy_SVM","SVM",4,22,1612,1603,9,2300,1913,387,0.940358915616645,0.680952380952381,1.75984200131666,755,369,386,12,1,58.79,4.9,0,0,0,0,0,0,0.014163864555318,10.3052422684063,1.74907179217656
8.7,"greedy_SVM","SVM",4,23,1512,1505,7,2400,2011,389,0.940991654393715,0.680952380952381,1.75337793519612,760,371,389,5,1,61.35,5.2,0,0,0,0,0,0,0.0110868247249651,8.10819404580386,1.20469717477957
8.7,"greedy_SVM","SVM",4,24,1412,1405,7,2500,2111,389,0.940931653302786,0.676190476190476,1.75498949579832,761,371,390,1,1.1,63.91,5.4,0,0,0,0,0,0,0.0105185672197303,6.9018745090224,1.07316101987518
8.7,"greedy_SVM","SVM",4,25,1312,1305,7,2600,2211,389,0.941515300278181,0.676190476190476,1.76842659644503,772,374,398,11,1.1,66.46,5.7,0,0,0,0,0,0,0.00642816021222753,3.92414869824701,0.75250575152319
8.7,"greedy_SVM","SVM",4,26,1212,1206,6,2700,2310,390,0.941741668030322,0.676190476190476,1.76193099829463,775,376,399,3,1.1,69.02,5.9,0,0,0,0,0,0,0.0066997395238767,3.56580532835567,0.700070868083636
8.7,"greedy_SVM","SVM",4,27,1112,1106,6,2800,2410,390,0.942142584410611,0.676190476190476,1.7770111915734,782,379,403,7,1.1,71.57,6.2,0,0,0,0,0,0,0.00555595050898013,2.65573983193776,0.616435818772132
8.7,"greedy_SVM","SVM",4,28,1012,1006,6,2900,2510,390,0.942107129220517,0.676190476190476,1.77211134453782,782,379,403,0,1.1,74.13,6.4,0,0,0,0,0,0,0.00459645300994345,1.86237751677179,0.481376134233444
8.7,"greedy_SVM","SVM",4,29,912,906,6,3000,2610,390,0.942445317187565,0.671428571428571,1.77048406139315,787,380,407,5,1.1,76.69,6.7,0,0,0,0,0,0,0.00406957952432921,1.42546291312496,0.441307899877403
8.7,"greedy_SVM","SVM",4,30,812,807,5,3100,2709,391,0.942502590956179,0.671428571428571,1.77211134453782,788,381,407,1,1.1,79.24,6.9,0,0,0,0,0,0,0.00316106747033625,0.974161344890927,0.361373047323941
8.7,"greedy_SVM","SVM",4,31,712,708,4,3200,2808,392,0.942814869361239,0.671428571428571,1.76885976408912,793,383,410,5,1.1,81.8,7.2,0,0,0,0,0,0,0.00169163431268958,0.518618723552637,0.218297639427803
8.7,"greedy_SVM","SVM",4,32,612,609,3,3300,2907,393,0.942853051873648,0.671428571428571,1.77211134453782,794,385,409,1,1.1,84.36,7.4,0,0,0,0,0,0,0.00123927319701101,0.388900914004234,0.161759331699015
8.7,"greedy_SVM","SVM",4,33,512,510,2,3400,3006,394,0.943320787650661,0.671428571428571,1.76723844441535,799,388,411,5,1.1,86.91,7.6,0,0,0,0,0,0,0.000799886844646792,0.243168660057798,0.104685793543381
8.7,"greedy_SVM","SVM",4,34,412,411,1,3500,3105,395,0.94347897234493,0.676190476190476,1.77537490134175,804,390,414,5,1.1,89.47,7.9,0,0,0,0,0,0,0.00057909208442035,0.167074574714235,0.0735701742716848
8.7,"greedy_SVM","SVM",4,35,312,312,0,3600,3204,396,0.943915343915321,0.671428571428571,1.77252646712848,807,393,414,3,1.1,92.02,8.1,0,0,0,0,0,0,0.000623633480565386,0.148251384044256,0.0743680351930493
8.7,"greedy_SVM","SVM",4,36,212,212,0,3700,3304,396,0.943802160039251,0.671428571428571,1.76885976408912,809,394,415,2,1.1,94.58,8.3,0,0,0,0,0,0,0.000207193057821853,0.0432852116964936,0.0284766645816774
8.7,"greedy_SVM","SVM",4,37,112,112,0,3800,3404,396,0.943868979435968,0.666666666666667,1.76723844441535,814,396,418,5,1.1,97.14,8.6,0,0,0,0,0,0,9.11235230811216e-05,0.0167703076789016,0.0158072960590394
8.7,"greedy_SVM","SVM",4,38,12,12,0,3900,3504,396,0.943803523700409,0.666666666666667,1.76723844441535,814,396,418,0,1.1,99.69,8.8,0,0,0,0,0,0,4.49797850594325e-05,0.000734938476605912,0.000734938476605912
8.7,"greedy_SVM","SVM",4,39,0,0,0,3912,3516,396,0.943849888179764,0.666666666666667,1.7737416217637,813,396,417,-1,1.1,100,8.9,0,0,0,0,0,0,0,0,0
8.7,"greedy_SVM","SVM",5,0,3812,3412,400,100,88,12,0.914375065822582,0.556701030927835,1.77488716803649,34,12,22,0,1.8,2.56,7.3,0,0,0,0,0,0,0.296610892390413,447.695517156522,33.7145039555752
8.7,"greedy_SVM","SVM",5,1,3712,3388,324,200,112,88,0.914857764723801,0.608247422680412,1.74219223771983,97,47,50,63,1.1,5.11,1.3,0,0,0,0,0,0,0.823726556707059,381.59145738647,87.178112058856
8.7,"greedy_SVM","SVM",5,2,3612,3358,254,300,142,158,0.908837192974246,0.628865979381443,1.68809952745211,163,86,77,66,0.9,7.67,0.9,0,0,0,0,0,0,0.545808102615653,230.085012412042,64.751986689379
8.7,"greedy_SVM","SVM",5,3,3512,3321,191,400,179,221,0.898769264074343,0.623711340206186,1.65574576752104,230,118,112,67,0.9,10.22,0.8,0,0,0,0,0,0,0.387455450185874,249.968077949688,48.1472557144571
8.7,"greedy_SVM","SVM",5,4,3412,3262,150,500,238,262,0.876743566940106,0.639175257731959,1.64025545785324,337,171,166,107,1,12.78,0.9,0,0,0,0,0,0,0.233377065073266,141.22588700663,32.1332971922432
8.7,"greedy_SVM","SVM",5,5,3312,3194,118,600,306,294,0.87155821056203,0.628865979381443,1.60466241144169,408,204,204,71,1,15.34,1,0,0,0,0,0,0,0.163133051732583,164.414838948016,21.7026504275626
8.7,"greedy_SVM","SVM",5,6,3212,3115,97,700,385,315,0.878286740700006,0.654639175257732,1.63549812342629,471,229,242,63,1.1,17.89,1.2,0,0,0,0,0,0,0.0956932539142121,111.223879180101,12.3382134070887
8.7,"greedy_SVM","SVM",5,7,3112,3036,76,800,464,336,0.883766104590618,0.670103092783505,1.6447907264003,519,251,268,48,1.1,20.45,1.4,0,0,0,0,0,0,0.0837501074367153,125.152019106653,10.1731701108121
8.7,"greedy_SVM","SVM",5,8,3012,2950,62,900,550,350,0.901497244228108,0.675257731958763,1.6447907264003,557,268,289,38,1.1,23.01,1.6,0,0,0,0,0,0,0.0787470147203399,129.101643286366,9.07574920018986
8.7,"greedy_SVM","SVM",5,9,2912,2857,55,1000,643,357,0.90971482734007,0.65979381443299,1.69125374127037,574,279,295,17,1.1,25.56,1.8,0,0,0,0,0,0,0.0602209867314098,94.9202111546333,6.63353086348062
8.7,"greedy_SVM","SVM",5,10,2812,2764,48,1100,736,364,0.915703219162855,0.664948453608247,1.69741746412618,590,283,307,16,1.1,28.12,2,0,0,0,0,0,0,0.0615124496067739,100.060063774838,6.5418789892251
8.7,"greedy_SVM","SVM",5,11,2712,2666,46,1200,834,366,0.922589723486666,0.65979381443299,1.70355854704496,606,295,311,16,1.1,30.67,2.3,0,0,0,0,0,0,0.0533660468680284,79.1360112269709,5.74046343156193
8.7,"greedy_SVM","SVM",5,12,2612,2570,42,1300,930,370,0.930700527750796,0.664948453608247,1.71439129775622,627,306,321,21,1,33.23,2.5,0,0,0,0,0,0,0.0549475670723146,68.0906429365025,6.11359875985841
8.7,"greedy_SVM","SVM",5,13,2512,2475,37,1400,1025,375,0.931690791860234,0.664948453608247,1.73581058117141,645,313,332,18,1.1,35.79,2.7,0,0,0,0,0,0,0.0604695891857826,64.0106513459099,6.81426269859228
8.7,"greedy_SVM","SVM",5,14,2412,2377,35,1500,1123,377,0.931566460325066,0.65979381443299,1.74504361617764,652,318,334,7,1.1,38.34,3,0,0,0,0,0,0,0.0505936808113679,46.1323184942082,5.53415938198031
8.7,"greedy_SVM","SVM",5,15,2312,2283,29,1600,1217,383,0.931608879319405,0.654639175257732,1.75910936923121,678,326,352,26,1.1,40.9,3.2,0,0,0,0,0,0,0.0552860728001435,43.8548361873022,6.17259957472044
8.7,"greedy_SVM","SVM",5,16,2212,2192,20,1700,1308,392,0.932022830195283,0.65979381443299,1.76072619769557,705,336,369,27,1.1,43.46,3.3,0,0,0,0,0,0,0.0525933943683755,39.3090786693468,5.99608310580926
8.7,"greedy_SVM","SVM",5,17,2112,2098,14,1800,1402,398,0.932454333758479,0.654639175257732,1.76559456506247,714,343,371,9,1.1,46.01,3.5,0,0,0,0,0,0,0.0387115903949389,33.7212418038226,4.83134859034101
8.7,"greedy_SVM","SVM",5,18,2012,2001,11,1900,1499,401,0.933185695729998,0.654639175257732,1.76234600100532,721,346,375,7,1.1,48.57,3.7,0,0,0,0,0,0,0.029276482190252,28.6765961663,3.36882971466102
8.7,"greedy_SVM","SVM",5,19,1912,1902,10,2000,1598,402,0.933191546625768,0.649484536082474,1.76559456506247,722,347,375,1,1.1,51.12,4,0,0,0,0,0,0,0.0252609039659481,24.9228825447507,2.69669444219249
8.7,"greedy_SVM","SVM",5,20,1812,1802,10,2100,1698,402,0.932910703628704,0.644329896907217,1.76396878737825,728,349,379,6,1.1,53.68,4.2,0,0,0,0,0,0,0.0203972857835236,20.0981009097433,2.21068751079177
8.7,"greedy_SVM","SVM",5,21,1712,1703,9,2200,1797,403,0.932925330868132,0.644329896907217,1.76234600100532,732,353,379,4,1.1,56.24,4.5,0,0,0,0,0,0,0.0172431708444663,15.4957467407748,1.76041634402006
8.7,"greedy_SVM","SVM",5,22,1612,1604,8,2300,1896,404,0.931266601916741,0.644329896907217,1.76836783959558,758,367,391,26,1.1,58.79,4.7,0,0,0,0,0,0,0.0121962502989557,8.66312809929341,1.57061018375594
8.7,"greedy_SVM","SVM",5,23,1512,1506,6,2400,1994,406,0.931392396175839,0.639175257731959,1.77162150627377,759,370,389,1,1.1,61.35,4.9,0,0,0,0,0,0,0.00893927851501757,7.13752441209162,1.03932674674786
8.7,"greedy_SVM","SVM",5,24,1412,1406,6,2500,2094,406,0.931307558187143,0.639175257731959,1.77162150627377,757,369,388,-2,1.1,63.91,5.2,0,0,0,0,0,0,0.00755268079602715,5.61140847337637,0.774386408137655
8.7,"greedy_SVM","SVM",5,25,1312,1308,4,2600,2192,408,0.931222720198446,0.639175257731959,1.77162150627377,765,374,391,8,1,66.46,5.4,0,0,0,0,0,0,0.00571290051410723,4.09407877984902,0.686134302176522
8.7,"greedy_SVM","SVM",5,26,1212,1209,3,2700,2291,409,0.931038416981625,0.639175257731959,1.77162150627377,771,377,394,6,1,69.02,5.6,0,0,0,0,0,0,0.0055732440672146,3.67859872672169,0.576128969190961
8.7,"greedy_SVM","SVM",5,27,1112,1109,3,2800,2391,409,0.930895070035211,0.634020618556701,1.77488716803649,774,381,393,3,1,71.57,5.8,0,0,0,0,0,0,0.00456591523903355,2.69797918318276,0.495669542076129
8.7,"greedy_SVM","SVM",5,28,1012,1010,2,2900,2490,410,0.931348514457558,0.628865979381443,1.76674548377944,781,383,398,7,1,74.13,6.1,0,0,0,0,0,0,0.00440508352360198,2.39737648497273,0.467760033600305
8.7,"greedy_SVM","SVM",5,29,912,910,2,3000,2590,410,0.93224955240648,0.628865979381443,1.77325283362761,786,386,400,5,1,76.69,6.3,0,0,0,0,0,0,0.00343893439166726,1.64518570669728,0.371590606517492
8.7,"greedy_SVM","SVM",5,30,812,810,2,3100,2690,410,0.932574277121838,0.628865979381443,1.77162150627377,788,386,402,2,1,79.24,6.6,0,0,0,0,0,0,0.00276462025223681,1.11591670805012,0.290984184236841
8.7,"greedy_SVM","SVM",5,31,712,710,2,3200,2790,410,0.932887300045651,0.628865979381443,1.77325283362761,791,387,404,3,1,81.8,6.8,0,0,0,0,0,0,0.00236302782581496,0.827697280311825,0.26135317545763
8.7,"greedy_SVM","SVM",5,32,612,610,2,3300,2890,410,0.932901927285083,0.628865979381443,1.76674548377944,792,388,404,1,1,84.36,7,0,0,0,0,0,0,0.00157056766090026,0.489392075341693,0.187763150099864
8.7,"greedy_SVM","SVM",5,33,512,510,2,3400,2990,410,0.933084767777964,0.628865979381443,1.76674548377944,790,388,402,-2,1,86.91,7.3,0,0,0,0,0,0,0.00094284633811899,0.303939267822945,0.127956225444603
8.7,"greedy_SVM","SVM",5,34,412,412,0,3500,3088,412,0.933074528710368,0.628865979381443,1.77325283362761,800,391,409,10,1,89.47,7.5,0,0,0,0,0,0,0.00113394029940579,0.335905514308837,0.139200268369283
8.7,"greedy_SVM","SVM",5,35,312,312,0,3600,3188,412,0.93339340252995,0.623711340206186,1.77325283362761,805,393,412,5,1,92.02,7.7,0,0,0,0,0,0,0.000705453649823829,0.179018693058544,0.0878078971316673
8.7,"greedy_SVM","SVM",5,36,212,212,0,3700,3288,412,0.93361573656929,0.618556701030928,1.77162150627377,810,395,415,5,1.1,94.58,8,0,0,0,0,0,0,0.000382954759581594,0.0801995847351916,0.050004538001835
8.7,"greedy_SVM","SVM",5,37,112,112,0,3800,3388,412,0.933955088524073,0.618556701030928,1.77162150627377,815,397,418,5,1.1,97.14,8.2,0,0,0,0,0,0,0.000180192662540907,0.0297056026128272,0.0277972941381026
8.7,"greedy_SVM","SVM",5,38,12,12,0,3900,3488,412,0.934183273459185,0.623711340206186,1.76999317768344,815,398,417,0,1,99.69,8.5,0,0,0,0,0,0,9.66432913253039e-05,0.00142531502646609,0.00142531502646609
8.7,"greedy_SVM","SVM",5,39,0,0,0,3912,3500,412,0.934221304281703,0.623711340206186,1.77162150627377,815,398,417,0,1,100,8.5,0,0,0,0,0,0,0,0,0
8.7,"greedy_SVM","SVM",6,0,3812,3396,416,100,91,9,0.894834643218441,0.524861878453039,1.74300481197647,23,9,14,0,1.6,2.56,10.1,0,0,0,0,0,0,0.282126655902208,341.67125683949,32.0732791941071
8.7,"greedy_SVM","SVM",6,1,3712,3360,352,200,127,73,0.893486888179924,0.519337016574586,1.71312472948545,96,49,47,73,1,5.11,1.7,0,0,0,0,0,0,0.826678489006061,355.472294869345,89.2117778498427
8.7,"greedy_SVM","SVM",6,2,3612,3322,290,300,165,135,0.909331569527678,0.569060773480663,1.74172788537429,167,86,81,71,0.9,7.67,1.2,0,0,0,0,0,0,0.462535948359773,160.235403588722,58.7806387313288
8.7,"greedy_SVM","SVM",6,3,3512,3288,224,400,199,201,0.909210178196262,0.574585635359116,1.72149812276793,238,124,114,71,0.9,10.22,1,0,0,0,0,0,0,0.289204133777293,130.920154186248,45.1667162014788
8.7,"greedy_SVM","SVM",6,4,3412,3235,177,500,252,248,0.860387518481054,0.607734806629834,1.57078888115194,319,162,157,81,1,12.78,1,0,0,0,0,0,0,0.159428611525326,96.2976591752172,29.0536347213671
8.7,"greedy_SVM","SVM",6,5,3312,3176,136,600,311,289,0.861607656991677,0.613259668508287,1.60208784835628,401,197,204,82,1,15.34,1.1,0,0,0,0,0,0,0.128480040930087,75.1704612823612,22.2383491734065
8.7,"greedy_SVM","SVM",6,6,3212,3094,118,700,393,307,0.874887557388533,0.646408839779006,1.61203870455725,443,215,228,42,1.1,17.89,1.3,0,0,0,0,0,0,0.0719042508283581,42.7542856759648,10.7452801973163
8.7,"greedy_SVM","SVM",6,7,3112,3009,103,800,478,322,0.884466578476382,0.651933701657459,1.63344450950938,472,226,246,29,1.1,20.45,1.5,0,0,0,0,0,0,0.0530201991536633,40.1335298725488,7.20929128290499
8.7,"greedy_SVM","SVM",6,8,3012,2929,83,900,558,342,0.886284335849361,0.651933701657459,1.63344450950938,534,255,279,62,1.1,23.01,1.6,0,0,0,0,0,0,0.0508057788840757,65.9210857080581,8.55244105034073
8.7,"greedy_SVM","SVM",6,9,2912,2845,67,1000,642,358,0.899089565014395,0.662983425414365,1.65873821904452,576,273,303,42,1.1,25.56,1.8,0,0,0,0,0,0,0.0474593594089639,66.4108502138471,5.90789933988198
8.7,"greedy_SVM","SVM",6,10,2812,2756,56,1100,731,369,0.912588903587265,0.674033149171271,1.69320467449143,604,286,318,28,1.1,28.12,2,0,0,0,0,0,0,0.0543994468430992,81.1469956884811,6.57475796058364
8.7,"greedy_SVM","SVM",6,11,2712,2663,49,1200,824,376,0.916062563224647,0.662983425414365,1.71991440784358,628,302,326,24,1.1,30.67,2.2,0,0,0,0,0,0,0.0442695980432447,62.6333189337362,5.00529332752251
8.7,"greedy_SVM","SVM",6,12,2612,2570,42,1300,917,383,0.921494047155871,0.662983425414365,1.71312472948545,648,314,334,20,1.1,33.23,2.4,0,0,0,0,0,0,0.0483352743330674,64.8334260760759,5.65679541111502
8.7,"greedy_SVM","SVM",6,13,2512,2476,36,1400,1011,389,0.929252198272529,0.657458563535912,1.72826616834579,664,324,340,16,1,35.79,2.6,0,0,0,0,0,0,0.056640695521261,58.3583544897193,6.25167180027589
8.7,"greedy_SVM","SVM",6,14,2412,2380,32,1500,1107,393,0.93152283868962,0.657458563535912,1.7314489789689,682,330,352,18,1.1,38.34,2.8,0,0,0,0,0,0,0.0527612209829477,48.3557149617532,5.83546447332608
8.7,"greedy_SVM","SVM",6,15,2312,2283,29,1600,1204,396,0.931806085129583,0.651933701657459,1.72985610962302,691,335,356,9,1.1,40.9,3,0,0,0,0,0,0,0.0465764285174985,40.9048880738274,5.26817119792985
8.7,"greedy_SVM","SVM",6,16,2212,2187,25,1700,1300,400,0.932229398490411,0.651933701657459,1.73979781140246,708,339,369,17,1.1,43.46,3.2,0,0,0,0,0,0,0.0462593192371252,38.8813488197057,5.4983041931599
8.7,"greedy_SVM","SVM",6,17,2112,2097,15,1800,1390,410,0.931197572173397,0.646408839779006,1.72826616834579,734,349,385,26,1.1,46.01,3.4,0,0,0,0,0,0,0.0360163439220815,34.2904037273172,4.82773969172151
8.7,"greedy_SVM","SVM",6,18,2012,1999,13,1900,1488,412,0.931314294607449,0.646408839779006,1.72985610962302,741,351,390,7,1.1,48.57,3.6,0,0,0,0,0,0,0.0266272541042177,28.4766122767081,2.97845530270726
8.7,"greedy_SVM","SVM",6,19,1912,1900,12,2000,1587,413,0.931759396155966,0.640883977900553,1.72985610962302,746,356,390,5,1.1,51.12,3.8,0,0,0,0,0,0,0.0248437630415286,23.8673840523512,2.52337218996725
8.7,"greedy_SVM","SVM",6,20,1812,1801,11,2100,1686,414,0.933191191346991,0.635359116022099,1.75644947719282,769,373,396,23,1.1,53.68,4.1,0,0,0,0,0,0,0.0184496541602611,13.145051621018,2.38657312381357
8.7,"greedy_SVM","SVM",6,21,1712,1703,9,2200,1784,416,0.933356159053784,0.640883977900553,1.75968121496135,773,375,398,4,1.1,56.24,4.3,0,0,0,0,0,0,0.0123215815290951,9.64619250431906,1.43271369737446
8.7,"greedy_SVM","SVM",6,22,1612,1605,7,2300,1882,418,0.933514901564094,0.635359116022099,1.76130154757181,778,380,398,5,1,58.79,4.5,0,0,0,0,0,0,0.0104406462632937,8.73819786507614,1.14525303018575
8.7,"greedy_SVM","SVM",6,23,1512,1506,6,2400,1981,419,0.933804373200543,0.640883977900553,1.75806386090348,782,383,399,4,1,61.35,4.7,0,0,0,0,0,0,0.00904407274561034,7.16924120979855,0.940921441549533
8.7,"greedy_SVM","SVM",6,24,1412,1406,6,2500,2081,419,0.93441288615673,0.635359116022099,1.76130154757181,794,387,407,12,1.1,63.91,5,0,0,0,0,0,0,0.0075978004005031,5.62323325190363,0.830743266986556
8.7,"greedy_SVM","SVM",6,25,1312,1307,5,2600,2180,420,0.933935102326679,0.635359116022099,1.75968121496135,796,388,408,2,1.1,66.46,5.2,0,0,0,0,0,0,0.00760941866808403,4.9099269195667,0.778154128146767
8.7,"greedy_SVM","SVM",6,26,1212,1207,5,2700,2280,420,0.93557232900164,0.635359116022099,1.75806386090348,806,395,411,10,1,69.02,5.4,0,0,0,0,0,0,0.00538884971445834,3.11448776311805,0.610098111458722
8.7,"greedy_SVM","SVM",6,27,1112,1108,4,2800,2379,421,0.935906933312589,0.635359116022099,1.75806386090348,807,395,412,1,1,71.57,5.7,0,0,0,0,0,0,0.00493555512525322,2.63530034809141,0.521453648908359
8.7,"greedy_SVM","SVM",6,28,1012,1008,4,2900,2479,421,0.935992529764227,0.635359116022099,1.75968121496135,814,399,415,7,1,74.13,5.9,0,0,0,0,0,0,0.00530235559111883,2.4763802013379,0.550108803414024
8.7,"greedy_SVM","SVM",6,29,912,908,4,3000,2579,421,0.936263325811227,0.635359116022099,1.75968121496135,815,399,416,1,1,76.69,6.1,0,0,0,0,0,0,0.00365460157783951,1.45322765646016,0.388965739187415
8.7,"greedy_SVM","SVM",6,30,812,808,4,3100,2679,421,0.936437631312744,0.635359116022099,1.75968121496135,818,399,419,3,1.1,79.24,6.4,0,0,0,0,0,0,0.00284225603354933,0.969808768506415,0.312547783848538
8.7,"greedy_SVM","SVM",6,31,712,708,4,3200,2779,421,0.936434518714502,0.635359116022099,1.75968121496135,817,399,418,-1,1,81.8,6.6,0,0,0,0,0,0,0.00212761718826247,0.658874548461932,0.246806634826935
8.7,"greedy_SVM","SVM",6,32,612,610,2,3300,2877,423,0.937128628122329,0.635359116022099,1.75968121496135,827,404,423,10,1,84.36,6.8,0,0,0,0,0,0,0.00180029912643873,0.560782235209139,0.21949104811182
8.7,"greedy_SVM","SVM",6,33,512,510,2,3400,2977,423,0.937474126527122,0.635359116022099,1.76292486697049,826,404,422,-1,1,86.91,7,0,0,0,0,0,0,0.000995254192053697,0.313489492797677,0.130505312278374
8.7,"greedy_SVM","SVM",6,34,412,411,1,3500,3076,424,0.937953466656295,0.629834254143646,1.76799642508937,833,407,426,7,1,89.47,7.3,0,0,0,0,0,0,0.000821818098411226,0.250619147914997,0.105308283012473
8.7,"greedy_SVM","SVM",6,35,312,312,0,3600,3175,425,0.938174461131433,0.629834254143646,1.77629636394076,838,409,429,5,1,92.02,7.5,0,0,0,0,0,0,0.000726305172524133,0.18428924885135,0.0864980582988982
8.7,"greedy_SVM","SVM",6,36,212,212,0,3700,3275,425,0.938288070967244,0.635359116022099,1.77792898927527,837,409,428,-1,1,94.58,7.7,0,0,0,0,0,0,0.000393071355279209,0.080560938212739,0.0495463532820657
8.7,"greedy_SVM","SVM",6,37,112,112,0,3800,3375,425,0.938339428838227,0.629834254143646,1.77956461852023,843,412,431,6,1,97.14,7.9,0,0,0,0,0,0,0.000192392418274136,0.0306970243003371,0.0286978378169768
8.7,"greedy_SVM","SVM",6,38,12,12,0,3900,3475,425,0.93830519025757,0.629834254143646,1.77956461852023,844,412,432,1,1,99.69,8.2,0,0,0,0,0,0,0.000146848478321177,0.00203542557770758,0.00203542557770758
8.7,"greedy_SVM","SVM",6,39,0,0,0,3912,3487,425,0.938373667418881,0.629834254143646,1.77956461852023,845,412,433,1,1.1,100,8.2,0,0,0,0,0,0,0,0,0
8.7,"greedy_SVM","SVM",7,0,3812,3423,389,100,95,5,0.835378981305163,0.424528301886792,1.66670724284845,28,5,23,0,4.6,2.56,19,0,0,0,0,0,0,0.0821781270840772,211.908162702491,9.8099240710381
8.7,"greedy_SVM","SVM",7,1,3712,3369,343,200,149,51,0.899385494201131,0.55188679245283,1.75217240782413,104,49,55,76,1.1,5.11,2.9,0,0,0,0,0,0,0.717992651395468,355.837283288539,77.9857433062743
8.7,"greedy_SVM","SVM",7,2,3612,3350,262,300,168,132,0.899280011251491,0.556603773584906,1.72305636076444,147,76,71,43,0.9,7.67,1.3,0,0,0,0,0,0,0.577018450672156,269.834553483205,69.335996404896
8.7,"greedy_SVM","SVM",7,3,3512,3312,200,400,206,194,0.915619049679731,0.575471698113208,1.74530900774469,220,110,110,73,1,10.22,1.1,0,0,0,0,0,0,0.417474738266129,208.780989829023,53.4284455384308
8.7,"greedy_SVM","SVM",7,4,3412,3268,144,500,250,250,0.918652360654295,0.580188679245283,1.73843299112098,309,156,153,89,1,12.78,1,0,0,0,0,0,0,0.31592348309921,194.140925021388,43.5361527334192
8.7,"greedy_SVM","SVM",7,5,3312,3199,113,600,319,281,0.874319770209446,0.594339622641509,1.61419785260085,389,194,195,80,1,15.34,1.1,0,0,0,0,0,0,0.178288022371858,153.649315505052,27.4154209092076
8.7,"greedy_SVM","SVM",7,6,3212,3121,91,700,397,303,0.897386727540242,0.613207547169811,1.67366829980194,457,219,238,68,1.1,17.89,1.3,0,0,0,0,0,0,0.0930071005127642,95.292557063941,13.2960562113621
8.7,"greedy_SVM","SVM",7,7,3112,3039,73,800,479,321,0.89868768391898,0.617924528301887,1.64818096528719,499,236,263,42,1.1,20.45,1.5,0,0,0,0,0,0,0.0635780885178368,89.7896152065711,8.70152305368424
8.7,"greedy_SVM","SVM",7,8,3012,2953,59,900,565,335,0.889989397611215,0.622641509433962,1.63667105993341,533,252,281,34,1.1,23.01,1.7,0,0,0,0,0,0,0.0599499826318793,92.5726178385873,9.65835114261577
8.7,"greedy_SVM","SVM",7,9,2912,2858,54,1000,660,340,0.907913384974896,0.617924528301887,1.69759247365954,550,267,283,17,1.1,25.56,1.9,0,0,0,0,0,0,0.0513652641680815,59.1176164415362,6.28690589062232
8.7,"greedy_SVM","SVM",7,10,2812,2763,49,1100,755,345,0.912670936472209,0.617924528301887,1.70451234739179,564,270,294,14,1.1,28.12,2.2,0,0,0,0,0,0,0.0389291042088572,52.8147389505263,4.44734307092243
8.7,"greedy_SVM","SVM",7,11,2712,2671,41,1200,847,353,0.923378808204944,0.617924528301887,1.73154432313274,584,283,301,20,1.1,30.67,2.4,0,0,0,0,0,0,0.0555215504734466,70.3598148856486,6.26157422985862
8.7,"greedy_SVM","SVM",7,12,2612,2572,40,1300,946,354,0.926084851566547,0.60377358490566,1.7183140038082,597,290,307,13,1.1,33.23,2.7,0,0,0,0,0,0,0.0320788309008258,42.6323970694262,3.70215103663844
8.7,"greedy_SVM","SVM",7,13,2512,2480,32,1400,1038,362,0.930053985632679,0.60377358490566,1.75700821023763,628,302,326,31,1.1,35.79,2.9,0,0,0,0,0,0,0.0609678557565155,55.749893104198,7.00410270776571
8.7,"greedy_SVM","SVM",7,14,2412,2381,31,1500,1137,363,0.930521897178459,0.60377358490566,1.75217240782413,628,303,325,0,1.1,38.34,3.1,0,0,0,0,0,0,0.0441428910466361,37.9238910886113,4.96145108395529
8.7,"greedy_SVM","SVM",7,15,2312,2285,27,1600,1233,367,0.931285972390505,0.608490566037736,1.76712185968936,639,309,330,11,1.1,40.9,3.4,0,0,0,0,0,0,0.0460722195356014,35.9952755270406,5.27126631000153
8.7,"greedy_SVM","SVM",7,16,2212,2193,19,1700,1325,375,0.931699790115972,0.608490566037736,1.76712185968936,664,320,344,25,1.1,43.46,3.5,0,0,0,0,0,0,0.0433721057584194,31.7233819209005,5.33727220924441
8.7,"greedy_SVM","SVM",7,17,2112,2102,10,1800,1416,384,0.933246873377183,0.60377358490566,1.76712185968936,693,330,363,29,1.1,46.01,3.7,0,0,0,0,0,0,0.0307605048271908,27.7634243426281,4.07428243442171
8.7,"greedy_SVM","SVM",7,18,2012,2002,10,1900,1516,384,0.933306376579536,0.60377358490566,1.76712185968936,690,329,361,-3,1.1,48.57,3.9,0,0,0,0,0,0,0.0218997360110493,22.3039145957307,2.4682677685866
8.7,"greedy_SVM","SVM",7,19,1912,1903,9,2000,1615,385,0.933203598320921,0.608490566037736,1.76712185968936,693,332,361,3,1.1,51.12,4.2,0,0,0,0,0,0,0.0211245698271782,20.6833941710752,2.16371144185114
8.7,"greedy_SVM","SVM",7,20,1812,1803,9,2100,1715,385,0.93160242123937,0.60377358490566,1.77561763786094,715,346,369,22,1.1,53.68,4.5,0,0,0,0,0,0,0.0147819149308993,10.0910643848748,1.98167612607091
8.7,"greedy_SVM","SVM",7,21,1712,1703,9,2200,1815,385,0.931559146183112,0.599056603773585,1.77235363485017,714,346,368,-1,1.1,56.24,4.7,0,0,0,0,0,0,0.00938619382504086,7.41856379697761,1.11812552207075
8.7,"greedy_SVM","SVM",7,22,1612,1604,8,2300,1914,386,0.931271096589898,0.599056603773585,1.77235363485017,716,347,369,2,1.1,58.79,5,0,0,0,0,0,0,0.00876995143652236,6.90850146253634,0.94391147304642
8.7,"greedy_SVM","SVM",7,23,1512,1506,6,2400,2012,388,0.931684914315361,0.599056603773585,1.77235363485017,719,349,370,3,1.1,61.35,5.2,0,0,0,0,0,0,0.00803165350519204,6.06230042600866,0.835834931684735
8.7,"greedy_SVM","SVM",7,24,1412,1407,5,2500,2111,389,0.931446901505946,0.599056603773585,1.77561763786094,736,356,380,17,1.1,63.91,5.4,0,0,0,0,0,0,0.00675279616530968,4.95021654385838,0.767529874448212
8.7,"greedy_SVM","SVM",7,25,1312,1307,5,2600,2211,389,0.931390102994608,0.60377358490566,1.77398413497422,736,356,380,0,1.1,66.46,5.7,0,0,0,0,0,0,0.00605767564066843,3.8926529562445,0.617974076886816
8.7,"greedy_SVM","SVM",7,26,1212,1207,5,2700,2311,389,0.931482062489155,0.589622641509434,1.77725415181289,744,361,383,8,1.1,69.02,5.9,0,0,0,0,0,0,0.00454445730127072,2.68479227494893,0.509867816685907
8.7,"greedy_SVM","SVM",7,27,1112,1107,5,2800,2411,389,0.931360351393431,0.594339622641509,1.77725415181289,743,361,382,-1,1.1,71.57,6.2,0,0,0,0,0,0,0.00467056030843161,2.40035450727658,0.478560243267451
8.7,"greedy_SVM","SVM",7,28,1012,1007,5,2900,2511,389,0.932059514021093,0.594339622641509,1.76910160983209,750,364,386,7,1.1,74.13,6.5,0,0,0,0,0,0,0.00334250660869222,1.52392174593602,0.371040366874458
8.7,"greedy_SVM","SVM",7,29,912,908,4,3000,2610,390,0.932013534273824,0.589622641509434,1.77235363485017,754,365,389,4,1.1,76.69,6.7,0,0,0,0,0,0,0.0033201136822804,1.27349849776877,0.349022875923932
8.7,"greedy_SVM","SVM",7,30,812,808,4,3100,2710,390,0.932439523108859,0.594339622641509,1.77235363485017,756,367,389,2,1.1,79.24,6.9,0,0,0,0,0,0,0.00224400323486522,0.728957568523317,0.250440889539024
8.7,"greedy_SVM","SVM",7,31,712,709,3,3200,2809,391,0.932493616929181,0.589622641509434,1.7707261292167,759,369,390,3,1.1,81.8,7.2,0,0,0,0,0,0,0.0017903414166162,0.535286265848824,0.209811444364621
8.7,"greedy_SVM","SVM",7,32,612,610,2,3300,2908,392,0.932561234204584,0.589622641509434,1.77235363485017,761,370,391,2,1.1,84.36,7.4,0,0,0,0,0,0,0.00117915945259784,0.369655401754487,0.155462304660416
8.7,"greedy_SVM","SVM",7,33,512,511,1,3400,3007,393,0.932477388783086,0.589622641509434,1.77398413497422,767,373,394,6,1.1,86.91,7.7,0,0,0,0,0,0,0.000946751957584543,0.301706151114345,0.124844409550746
8.7,"greedy_SVM","SVM",7,34,412,412,0,3500,3106,394,0.932766790721807,0.584905660377358,1.77398413497422,772,377,395,5,1,89.47,7.9,0,0,0,0,0,0,0.000689966131227459,0.208880626954293,0.0847820127359057
8.7,"greedy_SVM","SVM",7,35,312,312,0,3600,3206,394,0.93313868573652,0.584905660377358,1.77235363485017,773,379,394,1,1,92.02,8.1,0,0,0,0,0,0,0.000482517187364916,0.123291260831902,0.058174973133046
8.7,"greedy_SVM","SVM",7,36,212,212,0,3700,3306,394,0.933012917604271,0.589622641509434,1.77398413497422,778,381,397,5,1,94.58,8.4,0,0,0,0,0,0,0.000322146449285342,0.0650873503128297,0.0397615348005287
8.7,"greedy_SVM","SVM",7,37,112,112,0,3800,3406,394,0.933112991171867,0.589622641509434,1.77725415181289,776,381,395,-2,1,97.14,8.6,0,0,0,0,0,0,8.87360768278524e-05,0.0159458319195242,0.0150194078556123
8.7,"greedy_SVM","SVM",7,38,12,12,0,3900,3506,394,0.933253635104705,0.589622641509434,1.78575776019477,780,381,399,4,1,99.69,8.9,0,0,0,0,0,0,6.67806201487654e-05,0.000983064644266569,0.000983064644266569
8.7,"greedy_SVM","SVM",7,39,0,0,0,3912,3518,394,0.933130571663472,0.589622641509434,1.78411341603252,780,381,399,0,1,100,8.9,0,0,0,0,0,0,0,0,0
8.7,"greedy_SVM","SVM",8,0,3812,3428,384,100,89,11,0.908722280313421,0.578199052132701,1.7600454277415,32,11,21,0,1.9,2.56,8.1,0,0,0,0,0,0,0.290900071072158,386.018460423964,33.7053799950705
8.7,"greedy_SVM","SVM",8,1,3712,3401,311,200,116,84,0.908515867950399,0.568720379146919,1.71101797814422,102,53,49,70,0.9,5.11,1.4,0,0,0,0,0,0,0.670390434081587,392.755408894926,75.6976493915822
8.7,"greedy_SVM","SVM",8,2,3612,3373,239,300,144,156,0.90678444845801,0.578199052132701,1.6754293664942,161,85,76,59,0.9,7.67,0.9,0,0,0,0,0,0,0.446277128847778,301.876537797463,55.8889521664957
8.7,"greedy_SVM","SVM",8,3,3512,3329,183,400,188,212,0.911019975828028,0.611374407582938,1.74827888401052,244,124,120,83,1,10.22,0.9,0,0,0,0,0,0,0.382426176150746,242.268822461024,52.8432711739993
8.7,"greedy_SVM","SVM",8,4,3412,3277,135,500,240,260,0.875416559160226,0.62085308056872,1.64594060787332,341,173,168,97,1,12.78,0.9,0,0,0,0,0,0,0.311494274874314,250.309115337315,39.581248990817
8.7,"greedy_SVM","SVM",8,5,3312,3200,112,600,317,283,0.889843696954059,0.62085308056872,1.63741241819522,398,196,202,57,1,15.34,1.1,0,0,0,0,0,0,0.157373449672156,180.496415347844,21.9214192768922
8.7,"greedy_SVM","SVM",8,6,3212,3122,90,700,395,305,0.902138812314131,0.644549763033175,1.66606241946404,466,222,244,68,1.1,17.89,1.3,0,0,0,0,0,0,0.105974986425617,144.275201990174,13.6746795557783
8.7,"greedy_SVM","SVM",8,7,3112,3037,75,800,480,320,0.89346134521109,0.639810426540284,1.62888422851712,510,239,271,44,1.1,20.45,1.5,0,0,0,0,0,0,0.0715418261139254,118.787909297048,10.1437503429841
8.7,"greedy_SVM","SVM",8,8,3012,2953,59,900,564,336,0.896334822580429,0.644549763033175,1.63892016443665,548,256,292,38,1.1,23.01,1.7,0,0,0,0,0,0,0.0780785841134686,130.17549385776,8.6493566017292
8.7,"greedy_SVM","SVM",8,9,2912,2858,54,1000,659,341,0.903109765205934,0.639810426540284,1.66452829200597,571,271,300,23,1.1,25.56,1.9,0,0,0,0,0,0,0.061292609181853,89.5839544800417,6.77774035226995
8.7,"greedy_SVM","SVM",8,10,2812,2761,51,1100,756,344,0.90546313773951,0.639810426540284,1.66299698722952,577,274,303,6,1.1,28.12,2.2,0,0,0,0,0,0,0.0533235617547664,75.5278533058479,5.67761303766443
8.7,"greedy_SVM","SVM",8,11,2712,2667,45,1200,850,350,0.909998777821533,0.639810426540284,1.68858155626382,601,286,315,24,1.1,30.67,2.4,0,0,0,0,0,0,0.0591530369550803,76.0803506914611,6.97603799552589
8.7,"greedy_SVM","SVM",8,12,2612,2570,42,1300,947,353,0.921625768953945,0.639810426540284,1.73441369821128,610,295,315,9,1.1,33.23,2.7,0,0,0,0,0,0,0.0477009164714104,53.8135917384034,5.43686997999298
8.7,"greedy_SVM","SVM",8,13,2512,2480,32,1400,1037,363,0.929290185906919,0.639810426540284,1.75842475976015,634,308,326,24,1.1,35.79,2.9,0,0,0,0,0,0,0.0570837210523671,53.2170057023816,6.22027136087319
8.7,"greedy_SVM","SVM",8,14,2412,2382,30,1500,1135,365,0.930032998818551,0.630331753554502,1.75519236130471,643,312,331,9,1.1,38.34,3.1,0,0,0,0,0,0,0.0431276838529508,40.0430970109246,4.82492998913435
8.7,"greedy_SVM","SVM",8,15,2312,2284,28,1600,1233,367,0.930706554950495,0.639810426540284,1.75842475976015,646,312,334,3,1.1,40.9,3.4,0,0,0,0,0,0,0.0391178436036672,38.2624204059742,4.2853759952603
8.7,"greedy_SVM","SVM",8,16,2212,2192,20,1700,1325,375,0.929613384212171,0.635071090047393,1.74988871723705,676,323,353,30,1.1,43.46,3.5,0,0,0,0,0,0,0.038953579984769,35.9957380265333,5.14164937415852
8.7,"greedy_SVM","SVM",8,17,2112,2100,12,1800,1417,383,0.929173399964696,0.630331753554502,1.75150151789809,700,333,367,24,1.1,46.01,3.7,0,0,0,0,0,0,0.0358236242656788,37.4761849441871,4.38322904858398
8.7,"greedy_SVM","SVM",8,18,2012,2002,10,1900,1515,385,0.929375738399487,0.630331753554502,1.74988871723705,707,338,369,7,1.1,48.57,3.9,0,0,0,0,0,0,0.0296130387037772,32.1886885494795,3.24845984396238
8.7,"greedy_SVM","SVM",8,19,1912,1902,10,2000,1615,385,0.92934450494982,0.630331753554502,1.7600454277415,703,338,365,-4,1.1,51.12,4.2,0,0,0,0,0,0,0.0216874208492215,23.1183550858441,2.3321045659783
8.7,"greedy_SVM","SVM",8,20,1812,1803,9,2100,1714,386,0.929724738250109,0.625592417061611,1.76533526336672,709,342,367,6,1.1,53.68,4.4,0,0,0,0,0,0,0.0183692457347511,18.121139000248,1.89816952775107
8.7,"greedy_SVM","SVM",8,21,1712,1705,7,2200,1812,388,0.93047434104211,0.62085308056872,1.76533526336672,730,356,374,21,1.1,56.24,4.7,0,0,0,0,0,0,0.0136553313919272,9.1215906919533,1.69888197312783
8.7,"greedy_SVM","SVM",8,22,1612,1605,7,2300,1912,388,0.930444465568516,0.62085308056872,1.76696080228326,730,356,374,0,1.1,58.79,4.9,0,0,0,0,0,0,0.00993065353366268,7.91822512735878,1.17412048776946
8.7,"greedy_SVM","SVM",8,23,1512,1507,5,2400,2010,390,0.930376566764895,0.616113744075829,1.7685893375849,734,358,376,4,1.1,61.35,5.2,0,0,0,0,0,0,0.00888211075498784,7.71026254393856,0.953732813716959
8.7,"greedy_SVM","SVM",8,24,1412,1408,4,2500,2109,391,0.930254348918376,0.616113744075829,1.76533526336672,739,363,376,5,1,63.91,5.4,0,0,0,0,0,0,0.00825677665265799,6.43541562730546,0.845820068711398
8.7,"greedy_SVM","SVM",8,25,1312,1308,4,2600,2209,391,0.931672075938029,0.62085308056872,1.76371271257318,759,371,388,20,1,66.46,5.6,0,0,0,0,0,0,0.00601670623034501,4.20489841837982,0.723708235587528
8.7,"greedy_SVM","SVM",8,26,1212,1208,4,2700,2309,391,0.931756270454522,0.62085308056872,1.76371271257318,760,370,390,1,1.1,69.02,5.9,0,0,0,0,0,0,0.00477335316872816,3.21291109707419,0.499473016222116
8.7,"greedy_SVM","SVM",8,27,1112,1108,4,2800,2409,391,0.931870340444605,0.62085308056872,1.76533526336672,765,375,390,5,1,71.57,6.2,0,0,0,0,0,0,0.0038201992877117,2.3159761249623,0.397160008212984
8.7,"greedy_SVM","SVM",8,28,1012,1009,3,2900,2508,392,0.932065888999029,0.625592417061611,1.7685893375849,770,377,393,5,1,74.13,6.4,0,0,0,0,0,0,0.00352233986899444,1.94472395398461,0.37065278430569
8.7,"greedy_SVM","SVM",8,29,912,909,3,3000,2608,392,0.932055025190445,0.625592417061611,1.7685893375849,771,378,393,1,1,76.69,6.7,0,0,0,0,0,0,0.00286710886252218,1.40259823486063,0.303311851630345
8.7,"greedy_SVM","SVM",8,30,812,809,3,3100,2708,392,0.932112060185488,0.62085308056872,1.76696080228326,771,378,393,0,1,79.24,6.9,0,0,0,0,0,0,0.00240900208164265,1.04944166766484,0.258608125771493
8.7,"greedy_SVM","SVM",8,31,712,710,2,3200,2807,393,0.932093048520475,0.62085308056872,1.7685893375849,776,379,397,5,1,81.8,7.1,0,0,0,0,0,0,0.00194286188811323,0.798365985538883,0.216312060825239
8.7,"greedy_SVM","SVM",8,32,612,610,2,3300,2907,393,0.932198970654127,0.62085308056872,1.76533526336672,776,380,396,0,1,84.36,7.4,0,0,0,0,0,0,0.00172414488643093,0.628920101693607,0.190251336170328
8.7,"greedy_SVM","SVM",8,33,512,511,1,3400,3006,394,0.932118850065858,0.62085308056872,1.76371271257318,780,382,398,4,1,86.91,7.6,0,0,0,0,0,0,0.00147278735270863,0.503578254298357,0.166504682349427
8.7,"greedy_SVM","SVM",8,34,412,411,1,3500,3106,394,0.93224242588845,0.616113744075829,1.76209314167091,780,382,398,0,1,89.47,7.9,0,0,0,0,0,0,0.00108983159705268,0.316600071443426,0.124707499441949
8.7,"greedy_SVM","SVM",8,35,312,312,0,3600,3205,395,0.932190822797705,0.62085308056872,1.77549684480637,785,385,400,5,1,92.02,8.1,0,0,0,0,0,0,0.000947382909043565,0.245016123952384,0.117164235419439
8.7,"greedy_SVM","SVM",8,36,212,212,0,3700,3305,395,0.932679694183787,0.62085308056872,1.77386345304482,790,386,404,5,1,94.58,8.4,0,0,0,0,0,0,0.000548193901835566,0.117550091790595,0.0709800776554091
8.7,"greedy_SVM","SVM",8,37,112,112,0,3800,3405,395,0.93298388082402,0.62085308056872,1.77713324742831,793,386,407,3,1.1,97.14,8.6,0,0,0,0,0,0,0.000302204550985255,0.0448705105572833,0.0415799843371851
8.7,"greedy_SVM","SVM",8,38,12,12,0,3900,3505,395,0.933135974144135,0.616113744075829,1.77223306384165,796,388,408,3,1.1,99.69,8.9,0,0,0,0,0,0,0.000161586387228936,0.00289729490807813,0.00289729490807813
8.7,"greedy_SVM","SVM",8,39,0,0,0,3912,3517,395,0.933106098670541,0.616113744075829,1.76898126005478,799,389,410,3,1.1,100,8.9,0,0,0,0,0,0,0,0,0
8.7,"greedy_SVM","SVM",9,0,3812,3417,395,100,91,9,0.907555008636557,0.569306930693069,1.74029292330155,26,9,17,0,1.9,2.56,10.1,0,0,0,0,0,0,0.2185421421063,294.060743148403,23.4529229963418
8.7,"greedy_SVM","SVM",9,1,3712,3391,321,200,117,83,0.919825406143815,0.569306930693069,1.77672813152875,92,46,46,66,1,5.11,1.4,0,0,0,0,0,0,0.628424995371959,264.938163771793,76.9381830721159
8.7,"greedy_SVM","SVM",9,2,3612,3356,256,300,152,148,0.909491177167895,0.574257425742574,1.73869044363,157,82,75,65,0.9,7.67,1,0,0,0,0,0,0,0.31208115127755,133.753618825703,42.6885144620688
8.7,"greedy_SVM","SVM",9,3,3512,3302,210,400,206,194,0.897701999390373,0.603960396039604,1.69255011977739,250,128,122,93,1,10.22,1.1,0,0,0,0,0,0,0.239977550267721,121.9710470854,38.8054184348188
8.7,"greedy_SVM","SVM",9,4,3412,3245,167,500,263,237,0.869726339794758,0.613861386138614,1.61979470005824,326,162,164,76,1,12.78,1.1,0,0,0,0,0,0,0.160169700705756,104.269045756556,22.2627933071721
8.7,"greedy_SVM","SVM",9,5,3312,3170,142,600,338,262,0.891218939453815,0.638613861386139,1.64498268008619,386,188,198,60,1.1,15.34,1.3,0,0,0,0,0,0,0.101123027310958,67.3050171779833,14.2505948167212
8.7,"greedy_SVM","SVM",9,6,3212,3101,111,700,407,293,0.911469681745825,0.653465346534653,1.68634461979653,446,216,230,60,1.1,17.89,1.4,0,0,0,0,0,0,0.0892129893342643,86.1503558729916,12.0647060341264
8.7,"greedy_SVM","SVM",9,7,3112,3036,76,800,472,328,0.902104948237123,0.678217821782178,1.62421613380403,524,251,273,78,1.1,20.45,1.4,0,0,0,0,0,0,0.100784317544564,168.22647731952,16.5149061909951
8.7,"greedy_SVM","SVM",9,8,3012,2952,60,900,556,344,0.907206441852849,0.678217821782178,1.66429455445545,559,270,289,35,1.1,23.01,1.6,0,0,0,0,0,0,0.0748702982568696,119.170564194434,8.5959699714765
8.7,"greedy_SVM","SVM",9,9,2912,2859,53,1000,649,351,0.913894126014647,0.678217821782178,1.6716580748984,588,282,306,29,1.1,25.56,1.8,0,0,0,0,0,0,0.0687032717399377,109.188949854003,7.53565921435613
8.7,"greedy_SVM","SVM",9,10,2812,2763,49,1100,745,355,0.927517865811676,0.673267326732673,1.71036643682768,611,295,316,23,1.1,28.12,2.1,0,0,0,0,0,0,0.0604621879908567,80.6508141948339,6.80723397949685
8.7,"greedy_SVM","SVM",9,11,2712,2672,40,1200,836,364,0.931116429772979,0.683168316831683,1.70722526798134,632,306,326,21,1.1,30.67,2.3,0,0,0,0,0,0,0.0609307870808765,80.898555522848,6.99030066039806
8.7,"greedy_SVM","SVM",9,12,2612,2575,37,1300,933,367,0.934878693114474,0.668316831683168,1.72977408238061,648,312,336,16,1.1,33.23,2.5,0,0,0,0,0,0,0.0547312060370867,64.8576064247582,5.91289420998429
8.7,"greedy_SVM","SVM",9,13,2512,2478,34,1400,1030,370,0.935781862108681,0.668316831683168,1.74599907092825,657,317,340,9,1.1,35.79,2.8,0,0,0,0,0,0,0.0503310128247285,58.3247937501759,5.39964632055443
8.7,"greedy_SVM","SVM",9,14,2412,2382,30,1500,1126,374,0.938395407385682,0.668316831683168,1.76381538797854,670,321,349,13,1.1,38.34,3,0,0,0,0,0,0,0.0511249086676699,52.4719387767497,5.73763278525857
8.7,"greedy_SVM","SVM",9,15,2312,2286,26,1600,1222,378,0.937904309245078,0.678217821782178,1.76706666058311,680,326,354,10,1.1,40.9,3.2,0,0,0,0,0,0,0.048019559987937,46.2918857959286,5.65615408951271
8.7,"greedy_SVM","SVM",9,16,2212,2195,17,1700,1313,387,0.93831355769557,0.688118811881188,1.76706666058311,709,337,372,29,1.1,43.46,3.4,0,0,0,0,0,0,0.0358567584799366,39.0540740537243,4.49114791514038
8.7,"greedy_SVM","SVM",9,17,2112,2097,15,1800,1411,389,0.938470201068003,0.683168316831683,1.7621942341293,720,341,379,11,1.1,46.01,3.6,0,0,0,0,0,0,0.0354329794039342,35.1567043386604,3.55735842860055
8.7,"greedy_SVM","SVM",9,18,2012,1997,15,1900,1511,389,0.938062363819058,0.648514851485149,1.7694678558765,741,358,383,21,1.1,48.57,3.9,0,0,0,0,0,0,0.0255102076582465,15.661958400306,3.2889323155739
8.7,"greedy_SVM","SVM",9,19,1912,1900,12,2000,1608,392,0.938595798006261,0.653465346534653,1.77272354650368,747,360,387,6,1.1,51.12,4.1,0,0,0,0,0,0,0.0180614735048635,12.5929530693043,2.13110946875494
8.7,"greedy_SVM","SVM",9,20,1812,1801,11,2100,1707,393,0.938968355216373,0.653465346534653,1.77272354650368,751,361,390,4,1.1,53.68,4.3,0,0,0,0,0,0,0.0130910102346957,10.6396441239685,1.51753958815691
8.7,"greedy_SVM","SVM",9,21,1712,1704,8,2200,1804,396,0.93924495072085,0.648514851485149,1.77835965414723,758,365,393,7,1.1,56.24,4.6,0,0,0,0,0,0,0.0109351617048824,9.49272678970392,1.2113898172819
8.7,"greedy_SVM","SVM",9,22,1612,1604,8,2300,1904,396,0.939088307348417,0.648514851485149,1.77999417588818,757,366,391,-1,1.1,58.79,4.8,0,0,0,0,0,0,0.00993740156262771,7.86894144188768,1.01549334482558
8.7,"greedy_SVM","SVM",9,23,1512,1504,8,2400,2004,396,0.93871433893675,0.653465346534653,1.78163170502883,764,374,390,7,1,61.35,5.1,0,0,0,0,0,0,0.00756133015811805,5.70679406416753,0.89456282738006
8.7,"greedy_SVM","SVM",9,24,1412,1404,8,2500,2104,396,0.93875103017714,0.653465346534653,1.78163170502883,765,374,391,1,1,63.91,5.3,0,0,0,0,0,0,0.00674172091605783,4.66259406724088,0.693576181037451
8.7,"greedy_SVM","SVM",9,25,1312,1305,7,2600,2203,397,0.938522415525481,0.653465346534653,1.77999417588818,769,377,392,4,1,66.46,5.5,0,0,0,0,0,0,0.00528241404018579,3.40990171479616,0.571910460056687
8.7,"greedy_SVM","SVM",9,26,1212,1206,6,2700,2302,398,0.938511125913054,0.648514851485149,1.78163170502883,776,379,397,7,1,69.02,5.8,0,0,0,0,0,0,0.00511993139781777,2.97458117622737,0.53558215895915
8.7,"greedy_SVM","SVM",9,27,1112,1106,6,2800,2402,398,0.938254287230327,0.648514851485149,1.78163170502883,779,379,400,3,1.1,71.57,6,0,0,0,0,0,0,0.00442073369422328,2.2508590294739,0.45880555415631
8.7,"greedy_SVM","SVM",9,28,1012,1006,6,2900,2502,398,0.938209128780616,0.648514851485149,1.78163170502883,778,381,397,-1,1,74.13,6.3,0,0,0,0,0,0,0.00427134362933433,1.94113243914079,0.451086659439799
8.7,"greedy_SVM","SVM",9,29,912,907,5,3000,2601,399,0.93825993203654,0.648514851485149,1.77509959978583,781,382,399,3,1,76.69,6.5,0,0,0,0,0,0,0.00357289532615957,1.46855824455789,0.389166521353503
8.7,"greedy_SVM","SVM",9,30,812,808,4,3100,2700,400,0.938350248935961,0.653465346534653,1.78163170502883,785,385,400,4,1,79.24,6.8,0,0,0,0,0,0,0.0033637335113407,1.26133290023577,0.369963025155471
8.7,"greedy_SVM","SVM",9,31,712,708,4,3200,2800,400,0.938257109633433,0.648514851485149,1.77999417588818,786,385,401,1,1,81.8,7,0,0,0,0,0,0,0.00212170775177706,0.692242480868444,0.235673750059261
8.7,"greedy_SVM","SVM",9,32,612,609,3,3300,2899,401,0.938429276222954,0.648514851485149,1.78163170502883,792,386,406,6,1.1,84.36,7.2,0,0,0,0,0,0,0.00185907704649894,0.565906796793378,0.220929750880129
8.7,"greedy_SVM","SVM",9,33,512,509,3,3400,2999,401,0.938652246068399,0.648514851485149,1.77835965414723,792,386,406,0,1.1,86.91,7.5,0,0,0,0,0,0,0.000997723063310186,0.319494499452317,0.134179984316647
8.7,"greedy_SVM","SVM",9,34,412,409,3,3500,3099,401,0.938736918161606,0.648514851485149,1.78163170502883,796,387,409,4,1.1,89.47,7.7,0,0,0,0,0,0,0.000714010352658143,0.208928592864253,0.0902137780735161
8.7,"greedy_SVM","SVM",9,35,312,312,0,3600,3196,404,0.939772740101838,0.653465346534653,1.79053986355397,807,396,411,11,1,92.02,7.9,0,0,0,0,0,0,0.000980260196287573,0.249847880094007,0.124483292452152
8.7,"greedy_SVM","SVM",9,36,212,212,0,3700,3296,404,0.940039457195439,0.653465346534653,1.78889414676762,814,396,418,7,1.1,94.58,8.2,0,0,0,0,0,0,0.000535412944991895,0.114504671882561,0.0722021368241588
8.7,"greedy_SVM","SVM",9,37,112,112,0,3800,3396,404,0.940213034986513,0.653465346534653,1.79053986355397,814,397,417,0,1.1,97.14,8.4,0,0,0,0,0,0,0.000258147672882982,0.0418435870130976,0.039033390884388
8.7,"greedy_SVM","SVM",9,38,12,12,0,3900,3496,404,0.940317463901469,0.653465346534653,1.78725145241797,812,397,415,-2,1,99.69,8.7,0,0,0,0,0,0,0.000172190537890758,0.00258611302254672,0.00258611302254672
8.7,"greedy_SVM","SVM",9,39,0,0,0,3912,3508,404,0.940369678358946,0.653465346534653,1.78889414676762,813,397,416,1,1,100,8.7,0,0,0,0,0,0,0,0,0
8.7,"greedy_SVM","SVM",10,0,3812,3411,401,100,89,11,0.897027159858188,0.541237113402062,1.67580850162406,28,11,17,0,1.5,2.56,8.1,0,0,0,0,0,0,0.535637693659268,405.021371525579,58.2543814328756
8.7,"greedy_SVM","SVM",10,1,3712,3391,321,200,109,91,0.906533402763973,0.551546391752577,1.74219223771983,73,38,35,45,0.9,5.11,1.2,0,0,0,0,0,0,0.736038089743572,271.272341760028,84.5958757068409
8.7,"greedy_SVM","SVM",10,2,3612,3346,266,300,154,146,0.901476766092922,0.577319587628866,1.73611664863018,154,80,74,81,0.9,7.67,1.1,0,0,0,0,0,0,0.316631150079269,113.803309460056,50.6490231624481
8.7,"greedy_SVM","SVM",10,3,3512,3302,210,400,198,202,0.89735919819326,0.603092783505155,1.73611664863018,238,121,117,84,1,10.22,1,0,0,0,0,0,0,0.330008526089184,120.555694919069,46.3163785638649
8.7,"greedy_SVM","SVM",10,4,3412,3237,175,500,263,237,0.890798881308733,0.597938144329897,1.68814195885773,318,159,159,80,1,12.78,1.1,0,0,0,0,0,0,0.128785675152402,56.3566988706061,19.7180481286948
8.7,"greedy_SVM","SVM",10,5,3312,3167,145,600,333,267,0.886328796938808,0.634020618556701,1.66652466558746,387,190,197,69,1,15.34,1.2,0,0,0,0,0,0,0.0835919499496435,47.8008900011162,14.3981396359071
8.7,"greedy_SVM","SVM",10,6,3212,3097,115,700,403,297,0.895435716208154,0.639175257731959,1.67266853532234,441,214,227,54,1.1,17.89,1.4,0,0,0,0,0,0,0.0670466409802563,44.3251964132773,9.09075623537998
8.7,"greedy_SVM","SVM",10,7,3112,3018,94,800,482,318,0.897027159858181,0.644329896907217,1.66337593234833,494,237,257,53,1.1,20.45,1.5,0,0,0,0,0,0,0.0723942060424717,76.3038116408928,11.1986911516125
8.7,"greedy_SVM","SVM",10,8,3012,2942,70,900,558,342,0.893076342488032,0.654639175257732,1.64025545785324,545,260,285,51,1.1,23.01,1.6,0,0,0,0,0,0,0.0601200285512121,78.5579350101377,8.10866923250081
8.7,"greedy_SVM","SVM",10,9,2912,2852,60,1000,648,352,0.896734615069564,0.654639175257732,1.65256023238594,575,275,300,30,1.1,25.56,1.8,0,0,0,0,0,0,0.0536454211819887,75.5197939061556,6.0556566840483
8.7,"greedy_SVM","SVM",10,10,2812,2755,57,1100,745,355,0.898697590601119,0.654639175257732,1.67266853532234,577,282,295,2,1,28.12,2.1,0,0,0,0,0,0,0.0449547214160254,57.2613201782401,5.00493814008333
8.7,"greedy_SVM","SVM",10,11,2712,2656,56,1200,844,356,0.897185134044017,0.65979381443299,1.67266853532234,585,284,301,8,1.1,30.67,2.4,0,0,0,0,0,0,0.0359579553586137,44.1891766779135,3.91761050679391
8.7,"greedy_SVM","SVM",10,12,2612,2561,51,1300,939,361,0.907939080473218,0.649484536082474,1.66499574387591,607,297,310,22,1,33.23,2.6,0,0,0,0,0,0,0.0319210055936047,34.9408022056662,3.72462013222866
8.7,"greedy_SVM","SVM",10,13,2512,2469,43,1400,1031,369,0.922422972957163,0.649484536082474,1.71596847466308,634,308,326,27,1.1,35.79,2.8,0,0,0,0,0,0,0.0341067914203867,46.0965180412376,4.20149369842678
8.7,"greedy_SVM","SVM",10,14,2412,2377,35,1500,1123,377,0.937121885860724,0.639175257731959,1.74219223771983,668,326,342,34,1,38.34,3,0,0,0,0,0,0,0.0541417094633172,50.6546041469323,6.40823954519263
8.7,"greedy_SVM","SVM",10,15,2312,2283,29,1600,1217,383,0.944109318136606,0.634020618556701,1.79779411764706,689,333,356,21,1.1,40.9,3.2,0,0,0,0,0,0,0.0572317058561183,42.9124104678618,6.23025706133581
8.7,"greedy_SVM","SVM",10,16,2212,2186,26,1700,1314,386,0.944972325262998,0.634020618556701,1.80276497695853,700,338,362,11,1.1,43.46,3.4,0,0,0,0,0,0,0.0505016174836583,36.9501580638254,5.66764300122554
8.7,"greedy_SVM","SVM",10,17,2112,2089,23,1800,1411,389,0.945106895865758,0.634020618556701,1.80276497695853,706,344,362,6,1.1,46.01,3.6,0,0,0,0,0,0,0.0421430867257003,28.4227497296635,4.96455651176235
8.7,"greedy_SVM","SVM",10,18,2012,1993,19,1900,1507,393,0.944369682998468,0.639175257731959,1.80276497695853,717,348,369,11,1.1,48.57,3.8,0,0,0,0,0,0,0.0353310217479278,25.1850452976543,4.30849431550512
8.7,"greedy_SVM","SVM",10,19,1912,1898,14,2000,1602,398,0.943351627134115,0.639175257731959,1.80276497695853,731,354,377,14,1.1,51.12,4,0,0,0,0,0,0,0.0287154186325923,23.9638191360162,3.550106590471
8.7,"greedy_SVM","SVM",10,20,1812,1801,11,2100,1699,401,0.943641246474834,0.634020618556701,1.80110497237569,738,359,379,7,1.1,53.68,4.2,0,0,0,0,0,0,0.0230791074237226,19.9246284127908,2.5827883255679
8.7,"greedy_SVM","SVM",10,21,1712,1701,11,2200,1799,401,0.943600290204429,0.634020618556701,1.80276497695853,745,359,386,7,1.1,56.24,4.5,0,0,0,0,0,0,0.0183733685094676,16.0700864802028,1.94469015900596
8.7,"greedy_SVM","SVM",10,22,1612,1602,10,2300,1898,402,0.942883555472345,0.634020618556701,1.79779411764706,756,368,388,11,1.1,58.79,4.7,0,0,0,0,0,0,0.0129764038044625,11.0424988602344,1.60876823097246
8.7,"greedy_SVM","SVM",10,23,1512,1504,8,2400,1996,404,0.943205354739814,0.634020618556701,1.79779411764706,763,371,392,7,1.1,61.35,4.9,0,0,0,0,0,0,0.0123146247445249,9.1787703787573,1.24748703483496
8.7,"greedy_SVM","SVM",10,24,1412,1404,8,2500,2096,404,0.94270802859918,0.634020618556701,1.79944802207912,785,382,403,22,1.1,63.91,5.2,0,0,0,0,0,0,0.00842817165146117,5.16754773684327,1.05338053432848
8.7,"greedy_SVM","SVM",10,25,1312,1304,8,2600,2196,404,0.942762149385073,0.634020618556701,1.80110497237569,783,381,402,-2,1.1,66.46,5.4,0,0,0,0,0,0,0.00657769998005038,4.42527874740387,0.756812330473899
8.7,"greedy_SVM","SVM",10,26,1212,1204,8,2700,2296,404,0.942642206021744,0.634020618556701,1.80110497237569,784,381,403,1,1.1,69.02,5.7,0,0,0,0,0,0,0.00604762226121819,3.68755061296793,0.623876139470271
8.7,"greedy_SVM","SVM",10,27,1112,1105,7,2800,2395,405,0.942599787027395,0.634020618556701,1.80276497695853,788,383,405,4,1.1,71.57,5.9,0,0,0,0,0,0,0.00565307985141441,3.15327196273451,0.593964565266676
8.7,"greedy_SVM","SVM",10,28,1012,1006,6,2900,2494,406,0.942485694559838,0.634020618556701,1.79944802207912,795,387,408,7,1.1,74.13,6.1,0,0,0,0,0,0,0.00482405618241351,2.35082877872139,0.498792867226396
8.7,"greedy_SVM","SVM",10,29,912,906,6,3000,2594,406,0.942364288472566,0.634020618556701,1.80110497237569,796,389,407,1,1,76.69,6.4,0,0,0,0,0,0,0.00433898009203134,1.84436621129193,0.456577822233374
8.7,"greedy_SVM","SVM",10,30,812,806,6,3100,2694,406,0.942408170190858,0.623711340206186,1.80110497237569,796,389,407,0,1,79.24,6.6,0,0,0,0,0,0,0.0033184472662211,1.20050542893094,0.357476048728705
8.7,"greedy_SVM","SVM",10,31,712,707,5,3200,2793,407,0.942482769111953,0.623711340206186,1.79944802207912,803,392,411,7,1,81.8,6.9,0,0,0,0,0,0,0.00368642420300722,1.20617193044415,0.411021434398152
8.7,"greedy_SVM","SVM",10,32,612,608,4,3300,2892,408,0.942547128965447,0.618556701030928,1.80110497237569,812,394,418,9,1.1,84.36,7.1,0,0,0,0,0,0,0.00270395812167011,0.812938044559933,0.320478855433993
8.7,"greedy_SVM","SVM",10,33,512,508,4,3400,2992,408,0.942633429678086,0.623711340206186,1.80110497237569,810,393,417,-2,1.1,86.91,7.3,0,0,0,0,0,0,0.0015040457352,0.446313243242829,0.19934664039289
8.7,"greedy_SVM","SVM",10,34,412,411,1,3500,3089,411,0.942770925728731,0.623711340206186,1.80110497237569,822,399,423,12,1.1,89.47,7.5,0,0,0,0,0,0,0.00133414801317705,0.394359842686103,0.169515786896927
8.7,"greedy_SVM","SVM",10,35,312,312,0,3600,3188,412,0.942686087740036,0.623711340206186,1.80110497237569,825,402,423,3,1.1,92.02,7.7,0,0,0,0,0,0,0.00101425882241927,0.252396184989894,0.124224522345771
8.7,"greedy_SVM","SVM",10,36,212,212,0,3700,3288,412,0.942671460500606,0.623711340206186,1.80110497237569,830,404,426,5,1.1,94.58,8,0,0,0,0,0,0,0.000529782848629423,0.10991140859764,0.0693120344682683
8.7,"greedy_SVM","SVM",10,37,112,112,0,3800,3388,412,0.942731432182271,0.623711340206186,1.79944802207912,834,404,430,4,1.1,97.14,8.2,0,0,0,0,0,0,0.000245099098955931,0.0406956135792187,0.0381037942477867
8.7,"greedy_SVM","SVM",10,38,12,12,0,3900,3488,412,0.942690475911866,0.623711340206186,1.80276497695853,835,405,430,1,1.1,99.69,8.5,0,0,0,0,0,0,0.000148051954155697,0.00207551734073836,0.00207551734073836
8.7,"greedy_SVM","SVM",10,39,0,0,0,3912,3500,412,0.94270217770341,0.623711340206186,1.80276497695853,834,405,429,-1,1.1,100,8.5,0,0,0,0,0,0,0,0,0
8.7,"greedy_SVM","SVM",11,0,3812,3410,402,100,94,6,0.898734213580625,0.55050505050505,1.7026113671275,17,6,11,0,1.8,2.56,15.7,0,0,0,0,0,0,0.198603767043443,202.592988885481,22.2717265784433
8.7,"greedy_SVM","SVM",11,1,3712,3372,340,200,132,68,0.904952540191445,0.560606060606061,1.71923656454043,100,52,48,83,0.9,5.11,1.9,0,0,0,0,0,0,0.589302436702916,212.873233717891,72.6373464877761
8.7,"greedy_SVM","SVM",11,2,3612,3346,266,300,158,142,0.897444295055216,0.575757575757576,1.7085668088428,148,76,72,48,0.9,7.67,1.1,0,0,0,0,0,0,0.332641194244406,117.854816210574,50.7753322001297
8.7,"greedy_SVM","SVM",11,3,3512,3300,212,400,204,196,0.901877133105791,0.595959595959596,1.73903086161151,235,120,115,87,1,10.22,1,0,0,0,0,0,0,0.283472078394706,96.3285034472011,45.6587047047259
8.7,"greedy_SVM","SVM",11,4,3412,3247,165,500,257,243,0.890023672446883,0.601010101010101,1.68440161988549,322,163,159,87,1,12.78,1.1,0,0,0,0,0,0,0.17506291495838,83.0292113147406,26.7763413825919
8.7,"greedy_SVM","SVM",11,5,3312,3185,127,600,319,281,0.881028717206201,0.606060606060606,1.65556113622412,401,198,203,79,1,15.34,1.1,0,0,0,0,0,0,0.102196766801628,67.655520887469,14.3641943013359
8.7,"greedy_SVM","SVM",11,6,3212,3112,100,700,392,308,0.894637501292795,0.636363636363636,1.66465762598359,461,223,238,60,1.1,17.89,1.3,0,0,0,0,0,0,0.0879563163684966,66.3275340898634,11.9920330203195
8.7,"greedy_SVM","SVM",11,7,3112,3040,72,800,464,336,0.889365785270223,0.656565656565657,1.64494995957737,524,253,271,63,1.1,20.45,1.4,0,0,0,0,0,0,0.0949529787128634,115.557086022001,13.1584319049156
8.7,"greedy_SVM","SVM",11,8,3012,2952,60,900,552,348,0.892334896174482,0.651515151515151,1.64646464646465,549,265,284,25,1.1,23.01,1.6,0,0,0,0,0,0,0.0605993819262324,76.1189271479905,6.9861710124291
8.7,"greedy_SVM","SVM",11,9,2912,2861,51,1000,643,357,0.892280311648917,0.661616161616162,1.63435828877005,582,275,307,33,1.1,25.56,1.8,0,0,0,0,0,0,0.0602889792309962,90.0952783558828,6.70366509428967
8.7,"greedy_SVM","SVM",11,10,2812,2761,51,1100,743,357,0.897964284483054,0.656565656565657,1.64798212540148,586,278,308,4,1.1,28.12,2.1,0,0,0,0,0,0,0.0471973251667878,67.5675029776104,5.12419320600023
8.7,"greedy_SVM","SVM",11,11,2712,2664,48,1200,840,360,0.900406223785065,0.641414141414141,1.65251782531194,592,282,310,6,1.1,30.67,2.3,0,0,0,0,0,0,0.0369950747790718,53.8457848190858,3.98597981728175
8.7,"greedy_SVM","SVM",11,12,2612,2567,45,1300,937,363,0.900854391468727,0.641414141414141,1.65708699902248,604,290,314,12,1.1,33.23,2.6,0,0,0,0,0,0,0.0419299105745536,54.7548917457678,4.80486054298294
8.7,"greedy_SVM","SVM",11,13,2512,2468,44,1400,1036,364,0.904448351547325,0.636363636363636,1.67529674626449,605,291,314,1,1.1,35.79,2.8,0,0,0,0,0,0,0.0301247409505499,39.6586433648056,3.25269333069144
8.7,"greedy_SVM","SVM",11,14,2412,2371,41,1500,1133,367,0.924857218372567,0.636363636363636,1.74491929413733,635,309,326,30,1.1,38.34,3.1,0,0,0,0,0,0,0.0295989200014046,27.6666972493969,3.56036321743842
8.7,"greedy_SVM","SVM",11,15,2312,2276,36,1600,1228,372,0.927040599395544,0.636363636363636,1.73264323677547,651,315,336,16,1.1,40.9,3.3,0,0,0,0,0,0,0.0257469961702529,28.3986360580101,3.04951587513934
8.7,"greedy_SVM","SVM",11,16,2212,2184,28,1700,1320,380,0.931499293274026,0.641414141414141,1.77381550309727,675,327,348,24,1.1,43.46,3.5,0,0,0,0,0,0,0.0599596175455642,40.5392526767173,7.15104519382678
8.7,"greedy_SVM","SVM",11,17,2112,2085,27,1800,1419,381,0.931884257822814,0.641414141414141,1.76730608840701,687,333,354,12,1.1,46.01,3.7,0,0,0,0,0,0,0.0470810280418265,32.3290139288285,5.42040402367255
8.7,"greedy_SVM","SVM",11,18,2012,1988,24,1900,1516,384,0.931467691706593,0.636363636363636,1.76568619281727,695,339,356,8,1.1,48.57,3.9,0,0,0,0,0,0,0.0368119080712606,22.4689115131107,4.16460252558963
8.7,"greedy_SVM","SVM",11,19,1912,1893,19,2000,1611,389,0.930197883269549,0.636363636363636,1.76568619281727,713,346,367,18,1.1,51.12,4.1,0,0,0,0,0,0,0.034391422330176,18.6989477633254,4.13741884045836
8.7,"greedy_SVM","SVM",11,20,1812,1803,9,2100,1701,399,0.928714046034858,0.626262626262626,1.77055481283422,738,357,381,25,1.1,53.68,4.3,0,0,0,0,0,0,0.0354379569789505,19.1520004020774,4.84608797344896
8.7,"greedy_SVM","SVM",11,21,1712,1705,7,2200,1799,401,0.929331713034779,0.626262626262626,1.77381550309727,744,359,385,6,1.1,56.24,4.5,0,0,0,0,0,0,0.01880988685833,13.3892940599318,2.47891837872855
8.7,"greedy_SVM","SVM",11,22,1612,1605,7,2300,1899,401,0.929292929292923,0.621212121212121,1.7689289590116,745,359,386,1,1.1,58.79,4.7,0,0,0,0,0,0,0.0141411571089408,10.9249535945777,1.61823774641876
8.7,"greedy_SVM","SVM",11,23,1512,1506,6,2400,1998,402,0.929860321071919,0.626262626262626,1.76730608840701,750,361,389,5,1.1,61.35,5,0,0,0,0,0,0,0.0115103076609119,9.11858377045546,1.25869258236425
8.7,"greedy_SVM","SVM",11,24,1412,1407,5,2500,2097,403,0.930536881902061,0.626262626262626,1.77545035609552,752,364,388,2,1.1,63.91,5.2,0,0,0,0,0,0,0.00903146084780328,7.01543412675554,0.974923649649019
8.7,"greedy_SVM","SVM",11,25,1312,1307,5,2600,2197,403,0.930615885820656,0.626262626262626,1.76730608840701,754,365,389,2,1.1,66.46,5.5,0,0,0,0,0,0,0.00813067920482244,6.31120058699685,0.883540354871962
8.7,"greedy_SVM","SVM",11,26,1212,1207,5,2700,2297,403,0.930714999827621,0.626262626262626,1.77381550309727,754,365,389,0,1.1,69.02,5.7,0,0,0,0,0,0,0.00649033769381046,4.42419477638823,0.657329676337713
8.7,"greedy_SVM","SVM",11,27,1112,1107,5,2800,2397,403,0.931614208064717,0.621212121212121,1.77545035609552,768,375,393,14,1,71.57,5.9,0,0,0,0,0,0,0.00536802875067015,3.29784459304332,0.661516908262039
8.7,"greedy_SVM","SVM",11,28,1012,1008,4,2900,2496,404,0.931667356155408,0.621212121212121,1.77381550309727,771,375,396,3,1.1,74.13,6.2,0,0,0,0,0,0,0.00490795672709248,2.72424917741271,0.506806577542469
8.7,"greedy_SVM","SVM",11,29,912,908,4,3000,2596,404,0.932240493673939,0.611111111111111,1.77055481283422,777,380,397,6,1,76.69,6.4,0,0,0,0,0,0,0.00361435488270712,1.78504467283232,0.391390316676786
8.7,"greedy_SVM","SVM",11,30,812,809,3,3100,2695,405,0.931775088771675,0.606060606060606,1.77218365810822,784,384,400,7,1,79.24,6.7,0,0,0,0,0,0,0.0034988707176442,1.50128174519047,0.365686149123776
8.7,"greedy_SVM","SVM",11,31,712,709,3,3200,2795,405,0.931849783385619,0.601010101010101,1.77055481283422,789,385,404,5,1,81.8,6.9,0,0,0,0,0,0,0.0028404674052629,1.02475814712706,0.304879230080016
8.7,"greedy_SVM","SVM",11,32,612,610,2,3300,2894,406,0.931858401994918,0.601010101010101,1.77218365810822,794,389,405,5,1,84.36,7.1,0,0,0,0,0,0,0.00271184819283539,0.795086998993403,0.289560121003331
8.7,"greedy_SVM","SVM",11,33,512,510,2,3400,2994,406,0.932004918353037,0.595959595959596,1.7689289590116,800,391,409,6,1,86.91,7.4,0,0,0,0,0,0,0.00176848126229342,0.486308607504398,0.22622217694366
8.7,"greedy_SVM","SVM",11,34,412,410,2,3500,3094,406,0.932269222371607,0.601010101010101,1.77218365810822,801,391,410,1,1,89.47,7.6,0,0,0,0,0,0,0.000761897088857273,0.235759741651406,0.116051022637213
8.7,"greedy_SVM","SVM",11,35,312,312,0,3600,3192,408,0.932879707197108,0.601010101010101,1.78291199285674,810,394,416,9,1.1,92.02,7.8,0,0,0,0,0,0,0.000858789053344701,0.219131086000296,0.110418783799652
8.7,"greedy_SVM","SVM",11,36,212,212,0,3700,3292,408,0.933225888004039,0.590909090909091,1.78455522971652,811,395,416,1,1.1,94.58,8.1,0,0,0,0,0,0,0.000466260961003596,0.0982002672227278,0.0614412234362909
8.7,"greedy_SVM","SVM",11,37,112,112,0,3800,3392,408,0.933724330908625,0.590909090909091,1.78291199285674,810,397,413,-1,1,97.14,8.3,0,0,0,0,0,0,0.000177065821201344,0.0286918681284965,0.0268214912222048
8.7,"greedy_SVM","SVM",11,38,12,12,0,3900,3492,408,0.934234265292279,0.590909090909091,1.78127177943185,812,398,414,2,1,99.69,8.6,0,0,0,0,0,0,0.000134198120238703,0.00197798075618417,0.00197798075618417
8.7,"greedy_SVM","SVM",11,39,0,0,0,3912,3504,408,0.934258684685299,0.595959595959596,1.78291199285674,812,398,414,0,1,100,8.6,0,0,0,0,0,0,0,0,0
8.7,"greedy_SVM","SVM",12,0,3812,3429,383,100,83,17,0.886604715672676,0.519417475728155,1.67817134321989,40,17,23,0,1.4,2.56,4.9,0,0,0,0,0,0,0.755082958750557,602.92772327674,80.8889930204038
8.7,"greedy_SVM","SVM",12,1,3712,3374,338,200,138,62,0.906435506241313,0.645631067961165,1.65623088176619,110,54,56,70,1,5.11,2.2,0,0,0,0,0,0,0.68874309085956,470.467187154843,77.8142646487576
8.7,"greedy_SVM","SVM",12,2,3612,3350,262,300,162,138,0.922163661581139,0.679611650485437,1.72956654549352,157,81,76,47,0.9,7.67,1.2,0,0,0,0,0,0,0.5,263.813538499421,61.5544027193151
8.7,"greedy_SVM","SVM",12,3,3512,3313,199,400,199,201,0.910472954230233,0.66504854368932,1.69867284225528,234,119,115,77,1,10.22,1,0,0,0,0,0,0,0.377729332479412,210.438856010228,53.0602255977999
8.7,"greedy_SVM","SVM",12,4,3412,3248,164,500,264,236,0.889572815533983,0.645631067961165,1.67253941391289,321,162,159,87,1,12.78,1.1,0,0,0,0,0,0,0.252641552636556,185.132136333288,34.9356203332501
8.7,"greedy_SVM","SVM",12,5,3312,3174,138,600,338,262,0.888524271844645,0.660194174757282,1.63919869480328,387,188,199,66,1.1,15.34,1.3,0,0,0,0,0,0,0.142694147181693,111.888905846736,19.145126346524
8.7,"greedy_SVM","SVM",12,6,3212,3091,121,700,421,279,0.899575589459073,0.674757281553398,1.66995655205707,431,206,225,44,1.1,17.89,1.5,0,0,0,0,0,0,0.0850826233148414,78.6054125158053,11.8521986566316
8.7,"greedy_SVM","SVM",12,7,3112,3014,98,800,498,302,0.91064355062411,0.689320388349515,1.68024696881571,476,226,250,45,1.1,20.45,1.6,0,0,0,0,0,0,0.0690250100552794,81.7390894504603,10.1859959014628
8.7,"greedy_SVM","SVM",12,8,3012,2940,72,900,572,328,0.909751733703185,0.694174757281553,1.67869978007831,539,255,284,63,1.1,23.01,1.7,0,0,0,0,0,0,0.0736207323636675,120.707118962558,11.2255727419343
8.7,"greedy_SVM","SVM",12,9,2912,2852,60,1000,660,340,0.913600554785017,0.699029126213592,1.68024696881571,575,273,302,36,1.1,25.56,1.9,0,0,0,0,0,0,0.0685892970764816,104.667149890146,7.5591544217155
8.7,"greedy_SVM","SVM",12,10,2812,2755,57,1100,757,343,0.922277392510389,0.689320388349515,1.69774954140754,592,286,306,17,1.1,28.12,2.2,0,0,0,0,0,0,0.056999799746956,77.7497922568569,6.30314698554623
8.7,"greedy_SVM","SVM",12,11,2712,2663,49,1200,849,351,0.930515950069357,0.689320388349515,1.71767097274599,612,296,316,20,1.1,30.67,2.4,0,0,0,0,0,0,0.0584800310598824,78.9186045220043,6.65625816839179
8.7,"greedy_SVM","SVM",12,12,2612,2572,40,1300,940,360,0.937876560332884,0.679611650485437,1.72797687035979,650,311,339,38,1.1,33.23,2.6,0,0,0,0,0,0,0.0625458808759705,74.5560214163615,7.26273416315184
8.7,"greedy_SVM","SVM",12,13,2512,2479,33,1400,1033,367,0.944488210818319,0.679611650485437,1.77487528831197,668,321,347,18,1.1,35.79,2.8,0,0,0,0,0,0,0.0615115005498288,63.1796115824655,6.77296768383513
8.7,"greedy_SVM","SVM",12,14,2412,2381,31,1500,1131,369,0.944834951456322,0.674757281553398,1.7699858247078,673,323,350,5,1.1,38.34,3.1,0,0,0,0,0,0,0.0554896387265951,54.447928899638,5.98909685730965
8.7,"greedy_SVM","SVM",12,15,2312,2286,26,1600,1226,374,0.945804438280178,0.679611650485437,1.77487528831197,692,330,362,19,1.1,40.9,3.3,0,0,0,0,0,0,0.0539973214958477,49.4255597651692,6.00880017688276
8.7,"greedy_SVM","SVM",12,16,2212,2189,23,1700,1323,377,0.94615256588073,0.679611650485437,1.77324246835952,701,335,366,9,1.1,43.46,3.5,0,0,0,0,0,0,0.0419185467068502,41.2426487211777,4.86936844710319
8.7,"greedy_SVM","SVM",12,17,2112,2095,17,1800,1417,383,0.947350901525669,0.674757281553398,1.77324246835952,713,341,372,12,1.1,46.01,3.7,0,0,0,0,0,0,0.0360109504741855,38.1064479884303,4.05666862640262
8.7,"greedy_SVM","SVM",12,18,2012,1999,13,1900,1513,387,0.947600554785029,0.674757281553398,1.7699858247078,723,345,378,10,1.1,48.57,3.9,0,0,0,0,0,0,0.0331734402017146,35.1983481825735,3.52682910783718
8.7,"greedy_SVM","SVM",12,19,1912,1899,13,2000,1613,387,0.947769764216375,0.679611650485437,1.77161264991433,728,349,379,5,1.1,51.12,4.2,0,0,0,0,0,0,0.0253292092678965,25.1685394395025,2.73276613288345
8.7,"greedy_SVM","SVM",12,20,1812,1800,12,2100,1712,388,0.949145631067973,0.679611650485437,1.78361851633321,736,357,379,8,1.1,53.68,4.4,0,0,0,0,0,0,0.0171247251884278,15.4363400719605,2.08688002881059
8.7,"greedy_SVM","SVM",12,21,1712,1702,10,2200,1810,390,0.949524271844672,0.679611650485437,1.78033980582524,744,359,385,8,1.1,56.24,4.6,0,0,0,0,0,0,0.0150889832070203,13.3592717720147,1.57472901941432
8.7,"greedy_SVM","SVM",12,22,1612,1603,9,2300,1909,391,0.949503467406381,0.674757281553398,1.78197765293272,755,367,388,11,1.1,58.79,4.9,0,0,0,0,0,0,0.0102917804544142,8.268122624683,1.23121574498545
8.7,"greedy_SVM","SVM",12,23,1512,1504,8,2400,2008,392,0.949500693481278,0.679611650485437,1.78197765293272,757,368,389,2,1.1,61.35,5.1,0,0,0,0,0,0,0.00976616968408633,7.41482888186842,1.00342626888984
8.7,"greedy_SVM","SVM",12,24,1412,1406,6,2500,2106,394,0.948981969486816,0.674757281553398,1.78197765293272,777,380,397,20,1,63.91,5.3,0,0,0,0,0,0,0.00689043330065347,4.95303081379519,0.859518904898743
8.7,"greedy_SVM","SVM",12,25,1312,1308,4,2600,2204,396,0.948984743411916,0.679611650485437,1.78197765293272,786,383,403,9,1.1,66.46,5.6,0,0,0,0,0,0,0.00744222627234901,5.06691013145945,0.77643992434587
8.7,"greedy_SVM","SVM",12,26,1212,1208,4,2700,2304,396,0.948909847434093,0.674757281553398,1.78033980582524,795,385,410,9,1.1,69.02,5.8,0,0,0,0,0,0,0.00544895967861711,3.42414490539414,0.617419981900755
8.7,"greedy_SVM","SVM",12,27,1112,1108,4,2800,2404,396,0.948997226074869,0.674757281553398,1.78033980582524,792,384,408,-3,1.1,71.57,6.1,0,0,0,0,0,0,0.00507309775631786,2.7987883826285,0.522003052786696
8.7,"greedy_SVM","SVM",12,28,1012,1008,4,2900,2504,396,0.948818307905659,0.679611650485437,1.78033980582524,795,387,408,3,1.1,74.13,6.3,0,0,0,0,0,0,0.00400637131487538,2.00039089475161,0.440148174320632
8.7,"greedy_SVM","SVM",12,29,912,908,4,3000,2604,396,0.948789181692067,0.679611650485437,1.78033980582524,795,387,408,0,1.1,76.69,6.6,0,0,0,0,0,0,0.00375253106315732,1.63283008415093,0.401280659240345
8.7,"greedy_SVM","SVM",12,30,812,808,4,3100,2704,396,0.948679611650459,0.674757281553398,1.78197765293272,797,389,408,2,1,79.24,6.8,0,0,0,0,0,0,0.00282911916671054,1.05252874047684,0.311429519790711
8.7,"greedy_SVM","SVM",12,31,712,708,4,3200,2804,396,0.948626907073482,0.674757281553398,1.77870496670144,797,389,408,0,1,81.8,7.1,0,0,0,0,0,0,0.00217805146809944,0.703610081737897,0.246638434927536
8.7,"greedy_SVM","SVM",12,32,612,611,1,3300,2901,399,0.948690707350875,0.679611650485437,1.77544427931977,806,393,413,9,1.1,84.36,7.3,0,0,0,0,0,0,0.00193190147661409,0.615989858698989,0.235580552552629
8.7,"greedy_SVM","SVM",12,33,512,511,1,3400,3001,399,0.9487766990291,0.684466019417476,1.78197765293272,807,393,414,1,1.1,86.91,7.5,0,0,0,0,0,0,0.00103699276876386,0.332949830428409,0.139669460285141
8.7,"greedy_SVM","SVM",12,34,412,412,0,3500,3100,400,0.948760055478477,0.689320388349515,1.78033980582524,809,395,414,2,1,89.47,7.8,0,0,0,0,0,0,0.000968774247682547,0.281977068863269,0.118825734590736
8.7,"greedy_SVM","SVM",12,35,312,312,0,3600,3200,400,0.948737864077645,0.689320388349515,1.77870496670144,810,396,414,1,1,92.02,8,0,0,0,0,0,0,0.000681567239472169,0.165236828643397,0.0827859158739976
8.7,"greedy_SVM","SVM",12,36,212,212,0,3700,3300,400,0.94876837725379,0.684466019417476,1.78033980582524,813,397,416,3,1,94.58,8.2,0,0,0,0,0,0,0.000296842037040227,0.0632855453966989,0.0405344779692751
8.7,"greedy_SVM","SVM",12,37,112,112,0,3800,3400,400,0.948538141470156,0.684466019417476,1.77707312728244,818,399,419,5,1.1,97.14,8.5,0,0,0,0,0,0,0.000102190779886951,0.018503548773694,0.0173913834498842
8.7,"greedy_SVM","SVM",12,38,12,12,0,3900,3500,400,0.948413314840475,0.669902912621359,1.77870496670144,820,400,420,2,1.1,99.69,8.8,0,0,0,0,0,0,7.35054607185004e-05,0.00103991632769253,0.00103991632769253
8.7,"greedy_SVM","SVM",12,39,0,0,0,3912,3512,400,0.948327323162251,0.669902912621359,1.77870496670144,820,400,420,0,1.1,100,8.8,0,0,0,0,0,0,0,0,0
8.7,"greedy_SVM","SVM",13,0,3812,3427,385,100,90,10,0.875036325859933,0.507109004739337,1.74295760805469,24,10,14,0,1.4,2.56,9,0,0,0,0,0,0,0.369456367874115,345.579456557964,41.32063982017
8.7,"greedy_SVM","SVM",13,1,3712,3415,297,200,102,98,0.87847743722755,0.511848341232227,1.71101797814422,62,32,30,38,0.9,5.11,1,0,0,0,0,0,0,0.677862173303412,333.531796885063,77.8755415315445
8.7,"greedy_SVM","SVM",13,2,3612,3365,247,300,152,148,0.882939746601668,0.535545023696682,1.70563793562002,154,80,74,92,0.9,7.67,1,0,0,0,0,0,0,0.279839670193789,98.5155741436026,39.0878447620831
8.7,"greedy_SVM","SVM",13,3,3512,3309,203,400,208,192,0.90775540134984,0.582938388625592,1.73975069433242,241,123,118,87,1,10.22,1.1,0,0,0,0,0,0,0.252187714276319,114.784924463354,40.0324998540502
8.7,"greedy_SVM","SVM",13,4,3412,3258,154,500,259,241,0.88990344790124,0.625592417061611,1.68702955115696,330,166,164,89,1,12.78,1.1,0,0,0,0,0,0,0.156581945337064,98.543026536058,22.6994237067017
8.7,"greedy_SVM","SVM",13,5,3312,3192,120,600,325,275,0.874809543855842,0.658767772511848,1.63892016443665,406,198,208,76,1.1,15.34,1.2,0,0,0,0,0,0,0.143721848079523,123.222159323454,19.7379150380805
8.7,"greedy_SVM","SVM",13,6,3212,3113,99,700,404,296,0.87943888428687,0.66824644549763,1.62888422851712,460,224,236,54,1.1,17.89,1.4,0,0,0,0,0,0,0.0861840517733585,77.3720922397789,12.2458228447693
8.7,"greedy_SVM","SVM",13,7,3112,3037,75,800,480,320,0.877025760806097,0.66824644549763,1.587703909298,509,246,263,49,1.1,20.45,1.5,0,0,0,0,0,0,0.0856676155342026,110.657318191268,12.0807770629268
8.7,"greedy_SVM","SVM",13,8,3012,2953,59,900,564,336,0.882543217588502,0.682464454976303,1.60182603847226,552,263,289,43,1.1,23.01,1.7,0,0,0,0,0,0,0.067866904175958,103.34939113746,9.12018291232189
8.7,"greedy_SVM","SVM",13,9,2912,2857,55,1000,660,340,0.891015630304594,0.672985781990521,1.63038412191354,568,272,296,16,1.1,25.56,1.9,0,0,0,0,0,0,0.0526399357543373,74.8195053149148,5.89688534292506
8.7,"greedy_SVM","SVM",13,10,2812,2762,50,1100,755,345,0.90108230692975,0.672985781990521,1.65294814608308,582,278,304,14,1.1,28.12,2.2,0,0,0,0,0,0,0.0440529252031596,64.8411426697736,4.75473312741525
8.7,"greedy_SVM","SVM",13,11,2712,2667,45,1200,850,350,0.919675715313893,0.672985781990521,1.71574454714462,602,288,314,20,1.1,30.67,2.4,0,0,0,0,0,0,0.0413197276379424,55.4615510105435,4.86227084410622
8.7,"greedy_SVM","SVM",13,12,2612,2574,38,1300,943,357,0.925445755645788,0.663507109004739,1.69554990242543,625,300,325,23,1.1,33.23,2.6,0,0,0,0,0,0,0.0617936061292074,75.2135079876801,7.38785730123919
8.7,"greedy_SVM","SVM",13,13,2512,2477,35,1400,1040,360,0.930240769157639,0.658767772511848,1.74295760805469,647,311,336,22,1.1,35.79,2.9,0,0,0,0,0,0,0.0450231384664009,47.057609624283,5.09454424345707
8.7,"greedy_SVM","SVM",13,14,2412,2379,33,1500,1138,362,0.932258721601312,0.658767772511848,1.75150151789809,652,314,338,5,1.1,38.34,3.1,0,0,0,0,0,0,0.0389991804524811,38.8419824059262,4.27143490118157
8.7,"greedy_SVM","SVM",13,15,2312,2282,30,1600,1235,365,0.932848083216756,0.658767772511848,1.7600454277415,659,317,342,7,1.1,40.9,3.4,0,0,0,0,0,0,0.0375704158880242,37.2716077321354,4.29206149258239
8.7,"greedy_SVM","SVM",13,16,2212,2186,26,1700,1331,369,0.93295400535041,0.658767772511848,1.76696080228326,667,322,345,8,1.1,43.46,3.6,0,0,0,0,0,0,0.034187033598395,32.3093307091089,4.06105468601043
8.7,"greedy_SVM","SVM",13,17,2112,2094,18,1800,1423,377,0.930792107443048,0.658767772511848,1.7600454277415,688,332,356,21,1.1,46.01,3.8,0,0,0,0,0,0,0.0308656596509331,28.4632312770918,4.1499390749492
8.7,"greedy_SVM","SVM",13,18,2012,1998,14,1900,1519,381,0.930468909137803,0.654028436018957,1.75842475976015,700,336,364,12,1.1,48.57,4,0,0,0,0,0,0,0.0261448387797268,24.0081161432912,2.93881418614149
8.7,"greedy_SVM","SVM",13,19,1912,1899,13,2000,1618,382,0.930879017911686,0.649289099526066,1.75358061441646,706,338,368,6,1.1,51.12,4.2,0,0,0,0,0,0,0.0227621710442041,21.531438433662,2.4871516420367
8.7,"greedy_SVM","SVM",13,20,1812,1800,12,2100,1717,383,0.931807873545257,0.654028436018957,1.76696080228326,711,342,369,5,1.1,53.68,4.5,0,0,0,0,0,0,0.0180683697462853,17.2781620209839,1.93518168134231
8.7,"greedy_SVM","SVM",13,21,1712,1702,10,2200,1815,385,0.930980866117126,0.639810426540284,1.76047654245837,717,347,370,6,1.1,56.24,4.7,0,0,0,0,0,0,0.0150553490282332,13.3861496699408,1.56682885577689
8.7,"greedy_SVM","SVM",13,22,1612,1603,9,2300,1914,386,0.93183231711455,0.625592417061611,1.77223306384165,734,356,378,17,1.1,58.79,5,0,0,0,0,0,0,0.0104064867380053,7.75463406353549,1.31784981035876
8.7,"greedy_SVM","SVM",13,23,1512,1503,9,2400,2014,386,0.931889352109593,0.625592417061611,1.77386345304482,736,356,380,2,1.1,61.35,5.2,0,0,0,0,0,0,0.00850343852644199,6.78353986011507,0.945650844585854
8.7,"greedy_SVM","SVM",13,24,1412,1406,6,2500,2111,389,0.932017001860404,0.630331753554502,1.77911819617981,744,362,382,8,1.1,63.91,5.4,0,0,0,0,0,0,0.00906221708972474,6.18568062692691,0.931706314379568
8.7,"greedy_SVM","SVM",13,25,1312,1306,6,2600,2211,389,0.932592783715129,0.625592417061611,1.77911819617981,756,368,388,12,1.1,66.46,5.7,0,0,0,0,0,0,0.00602258819522262,3.96998418355115,0.720136546585652
8.7,"greedy_SVM","SVM",13,26,1212,1207,5,2700,2310,390,0.932706853705216,0.625592417061611,1.77911819617981,759,370,389,3,1.1,69.02,5.9,0,0,0,0,0,0,0.00577306836361208,3.4430980043246,0.598988953635125
8.7,"greedy_SVM","SVM",13,27,1112,1107,5,2800,2410,390,0.932905118211797,0.62085308056872,1.78239164272292,764,371,393,5,1.1,71.57,6.2,0,0,0,0,0,0,0.00372098259281749,2.03434596250393,0.411278584070371
8.7,"greedy_SVM","SVM",13,28,1012,1007,5,2900,2510,390,0.932676978231623,0.62085308056872,1.78239164272292,762,371,391,-2,1.1,74.13,6.4,0,0,0,0,0,0,0.00369223016801364,1.76456343942974,0.391000947490371
8.7,"greedy_SVM","SVM",13,29,912,907,5,3000,2610,390,0.933301647224957,0.62085308056872,1.78763072343426,770,376,394,8,1,76.69,6.7,0,0,0,0,0,0,0.00316371353842169,1.35044930726541,0.343801959904698
8.7,"greedy_SVM","SVM",13,30,812,809,3,3100,2708,392,0.933179429378435,0.625592417061611,1.79091983240102,776,380,396,6,1,79.24,6.9,0,0,0,0,0,0,0.00276661504115946,1.10236624296832,0.310444348668441
8.7,"greedy_SVM","SVM",13,31,712,710,2,3200,2807,393,0.932986596776146,0.625592417061611,1.79091983240102,780,382,398,4,1,81.8,7.1,0,0,0,0,0,0,0.00229860524267465,0.828106798815837,0.255829252334053
8.7,"greedy_SVM","SVM",13,32,612,610,2,3300,2907,393,0.932901044283581,0.625592417061611,1.78927376637859,778,382,396,-2,1,84.36,7.4,0,0,0,0,0,0,0.00184968242525493,0.60609749108329,0.215014605412123
8.7,"greedy_SVM","SVM",13,33,512,510,2,3400,3007,393,0.932896970355364,0.630331753554502,1.78599069524762,780,382,398,2,1,86.91,7.7,0,0,0,0,0,0,0.00123127137005115,0.385949025506325,0.155145047131727
8.7,"greedy_SVM","SVM",13,34,412,410,2,3500,3107,393,0.932994744632581,0.630331753554502,1.78763072343426,780,382,398,0,1,89.47,7.9,0,0,0,0,0,0,0.000786002957806434,0.229364456609897,0.101488684834508
8.7,"greedy_SVM","SVM",13,35,312,312,0,3600,3205,395,0.933631635410566,0.630331753554502,1.78599069524762,786,386,400,6,1,92.02,8.1,0,0,0,0,0,0,0.000925465876119374,0.2390622235434,0.11696279755561
8.7,"greedy_SVM","SVM",13,36,212,212,0,3700,3305,395,0.933869281223248,0.635071090047393,1.79422106711512,789,388,401,3,1,94.58,8.4,0,0,0,0,0,0,0.000475731210439842,0.0964359441460527,0.0596975447503896
8.7,"greedy_SVM","SVM",13,37,112,112,0,3800,3405,395,0.934064829777685,0.635071090047393,1.78763072343426,794,389,405,5,1,97.14,8.6,0,0,0,0,0,0,0.00018765524449944,0.0311663592562636,0.0292312099992816
8.7,"greedy_SVM","SVM",13,38,12,12,0,3900,3505,395,0.934123222748802,0.635071090047393,1.78599069524762,795,390,405,1,1,99.69,8.9,0,0,0,0,0,0,0.000139206429588637,0.00208026330890346,0.00208026330890346
8.7,"greedy_SVM","SVM",13,39,0,0,0,3912,3517,395,0.934216923097802,0.635071090047393,1.78435367352879,795,390,405,0,1,100,8.9,0,0,0,0,0,0,0,0,0
8.7,"greedy_SVM","SVM",14,0,3812,3414,398,100,87,13,0.89815955386652,0.533333333333333,1.7636517328825,32,13,19,0,1.5,2.56,6.7,0,0,0,0,0,0,0.696650548181584,532.295199723732,75.8883714316644
8.7,"greedy_SVM","SVM",14,1,3712,3372,340,200,129,71,0.915250658862241,0.57948717948718,1.77013574660633,104,50,54,72,1.1,5.11,1.8,0,0,0,0,0,0,0.693633781624833,367.352508990693,77.8083868501051
8.7,"greedy_SVM","SVM",14,2,3612,3356,256,300,145,155,0.91630192635303,0.58974358974359,1.77013574660633,138,70,68,34,1,7.67,0.9,0,0,0,0,0,0,0.595181851462902,297.005195846482,68.8460686478184
8.7,"greedy_SVM","SVM",14,3,3512,3311,201,400,190,210,0.916900362556225,0.605128205128205,1.7641592293526,225,115,110,87,1,10.22,0.9,0,0,0,0,0,0,0.342047322610258,137.593567685505,45.5438176402009
8.7,"greedy_SVM","SVM",14,4,3412,3255,157,500,246,254,0.858431252639096,0.61025641025641,1.62711095356257,320,161,159,95,1,12.78,1,0,0,0,0,0,0,0.287508806218141,195.844791706073,40.3453143788971
8.7,"greedy_SVM","SVM",14,5,3312,3183,129,600,318,282,0.889867353921868,0.630769230769231,1.65332200028333,391,195,196,71,1,15.34,1.1,0,0,0,0,0,0,0.159364045354906,104.668200010963,22.1113880487533
8.7,"greedy_SVM","SVM",14,6,3212,3111,101,700,390,310,0.870790197877095,0.651282051282051,1.60862105636299,462,224,238,71,1.1,17.89,1.3,0,0,0,0,0,0,0.103502980105431,98.0054161578011,14.0041300688329
8.7,"greedy_SVM","SVM",14,7,3112,3024,88,800,477,323,0.875848512645802,0.646153846153846,1.62561269301601,496,236,260,34,1.1,20.45,1.5,0,0,0,0,0,0,0.066256523015673,77.7199935839097,8.44056390281486
8.7,"greedy_SVM","SVM",14,8,3012,2942,70,900,559,341,0.882977329314636,0.656410256410256,1.61192343010525,544,259,285,48,1.1,23.01,1.6,0,0,0,0,0,0,0.0764640748359899,127.115284261316,10.9227663810435
8.7,"greedy_SVM","SVM",14,9,2912,2857,55,1000,644,356,0.88657377073051,0.656410256410256,1.62411718915859,582,282,300,38,1.1,25.56,1.8,0,0,0,0,0,0,0.0732493468162291,105.420736234232,7.99761027707496
8.7,"greedy_SVM","SVM",14,10,2812,2760,52,1100,741,359,0.91031028407519,0.625641025641026,1.66102894345765,614,299,315,32,1.1,28.12,2.1,0,0,0,0,0,0,0.0592183935653998,45.8355938307566,7.22746023430006
8.7,"greedy_SVM","SVM",14,11,2712,2664,48,1200,837,363,0.911370287860914,0.630769230769231,1.66718937628029,625,304,321,11,1.1,30.67,2.3,0,0,0,0,0,0,0.0424146898153654,39.9693563486425,4.90881405990486
8.7,"greedy_SVM","SVM",14,12,2612,2570,42,1300,931,369,0.913164140421374,0.641025641025641,1.69182559376108,638,310,328,13,1.1,33.23,2.5,0,0,0,0,0,0,0.0382703754568485,41.0659464097257,4.40148214895354
8.7,"greedy_SVM","SVM",14,13,2512,2475,37,1400,1026,374,0.915342389959071,0.646153846153846,1.69026774330642,652,319,333,14,1,35.79,2.7,0,0,0,0,0,0,0.033065419972914,38.0302799349899,3.81409934491003
8.7,"greedy_SVM","SVM",14,14,2412,2379,33,1500,1122,378,0.918011328062416,0.641025641025641,1.68103130755064,667,327,340,15,1,38.34,3,0,0,0,0,0,0,0.0343140571263658,38.914094303053,4.45562730219117
8.7,"greedy_SVM","SVM",14,15,2312,2284,28,1600,1217,383,0.92251488810261,0.635897435897436,1.71481900452489,686,336,350,19,1,40.9,3.2,0,0,0,0,0,0,0.0402268387648393,35.9423450608542,4.7589556531858
8.7,"greedy_SVM","SVM",14,16,2212,2190,22,1700,1311,389,0.92666462819784,0.646153846153846,1.74247737556561,710,344,366,24,1.1,43.46,3.4,0,0,0,0,0,0,0.0420095196857816,33.5471349571673,4.71372728467646
8.7,"greedy_SVM","SVM",14,17,2112,2093,19,1800,1408,392,0.927057761470021,0.641025641025641,1.73768596206726,719,348,371,9,1.1,46.01,3.6,0,0,0,0,0,0,0.0362247497387532,28.5779753870637,4.07115963961752
8.7,"greedy_SVM","SVM",14,18,2012,1998,14,1900,1503,397,0.92781781912957,0.630769230769231,1.74408039063053,732,353,379,13,1.1,48.57,3.8,0,0,0,0,0,0,0.0349592393046839,25.5944069558428,4.4054669910242
8.7,"greedy_SVM","SVM",14,19,1912,1900,12,2000,1601,399,0.927807626785478,0.635897435897436,1.74247737556561,738,356,382,6,1.1,51.12,4,0,0,0,0,0,0,0.0250227063611429,21.9240603963537,3.17382449725472
8.7,"greedy_SVM","SVM",14,20,1812,1805,7,2100,1696,404,0.927643093230827,0.641025641025641,1.73609467455621,753,363,390,15,1.1,53.68,4.2,0,0,0,0,0,0,0.021504935606237,18.9971338176749,2.64704366955364
8.7,"greedy_SVM","SVM",14,21,1712,1705,7,2200,1796,404,0.927912462324725,0.641025641025641,1.73609467455621,752,363,389,-1,1.1,56.24,4.4,0,0,0,0,0,0,0.0178835748655903,14.76610108686,1.83889959231009
8.7,"greedy_SVM","SVM",14,22,1612,1605,7,2300,1896,404,0.929699034639407,0.625641025641026,1.74688006768667,761,372,389,9,1,58.79,4.7,0,0,0,0,0,0,0.0124350973347952,8.98241346121149,1.53646541016033
8.7,"greedy_SVM","SVM",14,23,1512,1508,4,2400,1993,407,0.929735435868313,0.635897435897436,1.75492279359683,776,378,398,15,1.1,61.35,4.9,0,0,0,0,0,0,0.0130178870427912,9.25437303422906,1.34596632445821
8.7,"greedy_SVM","SVM",14,24,1412,1409,3,2500,2092,408,0.930970165552789,0.630769230769231,1.75446604677374,779,382,397,3,1,63.91,5.1,0,0,0,0,0,0,0.00911695357537859,6.23637855218834,1.06005594013794
8.7,"greedy_SVM","SVM",14,25,1312,1309,3,2600,2192,408,0.930834752981261,0.635897435897436,1.75607417330607,780,382,398,1,1,66.46,5.4,0,0,0,0,0,0,0.00899230617393167,5.43343488422064,0.923151120294886
8.7,"greedy_SVM","SVM",14,26,1212,1209,3,2700,2292,408,0.931341458087624,0.625641025641026,1.75768525052929,789,387,402,9,1,69.02,5.6,0,0,0,0,0,0,0.00643641372053382,3.65118599697811,0.716278628301146
8.7,"greedy_SVM","SVM",14,27,1112,1109,3,2800,2392,408,0.931446293626871,0.625641025641026,1.75607417330607,788,387,401,-1,1,71.57,5.9,0,0,0,0,0,0,0.00586454269215405,2.90686375263148,0.614563385377246
8.7,"greedy_SVM","SVM",14,28,1012,1009,3,2900,2492,408,0.931358930677496,0.625641025641026,1.75929928657201,791,387,404,3,1,74.13,6.1,0,0,0,0,0,0,0.00483619781976708,2.1089461484476,0.512522503749636
8.7,"greedy_SVM","SVM",14,29,912,909,3,3000,2592,408,0.931609371132364,0.625641025641026,1.76091628959276,793,387,406,2,1,76.69,6.4,0,0,0,0,0,0,0.00428449472056842,1.65914749824029,0.464535459670801
8.7,"greedy_SVM","SVM",14,30,812,809,3,3100,2692,408,0.931693821983424,0.625641025641026,1.7641592293526,792,387,405,-1,1,79.24,6.6,0,0,0,0,0,0,0.00307619024240239,1.0956516938561,0.351166292449527
8.7,"greedy_SVM","SVM",14,31,712,709,3,3200,2792,408,0.931787009129421,0.625641025641026,1.76253626778006,794,387,407,2,1.1,81.8,6.8,0,0,0,0,0,0,0.00235714277106536,0.729112087127027,0.267593381197287
8.7,"greedy_SVM","SVM",14,32,612,610,2,3300,2891,409,0.93211753228788,0.625641025641026,1.75768525052929,798,389,409,4,1.1,84.36,7.1,0,0,0,0,0,0,0.00184059452045721,0.608081568143739,0.234094216942616
8.7,"greedy_SVM","SVM",14,33,512,510,2,3400,2991,409,0.932014152797787,0.625641025641026,1.7641592293526,800,390,410,2,1.1,86.91,7.3,0,0,0,0,0,0,0.00107897702511627,0.331163589407161,0.136740098546978
8.7,"greedy_SVM","SVM",14,34,412,411,1,3500,3090,410,0.932483000626086,0.615384615384615,1.75768525052929,803,391,412,3,1.1,89.47,7.5,0,0,0,0,0,0,0.000977966872039845,0.290997817876201,0.120323033511624
8.7,"greedy_SVM","SVM",14,35,312,312,0,3600,3189,411,0.933187728417694,0.615384615384615,1.75929928657201,812,394,418,9,1.1,92.02,7.8,0,0,0,0,0,0,0.000694762186972185,0.177444127388162,0.0876965362297065
8.7,"greedy_SVM","SVM",14,36,212,212,0,3700,3289,411,0.93326635507213,0.615384615384615,1.7641592293526,814,395,419,2,1.1,94.58,8,0,0,0,0,0,0,0.000453988344380589,0.0922709826523366,0.057764109601002
8.7,"greedy_SVM","SVM",14,37,112,112,0,3800,3389,411,0.933219761499131,0.615384615384615,1.7641592293526,818,397,421,4,1.1,97.14,8.2,0,0,0,0,0,0,0.000163901776651106,0.0266087321185797,0.0248510154312039
8.7,"greedy_SVM","SVM",14,38,12,12,0,3900,3489,411,0.933407591840285,0.615384615384615,1.75768525052929,821,398,423,3,1.1,99.69,8.5,0,0,0,0,0,0,0.000141803977364187,0.00194444697968734,0.00194444697968734
8.7,"greedy_SVM","SVM",14,39,0,0,0,3912,3501,411,0.933457097511597,0.615384615384615,1.75768525052929,821,399,422,0,1.1,100,8.5,0,0,0,0,0,0,0,0,0
8.7,"greedy_SVM","SVM",15,0,3812,3411,401,100,88,12,0.912040533828636,0.575129533678757,1.76540197225472,29,12,17,0,1.4,2.56,7.3,0,0,0,0,0,0,0.368483395418629,434.906486859486,41.6095247714058
8.7,"greedy_SVM","SVM",15,1,3712,3369,343,200,130,70,0.913849449977804,0.580310880829015,1.76984913136239,92,46,46,63,1,5.11,1.9,0,0,0,0,0,0,0.683301481453758,402.193685003285,75.1643635967962
8.7,"greedy_SVM","SVM",15,2,3612,3342,270,300,157,143,0.914842810917573,0.601036269430052,1.74800589437657,145,73,72,53,1,7.67,1.1,0,0,0,0,0,0,0.570513219127046,308.122572832795,65.8509926404905
8.7,"greedy_SVM","SVM",15,3,3512,3302,210,400,197,203,0.894622919599497,0.606217616580311,1.68911917098446,221,112,109,76,1,10.22,1,0,0,0,0,0,0,0.342092623037952,210.04021786237,43.8843354057455
8.7,"greedy_SVM","SVM",15,4,3412,3233,179,500,266,234,0.884961161938414,0.616580310880829,1.67824167862301,321,163,158,100,1,12.78,1.1,0,0,0,0,0,0,0.162019451528087,127.742878751639,23.3740134707089
8.7,"greedy_SVM","SVM",15,5,3312,3161,151,600,338,262,0.905183992194188,0.652849740932642,1.72803896755092,383,187,196,62,1,15.34,1.3,0,0,0,0,0,0,0.114600832582943,104.177766934981,17.2519463371265
8.7,"greedy_SVM","SVM",15,6,3212,3094,118,700,405,295,0.91434613044771,0.663212435233161,1.70151637590911,446,215,231,63,1.1,17.89,1.4,0,0,0,0,0,0,0.0961966438757738,134.489015862138,16.0696513459551
8.7,"greedy_SVM","SVM",15,7,3112,3029,83,800,470,330,0.908660755483322,0.689119170984456,1.67199446049521,525,249,276,79,1.1,20.45,1.4,0,0,0,0,0,0,0.120537270699174,187.998876137423,15.4562437280785
8.7,"greedy_SVM","SVM",15,8,3012,2941,71,900,558,342,0.919116026321124,0.678756476683938,1.68601417250838,570,272,298,45,1.1,23.01,1.6,0,0,0,0,0,0,0.0862771937031246,125.090618650561,10.4599182750353
8.7,"greedy_SVM","SVM",15,9,2912,2851,61,1000,648,352,0.920150532388563,0.678756476683938,1.68601417250838,587,282,305,17,1.1,25.56,1.8,0,0,0,0,0,0,0.0732209350922756,119.660603197291,7.93954555078201
8.7,"greedy_SVM","SVM",15,10,2812,2760,52,1100,739,361,0.928595569845318,0.673575129533679,1.7264477714482,615,296,319,28,1.1,28.12,2,0,0,0,0,0,0,0.0663382277919504,103.575195197011,7.42425026933329
8.7,"greedy_SVM","SVM",15,11,2712,2667,45,1200,832,368,0.93509650001911,0.66839378238342,1.74190414507772,632,305,327,17,1.1,30.67,2.3,0,0,0,0,0,0,0.0742001677696156,90.1755274832662,8.43285233812226
8.7,"greedy_SVM","SVM",15,12,2612,2572,40,1300,927,373,0.938429255361364,0.66839378238342,1.76053413593417,649,314,335,17,1.1,33.23,2.5,0,0,0,0,0,0,0.0623187107400311,72.44727554183,6.92976504619262
8.7,"greedy_SVM","SVM",15,13,2512,2479,33,1400,1020,380,0.939537234871084,0.66839378238342,1.75891748383505,668,321,347,19,1.1,35.79,2.7,0,0,0,0,0,0,0.0670536821694326,65.9914566456972,7.48168787483967
8.7,"greedy_SVM","SVM",15,14,2412,2385,27,1500,1114,386,0.940180862225542,0.66839378238342,1.76215376255416,686,329,357,18,1.1,38.34,2.9,0,0,0,0,0,0,0.0608207219827895,61.5473151035078,6.92427300580545
8.7,"greedy_SVM","SVM",15,15,2312,2291,21,1600,1208,392,0.941782583267454,0.66839378238342,1.77474272343067,707,335,372,21,1.1,40.9,3.1,0,0,0,0,0,0,0.0469799873431997,53.8952972530361,5.59808447743975
8.7,"greedy_SVM","SVM",15,16,2212,2193,19,1700,1306,394,0.941929530152032,0.66839378238342,1.77474272343067,712,338,374,5,1.1,43.46,3.3,0,0,0,0,0,0,0.0371573178252898,43.4792836119066,4.05510418719579
8.7,"greedy_SVM","SVM",15,17,2112,2095,17,1800,1404,396,0.942050026597386,0.66839378238342,1.7714773274354,717,342,375,5,1.1,46.01,3.5,0,0,0,0,0,0,0.0321484594710967,37.9029612750436,3.46291414449167
8.7,"greedy_SVM","SVM",15,18,2012,1997,15,1900,1502,398,0.942990486658698,0.66839378238342,1.78080089231664,720,346,374,3,1.1,48.57,3.8,0,0,0,0,0,0,0.0276453811453036,31.5687741636806,2.94827973275331
8.7,"greedy_SVM","SVM",15,19,1912,1899,13,2000,1600,400,0.942733329610685,0.673575129533679,1.77310852202788,728,351,377,8,1.1,51.12,4,0,0,0,0,0,0,0.0272686767576594,27.3378325592255,2.79176463015248
8.7,"greedy_SVM","SVM",15,20,1812,1801,11,2100,1698,402,0.939643036627983,0.652849740932642,1.79944802207912,765,371,394,37,1.1,53.68,4.2,0,0,0,0,0,0,0.0209050029604644,14.1410330374136,2.8100863868601
8.7,"greedy_SVM","SVM",15,21,1712,1703,9,2200,1796,404,0.939804678201021,0.658031088082902,1.79614325068871,771,373,398,6,1.1,56.24,4.4,0,0,0,0,0,0,0.0132238313383344,10.3109706046719,1.5555956363015
8.7,"greedy_SVM","SVM",15,22,1612,1606,6,2300,1893,407,0.940101510907868,0.658031088082902,1.79614325068871,777,376,401,6,1.1,58.79,4.7,0,0,0,0,0,0,0.0121985738458893,10.4912311730803,1.37949416926153
8.7,"greedy_SVM","SVM",15,23,1512,1506,6,2400,1993,407,0.940125022409401,0.658031088082902,1.79944802207912,779,376,403,2,1.1,61.35,4.9,0,0,0,0,0,0,0.0096707432349657,8.04527475768456,1.0049110397599
8.7,"greedy_SVM","SVM",15,24,1412,1406,6,2500,2093,407,0.939484333992636,0.647668393782383,1.79614325068871,786,384,402,7,1,63.91,5.1,0,0,0,0,0,0,0.00756696040913515,5.91194087675671,0.855494261277876
8.7,"greedy_SVM","SVM",15,25,1312,1307,5,2600,2192,408,0.939672426004897,0.647668393782383,1.79614325068871,789,386,403,3,1,66.46,5.4,0,0,0,0,0,0,0.00768587630604137,5.53027174928392,0.786868812463765
8.7,"greedy_SVM","SVM",15,26,1212,1207,5,2700,2292,408,0.939246280039616,0.647668393782383,1.79779411764706,795,387,408,6,1.1,69.02,5.6,0,0,0,0,0,0,0.00550660015273238,3.58751284677144,0.613972316462686
8.7,"greedy_SVM","SVM",15,27,1112,1109,3,2800,2390,410,0.939285955698451,0.647668393782383,1.79177282225975,799,390,409,4,1,71.57,5.8,0,0,0,0,0,0,0.00594381291115937,3.53436816099187,0.61366013342114
8.7,"greedy_SVM","SVM",15,28,1012,1009,3,2900,2490,410,0.938558568619786,0.637305699481865,1.79012445719788,804,392,412,5,1.1,74.13,6.1,0,0,0,0,0,0,0.00464982582762214,2.49974894162797,0.50901992714838
8.7,"greedy_SVM","SVM",15,29,912,909,3,3000,2590,410,0.938526240305178,0.637305699481865,1.79177282225975,804,392,412,0,1.1,76.69,6.3,0,0,0,0,0,0,0.00390140943767779,1.83863476580819,0.413797248417488
8.7,"greedy_SVM","SVM",15,30,812,809,3,3100,2690,410,0.938079521776059,0.637305699481865,1.79012445719788,805,393,412,1,1,79.24,6.6,0,0,0,0,0,0,0.00344602105132544,1.4032822055787,0.369964024378934
8.7,"greedy_SVM","SVM",15,31,712,709,3,3200,2790,410,0.938150056280656,0.637305699481865,1.79177282225975,804,393,411,-1,1,81.8,6.8,0,0,0,0,0,0,0.00251966543474306,0.931439548854273,0.281903638103452
8.7,"greedy_SVM","SVM",15,32,612,609,3,3300,2890,410,0.938141239467582,0.637305699481865,1.79342422578257,805,394,411,1,1,84.36,7,0,0,0,0,0,0,0.00210244151670927,0.709507698328165,0.243698013622074
8.7,"greedy_SVM","SVM",15,33,512,510,2,3400,2989,411,0.938202957159104,0.637305699481865,1.79342422578257,811,396,415,6,1,86.91,7.3,0,0,0,0,0,0,0.00155137685692737,0.517505392154778,0.185433964649688
8.7,"greedy_SVM","SVM",15,34,412,412,0,3500,3087,413,0.938654084094763,0.642487046632124,1.78847912221884,819,400,419,8,1,89.47,7.5,0,0,0,0,0,0,0.00189570391508684,0.577203636088045,0.221246200505873
8.7,"greedy_SVM","SVM",15,35,312,312,0,3600,3187,413,0.938476278364421,0.642487046632124,1.79177282225975,824,402,422,5,1,92.02,7.7,0,0,0,0,0,0,0.0010543160833481,0.277254129295643,0.12935230377118
8.7,"greedy_SVM","SVM",15,36,212,212,0,3700,3287,413,0.938470400489038,0.642487046632124,1.79342422578257,826,405,421,2,1,94.58,8,0,0,0,0,0,0,0.000713656555751715,0.146314152223427,0.0868923096611006
8.7,"greedy_SVM","SVM",15,37,112,112,0,3800,3387,413,0.938502728803645,0.642487046632124,1.79012445719788,828,406,422,2,1,97.14,8.2,0,0,0,0,0,0,0.000356669016486617,0.0544080969606771,0.0504296181084104
8.7,"greedy_SVM","SVM",15,38,12,12,0,3900,3487,413,0.938580610652472,0.642487046632124,1.79177282225975,831,407,424,3,1,99.69,8.4,0,0,0,0,0,0,0.000203698023589649,0.00266881153216066,0.00266881153216066
8.7,"greedy_SVM","SVM",15,39,0,0,0,3912,3499,413,0.938617347373616,0.642487046632124,1.78847912221884,831,407,424,0,1,100,8.5,0,0,0,0,0,0,0,0,0
8.7,"greedy_SVM","SVM",16,0,3812,3417,395,100,93,7,0.897584833019978,0.568627450980392,1.73206831119545,23,7,16,0,2.3,2.56,13.3,0,0,0,0,0,0,0.342362663425692,267.415636606286,40.3163616014308
8.7,"greedy_SVM","SVM",16,1,3712,3398,314,200,112,88,0.911009266720396,0.583333333333333,1.72816317743932,78,42,36,55,0.9,5.11,1.3,0,0,0,0,0,0,0.697840174803527,268.941888620108,78.3809920221413
8.7,"greedy_SVM","SVM",16,2,3612,3361,251,300,149,151,0.909613103232172,0.568627450980392,1.73047340483155,154,80,74,76,0.9,7.67,1,0,0,0,0,0,0,0.387012392557893,117.717365977293,52.9593701564296
8.7,"greedy_SVM","SVM",16,3,3512,3320,192,400,190,210,0.907177511415538,0.57843137254902,1.72164445888853,234,120,114,80,1,10.22,0.9,0,0,0,0,0,0,0.260588878392652,124.470410794089,38.4956570688212
8.7,"greedy_SVM","SVM",16,4,3412,3254,158,500,256,244,0.86163432267885,0.632352941176471,1.58774825477569,323,163,160,89,1,12.78,1,0,0,0,0,0,0,0.224623437597091,172.755515878073,31.0798580201451
8.7,"greedy_SVM","SVM",16,5,3312,3187,125,600,323,277,0.859340025964733,0.642156862745098,1.59803921568627,398,197,201,75,1,15.34,1.2,0,0,0,0,0,0,0.151953584759717,113.93808379391,26.5310750818822
8.7,"greedy_SVM","SVM",16,6,3212,3105,107,700,405,295,0.875789014235837,0.661764705882353,1.60834914611006,448,217,231,50,1.1,17.89,1.4,0,0,0,0,0,0,0.080890584613917,74.3433005560577,11.0970784749308
8.7,"greedy_SVM","SVM",16,7,3112,3020,92,800,490,310,0.884851486256607,0.666666666666667,1.62005077513099,478,232,246,30,1.1,20.45,1.6,0,0,0,0,0,0,0.0587392526746428,67.65574483323,7.36472550492622
8.7,"greedy_SVM","SVM",16,8,3012,2937,75,900,573,327,0.895192609007085,0.67156862745098,1.63766002268676,527,252,275,49,1.1,23.01,1.8,0,0,0,0,0,0,0.0561787823658275,75.6618626293955,6.96524184554734
8.7,"greedy_SVM","SVM",16,9,2912,2856,56,1000,654,346,0.901841872593793,0.676470588235294,1.63916522491349,574,277,297,47,1.1,25.56,1.9,0,0,0,0,0,0,0.0686371354385772,113.319952818516,10.1061034346163
8.7,"greedy_SVM","SVM",16,10,2812,2766,46,1100,744,356,0.907011035007622,0.661764705882353,1.65831484387683,606,290,316,32,1.1,28.12,2.1,0,0,0,0,0,0,0.0605125424732483,96.5801859673122,7.4710288980518
8.7,"greedy_SVM","SVM",16,11,2712,2674,38,1200,836,364,0.909613103232174,0.656862745098039,1.67020872865275,630,302,328,24,1.1,30.67,2.3,0,0,0,0,0,0,0.0545840084481303,81.1050441170392,5.85576890970433
8.7,"greedy_SVM","SVM",16,12,2612,2579,33,1300,931,369,0.919216973319022,0.651960784313726,1.69204152249135,649,316,333,19,1.1,33.23,2.5,0,0,0,0,0,0,0.0527085302424164,71.8670454724764,5.96567375716228
8.7,"greedy_SVM","SVM",16,13,2512,2486,26,1400,1024,376,0.929251723520467,0.651960784313726,1.73770225661562,669,324,345,20,1.1,35.79,2.7,0,0,0,0,0,0,0.0594811266586167,64.3685466091777,6.44820959176895
8.7,"greedy_SVM","SVM",16,14,2412,2386,26,1500,1124,376,0.929867266541328,0.647058823529412,1.73770225661562,669,324,345,0,1.1,38.34,3,0,0,0,0,0,0,0.0446235686280008,49.3550244513796,4.83634979657596
8.7,"greedy_SVM","SVM",16,15,2312,2287,25,1600,1223,377,0.930368094726483,0.647058823529412,1.74652308025326,670,326,344,1,1.1,40.9,3.2,0,0,0,0,0,0,0.036424843216068,39.8937740562432,3.93500268747614
8.7,"greedy_SVM","SVM",16,16,2212,2189,23,1700,1321,379,0.93250011191692,0.651960784313726,1.75212013179928,675,329,346,5,1.1,43.46,3.5,0,0,0,0,0,0,0.0303201245157942,33.1074811527079,3.43179077724849
8.7,"greedy_SVM","SVM",16,17,2112,2096,16,1800,1414,386,0.933410835795512,0.647058823529412,1.75373053633218,697,337,360,22,1.1,46.01,3.7,0,0,0,0,0,0,0.0314001881991303,30.3000277973654,4.18449639073381
8.7,"greedy_SVM","SVM",16,18,2012,2003,9,1900,1507,393,0.932701562360111,0.647058823529412,1.7585795608566,717,344,373,20,1.1,48.57,3.8,0,0,0,0,0,0,0.02967359436578,30.5750466853,3.48389465045289
8.7,"greedy_SVM","SVM",16,19,1912,1905,7,2000,1605,395,0.93288762422778,0.647058823529412,1.7569602426606,722,348,374,5,1.1,51.12,4.1,0,0,0,0,0,0,0.0257423079289167,27.623858503044,2.75558309881523
8.7,"greedy_SVM","SVM",16,20,1812,1805,7,2100,1705,395,0.93258125167876,0.642156862745098,1.7553439038909,724,350,374,2,1.1,53.68,4.3,0,0,0,0,0,0,0.0209101205778427,20.3849234728838,2.13255110945735
8.7,"greedy_SVM","SVM",16,21,1712,1705,7,2200,1805,395,0.929272707941631,0.637254901960784,1.76578918860362,750,363,387,26,1.1,56.24,4.6,0,0,0,0,0,0,0.0130653163941599,8.95731665287895,1.72944605950427
8.7,"greedy_SVM","SVM",16,22,1612,1607,5,2300,1903,397,0.929898043692369,0.637254901960784,1.76578918860362,752,365,387,2,1.1,58.79,4.8,0,0,0,0,0,0,0.0106643615344472,8.57982756341459,1.25729232579457
8.7,"greedy_SVM","SVM",16,23,1512,1508,4,2400,2002,398,0.929934416689056,0.637254901960784,1.76416472752855,756,365,391,4,1.1,61.35,5,0,0,0,0,0,0,0.00832472987448544,6.9125736149856,0.899310695891979
8.7,"greedy_SVM","SVM",16,24,1412,1409,3,2500,2101,399,0.929665816098135,0.642156862745098,1.76741664407699,770,371,399,14,1.1,63.91,5.3,0,0,0,0,0,0,0.00747773041916262,5.57091666757348,0.782179618104479
8.7,"greedy_SVM","SVM",16,25,1312,1309,3,2600,2201,399,0.929896644730957,0.642156862745098,1.76578918860362,779,378,401,9,1.1,66.46,5.5,0,0,0,0,0,0,0.00512717478423549,3.37348556229747,0.591022184283476
8.7,"greedy_SVM","SVM",16,26,1212,1210,2,2700,2300,400,0.930517783597462,0.642156862745098,1.76578918860362,782,379,403,3,1.1,69.02,5.8,0,0,0,0,0,0,0.00478768412061584,3.11101335457818,0.502746847367355
8.7,"greedy_SVM","SVM",16,27,1112,1110,2,2800,2400,400,0.930527576327339,0.642156862745098,1.76578918860362,783,379,404,1,1.1,71.57,6,0,0,0,0,0,0,0.00439485380667461,2.54079608503331,0.454280012398177
8.7,"greedy_SVM","SVM",16,28,1012,1011,1,2900,2499,401,0.930639493240223,0.642156862745098,1.76092475557716,785,382,403,2,1.1,74.13,6.2,0,0,0,0,0,0,0.00392176120855548,2.03332791195646,0.410587004635096
8.7,"greedy_SVM","SVM",16,29,912,911,1,3000,2599,401,0.930829751992125,0.642156862745098,1.76092475557716,787,384,403,2,1,76.69,6.5,0,0,0,0,0,0,0.00303049218391282,1.36747779763838,0.319069448117149
8.7,"greedy_SVM","SVM",16,30,812,811,1,3100,2699,401,0.931039596203782,0.651960784313726,1.76416472752855,789,385,404,2,1,79.24,6.7,0,0,0,0,0,0,0.00267127878934671,1.04351556064645,0.28472103924904
8.7,"greedy_SVM","SVM",16,31,712,711,1,3200,2799,401,0.931115140119979,0.647058823529412,1.75769666253302,792,387,405,3,1,81.8,7,0,0,0,0,0,0,0.00208523786859911,0.689164031469263,0.228217631624024
8.7,"greedy_SVM","SVM",16,32,612,611,1,3300,2899,401,0.931103948428691,0.651960784313726,1.76578918860362,792,387,405,0,1,84.36,7.2,0,0,0,0,0,0,0.001848680492584,0.549974623161023,0.213854262765157
8.7,"greedy_SVM","SVM",16,33,512,511,1,3400,2999,401,0.931185088190532,0.651960784313726,1.75448038318713,792,387,405,0,1,86.91,7.5,0,0,0,0,0,0,0.000967492845795716,0.286209573490688,0.126799521102132
8.7,"greedy_SVM","SVM",16,34,412,412,0,3500,3098,402,0.93166353299311,0.651960784313726,1.75930922827847,794,390,404,2,1,89.47,7.7,0,0,0,0,0,0,0.000674010824887906,0.20052822154995,0.0901706622329028
8.7,"greedy_SVM","SVM",16,35,312,312,0,3600,3198,402,0.931506849315072,0.642156862745098,1.76648514584569,796,392,404,2,1,92.02,8,0,0,0,0,0,0,0.000472134451478158,0.119815075419701,0.0608298153521485
8.7,"greedy_SVM","SVM",16,36,212,212,0,3700,3298,402,0.931285813412127,0.642156862745098,1.76972937935505,800,391,409,4,1,94.58,8.2,0,0,0,0,0,0,0.000238425601226826,0.0506009669301725,0.0322558031803584
8.7,"greedy_SVM","SVM",16,37,112,112,0,3800,3398,402,0.931319388485992,0.642156862745098,1.76972937935505,801,392,409,1,1,97.14,8.5,0,0,0,0,0,0,9.80499950771606e-05,0.0167488826689462,0.0157296183308061
8.7,"greedy_SVM","SVM",16,38,12,12,0,3900,3498,402,0.931467678395563,0.647058823529412,1.77625372729737,803,394,409,2,1,99.69,8.7,0,0,0,0,0,0,5.68871558493212e-05,0.000815384684236722,0.000815384684236722
8.7,"greedy_SVM","SVM",16,39,0,0,0,3912,3510,402,0.931491460739551,0.647058823529412,1.76810577441986,804,394,410,1,1,100,8.7,0,0,0,0,0,0,0,0,0
8.7,"greedy_SVM","SVM",17,0,3812,3410,402,100,92,8,0.865674281076056,0.418367346938776,1.72600116403507,33,8,25,0,3.1,2.56,11.5,0,0,0,0,0,0,0.340341623501196,310.881095736015,46.3713393623594
8.7,"greedy_SVM","SVM",17,1,3712,3347,365,200,155,45,0.910963589981447,0.494897959183673,1.78436941596915,99,45,54,66,1.2,5.11,3.4,0,0,0,0,0,0,0.354781577116482,472.133237816209,43.0988229175496
8.7,"greedy_SVM","SVM",17,2,3612,3302,310,300,200,100,0.933818413729114,0.627551020408163,1.77618423516195,195,94,101,96,1.1,7.67,2,0,0,0,0,0,0,0.541065907849501,425.577464266707,64.8148415653766
8.7,"greedy_SVM","SVM",17,3,3512,3286,226,400,216,184,0.939977098794062,0.607142857142857,1.77944927971188,236,118,118,41,1,10.22,1.2,0,0,0,0,0,0,0.473561692809887,288.587682273581,59.5919897530789
8.7,"greedy_SVM","SVM",17,4,3412,3234,178,500,268,232,0.930967358534329,0.642857142857143,1.76110444177671,330,165,165,94,1,12.78,1.2,0,0,0,0,0,0,0.34704932203436,277.138826728512,45.9001409682746
8.7,"greedy_SVM","SVM",17,5,3312,3176,136,600,326,274,0.909270640074197,0.653061224489796,1.68927773501305,413,204,209,83,1,15.34,1.2,0,0,0,0,0,0,0.222549537574943,210.972602039295,29.8083447756427
8.7,"greedy_SVM","SVM",17,6,3212,3110,102,700,392,308,0.91652655380333,0.673469387755102,1.68617529656491,476,232,244,63,1.1,17.89,1.3,0,0,0,0,0,0,0.166779637352027,209.791089350252,22.2373866535111
8.7,"greedy_SVM","SVM",17,7,3112,3039,73,800,463,337,0.901388566790355,0.683673469387755,1.64337344873552,548,264,284,72,1.1,20.45,1.4,0,0,0,0,0,0,0.131296841876743,208.297663770745,17.0681622622722
8.7,"greedy_SVM","SVM",17,8,3012,2954,58,900,548,352,0.902881493506487,0.673469387755102,1.66173516324653,589,283,306,41,1.1,23.01,1.6,0,0,0,0,0,0,0.10707421543149,161.432706843992,12.1602025501913
8.7,"greedy_SVM","SVM",17,9,2912,2858,54,1000,644,356,0.912346358998144,0.668367346938776,1.6831938305276,607,296,311,18,1.1,25.56,1.8,0,0,0,0,0,0,0.0841130444415456,120.490644442308,9.47059744125732
8.7,"greedy_SVM","SVM",17,10,2812,2767,45,1100,735,365,0.917967300556575,0.668367346938776,1.6968975090036,626,302,324,19,1.1,28.12,2,0,0,0,0,0,0,0.0784063280475148,111.69085212501,8.46369277932485
8.7,"greedy_SVM","SVM",17,11,2712,2671,41,1200,831,369,0.922379406307961,0.668367346938776,1.71366728509586,648,311,337,22,1.1,30.67,2.3,0,0,0,0,0,0,0.0690493094592086,90.451527922421,7.47225744527244
8.7,"greedy_SVM","SVM",17,12,2612,2572,40,1300,930,370,0.923141813543587,0.663265306122449,1.72283128127284,657,313,344,9,1.1,33.23,2.5,0,0,0,0,0,0,0.0602735452803571,71.4207577666731,6.33638988420645
8.7,"greedy_SVM","SVM",17,13,2512,2479,33,1400,1023,377,0.928246753246745,0.663265306122449,1.75354373580159,679,323,356,22,1.1,35.79,2.7,0,0,0,0,0,0,0.0642634174818488,64.4520517321019,7.39853819212143
8.7,"greedy_SVM","SVM",17,14,2412,2384,28,1500,1118,382,0.928968576066778,0.663265306122449,1.75354373580159,688,329,359,9,1.1,38.34,2.9,0,0,0,0,0,0,0.0586282890429539,56.3953308191966,6.50319402819151
8.7,"greedy_SVM","SVM",17,15,2312,2295,17,1600,1207,393,0.928267045454535,0.668367346938776,1.75032326980379,713,339,374,25,1.1,40.9,3.1,0,0,0,0,0,0,0.0515663395776318,53.2961024847568,6.04883742655423
8.7,"greedy_SVM","SVM",17,16,2212,2200,12,1700,1302,398,0.927826414656764,0.668367346938776,1.75677607448509,732,344,388,19,1.1,43.46,3.3,0,0,0,0,0,0,0.0428601261014407,47.9568896148141,4.77250000197114
8.7,"greedy_SVM","SVM",17,17,2112,2100,12,1800,1402,398,0.927614795918358,0.663265306122449,1.75354373580159,732,344,388,0,1.1,46.01,3.5,0,0,0,0,0,0,0.0359470531595332,38.4576894923924,3.83382127546851
8.7,"greedy_SVM","SVM",17,18,2012,2000,12,1900,1502,398,0.927595953153979,0.668367346938776,1.75515841695794,730,345,385,-2,1.1,48.57,3.8,0,0,0,0,0,0,0.0281441557176059,29.059053765569,2.99750708766053
8.7,"greedy_SVM","SVM",17,19,1912,1902,10,2000,1600,400,0.926956748608524,0.658163265306122,1.75354373580159,729,349,380,-1,1.1,51.12,4,0,0,0,0,0,0,0.0241027481223946,24.2977334911782,2.57225462755858
8.7,"greedy_SVM","SVM",17,20,1812,1803,9,2100,1699,401,0.926566848330233,0.658163265306122,1.75515841695794,736,352,384,7,1.1,53.68,4.2,0,0,0,0,0,0,0.0229732137658006,21.9719817390193,2.36563408859964
8.7,"greedy_SVM","SVM",17,21,1712,1704,8,2200,1798,402,0.929612128942467,0.653061224489796,1.76597385497978,758,366,392,22,1.1,56.24,4.5,0,0,0,0,0,0,0.0139616164894303,10.6619556730923,1.83130716037189
8.7,"greedy_SVM","SVM",17,22,1612,1605,7,2300,1897,403,0.928909148886808,0.653061224489796,1.75515841695794,759,367,392,1,1.1,58.79,4.7,0,0,0,0,0,0,0.0110313764853119,9.16818572094851,1.22756697275832
8.7,"greedy_SVM","SVM",17,23,1512,1505,7,2400,1997,403,0.928843923933191,0.653061224489796,1.75515841695794,760,370,390,1,1.1,61.35,5,0,0,0,0,0,0,0.0101906458329802,7.59680057459442,1.03054575293976
8.7,"greedy_SVM","SVM",17,24,1412,1405,7,2500,2097,403,0.930854301948043,0.642857142857143,1.76702864632091,775,376,399,15,1.1,63.91,5.2,0,0,0,0,0,0,0.00649555933555558,4.35603673413155,0.815885764247488
8.7,"greedy_SVM","SVM",17,25,1312,1306,6,2600,2196,404,0.931083314007412,0.647959183673469,1.7702768607443,781,378,403,6,1.1,66.46,5.4,0,0,0,0,0,0,0.00615406628298164,3.91433413583603,0.640468410749718
8.7,"greedy_SVM","SVM",17,26,1212,1207,5,2700,2295,405,0.931794990723557,0.642857142857143,1.77781525833474,794,384,410,13,1.1,69.02,5.7,0,0,0,0,0,0,0.00458863239532098,2.72742753189992,0.515475060755783
8.7,"greedy_SVM","SVM",17,27,1112,1107,5,2800,2395,405,0.931945732838585,0.642857142857143,1.77618423516195,791,383,408,-3,1.1,71.57,5.9,0,0,0,0,0,0,0.0043117742486376,2.19589369641317,0.439905308361985
8.7,"greedy_SVM","SVM",17,28,1012,1007,5,2900,2495,405,0.931800788497214,0.642857142857143,1.77781525833474,796,388,408,5,1.1,74.13,6.2,0,0,0,0,0,0,0.00320489255483351,1.44380600689832,0.357745459120496
8.7,"greedy_SVM","SVM",17,29,912,908,4,3000,2594,406,0.932574791280146,0.637755102040816,1.77455620194916,797,389,408,1,1,76.69,6.4,0,0,0,0,0,0,0.00389184792153442,1.44376557719245,0.423360733273697
8.7,"greedy_SVM","SVM",17,30,812,808,4,3100,2694,406,0.932761769480518,0.637755102040816,1.77944927971188,803,393,410,6,1,79.24,6.6,0,0,0,0,0,0,0.00218920285261313,0.696557475461758,0.253939584508636
8.7,"greedy_SVM","SVM",17,31,712,708,4,3200,2794,406,0.932980635435991,0.637755102040816,1.77781525833474,803,393,410,0,1,81.8,6.9,0,0,0,0,0,0,0.00162123872854448,0.462787806261547,0.192304430767284
8.7,"greedy_SVM","SVM",17,32,612,609,3,3300,2893,407,0.933171961966603,0.637755102040816,1.77781525833474,805,394,411,2,1,84.36,7.1,0,0,0,0,0,0,0.0011540132093843,0.346342842632147,0.152953485254356
8.7,"greedy_SVM","SVM",17,33,512,509,3,3400,2993,407,0.933544468923931,0.637755102040816,1.77944927971188,805,395,410,0,1,86.91,7.4,0,0,0,0,0,0,0.000618260240926668,0.188514873342002,0.0872410372892439
8.7,"greedy_SVM","SVM",17,34,412,411,1,3500,3091,409,0.935162047773654,0.642857142857143,1.78272635020859,812,399,413,7,1,89.47,7.6,0,0,0,0,0,0,0.000582090081016696,0.167156184253128,0.0745648128934908
8.7,"greedy_SVM","SVM",17,35,312,312,0,3600,3190,410,0.935830241187383,0.642857142857143,1.785339824003,817,402,415,5,1,92.02,7.8,0,0,0,0,0,0,0.000330052724489402,0.0826121521358688,0.0424093905326303
8.7,"greedy_SVM","SVM",17,36,212,212,0,3700,3290,410,0.936410018552875,0.642857142857143,1.78370339886642,820,402,418,3,1,94.58,8,0,0,0,0,0,0,0.000210302362086426,0.0437414857581605,0.027962769564543
8.7,"greedy_SVM","SVM",17,37,112,112,0,3800,3390,410,0.937039076994433,0.647959183673469,1.78697925451172,824,404,420,4,1,97.14,8.3,0,0,0,0,0,0,8.815438704432e-05,0.0154838292169577,0.0145368730009592
8.7,"greedy_SVM","SVM",17,38,12,12,0,3900,3490,410,0.937317370129869,0.647959183673469,1.78697925451172,826,405,421,2,1,99.69,8.5,0,0,0,0,0,0,3.53604847374554e-05,0.000578929126752889,0.000578929126752889
8.7,"greedy_SVM","SVM",17,39,0,0,0,3912,3502,410,0.937357954545454,0.647959183673469,1.78697925451172,828,406,422,2,1,100,8.5,0,0,0,0,0,0,0,0,0
8.7,"greedy_SVM","SVM",18,0,3812,3418,394,100,89,11,0.905183484287965,0.577114427860697,1.74985622346981,28,11,17,0,1.5,2.56,8.1,0,0,0,0,0,0,0.6138522508259,407.531231802674,65.8651464313482
8.7,"greedy_SVM","SVM",18,1,3712,3394,318,200,113,87,0.900480503465589,0.562189054726368,1.72941920233089,88,47,41,60,0.9,5.11,1.3,0,0,0,0,0,0,0.614482180474294,268.411306250758,72.04106211402
8.7,"greedy_SVM","SVM",18,2,3612,3366,246,300,141,159,0.892707403155164,0.592039800995025,1.72045848107529,140,72,68,52,0.9,7.67,0.9,0,0,0,0,0,0,0.364180960605114,117.038983419977,50.6456671919104
8.7,"greedy_SVM","SVM",18,3,3512,3321,191,400,186,214,0.886343212711364,0.592039800995025,1.71307517710984,230,117,113,90,1,10.22,0.9,0,0,0,0,0,0,0.327029266469121,162.645589570426,44.8162662109989
8.7,"greedy_SVM","SVM",18,4,3412,3263,149,500,244,256,0.856550580431173,0.582089552238806,1.59207638279192,320,161,159,90,1,12.78,1,0,0,0,0,0,0,0.279021623073787,188.937149856766,36.9009844996084
8.7,"greedy_SVM","SVM",18,5,3312,3189,123,600,318,282,0.868609941744269,0.616915422885572,1.58915514172258,394,196,198,74,1,15.34,1.1,0,0,0,0,0,0,0.0848812413877894,60.8467972233292,13.0563088321554
8.7,"greedy_SVM","SVM",18,6,3212,3107,105,700,400,300,0.86483253249423,0.631840796019901,1.58750945732169,437,212,225,43,1.1,17.89,1.3,0,0,0,0,0,0,0.0595780658675018,57.8565722860169,8.56254107396352
8.7,"greedy_SVM","SVM",18,7,3112,3022,90,800,485,315,0.867517115278309,0.646766169154229,1.58750945732169,478,226,252,41,1.1,20.45,1.5,0,0,0,0,0,0,0.0580778223725056,75.7322755966034,7.14220877932654
8.7,"greedy_SVM","SVM",18,8,3012,2936,76,900,571,329,0.869844509645502,0.646766169154229,1.59955045708099,506,243,263,28,1.1,23.01,1.7,0,0,0,0,0,0,0.0601938933884364,87.0861201765282,9.05021003865625
8.7,"greedy_SVM","SVM",18,9,2912,2846,66,1000,661,339,0.88448639990929,0.63681592039801,1.62935094536517,538,260,278,32,1.1,25.56,1.9,0,0,0,0,0,0,0.041819934582397,55.186192623087,5.48195926789441
8.7,"greedy_SVM","SVM",18,10,2812,2757,55,1100,750,350,0.897693866848103,0.641791044776119,1.65926129720063,565,273,292,27,1.1,28.12,2.1,0,0,0,0,0,0,0.0432366548629586,62.707561618256,4.93591149039861
8.7,"greedy_SVM","SVM",18,11,2712,2663,49,1200,844,356,0.911218834601926,0.621890547263682,1.68306581169589,587,283,304,22,1.1,30.67,2.4,0,0,0,0,0,0,0.0390984498757461,52.6412874722993,4.52763187720523
8.7,"greedy_SVM","SVM",18,12,2612,2569,43,1300,938,362,0.914665986307773,0.621890547263682,1.69784685388485,612,295,317,25,1.1,33.23,2.6,0,0,0,0,0,0,0.0609953461242137,58.922809736013,7.29764603606227
8.7,"greedy_SVM","SVM",18,13,2512,2472,40,1400,1035,365,0.915675185326929,0.616915422885572,1.70835162423178,631,305,326,19,1.1,35.79,2.8,0,0,0,0,0,0,0.0530289824954553,46.4610705241261,5.93733525026982
8.7,"greedy_SVM","SVM",18,14,2412,2381,31,1500,1126,374,0.918827514847423,0.616915422885572,1.72941920233089,656,316,340,25,1.1,38.34,3,0,0,0,0,0,0,0.0569291802105103,40.3057086247811,6.26243579125546
8.7,"greedy_SVM","SVM",18,15,2312,2288,24,1600,1219,381,0.918121642499759,0.621890547263682,1.72941920233089,670,324,346,14,1.1,40.9,3.2,0,0,0,0,0,0,0.0579364520195711,37.7547885591025,6.51606201683374
8.7,"greedy_SVM","SVM",18,16,2212,2192,20,1700,1315,385,0.917906195518146,0.621890547263682,1.72941920233089,685,329,356,15,1.1,43.46,3.4,0,0,0,0,0,0,0.0489706030903332,33.4345347275097,5.69334075918789
8.7,"greedy_SVM","SVM",18,17,2112,2098,14,1800,1409,391,0.916896996498995,0.621890547263682,1.73101313707958,699,336,363,14,1.1,46.01,3.6,0,0,0,0,0,0,0.0377521399868714,28.5348911444106,4.57203152690029
8.7,"greedy_SVM","SVM",18,18,2012,2001,11,1900,1506,394,0.916049382716058,0.621890547263682,1.73101313707958,709,339,370,10,1.1,48.57,3.8,0,0,0,0,0,0,0.028137888398854,23.8955321828978,3.29368588590183
8.7,"greedy_SVM","SVM",18,19,1912,1903,9,2000,1604,396,0.916996215503683,0.621890547263682,1.73101313707958,715,344,371,6,1.1,51.12,4.1,0,0,0,0,0,0,0.0215034656165989,18.9552411980277,2.38680180379691
8.7,"greedy_SVM","SVM",18,20,1812,1803,9,2100,1704,396,0.917120947966724,0.621890547263682,1.73101313707958,720,347,373,5,1.1,53.68,4.3,0,0,0,0,0,0,0.0172637624283661,15.818391006227,1.89476598909231
8.7,"greedy_SVM","SVM",18,21,1712,1703,9,2200,1804,396,0.917064251392615,0.621890547263682,1.72782820030482,721,347,374,1,1.1,56.24,4.6,0,0,0,0,0,0,0.016288084438209,13.4562982476392,1.6414781233386
8.7,"greedy_SVM","SVM",18,22,1612,1605,7,2300,1902,398,0.921329251180011,0.601990049751244,1.75630136609769,749,365,384,28,1.1,58.79,4.8,0,0,0,0,0,0,0.0124263092806506,8.08077927287729,1.69715528800786
8.7,"greedy_SVM","SVM",18,23,1512,1507,5,2400,2000,400,0.921533358846805,0.606965174129353,1.75307287093942,753,366,387,4,1.1,61.35,5,0,0,0,0,0,0,0.0100587330370585,7.22037611444297,1.14872082729999
8.7,"greedy_SVM","SVM",18,24,1412,1408,4,2500,2099,401,0.921412878626823,0.611940298507463,1.7457331557484,761,366,395,8,1.1,63.91,5.2,0,0,0,0,0,0,0.00999960004786333,6.27792049727826,1.01055080028887
8.7,"greedy_SVM","SVM",18,25,1312,1308,4,2600,2199,401,0.921492253830573,0.601990049751244,1.75792007703418,765,374,391,4,1,66.46,5.5,0,0,0,0,0,0,0.00623401320381893,3.73096446609237,0.758525703914102
8.7,"greedy_SVM","SVM",18,26,1212,1208,4,2700,2299,401,0.921421383112936,0.601990049751244,1.75792007703418,765,374,391,0,1,69.02,5.7,0,0,0,0,0,0,0.00626167398070365,3.19632031682761,0.639265970333132
8.7,"greedy_SVM","SVM",18,27,1112,1108,4,2800,2399,401,0.921835268103932,0.592039800995025,1.75630136609769,774,378,396,9,1,71.57,6,0,0,0,0,0,0,0.00488645586524502,2.24939148084305,0.535911850885602
8.7,"greedy_SVM","SVM",18,28,1012,1008,4,2900,2499,401,0.922175447548586,0.597014925373134,1.75630136609769,777,379,398,3,1.1,74.13,6.2,0,0,0,0,0,0,0.0038736540327576,1.55265033273298,0.421921095363419
8.7,"greedy_SVM","SVM",18,29,912,908,4,3000,2599,401,0.922833127808252,0.601990049751244,1.75792007703418,781,382,399,4,1,76.69,6.5,0,0,0,0,0,0,0.00301977884262231,1.0978212446176,0.337769326263409
8.7,"greedy_SVM","SVM",18,30,812,808,4,3100,2699,401,0.922898328868478,0.601990049751244,1.75792007703418,779,382,397,-2,1,79.24,6.7,0,0,0,0,0,0,0.00214060817954136,0.685561390959685,0.243482869659266
8.7,"greedy_SVM","SVM",18,31,712,708,4,3200,2799,401,0.922915337840713,0.597014925373134,1.75792007703418,779,382,397,0,1,81.8,7,0,0,0,0,0,0,0.0016239008221604,0.489536684605445,0.200563760998529
8.7,"greedy_SVM","SVM",18,32,612,609,3,3300,2898,402,0.923244177970548,0.592039800995025,1.75630136609769,783,383,400,4,1,84.36,7.2,0,0,0,0,0,0,0.00106585970858314,0.322617133104568,0.140263335701465
8.7,"greedy_SVM","SVM",18,33,512,510,2,3400,2997,403,0.924015251378435,0.597014925373134,1.75792007703418,785,385,400,2,1,86.91,7.4,0,0,0,0,0,0,0.000643156156314679,0.208725677550567,0.0895336635103001
8.7,"greedy_SVM","SVM",18,34,412,411,1,3500,3096,404,0.924324247707336,0.597014925373134,1.75792007703418,790,387,403,5,1,89.47,7.7,0,0,0,0,0,0,0.000464386010875395,0.132464639487549,0.0579067408572726
8.7,"greedy_SVM","SVM",18,35,312,312,0,3600,3195,405,0.924946492608187,0.592039800995025,1.75630136609769,796,389,407,6,1,92.02,7.9,0,0,0,0,0,0,0.000453023414116491,0.112759204242521,0.0563712875460494
8.7,"greedy_SVM","SVM",18,36,212,212,0,3700,3295,405,0.925322107411661,0.592039800995025,1.75630136609769,798,391,407,2,1,94.58,8.1,0,0,0,0,0,0,0.000232894950500558,0.047370700912852,0.0301899480363567
8.7,"greedy_SVM","SVM",18,37,112,112,0,3800,3395,405,0.925582911652565,0.582089552238806,1.75630136609769,805,394,411,7,1,97.14,8.4,0,0,0,0,0,0,7.52504766358319e-05,0.0136295091332884,0.0128769092522138
8.7,"greedy_SVM","SVM",18,38,12,12,0,3900,3495,405,0.926076171847321,0.592039800995025,1.75792007703418,810,397,413,5,1,99.69,8.6,0,0,0,0,0,0,5.6666261103899e-05,0.000775563953348068,0.000775563953348068
8.7,"greedy_SVM","SVM",18,39,0,0,0,3912,3507,405,0.926081841504732,0.592039800995025,1.75792007703418,810,397,413,0,1,100,8.7,0,0,0,0,0,0,0,0,0
8.7,"greedy_SVM","SVM",19,0,3812,3396,416,100,94,6,0.817523800176664,0.451086956521739,1.61660989781607,21,6,15,0,2.5,2.56,15.7,0,0,0,0,0,0,0.163894700627114,253.31235034679,18.7508529398677
8.7,"greedy_SVM","SVM",19,1,3712,3369,343,200,121,79,0.896432427127295,0.521739130434783,1.75216190247418,74,36,38,53,1.1,5.11,1.5,0,0,0,0,0,0,0.752436359139501,338.405403459391,84.9451038785631
8.7,"greedy_SVM","SVM",19,2,3612,3341,271,300,149,151,0.894107616056536,0.53804347826087,1.71805006587615,126,66,60,52,0.9,7.67,1,0,0,0,0,0,0,0.427988982675727,178.975858910443,55.8757658852521
8.7,"greedy_SVM","SVM",19,3,3512,3280,232,400,210,190,0.887764991657664,0.570652173913043,1.69499098377079,222,113,109,96,1,10.22,1.1,0,0,0,0,0,0,0.270594505684021,89.97555618474,45.9182075981456
8.7,"greedy_SVM","SVM",19,4,3412,3235,177,500,255,245,0.895823621061923,0.58695652173913,1.71300744655297,304,153,151,82,1,12.78,1,0,0,0,0,0,0,0.141978151906706,67.7944754585317,24.444755870206
8.7,"greedy_SVM","SVM",19,5,3312,3159,153,600,331,269,0.892911473157326,0.592391304347826,1.70478861951513,364,177,187,60,1.1,15.34,1.2,0,0,0,0,0,0,0.0855445868475358,39.7893377236342,11.1143954637564
8.7,"greedy_SVM","SVM",19,6,3212,3080,132,700,410,290,0.889881244479338,0.614130434782609,1.68519334802645,411,201,210,47,1,17.89,1.4,0,0,0,0,0,0,0.0570217279357939,42.2660467315768,8.19948248107013
8.7,"greedy_SVM","SVM",19,7,3112,3004,108,800,486,314,0.903925188929233,0.630434782608696,1.68519334802645,458,225,233,47,1,20.45,1.5,0,0,0,0,0,0,0.063610995878745,79.1282087894187,10.4946957754755
8.7,"greedy_SVM","SVM",19,8,3012,2937,75,900,553,347,0.896101187555214,0.652173913043478,1.651234814578,537,258,279,79,1.1,23.01,1.6,0,0,0,0,0,0,0.112158204756842,166.923190604048,17.6998400100613
8.7,"greedy_SVM","SVM",19,9,2912,2851,61,1000,639,361,0.899468789871426,0.630434782608696,1.67900347346988,582,280,302,45,1.1,25.56,1.8,0,0,0,0,0,0,0.0748113588214752,106.662915614431,9.97037022093043
8.7,"greedy_SVM","SVM",19,10,2812,2758,54,1100,732,368,0.902063499852785,0.619565217391304,1.68876512157145,608,290,318,26,1.1,28.12,2,0,0,0,0,0,0,0.0531020531887938,73.246769155726,6.081663873301
8.7,"greedy_SVM","SVM",19,11,2712,2665,47,1200,825,375,0.902811855923051,0.630434782608696,1.691872325107,620,298,322,12,1.1,30.67,2.2,0,0,0,0,0,0,0.0488906721833108,65.9632200391924,5.11619732169161
8.7,"greedy_SVM","SVM",19,12,2612,2569,43,1300,921,379,0.916243927274516,0.614130434782609,1.71962915601023,651,317,334,31,1.1,33.23,2.4,0,0,0,0,0,0,0.0426981355279492,38.1573542060157,5.13622830538441
8.7,"greedy_SVM","SVM",19,13,2512,2474,38,1400,1016,384,0.920832208754542,0.614130434782609,1.73597925807738,657,322,335,6,1,35.79,2.6,0,0,0,0,0,0,0.0341971020482945,36.6200645477889,3.98113913532958
8.7,"greedy_SVM","SVM",19,14,2412,2380,32,1500,1110,390,0.925914282559606,0.614130434782609,1.74894101662404,680,331,349,23,1.1,38.34,2.8,0,0,0,0,0,0,0.0506533769265553,41.0952291298204,6.37348543224092
8.7,"greedy_SVM","SVM",19,15,2312,2283,29,1600,1207,393,0.927259176562946,0.608695652173913,1.77010919563217,691,338,353,11,1,40.9,3.1,0,0,0,0,0,0,0.0417370761309242,32.3529281266458,4.89638025141869
8.7,"greedy_SVM","SVM",19,16,2212,2187,25,1700,1303,397,0.927081288644606,0.614130434782609,1.77010919563217,711,343,368,20,1.1,43.46,3.3,0,0,0,0,0,0,0.0403900229660929,27.8899495628035,4.57552121132805
8.7,"greedy_SVM","SVM",19,17,2112,2091,21,1800,1399,401,0.926613566100686,0.614130434782609,1.76848225703325,720,347,373,9,1.1,46.01,3.5,0,0,0,0,0,0,0.0347623444598251,23.7998613475057,4.07040828663069
8.7,"greedy_SVM","SVM",19,18,2012,1996,16,1900,1494,406,0.925704190793987,0.608695652173913,1.77010919563217,723,351,372,3,1.1,48.57,3.7,0,0,0,0,0,0,0.0265426771735175,20.6277696811398,3.61182553740718
8.7,"greedy_SVM","SVM",19,19,1912,1900,12,2000,1590,410,0.926128974874858,0.603260869565217,1.76848225703325,743,357,386,20,1.1,51.12,3.9,0,0,0,0,0,0,0.0189438328682376,17.7715473400481,2.37355604138077
8.7,"greedy_SVM","SVM",19,20,1812,1800,12,2100,1690,410,0.925932684758065,0.603260869565217,1.77173913043478,744,357,387,1,1.1,53.68,4.1,0,0,0,0,0,0,0.0161780056459739,14.1913835956439,1.64639903128688
8.7,"greedy_SVM","SVM",19,21,1712,1702,10,2200,1788,412,0.924308690744923,0.603260869565217,1.77173913043478,780,372,408,36,1.1,56.24,4.3,0,0,0,0,0,0,0.0121995017437946,9.47227315002123,1.50727955743282
8.7,"greedy_SVM","SVM",19,22,1612,1604,8,2300,1886,414,0.92442523800177,0.603260869565217,1.77173913043478,780,374,406,0,1.1,58.79,4.6,0,0,0,0,0,0,0.0111224807369417,9.00649267353977,1.18649510211772
8.7,"greedy_SVM","SVM",19,23,1512,1504,8,2400,1986,414,0.924327092943375,0.608695652173913,1.77337206972551,778,377,401,-2,1.1,61.35,4.8,0,0,0,0,0,0,0.00883840338611003,6.58124291418194,0.934171203560109
8.7,"greedy_SVM","SVM",19,24,1412,1405,7,2500,2085,415,0.924977303955249,0.608695652173913,1.76848225703325,785,382,403,7,1.1,63.91,5,0,0,0,0,0,0,0.00757517466375151,5.16105868473294,0.80244201929627
8.7,"greedy_SVM","SVM",19,25,1312,1306,6,2600,2184,416,0.92523493473354,0.608695652173913,1.76848225703325,787,384,403,2,1,66.46,5.2,0,0,0,0,0,0,0.00727152027204477,4.6106360704278,0.766972226916224
8.7,"greedy_SVM","SVM",19,26,1212,1206,6,2700,2284,416,0.925549305623715,0.608695652173913,1.76523733546071,789,385,404,2,1,69.02,5.5,0,0,0,0,0,0,0.00573833188100099,3.24813913694026,0.602293665351125
8.7,"greedy_SVM","SVM",19,27,1112,1107,5,2800,2383,417,0.925969489154975,0.603260869565217,1.77173913043478,793,389,404,4,1,71.57,5.7,0,0,0,0,0,0,0.00526152984020163,2.67007314939256,0.547621510112975
8.7,"greedy_SVM","SVM",19,28,1012,1008,4,2900,2482,418,0.926613566100699,0.603260869565217,1.76848225703325,804,394,410,11,1,74.13,5.9,0,0,0,0,0,0,0.00484172817406655,2.2365577335854,0.517343282460268
8.7,"greedy_SVM","SVM",19,29,912,908,4,3000,2582,418,0.926920269408186,0.603260869565217,1.76848225703325,804,394,410,0,1,76.69,6.2,0,0,0,0,0,0,0.00386986796606663,1.60135712251259,0.422783431902168
8.7,"greedy_SVM","SVM",19,30,812,809,3,3100,2681,419,0.927069020512318,0.592391304347826,1.77010919563217,808,396,412,4,1,79.24,6.4,0,0,0,0,0,0,0.00352932569395898,1.33935372449721,0.388167129259567
8.7,"greedy_SVM","SVM",19,31,712,709,3,3200,2781,419,0.927262243596037,0.592391304347826,1.77010919563217,805,396,409,-3,1,81.8,6.6,0,0,0,0,0,0,0.00236945071668945,0.821639535426855,0.273652931747909
8.7,"greedy_SVM","SVM",19,32,612,609,3,3300,2881,419,0.9272361738149,0.592391304347826,1.76848225703325,804,396,408,-1,1,84.36,6.9,0,0,0,0,0,0,0.00170965041503048,0.579232840567891,0.207554041564551
8.7,"greedy_SVM","SVM",19,33,512,510,2,3400,2980,420,0.927587349101982,0.592391304347826,1.76848225703325,811,398,413,7,1,86.91,7.1,0,0,0,0,0,0,0.001353620809681,0.446822048854359,0.161730659486612
8.7,"greedy_SVM","SVM",19,34,412,411,1,3500,3079,421,0.928366375503007,0.592391304347826,1.77010919563217,815,399,416,4,1,89.47,7.3,0,0,0,0,0,0,0.00114806646164561,0.352603057730162,0.13593385431563
8.7,"greedy_SVM","SVM",19,35,312,312,0,3600,3178,422,0.930540901953098,0.597826086956522,1.77661995448557,820,404,416,5,1,92.02,7.5,0,0,0,0,0,0,0.00099059847936427,0.250856987212982,0.11735339195094
8.7,"greedy_SVM","SVM",19,36,212,212,0,3700,3278,422,0.930612977230361,0.597826086956522,1.78152774441509,823,404,419,3,1,94.58,7.8,0,0,0,0,0,0,0.000546007502536563,0.115285921924126,0.0705304572700494
8.7,"greedy_SVM","SVM",19,37,112,112,0,3800,3378,422,0.930686586024159,0.597826086956522,1.77825287723785,831,405,426,8,1.1,97.14,8,0,0,0,0,0,0,0.00037504229756761,0.0569387034653617,0.0528418455812329
8.7,"greedy_SVM","SVM",19,38,12,12,0,3900,3478,422,0.931178844832685,0.58695652173913,1.78316970546985,829,405,424,-2,1,99.69,8.2,0,0,0,0,0,0,0.000242159117979958,0.00365594983973575,0.00365594983973575
8.7,"greedy_SVM","SVM",19,39,0,0,0,3912,3490,422,0.931209515163435,0.58695652173913,1.78152774441509,829,405,424,0,1,100,8.3,0,0,0,0,0,0,0,0,0
8.7,"greedy_SVM","SVM",20,0,3812,3410,402,100,86,14,0.89801215950409,0.589473684210526,1.72526897353882,32,14,18,0,1.3,2.56,6.1,0,0,0,0,0,0,0.787886458988797,473.946215214795,86.4329500119651
8.7,"greedy_SVM","SVM",20,1,3712,3377,335,200,119,81,0.908502712046261,0.589473684210526,1.76156490582482,105,51,54,73,1.1,5.11,1.5,0,0,0,0,0,0,0.764710334837748,369.54787685677,82.2147142640238
8.7,"greedy_SVM","SVM",20,2,3612,3343,269,300,153,147,0.90226500566251,0.631578947368421,1.71106278091924,174,90,84,69,0.9,7.67,1,0,0,0,0,0,0,0.521843070851822,221.967127497728,64.1449337431046
8.7,"greedy_SVM","SVM",20,3,3512,3311,201,400,185,215,0.893391249925506,0.647368421052632,1.65891247455656,246,127,119,72,0.9,10.22,0.9,0,0,0,0,0,0,0.308096048209439,158.787371550556,46.2576864665517
8.7,"greedy_SVM","SVM",20,4,3412,3260,152,500,236,264,0.893202002741849,0.652631578947368,1.67787147426577,342,176,166,96,0.9,12.78,0.9,0,0,0,0,0,0,0.261339429406017,145.135701542983,36.9874299038049
8.7,"greedy_SVM","SVM",20,5,3312,3187,125,600,309,291,0.880151397746906,0.673684210526316,1.60707554008989,415,207,208,73,1,15.34,1.1,0,0,0,0,0,0,0.161060894259721,147.208896355737,22.9163684692703
8.7,"greedy_SVM","SVM",20,6,3212,3109,103,700,387,313,0.885921201645113,0.673684210526316,1.62449058425881,478,229,249,63,1.1,17.89,1.2,0,0,0,0,0,0,0.0964582770553722,96.6810988231285,12.648765429236
8.7,"greedy_SVM","SVM",20,7,3112,3027,85,800,469,331,0.889604816117303,0.673684210526316,1.63844477799835,518,248,270,40,1.1,20.45,1.4,0,0,0,0,0,0,0.0788334684379662,108.456415306879,10.9247503581784
8.7,"greedy_SVM","SVM",20,8,3012,2942,70,900,554,346,0.890945937891172,0.673684210526316,1.63543569667972,552,265,287,34,1.1,23.01,1.6,0,0,0,0,0,0,0.0610391700520991,93.1230476300256,6.94462895346903
8.7,"greedy_SVM","SVM",20,9,2912,2852,60,1000,644,356,0.899243011265431,0.673684210526316,1.64943297470195,584,277,307,32,1.1,25.56,1.8,0,0,0,0,0,0,0.0603867981210897,87.8366429741766,6.59470594084011
8.7,"greedy_SVM","SVM",20,10,2812,2758,54,1100,738,362,0.908109316325924,0.673684210526316,1.66044142614601,594,284,310,10,1.1,28.12,2,0,0,0,0,0,0,0.0535593507137562,79.5376827541523,5.94509763082024
8.7,"greedy_SVM","SVM",20,11,2712,2665,47,1200,831,369,0.917312391965188,0.673684210526316,1.69683047397499,617,298,319,23,1.1,30.67,2.3,0,0,0,0,0,0,0.0539283627359284,85.3579185975563,6.42005158102053
8.7,"greedy_SVM","SVM",20,12,2612,2575,37,1300,921,379,0.924549979138111,0.663157894736842,1.70004828585225,654,314,340,37,1.1,33.23,2.4,0,0,0,0,0,0,0.0608929448002463,73.9489315087588,7.01017512980977
8.7,"greedy_SVM","SVM",20,13,2512,2480,32,1400,1016,384,0.928799845025949,0.652631578947368,1.72838242394978,675,322,353,21,1.1,35.79,2.6,0,0,0,0,0,0,0.0609779794905635,65.011747293193,6.69935822898731
8.7,"greedy_SVM","SVM",20,14,2412,2382,30,1500,1114,386,0.930064969899287,0.647368421052632,1.74102167182663,678,325,353,3,1.1,38.34,2.9,0,0,0,0,0,0,0.0518202101179603,52.7907252520538,5.60503387627884
8.7,"greedy_SVM","SVM",20,15,2312,2285,27,1600,1211,389,0.930467306431438,0.647368421052632,1.75209412676125,691,330,361,13,1.1,40.9,3.1,0,0,0,0,0,0,0.046844822643421,44.9576223452438,5.28968742129152
8.7,"greedy_SVM","SVM",20,16,2212,2192,20,1700,1304,396,0.929632830661036,0.647368421052632,1.75370747310265,709,337,372,18,1.1,43.46,3.3,0,0,0,0,0,0,0.0446885995862855,40.1695298130888,5.24877631844287
8.7,"greedy_SVM","SVM",20,17,2112,2100,12,1800,1396,404,0.928995052750808,0.642105263157895,1.74262334769767,728,346,382,19,1.1,46.01,3.5,0,0,0,0,0,0,0.040824251784004,39.3959993545483,4.98134174459436
8.7,"greedy_SVM","SVM",20,18,2012,2003,9,1900,1493,407,0.928768552184555,0.647368421052632,1.74102167182663,736,350,386,8,1.1,48.57,3.7,0,0,0,0,0,0,0.0347749146934405,34.5135677071854,3.82128186598049
8.7,"greedy_SVM","SVM",20,19,1912,1903,9,2000,1593,407,0.928986111938982,0.647368421052632,1.74102167182663,740,352,388,4,1.1,51.12,3.9,0,0,0,0,0,0,0.0271220772480148,27.3080188360522,2.901783806707
8.7,"greedy_SVM","SVM",20,20,1812,1803,9,2100,1693,407,0.929136615604711,0.652631578947368,1.75370747310265,743,355,388,3,1.1,53.68,4.2,0,0,0,0,0,0,0.0236620271625145,22.7546650980438,2.45350371122965
8.7,"greedy_SVM","SVM",20,21,1712,1704,8,2200,1792,408,0.928574834594989,0.642105263157895,1.76481203007519,756,365,391,13,1.1,56.24,4.4,0,0,0,0,0,0,0.016615446485374,14.5750405434103,1.97868632180402
8.7,"greedy_SVM","SVM",20,22,1612,1605,7,2300,1891,409,0.929474876318784,0.642105263157895,1.76318697295726,761,366,395,5,1.1,58.79,4.6,0,0,0,0,0,0,0.0145834547973752,12.2571171942933,1.49974171446382
8.7,"greedy_SVM","SVM",20,23,1512,1505,7,2400,1991,409,0.929921916910072,0.626315789473684,1.77103568488839,774,374,400,13,1.1,61.35,4.9,0,0,0,0,0,0,0.0104865838055496,7.73151101404311,1.2858642634675
8.7,"greedy_SVM","SVM",20,24,1412,1408,4,2500,2088,412,0.929740120402948,0.636842105263158,1.77430026679602,779,378,401,5,1.1,63.91,5.1,0,0,0,0,0,0,0.00958418364774602,6.93468786611737,0.995986812404237
8.7,"greedy_SVM","SVM",20,25,1312,1308,4,2600,2188,412,0.930091792334759,0.626315789473684,1.77430026679602,784,381,403,5,1.1,66.46,5.3,0,0,0,0,0,0,0.00779320528050093,5.13841014929368,0.879664177137823
8.7,"greedy_SVM","SVM",20,26,1212,1208,4,2700,2288,412,0.929947249210243,0.631578947368421,1.77266647281186,783,380,403,-1,1.1,69.02,5.6,0,0,0,0,0,0,0.00681883484005147,3.95149987869692,0.692879949659199
8.7,"greedy_SVM","SVM",20,27,1112,1108,4,2800,2388,412,0.930514990761173,0.626315789473684,1.77266647281186,788,386,402,5,1,71.57,5.8,0,0,0,0,0,0,0.00611555995312896,3.28532273393727,0.69220592763012
8.7,"greedy_SVM","SVM",20,28,1012,1009,3,2900,2487,413,0.93058353698517,0.626315789473684,1.77266647281186,792,387,405,4,1,74.13,6,0,0,0,0,0,0,0.00565351991017998,2.56818737615815,0.578289899480415
8.7,"greedy_SVM","SVM",20,29,912,909,3,3000,2587,413,0.930967991893676,0.621052631578947,1.77266647281186,797,388,409,5,1.1,76.69,6.3,0,0,0,0,0,0,0.00421862355541103,1.68250594047034,0.466391187773779
8.7,"greedy_SVM","SVM",20,30,812,809,3,3100,2687,413,0.930950110270024,0.621052631578947,1.77266647281186,797,387,410,0,1.1,79.24,6.5,0,0,0,0,0,0,0.00381606604451463,1.31892032816437,0.423381214115239
8.7,"greedy_SVM","SVM",20,31,712,710,2,3200,2786,414,0.931337545449139,0.621052631578947,1.77430026679602,800,390,410,3,1.1,81.8,6.7,0,0,0,0,0,0,0.00300099603786876,0.932381633818492,0.341715142370808
8.7,"greedy_SVM","SVM",20,32,612,612,0,3300,2884,416,0.932031948500936,0.626315789473684,1.77103568488839,809,393,416,9,1.1,84.36,6.9,0,0,0,0,0,0,0.002232924494171,0.707583112494311,0.276774396920643
8.7,"greedy_SVM","SVM",20,33,512,512,0,3400,2984,416,0.932183942301972,0.626315789473684,1.77430026679602,812,394,418,3,1.1,86.91,7.2,0,0,0,0,0,0,0.00126446834513654,0.404418636196325,0.1669061345345
8.7,"greedy_SVM","SVM",20,34,412,412,0,3500,3084,416,0.932189902843188,0.621052631578947,1.77430026679602,814,396,418,2,1.1,89.47,7.4,0,0,0,0,0,0,0.000767280592119977,0.225666846956767,0.0964636813056638
8.7,"greedy_SVM","SVM",20,35,312,312,0,3600,3184,416,0.931918698217807,0.626315789473684,1.77430026679602,816,398,418,2,1.1,92.02,7.7,0,0,0,0,0,0,0.000527211148614262,0.133565008437791,0.0662127536699913
8.7,"greedy_SVM","SVM",20,36,212,212,0,3700,3284,416,0.932033438636235,0.621052631578947,1.77266647281186,817,401,416,1,1,94.58,7.9,0,0,0,0,0,0,0.00027418684929159,0.0576289384735786,0.0362576907643539
8.7,"greedy_SVM","SVM",20,37,112,112,0,3800,3384,416,0.932550515586815,0.621052631578947,1.77103568488839,822,405,417,5,1,97.14,8.1,0,0,0,0,0,0,0.000125158225923013,0.0212638045033554,0.0198877636806258
8.7,"greedy_SVM","SVM",20,38,12,12,0,3900,3484,416,0.932946891577754,0.621052631578947,1.77103568488839,823,404,419,1,1,99.69,8.4,0,0,0,0,0,0,0.000102259424502872,0.00145721900496923,0.00145721900496923
8.7,"greedy_SVM","SVM",20,39,0,0,0,3912,3496,416,0.932890266436191,0.621052631578947,1.77103568488839,824,404,420,1,1,100,8.4,0,0,0,0,0,0,0,0,0
8.7,"greedy_SVM","SVM",21,0,3812,3418,394,100,87,13,0.88999636772365,0.517587939698492,1.7302920130607,30,13,17,0,1.3,2.56,6.7,0,0,0,0,0,0,0.392420183688337,426.693800661515,42.8765365072936
8.7,"greedy_SVM","SVM",21,1,3712,3374,338,200,131,69,0.886717308797823,0.542713567839196,1.69841856340526,122,61,61,92,1,5.11,1.9,0,0,0,0,0,0,0.576828218967737,381.808791101336,67.453994051783
8.7,"greedy_SVM","SVM",21,2,3612,3324,288,300,181,119,0.922967140769297,0.587939698492462,1.78711740520786,213,107,106,91,1,7.67,1.5,0,0,0,0,0,0,0.468509390487247,356.687559182855,55.6873354396928
8.7,"greedy_SVM","SVM",21,3,3512,3298,214,400,207,193,0.913900750193765,0.597989949748744,1.73774952108609,266,133,133,53,1,10.22,1.1,0,0,0,0,0,0,0.422917670928849,305.43913218929,56.3211280027709
8.7,"greedy_SVM","SVM",21,4,3412,3251,161,500,254,246,0.909087269014389,0.597989949748744,1.74198817780362,339,171,168,73,1,12.78,1,0,0,0,0,0,0,0.255911335330385,174.455976698538,33.1804516709255
8.7,"greedy_SVM","SVM",21,5,3312,3179,133,600,326,274,0.899589009360971,0.628140703517588,1.70275760102069,404,201,203,65,1,15.34,1.2,0,0,0,0,0,0,0.125597875983912,100.517389674208,17.4101499437026
8.7,"greedy_SVM","SVM",21,6,3212,3108,104,700,397,303,0.883110772988435,0.658291457286432,1.62914017601821,467,228,239,63,1,17.89,1.3,0,0,0,0,0,0,0.155456883372342,181.423534982108,23.4002869152207
8.7,"greedy_SVM","SVM",21,7,3112,3027,85,800,478,322,0.882717514722154,0.663316582914573,1.61711129175288,509,249,260,42,1,20.45,1.5,0,0,0,0,0,0,0.112803250547867,179.395120275927,15.3634260626968
8.7,"greedy_SVM","SVM",21,8,3012,2944,68,900,561,339,0.883669914741595,0.673366834170854,1.62008939726256,559,268,291,50,1.1,23.01,1.7,0,0,0,0,0,0,0.0896206212272615,146.93498664807,10.8579003269241
8.7,"greedy_SVM","SVM",21,9,2912,2848,64,1000,657,343,0.887420883586955,0.683417085427136,1.61711129175288,574,277,297,15,1.1,25.56,1.9,0,0,0,0,0,0,0.0595600078750791,90.4462607123909,6.56923422679482
8.7,"greedy_SVM","SVM",21,10,2812,2753,59,1100,752,348,0.892710564776048,0.678391959798995,1.63668387937849,589,283,306,15,1.1,28.12,2.2,0,0,0,0,0,0,0.0510964119595998,76.3697831553417,5.55579638841836
8.7,"greedy_SVM","SVM",21,11,2712,2659,53,1200,846,354,0.911566941137103,0.668341708542714,1.68499641062455,613,296,317,24,1.1,30.67,2.4,0,0,0,0,0,0,0.043915768810908,55.3989562602966,5.24898736473893
8.7,"greedy_SVM","SVM",21,12,2612,2569,43,1300,936,364,0.919409225981917,0.663316582914573,1.71217377208624,645,310,335,32,1.1,33.23,2.6,0,0,0,0,0,0,0.0636262349224198,76.8778494655747,6.91153152357452
8.7,"greedy_SVM","SVM",21,13,2512,2471,41,1400,1034,366,0.923822298744706,0.658291457286432,1.72077619997329,656,317,339,11,1.1,35.79,2.8,0,0,0,0,0,0,0.0515351263603939,55.2600417126617,5.51634186107685
8.7,"greedy_SVM","SVM",21,14,2412,2381,31,1500,1124,376,0.926194718612964,0.653266331658292,1.7345551285841,687,329,358,31,1.1,38.34,3,0,0,0,0,0,0,0.0716526040294176,53.2761640673026,8.01819737756498
8.7,"greedy_SVM","SVM",21,15,2312,2285,27,1600,1220,380,0.925541194875895,0.653266331658292,1.73615085547332,701,335,366,14,1.1,40.9,3.2,0,0,0,0,0,0,0.0607471113500338,39.8754230920671,6.51374288533844
8.7,"greedy_SVM","SVM",21,16,2212,2192,20,1700,1313,387,0.925352430908077,0.653266331658292,1.73615085547332,717,346,371,16,1.1,43.46,3.4,0,0,0,0,0,0,0.0580442669132964,36.9718938936361,6.64070374593682
8.7,"greedy_SVM","SVM",21,17,2112,2097,15,1800,1408,392,0.924974902972438,0.653266331658292,1.73774952108609,734,351,383,17,1.1,46.01,3.6,0,0,0,0,0,0,0.0402847513655186,30.683038851786,5.33978981527537
8.7,"greedy_SVM","SVM",21,18,2012,1999,13,1900,1506,394,0.924757538403435,0.653266331658292,1.73296233232277,737,353,384,3,1.1,48.57,3.8,0,0,0,0,0,0,0.0283414166915271,25.2801854522525,3.36749340546756
8.7,"greedy_SVM","SVM",21,19,1912,1902,10,2000,1603,397,0.925385321599441,0.653266331658292,1.73137245862339,742,356,386,5,1.1,51.12,4,0,0,0,0,0,0,0.023385283471135,21.5381016953735,2.56619210049337
8.7,"greedy_SVM","SVM",21,20,1812,1804,8,2100,1701,399,0.926005954645145,0.658291457286432,1.7345551285841,749,358,391,7,1.1,53.68,4.3,0,0,0,0,0,0,0.0186529550036463,17.2093925624075,2.00129525994442
8.7,"greedy_SVM","SVM",21,21,1712,1705,7,2200,1800,400,0.926989815325899,0.663316582914573,1.7345551285841,754,359,395,5,1.1,56.24,4.5,0,0,0,0,0,0,0.0177632110131049,15.4736262151815,1.80802618217681
8.7,"greedy_SVM","SVM",21,22,1612,1605,7,2300,1900,400,0.928226791327145,0.658291457286432,1.74519330784558,766,370,396,12,1.1,58.79,4.8,0,0,0,0,0,0,0.0112254678144578,8.1317768532156,1.37331251394001
8.7,"greedy_SVM","SVM",21,23,1512,1506,6,2400,1999,401,0.928595739082427,0.658291457286432,1.75585107859741,771,372,399,5,1.1,61.35,5,0,0,0,0,0,0,0.0102363545860527,7.82913973418003,1.12543397612578
8.7,"greedy_SVM","SVM",21,24,1412,1406,6,2500,2099,401,0.928704421366929,0.658291457286432,1.75423576021783,774,371,403,3,1.1,63.91,5.2,0,0,0,0,0,0,0.0101849746076236,7.05770286968487,1.02925704051174
8.7,"greedy_SVM","SVM",21,25,1312,1306,6,2600,2199,401,0.929523828590878,0.648241206030151,1.75585107859741,782,377,405,8,1.1,66.46,5.5,0,0,0,0,0,0,0.00697197274060087,4.30358170258231,0.806613649061618
8.7,"greedy_SVM","SVM",21,26,1212,1207,5,2700,2298,402,0.929320764322467,0.648241206030151,1.75585107859741,782,378,404,0,1.1,69.02,5.7,0,0,0,0,0,0,0.00608168148018896,3.58396160246228,0.651993781422871
8.7,"greedy_SVM","SVM",21,27,1112,1109,3,2800,2396,404,0.929113409963878,0.648241206030151,1.75101402328447,788,383,405,6,1.1,71.57,5.9,0,0,0,0,0,0,0.00645298332270953,3.1395334405018,0.663623099677881
8.7,"greedy_SVM","SVM",21,28,1012,1009,3,2900,2496,404,0.929605340304248,0.648241206030151,1.75423576021783,795,385,410,7,1.1,74.13,6.2,0,0,0,0,0,0,0.00441703169240121,1.93588403435295,0.500778924491045
8.7,"greedy_SVM","SVM",21,29,912,909,3,3000,2596,404,0.929528118681052,0.64321608040201,1.75101402328447,796,385,411,1,1.1,76.69,6.4,0,0,0,0,0,0,0.00386757833800377,1.40062291233945,0.402226651988595
8.7,"greedy_SVM","SVM",21,30,812,809,3,3100,2696,404,0.930300334913038,0.638190954773869,1.75262341117351,799,386,413,3,1.1,79.24,6.7,0,0,0,0,0,0,0.00358484242696222,1.1110232586005,0.395962576262551
8.7,"greedy_SVM","SVM",21,31,712,709,3,3200,2796,404,0.930286034612446,0.638190954773869,1.76165755246822,800,388,412,1,1.1,81.8,6.9,0,0,0,0,0,0,0.00217737910167458,0.635826258459138,0.271999227536798
8.7,"greedy_SVM","SVM",21,32,612,609,3,3300,2896,404,0.930471938520146,0.633165829145729,1.76003986876531,803,388,415,3,1.1,84.36,7.2,0,0,0,0,0,0,0.00117742758864715,0.360137331516267,0.161962904832243
8.7,"greedy_SVM","SVM",21,33,512,509,3,3400,2996,404,0.931081131325378,0.633165829145729,1.76327821259009,802,389,413,-1,1.1,86.91,7.4,0,0,0,0,0,0,0.000602139696127804,0.176406392413441,0.0848556820453108
8.7,"greedy_SVM","SVM",21,34,412,411,1,3500,3094,406,0.932318107326599,0.633165829145729,1.76165755246822,807,394,413,5,1,89.47,7.6,0,0,0,0,0,0,0.000633396090763057,0.190722717943026,0.0872854834196487
8.7,"greedy_SVM","SVM",21,35,312,312,0,3600,3193,407,0.932888689320232,0.633165829145729,1.75681339787849,812,397,415,5,1,92.02,7.8,0,0,0,0,0,0,0.000553056302462613,0.136233579685044,0.068636854971704
8.7,"greedy_SVM","SVM",21,36,212,212,0,3700,3293,407,0.933509322365944,0.628140703517588,1.76003986876531,814,398,416,2,1,94.58,8.1,0,0,0,0,0,0,0.000286319539088726,0.0588103830047786,0.036855415692375
8.7,"greedy_SVM","SVM",21,37,112,112,0,3800,3393,407,0.933996962616148,0.633165829145729,1.75842515328938,815,400,415,1,1,97.14,8.3,0,0,0,0,0,0,0.000113348539443457,0.0202642956006062,0.0190697013723674
8.7,"greedy_SVM","SVM",21,38,12,12,0,3900,3493,407,0.93433301968007,0.628140703517588,1.76906571424616,820,401,419,5,1,99.69,8.6,0,0,0,0,0,0,8.29623495964777e-05,0.00115275852462265,0.00115275852462265
8.7,"greedy_SVM","SVM",21,39,0,0,0,3912,3505,407,0.934350180040781,0.628140703517588,1.76744271817805,822,401,421,2,1,100,8.6,0,0,0,0,0,0,0,0,0
8.7,"greedy_SVM","SVM",22,0,3812,3413,399,100,92,8,0.845322228673242,0.412060301507538,1.65781904916286,31,8,23,0,2.9,2.56,11.5,0,0,0,0,0,0,0.171624429982717,328.657608016088,20.2736806113329
8.7,"greedy_SVM","SVM",22,1,3712,3346,366,200,159,41,0.873682584807925,0.522613065326633,1.70311465159901,92,41,51,61,1.2,5.11,3.9,0,0,0,0,0,0,0.32777205305317,320.759926436193,43.2157618529029
8.7,"greedy_SVM","SVM",22,2,3612,3300,312,300,205,95,0.879778802950427,0.547738693467337,1.64119680973676,180,88,92,88,1,7.67,2.2,0,0,0,0,0,0,0.472332726804201,268.742738595381,60.1992865702861
8.7,"greedy_SVM","SVM",22,3,3512,3276,236,400,229,171,0.889371444587771,0.592964824120603,1.65629251228518,225,111,114,45,1,10.22,1.3,0,0,0,0,0,0,0.358074524798267,221.43088366375,51.2465419709078
8.7,"greedy_SVM","SVM",22,4,3412,3232,180,500,273,227,0.917517296213558,0.64321608040201,1.75262341117351,317,156,161,92,1,12.78,1.2,0,0,0,0,0,0,0.353741175727409,204.066845099885,48.5333557614877
8.7,"greedy_SVM","SVM",22,5,3312,3186,126,600,319,281,0.87950137711894,0.64321608040201,1.64724173352953,406,202,204,89,1,15.34,1.1,0,0,0,0,0,0,0.242584318869798,157.439751575129,33.4976561433832
8.7,"greedy_SVM","SVM",22,6,3212,3105,107,700,400,300,0.891984109505981,0.648241206030151,1.66534329104084,456,221,235,50,1.1,17.89,1.3,0,0,0,0,0,0,0.107820635940686,93.6560098079188,16.023363601221
8.7,"greedy_SVM","SVM",22,7,3112,3031,81,800,474,326,0.880054798751868,0.678391959798995,1.63064168770118,517,251,266,61,1.1,20.45,1.5,0,0,0,0,0,0,0.0881322788912627,114.037585941511,11.8747828260774
8.7,"greedy_SVM","SVM",22,8,3012,2948,64,900,557,343,0.884719556805066,0.688442211055276,1.62914017601821,568,271,297,51,1.1,23.01,1.6,0,0,0,0,0,0,0.0768816677315717,127.692926830251,11.3352423003615
8.7,"greedy_SVM","SVM",22,9,2912,2855,57,1000,650,350,0.898424964892762,0.683417085427136,1.65781904916286,588,285,303,20,1.1,25.56,1.9,0,0,0,0,0,0,0.0702559667992824,106.821364310601,8.01981544036727
8.7,"greedy_SVM","SVM",22,10,2812,2765,47,1100,740,360,0.908370823954716,0.688442211055276,1.67131613952113,614,300,314,26,1,28.12,2.1,0,0,0,0,0,0,0.0595051476400962,92.6916759359231,6.44906060768777
8.7,"greedy_SVM","SVM",22,11,2712,2673,39,1200,832,368,0.92187459780403,0.688442211055276,1.71217377208624,638,309,329,24,1.1,30.67,2.3,0,0,0,0,0,0,0.0667013819939232,97.7223165406892,7.48725453433518
8.7,"greedy_SVM","SVM",22,12,2612,2583,29,1300,922,378,0.929852735504482,0.678391959798995,1.74358926987881,670,322,348,32,1.1,33.23,2.4,0,0,0,0,0,0,0.0823098745290274,87.3333740147814,9.08878115601706
8.7,"greedy_SVM","SVM",22,13,2512,2484,28,1400,1021,379,0.929629650815243,0.678391959798995,1.74680029984175,677,325,352,7,1.1,35.79,2.7,0,0,0,0,0,0,0.0642861570881046,65.9400313785681,6.97040134380315
8.7,"greedy_SVM","SVM",22,14,2412,2387,25,1500,1118,382,0.930074390163674,0.673366834170854,1.75746937452238,689,331,358,12,1.1,38.34,2.9,0,0,0,0,0,0,0.0605657808981291,54.6002100757931,6.56908659818554
8.7,"greedy_SVM","SVM",22,15,2312,2293,19,1600,1212,388,0.930203092869006,0.678391959798995,1.75746937452238,703,337,366,14,1.1,40.9,3.1,0,0,0,0,0,0,0.0549948746274403,47.2095592808383,6.22600538106451
8.7,"greedy_SVM","SVM",22,16,2212,2199,13,1700,1306,394,0.930180212388057,0.678391959798995,1.75746937452238,716,345,371,13,1.1,43.46,3.3,0,0,0,0,0,0,0.0461540386654487,44.3150807555334,5.62658173438603
8.7,"greedy_SVM","SVM",22,17,2112,2103,9,1800,1402,398,0.92903332828055,0.678391959798995,1.74358926987881,731,349,382,15,1.1,46.01,3.5,0,0,0,0,0,0,0.0360315355524406,36.6928123173532,4.06645531655196
8.7,"greedy_SVM","SVM",22,18,2012,2003,9,1900,1502,398,0.928817393741606,0.678391959798995,1.74358926987881,734,349,385,3,1.1,48.57,3.8,0,0,0,0,0,0,0.0287267645392584,30.5491943218767,3.109447199105
8.7,"greedy_SVM","SVM",22,19,1912,1903,9,2000,1602,398,0.928896045394866,0.678391959798995,1.75423576021783,733,350,383,-1,1.1,51.12,4,0,0,0,0,0,0,0.024271764076589,23.4121894408449,2.48386021868412
8.7,"greedy_SVM","SVM",22,20,1812,1803,9,2100,1702,398,0.927937925255176,0.653266331658292,1.77558761549684,756,363,393,23,1.1,53.68,4.3,0,0,0,0,0,0,0.0172009165984792,12.8304062894843,2.19490654387973
8.7,"greedy_SVM","SVM",22,21,1712,1705,7,2200,1800,400,0.927940785315295,0.653266331658292,1.77232066496235,758,364,394,2,1.1,56.24,4.5,0,0,0,0,0,0,0.0128256431788014,10.7357878117574,1.45684016888972
8.7,"greedy_SVM","SVM",22,22,1612,1607,5,2300,1898,402,0.928211060996489,0.653266331658292,1.77395263610872,760,368,392,2,1.1,58.79,4.7,0,0,0,0,0,0,0.0122911969291568,10.5775549509972,1.31257050039971
8.7,"greedy_SVM","SVM",22,23,1512,1507,5,2400,1998,402,0.927926485014702,0.653266331658292,1.77069169376293,767,369,398,7,1.1,61.35,5,0,0,0,0,0,0,0.00947836033919654,7.60039953502157,1.06103434676197
8.7,"greedy_SVM","SVM",22,24,1412,1407,5,2500,2098,402,0.928059477810211,0.653266331658292,1.77395263610872,768,369,399,1,1.1,63.91,5.2,0,0,0,0,0,0,0.0089845564361728,6.47188075225827,0.908286563745753
8.7,"greedy_SVM","SVM",22,25,1312,1307,5,2600,2198,402,0.928118109042637,0.653266331658292,1.77395263610872,781,377,404,13,1.1,66.46,5.5,0,0,0,0,0,0,0.00660810553700674,4.17120708322461,0.75056871570434
8.7,"greedy_SVM","SVM",22,26,1212,1207,5,2700,2298,402,0.928080928261097,0.653266331658292,1.76906571424616,782,376,406,1,1.1,69.02,5.7,0,0,0,0,0,0,0.00584203671371534,3.55435597334303,0.619447451162024
8.7,"greedy_SVM","SVM",22,27,1112,1108,4,2800,2397,403,0.928252531868204,0.648241206030151,1.77395263610872,782,378,404,0,1.1,71.57,5.9,0,0,0,0,0,0,0.00508740562350567,2.6463766299146,0.520424223226994
8.7,"greedy_SVM","SVM",22,28,1012,1008,4,2900,2497,403,0.928565708451175,0.64321608040201,1.77395263610872,786,383,403,4,1.1,74.13,6.2,0,0,0,0,0,0,0.00427424235313021,2.00603049032972,0.468792923069484
8.7,"greedy_SVM","SVM",22,29,912,909,3,3000,2596,404,0.928906055605273,0.638190954773869,1.77069169376293,791,384,407,5,1.1,76.69,6.4,0,0,0,0,0,0,0.00411269296905564,1.61692410179813,0.429516341666028
8.7,"greedy_SVM","SVM",22,30,812,810,2,3100,2695,405,0.929407996156063,0.638190954773869,1.77395263610872,798,387,411,7,1.1,79.24,6.7,0,0,0,0,0,0,0.00366605264664242,1.28676000032954,0.406311699191207
8.7,"greedy_SVM","SVM",22,31,712,710,2,3200,2795,405,0.929459477238195,0.638190954773869,1.77232066496235,799,387,412,1,1.1,81.8,6.9,0,0,0,0,0,0,0.00258266017502453,0.832694032050707,0.308799057054505
8.7,"greedy_SVM","SVM",22,32,612,611,1,3300,2894,406,0.929553859222105,0.638190954773869,1.76906571424616,803,390,413,4,1.1,84.36,7.1,0,0,0,0,0,0,0.00156351406584472,0.522819867780616,0.209022841466902
8.7,"greedy_SVM","SVM",22,33,512,512,0,3400,2993,407,0.929430876637011,0.638190954773869,1.76906571424616,804,392,412,1,1.1,86.91,7.4,0,0,0,0,0,0,0.00121842370987783,0.402735698195822,0.15514178587861
8.7,"greedy_SVM","SVM",22,34,412,412,0,3500,3093,407,0.929679701867318,0.638190954773869,1.76906571424616,808,392,416,4,1.1,89.47,7.6,0,0,0,0,0,0,0.000805320250864752,0.238827841940663,0.100402951510853
8.7,"greedy_SVM","SVM",22,35,312,312,0,3600,3193,407,0.929902786556559,0.633165829145729,1.76906571424616,810,394,416,2,1.1,92.02,7.8,0,0,0,0,0,0,0.000499904943184325,0.129485362263863,0.0615147437492535
8.7,"greedy_SVM","SVM",22,36,212,212,0,3700,3293,407,0.930177352327932,0.628140703517588,1.76906571424616,813,394,419,3,1.1,94.58,8.1,0,0,0,0,0,0,0.000301652141205526,0.0620449200149852,0.0377016430319195
8.7,"greedy_SVM","SVM",22,37,112,112,0,3800,3393,407,0.930457638219543,0.628140703517588,1.77069169376293,814,396,418,1,1.1,97.14,8.3,0,0,0,0,0,0,0.000139678123487541,0.023152091067892,0.0216556698659814
8.7,"greedy_SVM","SVM",22,38,12,12,0,3900,3493,407,0.930936698289392,0.628140703517588,1.77069169376293,817,397,420,3,1.1,99.69,8.6,0,0,0,0,0,0,8.81277374377557e-05,0.00121887885895937,0.00121887885895937
8.7,"greedy_SVM","SVM",22,39,0,0,0,3912,3505,407,0.9309610088004,0.628140703517588,1.77232066496235,817,397,420,0,1.1,100,8.6,0,0,0,0,0,0,0,0,0
8.7,"greedy_SVM","SVM",23,0,3812,3427,385,100,84,16,0.897494114861201,0.585365853658537,1.75394548063128,32,15,17,0,1.1,2.56,5.2,0,0,0,0,0,0,0.957209950854811,501.075429093022,96.9466611522504
8.7,"greedy_SVM","SVM",23,1,3712,3403,309,200,108,92,0.899644802273269,0.585365853658537,1.74678125070119,75,37,38,43,1,5.11,1.2,0,0,0,0,0,0,0.740794566020426,273.782803321506,82.311566477756
8.7,"greedy_SVM","SVM",23,2,3612,3366,246,300,145,155,0.888281260882298,0.590243902439024,1.69567443740736,145,75,70,70,0.9,7.67,0.9,0,0,0,0,0,0,0.516647758894462,235.813915378984,63.2491774541952
8.7,"greedy_SVM","SVM",23,3,3512,3317,195,400,194,206,0.868167319023269,0.614634146341463,1.63116929698709,236,123,113,91,0.9,10.22,0.9,0,0,0,0,0,0,0.259968170349847,135.765883336534,36.928901037516
8.7,"greedy_SVM","SVM",23,4,3412,3253,159,500,258,242,0.846958532406567,0.634146341463415,1.5741216140272,319,160,159,83,1,12.78,1.1,0,0,0,0,0,0,0.166221760118103,108.52367607429,27.0542625461559
8.7,"greedy_SVM","SVM",23,5,3312,3186,126,600,325,275,0.84759370951791,0.634146341463415,1.55653366303248,388,193,195,69,1,15.34,1.2,0,0,0,0,0,0,0.116604408754694,86.0628188592129,21.3448415973762
8.7,"greedy_SVM","SVM",23,6,3212,3106,106,700,405,295,0.855611427616284,0.64390243902439,1.5536697556488,439,213,226,51,1.1,17.89,1.4,0,0,0,0,0,0,0.0693269489399211,60.0726293552431,10.2339108030578
8.7,"greedy_SVM","SVM",23,7,3112,3032,80,800,479,321,0.863251661071725,0.663414634146341,1.54631451286889,501,240,261,62,1.1,20.45,1.5,0,0,0,0,0,0,0.0616468602567516,90.5800804650547,10.4154923062788
8.7,"greedy_SVM","SVM",23,8,3012,2948,64,900,563,337,0.87536320708724,0.668292682926829,1.58000314133776,544,260,284,43,1.1,23.01,1.7,0,0,0,0,0,0,0.0573197465318387,80.1047840178593,6.99204110453189
8.7,"greedy_SVM","SVM",23,9,2912,2861,51,1000,650,350,0.897836776197579,0.668292682926829,1.63417329200916,579,274,305,35,1.1,25.56,1.9,0,0,0,0,0,0,0.0526753448278598,85.9759950865534,6.10883948221096
8.7,"greedy_SVM","SVM",23,10,2812,2772,40,1100,739,361,0.923550305748643,0.668292682926829,1.71167006978257,609,286,323,30,1.1,28.12,2,0,0,0,0,0,0,0.0714505321571712,98.7869829426154,7.89836770998728
8.7,"greedy_SVM","SVM",23,11,2712,2680,32,1200,831,369,0.929411764705888,0.658536585365854,1.75555904593085,635,303,332,26,1.1,30.67,2.3,0,0,0,0,0,0,0.0860036641158705,82.7626754211884,9.5974623735493
8.7,"greedy_SVM","SVM",23,12,2612,2584,28,1300,927,373,0.928450641445313,0.648780487804878,1.75879509947173,647,309,338,12,1.1,33.23,2.5,0,0,0,0,0,0,0.0842169536812707,68.0091410004934,9.12111930836534
8.7,"greedy_SVM","SVM",23,13,2512,2488,24,1400,1023,377,0.928216628825346,0.648780487804878,1.75555904593085,663,318,345,16,1.1,35.79,2.7,0,0,0,0,0,0,0.0750647495137737,57.3506747335535,8.20134136449364
8.7,"greedy_SVM","SVM",23,14,2412,2391,21,1500,1120,380,0.928298811828787,0.648780487804878,1.75717558280555,675,322,353,12,1.1,38.34,2.9,0,0,0,0,0,0,0.0595270968111009,42.6475434697931,6.4256199795068
8.7,"greedy_SVM","SVM",23,15,2312,2295,17,1600,1216,384,0.928634508503858,0.648780487804878,1.75879509947173,684,327,357,9,1.1,40.9,3.2,0,0,0,0,0,0,0.0400581134892008,33.0545259764675,4.94133132497443
8.7,"greedy_SVM","SVM",23,16,2212,2200,12,1700,1311,389,0.928241701606057,0.648780487804878,1.75879509947173,696,333,363,12,1.1,43.46,3.4,0,0,0,0,0,0,0.0300645854428127,28.9231156683959,3.61730108084241
8.7,"greedy_SVM","SVM",23,17,2112,2100,12,1800,1411,389,0.927940828237528,0.648780487804878,1.75879509947173,698,333,365,2,1.1,46.01,3.6,0,0,0,0,0,0,0.0219979729838431,22.1681841823596,2.45969450691951
8.7,"greedy_SVM","SVM",23,18,2012,2002,10,1900,1509,391,0.928433926258172,0.648780487804878,1.75879509947173,708,337,371,10,1.1,48.57,3.9,0,0,0,0,0,0,0.0175994240848811,17.8178287995834,1.94131385585344
8.7,"greedy_SVM","SVM",23,19,1912,1903,9,2000,1608,392,0.929687565293705,0.64390243902439,1.75879509947173,707,340,367,-1,1.1,51.12,4.1,0,0,0,0,0,0,0.0150927518190484,15.4641865391425,1.60555810435325
8.7,"greedy_SVM","SVM",23,20,1812,1803,9,2100,1708,392,0.929832430248924,0.64390243902439,1.75879509947173,709,341,368,2,1.1,53.68,4.4,0,0,0,0,0,0,0.0131496907691974,12.7885526849124,1.38554755812042
8.7,"greedy_SVM","SVM",23,21,1712,1705,7,2200,1806,394,0.92955105793206,0.639024390243902,1.75717558280555,714,344,370,5,1.1,56.24,4.6,0,0,0,0,0,0,0.0118467739305943,11.6745246171552,1.27710592351344
8.7,"greedy_SVM","SVM",23,22,1612,1607,5,2300,1904,396,0.928829519020498,0.634146341463415,1.76596146071958,722,350,372,8,1.1,58.79,4.8,0,0,0,0,0,0,0.00992636485734607,9.31708329404702,1.12251330766195
8.7,"greedy_SVM","SVM",23,23,1512,1507,5,2400,2004,396,0.92847850009055,0.634146341463415,1.76596146071958,727,351,376,5,1.1,61.35,5.1,0,0,0,0,0,0,0.00892849855511445,7.48539986335066,0.909606014775222
8.7,"greedy_SVM","SVM",23,24,1412,1407,5,2500,2104,396,0.927972865679552,0.639024390243902,1.76596146071958,751,364,387,24,1.1,63.91,5.3,0,0,0,0,0,0,0.0063121789906537,4.20143491316786,0.817247596091506
8.7,"greedy_SVM","SVM",23,25,1312,1307,5,2600,2204,396,0.927876753353495,0.639024390243902,1.76758907496909,752,364,388,1,1.1,66.46,5.6,0,0,0,0,0,0,0.00419846769276036,3.15226885801319,0.486649281564017
8.7,"greedy_SVM","SVM",23,26,1212,1208,4,2700,2303,397,0.928160911534882,0.634146341463415,1.76758907496909,752,364,388,0,1.1,69.02,5.8,0,0,0,0,0,0,0.00481798117370973,3.27481122785064,0.490810355581845
8.7,"greedy_SVM","SVM",23,27,1112,1108,4,2800,2403,397,0.928016046579664,0.629268292682927,1.7643368411605,759,369,390,7,1.1,71.57,6.1,0,0,0,0,0,0,0.0030490883424647,1.76971885510392,0.363937666095613
8.7,"greedy_SVM","SVM",23,28,1012,1009,3,2900,2502,398,0.927868395759923,0.629268292682927,1.76109655311429,763,371,392,4,1.1,74.13,6.3,0,0,0,0,0,0,0.00283595260372952,1.64200193276985,0.304448404882734
8.7,"greedy_SVM","SVM",23,29,912,910,2,3000,2601,399,0.927681742836855,0.634146341463415,1.76109655311429,767,374,393,4,1.1,76.69,6.5,0,0,0,0,0,0,0.00240322227009405,1.21347013703942,0.250592890397731
8.7,"greedy_SVM","SVM",23,30,812,810,2,3100,2701,399,0.927788998621006,0.634146341463415,1.75948086820318,774,377,397,7,1.1,79.24,6.8,0,0,0,0,0,0,0.00224906920822094,0.983874900892848,0.238324228396332
8.7,"greedy_SVM","SVM",23,31,712,710,2,3200,2801,399,0.927945007034316,0.634146341463415,1.76596146071958,775,379,396,1,1,81.8,7,0,0,0,0,0,0,0.00197015203660133,0.710292595507626,0.2068999232074
8.7,"greedy_SVM","SVM",23,32,612,610,2,3300,2901,399,0.928336420999853,0.624390243902439,1.75786814513425,780,380,400,5,1.1,84.36,7.3,0,0,0,0,0,0,0.0015515393719382,0.483520064599017,0.175521911997451
8.7,"greedy_SVM","SVM",23,33,512,511,1,3400,3000,400,0.928686046997541,0.629268292682927,1.75948086820318,784,383,401,4,1,86.91,7.5,0,0,0,0,0,0,0.00105911558403053,0.319474778871432,0.129441592235049
8.7,"greedy_SVM","SVM",23,34,412,412,0,3500,3099,401,0.92868604699754,0.629268292682927,1.75948086820318,789,386,403,5,1,89.47,7.7,0,0,0,0,0,0,0.000789139802300231,0.235355518850823,0.101210276792633
8.7,"greedy_SVM","SVM",23,35,312,312,0,3600,3199,401,0.928656795420045,0.629268292682927,1.76109655311429,791,387,404,2,1,92.02,8,0,0,0,0,0,0,0.000431364102314726,0.115002780597765,0.0560735770689108
8.7,"greedy_SVM","SVM",23,36,212,212,0,3700,3299,401,0.928550932568154,0.629268292682927,1.76338116171647,795,390,405,4,1,94.58,8.2,0,0,0,0,0,0,0.000311100935107852,0.0649145222547646,0.039266311937685
8.7,"greedy_SVM","SVM",23,37,112,112,0,3800,3399,401,0.928715298575034,0.629268292682927,1.76338116171647,796,391,405,1,1,97.14,8.5,0,0,0,0,0,0,0.000143155219662787,0.022570001100244,0.0210527186656854
8.7,"greedy_SVM","SVM",23,38,12,12,0,3900,3499,401,0.92872922789765,0.624390243902439,1.77311463639015,798,391,407,2,1,99.69,8.7,0,0,0,0,0,0,9.91044111523016e-05,0.00135656603241731,0.00135656603241731
8.7,"greedy_SVM","SVM",23,39,0,0,0,3912,3511,401,0.928738978423482,0.624390243902439,1.77474733863361,798,391,407,0,1,100,8.8,0,0,0,0,0,0,0,0,0
8.7,"greedy_SVM","SVM",24,0,3812,3436,376,100,86,14,0.886230842911903,0.560185185185185,1.71544221817446,31,14,17,0,1.2,2.56,6.1,0,0,0,0,0,0,0.525731502636804,485.66316279636,56.9019325893044
8.7,"greedy_SVM","SVM",24,1,3712,3411,301,200,111,89,0.882327586206917,0.560185185185185,1.71456290849673,89,46,43,58,0.9,5.11,1.2,0,0,0,0,0,0,0.648101645285113,305.921677205607,74.1041856069407
8.7,"greedy_SVM","SVM",24,2,3612,3384,228,300,138,162,0.891501702852287,0.546296296296296,1.73793490460157,148,79,69,59,0.9,7.67,0.9,0,0,0,0,0,0,0.450985295516234,216.620009159235,57.9867773504588
8.7,"greedy_SVM","SVM",24,3,3512,3338,174,400,184,216,0.87370423584505,0.569444444444444,1.70780946539916,229,119,110,81,0.9,10.22,0.9,0,0,0,0,0,0,0.320752379484687,173.749645033883,42.0560682221354
8.7,"greedy_SVM","SVM",24,4,3412,3277,135,500,245,255,0.854923637718178,0.597222222222222,1.64797794117647,331,168,163,102,1,12.78,1,0,0,0,0,0,0,0.219715874611307,153.332452657846,29.0030775652898
8.7,"greedy_SVM","SVM",24,5,3312,3198,114,600,324,276,0.862143465304381,0.615740740740741,1.6328324644792,393,192,201,62,1,15.34,1.2,0,0,0,0,0,0,0.0911814173033706,54.140426724454,12.2237908608052
8.7,"greedy_SVM","SVM",24,6,3212,3118,94,700,404,296,0.871329555129837,0.615740740740741,1.63965482026144,438,213,225,45,1.1,17.89,1.4,0,0,0,0,0,0,0.0729609669152076,53.12641367815,9.6231386485844
8.7,"greedy_SVM","SVM",24,7,3112,3035,77,800,487,313,0.866004150702433,0.62037037037037,1.57849133537207,480,232,248,42,1.1,20.45,1.6,0,0,0,0,0,0,0.067283330756713,74.1730868496016,9.27045196789907
8.7,"greedy_SVM","SVM",24,8,3012,2953,59,900,569,331,0.853948488718601,0.634259259259259,1.56907322068612,519,251,268,39,1.1,23.01,1.7,0,0,0,0,0,0,0.066563387225158,104.717330917971,8.97663158143544
8.7,"greedy_SVM","SVM",24,9,2912,2862,50,1000,660,340,0.872492283950625,0.638888888888889,1.61765909555965,557,265,292,38,1.1,25.56,1.9,0,0,0,0,0,0,0.06848917025591,110.662860131476,8.21761390532576
8.7,"greedy_SVM","SVM",24,10,2812,2767,45,1100,755,345,0.887030385270335,0.638888888888889,1.63433599345202,576,276,300,19,1.1,28.12,2.2,0,0,0,0,0,0,0.0542446010970368,75.9261363187378,5.83747599704821
8.7,"greedy_SVM","SVM",24,11,2712,2676,36,1200,846,354,0.897399159216684,0.634259259259259,1.63965482026144,598,288,310,22,1.1,30.67,2.4,0,0,0,0,0,0,0.0587284922098576,77.5945122178583,6.41907062609636
8.7,"greedy_SVM","SVM",24,12,2612,2582,30,1300,940,360,0.90965836526182,0.634259259259259,1.70780946539916,620,298,322,22,1.1,33.23,2.6,0,0,0,0,0,0,0.0603987231803248,70.380959715832,6.4670372488775
8.7,"greedy_SVM","SVM",24,13,2512,2483,29,1400,1039,361,0.91209025117072,0.638888888888889,1.72764976958525,621,300,321,1,1.1,35.79,2.9,0,0,0,0,0,0,0.0481259025808625,52.3704686250589,5.16004329153396
8.7,"greedy_SVM","SVM",24,14,2412,2387,25,1500,1135,365,0.913620157513839,0.638888888888889,1.72447102115915,631,305,326,10,1.1,38.34,3.1,0,0,0,0,0,0,0.0459207488638613,50.2792750200245,5.03831382897956
8.7,"greedy_SVM","SVM",24,15,2312,2294,18,1600,1228,372,0.917306566624104,0.638888888888889,1.72803261977574,657,314,343,26,1.1,40.9,3.3,0,0,0,0,0,0,0.0515071597105456,44.9840768812714,5.94405165920308
8.7,"greedy_SVM","SVM",24,16,2212,2198,14,1700,1324,376,0.917133620689662,0.643518518518518,1.73439738080622,670,318,352,13,1.1,43.46,3.5,0,0,0,0,0,0,0.0392780947489353,38.5261355287129,4.81881502065456
8.7,"greedy_SVM","SVM",24,17,2112,2102,10,1800,1420,380,0.917451575138364,0.643518518518518,1.72803261977574,675,322,353,5,1.1,46.01,3.7,0,0,0,0,0,0,0.0300453860386273,30.765090739605,3.45270050401984
8.7,"greedy_SVM","SVM",24,18,2012,2003,9,1900,1519,381,0.917927841634754,0.643518518518518,1.7427358297524,677,323,354,2,1.1,48.57,4,0,0,0,0,0,0,0.0244067241600051,25.9672469921963,2.64065599442012
8.7,"greedy_SVM","SVM",24,19,1912,1903,9,2000,1619,381,0.917717645806741,0.634259259259259,1.7427358297524,687,327,360,10,1.1,51.12,4.2,0,0,0,0,0,0,0.0203118520334675,21.0484388350317,2.1750370628254
8.7,"greedy_SVM","SVM",24,20,1812,1805,7,2100,1717,383,0.917758886760334,0.638888888888889,1.73634046890928,695,330,365,8,1.1,53.68,4.5,0,0,0,0,0,0,0.0201072913746878,19.4032853039244,2.03643450170679
8.7,"greedy_SVM","SVM",24,21,1712,1705,7,2200,1817,383,0.916616113239675,0.634259259259259,1.76612491055913,713,348,365,18,1,56.24,4.7,0,0,0,0,0,0,0.0125591104838557,8.60535275391979,1.73212818280285
8.7,"greedy_SVM","SVM",24,22,1612,1606,6,2300,1916,384,0.916203703703701,0.634259259259259,1.76612491055913,714,349,365,1,1,58.79,5,0,0,0,0,0,0,0.00905488038744924,7.08857338572956,1.05947142988463
8.7,"greedy_SVM","SVM",24,23,1512,1507,5,2400,2015,385,0.916679970200084,0.634259259259259,1.76775117659096,718,350,368,4,1.1,61.35,5.2,0,0,0,0,0,0,0.00827703503945635,6.62308077105055,0.887573873649757
8.7,"greedy_SVM","SVM",24,24,1412,1407,5,2500,2115,385,0.916296828437632,0.634259259259259,1.76450163398693,720,352,368,2,1,63.91,5.5,0,0,0,0,0,0,0.00625772807444669,4.63594630763728,0.662994887911125
8.7,"greedy_SVM","SVM",24,25,1312,1307,5,2600,2215,385,0.91595625798212,0.62962962962963,1.76612491055913,733,360,373,13,1,66.46,5.8,0,0,0,0,0,0,0.00532184800071628,3.63491176760481,0.599651863861076
8.7,"greedy_SVM","SVM",24,26,1212,1210,2,2700,2312,388,0.917411664538105,0.625,1.76288133863891,738,364,374,5,1,69.02,6,0,0,0,0,0,0,0.00538720541344991,3.3945758453727,0.578007047154011
8.7,"greedy_SVM","SVM",24,27,1112,1110,2,2800,2412,388,0.917701681566636,0.625,1.75964965882473,747,367,380,9,1,71.57,6.2,0,0,0,0,0,0,0.00369608992424541,2.16920344024393,0.414791589428096
8.7,"greedy_SVM","SVM",24,28,1012,1011,1,2900,2511,389,0.917837377607497,0.625,1.76450163398693,750,368,382,3,1,74.13,6.5,0,0,0,0,0,0,0.00448362466920329,2.1047633269298,0.469218418925171
8.7,"greedy_SVM","SVM",24,29,912,911,1,3000,2611,389,0.917753565346968,0.625,1.76450163398693,753,370,383,3,1,76.69,6.7,0,0,0,0,0,0,0.00310331644921169,1.37264799981615,0.342261555560128
8.7,"greedy_SVM","SVM",24,30,812,811,1,3100,2711,389,0.91778416347383,0.625,1.76612491055913,754,370,384,1,1,79.24,7,0,0,0,0,0,0,0.00341264793585564,1.37003246103642,0.370995578670762
8.7,"greedy_SVM","SVM",24,31,712,711,1,3200,2811,389,0.917861323967657,0.625,1.76450163398693,753,371,382,-1,1,81.8,7.2,0,0,0,0,0,0,0.00223084759962878,0.78437039263129,0.246681927443853
8.7,"greedy_SVM","SVM",24,32,612,611,1,3300,2911,389,0.917858663260972,0.625,1.75964965882473,755,371,384,2,1,84.36,7.5,0,0,0,0,0,0,0.00151752466646224,0.487233967499532,0.178180687147217
8.7,"greedy_SVM","SVM",24,33,512,511,1,3400,3011,389,0.917974404001712,0.62037037037037,1.76126401630989,759,371,388,4,1,86.91,7.7,0,0,0,0,0,0,0.000967394729341471,0.323285778865275,0.128633476889624
8.7,"greedy_SVM","SVM",24,34,412,412,0,3500,3110,390,0.917954448701582,0.615740740740741,1.76450163398693,769,375,394,10,1.1,89.47,8,0,0,0,0,0,0,0.000998513451746211,0.2946374087071,0.120684032660246
8.7,"greedy_SVM","SVM",24,35,312,312,0,3600,3210,390,0.917911877394641,0.615740740740741,1.76288133863891,764,375,389,-5,1,92.02,8.2,0,0,0,0,0,0,0.000597032678267506,0.146726053249295,0.0728676327046403
8.7,"greedy_SVM","SVM",24,36,212,212,0,3700,3310,390,0.918953544061304,0.615740740740741,1.76450163398693,769,377,392,5,1,94.58,8.5,0,0,0,0,0,0,0.000400733551001368,0.0826481903691237,0.0524005072827115
8.7,"greedy_SVM","SVM",24,37,112,112,0,3800,3410,390,0.919651979565772,0.615740740740741,1.76288133863891,773,378,395,4,1,97.14,8.7,0,0,0,0,0,0,0.000157853638173175,0.0259368624630642,0.0242470935364675
8.7,"greedy_SVM","SVM",24,38,12,12,0,3900,3510,390,0.92015485312899,0.611111111111111,1.76288133863891,775,378,397,2,1.1,99.69,9,0,0,0,0,0,0,0.0001152007131469,0.0018690270526886,0.0018690270526886
8.7,"greedy_SVM","SVM",24,39,0,0,0,3912,3522,390,0.920204076202638,0.611111111111111,1.76450163398693,776,379,397,1,1,100,9,0,0,0,0,0,0,0,0,0
8.7,"greedy_SVM","SVM",25,0,3812,3411,401,100,88,12,0.873513999629693,0.481865284974093,1.69067596284711,34,12,22,0,1.8,2.56,7.3,0,0,0,0,0,0,0.229091724399752,438.617826080053,26.4656192305619
8.7,"greedy_SVM","SVM",25,1,3712,3348,364,200,151,49,0.909601215544621,0.559585492227979,1.74030460040823,107,49,58,73,1.2,5.11,3.1,0,0,0,0,0,0,0.644338635887895,450.548886097765,75.231706230879
8.7,"greedy_SVM","SVM",25,2,3612,3325,287,300,174,126,0.9184768073732,0.61139896373057,1.74030460040823,164,83,81,57,1,7.67,1.4,0,0,0,0,0,0,0.558555905686616,351.952035692311,66.8028982503629
8.7,"greedy_SVM","SVM",25,3,3512,3296,216,400,203,197,0.920348910682734,0.632124352331606,1.74030460040823,229,115,114,65,1,10.22,1,0,0,0,0,0,0,0.506806883733721,304.205291544743,58.5935382506711
8.7,"greedy_SVM","SVM",25,4,3412,3243,169,500,256,244,0.909535089446579,0.61139896373057,1.73577992156414,323,163,160,94,1,12.78,1,0,0,0,0,0,0,0.306524778666802,195.519758347762,42.1784331437402
8.7,"greedy_SVM","SVM",25,5,3312,3183,129,600,316,284,0.867068909272057,0.632124352331606,1.6036531595731,414,207,207,91,1,15.34,1.1,0,0,0,0,0,0,0.243869657726518,259.325650005532,32.327634177901
8.7,"greedy_SVM","SVM",25,6,3212,3104,108,700,395,305,0.891888238077451,0.66839378238342,1.61594995343951,477,234,243,63,1,17.89,1.3,0,0,0,0,0,0,0.124512331618019,145.045900704413,17.1343908209998
8.7,"greedy_SVM","SVM",25,7,3112,3025,87,800,474,326,0.9004993255138,0.673575129533679,1.62230028933558,526,250,276,49,1.1,20.45,1.5,0,0,0,0,0,0,0.0931384924388972,139.318984716157,11.5281646091742
8.7,"greedy_SVM","SVM",25,8,3012,2939,73,900,560,340,0.908713656361774,0.694300518134715,1.64875419079549,558,268,290,32,1.1,23.01,1.6,0,0,0,0,0,0,0.0810850671153504,124.299422692456,11.1107481857902
8.7,"greedy_SVM","SVM",25,9,2912,2854,58,1000,645,355,0.910676866739745,0.699481865284974,1.65959454886053,605,291,314,47,1.1,25.56,1.8,0,0,0,0,0,0,0.0904937171774216,130.372563017164,10.397217774308
8.7,"greedy_SVM","SVM",25,10,2812,2756,56,1100,743,357,0.914103668088127,0.694300518134715,1.68133521167116,614,298,316,9,1.1,28.12,2.1,0,0,0,0,0,0,0.0616234578874902,82.9008262685585,6.77616088622991
8.7,"greedy_SVM","SVM",25,11,2712,2661,51,1200,838,362,0.918617876382407,0.689119170984456,1.69067596284711,629,303,326,15,1.1,30.67,2.3,0,0,0,0,0,0,0.0500374127089045,66.0977228376185,5.43339315358888
8.7,"greedy_SVM","SVM",25,12,2612,2563,49,1300,936,364,0.92086028584108,0.689119170984456,1.69845132110039,637,306,331,8,1.1,33.23,2.6,0,0,0,0,0,0,0.0412947785440238,54.2936834939341,4.47658363267452
8.7,"greedy_SVM","SVM",25,13,2512,2466,46,1400,1033,367,0.924094586770666,0.689119170984456,1.70778347121633,642,309,333,5,1.1,35.79,2.8,0,0,0,0,0,0,0.0393014617128519,51.9875757701657,4.48834232992063
8.7,"greedy_SVM","SVM",25,14,2412,2375,37,1500,1124,376,0.933756344431749,0.689119170984456,1.75606122107877,669,322,347,27,1.1,38.34,3,0,0,0,0,0,0,0.0591567447970922,55.225604718365,6.52859518866667
8.7,"greedy_SVM","SVM",25,15,2312,2280,32,1600,1219,381,0.933544740917957,0.673575129533679,1.75606122107877,682,329,353,13,1.1,40.9,3.2,0,0,0,0,0,0,0.0593738488958304,50.7079493902873,6.41166458671956
8.7,"greedy_SVM","SVM",25,16,2212,2186,26,1700,1313,387,0.933704913022147,0.66839378238342,1.75444422179601,707,336,371,25,1.1,43.46,3.4,0,0,0,0,0,0,0.0531369020115089,42.6672504338806,6.05341059601312
8.7,"greedy_SVM","SVM",25,17,2112,2092,20,1800,1407,393,0.93294813656656,0.66839378238342,1.74511207168007,720,342,378,13,1.1,46.01,3.6,0,0,0,0,0,0,0.0489511205943176,42.9227239946348,5.68942654557598
8.7,"greedy_SVM","SVM",25,18,2012,1998,14,1900,1501,399,0.932087027822929,0.66839378238342,1.74672046990282,733,349,384,13,1.1,48.57,3.8,0,0,0,0,0,0,0.0392518906116611,34.1219117859866,4.4218126273264
8.7,"greedy_SVM","SVM",25,19,1912,1899,13,2000,1600,400,0.93268657111201,0.673575129533679,1.74672046990282,737,353,384,4,1.1,51.12,4,0,0,0,0,0,0,0.028494100889743,26.0638020629494,3.11101570469426
8.7,"greedy_SVM","SVM",25,20,1812,1801,11,2100,1698,402,0.932812945432748,0.673575129533679,1.74672046990282,739,356,383,2,1.1,53.68,4.2,0,0,0,0,0,0,0.0245125814096029,22.9564608184853,2.65729284868965
8.7,"greedy_SVM","SVM",25,21,1712,1703,9,2200,1796,404,0.932754166678916,0.673575129533679,1.75283019767292,748,361,387,9,1.1,56.24,4.4,0,0,0,0,0,0,0.0185213562545532,16.8253884296966,2.06553506276876
8.7,"greedy_SVM","SVM",25,22,1612,1604,8,2300,1895,405,0.933299339620705,0.66839378238342,1.77310852202788,764,368,396,16,1.1,58.79,4.7,0,0,0,0,0,0,0.0149355167878538,12.3418515285441,1.59710420700386
8.7,"greedy_SVM","SVM",25,23,1512,1504,8,2400,1995,405,0.932774739242752,0.663212435233161,1.7714773274354,779,374,405,15,1.1,61.35,4.9,0,0,0,0,0,0,0.00967509211703112,7.24088070506519,1.17664731544768
8.7,"greedy_SVM","SVM",25,24,1412,1407,5,2500,2092,408,0.93287025471773,0.663212435233161,1.77310852202788,781,379,402,2,1.1,63.91,5.1,0,0,0,0,0,0,0.00912864338046228,6.95142783734704,0.974378725787064
8.7,"greedy_SVM","SVM",25,25,1312,1307,5,2600,2192,408,0.932618975545098,0.66839378238342,1.77474272343067,783,382,401,2,1,66.46,5.4,0,0,0,0,0,0,0.00734802699375096,5.07890549783277,0.780651104075909
8.7,"greedy_SVM","SVM",25,26,1212,1207,5,2700,2292,408,0.932253077802496,0.66839378238342,1.77310852202788,791,384,407,8,1.1,69.02,5.6,0,0,0,0,0,0,0.00619848032074338,3.87368972391523,0.658005966726946
8.7,"greedy_SVM","SVM",25,27,1112,1107,5,2800,2392,408,0.932019432256014,0.66839378238342,1.7714773274354,797,385,412,6,1.1,71.57,5.9,0,0,0,0,0,0,0.00497559864049212,2.74362869013401,0.519447716366574
8.7,"greedy_SVM","SVM",25,28,1012,1007,5,2900,2492,408,0.931963592439872,0.663212435233161,1.7714773274354,799,387,412,2,1.1,74.13,6.1,0,0,0,0,0,0,0.004010581366218,1.90543525028297,0.417151544536462
8.7,"greedy_SVM","SVM",25,29,912,907,5,3000,2592,408,0.932197237986348,0.66839378238342,1.77310852202788,804,391,413,5,1.1,76.69,6.4,0,0,0,0,0,0,0.00374401240607163,1.48489006380258,0.389675151306669
8.7,"greedy_SVM","SVM",25,30,812,807,5,3100,2692,408,0.93232508177593,0.663212435233161,1.7714773274354,807,393,414,3,1.1,79.24,6.6,0,0,0,0,0,0,0.00297236330006059,0.953455770676024,0.314751174569659
8.7,"greedy_SVM","SVM",25,31,712,707,5,3200,2792,408,0.932204585330573,0.663212435233161,1.77474272343067,808,394,414,1,1.1,81.8,6.8,0,0,0,0,0,0,0.0020565086177764,0.597982107773123,0.247350813605936
8.7,"greedy_SVM","SVM",25,32,612,609,3,3300,2890,410,0.93270420473814,0.66839378238342,1.76822392554847,817,398,419,9,1.1,84.36,7,0,0,0,0,0,0,0.00162109661159151,0.48999359503827,0.210927464749741
8.7,"greedy_SVM","SVM",25,33,512,511,1,3400,2988,412,0.933807775841331,0.66839378238342,1.76984913136239,830,403,427,13,1.1,86.91,7.3,0,0,0,0,0,0,0.00114279197786435,0.365663790094477,0.157254041732508
8.7,"greedy_SVM","SVM",25,34,412,411,1,3500,3088,412,0.934103139079334,0.66839378238342,1.76984913136239,830,404,426,0,1.1,89.47,7.5,0,0,0,0,0,0,0.000582597482714212,0.164355561628213,0.0754803904782131
8.7,"greedy_SVM","SVM",25,35,312,312,0,3600,3187,413,0.934626269988435,0.658031088082902,1.7714773274354,834,407,427,4,1,92.02,7.7,0,0,0,0,0,0,0.000484815448325949,0.124540926937811,0.0635690172027473
8.7,"greedy_SVM","SVM",25,36,212,212,0,3700,3287,413,0.934640964676893,0.658031088082902,1.7714773274354,838,407,431,4,1.1,94.58,8,0,0,0,0,0,0,0.000238113354390324,0.0493744729956111,0.0311824002981359
8.7,"greedy_SVM","SVM",25,37,112,112,0,3800,3387,413,0.934854037659533,0.658031088082902,1.76660170176356,840,409,431,2,1.1,97.14,8.2,0,0,0,0,0,0,8.24208346222267e-05,0.0146376309885969,0.0137487506598586
8.7,"greedy_SVM","SVM",25,38,12,12,0,3900,3487,413,0.935093561081398,0.658031088082902,1.7714773274354,841,409,432,1,1.1,99.69,8.4,0,0,0,0,0,0,6.14439468083403e-05,0.00084236198071531,0.00084236198071531
8.7,"greedy_SVM","SVM",25,39,0,0,0,3912,3499,413,0.935250794247898,0.658031088082902,1.77310852202788,841,409,432,0,1.1,100,8.5,0,0,0,0,0,0,0,0,0
8.7,"greedy_SVM","SVM",26,0,3812,3410,402,100,88,12,0.902382133408902,0.536458333333333,1.76807851239669,29,12,17,0,1.4,2.56,7.3,0,0,0,0,0,0,0.72513446404959,479.946993405817,77.3368638548639
8.7,"greedy_SVM","SVM",26,1,3712,3375,337,200,123,77,0.898418308295535,0.520833333333333,1.7509765625,103,52,51,74,1,5.11,1.6,0,0,0,0,0,0,0.686183652953555,370.849474364143,75.5993386023639
8.7,"greedy_SVM","SVM",26,2,3612,3345,267,300,153,147,0.908085022203325,0.567708333333333,1.76034007352941,159,83,76,56,0.9,7.67,1,0,0,0,0,0,0,0.531197741141498,240.931599506931,65.0733545623284
8.7,"greedy_SVM","SVM",26,3,3512,3318,194,400,180,220,0.904494697184424,0.588541666666667,1.7509765625,224,118,106,65,0.9,10.22,0.8,0,0,0,0,0,0,0.367267058093109,154.450703104871,49.5619319933517
8.7,"greedy_SVM","SVM",26,4,3412,3252,160,500,246,254,0.829208593159493,0.598958333333333,1.50891214351426,315,160,155,91,1,12.78,1,0,0,0,0,0,0,0.217024850579995,151.111001498827,32.1950316348318
8.7,"greedy_SVM","SVM",26,5,3312,3178,134,600,320,280,0.86841281651549,0.604166666666667,1.624366359447,386,193,193,71,1,15.34,1.1,0,0,0,0,0,0,0.100821014677164,63.8710416555496,14.536021426191
8.7,"greedy_SVM","SVM",26,6,3212,3107,105,700,391,309,0.867842970521548,0.614583333333333,1.591796875,445,217,228,59,1.1,17.89,1.3,0,0,0,0,0,0,0.092754009496835,77.6889621411195,13.6444589595825
8.7,"greedy_SVM","SVM",26,7,3112,3031,81,800,467,333,0.869773951247165,0.630208333333333,1.57596685082873,494,242,252,49,1,20.45,1.4,0,0,0,0,0,0,0.0701897504754515,78.2963138522567,10.1529050637724
8.7,"greedy_SVM","SVM",26,8,3012,2948,64,900,550,350,0.869038761337873,0.645833333333333,1.57018348623853,537,256,281,43,1.1,23.01,1.6,0,0,0,0,0,0,0.0611036452458921,89.5394853500919,7.98232414465626
8.7,"greedy_SVM","SVM",26,9,2912,2861,51,1000,637,363,0.880716175359037,0.640625,1.6213776448942,577,274,303,40,1.1,25.56,1.8,0,0,0,0,0,0,0.0600355713899298,91.1489042938053,6.84057442759659
8.7,"greedy_SVM","SVM",26,10,2812,2772,40,1100,726,374,0.89122437169312,0.630208333333333,1.64163213627993,607,288,319,30,1.1,28.12,1.9,0,0,0,0,0,0,0.0668844923390804,107.080050783653,7.52932069317135
8.7,"greedy_SVM","SVM",26,11,2712,2677,35,1200,821,379,0.901714852607706,0.614583333333333,1.64646464646465,625,298,327,18,1.1,30.67,2.2,0,0,0,0,0,0,0.0548949212434734,76.1712460258145,6.11277231321579
8.7,"greedy_SVM","SVM",26,12,2612,2582,30,1300,916,384,0.910634566326532,0.604166666666667,1.66670496323529,643,312,331,18,1.1,33.23,2.4,0,0,0,0,0,0,0.0557692518119798,69.004003838836,6.09143325952355
8.7,"greedy_SVM","SVM",26,13,2512,2487,25,1400,1011,389,0.921875000000013,0.604166666666667,1.75872359963269,667,319,348,24,1.1,35.79,2.6,0,0,0,0,0,0,0.051625517381921,57.359535281518,5.73093937581087
8.7,"greedy_SVM","SVM",26,14,2412,2389,23,1500,1109,391,0.924098285147407,0.604166666666667,1.77459677419355,667,321,346,0,1.1,38.34,2.8,0,0,0,0,0,0,0.0469255907634114,49.7800337017596,5.18823398736544
8.7,"greedy_SVM","SVM",26,15,2312,2291,21,1600,1207,393,0.92596430933486,0.604166666666667,1.77906709558824,676,324,352,9,1.1,40.9,3.1,0,0,0,0,0,0,0.0401970610996485,38.799705081706,4.50262572495659
8.7,"greedy_SVM","SVM",26,16,2212,2196,16,1700,1302,398,0.926683260109613,0.604166666666667,1.78234346224678,688,331,357,12,1.1,43.46,3.3,0,0,0,0,0,0,0.0346980719963948,32.7616321221297,4.17942960958075
8.7,"greedy_SVM","SVM",26,17,2112,2100,12,1800,1398,402,0.926277281746046,0.604166666666667,1.76807851239669,708,337,371,20,1.1,46.01,3.5,0,0,0,0,0,0,0.0289820473042595,29.5710000962825,3.49181642419272
8.7,"greedy_SVM","SVM",26,18,2012,2001,11,1900,1497,403,0.926138510959953,0.609375,1.77133164673413,711,338,373,3,1.1,48.57,3.7,0,0,0,0,0,0,0.0241350202609602,24.7384285975648,2.58493558771263
8.7,"greedy_SVM","SVM",26,19,1912,1901,11,2000,1597,403,0.926548918178396,0.604166666666667,1.77417506874427,708,340,368,-3,1.1,51.12,4,0,0,0,0,0,0,0.0178376600642756,18.4183284386886,1.93549646908409
8.7,"greedy_SVM","SVM",26,20,1812,1803,9,2100,1695,405,0.926898797713541,0.609375,1.77906709558824,712,342,370,4,1.1,53.68,4.2,0,0,0,0,0,0,0.0161176691424637,16.8434158299823,1.73550823483601
8.7,"greedy_SVM","SVM",26,21,1712,1704,8,2200,1794,406,0.926941609977332,0.609375,1.78070377184913,723,352,371,11,1.1,56.24,4.4,0,0,0,0,0,0,0.0132551256884764,13.1194147932552,1.38762270909392
8.7,"greedy_SVM","SVM",26,22,1612,1605,7,2300,1893,407,0.926720167233557,0.59375,1.7774334251607,735,360,375,12,1,58.79,4.7,0,0,0,0,0,0,0.0108668970936775,9.51705851215302,1.31467284693373
8.7,"greedy_SVM","SVM",26,23,1512,1506,6,2400,1992,408,0.926557775888133,0.59375,1.7774334251607,739,360,379,4,1.1,61.35,4.9,0,0,0,0,0,0,0.0102879798954523,8.75732237496256,1.04592307403614
8.7,"greedy_SVM","SVM",26,24,1412,1406,6,2500,2092,408,0.927195530990154,0.59375,1.77417506874427,753,366,387,14,1.1,63.91,5.1,0,0,0,0,0,0,0.00744085448151407,5.5293889833577,0.898013642193345
8.7,"greedy_SVM","SVM",26,25,1312,1306,6,2600,2192,408,0.92728410808766,0.59375,1.77417506874427,753,366,387,0,1.1,66.46,5.4,0,0,0,0,0,0,0.00650260815262827,4.98298374204706,0.707070232012251
8.7,"greedy_SVM","SVM",26,26,1212,1207,5,2700,2291,409,0.927213246409657,0.598958333333333,1.77906709558824,761,370,391,8,1.1,69.02,5.6,0,0,0,0,0,0,0.00564845560837959,3.96585671939618,0.58794254518604
8.7,"greedy_SVM","SVM",26,27,1112,1108,4,2800,2390,410,0.92671426209371,0.59375,1.7774334251607,766,374,392,5,1,71.57,5.8,0,0,0,0,0,0,0.00490385670628301,3.14940517994736,0.524375614022311
8.7,"greedy_SVM","SVM",26,28,1012,1008,4,2900,2490,410,0.926424910241859,0.59375,1.7774334251607,769,375,394,3,1.1,74.13,6.1,0,0,0,0,0,0,0.00476084292840131,2.74923793842164,0.496110969564119
8.7,"greedy_SVM","SVM",26,29,912,909,3,3000,2589,411,0.926082412131503,0.583333333333333,1.7774334251607,776,381,395,7,1,76.69,6.3,0,0,0,0,0,0,0.00394529986778735,1.99861357492507,0.417953736613113
8.7,"greedy_SVM","SVM",26,30,812,809,3,3100,2689,411,0.925796012849569,0.583333333333333,1.77906709558824,777,382,395,1,1,79.24,6.5,0,0,0,0,0,0,0.00323818525280328,1.43786429553838,0.345339926102226
8.7,"greedy_SVM","SVM",26,31,712,710,2,3200,2788,412,0.925928878495827,0.583333333333333,1.78843060661765,779,382,397,2,1,81.8,6.8,0,0,0,0,0,0,0.00302290593087241,1.2268817705311,0.328155632695401
8.7,"greedy_SVM","SVM",26,32,612,610,2,3300,2888,412,0.925853587962947,0.583333333333333,1.78843060661765,779,383,396,0,1,84.36,7,0,0,0,0,0,0,0.00266395107208532,0.958956281285894,0.291710847594324
8.7,"greedy_SVM","SVM",26,33,512,510,2,3400,2988,412,0.92597316704458,0.583333333333333,1.7867883379247,780,383,397,1,1,86.91,7.3,0,0,0,0,0,0,0.00191274721956522,0.621526900351058,0.219897846964038
8.7,"greedy_SVM","SVM",26,34,412,412,0,3500,3086,414,0.926346667139065,0.588541666666667,1.78843060661765,788,387,401,8,1,89.47,7.5,0,0,0,0,0,0,0.00219963795748501,0.6876702990298,0.266589251820803
8.7,"greedy_SVM","SVM",26,35,312,312,0,3600,3186,414,0.926153273809512,0.583333333333333,1.79337557603687,787,388,399,-1,1,92.02,7.7,0,0,0,0,0,0,0.00138250242973063,0.361264259013846,0.166988313621548
8.7,"greedy_SVM","SVM",26,36,212,212,0,3700,3286,414,0.926321570294772,0.583333333333333,1.79007589696412,793,389,404,6,1,94.58,7.9,0,0,0,0,0,0,0.00077176827546598,0.164531121829754,0.0978640524378767
8.7,"greedy_SVM","SVM",26,37,112,112,0,3800,3386,414,0.92616508408918,0.578125,1.79337557603687,797,391,406,4,1,97.14,8.2,0,0,0,0,0,0,0.000459134488994428,0.0702588098110402,0.0654018495171237
8.7,"greedy_SVM","SVM",26,38,12,12,0,3900,3486,414,0.926101603835968,0.578125,1.79172421731123,798,391,407,1,1,99.69,8.4,0,0,0,0,0,0,0.000270992260603133,0.00406233160968141,0.00406233160968141
8.7,"greedy_SVM","SVM",26,39,0,0,0,3912,3498,414,0.926135558390012,0.578125,1.7867883379247,798,391,407,0,1,100,8.4,0,0,0,0,0,0,0,0,0
8.7,"greedy_SVM","SVM",27,0,3812,3405,407,100,86,14,0.855345124910353,0.432432432432432,1.71506289699838,37,14,23,0,1.6,2.56,6.1,0,0,0,0,0,0,0.364922117690811,482.172054330704,43.7506726299466
8.7,"greedy_SVM","SVM",27,1,3712,3360,352,200,131,69,0.907940238375025,0.518918918918919,1.7426907570554,131,64,67,94,1,5.11,1.9,0,0,0,0,0,0,0.574623740232214,589.821977288737,63.5220701189794
8.7,"greedy_SVM","SVM",27,2,3612,3322,290,300,169,131,0.916379507683873,0.583783783783784,1.76377734287908,198,100,98,67,1,7.67,1.3,0,0,0,0,0,0,0.643358983640457,399.172363748132,71.1272675343035
8.7,"greedy_SVM","SVM",27,3,3512,3294,218,400,197,203,0.920774642513773,0.594594594594595,1.75404159920289,257,131,126,59,1,10.22,1,0,0,0,0,0,0,0.491144880078369,303.685061319202,60.6171727852288
8.7,"greedy_SVM","SVM",27,4,3412,3255,157,500,236,264,0.884081371037897,0.6,1.63109224927407,332,168,164,75,1,12.78,0.9,0,0,0,0,0,0,0.30280997821012,262.532581702082,42.7230903346372
8.7,"greedy_SVM","SVM",27,5,3312,3196,116,600,295,305,0.856849848154197,0.627027027027027,1.56889276373147,434,220,214,102,1,15.34,1,0,0,0,0,0,0,0.249443425394517,210.483863401447,34.9249957787041
8.7,"greedy_SVM","SVM",27,6,3212,3108,104,700,383,317,0.890686281990636,0.621621621621622,1.64382008503444,468,230,238,34,1,17.89,1.2,0,0,0,0,0,0,0.115619813443565,128.782737451315,16.8799579950238
8.7,"greedy_SVM","SVM",27,7,3112,3035,77,800,456,344,0.879576357837237,0.637837837837838,1.61167448440176,541,260,281,73,1.1,20.45,1.3,0,0,0,0,0,0,0.0972383092971539,140.421973939412,12.6457006255994
8.7,"greedy_SVM","SVM",27,8,3012,2953,59,900,538,362,0.877575655836525,0.654054054054054,1.62586232641481,583,280,303,42,1.1,23.01,1.5,0,0,0,0,0,0,0.0795055954977569,125.703029163348,9.74320457930028
8.7,"greedy_SVM","SVM",27,9,2912,2856,56,1000,635,365,0.883739527217793,0.648648648648649,1.61761614148711,599,285,314,16,1.1,25.56,1.7,0,0,0,0,0,0,0.0611362522991319,92.8029609777861,6.71233658098837
8.7,"greedy_SVM","SVM",27,10,2812,2761,51,1100,730,370,0.884395745265315,0.648648648648649,1.61315580286169,620,295,325,21,1.1,28.12,2,0,0,0,0,0,0,0.0520234792763032,71.3832158146314,5.55160808602788
8.7,"greedy_SVM","SVM",27,11,2712,2664,48,1200,827,373,0.90021212629908,0.632432432432432,1.65051001414638,637,309,328,17,1.1,30.67,2.2,0,0,0,0,0,0,0.0424250407287805,41.6495232842004,5.19487983605459
8.7,"greedy_SVM","SVM",27,12,2612,2572,40,1300,919,381,0.909788331527474,0.632432432432432,1.70374794684187,654,318,336,17,1.1,33.23,2.4,0,0,0,0,0,0,0.037958451492067,46.3513578098482,4.30505982389639
8.7,"greedy_SVM","SVM",27,13,2512,2477,35,1400,1014,386,0.920092480962064,0.632432432432432,1.72321935194863,668,325,343,14,1.1,35.79,2.6,0,0,0,0,0,0,0.0487513685469868,48.2943451293402,5.7616150883458
8.7,"greedy_SVM","SVM",27,14,2412,2381,31,1500,1110,390,0.924394524394537,0.632432432432432,1.73788995607177,689,336,353,21,1.1,38.34,2.8,0,0,0,0,0,0,0.0479725115423462,41.266139094679,5.46987256665718
8.7,"greedy_SVM","SVM",27,15,2312,2285,27,1600,1206,394,0.925873304134188,0.632432432432432,1.75242645960878,706,343,363,17,1.1,40.9,3.1,0,0,0,0,0,0,0.0406336800220359,35.5098776576917,4.57748553211897
8.7,"greedy_SVM","SVM",27,16,2212,2191,21,1700,1300,400,0.928743876569982,0.632432432432432,1.77026778388324,720,351,369,14,1.1,43.46,3.2,0,0,0,0,0,0,0.0386665670957537,31.3471230623418,4.44355426017764
8.7,"greedy_SVM","SVM",27,17,2112,2094,18,1800,1397,403,0.930341691211277,0.627027027027027,1.76539548723035,729,354,375,9,1.1,46.01,3.5,0,0,0,0,0,0,0.0336711693184814,27.0007572924402,4.0065016756592
8.7,"greedy_SVM","SVM",27,18,2012,1998,14,1900,1493,407,0.931268026920219,0.627027027027027,1.76864069952305,742,359,383,13,1.1,48.57,3.7,0,0,0,0,0,0,0.0260387370621045,23.3740728034482,3.31411310408964
8.7,"greedy_SVM","SVM",27,19,1912,1899,13,2000,1592,408,0.931562561997363,0.627027027027027,1.77189786471554,745,361,384,3,1.1,51.12,3.9,0,0,0,0,0,0,0.0202766120764709,19.1294693690402,2.22015135710352
8.7,"greedy_SVM","SVM",27,20,1812,1799,13,2100,1692,408,0.931260396477803,0.627027027027027,1.76864069952305,750,364,386,5,1.1,53.68,4.1,0,0,0,0,0,0,0.0174287960491321,14.7010597156631,1.80497947947504
8.7,"greedy_SVM","SVM",27,21,1712,1699,13,2200,1792,408,0.931544248935565,0.621621621621622,1.76864069952305,764,374,390,14,1,56.24,4.4,0,0,0,0,0,0,0.0113109888727505,7.79176513881172,1.47316028608527
8.7,"greedy_SVM","SVM",27,22,1612,1603,9,2300,1888,412,0.93185099272057,0.621621621621622,1.76701660338024,775,378,397,11,1.1,58.79,4.6,0,0,0,0,0,0,0.00986100097752491,7.85912326863068,1.14567985343097
8.7,"greedy_SVM","SVM",27,23,1512,1504,8,2400,1987,413,0.931594609855492,0.621621621621622,1.77026778388324,778,381,397,3,1,61.35,4.8,0,0,0,0,0,0,0.00922322635482825,6.60085444728889,0.956390371275099
8.7,"greedy_SVM","SVM",27,24,1412,1404,8,2500,2087,413,0.932678132678133,0.610810810810811,1.76701660338024,786,386,400,8,1,63.91,5.1,0,0,0,0,0,0,0.0066902437758287,4.43587613611397,0.812999413638758
8.7,"greedy_SVM","SVM",27,25,1312,1305,7,2600,2186,414,0.931976131976138,0.610810810810811,1.76701660338024,790,387,403,4,1,66.46,5.3,0,0,0,0,0,0,0.00615797761077999,3.85346010737804,0.64674271309634
8.7,"greedy_SVM","SVM",27,26,1212,1206,6,2700,2285,415,0.933001663436443,0.616216216216216,1.76701660338024,793,389,404,3,1,69.02,5.5,0,0,0,0,0,0,0.00479525436795132,2.83873752768359,0.523882116588347
8.7,"greedy_SVM","SVM",27,27,1112,1108,4,2800,2383,417,0.933413707326747,0.616216216216216,1.76216216216216,803,395,408,10,1,71.57,5.7,0,0,0,0,0,0,0.00489264282714318,2.63140014400586,0.538595465649478
8.7,"greedy_SVM","SVM",27,28,1012,1009,3,2900,2482,418,0.934118760205711,0.610810810810811,1.76701660338024,808,397,411,5,1,74.13,5.9,0,0,0,0,0,0,0.00442850908766951,2.17728032155918,0.49582196072871
8.7,"greedy_SVM","SVM",27,29,912,909,3,3000,2582,418,0.934076029728198,0.610810810810811,1.76377734287908,808,397,411,0,1,76.69,6.2,0,0,0,0,0,0,0.0039358830984025,1.78228923240765,0.424254966304876
8.7,"greedy_SVM","SVM",27,30,812,809,3,3100,2682,418,0.934123338471159,0.610810810810811,1.76864069952305,809,397,412,1,1,79.24,6.4,0,0,0,0,0,0,0.00291572100466614,1.17589916905692,0.316837156397883
8.7,"greedy_SVM","SVM",27,31,712,709,3,3200,2782,418,0.934274421230937,0.610810810810811,1.77353095030514,808,397,411,-1,1,81.8,6.7,0,0,0,0,0,0,0.00245287316112134,0.896743397733345,0.271724536640558
8.7,"greedy_SVM","SVM",27,32,612,609,3,3300,2882,418,0.934294260381212,0.610810810810811,1.76864069952305,809,397,412,1,1,84.36,6.9,0,0,0,0,0,0,0.00188469242599542,0.640269680659732,0.221870193229807
8.7,"greedy_SVM","SVM",27,33,512,509,3,3400,2982,418,0.934466708379747,0.610810810810811,1.76701660338024,811,399,412,2,1,86.91,7.1,0,0,0,0,0,0,0.00130425910857701,0.398106212839957,0.154414078001371
8.7,"greedy_SVM","SVM",27,34,412,411,1,3500,3080,420,0.933703664138443,0.610810810810811,1.77026778388324,818,402,416,7,1,89.47,7.3,0,0,0,0,0,0,0.00159671588297461,0.480679231016196,0.202102208615016
8.7,"greedy_SVM","SVM",27,35,312,312,0,3600,3179,421,0.933917316526008,0.605405405405405,1.76539548723035,828,406,422,10,1,92.02,7.6,0,0,0,0,0,0,0.00144574028042854,0.363133468608184,0.175765316075507
8.7,"greedy_SVM","SVM",27,36,212,212,0,3700,3279,421,0.933775390297124,0.605405405405405,1.76864069952305,830,408,422,2,1,94.58,7.8,0,0,0,0,0,0,0.000695542923822745,0.147931728371863,0.0915171900346435
8.7,"greedy_SVM","SVM",27,37,112,112,0,3800,3379,421,0.933746394615955,0.605405405405405,1.77353095030514,834,409,425,4,1,97.14,8,0,0,0,0,0,0,0.000320844443170506,0.0527339297529452,0.0491107542857445
8.7,"greedy_SVM","SVM",27,38,12,12,0,3900,3479,421,0.933758603323816,0.605405405405405,1.77353095030514,835,409,426,1,1,99.69,8.3,0,0,0,0,0,0,0.00024286129629932,0.00329953853744027,0.00329953853744027
8.7,"greedy_SVM","SVM",27,39,0,0,0,3912,3491,421,0.933709768492373,0.605405405405405,1.77353095030514,835,409,426,0,1,100,8.3,0,0,0,0,0,0,0,0,0
8.7,"greedy_SVM","SVM",28,0,3812,3424,388,100,89,11,0.906384048303665,0.584541062801932,1.72438389100381,26,11,15,0,1.4,2.56,8.1,0,0,0,0,0,0,0.376779011708992,433.854934481663,42.1197810542578
8.7,"greedy_SVM","SVM",28,1,3712,3385,327,200,128,72,0.924363956767575,0.594202898550725,1.77500200176155,101,50,51,75,1,5.11,1.8,0,0,0,0,0,0,0.798697094823185,468.673982940456,85.0282231445491
8.7,"greedy_SVM","SVM",28,2,3612,3352,260,300,161,139,0.923105818922064,0.584541062801932,1.76792893875643,161,82,79,60,1,7.67,1.2,0,0,0,0,0,0,0.576333178963388,241.167805930781,69.0223975542845
8.7,"greedy_SVM","SVM",28,3,3512,3318,194,400,195,205,0.91219827479057,0.594202898550725,1.73540410694561,234,119,115,73,1,10.22,1,0,0,0,0,0,0,0.419372534822217,190.025809430936,51.4842564958537
8.7,"greedy_SVM","SVM",28,4,3412,3256,156,500,257,243,0.899643136312537,0.63768115942029,1.7109441602728,330,168,162,96,1,12.78,1.1,0,0,0,0,0,0,0.221402834433101,121.010224755854,31.2466251969506
8.7,"greedy_SVM","SVM",28,5,3312,3192,120,600,321,279,0.877699610267302,0.657004830917874,1.62409420289855,406,200,206,76,1,15.34,1.2,0,0,0,0,0,0,0.188992041483311,128.421637787902,27.8356805949773
8.7,"greedy_SVM","SVM",28,6,3212,3108,104,700,405,295,0.882373088279575,0.661835748792271,1.62858478594804,449,220,229,43,1,17.89,1.4,0,0,0,0,0,0,0.0874777449646617,69.5587801275474,12.1327281113872
8.7,"greedy_SVM","SVM",28,7,3112,3023,89,800,490,310,0.888607154398799,0.661835748792271,1.64297428102876,491,235,256,42,1.1,20.45,1.6,0,0,0,0,0,0,0.0640512469864277,58.3146814366507,7.5965187905682
8.7,"greedy_SVM","SVM",28,8,3012,2937,75,900,576,324,0.892474098380579,0.666666666666667,1.63428129541485,520,249,271,29,1.1,23.01,1.8,0,0,0,0,0,0,0.0522204975763363,56.0993740207675,6.41798435456401
8.7,"greedy_SVM","SVM",28,9,2912,2851,61,1000,662,338,0.887656991020401,0.676328502415459,1.63428129541485,555,268,287,35,1.1,25.56,2,0,0,0,0,0,0,0.0513303144868786,71.5789038307746,7.08107583890827
8.7,"greedy_SVM","SVM",28,10,2812,2762,50,1100,751,349,0.896376949699342,0.661835748792271,1.64448714869085,583,280,303,28,1.1,28.12,2.2,0,0,0,0,0,0,0.0487851388720076,68.1634076136219,5.5141636429216
8.7,"greedy_SVM","SVM",28,11,2712,2668,44,1200,845,355,0.908212560386482,0.676328502415459,1.68488917306053,600,290,310,17,1.1,30.67,2.4,0,0,0,0,0,0,0.0491900493275993,70.5624873731962,5.27475009390738
8.7,"greedy_SVM","SVM",28,12,2612,2571,41,1300,942,358,0.919680811395337,0.666666666666667,1.71567488145328,617,304,313,17,1,33.23,2.6,0,0,0,0,0,0,0.0356199506128757,40.552599722023,4.18558894924223
8.7,"greedy_SVM","SVM",28,13,2512,2475,37,1400,1038,362,0.926737984162122,0.661835748792271,1.71647387315517,625,306,319,8,1,35.79,2.9,0,0,0,0,0,0,0.0433322757886581,52.2940917176616,5.01185869086554
8.7,"greedy_SVM","SVM",28,14,2412,2384,28,1500,1129,371,0.934155611350037,0.652173913043478,1.75981917298232,662,321,341,37,1.1,38.34,3,0,0,0,0,0,0,0.0672373134493311,56.2213015517224,7.80573982626159
8.7,"greedy_SVM","SVM",28,15,2312,2285,27,1600,1228,372,0.934648646707724,0.657004830917874,1.76848823294775,673,328,345,11,1.1,40.9,3.3,0,0,0,0,0,0,0.0594135171870919,44.4867248598091,6.21959074206385
8.7,"greedy_SVM","SVM",28,16,2212,2188,24,1700,1325,375,0.934724604535939,0.652173913043478,1.77173913043478,682,331,351,9,1.1,43.46,3.5,0,0,0,0,0,0,0.0494971121771297,32.9072039227001,5.5421387770601
8.7,"greedy_SVM","SVM",28,17,2112,2091,21,1800,1422,378,0.934593404650839,0.661835748792271,1.77663794830695,690,334,356,8,1.1,46.01,3.8,0,0,0,0,0,0,0.0413790380447968,28.6140397394075,5.07814688846593
8.7,"greedy_SVM","SVM",28,18,2012,1998,14,1900,1515,385,0.933728866460619,0.661835748792271,1.76792893875643,715,343,372,25,1.1,48.57,3.9,0,0,0,0,0,0,0.031468421605365,24.4073458305846,4.20284702123843
8.7,"greedy_SVM","SVM",28,19,1912,1900,12,2000,1613,387,0.932677886328426,0.661835748792271,1.76630101155684,723,345,378,8,1.1,51.12,4.2,0,0,0,0,0,0,0.0235822066704536,19.3844007624598,2.74363314718734
8.7,"greedy_SVM","SVM",28,20,1812,1800,12,2100,1713,387,0.933198542714551,0.661835748792271,1.77663794830695,720,346,374,-3,1.1,53.68,4.4,0,0,0,0,0,0,0.0190246099006698,15.9700745932962,2.07804920923681
8.7,"greedy_SVM","SVM",28,21,1712,1700,12,2200,1813,387,0.933159873274736,0.657004830917874,1.77663794830695,723,347,376,3,1.1,56.24,4.7,0,0,0,0,0,0,0.0137764171122019,11.9937857526595,1.51781166695899
8.7,"greedy_SVM","SVM",28,22,1612,1601,11,2300,1912,388,0.932386484478378,0.657004830917874,1.77336906523739,727,350,377,4,1.1,58.79,4.9,0,0,0,0,0,0,0.0141341155550945,10.7649676678651,1.4229348352579
8.7,"greedy_SVM","SVM",28,23,1512,1501,11,2400,2012,388,0.932571545368939,0.657004830917874,1.78534695785748,745,364,381,18,1,61.35,5.2,0,0,0,0,0,0,0.00867662825845764,5.17946217144194,1.18715719059543
8.7,"greedy_SVM","SVM",28,24,1412,1402,10,2500,2111,389,0.932636454785777,0.657004830917874,1.78370299196626,749,365,384,4,1.1,63.91,5.4,0,0,0,0,0,0,0.00600653276828781,3.91238969595445,0.709246508934224
8.7,"greedy_SVM","SVM",28,25,1312,1304,8,2600,2209,391,0.933176445891803,0.657004830917874,1.7820620508513,756,365,391,7,1.1,66.46,5.6,0,0,0,0,0,0,0.00558642288727495,3.51222103339101,0.583823568419641
8.7,"greedy_SVM","SVM",28,26,1212,1204,8,2700,2309,391,0.93356866449567,0.657004830917874,1.7820620508513,761,371,390,5,1.1,69.02,5.9,0,0,0,0,0,0,0.0040973754355129,2.38895839922376,0.454547418236542
8.7,"greedy_SVM","SVM",28,27,1112,1105,7,2800,2408,392,0.933739914872005,0.657004830917874,1.78370299196626,768,372,396,7,1.1,71.57,6.1,0,0,0,0,0,0,0.00453262393973748,2.25220845772199,0.469103999915192
8.7,"greedy_SVM","SVM",28,28,1012,1006,6,2900,2507,393,0.933952596791005,0.657004830917874,1.794055967408,772,377,395,4,1,74.13,6.4,0,0,0,0,0,0,0.00397833276336658,1.73321080366066,0.428868270594177
8.7,"greedy_SVM","SVM",28,29,912,906,6,3000,2607,393,0.934110036653121,0.647342995169082,1.79075503646521,775,378,397,3,1.1,76.69,6.6,0,0,0,0,0,0,0.00301274175173007,1.15791930983521,0.328854785659034
8.7,"greedy_SVM","SVM",28,30,812,807,5,3100,2706,394,0.93422880707542,0.647342995169082,1.79075503646521,777,379,398,2,1.1,79.24,6.9,0,0,0,0,0,0,0.00251960831962283,0.861375198591954,0.282118316175602
8.7,"greedy_SVM","SVM",28,31,712,708,4,3200,2805,395,0.934455299508639,0.652173913043478,1.79240398217098,783,383,400,6,1,81.8,7.1,0,0,0,0,0,0,0.00236857232818626,0.732102635254746,0.265040489735779
8.7,"greedy_SVM","SVM",28,32,612,609,3,3300,2904,396,0.934807467621269,0.652173913043478,1.79240398217098,784,383,401,1,1,84.36,7.3,0,0,0,0,0,0,0.00166085447616054,0.498786872464481,0.210102314664812
8.7,"greedy_SVM","SVM",28,33,512,510,2,3400,3003,397,0.934677648787596,0.647342995169082,1.79240398217098,787,385,402,3,1,86.91,7.6,0,0,0,0,0,0,0.00108208096898727,0.344640698081715,0.147238434486219
8.7,"greedy_SVM","SVM",28,34,412,410,2,3500,3103,397,0.934803324467003,0.642512077294686,1.79075503646521,791,386,405,4,1,89.47,7.8,0,0,0,0,0,0,0.00062992780702066,0.176825196161249,0.0799287788473014
8.7,"greedy_SVM","SVM",28,35,312,312,0,3600,3201,399,0.935272881950508,0.642512077294686,1.79240398217098,804,392,412,13,1.1,92.02,8,0,0,0,0,0,0,0.000626402947138306,0.154365244733432,0.0825486591288349
8.7,"greedy_SVM","SVM",28,36,212,212,0,3700,3301,399,0.935355745035832,0.642512077294686,1.78582635287861,809,393,416,5,1.1,94.58,8.3,0,0,0,0,0,0,0.000254955259342545,0.0543447155019662,0.0353647985035353
8.7,"greedy_SVM","SVM",28,37,112,112,0,3800,3401,399,0.935817016210803,0.647342995169082,1.794055967408,812,394,418,3,1.1,97.14,8.5,0,0,0,0,0,0,0.000129227138038334,0.0224349371841451,0.0211066472264975
8.7,"greedy_SVM","SVM",28,38,12,12,0,3900,3501,399,0.936122228575081,0.642512077294686,1.78582635287861,812,395,417,0,1.1,99.69,8.8,0,0,0,0,0,0,6.06257172246843e-05,0.00101457538858486,0.00101457538858486
8.7,"greedy_SVM","SVM",28,39,0,0,0,3912,3513,399,0.936210615866093,0.642512077294686,1.78582635287861,812,395,417,0,1.1,100,8.8,0,0,0,0,0,0,0,0,0
8.7,"greedy_SVM","SVM",29,0,3812,3411,401,100,87,13,0.906131897203331,0.520833333333333,1.76520737327189,35,13,22,0,1.7,2.56,6.7,0,0,0,0,0,0,0.414230258737418,509.352499160239,45.7212500793063
8.7,"greedy_SVM","SVM",29,1,3712,3365,347,200,133,67,0.901874291383225,0.572916666666667,1.70568389752973,120,58,62,85,1.1,5.11,2,0,0,0,0,0,0,0.684053056981475,580.385133283157,75.1026272972581
8.7,"greedy_SVM","SVM",29,2,3612,3337,275,300,161,139,0.91270284155329,0.598958333333333,1.74482044198895,172,87,85,52,1,7.67,1.2,0,0,0,0,0,0,0.587750552666611,333.895774593811,68.8057150247446
8.7,"greedy_SVM","SVM",29,3,3512,3305,207,400,193,207,0.890462608654579,0.583333333333333,1.67452938475666,240,121,119,68,1,10.22,0.9,0,0,0,0,0,0,0.468062948188234,344.487924980916,55.9991653704707
8.7,"greedy_SVM","SVM",29,4,3412,3252,160,500,246,254,0.893689767573693,0.614583333333333,1.64646464646465,333,170,163,93,1,12.78,1,0,0,0,0,0,0,0.326403823341438,243.83678240456,43.0560012713943
8.7,"greedy_SVM","SVM",29,5,3312,3192,120,600,306,294,0.896993693310666,0.614583333333333,1.66517447199265,415,205,210,82,1,15.34,1,0,0,0,0,0,0,0.240690428888539,235.507077586614,33.1383290017241
8.7,"greedy_SVM","SVM",29,6,3212,3117,95,700,381,319,0.874347482048373,0.635416666666667,1.59529532967033,476,233,243,61,1,17.89,1.2,0,0,0,0,0,0,0.134076676823029,197.974362907665,18.9134524148852
8.7,"greedy_SVM","SVM",29,7,3112,3038,74,800,460,340,0.882072881235826,0.640625,1.61988740808824,544,260,284,68,1.1,20.45,1.4,0,0,0,0,0,0,0.10784607700845,165.981776021196,12.7447276186973
8.7,"greedy_SVM","SVM",29,8,3012,2947,65,900,551,349,0.890852347883602,0.630208333333333,1.66039364640884,565,271,294,21,1.1,23.01,1.6,0,0,0,0,0,0,0.0800749953579278,111.463393707303,9.11330998107068
8.7,"greedy_SVM","SVM",29,9,2912,2852,60,1000,646,354,0.891180083144384,0.635416666666667,1.6713133640553,589,283,306,24,1.1,25.56,1.8,0,0,0,0,0,0,0.0706589318525156,100.117610430487,8.11776178364008
8.7,"greedy_SVM","SVM",29,10,2812,2758,54,1100,740,360,0.894680354780805,0.635416666666667,1.66670496323529,603,290,313,14,1.1,28.12,2.1,0,0,0,0,0,0,0.055964552482375,76.2407214868187,6.06226722614787
8.7,"greedy_SVM","SVM",29,11,2712,2658,54,1200,840,360,0.896128590325024,0.635416666666667,1.66212190650779,604,291,313,1,1.1,30.67,2.3,0,0,0,0,0,0,0.0423282918795865,56.9744589979216,4.56381191522601
8.7,"greedy_SVM","SVM",29,12,2612,2563,49,1300,935,365,0.904292446145138,0.635416666666667,1.69791666666667,621,299,322,17,1.1,33.23,2.6,0,0,0,0,0,0,0.0403810263706109,54.3682268932741,4.21309973846341
8.7,"greedy_SVM","SVM",29,13,2512,2466,46,1400,1032,368,0.921133904950865,0.630208333333333,1.71509889604416,654,318,336,33,1.1,35.79,2.8,0,0,0,0,0,0,0.033154041987406,25.2439477108912,4.33244944944842
8.7,"greedy_SVM","SVM",29,14,2412,2372,40,1500,1126,374,0.924563314909295,0.625,1.72605893186004,664,324,340,10,1,38.34,3,0,0,0,0,0,0,0.0289716736732072,26.0880291573436,3.28361537589261
8.7,"greedy_SVM","SVM",29,15,2312,2281,31,1600,1217,383,0.928946404950867,0.625,1.74321527138914,694,338,356,30,1.1,40.9,3.2,0,0,0,0,0,0,0.0299676056669716,30.0063242179953,3.49462419378361
8.7,"greedy_SVM","SVM",29,16,2212,2190,22,1700,1308,392,0.927586746504151,0.630208333333333,1.75420119705341,719,351,368,25,1,43.46,3.3,0,0,0,0,0,0,0.0615599404497975,40.9986150610266,7.50032502500136
8.7,"greedy_SVM","SVM",29,17,2112,2090,22,1800,1408,392,0.927731422430079,0.630208333333333,1.76034007352941,726,356,370,7,1,46.01,3.6,0,0,0,0,0,0,0.0445208121467784,27.3237959452096,4.8812560716192
8.7,"greedy_SVM","SVM",29,18,2012,1998,14,1900,1500,400,0.927555744520025,0.635416666666667,1.76520737327189,748,365,383,22,1,48.57,3.8,0,0,0,0,0,0,0.0493470757303742,24.7223039737947,5.63637585147976
8.7,"greedy_SVM","SVM",29,19,1912,1903,9,2000,1595,405,0.927284108087675,0.635416666666667,1.76195952161914,760,369,391,12,1.1,51.12,3.9,0,0,0,0,0,0,0.033152346802936,19.6893795190832,4.47469676237118
8.7,"greedy_SVM","SVM",29,20,1812,1805,7,2100,1693,407,0.927093667328036,0.640625,1.76034007352941,766,371,395,6,1.1,53.68,4.2,0,0,0,0,0,0,0.0201291718920647,15.4391630967902,2.5754018241913
8.7,"greedy_SVM","SVM",29,21,1712,1706,6,2200,1792,408,0.927473072562355,0.640625,1.76195952161914,769,371,398,3,1.1,56.24,4.4,0,0,0,0,0,0,0.0156840340110235,13.1465658040748,1.75257354788559
8.7,"greedy_SVM","SVM",29,22,1612,1607,5,2300,1891,409,0.927986819727891,0.635416666666667,1.76195952161914,770,370,400,1,1.1,58.79,4.6,0,0,0,0,0,0,0.012188377550057,10.7570867345549,1.33056922610036
8.7,"greedy_SVM","SVM",29,23,1512,1508,4,2400,1990,410,0.928166926492818,0.635416666666667,1.76195952161914,782,376,406,12,1.1,61.35,4.9,0,0,0,0,0,0,0.011996980871488,9.69321409590598,1.23551529348006
8.7,"greedy_SVM","SVM",29,24,1412,1408,4,2500,2090,410,0.928940499811037,0.619791666666667,1.75872359963269,789,383,406,7,1.1,63.91,5.1,0,0,0,0,0,0,0.00833775188440992,5.85158456863757,0.984020828012734
8.7,"greedy_SVM","SVM",29,25,1312,1308,4,2600,2190,410,0.928840112433864,0.625,1.76034007352941,789,383,406,0,1.1,66.46,5.3,0,0,0,0,0,0,0.00697406266649968,4.74334756749047,0.734728453206312
8.7,"greedy_SVM","SVM",29,26,1212,1208,4,2700,2290,410,0.928955262660621,0.619791666666667,1.76358195211786,795,385,410,6,1.1,69.02,5.6,0,0,0,0,0,0,0.00619705422955431,3.87306704762281,0.653415419809194
8.7,"greedy_SVM","SVM",29,27,1112,1109,3,2800,2389,411,0.929219517668179,0.619791666666667,1.76358195211786,797,386,411,2,1.1,71.57,5.8,0,0,0,0,0,0,0.00554375832407329,3.13786327462693,0.57662719305869
8.7,"greedy_SVM","SVM",29,28,1012,1009,3,2900,2489,411,0.929424721277401,0.619791666666667,1.75420119705341,801,387,414,4,1.1,74.13,6.1,0,0,0,0,0,0,0.00439668687630876,2.20064139718331,0.461449427069078
8.7,"greedy_SVM","SVM",29,29,912,910,2,3000,2588,412,0.929590065192745,0.614583333333333,1.75581797235023,806,391,415,5,1.1,76.69,6.3,0,0,0,0,0,0,0.00409705396925588,1.83541195967311,0.431509294407783
8.7,"greedy_SVM","SVM",29,30,812,810,2,3100,2688,412,0.929581207482997,0.614583333333333,1.75258739650414,807,391,416,1,1.1,79.24,6.5,0,0,0,0,0,0,0.00359709837792951,1.38033164343725,0.380466733857248
8.7,"greedy_SVM","SVM",29,31,712,710,2,3200,2788,412,0.929699310279672,0.614583333333333,1.75258739650414,809,393,416,2,1.1,81.8,6.8,0,0,0,0,0,0,0.00266169976138718,0.887465199208792,0.295795818840542
8.7,"greedy_SVM","SVM",29,32,612,611,1,3300,2887,413,0.929846938775516,0.614583333333333,1.75258739650414,808,394,414,-1,1.1,84.36,7,0,0,0,0,0,0,0.00229314128143915,0.742989301041706,0.284073872546645
8.7,"greedy_SVM","SVM",29,33,512,511,1,3400,2987,413,0.930139243197287,0.614583333333333,1.75258739650414,809,395,414,1,1,86.91,7.2,0,0,0,0,0,0,0.00120343993925669,0.394658995414144,0.160554050918217
8.7,"greedy_SVM","SVM",29,34,412,412,0,3500,3086,414,0.93058655753969,0.614583333333333,1.7509765625,817,398,419,8,1.1,89.47,7.5,0,0,0,0,0,0,0.00106075472674959,0.322963146067876,0.129206149694876
8.7,"greedy_SVM","SVM",29,35,312,312,0,3600,3186,414,0.931184452947856,0.609375,1.75258739650414,824,399,425,7,1.1,92.02,7.7,0,0,0,0,0,0,0.000688225813331236,0.169564647392348,0.0820100827761356
8.7,"greedy_SVM","SVM",29,36,212,212,0,3700,3286,414,0.931746917517021,0.604166666666667,1.75420119705341,827,402,425,3,1.1,94.58,7.9,0,0,0,0,0,0,0.000381538308374944,0.078447424326579,0.0496290276750354
8.7,"greedy_SVM","SVM",29,37,112,112,0,3800,3386,414,0.931801540060481,0.598958333333333,1.75581797235023,826,403,423,-1,1,97.14,8.2,0,0,0,0,0,0,0.000174412155245605,0.0285626793200401,0.0266692857697335
8.7,"greedy_SVM","SVM",29,38,12,12,0,3900,3486,414,0.932067271352998,0.598958333333333,1.75581797235023,827,404,423,1,1,99.69,8.4,0,0,0,0,0,0,0.0001171299128853,0.00157531267182496,0.00157531267182496
8.7,"greedy_SVM","SVM",29,39,0,0,0,3912,3498,414,0.932020030234328,0.59375,1.74616177818515,827,404,423,0,1,100,8.4,0,0,0,0,0,0,0,0,0
8.7,"greedy_SVM","SVM",30,0,3812,3413,399,100,89,11,0.895785018552878,0.510204081632653,1.76646059883808,30,11,19,0,1.7,2.56,8.1,0,0,0,0,0,0,0.556675881395441,413.890762576428,60.690153567206
8.7,"greedy_SVM","SVM",30,1,3712,3383,329,200,119,81,0.906352910482375,0.510204081632653,1.79449541284404,100,51,49,70,1,5.11,1.5,0,0,0,0,0,0,0.629387791162532,349.753529117619,68.4598324782009
8.7,"greedy_SVM","SVM",30,2,3612,3362,250,300,140,160,0.905383232838592,0.535714285714286,1.77455620194916,147,77,70,47,0.9,7.67,0.9,0,0,0,0,0,0,0.533848427242894,233.596496293852,61.6940129215628
8.7,"greedy_SVM","SVM",30,3,3512,3315,197,400,187,213,0.900762407235614,0.520408163265306,1.75677607448509,233,122,111,86,0.9,10.22,0.9,0,0,0,0,0,0,0.328080914698944,151.206212499049,45.1857362865126
8.7,"greedy_SVM","SVM",30,4,3412,3259,153,500,243,257,0.864139320500926,0.571428571428571,1.65716158022842,326,167,159,93,1,12.78,0.9,0,0,0,0,0,0,0.168715841096942,93.0736458817804,27.280629527841
8.7,"greedy_SVM","SVM",30,5,3312,3197,115,600,305,295,0.872393900742109,0.586734693877551,1.66173516324653,398,198,200,72,1,15.34,1,0,0,0,0,0,0,0.108716518221483,65.8012323827043,16.9746658375139
8.7,"greedy_SVM","SVM",30,6,3212,3119,93,700,383,317,0.875217416512062,0.596938775510204,1.6356973728718,460,225,235,62,1,17.89,1.2,0,0,0,0,0,0,0.0682709040782115,46.7465039828264,10.2821016263988
8.7,"greedy_SVM","SVM",30,7,3112,3037,75,800,465,335,0.871924281076068,0.612244897959184,1.6188093670648,501,246,255,41,1,20.45,1.4,0,0,0,0,0,0,0.0446007547968199,37.6505826502064,7.44485047499059
8.7,"greedy_SVM","SVM",30,8,3012,2959,53,900,543,357,0.874724605751386,0.612244897959184,1.62501173422451,553,270,283,52,1,23.01,1.5,0,0,0,0,0,0,0.063303583964245,82.5482913218378,7.4565387987271
8.7,"greedy_SVM","SVM",30,9,2912,2869,43,1000,633,367,0.886357838589988,0.61734693877551,1.63720492805417,580,281,299,27,1.1,25.56,1.7,0,0,0,0,0,0,0.0479558605596044,67.1244807362569,5.73296028182738
8.7,"greedy_SVM","SVM",30,10,2812,2775,37,1100,727,373,0.896469155844154,0.607142857142857,1.64186299519808,597,291,306,17,1.1,28.12,1.9,0,0,0,0,0,0,0.0441673986856046,63.0646604246731,5.4604566604347
8.7,"greedy_SVM","SVM",30,11,2712,2685,27,1200,817,383,0.906609461966591,0.602040816326531,1.70002255045665,629,303,326,32,1.1,30.67,2.1,0,0,0,0,0,0,0.0647545248378574,70.2007089230615,7.6114553499383
8.7,"greedy_SVM","SVM",30,12,2612,2586,26,1300,916,384,0.907418251391458,0.602040816326531,1.6968975090036,647,313,334,18,1.1,33.23,2.4,0,0,0,0,0,0,0.0526159135720768,50.9020062382059,5.85099896294315
8.7,"greedy_SVM","SVM",30,13,2512,2488,24,1400,1014,386,0.909664888682739,0.602040816326531,1.71682030677957,656,318,338,9,1.1,35.79,2.6,0,0,0,0,0,0,0.0446900303652604,40.4894229993827,4.97346355185718
8.7,"greedy_SVM","SVM",30,14,2412,2391,21,1500,1111,389,0.909470663265298,0.607142857142857,1.72600116403507,666,321,345,10,1.1,38.34,2.9,0,0,0,0,0,0,0.0388334475405843,32.9464198973447,4.78846876166814
8.7,"greedy_SVM","SVM",30,15,2312,2298,14,1600,1204,396,0.910534554730978,0.602040816326531,1.73518202129058,681,331,350,15,1.1,40.9,3,0,0,0,0,0,0,0.0360224134475877,31.7886742930682,4.47160936853278
8.7,"greedy_SVM","SVM",30,16,2212,2205,7,1700,1297,403,0.910560644712423,0.596938775510204,1.72600116403507,702,338,364,21,1.1,43.46,3.2,0,0,0,0,0,0,0.0276435663756457,27.574202582236,3.37036326156716
8.7,"greedy_SVM","SVM",30,17,2112,2106,6,1800,1396,404,0.910143205009269,0.596938775510204,1.72283128127284,704,341,363,2,1.1,46.01,3.5,0,0,0,0,0,0,0.0217653834777215,21.7720357520841,2.38908604943644
8.7,"greedy_SVM","SVM",30,18,2012,2006,6,1900,1496,404,0.909818529684594,0.596938775510204,1.72283128127284,705,341,364,1,1.1,48.57,3.7,0,0,0,0,0,0,0.0169835927900919,16.9889585154677,1.84983947653912
8.7,"greedy_SVM","SVM",30,19,1912,1907,5,2000,1595,405,0.909888102968456,0.612244897959184,1.72723704866562,713,344,369,8,1.1,51.12,3.9,0,0,0,0,0,0,0.0145772064833885,14.5366715028316,1.5724397053852
8.7,"greedy_SVM","SVM",30,20,1812,1807,5,2100,1695,405,0.910027249536176,0.607142857142857,1.74275960384154,715,346,369,2,1.1,53.68,4.2,0,0,0,0,0,0,0.0111862918544438,10.1186804435746,1.17662117684672
8.7,"greedy_SVM","SVM",30,21,1712,1707,5,2200,1795,405,0.911304209183666,0.596938775510204,1.76434772804149,726,357,369,11,1,56.24,4.4,0,0,0,0,0,0,0.00675236620993792,5.47620092982119,0.892923483683557
8.7,"greedy_SVM","SVM",30,22,1612,1607,5,2300,1895,405,0.911353490259732,0.596938775510204,1.76434772804149,726,357,369,0,1,58.79,4.7,0,0,0,0,0,0,0.00624390677240405,4.94234083094608,0.644111995784674
8.7,"greedy_SVM","SVM",30,23,1512,1507,5,2400,1995,405,0.913408801020397,0.596938775510204,1.76434772804149,740,363,377,14,1,61.35,4.9,0,0,0,0,0,0,0.00477375862131293,3.51043424949802,0.590816166096048
8.7,"greedy_SVM","SVM",30,24,1412,1407,5,2500,2095,405,0.913413149350638,0.596938775510204,1.76434772804149,735,361,374,-5,1,63.91,5.2,0,0,0,0,0,0,0.00396152765337791,2.72618390527547,0.406345205481279
8.7,"greedy_SVM","SVM",30,25,1312,1307,5,2600,2195,405,0.913730577458246,0.596938775510204,1.76434772804149,748,369,379,13,1,66.46,5.4,0,0,0,0,0,0,0.00320660318430189,2.14966629910986,0.376589233886811
8.7,"greedy_SVM","SVM",30,26,1212,1207,5,2700,2295,405,0.913908858998135,0.596938775510204,1.76272459305709,749,369,380,1,1,69.02,5.7,0,0,0,0,0,0,0.00265305429048401,1.54304791475705,0.272240467117148
8.7,"greedy_SVM","SVM",30,27,1112,1107,5,2800,2395,405,0.914369782003705,0.591836734693878,1.76597385497978,755,372,383,6,1,71.57,5.9,0,0,0,0,0,0,0.00231639358400799,1.27402266928224,0.257969679282002
8.7,"greedy_SVM","SVM",30,28,1012,1007,5,2900,2495,405,0.914384276437842,0.591836734693878,1.75787305747987,755,372,383,0,1,74.13,6.2,0,0,0,0,0,0,0.00165354795138616,0.781712665905064,0.172924048117076
8.7,"greedy_SVM","SVM",30,29,912,908,4,3000,2594,406,0.915420628478659,0.591836734693878,1.75787305747987,758,374,384,3,1,76.69,6.4,0,0,0,0,0,0,0.00165191585321409,0.687584388772893,0.1782276693557
8.7,"greedy_SVM","SVM",30,30,812,809,3,3100,2693,407,0.915380044063075,0.591836734693878,1.76110444177671,764,375,389,6,1,79.24,6.6,0,0,0,0,0,0,0.00162798804940656,0.641684143205832,0.180056895780275
8.7,"greedy_SVM","SVM",30,31,712,709,3,3200,2793,407,0.915584415584411,0.586734693877551,1.75787305747987,765,375,390,1,1,81.8,6.9,0,0,0,0,0,0,0.00122870283265069,0.438100854221005,0.138440407688929
8.7,"greedy_SVM","SVM",30,32,612,609,3,3300,2893,407,0.915572820037101,0.586734693877551,1.75948726598077,765,375,390,0,1,84.36,7.1,0,0,0,0,0,0,0.000951666089470651,0.30660594404235,0.110292836889548
8.7,"greedy_SVM","SVM",30,33,512,509,3,3400,2993,407,0.915810528756952,0.586734693877551,1.76272459305709,767,376,391,2,1,86.91,7.4,0,0,0,0,0,0,0.000588780696089817,0.175702200060838,0.0726335755156304
8.7,"greedy_SVM","SVM",30,34,412,411,1,3500,3091,409,0.916071428571423,0.586734693877551,1.78108630756811,777,380,397,10,1,89.47,7.6,0,0,0,0,0,0,0.000595256121323729,0.181445508515446,0.0757106516480191
8.7,"greedy_SVM","SVM",30,35,312,312,0,3600,3190,410,0.916333777829307,0.586734693877551,1.77944927971188,784,382,402,7,1.1,92.02,7.8,0,0,0,0,0,0,0.000537123223236626,0.136344062207897,0.0647598448806356
8.7,"greedy_SVM","SVM",30,36,212,212,0,3700,3290,410,0.916555542671608,0.586734693877551,1.78272635020859,787,385,402,3,1,94.58,8,0,0,0,0,0,0,0.000325646844092394,0.0700585508276036,0.0426996919662775
8.7,"greedy_SVM","SVM",30,37,112,112,0,3800,3390,410,0.916570037105747,0.581632653061224,1.78436941596915,788,388,400,1,1,97.14,8.3,0,0,0,0,0,0,0.000166978047255248,0.0251715495002315,0.023371717929762
8.7,"greedy_SVM","SVM",30,38,12,12,0,3900,3490,410,0.916684543135433,0.581632653061224,1.78272635020859,791,389,402,3,1,99.69,8.5,0,0,0,0,0,0,0.000120634790221941,0.00161752653488874,0.00161752653488874
8.7,"greedy_SVM","SVM",30,39,0,0,0,3912,3502,410,0.916790352504635,0.581632653061224,1.78108630756811,792,389,403,1,1,100,8.5,0,0,0,0,0,0,0,0,0
8.7,"greedy_SVM","SVM",31,0,3812,3393,419,100,93,7,0.90400400400401,0.572222222222222,1.74267281105991,20,7,13,0,1.9,2.56,13.3,0,0,0,0,0,0,0.237837734096459,282.155498849517,26.4060794932687
8.7,"greedy_SVM","SVM",31,1,3712,3358,354,200,128,72,0.923124687187188,0.533333333333333,1.79109883364027,91,45,46,71,1,5.11,1.8,0,0,0,0,0,0,0.791340224251517,413.968973143107,84.2860510736464
8.7,"greedy_SVM","SVM",31,2,3612,3331,281,300,155,145,0.91112362362364,0.561111111111111,1.73106200122775,146,75,71,55,0.9,7.67,1.1,0,0,0,0,0,0,0.604007565760491,254.448479772666,73.1920610645793
8.7,"greedy_SVM","SVM",31,3,3512,3293,219,400,193,207,0.900652214714704,0.561111111111111,1.73106200122775,213,109,104,67,1,10.22,0.9,0,0,0,0,0,0,0.37757626078978,148.731968820885,50.3320927088246
8.7,"greedy_SVM","SVM",31,4,3412,3234,178,500,252,248,0.877202202202191,0.605555555555556,1.6295001533272,310,156,154,97,1,12.78,1,0,0,0,0,0,0,0.128577554554973,55.7497959219364,23.7765313027781
8.7,"greedy_SVM","SVM",31,5,3312,3182,130,600,304,296,0.857860985985982,0.616666666666667,1.57951548604722,400,201,199,90,1,15.34,1,0,0,0,0,0,0,0.120612047561952,68.8828377049307,18.8943665573597
8.7,"greedy_SVM","SVM",31,6,3212,3100,112,700,386,314,0.858649274274268,0.616666666666667,1.5609576427256,451,219,232,51,1.1,17.89,1.2,0,0,0,0,0,0,0.0756531209906586,65.8756857083684,10.9510702914549
8.7,"greedy_SVM","SVM",31,7,3112,3028,84,800,458,342,0.860013138138143,0.627777777777778,1.56239631336406,518,250,268,67,1.1,20.45,1.3,0,0,0,0,0,0,0.078458060357665,105.124275912981,11.1780345736115
8.7,"greedy_SVM","SVM",31,8,3012,2940,72,900,546,354,0.872985485485481,0.633333333333333,1.5851376146789,548,266,282,30,1.1,23.01,1.5,0,0,0,0,0,0,0.063648273578679,87.7602756965287,7.76044164804894
8.7,"greedy_SVM","SVM",31,9,2912,2850,62,1000,636,364,0.887465590590591,0.638888888888889,1.62800245098039,575,280,295,27,1.1,25.56,1.7,0,0,0,0,0,0,0.0612763075518369,87.3929961079038,6.70296504814558
8.7,"greedy_SVM","SVM",31,10,2812,2758,54,1100,728,372,0.910954704704714,0.633333333333333,1.68328750381913,609,293,316,34,1.1,28.12,2,0,0,0,0,0,0,0.051566831688401,64.9872490700038,6.1643311654345
8.7,"greedy_SVM","SVM",31,11,2712,2668,44,1200,818,382,0.919932432432444,0.633333333333333,1.72946948788715,633,304,329,24,1.1,30.67,2.1,0,0,0,0,0,0,0.0453646888998535,62.9122483873123,5.02570569562147
8.7,"greedy_SVM","SVM",31,12,2612,2573,39,1300,913,387,0.929735985985999,0.633333333333333,1.74267281105991,649,315,334,16,1.1,33.23,2.4,0,0,0,0,0,0,0.0467590829679283,64.2497932930499,5.48835273635393
8.7,"greedy_SVM","SVM",31,13,2512,2476,36,1400,1010,390,0.933391203703723,0.638888888888889,1.76108041743401,672,326,346,23,1.1,35.79,2.6,0,0,0,0,0,0,0.0480753990930286,55.0049598132291,5.52559851634033
8.7,"greedy_SVM","SVM",31,14,2412,2378,34,1500,1108,392,0.935094469469496,0.638888888888889,1.75268817204301,677,330,347,5,1.1,38.34,2.8,0,0,0,0,0,0,0.0404359712591427,42.8720920612765,4.4290801768629
8.7,"greedy_SVM","SVM",31,15,2312,2280,32,1600,1206,394,0.935957832832863,0.638888888888889,1.76270353302611,682,332,350,5,1.1,40.9,3.1,0,0,0,0,0,0,0.0369655721877219,37.4107258959232,4.14082806367828
8.7,"greedy_SVM","SVM",31,16,2212,2182,30,1700,1304,396,0.936351976977003,0.633333333333333,1.76108041743401,691,335,356,9,1.1,43.46,3.3,0,0,0,0,0,0,0.0324827039113649,29.9643921293281,3.62783841745906
8.7,"greedy_SVM","SVM",31,17,2112,2089,23,1800,1397,403,0.934024649649674,0.638888888888889,1.74946335479914,711,344,367,20,1.1,46.01,3.5,0,0,0,0,0,0,0.0355199306913365,30.4003594440814,4.60288960068888
8.7,"greedy_SVM","SVM",31,18,2012,1997,15,1900,1489,411,0.933112800300318,0.638888888888889,1.74785539215686,734,353,381,23,1.1,48.57,3.6,0,0,0,0,0,0,0.0288339926822588,27.5344572791897,3.74702962067537
8.7,"greedy_SVM","SVM",31,19,1912,1900,12,2000,1586,414,0.933295795795814,0.638888888888889,1.74946335479914,741,355,386,7,1.1,51.12,3.8,0,0,0,0,0,0,0.023963995841055,23.9223389096607,2.69762327743627
8.7,"greedy_SVM","SVM",31,20,1812,1800,12,2100,1686,414,0.933308308308327,0.638888888888889,1.75107427869859,745,358,387,4,1.1,53.68,4.1,0,0,0,0,0,0,0.0204704894819022,18.236649872755,2.05997948072146
8.7,"greedy_SVM","SVM",31,21,1712,1700,12,2200,1786,414,0.935010010010016,0.616666666666667,1.77271889400922,765,376,389,20,1,56.24,4.3,0,0,0,0,0,0,0.0161673571658076,10.1357504237467,2.16650695609717
8.7,"greedy_SVM","SVM",31,22,1612,1602,10,2300,1884,416,0.9352195945946,0.622222222222222,1.78273425499232,770,379,391,5,1,58.79,4.5,0,0,0,0,0,0,0.00965662035131491,7.26684509647034,1.19611010568452
8.7,"greedy_SVM","SVM",31,23,1512,1504,8,2400,1982,418,0.935376001001007,0.627777777777778,1.77945415516713,776,381,395,6,1,61.35,4.7,0,0,0,0,0,0,0.00868275870208851,7.07480572281521,0.967099317518668
8.7,"greedy_SVM","SVM",31,24,1412,1404,8,2500,2082,418,0.935451076076082,0.627777777777778,1.77781862745098,779,381,398,3,1,63.91,5,0,0,0,0,0,0,0.00836597039046638,6.14866909136714,0.849200832674924
8.7,"greedy_SVM","SVM",31,25,1312,1304,8,2600,2182,418,0.935535535535541,0.616666666666667,1.77618610345883,792,384,408,13,1.1,66.46,5.2,0,0,0,0,0,0,0.00572466839383324,3.79655150061541,0.648519404765465
8.7,"greedy_SVM","SVM",31,26,1212,1204,8,2700,2282,418,0.93556212462463,0.616666666666667,1.77781862745098,791,384,407,-1,1.1,69.02,5.5,0,0,0,0,0,0,0.00558623899252623,3.28719380975599,0.571659394345113
8.7,"greedy_SVM","SVM",31,27,1112,1105,7,2800,2381,419,0.936029779779783,0.616666666666667,1.77781862745098,795,388,407,4,1,71.57,5.7,0,0,0,0,0,0,0.00445629213041964,2.39677987816166,0.480288352018534
8.7,"greedy_SVM","SVM",31,28,1012,1007,5,2900,2479,421,0.936061061061065,0.611111111111111,1.78273425499232,803,392,411,8,1,74.13,5.9,0,0,0,0,0,0,0.00506127197579435,2.51461441058875,0.544674279782631
8.7,"greedy_SVM","SVM",31,29,912,907,5,3000,2579,421,0.936251876876881,0.611111111111111,1.77618610345883,808,395,413,5,1,76.69,6.1,0,0,0,0,0,0,0.00375174250758108,1.67004268011365,0.413402514389581
8.7,"greedy_SVM","SVM",31,30,812,807,5,3100,2679,421,0.936323823823829,0.616666666666667,1.77945415516713,809,396,413,1,1,79.24,6.4,0,0,0,0,0,0,0.00306239612779866,1.20792604909248,0.331909415096541
8.7,"greedy_SVM","SVM",31,31,712,708,4,3200,2778,422,0.936469281781788,0.616666666666667,1.78109269490485,812,397,415,3,1,81.8,6.6,0,0,0,0,0,0,0.00269790348532865,0.941475271510702,0.295156446527772
8.7,"greedy_SVM","SVM",31,32,612,609,3,3300,2877,423,0.93665853353354,0.616666666666667,1.77781862745098,820,400,420,8,1.1,84.36,6.8,0,0,0,0,0,0,0.00208992646559755,0.688614668739473,0.241573428286554
8.7,"greedy_SVM","SVM",31,33,512,510,2,3400,2976,424,0.936774274274281,0.622222222222222,1.77945415516713,821,401,420,1,1,86.91,7,0,0,0,0,0,0,0.00164782604035419,0.575254938394213,0.207227731818336
8.7,"greedy_SVM","SVM",31,34,412,412,0,3500,3074,426,0.937027652652662,0.622222222222222,1.77781862745098,827,404,423,6,1,89.47,7.2,0,0,0,0,0,0,0.00192010106755682,0.599862599265002,0.230980165929702
8.7,"greedy_SVM","SVM",31,35,312,312,0,3600,3174,426,0.937421796796808,0.616666666666667,1.78273425499232,831,409,422,4,1,92.02,7.5,0,0,0,0,0,0,0.00125245527340036,0.31267987340867,0.144970917887844
8.7,"greedy_SVM","SVM",31,36,212,212,0,3700,3274,426,0.937887887887901,0.616666666666667,1.77618610345883,837,411,426,6,1,94.58,7.7,0,0,0,0,0,0,0.000762582745668363,0.15312270599233,0.0953363974370336
8.7,"greedy_SVM","SVM",31,37,112,112,0,3800,3374,426,0.938228853853874,0.616666666666667,1.78273425499232,839,412,427,2,1,97.14,7.9,0,0,0,0,0,0,0.000390889520259718,0.0621499422772565,0.0579584154476925
8.7,"greedy_SVM","SVM",31,38,12,12,0,3900,3474,426,0.938582332332352,0.616666666666667,1.77945415516713,841,413,428,2,1,99.69,8.2,0,0,0,0,0,0,0.000227779916477379,0.00309281794789307,0.00309281794789307
8.7,"greedy_SVM","SVM",31,39,0,0,0,3912,3486,426,0.938652715215235,0.616666666666667,1.77781862745098,842,414,428,1,1,100,8.2,0,0,0,0,0,0,0,0,0
8.7,"greedy_SVM","SVM",32,0,3812,3432,380,100,94,6,0.189717741935484,0,0.221248428990364,23,6,17,0,2.8,2.56,15.7,0,0,0,0,0,0,0.0665416712521658,237.620195604712,6.69775328286609
8.7,"greedy_SVM","SVM",32,1,3712,3333,379,200,193,7,0.815306870548807,0.372727272727273,1.68804356933389,34,7,27,11,3.9,5.11,27.6,0,0,0,0,0,0,0.158336861486269,219.671861431674,21.473131974115
8.7,"greedy_SVM","SVM",32,2,3612,3259,353,300,267,33,0.848054566401347,0.513636363636364,1.65526602429828,85,33,52,51,1.6,7.67,8.1,0,0,0,0,0,0,0.347707308940728,367.150861021664,41.5209778806025
8.7,"greedy_SVM","SVM",32,3,3512,3234,278,400,292,108,0.91316506074571,0.55,1.78308940369658,150,75,75,65,1,10.22,2.7,0,0,0,0,0,0,0.591401333447956,340.004257570686,68.5113592519759
8.7,"greedy_SVM","SVM",32,4,3412,3201,211,500,325,175,0.907553937997503,0.572727272727273,1.76348610067618,214,108,106,64,1,12.78,1.9,0,0,0,0,0,0,0.442631650794597,234.481844486322,52.7861934867976
8.7,"greedy_SVM","SVM",32,5,3312,3152,160,600,374,226,0.901830226225407,0.577272727272727,1.76348610067618,308,155,153,94,1,15.34,1.7,0,0,0,0,0,0,0.360323872969872,216.506373466938,45.8741859726485
8.7,"greedy_SVM","SVM",32,6,3212,3083,129,700,443,257,0.900333839547548,0.590909090909091,1.73241978609626,399,198,201,91,1,17.89,1.7,0,0,0,0,0,0,0.168855988667026,96.0506773017161,24.095921603241
8.7,"greedy_SVM","SVM",32,7,3112,3015,97,800,511,289,0.89079650188522,0.604545454545454,1.7258342393577,466,230,236,67,1,20.45,1.8,0,0,0,0,0,0,0.158277754526632,113.593711750422,20.1895947788286
8.7,"greedy_SVM","SVM",32,8,3012,2929,83,900,597,303,0.901248952660253,0.613636363636364,1.73082895066366,494,242,252,28,1,23.01,2,0,0,0,0,0,0,0.0951812710251281,64.5273571828989,11.7808766532655
8.7,"greedy_SVM","SVM",32,9,2912,2846,66,1000,680,320,0.899461929199845,0.640909090909091,1.69156082887701,528,259,269,34,1,25.56,2.1,0,0,0,0,0,0,0.0662369247976961,61.0665550513272,8.94743498019983
8.7,"greedy_SVM","SVM",32,10,2812,2761,51,1100,765,335,0.889304042731461,0.645454545454546,1.62469321312297,568,275,293,40,1.1,28.12,2.3,0,0,0,0,0,0,0.0645755679612613,86.728647850501,9.65730314550501
8.7,"greedy_SVM","SVM",32,11,2712,2671,41,1200,855,345,0.890402440301638,0.65,1.6455549974887,595,288,307,27,1.1,30.67,2.5,0,0,0,0,0,0,0.0593952283859067,76.0573621215789,6.99993410061914
8.7,"greedy_SVM","SVM",32,12,2612,2576,36,1300,950,350,0.899493349392539,0.640909090909091,1.6588736631016,622,300,322,27,1.1,33.23,2.7,0,0,0,0,0,0,0.047903984383808,60.1447268036083,5.78591379219129
8.7,"greedy_SVM","SVM",32,13,2512,2480,32,1400,1046,354,0.905765605362374,0.65,1.68338903743316,627,304,323,5,1.1,35.79,3,0,0,0,0,0,0,0.042141111532307,52.5870321662518,4.75225683590285
8.7,"greedy_SVM","SVM",32,14,2412,2386,26,1500,1140,360,0.912562840385413,0.645454545454546,1.6783023606228,649,312,337,22,1.1,38.34,3.2,0,0,0,0,0,0,0.0481702618370275,49.5493460254462,5.6598911176709
8.7,"greedy_SVM","SVM",32,15,2312,2292,20,1600,1234,366,0.918645266024281,0.645454545454546,1.70947562097516,670,324,346,21,1.1,40.9,3.4,0,0,0,0,0,0,0.043848596367917,38.9992825812995,5.07605212332104
8.7,"greedy_SVM","SVM",32,16,2212,2195,17,1700,1331,369,0.919168935902798,0.645454545454546,1.7290155006284,680,328,352,10,1.1,43.46,3.6,0,0,0,0,0,0,0.0430567042729898,33.4899571601397,5.05834345937723
8.7,"greedy_SVM","SVM",32,17,2112,2099,13,1800,1427,373,0.919475282781726,0.645454545454546,1.7290155006284,688,332,356,8,1.1,46.01,3.8,0,0,0,0,0,0,0.0371484220786467,31.052099765272,4.53208761311391
8.7,"greedy_SVM","SVM",32,18,2012,2004,8,1900,1522,378,0.920216275659815,0.65,1.7290155006284,701,336,365,13,1.1,48.57,4,0,0,0,0,0,0,0.0314432747137224,30.8293523426826,3.91072316694031
8.7,"greedy_SVM","SVM",32,19,1912,1905,7,2000,1621,379,0.920301372015073,0.65,1.72742340532396,709,337,372,8,1.1,51.12,4.3,0,0,0,0,0,0,0.0246729443936581,24.3465299826309,2.66957373464429
8.7,"greedy_SVM","SVM",32,20,1812,1805,7,2100,1721,379,0.921177209886885,0.65,1.73739783152627,717,345,372,8,1.1,53.68,4.5,0,0,0,0,0,0,0.0175498962751843,16.0880183243457,1.98262848217528
8.7,"greedy_SVM","SVM",32,21,1712,1705,7,2200,1821,379,0.92075696480938,0.645454545454546,1.74059157754011,725,346,379,8,1.1,56.24,4.8,0,0,0,0,0,0,0.0136930733603464,11.6797123384308,1.47968695322991
8.7,"greedy_SVM","SVM",32,22,1612,1606,6,2300,1920,380,0.920492511520729,0.640909090909091,1.75693516042781,735,358,377,10,1.1,58.79,5.1,0,0,0,0,0,0,0.00886105811343517,7.2702910574934,1.05837732814469
8.7,"greedy_SVM","SVM",32,23,1512,1508,4,2400,2018,382,0.92072685379136,0.640909090909091,1.75532181317305,739,360,379,4,1.1,61.35,5.3,0,0,0,0,0,0,0.0094591803766767,6.75637283165808,0.964930512141969
8.7,"greedy_SVM","SVM",32,24,1412,1408,4,2500,2118,382,0.921884164222874,0.636363636363636,1.75210399133406,752,366,386,13,1.1,63.91,5.5,0,0,0,0,0,0,0.00716432657828337,4.77023129432942,0.884369623409876
8.7,"greedy_SVM","SVM",32,25,1312,1308,4,2600,2218,382,0.92186059907834,0.640909090909091,1.75210399133406,754,366,388,2,1.1,66.46,5.8,0,0,0,0,0,0,0.00582653801972648,3.77214662639136,0.62231198258052
8.7,"greedy_SVM","SVM",32,26,1212,1208,4,2700,2318,382,0.921738845831591,0.636363636363636,1.75371142618849,753,366,387,-1,1.1,69.02,6.1,0,0,0,0,0,0,0.00509861721292581,2.96042706196339,0.526035414982889
8.7,"greedy_SVM","SVM",32,27,1112,1109,3,2800,2417,383,0.922363322161721,0.627272727272727,1.76510695187166,761,371,390,8,1.1,71.57,6.3,0,0,0,0,0,0,0.00429609434236978,2.29653368607708,0.453256248500444
8.7,"greedy_SVM","SVM",32,28,1012,1009,3,2900,2517,383,0.9225466066192,0.627272727272727,1.76998743192292,762,371,391,1,1.1,74.13,6.6,0,0,0,0,0,0,0.0036855959129596,1.74735591421975,0.387274472878173
8.7,"greedy_SVM","SVM",32,29,912,909,3,3000,2617,383,0.922900083787191,0.627272727272727,1.76673078531404,762,373,389,0,1,76.69,6.8,0,0,0,0,0,0,0.0027743396567707,1.17382901418256,0.301089610370206
8.7,"greedy_SVM","SVM",32,30,812,809,3,3100,2717,383,0.922987798491841,0.627272727272727,1.76510695187166,762,373,389,0,1,79.24,7.1,0,0,0,0,0,0,0.00220489113561355,0.846573959405391,0.241356055220904
8.7,"greedy_SVM","SVM",32,31,712,709,3,3200,2817,383,0.923025764558033,0.627272727272727,1.76673078531404,763,373,390,1,1,81.8,7.4,0,0,0,0,0,0,0.00151103913639082,0.500192860454031,0.16728033864407
8.7,"greedy_SVM","SVM",32,32,612,609,3,3300,2917,383,0.923155372852963,0.627272727272727,1.76510695187166,762,373,389,-1,1,84.36,7.6,0,0,0,0,0,0,0.00139582852227237,0.403126235969098,0.158829658705911
8.7,"greedy_SVM","SVM",32,33,512,509,3,3400,3017,383,0.92336353162967,0.627272727272727,1.76673078531404,763,373,390,1,1,86.91,7.9,0,0,0,0,0,0,0.000929088564250684,0.261136406917454,0.123318874824867
8.7,"greedy_SVM","SVM",32,34,412,409,3,3500,3117,383,0.923754974863854,0.627272727272727,1.76510695187166,764,373,391,1,1,89.47,8.1,0,0,0,0,0,0,0.000444067376799904,0.117326875021822,0.0620181745478741
8.7,"greedy_SVM","SVM",32,35,312,312,0,3600,3214,386,0.924731619187268,0.631818181818182,1.76510695187166,774,380,394,10,1,92.02,8.3,0,0,0,0,0,0,0.000542264671735911,0.13411030486368,0.0742992672065498
8.7,"greedy_SVM","SVM",32,36,212,212,0,3700,3314,386,0.92497643485547,0.631818181818182,1.76673078531404,776,381,395,2,1,94.58,8.6,0,0,0,0,0,0,0.000243104815814179,0.0550836700243916,0.0368482508642067
8.7,"greedy_SVM","SVM",32,37,112,112,0,3800,3414,386,0.925243506493508,0.627272727272727,1.76998743192292,776,381,395,0,1,97.14,8.8,0,0,0,0,0,0,0.000100182563842403,0.0165833967711218,0.0155617299280864
8.7,"greedy_SVM","SVM",32,38,12,12,0,3900,3514,386,0.925483085462926,0.627272727272727,1.7618682235196,775,382,393,-1,1,99.69,9.1,0,0,0,0,0,0,5.54785300649047e-05,0.000937267271252446,0.000937267271252446
8.7,"greedy_SVM","SVM",32,39,0,0,0,3912,3526,386,0.92561531210725,0.627272727272727,1.76348610067618,776,382,394,1,1,100,9.1,0,0,0,0,0,0,0,0,0
8.7,"greedy_SVM","SVM",33,0,3812,3422,390,100,89,11,0.914733044532049,0.55609756097561,1.78517702596381,27,11,16,0,1.5,2.56,8.1,0,0,0,0,0,0,0.404179822711031,400.493228006006,46.7048926603172
8.7,"greedy_SVM","SVM",33,1,3712,3366,346,200,145,55,0.897489936064409,0.585365853658537,1.73004556419191,112,55,57,85,1,5.11,2.6,0,0,0,0,0,0,0.612655970542927,485.646805061444,66.4380619728741
8.7,"greedy_SVM","SVM",33,2,3612,3321,291,300,190,110,0.911997325570064,0.624390243902439,1.76109655311429,196,97,99,84,1,7.67,1.7,0,0,0,0,0,0,0.531616987491079,357.008267062542,61.4082932531858
8.7,"greedy_SVM","SVM",33,3,3512,3296,216,400,215,185,0.911235391622912,0.604878048780488,1.73081794906347,251,128,123,55,1,10.22,1.2,0,0,0,0,0,0,0.381657107063758,181.170909879833,53.9013207712723
8.7,"greedy_SVM","SVM",33,4,3412,3241,171,500,270,230,0.899898315944909,0.624390243902439,1.72604985553988,334,166,168,83,1,12.78,1.2,0,0,0,0,0,0,0.22695357166264,123.063424994968,32.2516813218726
8.7,"greedy_SVM","SVM",33,5,3312,3169,143,600,342,258,0.907147135434816,0.653658536585366,1.72446632356232,394,194,200,60,1,15.34,1.3,0,0,0,0,0,0,0.10779355826824,69.2088024578037,15.1681357700747
8.7,"greedy_SVM","SVM",33,6,3212,3096,116,700,415,285,0.894481202379133,0.682926829268293,1.64568359812039,457,224,233,63,1,17.89,1.5,0,0,0,0,0,0,0.11170908895373,97.5131508225657,16.2816978535211
8.7,"greedy_SVM","SVM",33,7,3112,3018,94,800,493,307,0.900791185524645,0.692682926829268,1.64568359812039,505,245,260,48,1.1,20.45,1.6,0,0,0,0,0,0,0.0823019151821632,80.2838641420699,11.8257714758123
8.7,"greedy_SVM","SVM",33,8,3012,2944,68,900,567,333,0.894248582691423,0.697560975609756,1.62688546701135,561,270,291,56,1.1,23.01,1.7,0,0,0,0,0,0,0.0652419520778004,90.5448296938415,9.23030284026288
8.7,"greedy_SVM","SVM",33,9,2912,2854,58,1000,657,343,0.901867922162955,0.702439024390244,1.64447341800607,592,284,308,31,1.1,25.56,1.9,0,0,0,0,0,0,0.0569159150666928,81.3632156697646,6.59495430389813
8.7,"greedy_SVM","SVM",33,10,2812,2762,50,1100,749,351,0.906996698750557,0.697560975609756,1.66624820659971,613,294,319,21,1.1,28.12,2.1,0,0,0,0,0,0,0.0556514907163166,87.2942560167889,6.12282537292119
8.7,"greedy_SVM","SVM",33,11,2712,2670,42,1200,841,359,0.923873466033365,0.697560975609756,1.71886657101865,645,314,331,32,1.1,30.67,2.3,0,0,0,0,0,0,0.0609734054054099,82.2370854621719,6.9927762250899
8.7,"greedy_SVM","SVM",33,12,2612,2578,34,1300,933,367,0.927417085707134,0.692682926829268,1.72044786501223,664,323,341,19,1.1,33.23,2.5,0,0,0,0,0,0,0.0730973445966253,76.2931941681187,8.11617023527957
8.7,"greedy_SVM","SVM",33,13,2512,2481,31,1400,1030,370,0.930735050354512,0.68780487804878,1.74838970489152,679,330,349,15,1.1,35.79,2.8,0,0,0,0,0,0,0.0626946001759741,60.8082243721589,6.79024577510155
8.7,"greedy_SVM","SVM",33,14,2412,2384,28,1500,1127,373,0.930428605256937,0.68780487804878,1.75000112397437,690,333,357,11,1.1,38.34,3,0,0,0,0,0,0,0.0562629015037998,46.7905515616228,6.07898756215448
8.7,"greedy_SVM","SVM",33,15,2312,2292,20,1600,1219,381,0.930106837904483,0.682926829268293,1.74838970489152,712,343,369,22,1.1,40.9,3.2,0,0,0,0,0,0,0.0603401616890148,46.9773302619973,6.84041727983517
8.7,"greedy_SVM","SVM",33,16,2212,2197,15,1700,1314,386,0.929932721371771,0.678048780487805,1.74120714847701,733,349,384,21,1.1,43.46,3.4,0,0,0,0,0,0,0.0464388634120156,40.1228265607176,5.65068287036588
8.7,"greedy_SVM","SVM",33,17,2112,2101,11,1800,1410,390,0.92961931161289,0.673170731707317,1.73081794906347,744,353,391,11,1.1,46.01,3.6,0,0,0,0,0,0,0.0374885422055855,34.5612557862406,4.30428611743319
8.7,"greedy_SVM","SVM",33,18,2012,2002,10,1900,1509,391,0.930502430666809,0.673170731707317,1.7396038269775,746,356,390,2,1.1,48.57,3.9,0,0,0,0,0,0,0.0273052088780785,25.9526896265792,2.99054891592864
8.7,"greedy_SVM","SVM",33,19,1912,1903,9,2000,1608,392,0.930999707484236,0.673170731707317,1.74838970489152,746,357,389,0,1.1,51.12,4.1,0,0,0,0,0,0,0.0220575428035469,20.664054880963,2.36966568833972
8.7,"greedy_SVM","SVM",33,20,1812,1803,9,2100,1708,392,0.931066568232797,0.673170731707317,1.74838970489152,747,358,389,1,1.1,53.68,4.4,0,0,0,0,0,0,0.0190560138764242,18.4085995171556,2.08249181544694
8.7,"greedy_SVM","SVM",33,21,1712,1703,9,2200,1808,392,0.93117521694921,0.673170731707317,1.74678125070119,747,359,388,0,1.1,56.24,4.6,0,0,0,0,0,0,0.0148905614922858,13.971906010557,1.57109757143181
8.7,"greedy_SVM","SVM",33,22,1612,1603,9,2300,1908,392,0.932871808443963,0.673170731707317,1.75555904593085,755,361,394,8,1.1,58.79,4.9,0,0,0,0,0,0,0.0106540643109543,9.15405809562665,1.18732222979262
8.7,"greedy_SVM","SVM",33,23,1512,1504,8,2400,2007,393,0.934334387318753,0.673170731707317,1.7643368411605,765,372,393,10,1.1,61.35,5.1,0,0,0,0,0,0,0.0072930322453157,5.84392285626137,0.893990195048653
8.7,"greedy_SVM","SVM",33,24,1412,1406,6,2500,2105,395,0.934810770152255,0.678048780487805,1.76758907496909,770,374,396,5,1.1,63.91,5.3,0,0,0,0,0,0,0.00830795676304525,6.11098927170464,0.847331145145698
8.7,"greedy_SVM","SVM",33,25,1312,1306,6,2600,2205,395,0.937302725968441,0.668292682926829,1.76271520803443,778,382,396,8,1,66.46,5.6,0,0,0,0,0,0,0.0044591222005432,2.7753969743599,0.578828829796682
8.7,"greedy_SVM","SVM",33,26,1212,1207,5,2700,2304,396,0.938084160967256,0.673170731707317,1.7643368411605,782,384,398,4,1,69.02,5.8,0,0,0,0,0,0,0.00441072049817699,2.68129236860329,0.463192580920387
8.7,"greedy_SVM","SVM",33,27,1112,1107,5,2800,2404,396,0.938833558524051,0.663414634146341,1.75948086820318,789,386,403,7,1,71.57,6.1,0,0,0,0,0,0,0.00343113807388739,1.94984641954252,0.384445789854053
8.7,"greedy_SVM","SVM",33,28,1012,1008,4,2900,2503,397,0.93910239445056,0.663414634146341,1.76596146071958,794,389,405,5,1,74.13,6.3,0,0,0,0,0,0,0.0033935796374141,1.73412322057834,0.358173206640821
8.7,"greedy_SVM","SVM",33,29,912,908,4,3000,2603,397,0.939265367525178,0.668292682926829,1.7643368411605,794,389,405,0,1,76.69,6.6,0,0,0,0,0,0,0.00280945518096921,1.26752742316557,0.304328012222833
8.7,"greedy_SVM","SVM",33,30,812,808,4,3100,2703,397,0.93939769609004,0.668292682926829,1.76596146071958,796,390,406,2,1,79.24,6.8,0,0,0,0,0,0,0.0020577710771077,0.76747289244348,0.217329932402533
8.7,"greedy_SVM","SVM",33,31,712,709,3,3200,2802,398,0.939608028861557,0.663414634146341,1.76758907496909,802,393,409,6,1,81.8,7,0,0,0,0,0,0,0.00163145804706417,0.533141908937537,0.181235212607652
8.7,"greedy_SVM","SVM",33,32,612,610,2,3300,2901,399,0.939775180732962,0.658536585365854,1.76758907496909,805,395,410,3,1,84.36,7.3,0,0,0,0,0,0,0.00138758759268023,0.439025788226404,0.16528255943253
8.7,"greedy_SVM","SVM",33,33,512,510,2,3400,3001,399,0.939933975010796,0.663414634146341,1.76596146071958,807,395,412,2,1,86.91,7.5,0,0,0,0,0,0,0.00102182651265089,0.318636120156505,0.127768166176867
8.7,"greedy_SVM","SVM",33,34,412,412,0,3500,3099,401,0.940349068824784,0.668292682926829,1.76596146071958,817,398,419,10,1.1,89.47,7.7,0,0,0,0,0,0,0.00104850812575286,0.317595746846977,0.129525420380068
8.7,"greedy_SVM","SVM",33,35,312,312,0,3600,3199,401,0.94032121017955,0.668292682926829,1.76758907496909,815,399,416,-2,1,92.02,8,0,0,0,0,0,0,0.000535090407987086,0.131843175156337,0.0646997015431709
8.7,"greedy_SVM","SVM",33,36,212,212,0,3700,3299,401,0.940138736053266,0.668292682926829,1.76596146071958,820,400,420,5,1.1,94.58,8.2,0,0,0,0,0,0,0.000260572201103016,0.0531115043160319,0.0340598217398716
8.7,"greedy_SVM","SVM",33,37,112,112,0,3800,3399,401,0.940067696507919,0.668292682926829,1.77148493543759,821,401,420,1,1,97.14,8.5,0,0,0,0,0,0,8.40583476324906e-05,0.0148729340693077,0.014009562087597
8.7,"greedy_SVM","SVM",33,38,12,12,0,3900,3499,401,0.940034266133637,0.668292682926829,1.77311463639015,822,401,421,1,1,99.69,8.7,0,0,0,0,0,0,3.31681455748872e-05,0.000517714728182474,0.000517714728182474
8.7,"greedy_SVM","SVM",33,39,0,0,0,3912,3511,401,0.940042623727207,0.668292682926829,1.77148493543759,822,401,421,0,1,100,8.8,0,0,0,0,0,0,0,0,0
8.7,"greedy_SVM","SVM",34,0,3812,3408,404,100,92,8,0.892712124226213,0.5,1.70054634424438,28,8,20,0,2.5,2.56,11.5,0,0,0,0,0,0,0.156338876969005,312.260875318506,16.9257936909768
8.7,"greedy_SVM","SVM",34,1,3712,3376,336,200,124,76,0.907795733526807,0.572164948453608,1.75910936923121,104,52,52,76,1,5.11,1.6,0,0,0,0,0,0,0.691628596253888,384.555194846204,75.7501913156015
8.7,"greedy_SVM","SVM",34,2,3612,3351,261,300,149,151,0.904694758767557,0.572164948453608,1.74664310620163,153,77,76,49,1,7.67,1,0,0,0,0,0,0,0.549910391956367,250.59191303217,63.8045405565168
8.7,"greedy_SVM","SVM",34,3,3512,3316,196,400,184,216,0.905099933299787,0.561855670103093,1.73292525773196,229,118,111,76,0.9,10.22,0.9,0,0,0,0,0,0,0.416528127115979,213.990383682717,53.615712737566
8.7,"greedy_SVM","SVM",34,4,3412,3252,160,500,248,252,0.903126718700637,0.61340206185567,1.72524397993152,332,169,163,103,1,12.78,1,0,0,0,0,0,0,0.210994740056251,135.507174625686,31.8371922989125
8.7,"greedy_SVM","SVM",34,5,3312,3188,124,600,312,288,0.887873433422656,0.618556701030928,1.65256023238594,402,202,200,70,1,15.34,1.1,0,0,0,0,0,0,0.172644773590258,139.841412791365,27.4028572220062
8.7,"greedy_SVM","SVM",34,6,3212,3109,103,700,391,309,0.894561007290221,0.628865979381443,1.66031544305238,460,226,234,58,1,17.89,1.3,0,0,0,0,0,0,0.0807887433960544,72.075654171328,11.5758910028417
8.7,"greedy_SVM","SVM",34,7,3112,3038,74,800,462,338,0.892179692710965,0.628865979381443,1.65878941782899,523,255,268,63,1.1,20.45,1.4,0,0,0,0,0,0,0.0794107236954055,103.616303602424,10.3475540371017
8.7,"greedy_SVM","SVM",34,8,3012,2957,55,900,543,357,0.881086394326983,0.628865979381443,1.58319843230809,570,277,293,47,1.1,23.01,1.5,0,0,0,0,0,0,0.0829654993749995,132.632808282567,11.5289202559148
8.7,"greedy_SVM","SVM",34,9,2912,2862,50,1000,638,362,0.887656950279088,0.628865979381443,1.64327618613658,588,285,303,18,1.1,25.56,1.8,0,0,0,0,0,0,0.0602736460950918,91.8549863384853,6.70116906760274
8.7,"greedy_SVM","SVM",34,10,2812,2765,47,1100,735,365,0.894420585791693,0.634020618556701,1.64176443251548,600,292,308,12,1.1,28.12,2,0,0,0,0,0,0,0.0547158349195059,81.5642686703409,5.75463198069277
8.7,"greedy_SVM","SVM",34,11,2712,2668,44,1200,832,368,0.914187837157877,0.61340206185567,1.70669296939463,626,306,320,26,1,30.67,2.3,0,0,0,0,0,0,0.0457463587986202,42.0697055498644,5.44967769295923
8.7,"greedy_SVM","SVM",34,12,2612,2575,37,1300,925,375,0.914557906315453,0.623711340206186,1.71754855613146,645,315,330,19,1,33.23,2.5,0,0,0,0,0,0,0.034241578574102,37.7830988475729,3.8449744317365
8.7,"greedy_SVM","SVM",34,13,2512,2478,34,1400,1022,378,0.915501363258711,0.618556701030928,1.71596847466308,649,319,330,4,1,35.79,2.7,0,0,0,0,0,0,0.0288134688165725,37.2481791854614,3.14058184686526
8.7,"greedy_SVM","SVM",34,14,2412,2383,29,1500,1117,383,0.918289315094136,0.618556701030928,1.72365827774409,661,324,337,12,1,38.34,2.9,0,0,0,0,0,0,0.0405779278529301,44.7180310741491,4.71501579117324
8.7,"greedy_SVM","SVM",34,15,2312,2288,24,1600,1212,388,0.920234737938377,0.608247422680412,1.74700935911445,685,336,349,24,1,40.9,3.1,0,0,0,0,0,0,0.0486096534731532,35.0557644033879,5.43392035405701
8.7,"greedy_SVM","SVM",34,16,2212,2193,19,1700,1307,393,0.920777408521242,0.597938144329897,1.74540069487954,704,344,360,19,1,43.46,3.3,0,0,0,0,0,0,0.0507091996481485,31.7356705717401,5.52262160368332
8.7,"greedy_SVM","SVM",34,17,2112,2096,16,1800,1404,396,0.920421966603086,0.592783505154639,1.74540069487954,711,347,364,7,1,46.01,3.5,0,0,0,0,0,0,0.0437634054181523,25.8048703315972,5.02241479683093
8.7,"greedy_SVM","SVM",34,18,2012,2003,9,1900,1497,403,0.919386358051419,0.592783505154639,1.74379499046842,737,355,382,26,1.1,48.57,3.7,0,0,0,0,0,0,0.0359221351292758,22.3766903756599,4.60971491862483
8.7,"greedy_SVM","SVM",34,19,1912,1909,3,2000,1591,409,0.918482394654624,0.592783505154639,1.74379499046842,749,362,387,12,1.1,51.12,3.9,0,0,0,0,0,0,0.0211138782765874,18.1506673993804,2.86669171462352
8.7,"greedy_SVM","SVM",34,20,1812,1809,3,2100,1691,409,0.918646219736243,0.592783505154639,1.74540069487954,752,363,389,3,1.1,53.68,4.1,0,0,0,0,0,0,0.0149899183675579,13.7662519947103,1.65441997547124
8.7,"greedy_SVM","SVM",34,21,1712,1709,3,2200,1791,409,0.918767625823515,0.592783505154639,1.74540069487954,752,363,389,0,1.1,56.24,4.4,0,0,0,0,0,0,0.0125631753215472,10.44305329661,1.29547059485296
8.7,"greedy_SVM","SVM",34,22,1612,1609,3,2300,1891,409,0.919266414688083,0.597938144329897,1.74379499046842,766,370,396,14,1.1,58.79,4.6,0,0,0,0,0,0,0.00976857114046877,6.99033519525163,1.18173790880833
8.7,"greedy_SVM","SVM",34,23,1512,1509,3,2400,1991,409,0.919237160209223,0.597938144329897,1.74379499046842,765,370,395,-1,1.1,61.35,4.9,0,0,0,0,0,0,0.00742752863354478,5.55521332139702,0.807597306806801
8.7,"greedy_SVM","SVM",34,24,1412,1409,3,2500,2091,409,0.919330774541576,0.597938144329897,1.74379499046842,768,371,397,3,1.1,63.91,5.1,0,0,0,0,0,0,0.00630830002374973,4.33727649160163,0.658460997200122
8.7,"greedy_SVM","SVM",34,25,1312,1309,3,2600,2191,409,0.920594568028352,0.587628865979381,1.74379499046842,774,376,398,6,1.1,66.46,5.4,0,0,0,0,0,0,0.00538080889259636,3.47052909627104,0.587452057344335
8.7,"greedy_SVM","SVM",34,26,1212,1209,3,2700,2291,409,0.920971950805652,0.587628865979381,1.74540069487954,777,377,400,3,1.1,69.02,5.6,0,0,0,0,0,0,0.0049830939497068,2.86148564081442,0.515189307370221
8.7,"greedy_SVM","SVM",34,27,1112,1109,3,2800,2391,409,0.921121148647841,0.587628865979381,1.75307049573687,778,377,401,1,1.1,71.57,5.8,0,0,0,0,0,0,0.00380895238947724,1.95811625958301,0.404832956510917
8.7,"greedy_SVM","SVM",34,28,1012,1010,2,2900,2490,410,0.921343482687183,0.587628865979381,1.7514592177077,785,381,404,7,1.1,74.13,6.1,0,0,0,0,0,0,0.00348546963109886,1.61102739791724,0.36927329610859
8.7,"greedy_SVM","SVM",34,29,912,911,1,3000,2589,411,0.92124986835483,0.587628865979381,1.75468474112889,789,384,405,4,1.1,76.69,6.3,0,0,0,0,0,0,0.00305997153294905,1.27127722979464,0.328829206805129
8.7,"greedy_SVM","SVM",34,30,812,811,1,3100,2689,411,0.921361035374501,0.587628865979381,1.75468474112889,789,385,404,0,1,79.24,6.5,0,0,0,0,0,0,0.00282707014157032,1.05973496220764,0.313377080392244
8.7,"greedy_SVM","SVM",34,31,712,712,0,3200,2788,412,0.921302526416779,0.587628865979381,1.75468474112889,795,387,408,6,1.1,81.8,6.8,0,0,0,0,0,0,0.00207554057116647,0.708525445690888,0.23935032496664
8.7,"greedy_SVM","SVM",34,32,612,612,0,3300,2888,412,0.921355184478729,0.587628865979381,1.75307049573687,796,387,409,1,1.1,84.36,7,0,0,0,0,0,0,0.00155277287448301,0.488731468436666,0.183712230592064
8.7,"greedy_SVM","SVM",34,33,512,512,0,3400,2988,412,0.921162104918248,0.587628865979381,1.7514592177077,799,388,411,3,1.1,86.91,7.3,0,0,0,0,0,0,0.000874215789228052,0.278209203238283,0.115027029116439
8.7,"greedy_SVM","SVM",34,34,412,412,0,3500,3088,412,0.921059714242235,0.587628865979381,1.75307049573687,801,389,412,2,1.1,89.47,7.5,0,0,0,0,0,0,0.000520643987723404,0.153639898944498,0.0672411264274874
8.7,"greedy_SVM","SVM",34,35,312,312,0,3600,3188,412,0.920983652597198,0.587628865979381,1.74985089886683,805,391,414,4,1.1,92.02,7.7,0,0,0,0,0,0,0.00038818557386873,0.100003165718136,0.048584959799283
8.7,"greedy_SVM","SVM",34,36,212,212,0,3700,3288,412,0.921030459763376,0.587628865979381,1.76234600100532,805,391,414,0,1.1,94.58,8,0,0,0,0,0,0,0.000211664299526261,0.0437463115059798,0.0279880322690379
8.7,"greedy_SVM","SVM",34,37,112,112,0,3800,3388,412,0.921124074095731,0.587628865979381,1.76396878737825,808,391,417,3,1.1,97.14,8.2,0,0,0,0,0,0,9.399464666682e-05,0.015984125660108,0.0150299583731289
8.7,"greedy_SVM","SVM",34,38,12,12,0,3900,3488,412,0.921334706343532,0.587628865979381,1.76559456506247,811,394,417,3,1.1,99.69,8.5,0,0,0,0,0,0,6.52121800029597e-05,0.000915298930981927,0.000915298930981927
8.7,"greedy_SVM","SVM",34,39,0,0,0,3912,3500,412,0.921333243619589,0.587628865979381,1.76396878737825,811,394,417,0,1.1,100,8.5,0,0,0,0,0,0,0,0,0
8.7,"greedy_SVM","SVM",35,0,3812,3433,379,100,91,9,0.877318651618951,0.440366972477064,1.77795628461506,36,9,27,0,3,2.56,10.1,0,0,0,0,0,0,0.0972761610448968,347.746257061292,9.86904056021919
8.7,"greedy_SVM","SVM",35,1,3712,3363,349,200,161,39,0.877664403880882,0.568807339449541,1.68543768057175,87,39,48,51,1.2,5.11,4.1,0,0,0,0,0,0,0.43143493438031,343.400847707703,55.6374944761305
8.7,"greedy_SVM","SVM",35,2,3612,3347,265,300,177,123,0.88971030711247,0.605504587155963,1.69416157216256,150,74,76,63,1,7.67,1.4,0,0,0,0,0,0,0.553251818627414,307.563023013489,66.3880047829338
8.7,"greedy_SVM","SVM",35,3,3512,3303,209,400,221,179,0.889397546478608,0.642201834862385,1.65238988291348,233,119,114,83,1,10.22,1.2,0,0,0,0,0,0,0.353639116904594,207.819513805342,46.8713470248415
8.7,"greedy_SVM","SVM",35,4,3412,3245,167,500,279,221,0.877234193051177,0.619266055045872,1.64110563950351,323,162,161,90,1,12.78,1.3,0,0,0,0,0,0,0.225274804174809,167.587934439113,29.6170930958867
8.7,"greedy_SVM","SVM",35,5,3312,3187,125,600,337,263,0.897865837565061,0.651376146788991,1.71179977169915,399,201,198,76,1,15.34,1.3,0,0,0,0,0,0,0.231594496881027,202.386390578583,34.4825110976013
8.7,"greedy_SVM","SVM",35,6,3212,3110,102,700,414,286,0.918753497112565,0.669724770642202,1.73341323227805,459,222,237,60,1.1,17.89,1.4,0,0,0,0,0,0,0.0971382573419223,104.432945734802,13.4176259427763
8.7,"greedy_SVM","SVM",35,7,3112,3031,81,800,493,307,0.918647923902835,0.688073394495413,1.70196157940088,513,245,268,54,1.1,20.45,1.6,0,0,0,0,0,0,0.0820517797945726,104.162209401239,9.73519417159801
8.7,"greedy_SVM","SVM",35,8,3012,2951,61,900,573,327,0.923360448052716,0.706422018348624,1.69058621154884,570,269,301,57,1.1,23.01,1.8,0,0,0,0,0,0,0.0923179950977267,129.886113974741,11.7222380898793
8.7,"greedy_SVM","SVM",35,9,2912,2858,54,1000,666,334,0.925760918909229,0.706422018348624,1.71179977169915,593,285,308,23,1.1,25.56,2,0,0,0,0,0,0,0.0731493336141697,96.1439268609571,8.18515130209667
8.7,"greedy_SVM","SVM",35,10,2812,2767,45,1100,757,343,0.930569778612987,0.701834862385321,1.7448780281571,620,296,324,27,1.1,28.12,2.2,0,0,0,0,0,0,0.0697170879941714,84.1892020998224,7.82497135420452
8.7,"greedy_SVM","SVM",35,11,2712,2675,37,1200,849,351,0.932646931514669,0.701834862385321,1.75153327588829,638,308,330,18,1.1,30.67,2.4,0,0,0,0,0,0,0.0715654209693836,80.474839164109,7.99208133677168
8.7,"greedy_SVM","SVM",35,12,2612,2580,32,1300,944,356,0.932924061190239,0.701834862385321,1.74992192972832,650,314,336,12,1.1,33.23,2.7,0,0,0,0,0,0,0.0649053982809227,70.2513921764091,7.10366888309513
8.7,"greedy_SVM","SVM",35,13,2512,2482,30,1400,1042,358,0.933264534791655,0.706422018348624,1.75153327588829,655,315,340,5,1.1,35.79,2.9,0,0,0,0,0,0,0.053446200756324,57.0586016388948,5.86246094498608
8.7,"greedy_SVM","SVM",35,14,2412,2384,28,1500,1140,360,0.933515271164789,0.701834862385321,1.75153327588829,664,317,347,9,1.1,38.34,3.2,0,0,0,0,0,0,0.0444510538553427,46.5765149851614,4.80051569538163
8.7,"greedy_SVM","SVM",35,15,2312,2290,22,1600,1234,366,0.933973194962044,0.697247706422018,1.74510563083916,690,324,366,26,1.1,40.9,3.4,0,0,0,0,0,0,0.0413493347880203,44.6060291815763,4.59414723433265
8.7,"greedy_SVM","SVM",35,16,2212,2192,20,1700,1332,368,0.934122317120803,0.692660550458716,1.75314759227159,692,328,364,2,1.1,43.46,3.6,0,0,0,0,0,0,0.0346830592060131,35.7216086289817,3.70113582707942
8.7,"greedy_SVM","SVM",35,17,2112,2092,20,1800,1432,368,0.934103841809098,0.692660550458716,1.74510563083916,698,328,370,6,1.1,46.01,3.9,0,0,0,0,0,0,0.033031378946408,33.8876557624147,3.50702390634999
8.7,"greedy_SVM","SVM",35,18,2012,1992,20,1900,1532,368,0.933772605863532,0.692660550458716,1.75153327588829,702,330,372,4,1.1,48.57,4.2,0,0,0,0,0,0,0.0242000477457261,22.9043093959802,2.57403636152302
8.7,"greedy_SVM","SVM",35,19,1912,1893,19,2000,1631,369,0.933872900412785,0.697247706422018,1.75979522530285,705,333,372,3,1.1,51.12,4.4,0,0,0,0,0,0,0.020367480453658,19.0937069098926,2.17792051635143
8.7,"greedy_SVM","SVM",35,20,1812,1798,14,2100,1726,374,0.93466997814634,0.697247706422018,1.7533372611733,712,340,372,7,1.1,53.68,4.6,0,0,0,0,0,0,0.0178975040056372,17.1596172936794,1.93103016967524
8.7,"greedy_SVM","SVM",35,21,1712,1701,11,2200,1823,377,0.935424826595995,0.692660550458716,1.75656030760928,730,348,382,18,1.1,56.24,4.8,0,0,0,0,0,0,0.0154306129334884,14.0582512064417,1.75512642379142
8.7,"greedy_SVM","SVM",35,22,1612,1604,8,2300,1920,380,0.935787734504487,0.697247706422018,1.75656030760928,744,356,388,14,1.1,58.79,5.1,0,0,0,0,0,0,0.0130327361229884,11.1254316639632,1.3943799419334
8.7,"greedy_SVM","SVM",35,23,1512,1504,8,2400,2020,380,0.935807529481316,0.701834862385321,1.75656030760928,751,363,388,7,1.1,61.35,5.3,0,0,0,0,0,0,0.00847129504823444,6.29067480130126,1.04027503909187
8.7,"greedy_SVM","SVM",35,24,1412,1407,5,2500,2117,383,0.935496088512572,0.701834862385321,1.75979522530285,755,366,389,4,1.1,63.91,5.5,0,0,0,0,0,0,0.00921428600736305,6.86438978773874,0.950674727154716
8.7,"greedy_SVM","SVM",35,25,1312,1308,4,2600,2216,384,0.937158866565997,0.697247706422018,1.76480706961684,769,371,398,14,1.1,66.46,5.8,0,0,0,0,0,0,0.00656824939374037,4.47818892795001,0.765671897912317
8.7,"greedy_SVM","SVM",35,26,1212,1208,4,2700,2316,384,0.937255202119887,0.697247706422018,1.76643062717858,768,371,397,-1,1.1,69.02,6,0,0,0,0,0,0,0.00601113827072707,3.69203783936604,0.617397222490751
8.7,"greedy_SVM","SVM",35,27,1112,1108,4,2800,2416,384,0.937297431403781,0.701834862385321,1.76968672050057,771,376,395,3,1.1,71.57,6.3,0,0,0,0,0,0,0.00438943693458868,2.49863908045106,0.495158431096269
8.7,"greedy_SVM","SVM",35,28,1012,1008,4,2900,2516,384,0.937344939348165,0.701834862385321,1.76968672050057,773,376,397,2,1.1,74.13,6.6,0,0,0,0,0,0,0.00367275503915388,1.7399816808905,0.376419155398649
8.7,"greedy_SVM","SVM",35,29,912,908,4,3000,2616,384,0.937517815479116,0.701834862385321,1.76480706961684,775,378,397,2,1.1,76.69,6.8,0,0,0,0,0,0,0.00324596682473996,1.32270280350997,0.349628807667045
8.7,"greedy_SVM","SVM",35,30,812,809,3,3100,2715,385,0.937388488297182,0.701834862385321,1.75834257485634,779,379,400,4,1.1,79.24,7.1,0,0,0,0,0,0,0.00228505285807101,0.794333605276202,0.248774959129489
8.7,"greedy_SVM","SVM",35,31,712,709,3,3200,2815,385,0.9375349711257,0.706422018348624,1.76318649379533,781,380,401,2,1.1,81.8,7.3,0,0,0,0,0,0,0.00174812249387031,0.564233496890515,0.204556783355765
8.7,"greedy_SVM","SVM",35,32,612,610,2,3300,2914,386,0.937827936782737,0.701834862385321,1.7681783398784,785,382,403,4,1.1,84.36,7.5,0,0,0,0,0,0,0.0011158789264897,0.366816652972699,0.144752004917563
8.7,"greedy_SVM","SVM",35,33,512,512,0,3400,3012,388,0.937595675721305,0.701834862385321,1.76668645931774,796,386,410,11,1.1,86.91,7.8,0,0,0,0,0,0,0.00107812539353599,0.361401670439142,0.135567596839375
8.7,"greedy_SVM","SVM",35,34,412,412,0,3500,3112,388,0.937734240559092,0.697247706422018,1.77803215217574,794,387,407,-2,1.1,89.47,8,0,0,0,0,0,0,0.000694526523381588,0.207579874322111,0.0849358274579608
8.7,"greedy_SVM","SVM",35,35,312,312,0,3600,3212,388,0.937566643088627,0.697247706422018,1.77142568301868,795,387,408,1,1.1,92.02,8.3,0,0,0,0,0,0,0.000571527862871419,0.145298670562942,0.068089601016863
8.7,"greedy_SVM","SVM",35,36,212,212,0,3700,3312,388,0.937426758585719,0.697247706422018,1.77468497590372,799,388,411,4,1.1,94.58,8.5,0,0,0,0,0,0,0.000218470348449464,0.0433335926696512,0.0275287539524396
8.7,"greedy_SVM","SVM",35,37,112,112,0,3800,3412,388,0.937368693320361,0.688073394495413,1.77305383162439,802,388,414,3,1.1,97.14,8.8,0,0,0,0,0,0,7.37647354847917e-05,0.0134913191580386,0.0127099629570841
8.7,"greedy_SVM","SVM",35,38,12,12,0,3900,3512,388,0.93809978779783,0.688073394495413,1.77468497590372,798,388,410,-4,1.1,99.69,9.1,0,0,0,0,0,0,4.98995534151931e-05,0.000676924971572496,0.000676924971572496
8.7,"greedy_SVM","SVM",35,39,0,0,0,3912,3524,388,0.93821063966806,0.688073394495413,1.77142568301868,798,388,410,0,1.1,100,9.1,0,0,0,0,0,0,0,0,0
8.7,"greedy_SVM","SVM",36,0,3812,3413,399,100,91,9,0.892885050734876,0.505050505050505,1.75663139182846,24,9,15,0,1.7,2.56,10.1,0,0,0,0,0,0,0.651123089206591,353.962972401427,75.7077147022456
8.7,"greedy_SVM","SVM",36,1,3712,3359,353,200,145,55,0.915346583008694,0.601010101010101,1.7647190133378,107,52,55,83,1.1,5.11,2.6,0,0,0,0,0,0,0.721754239876933,329.351490241425,79.9400592949479
8.7,"greedy_SVM","SVM",36,2,3612,3346,266,300,158,142,0.914705933050636,0.611111111111111,1.76147504456328,135,70,65,28,0.9,7.67,1.1,0,0,0,0,0,0,0.605967790138921,251.443217427874,70.8561476087113
8.7,"greedy_SVM","SVM",36,3,3512,3304,208,400,200,200,0.90326760207304,0.616161616161616,1.7299259879905,210,109,101,75,0.9,10.22,1,0,0,0,0,0,0,0.332756552684219,109.032424542395,49.1981440651226
8.7,"greedy_SVM","SVM",36,4,3412,3239,173,500,265,235,0.897102423552933,0.621212121212121,1.71923656454043,310,157,153,100,1,12.78,1.1,0,0,0,0,0,0,0.122636484858021,54.5560963989269,19.4464535596618
8.7,"greedy_SVM","SVM",36,5,3312,3171,141,600,333,267,0.880536020041154,0.626262626262626,1.63736815670517,380,185,195,70,1.1,15.34,1.2,0,0,0,0,0,0,0.0866611007060319,53.8493982721693,13.7853174519086
8.7,"greedy_SVM","SVM",36,6,3212,3093,119,700,411,289,0.891142655221154,0.631313131313131,1.65556113622412,433,212,221,53,1,17.89,1.4,0,0,0,0,0,0,0.0608121258432594,39.9594392591495,9.60162788891311
8.7,"greedy_SVM","SVM",36,7,3112,3019,93,800,485,315,0.895059813148552,0.656565656565657,1.67529674626449,487,234,253,54,1.1,20.45,1.5,0,0,0,0,0,0,0.0547791009411538,49.730117136486,9.08206936389205
8.7,"greedy_SVM","SVM",36,8,3012,2941,71,900,563,337,0.897981521701655,0.666666666666667,1.6600717923032,539,259,280,52,1.1,23.01,1.7,0,0,0,0,0,0,0.0558239049237243,69.7450736413308,7.96120226199371
8.7,"greedy_SVM","SVM",36,9,2912,2859,53,1000,645,355,0.9010569287873,0.666666666666667,1.66465762598359,586,280,306,47,1.1,25.56,1.8,0,0,0,0,0,0,0.0606882176916841,89.0021610341069,7.22866718271512
8.7,"greedy_SVM","SVM",36,10,2812,2767,45,1100,737,363,0.911689419795227,0.661616161616162,1.68285060550254,611,294,317,25,1.1,28.12,2,0,0,0,0,0,0,0.05528438651564,79.6341502457907,6.12131395287595
8.7,"greedy_SVM","SVM",36,11,2712,2675,37,1200,829,371,0.92568747773526,0.671717171717172,1.7299259879905,642,307,335,31,1.1,30.67,2.2,0,0,0,0,0,0,0.0624470105058004,78.8070803190071,7.13416033826863
8.7,"greedy_SVM","SVM",36,12,2612,2582,30,1300,922,378,0.930140425874198,0.661616161616162,1.74813573523251,660,319,341,18,1.1,33.23,2.4,0,0,0,0,0,0,0.0596710716008911,65.7166034626419,6.58221787172408
8.7,"greedy_SVM","SVM",36,13,2512,2485,27,1400,1019,381,0.929985290906783,0.651515151515151,1.74652603381885,672,322,350,12,1.1,35.79,2.7,0,0,0,0,0,0,0.0553642232929891,56.2332310362793,5.9609374350532
8.7,"greedy_SVM","SVM",36,14,2412,2387,25,1500,1117,383,0.928703990990669,0.656565656565657,1.74491929413733,682,327,355,10,1.1,38.34,2.9,0,0,0,0,0,0,0.0490090741259311,49.4626976330181,5.42136882663513
8.7,"greedy_SVM","SVM",36,15,2312,2295,17,1600,1209,391,0.92689408303742,0.661616161616162,1.7417146673345,710,335,375,28,1.1,40.9,3.1,0,0,0,0,0,0,0.0481503994130245,43.8658673395641,5.97068740976951
8.7,"greedy_SVM","SVM",36,16,2212,2200,12,1700,1304,396,0.926816515553709,0.661616161616162,1.74491929413733,719,342,377,9,1.1,43.46,3.3,0,0,0,0,0,0,0.0360415456511702,37.7563659619411,4.42681645250884
8.7,"greedy_SVM","SVM",36,17,2112,2103,9,1800,1401,399,0.927095183921118,0.661616161616162,1.74491929413733,727,345,382,8,1.1,46.01,3.5,0,0,0,0,0,0,0.0307549101269463,33.5969151166677,3.3558095312345
8.7,"greedy_SVM","SVM",36,18,2012,2003,9,1900,1501,399,0.927075073832743,0.651515151515151,1.74813573523251,731,352,379,4,1.1,48.57,3.8,0,0,0,0,0,0,0.0220538292477382,22.8045250122792,2.60559679845434
8.7,"greedy_SVM","SVM",36,19,1912,1904,8,2000,1600,400,0.927342250721084,0.651515151515151,1.75562252357832,737,352,385,6,1.1,51.12,4,0,0,0,0,0,0,0.0181215997581201,17.6081790685678,1.8910713621218
8.7,"greedy_SVM","SVM",36,20,1812,1805,7,2100,1699,401,0.929741096976583,0.646464646464647,1.78291199285674,752,366,386,15,1.1,53.68,4.2,0,0,0,0,0,0,0.0127223612452965,10.2778723843118,1.55909452404694
8.7,"greedy_SVM","SVM",36,21,1712,1705,7,2200,1799,401,0.929584525574278,0.646464646464647,1.77963458110517,751,364,387,-1,1.1,56.24,4.5,0,0,0,0,0,0,0.00887348162338518,7.6822051454364,0.969808425346625
8.7,"greedy_SVM","SVM",36,22,1612,1605,7,2300,1899,401,0.930037002562597,0.641414141414141,1.77218365810822,760,372,388,9,1,58.79,4.7,0,0,0,0,0,0,0.00690593446881101,5.66888721132198,0.778529537570188
8.7,"greedy_SVM","SVM",36,23,1512,1505,7,2400,1999,401,0.930134680134679,0.646464646464647,1.77218365810822,759,371,388,-1,1,61.35,5,0,0,0,0,0,0,0.00534144238977392,3.96629992202754,0.556355829364278
8.7,"greedy_SVM","SVM",36,24,1412,1405,7,2500,2099,401,0.930686271129957,0.636363636363636,1.77381550309727,771,376,395,12,1.1,63.91,5.2,0,0,0,0,0,0,0.00464486656636499,3.22885634665502,0.532019174308572
8.7,"greedy_SVM","SVM",36,25,1312,1306,6,2600,2198,402,0.931099964376415,0.641414141414141,1.77055481283422,776,378,398,5,1.1,66.46,5.5,0,0,0,0,0,0,0.00438811093513329,2.79253342376848,0.450233624200825
8.7,"greedy_SVM","SVM",36,26,1212,1206,6,2700,2298,402,0.931967571046068,0.636363636363636,1.77636919655268,780,381,399,4,1,69.02,5.7,0,0,0,0,0,0,0.00339563355581427,1.98838327815036,0.374249243784485
8.7,"greedy_SVM","SVM",36,27,1112,1106,6,2800,2398,402,0.932125578883257,0.631313131313131,1.77800038957064,780,381,399,0,1,71.57,6,0,0,0,0,0,0,0.00302045280986171,1.49103011167963,0.310402257636551
8.7,"greedy_SVM","SVM",36,28,1012,1006,6,2900,2498,402,0.932928545983153,0.626262626262626,1.77963458110517,787,383,404,7,1.1,74.13,6.2,0,0,0,0,0,0,0.00241144207369341,1.06685894557165,0.258400010374219
8.7,"greedy_SVM","SVM",36,29,912,907,5,3000,2597,403,0.933185667827307,0.626262626262626,1.78127177943185,792,386,406,5,1.1,76.69,6.4,0,0,0,0,0,0,0.00230170294781912,0.885602762738726,0.250808722542708
8.7,"greedy_SVM","SVM",36,30,812,809,3,3100,2695,405,0.933626653336551,0.626262626262626,1.77636919655268,799,390,409,7,1,79.24,6.7,0,0,0,0,0,0,0.00194664449843724,0.677959025903129,0.21688126411789
8.7,"greedy_SVM","SVM",36,31,712,709,3,3200,2795,405,0.933734385952817,0.626262626262626,1.77636919655268,801,390,411,2,1.1,81.8,6.9,0,0,0,0,0,0,0.00150891039113743,0.483735973907069,0.17472611481255
8.7,"greedy_SVM","SVM",36,32,612,609,3,3300,2895,405,0.933768860390021,0.626262626262626,1.78127177943185,801,390,411,0,1.1,84.36,7.1,0,0,0,0,0,0,0.00106605087567859,0.326783797332336,0.132282121050819
8.7,"greedy_SVM","SVM",36,33,512,510,2,3400,2994,406,0.934150952069041,0.636363636363636,1.78127177943185,805,394,411,4,1,86.91,7.4,0,0,0,0,0,0,0.00082430250924846,0.262184397602149,0.108005239923872
8.7,"greedy_SVM","SVM",36,34,412,411,1,3500,3093,407,0.934584755403868,0.636363636363636,1.77963458110517,809,395,414,4,1,89.47,7.6,0,0,0,0,0,0,0.000621816083645982,0.185914910686483,0.0774528866812765
8.7,"greedy_SVM","SVM",36,35,312,312,0,3600,3192,408,0.934834695073604,0.631313131313131,1.78127177943185,814,400,414,5,1,92.02,7.8,0,0,0,0,0,0,0.000538676943595184,0.134928228440078,0.0639249950546917
8.7,"greedy_SVM","SVM",36,36,212,212,0,3700,3292,408,0.934870605945692,0.636363636363636,1.79200848261622,816,402,414,2,1,94.58,8.1,0,0,0,0,0,0,0.000228256475360271,0.049360675724266,0.0308171587701588
8.7,"greedy_SVM","SVM",36,37,112,112,0,3800,3392,408,0.935098999092174,0.636363636363636,1.78871434937611,819,402,417,3,1,97.14,8.3,0,0,0,0,0,0,0.000120478417964079,0.0182349545107494,0.0169509792570209
8.7,"greedy_SVM","SVM",36,38,12,12,0,3900,3492,408,0.935432251985154,0.636363636363636,1.78543230469836,822,404,418,3,1,99.69,8.6,0,0,0,0,0,0,8.14450582523984e-05,0.00113509651861276,0.00113509651861276
8.7,"greedy_SVM","SVM",36,39,0,0,0,3912,3504,408,0.935380540329347,0.636363636363636,1.79200848261622,822,404,418,0,1,100,8.6,0,0,0,0,0,0,0,0,0
8.7,"greedy_SVM","SVM",37,0,3812,3417,395,100,89,11,0.900808656036458,0.505,1.75769585253456,33,11,22,0,2,2.56,8.1,0,0,0,0,0,0,0.26322907211477,405.478133580062,30.8796965028928
8.7,"greedy_SVM","SVM",37,1,3712,3382,330,200,124,76,0.922423120728938,0.595,1.76508287292818,106,52,54,73,1,5.11,1.6,0,0,0,0,0,0,0.687149140269114,355.233126055567,76.5888581244366
8.7,"greedy_SVM","SVM",37,2,3612,3360,252,300,146,154,0.916352505694768,0.595,1.72588235294118,153,80,73,47,0.9,7.67,0.9,0,0,0,0,0,0,0.480818676741891,209.272955591137,60.5493143061205
8.7,"greedy_SVM","SVM",37,3,3512,3307,205,400,199,201,0.917148348519378,0.625,1.74386029411765,248,127,121,95,1,10.22,1,0,0,0,0,0,0,0.264403465345763,146.205658309633,40.4206913616196
8.7,"greedy_SVM","SVM",37,4,3412,3250,162,500,256,244,0.926059225512525,0.665,1.70633608815427,329,166,163,81,1,12.78,1,0,0,0,0,0,0,0.210550941976858,135.792949784236,29.5950870601719
8.7,"greedy_SVM","SVM",37,5,3312,3187,125,600,319,281,0.897561218678814,0.66,1.63,416,207,209,87,1,15.34,1.1,0,0,0,0,0,0,0.131549783300924,140.686176013384,20.15158430485
8.7,"greedy_SVM","SVM",37,6,3212,3112,100,700,394,306,0.898673120728939,0.68,1.62248847926267,469,229,240,53,1,17.89,1.3,0,0,0,0,0,0,0.090262828615051,120.386147418371,12.0599849082613
8.7,"greedy_SVM","SVM",37,7,3112,3027,85,800,479,321,0.905296127562638,0.685,1.64051612903226,518,246,272,49,1.1,20.45,1.5,0,0,0,0,0,0,0.0783773356748845,114.932865944814,9.42345951629126
8.7,"greedy_SVM","SVM",37,8,3012,2936,76,900,570,330,0.911904897494313,0.685,1.66448942042318,541,259,282,23,1.1,23.01,1.7,0,0,0,0,0,0,0.0671348903736041,107.21684586422,7.55251801677812
8.7,"greedy_SVM","SVM",37,9,2912,2844,68,1000,662,338,0.930515375854223,0.67,1.7332782369146,568,274,294,27,1.1,25.56,2,0,0,0,0,0,0,0.0598186979540987,79.2839449189217,6.85454351887802
8.7,"greedy_SVM","SVM",37,10,2812,2757,55,1100,749,351,0.940458428246023,0.665,1.75284926470588,602,290,312,34,1.1,28.12,2.1,0,0,0,0,0,0,0.0780022192402264,102.3649476687,8.99632337767091
8.7,"greedy_SVM","SVM",37,11,2712,2666,46,1200,840,360,0.943926537585439,0.66,1.74546458141674,633,307,326,31,1.1,30.67,2.3,0,0,0,0,0,0,0.0692676126644012,79.6610232351994,7.79926555965638
8.7,"greedy_SVM","SVM",37,12,2612,2573,39,1300,933,367,0.946660022779053,0.665,1.76670967741935,650,314,336,17,1.1,33.23,2.5,0,0,0,0,0,0,0.0626400904653876,70.9999484226203,6.88195237301851
8.7,"greedy_SVM","SVM",37,13,2512,2476,36,1400,1030,370,0.947243735763109,0.665,1.76670967741935,660,318,342,10,1.1,35.79,2.8,0,0,0,0,0,0,0.0588075913452048,60.4774146476967,6.19901534599176
8.7,"greedy_SVM","SVM",37,14,2412,2379,33,1500,1127,373,0.947292141230081,0.66,1.76022038567493,669,322,347,9,1.1,38.34,3,0,0,0,0,0,0,0.0526114668231536,51.3442808812401,5.80230019024641
8.7,"greedy_SVM","SVM",37,15,2312,2289,23,1600,1217,383,0.946744020501152,0.65,1.77408839779006,700,333,367,31,1.1,40.9,3.2,0,0,0,0,0,0,0.0506176882178891,49.6855175377103,6.50388860273951
8.7,"greedy_SVM","SVM",37,16,2212,2197,15,1700,1309,391,0.945784453302978,0.65,1.76508287292818,722,342,380,22,1.1,43.46,3.3,0,0,0,0,0,0,0.0414291336165384,45.9102350363972,4.99445355968971
8.7,"greedy_SVM","SVM",37,17,2112,2099,13,1800,1407,393,0.945496867881568,0.66,1.76183823529412,724,344,380,2,1.1,46.01,3.6,0,0,0,0,0,0,0.0411754392720147,43.829511294578,4.2371963923782
8.7,"greedy_SVM","SVM",37,18,2012,2000,12,1900,1506,394,0.944271070615046,0.645,1.77818181818182,754,363,391,30,1.1,48.57,3.8,0,0,0,0,0,0,0.0272157309659813,20.3014536763776,3.59599881147971
8.7,"greedy_SVM","SVM",37,19,1912,1901,11,2000,1605,395,0.944179954441924,0.645,1.78145354185833,755,363,392,1,1.1,51.12,4.1,0,0,0,0,0,0,0.017876816647728,15.0199710803698,2.13575675269716
8.7,"greedy_SVM","SVM",37,20,1812,1802,10,2100,1704,396,0.943852505694765,0.645,1.77082720588235,757,365,392,2,1.1,53.68,4.3,0,0,0,0,0,0,0.0148883890504764,13.2631841371764,1.6469895558005
8.7,"greedy_SVM","SVM",37,21,1712,1704,8,2200,1802,398,0.944255410022781,0.645,1.77082720588235,762,369,393,5,1.1,56.24,4.5,0,0,0,0,0,0,0.013545871048622,11.3111963087303,1.41686929708596
8.7,"greedy_SVM","SVM",37,22,1612,1606,6,2300,1900,400,0.94458143507973,0.65,1.78880514705882,788,378,410,26,1.1,58.79,4.8,0,0,0,0,0,0,0.0099374313779098,7.90663359402587,1.21171379039746
8.7,"greedy_SVM","SVM",37,23,1512,1507,5,2400,1999,401,0.944346526195903,0.645,1.79209944751381,793,381,412,5,1.1,61.35,5,0,0,0,0,0,0,0.0106244783661957,7.54053410098294,1.08805359370511
8.7,"greedy_SVM","SVM",37,24,1412,1407,5,2500,2099,401,0.943903758542147,0.64,1.78880514705882,800,387,413,7,1.1,63.91,5.2,0,0,0,0,0,0,0.00705128661939407,4.59053739601966,0.804366989048651
8.7,"greedy_SVM","SVM",37,25,1312,1307,5,2600,2199,401,0.943989179954448,0.64,1.78880514705882,799,386,413,-1,1.1,66.46,5.5,0,0,0,0,0,0,0.00595849717516402,3.62064929630296,0.623730547709601
8.7,"greedy_SVM","SVM",37,26,1212,1207,5,2700,2299,401,0.944132972665154,0.635,1.78880514705882,798,388,410,-1,1.1,69.02,5.7,0,0,0,0,0,0,0.00507758926445236,2.86836554823532,0.541146306288672
8.7,"greedy_SVM","SVM",37,27,1112,1108,4,2800,2398,402,0.944601366742601,0.635,1.78552293577982,801,390,411,3,1.1,71.57,6,0,0,0,0,0,0,0.00457442302780424,2.31467054140027,0.480179603010753
8.7,"greedy_SVM","SVM",37,28,1012,1008,4,2900,2498,402,0.944458997722099,0.635,1.78880514705882,803,392,411,2,1,74.13,6.2,0,0,0,0,0,0,0.00389103848545097,1.77059313640621,0.418733528218691
8.7,"greedy_SVM","SVM",37,29,912,909,3,3000,2597,403,0.944709567198181,0.635,1.78716253443526,810,394,416,7,1.1,76.69,6.4,0,0,0,0,0,0,0.003331763616715,1.38270750636468,0.363265519381098
8.7,"greedy_SVM","SVM",37,30,812,809,3,3100,2697,403,0.944733769931666,0.635,1.79209944751381,808,394,414,-2,1.1,79.24,6.7,0,0,0,0,0,0,0.00253299230779708,0.955356860420768,0.283781127296128
8.7,"greedy_SVM","SVM",37,31,712,710,2,3200,2796,404,0.94479498861048,0.635,1.79375115207373,814,395,419,6,1.1,81.8,6.9,0,0,0,0,0,0,0.00204169361629027,0.692862325421656,0.228528115451342
8.7,"greedy_SVM","SVM",37,32,612,610,2,3300,2896,404,0.94473804100228,0.64,1.79045078196872,814,395,419,0,1.1,84.36,7.2,0,0,0,0,0,0,0.00155476801983243,0.485574235947048,0.182650649379847
8.7,"greedy_SVM","SVM",37,33,512,510,2,3400,2996,404,0.944730922551254,0.64,1.79209944751381,814,396,418,0,1.1,86.91,7.4,0,0,0,0,0,0,0.000981441358322127,0.288278295886163,0.124742493146897
8.7,"greedy_SVM","SVM",37,34,412,411,1,3500,3095,405,0.94484339407745,0.64,1.79045078196872,816,397,419,2,1.1,89.47,7.6,0,0,0,0,0,0,0.000843594823369194,0.243314361315033,0.10929100536774
8.7,"greedy_SVM","SVM",37,35,312,312,0,3600,3194,406,0.945472665148065,0.635,1.79045078196872,822,402,420,6,1,92.02,7.9,0,0,0,0,0,0,0.000596566279659684,0.145166200728434,0.0741887360314959
8.7,"greedy_SVM","SVM",37,36,212,212,0,3700,3294,406,0.945498291571755,0.635,1.79045078196872,826,402,424,4,1.1,94.58,8.1,0,0,0,0,0,0,0.000226026066245717,0.051607675320245,0.0336324495184842
8.7,"greedy_SVM","SVM",37,37,112,112,0,3800,3394,406,0.945666287015946,0.635,1.80276497695853,829,402,427,3,1.1,97.14,8.4,0,0,0,0,0,0,0.000106115835884754,0.0188720718903835,0.0177209231666599
8.7,"greedy_SVM","SVM",37,38,12,12,0,3900,3494,406,0.945881264236903,0.63,1.79779411764706,833,404,429,4,1.1,99.69,8.6,0,0,0,0,0,0,6.05760693431588e-05,0.000880641453370743,0.000880641453370743
8.7,"greedy_SVM","SVM",37,39,0,0,0,3912,3506,406,0.945802961275627,0.63,1.80110497237569,835,404,431,2,1.1,100,8.6,0,0,0,0,0,0,0,0,0
8.7,"greedy_SVM","SVM",38,0,3812,3418,394,100,91,9,0.90675520360593,0.551724137931034,1.75836189870832,23,9,14,0,1.6,2.56,10.1,0,0,0,0,0,0,0.345760198404571,319.15800283929,38.7181480056156
8.7,"greedy_SVM","SVM",38,1,3712,3391,321,200,118,82,0.919563647399677,0.596059113300493,1.76075126545346,87,46,41,64,0.9,5.11,1.4,0,0,0,0,0,0,0.712664024832911,261.18167834874,80.0343431164944
8.7,"greedy_SVM","SVM",38,2,3612,3358,254,300,151,149,0.923586308060213,0.605911330049261,1.77122573167198,151,78,73,64,0.9,7.67,1,0,0,0,0,0,0,0.416904828380846,135.970861800128,54.777528455429
8.7,"greedy_SVM","SVM",38,3,3512,3310,202,400,199,201,0.9163278152302,0.625615763546798,1.76561521922543,239,123,116,88,0.9,10.22,1,0,0,0,0,0,0,0.209750797940457,79.1642098024496,34.5106386871008
8.7,"greedy_SVM","SVM",38,4,3412,3254,158,500,255,245,0.871721665041491,0.61576354679803,1.64875533057495,330,167,163,91,1,12.78,1,0,0,0,0,0,0,0.225428776731431,135.840194362952,33.8168795572502
8.7,"greedy_SVM","SVM",38,5,3312,3179,133,600,330,270,0.893769723401682,0.645320197044335,1.6695557422079,392,195,197,62,1,15.34,1.2,0,0,0,0,0,0,0.0842823517743939,47.8486951878796,13.7685160412576
8.7,"greedy_SVM","SVM",38,6,3212,3107,105,700,402,298,0.893126210100067,0.660098522167488,1.65914595977465,457,222,235,65,1.1,17.89,1.3,0,0,0,0,0,0,0.0744366181623128,63.4177285856826,11.1009944262178
8.7,"greedy_SVM","SVM",38,7,3112,3030,82,800,479,321,0.895104521734731,0.669950738916256,1.63403327960773,512,244,268,55,1.1,20.45,1.5,0,0,0,0,0,0,0.07982454203463,107.929081790373,11.4631091293822
8.7,"greedy_SVM","SVM",38,8,3012,2942,70,900,567,333,0.902323673140214,0.689655172413793,1.65027352148709,546,261,285,34,1.1,23.01,1.7,0,0,0,0,0,0,0.0525388236832037,71.7219451431948,6.41765876560497
8.7,"greedy_SVM","SVM",38,9,2912,2859,53,1000,650,350,0.911335669464612,0.684729064039409,1.67689083634978,585,280,305,39,1.1,25.56,1.9,0,0,0,0,0,0,0.0726118982918,116.72832094738,9.28346648044118
8.7,"greedy_SVM","SVM",38,10,2812,2765,47,1100,744,356,0.922483343121866,0.694581280788177,1.69881529129178,608,295,313,23,1.1,28.12,2.1,0,0,0,0,0,0,0.0709644127933833,99.7987187725621,8.2616561495392
8.7,"greedy_SVM","SVM",38,11,2712,2668,44,1200,841,359,0.931485504090131,0.684729064039409,1.72694508838018,634,304,330,26,1.1,30.67,2.3,0,0,0,0,0,0,0.0594142710724576,75.5547465873444,6.45973205967015
8.7,"greedy_SVM","SVM",38,12,2612,2575,37,1300,934,366,0.937514577402877,0.679802955665025,1.73739809028329,652,312,340,18,1.1,33.23,2.6,0,0,0,0,0,0,0.0586806691907664,65.9168796164593,6.41458263319744
8.7,"greedy_SVM","SVM",38,13,2512,2482,30,1400,1027,373,0.941822463391437,0.684729064039409,1.76399091819578,669,319,350,17,1.1,35.79,2.8,0,0,0,0,0,0,0.0637494661502321,67.130420795339,7.03346127964836
8.7,"greedy_SVM","SVM",38,14,2412,2385,27,1500,1124,376,0.942238358450995,0.684729064039409,1.76399091819578,669,322,347,0,1.1,38.34,3,0,0,0,0,0,0,0.0594968799362789,56.560321362232,6.32430575744329
8.7,"greedy_SVM","SVM",38,15,2312,2291,21,1600,1218,382,0.942488457507078,0.684729064039409,1.76561521922543,696,330,366,27,1.1,40.9,3.2,0,0,0,0,0,0,0.0581456730353599,49.687297254759,6.59642256519313
8.7,"greedy_SVM","SVM",38,16,2212,2196,16,1700,1313,387,0.942125954380836,0.684729064039409,1.75913589732002,713,334,379,17,1.1,43.46,3.4,0,0,0,0,0,0,0.0404046315274691,44.2565801427158,5.11613374661901
8.7,"greedy_SVM","SVM",38,17,2112,2098,14,1800,1411,389,0.941792957323009,0.684729064039409,1.76236960301362,718,336,382,5,1.1,46.01,3.6,0,0,0,0,0,0,0.0359319967673159,37.6334415823222,3.68781368231534
8.7,"greedy_SVM","SVM",38,18,2012,1998,14,1900,1511,389,0.942304395842202,0.669950738916256,1.78565553396303,736,356,380,18,1.1,48.57,3.9,0,0,0,0,0,0,0.0247360856583362,17.5527142512672,3.27577976344255
8.7,"greedy_SVM","SVM",38,19,1912,1900,12,2000,1609,391,0.942258029163265,0.669950738916256,1.79058374610828,741,357,384,5,1.1,51.12,4.1,0,0,0,0,0,0,0.0165905470921151,13.8348966129788,2.03494913022421
8.7,"greedy_SVM","SVM",38,20,1812,1801,11,2100,1708,392,0.942109093770314,0.669950738916256,1.78075437513239,744,358,386,3,1.1,53.68,4.4,0,0,0,0,0,0,0.0145985850724436,12.8252108043716,1.60761539353162
8.7,"greedy_SVM","SVM",38,21,1712,1702,10,2200,1807,393,0.942201827128188,0.669950738916256,1.79388436130848,747,361,386,3,1.1,56.24,4.6,0,0,0,0,0,0,0.0115833182357931,10.0048068798681,1.22742077121386
8.7,"greedy_SVM","SVM",38,22,1612,1604,8,2300,1905,395,0.941652452235322,0.669950738916256,1.7889379889887,758,365,393,11,1.1,58.79,4.8,0,0,0,0,0,0,0.0121251842129132,9.73261367438173,1.23785494377143
8.7,"greedy_SVM","SVM",38,23,1512,1505,7,2400,2004,396,0.94119019049682,0.655172413793103,1.79388436130848,769,373,396,11,1.1,61.35,5.1,0,0,0,0,0,0,0.00871547410205137,6.30112611737712,1.03310641476002
8.7,"greedy_SVM","SVM",38,24,1412,1406,6,2500,2103,397,0.94128573395645,0.655172413793103,1.79223253408813,771,374,397,2,1.1,63.91,5.3,0,0,0,0,0,0,0.0082484065260476,5.5111356171876,0.856009458848804
8.7,"greedy_SVM","SVM",38,25,1312,1306,6,2600,2203,397,0.94094571164424,0.650246305418719,1.79388436130848,777,380,397,6,1,66.46,5.5,0,0,0,0,0,0,0.00662596418598476,4.1521913930073,0.766666530127098
8.7,"greedy_SVM","SVM",38,26,1212,1206,6,2700,2303,397,0.940886699507411,0.650246305418719,1.79058374610828,778,380,398,1,1,69.02,5.8,0,0,0,0,0,0,0.00519483242916487,2.90824726771728,0.536733800827215
8.7,"greedy_SVM","SVM",38,27,1112,1106,6,2800,2403,397,0.940788345946027,0.650246305418719,1.7889379889887,779,380,399,1,1.1,71.57,6.1,0,0,0,0,0,0,0.00425198738048504,2.12976591458605,0.453108594118
8.7,"greedy_SVM","SVM",38,28,1012,1007,5,2900,2502,398,0.941038445002114,0.650246305418719,1.7889379889887,779,381,398,0,1,74.13,6.3,0,0,0,0,0,0,0.00407657387255323,1.78333196171492,0.426995126967259
8.7,"greedy_SVM","SVM",38,29,912,907,5,3000,2602,398,0.941001913679314,0.650246305418719,1.7889379889887,787,385,402,8,1,76.69,6.5,0,0,0,0,0,0,0.00321884819498724,1.21616535704364,0.344974985915048
8.7,"greedy_SVM","SVM",38,30,812,808,4,3100,2701,399,0.941079191477541,0.650246305418719,1.79223253408813,789,387,402,2,1,79.24,6.8,0,0,0,0,0,0,0.00286171808372545,0.97327525653106,0.318832169126553
8.7,"greedy_SVM","SVM",38,31,712,709,3,3200,2800,400,0.941119937952968,0.640394088669951,1.7889379889887,794,388,406,5,1,81.8,7,0,0,0,0,0,0,0.0021676626333477,0.681804418279304,0.256502596963429
8.7,"greedy_SVM","SVM",38,32,612,609,3,3300,2900,400,0.94124920263364,0.645320197044335,1.79388436130848,794,388,406,0,1,84.36,7.2,0,0,0,0,0,0,0.00152349804559955,0.457394360152987,0.192408838578726
8.7,"greedy_SVM","SVM",38,33,512,509,3,3400,3000,400,0.941586414844092,0.645320197044335,1.79058374610828,795,388,407,1,1,86.91,7.5,0,0,0,0,0,0,0.000811179548268448,0.247347814599185,0.11050495888531
8.7,"greedy_SVM","SVM",38,34,412,412,0,3500,3097,403,0.942345142317609,0.640394088669951,1.78729525437989,807,394,413,12,1,89.47,7.7,0,0,0,0,0,0,0.000953961859753331,0.280915464871587,0.118939349896407
8.7,"greedy_SVM","SVM",38,35,312,312,0,3600,3197,403,0.942536229236863,0.640394088669951,1.79388436130848,813,394,419,6,1.1,92.02,7.9,0,0,0,0,0,0,0.000595091288335017,0.145656381684641,0.0729195625687263
8.7,"greedy_SVM","SVM",38,36,212,212,0,3700,3297,403,0.942918403075375,0.640394088669951,1.79223253408813,818,397,421,5,1.1,94.58,8.2,0,0,0,0,0,0,0.000322584898937449,0.0685796291951751,0.043380027436413
8.7,"greedy_SVM","SVM",38,37,112,112,0,3800,3397,403,0.943221894064781,0.640394088669951,1.79388436130848,817,398,419,-1,1.1,97.14,8.4,0,0,0,0,0,0,0.00012717110065307,0.0205423658924222,0.0191621508644092
8.7,"greedy_SVM","SVM",38,38,12,12,0,3900,3497,403,0.943365209254224,0.640394088669951,1.79388436130848,816,398,418,-1,1.1,99.69,8.7,0,0,0,0,0,0,9.40181217128504e-05,0.00133347262214677,0.00133347262214677
8.7,"greedy_SVM","SVM",38,39,0,0,0,3912,3509,403,0.943396120373515,0.640394088669951,1.79388436130848,816,398,418,0,1.1,100,8.7,0,0,0,0,0,0,0,0,0
8.7,"greedy_SVM","SVM",39,0,3812,3413,399,100,90,10,0.870981146994559,0.49746192893401,1.69295188191537,30,10,20,0,2,2.56,9,0,0,0,0,0,0,0.176498268652868,377.576770250191,19.3456102049907
8.7,"greedy_SVM","SVM",39,1,3712,3366,346,200,137,63,0.903256060925246,0.573604060913706,1.70496846638979,113,55,58,83,1.1,5.11,2.2,0,0,0,0,0,0,0.671963785634744,382.565358655871,73.7402386918189
8.7,"greedy_SVM","SVM",39,2,3612,3347,265,300,156,144,0.905834533349874,0.578680203045685,1.6882838160645,153,78,75,40,1,7.67,1.1,0,0,0,0,0,0,0.633725189327659,345.217331989046,71.8643962906328
8.7,"greedy_SVM","SVM",39,3,3512,3308,204,400,195,205,0.899542021741699,0.604060913705584,1.66849855267022,227,115,112,74,1,10.22,1,0,0,0,0,0,0,0.407768604330657,258.918097916811,52.8220178882023
8.7,"greedy_SVM","SVM",39,4,3412,3256,156,500,247,253,0.91782940814895,0.634517766497462,1.75216482532099,320,160,160,93,1,12.78,1,0,0,0,0,0,0,0.311203952856749,201.54750953636,49.6993216126205
8.7,"greedy_SVM","SVM",39,5,3312,3192,120,600,311,289,0.879536134686575,0.629441624365482,1.6273943405222,402,200,202,82,1,15.34,1.1,0,0,0,0,0,0,0.207318078423168,209.496556297162,28.2910100752592
8.7,"greedy_SVM","SVM",39,6,3212,3113,99,700,390,310,0.910112748648716,0.66497461928934,1.68380079066177,461,226,235,59,1,17.89,1.3,0,0,0,0,0,0,0.0891863547900683,93.3145301215711,11.986940836181
8.7,"greedy_SVM","SVM",39,7,3112,3027,85,800,476,324,0.910508104801119,0.67005076142132,1.69740967452971,498,241,257,37,1.1,20.45,1.5,0,0,0,0,0,0,0.0741415256329981,99.1272315346798,8.98083433571552
8.7,"greedy_SVM","SVM",39,8,3012,2942,70,900,561,339,0.910457603102823,0.6751269035533,1.69139299436296,536,257,279,38,1.1,23.01,1.7,0,0,0,0,0,0,0.0798135901815085,133.475972012703,10.9579742232831
8.7,"greedy_SVM","SVM",39,9,2912,2851,61,1000,652,348,0.913396801943871,0.67005076142132,1.68983697504892,566,274,292,30,1.1,25.56,1.9,0,0,0,0,0,0,0.0602693920796312,96.2047790005095,7.45587603210398
8.7,"greedy_SVM","SVM",39,10,2812,2758,54,1100,745,355,0.924377314059958,0.680203045685279,1.71125406442256,590,284,306,24,1.1,28.12,2.1,0,0,0,0,0,0,0.0439538913297724,63.5272992444806,4.94376332225139
8.7,"greedy_SVM","SVM",39,11,2712,2665,47,1200,838,362,0.931802506615718,0.680203045685279,1.73391310839056,607,294,313,17,1.1,30.67,2.3,0,0,0,0,0,0,0.0481979957074898,67.2161909369128,5.38639536611371
8.7,"greedy_SVM","SVM",39,12,2612,2574,38,1300,929,371,0.941018345102631,0.67005076142132,1.76453431303811,636,308,328,29,1.1,33.23,2.5,0,0,0,0,0,0,0.0633424172300042,70.6630268970702,7.42458956664862
8.7,"greedy_SVM","SVM",39,13,2512,2475,37,1400,1028,372,0.943503028658988,0.66497461928934,1.77367697787251,642,311,331,6,1.1,35.79,2.8,0,0,0,0,0,0,0.0509060227948664,56.8265390635187,5.62747070158502
8.7,"greedy_SVM","SVM",39,14,2412,2378,34,1500,1125,375,0.945951639573702,0.67005076142132,1.76879081539903,653,317,336,11,1.1,38.34,3,0,0,0,0,0,0,0.0473276326390039,52.1824902395901,5.08904385926813
8.7,"greedy_SVM","SVM",39,15,2312,2281,31,1600,1222,378,0.947316628333467,0.67005076142132,1.78866825918185,661,321,340,8,1.1,40.9,3.2,0,0,0,0,0,0,0.0406226951041874,42.3634280039518,4.52887970099954
8.7,"greedy_SVM","SVM",39,16,2212,2185,27,1700,1318,382,0.948531554903994,0.66497461928934,1.79031376815993,678,326,352,17,1.1,43.46,3.5,0,0,0,0,0,0,0.0374492564060273,37.9346131552777,4.50397075490122
8.7,"greedy_SVM","SVM",39,17,2112,2090,22,1800,1413,387,0.950098550456958,0.65989847715736,1.79361388570493,691,330,361,13,1.1,46.01,3.7,0,0,0,0,0,0,0.0332647390570745,33.5882051144713,3.90787600362629
8.7,"greedy_SVM","SVM",39,18,2012,1995,17,1900,1508,392,0.950485249175369,0.654822335025381,1.79031376815993,709,338,371,18,1.1,48.57,3.8,0,0,0,0,0,0,0.0325630383067859,32.3256364203138,3.58573920882007
8.7,"greedy_SVM","SVM",39,19,1912,1896,16,2000,1607,393,0.950193782230895,0.65989847715736,1.7919623075413,712,341,371,3,1.1,51.12,4.1,0,0,0,0,0,0,0.026396706724269,24.3687342063705,2.7106273016466
8.7,"greedy_SVM","SVM",39,20,1812,1796,16,2100,1707,393,0.947674468938561,0.649746192893401,1.78702577225881,723,352,371,11,1.1,53.68,4.3,0,0,0,0,0,0,0.018247576891072,13.4846035997858,2.2712304905053
8.7,"greedy_SVM","SVM",39,21,1712,1698,14,2200,1805,395,0.947625410145927,0.644670050761421,1.78866825918185,728,354,374,5,1.1,56.24,4.6,0,0,0,0,0,0,0.0134335633627263,11.3046809079526,1.53240568996788
8.7,"greedy_SVM","SVM",39,22,1612,1601,11,2300,1902,398,0.946673092406556,0.654822335025381,1.79031376815993,743,362,381,15,1.1,58.79,4.8,0,0,0,0,0,0,0.0116066504191969,9.44022866480021,1.2666586148172
8.7,"greedy_SVM","SVM",39,23,1512,1502,10,2400,2001,399,0.946606718745938,0.649746192893401,1.7919623075413,753,368,385,10,1,61.35,5,0,0,0,0,0,0,0.00905979124914364,6.97616700397178,1.0844564456689
8.7,"greedy_SVM","SVM",39,24,1412,1403,9,2500,2100,400,0.946661549161236,0.649746192893401,1.79361388570493,756,369,387,3,1,63.91,5.2,0,0,0,0,0,0,0.00891875745798517,6.58502731923769,0.916251729415601
8.7,"greedy_SVM","SVM",39,25,1312,1303,9,2600,2200,400,0.946719265387864,0.639593908629442,1.7919623075413,771,375,396,15,1.1,66.46,5.5,0,0,0,0,0,0,0.00625094686589432,4.15422789531035,0.702302600241748
8.7,"greedy_SVM","SVM",39,26,1212,1204,8,2700,2299,401,0.947088649238287,0.639593908629442,1.7919623075413,773,375,398,2,1.1,69.02,5.7,0,0,0,0,0,0,0.00647656240610368,3.93913499104795,0.664419896072052
8.7,"greedy_SVM","SVM",39,27,1112,1105,7,2800,2398,402,0.94778124395783,0.644670050761421,1.79779411764706,779,379,400,6,1.1,71.57,6,0,0,0,0,0,0,0.00484000128413286,2.67723383292058,0.53434034943834
8.7,"greedy_SVM","SVM",39,28,1012,1006,6,2900,2497,403,0.94848826773403,0.644670050761421,1.79779411764706,782,380,402,3,1.1,74.13,6.2,0,0,0,0,0,0,0.00491680458424008,2.41662856993003,0.513030280254145
8.7,"greedy_SVM","SVM",39,29,912,908,4,3000,2595,405,0.948996170528361,0.644670050761421,1.80276497695853,791,387,404,9,1,76.69,6.4,0,0,0,0,0,0,0.00438853933653868,1.89613521520142,0.475712491234598
8.7,"greedy_SVM","SVM",39,30,812,809,3,3100,2694,406,0.948984627283035,0.639593908629442,1.79944802207912,797,390,407,6,1,79.24,6.6,0,0,0,0,0,0,0.00375506994805121,1.4685266582588,0.416190063469138
8.7,"greedy_SVM","SVM",39,31,712,709,3,3200,2794,406,0.949088516490967,0.639593908629442,1.79944802207912,797,389,408,0,1,81.8,6.9,0,0,0,0,0,0,0.00268422831621922,0.944747467435046,0.307867091192713
8.7,"greedy_SVM","SVM",39,32,612,609,3,3300,2894,406,0.949170762113912,0.639593908629442,1.79779411764706,799,389,410,2,1.1,84.36,7.1,0,0,0,0,0,0,0.0019536628500047,0.664341280856586,0.236518233763676
8.7,"greedy_SVM","SVM",39,33,512,509,3,3400,2994,406,0.949219820906546,0.639593908629442,1.80110497237569,801,390,411,2,1.1,86.91,7.4,0,0,0,0,0,0,0.00144743130237773,0.474130895582563,0.1774622181371
8.7,"greedy_SVM","SVM",39,34,412,411,1,3500,3092,408,0.950263041702857,0.639593908629442,1.79944802207912,810,395,415,9,1.1,89.47,7.6,0,0,0,0,0,0,0.0014596645220024,0.440466898854939,0.17993336285685
8.7,"greedy_SVM","SVM",39,35,312,312,0,3600,3191,409,0.950459276873395,0.639593908629442,1.80276497695853,820,398,422,10,1.1,92.02,7.8,0,0,0,0,0,0,0.00134946518269187,0.35288490474053,0.166043958338881
8.7,"greedy_SVM","SVM",39,36,212,212,0,3700,3291,409,0.950361159288126,0.639593908629442,1.79944802207912,823,398,425,3,1.1,94.58,8,0,0,0,0,0,0,0.000881360555332685,0.187582456379745,0.112231014105179
8.7,"greedy_SVM","SVM",39,37,112,112,0,3800,3391,409,0.950252941363197,0.639593908629442,1.80110497237569,827,401,426,4,1.1,97.14,8.3,0,0,0,0,0,0,0.000477115301380796,0.07095390106155,0.0657471442853759
8.7,"greedy_SVM","SVM",39,38,12,12,0,3900,3491,409,0.950065363626655,0.639593908629442,1.79779411764706,830,402,428,3,1.1,99.69,8.5,0,0,0,0,0,0,0.000352936811659253,0.00473161967602039,0.00473161967602039
8.7,"greedy_SVM","SVM",39,39,0,0,0,3912,3503,409,0.950032176796343,0.639593908629442,1.80276497695853,829,402,427,-1,1.1,100,8.6,0,0,0,0,0,0,0,0,0
8.7,"greedy_SVM","SVM",40,0,3812,3413,399,100,92,8,0.902326086894346,0.557788944723618,1.72123289257347,20,8,12,0,1.5,2.56,11.5,0,0,0,0,0,0,0.256292674406765,287.34660918553,28.3491076034404
8.7,"greedy_SVM","SVM",40,1,3712,3382,330,200,123,77,0.90353589232446,0.557788944723618,1.76003986876531,92,45,47,72,1,5.11,1.6,0,0,0,0,0,0,0.783032456567053,368.880506568608,85.1298515594491
8.7,"greedy_SVM","SVM",40,2,3612,3357,255,300,148,152,0.904671336191491,0.547738693467337,1.74198817780362,140,72,68,48,0.9,7.67,1,0,0,0,0,0,0,0.570045177158908,245.05958836037,66.1993280667057
8.7,"greedy_SVM","SVM",40,3,3512,3321,191,400,184,216,0.890239472833708,0.547738693467337,1.72123289257347,219,114,105,79,0.9,10.22,0.9,0,0,0,0,0,0,0.367008790225795,161.247639619997,50.2059921214356
8.7,"greedy_SVM","SVM",40,4,3412,3258,154,500,247,253,0.845061963202451,0.577889447236181,1.60051406988947,318,160,158,99,1,12.78,1,0,0,0,0,0,0,0.234818805588383,140.843350094364,32.2391187021919
8.7,"greedy_SVM","SVM",40,5,3312,3189,123,600,316,284,0.841764313885883,0.603015075376884,1.56147126818666,393,197,196,75,1,15.34,1.1,0,0,0,0,0,0,0.128333186227035,91.2152219577352,19.6667129446631
8.7,"greedy_SVM","SVM",40,6,3212,3119,93,700,386,314,0.847967784282831,0.618090452261307,1.58534608526503,466,228,238,73,1,17.89,1.2,0,0,0,0,0,0,0.0866319914978163,87.5048033192206,13.9399008795469
8.7,"greedy_SVM","SVM",40,7,3112,3041,71,800,464,336,0.861072579745631,0.638190954773869,1.59000886786876,509,247,262,43,1.1,20.45,1.4,0,0,0,0,0,0,0.0771214949605272,95.1102719219487,10.2677210864486
8.7,"greedy_SVM","SVM",40,8,3012,2950,62,900,555,345,0.870653781142472,0.64321608040201,1.59904300916346,531,257,274,22,1.1,23.01,1.6,0,0,0,0,0,0,0.0596182734515222,81.2094586930426,6.76278011319642
8.7,"greedy_SVM","SVM",40,9,2912,2862,50,1000,643,357,0.885051323778807,0.64321608040201,1.61562634107175,562,272,290,31,1.1,25.56,1.8,0,0,0,0,0,0,0.0548369472862184,81.9882529028665,6.44343140868446
8.7,"greedy_SVM","SVM",40,10,2812,2769,43,1100,736,364,0.891833956349749,0.628140703517588,1.63819095477387,583,281,302,21,1.1,28.12,2,0,0,0,0,0,0,0.048895224034231,73.4672050502149,5.7992758468943
8.7,"greedy_SVM","SVM",40,11,2712,2677,35,1200,828,372,0.90026684360905,0.628140703517588,1.64875992867564,616,297,319,33,1.1,30.67,2.2,0,0,0,0,0,0,0.0572081538076177,70.8220324462851,6.47080858003972
8.7,"greedy_SVM","SVM",40,12,2612,2579,33,1300,926,374,0.909725062420807,0.613065326633166,1.70311465159901,632,303,329,16,1.1,33.23,2.5,0,0,0,0,0,0,0.0439978666678093,51.3871459054063,4.93185974201945
8.7,"greedy_SVM","SVM",40,13,2512,2481,31,1400,1024,376,0.90990524620827,0.613065326633166,1.69998104598429,635,305,330,3,1.1,35.79,2.7,0,0,0,0,0,0,0.0360607662060932,42.8226236677283,3.90939608961592
8.7,"greedy_SVM","SVM",40,14,2412,2385,27,1500,1120,380,0.913011271496914,0.608040201005025,1.71806595072881,648,310,338,13,1.1,38.34,2.9,0,0,0,0,0,0,0.0298392227729061,33.6809702338327,3.27503330715336
8.7,"greedy_SVM","SVM",40,15,2312,2287,25,1600,1218,382,0.91473588774834,0.608040201005025,1.72710840310106,654,313,341,6,1.1,40.9,3.2,0,0,0,0,0,0,0.0258462729589896,29.3104390100466,2.89610221399238
8.7,"greedy_SVM","SVM",40,16,2212,2194,18,1700,1311,389,0.917896254179254,0.613065326633166,1.74680029984175,680,323,357,26,1.1,43.46,3.4,0,0,0,0,0,0,0.0307753944941045,31.7335241829521,3.95342729707514
8.7,"greedy_SVM","SVM",40,17,2112,2098,14,1800,1407,393,0.917919134660203,0.613065326633166,1.74519330784558,693,329,364,13,1.1,46.01,3.6,0,0,0,0,0,0,0.0240365671794799,27.4780875441208,2.77437394593694
8.7,"greedy_SVM","SVM",40,18,2012,2000,12,1900,1505,395,0.91820085058187,0.613065326633166,1.74680029984175,700,333,367,7,1.1,48.57,3.8,0,0,0,0,0,0,0.0201772253973978,22.7620431611927,2.16466559648123
8.7,"greedy_SVM","SVM",40,19,1912,1900,12,2000,1605,395,0.917962035561973,0.613065326633166,1.74519330784558,701,335,366,1,1.1,51.12,4.1,0,0,0,0,0,0,0.0152868338001286,16.2926619076354,1.6232758984841
8.7,"greedy_SVM","SVM",40,20,1812,1800,12,2100,1705,395,0.917438644560296,0.608040201005025,1.75746937452238,706,346,360,5,1,53.68,4.3,0,0,0,0,0,0,0.0111298029961716,9.43426970109915,1.36356377412587
8.7,"greedy_SVM","SVM",40,21,1712,1703,9,2200,1802,398,0.917703200121254,0.608040201005025,1.75262341117351,712,350,362,6,1,56.24,4.5,0,0,0,0,0,0,0.00922827818133227,9.06319544008505,1.03965497242731
8.7,"greedy_SVM","SVM",40,22,1612,1606,6,2300,1899,401,0.918465406142825,0.608040201005025,1.75423576021783,720,354,366,8,1,58.79,4.7,0,0,0,0,0,0,0.00971659314744911,9.33084557005537,1.07473794491007
8.7,"greedy_SVM","SVM",40,23,1512,1506,6,2400,1999,401,0.917784711834638,0.592964824120603,1.75423576021783,741,361,380,21,1.1,61.35,5,0,0,0,0,0,0,0.00750098988175892,6.43430585816898,0.923931047090298
8.7,"greedy_SVM","SVM",40,24,1412,1408,4,2500,2097,403,0.917744670992977,0.597989949748744,1.74780409840218,746,363,383,5,1.1,63.91,5.2,0,0,0,0,0,0,0.00655377393261378,5.37526303564645,0.72661918293061
8.7,"greedy_SVM","SVM",40,25,1312,1308,4,2600,2197,403,0.918170819950632,0.592964824120603,1.75423576021783,759,369,390,13,1.1,66.46,5.5,0,0,0,0,0,0,0.00465685105271958,3.63985493627439,0.552930520785339
8.7,"greedy_SVM","SVM",40,26,1212,1209,3,2700,2296,404,0.9183052427762,0.592964824120603,1.75262341117351,762,370,392,3,1.1,69.02,5.7,0,0,0,0,0,0,0.00444609324501414,3.1074511635319,0.453872216315267
8.7,"greedy_SVM","SVM",40,27,1112,1110,2,2800,2395,405,0.919781033797339,0.592964824120603,1.75262341117351,778,381,397,16,1,71.57,5.9,0,0,0,0,0,0,0.00376009554183117,2.48104980389596,0.435558623300439
8.7,"greedy_SVM","SVM",40,28,1012,1011,1,2900,2494,406,0.921016579768511,0.597989949748744,1.75423576021783,777,381,396,-1,1,74.13,6.1,0,0,0,0,0,0,0.00388316924201124,2.23845687225683,0.398351747866844
8.7,"greedy_SVM","SVM",40,29,912,911,1,3000,2594,406,0.921065200790525,0.603015075376884,1.75262341117351,776,383,393,-1,1,76.69,6.4,0,0,0,0,0,0,0.00315931034211498,1.66506838465299,0.343898982288831
8.7,"greedy_SVM","SVM",40,30,812,812,0,3100,2693,407,0.921505650048768,0.603015075376884,1.75262341117351,783,385,398,7,1,79.24,6.6,0,0,0,0,0,0,0.00345652846215049,1.70771324677625,0.372512608998142
8.7,"greedy_SVM","SVM",40,31,712,712,0,3200,2793,407,0.921700134136822,0.603015075376884,1.75262341117351,786,387,399,3,1,81.8,6.9,0,0,0,0,0,0,0.0026243583044397,1.17326559628099,0.283794109943969
8.7,"greedy_SVM","SVM",40,32,612,612,0,3300,2893,407,0.92189175816476,0.603015075376884,1.75101402328447,784,386,398,-2,1,84.36,7.1,0,0,0,0,0,0,0.00210780055553437,0.831364600859301,0.228103946221091
8.7,"greedy_SVM","SVM",40,33,512,512,0,3400,2993,407,0.92183455696239,0.603015075376884,1.75101402328447,784,386,398,0,1,86.91,7.4,0,0,0,0,0,0,0.00164237526525805,0.569492952913142,0.179940204008109
8.7,"greedy_SVM","SVM",40,34,412,412,0,3500,3093,407,0.922214944958146,0.603015075376884,1.75101402328447,788,386,402,4,1,89.47,7.6,0,0,0,0,0,0,0.00129343503276385,0.384200615182768,0.146703217470685
8.7,"greedy_SVM","SVM",40,35,312,312,0,3600,3193,407,0.922349367783714,0.603015075376884,1.75746937452238,790,389,401,2,1,92.02,7.8,0,0,0,0,0,0,0.000944760582157817,0.235847970921532,0.113306820519009
8.7,"greedy_SVM","SVM",40,36,212,212,0,3700,3293,407,0.922621073494966,0.597989949748744,1.75101402328447,791,390,401,1,1,94.58,8.1,0,0,0,0,0,0,0.000489927518542708,0.101513788260126,0.0624639050411048
8.7,"greedy_SVM","SVM",40,37,112,112,0,3800,3393,407,0.92317020503771,0.597989949748744,1.75585107859741,792,391,401,1,1,97.14,8.3,0,0,0,0,0,0,0.000237525529079867,0.0378228703678042,0.0353729241483077
8.7,"greedy_SVM","SVM",40,38,12,12,0,3900,3493,407,0.923913820668508,0.603015075376884,1.75423576021783,797,391,406,5,1,99.69,8.6,0,0,0,0,0,0,0.000155748438126524,0.00260067435985271,0.00260067435985271
8.7,"greedy_SVM","SVM",40,39,0,0,0,3912,3505,407,0.923968161810759,0.603015075376884,1.75423576021783,797,391,406,0,1,100,8.6,0,0,0,0,0,0,0,0,0
8.7,"greedy_SVM","SVM",41,0,3812,3423,389,100,90,10,0.880097115536009,0.516908212560386,1.69825686235223,28,10,18,0,1.8,2.56,9,0,0,0,0,0,0,0.367270340324376,346.0675698736,43.4052475384897
8.7,"greedy_SVM","SVM",41,1,3712,3376,336,200,137,63,0.913098720317759,0.550724637681159,1.75436913895993,115,57,58,87,1,5.11,2.2,0,0,0,0,0,0,0.597772074696151,294.645806110025,69.0342742608483
8.7,"greedy_SVM","SVM",41,2,3612,3356,256,300,157,143,0.914399670757349,0.57487922705314,1.74889903114741,155,81,74,40,0.9,7.67,1.1,0,0,0,0,0,0,0.44952733355792,155.092884958707,60.0860019696541
8.7,"greedy_SVM","SVM",41,3,3512,3318,194,400,195,205,0.90399344829205,0.560386473429952,1.75436913895993,226,116,110,71,0.9,10.22,1,0,0,0,0,0,0,0.32122974594451,112.600653762309,48.6496753378512
8.7,"greedy_SVM","SVM",41,4,3412,3258,154,500,255,245,0.90006021384201,0.579710144927536,1.71962915601023,323,162,161,97,1,12.78,1,0,0,0,0,0,0,0.213934484081286,104.393918766151,29.9115432140612
8.7,"greedy_SVM","SVM",41,5,3312,3188,124,600,325,275,0.904768218139846,0.594202898550725,1.73859712278176,388,193,195,65,1,15.34,1.2,0,0,0,0,0,0,0.0974670181588104,54.3482625941043,14.6946645769745
8.7,"greedy_SVM","SVM",41,6,3212,3112,100,700,401,299,0.907339735887721,0.623188405797101,1.73149705073798,442,217,225,54,1,17.89,1.3,0,0,0,0,0,0,0.0726875136626034,53.0788437935685,10.2525055646657
8.7,"greedy_SVM","SVM",41,7,3112,3028,84,800,485,315,0.902144220437905,0.623188405797101,1.66751918158568,483,235,248,41,1.1,20.45,1.5,0,0,0,0,0,0,0.0624213031976559,61.5038072089028,8.59281488010384
8.7,"greedy_SVM","SVM",41,8,3012,2946,66,900,567,333,0.894977944608799,0.657004830917874,1.63578615848613,526,252,274,43,1.1,23.01,1.7,0,0,0,0,0,0,0.0572604899326042,80.4225011398773,8.05397377409619
8.7,"greedy_SVM","SVM",41,9,2912,2858,54,1000,655,345,0.893424261758966,0.647342995169082,1.63578615848613,560,269,291,34,1.1,25.56,1.9,0,0,0,0,0,0,0.0491564826778031,76.2144586690629,5.52197335469293
8.7,"greedy_SVM","SVM",41,10,2812,2762,50,1100,751,349,0.900716213267492,0.642512077294686,1.6414641943734,579,281,298,19,1.1,28.12,2.2,0,0,0,0,0,0,0.0375346026247029,54.847969268769,4.18690713434019
8.7,"greedy_SVM","SVM",41,11,2712,2665,47,1200,848,352,0.906483484006056,0.632850241545894,1.65883418584825,583,282,301,4,1.1,30.67,2.4,0,0,0,0,0,0,0.0310260783037544,46.1681286524148,3.4158477524956
8.7,"greedy_SVM","SVM",41,12,2612,2571,41,1300,942,358,0.912062931751208,0.628019323671498,1.68954785280171,604,295,309,21,1,33.23,2.6,0,0,0,0,0,0,0.030271098078256,44.6278726627481,3.33735462066757
8.7,"greedy_SVM","SVM",41,13,2512,2473,39,1400,1040,360,0.914218753021067,0.618357487922705,1.70225916453538,612,300,312,8,1,35.79,2.9,0,0,0,0,0,0,0.0238189992869495,34.6267137554596,2.65623291873471
8.7,"greedy_SVM","SVM",41,14,2412,2376,36,1500,1137,363,0.922398720593964,0.623188405797101,1.73149705073798,621,304,317,9,1,38.34,3.1,0,0,0,0,0,0,0.0500422636599921,46.6130887807093,5.95847486240975
8.7,"greedy_SVM","SVM",41,15,2312,2276,36,1600,1237,363,0.924558685018075,0.623188405797101,1.74729010839566,631,307,324,10,1.1,40.9,3.4,0,0,0,0,0,0,0.0260398606866082,27.3115178919293,2.88725578513823
8.7,"greedy_SVM","SVM",41,16,2212,2184,28,1700,1329,371,0.926127559433552,0.628019323671498,1.75598309400957,655,315,340,24,1.1,43.46,3.6,0,0,0,0,0,0,0.0499278921011625,32.0596773491949,5.98921750649868
8.7,"greedy_SVM","SVM",41,17,2112,2089,23,1800,1424,376,0.925876208074733,0.628019323671498,1.75275814801506,669,322,347,14,1.1,46.01,3.8,0,0,0,0,0,0,0.0396751827493628,25.1857487062546,4.72028319240018
8.7,"greedy_SVM","SVM",41,18,2012,1999,13,1900,1514,386,0.925760199755276,0.623188405797101,1.74408112748034,688,332,356,19,1.1,48.57,3.9,0,0,0,0,0,0,0.0309735658802294,23.5467751703987,4.41383987161959
8.7,"greedy_SVM","SVM",41,19,1912,1901,11,2000,1612,388,0.926621975842646,0.623188405797101,1.75051091965538,699,335,364,11,1.1,51.12,4.2,0,0,0,0,0,0,0.0236375039568631,18.503136427477,2.74039222519447
8.7,"greedy_SVM","SVM",41,20,1812,1802,10,2100,1711,389,0.927853873711126,0.623188405797101,1.75051091965538,700,336,364,1,1.1,53.68,4.4,0,0,0,0,0,0,0.01618377949841,14.5198580957708,1.85551461151909
8.7,"greedy_SVM","SVM",41,21,1712,1703,9,2200,1810,390,0.928480871056741,0.623188405797101,1.75051091965538,709,342,367,9,1.1,56.24,4.6,0,0,0,0,0,0,0.0137686348892373,12.4042647993412,1.43534471494952
8.7,"greedy_SVM","SVM",41,22,1612,1603,9,2300,1910,390,0.927376029919095,0.613526570048309,1.76630101155684,725,355,370,16,1,58.79,4.9,0,0,0,0,0,0,0.0082957716723616,6.58682405290126,1.16078727709853
8.7,"greedy_SVM","SVM",41,23,1512,1505,7,2400,2008,392,0.927370505713406,0.613526570048309,1.76792893875643,733,356,377,8,1.1,61.35,5.1,0,0,0,0,0,0,0.00737036039438243,6.15265558119954,0.818593634207586
8.7,"greedy_SVM","SVM",41,24,1412,1406,6,2500,2107,393,0.927113630148902,0.608695652173913,1.76630101155684,741,363,378,8,1,63.91,5.4,0,0,0,0,0,0,0.00706565114916088,5.25074837207566,0.723001299796981
8.7,"greedy_SVM","SVM",41,25,1312,1307,5,2600,2206,394,0.928009932521821,0.613526570048309,1.76630101155684,757,369,388,16,1.1,66.46,5.6,0,0,0,0,0,0,0.00511648490242491,3.24669432258153,0.607248720762728
8.7,"greedy_SVM","SVM",41,26,1212,1208,4,2700,2305,395,0.92789530525379,0.613526570048309,1.76467607962348,760,371,389,3,1,69.02,5.8,0,0,0,0,0,0,0.00441679926648156,2.89644602994817,0.481044205060147
8.7,"greedy_SVM","SVM",41,27,1112,1109,3,2800,2404,396,0.927806917962778,0.613526570048309,1.76630101155684,766,373,393,6,1.1,71.57,6.1,0,0,0,0,0,0,0.0041697450024711,2.40585672886014,0.427001687838196
8.7,"greedy_SVM","SVM",41,28,1012,1009,3,2900,2504,396,0.92884823073502,0.613526570048309,1.76143516854979,773,375,398,7,1.1,74.13,6.3,0,0,0,0,0,0,0.00339741371094707,1.75715066943025,0.381821421480585
8.7,"greedy_SVM","SVM",41,29,912,909,3,3000,2604,396,0.92900843269998,0.613526570048309,1.76143516854979,773,375,398,0,1.1,76.69,6.6,0,0,0,0,0,0,0.00299204488439815,1.29676589590029,0.309445266067628
8.7,"greedy_SVM","SVM",41,30,812,809,3,3100,2704,396,0.929182445179164,0.608695652173913,1.76143516854979,780,379,401,7,1.1,79.24,6.8,0,0,0,0,0,0,0.00248703302078996,0.908416003811554,0.270917313860298
8.7,"greedy_SVM","SVM",41,31,712,710,2,3200,2803,397,0.929221114618983,0.599033816425121,1.76630101155684,785,381,404,5,1.1,81.8,7.1,0,0,0,0,0,0,0.00227524959213184,0.72746257783513,0.253561295522007
8.7,"greedy_SVM","SVM",41,32,612,610,2,3300,2903,397,0.929279118778713,0.599033816425121,1.76467607962348,785,382,403,0,1.1,84.36,7.3,0,0,0,0,0,0,0.0014616268991681,0.438913594060132,0.18194178865127
8.7,"greedy_SVM","SVM",41,33,512,511,1,3400,3002,398,0.929919926638561,0.603864734299517,1.76143516854979,788,385,403,3,1,86.91,7.5,0,0,0,0,0,0,0.000949641187828071,0.278244017200878,0.125452321763697
8.7,"greedy_SVM","SVM",41,34,412,411,1,3500,3102,398,0.929998646569622,0.599033816425121,1.76305413469736,793,386,407,5,1.1,89.47,7.8,0,0,0,0,0,0,0.000631504185494184,0.181828710897802,0.083312580000015
8.7,"greedy_SVM","SVM",41,35,312,312,0,3600,3201,399,0.93006079388362,0.603864734299517,1.76630101155684,794,389,405,1,1,92.02,8,0,0,0,0,0,0,0.000393443156843936,0.0999211377015091,0.051053232330309
8.7,"greedy_SVM","SVM",41,36,212,212,0,3700,3301,399,0.930243092671338,0.599033816425121,1.76467607962348,798,391,407,4,1,94.58,8.3,0,0,0,0,0,0,0.000208537006355239,0.0439565073048095,0.0280672222344686
8.7,"greedy_SVM","SVM",41,37,112,112,0,3800,3401,399,0.930361863093637,0.599033816425121,1.76467607962348,802,393,409,4,1,97.14,8.5,0,0,0,0,0,0,7.13414570448417e-05,0.0131693174821529,0.0124230055737569
8.7,"greedy_SVM","SVM",41,38,12,12,0,3900,3501,399,0.930400532533453,0.594202898550725,1.76630101155684,806,394,412,4,1,99.69,8.8,0,0,0,0,0,0,4.09683075870151e-05,0.000607452891327474,0.000607452891327474
8.7,"greedy_SVM","SVM",41,39,0,0,0,3912,3513,399,0.930392246224921,0.594202898550725,1.76630101155684,807,394,413,1,1,100,8.8,0,0,0,0,0,0,0,0,0
8.7,"greedy_SVM","SVM",42,0,3812,3415,397,100,91,9,0.83546412300684,0.32,1.74868202764977,33,9,24,0,2.7,2.56,10.1,0,0,0,0,0,0,0.160213703157086,336.610007476141,21.571556131723
8.7,"greedy_SVM","SVM",42,1,3712,3347,365,200,159,41,0.913556378132126,0.505,1.76920110192837,94,41,53,61,1.3,5.11,3.9,0,0,0,0,0,0,0.420989311514771,355.537049774873,54.4390092150025
8.7,"greedy_SVM","SVM",42,2,3612,3308,304,300,198,102,0.933853929384967,0.6,1.7765504587156,180,89,91,86,1,7.67,1.9,0,0,0,0,0,0,0.662624795189841,454.804063322566,71.0390809404422
8.7,"greedy_SVM","SVM",42,3,3512,3287,225,400,219,181,0.939779328018227,0.6,1.79449541284404,229,115,114,49,1,10.22,1.2,0,0,0,0,0,0,0.612635935745801,374.273563684016,68.4835737420042
8.7,"greedy_SVM","SVM",42,4,3412,3255,157,500,251,249,0.942630979498864,0.62,1.79779411764706,297,147,150,68,1,12.78,1,0,0,0,0,0,0,0.5,356.767739251,57.5000841352034
8.7,"greedy_SVM","SVM",42,5,3312,3186,126,600,320,280,0.888903758542137,0.635,1.65535224153705,399,197,202,102,1,15.34,1.1,0,0,0,0,0,0,0.240909213533064,240.198701561786,35.0118713772211
8.7,"greedy_SVM","SVM",42,6,3212,3119,93,700,387,313,0.902870159453299,0.66,1.66735105407883,482,239,243,83,1,17.89,1.2,0,0,0,0,0,0,0.151651903812557,148.746509445705,19.9921429643487
8.7,"greedy_SVM","SVM",42,7,3112,3042,70,800,464,336,0.909533029612754,0.65,1.66295955882353,537,260,277,55,1.1,20.45,1.4,0,0,0,0,0,0,0.103273916981763,132.383769628542,13.0185852781039
8.7,"greedy_SVM","SVM",42,8,3012,2954,58,900,552,348,0.915526765375847,0.665,1.66602209944751,574,276,298,37,1.1,23.01,1.6,0,0,0,0,0,0,0.0745764833444963,109.538699559651,8.91066008322305
8.7,"greedy_SVM","SVM",42,9,2912,2860,52,1000,646,354,0.920603644646923,0.665,1.69148114075437,585,283,302,11,1.1,25.56,1.8,0,0,0,0,0,0,0.0664470829854817,95.0055729544135,7.18807207525586
8.7,"greedy_SVM","SVM",42,10,2812,2764,48,1100,742,358,0.931039293849664,0.65,1.7332782369146,610,295,315,25,1.1,28.12,2.1,0,0,0,0,0,0,0.0652231518285153,80.937591127354,7.62574473580903
8.7,"greedy_SVM","SVM",42,11,2712,2668,44,1200,838,362,0.935952448747162,0.645,1.76508287292818,626,303,323,16,1.1,30.67,2.3,0,0,0,0,0,0,0.0518006885542802,56.3914803782189,5.82188478525566
8.7,"greedy_SVM","SVM",42,12,2612,2581,31,1300,925,375,0.94240318906607,0.645,1.78880514705882,659,318,341,33,1.1,33.23,2.5,0,0,0,0,0,0,0.0657144609948194,69.3626399743754,7.31041205216377
8.7,"greedy_SVM","SVM",42,13,2512,2488,24,1400,1018,382,0.943041002277918,0.645,1.78552293577982,678,325,353,19,1.1,35.79,2.7,0,0,0,0,0,0,0.0628623204413034,60.1958330009139,7.0432772321662
8.7,"greedy_SVM","SVM",42,14,2412,2389,23,1500,1117,383,0.942742027334867,0.645,1.79045078196872,681,327,354,3,1.1,38.34,2.9,0,0,0,0,0,0,0.0484217362939757,44.8212497808466,5.36352042774999
8.7,"greedy_SVM","SVM",42,15,2312,2291,21,1600,1215,385,0.942605353075186,0.645,1.78145354185833,691,330,361,10,1.1,40.9,3.2,0,0,0,0,0,0,0.0390115603725192,40.5073921773553,4.42719746754605
8.7,"greedy_SVM","SVM",42,16,2212,2195,17,1700,1311,389,0.942380410022796,0.645,1.77818181818182,696,335,361,5,1.1,43.46,3.4,0,0,0,0,0,0,0.0313619601593197,34.8194692062535,3.59337871396529
8.7,"greedy_SVM","SVM",42,17,2112,2098,14,1800,1408,392,0.942488610478378,0.635,1.77818181818182,710,341,369,14,1.1,46.01,3.6,0,0,0,0,0,0,0.0254835574335623,28.9774404783325,2.90160521717551
8.7,"greedy_SVM","SVM",42,18,2012,2000,12,1900,1506,394,0.942283599088856,0.64,1.78145354185833,719,343,376,9,1.1,48.57,3.8,0,0,0,0,0,0,0.0221500362850768,25.360946926097,2.36176597215073
8.7,"greedy_SVM","SVM",42,19,1912,1900,12,2000,1606,394,0.941785307517102,0.635,1.7765504587156,715,344,371,-4,1.1,51.12,4.1,0,0,0,0,0,0,0.0200750723573801,21.6356715052114,2.08596621991234
8.7,"greedy_SVM","SVM",42,20,1812,1800,12,2100,1706,394,0.941605922551266,0.625,1.78880514705882,724,353,371,9,1.1,53.68,4.3,0,0,0,0,0,0,0.0130881119288456,11.0062623518187,1.67590159667694
8.7,"greedy_SVM","SVM",42,21,1712,1702,10,2200,1804,396,0.942013097949901,0.63,1.78716253443526,729,355,374,5,1.1,56.24,4.6,0,0,0,0,0,0,0.0102949633985474,9.77940543403284,1.14950539904765
8.7,"greedy_SVM","SVM",42,22,1612,1603,9,2300,1903,397,0.941997437357644,0.63,1.77981617647059,731,356,375,2,1.1,58.79,4.8,0,0,0,0,0,0,0.010575211374224,9.40579866901519,1.07032032785084
8.7,"greedy_SVM","SVM",42,23,1512,1503,9,2400,2003,397,0.942033029612764,0.625,1.78145354185833,750,366,384,19,1,61.35,5,0,0,0,0,0,0,0.0065055444421283,4.82890952779221,0.80775882201841
8.7,"greedy_SVM","SVM",42,24,1412,1406,6,2500,2100,400,0.942114179954449,0.625,1.79209944751381,761,372,389,11,1,63.91,5.2,0,0,0,0,0,0,0.00661159389948713,5.43110271674192,0.711577172574114
8.7,"greedy_SVM","SVM",42,25,1312,1306,6,2600,2200,400,0.942075740318914,0.625,1.79375115207373,763,376,387,2,1,66.46,5.5,0,0,0,0,0,0,0.00544349725642734,4.06116557587544,0.570956363524705
8.7,"greedy_SVM","SVM",42,26,1212,1206,6,2700,2300,400,0.941776765375861,0.625,1.79045078196872,765,377,388,2,1,69.02,5.8,0,0,0,0,0,0,0.0047317026783708,3.25711400053122,0.511124052860245
8.7,"greedy_SVM","SVM",42,27,1112,1107,5,2800,2399,401,0.941931947608208,0.625,1.79779411764706,769,378,391,4,1,71.57,6,0,0,0,0,0,0,0.00404401080493024,2.46143633343008,0.41950062489735
8.7,"greedy_SVM","SVM",42,28,1012,1008,4,2900,2498,402,0.941859339407753,0.63,1.79614325068871,779,382,397,10,1,74.13,6.2,0,0,0,0,0,0,0.0034139455848808,1.8389796419282,0.358381539332813
8.7,"greedy_SVM","SVM",42,29,912,908,4,3000,2598,402,0.941884965831443,0.63,1.79285059578368,780,383,397,1,1,76.69,6.5,0,0,0,0,0,0,0.00308187923142381,1.46358792455082,0.323197421397179
8.7,"greedy_SVM","SVM",42,30,812,809,3,3100,2697,403,0.942010250569483,0.63,1.79779411764706,785,385,400,5,1,79.24,6.7,0,0,0,0,0,0,0.00264806835110442,1.14640115912839,0.285264131272489
8.7,"greedy_SVM","SVM",42,31,712,709,3,3200,2797,403,0.941983200455588,0.63,1.79779411764706,787,385,402,2,1,81.8,6.9,0,0,0,0,0,0,0.00237345170909744,0.911113643182386,0.257331182854086
8.7,"greedy_SVM","SVM",42,32,612,609,3,3300,2897,403,0.942088553530758,0.63,1.79779411764706,786,385,401,-1,1,84.36,7.2,0,0,0,0,0,0,0.00166658134326254,0.583413577670367,0.187598408264995
8.7,"greedy_SVM","SVM",42,33,512,511,1,3400,2995,405,0.942297835990894,0.625,1.79779411764706,795,388,407,9,1,86.91,7.4,0,0,0,0,0,0,0.0019433377000231,0.729253318114835,0.241102911442101
8.7,"greedy_SVM","SVM",42,34,412,412,0,3500,3094,406,0.942468678815494,0.63,1.80110497237569,802,392,410,7,1,89.47,7.6,0,0,0,0,0,0,0.00177535136029088,0.559212062505315,0.200043383553489
8.7,"greedy_SVM","SVM",42,35,312,312,0,3600,3194,406,0.942359054669708,0.63,1.79779411764706,803,392,411,1,1,92.02,7.9,0,0,0,0,0,0,0.00122711968457255,0.308520428973589,0.140009627949826
8.7,"greedy_SVM","SVM",42,36,212,212,0,3700,3294,406,0.942257972665152,0.63,1.80276497695853,807,394,413,4,1,94.58,8.1,0,0,0,0,0,0,0.000780284193722239,0.163254969416267,0.0997037625295332
8.7,"greedy_SVM","SVM",42,37,112,112,0,3800,3394,406,0.942400341685654,0.63,1.79779411764706,813,395,418,6,1.1,97.14,8.4,0,0,0,0,0,0,0.000336440782927371,0.0535185888552367,0.0497700584602193
8.7,"greedy_SVM","SVM",42,38,12,12,0,3900,3494,406,0.942421697038729,0.63,1.79449541284404,814,396,418,1,1.1,99.69,8.6,0,0,0,0,0,0,0.000341377603324191,0.00465282229370645,0.00465282229370645
8.7,"greedy_SVM","SVM",42,39,0,0,0,3912,3506,406,0.942290717539868,0.63,1.79449541284404,814,396,418,0,1.1,100,8.6,0,0,0,0,0,0,0,0,0
8.7,"greedy_SVM","SVM",43,0,3812,3422,390,100,93,7,0.917403176463824,0.583732057416268,1.7789552769979,19,7,12,0,1.7,2.56,13.3,0,0,0,0,0,0,0.820616908890698,611.355629772365,85.1710831185143
8.7,"greedy_SVM","SVM",43,1,3712,3402,310,200,113,87,0.91585575271895,0.602870813397129,1.7531733164617,71,37,34,52,0.9,5.11,1.3,0,0,0,0,0,0,0.680554091261118,376.331210886217,72.7195025259939
8.7,"greedy_SVM","SVM",43,2,3612,3368,244,300,147,153,0.911695510827868,0.593301435406699,1.75101095848125,142,73,69,71,0.9,7.67,1,0,0,0,0,0,0,0.507952089530669,205.51103383039,59.4304162933802
8.7,"greedy_SVM","SVM",43,3,3512,3317,195,400,198,202,0.892556754846997,0.583732057416268,1.68045679240794,229,118,111,87,0.9,10.22,1,0,0,0,0,0,0,0.355414340080514,203.505681138342,46.6359990050342
8.7,"greedy_SVM","SVM",43,4,3412,3260,152,500,255,245,0.889576937086937,0.607655502392344,1.7102033822347,329,165,164,100,1,12.78,1,0,0,0,0,0,0,0.21746369280345,141.844704726076,30.215508544046
8.7,"greedy_SVM","SVM",43,5,3312,3182,130,600,333,267,0.88636158226131,0.626794258373206,1.67337993076533,374,185,189,45,1,15.34,1.2,0,0,0,0,0,0,0.0910322879634344,49.3169677445386,14.0106747413841
8.7,"greedy_SVM","SVM",43,6,3212,3107,105,700,408,292,0.886172604848247,0.636363636363636,1.6414514874715,437,209,228,63,1.1,17.89,1.4,0,0,0,0,0,0,0.0836791149091889,68.53124887674,11.8009506680815
8.7,"greedy_SVM","SVM",43,7,3112,3028,84,800,487,313,0.877454994618252,0.660287081339713,1.61300024254184,491,234,257,54,1.1,20.45,1.6,0,0,0,0,0,0,0.071385883339715,99.5481133223765,11.905321947551
8.7,"greedy_SVM","SVM",43,8,3012,2947,65,900,568,332,0.883455712184657,0.655502392344498,1.62725203910504,534,258,276,43,1.1,23.01,1.7,0,0,0,0,0,0,0.0717339511920878,117.146457743289,8.33089300546354
8.7,"greedy_SVM","SVM",43,9,2912,2860,52,1000,655,345,0.894468439402614,0.650717703349282,1.65308143655115,575,275,300,41,1.1,25.56,1.9,0,0,0,0,0,0,0.0710883151132306,116.697022290091,8.51985519175242
8.7,"greedy_SVM","SVM",43,10,2812,2764,48,1100,751,349,0.90561810677499,0.650717703349282,1.68907451954849,595,285,310,20,1.1,28.12,2.2,0,0,0,0,0,0,0.063005052050623,101.29374417106,6.85544340000991
8.7,"greedy_SVM","SVM",43,11,2712,2669,43,1200,846,354,0.918202906965576,0.660287081339713,1.7016093953893,622,301,321,27,1.1,30.67,2.4,0,0,0,0,0,0,0.0549750940515559,67.2707680907202,6.40024611327402
8.7,"greedy_SVM","SVM",43,12,2612,2577,35,1300,938,362,0.926391928199525,0.650717703349282,1.7187973690801,637,309,328,15,1.1,33.23,2.6,0,0,0,0,0,0,0.0562061880023031,67.3965110592548,6.48295583293864
8.7,"greedy_SVM","SVM",43,13,2512,2484,28,1400,1031,369,0.932896585534189,0.636363636363636,1.75963662822746,667,322,345,30,1.1,35.79,2.8,0,0,0,0,0,0,0.0607066860341747,59.2900985331041,6.74857408857118
8.7,"greedy_SVM","SVM",43,14,2412,2386,26,1500,1129,371,0.9338620136228,0.636363636363636,1.76663406381348,671,324,347,4,1.1,38.34,3,0,0,0,0,0,0,0.0526572475223699,48.0344207347867,5.76327225862674
8.7,"greedy_SVM","SVM",43,15,2312,2288,24,1600,1227,373,0.934470027908391,0.631578947368421,1.76338657472558,679,327,352,8,1.1,40.9,3.3,0,0,0,0,0,0,0.0460049628776616,39.8874421119535,5.01750444168186
8.7,"greedy_SVM","SVM",43,16,2212,2192,20,1700,1323,377,0.936069488911939,0.631578947368421,1.76873710548264,693,334,359,14,1.1,43.46,3.5,0,0,0,0,0,0,0.0429642265754165,32.8842030480141,5.01836082043385
8.7,"greedy_SVM","SVM",43,17,2112,2102,10,1800,1413,387,0.937138991517915,0.636363636363636,1.7650088254843,718,347,371,25,1.1,46.01,3.7,0,0,0,0,0,0,0.0483564816554553,36.5906927057195,6.20999681493107
8.7,"greedy_SVM","SVM",43,18,2012,2004,8,1900,1511,389,0.937990759278372,0.636363636363636,1.7617673033071,720,348,372,2,1.1,48.57,3.9,0,0,0,0,0,0,0.0289689683384744,27.5636543566953,3.48267341051189
8.7,"greedy_SVM","SVM",43,19,1912,1904,8,2000,1611,389,0.937942830224327,0.636363636363636,1.76338657472558,721,348,373,1,1.1,51.12,4.1,0,0,0,0,0,0,0.0229732843530436,22.2659887710006,2.51309522748411
8.7,"greedy_SVM","SVM",43,20,1812,1804,8,2100,1711,389,0.937868882540943,0.636363636363636,1.76338657472558,722,348,374,1,1.1,53.68,4.4,0,0,0,0,0,0,0.0215674797935083,21.2547835341817,2.30038885304226
8.7,"greedy_SVM","SVM",43,21,1712,1705,7,2200,1810,390,0.937892162367186,0.636363636363636,1.7650088254843,729,351,378,7,1.1,56.24,4.6,0,0,0,0,0,0,0.0184287615421086,16.419453628256,1.87801675475457
8.7,"greedy_SVM","SVM",43,22,1612,1605,7,2300,1910,390,0.935829843641711,0.62200956937799,1.7703612901525,745,359,386,16,1.1,58.79,4.9,0,0,0,0,0,0,0.0126255768446575,9.70411323345071,1.57535258146901
8.7,"greedy_SVM","SVM",43,23,1512,1507,5,2400,2008,392,0.936506328004517,0.62200956937799,1.7703612901525,746,359,387,1,1.1,61.35,5.1,0,0,0,0,0,0,0.0108123973961086,8.6554671145604,1.18510257792615
8.7,"greedy_SVM","SVM",43,24,1412,1407,5,2500,2108,392,0.936492633989075,0.62200956937799,1.7703612901525,746,359,387,0,1.1,63.91,5.4,0,0,0,0,0,0,0.0102406582284431,7.14718995301875,1.03503693933688
8.7,"greedy_SVM","SVM",43,25,1312,1307,5,2600,2208,392,0.935695642290397,0.617224880382775,1.7703612901525,754,370,384,8,1,66.46,5.6,0,0,0,0,0,0,0.0068481619138693,4.10338786158743,0.84636446170756
8.7,"greedy_SVM","SVM",43,26,1212,1207,5,2700,2308,392,0.935780545186133,0.617224880382775,1.77198846045595,754,370,384,0,1,69.02,5.9,0,0,0,0,0,0,0.00544053483896768,3.17608285797805,0.597231250486577
8.7,"greedy_SVM","SVM",43,27,1112,1107,5,2800,2408,392,0.935799716807751,0.617224880382775,1.76873710548264,755,370,385,1,1,71.57,6.1,0,0,0,0,0,0,0.00507664138828992,2.60469974675423,0.520964729825126
8.7,"greedy_SVM","SVM",43,28,1012,1007,5,2900,2508,392,0.935969522599215,0.61244019138756,1.77198846045595,759,370,389,4,1.1,74.13,6.4,0,0,0,0,0,0,0.00349261627979958,1.56260432057568,0.385445605622818
8.7,"greedy_SVM","SVM",43,29,912,908,4,3000,2607,393,0.935868186884946,0.61244019138756,1.7703612901525,760,372,388,1,1,76.69,6.6,0,0,0,0,0,0,0.00357196703338126,1.3251844802649,0.373216721185541
8.7,"greedy_SVM","SVM",43,30,812,808,4,3100,2707,393,0.935616217000826,0.617224880382775,1.7703612901525,762,373,389,2,1,79.24,6.9,0,0,0,0,0,0,0.00304382531799708,0.962934393788412,0.339871962444322
8.7,"greedy_SVM","SVM",43,31,712,709,3,3200,2806,394,0.935709336305827,0.61244019138756,1.77732320793644,768,376,392,6,1,81.8,7.1,0,0,0,0,0,0,0.00206430268832121,0.614343550406283,0.258648600280079
8.7,"greedy_SVM","SVM",43,32,612,610,2,3300,2905,395,0.935597045379206,0.61244019138756,1.7789552769979,773,380,393,5,1,84.36,7.4,0,0,0,0,0,0,0.00139729383344468,0.434376771947282,0.189950676503835
8.7,"greedy_SVM","SVM",43,33,512,511,1,3400,3004,396,0.935608000591558,0.61244019138756,1.7789552769979,777,382,395,4,1,86.91,7.6,0,0,0,0,0,0,0.00118357592872928,0.373085509157564,0.150508726812752
8.7,"greedy_SVM","SVM",43,34,412,412,0,3500,3103,397,0.935939395765238,0.617224880382775,1.7789552769979,784,384,400,7,1,89.47,7.8,0,0,0,0,0,0,0.000739753289666659,0.222736250019346,0.0948595983285781
8.7,"greedy_SVM","SVM",43,35,312,312,0,3600,3203,397,0.93564908263788,0.617224880382775,1.78222842378171,790,384,406,6,1.1,92.02,8.1,0,0,0,0,0,0,0.000463861358313403,0.121387697772785,0.059665183790824
8.7,"greedy_SVM","SVM",43,36,212,212,0,3700,3303,397,0.935801086209279,0.61244019138756,1.78059034618632,796,388,408,6,1.1,94.58,8.3,0,0,0,0,0,0,0.000256354062718325,0.0541782884472325,0.0333032243939632
8.7,"greedy_SVM","SVM",43,37,112,112,0,3800,3403,397,0.935773698178397,0.61244019138756,1.78059034618632,797,388,409,1,1.1,97.14,8.6,0,0,0,0,0,0,0.000120943415438771,0.0182589170695633,0.0170632998315237
8.7,"greedy_SVM","SVM",43,38,12,12,0,3900,3503,397,0.935892836112736,0.61244019138756,1.7855136374661,799,389,410,2,1.1,99.69,8.8,0,0,0,0,0,0,6.35222381240246e-05,0.000969587829368209,0.000969587829368209
8.7,"greedy_SVM","SVM",43,39,0,0,0,3912,3515,397,0.935805194413912,0.61244019138756,1.78059034618632,799,389,410,0,1.1,100,8.9,0,0,0,0,0,0,0,0,0
8.7,"greedy_SVM","SVM",44,0,3812,3403,409,100,85,15,0.910045281663098,0.5,1.7748656453036,37,15,22,0,1.5,2.56,5.7,0,0,0,0,0,0,0.714286760749304,670.433591407082,74.8602076343814
8.7,"greedy_SVM","SVM",44,1,3712,3376,336,200,112,88,0.918452742297156,0.521978021978022,1.7632981134356,88,43,45,51,1,5.11,1.3,0,0,0,0,0,0,0.819011982659352,550.531191647171,86.9298811469134
8.7,"greedy_SVM","SVM",44,2,3612,3348,264,300,140,160,0.920428782040953,0.549450549450549,1.76168337157348,146,74,72,58,1,7.67,0.9,0,0,0,0,0,0,0.626976664660929,423.473600147813,70.1314625104441
8.7,"greedy_SVM","SVM",44,3,3512,3312,200,400,176,224,0.913089869544205,0.565934065934066,1.73533622340962,221,113,108,75,1,10.22,0.8,0,0,0,0,0,0,0.525709506241981,384.807862972342,63.274200243616
8.7,"greedy_SVM","SVM",44,4,3412,3254,158,500,234,266,0.84588593480927,0.604395604395604,1.5635966243701,313,157,156,92,1,12.78,0.9,0,0,0,0,0,0,0.321803806388524,289.994794522472,42.8140012270191
8.7,"greedy_SVM","SVM",44,5,3312,3190,122,600,298,302,0.849607269844016,0.604395604395604,1.58484833139211,402,201,201,89,1,15.34,1,0,0,0,0,0,0,0.163310417295008,153.150195075585,23.9271314370881
8.7,"greedy_SVM","SVM",44,6,3212,3116,96,700,372,328,0.85325117385433,0.593406593406593,1.57060035552683,464,224,240,62,1.1,17.89,1.1,0,0,0,0,0,0,0.116243837667885,115.620233451216,17.6453022514672
8.7,"greedy_SVM","SVM",44,7,3112,3025,87,800,463,337,0.859109605163715,0.60989010989011,1.5932851678708,499,236,263,35,1.1,20.45,1.4,0,0,0,0,0,0,0.0643309828584284,79.0092465884777,8.39126210964316
8.7,"greedy_SVM","SVM",44,8,3012,2942,70,900,546,354,0.868401328096929,0.615384615384615,1.59475363346331,544,261,283,45,1.1,23.01,1.5,0,0,0,0,0,0,0.0663297635385817,99.7346799532451,8.53836220053575
8.7,"greedy_SVM","SVM",44,9,2912,2848,64,1000,640,360,0.8808832092372,0.615384615384615,1.6328698925384,570,271,299,26,1.1,25.56,1.8,0,0,0,0,0,0,0.0538063355362943,68.2516542507429,6.20839725568157
8.7,"greedy_SVM","SVM",44,10,2812,2759,53,1100,729,371,0.882626955907666,0.626373626373626,1.63136771232447,598,282,316,28,1.1,28.12,2,0,0,0,0,0,0,0.0610384011552647,77.9678688638348,6.19429800438464
8.7,"greedy_SVM","SVM",44,11,2712,2660,52,1200,828,372,0.913046508170537,0.604395604395604,1.69901422107304,633,310,323,35,1,30.67,2.2,0,0,0,0,0,0,0.058910024873273,39.4882919919876,7.38364192176928
8.7,"greedy_SVM","SVM",44,12,2612,2567,45,1300,921,379,0.915002415847983,0.60989010989011,1.69380665417532,651,318,333,18,1,33.23,2.4,0,0,0,0,0,0,0.0395872589438214,31.0184272137172,4.66838962282272
8.7,"greedy_SVM","SVM",44,13,2512,2472,40,1400,1016,384,0.917724890667406,0.604395604395604,1.69380665417532,660,323,337,9,1,35.79,2.6,0,0,0,0,0,0,0.0323639086545536,29.1230345647246,3.63684069724884
8.7,"greedy_SVM","SVM",44,14,2412,2379,33,1500,1109,391,0.924706071831213,0.615384615384615,1.73023848276838,677,330,347,17,1.1,38.34,2.8,0,0,0,0,0,0,0.0330411977887637,35.4527528556184,4.01458210535751
8.7,"greedy_SVM","SVM",44,15,2312,2285,27,1600,1203,397,0.930386411784397,0.60989010989011,1.75989971390155,701,341,360,24,1.1,40.9,3,0,0,0,0,0,0,0.0540560434522855,41.216446056966,6.85049100772867
8.7,"greedy_SVM","SVM",44,16,2212,2187,25,1700,1301,399,0.932827037674849,0.593406593406593,1.77640541276905,719,348,371,18,1.1,43.46,3.3,0,0,0,0,0,0,0.043244950375248,32.6366998284778,5.0057400281733
8.7,"greedy_SVM","SVM",44,17,2112,2088,24,1800,1400,400,0.932858010084627,0.593406593406593,1.77640541276905,718,349,369,-1,1.1,46.01,3.5,0,0,0,0,0,0,0.0303565823127955,22.9658980275764,3.43090296044932
8.7,"greedy_SVM","SVM",44,18,2012,1995,17,1900,1493,407,0.933234324863417,0.604395604395604,1.77803813833226,738,361,377,20,1,48.57,3.7,0,0,0,0,0,0,0.0308256483749492,20.4537111991689,3.48556627812629
8.7,"greedy_SVM","SVM",44,19,1912,1899,13,2000,1589,411,0.932667529764488,0.60989010989011,1.78131261004189,743,364,379,5,1,51.12,3.9,0,0,0,0,0,0,0.0299888061427723,19.5716497670057,3.53519352548602
8.7,"greedy_SVM","SVM",44,20,1812,1803,9,2100,1685,415,0.933062427989148,0.615384615384615,1.78295437281612,756,370,386,13,1,53.68,4.1,0,0,0,0,0,0,0.0245761264039194,17.9207365122456,3.20689742368523
8.7,"greedy_SVM","SVM",44,21,1712,1706,6,2200,1782,418,0.932972608000793,0.60989010989011,1.77967386799034,763,374,389,7,1,56.24,4.3,0,0,0,0,0,0,0.0164542612111003,13.5724642189017,2.07298889353015
8.7,"greedy_SVM","SVM",44,22,1612,1607,5,2300,1881,419,0.932333027738889,0.615384615384615,1.77141642887499,766,375,391,3,1,58.79,4.5,0,0,0,0,0,0,0.0146612868802212,12.1016305912178,1.57075388539998
8.7,"greedy_SVM","SVM",44,23,1512,1507,5,2400,1981,419,0.933167734182391,0.615384615384615,1.78131261004189,772,379,393,6,1,61.35,4.7,0,0,0,0,0,0,0.0114162281092846,8.77380360425856,1.23221093411479
8.7,"greedy_SVM","SVM",44,24,1412,1407,5,2500,2081,419,0.933099594880882,0.615384615384615,1.77477568303256,779,381,398,7,1,63.91,5,0,0,0,0,0,0,0.00868010141971692,6.24489841493789,0.962828097620296
8.7,"greedy_SVM","SVM",44,25,1312,1307,5,2600,2181,419,0.933146053495548,0.615384615384615,1.77640541276905,778,380,398,-1,1,66.46,5.2,0,0,0,0,0,0,0.00936394789560111,6.11746277148419,0.961357834158128
8.7,"greedy_SVM","SVM",44,26,1212,1207,5,2700,2281,419,0.932808454228974,0.615384615384615,1.77967386799034,785,385,400,7,1,69.02,5.4,0,0,0,0,0,0,0.00595404653562314,3.59737163396364,0.661653154474186
8.7,"greedy_SVM","SVM",44,27,1112,1107,5,2800,2381,419,0.932805356987997,0.615384615384615,1.77967386799034,786,385,401,1,1,71.57,5.7,0,0,0,0,0,0,0.00560882632328086,3.01499786049407,0.583471121093613
8.7,"greedy_SVM","SVM",44,28,1012,1007,5,2900,2481,419,0.932690759071822,0.615384615384615,1.78131261004189,786,385,401,0,1,74.13,5.9,0,0,0,0,0,0,0.00472141405894039,2.27068465352268,0.50733254174911
8.7,"greedy_SVM","SVM",44,29,912,909,3,3000,2579,421,0.932780579060177,0.615384615384615,1.78295437281612,794,390,404,8,1,76.69,6.1,0,0,0,0,0,0,0.00465612291041641,2.06910125408128,0.504309851088189
8.7,"greedy_SVM","SVM",44,30,812,809,3,3100,2679,421,0.932755801132356,0.615384615384615,1.78131261004189,797,392,405,3,1,79.24,6.4,0,0,0,0,0,0,0.00377841492097767,1.50815336040947,0.41458444529914
8.7,"greedy_SVM","SVM",44,31,712,709,3,3200,2779,421,0.932919954904177,0.615384615384615,1.77640541276905,798,392,406,1,1,81.8,6.6,0,0,0,0,0,0,0.00271938107819942,0.963433946913597,0.305592267246239
8.7,"greedy_SVM","SVM",44,32,612,610,2,3300,2878,422,0.933186317628265,0.60989010989011,1.78295437281612,803,393,410,5,1,84.36,6.8,0,0,0,0,0,0,0.0025598414802755,0.859955567950472,0.290884014453154
8.7,"greedy_SVM","SVM",44,33,512,510,2,3400,2978,422,0.933266845893688,0.604395604395604,1.77967386799034,805,394,411,2,1,86.91,7.1,0,0,0,0,0,0,0.00163900670606264,0.526987073293071,0.198843919447616
8.7,"greedy_SVM","SVM",44,34,412,411,1,3500,3077,423,0.933353568641069,0.598901098901099,1.77803813833226,809,397,412,4,1,89.47,7.3,0,0,0,0,0,0,0.00127601755621555,0.363896548626549,0.15433566319165
8.7,"greedy_SVM","SVM",44,35,312,312,0,3600,3176,424,0.933739175142804,0.598901098901099,1.77803813833226,815,400,415,6,1,92.02,7.5,0,0,0,0,0,0,0.00107258322510703,0.268047682421094,0.135435205861947
8.7,"greedy_SVM","SVM",44,36,212,212,0,3700,3276,424,0.934319907826129,0.598901098901099,1.77314894088496,816,401,415,1,1,94.58,7.7,0,0,0,0,0,0,0.000499496799767674,0.110661664491151,0.0708850489136658
8.7,"greedy_SVM","SVM",44,37,112,112,0,3800,3376,424,0.934741132599102,0.598901098901099,1.77967386799034,822,403,419,6,1,97.14,8,0,0,0,0,0,0,0.000307926308065838,0.0483388716488654,0.0449601388306986
8.7,"greedy_SVM","SVM",44,38,12,12,0,3900,3476,424,0.935075634624696,0.598901098901099,1.77803813833226,826,404,422,4,1,99.69,8.2,0,0,0,0,0,0,0.000217781364876666,0.00310725521339324,0.00310725521339324
8.7,"greedy_SVM","SVM",44,39,0,0,0,3912,3488,424,0.935106607034474,0.598901098901099,1.77314894088496,826,404,422,0,1,100,8.2,0,0,0,0,0,0,0,0,0
8.7,"greedy_SVM","SVM",45,0,3812,3420,392,100,90,10,0.914674545617339,0.622549019607843,1.7585795608566,22,10,12,0,1.2,2.56,9,0,0,0,0,0,0,0.417457345513292,305.371835393403,45.7179714656499
8.7,"greedy_SVM","SVM",45,1,3712,3402,310,200,108,92,0.907832225355905,0.607843137254902,1.71281551294551,81,42,39,59,0.9,5.11,1.2,0,0,0,0,0,0,0.660883223269667,218.849188965961,75.2265848286104
8.7,"greedy_SVM","SVM",45,2,3612,3365,247,300,145,155,0.910916935267268,0.627450980392157,1.74090539441583,148,76,72,67,0.9,7.67,0.9,0,0,0,0,0,0,0.323743972309733,99.1359786552466,51.0546470614666
8.7,"greedy_SVM","SVM",45,3,3512,3318,194,400,192,208,0.902246172441591,0.607843137254902,1.72164445888853,241,125,116,93,0.9,10.22,0.9,0,0,0,0,0,0,0.127390502867642,48.0066949165195,27.9041450653802
8.7,"greedy_SVM","SVM",45,4,3412,3260,152,500,250,250,0.849477348016843,0.627450980392157,1.55532664678775,332,166,166,91,1,12.78,1,0,0,0,0,0,0,0.219199103549674,145.579598371136,30.3375145666043
8.7,"greedy_SVM","SVM",45,5,3312,3187,125,600,323,277,0.850441232429055,0.666666666666667,1.5627234319142,400,197,203,68,1,15.34,1.2,0,0,0,0,0,0,0.123028068686587,100.242248942866,17.2555525725154
8.7,"greedy_SVM","SVM",45,6,3212,3103,109,700,407,293,0.868500425284277,0.676470588235294,1.57458175930923,451,215,236,51,1.1,17.89,1.4,0,0,0,0,0,0,0.0755065970798547,71.4868145614554,10.6780900016996
8.7,"greedy_SVM","SVM",45,7,3112,3023,89,800,487,313,0.871429850479012,0.696078431372549,1.58774825477569,498,239,259,47,1.1,20.45,1.6,0,0,0,0,0,0,0.0626726926483292,78.0454509846952,8.75212266899884
8.7,"greedy_SVM","SVM",45,8,3012,2949,63,900,561,339,0.865941724863471,0.696078431372549,1.57155237785722,552,265,287,54,1.1,23.01,1.7,0,0,0,0,0,0,0.0742264495593313,107.396183175353,10.2047820742016
8.7,"greedy_SVM","SVM",45,9,2912,2855,57,1000,655,345,0.872984096606686,0.681372549019608,1.56866349480969,581,276,305,29,1.1,25.56,1.9,0,0,0,0,0,0,0.0595682215791876,81.7025494124771,6.61935235439459
8.7,"greedy_SVM","SVM",45,10,2812,2758,54,1100,752,348,0.875665905631666,0.681372549019608,1.58921026974326,591,283,308,10,1.1,28.12,2.2,0,0,0,0,0,0,0.0478443784969682,66.2997023710981,5.26735279864882
8.7,"greedy_SVM","SVM",45,11,2712,2661,51,1200,849,351,0.87619471304504,0.676470588235294,1.59951206288967,599,289,310,8,1.1,30.67,2.4,0,0,0,0,0,0,0.0401528825074133,53.4915857176821,4.4238560078741
8.7,"greedy_SVM","SVM",45,12,2612,2564,48,1300,946,354,0.880805689855854,0.676470588235294,1.60538990205098,604,291,313,5,1.1,33.23,2.7,0,0,0,0,0,0,0.0389794620431038,50.6321526471205,4.04000230329769
8.7,"greedy_SVM","SVM",45,13,2512,2465,47,1400,1045,355,0.899028561196169,0.666666666666667,1.63766002268676,623,307,316,19,1,35.79,2.9,0,0,0,0,0,0,0.0290702926763242,23.1134880858938,3.53503073620317
8.7,"greedy_SVM","SVM",45,14,2412,2373,39,1500,1137,363,0.90197477392784,0.661764705882353,1.64067319660155,642,315,327,19,1,38.34,3.1,0,0,0,0,0,0,0.0267427093912592,26.1728396852042,3.07442636453066
8.7,"greedy_SVM","SVM",45,15,2312,2277,35,1600,1233,367,0.908804503536583,0.661764705882353,1.65831484387683,657,320,337,15,1.1,40.9,3.4,0,0,0,0,0,0,0.0223796378486228,24.9547805338878,2.53541988067851
8.7,"greedy_SVM","SVM",45,16,2212,2181,31,1700,1329,371,0.913958277374892,0.666666666666667,1.6744160899654,667,327,340,10,1,43.46,3.6,0,0,0,0,0,0,0.021242404874199,25.8791100334711,2.4075856857118
8.7,"greedy_SVM","SVM",45,17,2112,2085,27,1800,1425,375,0.924184685289651,0.666666666666667,1.72729238754325,683,335,348,16,1,46.01,3.8,0,0,0,0,0,0,0.0262267046580641,27.9970887019731,3.12841098020094
8.7,"greedy_SVM","SVM",45,18,2012,1989,23,1900,1521,379,0.930734622616177,0.666666666666667,1.76416472752855,699,341,358,16,1,48.57,4,0,0,0,0,0,0,0.031716510895651,26.8049188853459,3.63453992094887
8.7,"greedy_SVM","SVM",45,19,1912,1894,18,2000,1616,384,0.93235461993017,0.661764705882353,1.76648514584569,721,349,372,22,1.1,51.12,4.2,0,0,0,0,0,0,0.0427136703948642,26.3335202503702,4.77321670515642
8.7,"greedy_SVM","SVM",45,20,1812,1796,16,2100,1714,386,0.932178350792378,0.661764705882353,1.77625372729737,730,353,377,9,1.1,53.68,4.4,0,0,0,0,0,0,0.0381197757388281,22.5077073519203,4.38534460005032
8.7,"greedy_SVM","SVM",45,21,1712,1701,11,2200,1809,391,0.931946123198144,0.656862745098039,1.77135596885813,745,361,384,15,1.1,56.24,4.6,0,0,0,0,0,0,0.0258108048710255,16.8688218408383,3.65438579581855
8.7,"greedy_SVM","SVM",45,22,1612,1605,7,2300,1905,395,0.931492859700964,0.661764705882353,1.77135596885813,758,365,393,13,1.1,58.79,4.8,0,0,0,0,0,0,0.0172469826945369,14.3873991267284,2.18471230247989
8.7,"greedy_SVM","SVM",45,23,1512,1506,6,2400,2004,396,0.931298404064829,0.661764705882353,1.76810577441986,756,366,390,-2,1.1,61.35,5.1,0,0,0,0,0,0,0.0129373632304159,10.5153245870129,1.36215009018493
8.7,"greedy_SVM","SVM",45,24,1412,1406,6,2500,2104,396,0.930889907332803,0.661764705882353,1.76486748545572,765,372,393,9,1.1,63.91,5.3,0,0,0,0,0,0,0.00982058670820624,7.6544666518521,1.11627651267591
8.7,"greedy_SVM","SVM",45,25,1312,1307,5,2600,2203,397,0.930653482854335,0.661764705882353,1.77298555116619,768,375,393,3,1,66.46,5.5,0,0,0,0,0,0,0.00787208498723638,5.5573626593002,0.825905609461052
8.7,"greedy_SVM","SVM",45,26,1212,1207,5,2700,2303,397,0.930535970095807,0.656862745098039,1.76810577441986,771,378,393,3,1,69.02,5.8,0,0,0,0,0,0,0.00678576284658358,4.56383552136613,0.750080667010214
8.7,"greedy_SVM","SVM",45,27,1112,1108,4,2800,2402,398,0.930477213716543,0.656862745098039,1.77135596885813,773,379,394,2,1,71.57,6,0,0,0,0,0,0,0.00633781053111887,3.69745153423236,0.648914024536656
8.7,"greedy_SVM","SVM",45,28,1012,1008,4,2900,2502,398,0.931347367714214,0.656862745098039,1.76972937935505,782,384,398,9,1,74.13,6.3,0,0,0,0,0,0,0.00537267474777194,2.89671244622131,0.576117825001056
8.7,"greedy_SVM","SVM",45,29,912,909,3,3000,2601,399,0.931336176022926,0.642156862745098,1.77625372729737,791,386,405,9,1,76.69,6.5,0,0,0,0,0,0,0.00438295450883336,2.11929797859799,0.467653120385295
8.7,"greedy_SVM","SVM",45,30,812,810,2,3100,2700,400,0.931562807771516,0.647058823529412,1.77298555116619,794,387,407,3,1.1,79.24,6.8,0,0,0,0,0,0,0.00389954945748232,1.67577487284779,0.417443463982337
8.7,"greedy_SVM","SVM",45,31,712,710,2,3200,2800,400,0.931305398871883,0.647058823529412,1.77135596885813,794,387,407,0,1.1,81.8,7,0,0,0,0,0,0,0.00355470782182157,1.36590942513864,0.385043596904681
8.7,"greedy_SVM","SVM",45,32,612,610,2,3300,2900,400,0.931280217566484,0.647058823529412,1.77298555116619,795,388,407,1,1,84.36,7.2,0,0,0,0,0,0,0.00272770985218247,0.927755679839747,0.306931784693978
8.7,"greedy_SVM","SVM",45,33,512,510,2,3400,3000,400,0.93112773077268,0.647058823529412,1.77461813454664,794,387,407,-1,1.1,86.91,7.5,0,0,0,0,0,0,0.00203652962107373,0.606023292589554,0.236536144061906
8.7,"greedy_SVM","SVM",45,34,412,410,2,3500,3100,400,0.931143119348201,0.647058823529412,1.76972937935505,794,387,407,0,1.1,89.47,7.8,0,0,0,0,0,0,0.00116685385791016,0.338356415184779,0.147721014030843
8.7,"greedy_SVM","SVM",45,35,312,312,0,3600,3198,402,0.931218663264398,0.647058823529412,1.76972937935505,797,391,406,3,1,92.02,8,0,0,0,0,0,0,0.00142044261308416,0.364529673061316,0.183646881825715
8.7,"greedy_SVM","SVM",45,36,212,212,0,3700,3298,402,0.931697108066976,0.642156862745098,1.76003223207091,799,392,407,2,1,94.58,8.2,0,0,0,0,0,0,0.000805459612520116,0.169560387117718,0.10398673368925
8.7,"greedy_SVM","SVM",45,37,112,112,0,3800,3398,402,0.931948921120964,0.642156862745098,1.76325278510306,803,393,410,4,1,97.14,8.5,0,0,0,0,0,0,0.000425231867823643,0.0677147171769105,0.0630761814049395
8.7,"greedy_SVM","SVM",45,38,12,12,0,3900,3498,402,0.932105604799002,0.642156862745098,1.76810577441986,808,396,412,5,1,99.69,8.7,0,0,0,0,0,0,0.00023904123497361,0.00373447690775974,0.00373447690775974
8.7,"greedy_SVM","SVM",45,39,0,0,0,3912,3510,402,0.932111200644646,0.642156862745098,1.76486748545572,808,396,412,0,1,100,8.7,0,0,0,0,0,0,0,0,0
8.7,"greedy_SVM","SVM",46,0,3812,3417,395,100,89,11,0.898758542141231,0.535,1.74707182320442,25,11,14,0,1.3,2.56,8.1,0,0,0,0,0,0,0.744770888691527,390.068000991904,81.0780867842172
8.7,"greedy_SVM","SVM",46,1,3712,3391,321,200,115,85,0.907796127562647,0.555,1.79045078196872,73,37,36,48,1,5.11,1.4,0,0,0,0,0,0,0.708801979385819,190.234522054062,81.9770532017321
8.7,"greedy_SVM","SVM",46,2,3612,3353,259,300,153,147,0.906341116173128,0.565,1.75769585253456,145,75,70,72,0.9,7.67,1,0,0,0,0,0,0,0.140607102050476,47.6739120864601,37.0682096748353
8.7,"greedy_SVM","SVM",46,3,3512,3309,203,400,197,203,0.888217539863339,0.585,1.7126267281106,235,119,116,90,1,10.22,1,0,0,0,0,0,0,0.135153256982444,41.7289598365347,23.3570247800021
8.7,"greedy_SVM","SVM",46,4,3412,3254,158,500,252,248,0.891577448747148,0.6,1.72005524861878,326,163,163,91,1,12.78,1,0,0,0,0,0,0,0.143200715465253,69.4449598239711,22.9116788016211
8.7,"greedy_SVM","SVM",46,5,3312,3186,126,600,320,280,0.883913724373578,0.605,1.65701657458564,389,192,197,63,1,15.34,1.1,0,0,0,0,0,0,0.0736164480035698,37.6936722796064,10.8812585325222
8.7,"greedy_SVM","SVM",46,6,3212,3115,97,700,391,309,0.873384111617309,0.615,1.62099447513812,454,222,232,65,1,17.89,1.3,0,0,0,0,0,0,0.0863513171572441,66.4754378543439,12.7113332942988
8.7,"greedy_SVM","SVM",46,7,3112,3031,81,800,475,325,0.864557232346242,0.63,1.57596685082873,499,240,259,45,1.1,20.45,1.5,0,0,0,0,0,0,0.0597660358462139,61.6238805175648,8.49112960523397
8.7,"greedy_SVM","SVM",46,8,3012,2948,64,900,558,342,0.871728359908885,0.635,1.57741935483871,540,258,282,41,1.1,23.01,1.6,0,0,0,0,0,0,0.0603272971576888,82.9482171635702,8.28245649697771
8.7,"greedy_SVM","SVM",46,9,2912,2862,50,1000,644,356,0.889985763097951,0.65,1.64051612903226,572,272,300,32,1.1,25.56,1.8,0,0,0,0,0,0,0.0557423930280465,84.41867903909,6.79893882397704
8.7,"greedy_SVM","SVM",46,10,2812,2772,40,1100,734,366,0.90719105922552,0.645,1.69303867403315,597,286,311,25,1.1,28.12,2,0,0,0,0,0,0,0.0502023290644555,73.3201583202648,6.08668457818105
8.7,"greedy_SVM","SVM",46,11,2712,2675,37,1200,831,369,0.916210136674266,0.64,1.69459907834101,618,296,322,21,1.1,30.67,2.3,0,0,0,0,0,0,0.0401013616873052,53.4133962612585,4.511186321195
8.7,"greedy_SVM","SVM",46,12,2612,2581,31,1300,925,375,0.922497152619601,0.635,1.71104972375691,639,306,333,21,1.1,33.23,2.5,0,0,0,0,0,0,0.0581844599919587,60.487392579674,6.37411410815813
8.7,"greedy_SVM","SVM",46,13,2512,2481,31,1400,1025,375,0.922636674259694,0.635,1.71847286108556,640,309,331,1,1.1,35.79,2.7,0,0,0,0,0,0,0.0384185149463538,39.3370315473139,4.18072995827047
8.7,"greedy_SVM","SVM",46,14,2412,2385,27,1500,1121,379,0.926677107061523,0.63,1.74546458141674,650,315,335,10,1.1,38.34,3,0,0,0,0,0,0,0.0419376967405477,39.5035878434345,4.79510598936332
8.7,"greedy_SVM","SVM",46,15,2312,2290,22,1600,1216,384,0.925472665148081,0.635,1.74546458141674,672,320,352,22,1.1,40.9,3.2,0,0,0,0,0,0,0.0397285266836319,32.3073884710333,4.86483451566875
8.7,"greedy_SVM","SVM",46,16,2212,2194,18,1700,1312,388,0.926846526195916,0.635,1.74386029411765,676,324,352,4,1.1,43.46,3.4,0,0,0,0,0,0,0.0262247171670296,25.1390085192706,3.25490924886587
8.7,"greedy_SVM","SVM",46,17,2112,2099,13,1800,1407,393,0.927736332574045,0.63,1.74868202764977,694,330,364,18,1.1,46.01,3.6,0,0,0,0,0,0,0.02329265213596,23.5170255123703,2.66727843961379
8.7,"greedy_SVM","SVM",46,18,2012,2001,11,1900,1505,395,0.92846526195901,0.63,1.74868202764977,695,335,360,1,1.1,48.57,3.8,0,0,0,0,0,0,0.0212082524814241,21.5758366440029,2.2704294433884
8.7,"greedy_SVM","SVM",46,19,1912,1902,10,2000,1604,396,0.928023917995459,0.63,1.74546458141674,697,339,358,2,1.1,51.12,4.1,0,0,0,0,0,0,0.0159929185984914,15.7916900276719,1.72451222839388
8.7,"greedy_SVM","SVM",46,20,1812,1803,9,2100,1703,397,0.928974943052411,0.63,1.75769585253456,709,342,367,12,1.1,53.68,4.3,0,0,0,0,0,0,0.0137255506095172,12.73638481206,1.44105762073731
8.7,"greedy_SVM","SVM",46,21,1712,1703,9,2200,1803,397,0.927065774487488,0.615,1.76508287292818,727,350,377,18,1.1,56.24,4.5,0,0,0,0,0,0,0.0102282729946319,9.03351384056565,1.26800129541339
8.7,"greedy_SVM","SVM",46,22,1612,1605,7,2300,1901,399,0.927736332574047,0.62,1.76670967741935,731,351,380,4,1.1,58.79,4.8,0,0,0,0,0,0,0.0102325886835351,8.12839502713232,1.03286027960257
8.7,"greedy_SVM","SVM",46,23,1512,1505,7,2400,2001,399,0.926719817767664,0.61,1.76345906163753,749,365,384,18,1.1,61.35,5,0,0,0,0,0,0,0.00635072416572896,4.2773272430572,0.865280098178577
8.7,"greedy_SVM","SVM",46,24,1412,1406,6,2500,2100,400,0.925758826879284,0.61,1.76508287292818,751,364,387,2,1.1,63.91,5.2,0,0,0,0,0,0,0.00578122246453499,3.7536556169588,0.601577326696525
8.7,"greedy_SVM","SVM",46,25,1312,1306,6,2600,2200,400,0.925412870159464,0.605,1.77082720588235,758,370,388,7,1,66.46,5.5,0,0,0,0,0,0,0.00461039243650966,2.75575727116722,0.505588194201594
8.7,"greedy_SVM","SVM",46,26,1212,1207,5,2700,2299,401,0.925578018223244,0.6,1.77245630174793,760,372,388,2,1,69.02,5.7,0,0,0,0,0,0,0.00492157564838002,2.64228859134266,0.509881743399096
8.7,"greedy_SVM","SVM",46,27,1112,1108,4,2800,2398,402,0.926047835990897,0.6,1.77245630174793,768,377,391,8,1,71.57,6,0,0,0,0,0,0,0.00420574020325756,2.04207594828372,0.446143553199643
8.7,"greedy_SVM","SVM",46,28,1012,1008,4,2900,2498,402,0.926025056947616,0.605,1.77572350230415,769,378,391,1,1,74.13,6.2,0,0,0,0,0,0,0.00382399391566534,1.62781241165429,0.406933234716696
8.7,"greedy_SVM","SVM",46,29,912,908,4,3000,2598,402,0.92603787015946,0.605,1.77408839779006,774,379,395,5,1,76.69,6.5,0,0,0,0,0,0,0.00317817897323993,1.20377051572132,0.346256475040286
8.7,"greedy_SVM","SVM",46,30,812,808,4,3100,2698,402,0.926060649202741,0.605,1.77408839779006,774,380,394,0,1,79.24,6.7,0,0,0,0,0,0,0.00227448508426921,0.763658989864193,0.253241456572636
8.7,"greedy_SVM","SVM",46,31,712,709,3,3200,2797,403,0.926452164009119,0.605,1.77245630174793,781,381,400,7,1,81.8,6.9,0,0,0,0,0,0,0.00164224826041784,0.49407350404634,0.19181626803768
8.7,"greedy_SVM","SVM",46,32,612,609,3,3300,2897,403,0.92660307517085,0.605,1.77245630174793,780,383,397,-1,1,84.36,7.2,0,0,0,0,0,0,0.00109263994083425,0.335962803121349,0.147397490986782
8.7,"greedy_SVM","SVM",46,33,512,509,3,3400,2997,403,0.926803815489756,0.605,1.77408839779006,780,383,397,0,1,86.91,7.4,0,0,0,0,0,0,0.000662585570949749,0.201098397056504,0.0884995448255822
8.7,"greedy_SVM","SVM",46,34,412,411,1,3500,3095,405,0.928334282460144,0.6,1.77572350230415,792,385,407,12,1.1,89.47,7.6,0,0,0,0,0,0,0.000538560784914701,0.159982899028929,0.0693138313320141
8.7,"greedy_SVM","SVM",46,35,312,312,0,3600,3194,406,0.929054669703879,0.605,1.77082720588235,797,390,407,5,1,92.02,7.9,0,0,0,0,0,0,0.000463091730789068,0.117510216254334,0.0567897749499669
8.7,"greedy_SVM","SVM",46,36,212,212,0,3700,3294,406,0.929036161731212,0.605,1.77082720588235,799,390,409,2,1,94.58,8.1,0,0,0,0,0,0,0.000295064861442976,0.0618512687103656,0.0389212875841439
8.7,"greedy_SVM","SVM",46,37,112,112,0,3800,3394,406,0.929246867881553,0.605,1.77082720588235,799,390,409,0,1,97.14,8.4,0,0,0,0,0,0,0.000119151184728491,0.0216531195836042,0.0202987626986223
8.7,"greedy_SVM","SVM",46,38,12,12,0,3900,3494,406,0.929319476082007,0.605,1.76920110192837,806,394,412,7,1,99.69,8.6,0,0,0,0,0,0,9.6031499715612e-05,0.00127412822480234,0.00127412822480234
8.7,"greedy_SVM","SVM",46,39,0,0,0,3912,3506,406,0.929258257403192,0.605,1.77082720588235,807,394,413,1,1,100,8.6,0,0,0,0,0,0,0,0,0
8.7,"greedy_SVM","SVM",47,0,3812,3410,402,100,88,12,0.903229520975051,0.557291666666667,1.74001377410468,28,12,16,0,1.3,2.56,7.3,0,0,0,0,0,0,0.5,361.483256160904,56.2647559067461
8.7,"greedy_SVM","SVM",47,1,3712,3383,329,200,115,85,0.917446145124719,0.5625,1.75711009174312,90,44,46,62,1,5.11,1.4,0,0,0,0,0,0,0.646154879537094,263.895173578897,77.4271096230005
8.7,"greedy_SVM","SVM",47,2,3612,3361,251,300,137,163,0.922071345899471,0.578125,1.77296270718232,141,77,64,51,0.8,7.67,0.8,0,0,0,0,0,0,0.4633960033684,150.780117591089,58.3641627731975
8.7,"greedy_SVM","SVM",47,3,3512,3308,204,400,190,210,0.899357225529108,0.598958333333333,1.70729742173112,231,118,113,90,1,10.22,0.9,0,0,0,0,0,0,0.218862253878864,95.8913929223698,31.9360574719596
8.7,"greedy_SVM","SVM",47,4,3412,3243,169,500,255,245,0.864367795729412,0.59375,1.64314516129032,317,158,159,86,1,12.78,1,0,0,0,0,0,0,0.143047573983801,91.8204807364979,21.4941331979019
8.7,"greedy_SVM","SVM",47,5,3312,3176,136,600,322,278,0.864792965797435,0.635416666666667,1.62287062615101,398,193,205,81,1.1,15.34,1.2,0,0,0,0,0,0,0.110642872894532,81.5473791513061,16.0423442196137
8.7,"greedy_SVM","SVM",47,6,3212,3096,116,700,402,298,0.874896660052904,0.640625,1.624366359447,439,208,231,41,1.1,17.89,1.3,0,0,0,0,0,0,0.0834546439682128,85.066877543331,11.4378532581746
8.7,"greedy_SVM","SVM",47,7,3112,3022,90,800,476,324,0.872847576530616,0.65625,1.59969008264463,507,240,267,68,1.1,20.45,1.5,0,0,0,0,0,0,0.0844104116717248,123.604249949301,12.7356840663505
8.7,"greedy_SVM","SVM",47,8,3012,2945,67,900,553,347,0.864391416288742,0.671875,1.57451701931923,558,265,293,51,1.1,23.01,1.6,0,0,0,0,0,0,0.104429267143455,161.626390796363,13.1919276435658
8.7,"greedy_SVM","SVM",47,9,2912,2851,61,1000,647,353,0.89915792705971,0.671875,1.65453923357664,590,288,302,32,1,25.56,1.8,0,0,0,0,0,0,0.0706847748411273,74.5836497086106,10.771285030386
8.7,"greedy_SVM","SVM",47,10,2812,2758,54,1100,740,360,0.903383054610755,0.666666666666667,1.67452938475666,606,293,313,16,1.1,28.12,2.1,0,0,0,0,0,0,0.0593830508522386,74.0383247348469,6.53641365221967
8.7,"greedy_SVM","SVM",47,11,2712,2666,46,1200,832,368,0.91366095049131,0.666666666666667,1.69479549632353,627,303,324,21,1.1,30.67,2.3,0,0,0,0,0,0,0.0492029466239967,67.7652762932739,5.60906739680816
8.7,"greedy_SVM","SVM",47,12,2612,2573,39,1300,925,375,0.924452593537403,0.65625,1.71037844036697,649,315,334,22,1.1,33.23,2.5,0,0,0,0,0,0,0.0497208295088171,66.9899033246216,5.77063108843693
8.7,"greedy_SVM","SVM",47,13,2512,2476,36,1400,1022,378,0.931022061602406,0.651041666666667,1.73384314627415,667,324,343,18,1.1,35.79,2.7,0,0,0,0,0,0,0.0465827602150896,55.4488327635146,5.28828245100152
8.7,"greedy_SVM","SVM",47,14,2412,2379,33,1500,1119,381,0.933468265778528,0.651041666666667,1.73224954044118,680,331,349,13,1.1,38.34,2.9,0,0,0,0,0,0,0.0404483925045538,43.0678349550894,4.49239516683204
8.7,"greedy_SVM","SVM",47,15,2312,2282,30,1600,1216,384,0.937077782501895,0.651041666666667,1.76807851239669,688,333,355,8,1.1,40.9,3.2,0,0,0,0,0,0,0.0371706330231644,36.0582398487173,4.17819893529304
8.7,"greedy_SVM","SVM",47,16,2212,2188,24,1700,1310,390,0.939364547902501,0.651041666666667,1.76034007352941,703,341,362,15,1.1,43.46,3.4,0,0,0,0,0,0,0.0373001496148887,34.0959548019802,4.51230652374351
8.7,"greedy_SVM","SVM",47,17,2112,2091,21,1800,1407,393,0.93991224962208,0.651041666666667,1.76195952161914,714,346,368,11,1.1,46.01,3.6,0,0,0,0,0,0,0.0310995243565327,29.0866728702155,3.65710690044864
8.7,"greedy_SVM","SVM",47,18,2012,1998,14,1900,1500,400,0.940300512566142,0.651041666666667,1.76358195211786,726,353,373,12,1.1,48.57,3.8,0,0,0,0,0,0,0.0284416467785328,27.2921373658866,3.59636856745507
8.7,"greedy_SVM","SVM",47,19,1912,1900,12,2000,1598,402,0.940431901927442,0.65625,1.76358195211786,738,358,380,12,1.1,51.12,4,0,0,0,0,0,0,0.0245378123901287,24.1416859943725,2.69608431830377
8.7,"greedy_SVM","SVM",47,20,1812,1801,11,2100,1697,403,0.940446664777027,0.65625,1.76195952161914,738,358,380,0,1.1,53.68,4.2,0,0,0,0,0,0,0.0214966454773161,18.9908957160322,2.17342479246205
8.7,"greedy_SVM","SVM",47,21,1712,1702,10,2200,1796,404,0.939885676492819,0.645833333333333,1.76483730522456,772,374,398,34,1.1,56.24,4.4,0,0,0,0,0,0,0.0179828251189844,12.5778616156356,2.30814258610794
8.7,"greedy_SVM","SVM",47,22,1612,1604,8,2300,1894,406,0.940127787225993,0.645833333333333,1.76970358455882,771,375,396,-1,1.1,58.79,4.7,0,0,0,0,0,0,0.0117308484033268,9.11771716320941,1.39888372247741
8.7,"greedy_SVM","SVM",47,23,1512,1506,6,2400,1992,408,0.941131660997722,0.651041666666667,1.77133164673413,776,378,398,5,1.1,61.35,4.9,0,0,0,0,0,0,0.0105892559291275,8.26908412140433,1.11149331760079
8.7,"greedy_SVM","SVM",47,24,1412,1406,6,2500,2092,408,0.941519923941782,0.640625,1.78234346224678,783,383,400,7,1,63.91,5.1,0,0,0,0,0,0,0.00852480570281299,6.28380132514642,0.933235082143435
8.7,"greedy_SVM","SVM",47,25,1312,1306,6,2600,2192,408,0.941524352796657,0.640625,1.78070377184913,781,383,398,-2,1,66.46,5.4,0,0,0,0,0,0,0.00842293013211809,5.55117269064074,0.862534467724594
8.7,"greedy_SVM","SVM",47,26,1212,1206,6,2700,2292,408,0.941304386337854,0.635416666666667,1.77906709558824,784,385,399,3,1,69.02,5.6,0,0,0,0,0,0,0.00651194183453176,3.94339958821331,0.709258923815954
8.7,"greedy_SVM","SVM",47,27,1112,1107,5,2800,2391,409,0.94092202853362,0.635416666666667,1.7774334251607,787,387,400,3,1,71.57,5.8,0,0,0,0,0,0,0.00694286175221077,3.6401624821492,0.73945044105472
8.7,"greedy_SVM","SVM",47,28,1012,1007,5,2900,2491,409,0.940431901927421,0.640625,1.7774334251607,796,389,407,9,1,74.13,6.1,0,0,0,0,0,0,0.00563258634155509,2.61698123516726,0.615192032644533
8.7,"greedy_SVM","SVM",47,29,912,908,4,3000,2590,410,0.940443712207089,0.640625,1.77255036630037,798,390,408,2,1,76.69,6.3,0,0,0,0,0,0,0.00461531938621436,1.90146345496118,0.500140496333701
8.7,"greedy_SVM","SVM",47,30,812,808,4,3100,2690,410,0.940279844576704,0.640625,1.77580275229358,797,390,407,-1,1,79.24,6.6,0,0,0,0,0,0,0.00357448114064657,1.28920558931945,0.395654047950651
8.7,"greedy_SVM","SVM",47,31,712,708,4,3200,2790,410,0.940394994803462,0.640625,1.77255036630037,799,391,408,2,1,81.8,6.8,0,0,0,0,0,0,0.0031934939735451,1.08000136492179,0.367935868477852
8.7,"greedy_SVM","SVM",47,32,612,609,3,3300,2889,411,0.940434854497339,0.635416666666667,1.77580275229358,804,393,411,5,1,84.36,7,0,0,0,0,0,0,0.00213565505845703,0.72468200090215,0.265976890759491
8.7,"greedy_SVM","SVM",47,33,512,510,2,3400,2988,412,0.940653344671186,0.630208333333333,1.78514908256881,808,395,413,4,1,86.91,7.3,0,0,0,0,0,0,0.00159967904560618,0.551505256966232,0.200186695731775
8.7,"greedy_SVM","SVM",47,34,412,411,1,3500,3087,413,0.940588388133015,0.635416666666667,1.7867883379247,814,400,414,6,1,89.47,7.5,0,0,0,0,0,0,0.00118863357253928,0.360001793647303,0.14051562227917
8.7,"greedy_SVM","SVM",47,35,312,312,0,3600,3186,414,0.94049981103551,0.635416666666667,1.79007589696412,821,403,418,7,1,92.02,7.7,0,0,0,0,0,0,0.00113165903761005,0.29062291570586,0.136025624898072
8.7,"greedy_SVM","SVM",47,36,212,212,0,3700,3286,414,0.940573625283432,0.635416666666667,1.78843060661765,825,405,420,4,1,94.58,7.9,0,0,0,0,0,0,0.000579052554821394,0.122795566400662,0.0748757036542343
8.7,"greedy_SVM","SVM",47,37,112,112,0,3800,3386,414,0.940623818972018,0.635416666666667,1.79007589696412,830,406,424,5,1,97.14,8.2,0,0,0,0,0,0,0.000310007115160257,0.0455021925203392,0.042247740281886
8.7,"greedy_SVM","SVM",47,38,12,12,0,3900,3486,414,0.940552957294014,0.635416666666667,1.79007589696412,829,406,423,-1,1,99.69,8.4,0,0,0,0,0,0,0.000218398052020594,0.00300025669126374,0.00300025669126374
8.7,"greedy_SVM","SVM",47,39,0,0,0,3912,3498,414,0.940579530423266,0.635416666666667,1.7867883379247,829,406,423,0,1,100,8.4,0,0,0,0,0,0,0,0,0
8.7,"greedy_SVM","SVM",48,0,3812,3422,390,100,90,10,0.914812760055477,0.611650485436893,1.71525211399937,27,10,17,0,1.7,2.56,9,0,0,0,0,0,0,0.170828659946224,372.542819513071,17.956769387119
8.7,"greedy_SVM","SVM",48,1,3712,3393,319,200,119,81,0.9151761442441,0.621359223300971,1.74703691463992,88,44,44,61,1,5.11,1.5,0,0,0,0,0,0,0.715718120607553,318.116992634178,82.1246588285787
8.7,"greedy_SVM","SVM",48,2,3612,3360,252,300,152,148,0.909151178918153,0.621359223300971,1.68024696881571,154,78,76,66,1,7.67,1,0,0,0,0,0,0,0.417682521259132,181.041354617985,54.1450443016974
8.7,"greedy_SVM","SVM",48,3,3512,3318,194,400,194,206,0.897803051317616,0.616504854368932,1.67561393489435,241,123,118,87,1,10.22,0.9,0,0,0,0,0,0,0.331332008664214,163.153409326518,47.3071621637898
8.7,"greedy_SVM","SVM",48,4,3412,3255,157,500,257,243,0.90869625520109,0.635922330097087,1.72164728475408,331,165,166,90,1,12.78,1.1,0,0,0,0,0,0,0.266315804088721,184.353535860066,36.5806815488096
8.7,"greedy_SVM","SVM",48,5,3312,3188,124,600,324,276,0.914058252427172,0.640776699029126,1.72480627059767,406,201,205,75,1,15.34,1.2,0,0,0,0,0,0,0.161848091684869,119.57833512938,22.8925140307913
8.7,"greedy_SVM","SVM",48,6,3212,3103,109,700,409,291,0.918805825242725,0.650485436893204,1.73115914820576,449,215,234,43,1.1,17.89,1.4,0,0,0,0,0,0,0.0739663555717575,61.782459077703,10.4010772620937
8.7,"greedy_SVM","SVM",48,7,3112,3017,95,800,495,305,0.912364771151179,0.669902912621359,1.67561393489435,486,230,256,37,1.1,20.45,1.6,0,0,0,0,0,0,0.0645055825023573,71.4928795270938,8.31000765573417
8.7,"greedy_SVM","SVM",48,8,3012,2938,74,900,574,326,0.915149791955605,0.679611650485437,1.68434109080525,544,253,291,58,1.2,23.01,1.8,0,0,0,0,0,0,0.084718136544583,110.990711283471,10.4181293111767
8.7,"greedy_SVM","SVM",48,9,2912,2856,56,1000,656,344,0.920976421636609,0.679611650485437,1.71525211399937,589,279,310,45,1.1,25.56,1.9,0,0,0,0,0,0,0.0986224076244564,113.697122056097,12.1773450624597
8.7,"greedy_SVM","SVM",48,10,2812,2762,50,1100,750,350,0.925102635228832,0.669902912621359,1.71924971444889,611,290,321,22,1.1,28.12,2.1,0,0,0,0,0,0,0.0850093177395751,84.6111801478081,9.2186319627894
8.7,"greedy_SVM","SVM",48,11,2712,2667,45,1200,845,355,0.925608876560313,0.66504854368932,1.72083136092032,626,298,328,15,1.1,30.67,2.4,0,0,0,0,0,0,0.0744325762319619,67.2703975817677,8.0949475542926
8.7,"greedy_SVM","SVM",48,12,2612,2573,39,1300,939,361,0.925546463245476,0.66504854368932,1.72241592018452,641,306,335,15,1.1,33.23,2.6,0,0,0,0,0,0,0.0632593483780827,53.3179905744702,6.9974090129847
8.7,"greedy_SVM","SVM",48,13,2512,2477,35,1400,1035,365,0.925374479889026,0.669902912621359,1.72241592018452,655,310,345,14,1.1,35.79,2.8,0,0,0,0,0,0,0.0556255798969002,47.5382430860099,6.13080639706707
8.7,"greedy_SVM","SVM",48,14,2412,2385,27,1500,1127,373,0.925814147018017,0.669902912621359,1.71767097274599,674,319,355,19,1.1,38.34,3,0,0,0,0,0,0,0.0471600011415604,43.6968416347759,5.54532211451432
8.7,"greedy_SVM","SVM",48,15,2312,2293,19,1600,1219,381,0.925542302357821,0.66504854368932,1.72083136092032,696,329,367,22,1.1,40.9,3.2,0,0,0,0,0,0,0.0420977369822375,47.1801940621352,4.80877306700209
8.7,"greedy_SVM","SVM",48,16,2212,2196,16,1700,1316,384,0.927747572815522,0.674757281553398,1.72400340029529,704,336,368,8,1.1,43.46,3.4,0,0,0,0,0,0,0.0337536377358965,38.4335487877138,3.74189907366795
8.7,"greedy_SVM","SVM",48,17,2112,2101,11,1800,1411,389,0.929651872399446,0.669902912621359,1.71924971444889,727,342,385,23,1.1,46.01,3.6,0,0,0,0,0,0,0.0345775391344814,39.1396480774415,3.77663511188555
8.7,"greedy_SVM","SVM",48,18,2012,2004,8,1900,1508,392,0.930660194174767,0.669902912621359,1.72797687035979,735,348,387,8,1.1,48.57,3.8,0,0,0,0,0,0,0.0280798236632968,30.043061609538,3.06351653337866
8.7,"greedy_SVM","SVM",48,19,1912,1905,7,2000,1607,393,0.930496532593629,0.669902912621359,1.72639011473963,737,350,387,2,1.1,51.12,4.1,0,0,0,0,0,0,0.025711745696872,27.121560543137,2.74772537970673
8.7,"greedy_SVM","SVM",48,20,1812,1805,7,2100,1707,393,0.930220527045778,0.669902912621359,1.73115914820576,737,351,386,0,1.1,53.68,4.3,0,0,0,0,0,0,0.0206376529197146,20.8188277852709,2.1847037523083
8.7,"greedy_SVM","SVM",48,21,1712,1705,7,2200,1807,393,0.930177531206662,0.669902912621359,1.72956654549352,740,352,388,3,1.1,56.24,4.6,0,0,0,0,0,0,0.0185356012141875,17.346854952955,1.89175526517708
8.7,"greedy_SVM","SVM",48,22,1612,1605,7,2300,1907,393,0.931403606102628,0.655339805825243,1.75025725918303,756,366,390,16,1.1,58.79,4.9,0,0,0,0,0,0,0.0112415119313895,7.54937086201068,1.52830126037735
8.7,"greedy_SVM","SVM",48,23,1512,1506,6,2400,2006,394,0.931206657420242,0.655339805825243,1.74703691463992,756,367,389,0,1.1,61.35,5.1,0,0,0,0,0,0,0.00810461576383075,6.17607031620166,0.957467132490206
8.7,"greedy_SVM","SVM",48,24,1412,1408,4,2500,2104,396,0.931564493758663,0.655339805825243,1.75025725918303,764,371,393,8,1.1,63.91,5.3,0,0,0,0,0,0,0.0082390968588438,6.28839149202421,0.853996863976213
8.7,"greedy_SVM","SVM",48,25,1312,1308,4,2600,2204,396,0.932596393897372,0.655339805825243,1.74222855615926,771,375,396,7,1.1,66.46,5.6,0,0,0,0,0,0,0.00556816697095439,3.825705416305,0.662245501940301
8.7,"greedy_SVM","SVM",48,26,1212,1208,4,2700,2304,396,0.932635228848828,0.655339805825243,1.74543118218161,770,374,396,-1,1.1,69.02,5.8,0,0,0,0,0,0,0.00503140257112091,3.06149044483024,0.511908328551499
8.7,"greedy_SVM","SVM",48,27,1112,1109,3,2800,2403,397,0.934041608876562,0.655339805825243,1.75577209921312,785,382,403,15,1.1,71.57,6.1,0,0,0,0,0,0,0.00401449286041762,2.38821292623905,0.476712622876566
8.7,"greedy_SVM","SVM",48,28,1012,1010,2,2900,2502,398,0.934116504854371,0.650485436893204,1.75900854547895,792,386,406,7,1.1,74.13,6.3,0,0,0,0,0,0,0.00405365129423671,2.07031015487591,0.415317691947219
8.7,"greedy_SVM","SVM",48,29,912,910,2,3000,2602,398,0.934449375866844,0.650485436893204,1.75577209921312,799,388,411,7,1.1,76.69,6.5,0,0,0,0,0,0,0.00262289436277555,1.13291560668037,0.292456881906043
8.7,"greedy_SVM","SVM",48,30,812,811,1,3100,2701,399,0.934707350901517,0.650485436893204,1.75577209921312,803,391,412,4,1.1,79.24,6.8,0,0,0,0,0,0,0.00275897647949656,1.00686729796533,0.291385827015924
8.7,"greedy_SVM","SVM",48,31,712,712,0,3200,2800,400,0.934937586685151,0.655339805825243,1.75577209921312,806,393,413,3,1.1,81.8,7,0,0,0,0,0,0,0.00211910170967669,0.648474062559176,0.235901062317559
8.7,"greedy_SVM","SVM",48,32,612,612,0,3300,2900,400,0.935015256588063,0.655339805825243,1.75577209921312,805,393,412,-1,1,84.36,7.2,0,0,0,0,0,0,0.00155290089787573,0.439898705965125,0.188669784324148
8.7,"greedy_SVM","SVM",48,33,512,512,0,3400,3000,400,0.935206657420241,0.655339805825243,1.75415833809252,808,393,415,3,1.1,86.91,7.5,0,0,0,0,0,0,0.000739928152441855,0.228549751832008,0.10392246563464
8.7,"greedy_SVM","SVM",48,34,412,412,0,3500,3100,400,0.935818307905682,0.655339805825243,1.7477328496746,813,396,417,5,1.1,89.47,7.8,0,0,0,0,0,0,0.000354899481064141,0.101584769497379,0.0487498370556109
8.7,"greedy_SVM","SVM",48,35,312,312,0,3600,3200,400,0.936391123439663,0.655339805825243,1.75093969894006,812,396,416,-1,1.1,92.02,8,0,0,0,0,0,0,0.00020899862083712,0.0525920777847696,0.0283318659622178
8.7,"greedy_SVM","SVM",48,36,212,212,0,3700,3300,400,0.93663800277392,0.650485436893204,1.75415833809252,814,397,417,2,1.1,94.58,8.2,0,0,0,0,0,0,8.51929472116434e-05,0.0189280370465063,0.0125196414390283
8.7,"greedy_SVM","SVM",48,37,112,112,0,3800,3400,400,0.936907073509011,0.650485436893204,1.75254754072053,816,398,418,2,1.1,97.14,8.5,0,0,0,0,0,0,2.67099219412709e-05,0.0051890201370678,0.00491260864348463
8.7,"greedy_SVM","SVM",48,38,12,12,0,3900,3500,400,0.937031900138693,0.650485436893204,1.75254754072053,819,399,420,3,1.1,99.69,8.8,0,0,0,0,0,0,2.29419815914028e-05,0.000346229584602747,0.000346229584602747
8.7,"greedy_SVM","SVM",48,39,0,0,0,3912,3512,400,0.937051317614421,0.650485436893204,1.75254754072053,819,399,420,0,1.1,100,8.8,0,0,0,0,0,0,0,0,0
8.7,"greedy_SVM","SVM",49,0,3812,3421,391,100,90,10,0.869816550821141,0.521951219512195,1.69255738880918,31,10,21,0,2.1,2.56,9,0,0,0,0,0,0,0.543555033684984,392.245797248581,64.4605945477831
8.7,"greedy_SVM","SVM",49,1,3712,3360,352,200,151,49,0.890206293267976,0.595121951219512,1.71167006978257,107,49,58,76,1.2,5.11,3.1,0,0,0,0,0,0,0.670716573253867,370.038904870753,78.2780220480064
8.7,"greedy_SVM","SVM",49,2,3612,3348,264,300,163,137,0.903904389129564,0.604878048780488,1.73081794906347,142,71,71,35,1,7.67,1.2,0,0,0,0,0,0,0.606275069909015,306.359380971853,70.3514391264278
8.7,"greedy_SVM","SVM",49,3,3512,3305,207,400,206,194,0.902168795531482,0.629268292682927,1.74197359588275,220,109,111,78,1,10.22,1.1,0,0,0,0,0,0,0.405728536531159,196.957176506618,52.2591731268975
8.7,"greedy_SVM","SVM",49,4,3412,3245,167,500,266,234,0.911091919599955,0.634146341463415,1.72288569448481,321,162,159,101,1,12.78,1.1,0,0,0,0,0,0,0.208312334978408,125.891661325529,30.3407331802064
8.7,"greedy_SVM","SVM",49,5,3312,3181,131,600,330,270,0.908657074006499,0.653658536585366,1.74120714847701,403,199,204,82,1,15.34,1.2,0,0,0,0,0,0,0.13541779707035,83.4173343932677,19.6769404984408
8.7,"greedy_SVM","SVM",49,6,3212,3105,107,700,406,294,0.916261091223143,0.648780487804878,1.74838970489152,456,220,236,53,1.1,17.89,1.4,0,0,0,0,0,0,0.0870907825159911,61.6545584108588,11.4420269021466
8.7,"greedy_SVM","SVM",49,7,3112,3022,90,800,489,311,0.912656182529852,0.663414634146341,1.70446031532139,491,237,254,35,1.1,20.45,1.6,0,0,0,0,0,0,0.0659229540253065,68.8546521814592,9.4488765713931
8.7,"greedy_SVM","SVM",49,8,3012,2938,74,900,573,327,0.91526514465604,0.673170731707317,1.68533668409361,525,255,270,34,1.1,23.01,1.8,0,0,0,0,0,0,0.0595755794797187,83.5170243946523,7.17768846907085
8.7,"greedy_SVM","SVM",49,9,2912,2855,57,1000,656,344,0.919201571227617,0.68780487804878,1.70446031532139,576,279,297,51,1.1,25.56,1.9,0,0,0,0,0,0,0.104011953284547,141.053203606493,12.6559179494302
8.7,"greedy_SVM","SVM",49,10,2812,2763,49,1100,748,352,0.925409870318026,0.68780487804878,1.72203207114944,605,295,310,29,1.1,28.12,2.1,0,0,0,0,0,0,0.0705050527493528,91.3774951494504,8.08646784772157
8.7,"greedy_SVM","SVM",49,11,2712,2674,38,1200,837,363,0.932267275842384,0.678048780487805,1.72763629842181,645,309,336,40,1.1,30.67,2.3,0,0,0,0,0,0,0.0692338219994337,85.7985095474592,7.89040645167041
8.7,"greedy_SVM","SVM",49,12,2612,2580,32,1300,931,369,0.936446072627493,0.702439024390244,1.74517575322812,660,314,346,15,1.1,33.23,2.5,0,0,0,0,0,0,0.0601304536998834,67.4172918899303,6.41068362291786
8.7,"greedy_SVM","SVM",49,13,2512,2486,26,1400,1025,375,0.938114805477012,0.692682926829268,1.75394548063128,677,323,354,17,1.1,35.79,2.7,0,0,0,0,0,0,0.0601431398516085,63.1513370447776,6.78695959969714
8.7,"greedy_SVM","SVM",49,14,2412,2391,21,1500,1120,380,0.939594099538954,0.697560975609756,1.76109655311429,690,329,361,13,1.1,38.34,2.9,0,0,0,0,0,0,0.0527074752805795,54.2361098525396,5.88394255558358
8.7,"greedy_SVM","SVM",49,15,2312,2295,17,1600,1216,384,0.939485450822532,0.697560975609756,1.76109655311429,698,334,364,8,1.1,40.9,3.2,0,0,0,0,0,0,0.04440025838277,48.7995137932807,5.0862513442969
8.7,"greedy_SVM","SVM",49,16,2212,2199,13,1700,1312,388,0.939882436517118,0.68780487804878,1.76596146071958,716,340,376,18,1.1,43.46,3.4,0,0,0,0,0,0,0.0386944552152722,43.7357668115616,4.32766342079253
8.7,"greedy_SVM","SVM",49,17,2112,2100,12,1800,1411,389,0.939961833656043,0.682926829268293,1.7643368411605,727,343,384,11,1.1,46.01,3.6,0,0,0,0,0,0,0.0310396298494115,33.3805649073395,3.30089984153215
8.7,"greedy_SVM","SVM",49,18,2012,2000,12,1900,1511,389,0.938931063782384,0.678048780487805,1.76109655311429,730,347,383,3,1.1,48.57,3.9,0,0,0,0,0,0,0.0228523898850519,22.57395264625,2.55399411917729
8.7,"greedy_SVM","SVM",49,19,1912,1900,12,2000,1611,389,0.939000710395467,0.673170731707317,1.77638305046645,729,349,380,-1,1.1,51.12,4.1,0,0,0,0,0,0,0.0185583510898065,17.4634904834098,2.04854364172444
8.7,"greedy_SVM","SVM",49,20,1812,1801,11,2100,1710,390,0.939152540011992,0.663414634146341,1.77148493543759,750,360,390,21,1.1,53.68,4.4,0,0,0,0,0,0,0.0145299867341559,12.5408926619827,1.66771574061587
8.7,"greedy_SVM","SVM",49,21,1712,1703,9,2200,1808,392,0.939589920742165,0.668292682926829,1.77474733863361,755,362,393,5,1.1,56.24,4.6,0,0,0,0,0,0,0.0128397606547823,10.7032726200352,1.32193456703709
8.7,"greedy_SVM","SVM",49,22,1612,1603,9,2300,1908,392,0.940177738156602,0.663414634146341,1.78025466284075,761,369,392,6,1.1,58.79,4.9,0,0,0,0,0,0,0.00839865249932345,6.4571647052306,1.04065696741216
8.7,"greedy_SVM","SVM",49,23,1512,1504,8,2400,2007,393,0.940279422211707,0.658536585365854,1.78517702596381,766,371,395,5,1.1,61.35,5.1,0,0,0,0,0,0,0.00747872690121677,5.5337277941543,0.789832316407165
8.7,"greedy_SVM","SVM",49,24,1412,1405,7,2500,2106,394,0.94104274909112,0.658536585365854,1.78517702596381,778,377,401,12,1.1,63.91,5.3,0,0,0,0,0,0,0.00626072406315483,4.57102923145791,0.724662468162802
8.7,"greedy_SVM","SVM",49,25,1312,1307,5,2600,2204,396,0.941365909375835,0.653658536585366,1.78517702596381,778,379,399,0,1.1,66.46,5.6,0,0,0,0,0,0,0.00646820192846669,4.13800526252747,0.669327504200213
8.7,"greedy_SVM","SVM",49,26,1212,1207,5,2700,2304,396,0.941594350266754,0.653658536585366,1.78517702596381,787,384,403,9,1,69.02,5.8,0,0,0,0,0,0,0.00560695521907031,3.32049620972899,0.592946734512782
8.7,"greedy_SVM","SVM",49,27,1112,1108,4,2800,2403,397,0.941708570712214,0.653658536585366,1.78517702596381,791,386,405,4,1,71.57,6.1,0,0,0,0,0,0,0.00450054864254338,2.3791020412263,0.470549772693392
8.7,"greedy_SVM","SVM",49,28,1012,1008,4,2900,2503,397,0.941721107102569,0.653658536585366,1.78353321654763,792,386,406,1,1.1,74.13,6.3,0,0,0,0,0,0,0.00440231415218125,2.1214273124763,0.467525760064609
8.7,"greedy_SVM","SVM",49,29,912,908,4,3000,2603,397,0.941736429357448,0.658536585365854,1.7786199019015,792,387,405,0,1,76.69,6.6,0,0,0,0,0,0,0.00314653406856349,1.33802433714432,0.340700350237571
8.7,"greedy_SVM","SVM",49,30,812,808,4,3100,2703,397,0.941914724686946,0.658536585365854,1.7786199019015,794,388,406,2,1,79.24,6.8,0,0,0,0,0,0,0.00243637731193557,0.943445373398616,0.269801954404397
8.7,"greedy_SVM","SVM",49,31,712,708,4,3200,2803,397,0.942176595952146,0.658536585365854,1.78025466284075,793,389,404,-1,1,81.8,7.1,0,0,0,0,0,0,0.00212152769573108,0.749971813210213,0.239435054651418
8.7,"greedy_SVM","SVM",49,32,612,609,3,3300,2902,398,0.942449610675439,0.653658536585366,1.77698814052361,798,389,409,5,1.1,84.36,7.3,0,0,0,0,0,0,0.00183143028040943,0.594054335291481,0.208660387073417
8.7,"greedy_SVM","SVM",49,33,512,509,3,3400,3002,398,0.942718446601948,0.658536585365854,1.78353321654763,803,390,413,5,1.1,86.91,7.5,0,0,0,0,0,0,0.0010623530311306,0.328367381152358,0.131674007089423
8.7,"greedy_SVM","SVM",49,34,412,410,2,3500,3101,399,0.943190650638665,0.658536585365854,1.7786199019015,808,392,416,5,1.1,89.47,7.8,0,0,0,0,0,0,0.000832277616592695,0.238809764407686,0.105767534717144
8.7,"greedy_SVM","SVM",49,35,312,311,1,3600,3200,400,0.943764538730486,0.658536585365854,1.78189243161981,811,394,417,3,1.1,92.02,8,0,0,0,0,0,0,0.00053050167540456,0.130261343235904,0.0676490785139161
8.7,"greedy_SVM","SVM",49,36,212,212,0,3700,3299,401,0.944260422615652,0.658536585365854,1.7786199019015,813,397,416,2,1,94.58,8.2,0,0,0,0,0,0,0.000380966942893229,0.0826887254174319,0.0521569421730872
8.7,"greedy_SVM","SVM",49,37,112,112,0,3800,3399,401,0.944376035993373,0.658536585365854,1.78025466284075,813,397,416,0,1,97.14,8.5,0,0,0,0,0,0,0.000153119514016245,0.0252506090913386,0.0235706927212505
8.7,"greedy_SVM","SVM",49,38,12,12,0,3900,3499,401,0.944547366661563,0.653658536585366,1.78189243161981,814,398,416,1,1,99.69,8.7,0,0,0,0,0,0,0.000180037112983379,0.00238588266441056,0.00238588266441056
8.7,"greedy_SVM","SVM",49,39,0,0,0,3912,3511,401,0.944530651474422,0.653658536585366,1.78025466284075,815,398,417,1,1,100,8.8,0,0,0,0,0,0,0,0,0
8.7,"greedy_SVM","SVM",50,0,3812,3431,381,100,95,5,0.856103372434023,0.490909090909091,1.67165479681609,24,5,19,0,3.8,2.56,19,0,0,0,0,0,0,0.0714586583893139,207.385456297345,7.70051916671777
8.7,"greedy_SVM","SVM",50,1,3712,3357,355,200,169,31,0.879252199413508,0.463636363636364,1.75359865940511,72,31,41,48,1.3,5.11,5.5,0,0,0,0,0,0,0.209429115487484,196.296683901954,31.4226703291865
8.7,"greedy_SVM","SVM",50,2,3612,3301,311,300,225,75,0.897917103058243,0.640909090909091,1.74059157754011,158,73,85,86,1.2,7.67,3,0,0,0,0,0,0,0.312999352865563,148.447932976042,42.356050070279
8.7,"greedy_SVM","SVM",50,3,3512,3270,242,400,256,144,0.900603529535003,0.663636363636364,1.71292743953294,237,116,121,79,1,10.22,1.8,0,0,0,0,0,0,0.527475959631402,202.123775311997,65.3718042544498
8.7,"greedy_SVM","SVM",50,4,3412,3245,167,500,281,219,0.905872957687485,0.668181818181818,1.69311700259262,298,148,150,61,1,12.78,1.3,0,0,0,0,0,0,0.353077833629538,170.783018853146,46.8228497161152
8.7,"greedy_SVM","SVM",50,5,3312,3186,126,600,340,260,0.859164222873906,0.677272727272727,1.56754320060105,387,191,196,89,1,15.34,1.3,0,0,0,0,0,0,0.192262956734427,142.265840821469,26.9365062067878
8.7,"greedy_SVM","SVM",50,6,3212,3106,106,700,420,280,0.865498010054466,0.677272727272727,1.58006027122049,441,216,225,54,1,17.89,1.5,0,0,0,0,0,0,0.0973244226049894,80.5880974034465,13.2550673759668
8.7,"greedy_SVM","SVM",50,7,3112,3026,86,800,500,300,0.872036028487637,0.690909090909091,1.60314460148867,489,232,257,48,1.1,20.45,1.7,0,0,0,0,0,0,0.0813743314277176,89.4803357901646,10.9669806713456
8.7,"greedy_SVM","SVM",50,8,3012,2948,64,900,578,322,0.871250523669878,0.695454545454545,1.58678598310613,536,255,281,47,1.1,23.01,1.8,0,0,0,0,0,0,0.0655217871062169,101.380004129061,10.9491779247946
8.7,"greedy_SVM","SVM",50,9,2912,2858,54,1000,668,332,0.875562945119398,0.7,1.61132391067994,572,272,300,36,1.1,25.56,2,0,0,0,0,0,0,0.0678229090943215,98.6067476405128,7.7234630945289
8.7,"greedy_SVM","SVM",50,10,2812,2764,48,1100,762,338,0.885295349811479,0.690909090909091,1.61132391067994,588,282,306,16,1.1,28.12,2.3,0,0,0,0,0,0,0.0531602156776703,72.9446159132258,5.82639299314129
8.7,"greedy_SVM","SVM",50,11,2712,2672,40,1200,854,346,0.895992616254714,0.686363636363636,1.6455549974887,616,294,322,28,1.1,30.67,2.5,0,0,0,0,0,0,0.0615529178895746,93.7655405507886,7.1548631915394
8.7,"greedy_SVM","SVM",50,12,2612,2576,36,1300,950,350,0.910601696690416,0.686363636363636,1.66039976582755,643,306,337,27,1.1,33.23,2.7,0,0,0,0,0,0,0.0490529893286784,64.8774047234558,5.54480768933624
8.7,"greedy_SVM","SVM",50,13,2512,2482,30,1400,1044,356,0.920344574780074,0.686363636363636,1.67367893814175,655,314,341,12,1.1,35.79,2.9,0,0,0,0,0,0,0.0528620156071097,68.694128727227,6.06314996728675
8.7,"greedy_SVM","SVM",50,14,2412,2390,22,1500,1136,364,0.933449413489747,0.677272727272727,1.74876336898396,680,329,351,25,1.1,38.34,3.1,0,0,0,0,0,0,0.0552554575498858,60.7464274399442,6.11749602784641
8.7,"greedy_SVM","SVM",50,15,2312,2291,21,1600,1235,365,0.936313887725196,0.677272727272727,1.76998743192292,685,331,354,5,1.1,40.9,3.4,0,0,0,0,0,0,0.0501172925938293,53.0474445971418,5.44001210060263
8.7,"greedy_SVM","SVM",50,16,2212,2192,20,1700,1334,366,0.937243401759552,0.677272727272727,1.76673078531404,692,333,359,7,1.1,43.46,3.6,0,0,0,0,0,0,0.0425530713991238,42.7253834996121,4.67338478699812
8.7,"greedy_SVM","SVM",50,17,2112,2096,16,1800,1430,370,0.93932760787601,0.677272727272727,1.77818181818182,699,338,361,7,1.1,46.01,3.9,0,0,0,0,0,0,0.0400318244268639,37.1985537098103,4.62315704763303
8.7,"greedy_SVM","SVM",50,18,2012,2001,11,1900,1525,375,0.9390160242983,0.672727272727273,1.77818181818182,717,344,373,18,1.1,48.57,4.1,0,0,0,0,0,0,0.0341506008294459,31.9292585860417,4.15045549898174
8.7,"greedy_SVM","SVM",50,19,1912,1902,10,2000,1624,376,0.938811793045681,0.672727272727273,1.77654445002511,722,345,377,5,1.1,51.12,4.3,0,0,0,0,0,0,0.0305065393743377,30.5150615013907,3.34201929446978
8.7,"greedy_SVM","SVM",50,20,1812,1802,10,2100,1724,376,0.938188625890256,0.672727272727273,1.77654445002511,720,347,373,-2,1.1,53.68,4.6,0,0,0,0,0,0,0.023288036770509,22.2358170830403,2.404480995046
8.7,"greedy_SVM","SVM",50,21,1712,1702,10,2200,1824,376,0.937028697109357,0.668181818181818,1.79291813159216,737,358,379,17,1.1,56.24,4.9,0,0,0,0,0,0,0.0132884845416983,9.29937457741998,1.80047053109156
8.7,"greedy_SVM","SVM",50,22,1612,1605,7,2300,1921,379,0.937146522832021,0.668181818181818,1.79126871288785,743,361,382,6,1.1,58.79,5.1,0,0,0,0,0,0,0.00924554003753944,8.30820416298805,1.10853781771268
8.7,"greedy_SVM","SVM",50,23,1512,1505,7,2400,2021,379,0.937204126518657,0.668181818181818,1.79126871288785,745,362,383,2,1.1,61.35,5.3,0,0,0,0,0,0,0.00874006382517694,7.06635702774199,0.892731419054426
8.7,"greedy_SVM","SVM",50,24,1412,1405,7,2500,2121,379,0.937248638458328,0.668181818181818,1.78797896318557,756,367,389,11,1.1,63.91,5.6,0,0,0,0,0,0,0.00560015685781922,4.00717900107207,0.677339016786343
8.7,"greedy_SVM","SVM",50,25,1312,1306,6,2600,2220,380,0.937235546711366,0.668181818181818,1.78633861551293,759,369,390,3,1.1,66.46,5.8,0,0,0,0,0,0,0.0051941150506587,3.74304574619726,0.552652544912757
8.7,"greedy_SVM","SVM",50,26,1212,1207,5,2700,2319,381,0.937027387934657,0.668181818181818,1.79291813159216,765,370,395,6,1.1,69.02,6.1,0,0,0,0,0,0,0.00418490121704162,2.84329927691437,0.449373753368306
8.7,"greedy_SVM","SVM",50,27,1112,1107,5,2800,2419,381,0.93698025764559,0.668181818181818,1.79291813159216,768,373,395,3,1.1,71.57,6.3,0,0,0,0,0,0,0.00369011053808462,2.28814834317574,0.384023609333929
8.7,"greedy_SVM","SVM",50,28,1012,1008,4,2900,2518,382,0.936416003351496,0.663636363636364,1.78797896318557,770,375,395,2,1.1,74.13,6.6,0,0,0,0,0,0,0.00347848715522995,2.06786721864567,0.374737721770415
8.7,"greedy_SVM","SVM",50,29,912,909,3,3000,2617,383,0.936059907834111,0.663636363636364,1.78633861551293,775,377,398,5,1.1,76.69,6.8,0,0,0,0,0,0,0.00280302342845549,1.47734214391508,0.296759432055807
8.7,"greedy_SVM","SVM",50,30,812,809,3,3100,2717,383,0.935991830749904,0.659090909090909,1.78962232620321,776,378,398,1,1.1,79.24,7.1,0,0,0,0,0,0,0.00234273293853617,1.09915132914594,0.248809397695752
8.7,"greedy_SVM","SVM",50,31,712,709,3,3200,2817,383,0.935983975701727,0.659090909090909,1.79291813159216,778,379,399,2,1.1,81.8,7.4,0,0,0,0,0,0,0.0017693321960059,0.72886338492877,0.1899470711721
8.7,"greedy_SVM","SVM",50,32,612,610,2,3300,2916,384,0.935889715123593,0.659090909090909,1.78797896318557,782,380,402,4,1.1,84.36,7.6,0,0,0,0,0,0,0.00189383904140472,0.743090573437794,0.209486489658472
8.7,"greedy_SVM","SVM",50,33,512,511,1,3400,3015,385,0.93601015919565,0.659090909090909,1.78470127489376,790,382,408,8,1.1,86.91,7.8,0,0,0,0,0,0,0.00130146608173097,0.46477025539723,0.151765173572718
8.7,"greedy_SVM","SVM",50,34,412,412,0,3500,3114,386,0.936579650188529,0.659090909090909,1.78306693306693,795,384,411,5,1.1,89.47,8.1,0,0,0,0,0,0,0.00114785133539487,0.343264345572939,0.129730144154537
8.7,"greedy_SVM","SVM",50,35,312,312,0,3600,3214,386,0.936641181399253,0.659090909090909,1.79457059069962,799,384,415,4,1.1,92.02,8.3,0,0,0,0,0,0,0.00071765541122526,0.179461467961606,0.0849660363123415
8.7,"greedy_SVM","SVM",50,36,212,212,0,3700,3314,386,0.936620234604113,0.659090909090909,1.79126871288785,801,385,416,2,1.1,94.58,8.6,0,0,0,0,0,0,0.000465381930391449,0.0987014306918434,0.0599542567823179
8.7,"greedy_SVM","SVM",50,37,112,112,0,3800,3414,386,0.936507645580233,0.659090909090909,1.79126871288785,799,385,414,-2,1.1,97.14,8.8,0,0,0,0,0,0,0.000263440395992463,0.0410591969457568,0.0381401716426846
8.7,"greedy_SVM","SVM",50,38,12,12,0,3900,3514,386,0.936654273146215,0.659090909090909,1.78633861551293,803,385,418,4,1.1,99.69,9.1,0,0,0,0,0,0,0.000192360531125912,0.00260513303575053,0.00260513303575053
8.7,"greedy_SVM","SVM",50,39,0,0,0,3912,3526,386,0.936647727272734,0.659090909090909,1.79291813159216,804,385,419,1,1.1,100,9.1,0,0,0,0,0,0,0,0,0
8.7,"greedy_SVM","SVM",51,0,3812,3421,391,100,90,10,0.882079926453187,0.492682926829268,1.70603124648758,35,10,25,0,2.5,2.56,9,0,0,0,0,0,0,0.281765652677818,372.651202437565,32.2397542202664
8.7,"greedy_SVM","SVM",51,1,3712,3378,334,200,133,67,0.917801674304587,0.6,1.76596146071958,108,53,55,73,1,5.11,2,0,0,0,0,0,0,0.757955251315456,403.188822555119,82.044917432229
8.7,"greedy_SVM","SVM",51,2,3612,3350,262,300,161,139,0.923976543020716,0.629268292682927,1.76758907496909,163,84,79,55,0.9,7.67,1.2,0,0,0,0,0,0,0.541206429676287,251.3342753795,65.5495652395872
8.7,"greedy_SVM","SVM",51,3,3512,3311,201,400,200,200,0.9157749578638,0.619512195121951,1.74120714847701,234,120,114,71,1,10.22,1,0,0,0,0,0,0,0.352591854249539,146.158169280951,46.6784849471348
8.7,"greedy_SVM","SVM",51,4,3412,3251,161,500,260,240,0.89177055619787,0.619512195121951,1.71324619323541,337,172,165,103,1,12.78,1.1,0,0,0,0,0,0,0.175793326223764,106.312546102358,25.5286439316083
8.7,"greedy_SVM","SVM",51,5,3312,3185,127,600,326,274,0.901411040381127,0.639024390243902,1.7236191974823,406,203,203,69,1,15.34,1.2,0,0,0,0,0,0,0.128077692857168,80.7751009261954,20.45011298677
8.7,"greedy_SVM","SVM",51,6,3212,3100,112,700,411,289,0.908530317170701,0.64390243902439,1.71324619323541,444,218,226,38,1,17.89,1.4,0,0,0,0,0,0,0.0719818755802892,48.7253217280269,9.37061667182348
8.7,"greedy_SVM","SVM",51,7,3112,3021,91,800,490,310,0.918590073964722,0.653658536585366,1.72763629842181,492,240,252,48,1.1,20.45,1.6,0,0,0,0,0,0,0.0731688454876289,67.9329988619934,8.82043213482601
8.7,"greedy_SVM","SVM",51,8,3012,2937,75,900,574,326,0.913847139613618,0.668292682926829,1.69567443740736,534,255,279,42,1.1,23.01,1.8,0,0,0,0,0,0,0.0634770029273187,82.4846244416102,9.47567385391396
8.7,"greedy_SVM","SVM",51,9,2912,2856,56,1000,655,345,0.913830424426469,0.692682926829268,1.66471813478465,589,281,308,55,1.1,25.56,1.9,0,0,0,0,0,0,0.0656140904488927,104.978726588772,8.23003767327449
8.7,"greedy_SVM","SVM",51,10,2812,2762,50,1100,749,351,0.913007201459805,0.697560975609756,1.67501793400287,608,293,315,19,1.1,28.12,2.1,0,0,0,0,0,0,0.0617397196163678,92.3968313443059,6.99608914199124
8.7,"greedy_SVM","SVM",51,11,2712,2663,49,1200,848,352,0.920157122759139,0.692682926829268,1.70446031532139,615,298,317,7,1.1,30.67,2.4,0,0,0,0,0,0,0.0455792743588118,60.1906811879567,5.15117127702592
8.7,"greedy_SVM","SVM",51,12,2612,2566,46,1300,945,355,0.926501929211201,0.68780487804878,1.7157126874021,618,301,317,3,1.1,33.23,2.7,0,0,0,0,0,0,0.0374110226748337,52.3006758436534,4.14464709818531
8.7,"greedy_SVM","SVM",51,13,2512,2473,39,1400,1038,362,0.935632600186661,0.697560975609756,1.73241317297966,643,312,331,25,1.1,35.79,2.9,0,0,0,0,0,0,0.0568565145418459,65.6194113277568,6.80085306419249
8.7,"greedy_SVM","SVM",51,14,2412,2378,34,1500,1133,367,0.939647030964887,0.697560975609756,1.75000112397437,672,320,352,29,1.1,38.34,3.1,0,0,0,0,0,0,0.053417668935982,55.2827143206341,5.95995434279329
8.7,"greedy_SVM","SVM",51,15,2312,2281,31,1600,1230,370,0.940505077238097,0.692682926829268,1.75000112397437,687,327,360,15,1.1,40.9,3.3,0,0,0,0,0,0,0.0471015393594007,46.1176227996592,5.25295848871997
8.7,"greedy_SVM","SVM",51,16,2212,2186,26,1700,1325,375,0.941095680517068,0.68780487804878,1.76271520803443,700,334,366,13,1.1,43.46,3.5,0,0,0,0,0,0,0.0490112229387947,41.7651747952485,5.60958504416694
8.7,"greedy_SVM","SVM",51,17,2112,2092,20,1800,1419,381,0.940091376356377,0.682926829268293,1.77148493543759,715,340,375,15,1.1,46.01,3.7,0,0,0,0,0,0,0.0505455568946302,37.9136647147209,5.94585789364034
8.7,"greedy_SVM","SVM",51,18,2012,1996,16,1900,1515,385,0.93961360059061,0.692682926829268,1.77148493543759,730,346,384,15,1.1,48.57,3.9,0,0,0,0,0,0,0.036783798437003,31.3390839396047,4.50750059456501
8.7,"greedy_SVM","SVM",51,19,1912,1900,12,2000,1611,389,0.938492290119939,0.68780487804878,1.76271520803443,737,351,386,7,1.1,51.12,4.1,0,0,0,0,0,0,0.0328931524414248,28.6476197817684,3.70548988810087
8.7,"greedy_SVM","SVM",51,20,1812,1802,10,2100,1709,391,0.939137217757107,0.682926829268293,1.7643368411605,743,354,389,6,1.1,53.68,4.4,0,0,0,0,0,0,0.024574917859021,22.5566556390384,2.68948913707987
8.7,"greedy_SVM","SVM",51,21,1712,1702,10,2200,1809,391,0.939031354905218,0.682926829268293,1.7643368411605,743,356,387,0,1.1,56.24,4.6,0,0,0,0,0,0,0.0224486243707572,18.615173662395,2.268017573867
8.7,"greedy_SVM","SVM",51,22,1612,1602,10,2300,1909,391,0.939036926634265,0.678048780487805,1.78353321654763,761,369,392,18,1.1,58.79,4.9,0,0,0,0,0,0,0.0163717746706793,10.319229083091,2.09071429771006
8.7,"greedy_SVM","SVM",51,23,1512,1504,8,2400,2007,393,0.93934337173184,0.678048780487805,1.77148493543759,764,370,394,3,1.1,61.35,5.1,0,0,0,0,0,0,0.0114672113654643,8.3471555717191,1.32782928575979
8.7,"greedy_SVM","SVM",51,24,1412,1407,5,2500,2104,396,0.939424161803017,0.673170731707317,1.78353321654763,775,374,401,11,1.1,63.91,5.3,0,0,0,0,0,0,0.0117692258429189,7.84319020871693,1.19424998699945
8.7,"greedy_SVM","SVM",51,25,1312,1307,5,2600,2204,396,0.940083018762801,0.663414634146341,1.78353321654763,784,381,403,9,1.1,66.46,5.6,0,0,0,0,0,0,0.00789306285364815,4.82726902764729,0.942450499011861
8.7,"greedy_SVM","SVM",51,26,1212,1207,5,2700,2304,396,0.940124806730652,0.673170731707317,1.78025466284075,783,380,403,-1,1.1,69.02,5.8,0,0,0,0,0,0,0.00740388162750823,4.52289787671991,0.791184084191406
8.7,"greedy_SVM","SVM",51,27,1112,1107,5,2800,2404,396,0.94009834101768,0.663414634146341,1.78517702596381,784,381,403,1,1.1,71.57,6.1,0,0,0,0,0,0,0.0061844274930167,3.27202442834122,0.630947128477321
8.7,"greedy_SVM","SVM",51,28,1012,1007,5,2900,2504,396,0.939637280439056,0.658536585365854,1.78353321654763,786,385,401,2,1,74.13,6.3,0,0,0,0,0,0,0.0043099604772596,2.04729431796392,0.477178960314307
8.7,"greedy_SVM","SVM",51,29,912,908,4,3000,2603,397,0.940042623727212,0.658536585365854,1.78517702596381,788,386,402,2,1,76.69,6.6,0,0,0,0,0,0,0.00425063644664215,1.81040018606987,0.459260395052517
8.7,"greedy_SVM","SVM",51,30,812,808,4,3100,2703,397,0.940078839966016,0.653658536585366,1.79397100146117,791,388,403,3,1,79.24,6.8,0,0,0,0,0,0,0.00292689838433469,1.05292109188233,0.323563947971376
8.7,"greedy_SVM","SVM",51,31,712,709,3,3200,2802,398,0.940179131088858,0.658536585365854,1.79397100146117,797,389,408,6,1,81.8,7,0,0,0,0,0,0,0.00258476966646105,0.86199023694041,0.293202568272647
8.7,"greedy_SVM","SVM",51,32,612,610,2,3300,2901,399,0.940360212282879,0.653658536585366,1.79397100146117,800,391,409,3,1,84.36,7.3,0,0,0,0,0,0,0.00212102968666036,0.687507177420439,0.253753220433679
8.7,"greedy_SVM","SVM",51,33,512,510,2,3400,3001,399,0.940521792425237,0.653658536585366,1.78517702596381,802,391,411,2,1.1,86.91,7.5,0,0,0,0,0,0,0.00117351974391226,0.368138398670647,0.150346758914177
8.7,"greedy_SVM","SVM",51,34,412,411,1,3500,3100,400,0.940828237522811,0.653658536585366,1.78517702596381,806,393,413,4,1.1,89.47,7.8,0,0,0,0,0,0,0.000987101299193713,0.300345517867639,0.123746916514708
8.7,"greedy_SVM","SVM",51,35,312,312,0,3600,3199,401,0.94091738518756,0.658536585365854,1.78025466284075,812,396,416,6,1.1,92.02,8,0,0,0,0,0,0,0.000956476135584376,0.241569938522482,0.113379333892099
8.7,"greedy_SVM","SVM",51,36,212,212,0,3700,3299,401,0.940956387290888,0.653658536585366,1.78353321654763,815,398,417,3,1,94.58,8.2,0,0,0,0,0,0,0.000499832011031491,0.105167589038912,0.0649203985054125
8.7,"greedy_SVM","SVM",51,37,112,112,0,3800,3399,401,0.940998175258739,0.648780487804878,1.78189243161981,814,399,415,-1,1,97.14,8.5,0,0,0,0,0,0,0.000210603265356729,0.0332254286492601,0.0310550661742485
8.7,"greedy_SVM","SVM",51,38,12,12,0,3900,3499,401,0.940812915267932,0.648780487804878,1.78353321654763,820,400,420,6,1.1,99.69,8.7,0,0,0,0,0,0,0.000140854482357944,0.00191328194335638,0.00191328194335638
8.7,"greedy_SVM","SVM",51,39,0,0,0,3912,3511,401,0.940870025490662,0.648780487804878,1.78353321654763,820,400,420,0,1.1,100,8.8,0,0,0,0,0,0,0,0,0
8.7,"greedy_SVM","SVM",52,0,3812,3410,402,100,89,11,0.906750445983799,0.559585492227979,1.74961104212164,24,11,13,0,1.2,2.56,8.1,0,0,0,0,0,0,0.757039661687439,449.164763787727,80.5137498137845
8.7,"greedy_SVM","SVM",52,1,3712,3374,338,200,125,75,0.906522678312684,0.538860103626943,1.76660170176356,88,45,43,64,1,5.11,1.7,0,0,0,0,0,0,0.863594920378792,323.865036438435,91.6960167456089
8.7,"greedy_SVM","SVM",52,2,3612,3335,277,300,164,136,0.910388850845972,0.538860103626943,1.76215376255416,163,83,80,75,1,7.67,1.2,0,0,0,0,0,0,0.465078892356992,191.834678844553,58.1119094968975
8.7,"greedy_SVM","SVM",52,3,3512,3301,211,400,198,202,0.917877264084152,0.585492227979275,1.76660170176356,229,117,112,66,1,10.22,1,0,0,0,0,0,0,0.30904393379887,121.504338048072,44.1764108907108
8.7,"greedy_SVM","SVM",52,4,3412,3238,174,500,261,239,0.905760023981737,0.590673575129534,1.74190414507772,318,159,159,89,1,12.78,1.1,0,0,0,0,0,0,0.1049805824166,41.2457291514323,17.5191854672915
8.7,"greedy_SVM","SVM",52,5,3312,3177,135,600,322,278,0.889263766718899,0.606217616580311,1.70935746519902,399,196,203,81,1,15.34,1.2,0,0,0,0,0,0,0.106843493910316,68.0941549363185,16.4216685739054
8.7,"greedy_SVM","SVM",52,6,3212,3103,109,700,396,304,0.895209237668941,0.632124352331606,1.66891811374177,455,223,232,56,1,17.89,1.3,0,0,0,0,0,0,0.0853145752500441,71.3086841697011,11.0944274113672
8.7,"greedy_SVM","SVM",52,7,3112,3022,90,800,477,323,0.896675767577059,0.632124352331606,1.64094741909805,499,242,257,44,1.1,20.45,1.5,0,0,0,0,0,0,0.0664831278576194,81.1776803410604,10.6649863068947
8.7,"greedy_SVM","SVM",52,8,3012,2948,64,900,551,349,0.902439024390246,0.647668393782383,1.67045487075258,567,271,296,68,1.1,23.01,1.6,0,0,0,0,0,0,0.0727059973791504,120.471521407622,10.166081063255
8.7,"greedy_SVM","SVM",52,9,2912,2858,54,1000,641,359,0.915770045759272,0.647668393782383,1.69688880838549,591,285,306,24,1.1,25.56,1.8,0,0,0,0,0,0,0.0773161752532899,116.300190081257,9.58031547730071
8.7,"greedy_SVM","SVM",52,10,2812,2767,45,1100,732,368,0.927406769549094,0.652849740932642,1.73577992156414,622,299,323,31,1.1,28.12,2,0,0,0,0,0,0,0.0740775687076147,91.5137948677675,8.38061222961811
8.7,"greedy_SVM","SVM",52,11,2712,2673,39,1200,826,374,0.930010668343843,0.652849740932642,1.74511207168007,641,312,329,19,1.1,30.67,2.2,0,0,0,0,0,0,0.062665126529504,72.0834781061125,6.89561940462811
8.7,"greedy_SVM","SVM",52,12,2612,2573,39,1300,926,374,0.929826984738119,0.647668393782383,1.74672046990282,645,314,331,4,1.1,33.23,2.5,0,0,0,0,0,0,0.0494306395216454,53.7024188716525,5.30505915141208
8.7,"greedy_SVM","SVM",52,13,2512,2477,35,1400,1022,378,0.930516165626802,0.647668393782383,1.75444422179601,664,321,343,19,1.1,35.79,2.7,0,0,0,0,0,0,0.0481030201358469,46.1601117701916,5.4192916871496
8.7,"greedy_SVM","SVM",52,14,2412,2381,31,1500,1118,382,0.930109122756521,0.647668393782383,1.75283019767292,674,326,348,10,1.1,38.34,2.9,0,0,0,0,0,0,0.0422193327752208,40.9429272572318,4.82582830131487
8.7,"greedy_SVM","SVM",52,15,2312,2292,20,1600,1207,393,0.92944198390053,0.647668393782383,1.74961104212164,697,334,363,23,1.1,40.9,3.1,0,0,0,0,0,0,0.0413707493512012,40.3687778928455,5.11575538925785
8.7,"greedy_SVM","SVM",52,16,2212,2194,18,1700,1305,395,0.929950420121173,0.652849740932642,1.75283019767292,702,337,365,5,1.1,43.46,3.3,0,0,0,0,0,0,0.02975429500623,33.3557745872031,3.45752088294567
8.7,"greedy_SVM","SVM",52,17,2112,2096,16,1800,1403,397,0.929394960897463,0.652849740932642,1.75121914050594,711,340,371,9,1.1,46.01,3.5,0,0,0,0,0,0,0.0305183325967809,35.7740636450122,3.28123593447739
8.7,"greedy_SVM","SVM",52,18,2012,1996,16,1900,1503,397,0.927666865534813,0.637305699481865,1.76053413593417,727,348,379,16,1.1,48.57,3.8,0,0,0,0,0,0,0.0213408396306168,21.8046846583067,2.46808098103108
8.7,"greedy_SVM","SVM",52,19,1912,1899,13,2000,1600,400,0.927810873481701,0.637305699481865,1.76215376255416,732,351,381,5,1.1,51.12,4,0,0,0,0,0,0,0.0195704213493894,20.3754358731976,2.09117309899675
8.7,"greedy_SVM","SVM",52,20,1812,1800,12,2100,1699,401,0.927769728354019,0.637305699481865,1.76215376255416,735,353,382,3,1.1,53.68,4.2,0,0,0,0,0,0,0.0182901507419876,17.8959881758933,1.87571893145162
8.7,"greedy_SVM","SVM",52,21,1712,1702,10,2200,1797,403,0.924980676484701,0.632124352331606,1.75444422179601,751,365,386,16,1.1,56.24,4.5,0,0,0,0,0,0,0.0137869526118492,10.2136006266167,1.65355054896268
8.7,"greedy_SVM","SVM",52,22,1612,1604,8,2300,1895,405,0.925377433073066,0.637305699481865,1.74961104212164,753,365,388,2,1.1,58.79,4.7,0,0,0,0,0,0,0.0102934950499729,8.68608125214946,1.16133656329701
8.7,"greedy_SVM","SVM",52,23,1512,1507,5,2400,1992,408,0.925715410907597,0.632124352331606,1.75121914050594,764,371,393,11,1.1,61.35,4.9,0,0,0,0,0,0,0.0101971386152073,8.7589730248763,1.09486806113293
8.7,"greedy_SVM","SVM",52,24,1412,1407,5,2500,2092,408,0.925750678159896,0.632124352331606,1.75283019767292,764,371,393,0,1.1,63.91,5.1,0,0,0,0,0,0,0.00860459093477053,6.78667282373126,0.880159277899131
8.7,"greedy_SVM","SVM",52,25,1312,1308,4,2600,2191,409,0.926332587822826,0.626943005181347,1.75283019767292,777,376,401,13,1.1,66.46,5.4,0,0,0,0,0,0,0.00724136664995615,5.33713232916579,0.806013999270285
8.7,"greedy_SVM","SVM",52,26,1212,1208,4,2700,2291,409,0.926489820989324,0.626943005181347,1.74800589437657,783,377,406,6,1.1,69.02,5.6,0,0,0,0,0,0,0.00670549049849885,4.38338614104328,0.682922764104234
8.7,"greedy_SVM","SVM",52,27,1112,1109,3,2800,2390,410,0.927896102674741,0.626943005181347,1.76540197225472,791,384,407,8,1.1,71.57,5.8,0,0,0,0,0,0,0.00529502995502824,3.12554954534533,0.580714122120234
8.7,"greedy_SVM","SVM",52,28,1012,1009,3,2900,2490,410,0.927809404012839,0.621761658031088,1.76053413593417,789,384,405,-2,1.1,74.13,6.1,0,0,0,0,0,0,0.00465952834754906,2.3138276540792,0.474287693702596
8.7,"greedy_SVM","SVM",52,29,912,909,3,3000,2590,410,0.928783661857592,0.621761658031088,1.76540197225472,792,387,405,3,1,76.69,6.3,0,0,0,0,0,0,0.00353874307754266,1.54244439193092,0.384214904318771
8.7,"greedy_SVM","SVM",52,30,812,809,3,3100,2690,410,0.928739577792216,0.621761658031088,1.76540197225472,791,388,403,-1,1,79.24,6.6,0,0,0,0,0,0,0.00312431324752679,1.17355510276254,0.337584328183044
8.7,"greedy_SVM","SVM",52,31,712,709,3,3200,2790,410,0.929054044125212,0.626943005181347,1.75891748383505,794,389,405,3,1,81.8,6.8,0,0,0,0,0,0,0.00241481943237094,0.783390689186887,0.272767414839882
8.7,"greedy_SVM","SVM",52,32,612,611,1,3300,2888,412,0.929921030744226,0.621761658031088,1.76215376255416,804,394,410,10,1,84.36,7,0,0,0,0,0,0,0.00204548632192439,0.655796888664633,0.252589662536004
8.7,"greedy_SVM","SVM",52,33,512,511,1,3400,2988,412,0.930520574033304,0.616580310880829,1.76377637191195,807,395,412,3,1,86.91,7.3,0,0,0,0,0,0,0.001188027049836,0.393485019772048,0.159456571957602
8.7,"greedy_SVM","SVM",52,34,412,411,1,3500,3088,412,0.930870307618599,0.616580310880829,1.76377637191195,811,395,416,4,1.1,89.47,7.5,0,0,0,0,0,0,0.000684824529506638,0.19724246284915,0.0852064536090219
8.7,"greedy_SVM","SVM",52,35,312,312,0,3600,3187,413,0.931317026147718,0.626943005181347,1.76215376255416,813,397,416,2,1,92.02,7.7,0,0,0,0,0,0,0.000625084074392291,0.159146571593493,0.0775876429174001
8.7,"greedy_SVM","SVM",52,36,212,212,0,3700,3287,413,0.931437522593072,0.626943005181347,1.76215376255416,818,400,418,5,1,94.58,8,0,0,0,0,0,0,0.000334929735809498,0.0693060393331884,0.0426358267073901
8.7,"greedy_SVM","SVM",52,37,112,112,0,3800,3387,413,0.931503648691134,0.626943005181347,1.76377637191195,822,402,420,4,1,97.14,8.2,0,0,0,0,0,0,0.00016129372705426,0.0265325835521499,0.024785121915716
8.7,"greedy_SVM","SVM",52,38,12,12,0,3900,3487,413,0.931531568599207,0.626943005181347,1.76377637191195,822,403,419,0,1,99.69,8.4,0,0,0,0,0,0,0.000114915610338313,0.00161081123342045,0.00161081123342045
8.7,"greedy_SVM","SVM",52,39,0,0,0,3912,3499,413,0.931516873910749,0.626943005181347,1.76215376255416,821,403,418,-1,1,100,8.5,0,0,0,0,0,0,0,0,0
8.7,"greedy_SVM","SVM",53,0,3812,3416,396,100,83,17,0.909802532776505,0.533678756476684,1.75121914050594,38,17,21,0,1.2,2.56,4.9,0,0,0,0,0,0,0.918703796895496,718.127182779799,94.1830576139833
8.7,"greedy_SVM","SVM",53,1,3712,3367,345,200,132,68,0.927640415095578,0.621761658031088,1.77753036726188,112,54,58,74,1.1,5.11,1.9,0,0,0,0,0,0,0.717429792427441,497.847946712072,78.9364901750594
8.7,"greedy_SVM","SVM",53,2,3612,3348,264,300,151,149,0.92751697971252,0.632124352331606,1.76822392554847,145,75,70,33,0.9,7.67,1,0,0,0,0,0,0,0.634976183093178,362.504165918377,71.3723894865926
8.7,"greedy_SVM","SVM",53,3,3512,3304,208,400,195,205,0.923878574850332,0.616580310880829,1.75606122107877,233,121,112,88,0.9,10.22,1,0,0,0,0,0,0,0.412685986059612,224.60098777023,52.6341069135073
8.7,"greedy_SVM","SVM",53,4,3412,3245,167,500,254,246,0.898971077914194,0.632124352331606,1.69067596284711,325,164,161,92,1,12.78,1,0,0,0,0,0,0,0.304154432763701,264.676761593319,40.9629364005158
8.7,"greedy_SVM","SVM",53,5,3312,3178,134,600,321,279,0.896527351223631,0.652849740932642,1.66112272063665,415,208,207,90,1,15.34,1.2,0,0,0,0,0,0,0.137789272934182,136.165139660065,21.2270379993493
8.7,"greedy_SVM","SVM",53,6,3212,3104,108,700,395,305,0.898001228475945,0.673575129533679,1.64245842040477,473,230,243,58,1.1,17.89,1.3,0,0,0,0,0,0,0.122802724829376,156.97799818679,18.5338696220845
8.7,"greedy_SVM","SVM",53,7,3112,3025,87,800,474,326,0.888387963286789,0.678756476683938,1.64397220696736,530,253,277,57,1.1,20.45,1.5,0,0,0,0,0,0,0.101736362987604,164.835470114061,13.9731288740646
8.7,"greedy_SVM","SVM",53,8,3012,2949,63,900,550,350,0.890359990477834,0.683937823834197,1.62529070461546,582,277,305,52,1.1,23.01,1.6,0,0,0,0,0,0,0.0981270058631875,161.553750272648,12.3181410379311
8.7,"greedy_SVM","SVM",53,9,2912,2854,58,1000,645,355,0.90422883744443,0.673575129533679,1.67830139038346,605,292,313,23,1.1,25.56,1.8,0,0,0,0,0,0,0.0727714485593656,100.389350844632,9.14094866010372
8.7,"greedy_SVM","SVM",53,10,2812,2765,47,1100,734,366,0.915772984696964,0.673575129533679,1.68601417250838,629,304,325,24,1.1,28.12,2,0,0,0,0,0,0,0.0599626384320972,85.6417765434186,6.75576539153105
8.7,"greedy_SVM","SVM",53,11,2712,2672,40,1200,827,373,0.92028719299124,0.678756476683938,1.70001671402307,654,316,338,25,1.1,30.67,2.2,0,0,0,0,0,0,0.0614447523019287,87.4034997117856,6.86443411841017
8.7,"greedy_SVM","SVM",53,12,2612,2577,35,1300,922,378,0.927400891673706,0.673575129533679,1.72327415422127,670,322,348,16,1.1,33.23,2.4,0,0,0,0,0,0,0.0599015229222314,76.67678525728,6.50569592953781
8.7,"greedy_SVM","SVM",53,13,2512,2480,32,1400,1019,381,0.932965770192711,0.673575129533679,1.73737971872687,681,327,354,11,1.1,35.79,2.7,0,0,0,0,0,0,0.0527498339652269,61.6054166171597,5.73618213317379
8.7,"greedy_SVM","SVM",53,14,2412,2385,27,1500,1114,386,0.93423245233778,0.66839378238342,1.74511207168007,696,334,362,15,1.1,38.34,2.9,0,0,0,0,0,0,0.0475714111947821,54.6177472912663,5.42885139241685
8.7,"greedy_SVM","SVM",53,15,2312,2289,23,1600,1210,390,0.935478561919007,0.66839378238342,1.74672046990282,711,340,371,15,1.1,40.9,3.1,0,0,0,0,0,0,0.0430597045239811,50.4935062638854,4.91547249891652
8.7,"greedy_SVM","SVM",53,16,2212,2194,18,1700,1305,395,0.936714385218325,0.66839378238342,1.74511207168007,722,346,376,11,1.1,43.46,3.3,0,0,0,0,0,0,0.0396928139331011,46.6365197681043,4.42657772416
8.7,"greedy_SVM","SVM",53,17,2112,2100,12,1800,1399,401,0.938008987271466,0.678756476683938,1.74672046990282,738,354,384,16,1.1,46.01,3.5,0,0,0,0,0,0,0.0378172779611147,43.3156842438497,4.11973372201367
8.7,"greedy_SVM","SVM",53,18,2012,2000,12,1900,1499,401,0.938561507557488,0.683937823834197,1.74672046990282,739,354,385,1,1.1,48.57,3.7,0,0,0,0,0,0,0.0314707706563691,32.462270484854,3.19777334853202
8.7,"greedy_SVM","SVM",53,19,1912,1901,11,2000,1598,402,0.939347673389983,0.663212435233161,1.77310852202788,766,370,396,27,1.1,51.12,4,0,0,0,0,0,0,0.0248185548620247,17.6428629378884,3.27729539045034
8.7,"greedy_SVM","SVM",53,20,1812,1801,11,2100,1698,402,0.939231585351166,0.663212435233161,1.77474272343067,764,370,394,-2,1.1,53.68,4.2,0,0,0,0,0,0,0.0150965005342964,11.8475644361931,1.80369621512821
8.7,"greedy_SVM","SVM",53,21,1712,1701,11,2200,1798,402,0.939137539345035,0.663212435233161,1.77310852202788,763,370,393,-1,1.1,56.24,4.5,0,0,0,0,0,0,0.0125535810680304,10.7851607215207,1.38494027685202
8.7,"greedy_SVM","SVM",53,22,1612,1603,9,2300,1896,404,0.939429963645347,0.663212435233161,1.77310852202788,769,372,397,6,1.1,58.79,4.7,0,0,0,0,0,0,0.0112942623247531,9.38936755290842,1.17492192297198
8.7,"greedy_SVM","SVM",53,23,1512,1504,8,2400,1995,405,0.939347673389983,0.66839378238342,1.77310852202788,782,379,403,13,1.1,61.35,4.9,0,0,0,0,0,0,0.00853484560826443,6.55631016264054,0.98433347695826
8.7,"greedy_SVM","SVM",53,24,1412,1406,6,2500,2093,407,0.939494620274564,0.66839378238342,1.77310852202788,786,381,405,4,1.1,63.91,5.1,0,0,0,0,0,0,0.00960175660299618,6.84326840371761,0.988761872897032
8.7,"greedy_SVM","SVM",53,25,1312,1308,4,2600,2191,409,0.939942808272529,0.647668393782383,1.77474272343067,798,390,408,12,1,66.46,5.4,0,0,0,0,0,0,0.00713988419407391,4.70097570120546,0.792175844588082
8.7,"greedy_SVM","SVM",53,26,1212,1208,4,2700,2291,409,0.939986892337903,0.647668393782383,1.77474272343067,798,390,408,0,1,69.02,5.6,0,0,0,0,0,0,0.00650510640735516,3.78728829805446,0.667585284754655
8.7,"greedy_SVM","SVM",53,27,1112,1108,4,2800,2391,409,0.94007506046865,0.647668393782383,1.77310852202788,806,392,414,8,1.1,71.57,5.8,0,0,0,0,0,0,0.0058328576856058,3.03563483867993,0.618841543054475
8.7,"greedy_SVM","SVM",53,28,1012,1009,3,2900,2490,410,0.940028037465584,0.647668393782383,1.77474272343067,813,395,418,7,1.1,74.13,6.1,0,0,0,0,0,0,0.00524714787054785,2.3834561403366,0.548626826699008
8.7,"greedy_SVM","SVM",53,29,912,910,2,3000,2589,411,0.940377771050882,0.647668393782383,1.77474272343067,818,396,422,5,1.1,76.69,6.3,0,0,0,0,0,0,0.00467885063229203,1.99429807781325,0.508227286626299
8.7,"greedy_SVM","SVM",53,30,812,810,2,3100,2689,411,0.940662848006966,0.647668393782383,1.77474272343067,818,397,421,0,1.1,79.24,6.5,0,0,0,0,0,0,0.00370689352211418,1.3929641026894,0.40471653486965
8.7,"greedy_SVM","SVM",53,31,712,710,2,3200,2789,411,0.940508553778158,0.647668393782383,1.77310852202788,817,397,420,-1,1.1,81.8,6.8,0,0,0,0,0,0,0.00282666787173575,0.958957869246907,0.319208193941302
8.7,"greedy_SVM","SVM",53,32,612,610,2,3300,2889,411,0.940580557751603,0.647668393782383,1.77474272343067,817,397,420,0,1.1,84.36,7,0,0,0,0,0,0,0.00194345857527133,0.658102850598349,0.246325182872505
8.7,"greedy_SVM","SVM",53,33,512,510,2,3400,2989,411,0.940649622787356,0.647668393782383,1.77310852202788,818,399,419,1,1.1,86.91,7.3,0,0,0,0,0,0,0.00124289224345587,0.390868177649258,0.153057931271933
8.7,"greedy_SVM","SVM",53,34,412,412,0,3500,3087,413,0.940821550642317,0.652849740932642,1.76822392554847,833,403,430,15,1.1,89.47,7.5,0,0,0,0,0,0,0.00124942307713058,0.374921515665764,0.150602564049155
8.7,"greedy_SVM","SVM",53,35,312,312,0,3600,3187,413,0.941268269171438,0.652849740932642,1.76984913136239,836,405,431,3,1.1,92.02,7.7,0,0,0,0,0,0,0.000811236892108032,0.202313170034439,0.0971478080444784
8.7,"greedy_SVM","SVM",53,36,212,212,0,3700,3287,413,0.941672373104033,0.652849740932642,1.76984913136239,839,405,434,3,1.1,94.58,8,0,0,0,0,0,0,0.000412302677372198,0.0857773579892369,0.0541146966719746
8.7,"greedy_SVM","SVM",53,37,112,112,0,3800,3387,413,0.942155828354301,0.652849740932642,1.77474272343067,841,407,434,2,1.1,97.14,8.2,0,0,0,0,0,0,0.000157685254006816,0.0252867128650706,0.023589777583587
8.7,"greedy_SVM","SVM",53,38,12,12,0,3900,3487,413,0.942135255790459,0.658031088082902,1.76822392554847,840,408,432,-1,1.1,99.69,8.4,0,0,0,0,0,0,0.000106557073729531,0.00149236060152037,0.00149236060152037
8.7,"greedy_SVM","SVM",53,39,0,0,0,3912,3499,413,0.942113213757772,0.658031088082902,1.77310852202788,840,408,432,0,1.1,100,8.5,0,0,0,0,0,0,0,0,0
8.7,"greedy_SVM","SVM",54,0,3812,3414,398,100,92,8,0.864161446469255,0.515,1.67785321100917,22,8,14,0,1.8,2.56,11.5,0,0,0,0,0,0,0.5,297.763357953031,58.0653463763868
8.7,"greedy_SVM","SVM",54,1,3712,3386,326,200,120,80,0.899686788154903,0.55,1.73487132352941,92,46,46,70,1,5.11,1.5,0,0,0,0,0,0,0.70746908200121,306.040967297902,79.0262450187096
8.7,"greedy_SVM","SVM",54,2,3612,3363,249,300,143,157,0.899353644646935,0.55,1.72588235294118,141,73,68,49,0.9,7.67,0.9,0,0,0,0,0,0,0.500151411598726,165.556240692865,62.8526426815552
8.7,"greedy_SVM","SVM",54,3,3512,3318,194,400,188,212,0.888143507972674,0.57,1.70633608815427,224,115,109,83,0.9,10.22,0.9,0,0,0,0,0,0,0.250408374317439,92.4934025238459,39.0809522307608
8.7,"greedy_SVM","SVM",54,4,3412,3259,153,500,247,253,0.862411731207296,0.56,1.69148114075437,315,159,156,91,1,12.78,1,0,0,0,0,0,0,0.231089378488239,139.301275536313,33.9972616417568
8.7,"greedy_SVM","SVM",54,5,3312,3188,124,600,318,282,0.873636104783595,0.595,1.65397058823529,384,190,194,69,1,15.34,1.1,0,0,0,0,0,0,0.105830952535187,61.0914504847514,16.5013038215354
8.7,"greedy_SVM","SVM",54,6,3212,3109,103,700,397,303,0.87558656036447,0.605,1.64051612903226,439,208,231,55,1.1,17.89,1.3,0,0,0,0,0,0,0.0639215193458722,46.2279565240871,8.53928649777837
8.7,"greedy_SVM","SVM",54,7,3112,3027,85,800,479,321,0.883352790432792,0.605,1.63,475,228,247,36,1.1,20.45,1.5,0,0,0,0,0,0,0.0608233988720109,69.1560853523967,7.660467557183
8.7,"greedy_SVM","SVM",54,8,3012,2944,68,900,562,338,0.878382687927111,0.635,1.62099447513812,520,250,270,45,1.1,23.01,1.7,0,0,0,0,0,0,0.0731293018155977,117.203335221244,9.93707742238235
8.7,"greedy_SVM","SVM",54,9,2912,2855,57,1000,651,349,0.899184225512537,0.615,1.67194852941176,556,267,289,36,1.1,25.56,1.9,0,0,0,0,0,0,0.0541788724547953,80.6865953667089,6.88670993387637
8.7,"greedy_SVM","SVM",54,10,2812,2766,46,1100,740,360,0.905083997722094,0.625,1.68992647058824,583,282,301,27,1.1,28.12,2.1,0,0,0,0,0,0,0.0537920142866527,75.7464028759987,6.3362125240906
8.7,"greedy_SVM","SVM",54,11,2712,2670,42,1200,836,364,0.912292141230069,0.61,1.71104972375691,608,295,313,25,1.1,30.67,2.3,0,0,0,0,0,0,0.0516227088598971,62.8219685564775,5.84717001588728
8.7,"greedy_SVM","SVM",54,12,2612,2575,37,1300,931,369,0.916022209567215,0.61,1.70361290322581,627,302,325,19,1.1,33.23,2.5,0,0,0,0,0,0,0.0496812412757229,55.1364284371187,5.63217256216613
8.7,"greedy_SVM","SVM",54,13,2512,2484,28,1400,1022,378,0.918522209567215,0.61,1.71847286108556,652,312,340,25,1.1,35.79,2.7,0,0,0,0,0,0,0.0535817829734446,48.3123431967205,5.99453605862516
8.7,"greedy_SVM","SVM",54,14,2412,2389,23,1500,1117,383,0.918106492027358,0.61,1.72906077348066,669,319,350,17,1.1,38.34,2.9,0,0,0,0,0,0,0.0508705514049205,45.4500717243211,5.88592623263248
8.7,"greedy_SVM","SVM",54,15,2312,2295,17,1600,1211,389,0.918536446469267,0.61,1.71847286108556,681,326,355,12,1.1,40.9,3.1,0,0,0,0,0,0,0.0443763822633634,41.3542897908722,5.33261600452239
8.7,"greedy_SVM","SVM",54,16,2212,2201,11,1700,1305,395,0.917918564920295,0.615,1.71689338235294,695,331,364,14,1.1,43.46,3.3,0,0,0,0,0,0,0.0345629918016643,37.5886309920471,4.44379201568001
8.7,"greedy_SVM","SVM",54,17,2112,2102,10,1800,1404,396,0.917697892938518,0.61,1.72005524861878,697,332,365,2,1.1,46.01,3.5,0,0,0,0,0,0,0.0299089097723709,29.0343701108249,3.00276593080799
8.7,"greedy_SVM","SVM",54,18,2012,2002,10,1900,1504,396,0.918747152619609,0.59,1.76345906163753,735,355,380,38,1.1,48.57,3.8,0,0,0,0,0,0,0.0236610765926538,13.4870598989294,3.26306714249437
8.7,"greedy_SVM","SVM",54,19,1912,1904,8,2000,1602,398,0.918724373576328,0.59,1.76345906163753,732,356,376,-3,1.1,51.12,4,0,0,0,0,0,0,0.0164835614420279,10.6546457014954,1.97970399053705
8.7,"greedy_SVM","SVM",54,20,1812,1804,8,2100,1702,398,0.918611902050132,0.59,1.76508287292818,731,355,376,-1,1.1,53.68,4.3,0,0,0,0,0,0,0.0110835341892774,8.22752722734505,1.29878580328692
8.7,"greedy_SVM","SVM",54,21,1712,1705,7,2200,1801,399,0.918408314350816,0.59,1.76508287292818,737,357,380,6,1.1,56.24,4.5,0,0,0,0,0,0,0.0085080295976658,6.8060400473043,0.949848366548876
8.7,"greedy_SVM","SVM",54,22,1612,1606,6,2300,1900,400,0.918325740318926,0.59,1.76183823529412,742,359,383,5,1.1,58.79,4.8,0,0,0,0,0,0,0.00866557841330284,6.66155140161884,0.897727025995822
8.7,"greedy_SVM","SVM",54,23,1512,1507,5,2400,1999,401,0.918186218678833,0.585,1.76508287292818,750,365,385,8,1.1,61.35,5,0,0,0,0,0,0,0.00673501164092984,4.95146044714816,0.757336465658415
8.7,"greedy_SVM","SVM",54,24,1412,1407,5,2500,2099,401,0.918042425968127,0.59,1.76508287292818,752,368,384,2,1,63.91,5.2,0,0,0,0,0,0,0.00504436094938478,3.26232049740894,0.521121081569595
8.7,"greedy_SVM","SVM",54,25,1312,1307,5,2600,2199,401,0.918502277904346,0.58,1.76022038567493,759,370,389,7,1.1,66.46,5.5,0,0,0,0,0,0,0.00438712738328849,2.61935817399337,0.470076366682669
8.7,"greedy_SVM","SVM",54,26,1212,1208,4,2700,2298,402,0.91916287015947,0.585,1.76345906163753,763,373,390,4,1,69.02,5.7,0,0,0,0,0,0,0.00382685791233426,2.07518245959252,0.404270263159017
8.7,"greedy_SVM","SVM",54,27,1112,1109,3,2800,2397,403,0.919487471526212,0.585,1.76022038567493,764,374,390,1,1,71.57,5.9,0,0,0,0,0,0,0.00338750835695171,1.6351170655935,0.354040120861445
8.7,"greedy_SVM","SVM",54,28,1012,1009,3,2900,2497,403,0.919615603644662,0.585,1.76670967741935,770,376,394,6,1,74.13,6.2,0,0,0,0,0,0,0.00300687483994054,1.33461661964422,0.325665737241757
8.7,"greedy_SVM","SVM",54,29,912,910,2,3000,2596,404,0.919735193621883,0.585,1.77408839779006,772,377,395,2,1,76.69,6.4,0,0,0,0,0,0,0.00268154663072954,1.07175767868924,0.291345830411502
8.7,"greedy_SVM","SVM",54,30,812,810,2,3100,2696,404,0.919743735763113,0.585,1.77572350230415,775,378,397,3,1.1,79.24,6.7,0,0,0,0,0,0,0.00247889174452459,0.902122982824959,0.27478693791485
8.7,"greedy_SVM","SVM",54,31,712,710,2,3200,2796,404,0.919823462414593,0.585,1.77245630174793,775,378,397,0,1.1,81.8,6.9,0,0,0,0,0,0,0.00187014691224516,0.59954094423401,0.211973372712418
8.7,"greedy_SVM","SVM",54,32,612,610,2,3300,2896,404,0.919914578587714,0.585,1.77572350230415,773,378,395,-2,1,84.36,7.2,0,0,0,0,0,0,0.0010862114176037,0.349502229330777,0.14187972038601
8.7,"greedy_SVM","SVM",54,33,512,510,2,3400,2996,404,0.919984339407759,0.585,1.77408839779006,775,379,396,2,1,86.91,7.4,0,0,0,0,0,0,0.000675286948855091,0.2131949086981,0.0880069171872533
8.7,"greedy_SVM","SVM",54,34,412,412,0,3500,3094,406,0.920503986332586,0.585,1.77572350230415,784,384,400,9,1,89.47,7.6,0,0,0,0,0,0,0.000641409721686778,0.200960358118815,0.0815351543007738
8.7,"greedy_SVM","SVM",54,35,312,312,0,3600,3194,406,0.920535307517095,0.585,1.77245630174793,787,385,402,3,1,92.02,7.9,0,0,0,0,0,0,0.000429719187790749,0.111618880901456,0.0526789885885954
8.7,"greedy_SVM","SVM",54,36,212,212,0,3700,3294,406,0.920797266514816,0.585,1.77572350230415,790,387,403,3,1,94.58,8.1,0,0,0,0,0,0,0.000257118962212658,0.0532370143327524,0.0329464291275832
8.7,"greedy_SVM","SVM",54,37,112,112,0,3800,3394,406,0.921205865603653,0.585,1.77408839779006,797,390,407,7,1,97.14,8.4,0,0,0,0,0,0,0.000122723681526016,0.021793986681822,0.0204940981680796
8.7,"greedy_SVM","SVM",54,38,12,12,0,3900,3494,406,0.921267084282469,0.585,1.76920110192837,804,391,413,7,1.1,99.69,8.6,0,0,0,0,0,0,8.42989548164727e-05,0.00119532362284165,0.00119532362284165
8.7,"greedy_SVM","SVM",54,39,0,0,0,3912,3506,406,0.921210136674269,0.585,1.77245630174793,804,391,413,0,1.1,100,8.6,0,0,0,0,0,0,0,0,0
8.7,"greedy_SVM","SVM",55,0,3812,3396,416,100,91,9,0.876347365963746,0.513812154696133,1.7183336041599,25,9,16,0,1.8,2.56,10.1,0,0,0,0,0,0,0.422029551268737,372.041256197126,50.5409237027617
8.7,"greedy_SVM","SVM",55,1,3712,3331,381,200,156,44,0.86964127305269,0.441988950276243,1.70003100428469,88,41,47,63,1.1,5.11,3.5,0,0,0,0,0,0,0.484967292840145,374.205778476528,57.6178892697613
8.7,"greedy_SVM","SVM",55,2,3612,3282,330,300,205,95,0.890256011205375,0.574585635359116,1.71312472948545,181,87,94,93,1.1,7.67,2.2,0,0,0,0,0,0,0.518957420129611,293.562799240046,61.857864823921
8.7,"greedy_SVM","SVM",55,3,3512,3256,256,400,231,169,0.845380126060233,0.607734806629834,1.57223527975337,236,119,117,55,1,10.22,1.4,0,0,0,0,0,0,0.466597020949947,177.777442889257,64.0570529840473
8.7,"greedy_SVM","SVM",55,4,3412,3232,180,500,255,245,0.851451248930041,0.596685082872928,1.58364437202434,292,145,147,56,1,12.78,1,0,0,0,0,0,0,0.329967728764121,165.921881690723,46.1235123540229
8.7,"greedy_SVM","SVM",55,5,3312,3170,142,600,317,283,0.85955334215236,0.635359116022099,1.59213699215531,382,192,190,90,1,15.34,1.1,0,0,0,0,0,0,0.186299452716371,110.891400494175,29.3419692108947
8.7,"greedy_SVM","SVM",55,6,3212,3094,118,700,393,307,0.859472414598085,0.651933701657459,1.57368434452733,441,221,220,59,1,17.89,1.3,0,0,0,0,0,0,0.0951720682612579,72.4978901774713,13.4262416019106
8.7,"greedy_SVM","SVM",55,7,3112,3013,99,800,474,326,0.863805151350088,0.651933701657459,1.58364437202434,490,238,252,49,1.1,20.45,1.5,0,0,0,0,0,0,0.0681151917449602,68.3137913992184,8.83373599482777
8.7,"greedy_SVM","SVM",55,8,3012,2934,78,900,553,347,0.870730682437168,0.668508287292818,1.60356442701836,539,259,280,49,1.1,23.01,1.6,0,0,0,0,0,0,0.0615507263685895,81.683532630301,9.11875852843577
8.7,"greedy_SVM","SVM",55,9,2912,2855,57,1000,632,368,0.874815967628985,0.651933701657459,1.58921026974326,590,284,306,51,1.1,25.56,1.7,0,0,0,0,0,0,0.0594146207869097,87.3747311136717,7.7127289352588
8.7,"greedy_SVM","SVM",55,10,2812,2766,46,1100,721,379,0.883411407672559,0.646408839779006,1.61455606139636,620,299,321,30,1.1,28.12,1.9,0,0,0,0,0,0,0.0598131624193747,89.9313529408541,6.74652619871066
8.7,"greedy_SVM","SVM",55,11,2712,2674,38,1200,813,387,0.8905299198506,0.635359116022099,1.64340453700639,646,310,336,26,1.1,30.67,2.1,0,0,0,0,0,0,0.0553448383401894,79.6024238873681,5.77096650985467
8.7,"greedy_SVM","SVM",55,12,2612,2577,35,1300,910,390,0.918490389852942,0.629834254143646,1.72149812276793,672,329,343,26,1,33.23,2.3,0,0,0,0,0,0,0.0462887661400355,42.7932285064767,5.85253914864013
8.7,"greedy_SVM","SVM",55,13,2512,2482,30,1400,1005,395,0.925235390242018,0.635359116022099,1.7314489789689,686,336,350,14,1,35.79,2.5,0,0,0,0,0,0,0.0350737287212221,38.0526529557469,3.93453184398591
8.7,"greedy_SVM","SVM",55,14,2412,2386,26,1500,1101,399,0.931186678079528,0.640883977900553,1.75644947719282,698,340,358,12,1.1,38.34,2.8,0,0,0,0,0,0,0.0397278190086446,42.0787418572284,4.66247339575501
8.7,"greedy_SVM","SVM",55,15,2312,2290,22,1600,1197,403,0.934280600731468,0.624309392265193,1.77629636394076,718,348,370,20,1.1,40.9,3,0,0,0,0,0,0,0.0546470523468515,42.1394757048005,6.21249104990109
8.7,"greedy_SVM","SVM",55,16,2212,2192,20,1700,1295,405,0.93510543926543,0.624309392265193,1.78621980731473,728,353,375,10,1.1,43.46,3.2,0,0,0,0,0,0,0.0471296651141968,33.1395758664822,5.1735652580763
8.7,"greedy_SVM","SVM",55,17,2112,2096,16,1800,1391,409,0.935077425881257,0.624309392265193,1.78621980731473,743,358,385,15,1.1,46.01,3.4,0,0,0,0,0,0,0.0420943446260342,26.7354837547957,4.84297691756377
8.7,"greedy_SVM","SVM",55,18,2012,2000,12,1900,1487,413,0.934749046766792,0.624309392265193,1.78786155346116,757,366,391,14,1.1,48.57,3.6,0,0,0,0,0,0,0.0331577638941278,22.2341782354871,4.24681792379164
8.7,"greedy_SVM","SVM",55,19,1912,1905,7,2000,1582,418,0.934951365652482,0.61878453038674,1.79115411617472,766,371,395,9,1.1,51.12,3.8,0,0,0,0,0,0,0.02167859428687,17.4723346270324,2.83133222997273
8.7,"greedy_SVM","SVM",55,20,1812,1806,6,2100,1681,419,0.934741265271188,0.61878453038674,1.79280494946152,765,371,394,-1,1.1,53.68,4,0,0,0,0,0,0,0.018594491655883,16.3387238501774,2.08157116437648
8.7,"greedy_SVM","SVM",55,21,1712,1706,6,2200,1781,419,0.934545171581982,0.61878453038674,1.79280494946152,766,371,395,1,1.1,56.24,4.3,0,0,0,0,0,0,0.0137337694900692,12.4075335557217,1.51457227330946
8.7,"greedy_SVM","SVM",55,22,1612,1606,6,2300,1881,419,0.934528052291654,0.624309392265193,1.79115411617472,765,372,393,-1,1.1,58.79,4.5,0,0,0,0,0,0,0.010770639070757,9.73951548034525,1.16130542993855
8.7,"greedy_SVM","SVM",55,23,1512,1506,6,2400,1981,419,0.934415998754965,0.624309392265193,1.79115411617472,768,372,396,3,1.1,61.35,4.7,0,0,0,0,0,0,0.0098161634833406,8.24678516129211,0.996506523893423
8.7,"greedy_SVM","SVM",55,24,1412,1406,6,2500,2081,419,0.934492257411877,0.624309392265193,1.78621980731473,780,380,400,12,1.1,63.91,5,0,0,0,0,0,0,0.00736568921663363,5.4418393135594,0.905317954141903
8.7,"greedy_SVM","SVM",55,25,1312,1307,5,2600,2180,420,0.934900007781498,0.624309392265193,1.78621980731473,783,381,402,3,1.1,66.46,5.2,0,0,0,0,0,0,0.00640746080495403,4.88952902723574,0.686219555031376
8.7,"greedy_SVM","SVM",55,26,1212,1207,5,2700,2280,420,0.93476927865536,0.624309392265193,1.79115411617472,793,385,408,10,1.1,69.02,5.4,0,0,0,0,0,0,0.00549042440745945,3.81391866627432,0.57407154869553
8.7,"greedy_SVM","SVM",55,27,1112,1107,5,2800,2380,420,0.935096101470705,0.624309392265193,1.79944802207912,797,387,410,4,1.1,71.57,5.7,0,0,0,0,0,0,0.00436519680525639,2.74230798039141,0.463312387189375
8.7,"greedy_SVM","SVM",55,28,1012,1007,5,2900,2480,420,0.935161466033773,0.61878453038674,1.78950632029967,799,392,407,2,1,74.13,5.9,0,0,0,0,0,0,0.00323204730335852,1.76598492169135,0.334662083767559
8.7,"greedy_SVM","SVM",55,29,912,907,5,3000,2580,420,0.935362228620343,0.61878453038674,1.79115411617472,801,392,409,2,1,76.69,6.1,0,0,0,0,0,0,0.00306869407294642,1.48176971567822,0.327184235130421
8.7,"greedy_SVM","SVM",55,30,812,809,3,3100,2678,422,0.935855575441602,0.61878453038674,1.80276497695853,813,396,417,12,1.1,79.24,6.3,0,0,0,0,0,0,0.00309247946681264,1.29422481258333,0.326479974938801
8.7,"greedy_SVM","SVM",55,31,712,709,3,3200,2778,422,0.93585246284336,0.624309392265193,1.79944802207912,816,397,419,3,1.1,81.8,6.6,0,0,0,0,0,0,0.00259160641458349,0.903683501857091,0.274700057374687
8.7,"greedy_SVM","SVM",55,32,612,609,3,3300,2878,422,0.935998754960705,0.624309392265193,1.79944802207912,818,398,420,2,1.1,84.36,6.8,0,0,0,0,0,0,0.00209272205588131,0.640665240797274,0.237244107097202
8.7,"greedy_SVM","SVM",55,33,512,509,3,3400,2978,422,0.935976966773015,0.624309392265193,1.80110497237569,818,398,420,0,1.1,86.91,7.1,0,0,0,0,0,0,0.00108722941104402,0.328368364711683,0.140145054893956
8.7,"greedy_SVM","SVM",55,34,412,411,1,3500,3076,424,0.936446969107463,0.624309392265193,1.80110497237569,827,403,424,9,1.1,89.47,7.3,0,0,0,0,0,0,0.0011121209836368,0.338403505801799,0.139378070952569
8.7,"greedy_SVM","SVM",55,35,312,312,0,3600,3175,425,0.936546572251188,0.61878453038674,1.80276497695853,834,407,427,7,1,92.02,7.5,0,0,0,0,0,0,0.000970634506826771,0.250470264753981,0.116067224075315
8.7,"greedy_SVM","SVM",55,36,212,212,0,3700,3275,425,0.936692864368533,0.61878453038674,1.80110497237569,841,408,433,7,1.1,94.58,7.7,0,0,0,0,0,0,0.000565381669611932,0.118275228707963,0.0720015871975661
8.7,"greedy_SVM","SVM",55,37,112,112,0,3800,3375,425,0.936688195471171,0.61878453038674,1.79779411764706,843,409,434,2,1.1,97.14,7.9,0,0,0,0,0,0,0.000217354295734734,0.0338227628244534,0.0316140167976583
8.7,"greedy_SVM","SVM",55,38,12,12,0,3900,3475,425,0.936689751770292,0.61878453038674,1.79449541284404,843,409,434,0,1.1,99.69,8.2,0,0,0,0,0,0,0.00014794232507235,0.00243188615645653,0.00243188615645653
8.7,"greedy_SVM","SVM",55,39,0,0,0,3912,3487,425,0.936688195471171,0.61878453038674,1.79779411764706,843,409,434,0,1.1,100,8.2,0,0,0,0,0,0,0,0,0
8.7,"greedy_SVM","SVM",56,0,3812,3412,400,100,87,13,0.877078931049587,0.393782383419689,1.72803896755092,38,13,25,0,1.9,2.56,6.7,0,0,0,0,0,0,0.18493387509154,508.241866409453,21.3736075438508
8.7,"greedy_SVM","SVM",56,1,3712,3357,355,200,142,58,0.894644961632159,0.559585492227979,1.73393569061716,110,51,59,72,1.2,5.11,2.4,0,0,0,0,0,0,0.708600522964726,593.937706826005,77.2286088157387
8.7,"greedy_SVM","SVM",56,2,3612,3317,295,300,182,118,0.920651621264951,0.621761658031088,1.75891748383505,179,87,92,69,1.1,7.67,1.5,0,0,0,0,0,0,0.66491192004956,498.872939401635,73.6787826426281
8.7,"greedy_SVM","SVM",56,3,3512,3295,217,400,204,196,0.922622178987178,0.637305699481865,1.75444422179601,232,114,118,53,1,10.22,1,0,0,0,0,0,0,0.607293539669936,408.935708339038,67.0933441940193
8.7,"greedy_SVM","SVM",56,4,3412,3253,159,500,246,254,0.918688410887016,0.663212435233161,1.74640368915716,316,160,156,84,1,12.78,1,0,0,0,0,0,0,0.450500182688888,342.11328801627,53.0367681149073
8.7,"greedy_SVM","SVM",56,5,3312,3188,124,600,311,289,0.861061720630467,0.642487046632124,1.59432959469186,412,207,205,96,1,15.34,1.1,0,0,0,0,0,0,0.342161054205792,292.806270982162,43.1976276247326
8.7,"greedy_SVM","SVM",56,6,3212,3107,105,700,392,308,0.892722896381875,0.663212435233161,1.60070797470703,466,227,239,54,1.1,17.89,1.3,0,0,0,0,0,0,0.181721039476354,200.189217688455,26.9630078271293
8.7,"greedy_SVM","SVM",56,7,3112,3038,74,800,461,339,0.90208635186726,0.663212435233161,1.65331295814331,559,266,293,93,1.1,20.45,1.4,0,0,0,0,0,0,0.121504485299752,161.839811853904,16.6195203267019
8.7,"greedy_SVM","SVM",56,8,3012,2959,53,900,540,360,0.904434563082839,0.66839378238342,1.65959454886053,600,286,314,41,1.1,23.01,1.5,0,0,0,0,0,0,0.0930302115542581,150.051041087582,11.047784861724
8.7,"greedy_SVM","SVM",56,9,2912,2868,44,1000,631,369,0.924292965064856,0.663212435233161,1.69688880838549,623,297,326,23,1.1,25.56,1.7,0,0,0,0,0,0,0.0765383063717618,117.50955433444,8.54729463998801
8.7,"greedy_SVM","SVM",56,10,2812,2773,39,1100,726,374,0.931463973032307,0.663212435233161,1.71853554518125,641,312,329,18,1.1,28.12,1.9,0,0,0,0,0,0,0.0685479998895882,101.281195492253,7.56860695488845
8.7,"greedy_SVM","SVM",56,11,2712,2678,34,1200,821,379,0.937097916587079,0.663212435233161,1.75121914050594,662,322,340,21,1.1,30.67,2.2,0,0,0,0,0,0,0.0742390520285396,95.3070537782104,8.3090326846841
8.7,"greedy_SVM","SVM",56,12,2612,2583,29,1300,916,384,0.941559224002905,0.663212435233161,1.76822392554847,680,330,350,18,1.1,33.23,2.4,0,0,0,0,0,0,0.0658847984047665,71.7762941238675,7.20197923745716
8.7,"greedy_SVM","SVM",56,13,2512,2484,28,1400,1015,385,0.941606247005969,0.658031088082902,1.7714773274354,680,331,349,0,1.1,35.79,2.6,0,0,0,0,0,0,0.053377149092427,54.113793240592,5.81176572230655
8.7,"greedy_SVM","SVM",56,14,2412,2391,21,1500,1108,392,0.940576149345073,0.658031088082902,1.76984913136239,703,337,366,23,1.1,38.34,2.8,0,0,0,0,0,0,0.0530545599211404,46.899704745614,6.09180003066694
8.7,"greedy_SVM","SVM",56,15,2312,2296,16,1600,1203,397,0.93961952512646,0.652849740932642,1.76053413593417,707,341,366,4,1.1,40.9,3,0,0,0,0,0,0,0.0441648242148383,41.4251868278511,5.23351192413671
8.7,"greedy_SVM","SVM",56,16,2212,2200,12,1700,1299,401,0.938939161050861,0.647668393782383,1.75444422179601,722,345,377,15,1.1,43.46,3.2,0,0,0,0,0,0,0.0345839948241396,37.918637628065,4.27518141600761
8.7,"greedy_SVM","SVM",56,17,2112,2102,10,1800,1397,403,0.938811317261282,0.647668393782383,1.75444422179601,728,350,378,6,1.1,46.01,3.5,0,0,0,0,0,0,0.0275937046365377,31.46773914633,3.00070874846667
8.7,"greedy_SVM","SVM",56,18,2012,2003,9,1900,1496,404,0.938673187189774,0.647668393782383,1.76540197225472,739,353,386,11,1.1,48.57,3.7,0,0,0,0,0,0,0.0249858663811702,28.4296684350366,2.71327391488517
8.7,"greedy_SVM","SVM",56,19,1912,1904,8,2000,1595,405,0.938545343400191,0.647668393782383,1.76984913136239,747,356,391,8,1.1,51.12,3.9,0,0,0,0,0,0,0.0222771049162628,24.5649867659648,2.4215231935936
8.7,"greedy_SVM","SVM",56,20,1812,1804,8,2100,1695,405,0.938251449631033,0.642487046632124,1.76984913136239,751,359,392,4,1.1,53.68,4.2,0,0,0,0,0,0,0.0188717969370571,19.305758331917,1.93139872970354
8.7,"greedy_SVM","SVM",56,21,1712,1704,8,2200,1795,405,0.937591658119281,0.647668393782383,1.78408347460662,750,365,385,-1,1.1,56.24,4.4,0,0,0,0,0,0,0.0131588886734816,10.6712724919247,1.66988085807901
8.7,"greedy_SVM","SVM",56,22,1612,1605,7,2300,1894,406,0.937726849253094,0.642487046632124,1.78847912221884,756,365,391,6,1.1,58.79,4.7,0,0,0,0,0,0,0.00998135929413556,8.91198092249839,1.09585555206796
8.7,"greedy_SVM","SVM",56,23,1512,1505,7,2400,1994,406,0.937241924533982,0.642487046632124,1.79012445719788,764,371,393,8,1.1,61.35,4.9,0,0,0,0,0,0,0.00735660906821856,6.19317976150276,0.832896925650023
8.7,"greedy_SVM","SVM",56,24,1412,1407,5,2500,2092,408,0.937663662092724,0.642487046632124,1.78847912221884,772,374,398,8,1.1,63.91,5.1,0,0,0,0,0,0,0.00772099809399729,5.98872972751594,0.831164618105544
8.7,"greedy_SVM","SVM",56,25,1312,1307,5,2600,2192,408,0.937618108558503,0.637305699481865,1.78847912221884,784,381,403,12,1.1,66.46,5.4,0,0,0,0,0,0,0.00513177514639511,3.50680819209371,0.598850765706541
8.7,"greedy_SVM","SVM",56,26,1212,1208,4,2700,2291,409,0.938063357618778,0.637305699481865,1.79177282225975,788,383,405,4,1.1,69.02,5.6,0,0,0,0,0,0,0.00460424230856772,3.08987941234244,0.486259620131393
8.7,"greedy_SVM","SVM",56,27,1112,1108,4,2800,2391,409,0.937912002327662,0.637305699481865,1.79012445719788,789,386,403,1,1,71.57,5.8,0,0,0,0,0,0,0.00380500509874203,2.28777893882157,0.394926327355356
8.7,"greedy_SVM","SVM",56,28,1012,1008,4,2900,2491,409,0.938226468660661,0.642487046632124,1.79177282225975,793,387,406,4,1,74.13,6.1,0,0,0,0,0,0,0.00332956390688263,1.78502522677238,0.351711123894436
8.7,"greedy_SVM","SVM",56,29,912,910,2,3000,2589,411,0.938684942940548,0.642487046632124,1.78847912221884,799,391,408,6,1,76.69,6.3,0,0,0,0,0,0,0.00372795800650319,1.84531428899526,0.393652726303707
8.7,"greedy_SVM","SVM",56,30,812,810,2,3100,2689,411,0.938526240305202,0.637305699481865,1.78847912221884,803,393,410,4,1,79.24,6.5,0,0,0,0,0,0,0.00261401045305101,1.11630161147013,0.279471125755584
8.7,"greedy_SVM","SVM",56,31,712,711,1,3200,2788,412,0.93852330136751,0.637305699481865,1.78847912221884,808,395,413,5,1,81.8,6.8,0,0,0,0,0,0,0.00231553615236428,0.889620103621036,0.251899007736529
8.7,"greedy_SVM","SVM",56,32,612,611,1,3300,2888,412,0.938483625708674,0.637305699481865,1.78847912221884,808,395,413,0,1,84.36,7,0,0,0,0,0,0,0.00162906618876654,0.560788215314062,0.185784839901833
8.7,"greedy_SVM","SVM",56,33,512,511,1,3400,2988,412,0.938511545616744,0.632124352331606,1.78683680897529,808,395,413,0,1,86.91,7.3,0,0,0,0,0,0,0.00102134907999099,0.303164051974348,0.118217817507399
8.7,"greedy_SVM","SVM",56,34,412,411,1,3500,3088,412,0.938676126127472,0.632124352331606,1.79012445719788,810,396,414,2,1,89.47,7.5,0,0,0,0,0,0,0.000814177104925196,0.237877070401546,0.103774527300053
8.7,"greedy_SVM","SVM",56,35,312,312,0,3600,3187,413,0.93910227209275,0.637305699481865,1.79177282225975,816,401,415,6,1,92.02,7.7,0,0,0,0,0,0,0.000595870553701516,0.153893864715155,0.0756646767309453
8.7,"greedy_SVM","SVM",56,36,212,212,0,3700,3287,413,0.93932563135731,0.642487046632124,1.79012445719788,823,402,421,7,1,94.58,8,0,0,0,0,0,0,0.000316642555838638,0.066259871439645,0.0411661670411072
8.7,"greedy_SVM","SVM",56,37,112,112,0,3800,3387,413,0.939369715422682,0.647668393782383,1.79342422578257,826,403,423,3,1,97.14,8.2,0,0,0,0,0,0,0.000133840911898288,0.0229874832245173,0.0215026692318757
8.7,"greedy_SVM","SVM",56,38,12,12,0,3900,3487,413,0.939440249927279,0.642487046632124,1.78683680897529,828,405,423,2,1,99.69,8.4,0,0,0,0,0,0,9.02667075511776e-05,0.00129603745193794,0.00129603745193794
8.7,"greedy_SVM","SVM",56,39,0,0,0,3912,3499,413,0.939454944615737,0.642487046632124,1.78683680897529,828,405,423,0,1,100,8.5,0,0,0,0,0,0,0,0,0
8.7,"greedy_SVM","SVM",57,0,3812,3402,410,100,82,18,0.924305810088348,0.601123595505618,1.77270620706701,39,18,21,0,1.2,2.56,4.6,0,0,0,0,0,0,0.755876255800252,607.331870956833,79.9353635333235
8.7,"greedy_SVM","SVM",57,1,3712,3391,321,200,93,107,0.917724118754826,0.601123595505618,1.75256181835034,63,33,30,24,0.9,5.11,0.9,0,0,0,0,0,0,0.77341010779051,418.34831898211,82.2935704001075
8.7,"greedy_SVM","SVM",57,2,3612,3342,270,300,142,158,0.888029094677756,0.589887640449438,1.68123025941076,156,83,73,93,0.9,7.67,0.9,0,0,0,0,0,0,0.411600923895106,142.679608196358,57.5498525307302
8.7,"greedy_SVM","SVM",57,3,3512,3300,212,400,184,216,0.883283199150652,0.617977528089888,1.67813691946704,242,125,117,86,0.9,10.22,0.9,0,0,0,0,0,0,0.318751210603868,138.114135465153,44.3387122259003
8.7,"greedy_SVM","SVM",57,4,3412,3235,177,500,249,251,0.874597136032168,0.640449438202247,1.64071868689484,332,166,166,90,1,12.78,1,0,0,0,0,0,0,0.180575211033761,118.239466294656,26.4199525600543
8.7,"greedy_SVM","SVM",57,5,3312,3158,154,600,326,274,0.88685525966557,0.662921348314607,1.65944503072816,396,195,201,64,1,15.34,1.2,0,0,0,0,0,0,0.0722455338324573,40.11857178958,11.4451745143252
8.7,"greedy_SVM","SVM",57,6,3212,3086,126,700,398,302,0.898541474450511,0.674157303370786,1.6609744731528,454,219,235,58,1.1,17.89,1.3,0,0,0,0,0,0,0.0645047440394755,52.2991942705356,9.64554969494838
8.7,"greedy_SVM","SVM",57,7,3112,3011,101,800,473,327,0.8982507804502,0.713483146067416,1.65791840236503,519,250,269,65,1.1,20.45,1.4,0,0,0,0,0,0,0.0606331620493802,64.0992507674647,8.4485247225327
8.7,"greedy_SVM","SVM",57,8,3012,2937,75,900,547,353,0.900194006648044,0.719101123595506,1.64780914381402,577,278,299,58,1.1,23.01,1.5,0,0,0,0,0,0,0.0656096524683658,100.311532644583,10.8795141862553
8.7,"greedy_SVM","SVM",57,9,2912,2849,63,1000,635,365,0.912589577988137,0.713483146067416,1.66802766091604,609,294,315,32,1.1,25.56,1.7,0,0,0,0,0,0,0.0612862670920582,84.0922331343971,7.11307605960399
8.7,"greedy_SVM","SVM",57,10,2812,2759,53,1100,725,375,0.919544115974262,0.713483146067416,1.65487355681431,645,310,335,36,1.1,28.12,1.9,0,0,0,0,0,0,0.0618249891031793,90.7189707441399,7.02469259392376
8.7,"greedy_SVM","SVM",57,11,2712,2672,40,1200,812,388,0.927955283679437,0.707865168539326,1.68824617801805,673,326,347,28,1.1,30.67,2.1,0,0,0,0,0,0,0.0854539762987012,105.828196567298,9.76035548865392
8.7,"greedy_SVM","SVM",57,12,2612,2578,34,1300,906,394,0.935034630502653,0.691011235955056,1.74039356881246,692,337,355,19,1.1,33.23,2.3,0,0,0,0,0,0,0.0702363872136373,78.1629843574686,7.83046102432371
8.7,"greedy_SVM","SVM",57,13,2512,2486,26,1400,998,402,0.937516588516335,0.679775280898876,1.750512136073,718,346,372,26,1.1,35.79,2.5,0,0,0,0,0,0,0.0736617086555712,67.4591179498278,8.27049727866909
8.7,"greedy_SVM","SVM",57,14,2412,2388,24,1500,1096,404,0.937695112549144,0.674157303370786,1.74729428288169,729,348,381,11,1.1,38.34,2.7,0,0,0,0,0,0,0.0617724931439584,56.1005832159139,6.92243112656768
8.7,"greedy_SVM","SVM",57,15,2312,2292,20,1600,1192,408,0.937927351777665,0.679775280898876,1.750512136073,743,354,389,14,1.1,40.9,2.9,0,0,0,0,0,0,0.0502833462018328,44.928394050378,5.76729993481565
8.7,"greedy_SVM","SVM",57,16,2212,2199,13,1700,1285,415,0.939807383627607,0.679775280898876,1.7622534044426,762,362,400,19,1.1,43.46,3.1,0,0,0,0,0,0,0.0416885564966639,42.7733317728085,5.00452241542456
8.7,"greedy_SVM","SVM",57,17,2112,2101,11,1800,1383,417,0.938979537670154,0.679775280898876,1.750512136073,771,365,406,9,1.1,46.01,3.3,0,0,0,0,0,0,0.0330139820114616,36.4037618362086,3.69318178168126
8.7,"greedy_SVM","SVM",57,18,2012,2002,10,1900,1482,418,0.940177070562807,0.679775280898876,1.7691202464261,777,370,407,6,1.1,48.57,3.5,0,0,0,0,0,0,0.0256387395782642,28.0878001677311,2.81046296121697
8.7,"greedy_SVM","SVM",57,19,1912,1902,10,2000,1582,418,0.939658876910047,0.679775280898876,1.7691202464261,778,368,410,1,1.1,51.12,3.8,0,0,0,0,0,0,0.0208945244614165,21.9468512347644,2.25930356660593
8.7,"greedy_SVM","SVM",57,20,1812,1803,9,2100,1681,419,0.939112245800733,0.674157303370786,1.7691202464261,780,373,407,2,1.1,53.68,4,0,0,0,0,0,0,0.0177163740526919,18.0529872884043,1.90464793895554
8.7,"greedy_SVM","SVM",57,21,1712,1704,8,2200,1780,420,0.938707801974188,0.679775280898876,1.7691202464261,787,375,412,7,1.1,56.24,4.2,0,0,0,0,0,0,0.015411727981441,15.0138275814723,1.60034421917574
8.7,"greedy_SVM","SVM",57,22,1612,1604,8,2300,1880,420,0.936783534080705,0.679775280898876,1.75578048101031,795,383,412,8,1.1,58.79,4.5,0,0,0,0,0,0,0.0116952023072729,8.85398366318234,1.45604695452833
8.7,"greedy_SVM","SVM",57,23,1512,1506,6,2400,1978,422,0.936475461634709,0.674157303370786,1.76063070333354,802,386,416,7,1.1,61.35,4.7,0,0,0,0,0,0,0.00935676598574526,7.99216839058176,1.05269788435312
8.7,"greedy_SVM","SVM",57,24,1412,1408,4,2500,2076,424,0.936227423819213,0.674157303370786,1.75578048101031,803,390,413,1,1.1,63.91,4.9,0,0,0,0,0,0,0.00886508457930518,7.32144352851321,0.946853341323354
8.7,"greedy_SVM","SVM",57,25,1312,1308,4,2600,2176,424,0.936527596971721,0.674157303370786,1.75578048101031,815,399,416,12,1,66.46,5.1,0,0,0,0,0,0,0.0057332646941292,4.30712244481678,0.703164292170059
8.7,"greedy_SVM","SVM",57,26,1212,1209,3,2700,2275,425,0.936325375058453,0.674157303370786,1.75256181835034,815,398,417,0,1,69.02,5.4,0,0,0,0,0,0,0.00573578374120228,3.90126896863789,0.583370576138724
8.7,"greedy_SVM","SVM",57,27,1112,1110,2,2800,2374,426,0.937371241516151,0.674157303370786,1.76063070333354,830,406,424,15,1,71.57,5.6,0,0,0,0,0,0,0.00492523320672835,3.16469769143201,0.551379167052216
8.7,"greedy_SVM","SVM",57,28,1012,1010,2,2900,2474,426,0.937453394168417,0.668539325842697,1.75578048101031,832,406,426,2,1,74.13,5.8,0,0,0,0,0,0,0.00400314989682779,2.15240922841868,0.407702242227291
8.7,"greedy_SVM","SVM",57,29,912,910,2,3000,2574,426,0.938910023887456,0.662921348314607,1.75256181835034,842,409,433,10,1.1,76.69,6,0,0,0,0,0,0,0.0029637541377645,1.41054124110403,0.326497024935901
8.7,"greedy_SVM","SVM",57,30,812,811,1,3100,2673,427,0.939312887855304,0.662921348314607,1.75416967322956,848,410,438,6,1.1,79.24,6.3,0,0,0,0,0,0,0.00279112697868449,1.16978246535815,0.301721429996043
8.7,"greedy_SVM","SVM",57,31,712,711,1,3200,2773,427,0.940311358552094,0.657303370786517,1.75416967322956,849,412,437,1,1.1,81.8,6.5,0,0,0,0,0,0,0.00210344675876794,0.780652490296918,0.235599256678925
8.7,"greedy_SVM","SVM",57,32,612,611,1,3300,2873,427,0.940369813323899,0.657303370786517,1.75578048101031,849,413,436,0,1.1,84.36,6.7,0,0,0,0,0,0,0.00161366973231349,0.523750504019961,0.182154429702891
8.7,"greedy_SVM","SVM",57,33,512,511,1,3400,2973,427,0.94022762604113,0.657303370786517,1.75901098787509,846,413,433,-3,1,86.91,7,0,0,0,0,0,0,0.00114900988762539,0.361157011154077,0.143424389032734
8.7,"greedy_SVM","SVM",57,34,412,412,0,3500,3072,428,0.940606792128516,0.662921348314607,1.75578048101031,848,415,433,2,1,89.47,7.2,0,0,0,0,0,0,0.00096157199786983,0.293679941055486,0.119399886882017
8.7,"greedy_SVM","SVM",57,35,312,312,0,3600,3172,428,0.940905385422332,0.662921348314607,1.75739424983477,852,417,435,4,1,92.02,7.4,0,0,0,0,0,0,0.000526105203684643,0.135418856267161,0.0648856555672402
8.7,"greedy_SVM","SVM",57,36,212,212,0,3700,3272,428,0.941219777303122,0.662921348314607,1.75901098787509,854,418,436,2,1,94.58,7.6,0,0,0,0,0,0,0.000344526957422533,0.0738005668601767,0.0451921640018215
8.7,"greedy_SVM","SVM",57,37,112,112,0,3800,3372,428,0.941804325021176,0.662921348314607,1.75578048101031,853,419,434,-1,1,97.14,7.9,0,0,0,0,0,0,0.000163646254365113,0.0266236304961544,0.0249130108362324
8.7,"greedy_SVM","SVM",57,38,12,12,0,3900,3472,428,0.942268803478222,0.662921348314607,1.75901098787509,855,419,436,2,1,99.69,8.1,0,0,0,0,0,0,0.000139416912944109,0.00191813779828508,0.00191813779828508
8.7,"greedy_SVM","SVM",57,39,0,0,0,3912,3484,428,0.942290921499986,0.662921348314607,1.75416967322956,855,419,436,0,1,100,8.1,0,0,0,0,0,0,0,0,0
8.7,"greedy_SVM","SVM",58,0,3812,3412,400,100,90,10,0.874426020408169,0.51530612244898,1.73838051349572,29,10,19,0,1.9,2.56,9,0,0,0,0,0,0,0.255380503038351,376.151040832649,28.927346195351
8.7,"greedy_SVM","SVM",58,1,3712,3361,351,200,141,59,0.898718692022255,0.561224489795918,1.75193202280912,109,53,56,80,1.1,5.11,2.4,0,0,0,0,0,0,0.70646516251124,538.825858719199,77.5333918136071
8.7,"greedy_SVM","SVM",58,2,3612,3331,281,300,171,129,0.90527162569573,0.556122448979592,1.73358718487395,167,83,84,58,1,7.67,1.3,0,0,0,0,0,0,0.646000577604667,318.969447643151,72.064693849922
8.7,"greedy_SVM","SVM",58,3,3512,3301,211,400,201,199,0.905420918367344,0.556122448979592,1.75515841695794,226,116,110,59,0.9,10.22,1,0,0,0,0,0,0,0.463843160896055,267.867746030695,56.5859784699127
8.7,"greedy_SVM","SVM",58,4,3412,3248,164,500,254,246,0.874653583024131,0.591836734693878,1.68772509003601,320,162,158,94,1,12.78,1,0,0,0,0,0,0,0.298386999429305,183.016544092299,40.5740760307965
8.7,"greedy_SVM","SVM",58,5,3312,3188,124,600,314,286,0.87792642625232,0.622448979591837,1.6296948137053,395,197,198,75,1,15.34,1.1,0,0,0,0,0,0,0.22655211069217,151.593055445738,32.6776245837418
8.7,"greedy_SVM","SVM",58,6,3212,3108,104,700,394,306,0.903780148422996,0.61734693877551,1.66020783313325,445,214,231,50,1.1,17.89,1.3,0,0,0,0,0,0,0.112381360215045,85.1667731575788,16.9011639866138
8.7,"greedy_SVM","SVM",58,7,3112,3031,81,800,471,329,0.899408627087194,0.637755102040816,1.63720492805417,507,241,266,62,1.1,20.45,1.4,0,0,0,0,0,0,0.0924565133204923,105.320690740457,12.6710194341257
8.7,"greedy_SVM","SVM",58,8,3012,2947,65,900,555,345,0.898043251391461,0.637755102040816,1.6235181572629,538,257,281,31,1.1,23.01,1.6,0,0,0,0,0,0,0.0692055333877027,102.231867284156,9.55011992793422
8.7,"greedy_SVM","SVM",58,9,2912,2859,53,1000,643,357,0.910404104823745,0.647959183673469,1.64800599138738,575,273,302,37,1.1,25.56,1.8,0,0,0,0,0,0,0.0763390820939836,120.533645347789,8.33670761339711
8.7,"greedy_SVM","SVM",58,10,2812,2762,50,1100,740,360,0.924410076530607,0.647959183673469,1.69982058757569,588,286,302,13,1.1,28.12,2.1,0,0,0,0,0,0,0.0634733830815668,88.0729094455591,7.28812986359781
8.7,"greedy_SVM","SVM",58,11,2712,2672,40,1200,830,370,0.93736375231909,0.647959183673469,1.76597385497978,618,299,319,30,1.1,30.67,2.2,0,0,0,0,0,0,0.0862020829692557,92.4666033393787,9.9413150284738
8.7,"greedy_SVM","SVM",58,12,2612,2575,37,1300,927,373,0.938198631725402,0.647959183673469,1.76217861343989,638,307,331,20,1.1,33.23,2.5,0,0,0,0,0,0,0.0701869809092027,67.2542785869956,7.60684719369802
8.7,"greedy_SVM","SVM",58,13,2512,2478,34,1400,1024,376,0.939285714285701,0.647959183673469,1.78272635020859,644,310,334,6,1.1,35.79,2.7,0,0,0,0,0,0,0.0587253638527011,51.9973484142114,6.27499941691868
8.7,"greedy_SVM","SVM",58,14,2412,2381,31,1500,1121,379,0.938213126159539,0.647959183673469,1.76865126215776,655,314,341,11,1.1,38.34,3,0,0,0,0,0,0,0.0546811564458885,45.3787521055194,6.00254605600809
8.7,"greedy_SVM","SVM",58,15,2312,2287,25,1600,1215,385,0.939627782931336,0.647959183673469,1.7719054503126,676,320,356,21,1.1,40.9,3.2,0,0,0,0,0,0,0.0466239376699423,39.7366492693888,5.50214264371368
8.7,"greedy_SVM","SVM",58,16,2212,2194,18,1700,1308,392,0.939764030612224,0.647959183673469,1.76865126215776,693,328,365,17,1.1,43.46,3.3,0,0,0,0,0,0,0.038491259192106,35.9698036099367,4.74771155797629
8.7,"greedy_SVM","SVM",58,17,2112,2096,16,1800,1406,394,0.939537917439681,0.642857142857143,1.77517163547447,698,330,368,5,1.1,46.01,3.6,0,0,0,0,0,0,0.0320962611832136,31.7968094625844,3.53348117699454
8.7,"greedy_SVM","SVM",58,18,2012,1996,16,1900,1506,394,0.939097286641908,0.647959183673469,1.7719054503126,699,333,366,1,1.1,48.57,3.8,0,0,0,0,0,0,0.0254839692251911,25.1429080338954,2.76532368190851
8.7,"greedy_SVM","SVM",58,19,1912,1899,13,2000,1603,397,0.938213126159537,0.63265306122449,1.7719054503126,708,338,370,9,1.1,51.12,4,0,0,0,0,0,0,0.0227190511605051,22.8032437685964,2.47778001081103
8.7,"greedy_SVM","SVM",58,20,1812,1799,13,2100,1703,397,0.938416048237462,0.63265306122449,1.78436941596915,711,341,370,3,1.1,53.68,4.3,0,0,0,0,0,0,0.018440303261228,17.9297485707966,1.96759057151086
8.7,"greedy_SVM","SVM",58,21,1712,1701,11,2200,1801,399,0.938160946196648,0.627551020408163,1.78108630756811,718,345,373,7,1.1,56.24,4.5,0,0,0,0,0,0,0.0149013669776865,13.038854366596,1.5656447177141
8.7,"greedy_SVM","SVM",58,22,1612,1602,10,2300,1900,400,0.937536236085332,0.63265306122449,1.77944927971188,729,354,375,11,1.1,58.79,4.8,0,0,0,0,0,0,0.0108980423579399,8.97695754479053,1.36320380737265
8.7,"greedy_SVM","SVM",58,23,1512,1504,8,2400,1998,402,0.937963821892382,0.63265306122449,1.78108630756811,738,356,382,9,1.1,61.35,5,0,0,0,0,0,0,0.0111135551237678,8.43632784281336,1.13733955043174
8.7,"greedy_SVM","SVM",58,24,1412,1405,7,2500,2097,403,0.936960807050085,0.622448979591837,1.78108630756811,753,368,385,15,1,63.91,5.2,0,0,0,0,0,0,0.00803550463399881,5.16455744990673,1.00869219834189
8.7,"greedy_SVM","SVM",58,25,1312,1305,7,2600,2197,403,0.937111549165113,0.622448979591837,1.78108630756811,752,367,385,-1,1,66.46,5.5,0,0,0,0,0,0,0.00633161273910753,4.40954127526634,0.721997450761265
8.7,"greedy_SVM","SVM",58,26,1212,1206,6,2700,2296,404,0.937234751855281,0.622448979591837,1.77944927971188,756,370,386,4,1,69.02,5.7,0,0,0,0,0,0,0.00609521845637663,3.75798585796448,0.62070194871718
8.7,"greedy_SVM","SVM",58,27,1112,1106,6,2800,2396,404,0.937398538961035,0.61734693877551,1.78108630756811,759,372,387,3,1,71.57,5.9,0,0,0,0,0,0,0.0050297485345684,2.9620079858414,0.569492541813997
8.7,"greedy_SVM","SVM",58,28,1012,1006,6,2900,2496,404,0.937407235621517,0.61734693877551,1.78436941596915,760,372,388,1,1,74.13,6.2,0,0,0,0,0,0,0.00426846560126605,2.10009847679403,0.443021713907166
8.7,"greedy_SVM","SVM",58,29,912,906,6,3000,2596,404,0.937305774582556,0.607142857142857,1.78272635020859,766,376,390,6,1,76.69,6.4,0,0,0,0,0,0,0.0030919373930766,1.34583951201832,0.342315941820162
8.7,"greedy_SVM","SVM",58,30,812,810,2,3100,2692,408,0.937643494897956,0.612244897959184,1.77618423516195,785,382,403,19,1.1,79.24,6.6,0,0,0,0,0,0,0.00367720224740292,1.55479000655881,0.436635677470561
8.7,"greedy_SVM","SVM",58,31,712,710,2,3200,2792,408,0.937711618738402,0.612244897959184,1.77293115048217,783,382,401,-2,1,81.8,6.8,0,0,0,0,0,0,0.00298868344054387,1.05636447051079,0.32753726583346
8.7,"greedy_SVM","SVM",58,32,612,610,2,3300,2892,408,0.937784090909089,0.612244897959184,1.77455620194916,785,382,403,2,1.1,84.36,7.1,0,0,0,0,0,0,0.0018982593735786,0.622090138084114,0.226207429149418
8.7,"greedy_SVM","SVM",58,33,512,510,2,3400,2992,408,0.938008754638218,0.612244897959184,1.77944927971188,784,383,401,-1,1,86.91,7.3,0,0,0,0,0,0,0.00141214975085507,0.456114521634635,0.181166365453649
8.7,"greedy_SVM","SVM",58,34,412,412,0,3500,3090,410,0.938363868274581,0.61734693877551,1.78108630756811,792,386,406,8,1.1,89.47,7.5,0,0,0,0,0,0,0.00133343830244089,0.388089063018788,0.161140602279986
8.7,"greedy_SVM","SVM",58,35,312,312,0,3600,3190,410,0.938314587198514,0.61734693877551,1.77781525833474,798,389,409,6,1.1,92.02,7.8,0,0,0,0,0,0,0.000970770768164588,0.247186610510299,0.119843984239087
8.7,"greedy_SVM","SVM",58,36,212,212,0,3700,3290,410,0.938389958256028,0.612244897959184,1.78436941596915,801,392,409,3,1,94.58,8,0,0,0,0,0,0,0.000495389622030056,0.101118677146048,0.0618916196964911
8.7,"greedy_SVM","SVM",58,37,112,112,0,3800,3390,410,0.938501565398885,0.612244897959184,1.78272635020859,804,393,411,3,1,97.14,8.3,0,0,0,0,0,0,0.000216008861643275,0.0360303826089892,0.0336972377699363
8.7,"greedy_SVM","SVM",58,38,12,12,0,3900,3490,410,0.938607374768087,0.61734693877551,1.78108630756811,804,393,411,0,1,99.69,8.5,0,0,0,0,0,0,0.000180067606435636,0.00250607484658592,0.00250607484658592
8.7,"greedy_SVM","SVM",58,39,0,0,0,3912,3502,410,0.938618970315397,0.61734693877551,1.78108630756811,805,394,411,1,1,100,8.5,0,0,0,0,0,0,0,0,0
8.7,"greedy_SVM","SVM",59,0,3812,3427,385,100,92,8,0.896196455843497,0.596244131455399,1.72659180891802,26,8,18,0,2.2,2.56,11.5,0,0,0,0,0,0,0.24232533131299,310.053811828802,31.3101250628722
8.7,"greedy_SVM","SVM",59,1,3712,3388,324,200,131,69,0.905326200846317,0.596244131455399,1.72709652409872,101,50,51,75,1,5.11,1.9,0,0,0,0,0,0,0.780216368564798,502.408867119274,84.354874652651
8.7,"greedy_SVM","SVM",59,2,3612,3348,264,300,171,129,0.919786456355287,0.629107981220657,1.75720745818055,177,88,89,76,1,7.67,1.3,0,0,0,0,0,0,0.510133687393139,305.84312535318,62.8885633373724
8.7,"greedy_SVM","SVM",59,3,3512,3316,196,400,203,197,0.924327760404458,0.657276995305164,1.76403272576636,246,125,121,69,1,10.22,1,0,0,0,0,0,0,0.442796444044793,280.007279502316,56.8585407222107
8.7,"greedy_SVM","SVM",59,4,3412,3266,146,500,253,247,0.900044174013303,0.657276995305164,1.69117837781755,342,173,169,96,1,12.78,1,0,0,0,0,0,0,0.301451887473559,256.33511850749,39.2945731921721
8.7,"greedy_SVM","SVM",59,5,3312,3214,98,600,305,295,0.894612655854808,0.657276995305164,1.64738199204426,435,219,216,93,1,15.34,1,0,0,0,0,0,0,0.313123289384398,335.475867726402,40.7852806220621
8.7,"greedy_SVM","SVM",59,6,3212,3125,87,700,394,306,0.895576942242479,0.657276995305164,1.62898715824358,478,234,244,43,1,17.89,1.3,0,0,0,0,0,0,0.138012150970194,130.006094180304,19.1591329032187
8.7,"greedy_SVM","SVM",59,7,3112,3040,72,800,479,321,0.893220097021208,0.68075117370892,1.60810021418836,520,248,272,42,1.1,20.45,1.5,0,0,0,0,0,0,0.0783092717916799,99.4277703662134,10.4020809001651
8.7,"greedy_SVM","SVM",59,8,3012,2959,53,900,560,340,0.905899924311599,0.68075117370892,1.64889891837211,568,271,297,48,1.1,23.01,1.6,0,0,0,0,0,0,0.0747469778497524,118.485762894699,8.7407671322212
8.7,"greedy_SVM","SVM",59,9,2912,2864,48,1000,655,345,0.906353785362792,0.685446009389671,1.65041864087752,580,275,305,12,1.1,25.56,1.9,0,0,0,0,0,0,0.0612116089794056,101.805541519251,6.50336789582429
8.7,"greedy_SVM","SVM",59,10,2812,2772,40,1100,747,353,0.916462631208947,0.671361502347418,1.68962255594283,610,292,318,30,1.1,28.12,2.1,0,0,0,0,0,0,0.0562611722707409,80.5714251216286,6.15275717130511
8.7,"greedy_SVM","SVM",59,11,2712,2679,33,1200,840,360,0.919228894114354,0.666666666666667,1.69963426970664,628,299,329,18,1.1,30.67,2.3,0,0,0,0,0,0,0.0663404069046333,87.5379670405811,7.94914520763314
8.7,"greedy_SVM","SVM",59,12,2612,2583,29,1300,936,364,0.924430114825504,0.671361502347418,1.72341500706169,644,307,337,16,1.1,33.23,2.6,0,0,0,0,0,0,0.0568855190619309,64.6701213439534,6.27563352012803
8.7,"greedy_SVM","SVM",59,13,2512,2485,27,1400,1034,366,0.926113575697833,0.666666666666667,1.73711506874119,647,312,335,3,1.1,35.79,2.8,0,0,0,0,0,0,0.0477573162432382,54.0481051731372,5.14306714477202
8.7,"greedy_SVM","SVM",59,14,2412,2388,24,1500,1131,369,0.926770798822391,0.666666666666667,1.73711506874119,663,318,345,16,1.1,38.34,3.1,0,0,0,0,0,0,0.0430882560707728,42.9460987379591,4.84413907607425
8.7,"greedy_SVM","SVM",59,15,2312,2295,17,1600,1224,376,0.926135123996997,0.657276995305164,1.72659180891802,688,326,362,25,1.1,40.9,3.3,0,0,0,0,0,0,0.0447682171917469,40.5101070623484,5.58939331043841
8.7,"greedy_SVM","SVM",59,16,2212,2202,10,1700,1317,383,0.926124349847415,0.647887323943662,1.72341500706169,704,334,370,16,1.1,43.46,3.4,0,0,0,0,0,0,0.0368576665920756,37.6118926043871,4.70234244334982
8.7,"greedy_SVM","SVM",59,17,2112,2106,6,1800,1413,387,0.92622131719366,0.652582159624413,1.72659180891802,714,338,376,10,1.1,46.01,3.7,0,0,0,0,0,0,0.0306553031620674,34.0275605445121,3.4251301255508
8.7,"greedy_SVM","SVM",59,18,2012,2006,6,1900,1513,387,0.926412558348753,0.647887323943662,1.72183098591549,712,341,371,-2,1.1,48.57,3.9,0,0,0,0,0,0,0.0238935512664684,25.5609656214451,2.54027214955382
8.7,"greedy_SVM","SVM",59,19,1912,1906,6,2000,1613,387,0.926762718210195,0.647887323943662,1.7318631198414,716,343,373,4,1.1,51.12,4.2,0,0,0,0,0,0,0.0196053583493522,19.92443983384,2.05124088441704
8.7,"greedy_SVM","SVM",59,20,1812,1806,6,2100,1713,387,0.927336441675476,0.647887323943662,1.75720745818055,722,348,374,6,1.1,53.68,4.4,0,0,0,0,0,0,0.0145679108471855,13.1506718864088,1.75278523826157
8.7,"greedy_SVM","SVM",59,21,1712,1707,5,2200,1812,388,0.927294691845842,0.647887323943662,1.75882551293025,725,351,374,3,1.1,56.24,4.7,0,0,0,0,0,0,0.0124173619972372,10.7632216001264,1.26867760424055
8.7,"greedy_SVM","SVM",59,22,1612,1608,4,2300,1911,389,0.927118265146423,0.652582159624413,1.75918203999432,752,364,388,27,1.1,58.79,4.9,0,0,0,0,0,0,0.00945881375795513,7.26159971193661,1.22417989489285
8.7,"greedy_SVM","SVM",59,23,1512,1509,3,2400,2010,390,0.926838137257266,0.647887323943662,1.76565557096026,759,364,395,7,1.1,61.35,5.2,0,0,0,0,0,0,0.00858290935608489,6.54950250283111,0.898551495085849
8.7,"greedy_SVM","SVM",59,24,1412,1409,3,2500,2110,390,0.92669807331269,0.647887323943662,1.76891023560719,750,366,384,-9,1,63.91,5.4,0,0,0,0,0,0,0.00594416578864661,4.14895753755969,0.67273361272233
8.7,"greedy_SVM","SVM",59,25,1312,1309,3,2600,2210,390,0.926689992700503,0.647887323943662,1.76403272576636,754,366,388,4,1.1,66.46,5.7,0,0,0,0,0,0,0.00542354587806331,3.50156831035855,0.556845193810389
8.7,"greedy_SVM","SVM",59,26,1212,1210,2,2700,2309,391,0.92706574116721,0.647887323943662,1.76403272576636,761,371,390,7,1.1,69.02,5.9,0,0,0,0,0,0,0.00452729811723715,2.6559635919534,0.505384555063008
8.7,"greedy_SVM","SVM",59,27,1112,1110,2,2800,2409,391,0.927170789125644,0.643192488262911,1.76403272576636,762,371,391,1,1.1,71.57,6.2,0,0,0,0,0,0,0.00365237136479285,1.94064299769118,0.37789377471917
8.7,"greedy_SVM","SVM",59,28,1012,1010,2,2900,2509,391,0.927394352729494,0.643192488262911,1.76079596847138,759,371,388,-3,1,74.13,6.4,0,0,0,0,0,0,0.00274872760394173,1.32807232632615,0.301550423068475
8.7,"greedy_SVM","SVM",59,29,912,911,1,3000,2608,392,0.928152583506391,0.643192488262911,1.76565557096026,767,373,394,8,1.1,76.69,6.7,0,0,0,0,0,0,0.00312208696739857,1.30585549368045,0.325783197283999
8.7,"greedy_SVM","SVM",59,30,812,811,1,3100,2708,392,0.928850209691892,0.63849765258216,1.76728140481934,768,374,394,1,1.1,79.24,6.9,0,0,0,0,0,0,0.00241540844326358,0.855713735710832,0.263294352265271
8.7,"greedy_SVM","SVM",59,31,712,712,0,3200,2807,393,0.928983539792982,0.643192488262911,1.76728140481934,777,379,398,9,1.1,81.8,7.1,0,0,0,0,0,0,0.00211996225831117,0.700886399434845,0.243138940654268
8.7,"greedy_SVM","SVM",59,32,612,612,0,3300,2907,393,0.929081853907927,0.643192488262911,1.76565557096026,775,379,396,-2,1,84.36,7.4,0,0,0,0,0,0,0.00130745429799303,0.413460946785141,0.165333687883293
8.7,"greedy_SVM","SVM",59,33,512,512,0,3400,3007,393,0.929372755946667,0.643192488262911,1.76565557096026,776,379,397,1,1,86.91,7.7,0,0,0,0,0,0,0.000782563198678831,0.242715012719768,0.10284324303849
8.7,"greedy_SVM","SVM",59,34,412,412,0,3500,3107,393,0.929642109686241,0.647887323943662,1.76241286100441,779,380,399,3,1.1,89.47,7.9,0,0,0,0,0,0,0.000430902450169474,0.126216651825177,0.0560336962806575
8.7,"greedy_SVM","SVM",59,35,312,312,0,3600,3207,393,0.929747157644676,0.643192488262911,1.75596304266588,779,381,398,0,1,92.02,8.2,0,0,0,0,0,0,0.000279283291660183,0.0721536518881381,0.0351506511427664
8.7,"greedy_SVM","SVM",59,36,212,212,0,3700,3307,393,0.930013817846853,0.63849765258216,1.75275580423178,781,382,399,2,1,94.58,8.4,0,0,0,0,0,0,0.000169407067796138,0.0362694655860901,0.0228838389224926
8.7,"greedy_SVM","SVM",59,37,112,112,0,3800,3407,393,0.93007846274435,0.633802816901408,1.76891023560719,785,383,402,4,1,97.14,8.7,0,0,0,0,0,0,6.67537659591142e-05,0.0110902717017591,0.0104182526208953
8.7,"greedy_SVM","SVM",59,38,12,12,0,3900,3507,393,0.930385526007462,0.633802816901408,1.76241286100441,788,385,403,3,1,99.69,8.9,0,0,0,0,0,0,6.30449555932066e-05,0.000837517675366974,0.000837517675366974
8.7,"greedy_SVM","SVM",59,39,0,0,0,3912,3519,393,0.930478453047615,0.633802816901408,1.76079596847138,788,386,402,0,1,100,9,0,0,0,0,0,0,0,0,0
8.7,"greedy_SVM","SVM",60,0,3812,3426,386,100,90,10,0.931879670539454,0.60952380952381,1.7770111915734,28,10,18,0,1.8,2.56,9,0,0,0,0,0,0,0.212360420462179,380.401072589846,22.8462713152514
8.7,"greedy_SVM","SVM",60,1,3712,3395,317,200,121,79,0.940716194839907,0.628571428571429,1.78759018759019,97,49,48,69,1,5.11,1.5,0,0,0,0,0,0,0.624133234983766,312.923418234705,69.6487717205954
8.7,"greedy_SVM","SVM",60,2,3612,3367,245,300,149,151,0.938444335351546,0.614285714285714,1.78231042186884,157,80,77,60,1,7.67,1,0,0,0,0,0,0,0.508100200243344,253.38915009924,59.0183171875558
8.7,"greedy_SVM","SVM",60,3,3512,3313,199,400,203,197,0.923186330660544,0.638095238095238,1.76355042016807,247,125,122,90,1,10.22,1,0,0,0,0,0,0,0.286912278872821,153.540783008197,40.7829326065662
8.7,"greedy_SVM","SVM",60,4,3412,3254,158,500,262,238,0.900545464462993,0.642857142857143,1.70205955660501,342,172,170,95,1,12.78,1.1,0,0,0,0,0,0,0.184578828068046,117.746654067006,26.5316765097136
8.7,"greedy_SVM","SVM",60,5,3312,3181,131,600,335,265,0.901575028636895,0.676190476190476,1.672454617206,413,204,209,71,1,15.34,1.3,0,0,0,0,0,0,0.104182174038067,70.508747554552,14.1028186300669
8.7,"greedy_SVM","SVM",60,6,3212,3104,108,700,412,288,0.895058091965318,0.69047619047619,1.63107307439105,468,224,244,55,1.1,17.89,1.4,0,0,0,0,0,0,0.0757933267002197,69.1666445560265,11.9262315134516
8.7,"greedy_SVM","SVM",60,7,3112,3023,89,800,493,307,0.898562701140016,0.685714285714286,1.64824226464779,516,249,267,48,1.1,20.45,1.6,0,0,0,0,0,0,0.0610424018439941,68.7919151961304,8.05572318628106
8.7,"greedy_SVM","SVM",60,8,3012,2943,69,900,573,327,0.894179894179895,0.685714285714286,1.62807201997634,559,267,292,43,1.1,23.01,1.8,0,0,0,0,0,0,0.0734397779389482,109.120043644432,8.96413458814912
8.7,"greedy_SVM","SVM",60,9,2912,2844,68,1000,672,328,0.904731904216442,0.685714285714286,1.62957116548277,567,272,295,8,1.1,25.56,2,0,0,0,0,0,0,0.0550233531943559,70.8939106627032,6.34314416104116
8.7,"greedy_SVM","SVM",60,10,2812,2751,61,1100,765,335,0.909495172639504,0.695238095238095,1.65225840336134,589,279,310,22,1.1,28.12,2.3,0,0,0,0,0,0,0.0535056060314937,80.9236303932532,5.83076416850138
8.7,"greedy_SVM","SVM",60,11,2712,2657,55,1200,859,341,0.926918671248574,0.69047619047619,1.69662242081745,608,290,318,19,1.1,30.67,2.5,0,0,0,0,0,0,0.0422958076384884,56.0229672535989,4.90770665047542
8.7,"greedy_SVM","SVM",60,12,2612,2563,49,1300,953,347,0.934365624829536,0.69047619047619,1.74106813996317,625,297,328,17,1.1,33.23,2.7,0,0,0,0,0,0,0.0471495742365254,58.3489242701723,5.67200172889152
8.7,"greedy_SVM","SVM",60,13,2512,2467,45,1400,1049,351,0.941478481426933,0.69047619047619,1.76679821099711,647,308,339,22,1.1,35.79,3,0,0,0,0,0,0,0.0589023446816987,55.7248417648483,6.45672664476705
8.7,"greedy_SVM","SVM",60,14,2412,2371,41,1500,1145,355,0.942818960344729,0.69047619047619,1.77537490134175,661,316,345,14,1.1,38.34,3.2,0,0,0,0,0,0,0.054362363419936,44.6828224368115,5.8602909476544
8.7,"greedy_SVM","SVM",60,15,2312,2279,33,1600,1237,363,0.943316696667207,0.676190476190476,1.77537490134175,679,326,353,18,1.1,40.9,3.4,0,0,0,0,0,0,0.0591304839415375,43.8449011230511,6.33102299782009
8.7,"greedy_SVM","SVM",60,16,2212,2186,26,1700,1330,370,0.942645775377729,0.676190476190476,1.76355042016807,692,333,359,13,1.1,43.46,3.6,0,0,0,0,0,0,0.0506104817452032,37.0317976803514,5.7776833241109
8.7,"greedy_SVM","SVM",60,17,2112,2091,21,1800,1425,375,0.942769868543059,0.676190476190476,1.76517282165856,712,339,373,20,1.1,46.01,3.8,0,0,0,0,0,0,0.0414056798483496,32.7230672969061,4.99010769597401
8.7,"greedy_SVM","SVM",60,18,2012,1994,18,1900,1522,378,0.94250395461735,0.676190476190476,1.76355042016807,721,343,378,9,1.1,48.57,4,0,0,0,0,0,0,0.0306457987562627,28.3589742109434,3.59517564851454
8.7,"greedy_SVM","SVM",60,19,1912,1896,16,2000,1620,380,0.943018054873721,0.671428571428571,1.76355042016807,735,344,391,14,1.1,51.12,4.3,0,0,0,0,0,0,0.0243496218316419,23.5799382925697,2.67748622286362
8.7,"greedy_SVM","SVM",60,20,1812,1797,15,2100,1719,381,0.944533082419675,0.671428571428571,1.77211134453782,736,346,390,1,1.1,53.68,4.5,0,0,0,0,0,0,0.0218375718596073,19.7458524719785,2.23197971537216
8.7,"greedy_SVM","SVM",60,21,1712,1698,14,2200,1818,382,0.944965363006588,0.661904761904762,1.79087922197398,757,359,398,21,1.1,56.24,4.8,0,0,0,0,0,0,0.0133212049164409,9.28606086819498,1.72766089089709
8.7,"greedy_SVM","SVM",60,22,1612,1602,10,2300,1914,386,0.944687176130462,0.652380952380952,1.79418038183015,764,362,402,7,1.1,58.79,5,0,0,0,0,0,0,0.0106029794354324,8.83480083928337,1.24587982730793
8.7,"greedy_SVM","SVM",60,23,1512,1503,9,2400,2013,387,0.944496263568414,0.652380952380952,1.78759018759019,768,363,405,4,1.1,61.35,5.2,0,0,0,0,0,0,0.0108169301121257,8.2262645192099,1.09866249877348
8.7,"greedy_SVM","SVM",60,24,1412,1403,9,2500,2113,387,0.944938089783452,0.647619047619048,1.78759018759019,773,373,400,5,1.1,63.91,5.5,0,0,0,0,0,0,0.00743443851763637,5.11073250742094,0.914922518922085
8.7,"greedy_SVM","SVM",60,25,1312,1304,8,2600,2212,388,0.944869906725578,0.647619047619048,1.79087922197398,774,372,402,1,1.1,66.46,5.7,0,0,0,0,0,0,0.00630730738694557,4.14522383275381,0.66710688915145
8.7,"greedy_SVM","SVM",60,26,1212,1205,7,2700,2311,389,0.945499918180331,0.647619047619048,1.78104822898967,781,377,404,7,1.1,69.02,5.9,0,0,0,0,0,0,0.00514337527969184,2.96348017075444,0.54037317203654
8.7,"greedy_SVM","SVM",60,27,1112,1105,7,2800,2411,389,0.945737195221732,0.647619047619048,1.78431321199424,783,380,403,2,1.1,71.57,6.2,0,0,0,0,0,0,0.00470746772902864,2.39637817312272,0.48962259720126
8.7,"greedy_SVM","SVM",60,28,1012,1006,6,2900,2510,390,0.945888561610212,0.642857142857143,1.7859501965924,790,385,405,7,1.1,74.13,6.4,0,0,0,0,0,0,0.00400465970135346,1.78533980962198,0.419421529415634
8.7,"greedy_SVM","SVM",60,29,912,906,6,3000,2610,390,0.945922653139148,0.642857142857143,1.78923319327731,790,385,405,0,1.1,76.69,6.7,0,0,0,0,0,0,0.00328893747278901,1.26027177281931,0.352112830025841
8.7,"greedy_SVM","SVM",60,30,812,806,6,3100,2710,390,0.945907652866416,0.642857142857143,1.79252828203104,792,385,407,2,1.1,79.24,6.9,0,0,0,0,0,0,0.00243890567009324,0.78018452570743,0.268585711861596
8.7,"greedy_SVM","SVM",60,31,712,708,4,3200,2808,392,0.946549937271585,0.647619047619048,1.79087922197398,800,387,413,8,1.1,81.8,7.2,0,0,0,0,0,0,0.00205778998154966,0.601074122119237,0.244943978210993
8.7,"greedy_SVM","SVM",60,32,612,609,3,3300,2907,393,0.946661757486499,0.647619047619048,1.80276497695853,806,389,417,6,1.1,84.36,7.4,0,0,0,0,0,0,0.0011552031129468,0.353141863739773,0.158407612019004
8.7,"greedy_SVM","SVM",60,33,512,509,3,3400,3007,393,0.94684994272623,0.647619047619048,1.79944802207912,804,389,415,-2,1.1,86.91,7.7,0,0,0,0,0,0,0.000673373714324647,0.19626436438302,0.0911871337113471
8.7,"greedy_SVM","SVM",60,34,412,411,1,3500,3105,395,0.946781759668355,0.652380952380952,1.79944802207912,810,392,418,6,1.1,89.47,7.9,0,0,0,0,0,0,0.000539254120197709,0.160414971745839,0.0736636551166745
8.7,"greedy_SVM","SVM",60,35,312,312,0,3600,3204,396,0.947148584519717,0.652380952380952,1.80110497237569,817,396,421,7,1.1,92.02,8.1,0,0,0,0,0,0,0.000363720624300448,0.0889560056797326,0.0466310146651655
8.7,"greedy_SVM","SVM",60,36,212,212,0,3700,3304,396,0.947220858561063,0.652380952380952,1.79614325068871,818,396,422,1,1.1,94.58,8.3,0,0,0,0,0,0,0.000148907712941132,0.0326099262135776,0.0214295928061616
8.7,"greedy_SVM","SVM",60,37,112,112,0,3800,3404,396,0.947358588337968,0.652380952380952,1.80110497237569,817,396,421,-1,1.1,97.14,8.6,0,0,0,0,0,0,4.88732919180382e-05,0.00881956023411325,0.00829495757590446
8.7,"greedy_SVM","SVM",60,38,12,12,0,3900,3504,396,0.947572683139692,0.652380952380952,1.80110497237569,816,396,420,-1,1.1,99.69,8.8,0,0,0,0,0,0,4.92782901006272e-05,0.000662215046370003,0.000662215046370003
8.7,"greedy_SVM","SVM",60,39,0,0,0,3912,3516,396,0.947621774941361,0.652380952380952,1.79944802207912,816,396,420,0,1.1,100,8.9,0,0,0,0,0,0,0,0,0
8.7,"greedy_SVM","SVM",61,0,3812,3410,402,100,91,9,0.905974169687957,0.58974358974359,1.73450629882469,25,9,16,0,1.8,2.56,10.1,0,0,0,0,0,0,0.482083110021826,330.356507242472,53.337716595223
8.7,"greedy_SVM","SVM",61,1,3712,3377,335,200,124,76,0.904509384236795,0.58974358974359,1.725624513481,89,46,43,64,0.9,5.11,1.6,0,0,0,0,0,0,0.785160718877025,334.577787325045,85.0314328156868
8.7,"greedy_SVM","SVM",61,2,3612,3349,263,300,152,148,0.89991118100144,0.57948717948718,1.71797705057374,141,73,68,52,0.9,7.67,1,0,0,0,0,0,0,0.451668912038565,153.508416422211,59.0392317156026
8.7,"greedy_SVM","SVM",61,3,3512,3299,213,400,202,198,0.880382649718234,0.564102564102564,1.71956043956044,235,121,114,94,0.9,10.22,1,0,0,0,0,0,0,0.238082621487899,80.184203212657,38.8021766788597
8.7,"greedy_SVM","SVM",61,4,3412,3243,169,500,258,242,0.880767046695494,0.6,1.69026774330642,316,158,158,81,1,12.78,1.1,0,0,0,0,0,0,0.12300935070299,53.3744067780279,20.5019821254622
8.7,"greedy_SVM","SVM",61,5,3312,3180,132,600,321,279,0.881646500385852,0.6,1.69182559376108,397,196,201,81,1,15.34,1.2,0,0,0,0,0,0,0.0926475011654104,51.4189316042797,17.8620111607831
8.7,"greedy_SVM","SVM",61,6,3212,3104,108,700,397,303,0.896643806694923,0.615384615384615,1.68258064516129,452,218,234,55,1.1,17.89,1.3,0,0,0,0,0,0,0.0689745252150638,49.5805365398877,10.4889263219198
8.7,"greedy_SVM","SVM",61,7,3112,3030,82,800,471,329,0.90317273111141,0.646153846153846,1.6733356965615,512,245,267,60,1.1,20.45,1.4,0,0,0,0,0,0,0.061909849270746,62.1020821585924,8.73397695260468
8.7,"greedy_SVM","SVM",61,8,3012,2942,70,900,559,341,0.905540267039413,0.656410256410256,1.67025688203241,544,263,281,32,1.1,23.01,1.6,0,0,0,0,0,0,0.0524773341482446,62.2424064524235,6.62955820619233
8.7,"greedy_SVM","SVM",61,9,2912,2856,56,1000,645,355,0.917581793561339,0.666666666666667,1.70874061481796,574,278,296,30,1.1,25.56,1.8,0,0,0,0,0,0,0.0602355617287941,92.95197277364,6.93364699391914
8.7,"greedy_SVM","SVM",61,10,2812,2763,49,1100,738,362,0.92445580162785,0.676923076923077,1.72087508821454,598,290,308,24,1.1,28.12,2,0,0,0,0,0,0,0.0491889433675292,73.3829661519295,5.56471686073083
8.7,"greedy_SVM","SVM",61,11,2712,2669,43,1200,832,368,0.933449817265818,0.671794871794872,1.71481900452489,631,303,328,33,1.1,30.67,2.3,0,0,0,0,0,0,0.0619628731187533,73.1118841431758,7.05712946940451
8.7,"greedy_SVM","SVM",61,12,2612,2570,42,1300,931,369,0.934617568689105,0.671794871794872,1.72721348632951,638,310,328,7,1.1,33.23,2.5,0,0,0,0,0,0,0.0453740070236508,48.3122554901028,4.96017752491521
8.7,"greedy_SVM","SVM",61,13,2512,2477,35,1400,1024,376,0.941396933560474,0.656410256410256,1.7641592293526,659,319,340,21,1.1,35.79,2.7,0,0,0,0,0,0,0.0520585699894693,49.4163065950356,5.77668241236551
8.7,"greedy_SVM","SVM",61,14,2412,2379,33,1500,1122,378,0.943265044627902,0.661538461538462,1.77935520361991,664,323,341,5,1.1,38.34,3,0,0,0,0,0,0,0.0456354559697728,39.9753536673961,5.17828915656612
8.7,"greedy_SVM","SVM",61,15,2312,2284,28,1600,1217,383,0.943452874969058,0.656410256410256,1.77772126863036,681,328,353,17,1.1,40.9,3.2,0,0,0,0,0,0,0.0481117611879046,37.2028553604289,5.56470714719523
8.7,"greedy_SVM","SVM",61,16,2212,2191,21,1700,1310,390,0.944434252100349,0.656410256410256,1.78427507975895,707,334,373,26,1.1,43.46,3.4,0,0,0,0,0,0,0.039177191056575,32.3387673167774,4.92669078932567
8.7,"greedy_SVM","SVM",61,17,2112,2094,18,1800,1407,393,0.945236535185426,0.656410256410256,1.78263210086415,713,337,376,6,1.1,46.01,3.6,0,0,0,0,0,0,0.0265249487539299,24.5834202069125,3.13913404022438
8.7,"greedy_SVM","SVM",61,18,2012,1997,15,1900,1504,396,0.945816042749593,0.656410256410256,1.79186853661992,720,340,380,7,1.1,48.57,3.8,0,0,0,0,0,0,0.0243710359238305,23.7437910706201,2.68052706645064
8.7,"greedy_SVM","SVM",61,19,1912,1899,13,2000,1602,398,0.945507360328475,0.656410256410256,1.78529287226535,727,347,380,7,1.1,51.12,4,0,0,0,0,0,0,0.0200184522088748,18.9481305453627,2.15900545275857
8.7,"greedy_SVM","SVM",61,20,1812,1799,13,2100,1702,398,0.945080737925703,0.661538461538462,1.78693225965953,730,349,381,3,1.1,53.68,4.3,0,0,0,0,0,0,0.0168479082159657,15.8962174608137,1.82416022657994
8.7,"greedy_SVM","SVM",61,21,1712,1699,13,2200,1802,398,0.944610434048246,0.661538461538462,1.79186853661992,730,349,381,0,1.1,56.24,4.5,0,0,0,0,0,0,0.0128609996734082,11.5716036424819,1.34465063714416
8.7,"greedy_SVM","SVM",61,22,1612,1599,13,2300,1902,398,0.943748452947775,0.656410256410256,1.80110497237569,737,355,382,7,1.1,58.79,4.8,0,0,0,0,0,0,0.00943440105185185,7.67969999690623,1.181752206527
8.7,"greedy_SVM","SVM",61,23,1512,1503,9,2400,1998,402,0.945118595203777,0.661538461538462,1.79944802207912,750,362,388,13,1.1,61.35,5,0,0,0,0,0,0,0.0101766511260672,8.1481818728027,1.05316908618851
8.7,"greedy_SVM","SVM",61,24,1412,1403,9,2500,2098,402,0.942381222790083,0.641025641025641,1.79944802207912,760,371,389,10,1,63.91,5.2,0,0,0,0,0,0,0.00654352495143753,4.63144852799018,0.849117560715465
8.7,"greedy_SVM","SVM",61,25,1312,1304,8,2600,2197,403,0.942531195853174,0.646153846153846,1.80110497237569,764,372,392,4,1.1,66.46,5.5,0,0,0,0,0,0,0.00648025920951129,4.1742077997471,0.663357177993386
8.7,"greedy_SVM","SVM",61,26,1212,1204,8,2700,2297,403,0.941859957192156,0.641025641025641,1.79614325068871,775,377,398,11,1.1,69.02,5.7,0,0,0,0,0,0,0.00439397615364955,2.69691020503889,0.514451241425503
8.7,"greedy_SVM","SVM",61,27,1112,1106,6,2800,2395,405,0.942270563054209,0.641025641025641,1.79944802207912,784,380,404,9,1.1,71.57,5.9,0,0,0,0,0,0,0.00562074958345521,2.77168510152217,0.577149112669583
8.7,"greedy_SVM","SVM",61,28,1012,1006,6,2900,2495,405,0.941475560214914,0.641025641025641,1.79944802207912,788,384,404,4,1.1,74.13,6.2,0,0,0,0,0,0,0.00371800741311582,1.76718249060161,0.411544205418856
8.7,"greedy_SVM","SVM",61,29,912,907,5,3000,2594,406,0.941471192067446,0.641025641025641,1.79779411764706,794,387,407,6,1.1,76.69,6.4,0,0,0,0,0,0,0.00334697133369689,1.44164126564329,0.364177300926846
8.7,"greedy_SVM","SVM",61,30,812,808,4,3100,2693,407,0.941117372122485,0.635897435897436,1.80110497237569,800,389,411,6,1.1,79.24,6.6,0,0,0,0,0,0,0.00290004272720833,1.17147433098407,0.32047114165101
8.7,"greedy_SVM","SVM",61,31,712,709,3,3200,2792,408,0.941041657566361,0.635897435897436,1.80110497237569,803,390,413,3,1.1,81.8,6.8,0,0,0,0,0,0,0.00269916351900068,1.02677226191785,0.308016933956086
8.7,"greedy_SVM","SVM",61,32,612,609,3,3300,2892,408,0.94099215189505,0.635897435897436,1.79779411764706,802,391,411,-1,1.1,84.36,7.1,0,0,0,0,0,0,0.00203547945792971,0.693281887219318,0.233911494552448
8.7,"greedy_SVM","SVM",61,33,512,509,3,3400,2992,408,0.941006712386612,0.635897435897436,1.80110497237569,804,392,412,2,1.1,86.91,7.3,0,0,0,0,0,0,0.00143364512344626,0.447933962494275,0.170085714022566
8.7,"greedy_SVM","SVM",61,34,412,410,2,3500,3091,409,0.940954294616989,0.635897435897436,1.79779411764706,812,395,417,8,1.1,89.47,7.6,0,0,0,0,0,0,0.00111072686501289,0.326011926278678,0.133312968076935
8.7,"greedy_SVM","SVM",61,35,312,312,0,3600,3189,411,0.94118435038367,0.635897435897436,1.79285059578368,819,399,420,7,1.1,92.02,7.8,0,0,0,0,0,0,0.00120077074515549,0.309229937894136,0.152124358454333
8.7,"greedy_SVM","SVM",61,36,212,212,0,3700,3289,411,0.941040201517205,0.635897435897436,1.79449541284404,823,402,421,4,1,94.58,8,0,0,0,0,0,0,0.000657430054115664,0.134169661617295,0.0819831000065477
8.7,"greedy_SVM","SVM",61,37,112,112,0,3800,3389,411,0.941021272878174,0.635897435897436,1.79944802207912,828,404,424,5,1,97.14,8.2,0,0,0,0,0,0,0.000308243556027372,0.0502828882265096,0.0469997892564895
8.7,"greedy_SVM","SVM",61,38,12,12,0,3900,3489,411,0.941044569664673,0.630769230769231,1.79944802207912,827,405,422,-1,1,99.69,8.5,0,0,0,0,0,0,0.00015776169786583,0.00227063728808454,0.00227063728808454
8.7,"greedy_SVM","SVM",61,39,0,0,0,3912,3501,411,0.941019816829017,0.630769230769231,1.79449541284404,827,405,422,0,1,100,8.5,0,0,0,0,0,0,0,0,0
8.7,"greedy_SVM","SVM",62,0,3812,3410,402,100,89,11,0.778211597635913,0.373056994818653,1.53134430336503,32,11,21,0,1.9,2.56,8.1,0,0,0,0,0,0,0.756770990022506,596.273641008579,87.7684299285339
8.7,"greedy_SVM","SVM",62,1,3712,3333,379,200,166,34,0.869834449639846,0.481865284974093,1.70001671402307,82,34,48,50,1.4,5.11,4.9,0,0,0,0,0,0,0.518957910747576,402.214423079633,62.7312121495743
8.7,"greedy_SVM","SVM",62,2,3612,3303,309,300,196,104,0.923875635912644,0.606217616580311,1.77753036726188,147,74,73,65,1,7.67,1.9,0,0,0,0,0,0,0.712079280158876,327.792545739464,77.9654073537351
8.7,"greedy_SVM","SVM",62,3,3512,3277,235,400,222,178,0.919702344390596,0.616580310880829,1.75121914050594,199,102,97,52,1,10.22,1.2,0,0,0,0,0,0,0.5,218.901135506545,60.424439441004
8.7,"greedy_SVM","SVM",62,4,3412,3223,189,500,276,224,0.901225243123642,0.61139896373057,1.69067596284711,289,148,141,90,1,12.78,1.2,0,0,0,0,0,0,0.35304864095145,169.114876591538,49.9473668112217
8.7,"greedy_SVM","SVM",62,5,3312,3172,140,600,327,273,0.909377856280076,0.632124352331606,1.73418306791044,381,191,190,92,1,15.34,1.2,0,0,0,0,0,0,0.166865294918677,95.7105604827824,26.212507611666
8.7,"greedy_SVM","SVM",62,6,3212,3099,113,700,400,300,0.892769919384945,0.647668393782383,1.66265370931926,451,221,230,70,1,17.89,1.3,0,0,0,0,0,0,0.111112999152661,87.4498664081791,15.1437000741291
8.7,"greedy_SVM","SVM",62,7,3112,3022,90,800,477,323,0.888437925227551,0.642487046632124,1.63463145579141,507,245,262,56,1.1,20.45,1.5,0,0,0,0,0,0,0.0842892985132535,86.1955246166866,10.879110370285
8.7,"greedy_SVM","SVM",62,8,3012,2936,76,900,563,337,0.898968138976499,0.652849740932642,1.63312627028884,545,265,280,38,1.1,23.01,1.7,0,0,0,0,0,0,0.0641740135564254,86.4773441519708,8.28646799923917
8.7,"greedy_SVM","SVM",62,9,2912,2850,62,1000,649,351,0.906377200896975,0.652849740932642,1.65331295814331,588,280,308,43,1.1,25.56,1.8,0,0,0,0,0,0,0.076426073353731,113.484294916102,9.27201116339269
8.7,"greedy_SVM","SVM",62,10,2812,2759,53,1100,740,360,0.913624621244419,0.652849740932642,1.71553593814797,613,293,320,25,1.1,28.12,2.1,0,0,0,0,0,0,0.0705564909226106,85.3478156737465,7.92183836742717
8.7,"greedy_SVM","SVM",62,11,2712,2667,45,1200,832,368,0.917208655759297,0.658031088082902,1.71395915879305,635,307,328,22,1.1,30.67,2.3,0,0,0,0,0,0,0.0687533356561857,77.6789181596731,7.58065086649015
8.7,"greedy_SVM","SVM",62,12,2612,2575,37,1300,924,376,0.920523777475394,0.663212435233161,1.7264477714482,658,316,342,23,1.1,33.23,2.5,0,0,0,0,0,0,0.0695868369154033,73.3987716959799,7.54524484158741
8.7,"greedy_SVM","SVM",62,13,2512,2480,32,1400,1019,381,0.922053494543859,0.66839378238342,1.72803896755092,677,322,355,19,1.1,35.79,2.7,0,0,0,0,0,0,0.06126422127854,57.4222752417938,6.64232009795607
8.7,"greedy_SVM","SVM",62,14,2412,2385,27,1500,1114,386,0.920992538037197,0.66839378238342,1.72803896755092,685,328,357,8,1.1,38.34,2.9,0,0,0,0,0,0,0.0591717500247866,54.4855197537217,6.61306253238928
8.7,"greedy_SVM","SVM",62,15,2312,2294,18,1600,1205,395,0.921301126494813,0.663212435233161,1.72803896755092,713,338,375,28,1.1,40.9,3.1,0,0,0,0,0,0,0.0512791223478817,48.0879435819645,5.81581078710759
8.7,"greedy_SVM","SVM",62,16,2212,2198,14,1700,1301,399,0.921517138415141,0.663212435233161,1.72327415422127,719,343,376,6,1.1,43.46,3.3,0,0,0,0,0,0,0.0426402072151828,43.4127424799564,4.82360735625208
8.7,"greedy_SVM","SVM",62,17,2112,2098,14,1800,1401,399,0.92244878166338,0.66839378238342,1.72327415422127,719,345,374,0,1.1,46.01,3.5,0,0,0,0,0,0,0.0328352577271777,34.2087721405188,3.64607612382489
8.7,"greedy_SVM","SVM",62,18,2012,2000,12,1900,1499,401,0.924595675647071,0.663212435233161,1.73737971872687,730,350,380,11,1.1,48.57,3.7,0,0,0,0,0,0,0.0287943186260018,29.4652700400987,3.09758788318836
8.7,"greedy_SVM","SVM",62,19,1912,1901,11,2000,1598,402,0.924125445616419,0.663212435233161,1.73737971872687,738,352,386,8,1.1,51.12,4,0,0,0,0,0,0,0.0254451258704791,25.5506221711804,2.78820045839064
8.7,"greedy_SVM","SVM",62,20,1812,1801,11,2100,1698,402,0.924331171254838,0.663212435233161,1.74511207168007,737,356,381,-1,1.1,53.68,4.2,0,0,0,0,0,0,0.0205167847237337,19.3501023584356,2.22674357019995
8.7,"greedy_SVM","SVM",62,21,1712,1703,9,2200,1796,404,0.926707302378492,0.663212435233161,1.74511207168007,748,360,388,11,1.1,56.24,4.4,0,0,0,0,0,0,0.0179416500742576,17.0719922929422,1.94675172373652
8.7,"greedy_SVM","SVM",62,22,1612,1605,7,2300,1894,406,0.92936410205169,0.663212435233161,1.75121914050594,758,362,396,10,1.1,58.79,4.7,0,0,0,0,0,0,0.0163533626989529,14.9296545121337,1.70504754414448
8.7,"greedy_SVM","SVM",62,23,1512,1505,7,2400,1994,406,0.928911505647182,0.658031088082902,1.76377637191195,778,375,403,20,1.1,61.35,4.9,0,0,0,0,0,0,0.00982507266957492,7.58679583800855,1.22380533689315
8.7,"greedy_SVM","SVM",62,24,1412,1406,6,2500,2093,407,0.928833623798356,0.652849740932642,1.76215376255416,778,374,404,0,1.1,63.91,5.1,0,0,0,0,0,0,0.0087836790643149,6.96528519775993,0.927730318519753
8.7,"greedy_SVM","SVM",62,25,1312,1306,6,2600,2193,407,0.928517687996509,0.658031088082902,1.76053413593417,781,379,402,3,1.1,66.46,5.4,0,0,0,0,0,0,0.00684136824451345,5.00690344304553,0.786979910933734
8.7,"greedy_SVM","SVM",62,26,1212,1207,5,2700,2292,408,0.928426580928069,0.658031088082902,1.76377637191195,784,380,404,3,1.1,69.02,5.6,0,0,0,0,0,0,0.00667979138917729,4.47744201159122,0.689436059468885
8.7,"greedy_SVM","SVM",62,27,1112,1107,5,2800,2392,408,0.92949488477895,0.658031088082902,1.76215376255416,793,386,407,9,1.1,71.57,5.9,0,0,0,0,0,0,0.00426979024951544,2.65927651690026,0.497462930816762
8.7,"greedy_SVM","SVM",62,28,1012,1007,5,2900,2492,408,0.929518396280481,0.658031088082902,1.76377637191195,795,386,409,2,1.1,74.13,6.1,0,0,0,0,0,0,0.00421295479433726,2.23553785843118,0.429087389910746
8.7,"greedy_SVM","SVM",62,29,912,907,5,3000,2592,408,0.930530860315222,0.652849740932642,1.76053413593417,807,390,417,12,1.1,76.69,6.4,0,0,0,0,0,0,0.00325093066649087,1.51733757314327,0.371257355341436
8.7,"greedy_SVM","SVM",62,30,812,808,4,3100,2691,409,0.930601394819819,0.658031088082902,1.76377637191195,809,393,416,2,1.1,79.24,6.6,0,0,0,0,0,0,0.00283593776443448,1.10091716125013,0.292871360036511
8.7,"greedy_SVM","SVM",62,31,712,709,3,3200,2790,410,0.930812998333614,0.652849740932642,1.76377637191195,811,396,415,2,1,81.8,6.8,0,0,0,0,0,0,0.00247264007029795,0.784084967675805,0.26846227660866
8.7,"greedy_SVM","SVM",62,32,612,610,2,3300,2889,411,0.93140813321616,0.658031088082902,1.76215376255416,816,398,418,5,1.1,84.36,7,0,0,0,0,0,0,0.00170964598283901,0.494401095953671,0.209179468164987
8.7,"greedy_SVM","SVM",62,33,512,510,2,3400,2989,411,0.931555080100739,0.658031088082902,1.76053413593417,817,398,419,1,1.1,86.91,7.3,0,0,0,0,0,0,0.00105975004860384,0.310517431425884,0.143862581220204
8.7,"greedy_SVM","SVM",62,34,412,411,1,3500,3088,412,0.93277767818044,0.658031088082902,1.76215376255416,827,403,424,10,1.1,89.47,7.5,0,0,0,0,0,0,0.000803290186874278,0.210214252054823,0.10117969636659
8.7,"greedy_SVM","SVM",62,35,312,312,0,3600,3187,413,0.933513882072194,0.658031088082902,1.76377637191195,833,405,428,6,1.1,92.02,7.7,0,0,0,0,0,0,0.000466771945614549,0.122240868196625,0.0660679032861429
8.7,"greedy_SVM","SVM",62,36,212,212,0,3700,3287,413,0.93380336743482,0.658031088082902,1.76540197225472,836,408,428,3,1,94.58,8,0,0,0,0,0,0,0.000203032646176088,0.0438472659065761,0.0281738311453228
8.7,"greedy_SVM","SVM",62,37,112,112,0,3800,3387,413,0.934361765596223,0.658031088082902,1.76053413593417,838,409,429,2,1,97.14,8.2,0,0,0,0,0,0,7.20262934998719e-05,0.0131033574901594,0.0123373083575948
8.7,"greedy_SVM","SVM",62,38,12,12,0,3900,3487,413,0.934826117751493,0.652849740932642,1.76053413593417,839,409,430,1,1.1,99.69,8.4,0,0,0,0,0,0,4.04959936800876e-05,0.000664767674855005,0.000664767674855005
8.7,"greedy_SVM","SVM",62,39,0,0,0,3912,3499,413,0.934854037659563,0.652849740932642,1.76377637191195,840,409,431,1,1.1,100,8.5,0,0,0,0,0,0,0,0,0
8.7,"greedy_SVM","SVM",63,0,3812,3428,384,100,88,12,0.884309714722079,0.538095238095238,1.71061261970353,33,12,21,0,1.8,2.56,7.3,0,0,0,0,0,0,0.567290857009803,532.090868794213,63.3302770419819
8.7,"greedy_SVM","SVM",63,1,3712,3370,342,200,146,54,0.903490972563135,0.571428571428571,1.73089762123801,116,54,62,83,1.1,5.11,2.7,0,0,0,0,0,0,0.52156624094114,639.484076288418,60.7207191174532
8.7,"greedy_SVM","SVM",63,2,3612,3337,275,300,179,121,0.913363879343254,0.614285714285714,1.75125740618828,183,90,93,67,1,7.67,1.5,0,0,0,0,0,0,0.539346831695873,336.430752946201,67.6248014016173
8.7,"greedy_SVM","SVM",63,3,3512,3300,212,400,216,184,0.909466535755205,0.647619047619048,1.73408821593153,247,124,123,64,1,10.22,1.2,0,0,0,0,0,0,0.388597324785681,269.321134593313,49.3474089345764
8.7,"greedy_SVM","SVM",63,4,3412,3253,159,500,263,237,0.891804396443568,0.661904761904762,1.69350649350649,342,171,171,95,1,12.78,1.1,0,0,0,0,0,0,0.32739327219806,343.178172342599,40.6651770639529
8.7,"greedy_SVM","SVM",63,5,3312,3189,123,600,327,273,0.897414498445434,0.666666666666667,1.64520962018662,404,199,205,62,1,15.34,1.2,0,0,0,0,0,0,0.2270896118306,247.625038993855,33.2683909016707
8.7,"greedy_SVM","SVM",63,6,3212,3125,87,700,391,309,0.877453226422297,0.69047619047619,1.58522801945065,493,240,253,89,1.1,17.89,1.3,0,0,0,0,0,0,0.142133377696512,222.39679892483,18.890274234956
8.7,"greedy_SVM","SVM",63,7,3112,3050,62,800,466,334,0.886302023673158,0.685714285714286,1.6265756302521,563,275,288,70,1,20.45,1.4,0,0,0,0,0,0,0.130599794528666,208.669170607111,16.8974423559656
8.7,"greedy_SVM","SVM",63,8,3012,2959,53,900,557,343,0.896314023891348,0.695238095238095,1.672454617206,586,283,303,23,1.1,23.01,1.6,0,0,0,0,0,0,0.0908967407825553,139.464213113421,11.2390189693005
8.7,"greedy_SVM","SVM",63,9,2912,2870,42,1000,646,354,0.910948835433361,0.69047619047619,1.70676137858458,622,298,324,36,1.1,25.56,1.8,0,0,0,0,0,0,0.0802434912301675,114.962743079269,9.26222776345984
8.7,"greedy_SVM","SVM",63,10,2812,2775,37,1100,741,359,0.917700321824031,0.680952380952381,1.71376002102773,641,307,334,19,1.1,28.12,2.1,0,0,0,0,0,0,0.0700782457663661,94.5682808370405,7.72325148286399
8.7,"greedy_SVM","SVM",63,11,2712,2681,31,1200,835,365,0.923891343478967,0.680952380952381,1.73946642134315,656,317,339,15,1.1,30.67,2.3,0,0,0,0,0,0,0.0671691844527326,79.3369923940644,7.36671756088877
8.7,"greedy_SVM","SVM",63,12,2612,2582,30,1300,934,366,0.925252277314131,0.680952380952381,1.73946642134315,663,318,345,7,1.1,33.23,2.6,0,0,0,0,0,0,0.0599530265009165,67.2120930985496,6.25527908051743
8.7,"greedy_SVM","SVM",63,13,2512,2486,26,1400,1030,370,0.926405934653349,0.680952380952381,1.75498949579832,673,324,349,10,1.1,35.79,2.8,0,0,0,0,0,0,0.0516112862963006,53.5047506262301,5.83339241880996
8.7,"greedy_SVM","SVM",63,14,2412,2391,21,1500,1125,375,0.928440517100303,0.676190476190476,1.76842659644503,688,329,359,15,1.1,38.34,3,0,0,0,0,0,0,0.0456974077012667,45.5640797322096,5.25378545101282
8.7,"greedy_SVM","SVM",63,15,2312,2297,15,1600,1219,381,0.929969181257839,0.676190476190476,1.76679821099711,704,335,369,16,1.1,40.9,3.2,0,0,0,0,0,0,0.0384606960263571,40.8583912489277,4.61544731244369
8.7,"greedy_SVM","SVM",63,16,2212,2201,11,1700,1315,385,0.930645557191949,0.676190476190476,1.76679821099711,715,340,375,11,1.1,43.46,3.4,0,0,0,0,0,0,0.0320507752794555,35.2570012614599,3.53245290558787
8.7,"greedy_SVM","SVM",63,17,2112,2101,11,1800,1415,385,0.930581465117547,0.676190476190476,1.76842659644503,718,340,378,3,1.1,46.01,3.7,0,0,0,0,0,0,0.0252253309012238,28.7605054567669,2.7979996512321
8.7,"greedy_SVM","SVM",63,18,2012,2002,10,1900,1514,386,0.93030055091911,0.676190476190476,1.76842659644503,722,342,380,4,1.1,48.57,3.9,0,0,0,0,0,0,0.0213837524276741,22.7788321086018,2.19262293897287
8.7,"greedy_SVM","SVM",63,19,1912,1903,9,2000,1613,387,0.928342333496977,0.661904761904762,1.7737416217637,742,358,384,20,1.1,51.12,4.2,0,0,0,0,0,0,0.0154137778683941,12.3427210487859,2.03175383532133
8.7,"greedy_SVM","SVM",63,20,1812,1804,8,2100,1712,388,0.928424153166425,0.666666666666667,1.7770111915734,746,360,386,4,1.1,53.68,4.4,0,0,0,0,0,0,0.0119028071363655,10.6343321812037,1.35885831364328
8.7,"greedy_SVM","SVM",63,21,1712,1705,7,2200,1811,389,0.928500518191245,0.666666666666667,1.7737416217637,748,361,387,2,1.1,56.24,4.7,0,0,0,0,0,0,0.00964067654729594,8.79852708218135,1.03562626434649
8.7,"greedy_SVM","SVM",63,22,1612,1605,7,2300,1911,389,0.928623247695418,0.666666666666667,1.7770111915734,749,362,387,1,1.1,58.79,4.9,0,0,0,0,0,0,0.00885728002779519,7.74769467723873,0.928539082838109
8.7,"greedy_SVM","SVM",63,23,1512,1506,6,2400,2010,390,0.928841433480614,0.671428571428571,1.7737416217637,760,363,397,11,1.1,61.35,5.2,0,0,0,0,0,0,0.00874231403486295,6.95385354105774,0.887677445628635
8.7,"greedy_SVM","SVM",63,24,1412,1407,5,2500,2109,391,0.928920525827748,0.671428571428571,1.77211134453782,769,373,396,9,1.1,63.91,5.4,0,0,0,0,0,0,0.00686873025042703,4.86904816507419,0.824806462794328
8.7,"greedy_SVM","SVM",63,25,1312,1307,5,2600,2209,391,0.928882343315339,0.671428571428571,1.7737416217637,770,373,397,1,1.1,66.46,5.6,0,0,0,0,0,0,0.00620804396774869,4.22732213419922,0.648079179266889
8.7,"greedy_SVM","SVM",63,26,1212,1207,5,2700,2309,391,0.929058255604652,0.671428571428571,1.77211134453782,771,375,396,1,1.1,69.02,5.9,0,0,0,0,0,0,0.00474679775124835,2.82852883297093,0.491340326087334
8.7,"greedy_SVM","SVM",63,27,1112,1107,5,2800,2409,391,0.928936889761636,0.666666666666667,1.7737416217637,773,377,396,2,1.1,71.57,6.2,0,0,0,0,0,0,0.00405105385212397,2.13435242475926,0.424664255490815
8.7,"greedy_SVM","SVM",63,28,1012,1008,4,2900,2508,392,0.928969617629416,0.666666666666667,1.7737416217637,777,378,399,4,1.1,74.13,6.4,0,0,0,0,0,0,0.0039013908661295,1.79131980841094,0.40492808743777
8.7,"greedy_SVM","SVM",63,29,912,909,3,3000,2607,393,0.928834615174826,0.666666666666667,1.77537490134175,782,382,400,5,1,76.69,6.6,0,0,0,0,0,0,0.00327288724545193,1.33309328021487,0.351190496302918
8.7,"greedy_SVM","SVM",63,30,812,810,2,3100,2706,394,0.928846888125244,0.666666666666667,1.7770111915734,792,385,407,10,1.1,79.24,6.9,0,0,0,0,0,0,0.00295919898683589,1.09320655800936,0.327691372051099
8.7,"greedy_SVM","SVM",63,31,712,710,2,3200,2806,394,0.92877870506737,0.666666666666667,1.7770111915734,793,385,408,1,1.1,81.8,7.1,0,0,0,0,0,0,0.00241802554709285,0.817962971479886,0.276804030944105
8.7,"greedy_SVM","SVM",63,32,612,611,1,3300,2905,395,0.929279168712163,0.666666666666667,1.77211134453782,794,386,408,1,1.1,84.36,7.4,0,0,0,0,0,0,0.00159664460651008,0.545616066847693,0.204283790530875
8.7,"greedy_SVM","SVM",63,33,512,511,1,3400,3005,395,0.929423716794856,0.657142857142857,1.77537490134175,796,386,410,2,1.1,86.91,7.6,0,0,0,0,0,0,0.00100535949322884,0.322107669146197,0.126264253324079
8.7,"greedy_SVM","SVM",63,34,412,412,0,3500,3104,396,0.929888725249556,0.657142857142857,1.7737416217637,802,389,413,6,1.1,89.47,7.8,0,0,0,0,0,0,0.00078214759903994,0.234915961969807,0.095489214932731
8.7,"greedy_SVM","SVM",63,35,312,312,0,3600,3204,396,0.930008727431415,0.661904761904762,1.76885976408912,808,391,417,6,1.1,92.02,8.1,0,0,0,0,0,0,0.000477649684403787,0.117887521103859,0.056986668189116
8.7,"greedy_SVM","SVM",63,36,212,212,0,3700,3304,396,0.930286914307541,0.657142857142857,1.77537490134175,807,391,416,-1,1.1,94.58,8.3,0,0,0,0,0,0,0.000216518881228844,0.0458296402079708,0.029513377949807
8.7,"greedy_SVM","SVM",63,37,112,112,0,3800,3404,396,0.930657830142375,0.657142857142857,1.7770111915734,808,393,415,1,1.1,97.14,8.6,0,0,0,0,0,0,0.000103383649020904,0.0165058350714107,0.0154465290708718
8.7,"greedy_SVM","SVM",63,38,12,12,0,3900,3504,396,0.931012382043324,0.657142857142857,1.7737416217637,812,394,418,4,1.1,99.69,8.8,0,0,0,0,0,0,6.65374397583508e-05,0.000955576636082232,0.000955576636082232
8.7,"greedy_SVM","SVM",63,39,0,0,0,3912,3516,396,0.931116020291293,0.657142857142857,1.77048406139315,815,394,421,3,1.1,100,8.9,0,0,0,0,0,0,0,0,0
8.7,"greedy_SVM","SVM",64,0,3812,3415,397,100,85,15,0.901570380425259,0.541237113402062,1.74700935911445,37,15,22,0,1.5,2.56,5.7,0,0,0,0,0,0,0.299161710392923,469.447952311288,32.84948517805
8.7,"greedy_SVM","SVM",64,1,3712,3384,328,200,116,84,0.934968756216586,0.577319587628866,1.7759954601343,106,54,52,69,1,5.11,1.4,0,0,0,0,0,0,0.662284621961085,358.551682246345,73.9065708638191
8.7,"greedy_SVM","SVM",64,2,3612,3351,261,300,149,151,0.925693623693812,0.592783505154639,1.77325283362761,162,82,80,56,1,7.67,1,0,0,0,0,0,0,0.5,247.292712863592,62.2203078729889
8.7,"greedy_SVM","SVM",64,3,3512,3303,209,400,197,203,0.902054542050397,0.597938144329897,1.76072619769557,252,129,123,90,1,10.22,1,0,0,0,0,0,0,0.322369345225982,152.757334189213,46.5145929119256
8.7,"greedy_SVM","SVM",64,4,3412,3241,171,500,259,241,0.910373053114423,0.608247422680412,1.73771675614043,331,164,167,79,1,12.78,1.1,0,0,0,0,0,0,0.142908839403697,84.5456204162654,21.4002104566539
8.7,"greedy_SVM","SVM",64,5,3312,3170,142,600,330,270,0.899347040031815,0.644329896907217,1.69125374127037,390,190,200,59,1.1,15.34,1.2,0,0,0,0,0,0,0.106443354913678,100.16882470947,14.5816532125985
8.7,"greedy_SVM","SVM",64,6,3212,3095,117,700,405,295,0.905800578068505,0.670103092783505,1.71281701740933,454,217,237,64,1.1,17.89,1.4,0,0,0,0,0,0,0.0930440505555703,108.61679771294,11.5187379298458
8.7,"greedy_SVM","SVM",64,7,3112,3012,100,800,488,312,0.900069625659697,0.664948453608247,1.68195262078676,496,238,258,42,1.1,20.45,1.6,0,0,0,0,0,0,0.138356152288366,134.115589954553,15.8825383276239
8.7,"greedy_SVM","SVM",64,8,3012,2923,89,900,577,323,0.901921434171569,0.65979381443299,1.68814195885773,536,255,281,40,1.1,23.01,1.8,0,0,0,0,0,0,0.0970884702924832,90.4590921860587,12.167415473876
8.7,"greedy_SVM","SVM",64,9,2912,2843,69,1000,657,343,0.901184221304299,0.654639175257732,1.68196113829636,584,276,308,48,1.1,25.56,1.9,0,0,0,0,0,0,0.0896418298377699,87.3694259161511,10.0664893278164
8.7,"greedy_SVM","SVM",64,10,2812,2753,59,1100,747,353,0.899598628550047,0.65979381443299,1.68196113829636,604,287,317,20,1.1,28.12,2.1,0,0,0,0,0,0,0.0843079300608681,88.4996274066007,9.98533462766834
8.7,"greedy_SVM","SVM",64,11,2712,2661,51,1200,839,361,0.901941912306797,0.65979381443299,1.68196113829636,624,299,325,20,1.1,30.67,2.3,0,0,0,0,0,0,0.075354606605174,70.0284424842405,8.19962766211509
8.7,"greedy_SVM","SVM",64,12,2612,2568,44,1300,932,368,0.902616228044536,0.65979381443299,1.68041237113402,648,306,342,24,1.1,33.23,2.5,0,0,0,0,0,0,0.067156414663875,62.1423880940236,7.47230016962753
8.7,"greedy_SVM","SVM",64,13,2512,2476,36,1400,1024,376,0.902784441297985,0.654639175257732,1.67886645358928,666,315,351,18,1.1,35.79,2.7,0,0,0,0,0,0,0.0603260829784196,59.673398850576,6.70775429038697
8.7,"greedy_SVM","SVM",64,14,2412,2376,36,1500,1124,376,0.902721544168434,0.654639175257732,1.67732337780473,670,317,353,4,1.1,38.34,3,0,0,0,0,0,0,0.0473564121760417,46.0037379135997,5.20623505631706
8.7,"greedy_SVM","SVM",64,15,2312,2281,31,1600,1219,381,0.904326152333931,0.654639175257732,1.67112832488466,685,323,362,15,1.1,40.9,3.2,0,0,0,0,0,0,0.042845732998076,46.3116130923099,4.79229600443873
8.7,"greedy_SVM","SVM",64,16,2212,2188,24,1700,1312,388,0.915650561100902,0.649484536082474,1.70054634424438,699,333,366,14,1.1,43.46,3.4,0,0,0,0,0,0,0.0389004322846282,42.4266533972723,4.57126230113005
8.7,"greedy_SVM","SVM",64,17,2112,2093,19,1800,1407,393,0.923081198731524,0.654639175257732,1.70043561661958,717,342,375,18,1.1,46.01,3.6,0,0,0,0,0,0,0.0366680131044852,39.5999947645857,4.2291762138274
8.7,"greedy_SVM","SVM",64,18,2012,2000,12,1900,1500,400,0.923451267889112,0.670103092783505,1.70512431776834,730,349,381,13,1.1,48.57,3.8,0,0,0,0,0,0,0.0361535659402809,35.4259900466296,3.77763801859487
8.7,"greedy_SVM","SVM",64,19,1912,1902,10,2000,1598,402,0.928490351872877,0.664948453608247,1.74379499046842,768,372,396,38,1.1,51.12,4,0,0,0,0,0,0,0.0250607676632612,16.5123649355604,3.52137764650906
8.7,"greedy_SVM","SVM",64,20,1812,1803,9,2100,1697,403,0.928869197374128,0.65979381443299,1.74219223771983,769,373,396,1,1.1,53.68,4.2,0,0,0,0,0,0,0.0177975580454915,13.7304208440112,2.14805447045159
8.7,"greedy_SVM","SVM",64,21,1712,1706,6,2200,1794,406,0.928971588050143,0.654639175257732,1.73899555471484,780,377,403,11,1.1,56.24,4.4,0,0,0,0,0,0,0.014437929243883,11.8929848844161,1.58146941475278
8.7,"greedy_SVM","SVM",64,22,1612,1607,5,2300,1893,407,0.930113975449656,0.649484536082474,1.74540069487954,784,379,405,4,1.1,58.79,4.7,0,0,0,0,0,0,0.0134021519696293,10.610874562231,1.39304761541044
8.7,"greedy_SVM","SVM",64,23,1512,1507,5,2400,1993,407,0.930895070035233,0.649484536082474,1.74219223771983,790,381,409,6,1.1,61.35,4.9,0,0,0,0,0,0,0.00975790345894503,7.26463387681963,1.08708613117132
8.7,"greedy_SVM","SVM",64,24,1412,1408,4,2500,2092,408,0.93102964063799,0.649484536082474,1.74379499046842,796,384,412,6,1.1,63.91,5.1,0,0,0,0,0,0,0.009611204465091,6.61766643860419,1.00313423515279
8.7,"greedy_SVM","SVM",64,25,1312,1308,4,2600,2192,408,0.932466035550043,0.654639175257732,1.75307049573687,805,391,414,9,1.1,66.46,5.4,0,0,0,0,0,0,0.00703379733645254,4.57223467638462,0.805566319966
8.7,"greedy_SVM","SVM",64,26,1212,1208,4,2700,2292,408,0.932331464947284,0.654639175257732,1.74985089886683,804,390,414,-1,1.1,69.02,5.6,0,0,0,0,0,0,0.0060131731449123,3.36830311616353,0.617451024065953
8.7,"greedy_SVM","SVM",64,27,1112,1108,4,2800,2392,408,0.933342207191916,0.649484536082474,1.7514592177077,808,394,414,4,1.1,71.57,5.9,0,0,0,0,0,0,0.00484928938724425,2.46606487601317,0.523698903671234
8.7,"greedy_SVM","SVM",64,28,1012,1008,4,2900,2492,408,0.933428507904555,0.649484536082474,1.7514592177077,808,394,414,0,1.1,74.13,6.1,0,0,0,0,0,0,0.00443199437988251,1.93529105234037,0.464685236360438
8.7,"greedy_SVM","SVM",64,29,912,908,4,3000,2592,408,0.933719589969219,0.644329896907217,1.75468474112889,809,394,415,1,1.1,76.69,6.4,0,0,0,0,0,0,0.00358764283536126,1.35274573704327,0.391387250475281
8.7,"greedy_SVM","SVM",64,30,812,809,3,3100,2691,409,0.933781024374824,0.644329896907217,1.7514592177077,813,397,416,4,1,79.24,6.6,0,0,0,0,0,0,0.00337348237316219,1.15152112058691,0.378957072829281
8.7,"greedy_SVM","SVM",64,31,712,709,3,3200,2791,409,0.933776636202995,0.644329896907217,1.74985089886683,813,397,416,0,1,81.8,6.8,0,0,0,0,0,0,0.00223266646095156,0.716179321792143,0.267556300818807
8.7,"greedy_SVM","SVM",64,32,612,610,2,3300,2890,410,0.934135003569039,0.644329896907217,1.75468474112889,818,399,419,5,1.1,84.36,7,0,0,0,0,0,0,0.0018134246775481,0.546078577253353,0.221741720243814
8.7,"greedy_SVM","SVM",64,33,512,510,2,3400,2990,410,0.934335396749235,0.644329896907217,1.74985089886683,816,399,417,-2,1,86.91,7.3,0,0,0,0,0,0,0.000952276814119134,0.296804600620782,0.130481439144154
8.7,"greedy_SVM","SVM",64,34,412,411,1,3500,3089,411,0.934651345120933,0.649484536082474,1.7514592177077,823,401,422,7,1.1,89.47,7.5,0,0,0,0,0,0,0.000704940834285501,0.205703245063664,0.091330583525378
8.7,"greedy_SVM","SVM",64,35,312,312,0,3600,3188,412,0.934905859087024,0.649484536082474,1.75910936923121,830,405,425,7,1,92.02,7.7,0,0,0,0,0,0,0.00052979424092436,0.130586439570291,0.0663989947512649
8.7,"greedy_SVM","SVM",64,36,212,212,0,3700,3288,412,0.935170612120718,0.644329896907217,1.76999317768344,836,406,430,6,1.1,94.58,8,0,0,0,0,0,0,0.000268504985244181,0.0556078509122253,0.0360378813094289
8.7,"greedy_SVM","SVM",64,37,112,112,0,3800,3388,412,0.935552383069856,0.644329896907217,1.76559456506247,834,407,427,-2,1,97.14,8.2,0,0,0,0,0,0,9.98918251708381e-05,0.0184684825638948,0.0174063817775869
8.7,"greedy_SVM","SVM",64,38,12,12,0,3900,3488,412,0.935637221058556,0.644329896907217,1.75910936923121,836,407,429,2,1.1,99.69,8.5,0,0,0,0,0,0,5.20623812340688e-05,0.000733448974177216,0.000733448974177216
8.7,"greedy_SVM","SVM",64,39,0,0,0,3912,3500,412,0.935610892027582,0.644329896907217,1.75427665118387,836,407,429,0,1.1,100,8.5,0,0,0,0,0,0,0,0,0
8.7,"greedy_SVM","SVM",65,0,3812,3425,387,100,88,12,0.892628776139863,0.51207729468599,1.72438389100381,32,12,20,0,1.7,2.56,7.3,0,0,0,0,0,0,0.330568169579672,399.805860686291,35.6145341340338
8.7,"greedy_SVM","SVM",65,1,3712,3394,318,200,119,81,0.924453725110004,0.570048309178744,1.79120879120879,98,48,50,66,1,5.11,1.5,0,0,0,0,0,0,0.614062404043215,345.049356733693,68.0830184160885
8.7,"greedy_SVM","SVM",65,2,3612,3361,251,300,152,148,0.928442201616936,0.589371980676328,1.78956999085087,168,86,82,70,1,7.67,1,0,0,0,0,0,0,0.482757063352758,285.614246256158,56.771737634795
8.7,"greedy_SVM","SVM",65,3,3512,3319,193,400,194,206,0.906900561535513,0.603864734299517,1.74408112748034,246,126,120,78,1,10.22,0.9,0,0,0,0,0,0,0.310009002237362,141.103854917863,42.1364813313176
8.7,"greedy_SVM","SVM",65,4,3412,3250,162,500,263,237,0.907901823816523,0.613526570048309,1.74889903114741,337,167,170,91,1,12.78,1.1,0,0,0,0,0,0,0.19718809757929,100.125250908774,28.838463991483
8.7,"greedy_SVM","SVM",65,5,3312,3168,144,600,345,255,0.915932637835866,0.608695652173913,1.75598309400957,385,189,196,48,1,15.34,1.4,0,0,0,0,0,0,0.0861045670471553,52.1113138202133,13.0228077067532
8.7,"greedy_SVM","SVM",65,6,3212,3098,114,700,415,285,0.926184182541869,0.642512077294686,1.76848823294775,443,214,229,58,1.1,17.89,1.5,0,0,0,0,0,0,0.0992763116319806,79.0785825720341,17.2773193840871
8.7,"greedy_SVM","SVM",65,7,3112,3021,91,800,492,308,0.9304668230017,0.652173913043478,1.74568414322251,485,235,250,42,1.1,20.45,1.6,0,0,0,0,0,0,0.0683417207086757,65.246902587226,9.17215127047161
8.7,"greedy_SVM","SVM",65,8,3012,2942,70,900,571,329,0.922661120364158,0.661835748792271,1.69513219471221,543,262,281,58,1.1,23.01,1.7,0,0,0,0,0,0,0.0719623371185775,109.968135980063,10.6627436884985
8.7,"greedy_SVM","SVM",65,9,2912,2853,59,1000,660,340,0.932531494877683,0.661835748792271,1.69913575322431,581,279,302,38,1.1,25.56,1.9,0,0,0,0,0,0,0.0708791644731705,106.740010285264,8.74554386328232
8.7,"greedy_SVM","SVM",65,10,2812,2768,44,1100,745,355,0.94523302480645,0.671497584541063,1.77663794830695,623,297,326,42,1.1,28.12,2.1,0,0,0,0,0,0,0.0921288448852843,118.749241587557,10.3694862806492
8.7,"greedy_SVM","SVM",65,11,2712,2670,42,1200,843,357,0.949702107208268,0.671497584541063,1.794055967408,637,302,335,14,1.1,30.67,2.4,0,0,0,0,0,0,0.0683557211518962,79.4925260486323,7.49277914990242
8.7,"greedy_SVM","SVM",65,12,2612,2573,39,1300,940,360,0.950377441353654,0.661835748792271,1.79449541284404,645,310,335,8,1.1,33.23,2.6,0,0,0,0,0,0,0.0627609442718319,65.5384759156969,6.86343190581141
8.7,"greedy_SVM","SVM",65,13,2512,2475,37,1400,1038,362,0.950443731821914,0.657004830917874,1.79779411764706,650,316,334,5,1.1,35.79,2.9,0,0,0,0,0,0,0.0560577828346255,52.1843830549928,6.01920267811083
8.7,"greedy_SVM","SVM",65,14,2412,2379,33,1500,1134,366,0.949892692304511,0.657004830917874,1.79944802207912,662,320,342,12,1.1,38.34,3.1,0,0,0,0,0,0,0.0462382080733497,42.453145025163,5.32931125747862
8.7,"greedy_SVM","SVM",65,15,2312,2286,26,1600,1227,373,0.950566645398481,0.652173913043478,1.78418948179439,675,327,348,13,1.1,40.9,3.3,0,0,0,0,0,0,0.04245435657459,42.0534839377069,5.05095427600236
8.7,"greedy_SVM","SVM",65,16,2212,2191,21,1700,1322,378,0.951377322583237,0.647342995169082,1.78910912190963,690,330,360,15,1.1,43.46,3.5,0,0,0,0,0,0,0.0320800752479004,33.3309094616454,3.71996154917336
8.7,"greedy_SVM","SVM",65,17,2112,2094,18,1800,1419,381,0.951561002422371,0.647342995169082,1.79075503646521,704,334,370,14,1.1,46.01,3.7,0,0,0,0,0,0,0.030304418873304,33.2385403918225,3.34979917043035
8.7,"greedy_SVM","SVM",65,18,2012,1997,15,1900,1516,384,0.95183859375821,0.647342995169082,1.79240398217098,716,341,375,12,1.1,48.57,3.9,0,0,0,0,0,0,0.0269649097460207,28.3669634896959,2.77383959817922
8.7,"greedy_SVM","SVM",65,19,1912,1899,13,2000,1614,386,0.951337272091992,0.657004830917874,1.79779411764706,737,358,379,21,1.1,51.12,4.2,0,0,0,0,0,0,0.0206889516992326,15.0081117460326,2.63421338282455
8.7,"greedy_SVM","SVM",65,20,1812,1800,12,2100,1713,387,0.951486425645576,0.661835748792271,1.79944802207912,739,360,379,2,1.1,53.68,4.4,0,0,0,0,0,0,0.0156063866755783,13.0396062654937,1.80789952411929
8.7,"greedy_SVM","SVM",65,21,1712,1704,8,2200,1809,391,0.951599671862185,0.652173913043478,1.79614325068871,749,364,385,10,1.1,56.24,4.6,0,0,0,0,0,0,0.0127068150311774,11.2441806593264,1.42645375326686
8.7,"greedy_SVM","SVM",65,22,1612,1604,8,2300,1909,391,0.951453280411445,0.657004830917874,1.80276497695853,750,364,386,1,1.1,58.79,4.9,0,0,0,0,0,0,0.0121074192148132,10.8888853091151,1.29907536306203
8.7,"greedy_SVM","SVM",65,23,1512,1506,6,2400,2007,393,0.951569288730901,0.657004830917874,1.79944802207912,762,371,391,12,1.1,61.35,5.1,0,0,0,0,0,0,0.0139239588365161,11.122673212869,1.44423081893288
8.7,"greedy_SVM","SVM",65,24,1412,1406,6,2500,2107,393,0.95026005198278,0.647342995169082,1.79614325068871,777,380,397,15,1,63.91,5.4,0,0,0,0,0,0,0.00836081607075307,6.02777593541201,1.04575441264298
8.7,"greedy_SVM","SVM",65,25,1312,1307,5,2600,2206,394,0.95040091922783,0.642512077294686,1.79779411764706,777,379,398,0,1.1,66.46,5.6,0,0,0,0,0,0,0.00773910936641276,5.52188854621277,0.820938022937192
8.7,"greedy_SVM","SVM",65,26,1212,1207,5,2700,2306,394,0.950171664691768,0.642512077294686,1.79944802207912,780,381,399,3,1,69.02,5.9,0,0,0,0,0,0,0.00621003946288431,3.94403770393487,0.640934891480764
8.7,"greedy_SVM","SVM",65,27,1112,1109,3,2800,2404,396,0.950348439273791,0.642512077294686,1.79944802207912,791,386,405,11,1,71.57,6.1,0,0,0,0,0,0,0.00582152204243518,3.38742042013007,0.613318732673956
8.7,"greedy_SVM","SVM",65,28,1012,1009,3,2900,2504,396,0.950179951000299,0.642512077294686,1.80276497695853,797,387,410,6,1.1,74.13,6.3,0,0,0,0,0,0,0.00523082540037585,2.64585992231708,0.544729598693333
8.7,"greedy_SVM","SVM",65,29,912,909,3,3000,2604,396,0.95000041431543,0.642512077294686,1.79944802207912,797,387,410,0,1.1,76.69,6.6,0,0,0,0,0,0,0.00438964111851351,1.91669321412599,0.464963554468356
8.7,"greedy_SVM","SVM",65,30,812,809,3,3100,2704,396,0.9499672690813,0.642512077294686,1.79944802207912,796,389,407,-1,1,79.24,6.8,0,0,0,0,0,0,0.00321758011288881,1.2406483874823,0.350329980799093
8.7,"greedy_SVM","SVM",65,31,712,709,3,3200,2804,396,0.950025273241027,0.642512077294686,1.80110497237569,797,389,408,1,1,81.8,7.1,0,0,0,0,0,0,0.00278756316862157,0.977570086010942,0.317409842934406
8.7,"greedy_SVM","SVM",65,32,612,609,3,3300,2904,396,0.950103993172085,0.642512077294686,1.79779411764706,798,389,409,1,1.1,84.36,7.3,0,0,0,0,0,0,0.00201237316599085,0.633709043046847,0.233082472642339
8.7,"greedy_SVM","SVM",65,33,512,509,3,3400,3004,396,0.950246241468558,0.642512077294686,1.80276497695853,799,389,410,1,1.1,86.91,7.6,0,0,0,0,0,0,0.00121933418973486,0.385321806330112,0.15947730187193
8.7,"greedy_SVM","SVM",65,34,412,412,0,3500,3101,399,0.95038158450792,0.647342995169082,1.79944802207912,812,394,418,13,1.1,89.47,7.8,0,0,0,0,0,0,0.00130588808357959,0.390086356013227,0.17538533761037
8.7,"greedy_SVM","SVM",65,35,312,312,0,3600,3201,399,0.950646746380957,0.642512077294686,1.79779411764706,818,396,422,6,1.1,92.02,8,0,0,0,0,0,0,0.00106716912902576,0.282233386947453,0.137159933670745
8.7,"greedy_SVM","SVM",65,36,212,212,0,3700,3301,399,0.950863571454223,0.63768115942029,1.80110497237569,817,397,420,-1,1.1,94.58,8.3,0,0,0,0,0,0,0.000331103833163497,0.0683222893913526,0.0424168962017031
8.7,"greedy_SVM","SVM",65,37,112,112,0,3800,3401,399,0.95115497330428,0.632850241545894,1.79944802207912,815,398,417,-2,1,97.14,8.5,0,0,0,0,0,0,0.000127422940691947,0.0206659984393572,0.0193206061456741
8.7,"greedy_SVM","SVM",65,38,12,12,0,3900,3501,399,0.951138400687215,0.63768115942029,1.79614325068871,816,399,417,1,1,99.69,8.8,0,0,0,0,0,0,0.00013717822451643,0.00184288555015858,0.00184288555015858
8.7,"greedy_SVM","SVM",65,39,0,0,0,3912,3513,399,0.951157735407124,0.63768115942029,1.80276497695853,817,399,418,1,1,100,8.8,0,0,0,0,0,0,0,0,0
8.7,"greedy_SVM","SVM",66,0,3812,3404,408,100,94,6,0.901080050075587,0.541666666666667,1.73703917050691,20,6,14,0,2.3,2.56,15.7,0,0,0,0,0,0,0.164782213421215,256.544012523125,18.5143926293423
8.7,"greedy_SVM","SVM",66,1,3712,3362,350,200,136,64,0.91466187169312,0.583333333333333,1.76195952161914,95,47,48,75,1,5.11,2.1,0,0,0,0,0,0,0.76629223372472,311.844518251845,85.2327619761381
8.7,"greedy_SVM","SVM",66,2,3612,3342,270,300,156,144,0.915329152494329,0.588541666666667,1.75872359963269,132,66,66,37,1,7.67,1.1,0,0,0,0,0,0,0.507718516206608,172.382994678289,64.625770065271
8.7,"greedy_SVM","SVM",66,3,3512,3299,213,400,199,201,0.917980560279667,0.598958333333333,1.76483730522456,221,115,106,89,0.9,10.22,1,0,0,0,0,0,0,0.302536740899073,112.038033279078,46.5550148874369
8.7,"greedy_SVM","SVM",66,4,3412,3241,171,500,257,243,0.877483111300075,0.625,1.68543198529412,314,159,155,93,1,12.78,1.1,0,0,0,0,0,0,0.229093957422945,101.106008115801,33.3516448801495
8.7,"greedy_SVM","SVM",66,5,3312,3162,150,600,336,264,0.887059771825396,0.645833333333333,1.71667817679558,373,184,189,59,1,15.34,1.3,0,0,0,0,0,0,0.0746068332791266,35.6115877554039,13.4750511312615
8.7,"greedy_SVM","SVM",66,6,3212,3092,120,700,406,294,0.897259424603183,0.640625,1.68070276497696,435,212,223,62,1.1,17.89,1.4,0,0,0,0,0,0,0.0618510611241041,35.6837117213306,9.4003452585251
8.7,"greedy_SVM","SVM",66,7,3112,3020,92,800,478,322,0.907230253212393,0.666666666666667,1.6713133640553,493,239,254,58,1.1,20.45,1.5,0,0,0,0,0,0,0.0731764172418747,69.7364980420718,10.7115648932021
8.7,"greedy_SVM","SVM",66,8,3012,2938,74,900,560,340,0.898118622448977,0.666666666666667,1.65253456221198,535,259,276,42,1.1,23.01,1.6,0,0,0,0,0,0,0.0545905539353849,71.2137519192307,9.2871222620141
8.7,"greedy_SVM","SVM",66,9,2912,2854,58,1000,644,356,0.900604686318982,0.6875,1.66192396313364,585,280,305,50,1.1,25.56,1.8,0,0,0,0,0,0,0.0665248809842421,95.891852174823,7.42980106569135
8.7,"greedy_SVM","SVM",66,10,2812,2758,54,1100,740,360,0.926537107898739,0.661458333333333,1.72447102115915,624,305,319,39,1,28.12,2.1,0,0,0,0,0,0,0.0486454838339359,42.145813268134,6.41056700890252
8.7,"greedy_SVM","SVM",66,11,2712,2670,42,1200,828,372,0.934103068310671,0.651041666666667,1.75420119705341,651,316,335,27,1.1,30.67,2.2,0,0,0,0,0,0,0.0466621504085251,51.2424544446513,6.07420233338384
8.7,"greedy_SVM","SVM",66,12,2612,2578,34,1300,920,380,0.937249031557091,0.645833333333333,1.78398617511521,674,327,347,23,1.1,33.23,2.4,0,0,0,0,0,0,0.0567818844511944,56.4848632656395,6.62174152056069
8.7,"greedy_SVM","SVM",66,13,2512,2480,32,1400,1018,382,0.936980347694656,0.645833333333333,1.78070377184913,686,333,353,12,1.1,35.79,2.7,0,0,0,0,0,0,0.0473534414264026,41.6372887208888,5.20017000195253
8.7,"greedy_SVM","SVM",66,14,2412,2384,28,1500,1114,386,0.937355324074096,0.645833333333333,1.78398617511521,696,340,356,10,1,38.34,2.9,0,0,0,0,0,0,0.045050926193066,33.8675347495523,5.00121520457119
8.7,"greedy_SVM","SVM",66,15,2312,2289,23,1600,1209,391,0.937473426870771,0.645833333333333,1.78398617511521,717,348,369,21,1.1,40.9,3.1,0,0,0,0,0,0,0.0480682902556955,32.3104383699141,5.59286610576043
8.7,"greedy_SVM","SVM",66,16,2212,2194,18,1700,1304,396,0.938058035714307,0.640625,1.78398617511521,732,355,377,15,1.1,43.46,3.3,0,0,0,0,0,0,0.0363048482396348,24.7517772908975,4.6438836186593
8.7,"greedy_SVM","SVM",66,17,2112,2097,15,1800,1401,399,0.938016699735475,0.640625,1.77459677419355,736,357,379,4,1.1,46.01,3.5,0,0,0,0,0,0,0.025737470612856,19.8155828437825,3.09999622149939
8.7,"greedy_SVM","SVM",66,18,2012,1999,13,1900,1499,401,0.938068369709017,0.640625,1.77296270718232,741,359,382,5,1.1,48.57,3.7,0,0,0,0,0,0,0.0214965827817205,19.0053543821354,2.48654730435896
8.7,"greedy_SVM","SVM",66,19,1912,1899,13,2000,1599,401,0.937691917044618,0.645833333333333,1.77459677419355,742,359,383,1,1.1,51.12,4,0,0,0,0,0,0,0.0161924536258981,14.5555690980859,1.78858031743338
8.7,"greedy_SVM","SVM",66,20,1812,1800,12,2100,1698,402,0.937683059334867,0.640625,1.77459677419355,747,360,387,5,1.1,53.68,4.2,0,0,0,0,0,0,0.0142196861815169,12.984690907771,1.53411080342481
8.7,"greedy_SVM","SVM",66,21,1712,1702,10,2200,1796,404,0.938208616780066,0.640625,1.77459677419355,754,365,389,7,1.1,56.24,4.4,0,0,0,0,0,0,0.0133725931463198,11.4290325007169,1.37089650177653
8.7,"greedy_SVM","SVM",66,22,1612,1603,9,2300,1895,405,0.937207695578253,0.645833333333333,1.78398617511521,770,375,395,16,1.1,58.79,4.7,0,0,0,0,0,0,0.00944455406107647,6.80915781323223,1.20164846141947
8.7,"greedy_SVM","SVM",66,23,1512,1504,8,2400,1994,406,0.937370086923679,0.645833333333333,1.78398617511521,772,377,395,2,1,61.35,4.9,0,0,0,0,0,0,0.00714250893340611,5.45072093407643,0.797268338966654
8.7,"greedy_SVM","SVM",66,24,1412,1405,7,2500,2093,407,0.937249031557089,0.645833333333333,1.78234346224678,778,379,399,6,1.1,63.91,5.1,0,0,0,0,0,0,0.00743386691724585,5.08327450500687,0.766353942897579
8.7,"greedy_SVM","SVM",66,25,1312,1305,7,2600,2193,407,0.936912438586567,0.640625,1.77906709558824,785,384,401,7,1,66.46,5.4,0,0,0,0,0,0,0.00528304794474659,3.45418790268233,0.621804787509706
8.7,"greedy_SVM","SVM",66,26,1212,1207,5,2700,2291,409,0.937237221277419,0.640625,1.78234346224678,796,387,409,11,1.1,69.02,5.6,0,0,0,0,0,0,0.00609466546526469,3.53526801154042,0.634044876046484
8.7,"greedy_SVM","SVM",66,27,1112,1107,5,2800,2391,409,0.93734056122451,0.645833333333333,1.77906709558824,805,393,412,9,1,71.57,5.8,0,0,0,0,0,0,0.00485201964796976,2.57292306567918,0.532524688160172
8.7,"greedy_SVM","SVM",66,28,1012,1008,4,2900,2490,410,0.937328750944843,0.640625,1.78070377184913,809,393,416,4,1.1,74.13,6.1,0,0,0,0,0,0,0.00450701525261306,2.13671312398738,0.478590871313222
8.7,"greedy_SVM","SVM",66,29,912,909,3,3000,2589,411,0.937349418934261,0.645833333333333,1.77417506874427,816,396,420,7,1.1,76.69,6.3,0,0,0,0,0,0,0.00380337689466108,1.60474726901058,0.411375516749592
8.7,"greedy_SVM","SVM",66,30,812,809,3,3100,2689,411,0.937384849773263,0.645833333333333,1.77417506874427,815,396,419,-1,1.1,79.24,6.5,0,0,0,0,0,0,0.003082060216937,1.15587423711015,0.34057236383889
8.7,"greedy_SVM","SVM",66,31,712,710,2,3200,2788,412,0.937523620559356,0.645833333333333,1.7774334251607,821,398,423,6,1.1,81.8,6.8,0,0,0,0,0,0,0.0025961387759274,0.922266854849607,0.294396849201113
8.7,"greedy_SVM","SVM",66,32,612,611,1,3300,2887,413,0.937501476284979,0.645833333333333,1.77906709558824,825,402,423,4,1.1,84.36,7,0,0,0,0,0,0,0.00209868472776464,0.689791307296641,0.242896800263299
8.7,"greedy_SVM","SVM",66,33,512,511,1,3400,2987,413,0.937451282596392,0.645833333333333,1.77906709558824,823,402,421,-2,1,86.91,7.2,0,0,0,0,0,0,0.00137470015265383,0.431279703756212,0.165755449237253
8.7,"greedy_SVM","SVM",66,34,412,411,1,3500,3087,413,0.937401088907806,0.645833333333333,1.78234346224678,822,401,421,-1,1,89.47,7.5,0,0,0,0,0,0,0.000784481162616921,0.229074772181556,0.0987632648071112
8.7,"greedy_SVM","SVM",66,35,312,312,0,3600,3186,414,0.937758349867745,0.645833333333333,1.77906709558824,828,405,423,6,1,92.02,7.7,0,0,0,0,0,0,0.000783082233861802,0.197677539443584,0.0986253799117452
8.7,"greedy_SVM","SVM",66,36,212,212,0,3700,3286,414,0.937895644368878,0.645833333333333,1.7774334251607,834,407,427,6,1,94.58,7.9,0,0,0,0,0,0,0.000347221228168392,0.0747531034545006,0.0475436504988184
8.7,"greedy_SVM","SVM",66,37,112,112,0,3800,3386,414,0.93808165627364,0.645833333333333,1.78398617511521,837,409,428,3,1,97.14,8.2,0,0,0,0,0,0,0.000123539494384713,0.0195923709699558,0.0182747789307405
8.7,"greedy_SVM","SVM",66,38,12,12,0,3900,3486,414,0.938424154383994,0.645833333333333,1.78398617511521,837,410,427,0,1,99.69,8.4,0,0,0,0,0,0,9.45406623867318e-05,0.00131400384262906,0.00131400384262906
8.7,"greedy_SVM","SVM",66,39,0,0,0,3912,3498,414,0.938409391534409,0.645833333333333,1.78398617511521,837,410,427,0,1,100,8.4,0,0,0,0,0,0,0,0,0
8.7,"greedy_SVM","SVM",67,0,3812,3414,398,100,87,13,0.856905313123366,0.420512820512821,1.68258064516129,42,13,29,0,2.2,2.56,6.7,0,0,0,0,0,0,0.167666471854909,507.1664596909,18.1653596490019
8.7,"greedy_SVM","SVM",67,1,3712,3352,360,200,149,51,0.909212423011404,0.528205128205128,1.75768525052929,108,49,59,66,1.2,5.11,2.9,0,0,0,0,0,0,0.804766582791965,510.066508386589,85.0540807423026
8.7,"greedy_SVM","SVM",67,2,3612,3325,287,300,176,124,0.911622184364956,0.523076923076923,1.75768525052929,165,79,86,57,1.1,7.67,1.4,0,0,0,0,0,0,0.555974361139255,366.656646765257,67.1222843631765
8.7,"greedy_SVM","SVM",67,3,3512,3294,218,400,207,193,0.921574280347686,0.615384615384615,1.76091628959276,228,114,114,63,1,10.22,1.1,0,0,0,0,0,0,0.425994016270961,257.421822487623,53.8151349051755
8.7,"greedy_SVM","SVM",67,4,3412,3242,170,500,259,241,0.906657056742235,0.630769230769231,1.71797705057374,318,157,161,90,1,12.78,1.1,0,0,0,0,0,0,0.261525056108497,230.415906941584,40.036868292709
8.7,"greedy_SVM","SVM",67,5,3312,3182,130,600,319,281,0.918184597912011,0.651282051282051,1.72880538816023,401,198,203,83,1,15.34,1.1,0,0,0,0,0,0,0.261473185302109,206.182484744306,36.8782008326768
8.7,"greedy_SVM","SVM",67,6,3212,3110,102,700,391,309,0.91129748540311,0.671794871794872,1.68258064516129,475,231,244,74,1.1,17.89,1.3,0,0,0,0,0,0,0.118213661684983,161.589190347445,15.699809773255
8.7,"greedy_SVM","SVM",67,7,3112,3028,84,800,473,327,0.910680120560866,0.687179487179487,1.67948482060718,524,253,271,49,1.1,20.45,1.4,0,0,0,0,0,0,0.115520338649505,163.069342345711,14.2369731848634
8.7,"greedy_SVM","SVM",67,8,3012,2940,72,900,561,339,0.921635434412254,0.671794871794872,1.73325791855204,565,271,294,41,1.1,23.01,1.7,0,0,0,0,0,0,0.100208337712434,118.305853913426,11.6000116614925
8.7,"greedy_SVM","SVM",67,9,2912,2849,63,1000,652,348,0.927830923571974,0.656410256410256,1.73007762879323,594,288,306,29,1.1,25.56,1.9,0,0,0,0,0,0,0.0820317360964066,90.3485723949971,9.12822216893618
8.7,"greedy_SVM","SVM",67,10,2812,2762,50,1100,739,361,0.934023500633372,0.656410256410256,1.74247737556561,627,303,324,33,1.1,28.12,2,0,0,0,0,0,0,0.0842230112506161,91.8879375284129,9.16619078113576
8.7,"greedy_SVM","SVM",67,11,2712,2670,42,1200,831,369,0.936038672665577,0.656410256410256,1.75654023395959,644,311,333,17,1.1,30.67,2.3,0,0,0,0,0,0,0.0767420189082529,81.1286473073931,8.39515797918473
8.7,"greedy_SVM","SVM",67,12,2612,2576,36,1300,925,375,0.937436479855546,0.661538461538462,1.75654023395959,655,317,338,11,1.1,33.23,2.5,0,0,0,0,0,0,0.0664031901572992,66.4575009845035,7.30135497870046
8.7,"greedy_SVM","SVM",67,13,2512,2484,28,1400,1017,383,0.939967093289062,0.661538461538462,1.76253626778006,682,325,357,27,1.1,35.79,2.7,0,0,0,0,0,0,0.0611953430287808,63.9681839832098,6.71954954735485
8.7,"greedy_SVM","SVM",67,14,2412,2389,23,1500,1112,388,0.94010396190975,0.661538461538462,1.75654023395959,694,331,363,12,1.1,38.34,2.9,0,0,0,0,0,0,0.0560994744250409,60.6033404757302,6.06795009688445
8.7,"greedy_SVM","SVM",67,15,2312,2295,17,1600,1206,394,0.939983109829783,0.646153846153846,1.75492279359683,706,338,368,12,1.1,40.9,3.1,0,0,0,0,0,0,0.0495550083345518,57.1560802328625,5.5167484061533
8.7,"greedy_SVM","SVM",67,16,2212,2199,13,1700,1302,398,0.940334017676432,0.651282051282051,1.75654023395959,726,345,381,20,1.1,43.46,3.3,0,0,0,0,0,0,0.041514614374662,48.5134996326665,4.51391058090156
8.7,"greedy_SVM","SVM",67,17,2112,2100,12,1800,1401,399,0.939620553589889,0.651282051282051,1.75654023395959,727,346,381,1,1.1,46.01,3.5,0,0,0,0,0,0,0.0369630583860998,41.5449785670656,3.92190114059383
8.7,"greedy_SVM","SVM",67,18,2012,2002,10,1900,1499,401,0.939119672680148,0.641025641025641,1.75654023395959,732,348,384,5,1.1,48.57,3.7,0,0,0,0,0,0,0.0303375388652245,33.2584747552942,3.25396148648126
8.7,"greedy_SVM","SVM",67,19,1912,1902,10,2000,1599,401,0.938647912753534,0.641025641025641,1.75330832920529,735,352,383,3,1.1,51.12,4,0,0,0,0,0,0,0.0242854095852266,25.6211268923264,2.57809049188922
8.7,"greedy_SVM","SVM",67,20,1812,1802,10,2100,1699,401,0.939099287991959,0.646153846153846,1.77503013115916,736,353,383,1,1.1,53.68,4.2,0,0,0,0,0,0,0.0199061460054677,19.0184412099552,2.03848306426382
8.7,"greedy_SVM","SVM",67,21,1712,1703,9,2200,1798,402,0.93803054791129,0.666666666666667,1.76851027760119,753,366,387,17,1.1,56.24,4.5,0,0,0,0,0,0,0.0159588825314274,11.8612702691998,2.07992728969713
8.7,"greedy_SVM","SVM",67,22,1612,1605,7,2300,1896,404,0.938091701975848,0.666666666666667,1.77176420635482,760,370,390,7,1.1,58.79,4.7,0,0,0,0,0,0,0.0117594953332977,9.97669621033108,1.36948962965905
8.7,"greedy_SVM","SVM",67,23,1512,1505,7,2400,1996,404,0.938026179763819,0.666666666666667,1.77013574660633,763,370,393,3,1.1,61.35,4.9,0,0,0,0,0,0,0.00951183774750479,8.02592526818308,1.00840657824446
8.7,"greedy_SVM","SVM",67,24,1412,1406,6,2500,2095,405,0.938397472298658,0.666666666666667,1.77339566510837,770,374,396,7,1.1,63.91,5.2,0,0,0,0,0,0,0.00797141674236972,6.31625064919332,0.862039889663489
8.7,"greedy_SVM","SVM",67,25,1312,1307,5,2600,2194,406,0.938886704815155,0.666666666666667,1.77013574660633,781,379,402,11,1.1,66.46,5.4,0,0,0,0,0,0,0.00710396833639829,5.1427370917691,0.739897200972184
8.7,"greedy_SVM","SVM",67,26,1212,1207,5,2700,2294,406,0.939294398578897,0.671794871794872,1.76851027760119,787,381,406,6,1.1,69.02,5.7,0,0,0,0,0,0,0.00603157032415013,3.9701035551389,0.669632554575548
8.7,"greedy_SVM","SVM",67,27,1112,1108,4,2800,2393,407,0.9391313210734,0.671794871794872,1.76851027760119,790,383,407,3,1.1,71.57,5.9,0,0,0,0,0,0,0.00594025824514422,3.53718645651677,0.604691956890939
8.7,"greedy_SVM","SVM",67,28,1012,1009,3,2900,2492,408,0.939324975611165,0.676923076923077,1.77013574660633,800,389,411,10,1.1,74.13,6.1,0,0,0,0,0,0,0.0046799087797456,2.56653328735956,0.513176953409193
8.7,"greedy_SVM","SVM",67,29,912,909,3,3000,2592,408,0.93934244820104,0.676923076923077,1.76688779110797,801,389,412,1,1.1,76.69,6.4,0,0,0,0,0,0,0.00387323234232597,1.77535689470765,0.397880126034171
8.7,"greedy_SVM","SVM",67,30,812,809,3,3100,2692,408,0.939179370695541,0.671794871794872,1.77013574660633,804,391,413,3,1.1,79.24,6.6,0,0,0,0,0,0,0.00336830105525468,1.33098146124653,0.369644578491569
8.7,"greedy_SVM","SVM",67,31,712,709,3,3200,2792,408,0.939148793663259,0.671794871794872,1.77176420635482,804,391,413,0,1.1,81.8,6.8,0,0,0,0,0,0,0.00281407733941802,0.936128609537019,0.309049971700449
8.7,"greedy_SVM","SVM",67,32,612,609,3,3300,2892,408,0.939243436858412,0.671794871794872,1.76688779110797,804,391,413,0,1.1,84.36,7.1,0,0,0,0,0,0,0.00192708497728916,0.5821526082981,0.233976171897015
8.7,"greedy_SVM","SVM",67,33,512,509,3,3400,2992,408,0.939233244514318,0.666666666666667,1.77013574660633,806,392,414,2,1.1,86.91,7.3,0,0,0,0,0,0,0.00105743014033777,0.314953790706321,0.138551043028157
8.7,"greedy_SVM","SVM",67,34,412,412,0,3500,3089,411,0.938767308784328,0.661538461538462,1.77503013115916,818,398,420,12,1.1,89.47,7.5,0,0,0,0,0,0,0.00125449688854507,0.384207074262255,0.16249143751599
8.7,"greedy_SVM","SVM",67,35,312,312,0,3600,3189,411,0.938614423622925,0.656410256410256,1.77339566510837,823,399,424,5,1.1,92.02,7.8,0,0,0,0,0,0,0.000872027857049493,0.225810512870626,0.107336438410235
8.7,"greedy_SVM","SVM",67,36,212,212,0,3700,3289,411,0.938615879672084,0.656410256410256,1.76851027760119,822,401,421,-1,1,94.58,8,0,0,0,0,0,0,0.000427718348198958,0.089568764950182,0.0553856529409732
8.7,"greedy_SVM","SVM",67,37,112,112,0,3800,3389,411,0.939081815402083,0.656410256410256,1.757215047726,824,403,421,2,1,97.14,8.2,0,0,0,0,0,0,0.000162632742671296,0.026468582431546,0.0248330834468876
8.7,"greedy_SVM","SVM",67,38,12,12,0,3900,3489,411,0.939145881564958,0.651282051282051,1.7636517328825,827,404,423,3,1,99.69,8.5,0,0,0,0,0,0,9.27862375862544e-05,0.00155887785093822,0.00155887785093822
8.7,"greedy_SVM","SVM",67,39,0,0,0,3912,3501,411,0.939073079107147,0.651282051282051,1.77176420635482,828,404,424,1,1,100,8.5,0,0,0,0,0,0,0,0,0
8.7,"greedy_SVM","SVM",68,0,3812,3398,414,100,89,11,0.897159754104749,0.50828729281768,1.76475239495159,27,11,16,0,1.5,2.56,8.1,0,0,0,0,0,0,0.810355503878333,571.005451453336,84.5173941895423
8.7,"greedy_SVM","SVM",68,1,3712,3376,336,200,111,89,0.906464866547358,0.535911602209945,1.75135069137084,82,43,39,55,0.9,5.11,1.2,0,0,0,0,0,0,0.676884065945528,309.313155991635,74.8483123537644
8.7,"greedy_SVM","SVM",68,2,3612,3345,267,300,142,158,0.89915492957748,0.530386740331492,1.7314489789689,148,77,71,66,0.9,7.67,0.9,0,0,0,0,0,0,0.5,265.32655061298,59.8627875682452
8.7,"greedy_SVM","SVM",68,3,3512,3309,203,400,178,222,0.893198972842607,0.541436464088398,1.7183336041599,221,117,104,73,0.9,10.22,0.8,0,0,0,0,0,0,0.33639348613987,135.914717295969,42.5645969286767
8.7,"greedy_SVM","SVM",68,4,3412,3244,168,500,243,257,0.884510154851758,0.585635359116022,1.67020589894636,319,162,157,98,1,12.78,0.9,0,0,0,0,0,0,0.185627666287092,109.222787028813,27.533509120598
8.7,"greedy_SVM","SVM",68,5,3312,3182,130,600,305,295,0.85970274686796,0.613259668508287,1.59067228471082,407,203,204,88,1,15.34,1,0,0,0,0,0,0,0.209237686816271,165.980425156508,29.8678531732587
8.7,"greedy_SVM","SVM",68,6,3212,3103,109,700,384,316,0.865442378025061,0.607734806629834,1.59213699215531,464,225,239,57,1.1,17.89,1.2,0,0,0,0,0,0,0.115555186993976,115.66902675328,16.30877622624
8.7,"greedy_SVM","SVM",68,7,3112,3025,87,800,462,338,0.855545871916591,0.61878453038674,1.55941257718557,507,245,262,43,1.1,20.45,1.4,0,0,0,0,0,0,0.0811206933540234,121.839158777766,12.27032261626
8.7,"greedy_SVM","SVM",68,8,3012,2943,69,900,544,356,0.862728192358582,0.61878453038674,1.58218613595434,559,264,295,52,1.1,23.01,1.5,0,0,0,0,0,0,0.0812272177956413,119.226670070651,9.73298121749582
8.7,"greedy_SVM","SVM",68,9,2912,2850,62,1000,637,363,0.872571784296954,0.607734806629834,1.61900796230094,574,276,298,15,1.1,25.56,1.8,0,0,0,0,0,0,0.0624168135706383,86.8682481485262,7.14956285862603
8.7,"greedy_SVM","SVM",68,10,2812,2757,55,1100,730,370,0.880289471636446,0.613259668508287,1.63043909182859,590,285,305,16,1.1,28.12,2,0,0,0,0,0,0,0.0521317803181958,73.8172414535844,5.64815261568429
8.7,"greedy_SVM","SVM",68,11,2712,2665,47,1200,822,378,0.893868181464485,0.613259668508287,1.64578032338182,614,296,318,24,1.1,30.67,2.2,0,0,0,0,0,0,0.0453401556995136,67.8498785305274,5.01565947122543
8.7,"greedy_SVM","SVM",68,12,2612,2573,39,1300,914,386,0.900178974398889,0.61878453038674,1.64578032338182,631,306,325,17,1.1,33.23,2.4,0,0,0,0,0,0,0.0465578175078184,70.2626302880215,4.92797887704952
8.7,"greedy_SVM","SVM",68,13,2512,2474,38,1400,1013,387,0.911384328067868,0.602209944751381,1.68853591160221,647,318,329,16,1,35.79,2.6,0,0,0,0,0,0,0.0340521834650849,42.3831157121754,4.03349109851435
8.7,"greedy_SVM","SVM",68,14,2412,2378,34,1500,1109,391,0.915729515212837,0.607734806629834,1.69379807667961,661,322,339,14,1.1,38.34,2.8,0,0,0,0,0,0,0.0325557864410038,43.7955039968195,3.66888731031469
8.7,"greedy_SVM","SVM",68,15,2312,2285,27,1600,1202,398,0.924065053303261,0.613259668508287,1.7497395131819,685,334,351,24,1.1,40.9,3,0,0,0,0,0,0,0.0552242576665571,45.8159034379564,6.47413684338348
8.7,"greedy_SVM","SVM",68,16,2212,2186,26,1700,1301,399,0.924342074546742,0.602209944751381,1.75296483947348,698,339,359,13,1.1,43.46,3.3,0,0,0,0,0,0,0.0406906801321232,33.907523542349,4.61585313785813
8.7,"greedy_SVM","SVM",68,17,2112,2091,21,1800,1396,404,0.925590226441534,0.596685082872928,1.7497395131819,713,346,367,15,1.1,46.01,3.5,0,0,0,0,0,0,0.0394601628275969,30.8253183459929,4.47129996516847
8.7,"greedy_SVM","SVM",68,18,2012,1996,16,1900,1491,409,0.925705392576468,0.596685082872928,1.76637292056679,725,353,372,12,1.1,48.57,3.6,0,0,0,0,0,0,0.032039459449222,25.7206648547836,4.09486402768053
8.7,"greedy_SVM","SVM",68,19,1912,1902,10,2000,1585,415,0.925641584312522,0.596685082872928,1.76799642508937,743,359,384,18,1.1,51.12,3.8,0,0,0,0,0,0,0.0256451214409908,23.8923197374408,3.26890102057735
8.7,"greedy_SVM","SVM",68,20,1812,1802,10,2100,1685,415,0.925633802816918,0.596685082872928,1.76962291674079,742,359,383,-1,1.1,53.68,4.1,0,0,0,0,0,0,0.0203401643244005,19.3971273382542,2.17348000338277
8.7,"greedy_SVM","SVM",68,21,1712,1703,9,2200,1784,416,0.92534744377871,0.596685082872928,1.77956461852023,759,368,391,17,1.1,56.24,4.3,0,0,0,0,0,0,0.0140396002602719,12.847306160159,1.70633419696324
8.7,"greedy_SVM","SVM",68,22,1612,1606,6,2300,1881,419,0.926131818535539,0.602209944751381,1.77792898927527,768,373,395,9,1.1,58.79,4.5,0,0,0,0,0,0,0.0153679955659147,12.2174491065093,1.57141288792749
8.7,"greedy_SVM","SVM",68,23,1512,1506,6,2400,1981,419,0.92760096490547,0.602209944751381,1.77956461852023,785,383,402,17,1,61.35,4.7,0,0,0,0,0,0,0.0116256053560867,7.72550548248563,1.38620408778135
8.7,"greedy_SVM","SVM",68,24,1412,1407,5,2500,2080,420,0.927653879075574,0.602209944751381,1.77956461852023,786,384,402,1,1,63.91,5,0,0,0,0,0,0,0.00877554806376786,6.49335125519665,1.00484200360281
8.7,"greedy_SVM","SVM",68,25,1312,1307,5,2600,2180,420,0.927400202318902,0.602209944751381,1.77792898927527,785,384,401,-1,1,66.46,5.2,0,0,0,0,0,0,0.00763099747106739,5.09502095460243,0.78605810047264
8.7,"greedy_SVM","SVM",68,26,1212,1207,5,2700,2280,420,0.927716131040402,0.607734806629834,1.77629636394076,792,390,402,7,1,69.02,5.4,0,0,0,0,0,0,0.00634466899940863,4.02909659953825,0.699146768351666
8.7,"greedy_SVM","SVM",68,27,1112,1109,3,2800,2378,422,0.927877986148953,0.607734806629834,1.77956461852023,801,392,409,9,1,71.57,5.6,0,0,0,0,0,0,0.00628522523418135,3.41716360310447,0.663105168131356
8.7,"greedy_SVM","SVM",68,28,1012,1009,3,2900,2478,422,0.92778149560347,0.607734806629834,1.77956461852023,809,395,414,8,1,74.13,5.9,0,0,0,0,0,0,0.0047947181499006,2.42968190742541,0.517967030681722
8.7,"greedy_SVM","SVM",68,29,912,910,2,3000,2577,423,0.927397089720659,0.613259668508287,1.77792898927527,809,396,413,0,1,76.69,6.1,0,0,0,0,0,0,0.00427056448624151,1.99504497011516,0.46019172657333
8.7,"greedy_SVM","SVM",68,30,812,811,1,3100,2676,424,0.927205664928814,0.613259668508287,1.77956461852023,811,399,412,2,1,79.24,6.3,0,0,0,0,0,0,0.00383076441644543,1.64605604704916,0.41499652444964
8.7,"greedy_SVM","SVM",68,31,712,711,1,3200,2776,424,0.927155863356952,0.613259668508287,1.77956461852023,814,399,415,3,1,81.8,6.5,0,0,0,0,0,0,0.00313294173563316,1.18736888694391,0.340289396280407
8.7,"greedy_SVM","SVM",68,32,612,611,1,3300,2876,424,0.927197883433211,0.613259668508287,1.77792898927527,813,399,414,-1,1,84.36,6.8,0,0,0,0,0,0,0.00254466717370903,0.866439926745982,0.283853948942517
8.7,"greedy_SVM","SVM",68,33,512,511,1,3400,2976,424,0.927278810987487,0.613259668508287,1.77792898927527,813,399,414,0,1,86.91,7,0,0,0,0,0,0,0.00171488021383528,0.519473219289119,0.199494277575998
8.7,"greedy_SVM","SVM",68,34,412,412,0,3500,3075,425,0.927555832230969,0.607734806629834,1.77792898927527,818,399,419,5,1.1,89.47,7.2,0,0,0,0,0,0,0.00135033659092343,0.407134750679505,0.168666779707805
8.7,"greedy_SVM","SVM",68,35,312,312,0,3600,3175,425,0.927714574741279,0.607734806629834,1.77466673424908,824,401,423,6,1.1,92.02,7.5,0,0,0,0,0,0,0.000929110656706651,0.234326925173732,0.111114244985034
8.7,"greedy_SVM","SVM",68,36,212,212,0,3700,3275,425,0.927926231421692,0.607734806629834,1.78120325997375,821,401,420,-3,1,94.58,7.7,0,0,0,0,0,0,0.000528662729384165,0.113908156409265,0.0699806746362499
8.7,"greedy_SVM","SVM",68,37,112,112,0,3800,3375,425,0.927865535755985,0.607734806629834,1.77956461852023,824,402,422,3,1,97.14,7.9,0,0,0,0,0,0,0.000275313401760824,0.0415987756423114,0.0386711205754986
8.7,"greedy_SVM","SVM",68,38,12,12,0,3900,3475,425,0.928004046377727,0.607734806629834,1.77792898927527,825,403,422,1,1,99.69,8.2,0,0,0,0,0,0,0.000207878474398337,0.00307294058519602,0.00307294058519602
8.7,"greedy_SVM","SVM",68,39,0,0,0,3912,3487,425,0.928112987316175,0.607734806629834,1.77466673424908,825,403,422,0,1,100,8.2,0,0,0,0,0,0,0,0,0
8.7,"greedy_SVM","SVM",69,0,3812,3412,400,100,89,11,0.863192533379924,0.502564102564103,1.64560085076214,31,11,20,0,1.8,2.56,8.1,0,0,0,0,0,0,0.220414870647783,355.376130539197,25.1059949756755
8.7,"greedy_SVM","SVM",69,1,3712,3370,342,200,131,69,0.914323155549723,0.574358974358974,1.725624513481,109,52,57,78,1.1,5.11,1.9,0,0,0,0,0,0,0.745751091186686,353.09860595352,82.4067021573997
8.7,"greedy_SVM","SVM",69,2,3612,3347,265,300,154,146,0.901386158796715,0.564102564102564,1.71797705057374,151,77,74,42,1,7.67,1.1,0,0,0,0,0,0,0.47878291438291,194.800493067778,65.5747911006948
8.7,"greedy_SVM","SVM",69,3,3512,3292,220,400,209,191,0.91577338050931,0.615384615384615,1.77176420635482,237,117,120,86,1,10.22,1.1,0,0,0,0,0,0,0.257189378913173,111.209003073447,40.6124882794208
8.7,"greedy_SVM","SVM",69,4,3412,3248,164,500,253,247,0.858696253585529,0.635897435897436,1.61786600496278,326,163,163,89,1,12.78,1,0,0,0,0,0,0,0.264082039912319,117.337489856872,39.1520025026262
8.7,"greedy_SVM","SVM",69,5,3312,3178,134,600,323,277,0.882756009842895,0.641025641025641,1.62262443438914,398,196,202,72,1,15.34,1.2,0,0,0,0,0,0,0.0993932751106921,51.3551601350338,16.4994083348475
8.7,"greedy_SVM","SVM",69,6,3212,3117,95,700,384,316,0.865560069307928,0.666666666666667,1.59013115916342,489,238,251,91,1.1,17.89,1.2,0,0,0,0,0,0,0.0936306973854499,94.7531107055555,15.8456123484483
8.7,"greedy_SVM","SVM",69,7,3112,3036,76,800,465,335,0.880170066541456,0.671794871794872,1.61786600496278,539,257,282,50,1.1,20.45,1.4,0,0,0,0,0,0,0.076350699720682,83.6606467729846,9.74125296918915
8.7,"greedy_SVM","SVM",69,8,3012,2948,64,900,553,347,0.885516679043098,0.676923076923077,1.61786600496278,567,268,299,28,1.1,23.01,1.6,0,0,0,0,0,0,0.0521419357055472,69.1192473790299,6.14238485112045
8.7,"greedy_SVM","SVM",69,9,2912,2856,56,1000,645,355,0.889238340686396,0.671794871794872,1.61816258901502,589,281,308,22,1.1,25.56,1.8,0,0,0,0,0,0,0.0533392818462987,76.6575619532981,5.71851252905147
8.7,"greedy_SVM","SVM",69,10,2812,2761,51,1100,740,360,0.92145342826772,0.651282051282051,1.69638009049774,622,302,320,33,1.1,28.12,2.1,0,0,0,0,0,0,0.0454982295090261,41.0596810751671,5.84138649406938
8.7,"greedy_SVM","SVM",69,11,2712,2671,41,1200,830,370,0.934699107441854,0.646153846153846,1.74087730451367,651,314,337,29,1.1,30.67,2.2,0,0,0,0,0,0,0.0382403282423579,43.5314944976156,4.60014312726903
8.7,"greedy_SVM","SVM",69,12,2612,2578,34,1300,923,377,0.940996520042514,0.646153846153846,1.78263210086415,662,322,340,11,1.1,33.23,2.4,0,0,0,0,0,0,0.0692037249461789,65.9529730540365,8.52593388551135
8.7,"greedy_SVM","SVM",69,13,2512,2481,31,1400,1020,380,0.944409499264697,0.646153846153846,1.79779411764706,680,334,346,18,1,35.79,2.7,0,0,0,0,0,0,0.0539492678757793,47.5741459905977,6.0227679803592
8.7,"greedy_SVM","SVM",69,14,2412,2384,28,1500,1117,383,0.945424365526582,0.641025641025641,1.79614325068871,688,336,352,8,1,38.34,2.9,0,0,0,0,0,0,0.0437136051740868,35.0715686591264,4.89412464446967
8.7,"greedy_SVM","SVM",69,15,2312,2289,23,1600,1212,388,0.945834971388638,0.641025641025641,1.79614325068871,708,344,364,20,1.1,40.9,3.1,0,0,0,0,0,0,0.0485101616900427,34.9238373623943,5.48790116229551
8.7,"greedy_SVM","SVM",69,16,2212,2193,19,1700,1308,392,0.945245271480368,0.641025641025641,1.78202310510003,722,349,373,14,1.1,43.46,3.3,0,0,0,0,0,0,0.0381897676632971,27.4875671151052,4.78862201153449
8.7,"greedy_SVM","SVM",69,17,2112,2098,14,1800,1403,397,0.94568063017807,0.641025641025641,1.78857466063348,729,354,375,7,1.1,46.01,3.5,0,0,0,0,0,0,0.0285972759269014,24.9975696983076,3.90232496616798
8.7,"greedy_SVM","SVM",69,18,2012,2000,12,1900,1501,399,0.945912141993907,0.641025641025641,1.78857466063348,737,358,379,8,1.1,48.57,3.8,0,0,0,0,0,0,0.0229232153876513,22.1910051580655,2.62011744120363
8.7,"greedy_SVM","SVM",69,19,1912,1900,12,2000,1601,399,0.945817498798753,0.641025641025641,1.78365649016428,736,358,378,-1,1.1,51.12,4,0,0,0,0,0,0,0.0170682531271918,16.8765473462537,1.86526422792713
8.7,"greedy_SVM","SVM",69,20,1812,1801,11,2100,1700,400,0.945849531880191,0.641025641025641,1.79022008350435,737,361,376,1,1,53.68,4.2,0,0,0,0,0,0,0.0175661922055295,16.1381437207567,1.7773579826158
8.7,"greedy_SVM","SVM",69,21,1712,1701,11,2200,1800,400,0.943703315423931,0.646153846153846,1.80276497695853,756,369,387,19,1,56.24,4.5,0,0,0,0,0,0,0.0135593061468929,9.80879116903036,1.65015176311605
8.7,"greedy_SVM","SVM",69,22,1612,1601,11,2300,1900,400,0.943720788013806,0.641025641025641,1.80276497695853,754,368,386,-2,1,58.79,4.8,0,0,0,0,0,0,0.00965931490135057,7.62713046705413,1.11468440308317
8.7,"greedy_SVM","SVM",69,23,1512,1504,8,2400,1997,403,0.943554798409997,0.646153846153846,1.80276497695853,760,373,387,6,1,61.35,5,0,0,0,0,0,0,0.00910017075907602,6.7786904686738,0.949749835307724
8.7,"greedy_SVM","SVM",69,24,1412,1404,8,2500,2097,403,0.94302188441882,0.641025641025641,1.80276497695853,773,378,395,13,1,63.91,5.2,0,0,0,0,0,0,0.00781225683751971,5.47026792098001,0.868941190407232
8.7,"greedy_SVM","SVM",69,25,1312,1304,8,2600,2197,403,0.943150016744567,0.641025641025641,1.79779411764706,770,377,393,-3,1,66.46,5.5,0,0,0,0,0,0,0.00645661085082989,4.15730923869469,0.671314516752101
8.7,"greedy_SVM","SVM",69,26,1212,1204,8,2700,2297,403,0.942937433567759,0.635897435897436,1.80110497237569,774,379,395,4,1,69.02,5.7,0,0,0,0,0,0,0.00573909480221342,3.41086053576179,0.61644431297621
8.7,"greedy_SVM","SVM",69,27,1112,1104,8,2800,2397,403,0.942978202944133,0.635897435897436,1.79944802207912,774,379,395,0,1,71.57,5.9,0,0,0,0,0,0,0.00481857794480379,2.4496586898702,0.498392073124898
8.7,"greedy_SVM","SVM",69,28,1012,1004,8,2900,2497,403,0.942882103699822,0.630769230769231,1.79944802207912,782,384,398,8,1,74.13,6.2,0,0,0,0,0,0,0.00422440385747154,1.9109372254685,0.452513309540108
8.7,"greedy_SVM","SVM",69,29,912,907,5,3000,2594,406,0.942797652848761,0.630769230769231,1.79944802207912,795,387,408,13,1.1,76.69,6.4,0,0,0,0,0,0,0.00427304759264293,1.78849148244089,0.46174464071371
8.7,"greedy_SVM","SVM",69,30,812,807,5,3100,2694,406,0.942595262016046,0.630769230769231,1.79779411764706,796,388,408,1,1.1,79.24,6.6,0,0,0,0,0,0,0.0030719412642893,1.12681888668165,0.342650946337478
8.7,"greedy_SVM","SVM",69,31,712,708,4,3200,2793,407,0.94283259802851,0.635897435897436,1.79614325068871,798,389,409,2,1.1,81.8,6.9,0,0,0,0,0,0,0.00270774040740741,0.8872589285376,0.31031483431656
8.7,"greedy_SVM","SVM",69,32,612,608,4,3300,2893,407,0.942887927896446,0.635897435897436,1.79449541284404,796,389,407,-2,1,84.36,7.1,0,0,0,0,0,0,0.00184869734994313,0.586850667038669,0.229743892349258
8.7,"greedy_SVM","SVM",69,33,512,510,2,3400,2991,409,0.943199522415878,0.641025641025641,1.79449541284404,805,393,412,9,1,86.91,7.3,0,0,0,0,0,0,0.00131649433096236,0.443085151923036,0.169229718398782
8.7,"greedy_SVM","SVM",69,34,412,411,1,3500,3090,410,0.943432490280873,0.641025641025641,1.79285059578368,810,395,415,5,1.1,89.47,7.5,0,0,0,0,0,0,0.00106815838532306,0.32739845228505,0.127839836405722
8.7,"greedy_SVM","SVM",69,35,312,312,0,3600,3189,411,0.943755733193554,0.635897435897436,1.79449541284404,814,398,416,4,1,92.02,7.8,0,0,0,0,0,0,0.00120538336103513,0.3132564664577,0.144992627476135
8.7,"greedy_SVM","SVM",69,36,212,212,0,3700,3289,411,0.943816887258115,0.630769230769231,1.79614325068871,820,401,419,6,1,94.58,8,0,0,0,0,0,0,0.000628602193233896,0.129264430198329,0.078469750239915
8.7,"greedy_SVM","SVM",69,37,112,112,0,3800,3389,411,0.943712051718868,0.625641025641026,1.79614325068871,824,403,421,4,1,97.14,8.2,0,0,0,0,0,0,0.000248620020947581,0.0404009354495381,0.0377473418196963
8.7,"greedy_SVM","SVM",69,38,12,12,0,3900,3489,411,0.943732436407055,0.625641025641026,1.79614325068871,826,403,423,2,1,99.69,8.5,0,0,0,0,0,0,0.000156586509799456,0.00244427546035374,0.00244427546035374
8.7,"greedy_SVM","SVM",69,39,0,0,0,3912,3501,411,0.943675650489962,0.625641025641026,1.79449541284404,826,403,423,0,1,100,8.5,0,0,0,0,0,0,0,0,0
8.7,"greedy_SVM","SVM",70,0,3812,3435,377,100,88,12,0.91082061569364,0.580645161290323,1.77958893501415,29,12,17,0,1.4,2.56,7.3,0,0,0,0,0,0,0.572969111815125,393.948807687284,63.1975184480038
8.7,"greedy_SVM","SVM",70,1,3712,3405,307,200,118,82,0.920372426549501,0.589861751152074,1.767904880719,91,44,47,62,1.1,5.11,1.4,0,0,0,0,0,0,0.714744985199112,302.09617390282,80.3276889371684
8.7,"greedy_SVM","SVM",70,2,3612,3373,239,300,150,150,0.920027930666226,0.617511520737327,1.79280494946152,151,78,73,60,0.9,7.67,1,0,0,0,0,0,0,0.438153007300856,142.141508470226,59.2796250516207
8.7,"greedy_SVM","SVM",70,3,3512,3328,184,400,195,205,0.908303145777402,0.599078341013825,1.76953428613901,239,122,117,88,1,10.22,1,0,0,0,0,0,0,0.251136156683787,89.2457354480154,36.8487689120874
8.7,"greedy_SVM","SVM",70,4,3412,3260,152,500,263,237,0.883393443448333,0.640552995391705,1.65018505250573,318,157,161,79,1,12.78,1.1,0,0,0,0,0,0,0.130444306369089,68.599597967973,21.2212551285433
8.7,"greedy_SVM","SVM",70,5,3312,3191,121,600,332,268,0.874812845986476,0.654377880184332,1.62232293610593,392,192,200,74,1,15.34,1.2,0,0,0,0,0,0,0.0889816647760836,62.9945530730793,12.0962524917091
8.7,"greedy_SVM","SVM",70,6,3212,3108,104,700,415,285,0.878989196079093,0.658986175115207,1.61168850474633,436,211,225,44,1.1,17.89,1.5,0,0,0,0,0,0,0.0643570701341277,57.491148481803,8.49036460141837
8.7,"greedy_SVM","SVM",70,7,3112,3025,87,800,498,302,0.888986201614876,0.668202764976959,1.63510451409222,478,229,249,42,1.1,20.45,1.6,0,0,0,0,0,0,0.0597361133226645,72.8380381116608,8.48810527174019
8.7,"greedy_SVM","SVM",70,8,3012,2945,67,900,578,322,0.897173278779306,0.686635944700461,1.66000458283474,522,253,269,44,1.1,23.01,1.8,0,0,0,0,0,0,0.0677945214099056,104.912638199412,8.95893273728842
8.7,"greedy_SVM","SVM",70,9,2912,2858,54,1000,665,335,0.901969721461818,0.691244239631336,1.62232293610593,563,273,290,41,1.1,25.56,2,0,0,0,0,0,0,0.0756961115076656,120.471944166136,8.81352315477221
8.7,"greedy_SVM","SVM",70,10,2812,2763,49,1100,760,340,0.911391683869364,0.682027649769585,1.66830460574891,590,286,304,27,1.1,28.12,2.2,0,0,0,0,0,0,0.0572735046781553,82.8227367689538,6.68582821390212
8.7,"greedy_SVM","SVM",70,11,2712,2670,42,1200,853,347,0.925241743361159,0.67741935483871,1.70307290449999,615,296,319,25,1.1,30.67,2.5,0,0,0,0,0,0,0.0641705852121635,83.2073844309329,7.57734653472114
8.7,"greedy_SVM","SVM",70,12,2612,2575,37,1300,948,352,0.93256890580157,0.682027649769585,1.7347047890623,634,304,330,19,1.1,33.23,2.7,0,0,0,0,0,0,0.0606467048757848,70.5059334449159,6.67561679323053
8.7,"greedy_SVM","SVM",70,13,2512,2479,33,1400,1044,356,0.935592519669385,0.682027649769585,1.74140131168947,647,309,338,13,1.1,35.79,2.9,0,0,0,0,0,0,0.0542403396625175,58.9186316487942,5.96676363740658
8.7,"greedy_SVM","SVM",70,14,2412,2382,30,1500,1141,359,0.93656240807922,0.691244239631336,1.73980075901328,655,315,340,8,1.1,38.34,3.2,0,0,0,0,0,0,0.0462292287854758,47.4606164318828,5.11149842741993
8.7,"greedy_SVM","SVM",70,15,2312,2288,24,1600,1235,365,0.938268987685594,0.682027649769585,1.7563702900515,680,321,359,25,1.1,40.9,3.4,0,0,0,0,0,0,0.0444606026847619,43.7011030241745,5.41053446623108
8.7,"greedy_SVM","SVM",70,16,2212,2195,17,1700,1328,372,0.940094815866947,0.682027649769585,1.76122661343414,696,329,367,16,1.1,43.46,3.6,0,0,0,0,0,0,0.0395940459058938,41.9286019733431,4.78164023354781
8.7,"greedy_SVM","SVM",70,17,2112,2096,16,1800,1427,373,0.940039166531957,0.67741935483871,1.75960485780482,697,331,366,1,1.1,46.01,3.8,0,0,0,0,0,0,0.0337429169279049,35.5620728522774,3.52811291852241
8.7,"greedy_SVM","SVM",70,18,2012,1996,16,1900,1527,373,0.940025916690293,0.668202764976959,1.7630346193396,697,336,361,0,1.1,48.57,4.1,0,0,0,0,0,0,0.0221108679793834,20.919743309644,2.61184336933354
8.7,"greedy_SVM","SVM",70,19,1912,1899,13,2000,1624,376,0.94066720902685,0.658986175115207,1.76627847328503,706,340,366,9,1.1,51.12,4.3,0,0,0,0,0,0,0.0213364680257765,19.9028502245063,2.21249499338929
8.7,"greedy_SVM","SVM",70,20,1812,1799,13,2100,1724,376,0.941687446835008,0.645161290322581,1.79280494946152,728,351,377,22,1.1,53.68,4.6,0,0,0,0,0,0,0.0137998410165204,10.5765116292126,1.79978755997268
8.7,"greedy_SVM","SVM",70,21,1712,1699,13,2200,1824,376,0.941493999146708,0.645161290322581,1.79280494946152,727,351,376,-1,1.1,56.24,4.9,0,0,0,0,0,0,0.00982137578555373,8.39235088734574,1.11230488889008
8.7,"greedy_SVM","SVM",70,22,1612,1602,10,2300,1921,379,0.941272726790913,0.645161290322581,1.78950935212795,734,356,378,7,1.1,58.79,5.1,0,0,0,0,0,0,0.0108645849585286,8.54563701029101,1.10875075047947
8.7,"greedy_SVM","SVM",70,23,1512,1503,9,2400,2020,380,0.940622159565192,0.640552995391705,1.7911556348806,747,365,382,13,1,61.35,5.3,0,0,0,0,0,0,0.00863716381665247,6.23838584840816,1.01890740032582
8.7,"greedy_SVM","SVM",70,24,1412,1405,7,2500,2118,382,0.941388000413394,0.640552995391705,1.7911556348806,753,367,386,6,1.1,63.91,5.5,0,0,0,0,0,0,0.0078336452273329,5.551438424306,0.838265257653533
8.7,"greedy_SVM","SVM",70,25,1312,1305,7,2600,2218,382,0.941181302883429,0.640552995391705,1.78622584872955,756,367,389,3,1.1,66.46,5.8,0,0,0,0,0,0,0.00728432981330797,4.67182755610846,0.747569439575245
8.7,"greedy_SVM","SVM",70,26,1212,1205,7,2700,2318,382,0.941030254688455,0.63594470046083,1.78622584872955,759,370,389,3,1.1,69.02,6.1,0,0,0,0,0,0,0.00607676707180854,3.47062749595618,0.654449965145223
8.7,"greedy_SVM","SVM",70,27,1112,1105,7,2800,2418,382,0.940938830780971,0.640552995391705,1.78950935212795,759,370,389,0,1.1,71.57,6.3,0,0,0,0,0,0,0.0058286404976308,2.84510089655486,0.593853350053718
8.7,"greedy_SVM","SVM",70,28,1012,1005,7,2900,2518,382,0.941350900856734,0.63594470046083,1.79445730425365,766,373,393,7,1.1,74.13,6.6,0,0,0,0,0,0,0.00430632393996373,1.82027251689561,0.466521549984962
8.7,"greedy_SVM","SVM",70,29,912,905,7,3000,2618,382,0.941328376125904,0.63594470046083,1.79280494946152,766,373,393,0,1.1,76.69,6.9,0,0,0,0,0,0,0.00371174371806066,1.35124719294111,0.406337757840778
8.7,"greedy_SVM","SVM",70,30,812,806,6,3100,2717,383,0.941344275935902,0.63594470046083,1.78950935212795,767,375,392,1,1,79.24,7.1,0,0,0,0,0,0,0.00291406402097398,0.935296753917731,0.328422678376707
8.7,"greedy_SVM","SVM",70,31,712,707,5,3200,2816,384,0.941569523244196,0.63594470046083,1.78950935212795,772,376,396,5,1.1,81.8,7.3,0,0,0,0,0,0,0.00232142877745248,0.720102365757649,0.279891402103758
8.7,"greedy_SVM","SVM",70,32,612,609,3,3300,2914,386,0.941486049241711,0.640552995391705,1.78786609285143,776,380,396,4,1,84.36,7.5,0,0,0,0,0,0,0.00188216423904304,0.613287092386365,0.238419753832339
8.7,"greedy_SVM","SVM",70,33,512,509,3,3400,3014,386,0.941660947151681,0.640552995391705,1.78458861147132,778,381,397,2,1,86.91,7.8,0,0,0,0,0,0,0.00107815116165252,0.346536239544789,0.142634802132035
8.7,"greedy_SVM","SVM",70,34,412,411,1,3500,3112,388,0.941900769285807,0.640552995391705,1.79280494946152,789,386,403,11,1,89.47,8,0,0,0,0,0,0,0.000813996520546295,0.234733073774626,0.103106640938634
8.7,"greedy_SVM","SVM",70,35,312,312,0,3600,3211,389,0.942270439868243,0.640552995391705,1.78950935212795,793,388,405,4,1,92.02,8.3,0,0,0,0,0,0,0.000684385239929723,0.167881419897413,0.0852708411957859
8.7,"greedy_SVM","SVM",70,36,212,212,0,3700,3311,389,0.942437387873215,0.640552995391705,1.7911556348806,796,388,408,3,1.1,94.58,8.5,0,0,0,0,0,0,0.000357712223525969,0.0771946445239559,0.0492170676623224
8.7,"greedy_SVM","SVM",70,37,112,112,0,3800,3411,389,0.942564586353193,0.63594470046083,1.78622584872955,800,389,411,4,1.1,97.14,8.8,0,0,0,0,0,0,0.000132202916719191,0.0223114445118842,0.0208950220121837
8.7,"greedy_SVM","SVM",70,38,12,12,0,3900,3511,389,0.942516886923201,0.63594470046083,1.78622584872955,801,389,412,1,1.1,99.69,9,0,0,0,0,0,0,0.00010199204520186,0.00140693826342472,0.00140693826342472
8.7,"greedy_SVM","SVM",70,39,0,0,0,3912,3523,389,0.942612285783184,0.63594470046083,1.78786609285143,800,389,411,-1,1.1,100,9.1,0,0,0,0,0,0,0,0,0
8.7,"greedy_SVM","SVM",71,0,3812,3403,409,100,92,8,0.774732530250351,0.259259259259259,1.56430400117036,29,8,21,0,2.6,2.56,11.5,0,0,0,0,0,0,0.136431150535283,328.311055703934,15.1107188473388
8.7,"greedy_SVM","SVM",71,1,3712,3322,390,200,173,27,0.851396711611757,0.439153439153439,1.70738058664326,80,27,53,51,2,5.11,6.4,0,0,0,0,0,0,0.253595609508759,326.523697322719,42.7729669031582
8.7,"greedy_SVM","SVM",71,2,3612,3285,327,300,210,90,0.927144623805628,0.560846560846561,1.76763304036031,157,76,81,77,1.1,7.67,2.3,0,0,0,0,0,0,0.724523598017733,394.645044614486,79.040137209945
8.7,"greedy_SVM","SVM",71,3,3512,3260,252,400,235,165,0.926857166811887,0.582010582010582,1.74862623347472,202,98,104,45,1.1,10.22,1.4,0,0,0,0,0,0,0.532287387251877,314.081948130792,63.0221505847443
8.7,"greedy_SVM","SVM",71,4,3412,3221,191,500,274,226,0.927429086455679,0.582010582010582,1.73752730449978,280,138,142,78,1,12.78,1.2,0,0,0,0,0,0,0.433816363590033,247.262879512702,55.2197327548019
8.7,"greedy_SVM","SVM",71,5,3312,3163,149,600,332,268,0.895048253848475,0.603174603174603,1.65359219904674,368,182,186,88,1,15.34,1.2,0,0,0,0,0,0,0.199687493028881,150.812836819253,29.8826338977769
8.7,"greedy_SVM","SVM",71,6,3212,3098,114,700,397,303,0.895521360150677,0.634920634920635,1.64711379798776,456,227,229,88,1,17.89,1.3,0,0,0,0,0,0,0.139138914962119,131.570207524412,18.9680791810108
8.7,"greedy_SVM","SVM",71,7,3112,3018,94,800,477,323,0.896156161011852,0.645502645502645,1.6395720681435,496,242,254,40,1,20.45,1.5,0,0,0,0,0,0,0.0942253310093735,120.953223752167,12.9137601995707
8.7,"greedy_SVM","SVM",71,8,3012,2945,67,900,550,350,0.90929833544434,0.666666666666667,1.68210240937514,562,269,293,66,1.1,23.01,1.6,0,0,0,0,0,0,0.11110619097847,170.293496276286,13.8109315636395
8.7,"greedy_SVM","SVM",71,9,2912,2855,57,1000,640,360,0.913747930159922,0.656084656084656,1.68674910111374,592,288,304,30,1.1,25.56,1.8,0,0,0,0,0,0,0.075025172335168,113.156977475019,9.05525612552039
8.7,"greedy_SVM","SVM",71,10,2812,2766,46,1100,729,371,0.917529786233797,0.656084656084656,1.74392703674472,621,301,320,29,1.1,28.12,2,0,0,0,0,0,0,0.0744663182802121,116.566687329847,8.22499100961546
8.7,"greedy_SVM","SVM",71,11,2712,2671,41,1200,824,376,0.927902192757871,0.661375661375661,1.76136446605628,646,313,333,25,1.1,30.67,2.2,0,0,0,0,0,0,0.0732523535144139,91.9104394506348,8.24268724651428
8.7,"greedy_SVM","SVM",71,12,2612,2573,39,1300,922,378,0.929797612310338,0.656084656084656,1.76298634862171,654,318,336,8,1.1,33.23,2.4,0,0,0,0,0,0,0.0610295499173083,69.7805329005124,6.57196774303262
8.7,"greedy_SVM","SVM",71,13,2512,2478,34,1400,1017,383,0.931213936873238,0.650793650793651,1.75184357705057,666,322,344,12,1.1,35.79,2.7,0,0,0,0,0,0,0.0585352797951943,59.063912165158,6.26465139546633
8.7,"greedy_SVM","SVM",71,14,2412,2383,29,1500,1112,388,0.931318738902206,0.645502645502645,1.75345669268321,681,329,352,15,1.1,38.34,2.9,0,0,0,0,0,0,0.0551181002392134,52.5827420381268,6.03830906876755
8.7,"greedy_SVM","SVM",71,15,2312,2289,23,1600,1206,394,0.933428254028133,0.645502645502645,1.75345669268321,694,335,359,13,1.1,40.9,3.1,0,0,0,0,0,0,0.0442033652668321,44.4454371100645,5.29131841507409
8.7,"greedy_SVM","SVM",71,16,2212,2198,14,1700,1297,403,0.936239942748141,0.645502645502645,1.75345669268321,721,343,378,27,1.1,43.46,3.2,0,0,0,0,0,0,0.0400335630120132,45.0308130602888,4.6316299105343
8.7,"greedy_SVM","SVM",71,17,2112,2101,11,1800,1394,406,0.935558729559854,0.645502645502645,1.75023342670401,731,347,384,10,1.1,46.01,3.4,0,0,0,0,0,0,0.0409489048356151,45.0576251490835,4.14404797571128
8.7,"greedy_SVM","SVM",71,18,2012,2002,10,1900,1493,407,0.934205286214336,0.64021164021164,1.7725160045602,757,365,392,26,1.1,48.57,3.7,0,0,0,0,0,0,0.0284675050590537,21.670049439772,3.76722755977853
8.7,"greedy_SVM","SVM",71,19,1912,1902,10,2000,1593,407,0.934133421965901,0.64021164021164,1.77088535506199,756,364,392,-1,1.1,51.12,3.9,0,0,0,0,0,0,0.0191381259439601,16.4899133738392,2.23312242753164
8.7,"greedy_SVM","SVM",71,20,1812,1804,8,2100,1691,409,0.933908846189542,0.64021164021164,1.76298634862171,756,365,391,0,1.1,53.68,4.1,0,0,0,0,0,0,0.0172375162811097,14.8354558294982,1.80668639704954
8.7,"greedy_SVM","SVM",71,21,1712,1704,8,2200,1791,409,0.934266670259874,0.64021164021164,1.76925770308123,768,371,397,12,1.1,56.24,4.4,0,0,0,0,0,0,0.0123240902162172,10.1967167192824,1.43304872512194
8.7,"greedy_SVM","SVM",71,22,1612,1605,7,2300,1890,410,0.934654437767053,0.634920634920635,1.77088535506199,769,373,396,1,1.1,58.79,4.6,0,0,0,0,0,0,0.0115262114221745,8.48791078343802,1.18537074237776
8.7,"greedy_SVM","SVM",71,23,1512,1505,7,2400,1990,410,0.934543647050717,0.64021164021164,1.77088535506199,783,381,402,14,1.1,61.35,4.9,0,0,0,0,0,0,0.00795479150069422,5.30643633581669,0.962513922545337
8.7,"greedy_SVM","SVM",71,24,1412,1406,6,2500,2089,411,0.934989804259749,0.634920634920635,1.77414965986395,784,383,401,1,1,63.91,5.1,0,0,0,0,0,0,0.0066660235609638,4.36466766155673,0.71418984820051
8.7,"greedy_SVM","SVM",71,25,1312,1308,4,2600,2187,413,0.935355114189292,0.645502645502645,1.77414965986395,788,387,401,4,1,66.46,5.3,0,0,0,0,0,0,0.00683784939431016,4.03950553622717,0.717932888557546
8.7,"greedy_SVM","SVM",71,26,1212,1208,4,2700,2287,413,0.935804265742009,0.645502645502645,1.76763304036031,797,389,408,9,1,69.02,5.5,0,0,0,0,0,0,0.00521923545343589,2.8204169032612,0.568008037654685
8.7,"greedy_SVM","SVM",71,27,1112,1108,4,2800,2387,413,0.935822231804118,0.645502645502645,1.76925770308123,797,389,408,0,1,71.57,5.8,0,0,0,0,0,0,0.00479084710033304,2.24954156485697,0.502255918170064
8.7,"greedy_SVM","SVM",71,28,1012,1008,4,2900,2487,413,0.935897090396238,0.650793650793651,1.77088535506199,798,390,408,1,1,74.13,6,0,0,0,0,0,0,0.00392938801839286,1.62248900161406,0.424039164152973
8.7,"greedy_SVM","SVM",71,29,912,908,4,3000,2587,413,0.936061779298901,0.650793650793651,1.77414965986395,798,390,408,0,1,76.69,6.3,0,0,0,0,0,0,0.00319851116547591,1.18201369472394,0.353999199542089
8.7,"greedy_SVM","SVM",71,30,812,809,3,3100,2686,414,0.93620550779577,0.650793650793651,1.77088535506199,802,392,410,4,1,79.24,6.5,0,0,0,0,0,0,0.00267976727749937,0.892084559019373,0.30325776197318
8.7,"greedy_SVM","SVM",71,31,712,709,3,3200,2786,414,0.936268389013151,0.650793650793651,1.76925770308123,802,392,410,0,1,81.8,6.7,0,0,0,0,0,0,0.00183341330650119,0.569694490195642,0.223017779653332
8.7,"greedy_SVM","SVM",71,32,612,609,3,3300,2886,414,0.936439066603183,0.645502645502645,1.77088535506199,804,392,412,2,1.1,84.36,7,0,0,0,0,0,0,0.00112588220428587,0.354640924489491,0.149767240847231
8.7,"greedy_SVM","SVM",71,33,512,509,3,3400,2986,414,0.93665615652033,0.64021164021164,1.76925770308123,807,393,414,3,1.1,86.91,7.2,0,0,0,0,0,0,0.000595111593731223,0.187023895792845,0.0796822502692747
8.7,"greedy_SVM","SVM",71,34,412,411,1,3500,3084,416,0.937406239613367,0.634920634920635,1.77088535506199,816,398,418,9,1.1,89.47,7.4,0,0,0,0,0,0,0.00072141082359863,0.215194283367274,0.0917796538427495
8.7,"greedy_SVM","SVM",71,35,312,312,0,3600,3183,417,0.938620445977546,0.634920634920635,1.76601135867191,823,404,419,7,1,92.02,7.6,0,0,0,0,0,0,0.000536996355720696,0.134945188293548,0.0661438436441992
8.7,"greedy_SVM","SVM",71,36,212,212,0,3700,3283,417,0.938852507613117,0.624338624338624,1.76277690563405,824,404,420,1,1,94.58,7.9,0,0,0,0,0,0,0.000280210749888593,0.0583782225451165,0.0366110880160083
8.7,"greedy_SVM","SVM",71,37,112,112,0,3800,3383,417,0.939310642196889,0.62962962962963,1.77387863180714,827,404,423,3,1,97.14,8.1,0,0,0,0,0,0,0.00013060921290629,0.0222041128178548,0.0208078235639645
8.7,"greedy_SVM","SVM",71,38,12,12,0,3900,3483,417,0.939640020002214,0.62962962962963,1.77387863180714,826,405,421,-1,1,99.69,8.4,0,0,0,0,0,0,0.000105277426921758,0.00151142050133355,0.00151142050133355
8.7,"greedy_SVM","SVM",71,39,0,0,0,3912,3495,417,0.939695415360382,0.62962962962963,1.77550604339595,826,405,421,0,1,100,8.4,0,0,0,0,0,0,0,0,0
8.7,"greedy_SVM","SVM",72,0,3812,3416,396,100,92,8,0.823692945121199,0.48019801980198,1.60642423689374,24,8,16,0,2,2.56,11.5,0,0,0,0,0,0,0.243149698717409,304.142423575217,37.2782022844935
8.7,"greedy_SVM","SVM",72,1,3712,3359,353,200,149,51,0.881505639161421,0.54950495049505,1.69099446709377,88,43,45,64,1,5.11,2.9,0,0,0,0,0,0,0.675986252054906,362.019965611492,74.7198236338229
8.7,"greedy_SVM","SVM",72,2,3612,3335,277,300,173,127,0.882808178195257,0.564356435643564,1.67782086964457,142,72,70,54,1,7.67,1.4,0,0,0,0,0,0,0.557301143474719,255.261014056411,65.1375430297083
8.7,"greedy_SVM","SVM",72,3,3512,3302,210,400,206,194,0.879240660668133,0.559405940594059,1.67319452533489,206,106,100,64,0.9,10.22,1.1,0,0,0,0,0,0,0.435028593501254,165.705802412521,55.6412096131431
8.7,"greedy_SVM","SVM",72,4,3412,3249,163,500,259,241,0.859560043803704,0.589108910891089,1.63169410863738,303,157,146,97,0.9,12.78,1.1,0,0,0,0,0,0,0.239384334492389,124.517921645662,34.6469046493923
8.7,"greedy_SVM","SVM",72,5,3312,3199,113,600,309,291,0.844976686950348,0.569306930693069,1.59602866363984,404,205,199,101,1,15.34,1.1,0,0,0,0,0,0,0.262329476358871,134.9997040648,36.4839197227639
8.7,"greedy_SVM","SVM",72,6,3212,3116,96,700,392,308,0.857908937986173,0.599009900990099,1.56927957989169,448,224,224,44,1,17.89,1.3,0,0,0,0,0,0,0.132282871093348,77.0678256512434,18.720393365682
8.7,"greedy_SVM","SVM",72,7,3112,3042,70,800,466,334,0.85378258464388,0.603960396039604,1.57072592051832,513,250,263,65,1.1,20.45,1.4,0,0,0,0,0,0,0.0954481439381043,74.1537979878278,11.6860614467258
8.7,"greedy_SVM","SVM",72,8,3012,2953,59,900,555,345,0.857254140465366,0.623762376237624,1.58857507870603,549,265,284,36,1.1,23.01,1.6,0,0,0,0,0,0,0.0599998278018157,53.6710848057431,7.32668267313419
8.7,"greedy_SVM","SVM",72,9,2912,2863,49,1000,645,355,0.858637117987741,0.628712871287129,1.60642423689374,567,276,291,18,1.1,25.56,1.8,0,0,0,0,0,0,0.0495495655363855,56.0663276745504,5.80889417672902
8.7,"greedy_SVM","SVM",72,10,2812,2773,39,1100,735,365,0.873597265655877,0.643564356435644,1.61386138613861,598,290,308,31,1.1,28.12,2,0,0,0,0,0,0,0.0444896002116682,59.6947341324616,5.2418062403591
8.7,"greedy_SVM","SVM",72,11,2712,2674,38,1200,834,366,0.880148063266991,0.643564356435644,1.622777747388,597,291,306,-1,1.1,30.67,2.3,0,0,0,0,0,0,0.0312371893243175,40.2955239188381,3.45184459035655
8.7,"greedy_SVM","SVM",72,12,2612,2578,34,1300,930,370,0.878591507953536,0.643564356435644,1.61534881598759,609,296,313,12,1.1,33.23,2.5,0,0,0,0,0,0,0.0322346234391721,43.2684444643638,3.52142459296146
8.7,"greedy_SVM","SVM",72,13,2512,2478,34,1400,1030,370,0.880951036950905,0.638613861386139,1.62128485157623,616,300,316,7,1.1,35.79,2.8,0,0,0,0,0,0,0.0241088380474899,30.5851998649994,2.69725127367818
8.7,"greedy_SVM","SVM",72,14,2412,2384,28,1500,1124,376,0.896180724115747,0.643564356435644,1.6747338027271,636,306,330,20,1.1,38.34,3,0,0,0,0,0,0,0.0235605969258782,31.4871040312158,2.63733042606564
8.7,"greedy_SVM","SVM",72,15,2312,2288,24,1600,1220,380,0.906990528015184,0.643564356435644,1.68209449621433,657,320,337,21,1.1,40.9,3.2,0,0,0,0,0,0,0.0291468241522318,32.6361573575235,3.64557829164849
8.7,"greedy_SVM","SVM",72,16,2212,2192,20,1700,1316,384,0.915474671754529,0.638613861386139,1.71611706625208,675,328,347,18,1.1,43.46,3.4,0,0,0,0,0,0,0.0382726338241997,32.9924466175129,4.55576218773797
8.7,"greedy_SVM","SVM",72,17,2112,2092,20,1800,1416,384,0.916737697144864,0.638613861386139,1.73549432149097,681,330,351,6,1.1,46.01,3.7,0,0,0,0,0,0,0.0289145316207955,25.3405893236937,3.25619703069637
8.7,"greedy_SVM","SVM",72,18,2012,1994,18,1900,1514,386,0.918068460209769,0.643564356435644,1.7549072294534,685,333,352,4,1.1,48.57,3.9,0,0,0,0,0,0,0.0247705785381803,20.2972213321043,2.78317314392966
8.7,"greedy_SVM","SVM",72,19,1912,1899,13,2000,1609,391,0.918584959978329,0.643564356435644,1.74279246106429,704,341,363,19,1.1,51.12,4.1,0,0,0,0,0,0,0.0262809646219266,19.3715219911543,3.41658495208831
8.7,"greedy_SVM","SVM",72,20,1812,1804,8,2100,1704,396,0.917038283075749,0.633663366336634,1.74599907092825,716,346,370,12,1.1,53.68,4.3,0,0,0,0,0,0,0.0179423143791032,15.879760992555,2.59748262333792
8.7,"greedy_SVM","SVM",72,21,1712,1706,6,2200,1802,398,0.916462512841942,0.638613861386139,1.74760680487938,721,350,371,5,1.1,56.24,4.5,0,0,0,0,0,0,0.0140802768179471,12.7195675846766,1.56681394932068
8.7,"greedy_SVM","SVM",72,22,1612,1606,6,2300,1902,398,0.91763804373597,0.633663366336634,1.76543952737815,733,354,379,12,1.1,58.79,4.8,0,0,0,0,0,0,0.0118167982747549,9.61849722221954,1.24698961906004
8.7,"greedy_SVM","SVM",72,23,1512,1506,6,2400,2002,398,0.919177664630783,0.623762376237624,1.76543952737815,741,363,378,8,1,61.35,5,0,0,0,0,0,0,0.00769773601583239,5.49818126765014,1.02344460724179
8.7,"greedy_SVM","SVM",72,24,1412,1407,5,2500,2101,399,0.918891190715434,0.633663366336634,1.76543952737815,750,366,384,9,1,63.91,5.3,0,0,0,0,0,0,0.00748664513391433,4.97770060715491,0.772042648669629
8.7,"greedy_SVM","SVM",72,25,1312,1307,5,2600,2201,399,0.919474016957007,0.618811881188119,1.76381538797854,765,371,394,15,1.1,66.46,5.5,0,0,0,0,0,0,0.00458347331114395,2.82828022382537,0.584328893217646
8.7,"greedy_SVM","SVM",72,26,1212,1208,4,2700,2300,400,0.919891732616829,0.618811881188119,1.77109420500874,766,372,394,1,1.1,69.02,5.8,0,0,0,0,0,0,0.00524816313291142,3.23292804864661,0.557399447498317
8.7,"greedy_SVM","SVM",72,27,1112,1108,4,2800,2400,400,0.919318784786127,0.618811881188119,1.77272354650368,770,373,397,4,1.1,71.57,6,0,0,0,0,0,0,0.00408631438140659,2.28329721173413,0.431309775507209
8.7,"greedy_SVM","SVM",72,28,1012,1009,3,2900,2499,401,0.919191776646317,0.618811881188119,1.77599123967696,779,380,399,9,1.1,74.13,6.2,0,0,0,0,0,0,0.00374393270770778,1.89896064548084,0.391842307599061
8.7,"greedy_SVM","SVM",72,29,912,909,3,3000,2599,401,0.919194599049423,0.613861386138614,1.77599123967696,779,380,399,0,1.1,76.69,6.5,0,0,0,0,0,0,0.00334133314608813,1.55980846085187,0.364173095595736
8.7,"greedy_SVM","SVM",72,30,812,810,2,3100,2698,402,0.919564333856428,0.618811881188119,1.77599123967696,779,381,398,0,1,79.24,6.7,0,0,0,0,0,0,0.0024702015475878,1.07572984857743,0.27275099056138
8.7,"greedy_SVM","SVM",72,31,712,710,2,3200,2798,402,0.919705454011773,0.618811881188119,1.77435588862754,779,382,397,0,1,81.8,7,0,0,0,0,0,0,0.00170034154002552,0.647527640911799,0.185999546065219
8.7,"greedy_SVM","SVM",72,32,612,610,2,3300,2898,402,0.919973582306928,0.618811881188119,1.77435588862754,781,383,398,2,1,84.36,7.2,0,0,0,0,0,0,0.00172454155146897,0.590224893608515,0.191928625439566
8.7,"greedy_SVM","SVM",72,33,512,510,2,3400,2998,402,0.920148571299556,0.618811881188119,1.77272354650368,779,383,396,-2,1,86.91,7.5,0,0,0,0,0,0,0.00106471153710001,0.326737836462443,0.125244387618254
8.7,"greedy_SVM","SVM",72,34,412,410,2,3500,3098,402,0.920320737889077,0.618811881188119,1.77599123967696,778,383,395,-1,1,89.47,7.7,0,0,0,0,0,0,0.000843807533306509,0.242944195780438,0.103290781183674
8.7,"greedy_SVM","SVM",72,35,312,312,0,3600,3196,404,0.921864592388552,0.618811881188119,1.77272354650368,790,387,403,12,1,92.02,7.9,0,0,0,0,0,0,0.000958610474523034,0.244088776266628,0.119981353557443
8.7,"greedy_SVM","SVM",72,36,212,212,0,3700,3296,404,0.922447418630127,0.618811881188119,1.77435588862754,794,391,403,4,1,94.58,8.2,0,0,0,0,0,0,0.000506362997692525,0.105660094029249,0.0650665885961756
8.7,"greedy_SVM","SVM",72,37,112,112,0,3800,3396,404,0.922573015568384,0.618811881188119,1.77599123967696,794,392,402,0,1,97.14,8.4,0,0,0,0,0,0,0.000257188223262505,0.0419307480278611,0.0390958483188299
8.7,"greedy_SVM","SVM",72,38,12,12,0,3900,3496,404,0.923100804949376,0.618811881188119,1.77109420500874,797,394,403,3,1,99.69,8.7,0,0,0,0,0,0,0.000179718989272441,0.00233779309811436,0.00233779309811436
8.7,"greedy_SVM","SVM",72,39,0,0,0,3912,3508,404,0.923320952391714,0.618811881188119,1.77272354650368,797,394,403,0,1,100,8.7,0,0,0,0,0,0,0,0,0
8.7,"greedy_SVM","SVM",73,0,3812,3414,398,100,94,6,0.908913995732527,0.504950495049505,1.76543952737815,18,6,12,0,2,2.56,15.7,0,0,0,0,0,0,0.467379312529605,279.480722786005,54.1118281910473
8.7,"greedy_SVM","SVM",73,1,3712,3377,335,200,131,69,0.920484437269273,0.579207920792079,1.7492175023954,90,45,45,72,1,5.11,1.9,0,0,0,0,0,0,0.654725907151712,252.756731358011,78.3352828857681
8.7,"greedy_SVM","SVM",73,2,3612,3355,257,300,153,147,0.921579529674756,0.594059405940594,1.73709091240311,137,69,68,47,1,7.67,1,0,0,0,0,0,0,0.434050167013985,154.624014820405,57.1024921906605
8.7,"greedy_SVM","SVM",73,3,3512,3309,203,400,199,201,0.919330074398552,0.623762376237624,1.75814208148925,234,121,113,97,0.9,10.22,1,0,0,0,0,0,0,0.27355305768111,108.09117588963,41.0125768916118
8.7,"greedy_SVM","SVM",73,4,3412,3250,162,500,258,242,0.8945296182982,0.599009900990099,1.69255011977739,315,157,158,81,1,12.78,1.1,0,0,0,0,0,0,0.253584674994374,133.467478877163,34.2968273659656
8.7,"greedy_SVM","SVM",73,5,3312,3170,142,600,338,262,0.903674204364562,0.603960396039604,1.67319452533489,368,180,188,53,1,15.34,1.3,0,0,0,0,0,0,0.0848072912716921,46.4893024805169,14.9683540408931
8.7,"greedy_SVM","SVM",73,6,3212,3099,113,700,409,291,0.90954339162537,0.623762376237624,1.68209449621433,428,207,221,60,1.1,17.89,1.4,0,0,0,0,0,0,0.0685873635549751,45.7466561183369,9.15281028436302
8.7,"greedy_SVM","SVM",73,7,3112,3012,100,800,496,304,0.910857220271624,0.633663366336634,1.69567002783228,462,221,241,34,1.1,20.45,1.6,0,0,0,0,0,0,0.0546290594778499,52.0695607763864,8.28738101478516
8.7,"greedy_SVM","SVM",73,8,3012,2932,80,900,576,324,0.915066834505571,0.663366336633663,1.68519227613369,511,247,264,49,1.1,23.01,1.8,0,0,0,0,0,0,0.0513987492931245,72.8658495011174,8.4737694255028
8.7,"greedy_SVM","SVM",73,9,2912,2846,66,1000,662,338,0.925012983054306,0.663366336633663,1.70302499863246,548,262,286,37,1.1,25.56,2,0,0,0,0,0,0,0.0449628385463283,65.3204646352066,5.22680965485396
8.7,"greedy_SVM","SVM",73,10,2812,2756,56,1100,752,348,0.934484967881063,0.653465346534653,1.74760680487938,586,279,307,38,1.1,28.12,2.2,0,0,0,0,0,0,0.0498652473232779,70.9518391198297,5.71209956044201
8.7,"greedy_SVM","SVM",73,11,2712,2665,47,1200,843,357,0.940856542894884,0.658415841584158,1.74029292330155,616,296,320,30,1.1,30.67,2.4,0,0,0,0,0,0,0.0490363835056169,62.1373925232625,5.63622812547646
8.7,"greedy_SVM","SVM",73,12,2612,2572,40,1300,936,364,0.944615983833273,0.648514851485149,1.77109420500874,644,308,336,28,1.1,33.23,2.6,0,0,0,0,0,0,0.0559486388323522,60.9719002086683,6.15428823929857
8.7,"greedy_SVM","SVM",73,13,2512,2474,38,1400,1034,366,0.94507039073349,0.653465346534653,1.77835965414723,648,311,337,4,1.1,35.79,2.8,0,0,0,0,0,0,0.0461803970841727,49.7298580924488,5.01924975311725
8.7,"greedy_SVM","SVM",73,14,2412,2377,35,1500,1131,369,0.945304650191366,0.653465346534653,1.78327224987692,655,314,341,7,1.1,38.34,3.1,0,0,0,0,0,0,0.0447500358219563,44.1590681056789,5.02195218344211
8.7,"greedy_SVM","SVM",73,15,2312,2283,29,1600,1225,375,0.944417004414246,0.653465346534653,1.78327224987692,673,322,351,18,1.1,40.9,3.3,0,0,0,0,0,0,0.0509984692036176,40.5187384903096,5.86368277324989
8.7,"greedy_SVM","SVM",73,16,2212,2194,18,1700,1314,386,0.945444359145159,0.653465346534653,1.78327224987692,704,334,370,31,1.1,43.46,3.4,0,0,0,0,0,0,0.0420274286400451,35.9880025675163,5.53475855309876
8.7,"greedy_SVM","SVM",73,17,2112,2097,15,1800,1411,389,0.945421779920304,0.648514851485149,1.78327224987692,713,338,375,9,1.1,46.01,3.6,0,0,0,0,0,0,0.0279105710316262,29.4411206908337,3.28435896242307
8.7,"greedy_SVM","SVM",73,18,2012,1997,15,1900,1511,389,0.945441536742053,0.648514851485149,1.78327224987692,712,338,374,-1,1.1,48.57,3.9,0,0,0,0,0,0,0.025703164076749,25.6085292409402,2.63280835880408
8.7,"greedy_SVM","SVM",73,19,1912,1897,15,2000,1611,389,0.943070718132252,0.638613861386139,1.79218861112631,725,353,372,13,1.1,51.12,4.1,0,0,0,0,0,0,0.0169614039948112,12.5038640629151,2.20742984722769
8.7,"greedy_SVM","SVM",73,20,1812,1799,13,2100,1709,391,0.94329509917925,0.633663366336634,1.79053986355397,734,355,379,9,1.1,53.68,4.4,0,0,0,0,0,0,0.0116258114021115,10.2637577310452,1.3794615626876
8.7,"greedy_SVM","SVM",73,21,1712,1703,9,2200,1805,395,0.942946532395549,0.638613861386139,1.77999417588818,743,363,380,9,1,56.24,4.6,0,0,0,0,0,0,0.0130843322872345,10.4401849624637,1.32479830041919
8.7,"greedy_SVM","SVM",73,22,1612,1603,9,2300,1905,395,0.942590909604076,0.643564356435644,1.78561177218639,767,371,396,24,1.1,58.79,4.8,0,0,0,0,0,0,0.00981147972684373,6.82067514720389,1.22586511358704
8.7,"greedy_SVM","SVM",73,23,1512,1504,8,2400,2004,396,0.943041082899628,0.648514851485149,1.78397509778476,772,373,399,5,1.1,61.35,5.1,0,0,0,0,0,0,0.00824423479426108,5.91747335858564,0.898402459700885
8.7,"greedy_SVM","SVM",73,24,1412,1405,7,2500,2103,397,0.943265463946627,0.648514851485149,1.78889414676762,774,374,400,2,1.1,63.91,5.3,0,0,0,0,0,0,0.00786836606122145,5.20379409403786,0.80848611231644
8.7,"greedy_SVM","SVM",73,25,1312,1305,7,2600,2203,397,0.943464443365664,0.648514851485149,1.79384039786467,778,377,401,4,1.1,66.46,5.5,0,0,0,0,0,0,0.00612519664478647,3.78054916147282,0.67868812365438
8.7,"greedy_SVM","SVM",73,26,1212,1205,7,2700,2303,397,0.94337694886935,0.648514851485149,1.79384039786467,777,377,400,-1,1.1,69.02,5.8,0,0,0,0,0,0,0.00580440384724121,3.01267361937845,0.591679619903274
8.7,"greedy_SVM","SVM",73,27,1112,1105,7,2800,2403,397,0.943889215033252,0.648514851485149,1.80110497237569,783,381,402,6,1.1,71.57,6.1,0,0,0,0,0,0,0.00457218472330039,2.15953185582068,0.510898910131651
8.7,"greedy_SVM","SVM",73,28,1012,1005,7,2900,2503,397,0.943937195886069,0.648514851485149,1.79779411764706,784,380,404,1,1.1,74.13,6.3,0,0,0,0,0,0,0.0036290296449517,1.46825111267666,0.384894687689723
8.7,"greedy_SVM","SVM",73,29,912,905,7,3000,2603,397,0.943921672668981,0.648514851485149,1.79944802207912,783,381,402,-1,1.1,76.69,6.6,0,0,0,0,0,0,0.00321874793701283,1.12045119791257,0.349547442078548
8.7,"greedy_SVM","SVM",73,30,812,805,7,3100,2703,397,0.944010578366848,0.648514851485149,1.80110497237569,786,381,405,3,1.1,79.24,6.8,0,0,0,0,0,0,0.00255934542274701,0.830650230046084,0.300740488819975
8.7,"greedy_SVM","SVM",73,31,712,706,6,3200,2802,398,0.944124885692678,0.653465346534653,1.79944802207912,788,383,405,2,1.1,81.8,7,0,0,0,0,0,0,0.00186171749029964,0.570617698066618,0.22956420660643
8.7,"greedy_SVM","SVM",73,32,612,608,4,3300,2900,400,0.944709123135806,0.648514851485149,1.79449541284404,793,385,408,5,1.1,84.36,7.2,0,0,0,0,0,0,0.00122644687823148,0.391786149520269,0.163355396020193
8.7,"greedy_SVM","SVM",73,33,512,509,3,3400,2999,401,0.945203043679515,0.648514851485149,1.79614325068871,803,391,412,10,1.1,86.91,7.5,0,0,0,0,0,0,0.000968861084166243,0.287873751549755,0.122016396863856
8.7,"greedy_SVM","SVM",73,34,412,411,1,3500,3097,403,0.945651805773512,0.648514851485149,1.78793418647166,812,394,418,9,1.1,89.47,7.7,0,0,0,0,0,0,0.000876883633094453,0.256428852183491,0.107163599098549
8.7,"greedy_SVM","SVM",73,35,312,312,0,3600,3196,404,0.945726599455845,0.648514851485149,1.79779411764706,818,397,421,6,1.1,92.02,7.9,0,0,0,0,0,0,0.0007128396615467,0.172199947622228,0.0857496173352595
8.7,"greedy_SVM","SVM",73,36,212,212,0,3700,3296,404,0.945558666470985,0.648514851485149,1.79120879120879,822,398,424,4,1.1,94.58,8.2,0,0,0,0,0,0,0.000355614292685715,0.0752970132732911,0.0475365136325381
8.7,"greedy_SVM","SVM",73,37,112,112,0,3800,3396,404,0.94578163631643,0.648514851485149,1.79944802207912,818,400,418,-4,1,97.14,8.4,0,0,0,0,0,0,0.000140266351038394,0.0221355037579193,0.0206365854782779
8.7,"greedy_SVM","SVM",73,38,12,12,0,3900,3496,404,0.945812682750606,0.648514851485149,1.79285059578368,817,400,417,-1,1,99.69,8.7,0,0,0,0,0,0,7.82828308318937e-05,0.00114241765383246,0.00114241765383246
8.7,"greedy_SVM","SVM",73,39,0,0,0,3912,3508,404,0.945753412285362,0.648514851485149,1.79285059578368,817,400,417,0,1,100,8.7,0,0,0,0,0,0,0,0,0
8.7,"greedy_SVM","SVM",74,0,3812,3424,388,100,89,11,0.892170267067732,0.541062801932367,1.74408112748034,30,11,19,0,1.7,2.56,8.1,0,0,0,0,0,0,0.472664452814757,405.940817233799,54.0514672349883
8.7,"greedy_SVM","SVM",74,1,3712,3377,335,200,136,64,0.920448675986006,0.570048309178744,1.77011218908452,120,58,62,90,1.1,5.11,2.1,0,0,0,0,0,0,0.661985129708253,372.742573780496,73.1361815578127
8.7,"greedy_SVM","SVM",74,2,3612,3356,256,300,157,143,0.918946092038793,0.589371980676328,1.77173913043478,161,82,79,41,1,7.67,1.1,0,0,0,0,0,0,0.543271377979745,268.810708890855,65.5102379613094
8.7,"greedy_SVM","SVM",74,3,3512,3309,203,400,204,196,0.90819598776941,0.584541062801932,1.74180191010486,245,126,119,84,0.9,10.22,1,0,0,0,0,0,0,0.319156663015616,160.534013074582,42.6665039032134
8.7,"greedy_SVM","SVM",74,4,3412,3260,152,500,253,247,0.902343091842694,0.623188405797101,1.75051091965538,337,171,166,92,1,12.78,1,0,0,0,0,0,0,0.283220010925512,156.6490478392,39.1669142208363
8.7,"greedy_SVM","SVM",74,5,3312,3190,122,600,323,277,0.906041547550986,0.628019323671498,1.74568414322251,405,201,204,68,1,15.34,1.2,0,0,0,0,0,0,0.154779002584106,118.481908574452,21.4135425439149
8.7,"greedy_SVM","SVM",74,6,3212,3111,101,700,402,298,0.904039022988999,0.642512077294686,1.68954785280171,456,222,234,51,1.1,17.89,1.3,0,0,0,0,0,0,0.0825246013535564,65.542651205227,11.1395798759579
8.7,"greedy_SVM","SVM",74,7,3112,3036,76,800,477,323,0.905061001041315,0.652173913043478,1.66905323787049,522,253,269,66,1.1,20.45,1.5,0,0,0,0,0,0,0.0838576567284304,106.416167014273,11.7996497993688
8.7,"greedy_SVM","SVM",74,8,3012,2957,55,900,556,344,0.904091502943026,0.657004830917874,1.65318813889556,579,274,305,57,1.1,23.01,1.6,0,0,0,0,0,0,0.0900185810990954,128.41628831877,11.127179959732
8.7,"greedy_SVM","SVM",74,9,2912,2862,50,1000,651,349,0.912460674560766,0.657004830917874,1.6864392090983,595,285,310,16,1.1,25.56,1.9,0,0,0,0,0,0,0.0665826347335505,90.8702474757609,7.66245038747351
8.7,"greedy_SVM","SVM",74,10,2812,2772,40,1100,741,359,0.923288117709774,0.666666666666667,1.72121115155394,627,300,327,32,1.1,28.12,2.1,0,0,0,0,0,0,0.0643679659992431,82.4757121043398,7.45375163054259
8.7,"greedy_SVM","SVM",74,11,2712,2680,32,1200,833,367,0.926561209580089,0.666666666666667,1.72990413716785,649,309,340,22,1.1,30.67,2.3,0,0,0,0,0,0,0.0599011109623563,68.2246208733846,6.36183937075106
8.7,"greedy_SVM","SVM",74,12,2612,2582,30,1300,931,369,0.927109486994652,0.661835748792271,1.7401980409427,661,314,347,12,1.1,33.23,2.5,0,0,0,0,0,0,0.0542133922277144,59.083610518427,5.74462324411186
8.7,"greedy_SVM","SVM",74,13,2512,2486,26,1400,1027,373,0.926804274630374,0.661835748792271,1.74729010839566,675,320,355,14,1.1,35.79,2.8,0,0,0,0,0,0,0.0541179843948398,50.8272253739903,6.53912378608782
8.7,"greedy_SVM","SVM",74,14,2412,2390,22,1500,1123,377,0.927751675905912,0.666666666666667,1.74568414322251,686,325,361,11,1.1,38.34,3,0,0,0,0,0,0,0.0416552174250603,40.1477393623202,4.9187427377003
8.7,"greedy_SVM","SVM",74,15,2312,2296,16,1600,1217,383,0.927863541071096,0.676328502415459,1.74889903114741,705,331,374,19,1.1,40.9,3.2,0,0,0,0,0,0,0.0399457162046878,40.7855339644302,4.7515949809114
8.7,"greedy_SVM","SVM",74,16,2212,2200,12,1700,1313,387,0.92719235007997,0.671497584541063,1.74568414322251,715,338,377,10,1.1,43.46,3.4,0,0,0,0,0,0,0.0330731842576752,34.5255431495353,3.60902515423624
8.7,"greedy_SVM","SVM",74,17,2112,2100,12,1800,1413,387,0.926953428183955,0.666666666666667,1.74568414322251,714,339,375,-1,1.1,46.01,3.7,0,0,0,0,0,0,0.0238940579097372,24.8713024040027,2.6023469528848
8.7,"greedy_SVM","SVM",74,18,2012,2001,11,1900,1512,388,0.926722792596471,0.671497584541063,1.74889903114741,722,341,381,8,1.1,48.57,3.9,0,0,0,0,0,0,0.0216496050823174,22.8673218309947,2.31401937179895
8.7,"greedy_SVM","SVM",74,19,1912,1902,10,2000,1611,389,0.92593697433732,0.666666666666667,1.7592199292059,731,344,387,9,1.1,51.12,4.1,0,0,0,0,0,0,0.0197594076709666,19.8898272085437,2.08189465205672
8.7,"greedy_SVM","SVM",74,20,1812,1802,10,2100,1711,389,0.925448082133907,0.652173913043478,1.7592199292059,739,355,384,8,1.1,53.68,4.4,0,0,0,0,0,0,0.014018514688993,13.3853184434303,1.63030555796323
8.7,"greedy_SVM","SVM",74,21,1712,1703,9,2200,1810,390,0.925122153998301,0.652173913043478,1.75598309400957,739,356,383,0,1.1,56.24,4.6,0,0,0,0,0,0,0.013556095033135,11.5285552362635,1.36335894756433
8.7,"greedy_SVM","SVM",74,22,1612,1603,9,2300,1910,390,0.928014075676104,0.652173913043478,1.78370299196626,754,368,386,15,1,58.79,4.9,0,0,0,0,0,0,0.0102655206898523,6.64223490255148,1.31725788406924
8.7,"greedy_SVM","SVM",74,23,1512,1504,8,2400,2009,391,0.927856635813989,0.647342995169082,1.7820620508513,757,369,388,3,1.1,61.35,5.1,0,0,0,0,0,0,0.00738784930610804,5.39133386921529,0.855966210438681
8.7,"greedy_SVM","SVM",74,24,1412,1405,7,2500,2108,392,0.928377292200108,0.647342995169082,1.78042412617221,759,370,389,2,1.1,63.91,5.4,0,0,0,0,0,0,0.00605326180955307,4.16630031403527,0.637773643579654
8.7,"greedy_SVM","SVM",74,25,1312,1305,7,2600,2208,392,0.928779178163925,0.647342995169082,1.78370299196626,763,375,388,4,1,66.46,5.6,0,0,0,0,0,0,0.00574514001647655,3.67440470501807,0.607470544855601
8.7,"greedy_SVM","SVM",74,26,1212,1205,7,2700,2308,392,0.92911615471091,0.642512077294686,1.7755283678051,769,376,393,6,1,69.02,5.9,0,0,0,0,0,0,0.00427484063917999,2.4178880755332,0.446412286283082
8.7,"greedy_SVM","SVM",74,27,1112,1105,7,2800,2408,392,0.92951251646904,0.642512077294686,1.78042412617221,771,377,394,2,1,71.57,6.1,0,0,0,0,0,0,0.00359982858866072,1.78079751882025,0.377213793138268
8.7,"greedy_SVM","SVM",74,28,1012,1005,7,2900,2508,392,0.929828777244693,0.642512077294686,1.7820620508513,777,378,399,6,1.1,74.13,6.4,0,0,0,0,0,0,0.00356836742115644,1.53967162041268,0.373904543503342
8.7,"greedy_SVM","SVM",74,29,912,906,6,3000,2607,393,0.929868827735932,0.642512077294686,1.78042412617221,780,380,400,3,1.1,76.69,6.6,0,0,0,0,0,0,0.00284230706479044,1.13210138978296,0.311188312912571
8.7,"greedy_SVM","SVM",74,30,812,808,4,3100,2705,395,0.929964120284054,0.642512077294686,1.78042412617221,783,384,399,3,1,79.24,6.8,0,0,0,0,0,0,0.00217886354760715,0.775773170774956,0.245531114845121
8.7,"greedy_SVM","SVM",74,31,712,708,4,3200,2805,395,0.929913021381437,0.642512077294686,1.78042412617221,784,384,400,1,1,81.8,7.1,0,0,0,0,0,0,0.00173523097385907,0.569801834015273,0.203262408154486
8.7,"greedy_SVM","SVM",74,32,612,609,3,3300,2904,396,0.929864684581665,0.63768115942029,1.78534695785748,787,386,401,3,1,84.36,7.3,0,0,0,0,0,0,0.00167394999394532,0.530775719783689,0.203046948866561
8.7,"greedy_SVM","SVM",74,33,512,509,3,3400,3004,396,0.930109130683371,0.63768115942029,1.78370299196626,795,388,407,8,1,86.91,7.6,0,0,0,0,0,0,0.000832844752173016,0.253987597871909,0.108809937657506
8.7,"greedy_SVM","SVM",74,34,412,411,1,3500,3102,398,0.930903235251062,0.63768115942029,1.78370299196626,803,390,413,8,1.1,89.47,7.8,0,0,0,0,0,0,0.000929788974038264,0.270263834444238,0.116214881286322
8.7,"greedy_SVM","SVM",74,35,312,312,0,3600,3201,399,0.93155509152228,0.63768115942029,1.77878920961925,809,393,416,6,1.1,92.02,8,0,0,0,0,0,0,0.000795343335710767,0.202836604010706,0.099882177740972
8.7,"greedy_SVM","SVM",74,36,212,212,0,3700,3301,399,0.931762249235591,0.63768115942029,1.7820620508513,808,394,414,-1,1.1,94.58,8.3,0,0,0,0,0,0,0.000281007809358631,0.0588401045378975,0.0380297409153192
8.7,"greedy_SVM","SVM",74,37,112,112,0,3800,3401,399,0.932103368936841,0.63768115942029,1.77390242607634,810,396,414,2,1,97.14,8.5,0,0,0,0,0,0,0.000153461060080962,0.0261498561324947,0.0245617506368143
8.7,"greedy_SVM","SVM",74,38,12,12,0,3900,3501,399,0.932215234102027,0.63768115942029,1.77878920961925,812,396,416,2,1.1,99.69,8.8,0,0,0,0,0,0,9.76167242930991e-05,0.00136097884175312,0.00136097884175312
8.7,"greedy_SVM","SVM",74,39,0,0,0,3912,3513,399,0.932249760387578,0.63768115942029,1.78370299196626,813,396,417,1,1.1,100,8.8,0,0,0,0,0,0,0,0,0
8.7,"greedy_SVM","SVM",75,0,3812,3432,380,100,84,16,0.909376534118801,0.533333333333333,1.75337793519612,36,16,20,0,1.2,2.56,5.2,0,0,0,0,0,0,0.7498680792689,510.145312070324,79.0786785779939
8.7,"greedy_SVM","SVM",75,1,3712,3406,306,200,110,90,0.91481754213713,0.561904761904762,1.7770111915734,85,41,44,49,1.1,5.11,1.2,0,0,0,0,0,0,0.734342462490556,293.062488445236,81.0790336489961
8.7,"greedy_SVM","SVM",75,2,3612,3372,240,300,144,156,0.91956717394862,0.547619047619048,1.78923319327731,152,78,74,67,0.9,7.67,0.9,0,0,0,0,0,0,0.433528918098503,161.603661710639,56.8474202108199
8.7,"greedy_SVM","SVM",75,3,3512,3326,186,400,190,210,0.905293732613314,0.576190476190476,1.73946642134315,241,127,114,89,0.9,10.22,0.9,0,0,0,0,0,0,0.244549002038822,102.660237672144,37.3142507241919
8.7,"greedy_SVM","SVM",75,4,3412,3262,150,500,254,246,0.890710740195271,0.580952380952381,1.71061261970353,331,166,165,90,1,12.78,1,0,0,0,0,0,0,0.155790272820464,77.9212012235828,22.6749922334061
8.7,"greedy_SVM","SVM",75,5,3312,3189,123,600,327,273,0.890391643484434,0.628571428571429,1.69116524028966,397,194,203,66,1,15.34,1.2,0,0,0,0,0,0,0.0868984991607871,49.6734629933792,13.9519351151547
8.7,"greedy_SVM","SVM",75,6,3212,3115,97,700,401,299,0.893678066873938,0.623809523809524,1.66784730421094,445,216,229,48,1.1,17.89,1.3,0,0,0,0,0,0,0.0708157800110051,55.8263846184589,10.3249212737312
8.7,"greedy_SVM","SVM",75,7,3112,3037,75,800,479,321,0.881064201167295,0.652380952380952,1.6139038841343,500,241,259,55,1.1,20.45,1.5,0,0,0,0,0,0,0.0604624973020958,79.2229745721706,11.3285919584431
8.7,"greedy_SVM","SVM",75,8,3012,2951,61,900,565,335,0.882070583101514,0.638095238095238,1.6094537815126,524,252,272,24,1.1,23.01,1.7,0,0,0,0,0,0,0.0548600437340717,72.5098501262811,6.26005391246048
8.7,"greedy_SVM","SVM",75,9,2912,2856,56,1000,660,340,0.882127856870125,0.638095238095238,1.6139038841343,535,258,277,11,1.1,25.56,1.9,0,0,0,0,0,0,0.0447358211946912,60.3621928436949,5.06998371136888
8.7,"greedy_SVM","SVM",75,10,2812,2758,54,1100,758,342,0.882572410407451,0.642857142857143,1.61801470588235,551,264,287,16,1.1,28.12,2.2,0,0,0,0,0,0,0.0383167016479608,49.1612528215887,4.09591912975429
8.7,"greedy_SVM","SVM",75,11,2712,2662,50,1200,854,346,0.90659193803523,0.638095238095238,1.68805362071231,582,281,301,31,1.1,30.67,2.5,0,0,0,0,0,0,0.0324405970949696,25.5311391895272,4.07913392693687
8.7,"greedy_SVM","SVM",75,12,2612,2568,44,1300,948,352,0.910650193639887,0.642857142857143,1.68805362071231,595,291,304,13,1,33.23,2.7,0,0,0,0,0,0,0.0241746842155121,25.0465084776725,2.94883089053276
8.7,"greedy_SVM","SVM",75,13,2512,2473,39,1400,1043,357,0.914138438880702,0.647619047619048,1.71758846657929,607,297,310,12,1,35.79,2.9,0,0,0,0,0,0,0.0208483614678225,25.2053826945367,2.48989721940323
8.7,"greedy_SVM","SVM",75,14,2412,2380,32,1500,1136,364,0.919350351824577,0.642857142857143,1.71376002102773,629,307,322,22,1,38.34,3.1,0,0,0,0,0,0,0.0354030130678513,34.506612955536,4.61580667564232
8.7,"greedy_SVM","SVM",75,15,2312,2284,28,1600,1232,368,0.923009054710091,0.638095238095238,1.73786764705882,649,317,332,20,1,40.9,3.3,0,0,0,0,0,0,0.0336544062540499,31.6099662505762,3.91182012331269
8.7,"greedy_SVM","SVM",75,16,2212,2187,25,1700,1329,371,0.924614083892446,0.638095238095238,1.73467889908257,663,322,341,14,1.1,43.46,3.6,0,0,0,0,0,0,0.027593070850864,24.5504405441942,3.17769720427734
8.7,"greedy_SVM","SVM",75,17,2112,2091,21,1800,1425,375,0.926261386570666,0.642857142857143,1.7448248720976,676,328,348,13,1.1,46.01,3.8,0,0,0,0,0,0,0.0287520907046272,21.0566276521553,3.36491144344115
8.7,"greedy_SVM","SVM",75,18,2012,1997,15,1900,1519,381,0.926373206785583,0.652380952380952,1.75337793519612,695,336,359,19,1.1,48.57,4,0,0,0,0,0,0,0.029438911694575,19.7785133699233,3.68174071679037
8.7,"greedy_SVM","SVM",75,19,1912,1902,10,2000,1614,386,0.924690448917263,0.652380952380952,1.74642857142857,708,342,366,13,1.1,51.12,4.2,0,0,0,0,0,0,0.0192499510480544,15.3773733630748,2.77137331824028
8.7,"greedy_SVM","SVM",75,20,1812,1806,6,2100,1710,390,0.923974526809587,0.652380952380952,1.74642857142857,716,347,369,8,1.1,53.68,4.4,0,0,0,0,0,0,0.0160377077753714,12.9312492368996,1.91060942963551
8.7,"greedy_SVM","SVM",75,21,1712,1706,6,2200,1810,390,0.924469535809744,0.652380952380952,1.74803522144829,718,349,369,2,1.1,56.24,4.6,0,0,0,0,0,0,0.012243492162664,10.3658994196006,1.35703152332874
8.7,"greedy_SVM","SVM",75,22,1612,1606,6,2300,1910,390,0.924536355206459,0.647619047619048,1.74964483030781,718,350,368,0,1.1,58.79,4.9,0,0,0,0,0,0,0.0108054997865548,8.7773297609037,1.10487117220934
8.7,"greedy_SVM","SVM",75,23,1512,1506,6,2400,2010,390,0.925724104074629,0.642857142857143,1.7587010606259,737,359,378,19,1.1,61.35,5.2,0,0,0,0,0,0,0.00749032187738486,5.31381378699306,0.933192395842389
8.7,"greedy_SVM","SVM",75,24,1412,1407,5,2500,2109,391,0.925781377843243,0.642857142857143,1.7587010606259,741,360,381,4,1.1,63.91,5.4,0,0,0,0,0,0,0.00652314104983503,4.61935135835037,0.681822631925029
8.7,"greedy_SVM","SVM",75,25,1312,1307,5,2600,2209,391,0.926375934107903,0.642857142857143,1.76355042016807,741,362,379,0,1,66.46,5.6,0,0,0,0,0,0,0.00468747256790139,3.12245305909524,0.533531698076022
8.7,"greedy_SVM","SVM",75,26,1212,1207,5,2700,2309,391,0.926384116074847,0.642857142857143,1.76355042016807,741,362,379,0,1,69.02,5.9,0,0,0,0,0,0,0.00460150528822456,2.69412050482495,0.473100965235778
8.7,"greedy_SVM","SVM",75,27,1112,1107,5,2800,2409,391,0.926939126165939,0.638095238095238,1.76355042016807,751,368,383,10,1,71.57,6.2,0,0,0,0,0,0,0.00399126444650911,2.08893848757354,0.431656603074119
8.7,"greedy_SVM","SVM",75,28,1012,1008,4,2900,2508,392,0.927158675612292,0.638095238095238,1.76193099829463,757,370,387,6,1,74.13,6.4,0,0,0,0,0,0,0.00391339599494743,1.79631176389541,0.407162890453496
8.7,"greedy_SVM","SVM",75,29,912,908,4,3000,2608,392,0.927205040091647,0.633333333333333,1.76842659644503,759,371,388,2,1,76.69,6.7,0,0,0,0,0,0,0.0032731610343243,1.28451488617151,0.347984146271791
8.7,"greedy_SVM","SVM",75,30,812,809,3,3100,2707,393,0.927622320405834,0.628571428571429,1.76193099829463,767,374,393,8,1.1,79.24,6.9,0,0,0,0,0,0,0.0024768578066991,0.844008402351996,0.284086049099234
8.7,"greedy_SVM","SVM",75,31,712,710,2,3200,2806,394,0.927798232695147,0.628571428571429,1.76355042016807,771,375,396,4,1.1,81.8,7.1,0,0,0,0,0,0,0.00200790012034131,0.637598369831195,0.242713840897868
8.7,"greedy_SVM","SVM",75,32,612,610,2,3300,2906,394,0.9281909671085,0.628571428571429,1.7570905285191,772,375,397,1,1.1,84.36,7.4,0,0,0,0,0,0,0.00110578122986093,0.348876431689219,0.141108886158811
8.7,"greedy_SVM","SVM",75,33,512,511,1,3400,3005,395,0.928612338406163,0.638095238095238,1.76031454783748,775,376,399,3,1.1,86.91,7.6,0,0,0,0,0,0,0.000881630355118667,0.276889911442359,0.110562195005441
8.7,"greedy_SVM","SVM",75,34,412,412,0,3500,3104,396,0.929273714067545,0.638095238095238,1.76031454783748,781,380,401,6,1.1,89.47,7.8,0,0,0,0,0,0,0.000761091521948057,0.215736742427152,0.0902740465519815
8.7,"greedy_SVM","SVM",75,35,312,312,0,3600,3204,396,0.929774177712341,0.633333333333333,1.76355042016807,785,382,403,4,1.1,92.02,8.1,0,0,0,0,0,0,0.000413396656936874,0.100236488721335,0.0513343367081638
8.7,"greedy_SVM","SVM",75,36,212,212,0,3700,3304,396,0.929812360224751,0.628571428571429,1.76193099829463,787,383,404,2,1.1,94.58,8.3,0,0,0,0,0,0,0.00025507266188923,0.0547969848808533,0.0346077418429027
8.7,"greedy_SVM","SVM",75,37,112,112,0,3800,3404,396,0.929782359679287,0.628571428571429,1.76031454783748,789,384,405,2,1.1,97.14,8.6,0,0,0,0,0,0,0.000126459831861356,0.0208660116901696,0.0194898884624705
8.7,"greedy_SVM","SVM",75,38,12,12,0,3900,3504,396,0.929954180985128,0.628571428571429,1.76031454783748,789,385,404,0,1,99.69,8.8,0,0,0,0,0,0,0.000103183182675419,0.00138273340305508,0.00138273340305508
8.7,"greedy_SVM","SVM",75,39,0,0,0,3912,3516,396,0.930090547100876,0.628571428571429,1.76517282165856,790,385,405,1,1.1,100,8.9,0,0,0,0,0,0,0,0,0
8.7,"greedy_SVM","SVM",76,0,3812,3420,392,100,87,13,0.900001417414346,0.537313432835821,1.73200054772012,30,13,17,0,1.3,2.56,6.7,0,0,0,0,0,0,0.610335393897266,482.475797991788,66.8645845410798
8.7,"greedy_SVM","SVM",76,1,3712,3381,331,200,126,74,0.892440929256838,0.572139303482587,1.73678067802661,107,52,55,77,1.1,5.11,1.7,0,0,0,0,0,0,0.677437958637473,479.711664256622,75.7911958050574
8.7,"greedy_SVM","SVM",76,2,3612,3363,249,300,144,156,0.897518107468354,0.572139303482587,1.75717197696212,144,72,72,37,1,7.67,0.9,0,0,0,0,0,0,0.57856248002447,339.154631769499,64.9799196245477
8.7,"greedy_SVM","SVM",76,3,3512,3307,205,400,200,200,0.902535754277061,0.621890547263682,1.74412862159789,243,123,120,99,1,10.22,1,0,0,0,0,0,0,0.353721386094454,174.179724916289,46.0357027383127
8.7,"greedy_SVM","SVM",76,4,3412,3262,150,500,245,255,0.892849144590426,0.592039800995025,1.71307517710984,337,171,166,94,1,12.78,1,0,0,0,0,0,0,0.262550350363636,155.322507147705,36.5769713321773
8.7,"greedy_SVM","SVM",76,5,3312,3198,114,600,309,291,0.867355530042101,0.616915422885572,1.61441639727629,412,204,208,75,1,15.34,1.1,0,0,0,0,0,0,0.221471968257013,191.003629176718,33.1485406811706
8.7,"greedy_SVM","SVM",76,6,3212,3121,91,700,386,314,0.877628949270749,0.641791044776119,1.6413233372309,473,230,243,61,1.1,17.89,1.2,0,0,0,0,0,0,0.100014662800995,91.6719932330946,13.6914779312695
8.7,"greedy_SVM","SVM",76,7,3112,3044,68,800,463,337,0.880528979036453,0.641791044776119,1.62635856530022,536,257,279,63,1.1,20.45,1.4,0,0,0,0,0,0,0.088409614400532,114.488365865279,11.0676380281096
8.7,"greedy_SVM","SVM",76,8,3012,2954,58,900,553,347,0.884786891752076,0.661691542288557,1.64725590080874,574,272,302,38,1.1,23.01,1.6,0,0,0,0,0,0,0.069783652058689,99.72529428513,9.39254845054226
8.7,"greedy_SVM","SVM",76,9,2912,2861,51,1000,646,354,0.893254525095331,0.656716417910448,1.65029231721576,588,282,306,14,1.1,25.56,1.8,0,0,0,0,0,0,0.0493793961762019,66.6402379252464,5.60738684190183
8.7,"greedy_SVM","SVM",76,10,2812,2768,44,1100,739,361,0.901072982665032,0.651741293532338,1.6741133339741,606,290,316,18,1.1,28.12,2,0,0,0,0,0,0,0.047503261878125,70.967088756022,5.29333584952738
8.7,"greedy_SVM","SVM",76,11,2712,2672,40,1200,835,365,0.914372581536775,0.631840796019901,1.71729587357331,621,299,322,15,1.1,30.67,2.3,0,0,0,0,0,0,0.0411693854683658,52.9574460724729,4.95374184708556
8.7,"greedy_SVM","SVM",76,12,2612,2576,36,1300,931,369,0.922433416960767,0.626865671641791,1.72045848107529,637,309,328,16,1.1,33.23,2.5,0,0,0,0,0,0,0.0467347512663183,50.2265004289841,5.37317773370025
8.7,"greedy_SVM","SVM",76,13,2512,2479,33,1400,1028,372,0.923601366387433,0.626865671641791,1.72782820030482,654,313,341,17,1.1,35.79,2.8,0,0,0,0,0,0,0.0446289729224831,42.5383647248463,5.00702123418698
8.7,"greedy_SVM","SVM",76,14,2412,2380,32,1500,1127,373,0.924203767487351,0.626865671641791,1.72624012291484,658,315,343,4,1.1,38.34,3,0,0,0,0,0,0,0.0343430151231087,32.5719861414328,3.83161757026907
8.7,"greedy_SVM","SVM",76,15,2312,2285,27,1600,1222,378,0.923981233433965,0.626865671641791,1.72782820030482,667,321,346,9,1.1,40.9,3.2,0,0,0,0,0,0,0.0316153426859246,28.7183778698819,3.86807314186647
8.7,"greedy_SVM","SVM",76,16,2212,2191,21,1700,1316,384,0.925421326416338,0.631840796019901,1.73837992358649,686,327,359,19,1.1,43.46,3.4,0,0,0,0,0,0,0.029843169900448,28.3953780137711,3.87938331573131
8.7,"greedy_SVM","SVM",76,17,2112,2099,13,1800,1408,392,0.927010247905761,0.63681592039801,1.73518437225637,707,337,370,21,1.1,46.01,3.6,0,0,0,0,0,0,0.025992459705015,25.7978644215189,3.1497238146258
8.7,"greedy_SVM","SVM",76,18,2012,2000,12,1900,1507,393,0.927127893297036,0.631840796019901,1.73998211706445,709,339,370,2,1.1,48.57,3.8,0,0,0,0,0,0,0.0232319704894067,24.1784730550267,2.53031123100871
8.7,"greedy_SVM","SVM",76,19,1912,1903,9,2000,1604,396,0.927395784609704,0.63681592039801,1.73518437225637,719,344,375,10,1.1,51.12,4.1,0,0,0,0,0,0,0.0209103944116093,21.5783114573554,2.21507669754045
8.7,"greedy_SVM","SVM",76,20,1812,1803,9,2100,1704,396,0.926325636773384,0.63681592039801,1.73837992358649,721,346,375,2,1.1,53.68,4.3,0,0,0,0,0,0,0.0168422135364979,16.3512027108771,1.82713418952938
8.7,"greedy_SVM","SVM",76,21,1712,1704,8,2200,1803,397,0.926572266870761,0.621890547263682,1.76688905701905,745,360,385,24,1.1,56.24,4.5,0,0,0,0,0,0,0.0118571413193524,9.87594831029417,1.40879009339129
8.7,"greedy_SVM","SVM",76,22,1612,1605,7,2300,1902,398,0.926563762384644,0.626865671641791,1.76688905701905,747,361,386,2,1.1,58.79,4.8,0,0,0,0,0,0,0.0104593540090603,8.91792755312802,1.11827172490334
8.7,"greedy_SVM","SVM",76,23,1512,1507,5,2400,2000,400,0.926994656347875,0.626865671641791,1.77585803700392,753,365,388,6,1.1,61.35,5,0,0,0,0,0,0,0.00766891645440155,6.22177552185278,0.863024460816639
8.7,"greedy_SVM","SVM",76,24,1412,1407,5,2500,2100,400,0.927252625760075,0.616915422885572,1.77585803700392,759,368,391,6,1.1,63.91,5.2,0,0,0,0,0,0,0.00647084786940667,4.76051282957076,0.691339692135662
8.7,"greedy_SVM","SVM",76,25,1312,1307,5,2600,2200,400,0.927459568255572,0.621890547263682,1.77585803700392,769,375,394,10,1.1,66.46,5.5,0,0,0,0,0,0,0.00445128968482043,3.07205377408633,0.490933671542558
8.7,"greedy_SVM","SVM",76,26,1212,1209,3,2700,2298,402,0.927942906549854,0.616915422885572,1.77422280860889,778,378,400,9,1.1,69.02,5.7,0,0,0,0,0,0,0.00446534437730608,2.85040484004459,0.471882726553269
8.7,"greedy_SVM","SVM",76,27,1112,1109,3,2800,2398,402,0.928229224249103,0.616915422885572,1.77422280860889,777,380,397,-1,1,71.57,6,0,0,0,0,0,0,0.00364911231645758,2.07672528149097,0.392094709802264
8.7,"greedy_SVM","SVM",76,28,1012,1010,2,2900,2497,403,0.928474436932127,0.616915422885572,1.77585803700392,782,383,399,5,1,74.13,6.2,0,0,0,0,0,0,0.00340560923906755,1.70260923089684,0.351824572167212
8.7,"greedy_SVM","SVM",76,29,912,910,2,3000,2597,403,0.928650196311867,0.616915422885572,1.77585803700392,785,384,401,3,1,76.69,6.4,0,0,0,0,0,0,0.00280319492556934,1.21117381907683,0.295128599440634
8.7,"greedy_SVM","SVM",76,30,812,810,2,3100,2697,403,0.928721067029504,0.616915422885572,1.76933514246947,792,388,404,7,1,79.24,6.7,0,0,0,0,0,0,0.00222143387027963,0.834303742657066,0.240033827029374
8.7,"greedy_SVM","SVM",76,31,712,710,2,3200,2797,403,0.92874941531656,0.616915422885572,1.77585803700392,791,388,403,-1,1,81.8,6.9,0,0,0,0,0,0,0.00196875626864209,0.658106448038718,0.219592987250727
8.7,"greedy_SVM","SVM",76,32,612,610,2,3300,2897,403,0.928641691825753,0.616915422885572,1.77585803700392,790,388,402,-1,1,84.36,7.2,0,0,0,0,0,0,0.00120480171236758,0.380387260987535,0.14881048913069
8.7,"greedy_SVM","SVM",76,33,512,510,2,3400,2997,403,0.928930844353713,0.616915422885572,1.77422280860889,790,388,402,0,1,86.91,7.4,0,0,0,0,0,0,0.000788166044619107,0.237568933206917,0.0971994815530483
8.7,"greedy_SVM","SVM",76,34,412,412,0,3500,3095,405,0.929402843333183,0.606965174129353,1.77096136962248,799,392,407,9,1,89.47,7.6,0,0,0,0,0,0,0.000773597389095865,0.236140147462692,0.0971732737530447
8.7,"greedy_SVM","SVM",76,35,312,312,0,3600,3195,405,0.929693413275506,0.606965174129353,1.76363811119197,806,393,413,7,1.1,92.02,7.9,0,0,0,0,0,0,0.000574504530408806,0.151066152129672,0.0694328442769784
8.7,"greedy_SVM","SVM",76,36,212,212,0,3700,3295,405,0.929877677141365,0.606965174129353,1.76363811119197,808,396,412,2,1,94.58,8.1,0,0,0,0,0,0,0.000257069289878917,0.0523457836046492,0.0321470435424009
8.7,"greedy_SVM","SVM",76,37,112,112,0,3800,3395,405,0.930064775835928,0.601990049751244,1.76201712028095,810,396,414,2,1,97.14,8.4,0,0,0,0,0,0,0.000109510725955446,0.0185002047435196,0.0173805983166785
8.7,"greedy_SVM","SVM",76,38,12,12,0,3900,3495,405,0.930005244433114,0.601990049751244,1.76688905701905,813,398,415,3,1,99.69,8.6,0,0,0,0,0,0,7.78504219807731e-05,0.00107355323917413,0.00107355323917413
8.7,"greedy_SVM","SVM",76,39,0,0,0,3912,3507,405,0.929983983217822,0.601990049751244,1.76201712028095,812,398,414,-1,1,100,8.7,0,0,0,0,0,0,0,0,0
8.7,"greedy_SVM","SVM",77,0,3812,3414,398,100,90,10,0.881574562461925,0.53030303030303,1.74813573523251,29,10,19,0,1.9,2.56,9,0,0,0,0,0,0,0.388231885193586,403.134624519562,47.0793730155116
8.7,"greedy_SVM","SVM",77,1,3712,3362,350,200,142,58,0.912661886211365,0.616161616161616,1.76147504456328,116,56,60,87,1.1,5.11,2.4,0,0,0,0,0,0,0.637618792278906,499.235838022694,69.4258960293758
8.7,"greedy_SVM","SVM",77,2,3612,3346,266,300,158,142,0.906218039323826,0.621212121212121,1.7251559714795,150,77,73,34,0.9,7.67,1.1,0,0,0,0,0,0,0.577512075254604,328.871298374486,68.3057341120772
8.7,"greedy_SVM","SVM",77,3,3512,3300,212,400,204,196,0.895530963790353,0.626262626262626,1.7283330542999,242,123,119,92,1,10.22,1,0,0,0,0,0,0,0.330598472940251,184.407262303097,43.2967003487654
8.7,"greedy_SVM","SVM",77,4,3412,3245,167,500,259,241,0.918559887843141,0.626262626262626,1.75724060885351,314,158,156,72,1,12.78,1.1,0,0,0,0,0,0,0.402670854026992,213.091898983888,54.0676737889055
8.7,"greedy_SVM","SVM",77,5,3312,3179,133,600,325,275,0.875690925178988,0.656565656565657,1.61917517718623,397,198,199,83,1,15.34,1.2,0,0,0,0,0,0,0.168381368901493,143.758441741769,25.8202344964884
8.7,"greedy_SVM","SVM",77,6,3212,3110,102,700,394,306,0.873060812907241,0.661616161616162,1.59188570790781,469,231,238,72,1,17.89,1.3,0,0,0,0,0,0,0.114939028365593,142.794828459074,16.2000514705652
8.7,"greedy_SVM","SVM",77,7,3112,3032,80,800,472,328,0.879579354408712,0.676767676767677,1.61917517718623,521,252,269,52,1.1,20.45,1.4,0,0,0,0,0,0,0.0910950143021255,141.123436253221,13.3813360915324
8.7,"greedy_SVM","SVM",77,8,3012,2952,60,900,552,348,0.8934854805162,0.681818181818182,1.62677371693011,574,272,302,53,1.1,23.01,1.6,0,0,0,0,0,0,0.080649015784088,129.162376171545,9.61100204440768
8.7,"greedy_SVM","SVM",77,9,2912,2863,49,1000,641,359,0.901944645545323,0.681818181818182,1.65251782531194,607,289,318,33,1.1,25.56,1.8,0,0,0,0,0,0,0.0658362363244575,106.385850566562,7.57343396847752
8.7,"greedy_SVM","SVM",77,10,2812,2772,40,1100,732,368,0.908094023281734,0.666666666666667,1.67221432354827,631,302,329,24,1.1,28.12,2,0,0,0,0,0,0,0.0619464202912301,98.9012182031828,6.83009984245323
8.7,"greedy_SVM","SVM",77,11,2712,2679,33,1200,825,375,0.914325277806504,0.656565656565657,1.69039056619553,656,314,342,25,1.1,30.67,2.2,0,0,0,0,0,0,0.0608435700733064,88.9563473404801,6.58834939177415
8.7,"greedy_SVM","SVM",77,12,2612,2583,29,1300,921,379,0.922719803265874,0.651515151515151,1.7283330542999,664,320,344,8,1.1,33.23,2.4,0,0,0,0,0,0,0.056965066224934,74.5064404479909,6.08540843791547
8.7,"greedy_SVM","SVM",77,13,2512,2484,28,1400,1020,380,0.925046827777197,0.656565656565657,1.7251559714795,664,321,343,0,1.1,35.79,2.7,0,0,0,0,0,0,0.0491074066632248,65.0354913930253,5.28751180638145
8.7,"greedy_SVM","SVM",77,14,2412,2386,26,1500,1118,382,0.927689867962888,0.656565656565657,1.73583117281369,671,325,346,7,1.1,38.34,2.9,0,0,0,0,0,0,0.0407101592126384,50.2350171699249,4.42038863838599
8.7,"greedy_SVM","SVM",77,15,2312,2289,23,1600,1215,385,0.929341768078943,0.661616161616162,1.74813573523251,684,327,357,13,1.1,40.9,3.2,0,0,0,0,0,0,0.0409347948338104,50.056606485728,4.56699157809137
8.7,"greedy_SVM","SVM",77,16,2212,2197,15,1700,1307,393,0.932771974580819,0.651515151515151,1.76634548247451,710,341,369,26,1.1,43.46,3.3,0,0,0,0,0,0,0.0395362448412725,47.0534854390265,4.79289133779603
8.7,"greedy_SVM","SVM",77,17,2112,2101,11,1800,1403,397,0.933972834143456,0.646464646464647,1.76634548247451,722,346,376,12,1.1,46.01,3.5,0,0,0,0,0,0,0.0339895186145534,37.441923029402,3.65242714104882
8.7,"greedy_SVM","SVM",77,18,2012,2001,11,1900,1503,397,0.933935486836487,0.641414141414141,1.76309553678459,729,351,378,7,1.1,48.57,3.8,0,0,0,0,0,0,0.0281011550998467,28.2493978469378,2.97397497476189
8.7,"greedy_SVM","SVM",77,19,1912,1901,11,2000,1603,397,0.931785143815839,0.631313131313131,1.76147504456328,740,359,381,11,1.1,51.12,4,0,0,0,0,0,0,0.020160806262336,16.4886829723489,2.54440387458844
8.7,"greedy_SVM","SVM",77,20,1812,1803,9,2100,1701,399,0.93226922237159,0.631313131313131,1.76634548247451,742,360,382,2,1.1,53.68,4.3,0,0,0,0,0,0,0.0142809114857763,12.9358813976982,1.58986338247433
8.7,"greedy_SVM","SVM",77,21,1712,1706,6,2200,1798,402,0.931766470162351,0.631313131313131,1.76309553678459,753,364,389,11,1.1,56.24,4.5,0,0,0,0,0,0,0.0142489842844386,11.9520918466734,1.46614198865079
8.7,"greedy_SVM","SVM",77,22,1612,1607,5,2300,1897,403,0.931157421771733,0.626262626262626,1.76309553678459,780,376,404,27,1.1,58.79,4.7,0,0,0,0,0,0,0.0119397416198214,9.16910223582952,1.45448347275856
8.7,"greedy_SVM","SVM",77,23,1512,1509,3,2400,1995,405,0.930870134795026,0.621212121212121,1.76309553678459,783,379,404,3,1.1,61.35,4.9,0,0,0,0,0,0,0.0103993198393433,7.97679420571902,1.09626409911623
8.7,"greedy_SVM","SVM",77,24,1412,1409,3,2500,2095,405,0.930946265843855,0.621212121212121,1.76147504456328,788,381,407,5,1.1,63.91,5.2,0,0,0,0,0,0,0.00845734879166972,6.15576476194362,0.918023906141661
8.7,"greedy_SVM","SVM",77,25,1312,1309,3,2600,2195,405,0.93091179140665,0.616161616161616,1.75824298026133,789,381,408,1,1.1,66.46,5.4,0,0,0,0,0,0,0.00752652705300186,4.93640319197424,0.774903106397338
8.7,"greedy_SVM","SVM",77,26,1212,1209,3,2700,2295,405,0.930914664276418,0.626262626262626,1.76147504456328,790,384,406,1,1.1,69.02,5.7,0,0,0,0,0,0,0.00557198955211033,3.34990277912121,0.608576942388671
8.7,"greedy_SVM","SVM",77,27,1112,1109,3,2800,2395,405,0.93101665115315,0.626262626262626,1.76309553678459,791,384,407,1,1.1,71.57,5.9,0,0,0,0,0,0,0.00582770846937492,3.12748281629648,0.607895266203361
8.7,"greedy_SVM","SVM",77,28,1012,1009,3,2900,2495,405,0.930776766527599,0.626262626262626,1.76147504456328,793,385,408,2,1.1,74.13,6.2,0,0,0,0,0,0,0.00441412161374266,2.0734761705003,0.473071507789357
8.7,"greedy_SVM","SVM",77,29,912,911,1,3000,2593,407,0.930723618436909,0.626262626262626,1.76309553678459,798,387,411,5,1.1,76.69,6.4,0,0,0,0,0,0,0.00441319200383681,1.89237477660134,0.475421083985184
8.7,"greedy_SVM","SVM",77,30,812,811,1,3100,2693,407,0.930773893657833,0.626262626262626,1.7647190133378,797,389,408,-1,1,79.24,6.6,0,0,0,0,0,0,0.00336933147990201,1.29750299434833,0.372094661016309
8.7,"greedy_SVM","SVM",77,31,712,712,0,3200,2792,408,0.930778202962484,0.631313131313131,1.76147504456328,803,391,412,6,1.1,81.8,6.8,0,0,0,0,0,0,0.00276765148918036,1.00160161350604,0.314883546957635
8.7,"greedy_SVM","SVM",77,32,612,612,0,3300,2892,408,0.930901736362468,0.636363636363636,1.76309553678459,805,391,414,2,1.1,84.36,7.1,0,0,0,0,0,0,0.00211723680595475,0.705963678713885,0.246029858357078
8.7,"greedy_SVM","SVM",77,33,512,512,0,3400,2992,408,0.930907482102002,0.631313131313131,1.7647190133378,806,391,415,1,1.1,86.91,7.3,0,0,0,0,0,0,0.00124226483254443,0.419245080672531,0.15916669656378
8.7,"greedy_SVM","SVM",77,34,412,412,0,3500,3092,408,0.930913227841537,0.626262626262626,1.76309553678459,807,392,415,1,1.1,89.47,7.6,0,0,0,0,0,0,0.000817589375473759,0.23997579978958,0.0978929659590237
8.7,"greedy_SVM","SVM",77,35,312,312,0,3600,3192,408,0.930913227841537,0.621212121212121,1.7647190133378,810,394,416,3,1.1,92.02,7.8,0,0,0,0,0,0,0.000570429845886859,0.145025057595553,0.0696565795255404
8.7,"greedy_SVM","SVM",77,36,212,212,0,3700,3292,408,0.931059744199659,0.631313131313131,1.75985752845257,812,396,416,2,1.1,94.58,8.1,0,0,0,0,0,0,0.000354212639242587,0.0741606592407599,0.0461753321768875
8.7,"greedy_SVM","SVM",77,37,112,112,0,3800,3392,408,0.931209133427547,0.631313131313131,1.76147504456328,814,396,418,2,1.1,97.14,8.3,0,0,0,0,0,0,0.000140676818122039,0.0235190673135555,0.0220292736687438
8.7,"greedy_SVM","SVM",77,38,12,12,0,3900,3492,408,0.931482056055418,0.626262626262626,1.7647190133378,816,398,418,2,1.1,99.69,8.6,0,0,0,0,0,0,9.60888113209711e-05,0.00133133167634954,0.00133133167634954
8.7,"greedy_SVM","SVM",77,39,0,0,0,3912,3504,408,0.931573987887964,0.626262626262626,1.76309553678459,816,398,418,0,1.1,100,8.6,0,0,0,0,0,0,0,0,0
8.7,"greedy_SVM","SVM",78,0,3812,3421,391,100,90,10,0.912970985220989,0.565853658536585,1.76499597963013,24,10,14,0,1.4,2.56,9,0,0,0,0,0,0,0.845574334713019,544.426383824792,87.6373931145661
8.7,"greedy_SVM","SVM",78,1,3712,3397,315,200,114,86,0.914744187990142,0.546341463414634,1.77474733863361,79,39,40,55,1,5.11,1.3,0,0,0,0,0,0,0.667846799591362,294.491261352569,74.8780411091228
8.7,"greedy_SVM","SVM",78,2,3612,3367,245,300,144,156,0.912498781184272,0.565853658536585,1.75233487872069,142,75,67,63,0.9,7.67,0.9,0,0,0,0,0,0,0.47434002508375,198.324048232996,59.1406389781859
8.7,"greedy_SVM","SVM",78,3,3512,3315,197,400,196,204,0.905963143012367,0.590243902439024,1.74120714847701,234,120,114,92,1,10.22,1,0,0,0,0,0,0,0.178662700540345,63.8878902147871,28.4465993508829
8.7,"greedy_SVM","SVM",78,4,3412,3251,161,500,260,240,0.889607332395443,0.6,1.69255738880918,321,160,161,87,1,12.78,1.1,0,0,0,0,0,0,0.158214210284188,68.3760366614378,24.9561036219685
8.7,"greedy_SVM","SVM",78,5,3312,3169,143,600,342,258,0.898967837194087,0.624390243902439,1.74357320432708,362,175,187,41,1.1,15.34,1.3,0,0,0,0,0,0,0.0802519156794454,44.4472409037194,11.9663001506719
8.7,"greedy_SVM","SVM",78,6,3212,3101,111,700,410,290,0.909963644467988,0.629268292682927,1.72203207114944,430,207,223,68,1.1,17.89,1.4,0,0,0,0,0,0,0.0743035290617384,55.7850331121971,13.0448004213747
8.7,"greedy_SVM","SVM",78,7,3112,3021,91,800,490,310,0.914244125308208,0.639024390243902,1.72203207114944,472,225,247,42,1.1,20.45,1.6,0,0,0,0,0,0,0.0644209605585518,64.7228960764571,8.24252511248792
8.7,"greedy_SVM","SVM",78,8,3012,2939,73,900,572,328,0.903634160270794,0.64390243902439,1.6796493199955,523,249,274,51,1.1,23.01,1.7,0,0,0,0,0,0,0.0666209898092209,107.881698058841,11.6156614639308
8.7,"greedy_SVM","SVM",78,9,2912,2853,59,1000,658,342,0.916510426097995,0.634146341463415,1.72044786501223,557,266,291,34,1.1,25.56,1.9,0,0,0,0,0,0,0.0626159093381901,95.5397788408072,7.85232144714628
8.7,"greedy_SVM","SVM",78,10,2812,2761,51,1100,750,350,0.927581451714021,0.629268292682927,1.72922566024188,589,285,304,32,1.1,28.12,2.1,0,0,0,0,0,0,0.0439098262728171,60.8335432972766,5.3924460005484
8.7,"greedy_SVM","SVM",78,11,2712,2672,40,1200,839,361,0.934459751222303,0.639024390243902,1.72763629842181,612,295,317,23,1.1,30.67,2.3,0,0,0,0,0,0,0.0608275999371603,77.6607980349654,6.93598144968168
8.7,"greedy_SVM","SVM",78,12,2612,2575,37,1300,936,364,0.935150645624107,0.639024390243902,1.74197359588275,631,302,329,19,1.1,33.23,2.6,0,0,0,0,0,0,0.0461336631248403,59.1960726286635,5.12524462196759
8.7,"greedy_SVM","SVM",78,13,2512,2481,31,1400,1030,370,0.94176985973173,0.634146341463415,1.77638305046645,648,311,337,17,1.1,35.79,2.8,0,0,0,0,0,0,0.0603723221531723,56.2332611365133,6.64686378045673
8.7,"greedy_SVM","SVM",78,14,2412,2384,28,1500,1127,373,0.943327158000313,0.634146341463415,1.7786199019015,660,315,345,12,1.1,38.34,3,0,0,0,0,0,0,0.0520368821804617,44.3565630149155,5.95083784181624
8.7,"greedy_SVM","SVM",78,15,2312,2290,22,1600,1221,379,0.944745163042727,0.634146341463415,1.79231909446166,673,323,350,13,1.1,40.9,3.2,0,0,0,0,0,0,0.0438650154373882,38.5343698929109,5.42460734440295
8.7,"greedy_SVM","SVM",78,16,2212,2195,17,1700,1316,384,0.945282834895745,0.64390243902439,1.78517702596381,690,330,360,17,1.1,43.46,3.4,0,0,0,0,0,0,0.0305104620847478,33.302936556272,4.0736850039175
8.7,"greedy_SVM","SVM",78,17,2112,2096,16,1800,1415,385,0.945404020002513,0.64390243902439,1.77698814052361,691,331,360,1,1.1,46.01,3.7,0,0,0,0,0,0,0.0291694472732635,30.0490408888409,2.95157359242586
8.7,"greedy_SVM","SVM",78,18,2012,1996,16,1900,1515,385,0.942480255185194,0.634146341463415,1.7873815762951,718,351,367,27,1,48.57,3.9,0,0,0,0,0,0,0.0198957797741027,13.2112874440409,2.77192959376481
8.7,"greedy_SVM","SVM",78,19,1912,1897,15,2000,1614,386,0.942655764650169,0.639024390243902,1.79067022684946,722,351,371,4,1.1,51.12,4.2,0,0,0,0,0,0,0.0138779126589797,10.3588912707427,1.60694595156322
8.7,"greedy_SVM","SVM",78,20,1812,1800,12,2100,1711,389,0.942530400746615,0.634146341463415,1.79397100146117,725,354,371,3,1,53.68,4.4,0,0,0,0,0,0,0.0113391900860713,9.68371403795102,1.30199360510959
8.7,"greedy_SVM","SVM",78,21,1712,1702,10,2200,1809,391,0.942513685559475,0.634146341463415,1.79397100146117,733,359,374,8,1,56.24,4.6,0,0,0,0,0,0,0.00955922165535392,8.60089045754346,1.05062618376494
8.7,"greedy_SVM","SVM",78,22,1612,1603,9,2300,1908,392,0.942159880765001,0.634146341463415,1.79397100146117,744,362,382,11,1.1,58.79,4.9,0,0,0,0,0,0,0.00922962883661423,7.59495314555907,0.950948540123327
8.7,"greedy_SVM","SVM",78,23,1512,1503,9,2400,2008,392,0.940939672103749,0.629268292682927,1.7873815762951,756,369,387,12,1,61.35,5.1,0,0,0,0,0,0,0.00683833555954053,4.96660288072519,0.821581685990294
8.7,"greedy_SVM","SVM",78,24,1412,1404,8,2500,2107,393,0.94156927748604,0.629268292682927,1.79067022684946,756,368,388,0,1.1,63.91,5.4,0,0,0,0,0,0,0.00647903988092552,4.73725528638746,0.70765834982685
8.7,"greedy_SVM","SVM",78,25,1312,1306,6,2600,2205,395,0.94195372679027,0.634146341463415,1.7873815762951,761,372,389,5,1,66.46,5.6,0,0,0,0,0,0,0.00593693607091201,3.89949119026427,0.617056808908907
8.7,"greedy_SVM","SVM",78,26,1212,1206,6,2700,2305,395,0.941638924099125,0.634146341463415,1.7890243902439,766,373,393,5,1.1,69.02,5.8,0,0,0,0,0,0,0.00491740711828741,2.92177507866047,0.539408341616309
8.7,"greedy_SVM","SVM",78,27,1112,1107,5,2800,2404,396,0.9418144335641,0.629268292682927,1.7873815762951,769,374,395,3,1.1,71.57,6.1,0,0,0,0,0,0,0.00504079136594848,2.74300388229604,0.524263997717032
8.7,"greedy_SVM","SVM",78,28,1012,1007,5,2900,2504,396,0.941506595534263,0.629268292682927,1.7890243902439,770,376,394,1,1,74.13,6.3,0,0,0,0,0,0,0.0041906739841812,2.05575314264403,0.452798999965898
8.7,"greedy_SVM","SVM",78,29,912,907,5,3000,2604,396,0.941573456282825,0.624390243902439,1.7890243902439,769,376,393,-1,1,76.69,6.6,0,0,0,0,0,0,0.00351617775553508,1.50261613759022,0.374637958716855
8.7,"greedy_SVM","SVM",78,30,812,807,5,3100,2704,396,0.941413269072728,0.629268292682927,1.7873815762951,771,378,393,2,1,79.24,6.8,0,0,0,0,0,0,0.00276460536221275,1.01398756918101,0.299659776744797
8.7,"greedy_SVM","SVM",78,31,712,708,4,3200,2803,397,0.941591564402227,0.629268292682927,1.7873815762951,780,380,400,9,1.1,81.8,7.1,0,0,0,0,0,0,0.00242073971126998,0.838070423045678,0.275348379389791
8.7,"greedy_SVM","SVM",78,32,612,609,3,3300,2902,398,0.941838113412549,0.624390243902439,1.79231909446166,783,382,401,3,1,84.36,7.3,0,0,0,0,0,0,0.00176771206620105,0.564117844733702,0.207036740414437
8.7,"greedy_SVM","SVM",78,33,512,509,3,3400,3002,398,0.941996907690383,0.629268292682927,1.7890243902439,784,382,402,1,1.1,86.91,7.5,0,0,0,0,0,0,0.00128348291655944,0.385759988326859,0.157138573438701
8.7,"greedy_SVM","SVM",78,34,412,409,3,3500,3102,398,0.94228106587177,0.624390243902439,1.7890243902439,783,382,401,-1,1,89.47,7.8,0,0,0,0,0,0,0.000721363747004173,0.20795217827659,0.0943018579624466
8.7,"greedy_SVM","SVM",78,35,312,312,0,3600,3199,401,0.94264183532755,0.629268292682927,1.78410498312133,801,391,410,18,1,92.02,8,0,0,0,0,0,0,0.00107166206456497,0.278071512311259,0.14357562473329
8.7,"greedy_SVM","SVM",78,36,212,212,0,3700,3299,401,0.942559652324109,0.624390243902439,1.7890243902439,802,391,411,1,1.1,94.58,8.2,0,0,0,0,0,0,0.000491105089359699,0.104024096106879,0.0645937146007995
8.7,"greedy_SVM","SVM",78,37,112,112,0,3800,3399,401,0.942448217743172,0.624390243902439,1.7890243902439,806,393,413,4,1.1,97.14,8.5,0,0,0,0,0,0,0.000229879125168091,0.0370988900878082,0.0346671351811836
8.7,"greedy_SVM","SVM",78,38,12,12,0,3900,3499,401,0.942400858046274,0.624390243902439,1.78574177668382,806,393,413,0,1.1,99.69,8.7,0,0,0,0,0,0,0.000152905640318267,0.0020946882500618,0.0020946882500618
8.7,"greedy_SVM","SVM",78,39,0,0,0,3912,3511,401,0.942320067975095,0.624390243902439,1.7890243902439,807,393,414,1,1.1,100,8.8,0,0,0,0,0,0,0,0,0
8.7,"greedy_SVM","SVM",79,0,3812,3413,399,100,93,7,0.851551822323469,0.51,1.67657142857143,35,7,28,0,4,2.56,13.3,0,0,0,0,0,0,0.0773896274652111,271.728453024796,7.99710967937972
8.7,"greedy_SVM","SVM",79,1,3712,3352,360,200,154,46,0.902945615034186,0.57,1.73487132352941,94,44,50,59,1.1,5.11,3.3,0,0,0,0,0,0,0.534545002718753,434.919466365072,59.9486063409925
8.7,"greedy_SVM","SVM",79,2,3612,3330,282,300,176,124,0.911156036446485,0.6,1.73646734130635,153,75,78,59,1,7.67,1.4,0,0,0,0,0,0,0.601490798765411,349.691345646513,71.7810078332472
8.7,"greedy_SVM","SVM",79,3,3512,3293,219,400,213,187,0.898265945330294,0.6,1.69579816513761,220,112,108,67,1,10.22,1.1,0,0,0,0,0,0,0.377916056093986,239.266205233589,49.2610793562195
8.7,"greedy_SVM","SVM",79,4,3412,3240,172,500,266,234,0.894541571753979,0.65,1.66295955882353,314,157,157,94,1,12.78,1.1,0,0,0,0,0,0,0.362077937805818,216.866707486623,47.0739368036476
8.7,"greedy_SVM","SVM",79,5,3312,3174,138,600,332,268,0.896809510250565,0.645,1.70204419889503,389,195,194,75,1,15.34,1.2,0,0,0,0,0,0,0.158790453205756,123.680812907592,24.8904103566753
8.7,"greedy_SVM","SVM",79,6,3212,3103,109,700,403,297,0.902602505694762,0.665,1.71847286108556,455,223,232,66,1,17.89,1.4,0,0,0,0,0,0,0.0981923136096496,90.2988208782289,13.48512252245
8.7,"greedy_SVM","SVM",79,7,3112,3017,95,800,489,311,0.897159738041013,0.67,1.63599264705882,487,235,252,32,1.1,20.45,1.6,0,0,0,0,0,0,0.0681781522408276,83.3668550563652,8.94108329101438
8.7,"greedy_SVM","SVM",79,8,3012,2934,78,900,572,328,0.905871298405479,0.675,1.65854377880184,535,258,277,48,1.1,23.01,1.7,0,0,0,0,0,0,0.0832584024270981,126.879430898508,10.954689305576
8.7,"greedy_SVM","SVM",79,9,2912,2846,66,1000,660,340,0.908771355353065,0.685,1.64801104972376,572,272,300,37,1.1,25.56,1.9,0,0,0,0,0,0,0.0604005973290072,85.8382692366281,7.90491672097501
8.7,"greedy_SVM","SVM",79,10,2812,2759,53,1100,747,353,0.921325455580865,0.68,1.72005524861878,602,290,312,30,1.1,28.12,2.1,0,0,0,0,0,0,0.0665586502550669,86.0419088970661,7.64091640910008
8.7,"greedy_SVM","SVM",79,11,2712,2663,49,1200,843,357,0.926480637813212,0.675,1.75446182152714,627,301,326,25,1.1,30.67,2.4,0,0,0,0,0,0,0.0721483451496763,78.8890491472398,8.05145459438027
8.7,"greedy_SVM","SVM",79,12,2612,2574,38,1300,932,368,0.929735193621881,0.675,1.75446182152714,657,317,340,30,1.1,33.23,2.5,0,0,0,0,0,0,0.0667570522408126,63.9074937326901,7.5250606068009
8.7,"greedy_SVM","SVM",79,13,2512,2481,31,1400,1025,375,0.93178103644649,0.675,1.74963302752294,671,322,349,14,1.1,35.79,2.7,0,0,0,0,0,0,0.0603592719615659,54.0450874587776,6.61031312024229
8.7,"greedy_SVM","SVM",79,14,2412,2388,24,1500,1118,382,0.930951025056962,0.67,1.75769585253456,693,332,361,22,1.1,38.34,2.9,0,0,0,0,0,0,0.0598365418242412,53.4324192633249,6.79080868310119
8.7,"greedy_SVM","SVM",79,15,2312,2292,20,1600,1214,386,0.931164578587715,0.67,1.74868202764977,697,333,364,4,1.1,40.9,3.1,0,0,0,0,0,0,0.0428254335587021,41.5088508342047,5.11180533606123
8.7,"greedy_SVM","SVM",79,16,2212,2197,15,1700,1309,391,0.931343963553545,0.665,1.74868202764977,712,339,373,15,1.1,43.46,3.3,0,0,0,0,0,0,0.036557404750107,40.3921834282332,4.35466229383216
8.7,"greedy_SVM","SVM",79,17,2112,2099,13,1800,1407,393,0.931771070615051,0.665,1.74546458141674,718,342,376,6,1.1,46.01,3.6,0,0,0,0,0,0,0.02797224442068,32.4999243642339,3.07814975526251
8.7,"greedy_SVM","SVM",79,18,2012,2001,11,1900,1505,395,0.932343394077465,0.67,1.75769585253456,723,347,376,5,1.1,48.57,3.8,0,0,0,0,0,0,0.026288058938958,30.8290164323977,2.83082554764952
8.7,"greedy_SVM","SVM",79,19,1912,1902,10,2000,1604,396,0.932437357631,0.675,1.76345906163753,728,351,377,5,1.1,51.12,4.1,0,0,0,0,0,0,0.0205863565107796,22.3923220100141,2.23193897320735
8.7,"greedy_SVM","SVM",79,20,1812,1803,9,2100,1703,397,0.931974658314371,0.675,1.76508287292818,731,354,377,3,1.1,53.68,4.3,0,0,0,0,0,0,0.0190668351258053,19.9305372242598,2.00511272127093
8.7,"greedy_SVM","SVM",79,21,1712,1704,8,2200,1802,398,0.931382403189085,0.675,1.76508287292818,743,358,385,12,1.1,56.24,4.5,0,0,0,0,0,0,0.0157403616419786,14.9125682800006,1.61088368354679
8.7,"greedy_SVM","SVM",79,22,1612,1605,7,2300,1901,399,0.929001993166305,0.665,1.7560773480663,763,368,395,20,1.1,58.79,4.8,0,0,0,0,0,0,0.0114420640608995,8.18220353604467,1.4197813057852
8.7,"greedy_SVM","SVM",79,23,1512,1506,6,2400,2000,400,0.929426252847399,0.67,1.75284926470588,767,370,397,4,1.1,61.35,5,0,0,0,0,0,0,0.0086544506975283,7.10580871046052,1.00715965972091
8.7,"greedy_SVM","SVM",79,24,1412,1407,5,2500,2099,401,0.929453302961288,0.67,1.75123966942149,770,369,401,3,1.1,63.91,5.2,0,0,0,0,0,0,0.0080022905519158,6.22441515055732,0.82074290182149
8.7,"greedy_SVM","SVM",79,25,1312,1308,4,2600,2198,402,0.929463268792728,0.665,1.7560773480663,777,380,397,7,1,66.46,5.5,0,0,0,0,0,0,0.00598954821648804,4.19809532390249,0.698976481753989
8.7,"greedy_SVM","SVM",79,26,1212,1209,3,2700,2297,403,0.929752277904348,0.665,1.75769585253456,782,382,400,5,1,69.02,5.7,0,0,0,0,0,0,0.0052229403573686,3.53197199913757,0.540586102105064
8.7,"greedy_SVM","SVM",79,27,1112,1110,2,2800,2396,404,0.930202164009129,0.66,1.75446182152714,793,386,407,11,1.1,71.57,5.9,0,0,0,0,0,0,0.00418593917662646,2.66320112369118,0.462392702752967
8.7,"greedy_SVM","SVM",79,28,1012,1010,2,2900,2496,404,0.93041287015947,0.655,1.75446182152714,793,386,407,0,1.1,74.13,6.2,0,0,0,0,0,0,0.00380169457155466,2.04656729868225,0.386328618570607
8.7,"greedy_SVM","SVM",79,29,912,910,2,3000,2596,404,0.929803530751724,0.65,1.75769585253456,801,389,412,8,1.1,76.69,6.4,0,0,0,0,0,0,0.00314444927650871,1.44828101869759,0.340730843093429
8.7,"greedy_SVM","SVM",79,30,812,810,2,3100,2696,404,0.929854783599104,0.65,1.7560773480663,801,389,412,0,1.1,79.24,6.7,0,0,0,0,0,0,0.00272480347029149,1.01299214018379,0.281735293640682
8.7,"greedy_SVM","SVM",79,31,712,710,2,3200,2796,404,0.929763667425984,0.65,1.75769585253456,805,392,413,4,1.1,81.8,6.9,0,0,0,0,0,0,0.00203390225134513,0.628677290307791,0.226482303916291
8.7,"greedy_SVM","SVM",79,32,612,610,2,3300,2896,404,0.929732346241473,0.655,1.75446182152714,805,392,413,0,1.1,84.36,7.2,0,0,0,0,0,0,0.00130226131988573,0.400639598099946,0.168925420482336
8.7,"greedy_SVM","SVM",79,33,512,510,2,3400,2996,404,0.930066913439651,0.65,1.7560773480663,806,392,414,1,1.1,86.91,7.4,0,0,0,0,0,0,0.000745360633437971,0.229463614109751,0.10248354597107
8.7,"greedy_SVM","SVM",79,34,412,412,0,3500,3094,406,0.930933940774503,0.655,1.76345906163753,813,395,418,7,1.1,89.47,7.6,0,0,0,0,0,0,0.000986950613078672,0.297012019314772,0.124993762813389
8.7,"greedy_SVM","SVM",79,35,312,312,0,3600,3194,406,0.931469248291587,0.655,1.76508287292818,817,397,420,4,1.1,92.02,7.9,0,0,0,0,0,0,0.000472327901822045,0.117233570650171,0.0588807548344752
8.7,"greedy_SVM","SVM",79,36,212,212,0,3700,3294,406,0.93177961275628,0.655,1.76345906163753,821,398,423,4,1.1,94.58,8.1,0,0,0,0,0,0,0.000255271652317495,0.0552832008621284,0.0351265783436719
8.7,"greedy_SVM","SVM",79,37,112,112,0,3800,3394,406,0.931903473804116,0.65,1.76508287292818,825,400,425,4,1.1,97.14,8.4,0,0,0,0,0,0,9.80260027967943e-05,0.0160514406253641,0.0150650129496897
8.7,"greedy_SVM","SVM",79,38,12,12,0,3900,3494,406,0.932246583143523,0.65,1.76670967741935,824,400,424,-1,1.1,99.69,8.6,0,0,0,0,0,0,6.39608390264488e-05,0.000997408315485952,0.000997408315485952
8.7,"greedy_SVM","SVM",79,39,0,0,0,3912,3506,406,0.932248006833728,0.65,1.76508287292818,826,400,426,2,1.1,100,8.6,0,0,0,0,0,0,0,0,0
8.7,"greedy_SVM","SVM",80,0,3812,3440,372,100,88,12,0.903480470089481,0.572072072072072,1.71052371052371,28,12,16,0,1.3,2.56,7.3,0,0,0,0,0,0,0.540043118208197,446.149974141468,61.9748589170459
8.7,"greedy_SVM","SVM",80,1,3712,3392,320,200,136,64,0.894962436484931,0.63963963963964,1.67283596961016,120,59,61,92,1,5.11,2.1,0,0,0,0,0,0,0.63997097394762,419.512787143488,73.1078293770454
8.7,"greedy_SVM","SVM",80,2,3612,3370,242,300,158,142,0.90012547149227,0.635135135135135,1.7006160572337,163,84,79,43,0.9,7.67,1.1,0,0,0,0,0,0,0.437618449081149,281.389428712392,56.304191651503
8.7,"greedy_SVM","SVM",80,3,3512,3318,194,400,210,190,0.883050437981237,0.662162162162162,1.66012519872814,251,127,124,88,1,10.22,1.1,0,0,0,0,0,0,0.275801341997034,205.379516629358,41.5211139782767
8.7,"greedy_SVM","SVM",80,4,3412,3262,150,500,266,234,0.867143094651741,0.675675675675676,1.59016475038574,336,168,168,85,1,12.78,1.1,0,0,0,0,0,0,0.202439602527006,230.169277524871,29.7534506104475
8.7,"greedy_SVM","SVM",80,5,3312,3199,113,600,329,271,0.883173831270719,0.666666666666667,1.62112434421542,418,207,211,82,1,15.34,1.2,0,0,0,0,0,0,0.133242984569966,148.712191422026,18.915889190196
8.7,"greedy_SVM","SVM",80,6,3212,3123,89,700,405,295,0.89205035485313,0.675675675675676,1.6307301776915,474,232,242,56,1,17.89,1.4,0,0,0,0,0,0,0.0958241227809038,140.348532583922,11.853626917882
8.7,"greedy_SVM","SVM",80,7,3112,3038,74,800,490,310,0.886988632230843,0.68018018018018,1.62261709223035,516,251,265,42,1.1,20.45,1.6,0,0,0,0,0,0,0.106924383622329,168.410186659757,12.9245985283275
8.7,"greedy_SVM","SVM",80,8,3012,2950,62,900,578,322,0.89930328252128,0.689189189189189,1.65354683109973,552,269,283,36,1.1,23.01,1.8,0,0,0,0,0,0,0.0814317392941813,121.873266169658,10.7424989231471
8.7,"greedy_SVM","SVM",80,9,2912,2860,52,1000,668,332,0.916960212807955,0.684684684684685,1.70531822144725,586,282,304,34,1.1,25.56,2,0,0,0,0,0,0,0.0680413567546282,97.5267905974009,8.26898583587447
8.7,"greedy_SVM","SVM",80,10,2812,2769,43,1100,759,341,0.921589409478683,0.684684684684685,1.69719765848798,610,291,319,24,1.1,28.12,2.2,0,0,0,0,0,0,0.0610700215865759,89.4605632608234,6.90958620941862
8.7,"greedy_SVM","SVM",80,11,2712,2674,38,1200,854,346,0.926151064559379,0.689189189189189,1.70374794684187,639,305,334,29,1.1,30.67,2.5,0,0,0,0,0,0,0.0555713941125984,74.7198682778877,6.00434373577244
8.7,"greedy_SVM","SVM",80,12,2612,2577,35,1300,951,349,0.928298107796385,0.689189189189189,1.71186103230302,649,309,340,10,1.1,33.23,2.7,0,0,0,0,0,0,0.0466994990227027,59.5984730904295,4.99997099709905
8.7,"greedy_SVM","SVM",80,13,2512,2481,31,1400,1047,353,0.929854162120603,0.689189189189189,1.71997411776417,652,313,339,3,1.1,35.79,3,0,0,0,0,0,0,0.0495938317476182,65.1606609596112,5.36256706042703
8.7,"greedy_SVM","SVM",80,14,2412,2383,29,1500,1145,355,0.932396063883958,0.689189189189189,1.72967991032507,659,317,342,7,1.1,38.34,3.2,0,0,0,0,0,0,0.0375952228065291,47.3882644221767,4.03581603015037
8.7,"greedy_SVM","SVM",80,15,2312,2286,26,1600,1242,358,0.933102652825852,0.684684684684685,1.74431337414763,673,319,354,14,1.1,40.9,3.5,0,0,0,0,0,0,0.0405683850539316,49.2814998682634,4.65489829420677
8.7,"greedy_SVM","SVM",80,16,2212,2193,19,1700,1335,365,0.937222689817859,0.689189189189189,1.75242645960878,691,327,364,18,1.1,43.46,3.7,0,0,0,0,0,0,0.0414854914144851,43.4200364000955,4.72424882221036
8.7,"greedy_SVM","SVM",80,17,2112,2095,17,1800,1433,367,0.938464415973082,0.689189189189189,1.75404159920289,696,330,366,5,1.1,46.01,3.9,0,0,0,0,0,0,0.0348756065494214,38.8206769287185,3.86931003736087
8.7,"greedy_SVM","SVM",80,18,2012,1999,13,1900,1529,371,0.93899175992603,0.689189189189189,1.75404159920289,711,335,376,15,1.1,48.57,4.1,0,0,0,0,0,0,0.0316917273131281,32.2249833894971,3.30754685698537
8.7,"greedy_SVM","SVM",80,19,1912,1899,13,2000,1629,371,0.937961750678017,0.675675675675676,1.77676571599224,728,352,376,17,1.1,51.12,4.4,0,0,0,0,0,0,0.0209281990632115,13.9993537795333,2.70333943722982
8.7,"greedy_SVM","SVM",80,20,1812,1800,12,2100,1728,372,0.938002015856691,0.68018018018018,1.77840328808071,729,352,377,1,1.1,53.68,4.6,0,0,0,0,0,0,0.0138140855069085,11.166393359414,1.73182018251748
8.7,"greedy_SVM","SVM",80,21,1712,1703,9,2200,1825,375,0.937287633654416,0.68018018018018,1.77840328808071,741,357,384,12,1.1,56.24,4.9,0,0,0,0,0,0,0.0124967207508585,11.1640640602029,1.40288639493983
8.7,"greedy_SVM","SVM",80,22,1612,1604,8,2300,1924,376,0.937252563982665,0.68018018018018,1.77676571599224,744,359,385,3,1.1,58.79,5.1,0,0,0,0,0,0,0.0119331110784015,10.0263112011456,1.23406255665769
8.7,"greedy_SVM","SVM",80,23,1512,1505,7,2400,2023,377,0.937591570809565,0.666666666666667,1.77840328808071,759,367,392,15,1.1,61.35,5.4,0,0,0,0,0,0,0.00877123345018901,6.24745884581661,1.04335884404875
8.7,"greedy_SVM","SVM",80,24,1412,1407,5,2500,2121,379,0.937756528154452,0.671171171171171,1.77676571599224,765,369,396,6,1.1,63.91,5.6,0,0,0,0,0,0,0.00715873159211957,5.41856331849449,0.796157650278746
8.7,"greedy_SVM","SVM",80,25,1312,1307,5,2600,2221,379,0.937879921443935,0.671171171171171,1.77840328808071,764,371,393,-1,1.1,66.46,5.9,0,0,0,0,0,0,0.00645441098845605,4.33513090775536,0.660504634786389
8.7,"greedy_SVM","SVM",80,26,1212,1207,5,2700,2321,379,0.938825503704404,0.671171171171171,1.77513115691589,766,373,393,2,1.1,69.02,6.1,0,0,0,0,0,0,0.00511467848890574,3.12900599773393,0.567395240598425
8.7,"greedy_SVM","SVM",80,27,1112,1107,5,2800,2421,379,0.938783939648999,0.671171171171171,1.77513115691589,765,372,393,-1,1.1,71.57,6.4,0,0,0,0,0,0,0.00458301992571733,2.49469498746294,0.472106314165881
8.7,"greedy_SVM","SVM",80,28,1012,1007,5,2900,2521,379,0.939133337489753,0.671171171171171,1.77349960254372,771,374,397,6,1.1,74.13,6.7,0,0,0,0,0,0,0.00361791924494633,1.74703924682876,0.396130290456953
8.7,"greedy_SVM","SVM",80,29,912,910,2,3000,2618,382,0.938002015856691,0.666666666666667,1.77840328808071,779,379,400,8,1.1,76.69,6.9,0,0,0,0,0,0,0.00338946747085747,1.56232013736889,0.366304071120424
8.7,"greedy_SVM","SVM",80,30,812,810,2,3100,2718,382,0.938191651859478,0.666666666666667,1.77840328808071,782,380,402,3,1.1,79.24,7.1,0,0,0,0,0,0,0.00262377968474008,1.03493280041807,0.282934611097213
8.7,"greedy_SVM","SVM",80,31,712,710,2,3200,2818,382,0.938253997942586,0.666666666666667,1.77840328808071,782,380,402,0,1.1,81.8,7.4,0,0,0,0,0,0,0.00209562255431575,0.727487663115406,0.232768574736465
8.7,"greedy_SVM","SVM",80,32,612,610,2,3300,2918,382,0.938334528299934,0.671171171171171,1.77840328808071,782,380,402,0,1.1,84.36,7.6,0,0,0,0,0,0,0.00172728521169982,0.560980271604021,0.203337197969616
8.7,"greedy_SVM","SVM",80,33,512,510,2,3400,3018,382,0.938442335068641,0.671171171171171,1.77676571599224,786,381,405,4,1.1,86.91,7.9,0,0,0,0,0,0,0.00133748194085032,0.417565686783905,0.16457433849024
8.7,"greedy_SVM","SVM",80,34,412,412,0,3500,3116,384,0.938474806986917,0.666666666666667,1.77840328808071,792,383,409,6,1.1,89.47,8.1,0,0,0,0,0,0,0.00157895899393621,0.454643764181957,0.210856323110398
8.7,"greedy_SVM","SVM",80,35,312,312,0,3600,3216,384,0.938999553186407,0.666666666666667,1.77349960254372,793,383,410,1,1.1,92.02,8.4,0,0,0,0,0,0,0.000636279698639806,0.154770307017049,0.0819966089059765
8.7,"greedy_SVM","SVM",80,36,212,212,0,3700,3316,384,0.939534690399746,0.666666666666667,1.77349960254372,795,384,411,2,1.1,94.58,8.6,0,0,0,0,0,0,0.000343681061072197,0.073808973493154,0.0478008642684227
8.7,"greedy_SVM","SVM",80,37,112,112,0,3800,3416,384,0.940080218626933,0.666666666666667,1.77840328808071,793,384,409,-2,1.1,97.14,8.9,0,0,0,0,0,0,0.000143205077699616,0.02457834741772,0.0230706436804616
8.7,"greedy_SVM","SVM",80,38,12,12,0,3900,3516,384,0.940472479399816,0.666666666666667,1.77349960254372,793,384,409,0,1.1,99.69,9.2,0,0,0,0,0,0,7.53788251395424e-05,0.00117100069288038,0.00117100069288038
8.7,"greedy_SVM","SVM",80,39,0,0,0,3912,3528,384,0.940543917620043,0.666666666666667,1.77349960254372,793,384,409,0,1.1,100,9.2,0,0,0,0,0,0,0,0,0
8.7,"greedy_SVM","SVM",81,0,3812,3404,408,100,91,9,0.827714447408839,0.455026455026455,1.62153463535952,23,9,14,0,1.6,2.56,10.1,0,0,0,0,0,0,0.246585973372929,384.422073999427,27.1936072801352
8.7,"greedy_SVM","SVM",81,1,3712,3365,347,200,130,70,0.855404640633837,0.53968253968254,1.63308577253531,94,46,48,71,1,5.11,1.9,0,0,0,0,0,0,0.794078948041593,317.852764214364,88.1402054823829
8.7,"greedy_SVM","SVM",81,2,3612,3341,271,300,154,146,0.842662211083262,0.55026455026455,1.62153463535952,141,73,68,47,0.9,7.67,1.1,0,0,0,0,0,0,0.458409336836382,182.426717801316,58.9156736253031
8.7,"greedy_SVM","SVM",81,3,3512,3299,213,400,196,204,0.828205519773139,0.576719576719577,1.55476556213883,225,112,113,84,1,10.22,1,0,0,0,0,0,0,0.318388574360685,145.735749216839,45.3513747078674
8.7,"greedy_SVM","SVM",81,4,3412,3251,161,500,244,256,0.865715663112368,0.597883597883598,1.66615557599918,312,158,154,87,1,12.78,1,0,0,0,0,0,0,0.290842656968065,163.226471576347,43.3471078266422
8.7,"greedy_SVM","SVM",81,5,3312,3186,126,600,309,291,0.82380682890019,0.608465608465608,1.49753492794967,391,197,194,79,1,15.34,1.1,0,0,0,0,0,0,0.164435840372463,121.924546334521,23.5447315565408
8.7,"greedy_SVM","SVM",81,6,3212,3115,97,700,380,320,0.8251033797157,0.624338624338624,1.50430046290212,474,230,244,83,1.1,17.89,1.2,0,0,0,0,0,0,0.10739098039643,85.7090685656239,14.9556729030623
8.7,"greedy_SVM","SVM",81,7,3112,3026,86,800,469,331,0.824245500250009,0.613756613756614,1.50568563828232,503,240,263,29,1.1,20.45,1.4,0,0,0,0,0,0,0.0637781316487271,63.8026729660871,7.97871802089984
8.7,"greedy_SVM","SVM",81,8,3012,2940,72,900,555,345,0.846102711977063,0.619047619047619,1.5533339179748,536,259,277,33,1.1,23.01,1.6,0,0,0,0,0,0,0.0564893704202153,60.2039823342109,6.48763009911946
8.7,"greedy_SVM","SVM",81,9,2912,2849,63,1000,646,354,0.849293185173194,0.619047619047619,1.55047852474323,557,268,289,21,1.1,25.56,1.8,0,0,0,0,0,0,0.053356956766956,67.8714752569793,6.17975944815972
8.7,"greedy_SVM","SVM",81,10,2812,2760,52,1100,735,365,0.860475561664007,0.645502645502645,1.57384244020189,589,282,307,32,1.1,28.12,2,0,0,0,0,0,0,0.0521702350645395,68.7967317548925,5.90928892164643
8.7,"greedy_SVM","SVM",81,11,2712,2663,49,1200,832,368,0.886232906040491,0.62962962962963,1.60460171836319,624,305,319,35,1,30.67,2.3,0,0,0,0,0,0,0.0447934158035228,37.2124882323365,5.62570547413566
8.7,"greedy_SVM","SVM",81,12,2612,2571,41,1300,924,376,0.896440623661904,0.634920634920635,1.63308577253531,646,317,329,22,1,33.23,2.5,0,0,0,0,0,0,0.0346905150361996,35.0049714178854,4.07301970808837
8.7,"greedy_SVM","SVM",81,13,2512,2478,34,1400,1017,383,0.90566919089838,0.619047619047619,1.67721944517525,656,322,334,10,1,35.79,2.7,0,0,0,0,0,0,0.0301412092161409,35.6034796718356,3.48423467702973
8.7,"greedy_SVM","SVM",81,14,2412,2389,23,1500,1106,394,0.9208535077239,0.624338624338624,1.75345669268321,689,336,353,33,1.1,38.34,2.8,0,0,0,0,0,0,0.0827386058822646,67.0734910238361,9.98261335563831
8.7,"greedy_SVM","SVM",81,15,2312,2291,21,1600,1204,396,0.922766893338475,0.619047619047619,1.77088535506199,701,343,358,12,1,40.9,3,0,0,0,0,0,0,0.057912254377948,43.6802705990483,6.30927246718542
8.7,"greedy_SVM","SVM",81,16,2212,2195,17,1700,1300,400,0.923293897826997,0.619047619047619,1.77088535506199,720,351,369,19,1.1,43.46,3.2,0,0,0,0,0,0,0.0513257968112967,36.4482539258563,5.69602580784251
8.7,"greedy_SVM","SVM",81,17,2112,2099,13,1800,1396,404,0.924439234286425,0.624338624338624,1.7725160045602,734,356,378,14,1.1,46.01,3.5,0,0,0,0,0,0,0.0470327910363793,31.9716083124781,5.36852305471495
8.7,"greedy_SVM","SVM",81,18,2012,2000,12,1900,1495,405,0.924671295921996,0.619047619047619,1.77414965986395,732,356,376,-2,1.1,48.57,3.7,0,0,0,0,0,0,0.0330490682363146,22.9760660729347,3.82860284412842
8.7,"greedy_SVM","SVM",81,19,1912,1904,8,2000,1591,409,0.925142905052349,0.613756613756614,1.76925770308123,745,361,384,13,1.1,51.12,3.9,0,0,0,0,0,0,0.0258456886909761,21.5143459653167,3.58610134460957
8.7,"greedy_SVM","SVM",81,20,1812,1806,6,2100,1689,411,0.92470423370253,0.608465608465608,1.77088535506199,750,365,385,5,1.1,53.68,4.1,0,0,0,0,0,0,0.0195715158800676,17.5108272777618,2.22909992695955
8.7,"greedy_SVM","SVM",81,21,1712,1706,6,2200,1789,411,0.924710222389899,0.608465608465608,1.77088535506199,751,365,386,1,1.1,56.24,4.4,0,0,0,0,0,0,0.0138964332856689,12.756788900384,1.5171146543757
8.7,"greedy_SVM","SVM",81,22,1612,1606,6,2300,1889,411,0.924825504621763,0.608465608465608,1.76925770308123,753,368,385,2,1,58.79,4.6,0,0,0,0,0,0,0.0124588830071128,10.5518681583275,1.27133580044181
8.7,"greedy_SVM","SVM",81,23,1512,1507,5,2400,1988,412,0.924367370037992,0.613756613756614,1.76925770308123,767,377,390,14,1,61.35,4.8,0,0,0,0,0,0,0.0087166440868325,6.92632066507636,1.11134100935133
8.7,"greedy_SVM","SVM",81,24,1412,1407,5,2500,2088,412,0.924373358725361,0.613756613756614,1.7725160045602,765,376,389,-2,1,63.91,5.1,0,0,0,0,0,0,0.00714174511582117,5.38710907535135,0.736993536980759
8.7,"greedy_SVM","SVM",81,25,1312,1307,5,2600,2188,412,0.924602426017247,0.608465608465608,1.77088535506199,776,381,395,11,1,66.46,5.3,0,0,0,0,0,0,0.00521987872943521,3.72201253560605,0.59307783524797
8.7,"greedy_SVM","SVM",81,26,1212,1207,5,2700,2288,412,0.924895871698356,0.608465608465608,1.76763304036031,776,381,395,0,1,69.02,5.6,0,0,0,0,0,0,0.00479371859576547,3.05674217913111,0.491577209900845
8.7,"greedy_SVM","SVM",81,27,1112,1107,5,2800,2388,412,0.924364375694307,0.613756613756614,1.7725160045602,787,384,403,11,1,71.57,5.8,0,0,0,0,0,0,0.00409027588676187,2.37558972471906,0.44039607119789
8.7,"greedy_SVM","SVM",81,28,1012,1007,5,2900,2488,412,0.924487143785383,0.608465608465608,1.76925770308123,785,384,401,-2,1,74.13,6,0,0,0,0,0,0,0.00413760216554522,2.13449353614707,0.428727938858553
8.7,"greedy_SVM","SVM",81,29,912,907,5,3000,2588,412,0.924138302746106,0.613756613756614,1.76763304036031,789,386,403,4,1,76.69,6.3,0,0,0,0,0,0,0.00326221237698526,1.49122240938247,0.354461825500196
8.7,"greedy_SVM","SVM",81,30,812,809,3,3100,2686,414,0.924562002377503,0.608465608465608,1.7725160045602,796,390,406,7,1,79.24,6.5,0,0,0,0,0,0,0.00309090666864271,1.30187612944495,0.337823948760334
8.7,"greedy_SVM","SVM",81,31,712,709,3,3200,2786,414,0.924225138712965,0.608465608465608,1.77088535506199,794,390,404,-2,1,81.8,6.7,0,0,0,0,0,0,0.00235068927946731,0.858338376728925,0.256413284524139
8.7,"greedy_SVM","SVM",81,32,612,609,3,3300,2886,414,0.924282031242976,0.608465608465608,1.7725160045602,792,390,402,-2,1,84.36,7,0,0,0,0,0,0,0.00221917594707294,0.716859041562233,0.24743687650205
8.7,"greedy_SVM","SVM",81,33,512,510,2,3400,2985,415,0.924401804990367,0.608465608465608,1.77088535506199,796,391,405,4,1,86.91,7.2,0,0,0,0,0,0,0.00152193679102336,0.457579013849747,0.18564404006106
8.7,"greedy_SVM","SVM",81,34,412,410,2,3500,3085,415,0.924470674895117,0.608465608465608,1.77088535506199,797,392,405,1,1,89.47,7.4,0,0,0,0,0,0,0.000876853886258706,0.252491158485685,0.113955977563483
8.7,"greedy_SVM","SVM",81,35,312,312,0,3600,3183,417,0.924371861553519,0.603174603174603,1.77088535506199,806,396,410,9,1,92.02,7.6,0,0,0,0,0,0,0.00108635781506434,0.269791565332487,0.136601889058626
8.7,"greedy_SVM","SVM",81,36,212,212,0,3700,3283,417,0.924683273296736,0.603174603174603,1.77387863180714,811,398,413,5,1,94.58,7.9,0,0,0,0,0,0,0.000666163710927423,0.135460577393923,0.0840024996161183
8.7,"greedy_SVM","SVM",81,37,112,112,0,3800,3383,417,0.924886888667302,0.608465608465608,1.78368809889547,819,400,419,8,1,97.14,8.1,0,0,0,0,0,0,0.000301119039802341,0.0486695874919496,0.0454268444347573
8.7,"greedy_SVM","SVM",81,38,12,12,0,3900,3483,417,0.925114458787345,0.608465608465608,1.78368809889547,821,401,420,2,1,99.69,8.4,0,0,0,0,0,0,0.000211977342677939,0.00316896246099145,0.00316896246099145
8.7,"greedy_SVM","SVM",81,39,0,0,0,3912,3495,417,0.925210277785258,0.608465608465608,1.78368809889547,821,401,420,0,1,100,8.4,0,0,0,0,0,0,0,0,0
8.7,"greedy_SVM","SVM",82,0,3812,3424,388,100,93,7,0.88525916973343,0.502369668246445,1.73655555990756,25,7,18,0,2.6,2.56,13.3,0,0,0,0,0,0,0.449898647076956,316.467650285841,56.9392007629919
8.7,"greedy_SVM","SVM",82,1,3712,3366,346,200,151,49,0.908735860074137,0.587677725118483,1.75842475976015,93,44,49,68,1.1,5.11,3.1,0,0,0,0,0,0,0.740074951358017,386.162848065125,82.5484510134961
8.7,"greedy_SVM","SVM",82,2,3612,3350,262,300,167,133,0.903284944119269,0.578199052132701,1.72586978836788,124,61,63,31,1,7.67,1.3,0,0,0,0,0,0,0.51589884532329,246.495728730692,62.8011786645529
8.7,"greedy_SVM","SVM",82,3,3512,3303,209,400,214,186,0.907568000651818,0.616113744075829,1.72804303265311,215,110,105,91,1,10.22,1.2,0,0,0,0,0,0,0.378462248531547,179.28062966884,53.6258750459033
8.7,"greedy_SVM","SVM",82,4,3412,3243,169,500,274,226,0.87133719903855,0.62085308056872,1.67460632930745,301,150,151,86,1,12.78,1.2,0,0,0,0,0,0,0.215883345827109,110.048235563033,31.0548779437007
8.7,"greedy_SVM","SVM",82,5,3312,3164,148,600,353,247,0.881391653879053,0.635071090047393,1.65751850962063,361,176,185,60,1.1,15.34,1.4,0,0,0,0,0,0,0.0775434095725945,51.5910010605999,12.1646002610544
8.7,"greedy_SVM","SVM",82,6,3212,3095,117,700,422,278,0.914219367454734,0.672985781990521,1.73975069433242,424,210,214,63,1,17.89,1.5,0,0,0,0,0,0,0.0714005240712658,58.1137576868181,10.8499928543414
8.7,"greedy_SVM","SVM",82,7,3112,3022,90,800,495,305,0.907809720392718,0.677725118483412,1.65751850962063,482,234,248,58,1.1,20.45,1.6,0,0,0,0,0,0,0.0734556352147788,90.1630128788249,11.0023905479983
8.7,"greedy_SVM","SVM",82,8,3012,2942,70,900,575,325,0.904402558426921,0.682464454976303,1.63590744354614,541,257,284,59,1.1,23.01,1.8,0,0,0,0,0,0,0.0824037975964153,106.836795224793,12.1597898355071
8.7,"greedy_SVM","SVM",82,9,2912,2852,60,1000,665,335,0.917050747565814,0.682464454976303,1.6754293664942,566,273,293,25,1.1,25.56,2,0,0,0,0,0,0,0.0658720846673806,84.7899852512125,7.66510191156282
8.7,"greedy_SVM","SVM",82,10,2812,2764,48,1100,753,347,0.919542633658803,0.687203791469194,1.66845534187197,609,288,321,43,1.1,28.12,2.2,0,0,0,0,0,0,0.0655248206374322,90.2436352791971,7.75255386326121
8.7,"greedy_SVM","SVM",82,11,2712,2672,40,1200,845,355,0.927427042735506,0.691943127962085,1.69710974594192,628,303,325,19,1.1,30.67,2.4,0,0,0,0,0,0,0.0644484568384192,79.2119754247852,7.23101643119089
8.7,"greedy_SVM","SVM",82,12,2612,2579,33,1300,938,362,0.934920354703354,0.691943127962085,1.7600454277415,649,312,337,21,1.1,33.23,2.6,0,0,0,0,0,0,0.0645420928387952,71.2383319857298,7.02065274302325
8.7,"greedy_SVM","SVM",82,13,2512,2482,30,1400,1035,365,0.935721560586105,0.696682464454976,1.75680707368862,659,315,344,10,1.1,35.79,2.8,0,0,0,0,0,0,0.060060099268529,64.0715779150903,6.43669298023011
8.7,"greedy_SVM","SVM",82,14,2412,2385,27,1500,1132,368,0.935794891294017,0.696682464454976,1.75842475976015,666,319,347,7,1.1,38.34,3.1,0,0,0,0,0,0,0.0521633196901977,54.2073902283861,5.9881261944541
8.7,"greedy_SVM","SVM",82,15,2312,2289,23,1600,1228,372,0.937161015222908,0.691943127962085,1.75842475976015,676,323,353,10,1.1,40.9,3.3,0,0,0,0,0,0,0.0401938384133059,43.9383682464521,4.56919681168204
8.7,"greedy_SVM","SVM",82,16,2212,2191,21,1700,1326,374,0.937177310935775,0.687203791469194,1.7600454277415,687,327,360,11,1.1,43.46,3.5,0,0,0,0,0,0,0.0342140619666621,39.1248224185204,3.74885395613798
8.7,"greedy_SVM","SVM",82,17,2112,2094,18,1800,1423,377,0.937500509241024,0.687203791469194,1.7600454277415,701,332,369,14,1.1,46.01,3.8,0,0,0,0,0,0,0.0290795779621916,32.6089530363603,3.11283801231568
8.7,"greedy_SVM","SVM",82,18,2012,1994,18,1900,1523,377,0.937106696180013,0.687203791469194,1.75680707368862,703,333,370,2,1.1,48.57,4,0,0,0,0,0,0,0.0248719761314002,25.7636971928999,2.57231957451784
8.7,"greedy_SVM","SVM",82,19,1912,1895,17,2000,1622,378,0.939570064775453,0.691943127962085,1.77713324742831,714,342,372,11,1.1,51.12,4.3,0,0,0,0,0,0,0.019142519403193,16.9702698004321,2.30207015472583
8.7,"greedy_SVM","SVM",82,20,1812,1800,12,2100,1717,383,0.939162671953709,0.691943127962085,1.77713324742831,724,348,376,10,1.1,53.68,4.5,0,0,0,0,0,0,0.0170911940808971,16.5421720726806,1.87531745809915
8.7,"greedy_SVM","SVM",82,21,1712,1701,11,2200,1816,384,0.939316123249893,0.687203791469194,1.77549684480637,737,356,381,13,1.1,56.24,4.7,0,0,0,0,0,0,0.0128436334681837,11.842961939593,1.43365437358027
8.7,"greedy_SVM","SVM",82,22,1612,1601,11,2300,1916,384,0.939920422602136,0.682464454976303,1.77911819617981,742,357,385,5,1.1,58.79,5,0,0,0,0,0,0,0.0106798308207946,8.88786014181634,1.10006907682828
8.7,"greedy_SVM","SVM",82,23,1512,1501,11,2400,2016,384,0.941234943440277,0.677725118483412,1.79091983240102,748,362,386,6,1.1,61.35,5.2,0,0,0,0,0,0,0.00805709774998667,6.19109277940853,0.935195727273205
8.7,"greedy_SVM","SVM",82,24,1412,1404,8,2500,2113,387,0.941516044487276,0.672985781990521,1.78927376637859,752,366,386,4,1.1,63.91,5.5,0,0,0,0,0,0,0.00985035465520754,6.86870560917303,1.00006901587626
8.7,"greedy_SVM","SVM",82,25,1312,1304,8,2600,2213,387,0.942390581077944,0.672985781990521,1.78927376637859,766,371,395,14,1.1,66.46,5.7,0,0,0,0,0,0,0.00658448918645478,4.35408974273423,0.770429593928397
8.7,"greedy_SVM","SVM",82,26,1212,1204,8,2700,2313,387,0.942324040250393,0.672985781990521,1.79091983240102,765,370,395,-1,1.1,69.02,6,0,0,0,0,0,0,0.00691653361703538,4.01835013553586,0.707741449994525
8.7,"greedy_SVM","SVM",82,27,1112,1104,8,2800,2413,387,0.942791184019321,0.66824644549763,1.79091983240102,765,374,391,0,1,71.57,6.2,0,0,0,0,0,0,0.00497496754560553,2.61777243018075,0.549822630601154
8.7,"greedy_SVM","SVM",82,28,1012,1006,6,2900,2511,389,0.942764024497872,0.66824644549763,1.79422106711512,772,377,395,7,1,74.13,6.5,0,0,0,0,0,0,0.00518166446733931,2.47070335862083,0.557309148315392
8.7,"greedy_SVM","SVM",82,29,912,907,5,3000,2610,390,0.942637732723133,0.663507109004739,1.78927376637859,775,380,395,3,1,76.69,6.7,0,0,0,0,0,0,0.00463517063733428,2.00442944850619,0.492204880973822
8.7,"greedy_SVM","SVM",82,30,812,808,4,3100,2709,391,0.942560328087002,0.663507109004739,1.78435367352879,779,381,398,4,1,79.24,6.9,0,0,0,0,0,0,0.00365621531244077,1.47283533669426,0.404571766523443
8.7,"greedy_SVM","SVM",82,31,712,708,4,3200,2809,391,0.942772172354306,0.663507109004739,1.78763072343426,780,381,399,1,1,81.8,7.2,0,0,0,0,0,0,0.00289367337078844,1.03618671031135,0.322652881758532
8.7,"greedy_SVM","SVM",82,32,612,608,4,3300,2909,391,0.942796615923611,0.663507109004739,1.79091983240102,784,382,402,4,1.1,84.36,7.4,0,0,0,0,0,0,0.00217385420177682,0.693346843865147,0.246146096223987
8.7,"greedy_SVM","SVM",82,33,512,509,3,3400,3008,392,0.943149689702453,0.663507109004739,1.79091983240102,786,384,402,2,1,86.91,7.7,0,0,0,0,0,0,0.00147640500502516,0.474783557240325,0.185176869333707
8.7,"greedy_SVM","SVM",82,34,412,410,2,3500,3107,393,0.943110308396354,0.663507109004739,1.78271965001823,788,385,403,2,1,89.47,7.9,0,0,0,0,0,0,0.00115610595899126,0.339569973273957,0.142997174906262
8.7,"greedy_SVM","SVM",82,35,312,311,1,3600,3206,394,0.943519059194169,0.654028436018957,1.79091983240102,793,387,406,5,1,92.02,8.1,0,0,0,0,0,0,0.0011125284117552,0.2780999587223,0.138319120657497
8.7,"greedy_SVM","SVM",82,36,212,212,0,3700,3305,395,0.943418568964807,0.654028436018957,1.79256892985258,801,390,411,8,1.1,94.58,8.4,0,0,0,0,0,0,0.000725507401452431,0.154072087565132,0.0972376788446766
8.7,"greedy_SVM","SVM",82,37,112,112,0,3800,3405,395,0.94336424992191,0.654028436018957,1.79091983240102,802,393,409,1,1,97.14,8.6,0,0,0,0,0,0,0.000303236424429217,0.0481690424340171,0.0448244874907446
8.7,"greedy_SVM","SVM",82,38,12,12,0,3900,3505,395,0.943445728486258,0.658767772511848,1.79091983240102,805,393,412,3,1,99.69,8.9,0,0,0,0,0,0,0.000190110838364666,0.00262191207335369,0.00262191207335369
8.7,"greedy_SVM","SVM",82,39,0,0,0,3912,3517,395,0.943331658496171,0.658767772511848,1.78763072343426,803,393,410,-2,1,100,8.9,0,0,0,0,0,0,0,0,0
8.7,"greedy_SVM","SVM",83,0,3812,3431,381,100,86,14,0.899902225722781,0.597156398104265,1.72861883431384,40,14,26,0,1.9,2.56,6.1,0,0,0,0,0,0,0.647296111343801,485.02211371881,70.9880583083066
8.7,"greedy_SVM","SVM",83,1,3712,3411,301,200,106,94,0.906701611917604,0.616113744075829,1.76047654245837,98,48,50,58,1,5.11,1.1,0,0,0,0,0,0,0.636309676498261,321.450357044311,75.661258329724
8.7,"greedy_SVM","SVM",83,2,3612,3387,225,300,130,170,0.902753975474936,0.601895734597156,1.74667201003624,146,74,72,48,1,7.67,0.8,0,0,0,0,0,0,0.527142586057668,292.778434893645,60.56993132242
8.7,"greedy_SVM","SVM",83,3,3512,3327,185,400,190,210,0.866500088268432,0.587677725118483,1.64291776010863,244,123,121,98,1,10.22,0.9,0,0,0,0,0,0,0.331039469689574,196.059097294972,47.0612501596851
8.7,"greedy_SVM","SVM",83,4,3412,3259,153,500,258,242,0.837542606499272,0.592417061611374,1.61479896040361,332,168,164,88,1,12.78,1.1,0,0,0,0,0,0,0.193358554434117,158.392729769819,26.9313188265117
8.7,"greedy_SVM","SVM",83,5,3312,3173,139,600,344,256,0.872067790165533,0.592417061611374,1.67152517690762,381,185,196,49,1.1,15.34,1.3,0,0,0,0,0,0,0.0828180281306645,74.4260253954462,12.2905276323262
8.7,"greedy_SVM","SVM",83,6,3212,3097,115,700,420,280,0.8669509363245,0.635071090047393,1.64043068993382,440,214,226,59,1.1,17.89,1.5,0,0,0,0,0,0,0.136097280728606,157.084925615735,19.6765947983905
8.7,"greedy_SVM","SVM",83,7,3112,3010,102,800,507,293,0.87449449340702,0.654028436018957,1.6188667410092,461,219,242,21,1.1,20.45,1.7,0,0,0,0,0,0,0.103791025139823,137.131049931973,16.0027410991138
8.7,"greedy_SVM","SVM",83,8,3012,2936,76,900,581,319,0.869066663045389,0.654028436018957,1.57771509044851,520,252,268,59,1.1,23.01,1.8,0,0,0,0,0,0,0.103973520198923,142.021248864525,14.5896270893428
8.7,"greedy_SVM","SVM",83,9,2912,2846,66,1000,671,329,0.885050041418264,0.649289099526066,1.62184807939043,553,269,284,33,1.1,25.56,2,0,0,0,0,0,0,0.0622911642406588,84.9108437733416,7.88860176030521
8.7,"greedy_SVM","SVM",83,10,2812,2756,56,1100,761,339,0.894068360515484,0.663507109004739,1.62738709227767,573,277,296,20,1.1,28.12,2.2,0,0,0,0,0,0,0.0596594627404618,80.3041669054992,6.65447645054919
8.7,"greedy_SVM","SVM",83,11,2712,2666,46,1200,851,349,0.908978937791131,0.663507109004739,1.69013641957529,602,294,308,29,1,30.67,2.4,0,0,0,0,0,0,0.0631698525291212,80.8067727714798,7.15109451556862
8.7,"greedy_SVM","SVM",83,12,2612,2573,39,1300,944,356,0.91979521720828,0.663507109004739,1.72269431497622,624,301,323,22,1.1,33.23,2.7,0,0,0,0,0,0,0.060349639018301,64.7185260742932,6.5992573442616
8.7,"greedy_SVM","SVM",83,13,2512,2479,33,1400,1038,362,0.925197246024537,0.663507109004739,1.74295760805469,641,308,333,17,1.1,35.79,2.9,0,0,0,0,0,0,0.0552583763902822,56.0201599345417,6.10179163586589
8.7,"greedy_SVM","SVM",83,14,2412,2382,30,1500,1135,365,0.928456388598447,0.663507109004739,1.75150151789809,650,311,339,9,1.1,38.34,3.1,0,0,0,0,0,0,0.0461891358191027,48.0851231354337,5.21310966175328
8.7,"greedy_SVM","SVM",83,15,2312,2288,24,1600,1229,371,0.930458045329252,0.66824644549763,1.75150151789809,661,316,345,11,1.1,40.9,3.3,0,0,0,0,0,0,0.0420503154231088,46.9785588607439,4.77805527690557
8.7,"greedy_SVM","SVM",83,16,2212,2192,20,1700,1325,375,0.93068890126157,0.658767772511848,1.74988871723705,675,322,353,14,1.1,43.46,3.5,0,0,0,0,0,0,0.0361525340723062,41.7086078895012,3.96327618912072
8.7,"greedy_SVM","SVM",83,17,2112,2092,20,1800,1425,375,0.930889881720295,0.658767772511848,1.75150151789809,681,325,356,6,1.1,46.01,3.8,0,0,0,0,0,0,0.0321986416905036,34.760412099592,3.28499136130151
8.7,"greedy_SVM","SVM",83,18,2012,1995,17,1900,1522,378,0.932182674941273,0.658767772511848,1.76533526336672,719,348,371,38,1.1,48.57,4,0,0,0,0,0,0,0.0215651512817935,13.8311052986203,3.05449921347444
8.7,"greedy_SVM","SVM",83,19,1912,1899,13,2000,1618,382,0.932323904452806,0.663507109004739,1.76533526336672,726,351,375,7,1.1,51.12,4.2,0,0,0,0,0,0,0.0158327314550527,11.7045732643408,1.89067790483976
8.7,"greedy_SVM","SVM",83,20,1812,1803,9,2100,1714,386,0.932522168959381,0.649289099526066,1.7685893375849,738,356,382,12,1.1,53.68,4.4,0,0,0,0,0,0,0.013259266989075,11.6900575722599,1.55170078495793
8.7,"greedy_SVM","SVM",83,21,1712,1704,8,2200,1813,387,0.932557476337264,0.654028436018957,1.76209314167091,739,357,382,1,1.1,56.24,4.7,0,0,0,0,0,0,0.0124572165249963,10.2754344368767,1.27442068592372
8.7,"greedy_SVM","SVM",83,22,1612,1606,6,2300,1911,389,0.933212020804198,0.644549763033175,1.77713324742831,763,371,392,24,1.1,58.79,4.9,0,0,0,0,0,0,0.00951633907734774,7.13108125058992,1.15843824704228
8.7,"greedy_SVM","SVM",83,23,1512,1506,6,2400,2011,389,0.933358682220024,0.644549763033175,1.77713324742831,761,369,392,-2,1.1,61.35,5.2,0,0,0,0,0,0,0.00897980976487026,6.44908214637704,0.93059429736989
8.7,"greedy_SVM","SVM",83,24,1412,1407,5,2500,2110,390,0.934268526188578,0.644549763033175,1.77713324742831,764,374,390,3,1,63.91,5.4,0,0,0,0,0,0,0.00737900091611196,4.69793420127627,0.7770291030579
8.7,"greedy_SVM","SVM",83,25,1312,1307,5,2600,2210,390,0.93440703974797,0.644549763033175,1.77713324742831,764,375,389,0,1,66.46,5.7,0,0,0,0,0,0,0.00612992619024675,3.74608103754023,0.668502757289353
8.7,"greedy_SVM","SVM",83,26,1212,1208,4,2700,2309,391,0.934450494982289,0.644549763033175,1.77549684480637,771,378,393,7,1,69.02,5.9,0,0,0,0,0,0,0.0050776320876533,2.92243831233197,0.546802838510948
8.7,"greedy_SVM","SVM",83,27,1112,1108,4,2800,2409,391,0.934485802360173,0.644549763033175,1.77549684480637,773,379,394,2,1,71.57,6.2,0,0,0,0,0,0,0.00432658442490124,2.29804708654286,0.465174838509497
8.7,"greedy_SVM","SVM",83,28,1012,1010,2,2900,2507,393,0.934138160485624,0.639810426540284,1.77713324742831,781,382,399,8,1,74.13,6.4,0,0,0,0,0,0,0.00396779585179432,2.06138302066506,0.436405759563925
8.7,"greedy_SVM","SVM",83,29,912,911,1,3000,2606,394,0.933988783117654,0.644549763033175,1.77386345304482,783,383,400,2,1,76.69,6.6,0,0,0,0,0,0,0.0036941480910096,1.84985914785578,0.403348373190607
8.7,"greedy_SVM","SVM",83,30,812,811,1,3100,2706,394,0.933958907644059,0.644549763033175,1.77713324742831,783,383,400,0,1,79.24,6.9,0,0,0,0,0,0,0.00263274534523031,1.18483851601378,0.286028525425455
8.7,"greedy_SVM","SVM",83,31,712,711,1,3200,2806,394,0.933961623596204,0.639810426540284,1.77713324742831,783,383,400,0,1,81.8,7.1,0,0,0,0,0,0,0.00214009958317164,0.871403944028815,0.234982199093408
8.7,"greedy_SVM","SVM",83,32,612,611,1,3300,2906,394,0.93388829288829,0.639810426540284,1.77549684480637,782,383,399,-1,1,84.36,7.4,0,0,0,0,0,0,0.00205277631703564,0.763411687956121,0.228006042180082
8.7,"greedy_SVM","SVM",83,33,512,511,1,3400,3006,394,0.933882860984,0.639810426540284,1.77713324742831,786,385,401,4,1,86.91,7.6,0,0,0,0,0,0,0.00150876800796377,0.505276751644262,0.174356085554791
8.7,"greedy_SVM","SVM",83,34,412,412,0,3500,3105,395,0.933486331970839,0.635071090047393,1.77060566892536,796,387,409,10,1.1,89.47,7.9,0,0,0,0,0,0,0.00116733767607967,0.34319833611561,0.136547062134353
8.7,"greedy_SVM","SVM",83,35,312,312,0,3600,3205,395,0.933499911731563,0.639810426540284,1.77386345304482,796,388,408,0,1.1,92.02,8.1,0,0,0,0,0,0,0.000983957860796981,0.246095760059581,0.119757382183072
8.7,"greedy_SVM","SVM",83,36,212,212,0,3700,3305,395,0.933452382569027,0.639810426540284,1.77549684480637,797,388,409,1,1.1,94.58,8.4,0,0,0,0,0,0,0.000447963222343527,0.0945819053353292,0.0600258678309333
8.7,"greedy_SVM","SVM",83,37,112,112,0,3800,3405,395,0.933554230774461,0.644549763033175,1.77386345304482,800,389,411,3,1.1,97.14,8.6,0,0,0,0,0,0,0.000174198122509859,0.0313205364945034,0.029474075474238
8.7,"greedy_SVM","SVM",83,38,12,12,0,3900,3505,395,0.933787802658924,0.644549763033175,1.77713324742831,799,390,409,-1,1,99.69,8.9,0,0,0,0,0,0,0.000161838637442428,0.00216942484344237,0.00216942484344237
8.7,"greedy_SVM","SVM",83,39,0,0,0,3912,3517,395,0.933766075041764,0.644549763033175,1.77060566892536,799,390,409,0,1,100,8.9,0,0,0,0,0,0,0,0,0
8.7,"greedy_SVM","SVM",84,0,3812,3426,386,100,91,9,0.865696166433548,0.535545023696682,1.66606241946404,22,9,13,0,1.4,2.56,10.1,0,0,0,0,0,0,0.268625030039687,320.279392732882,29.343849054084
8.7,"greedy_SVM","SVM",84,1,3712,3389,323,200,128,72,0.862089381985085,0.578199052132701,1.64043068993382,102,52,50,80,1,5.11,1.8,0,0,0,0,0,0,0.636925307508294,238.906299086618,75.228728439436
8.7,"greedy_SVM","SVM",84,2,3612,3358,254,300,159,141,0.833072149268725,0.540284360189573,1.5977111407168,161,85,76,59,0.9,7.67,1.1,0,0,0,0,0,0,0.331973594250211,124.285129743873,49.3920408748885
8.7,"greedy_SVM","SVM",84,3,3512,3307,205,400,210,190,0.851350507204062,0.611374407582938,1.58062332102999,247,123,124,86,1,10.22,1.1,0,0,0,0,0,0,0.210399600299863,91.2026517372803,37.9137346238632
8.7,"greedy_SVM","SVM",84,4,3412,3253,159,500,264,236,0.871600646396604,0.649289099526066,1.62334287024701,329,166,163,82,1,12.78,1.1,0,0,0,0,0,0,0.123394371211964,61.0914265358771,20.8433477965544
8.7,"greedy_SVM","SVM",84,5,3312,3196,116,600,321,279,0.897277257974707,0.649289099526066,1.65994281461752,418,206,212,89,1,15.34,1.2,0,0,0,0,0,0,0.103826344842014,68.0722099169435,15.7979400072795
8.7,"greedy_SVM","SVM",84,6,3212,3123,89,700,394,306,0.894645500346293,0.66824644549763,1.63741241819522,483,232,251,65,1.1,17.89,1.3,0,0,0,0,0,0,0.0713196800384174,58.6224663707173,10.2819163143867
8.7,"greedy_SVM","SVM",84,7,3112,3044,68,800,473,327,0.88127079400861,0.682464454976303,1.61034638974073,526,250,276,43,1.1,20.45,1.4,0,0,0,0,0,0,0.0718055881128033,107.209054394418,10.2623181312558
8.7,"greedy_SVM","SVM",84,8,3012,2955,57,900,562,338,0.896348402341144,0.677725118483412,1.65446879755142,562,268,294,36,1.1,23.01,1.7,0,0,0,0,0,0,0.0586238137699379,82.3445928116581,7.26716508414787
8.7,"greedy_SVM","SVM",84,9,2912,2859,53,1000,658,342,0.902269178017083,0.677725118483412,1.66606241946404,574,275,299,12,1.1,25.56,1.9,0,0,0,0,0,0,0.0470984744035785,68.4348539202563,5.17580078635352
8.7,"greedy_SVM","SVM",84,10,2812,2763,49,1100,754,346,0.910305680413919,0.682464454976303,1.6986724620984,599,287,312,25,1.1,28.12,2.2,0,0,0,0,0,0,0.0370500697405674,51.7710510817994,4.23313831764003
8.7,"greedy_SVM","SVM",84,11,2712,2668,44,1200,849,351,0.92048506905308,0.672985781990521,1.70878196868107,610,295,315,11,1.1,30.67,2.4,0,0,0,0,0,0,0.0376334810700559,50.9005520026844,4.23395665588607
8.7,"greedy_SVM","SVM",84,12,2612,2574,38,1300,943,357,0.925580195276948,0.677725118483412,1.71416612529812,627,303,324,17,1.1,33.23,2.6,0,0,0,0,0,0,0.044061615300447,52.4713437250403,5.07762634702503
8.7,"greedy_SVM","SVM",84,13,2512,2478,34,1400,1039,361,0.929887695378805,0.682464454976303,1.73281663219083,646,311,335,19,1.1,35.79,2.9,0,0,0,0,0,0,0.0447541519206497,46.596510089745,5.05693128140706
8.7,"greedy_SVM","SVM",84,14,2412,2380,32,1500,1137,363,0.932158231371965,0.677725118483412,1.75150151789809,662,318,344,16,1.1,38.34,3.1,0,0,0,0,0,0,0.0380026703176035,37.4904065507425,4.15920722870565
8.7,"greedy_SVM","SVM",84,15,2312,2281,31,1600,1236,364,0.932283165170633,0.677725118483412,1.74506808716201,666,320,346,4,1.1,40.9,3.4,0,0,0,0,0,0,0.0347072370314028,34.5831774813881,3.81850063534311
8.7,"greedy_SVM","SVM",84,16,2212,2187,25,1700,1330,370,0.93155800594794,0.677725118483412,1.74135267471394,682,326,356,16,1.1,43.46,3.6,0,0,0,0,0,0,0.0339360379535671,27.618811381401,4.31708961512148
8.7,"greedy_SVM","SVM",84,17,2112,2096,16,1800,1421,379,0.930312741889488,0.677725118483412,1.74135267471394,712,337,375,30,1.1,46.01,3.7,0,0,0,0,0,0,0.0339674629755859,30.3631825256152,4.32554115769244
8.7,"greedy_SVM","SVM",84,18,2012,2001,11,1900,1516,384,0.930026208938197,0.677725118483412,1.74295760805469,723,341,382,11,1.1,48.57,3.9,0,0,0,0,0,0,0.0266461368361347,25.9759895158746,2.99232228567666
8.7,"greedy_SVM","SVM",84,19,1912,1902,10,2000,1615,385,0.929842882168417,0.672985781990521,1.74135267471394,730,343,387,7,1.1,51.12,4.2,0,0,0,0,0,0,0.0233785834171573,23.3367445859758,2.51361192037505
8.7,"greedy_SVM","SVM",84,20,1812,1802,10,2100,1715,385,0.930832846725241,0.672985781990521,1.74988871723705,733,348,385,3,1.1,53.68,4.5,0,0,0,0,0,0,0.0162005599298965,15.1528479129419,1.85921742993258
8.7,"greedy_SVM","SVM",84,21,1712,1703,9,2200,1814,386,0.93076494792162,0.66824644549763,1.75150151789809,740,352,388,7,1.1,56.24,4.7,0,0,0,0,0,0,0.0125771575734835,10.6225390720449,1.31323052526679
8.7,"greedy_SVM","SVM",84,22,1612,1604,8,2300,1913,387,0.930805687203802,0.654028436018957,1.75680707368862,755,364,391,15,1.1,58.79,4.9,0,0,0,0,0,0,0.00840396380060503,6.12506385886305,1.07947811729437
8.7,"greedy_SVM","SVM",84,23,1512,1507,5,2400,2010,390,0.930900745528875,0.649289099526066,1.75680707368862,762,368,394,7,1.1,61.35,5.2,0,0,0,0,0,0,0.00811744981905436,6.14399034720152,0.865234183978258
8.7,"greedy_SVM","SVM",84,24,1412,1408,4,2500,2109,391,0.930672605548703,0.649289099526066,1.75358061441646,770,373,397,8,1.1,63.91,5.4,0,0,0,0,0,0,0.00596206552670457,4.32820561965521,0.674699445581497
8.7,"greedy_SVM","SVM",84,25,1312,1309,3,2600,2208,392,0.930616928529731,0.649289099526066,1.75519236130471,777,375,402,7,1.1,66.46,5.6,0,0,0,0,0,0,0.0065626351747841,4.32884509593107,0.671254509701212
8.7,"greedy_SVM","SVM",84,26,1212,1209,3,2700,2308,392,0.931635410584059,0.649289099526066,1.75519236130471,792,383,409,15,1.1,69.02,5.9,0,0,0,0,0,0,0.00499747170764244,3.04323322600008,0.576297629379558
8.7,"greedy_SVM","SVM",84,27,1112,1109,3,2800,2408,392,0.93154714213935,0.649289099526066,1.75358061441646,788,382,406,-4,1.1,71.57,6.1,0,0,0,0,0,0,0.00417189870245765,2.24665782291577,0.4303356199759
8.7,"greedy_SVM","SVM",84,28,1012,1009,3,2900,2508,392,0.932063173046884,0.644549763033175,1.75519236130471,790,384,406,2,1.1,74.13,6.4,0,0,0,0,0,0,0.0030031616760769,1.44377057038573,0.322025627546451
8.7,"greedy_SVM","SVM",84,29,912,909,3,3000,2608,392,0.932336126237452,0.639810426540284,1.75842475976015,791,384,407,1,1.1,76.69,6.7,0,0,0,0,0,0,0.00231867502038438,0.938959951977831,0.24363046210426
8.7,"greedy_SVM","SVM",84,30,812,810,2,3100,2707,393,0.932516737055092,0.644549763033175,1.75680707368862,796,386,410,5,1.1,79.24,6.9,0,0,0,0,0,0,0.00218258715804167,0.777441925569905,0.237670368029028
8.7,"greedy_SVM","SVM",84,31,712,711,1,3200,2806,394,0.933043631771211,0.644549763033175,1.75680707368862,798,389,409,2,1.1,81.8,7.1,0,0,0,0,0,0,0.00201744085567674,0.652001273753123,0.224106552041978
8.7,"greedy_SVM","SVM",84,32,612,611,1,3300,2906,394,0.933418433167215,0.644549763033175,1.75842475976015,799,389,410,1,1.1,84.36,7.4,0,0,0,0,0,0,0.00127697617895248,0.384249428822167,0.153661998991401
8.7,"greedy_SVM","SVM",84,33,512,511,1,3400,3006,394,0.933593612080565,0.644549763033175,1.75842475976015,800,389,411,1,1.1,86.91,7.6,0,0,0,0,0,0,0.000693616344216179,0.198295407218054,0.092311660021823
8.7,"greedy_SVM","SVM",84,34,412,412,0,3500,3105,395,0.933994215021946,0.644549763033175,1.75842475976015,804,391,413,4,1.1,89.47,7.9,0,0,0,0,0,0,0.000477300308150982,0.137399823694257,0.0637959986465679
8.7,"greedy_SVM","SVM",84,35,312,312,0,3600,3205,395,0.934545553307367,0.644549763033175,1.7600454277415,805,391,414,1,1.1,92.02,8.1,0,0,0,0,0,0,0.000368713326887827,0.0947317489912788,0.0493050768412667
8.7,"greedy_SVM","SVM",84,36,212,212,0,3700,3305,395,0.934398891891541,0.639810426540284,1.75842475976015,809,393,416,4,1.1,94.58,8.4,0,0,0,0,0,0,0.000126794524533589,0.0270156261673303,0.0174783701448143
8.7,"greedy_SVM","SVM",84,37,112,112,0,3800,3405,395,0.934700362579626,0.635071090047393,1.75519236130471,810,394,416,1,1.1,97.14,8.6,0,0,0,0,0,0,4.11382780250104e-05,0.00739557882582239,0.00700114200952739
8.7,"greedy_SVM","SVM",84,38,12,12,0,3900,3505,395,0.935053436358467,0.635071090047393,1.7685893375849,810,395,415,0,1.1,99.69,8.9,0,0,0,0,0,0,2.00062946819329e-05,0.000305748224959315,0.000305748224959315
8.7,"greedy_SVM","SVM",84,39,0,0,0,3912,3517,395,0.93514306277925,0.635071090047393,1.7685893375849,810,395,415,0,1.1,100,8.9,0,0,0,0,0,0,0,0,0
8.7,"greedy_SVM","SVM",85,0,3812,3423,389,100,94,6,0.837156941294698,0.5260663507109,1.6062550505602,24,6,18,0,3,2.56,15.7,0,0,0,0,0,0,0.142352373328418,265.230780220632,15.2939880778356
8.7,"greedy_SVM","SVM",85,1,3712,3385,327,200,132,68,0.896495063756969,0.582938388625592,1.67696786912642,81,42,39,57,0.9,5.11,1.9,0,0,0,0,0,0,0.686044835975415,262.225182763181,79.5678817543043
8.7,"greedy_SVM","SVM",85,2,3612,3354,258,300,163,137,0.895795706079665,0.554502369668246,1.72428058966772,139,72,67,58,0.9,7.67,1.2,0,0,0,0,0,0,0.340850063271712,109.64917787014,52.1153194574481
8.7,"greedy_SVM","SVM",85,3,3512,3296,216,400,221,179,0.882228167139702,0.57345971563981,1.70023805883766,236,120,116,97,1,10.22,1.2,0,0,0,0,0,0,0.132997213782146,51.256239411356,26.1462525458793
8.7,"greedy_SVM","SVM",85,4,3412,3246,166,500,271,229,0.884156493162601,0.601895734597156,1.69710974594192,312,155,157,76,1,12.78,1.2,0,0,0,0,0,0,0.152247579967296,79.2496044623597,25.6540906449126
8.7,"greedy_SVM","SVM",85,5,3312,3189,123,600,328,272,0.882985917788119,0.625592417061611,1.70023805883766,398,196,202,86,1,15.34,1.2,0,0,0,0,0,0,0.15472642678277,100.544603063128,22.1707816681362
8.7,"greedy_SVM","SVM",85,6,3212,3109,103,700,408,292,0.886663316992345,0.630331753554502,1.67696786912642,443,214,229,45,1.1,17.89,1.4,0,0,0,0,0,0,0.0797792141002168,54.500769705298,11.504171655555
8.7,"greedy_SVM","SVM",85,7,3112,3028,84,800,489,311,0.891649805130445,0.644549763033175,1.65751850962063,493,238,255,50,1.1,20.45,1.6,0,0,0,0,0,0,0.0763464245825401,84.5566033318784,10.005836816926
8.7,"greedy_SVM","SVM",85,8,3012,2947,65,900,570,330,0.884969920829998,0.658767772511848,1.61034638974073,532,255,277,39,1.1,23.01,1.7,0,0,0,0,0,0,0.0645472858931868,103.257410806369,10.7165533020151
8.7,"greedy_SVM","SVM",85,9,2912,2858,54,1000,659,341,0.893838862559244,0.663507109004739,1.63892016443665,559,271,288,27,1.1,25.56,1.9,0,0,0,0,0,0,0.0526078786039186,76.8915497863581,6.00315876012882
8.7,"greedy_SVM","SVM",85,10,2812,2764,48,1100,753,347,0.900368011515631,0.654028436018957,1.66606241946404,582,281,301,23,1.1,28.12,2.2,0,0,0,0,0,0,0.0504934050353892,76.678859134245,5.67649617062624
8.7,"greedy_SVM","SVM",85,11,2712,2671,41,1200,846,354,0.909656567851272,0.654028436018957,1.68315023915085,608,297,311,26,1,30.67,2.4,0,0,0,0,0,0,0.0457627596703692,67.0201631956361,4.97210989268893
8.7,"greedy_SVM","SVM",85,12,2612,2578,34,1300,939,361,0.914602316707188,0.654028436018957,1.71416612529812,631,306,325,23,1.1,33.23,2.6,0,0,0,0,0,0,0.0620774576602048,67.7288676944829,7.34366449405938
8.7,"greedy_SVM","SVM",85,13,2512,2485,27,1400,1032,368,0.91983867244258,0.654028436018957,1.70407025369389,663,321,342,32,1.1,35.79,2.8,0,0,0,0,0,0,0.0565172150153194,53.8105086629165,6.31643667447803
8.7,"greedy_SVM","SVM",85,14,2412,2386,26,1500,1131,369,0.920235201455741,0.654028436018957,1.70250545088977,669,322,347,6,1.1,38.34,3.1,0,0,0,0,0,0,0.0473090671936913,47.5747896865582,5.21135780025635
8.7,"greedy_SVM","SVM",85,15,2312,2288,24,1600,1229,371,0.921088010429254,0.654028436018957,1.71101797814422,675,324,351,6,1.1,40.9,3.3,0,0,0,0,0,0,0.0374521965154858,35.3766638251289,4.25018385431921
8.7,"greedy_SVM","SVM",85,16,2212,2195,17,1700,1322,378,0.918916606689381,0.654028436018957,1.71574454714462,695,333,362,20,1.1,43.46,3.5,0,0,0,0,0,0,0.0414861250163265,34.7261757890829,5.45342781954768
8.7,"greedy_SVM","SVM",85,17,2112,2101,11,1800,1416,384,0.918054291883364,0.654028436018957,1.71101797814422,716,339,377,21,1.1,46.01,3.7,0,0,0,0,0,0,0.0355877976836129,30.5152311089424,4.13809440190259
8.7,"greedy_SVM","SVM",85,18,2012,2004,8,1900,1513,387,0.918286505791755,0.654028436018957,1.71574454714462,719,342,377,3,1.1,48.57,3.9,0,0,0,0,0,0,0.0279885083326417,25.2111429671541,3.09890174108535
8.7,"greedy_SVM","SVM",85,19,1912,1906,6,2000,1611,389,0.918875867407203,0.649289099526066,1.71574454714462,730,346,384,11,1.1,51.12,4.1,0,0,0,0,0,0,0.0221886556905992,20.8382682691444,2.44252510047688
8.7,"greedy_SVM","SVM",85,20,1812,1806,6,2100,1711,389,0.918836486101107,0.649289099526066,1.71732587852447,733,348,385,3,1.1,53.68,4.4,0,0,0,0,0,0,0.0185606194094973,17.4076323746399,2.0036164123759
8.7,"greedy_SVM","SVM",85,21,1712,1707,5,2200,1810,390,0.919787069351825,0.649289099526066,1.71574454714462,738,353,385,5,1.1,56.24,4.6,0,0,0,0,0,0,0.016413571319907,14.3733156984319,1.70283656553058
8.7,"greedy_SVM","SVM",85,22,1612,1607,5,2300,1910,390,0.920618150708185,0.639810426540284,1.73975069433242,752,364,388,14,1.1,58.79,4.9,0,0,0,0,0,0,0.0116099586916618,8.06208727296093,1.53551359851049
8.7,"greedy_SVM","SVM",85,23,1512,1509,3,2400,2008,392,0.921093442333547,0.639810426540284,1.74506808716201,754,365,389,2,1.1,61.35,5.1,0,0,0,0,0,0,0.00787665942119065,6.1492022921699,0.911925196660523
8.7,"greedy_SVM","SVM",85,24,1412,1409,3,2500,2108,392,0.9211450454243,0.639810426540284,1.74988871723705,755,366,389,1,1.1,63.91,5.4,0,0,0,0,0,0,0.00743759138634563,5.48775299796955,0.773205830772791
8.7,"greedy_SVM","SVM",85,25,1312,1309,3,2600,2208,392,0.921723543231177,0.639810426540284,1.74827888401052,760,370,390,5,1.1,66.46,5.6,0,0,0,0,0,0,0.00548383472982533,3.80719320340262,0.620151535781217
8.7,"greedy_SVM","SVM",85,26,1212,1209,3,2700,2308,392,0.921754776680844,0.639810426540284,1.74988871723705,761,370,391,1,1.1,69.02,5.9,0,0,0,0,0,0,0.00503073022605532,2.99203660357078,0.507988222621566
8.7,"greedy_SVM","SVM",85,27,1112,1109,3,2800,2408,392,0.922723013620509,0.644549763033175,1.75150151789809,768,376,392,7,1,71.57,6.1,0,0,0,0,0,0,0.00316434539031215,1.70922437987814,0.375193352925893
8.7,"greedy_SVM","SVM",85,28,1012,1010,2,2900,2507,393,0.922989176930711,0.639810426540284,1.74827888401052,775,378,397,7,1.1,74.13,6.4,0,0,0,0,0,0,0.00294756268164636,1.41098934974912,0.305139366569183
8.7,"greedy_SVM","SVM",85,29,912,910,2,3000,2607,393,0.924138024688002,0.639810426540284,1.74667201003624,773,379,394,-2,1,76.69,6.6,0,0,0,0,0,0,0.00284229701271387,1.1742852562551,0.300204228028881
8.7,"greedy_SVM","SVM",85,30,812,810,2,3100,2707,393,0.925057374489063,0.639810426540284,1.74667201003624,778,380,398,5,1,79.24,6.9,0,0,0,0,0,0,0.00192025054201784,0.652717699152827,0.204484647644266
8.7,"greedy_SVM","SVM",85,31,712,710,2,3200,2807,393,0.925540813970862,0.639810426540284,1.74667201003624,779,382,397,1,1,81.8,7.1,0,0,0,0,0,0,0.00152587752698328,0.465303667350165,0.176579728555669
8.7,"greedy_SVM","SVM",85,32,612,610,2,3300,2907,393,0.925713276932063,0.639810426540284,1.75150151789809,781,383,398,2,1,84.36,7.4,0,0,0,0,0,0,0.00110929175101694,0.331536630498469,0.145513379759169
8.7,"greedy_SVM","SVM",85,33,512,510,2,3400,3007,393,0.926012031668005,0.639810426540284,1.74827888401052,783,383,400,2,1,86.91,7.7,0,0,0,0,0,0,0.000517393068820855,0.153524542527351,0.0717874655066596
8.7,"greedy_SVM","SVM",85,34,412,411,1,3500,3106,394,0.9268159535029,0.639810426540284,1.74988871723705,787,386,401,4,1,89.47,7.9,0,0,0,0,0,0,0.000392054135766544,0.11339250816942,0.050651901175876
8.7,"greedy_SVM","SVM",85,35,312,312,0,3600,3205,395,0.928216026833601,0.644549763033175,1.74346710726553,794,389,405,7,1,92.02,8.1,0,0,0,0,0,0,0.000300444724659902,0.0768602222164613,0.0382764279204008
8.7,"greedy_SVM","SVM",85,36,212,212,0,3700,3305,395,0.928977851410247,0.644549763033175,1.74506808716201,797,390,407,3,1,94.58,8.4,0,0,0,0,0,0,0.000183239695267764,0.0367882837849164,0.023246517402274
8.7,"greedy_SVM","SVM",85,37,112,112,0,3800,3405,395,0.929199201510055,0.644549763033175,1.74667201003624,802,391,411,5,1.1,97.14,8.6,0,0,0,0,0,0,5.93632249368402e-05,0.0103019690626944,0.00969899009424439
8.7,"greedy_SVM","SVM",85,38,12,12,0,3900,3505,395,0.929325493284793,0.644549763033175,1.74667201003624,801,391,410,-1,1,99.69,8.9,0,0,0,0,0,0,4.95534444345765e-05,0.000716716698391467,0.000716716698391467
8.7,"greedy_SVM","SVM",85,39,0,0,0,3912,3517,395,0.929442279227024,0.644549763033175,1.75150151789809,801,391,410,0,1,100,8.9,0,0,0,0,0,0,0,0,0
8.7,"greedy_SVM","SVM",86,0,3812,3427,385,100,91,9,0.883511662627633,0.5,1.75174332666725,26,9,17,0,1.9,2.56,10.1,0,0,0,0,0,0,0.266667281617535,321.762884933825,31.4692749305106
8.7,"greedy_SVM","SVM",86,1,3712,3380,332,200,138,62,0.909315767266749,0.537735849056604,1.75539331298557,93,46,47,67,1,5.11,2.2,0,0,0,0,0,0,0.768104054758585,360.711802943141,84.4123994971346
8.7,"greedy_SVM","SVM",86,2,3612,3354,258,300,164,136,0.911232040851643,0.556603773584906,1.74852024786933,146,75,71,53,0.9,7.67,1.2,0,0,0,0,0,0,0.514942157484505,227.935629548682,63.4608583459019
8.7,"greedy_SVM","SVM",86,3,3512,3310,202,400,208,192,0.906455556517209,0.617924528301887,1.74003228550103,227,116,111,81,1,10.22,1.1,0,0,0,0,0,0,0.33608054625104,163.253531454411,46.0697653812743
8.7,"greedy_SVM","SVM",86,4,3412,3253,159,500,265,235,0.918101956032517,0.60377358490566,1.76387347391787,325,161,164,98,1,12.78,1.1,0,0,0,0,0,0,0.184504717272115,108.563784506057,29.3183235904962
8.7,"greedy_SVM","SVM",86,5,3312,3182,130,600,336,264,0.899158300155773,0.636792452830189,1.71299250832408,379,188,191,54,1,15.34,1.3,0,0,0,0,0,0,0.156782018629098,120.481130817514,23.3164793013515
8.7,"greedy_SVM","SVM",86,6,3212,3099,113,700,419,281,0.909371213432568,0.64622641509434,1.72623250152161,419,204,215,40,1.1,17.89,1.5,0,0,0,0,0,0,0.0943435648054967,81.789517614068,12.6383242293236
8.7,"greedy_SVM","SVM",86,7,3112,3023,89,800,495,305,0.889253721654828,0.64622641509434,1.63516814803264,477,227,250,58,1.1,20.45,1.6,0,0,0,0,0,0,0.0755342530024278,95.8184221729557,13.0830567503029
8.7,"greedy_SVM","SVM",86,8,3012,2950,62,900,568,332,0.886331303011937,0.655660377358491,1.63118940894402,525,251,274,48,1.1,23.01,1.7,0,0,0,0,0,0,0.0734237763769223,121.886262446554,10.2898492924082
8.7,"greedy_SVM","SVM",86,9,2912,2863,49,1000,655,345,0.894216829669374,0.669811320754717,1.64666469944976,576,270,306,51,1.1,25.56,1.9,0,0,0,0,0,0,0.0688833815563681,108.769368383114,7.36045144574454
8.7,"greedy_SVM","SVM",86,10,2812,2767,45,1100,751,349,0.913536437597355,0.655660377358491,1.69447476480067,601,296,305,25,1,28.12,2.2,0,0,0,0,0,0,0.0656457677640795,60.9056805085568,8.22738078427682
8.7,"greedy_SVM","SVM",86,11,2712,2672,40,1200,846,354,0.915194413190228,0.660377358490566,1.70451234739179,617,303,314,16,1,30.67,2.4,0,0,0,0,0,0,0.0494466605958742,46.0738192442029,5.430847419849
8.7,"greedy_SVM","SVM",86,12,2612,2575,37,1300,943,357,0.917661091396912,0.665094339622642,1.71456839839614,623,308,315,6,1,33.23,2.6,0,0,0,0,0,0,0.0405451693688023,40.6620545339524,4.44391573585957
8.7,"greedy_SVM","SVM",86,13,2512,2477,35,1400,1041,359,0.91853741128613,0.660377358490566,1.71614719065986,629,308,321,6,1,35.79,2.9,0,0,0,0,0,0,0.0314245377850926,33.286130061333,3.47273795360572
8.7,"greedy_SVM","SVM",86,14,2412,2378,34,1500,1140,360,0.921188008481908,0.660377358490566,1.71456839839614,633,309,324,4,1,38.34,3.2,0,0,0,0,0,0,0.024463503850907,28.0422191654651,2.72890438779126
8.7,"greedy_SVM","SVM",86,15,2312,2285,27,1600,1233,367,0.929521161502512,0.665094339622642,1.75539331298557,654,319,335,21,1.1,40.9,3.4,0,0,0,0,0,0,0.0478477985361103,41.7871109787403,5.99720302191141
8.7,"greedy_SVM","SVM",86,16,2212,2185,27,1700,1333,367,0.929147914142289,0.655660377358491,1.74530900774469,660,322,338,6,1,43.46,3.6,0,0,0,0,0,0,0.028043773736411,28.6339555850916,3.18355099242037
8.7,"greedy_SVM","SVM",86,17,2112,2093,19,1800,1425,375,0.934681711961229,0.650943396226415,1.79779411764706,689,334,355,29,1.1,46.01,3.8,0,0,0,0,0,0,0.0520127938075652,31.6703709073995,5.92481952123632
8.7,"greedy_SVM","SVM",86,18,2012,1994,18,1900,1524,376,0.934670893197164,0.64622641509434,1.79944802207912,694,336,358,5,1.1,48.57,4.1,0,0,0,0,0,0,0.0401232739971461,24.3818792741798,4.54206209457199
8.7,"greedy_SVM","SVM",86,19,1912,1899,13,2000,1619,381,0.935591840488145,0.64622641509434,1.79779411764706,708,345,363,14,1.1,51.12,4.2,0,0,0,0,0,0,0.0288095443559881,19.3609111582143,3.79310208329815
8.7,"greedy_SVM","SVM",86,20,1812,1801,11,2100,1717,383,0.935586431106113,0.650943396226415,1.78931395671476,717,347,370,9,1.1,53.68,4.5,0,0,0,0,0,0,0.018751043673706,16.2153728889486,2.47659804562731
8.7,"greedy_SVM","SVM",86,21,1712,1703,9,2200,1815,385,0.935325428423059,0.650943396226415,1.78439375335074,726,351,375,9,1.1,56.24,4.7,0,0,0,0,0,0,0.0153594485034768,13.1949718981705,1.70575530271931
8.7,"greedy_SVM","SVM",86,22,1612,1603,9,2300,1915,385,0.93535247533322,0.64622641509434,1.78439375335074,726,351,375,0,1.1,58.79,5,0,0,0,0,0,0,0.0146279848773546,11.3973372392008,1.48664460609126
8.7,"greedy_SVM","SVM",86,23,1512,1503,9,2400,2015,385,0.935655400727024,0.641509433962264,1.7876708768647,738,358,380,12,1.1,61.35,5.2,0,0,0,0,0,0,0.00980148580739609,6.57309804065101,1.24851173072699
8.7,"greedy_SVM","SVM",86,24,1412,1404,8,2500,2114,386,0.93572031331141,0.641509433962264,1.7876708768647,743,360,383,5,1.1,63.91,5.5,0,0,0,0,0,0,0.00685876416617921,4.84178877707888,0.780551227196063
8.7,"greedy_SVM","SVM",86,25,1312,1305,7,2600,2213,387,0.935717608620394,0.641509433962264,1.79944802207912,743,361,382,0,1.1,66.46,5.7,0,0,0,0,0,0,0.0074521747015337,4.54609235418538,0.768297576935522
8.7,"greedy_SVM","SVM",86,26,1212,1205,7,2700,2313,387,0.935528280249267,0.64622641509434,1.79614325068871,751,365,386,8,1.1,69.02,6,0,0,0,0,0,0,0.00579923826941687,3.42574397875113,0.671263194414494
8.7,"greedy_SVM","SVM",86,27,1112,1106,6,2800,2412,388,0.935472834083437,0.641509433962264,1.79779411764706,752,365,387,1,1.1,71.57,6.2,0,0,0,0,0,0,0.00515228773430897,2.64454043220642,0.534345172639757
8.7,"greedy_SVM","SVM",86,28,1012,1006,6,2900,2512,388,0.935321371386535,0.636792452830189,1.79449541284404,756,369,387,4,1,74.13,6.5,0,0,0,0,0,0,0.00400193348791236,1.84095072004483,0.426701119673625
8.7,"greedy_SVM","SVM",86,29,912,906,6,3000,2612,388,0.935184784490223,0.636792452830189,1.79944802207912,757,369,388,1,1.1,76.69,6.7,0,0,0,0,0,0,0.00360889699702072,1.45909221099312,0.385534431441174
8.7,"greedy_SVM","SVM",86,30,812,806,6,3100,2712,388,0.935307847931455,0.636792452830189,1.79449541284404,756,369,387,-1,1,79.24,7,0,0,0,0,0,0,0.00309394248903033,1.09971987220912,0.341336816841247
8.7,"greedy_SVM","SVM",86,31,712,708,4,3200,2810,390,0.935099586723215,0.632075471698113,1.79449541284404,763,373,390,7,1,81.8,7.2,0,0,0,0,0,0,0.00243303731376726,0.812042859741205,0.274605794034487
8.7,"greedy_SVM","SVM",86,32,612,609,3,3300,2909,391,0.934992751428079,0.636792452830189,1.79779411764706,765,374,391,2,1,84.36,7.4,0,0,0,0,0,0,0.00230068231454016,0.739065287047106,0.267631291812221
8.7,"greedy_SVM","SVM",86,33,512,509,3,3400,3009,391,0.934887268478452,0.636792452830189,1.79779411764706,768,375,393,3,1,86.91,7.7,0,0,0,0,0,0,0.00124692575469529,0.368074992611132,0.153622585862904
8.7,"greedy_SVM","SVM",86,34,412,410,2,3500,3108,392,0.934595161848713,0.627358490566038,1.79944802207912,774,377,397,6,1.1,89.47,7.9,0,0,0,0,0,0,0.00107134916879948,0.310432301399523,0.13975895867788
8.7,"greedy_SVM","SVM",86,35,312,312,0,3600,3206,394,0.934481564826037,0.627358490566038,1.79449541284404,787,383,404,13,1.1,92.02,8.1,0,0,0,0,0,0,0.00130339776199499,0.335114270855347,0.165880711807385
8.7,"greedy_SVM","SVM",86,36,212,212,0,3700,3306,394,0.934443699151812,0.632075471698113,1.79614325068871,789,384,405,2,1.1,94.58,8.4,0,0,0,0,0,0,0.000531778830321233,0.110870349763677,0.0684233733047272
8.7,"greedy_SVM","SVM",86,37,112,112,0,3800,3406,394,0.93423679028908,0.636792452830189,1.79779411764706,790,385,405,1,1.1,97.14,8.6,0,0,0,0,0,0,0.000319547326246683,0.0495152025911052,0.0460074695470524
8.7,"greedy_SVM","SVM",86,38,12,12,0,3900,3506,394,0.934261132508225,0.636792452830189,1.79779411764706,793,386,407,3,1.1,99.69,8.9,0,0,0,0,0,0,0.000184569845840231,0.00273412251655441,0.00273412251655441
8.7,"greedy_SVM","SVM",86,39,0,0,0,3912,3518,394,0.934171877704694,0.636792452830189,1.79779411764706,794,386,408,1,1.1,100,8.9,0,0,0,0,0,0,0,0,0
8.7,"greedy_SVM","SVM",87,0,3812,3420,392,100,95,5,0.896678653494822,0.588516746411483,1.74238528873503,16,5,11,0,2.2,2.56,19,0,0,0,0,0,0,0.128770065758169,195.602620113957,14.091553165633
8.7,"greedy_SVM","SVM",87,1,3712,3383,329,200,132,68,0.909556505615902,0.588516746411483,1.73917942803819,91,44,47,75,1.1,5.11,1.9,0,0,0,0,0,0,0.767414760810525,288.670898158523,84.2074842057343
8.7,"greedy_SVM","SVM",87,2,3612,3354,258,300,161,139,0.905855013242089,0.602870813397129,1.72897903180411,143,73,70,52,1,7.67,1.2,0,0,0,0,0,0,0.414308740146422,118.000697287196,59.1409041862806
8.7,"greedy_SVM","SVM",87,3,3512,3316,196,400,199,201,0.899390068552231,0.598086124401914,1.71650827949639,219,112,107,76,1,10.22,1,0,0,0,0,0,0,0.172466579447626,54.2860119921977,31.6344555930432
8.7,"greedy_SVM","SVM",87,4,3412,3247,165,500,268,232,0.877241367977378,0.602870813397129,1.68752063314597,305,151,154,86,1,12.78,1.2,0,0,0,0,0,0,0.15280997139144,75.7290223178713,22.0236893150837
8.7,"greedy_SVM","SVM",87,5,3312,3179,133,600,336,264,0.878464243556276,0.631578947368421,1.65460361098628,375,183,192,70,1,15.34,1.3,0,0,0,0,0,0,0.0743192550495954,44.52507233584,13.0964831507062
8.7,"greedy_SVM","SVM",87,6,3212,3107,105,700,408,292,0.868888018558136,0.631578947368421,1.59281284251022,436,212,224,61,1.1,17.89,1.4,0,0,0,0,0,0,0.0678836577213992,59.9819648936212,10.7131655736581
8.7,"greedy_SVM","SVM",87,7,3112,3029,83,800,486,314,0.873782259676889,0.641148325358852,1.59427952100241,478,232,246,42,1.1,20.45,1.5,0,0,0,0,0,0,0.0602244675287752,73.8417447064975,8.09448584794204
8.7,"greedy_SVM","SVM",87,8,3012,2946,66,900,569,331,0.889168855426814,0.641148325358852,1.61864223995633,523,250,273,45,1.1,23.01,1.7,0,0,0,0,0,0,0.0529162730025965,78.8642630260649,7.18055633612426
8.7,"greedy_SVM","SVM",87,9,2912,2853,59,1000,662,338,0.898053532645166,0.636363636363636,1.64447163740245,545,266,279,22,1,25.56,2,0,0,0,0,0,0,0.0494049210131598,69.2539333700645,5.53247967320197
8.7,"greedy_SVM","SVM",87,10,2812,2763,49,1100,752,348,0.903550310443323,0.641148325358852,1.67979389032021,573,280,293,28,1,28.12,2.2,0,0,0,0,0,0,0.0535738267061863,77.1829962585552,6.20817367507216
8.7,"greedy_SVM","SVM",87,11,2712,2669,43,1200,846,354,0.917207352043003,0.636363636363636,1.71492770097016,608,296,312,35,1.1,30.67,2.4,0,0,0,0,0,0,0.0521353939792939,64.5396129332103,5.99554041159462
8.7,"greedy_SVM","SVM",87,12,2612,2576,36,1300,939,361,0.924206363335075,0.62200956937799,1.72037714607374,632,306,326,24,1.1,33.23,2.6,0,0,0,0,0,0,0.0444468205417392,51.8168832276645,5.02072140488716
8.7,"greedy_SVM","SVM",87,13,2512,2480,32,1400,1035,365,0.928629530322672,0.626794258373206,1.74078088239182,641,311,330,9,1.1,35.79,2.8,0,0,0,0,0,0,0.0464423252263812,51.3026553473767,5.20290445187497
8.7,"greedy_SVM","SVM",87,14,2412,2383,29,1500,1132,368,0.931696989781528,0.636363636363636,1.75478468899522,649,316,333,8,1.1,38.34,3.1,0,0,0,0,0,0,0.0436761721138872,41.3566830219924,4.9727468512043
8.7,"greedy_SVM","SVM",87,15,2312,2286,26,1600,1229,371,0.932502197889471,0.631578947368421,1.75478468899522,663,319,344,14,1.1,40.9,3.3,0,0,0,0,0,0,0.036344629716099,34.4614899421089,4.23834968373363
8.7,"greedy_SVM","SVM",87,16,2212,2192,20,1700,1323,377,0.934464550302215,0.636363636363636,1.76663406381348,670,323,347,7,1.1,43.46,3.5,0,0,0,0,0,0,0.0320934940612449,30.6710667544304,3.80140953909108
8.7,"greedy_SVM","SVM",87,17,2112,2098,14,1800,1417,383,0.935827104838634,0.631578947368421,1.76826229797367,691,331,360,21,1.1,46.01,3.7,0,0,0,0,0,0,0.0246331883023953,25.6986496391959,2.85053504162098
8.7,"greedy_SVM","SVM",87,18,2012,1999,13,1900,1516,384,0.935047915360027,0.62200956937799,1.75478468899522,700,332,368,9,1.1,48.57,3.9,0,0,0,0,0,0,0.0215707452260479,23.6805789850828,2.33880350803712
8.7,"greedy_SVM","SVM",87,19,1912,1899,13,2000,1616,384,0.935462844027898,0.626794258373206,1.77688796771989,703,334,369,3,1.1,51.12,4.2,0,0,0,0,0,0,0.0195412021882666,20.0892497194746,1.99871326201032
8.7,"greedy_SVM","SVM",87,20,1812,1799,13,2100,1716,384,0.9342029946073,0.617224880382775,1.78059034618632,727,347,380,24,1.1,53.68,4.5,0,0,0,0,0,0,0.014075915594704,10.8063460063735,1.81428634547421
8.7,"greedy_SVM","SVM",87,21,1712,1702,10,2200,1813,387,0.93426324827524,0.61244019138756,1.78222842378171,736,354,382,9,1.1,56.24,4.7,0,0,0,0,0,0,0.0104908597841069,9.50181519819461,1.2409247607482
8.7,"greedy_SVM","SVM",87,22,1612,1603,9,2300,1912,388,0.934700087367821,0.61244019138756,1.78059034618632,741,356,385,5,1.1,58.79,4.9,0,0,0,0,0,0,0.00938999617736017,7.76980459269327,0.960053893198238
8.7,"greedy_SVM","SVM",87,23,1512,1503,9,2400,2012,388,0.933159510630661,0.61244019138756,1.77732320793644,743,363,380,2,1,61.35,5.2,0,0,0,0,0,0,0.007064700003456,5.24913778010835,0.890142742632347
8.7,"greedy_SVM","SVM",87,24,1412,1404,8,2500,2111,389,0.933551159472285,0.61244019138756,1.78222842378171,746,363,383,3,1.1,63.91,5.4,0,0,0,0,0,0,0.00675893891172204,5.03144800773099,0.711020064439036
8.7,"greedy_SVM","SVM",87,25,1312,1306,6,2600,2209,391,0.933748353294634,0.607655502392344,1.78222842378171,757,370,387,11,1,66.46,5.6,0,0,0,0,0,0,0.00568000407127194,3.92485039824513,0.623455367830906
8.7,"greedy_SVM","SVM",87,26,1212,1207,5,2700,2308,392,0.934118091711551,0.607655502392344,1.78059034618632,760,372,388,3,1,69.02,5.9,0,0,0,0,0,0,0.00497296412757928,3.06916178059093,0.519061256373234
8.7,"greedy_SVM","SVM",87,27,1112,1108,4,2800,2407,393,0.934150957348607,0.602870813397129,1.78386951809458,772,377,395,12,1,71.57,6.1,0,0,0,0,0,0,0.00423827928134103,2.47937108747428,0.459269131870233
8.7,"greedy_SVM","SVM",87,28,1012,1008,4,2900,2507,393,0.934227643835079,0.602870813397129,1.7855136374661,775,379,396,3,1,74.13,6.4,0,0,0,0,0,0,0.00404574293236201,2.11864670753709,0.424692758849064
8.7,"greedy_SVM","SVM",87,29,912,909,3,3000,2606,394,0.933823670379561,0.602870813397129,1.78386951809458,779,381,398,4,1,76.69,6.6,0,0,0,0,0,0,0.00341321303959601,1.62141779064021,0.3662965897282
8.7,"greedy_SVM","SVM",87,30,812,809,3,3100,2706,394,0.933975673950962,0.602870813397129,1.78222842378171,778,381,397,-1,1,79.24,6.9,0,0,0,0,0,0,0.00297716019333339,1.27123248444542,0.323878495309204
8.7,"greedy_SVM","SVM",87,31,712,709,3,3200,2806,394,0.933926375495373,0.602870813397129,1.78059034618632,780,381,399,2,1,81.8,7.1,0,0,0,0,0,0,0.0022593721852445,0.839914094479156,0.244759098026096
8.7,"greedy_SVM","SVM",87,32,612,609,3,3300,2906,394,0.934082487271405,0.602870813397129,1.78222842378171,779,381,398,-1,1,84.36,7.4,0,0,0,0,0,0,0.00197065950772344,0.651298320307345,0.222005061852839
8.7,"greedy_SVM","SVM",87,33,512,509,3,3400,3006,394,0.934127677522362,0.607655502392344,1.78059034618632,779,381,398,0,1,86.91,7.6,0,0,0,0,0,0,0.0012704070679645,0.397879997024619,0.157633543465517
8.7,"greedy_SVM","SVM",87,34,412,409,3,3500,3106,394,0.934474136113029,0.607655502392344,1.78222842378171,779,381,398,0,1,89.47,7.9,0,0,0,0,0,0,0.000770793073373083,0.207950343912588,0.0947785516437143
8.7,"greedy_SVM","SVM",87,35,312,312,0,3600,3203,397,0.934884956576276,0.607655502392344,1.78263841421736,792,388,404,13,1,92.02,8.1,0,0,0,0,0,0,0.000835213382386637,0.220801828584943,0.119177771809871
8.7,"greedy_SVM","SVM",87,36,212,212,0,3700,3303,397,0.935186224915985,0.607655502392344,1.7875492638433,792,390,402,0,1,94.58,8.3,0,0,0,0,0,0,0.000447003538993586,0.0941494368709652,0.0593796749530688
8.7,"greedy_SVM","SVM",87,37,112,112,0,3800,3403,397,0.935703858699668,0.607655502392344,1.79248724523514,792,389,403,0,1,97.14,8.6,0,0,0,0,0,0,0.000184862726008243,0.0291453326931687,0.0271610040390297
8.7,"greedy_SVM","SVM",87,38,12,12,0,3900,3503,397,0.936285854355926,0.607655502392344,1.79248724523514,796,390,406,4,1,99.69,8.8,0,0,0,0,0,0,0.00011620445458869,0.00178698804976951,0.00178698804976951
8.7,"greedy_SVM","SVM",87,39,0,0,0,3912,3515,397,0.936276268545117,0.607655502392344,1.7875492638433,797,391,406,1,1,100,8.9,0,0,0,0,0,0,0,0,0
8.7,"greedy_SVM","SVM",88,0,3812,3429,383,100,91,9,0.900755925619939,0.55607476635514,1.76257047964779,23,9,14,0,1.6,2.56,10.1,0,0,0,0,0,0,0.774152685767712,428.440260940733,83.6226134156794
8.7,"greedy_SVM","SVM",88,1,3712,3389,323,200,131,69,0.903822011438137,0.565420560747664,1.75222016452044,97,49,48,74,1,5.11,1.9,0,0,0,0,0,0,0.781131811708023,323.391159409281,83.7785977895139
8.7,"greedy_SVM","SVM",88,2,3612,3360,252,300,160,140,0.914543923087652,0.574766355140187,1.77422211522754,154,81,73,57,0.9,7.67,1.1,0,0,0,0,0,0,0.492060669266282,174.69734641974,62.9564551377375
8.7,"greedy_SVM","SVM",88,3,3512,3323,189,400,197,203,0.914647198944172,0.607476635514019,1.76743945887334,225,116,109,71,0.9,10.22,1,0,0,0,0,0,0,0.286622628946223,93.6081843435419,40.7129217216795
8.7,"greedy_SVM","SVM",88,4,3412,3258,154,500,262,238,0.872849984441561,0.598130841121495,1.63277740486394,315,156,159,90,1,12.78,1.1,0,0,0,0,0,0,0.132403067282102,61.2640415821259,20.1816152899828
8.7,"greedy_SVM","SVM",88,5,3312,3189,123,600,331,269,0.851600641651557,0.607476635514019,1.58227913461042,384,186,198,69,1.1,15.34,1.2,0,0,0,0,0,0,0.127266129005162,92.1910032675131,20.0977696410657
8.7,"greedy_SVM","SVM",88,6,3212,3110,102,700,410,290,0.860553451291356,0.626168224299065,1.59764076726651,425,206,219,41,1.1,17.89,1.4,0,0,0,0,0,0,0.0753331089634297,64.263733847163,10.6093040428826
8.7,"greedy_SVM","SVM",88,7,3112,3030,82,800,490,310,0.8670262991298,0.630841121495327,1.61445803850089,481,224,257,56,1.1,20.45,1.6,0,0,0,0,0,0,0.0659230730857934,92.0669584799825,10.1782573564843
8.7,"greedy_SVM","SVM",88,8,3012,2947,65,900,573,327,0.872992156399875,0.649532710280374,1.62585813342521,525,245,280,44,1.1,23.01,1.8,0,0,0,0,0,0,0.0737390087758663,115.721902099514,10.6239318294235
8.7,"greedy_SVM","SVM",88,9,2912,2855,57,1000,665,335,0.886796248806287,0.649532710280374,1.63428226883156,547,263,284,22,1.1,25.56,2,0,0,0,0,0,0,0.0578589356004679,78.9737994539637,7.01686140959154
8.7,"greedy_SVM","SVM",88,10,2812,2763,49,1100,757,343,0.893776087213106,0.644859813084112,1.64506578100461,565,274,291,18,1.1,28.12,2.2,0,0,0,0,0,0,0.0426988161234169,61.3469311718213,4.91355093827595
8.7,"greedy_SVM","SVM",88,11,2712,2670,42,1200,850,350,0.909959548054138,0.649532710280374,1.65345897376484,593,288,305,28,1.1,30.67,2.4,0,0,0,0,0,0,0.050015351404762,63.0630030032136,5.94535131392338
8.7,"greedy_SVM","SVM",88,12,2612,2576,36,1300,944,356,0.919790873096771,0.649532710280374,1.70695303029,626,299,327,33,1.1,33.23,2.7,0,0,0,0,0,0,0.0511402991548358,54.4535049502068,5.88971644473688
8.7,"greedy_SVM","SVM",88,13,2512,2479,33,1400,1041,359,0.924375248130307,0.649532710280374,1.74379602911409,633,303,330,7,1.1,35.79,2.9,0,0,0,0,0,0,0.0466568491740904,47.4455926179434,5.14418485550047
8.7,"greedy_SVM","SVM",88,14,2412,2384,28,1500,1136,364,0.926977263216622,0.649532710280374,1.73420595012721,641,309,332,8,1.1,38.34,3.1,0,0,0,0,0,0,0.0432785395906923,39.9855374180591,4.94031868739231
8.7,"greedy_SVM","SVM",88,15,2312,2287,25,1600,1233,367,0.928927433286484,0.649532710280374,1.74578409412734,647,313,334,6,1.1,40.9,3.4,0,0,0,0,0,0,0.04200329706481,37.2069062118802,4.80331180653058
8.7,"greedy_SVM","SVM",88,16,2212,2191,21,1700,1329,371,0.930048714014401,0.644859813084112,1.75578958218802,660,318,342,13,1.1,43.46,3.6,0,0,0,0,0,0,0.0348199266693483,29.518821762123,4.14574306214446
8.7,"greedy_SVM","SVM",88,17,2112,2097,15,1800,1423,377,0.9306576391944,0.64018691588785,1.75417728688757,672,324,348,12,1.1,46.01,3.8,0,0,0,0,0,0,0.0275601329720429,26.771518271165,3.45943606540741
8.7,"greedy_SVM","SVM",88,18,2012,1999,13,1900,1521,379,0.930536927154314,0.64018691588785,1.75417728688757,675,327,348,3,1.1,48.57,4,0,0,0,0,0,0,0.0232430844795646,23.5299099136259,2.49683547152636
8.7,"greedy_SVM","SVM",88,19,1912,1899,13,2000,1621,379,0.92971072030216,0.64018691588785,1.75740484399316,688,331,357,13,1.1,51.12,4.3,0,0,0,0,0,0,0.0180980372679729,17.0602862076526,2.02534694872535
8.7,"greedy_SVM","SVM",88,20,1812,1801,11,2100,1719,381,0.929903859566291,0.64018691588785,1.76257047964779,702,340,362,14,1.1,53.68,4.5,0,0,0,0,0,0,0.0132010499187066,12.0426088654812,1.60212633085564
8.7,"greedy_SVM","SVM",88,21,1712,1703,9,2200,1817,383,0.929442471324182,0.644859813084112,1.75740484399316,706,343,363,4,1.1,56.24,4.7,0,0,0,0,0,0,0.0133783776969303,10.786362432005,1.35385371307569
8.7,"greedy_SVM","SVM",88,22,1612,1604,8,2300,1916,384,0.928409712758994,0.64018691588785,1.76581347961035,733,356,377,27,1.1,58.79,5,0,0,0,0,0,0,0.00904594107790727,6.26554046283975,1.13056369808707
8.7,"greedy_SVM","SVM",88,23,1512,1505,7,2400,2015,385,0.929152762427976,0.64018691588785,1.76581347961035,732,356,376,-1,1.1,61.35,5.2,0,0,0,0,0,0,0.00699793338430653,5.11160614695427,0.774742054401793
8.7,"greedy_SVM","SVM",88,24,1412,1405,7,2500,2115,385,0.929046804081677,0.64018691588785,1.76419048927982,735,358,377,3,1.1,63.91,5.5,0,0,0,0,0,0,0.00733471468266587,4.81914164528932,0.746736059644832
8.7,"greedy_SVM","SVM",88,25,1312,1305,7,2600,2215,385,0.928174994903265,0.626168224299065,1.77585583724893,743,364,379,8,1,66.46,5.8,0,0,0,0,0,0,0.00564181433049994,3.46540986870687,0.629515526787983
8.7,"greedy_SVM","SVM",88,26,1212,1206,6,2700,2314,386,0.928133416311679,0.626168224299065,1.77259139637163,750,366,384,7,1,69.02,6,0,0,0,0,0,0,0.00540798507561964,2.94815886015803,0.558138172653412
8.7,"greedy_SVM","SVM",88,27,1112,1106,6,2800,2414,386,0.927917475884409,0.626168224299065,1.77259139637163,754,367,387,4,1.1,71.57,6.3,0,0,0,0,0,0,0.00420934121959004,2.00601682398265,0.438530553308807
8.7,"greedy_SVM","SVM",88,28,1012,1006,6,2900,2514,386,0.928032822944931,0.626168224299065,1.77585583724893,753,368,385,-1,1,74.13,6.5,0,0,0,0,0,0,0.0037672386233614,1.56365938086529,0.398702142573685
8.7,"greedy_SVM","SVM",88,29,912,906,6,3000,2614,386,0.928073060291623,0.626168224299065,1.78427221562452,757,370,387,4,1,76.69,6.8,0,0,0,0,0,0,0.00316745221362092,1.15301328237073,0.34242723138495
8.7,"greedy_SVM","SVM",88,30,812,808,4,3100,2712,388,0.928707469124526,0.630841121495327,1.78263075084473,759,373,386,2,1,79.24,7,0,0,0,0,0,0,0.00271530068305683,0.947621339007309,0.309454061186231
8.7,"greedy_SVM","SVM",88,31,712,708,4,3200,2812,388,0.928785261328138,0.626168224299065,1.77935686516825,759,373,386,0,1,81.8,7.2,0,0,0,0,0,0,0.00198060717538784,0.638031370591506,0.231084179245326
8.7,"greedy_SVM","SVM",88,32,612,609,3,3300,2911,389,0.928793308797476,0.626168224299065,1.78263075084473,765,374,391,6,1,84.36,7.5,0,0,0,0,0,0,0.00141457035260897,0.438972267694596,0.172154356737153
8.7,"greedy_SVM","SVM",88,33,512,510,2,3400,3010,390,0.929144714958615,0.621495327102804,1.77935686516825,769,376,393,4,1,86.91,7.7,0,0,0,0,0,0,0.000972385398948189,0.304608072685146,0.124235145333986
8.7,"greedy_SVM","SVM",88,34,412,411,1,3500,3109,391,0.929213118447997,0.621495327102804,1.78427221562452,773,379,394,4,1,89.47,8,0,0,0,0,0,0,0.000806154878744671,0.237410108411287,0.101270887175676
8.7,"greedy_SVM","SVM",88,35,312,312,0,3600,3208,392,0.929364679120552,0.621495327102804,1.78263075084473,777,381,396,4,1,92.02,8.2,0,0,0,0,0,0,0.000750326826297505,0.182094564422756,0.0903528913293263
8.7,"greedy_SVM","SVM",88,36,212,212,0,3700,3308,392,0.929659752996322,0.621495327102804,1.78427221562452,784,383,401,7,1,94.58,8.4,0,0,0,0,0,0,0.000443720429212343,0.0938585394572687,0.0583531991731818
8.7,"greedy_SVM","SVM",88,37,112,112,0,3800,3408,392,0.92959805573139,0.616822429906542,1.78263075084473,785,384,401,1,1,97.14,8.7,0,0,0,0,0,0,0.00014755801069327,0.0252946926482554,0.0236720902959485
8.7,"greedy_SVM","SVM",88,38,12,12,0,3900,3508,392,0.929632928098526,0.616822429906542,1.77935686516825,785,385,400,0,1,99.69,8.9,0,0,0,0,0,0,9.91853963351318e-05,0.00164277003119974,0.00164277003119974
8.7,"greedy_SVM","SVM",88,39,0,0,0,3912,3520,392,0.92969462536346,0.616822429906542,1.78591670614583,786,385,401,1,1,100,9,0,0,0,0,0,0,0,0,0
8.7,"greedy_SVM","SVM",89,0,3812,3420,392,100,89,11,0.899862024003912,0.561576354679803,1.75190326914465,25,11,14,0,1.3,2.56,8.1,0,0,0,0,0,0,0.618790290149721,368.789342326373,67.1140582184195
8.7,"greedy_SVM","SVM",89,1,3712,3381,331,200,128,72,0.896501142306372,0.561576354679803,1.75674278093787,89,45,44,64,1,5.11,1.8,0,0,0,0,0,0,0.714405207105867,235.159088509803,83.9135502583287
8.7,"greedy_SVM","SVM",89,2,3612,3343,269,300,166,134,0.897174161676384,0.586206896551724,1.73012546607517,156,77,79,67,1,7.67,1.2,0,0,0,0,0,0,0.250048436439115,76.9804907827022,42.3610732821094
8.7,"greedy_SVM","SVM",89,3,3512,3298,214,400,211,189,0.897619562804365,0.596059113300493,1.72283943610815,235,117,118,79,1,10.22,1.1,0,0,0,0,0,0,0.268871711787009,84.4458860406553,43.9513251845523
8.7,"greedy_SVM","SVM",89,4,3412,3249,163,500,260,240,0.902978426848848,0.600985221674877,1.73739809028329,324,163,161,89,1,12.78,1.1,0,0,0,0,0,0,0.146447936053765,65.6195130804544,23.8641285054114
8.7,"greedy_SVM","SVM",89,5,3312,3185,127,600,324,276,0.899512166335547,0.635467980295567,1.70350815121248,398,196,202,74,1,15.34,1.2,0,0,0,0,0,0,0.124023277337591,76.7066971091174,18.3082350741552
8.7,"greedy_SVM","SVM",89,6,3212,3109,103,700,400,300,0.904573159594114,0.645320197044335,1.67689083634978,453,217,236,55,1.1,17.89,1.3,0,0,0,0,0,0,0.0795767044091079,48.8796133689077,10.282174397513
8.7,"greedy_SVM","SVM",89,7,3112,3033,79,800,476,324,0.901675944685957,0.660098522167488,1.67689083634978,514,244,270,61,1.1,20.45,1.5,0,0,0,0,0,0,0.0663285491798064,66.4066528557147,10.2108216106637
8.7,"greedy_SVM","SVM",89,8,3012,2953,59,900,556,344,0.900809028294911,0.655172413793103,1.66801839806222,556,268,288,42,1.1,23.01,1.6,0,0,0,0,0,0,0.061517162029448,85.2012437515,8.71898343393228
8.7,"greedy_SVM","SVM",89,9,2912,2863,49,1000,646,354,0.901697020449113,0.665024630541872,1.65761960654579,586,280,306,30,1.1,25.56,1.8,0,0,0,0,0,0,0.060392702510505,90.0000444634924,6.86965361415939
8.7,"greedy_SVM","SVM",89,10,2812,2764,48,1100,745,355,0.907227300700567,0.665024630541872,1.67843635785794,603,288,315,17,1.1,28.12,2.1,0,0,0,0,0,0,0.0407692161417621,53.4046431343743,4.62953599227353
8.7,"greedy_SVM","SVM",89,11,2712,2669,43,1200,840,360,0.909652418514086,0.665024630541872,1.66801839806222,607,293,314,4,1.1,30.67,2.3,0,0,0,0,0,0,0.0357559170959726,51.2399752533398,3.83390579218135
8.7,"greedy_SVM","SVM",89,12,2612,2575,37,1300,934,366,0.916242107126706,0.665024630541872,1.69619758915802,623,302,321,16,1.1,33.23,2.6,0,0,0,0,0,0,0.0405494113698813,53.1381651300445,4.64225376636108
8.7,"greedy_SVM","SVM",89,13,2512,2480,32,1400,1029,371,0.922882377570887,0.665024630541872,1.7165112839094,660,314,346,37,1.1,35.79,2.8,0,0,0,0,0,0,0.0600968855754003,54.5250979588969,6.84480223241304
8.7,"greedy_SVM","SVM",89,14,2412,2385,27,1500,1124,376,0.926706926057795,0.665024630541872,1.75029601843901,671,323,348,11,1.1,38.34,3,0,0,0,0,0,0,0.0583880670750007,43.9398840396308,6.27511071215289
8.7,"greedy_SVM","SVM",89,15,2312,2289,23,1600,1220,380,0.927018847352468,0.660098522167488,1.75190326914465,682,330,352,11,1.1,40.9,3.2,0,0,0,0,0,0,0.0552269584026835,39.0134450090361,6.09697387628688
8.7,"greedy_SVM","SVM",89,16,2212,2195,17,1700,1314,386,0.927195883762958,0.665024630541872,1.75836189870832,703,338,365,21,1.1,43.46,3.4,0,0,0,0,0,0,0.0504517550988854,30.9814250287411,5.66467645749477
8.7,"greedy_SVM","SVM",89,17,2112,2098,14,1800,1411,389,0.927198693864713,0.660098522167488,1.74305527283584,711,342,369,8,1.1,46.01,3.6,0,0,0,0,0,0,0.035350832709491,24.9451651236567,4.41238021943033
8.7,"greedy_SVM","SVM",89,18,2012,2003,9,1900,1506,394,0.926848836196366,0.660098522167488,1.73899790436274,724,349,375,13,1.1,48.57,3.8,0,0,0,0,0,0,0.0259145509867978,22.4362023126731,3.26206365291818
8.7,"greedy_SVM","SVM",89,19,1912,1904,8,2000,1605,395,0.927440362615541,0.660098522167488,1.74948128305827,729,351,378,5,1.1,51.12,4.1,0,0,0,0,0,0,0.0178622353261627,16.9217026775655,2.05081671953217
8.7,"greedy_SVM","SVM",89,20,1812,1805,7,2100,1704,396,0.927719967740041,0.660098522167488,1.75351347435526,728,352,376,-1,1.1,53.68,4.3,0,0,0,0,0,0,0.0156843967918289,15.2059238334581,1.64535092673749
8.7,"greedy_SVM","SVM",89,21,1712,1705,7,2200,1804,396,0.927240845391015,0.655172413793103,1.7478703426503,742,357,385,14,1.1,56.24,4.6,0,0,0,0,0,0,0.0104954902989986,9.60763961139095,1.25075617707227
8.7,"greedy_SVM","SVM",89,22,1612,1608,4,2300,1901,399,0.927427717157632,0.660098522167488,1.7446573456969,750,360,390,8,1.1,58.79,4.8,0,0,0,0,0,0,0.0113671064114762,9.11700312913104,1.14406805276839
8.7,"greedy_SVM","SVM",89,23,1512,1508,4,2400,2001,399,0.926099944078967,0.650246305418719,1.75351347435526,768,372,396,18,1.1,61.35,5,0,0,0,0,0,0,0.0080542444812746,5.00781456190734,1.04722759450295
8.7,"greedy_SVM","SVM",89,24,1412,1408,4,2500,2101,399,0.926219373403503,0.650246305418719,1.75674278093787,768,371,397,0,1.1,63.91,5.3,0,0,0,0,0,0,0.00537323257583558,3.66402701470773,0.645067979453278
8.7,"greedy_SVM","SVM",89,25,1312,1309,3,2600,2200,400,0.926158956215796,0.645320197044335,1.75512664222495,772,373,399,4,1.1,66.46,5.5,0,0,0,0,0,0,0.00466764861332604,3.11727634996504,0.495244115607181
8.7,"greedy_SVM","SVM",89,26,1212,1209,3,2700,2300,400,0.926054982450907,0.640394088669951,1.75674278093787,771,376,395,-1,1.1,69.02,5.8,0,0,0,0,0,0,0.00381095705993483,2.27446068152747,0.395444443377083
8.7,"greedy_SVM","SVM",89,27,1112,1110,2,2800,2399,401,0.926220778454379,0.635467980295567,1.75190326914465,775,380,395,4,1,71.57,6,0,0,0,0,0,0,0.00371031640672757,2.10799025401999,0.405310166608254
8.7,"greedy_SVM","SVM",89,28,1012,1011,1,2900,2498,402,0.926588901784125,0.645320197044335,1.75029601843901,780,385,395,5,1,74.13,6.2,0,0,0,0,0,0,0.00340114089750512,1.70904279287306,0.358746521599426
8.7,"greedy_SVM","SVM",89,29,912,912,0,3000,2597,403,0.926930329147212,0.640394088669951,1.75351347435526,788,387,401,8,1,76.69,6.4,0,0,0,0,0,0,0.00267900738473021,1.23628063291956,0.29701097678199
8.7,"greedy_SVM","SVM",89,30,812,812,0,3100,2697,403,0.926983721080534,0.640394088669951,1.75029601843901,787,387,400,-1,1,79.24,6.7,0,0,0,0,0,0,0.00240502884936621,0.981942487168535,0.260024141307308
8.7,"greedy_SVM","SVM",89,31,712,712,0,3200,2797,403,0.927143896880501,0.640394088669951,1.75029601843901,788,389,399,1,1,81.8,6.9,0,0,0,0,0,0,0.00195029451131133,0.69971884127625,0.213673659048885
8.7,"greedy_SVM","SVM",89,32,612,612,0,3300,2897,403,0.927254895899776,0.645320197044335,1.75836189870832,788,389,399,0,1,84.36,7.2,0,0,0,0,0,0,0.00124290905765571,0.399406781139429,0.144094432069199
8.7,"greedy_SVM","SVM",89,33,512,512,0,3400,2997,403,0.927517640413755,0.645320197044335,1.75351347435526,789,389,400,1,1,86.91,7.4,0,0,0,0,0,0,0.000849445962505181,0.266216763036122,0.107174702604068
8.7,"greedy_SVM","SVM",89,34,412,412,0,3500,3097,403,0.927701702078628,0.645320197044335,1.75512664222495,791,389,402,2,1,89.47,7.7,0,0,0,0,0,0,0.000532038004725944,0.159403597609062,0.0682584860036525
8.7,"greedy_SVM","SVM",89,35,312,312,0,3600,3197,403,0.928277772938157,0.645320197044335,1.74709034807557,794,391,403,3,1,92.02,7.9,0,0,0,0,0,0,0.000325205174182669,0.083416654367152,0.0407284918705949
8.7,"greedy_SVM","SVM",89,36,212,212,0,3700,3297,403,0.92886648925558,0.645320197044335,1.74709034807557,797,391,406,3,1,94.58,8.2,0,0,0,0,0,0,0.000174571236312048,0.0370980535485855,0.0229855340289625
8.7,"greedy_SVM","SVM",89,37,112,112,0,3800,3397,403,0.929376522723898,0.645320197044335,1.74869171411414,801,393,408,4,1,97.14,8.4,0,0,0,0,0,0,9.66825997645665e-05,0.0154552766861971,0.0144527143813877
8.7,"greedy_SVM","SVM",89,38,12,12,0,3900,3497,403,0.929605546016833,0.645320197044335,1.75674278093787,806,393,413,5,1.1,99.69,8.7,0,0,0,0,0,0,5.79428842564255e-05,0.000812597199441244,0.000812597199441244
8.7,"greedy_SVM","SVM",89,39,0,0,0,3912,3509,403,0.929761506664169,0.645320197044335,1.74709034807557,808,393,415,2,1.1,100,8.7,0,0,0,0,0,0,0,0,0
8.7,"greedy_SVM","SVM",90,0,3812,3389,423,100,92,8,0.851996470682594,0.434285714285714,1.67914680710994,30,8,22,0,2.8,2.56,11.5,0,0,0,0,0,0,0.123317696028822,317.096119108566,13.8259288988648
8.7,"greedy_SVM","SVM",90,1,3712,3343,369,200,138,62,0.924689179433705,0.565714285714286,1.7739868938401,113,54,59,83,1.1,5.11,2.2,0,0,0,0,0,0,0.669509189247948,439.413966763134,72.8483828584206
8.7,"greedy_SVM","SVM",90,2,3612,3321,291,300,160,140,0.924756557311305,0.565714285714286,1.77724789915966,164,83,81,51,1,7.67,1.1,0,0,0,0,0,0,0.629842152443795,363.043556182404,70.7749575422882
8.7,"greedy_SVM","SVM",90,3,3512,3287,225,400,194,206,0.92633031202374,0.571428571428571,1.79944802207912,225,115,110,61,1,10.22,0.9,0,0,0,0,0,0,0.5,247.996903214481,61.8614682528641
8.7,"greedy_SVM","SVM",90,4,3412,3238,174,500,243,257,0.900829389588497,0.56,1.74803522144829,317,161,156,92,1,12.78,0.9,0,0,0,0,0,0,0.336650983933252,169.920083413469,43.3209391907226
8.7,"greedy_SVM","SVM",90,5,3312,3173,139,600,308,292,0.888406192347787,0.594285714285714,1.64672454617206,400,200,200,83,1,15.34,1.1,0,0,0,0,0,0,0.222656736288391,174.020069799675,29.6638879674588
8.7,"greedy_SVM","SVM",90,6,3212,3108,104,700,373,327,0.888486404106833,0.582857142857143,1.67760063141279,476,233,243,76,1,17.89,1.1,0,0,0,0,0,0,0.153499363257499,136.124440971571,22.4165458752595
8.7,"greedy_SVM","SVM",90,7,3112,3032,80,800,449,351,0.894592123205264,0.611428571428571,1.65854377880184,536,260,276,60,1.1,20.45,1.3,0,0,0,0,0,0,0.0826701787569827,85.1723827628256,12.4324885327357
8.7,"greedy_SVM","SVM",90,8,3012,2953,59,900,528,372,0.899714446137804,0.622857142857143,1.65397058823529,577,277,300,41,1.1,23.01,1.4,0,0,0,0,0,0,0.0623569986481082,78.5549630984491,8.19687028413019
8.7,"greedy_SVM","SVM",90,9,2912,2859,53,1000,622,378,0.903717012914081,0.617142857142857,1.66730860299921,592,286,306,15,1.1,25.56,1.6,0,0,0,0,0,0,0.0536193543851779,74.605933346327,6.16607099174166
8.7,"greedy_SVM","SVM",90,10,2812,2763,49,1100,718,382,0.90960295179273,0.617142857142857,1.68169855832241,607,294,313,15,1.1,28.12,1.9,0,0,0,0,0,0,0.0490938408415068,69.0120177351266,5.41706875317533
8.7,"greedy_SVM","SVM",90,11,2712,2667,45,1200,814,386,0.917070666559716,0.622857142857143,1.70690498094362,621,301,320,14,1.1,30.67,2.1,0,0,0,0,0,0,0.0409389646484878,56.1921624752517,4.58004019469737
8.7,"greedy_SVM","SVM",90,12,2612,2574,38,1300,907,393,0.925773642415984,0.617142857142857,1.71560924369748,641,313,328,20,1,33.23,2.3,0,0,0,0,0,0,0.0458725008460988,56.6039170545993,5.56322654419237
8.7,"greedy_SVM","SVM",90,13,2512,2481,31,1400,1000,400,0.933457928932385,0.605714285714286,1.75993685872139,678,328,350,37,1.1,35.79,2.5,0,0,0,0,0,0,0.0519854781219035,51.5639015611806,5.85683754072799
8.7,"greedy_SVM","SVM",90,14,2412,2382,30,1500,1099,401,0.933857383492424,0.605714285714286,1.75993685872139,682,329,353,4,1.1,38.34,2.7,0,0,0,0,0,0,0.0376929277368421,37.1358169907129,4.18769590288111
8.7,"greedy_SVM","SVM",90,15,2312,2284,28,1600,1197,403,0.933369695997436,0.605714285714286,1.75670168067227,684,330,354,2,1.1,40.9,3,0,0,0,0,0,0,0.0341407676672287,32.3445099544242,3.79310763302633
8.7,"greedy_SVM","SVM",90,16,2212,2188,24,1700,1293,407,0.9316948744686,0.605714285714286,1.76155892034233,696,336,360,12,1.1,43.46,3.2,0,0,0,0,0,0,0.0365574407532215,30.3918001005218,4.32538833247774
8.7,"greedy_SVM","SVM",90,17,2112,2098,14,1800,1383,417,0.927725996631106,0.594285714285714,1.75831778157445,725,347,378,29,1.1,46.01,3.3,0,0,0,0,0,0,0.0365978790332232,30.8968619101183,5.29210987997773
8.7,"greedy_SVM","SVM",90,18,2012,2002,10,1900,1479,421,0.927121199967916,0.588571428571429,1.75347837483617,730,352,378,5,1.1,48.57,3.5,0,0,0,0,0,0,0.0291803409100134,25.7375289419571,3.37977726227077
8.7,"greedy_SVM","SVM",90,19,1912,1902,10,2000,1579,421,0.927334563246972,0.588571428571429,1.75670168067227,738,353,385,8,1.1,51.12,3.8,0,0,0,0,0,0,0.0208885997559007,19.2181204365787,2.30565951344867
8.7,"greedy_SVM","SVM",90,20,1812,1802,10,2100,1679,421,0.927170931258522,0.588571428571429,1.75508854781582,740,355,385,2,1.1,53.68,4,0,0,0,0,0,0,0.0172491073299129,15.8394419055229,1.86300123916644
8.7,"greedy_SVM","SVM",90,21,1712,1703,9,2200,1778,422,0.927607283227718,0.588571428571429,1.75026687598116,748,359,389,8,1.1,56.24,4.2,0,0,0,0,0,0,0.0157342018812784,13.0495983747467,1.60256426697548
8.7,"greedy_SVM","SVM",90,22,1612,1604,8,2300,1877,423,0.928757519852411,0.6,1.79081294396212,766,373,393,18,1.1,58.79,4.4,0,0,0,0,0,0,0.011136222080644,7.3052810638062,1.42257800910946
8.7,"greedy_SVM","SVM",90,23,1512,1504,8,2400,1977,423,0.928868212079891,0.6,1.78916546195295,765,373,392,-1,1.1,61.35,4.7,0,0,0,0,0,0,0.00758379924786614,5.56608030289373,0.844492378127971
8.7,"greedy_SVM","SVM",90,24,1412,1404,8,2500,2077,423,0.928964466190743,0.6,1.79246346280448,775,377,398,10,1.1,63.91,4.9,0,0,0,0,0,0,0.00588724131741387,3.93461765102412,0.618720525969003
8.7,"greedy_SVM","SVM",90,25,1312,1304,8,2600,2177,423,0.931271356380842,0.594285714285714,1.78052091554854,777,379,398,2,1.1,66.46,5.1,0,0,0,0,0,0,0.00462312033335863,2.94972109203442,0.525768859786857
8.7,"greedy_SVM","SVM",90,26,1212,1205,7,2700,2276,424,0.93167081094088,0.594285714285714,1.78752100840336,780,382,398,3,1,69.02,5.4,0,0,0,0,0,0,0.00463412862347561,2.47470708787827,0.474672900885418
8.7,"greedy_SVM","SVM",90,27,1112,1106,6,2800,2375,425,0.933190021657172,0.594285714285714,1.78052091554854,795,389,406,15,1,71.57,5.6,0,0,0,0,0,0,0.003684093104427,1.8847779939944,0.416320302165859
8.7,"greedy_SVM","SVM",90,28,1012,1006,6,2900,2475,425,0.933315152001281,0.594285714285714,1.78587957497048,796,389,407,1,1,74.13,5.8,0,0,0,0,0,0,0.00342105525293074,1.49304928605321,0.360906099498015
8.7,"greedy_SVM","SVM",90,29,912,906,6,3000,2575,425,0.933207668244162,0.594285714285714,1.78052091554854,796,390,406,0,1,76.69,6.1,0,0,0,0,0,0,0.00257417440514085,0.974668828718207,0.282213244245931
8.7,"greedy_SVM","SVM",90,30,812,807,5,3100,2674,426,0.933417823052857,0.594285714285714,1.77724789915966,797,391,406,1,1,79.24,6.3,0,0,0,0,0,0,0.00253912597379397,0.857807225717277,0.277368549186246
8.7,"greedy_SVM","SVM",90,31,712,708,4,3200,2773,427,0.933623165156009,0.594285714285714,1.77888290182678,800,392,408,3,1,81.8,6.5,0,0,0,0,0,0,0.00183262632939479,0.581522783967137,0.21492406926574
8.7,"greedy_SVM","SVM",90,32,612,608,4,3300,2873,427,0.933748295500118,0.6,1.77888290182678,800,392,408,0,1,84.36,6.7,0,0,0,0,0,0,0.00112591765981463,0.33957809953906,0.143571915754097
8.7,"greedy_SVM","SVM",90,33,512,509,3,3400,2972,428,0.934239191465467,0.6,1.77724789915966,806,397,409,6,1,86.91,6.9,0,0,0,0,0,0,0.000856385484649036,0.265228897622338,0.112496100220668
8.7,"greedy_SVM","SVM",90,34,412,411,1,3500,3070,430,0.93486805165637,0.6,1.79246346280448,816,402,414,10,1,89.47,7.1,0,0,0,0,0,0,0.00081580475888284,0.245807301463073,0.102296587825684
8.7,"greedy_SVM","SVM",90,35,312,312,0,3600,3169,431,0.935272318921952,0.594285714285714,1.79081294396212,828,406,422,12,1,92.02,7.4,0,0,0,0,0,0,0.000708428433931369,0.177176633966626,0.0847367289742405
8.7,"greedy_SVM","SVM",90,36,212,212,0,3700,3269,431,0.935528996550892,0.594285714285714,1.79246346280448,830,406,424,2,1,94.58,7.6,0,0,0,0,0,0,0.000379368018042171,0.0781812622394744,0.0487184130009405
8.7,"greedy_SVM","SVM",90,37,112,112,0,3800,3369,431,0.935723109007778,0.594285714285714,1.78752100840336,831,408,423,1,1,97.14,7.8,0,0,0,0,0,0,0.000204523797391424,0.0315294276624919,0.0293225257213333
8.7,"greedy_SVM","SVM",90,38,12,12,0,3900,3469,431,0.935753589476214,0.588571428571429,1.78916546195295,833,410,423,2,1,99.69,8,0,0,0,0,0,0,0.000149728229237735,0.00208614325617875,0.00208614325617875
8.7,"greedy_SVM","SVM",90,39,0,0,0,3912,3481,431,0.935729525948501,0.588571428571429,1.78752100840336,834,411,423,1,1,100,8.1,0,0,0,0,0,0,0,0,0
8.7,"greedy_SVM","SVM",91,0,3812,3423,389,100,92,8,0.887984323091124,0.478468899521531,1.76015100302884,27,8,19,0,2.4,2.56,11.5,0,0,0,0,0,0,0.452058282978407,329.54582200873,59.232383971786
8.7,"greedy_SVM","SVM",91,1,3712,3359,353,200,156,44,0.906976553106748,0.550239234449761,1.74618280326485,101,44,57,74,1.3,5.11,3.5,0,0,0,0,0,0,0.5,347.767690832678,63.461664357129
8.7,"greedy_SVM","SVM",91,2,3612,3337,275,300,178,122,0.915691424533639,0.598086124401914,1.78590931039024,167,83,84,66,1,7.67,1.5,0,0,0,0,0,0,0.651311079274957,361.982141039835,74.3657114537905
8.7,"greedy_SVM","SVM",91,3,3512,3308,204,400,207,193,0.914845134379357,0.578947368421053,1.77361862463301,223,111,112,56,1,10.22,1.1,0,0,0,0,0,0,0.466338285360815,218.301702561436,57.1926647798635
8.7,"greedy_SVM","SVM",91,4,3412,3265,147,500,250,250,0.91554352916687,0.602870813397129,1.76711589823655,316,160,156,93,1,12.78,1,0,0,0,0,0,0,0.354777432563478,219.234667063127,45.7217518199105
8.7,"greedy_SVM","SVM",91,5,3312,3196,116,600,319,281,0.878892866239597,0.61244019138756,1.65308143655115,393,195,198,77,1,15.34,1.1,0,0,0,0,0,0,0.19047269306633,126.761908407163,27.6971199948744
8.7,"greedy_SVM","SVM",91,6,3212,3119,93,700,396,304,0.879128403305186,0.617224880382775,1.64750292152669,453,223,230,60,1,17.89,1.3,0,0,0,0,0,0,0.095949237979611,77.0785353747094,13.8560567246085
8.7,"greedy_SVM","SVM",91,7,3112,3042,70,800,473,327,0.879265343459601,0.636363636363636,1.63025158203426,510,247,263,57,1.1,20.45,1.4,0,0,0,0,0,0,0.0808655190775152,83.587668900718,11.1832208297406
8.7,"greedy_SVM","SVM",91,8,3012,2951,61,900,564,336,0.880638853208373,0.636363636363636,1.63736815670517,528,258,270,18,1,23.01,1.7,0,0,0,0,0,0,0.0582837002478752,69.5625518343253,7.17453329520777
8.7,"greedy_SVM","SVM",91,9,2912,2862,50,1000,653,347,0.887339334963837,0.645933014354067,1.64750292152669,560,270,290,32,1.1,25.56,1.9,0,0,0,0,0,0,0.0588526654521202,85.8248191571016,6.41415153877663
8.7,"greedy_SVM","SVM",91,10,2812,2768,44,1100,747,353,0.899406501370766,0.641148325358852,1.66322133812683,576,276,300,16,1.1,28.12,2.1,0,0,0,0,0,0,0.0457969151126032,65.7310608718024,5.20843861305607
8.7,"greedy_SVM","SVM",91,11,2712,2675,37,1200,840,360,0.906346628396457,0.641148325358852,1.6672334480077,596,286,310,20,1.1,30.67,2.3,0,0,0,0,0,0,0.0506194906168972,68.0238668331496,5.71280580751574
8.7,"greedy_SVM","SVM",91,12,2612,2579,33,1300,936,364,0.916488416232333,0.645933014354067,1.71177526034337,616,299,317,20,1.1,33.23,2.6,0,0,0,0,0,0,0.057852254953589,60.2901241331537,6.40998056485201
8.7,"greedy_SVM","SVM",91,13,2512,2486,26,1400,1029,371,0.921864686694622,0.641148325358852,1.73917942803819,638,310,328,22,1.1,35.79,2.8,0,0,0,0,0,0,0.0567328842038411,53.8816596010279,6.19009813463115
8.7,"greedy_SVM","SVM",91,14,2412,2388,24,1500,1127,373,0.923516184956847,0.641148325358852,1.74939860953237,649,313,336,11,1.1,38.34,3,0,0,0,0,0,0,0.0487626788756291,44.1481572110783,5.39368761859448
8.7,"greedy_SVM","SVM",91,15,2312,2290,22,1600,1225,375,0.924239228972148,0.645933014354067,1.75101095848125,653,317,336,4,1.1,40.9,3.3,0,0,0,0,0,0,0.0392894897233948,35.3577866500962,4.4845495848714
8.7,"greedy_SVM","SVM",91,16,2212,2196,16,1700,1319,381,0.92418445291038,0.645933014354067,1.75101095848125,669,324,345,16,1.1,43.46,3.5,0,0,0,0,0,0,0.037239472519767,32.9355077599314,4.74048017291291
8.7,"greedy_SVM","SVM",91,17,2112,2101,11,1800,1414,386,0.925025265458476,0.645933014354067,1.74778922718689,686,330,356,17,1.1,46.01,3.7,0,0,0,0,0,0,0.0291751813132304,27.6979159076285,3.37277679001908
8.7,"greedy_SVM","SVM",91,18,2012,2001,11,1900,1514,386,0.924825332833032,0.645933014354067,1.74618280326485,689,332,357,3,1.1,48.57,3.9,0,0,0,0,0,0,0.0237742714774261,22.8983489552619,2.59951782115369
8.7,"greedy_SVM","SVM",91,19,1912,1902,10,2000,1613,387,0.925127970574286,0.645933014354067,1.74939860953237,691,334,357,2,1.1,51.12,4.2,0,0,0,0,0,0,0.0213664519365448,20.4458109604112,2.28895501658057
8.7,"greedy_SVM","SVM",91,20,1812,1803,9,2100,1712,388,0.92478151198362,0.645933014354067,1.75101095848125,694,336,358,3,1.1,53.68,4.4,0,0,0,0,0,0,0.0173287771710156,16.6378509916753,1.8722280035185
8.7,"greedy_SVM","SVM",91,21,1712,1703,9,2200,1812,388,0.924277572215378,0.645933014354067,1.75101095848125,695,337,358,1,1.1,56.24,4.7,0,0,0,0,0,0,0.0154050433970138,14.7873012668664,1.63397337435066
8.7,"greedy_SVM","SVM",91,22,1612,1605,7,2300,1910,390,0.925393634473853,0.645933014354067,1.75478468899522,701,340,361,6,1.1,58.79,4.9,0,0,0,0,0,0,0.0131823089658703,11.7326345217887,1.3519692667156
8.7,"greedy_SVM","SVM",91,23,1512,1505,7,2400,2010,390,0.924124199242444,0.636363636363636,1.74778922718689,719,350,369,18,1.1,61.35,5.2,0,0,0,0,0,0,0.00873737791107967,6.93378105324311,1.03946896274205
8.7,"greedy_SVM","SVM",91,24,1412,1406,6,2500,2109,391,0.92386264354751,0.636363636363636,1.74939860953237,724,351,373,5,1.1,63.91,5.4,0,0,0,0,0,0,0.00744103903712057,5.60062312417095,0.771714379777896
8.7,"greedy_SVM","SVM",91,25,1312,1306,6,2600,2209,391,0.923351856771547,0.62200956937799,1.75101095848125,724,353,371,0,1.1,66.46,5.6,0,0,0,0,0,0,0.00556344327097452,3.83821780146822,0.618977781447198
8.7,"greedy_SVM","SVM",91,26,1212,1206,6,2700,2309,391,0.923208069609414,0.62200956937799,1.74618280326485,728,354,374,4,1.1,69.02,5.9,0,0,0,0,0,0,0.00534660344432162,3.13464265822542,0.537744179425816
8.7,"greedy_SVM","SVM",91,27,1112,1107,5,2800,2408,392,0.923880445767589,0.617224880382775,1.74939860953237,740,362,378,12,1,71.57,6.1,0,0,0,0,0,0,0.00402133384606683,2.21879076503393,0.471562312453605
8.7,"greedy_SVM","SVM",91,28,1012,1008,4,2900,2507,393,0.924058467968328,0.617224880382775,1.75101095848125,745,364,381,5,1,74.13,6.4,0,0,0,0,0,0,0.0040640159555133,1.83301675815968,0.411606147821742
8.7,"greedy_SVM","SVM",91,29,912,908,4,3000,2607,393,0.924487090651639,0.61244019138756,1.74939860953237,759,370,389,14,1.1,76.69,6.6,0,0,0,0,0,0,0.00283371434406379,1.19242968141433,0.332533658207971
8.7,"greedy_SVM","SVM",91,30,812,809,3,3100,2706,394,0.924592534570536,0.61244019138756,1.75101095848125,760,371,389,1,1,79.24,6.9,0,0,0,0,0,0,0.00240754105261385,0.866095350584654,0.261767893025406
8.7,"greedy_SVM","SVM",91,31,712,710,2,3200,2805,395,0.92461992260142,0.61244019138756,1.74778922718689,764,376,388,4,1,81.8,7.1,0,0,0,0,0,0,0.00230238644328197,0.76450288212262,0.259773924922054
8.7,"greedy_SVM","SVM",91,32,612,610,2,3300,2905,395,0.924693870284802,0.61244019138756,1.75101095848125,765,376,389,1,1,84.36,7.4,0,0,0,0,0,0,0.00162752428162114,0.473289779812556,0.190098635032297
8.7,"greedy_SVM","SVM",91,33,512,510,2,3400,3005,395,0.924910235728775,0.61244019138756,1.74939860953237,764,376,388,-1,1,86.91,7.6,0,0,0,0,0,0,0.000774032164316431,0.245414016870771,0.109555320969745
8.7,"greedy_SVM","SVM",91,34,412,412,0,3500,3103,397,0.924978705805983,0.61244019138756,1.7563990263356,770,377,393,6,1,89.47,7.8,0,0,0,0,0,0,0.000741162665464469,0.239195947934596,0.0995453103420454
8.7,"greedy_SVM","SVM",91,35,312,312,0,3600,3203,397,0.925295037562672,0.61244019138756,1.75801633667292,774,379,395,4,1,92.02,8.1,0,0,0,0,0,0,0.000688841022047222,0.179573596464359,0.0811410954030496
8.7,"greedy_SVM","SVM",91,36,212,212,0,3700,3303,397,0.925522358218996,0.61244019138756,1.75801633667292,779,383,396,5,1,94.58,8.3,0,0,0,0,0,0,0.000368044536653109,0.0742898200471746,0.0449612166048662
8.7,"greedy_SVM","SVM",91,37,112,112,0,3800,3403,397,0.925379940458405,0.61244019138756,1.75801633667292,781,383,398,2,1,97.14,8.6,0,0,0,0,0,0,0.000140176843964445,0.0248947166007225,0.0233754903636148
8.7,"greedy_SVM","SVM",91,38,12,12,0,3900,3503,397,0.925545638045245,0.607655502392344,1.75801633667292,782,383,399,1,1,99.69,8.8,0,0,0,0,0,0,8.91585967164023e-05,0.00124645496988529,0.00124645496988529
8.7,"greedy_SVM","SVM",91,39,0,0,0,3912,3515,397,0.925545638045244,0.607655502392344,1.7563990263356,782,383,399,0,1,100,8.9,0,0,0,0,0,0,0,0,0
8.7,"greedy_SVM","SVM",92,0,3812,3415,397,100,87,13,0.908395176252323,0.556122448979592,1.74275960384154,31,13,18,0,1.4,2.56,6.7,0,0,0,0,0,0,0.798974249196387,597.290102958624,82.8880234708005
8.7,"greedy_SVM","SVM",92,1,3712,3389,323,200,113,87,0.909967822356196,0.581632653061224,1.75193202280912,89,44,45,58,1,5.11,1.3,0,0,0,0,0,0,0.676768164303238,372.42474635389,74.136329724745
8.7,"greedy_SVM","SVM",92,2,3612,3352,260,300,150,150,0.902565514842299,0.586734693877551,1.72600116403507,158,81,77,69,1,7.67,1,0,0,0,0,0,0,0.485820881030919,216.885563202219,58.6626068903215
8.7,"greedy_SVM","SVM",92,3,3512,3312,200,400,190,210,0.885391059833025,0.576530612244898,1.66020783313325,240,126,114,82,0.9,10.22,0.9,0,0,0,0,0,0,0.376733046793764,252.3413380589,48.9853550982714
8.7,"greedy_SVM","SVM",92,4,3412,3245,167,500,257,243,0.864879986085342,0.576530612244898,1.62650806178825,331,166,165,91,1,12.78,1.1,0,0,0,0,0,0,0.183439150923632,113.08620621171,27.5352145395107
8.7,"greedy_SVM","SVM",92,5,3312,3180,132,600,322,278,0.872063427643793,0.622448979591837,1.615830876969,399,198,201,68,1,15.34,1.2,0,0,0,0,0,0,0.170332715043876,114.136598522758,24.5231978571173
8.7,"greedy_SVM","SVM",92,6,3212,3104,108,700,398,302,0.876226229128016,0.622448979591837,1.60812943962115,450,221,229,51,1,17.89,1.3,0,0,0,0,0,0,0.102073104434499,82.5366105907974,16.5928592266424
8.7,"greedy_SVM","SVM",92,7,3112,3026,86,800,476,324,0.875339169758809,0.647959183673469,1.59746916245799,506,242,264,56,1.1,20.45,1.5,0,0,0,0,0,0,0.0641752452899347,75.8880816469343,11.4425078399064
8.7,"greedy_SVM","SVM",92,8,3012,2938,74,900,564,336,0.888317486085329,0.637755102040816,1.62501173422451,539,259,280,33,1.1,23.01,1.7,0,0,0,0,0,0,0.0477120752514406,48.0175150566587,6.02886116271524
8.7,"greedy_SVM","SVM",92,9,2912,2851,61,1000,651,349,0.897643205009265,0.642857142857143,1.63419259148001,565,271,294,26,1.1,25.56,1.9,0,0,0,0,0,0,0.0454627973959102,56.8345207045613,5.36561792815279
8.7,"greedy_SVM","SVM",92,10,2812,2760,52,1100,742,358,0.905251333487938,0.658163265306122,1.66020783313325,588,283,305,23,1.1,28.12,2.1,0,0,0,0,0,0,0.0403764839661367,55.7374335796377,4.58060456238797
8.7,"greedy_SVM","SVM",92,11,2712,2666,46,1200,836,364,0.919192080241179,0.653061224489796,1.7092118615402,614,294,320,26,1.1,30.67,2.3,0,0,0,0,0,0,0.0527368113930929,58.8749203378462,6.14436412331608
8.7,"greedy_SVM","SVM",92,12,2612,2576,36,1300,926,374,0.925956632653074,0.637755102040816,1.74757829399041,644,309,335,30,1.1,33.23,2.5,0,0,0,0,0,0,0.0636018863603852,60.3479038041354,7.20307816831696
8.7,"greedy_SVM","SVM",92,13,2512,2479,33,1400,1023,377,0.92454922309834,0.63265306122449,1.74596910587439,656,316,340,12,1.1,35.79,2.7,0,0,0,0,0,0,0.061708865043164,52.6971697004171,6.70660827775884
8.7,"greedy_SVM","SVM",92,14,2412,2380,32,1500,1122,378,0.924272379406316,0.63265306122449,1.74757829399041,659,318,341,3,1.1,38.34,3,0,0,0,0,0,0,0.0490658081759466,37.7752674733829,5.41543333366445
8.7,"greedy_SVM","SVM",92,15,2312,2285,27,1600,1217,383,0.923217184601118,0.627551020408163,1.74757829399041,674,327,347,15,1.1,40.9,3.2,0,0,0,0,0,0,0.0441859472638933,33.7887095499787,5.21674520718223
8.7,"greedy_SVM","SVM",92,16,2212,2189,23,1700,1313,387,0.922246057513922,0.627551020408163,1.74757829399041,687,331,356,13,1.1,43.46,3.4,0,0,0,0,0,0,0.0351759278818206,28.5406491022428,4.3057049361433
8.7,"greedy_SVM","SVM",92,17,2112,2094,18,1800,1408,392,0.921738752319116,0.627551020408163,1.74757829399041,695,335,360,8,1.1,46.01,3.6,0,0,0,0,0,0,0.0265533359714464,24.2990296071629,3.17831509007742
8.7,"greedy_SVM","SVM",92,18,2012,1996,16,1900,1506,394,0.921892393320971,0.627551020408163,1.74757829399041,700,339,361,5,1.1,48.57,3.8,0,0,0,0,0,0,0.0224147635903283,21.4750415692208,2.47042261417751
8.7,"greedy_SVM","SVM",92,19,1912,1898,14,2000,1604,396,0.923060644712438,0.627551020408163,1.74757829399041,701,342,359,1,1,51.12,4.1,0,0,0,0,0,0,0.0178773327684213,18.1799716579691,1.99147424001736
8.7,"greedy_SVM","SVM",92,20,1812,1802,10,2100,1700,400,0.925626159554736,0.61734693877551,1.74757829399041,721,348,373,20,1.1,53.68,4.2,0,0,0,0,0,0,0.0171680173336669,17.1339961623071,1.78752792690192
8.7,"greedy_SVM","SVM",92,21,1712,1704,8,2200,1798,402,0.925687036178102,0.61734693877551,1.75948726598077,739,360,379,18,1.1,56.24,4.5,0,0,0,0,0,0,0.011079878372402,8.98239747574485,1.41662393824419
8.7,"greedy_SVM","SVM",92,22,1612,1607,5,2300,1895,405,0.925887059369195,0.612244897959184,1.76597385497978,750,364,386,11,1.1,58.79,4.7,0,0,0,0,0,0,0.00989036160838708,9.36989705126164,1.13876290155072
8.7,"greedy_SVM","SVM",92,23,1512,1507,5,2400,1995,405,0.925640653988864,0.612244897959184,1.76434772804149,751,364,387,1,1.1,61.35,4.9,0,0,0,0,0,0,0.00867615501500477,7.44362340954321,0.883826329206178
8.7,"greedy_SVM","SVM",92,24,1412,1407,5,2500,2095,405,0.924083951762529,0.607142857142857,1.75948726598077,771,374,397,20,1.1,63.91,5.2,0,0,0,0,0,0,0.00557117932536639,4.08829965627844,0.680347147667017
8.7,"greedy_SVM","SVM",92,25,1312,1307,5,2600,2195,405,0.924034670686462,0.607142857142857,1.76110444177671,771,374,397,0,1.1,66.46,5.4,0,0,0,0,0,0,0.0045983597108824,3.35612202830377,0.498508756701776
8.7,"greedy_SVM","SVM",92,26,1212,1207,5,2700,2295,405,0.924059311224496,0.612244897959184,1.75787305747987,771,374,397,0,1.1,69.02,5.7,0,0,0,0,0,0,0.00388692151281894,2.58608855071568,0.404753973762448
8.7,"greedy_SVM","SVM",92,27,1112,1107,5,2800,2395,405,0.923733186456408,0.61734693877551,1.76110444177671,772,375,397,1,1.1,71.57,5.9,0,0,0,0,0,0,0.00354143247092944,2.12137604916088,0.374190618357063
8.7,"greedy_SVM","SVM",92,28,1012,1009,3,2900,2493,407,0.923798411410028,0.612244897959184,1.76110444177671,782,380,402,10,1.1,74.13,6.1,0,0,0,0,0,0,0.00318376288280887,1.68129947337361,0.326759549212234
8.7,"greedy_SVM","SVM",92,29,912,909,3,3000,2593,407,0.92344184833025,0.607142857142857,1.76434772804149,789,384,405,7,1.1,76.69,6.4,0,0,0,0,0,0,0.00255184533389711,1.19986842128217,0.288292186887396
8.7,"greedy_SVM","SVM",92,30,812,809,3,3100,2693,407,0.923444747217076,0.607142857142857,1.76434772804149,789,384,405,0,1.1,79.24,6.6,0,0,0,0,0,0,0.0021672317809651,0.851961451045066,0.23030444399272
8.7,"greedy_SVM","SVM",92,31,712,709,3,3200,2793,407,0.924515885899801,0.612244897959184,1.76597385497978,795,387,408,6,1.1,81.8,6.9,0,0,0,0,0,0,0.00169935271886192,0.586654509413232,0.190831170299454
8.7,"greedy_SVM","SVM",92,32,612,610,2,3300,2892,408,0.925020292207777,0.607142857142857,1.76434772804149,797,389,408,2,1,84.36,7.1,0,0,0,0,0,0,0.00137895856162754,0.433781039301784,0.161061067972175
8.7,"greedy_SVM","SVM",92,33,512,511,1,3400,2991,409,0.925497159090893,0.612244897959184,1.76434772804149,801,390,411,4,1.1,86.91,7.3,0,0,0,0,0,0,0.000982957455832346,0.307860249421522,0.122120836633636
8.7,"greedy_SVM","SVM",92,34,412,412,0,3500,3090,410,0.925850823283842,0.612244897959184,1.75787305747987,806,393,413,5,1.1,89.47,7.5,0,0,0,0,0,0,0.000768394175511061,0.235247917704943,0.09623878065249
8.7,"greedy_SVM","SVM",92,35,312,312,0,3600,3190,410,0.926152307513895,0.612244897959184,1.75465350975555,807,395,412,1,1,92.02,7.8,0,0,0,0,0,0,0.000440548654167703,0.115342773882984,0.0546629710521489
8.7,"greedy_SVM","SVM",92,36,212,212,0,3700,3290,410,0.926211734693857,0.61734693877551,1.76272459305709,808,395,413,1,1,94.58,8,0,0,0,0,0,0,0.000233886022142445,0.0484894137694422,0.0300326972875941
8.7,"greedy_SVM","SVM",92,37,112,112,0,3800,3390,410,0.9263639262523,0.612244897959184,1.76110444177671,813,397,416,5,1,97.14,8.3,0,0,0,0,0,0,0.000114353531707565,0.0191763546269896,0.0179454396728234
8.7,"greedy_SVM","SVM",92,38,12,12,0,3900,3490,410,0.926623376623359,0.612244897959184,1.76597385497978,817,400,417,4,1,99.69,8.5,0,0,0,0,0,0,7.56774586272422e-05,0.00116391791332905,0.00116391791332905
8.7,"greedy_SVM","SVM",92,39,0,0,0,3912,3502,410,0.926701646567701,0.612244897959184,1.76597385497978,818,400,418,1,1,100,8.5,0,0,0,0,0,0,0,0,0
8.7,"greedy_SVM","SVM",93,0,3812,3425,387,100,88,12,0.917208729349833,0.618357487922705,1.74729010839566,30,12,18,0,1.5,2.56,7.3,0,0,0,0,0,0,0.458904577690195,470.960141296528,50.8877196557188
8.7,"greedy_SVM","SVM",93,1,3712,3406,306,200,107,93,0.914140033090005,0.608695652173913,1.72121115155394,80,41,39,50,1,5.11,1.2,0,0,0,0,0,0,0.677019664779296,358.999024339273,74.8657863986913
8.7,"greedy_SVM","SVM",93,2,3612,3373,239,300,140,160,0.915301497335962,0.584541062801932,1.72831415174766,152,79,73,72,0.9,7.67,0.9,0,0,0,0,0,0,0.5,254.083959376365,59.3250952502498
8.7,"greedy_SVM","SVM",93,3,3512,3322,190,400,191,209,0.916910422242666,0.608695652173913,1.7592199292059,251,132,119,99,0.9,10.22,0.9,0,0,0,0,0,0,0.303060766256174,133.029214931747,42.8218983744804
8.7,"greedy_SVM","SVM",93,4,3412,3261,151,500,252,248,0.889919153249771,0.632850241545894,1.65731092213306,334,169,165,83,1,12.78,1,0,0,0,0,0,0,0.225827493840144,169.580733266232,31.0701653678383
8.7,"greedy_SVM","SVM",93,5,3312,3189,123,600,324,276,0.886596343528272,0.63768115942029,1.66342082415014,410,202,208,76,1,15.34,1.2,0,0,0,0,0,0,0.143736056366716,127.15686057828,19.5428977234568
8.7,"greedy_SVM","SVM",93,6,3212,3102,110,700,411,289,0.900674781724829,0.652173913043478,1.66342082415014,442,216,226,32,1,17.89,1.4,0,0,0,0,0,0,0.0846702746920602,78.9580023108925,11.4084786899479
8.7,"greedy_SVM","SVM",93,7,3112,3026,86,800,487,313,0.89517129180788,0.666666666666667,1.6414641943734,499,242,257,57,1.1,20.45,1.6,0,0,0,0,0,0,0.079176386607104,102.446436857997,11.3797384141928
8.7,"greedy_SVM","SVM",93,8,3012,2944,68,900,569,331,0.899755001477729,0.666666666666667,1.65471181459961,541,263,278,42,1.1,23.01,1.7,0,0,0,0,0,0,0.0759940317558557,118.8956176339,10.3327519849106
8.7,"greedy_SVM","SVM",93,9,2912,2856,56,1000,657,343,0.904367713227426,0.671497584541063,1.69825686235223,568,276,292,27,1.1,25.56,1.9,0,0,0,0,0,0,0.0603814664189012,92.6011182332573,6.8810102908665
8.7,"greedy_SVM","SVM",93,10,2812,2763,49,1100,750,350,0.908798126189419,0.666666666666667,1.69357416879795,593,287,306,25,1.1,28.12,2.1,0,0,0,0,0,0,0.0561093227257245,83.5169314591993,6.10216282770524
8.7,"greedy_SVM","SVM",93,11,2712,2668,44,1200,845,355,0.923170728338913,0.666666666666667,1.70539408012384,622,301,321,29,1.1,30.67,2.4,0,0,0,0,0,0,0.0430924073175037,57.5901431274396,5.0756717049621
8.7,"greedy_SVM","SVM",93,12,2612,2576,36,1300,937,363,0.929884019301606,0.652173913043478,1.73309290055433,643,307,336,21,1.1,33.23,2.6,0,0,0,0,0,0,0.0592540923489006,70.4881289540927,6.86042362352225
8.7,"greedy_SVM","SVM",93,13,2512,2480,32,1400,1033,367,0.935817016210812,0.652173913043478,1.77500200176155,658,318,340,15,1.1,35.79,2.8,0,0,0,0,0,0,0.0553757793624601,58.9739575425116,6.10397040366299
8.7,"greedy_SVM","SVM",93,14,2412,2381,31,1500,1132,368,0.936728510149377,0.652173913043478,1.77500200176155,668,322,346,10,1.1,38.34,3.1,0,0,0,0,0,0,0.0438903824346032,45.4466712884782,4.84422725236615
8.7,"greedy_SVM","SVM",93,15,2312,2283,29,1600,1230,370,0.937442513734588,0.652173913043478,1.76630101155684,675,325,350,7,1.1,40.9,3.3,0,0,0,0,0,0,0.0386116529951258,41.1383401511743,4.32307711620864
8.7,"greedy_SVM","SVM",93,16,2212,2185,27,1700,1328,372,0.938291860359155,0.652173913043478,1.76467607962348,678,326,352,3,1.1,43.46,3.6,0,0,0,0,0,0,0.031450185804187,31.6464163838186,3.49710089076755
8.7,"greedy_SVM","SVM",93,17,2112,2092,20,1800,1421,379,0.937535044179854,0.652173913043478,1.76630101155684,705,339,366,27,1.1,46.01,3.7,0,0,0,0,0,0,0.0375578925696817,33.6180706353304,4.90060109014886
8.7,"greedy_SVM","SVM",93,18,2012,1999,13,1900,1514,386,0.935678911068593,0.652173913043478,1.75820613982651,723,348,375,18,1.1,48.57,3.9,0,0,0,0,0,0,0.029856770910948,28.179515448444,3.58731456862242
8.7,"greedy_SVM","SVM",93,19,1912,1900,12,2000,1613,387,0.934877901243795,0.652173913043478,1.75659606094389,729,350,379,6,1.1,51.12,4.2,0,0,0,0,0,0,0.0237960320496827,23.0817378011946,2.56734650185463
8.7,"greedy_SVM","SVM",93,20,1812,1802,10,2100,1711,389,0.936691221760978,0.652173913043478,1.76848823294775,737,351,386,8,1.1,53.68,4.4,0,0,0,0,0,0,0.022428952093084,20.0453868583992,2.27745792257121
8.7,"greedy_SVM","SVM",93,21,1712,1703,9,2200,1810,390,0.93374820118055,0.652173913043478,1.78042412617221,757,367,390,20,1.1,56.24,4.6,0,0,0,0,0,0,0.0152336825241896,10.4745581693351,1.99044929971732
8.7,"greedy_SVM","SVM",93,22,1612,1605,7,2300,1908,392,0.934347577497729,0.652173913043478,1.7820620508513,762,368,394,5,1.1,58.79,4.9,0,0,0,0,0,0,0.0130222876956264,10.7176338718734,1.53346679244211
8.7,"greedy_SVM","SVM",93,23,1512,1507,5,2400,2006,394,0.934532638388286,0.652173913043478,1.77715729291318,765,371,394,3,1.1,61.35,5.1,0,0,0,0,0,0,0.01136112286789,9.19228310239467,1.21379660095755
8.7,"greedy_SVM","SVM",93,24,1412,1407,5,2500,2106,394,0.934507779462688,0.652173913043478,1.78534695785748,767,371,396,2,1.1,63.91,5.3,0,0,0,0,0,0,0.00959521940456233,6.80002938098528,0.975985167051231
8.7,"greedy_SVM","SVM",93,25,1312,1307,5,2600,2206,394,0.934912427529353,0.652173913043478,1.78370299196626,774,378,396,7,1,66.46,5.6,0,0,0,0,0,0,0.00711912576602445,4.63852981812798,0.841401923179784
8.7,"greedy_SVM","SVM",93,26,1212,1207,5,2700,2306,394,0.935004957974632,0.657004830917874,1.78370299196626,774,378,396,0,1,69.02,5.9,0,0,0,0,0,0,0.00655749822431739,3.7483522297278,0.669982174414546
8.7,"greedy_SVM","SVM",93,27,1112,1107,5,2800,2406,394,0.935441370224005,0.652173913043478,1.78534695785748,781,380,401,7,1.1,71.57,6.1,0,0,0,0,0,0,0.00529535240258665,2.66616892278971,0.555136765711499
8.7,"greedy_SVM","SVM",93,28,1012,1008,4,2900,2505,395,0.935510422795107,0.647342995169082,1.78534695785748,788,382,406,7,1.1,74.13,6.3,0,0,0,0,0,0,0.00525272925651998,2.31793042912978,0.548698518714688
8.7,"greedy_SVM","SVM",93,29,912,908,4,3000,2605,395,0.935709294199885,0.647342995169082,1.7820620508513,793,384,409,5,1.1,76.69,6.6,0,0,0,0,0,0,0.00418277579947608,1.63379898067052,0.460319909641999
8.7,"greedy_SVM","SVM",93,30,812,810,2,3100,2703,397,0.935539424874972,0.652173913043478,1.78370299196626,799,386,413,6,1.1,79.24,6.8,0,0,0,0,0,0,0.00359391784039614,1.28029567848105,0.401605963110637
8.7,"greedy_SVM","SVM",93,31,712,710,2,3200,2803,397,0.935554616440615,0.647342995169082,1.7820620508513,800,386,414,1,1.1,81.8,7.1,0,0,0,0,0,0,0.00285734158373847,0.896454753667746,0.321112802179184
8.7,"greedy_SVM","SVM",93,32,612,610,2,3300,2903,397,0.935540805926394,0.647342995169082,1.78534695785748,799,387,412,-1,1.1,84.36,7.3,0,0,0,0,0,0,0.00164934518414255,0.511973940469442,0.210518881216165
8.7,"greedy_SVM","SVM",93,33,512,510,2,3400,3003,397,0.935689959479976,0.642512077294686,1.78534695785748,799,388,411,0,1.1,86.91,7.6,0,0,0,0,0,0,0.000953252289350351,0.292600720328415,0.129215876185001
8.7,"greedy_SVM","SVM",93,34,412,411,1,3500,3102,398,0.935507660692262,0.642512077294686,1.78534695785748,804,390,414,5,1.1,89.47,7.8,0,0,0,0,0,0,0.000660360001309811,0.192529766741382,0.0839621261734189
8.7,"greedy_SVM","SVM",93,35,312,312,0,3600,3201,399,0.936039365489756,0.647342995169082,1.78370299196626,804,392,412,0,1.1,92.02,8,0,0,0,0,0,0,0.000563840513518141,0.14049140079706,0.069882722559314
8.7,"greedy_SVM","SVM",93,36,212,212,0,3700,3301,399,0.936046270746866,0.647342995169082,1.78042412617221,808,394,414,4,1.1,94.58,8.3,0,0,0,0,0,0,0.000279875427390772,0.0586260464152454,0.0373527039317267
8.7,"greedy_SVM","SVM",93,37,112,112,0,3800,3401,399,0.936249285305909,0.647342995169082,1.78370299196626,811,395,416,3,1.1,97.14,8.5,0,0,0,0,0,0,0.000109046160273909,0.017810576926113,0.0167124808290529
8.7,"greedy_SVM","SVM",93,38,12,12,0,3900,3501,399,0.936435727247888,0.647342995169082,1.78042412617221,811,396,415,0,1,99.69,8.8,0,0,0,0,0,0,7.7058262025548e-05,0.00108198348312077,0.00108198348312077
8.7,"greedy_SVM","SVM",93,39,0,0,0,3912,3513,399,0.936449537762108,0.647342995169082,1.78370299196626,813,396,417,2,1.1,100,8.8,0,0,0,0,0,0,0,0,0
8.7,"greedy_SVM","SVM",94,0,3812,3425,387,100,87,13,0.910846047156727,0.597087378640777,1.75254754072053,31,13,18,0,1.4,2.56,6.7,0,0,0,0,0,0,0.904025346192065,614.76774697557,92.6619801801258
8.7,"greedy_SVM","SVM",94,1,3712,3402,310,200,110,90,0.908349514563106,0.58252427184466,1.72956654549352,87,44,43,56,1,5.11,1.2,0,0,0,0,0,0,0.656432337161014,386.688406736146,71.3495943714855
8.7,"greedy_SVM","SVM",94,2,3612,3370,242,300,142,158,0.914036061026352,0.601941747572815,1.74703691463992,151,79,72,64,0.9,7.67,0.9,0,0,0,0,0,0,0.5,268.328826952405,59.6743848037465
8.7,"greedy_SVM","SVM",94,3,3512,3324,188,400,188,212,0.90919140083217,0.62621359223301,1.72241592018452,234,120,114,83,1,10.22,0.9,0,0,0,0,0,0,0.306816356488557,206.786637732531,40.5152461604556
8.7,"greedy_SVM","SVM",94,4,3412,3255,157,500,257,243,0.880848821081818,0.640776699029126,1.63919869480328,328,164,164,94,1,12.78,1.1,0,0,0,0,0,0,0.206498718840377,170.476049920218,30.9125853678764
8.7,"greedy_SVM","SVM",94,5,3312,3191,121,600,321,279,0.885367545076282,0.679611650485437,1.64221469976152,409,202,207,81,1,15.34,1.2,0,0,0,0,0,0,0.129333404443865,129.579288646518,18.8160939546667
8.7,"greedy_SVM","SVM",94,6,3212,3116,96,700,396,304,0.891545076282934,0.699029126213592,1.63347951518832,469,226,243,60,1.1,17.89,1.3,0,0,0,0,0,0,0.099465860903577,128.784940164093,14.1661122727335
8.7,"greedy_SVM","SVM",94,7,3112,3030,82,800,482,318,0.904127600554779,0.694174757281553,1.67561393489435,496,243,253,27,1,20.45,1.5,0,0,0,0,0,0,0.0824928989414985,114.078744784742,10.1344053802564
8.7,"greedy_SVM","SVM",94,8,3012,2951,61,900,561,339,0.915839112343952,0.694174757281553,1.69462580720072,546,267,279,50,1,23.01,1.7,0,0,0,0,0,0,0.0972958040275446,164.64209773263,11.5260931206894
8.7,"greedy_SVM","SVM",94,9,2912,2859,53,1000,653,347,0.927074895977796,0.684466019417476,1.71609512781687,592,281,311,46,1.1,25.56,1.9,0,0,0,0,0,0,0.0884499102760823,117.452164639833,9.88395334805009
8.7,"greedy_SVM","SVM",94,10,2812,2766,46,1100,746,354,0.932859916782243,0.66504854368932,1.75577209921312,610,293,317,18,1.1,28.12,2.1,0,0,0,0,0,0,0.0772109510283342,93.7084661195617,8.44346752656938
8.7,"greedy_SVM","SVM",94,11,2712,2673,39,1200,839,361,0.933675450762825,0.66504854368932,1.75025725918303,632,301,331,22,1.1,30.67,2.3,0,0,0,0,0,0,0.0706104870456363,87.4336210736516,7.67251035892698
8.7,"greedy_SVM","SVM",94,12,2612,2580,32,1300,932,368,0.935778085991658,0.669902912621359,1.75738883226948,648,310,338,16,1.1,33.23,2.5,0,0,0,0,0,0,0.0661294013352769,81.5324831734782,7.29995481466194
8.7,"greedy_SVM","SVM",94,13,2512,2483,29,1400,1029,371,0.935345353675433,0.669902912621359,1.74543118218161,656,313,343,8,1.1,35.79,2.8,0,0,0,0,0,0,0.0579121297074006,67.6447725675055,6.1903625782339
8.7,"greedy_SVM","SVM",94,14,2412,2388,24,1500,1124,376,0.936002773925085,0.66504854368932,1.74703691463992,674,322,352,18,1.1,38.34,3,0,0,0,0,0,0,0.0502363734985023,57.9703575319624,5.57476001944901
8.7,"greedy_SVM","SVM",94,15,2312,2295,17,1600,1217,383,0.936094313453523,0.669902912621359,1.74150597288712,689,329,360,15,1.1,40.9,3.2,0,0,0,0,0,0,0.0471880220276377,56.6078890928864,5.22395882596659
8.7,"greedy_SVM","SVM",94,16,2212,2196,16,1700,1316,384,0.936183079056852,0.674757281553398,1.739902376227,687,330,357,-2,1.1,43.46,3.4,0,0,0,0,0,0,0.0383896108533006,45.8275426229836,4.1375584626816
8.7,"greedy_SVM","SVM",94,17,2112,2097,15,1800,1415,385,0.936102635228831,0.66504854368932,1.75025725918303,691,332,359,4,1.1,46.01,3.7,0,0,0,0,0,0,0.0318273302805879,37.2234120385589,3.36532067387414
8.7,"greedy_SVM","SVM",94,18,2012,1997,15,1900,1515,385,0.935622746185837,0.660194174757282,1.75025725918303,693,331,362,2,1.1,48.57,3.9,0,0,0,0,0,0,0.0272435645867823,30.2405581132493,2.86053342863689
8.7,"greedy_SVM","SVM",94,19,1912,1899,13,2000,1613,387,0.936690707350885,0.660194174757282,1.75025725918303,703,337,366,10,1.1,51.12,4.2,0,0,0,0,0,0,0.0244727894248161,26.3992536393792,2.5619400337778
8.7,"greedy_SVM","SVM",94,20,1812,1799,13,2100,1713,387,0.935919556171975,0.640776699029126,1.76126668271417,718,348,370,15,1.1,53.68,4.4,0,0,0,0,0,0,0.0161693973526105,14.1566728579332,1.93435667017135
8.7,"greedy_SVM","SVM",94,21,1712,1701,11,2200,1811,389,0.936431345353665,0.645631067961165,1.76613206029073,720,349,371,2,1.1,56.24,4.7,0,0,0,0,0,0,0.0135842516376141,12.4167513224837,1.48759396246744
8.7,"greedy_SVM","SVM",94,22,1612,1604,8,2300,1908,392,0.93742579750346,0.640776699029126,1.76613206029073,729,351,378,9,1.1,58.79,4.9,0,0,0,0,0,0,0.0140934749024265,13.0537662870753,1.53206366623623
8.7,"greedy_SVM","SVM",94,23,1512,1505,7,2400,2007,393,0.937750346740637,0.635922330097087,1.76288549400343,738,358,380,9,1.1,61.35,5.1,0,0,0,0,0,0,0.0104365003894248,8.49316368348844,1.15424725801576
8.7,"greedy_SVM","SVM",94,24,1412,1405,7,2500,2107,393,0.937719833564492,0.635922330097087,1.76126668271417,738,358,380,0,1.1,63.91,5.4,0,0,0,0,0,0,0.00955264835475341,7.38041140535757,0.977789977879537
8.7,"greedy_SVM","SVM",94,25,1312,1305,7,2600,2207,393,0.936546463245492,0.631067961165049,1.7699858247078,750,366,384,12,1,66.46,5.6,0,0,0,0,0,0,0.00817537575756486,5.74743309920503,0.943457119930401
8.7,"greedy_SVM","SVM",94,26,1212,1207,5,2700,2305,395,0.937251040221914,0.635922330097087,1.7699858247078,752,367,385,2,1,69.02,5.8,0,0,0,0,0,0,0.0084085802087153,5.14122399648726,0.85933847237383
8.7,"greedy_SVM","SVM",94,27,1112,1107,5,2800,2405,395,0.936818307905683,0.631067961165049,1.77707312728244,767,374,393,15,1.1,71.57,6.1,0,0,0,0,0,0,0.00598249997373792,3.30746094299448,0.670234638825781
8.7,"greedy_SVM","SVM",94,28,1012,1008,4,2900,2504,396,0.937073509015247,0.631067961165049,1.78526240436669,772,375,397,5,1.1,74.13,6.3,0,0,0,0,0,0,0.00530328227036336,2.50912126995081,0.546061848203186
8.7,"greedy_SVM","SVM",94,29,912,908,4,3000,2604,396,0.937131761442422,0.635922330097087,1.78526240436669,774,376,398,2,1.1,76.69,6.6,0,0,0,0,0,0,0.0043174089434241,1.73855307065811,0.459435873943115
8.7,"greedy_SVM","SVM",94,30,812,808,4,3100,2704,396,0.937227461858509,0.635922330097087,1.78033980582524,776,379,397,2,1,79.24,6.8,0,0,0,0,0,0,0.00357010571183017,1.21140786078589,0.384439013753053
8.7,"greedy_SVM","SVM",94,31,712,709,3,3200,2803,397,0.937517337031878,0.62621359223301,1.77870496670144,779,381,398,3,1,81.8,7.1,0,0,0,0,0,0,0.00272912340043641,0.861600286545599,0.326397028861661
8.7,"greedy_SVM","SVM",94,32,612,611,1,3300,2901,399,0.937453536754482,0.631067961165049,1.77870496670144,785,383,402,6,1,84.36,7.3,0,0,0,0,0,0,0.00210600703712556,0.663427597031223,0.262978558181536
8.7,"greedy_SVM","SVM",94,33,512,511,1,3400,3001,399,0.937429958391096,0.631067961165049,1.77707312728244,788,385,403,3,1,86.91,7.5,0,0,0,0,0,0,0.00124974110786967,0.39842375326231,0.170075179346904
8.7,"greedy_SVM","SVM",94,34,412,412,0,3500,3100,400,0.937314840499282,0.631067961165049,1.77870496670144,796,388,408,8,1.1,89.47,7.8,0,0,0,0,0,0,0.000909281074041198,0.264047440378964,0.115715423912024
8.7,"greedy_SVM","SVM",94,35,312,312,0,3600,3200,400,0.93743689320386,0.631067961165049,1.77707312728244,799,389,410,3,1.1,92.02,8,0,0,0,0,0,0,0.000567366117294084,0.138857084665709,0.0707292493041989
8.7,"greedy_SVM","SVM",94,36,212,212,0,3700,3300,400,0.937413314840476,0.62621359223301,1.78361851633321,802,391,411,3,1.1,94.58,8.2,0,0,0,0,0,0,0.00027128286348838,0.0575300214145498,0.036595201655476
8.7,"greedy_SVM","SVM",94,37,112,112,0,3800,3400,400,0.93752565880719,0.631067961165049,1.78197765293272,802,391,411,0,1.1,97.14,8.5,0,0,0,0,0,0,0.000111973402827878,0.0187501687550836,0.0176042871257309
8.7,"greedy_SVM","SVM",94,38,12,12,0,3900,3500,400,0.937583911234375,0.631067961165049,1.78197765293272,804,392,412,2,1.1,99.69,8.8,0,0,0,0,0,0,7.23549619345378e-05,0.00117233890976687,0.00117233890976687
8.7,"greedy_SVM","SVM",94,39,0,0,0,3912,3512,400,0.937520110956982,0.631067961165049,1.79071283750592,804,392,412,0,1.1,100,8.8,0,0,0,0,0,0,0,0,0
8.7,"greedy_SVM","SVM",95,0,3812,3429,383,100,90,10,0.909682997583901,0.539906103286385,1.77737392094502,23,10,13,0,1.3,2.56,9,0,0,0,0,0,0,0.384416132806947,327.666479908062,43.0270325578251
8.7,"greedy_SVM","SVM",95,1,3712,3415,297,200,104,96,0.904864259182949,0.568075117370892,1.72024987389904,64,34,30,41,0.9,5.11,1.1,0,0,0,0,0,0,0.645343364613186,268.281479230004,74.1634341300416
8.7,"greedy_SVM","SVM",95,2,3612,3370,242,300,149,151,0.900193665338745,0.563380281690141,1.74875934540083,147,74,73,83,1,7.67,1,0,0,0,0,0,0,0.287739218113786,82.3899789202411,44.9445363544081
8.7,"greedy_SVM","SVM",95,3,3512,3324,188,400,195,205,0.897304846481864,0.582159624413146,1.73345783726299,239,125,114,92,0.9,10.22,1,0,0,0,0,0,0,0.198203480707946,72.8892892892204,35.4480978256165
8.7,"greedy_SVM","SVM",95,4,3412,3255,157,500,264,236,0.901314176895382,0.572769953051643,1.76728140481934,321,159,162,82,1,12.78,1.1,0,0,0,0,0,0,0.12886604457351,49.7388464945011,19.9179075055901
8.7,"greedy_SVM","SVM",95,5,3312,3177,135,600,342,258,0.892517083760938,0.591549295774648,1.72659180891802,372,180,192,51,1.1,15.34,1.3,0,0,0,0,0,0,0.0621954166880876,30.1471902352053,9.60087212980308
8.7,"greedy_SVM","SVM",95,6,3212,3101,111,700,418,282,0.880012336401276,0.615023474178404,1.66581070215029,426,204,222,54,1.1,17.89,1.5,0,0,0,0,0,0,0.080629562374214,53.2385359665078,14.6992126933777
8.7,"greedy_SVM","SVM",95,7,3112,3017,95,800,502,298,0.888851179365346,0.619718309859155,1.64586785418393,457,221,236,31,1.1,20.45,1.7,0,0,0,0,0,0,0.0502782654197403,36.4920334287326,6.97936482411158
8.7,"greedy_SVM","SVM",95,8,3012,2936,76,900,583,317,0.882416318526972,0.63849765258216,1.63349127020186,501,243,258,44,1.1,23.01,1.8,0,0,0,0,0,0,0.0516835905319227,62.9696026975177,7.50933330371476
8.7,"greedy_SVM","SVM",95,9,2912,2852,60,1000,667,333,0.878763881818355,0.633802816901408,1.61358954092541,550,260,290,49,1.1,25.56,2,0,0,0,0,0,0,0.0663197749568997,86.3772639324041,8.69402793349818
8.7,"greedy_SVM","SVM",95,10,2812,2758,54,1100,761,339,0.885688966462778,0.652582159624413,1.62502758486402,570,269,301,20,1.1,28.12,2.2,0,0,0,0,0,0,0.0486817880639851,61.4848838619811,5.58711468746571
8.7,"greedy_SVM","SVM",95,11,2712,2661,51,1200,858,342,0.888646470523289,0.652582159624413,1.63349127020186,579,275,304,9,1.1,30.67,2.5,0,0,0,0,0,0,0.0404319398965237,52.6778874541732,4.41181124543782
8.7,"greedy_SVM","SVM",95,12,2612,2562,50,1300,957,343,0.894009303478179,0.647887323943662,1.65041864087752,582,278,304,3,1.1,33.23,2.8,0,0,0,0,0,0,0.0273275935645555,33.5230939854859,3.04660261977791
8.7,"greedy_SVM","SVM",95,13,2512,2467,45,1400,1052,348,0.897610562976248,0.63849765258216,1.64435649710938,600,287,313,18,1.1,35.79,3,0,0,0,0,0,0,0.029088678443729,37.0320500794906,3.09946142406184
8.7,"greedy_SVM","SVM",95,14,2412,2370,42,1500,1149,351,0.906197560193829,0.63849765258216,1.68117444316312,612,295,317,12,1.1,38.34,3.3,0,0,0,0,0,0,0.0242297481274289,26.3756431269981,2.67963127929961
8.7,"greedy_SVM","SVM",95,15,2312,2276,36,1600,1243,357,0.910469510503444,0.647887323943662,1.67118889809445,633,305,328,21,1.1,40.9,3.5,0,0,0,0,0,0,0.0246457582287025,31.8164926184684,2.78106853326181
8.7,"greedy_SVM","SVM",95,16,2212,2183,29,1700,1336,364,0.919336635610173,0.652582159624413,1.73345783726299,649,313,336,16,1.1,43.46,3.7,0,0,0,0,0,0,0.0522380548549353,43.4611323364363,6.0253013279169
8.7,"greedy_SVM","SVM",95,17,2112,2086,26,1800,1433,367,0.921195176413219,0.652582159624413,1.74031123262112,668,324,344,19,1.1,46.01,3.9,0,0,0,0,0,0,0.0465369080079452,35.0768877997724,5.29153340398473
8.7,"greedy_SVM","SVM",95,18,2012,1987,25,1900,1532,368,0.921558803961641,0.652582159624413,1.74351917959369,678,331,347,10,1,48.57,4.2,0,0,0,0,0,0,0.0384588937270206,29.2201397556076,4.26193444859149
8.7,"greedy_SVM","SVM",95,19,1912,1895,17,2000,1624,376,0.920955451585004,0.652582159624413,1.74351917959369,709,342,367,31,1.1,51.12,4.3,0,0,0,0,0,0,0.0528190202287022,29.7212011268127,6.00385151223012
8.7,"greedy_SVM","SVM",95,20,1812,1803,9,2100,1716,384,0.921677319607061,0.652582159624413,1.7318631198414,722,348,374,13,1.1,53.68,4.5,0,0,0,0,0,0,0.0383952550632133,24.4178886176394,5.17245184138281
8.7,"greedy_SVM","SVM",95,21,1712,1706,6,2200,1813,387,0.921960141033612,0.652582159624413,1.7318631198414,734,352,382,12,1.1,56.24,4.7,0,0,0,0,0,0,0.0248444701426382,19.0149958670806,3.0770307841092
8.7,"greedy_SVM","SVM",95,22,1612,1607,5,2300,1912,388,0.921806609402056,0.652582159624413,1.73027133388567,736,355,381,2,1.1,58.79,4.9,0,0,0,0,0,0,0.0176351062851944,14.124812089416,1.95757389991186
8.7,"greedy_SVM","SVM",95,23,1512,1507,5,2400,2012,388,0.922186398174851,0.652582159624413,1.73027133388567,739,356,383,3,1.1,61.35,5.2,0,0,0,0,0,0,0.0139778901318144,11.3270364508633,1.5057549760153
8.7,"greedy_SVM","SVM",95,24,1412,1407,5,2500,2112,388,0.9225338644989,0.647887323943662,1.72868247132012,741,358,383,2,1.1,63.91,5.4,0,0,0,0,0,0,0.0136257327813093,9.80241739514311,1.36973481219299
8.7,"greedy_SVM","SVM",95,25,1312,1307,5,2600,2212,388,0.925720319238045,0.647887323943662,1.76241286100441,752,369,383,11,1,66.46,5.7,0,0,0,0,0,0,0.00886841686696643,5.35491137397787,1.1584036095936
8.7,"greedy_SVM","SVM",95,26,1212,1207,5,2700,2312,388,0.925580255293467,0.652582159624413,1.75720745818055,752,369,383,0,1,69.02,6,0,0,0,0,0,0,0.00670730857307133,4.09825876908712,0.740015199460365
8.7,"greedy_SVM","SVM",95,27,1112,1107,5,2800,2412,388,0.925603150361331,0.647887323943662,1.75882551293025,752,369,383,0,1,71.57,6.2,0,0,0,0,0,0,0.00561984270619535,3.06282635251143,0.58387714026749
8.7,"greedy_SVM","SVM",95,28,1012,1007,5,2900,2512,388,0.925779577060752,0.647887323943662,1.76565557096026,756,371,385,4,1,74.13,6.5,0,0,0,0,0,0,0.00484905830863762,2.354183447008,0.518030344776901
8.7,"greedy_SVM","SVM",95,29,912,907,5,3000,2612,388,0.926447574334901,0.647887323943662,1.76403272576636,758,372,386,2,1,76.69,6.7,0,0,0,0,0,0,0.00429369360913659,1.66261628182957,0.436311174852926
8.7,"greedy_SVM","SVM",95,30,812,808,4,3100,2711,389,0.92679638742765,0.63849765258216,1.76403272576636,767,375,392,9,1,79.24,7,0,0,0,0,0,0,0.00379950748918695,1.26163958533358,0.427518954836209
8.7,"greedy_SVM","SVM",95,31,712,709,3,3200,2810,390,0.926972814127069,0.643192488262911,1.75398026358334,772,377,395,5,1,81.8,7.2,0,0,0,0,0,0,0.0025980481411332,0.741520457829122,0.309581706283436
8.7,"greedy_SVM","SVM",95,32,612,610,2,3300,2909,391,0.927142506983003,0.643192488262911,1.75720745818055,783,380,403,11,1.1,84.36,7.4,0,0,0,0,0,0,0.00174090106125769,0.504722166538734,0.2372533409707
8.7,"greedy_SVM","SVM",95,33,512,511,1,3400,3008,392,0.927648892013401,0.63849765258216,1.76403272576636,786,383,403,3,1.1,86.91,7.7,0,0,0,0,0,0,0.000923017650625464,0.297249538784291,0.132820570715014
8.7,"greedy_SVM","SVM",95,34,412,412,0,3500,3107,393,0.927982890650472,0.633802816901408,1.76403272576636,790,385,405,4,1.1,89.47,7.9,0,0,0,0,0,0,0.000712815724347731,0.205495152686587,0.0911359519891145
8.7,"greedy_SVM","SVM",95,35,312,312,0,3600,3207,393,0.928477154762586,0.629107981220657,1.76403272576636,794,386,408,4,1.1,92.02,8.2,0,0,0,0,0,0,0.000524842978833504,0.13432007244826,0.0684318145225619
8.7,"greedy_SVM","SVM",95,36,212,212,0,3700,3307,393,0.928658968536796,0.624413145539906,1.76403272576636,797,387,410,3,1.1,94.58,8.4,0,0,0,0,0,0,0.000235601376646698,0.0494913136335738,0.0318280326662955
8.7,"greedy_SVM","SVM",95,37,112,112,0,3800,3407,393,0.928900040133712,0.624413145539906,1.76403272576636,796,388,408,-1,1.1,97.14,8.7,0,0,0,0,0,0,8.27773953459921e-05,0.0149314373399,0.0140339084425986
8.7,"greedy_SVM","SVM",95,38,12,12,0,3900,3507,393,0.929073773295734,0.619718309859155,1.76241286100441,796,389,407,0,1,99.69,8.9,0,0,0,0,0,0,8.41719147112585e-05,0.00116782230451476,0.00116782230451476
8.7,"greedy_SVM","SVM",95,39,0,0,0,3912,3519,393,0.929022596085216,0.619718309859155,1.76241286100441,797,390,407,1,1,100,9,0,0,0,0,0,0,0,0,0
8.7,"greedy_SVM","SVM",96,0,3812,3403,409,100,85,15,0.919583235254031,0.56043956043956,1.76007158440827,33,15,18,0,1.2,2.56,5.7,0,0,0,0,0,0,0.711796019922025,691.247811832627,73.9796822003437
8.7,"greedy_SVM","SVM",96,1,3712,3382,330,200,106,94,0.921181411598541,0.56043956043956,1.76007158440827,84,44,40,51,0.9,5.11,1.1,0,0,0,0,0,0,0.692763316410894,512.642631258858,73.1673001239154
8.7,"greedy_SVM","SVM",96,2,3612,3351,261,300,137,163,0.919837209014203,0.543956043956044,1.74679865588956,151,80,71,67,0.9,7.67,0.8,0,0,0,0,0,0,0.588130121337399,375.578794346561,65.4009809068584
8.7,"greedy_SVM","SVM",96,3,3512,3309,203,400,179,221,0.911106086697962,0.56043956043956,1.72706081796991,233,122,111,82,0.9,10.22,0.8,0,0,0,0,0,0,0.413759589152185,192.516489407259,51.7853017894162
8.7,"greedy_SVM","SVM",96,4,3412,3248,164,500,240,260,0.888112169679254,0.56043956043956,1.69745406109042,322,164,158,89,1,12.78,0.9,0,0,0,0,0,0,0.445751313967917,314.669490372453,52.2093503079419
8.7,"greedy_SVM","SVM",96,5,3312,3173,139,600,315,285,0.91144368596456,0.582417582417582,1.71719189901008,408,204,204,86,1,15.34,1.1,0,0,0,0,0,0,0.147297687298081,96.1098755715026,20.4809394181444
8.7,"greedy_SVM","SVM",96,6,3212,3096,116,700,392,308,0.911332185289334,0.620879120879121,1.74012555981277,462,225,237,54,1.1,17.89,1.3,0,0,0,0,0,0,0.112601271375778,87.4294632494674,16.9688781134746
8.7,"greedy_SVM","SVM",96,7,3112,3013,99,800,475,325,0.923634426452918,0.642857142857143,1.75989971390155,498,244,254,36,1,20.45,1.5,0,0,0,0,0,0,0.0816911904527754,69.1440099722868,10.3039044794735
8.7,"greedy_SVM","SVM",96,8,3012,2933,79,900,555,345,0.924015387093183,0.653846153846154,1.72864819004525,542,263,279,44,1.1,23.01,1.6,0,0,0,0,0,0,0.0834496196545083,116.408250291366,12.4218866010038
8.7,"greedy_SVM","SVM",96,9,2912,2853,59,1000,635,365,0.922762553117689,0.653846153846154,1.73533622340962,593,286,307,51,1.1,25.56,1.7,0,0,0,0,0,0,0.0913347891722753,97.6911168397985,10.3797155367387
8.7,"greedy_SVM","SVM",96,10,2812,2759,53,1100,729,371,0.925656924811389,0.642857142857143,1.75162406654119,625,300,325,32,1.1,28.12,2,0,0,0,0,0,0,0.0855181528935149,86.559250616518,9.32926693829904
8.7,"greedy_SVM","SVM",96,11,2712,2667,45,1200,821,379,0.929491309141819,0.642857142857143,1.76314376867372,650,312,338,25,1.1,30.67,2.2,0,0,0,0,0,0,0.0777521390237032,72.4444608296516,8.54646088563666
8.7,"greedy_SVM","SVM",96,12,2612,2569,43,1300,919,381,0.931039929630696,0.642857142857143,1.75989971390155,661,315,346,11,1.1,33.23,2.4,0,0,0,0,0,0,0.0617066601897184,53.9609300445552,6.61837634060236
8.7,"greedy_SVM","SVM",96,13,2512,2474,38,1400,1014,386,0.930593926929901,0.642857142857143,1.76152024770809,678,323,355,17,1.1,35.79,2.6,0,0,0,0,0,0,0.0540635588157024,46.180483923718,5.96756968441377
8.7,"greedy_SVM","SVM",96,14,2412,2379,33,1500,1109,391,0.931188597197624,0.642857142857143,1.75989971390155,686,328,358,8,1.1,38.34,2.8,0,0,0,0,0,0,0.0436972201748202,37.3760052351788,5.07255315435478
8.7,"greedy_SVM","SVM",96,15,2312,2286,26,1600,1202,398,0.932737217686495,0.653846153846154,1.75989971390155,709,336,373,23,1.1,40.9,3,0,0,0,0,0,0,0.0383374645313545,34.1476480703456,4.43690586914995
8.7,"greedy_SVM","SVM",96,16,2212,2193,19,1700,1295,405,0.934307518862205,0.659340659340659,1.76152024770809,721,343,378,12,1.1,43.46,3.2,0,0,0,0,0,0,0.0325216109696685,31.7987965517278,3.74614235388144
8.7,"greedy_SVM","SVM",96,17,2112,2095,17,1800,1393,407,0.934319907826115,0.664835164835165,1.75989971390155,724,347,377,3,1.1,46.01,3.4,0,0,0,0,0,0,0.0267806560121222,27.0822059669802,2.91775474355926
8.7,"greedy_SVM","SVM",96,18,2012,1996,16,1900,1492,408,0.934353977476873,0.664835164835165,1.76152024770809,732,352,380,8,1.1,48.57,3.7,0,0,0,0,0,0,0.0200511202286097,20.2650620474366,2.21065277130012
8.7,"greedy_SVM","SVM",96,19,1912,1899,13,2000,1589,411,0.93472874363518,0.659340659340659,1.76314376867372,741,358,383,9,1.1,51.12,3.9,0,0,0,0,0,0,0.0193198190711402,19.4837535417818,2.06310234900567
8.7,"greedy_SVM","SVM",96,20,1812,1799,13,2100,1689,411,0.934834049828427,0.659340659340659,1.76314376867372,744,360,384,3,1.1,53.68,4.1,0,0,0,0,0,0,0.0166926178280614,16.980169360374,1.79987090560496
8.7,"greedy_SVM","SVM",96,21,1712,1702,10,2200,1786,414,0.935225850812115,0.664835164835165,1.76152024770809,760,366,394,16,1.1,56.24,4.3,0,0,0,0,0,0,0.0161260319291775,14.1617996240305,1.63113322948928
8.7,"greedy_SVM","SVM",96,22,1612,1603,9,2300,1885,415,0.935258371842381,0.642857142857143,1.76653649380922,787,383,404,27,1.1,58.79,4.5,0,0,0,0,0,0,0.0116922218796096,7.10861755191393,1.61060538557355
8.7,"greedy_SVM","SVM",96,23,1512,1505,7,2400,1983,417,0.935007495323184,0.642857142857143,1.77141642887499,797,386,411,10,1.1,61.35,4.8,0,0,0,0,0,0,0.00768390766798799,5.47947203674563,0.967212355891833
8.7,"greedy_SVM","SVM",96,24,1412,1406,6,2500,2082,418,0.935196427022826,0.648351648351648,1.76978679094594,798,388,410,1,1.1,63.91,5,0,0,0,0,0,0,0.00644847010699021,4.90073084675562,0.727893479428905
8.7,"greedy_SVM","SVM",96,25,1312,1307,5,2600,2181,419,0.935685791097308,0.648351648351648,1.76978679094594,799,389,410,1,1.1,66.46,5.2,0,0,0,0,0,0,0.00618033290118135,4.47628360302133,0.646364886786781
8.7,"greedy_SVM","SVM",96,26,1212,1207,5,2700,2281,419,0.936710977860938,0.637362637362637,1.77141642887499,803,396,407,4,1,69.02,5.4,0,0,0,0,0,0,0.0044050512553545,2.94602940951906,0.485937009476858
8.7,"greedy_SVM","SVM",96,27,1112,1110,2,2800,2378,422,0.937565816370795,0.631868131868132,1.76653649380922,815,400,415,12,1,71.57,5.6,0,0,0,0,0,0,0.00539344434409368,3.12565283052564,0.555002653805033
8.7,"greedy_SVM","SVM",96,28,1012,1010,2,2900,2478,422,0.938326189030825,0.631868131868132,1.76491581812683,818,401,417,3,1,74.13,5.9,0,0,0,0,0,0,0.00386739546523565,2.07179106077384,0.439414606825222
8.7,"greedy_SVM","SVM",96,29,912,910,2,3000,2578,422,0.938343223856202,0.626373626373626,1.76816014867485,816,401,415,-2,1,76.69,6.1,0,0,0,0,0,0,0.00339614918160925,1.58526077526653,0.354011782114094
8.7,"greedy_SVM","SVM",96,30,812,810,2,3100,2678,422,0.938656045194949,0.626373626373626,1.76168337157348,828,405,423,12,1,79.24,6.3,0,0,0,0,0,0,0.00275738690229765,1.10351657840287,0.298290370835057
8.7,"greedy_SVM","SVM",96,31,712,710,2,3200,2778,422,0.938742767942324,0.626373626373626,1.76491581812683,827,404,423,-1,1,81.8,6.6,0,0,0,0,0,0,0.00236915072198956,0.84827451652878,0.26414194189755
8.7,"greedy_SVM","SVM",96,32,612,611,1,3300,2877,423,0.939538758873597,0.631868131868132,1.76653649380922,831,406,425,4,1,84.36,6.8,0,0,0,0,0,0,0.00207280733146339,0.697319316818072,0.241611658122171
8.7,"greedy_SVM","SVM",96,33,512,511,1,3400,2977,423,0.939678134717593,0.631868131868132,1.76653649380922,833,408,425,2,1,86.91,7,0,0,0,0,0,0,0.00136872685489285,0.425265850778952,0.166616468952915
8.7,"greedy_SVM","SVM",96,34,412,412,0,3500,3076,424,0.940012636743187,0.626373626373626,1.76816014867485,836,409,427,3,1,89.47,7.3,0,0,0,0,0,0,0.00110766930815946,0.319345159697191,0.134500259651726
8.7,"greedy_SVM","SVM",96,35,312,312,0,3600,3176,424,0.940201568442828,0.626373626373626,1.76978679094594,836,410,426,0,1,92.02,7.5,0,0,0,0,0,0,0.000667610662511456,0.171581726165641,0.0856286555639322
8.7,"greedy_SVM","SVM",96,36,212,212,0,3700,3276,424,0.940350236009759,0.626373626373626,1.76978679094594,838,412,426,2,1,94.58,7.7,0,0,0,0,0,0,0.000424627220550247,0.0851381642981562,0.0528265967029083
8.7,"greedy_SVM","SVM",96,37,112,112,0,3800,3376,424,0.940605758390422,0.631868131868132,1.77141642887499,845,413,432,7,1,97.14,8,0,0,0,0,0,0,0.00019415656364835,0.0319283726276312,0.0298923365137707
8.7,"greedy_SVM","SVM",96,38,12,12,0,3900,3476,424,0.940550008052824,0.631868131868132,1.77141642887499,844,413,431,-1,1,99.69,8.2,0,0,0,0,0,0,9.72065067892824e-05,0.00154117325347555,0.00154117325347555
8.7,"greedy_SVM","SVM",96,39,0,0,0,3912,3488,424,0.940553105293801,0.631868131868132,1.77141642887499,845,413,432,1,1,100,8.2,0,0,0,0,0,0,0,0,0
8.7,"greedy_SVM","SVM",97,0,3812,3412,400,100,92,8,0.819646981763023,0.44949494949495,1.58424801005446,26,8,18,0,2.2,2.56,11.5,0,0,0,0,0,0,0.401973299866205,349.744387489009,52.6301469661184
8.7,"greedy_SVM","SVM",97,1,3712,3342,370,200,162,38,0.863983980878178,0.54040404040404,1.6282716669457,83,38,45,57,1.2,5.11,4.3,0,0,0,0,0,0,0.451398649524129,432.454988441789,51.9431415662878
8.7,"greedy_SVM","SVM",97,2,3612,3331,281,300,173,127,0.867491754863761,0.51010101010101,1.64494995957737,120,61,59,37,1,7.67,1.4,0,0,0,0,0,0,0.625013581927211,289.935467240131,74.1648332863953
8.7,"greedy_SVM","SVM",97,3,3512,3275,237,400,229,171,0.885369623424227,0.560606060606061,1.73583117281369,215,107,108,95,1,10.22,1.3,0,0,0,0,0,0,0.286929340136761,174.887263983838,40.7495636219618
8.7,"greedy_SVM","SVM",97,4,3412,3229,183,500,275,225,0.887073235196115,0.595959595959596,1.71765493016643,297,148,149,82,1,12.78,1.2,0,0,0,0,0,0,0.324095814758622,192.03710585732,44.7077510524905
8.7,"greedy_SVM","SVM",97,5,3312,3176,136,600,328,272,0.845066133462044,0.606060606060606,1.55693338919145,383,191,192,86,1,15.34,1.2,0,0,0,0,0,0,0.208974899538955,129.477513157863,28.1876785920761
8.7,"greedy_SVM","SVM",97,6,3212,3099,113,700,405,295,0.852782661656383,0.641414141414141,1.56603826281246,439,217,222,56,1,17.89,1.4,0,0,0,0,0,0,0.120460252910008,105.910616388378,18.1041325146993
8.7,"greedy_SVM","SVM",97,7,3112,3025,87,800,479,321,0.83641304972363,0.651515151515151,1.51140902108644,504,243,261,65,1.1,20.45,1.5,0,0,0,0,0,0,0.0826098023075288,107.576804925837,11.9007523784596
8.7,"greedy_SVM","SVM",97,8,3012,2937,75,900,567,333,0.849329472196372,0.651515151515151,1.55406874634106,529,253,276,25,1.1,23.01,1.7,0,0,0,0,0,0,0.0650364525361613,89.4092484853218,8.34859868544407
8.7,"greedy_SVM","SVM",97,9,2912,2853,59,1000,651,349,0.857469748681356,0.641414141414141,1.5617201426025,578,272,306,49,1.1,25.56,1.9,0,0,0,0,0,0,0.0565068617092548,82.9033371828202,6.77134696399437
8.7,"greedy_SVM","SVM",97,10,2812,2766,46,1100,738,362,0.865736431436088,0.646464646464647,1.57514313643346,606,290,316,28,1.1,28.12,2,0,0,0,0,0,0,0.062719204757275,91.7953525980446,6.79205805336708
8.7,"greedy_SVM","SVM",97,11,2712,2669,43,1200,835,365,0.901295376977972,0.636363636363636,1.66465762598359,640,315,325,34,1,30.67,2.3,0,0,0,0,0,0,0.0541468720170121,41.041413406461,6.83135260066211
8.7,"greedy_SVM","SVM",97,12,2612,2574,38,1300,930,370,0.901374380896566,0.646464646464647,1.65251782531194,652,321,331,12,1,33.23,2.5,0,0,0,0,0,0,0.0374858077900172,32.1847316348505,4.27284766919451
8.7,"greedy_SVM","SVM",97,13,2512,2481,31,1400,1023,377,0.91002746463497,0.646464646464647,1.69635751453933,669,330,339,17,1,35.79,2.7,0,0,0,0,0,0,0.0346825548857362,36.1354116637464,4.03631532150989
8.7,"greedy_SVM","SVM",97,14,2412,2384,28,1500,1120,380,0.912567081509058,0.641414141414141,1.71014007478096,678,333,345,9,1,38.34,2.9,0,0,0,0,0,0,0.0301840330630564,33.5639667389727,3.32775363723942
8.7,"greedy_SVM","SVM",97,15,2312,2293,19,1600,1211,389,0.919010928396576,0.646464646464647,1.75400741546096,702,343,359,24,1,40.9,3.1,0,0,0,0,0,0,0.0674055192597343,48.0008772622575,8.13055610287437
8.7,"greedy_SVM","SVM",97,16,2212,2194,18,1700,1310,390,0.920424380321977,0.651515151515151,1.76309553678459,715,351,364,13,1,43.46,3.4,0,0,0,0,0,0,0.0467059705697809,31.2017631883532,5.20481558975617
8.7,"greedy_SVM","SVM",97,17,2112,2098,14,1800,1406,394,0.920421507452209,0.646464646464647,1.76147504456328,735,357,378,20,1.1,46.01,3.6,0,0,0,0,0,0,0.0453897291991781,26.5399563132993,5.13613815696105
8.7,"greedy_SVM","SVM",97,18,2012,2004,8,1900,1500,400,0.920296537617339,0.641414141414141,1.7647190133378,745,362,383,10,1.1,48.57,3.8,0,0,0,0,0,0,0.0432963477447948,23.4515735782971,5.18936487062057
8.7,"greedy_SVM","SVM",97,19,1912,1905,7,2000,1599,401,0.919792348973218,0.636363636363636,1.75078609789354,745,364,381,0,1,51.12,4,0,0,0,0,0,0,0.0254201935776389,17.9564632881889,3.53027393906161
8.7,"greedy_SVM","SVM",97,20,1812,1807,5,2100,1697,403,0.919709035749973,0.636363636363636,1.75239527629233,751,366,385,6,1.1,53.68,4.2,0,0,0,0,0,0,0.0175893440254926,14.3233871497378,2.10952286231994
8.7,"greedy_SVM","SVM",97,21,1712,1707,5,2200,1797,403,0.919585502349988,0.636363636363636,1.75078609789354,750,366,384,-1,1,56.24,4.5,0,0,0,0,0,0,0.0134461278113435,11.6015928150777,1.50040460018058
8.7,"greedy_SVM","SVM",97,22,1612,1607,5,2300,1897,403,0.919684616356952,0.636363636363636,1.74917987211565,751,366,385,1,1.1,58.79,4.7,0,0,0,0,0,0,0.0111869046502637,9.22623139513862,1.16557105085064
8.7,"greedy_SVM","SVM",97,23,1512,1507,5,2400,1997,403,0.920398524494072,0.646464646464647,1.76309553678459,756,368,388,5,1.1,61.35,5,0,0,0,0,0,0,0.00902912971938574,7.02070713358088,0.974160951904208
8.7,"greedy_SVM","SVM",97,24,1412,1408,4,2500,2096,404,0.921541926661369,0.641414141414141,1.76309553678459,771,373,398,15,1.1,63.91,5.2,0,0,0,0,0,0,0.00722002156476352,5.2990137373817,0.807256395961516
8.7,"greedy_SVM","SVM",97,25,1312,1308,4,2600,2196,404,0.921533308052068,0.641414141414141,1.76309553678459,773,375,398,2,1.1,66.46,5.4,0,0,0,0,0,0,0.0067145057112009,4.36913870024372,0.68469436926496
8.7,"greedy_SVM","SVM",97,26,1212,1208,4,2700,2296,404,0.922231415405467,0.641414141414141,1.76147504456328,783,380,403,10,1.1,69.02,5.7,0,0,0,0,0,0,0.00580670008982976,3.45626091697997,0.620872745604978
8.7,"greedy_SVM","SVM",97,27,1112,1108,4,2800,2396,404,0.922263016972905,0.646464646464647,1.75985752845257,784,382,402,1,1.1,71.57,5.9,0,0,0,0,0,0,0.00471621775051079,2.39978439943991,0.485735198563294
8.7,"greedy_SVM","SVM",97,28,1012,1008,4,2900,2496,404,0.922234288275235,0.646464646464647,1.76147504456328,781,382,399,-3,1,74.13,6.2,0,0,0,0,0,0,0.00426030072018657,1.91742598985006,0.449560190645193
8.7,"greedy_SVM","SVM",97,29,912,908,4,3000,2596,404,0.922432516289162,0.646464646464647,1.75985752845257,787,383,404,6,1.1,76.69,6.4,0,0,0,0,0,0,0.003377283086195,1.28944411697394,0.358491942063139
8.7,"greedy_SVM","SVM",97,30,812,808,4,3100,2696,404,0.922525884556592,0.646464646464647,1.76147504456328,788,383,405,1,1.1,79.24,6.7,0,0,0,0,0,0,0.00287097827626796,0.967493282012377,0.316323029662938
8.7,"greedy_SVM","SVM",97,31,712,710,2,3200,2794,406,0.923267084956494,0.646464646464647,1.75502275502276,794,386,408,6,1.1,81.8,6.9,0,0,0,0,0,0,0.00267767211433368,0.91727829325556,0.320361581197455
8.7,"greedy_SVM","SVM",97,32,612,610,2,3300,2894,406,0.923271394261144,0.646464646464647,1.75021447350214,798,386,412,4,1.1,84.36,7.1,0,0,0,0,0,0,0.00165276480085516,0.511117038574058,0.199328569364734
8.7,"greedy_SVM","SVM",97,33,512,510,2,3400,2994,406,0.923381999747176,0.646464646464647,1.75502275502276,799,387,412,1,1.1,86.91,7.4,0,0,0,0,0,0,0.00103692483918268,0.322012255591573,0.134668526625774
8.7,"greedy_SVM","SVM",97,34,412,412,0,3500,3092,408,0.923857459693626,0.646464646464647,1.77381550309727,806,391,415,7,1.1,89.47,7.6,0,0,0,0,0,0,0.000953636274248177,0.276028501722595,0.116897706563901
8.7,"greedy_SVM","SVM",97,35,312,312,0,3600,3192,408,0.924331483205193,0.646464646464647,1.76730608840701,806,392,414,0,1.1,92.02,7.8,0,0,0,0,0,0,0.000650684801406123,0.161061582439081,0.0805962401651073
8.7,"greedy_SVM","SVM",97,36,212,212,0,3700,3292,408,0.924794015237692,0.641414141414141,1.7689289590116,807,394,413,1,1,94.58,8.1,0,0,0,0,0,0,0.000356976467571896,0.0732753710468754,0.0461391244666104
8.7,"greedy_SVM","SVM",97,37,112,112,0,3800,3392,408,0.925611346686425,0.641414141414141,1.77055481283422,807,395,412,0,1,97.14,8.3,0,0,0,0,0,0,0.000173690335081545,0.0284250092513411,0.0265896610810395
8.7,"greedy_SVM","SVM",97,38,12,12,0,3900,3492,408,0.926167246986354,0.636363636363636,1.7689289590116,816,398,418,9,1.1,99.69,8.6,0,0,0,0,0,0,0.00012859705353231,0.00182498681172062,0.00182498681172062
8.7,"greedy_SVM","SVM",97,39,0,0,0,3912,3504,408,0.926241941600298,0.636363636363636,1.7689289590116,816,398,418,0,1.1,100,8.6,0,0,0,0,0,0,0,0,0
8.7,"greedy_SVM","SVM",98,0,3812,3394,418,100,90,10,0.911916558183037,0.539325842696629,1.76063070333354,25,10,15,0,1.5,2.56,9,0,0,0,0,0,0,0.663450197251427,384.11375887368,72.2488268248342
8.7,"greedy_SVM","SVM",98,1,3712,3371,341,200,113,87,0.912482147596704,0.561797752808989,1.75739424983477,81,42,39,56,0.9,5.11,1.3,0,0,0,0,0,0,0.712669343957724,268.31604063824,79.964866863749
8.7,"greedy_SVM","SVM",98,2,3612,3342,270,300,142,158,0.913512215467451,0.550561797752809,1.72550840375151,136,71,65,55,0.9,7.67,0.9,0,0,0,0,0,0,0.518906176125212,180.332435016934,63.510362928416
8.7,"greedy_SVM","SVM",98,3,3512,3300,212,400,184,216,0.913180445140986,0.567415730337079,1.7622534044426,217,112,105,81,0.9,10.22,0.9,0,0,0,0,0,0,0.325174720237739,109.670059024102,44.6823850479355
8.7,"greedy_SVM","SVM",98,4,3412,3239,173,500,245,255,0.890348327245603,0.589887640449438,1.70846469512006,316,158,158,99,1,12.78,1,0,0,0,0,0,0,0.141295436063387,62.5088496081749,24.5149928668844
8.7,"greedy_SVM","SVM",98,5,3312,3171,141,600,313,287,0.885077918630952,0.595505617977528,1.6695635979887,383,192,191,67,1,15.34,1.1,0,0,0,0,0,0,0.139502292618924,80.3564449608407,22.1740903283473
8.7,"greedy_SVM","SVM",98,6,3212,3093,119,700,391,309,0.897734166656134,0.617977528089888,1.65944503072816,435,212,223,52,1.1,17.89,1.3,0,0,0,0,0,0,0.0803492974139031,50.8745719408905,12.413323265302
8.7,"greedy_SVM","SVM",98,7,3112,3019,93,800,465,335,0.891054524083372,0.634831460674157,1.65639458030403,496,240,256,61,1.1,20.45,1.4,0,0,0,0,0,0,0.077128231487944,77.6455997732346,11.4815524196805
8.7,"greedy_SVM","SVM",98,8,3012,2932,80,900,552,348,0.895776721729998,0.646067415730337,1.67110236628178,529,255,274,33,1.1,23.01,1.6,0,0,0,0,0,0,0.0623716867756513,76.2744600337003,8.00493353997754
8.7,"greedy_SVM","SVM",98,9,2912,2846,66,1000,638,362,0.902895565020659,0.640449438202247,1.68123025941076,562,269,293,33,1.1,25.56,1.8,0,0,0,0,0,0,0.0614581358162309,89.8594295156018,8.85855220251144
8.7,"greedy_SVM","SVM",98,10,2812,2754,58,1100,730,370,0.913188344434471,0.634831460674157,1.7068944150694,581,279,302,19,1.1,28.12,2,0,0,0,0,0,0,0.051984713077649,73.621304321114,5.83129663922275
8.7,"greedy_SVM","SVM",98,11,2712,2659,53,1200,825,375,0.91784102829843,0.640449438202247,1.70532701891231,597,285,312,16,1.1,30.67,2.2,0,0,0,0,0,0,0.041606536547932,59.6457192093701,4.48281654728192
8.7,"greedy_SVM","SVM",98,12,2612,2563,49,1300,921,379,0.922315188129562,0.623595505617977,1.71384393361509,625,300,325,28,1.1,33.23,2.4,0,0,0,0,0,0,0.0351440677944677,48.8495447350045,3.87065575422495
8.7,"greedy_SVM","SVM",98,13,2512,2468,44,1400,1016,384,0.927234868113388,0.617977528089888,1.71857395367107,644,313,331,19,1.1,35.79,2.6,0,0,0,0,0,0,0.033441075588731,38.3202926801196,3.87692798972955
8.7,"greedy_SVM","SVM",98,14,2412,2374,38,1500,1110,390,0.932980814195976,0.612359550561798,1.74039356881246,662,321,341,18,1.1,38.34,2.8,0,0,0,0,0,0,0.0489362632773482,48.7875237892758,5.59390226843724
8.7,"greedy_SVM","SVM",98,15,2312,2281,31,1600,1203,397,0.936041000492906,0.612359550561798,1.75901098787509,684,333,351,22,1.1,40.9,3,0,0,0,0,0,0,0.0555148466967451,40.3488998846695,6.14816324538468
8.7,"greedy_SVM","SVM",98,16,2212,2184,28,1700,1300,400,0.93590197292753,0.612359550561798,1.76063070333354,702,338,364,18,1.1,43.46,3.2,0,0,0,0,0,0,0.0478457847762971,33.7471364206745,5.49133854724914
8.7,"greedy_SVM","SVM",98,17,2112,2090,22,1800,1394,406,0.934894023078564,0.617977528089888,1.75901098787509,715,344,371,13,1.1,46.01,3.4,0,0,0,0,0,0,0.0410896099710793,29.260119430399,4.9902722896126
8.7,"greedy_SVM","SVM",98,18,2012,1998,14,1900,1486,414,0.934211524121274,0.617977528089888,1.7622534044426,733,352,381,18,1.1,48.57,3.6,0,0,0,0,0,0,0.0340167324098606,27.014046152814,4.5973494139497
8.7,"greedy_SVM","SVM",98,19,1912,1901,11,2000,1583,417,0.934325273947491,0.612359550561798,1.7622534044426,740,355,385,7,1.1,51.12,3.8,0,0,0,0,0,0,0.0258326271804346,22.1858247176428,2.89512808519004
8.7,"greedy_SVM","SVM",98,20,1812,1802,10,2100,1682,418,0.93439794744757,0.612359550561798,1.75739424983477,744,359,385,4,1.1,53.68,4,0,0,0,0,0,0,0.0216617029388059,19.9501264519733,2.38393023444106
8.7,"greedy_SVM","SVM",98,21,1712,1702,10,2200,1782,418,0.934160968642953,0.612359550561798,1.75901098787509,750,361,389,6,1.1,56.24,4.3,0,0,0,0,0,0,0.0170813180001459,14.2391304843889,1.73667315386949
8.7,"greedy_SVM","SVM",98,22,1612,1603,9,2300,1881,419,0.931555781650878,0.606741573033708,1.75780046422776,775,378,397,25,1.1,58.79,4.5,0,0,0,0,0,0,0.0138890750091542,8.92766709915743,1.86918781559113
8.7,"greedy_SVM","SVM",98,23,1512,1504,8,2400,1980,420,0.931754843846755,0.606741573033708,1.76749421678784,774,375,399,-1,1.1,61.35,4.7,0,0,0,0,0,0,0.00893181244786772,6.40043002274612,1.05838749792865
8.7,"greedy_SVM","SVM",98,24,1412,1406,6,2500,2078,422,0.932236700749473,0.606741573033708,1.76263401270868,779,377,402,5,1.1,63.91,4.9,0,0,0,0,0,0,0.00773006581345757,5.52278087230812,0.822359273999835
8.7,"greedy_SVM","SVM",98,25,1312,1306,6,2600,2178,422,0.93194284703175,0.606741573033708,1.76425110813318,788,385,403,9,1,66.46,5.2,0,0,0,0,0,0,0.00618037823433476,4.06800237664067,0.664119829566947
8.7,"greedy_SVM","SVM",98,26,1212,1207,5,2700,2277,423,0.9322825166517,0.606741573033708,1.76749421678784,792,388,404,4,1,69.02,5.4,0,0,0,0,0,0,0.00610196326583624,3.56839236286419,0.626008685939623
8.7,"greedy_SVM","SVM",98,27,1112,1108,4,2800,2376,424,0.933004512076431,0.601123595505618,1.76425110813318,801,393,408,9,1,71.57,5.6,0,0,0,0,0,0,0.00497175915223154,2.66364955760758,0.535461217761816
8.7,"greedy_SVM","SVM",98,28,1012,1009,3,2900,2475,425,0.933023470380801,0.606741573033708,1.76749421678784,802,394,408,1,1,74.13,5.8,0,0,0,0,0,0,0.00487689884517502,2.30912671432795,0.50780295480546
8.7,"greedy_SVM","SVM",98,29,912,909,3,3000,2575,425,0.933064546706934,0.601123595505618,1.7691202464261,806,397,409,4,1,76.69,6.1,0,0,0,0,0,0,0.00410009255316014,1.68800425477086,0.440847836822664
8.7,"greedy_SVM","SVM",98,30,812,810,2,3100,2674,426,0.933168817380964,0.601123595505618,1.76425110813318,812,399,413,6,1,79.24,6.3,0,0,0,0,0,0,0.00349247838562488,1.31564686980005,0.383710863478328
8.7,"greedy_SVM","SVM",98,31,712,711,1,3200,2773,427,0.933397896892092,0.601123595505618,1.77074927059408,814,402,412,2,1,81.8,6.5,0,0,0,0,0,0,0.00316780634112659,1.11084205414457,0.355335151445396
8.7,"greedy_SVM","SVM",98,32,612,611,1,3300,2873,427,0.933612757674943,0.601123595505618,1.76749421678784,812,400,412,-2,1,84.36,6.7,0,0,0,0,0,0,0.00210189723686178,0.656555881651038,0.24680515775127
8.7,"greedy_SVM","SVM",98,33,512,511,1,3400,2973,427,0.933773903262081,0.595505617977528,1.77074927059408,811,400,411,-1,1,86.91,7,0,0,0,0,0,0,0.0014769240104395,0.457754144618486,0.186653920898794
8.7,"greedy_SVM","SVM",98,34,412,412,0,3500,3072,428,0.934390048154079,0.595505617977528,1.76749421678784,820,404,416,9,1,89.47,7.2,0,0,0,0,0,0,0.000996333628427886,0.288797375494853,0.126091520435286
8.7,"greedy_SVM","SVM",98,35,312,312,0,3600,3172,428,0.935045689513513,0.595505617977528,1.7691202464261,824,405,419,4,1,92.02,7.4,0,0,0,0,0,0,0.000593477237114734,0.155320286219581,0.0783043468904538
8.7,"greedy_SVM","SVM",98,36,212,212,0,3700,3272,428,0.935440654187868,0.589887640449438,1.7691202464261,829,408,421,5,1,94.58,7.6,0,0,0,0,0,0,0.000362303311409689,0.0767618840932999,0.0476861754468767
8.7,"greedy_SVM","SVM",98,37,112,112,0,3800,3372,428,0.935627077514165,0.595505617977528,1.7691202464261,830,410,420,1,1,97.14,7.9,0,0,0,0,0,0,0.000166596675163813,0.0266895961456041,0.0249876626555283
8.7,"greedy_SVM","SVM",98,38,12,12,0,3900,3472,428,0.935712389883827,0.595505617977528,1.76587117342991,831,411,420,1,1,99.69,8.1,0,0,0,0,0,0,0.000133869348301022,0.00183832302928191,0.00183832302928191
8.7,"greedy_SVM","SVM",98,39,0,0,0,3912,3484,428,0.935608119209796,0.595505617977528,1.76587117342991,833,412,421,2,1,100,8.1,0,0,0,0,0,0,0,0,0
8.7,"greedy_SVM","SVM",99,0,3812,3399,413,100,88,12,0.916414286825929,0.513812154696133,1.79449541284404,28,12,16,0,1.3,2.56,7.3,0,0,0,0,0,0,0.859865226713408,592.376844457125,89.1951503714325
8.7,"greedy_SVM","SVM",99,1,3712,3385,327,200,102,98,0.912662049645942,0.50828729281768,1.79779411764706,62,32,30,34,0.9,5.11,1,0,0,0,0,0,0,0.757452197157585,376.651015487154,81.3674878914385
8.7,"greedy_SVM","SVM",99,2,3612,3351,261,300,136,164,0.915832230954801,0.530386740331492,1.76962291674079,126,66,60,64,0.9,7.67,0.8,0,0,0,0,0,0,0.595682773938197,232.498607857596,68.0645738273264
8.7,"greedy_SVM","SVM",99,3,3512,3310,202,400,177,223,0.916868726169179,0.546961325966851,1.77125240377278,214,113,101,88,0.9,10.22,0.8,0,0,0,0,0,0,0.363616545174377,154.04670621965,50.2545613097548
8.7,"greedy_SVM","SVM",99,4,3412,3240,172,500,247,253,0.897816512333676,0.546961325966851,1.708401039974,302,151,151,88,1,12.78,1,0,0,0,0,0,0,0.22833484508722,113.449100065505,32.5112161136991
8.7,"greedy_SVM","SVM",99,5,3312,3180,132,600,307,293,0.895121002256638,0.574585635359116,1.67328461949742,387,192,195,85,1,15.34,1,0,0,0,0,0,0,0.149166661403829,97.8635837172344,26.3145758710316
8.7,"greedy_SVM","SVM",99,6,3212,3104,108,700,383,317,0.907907555832238,0.596685082872928,1.68324464699442,447,216,231,60,1.1,17.89,1.2,0,0,0,0,0,0,0.0924382130719143,74.2080521956778,12.2600243955292
8.7,"greedy_SVM","SVM",99,7,3112,3024,88,800,463,337,0.897169091899468,0.607734806629834,1.6533645645034,485,236,249,38,1.1,20.45,1.4,0,0,0,0,0,0,0.0669798271251981,75.2374103753097,9.92678043156409
8.7,"greedy_SVM","SVM",99,8,3012,2942,70,900,545,355,0.896110808497402,0.613259668508287,1.65184212936113,536,259,277,51,1.1,23.01,1.5,0,0,0,0,0,0,0.0642755073249523,83.2415266682257,8.77259451488232
8.7,"greedy_SVM","SVM",99,9,2912,2861,51,1000,626,374,0.887411096412742,0.61878453038674,1.64880565485863,581,282,299,45,1.1,25.56,1.7,0,0,0,0,0,0,0.0623469077172999,89.8651324373897,7.75952994375181
8.7,"greedy_SVM","SVM",99,10,2812,2762,50,1100,725,375,0.891233367053155,0.61878453038674,1.65032249538748,597,285,312,16,1.1,28.12,1.9,0,0,0,0,0,0,0.0431590693225793,57.2022730586889,4.8769613392429
8.7,"greedy_SVM","SVM",99,11,2712,2666,46,1200,821,379,0.89382927398646,0.61878453038674,1.6533645645034,605,291,314,8,1.1,30.67,2.2,0,0,0,0,0,0,0.0448783192420658,61.3611436655383,4.74474765789051
8.7,"greedy_SVM","SVM",99,12,2612,2568,44,1300,919,381,0.915469613259673,0.591160220994475,1.69846847578811,633,308,325,28,1.1,33.23,2.4,0,0,0,0,0,0,0.0398858781596571,32.9337219274365,5.2055248128053
8.7,"greedy_SVM","SVM",99,13,2512,2477,35,1400,1010,390,0.922807563613735,0.596685082872928,1.73979781140246,656,319,337,23,1.1,35.79,2.6,0,0,0,0,0,0,0.0325183105321998,33.5905432062682,3.87869723497922
8.7,"greedy_SVM","SVM",99,14,2412,2383,29,1500,1104,396,0.92803672865926,0.596685082872928,1.7728848944675,669,325,344,13,1.1,38.34,2.8,0,0,0,0,0,0,0.0422932002638518,38.3437823331105,5.2308608465692
8.7,"greedy_SVM","SVM",99,15,2312,2288,24,1600,1199,401,0.92742665940395,0.596685082872928,1.76637292056679,692,336,356,23,1.1,40.9,3,0,0,0,0,0,0,0.0482613779219415,34.8725626684537,5.53016035749559
8.7,"greedy_SVM","SVM",99,16,2212,2189,23,1700,1298,402,0.92733950665319,0.591160220994475,1.76313484005246,698,340,358,6,1.1,43.46,3.2,0,0,0,0,0,0,0.0388966694137498,27.3461244601102,4.34668745940778
8.7,"greedy_SVM","SVM",99,17,2112,2092,20,1800,1395,405,0.926713874406674,0.591160220994475,1.76799642508937,703,342,361,5,1.1,46.01,3.4,0,0,0,0,0,0,0.0322090205384117,21.1035679358507,3.72743842693967
8.7,"greedy_SVM","SVM",99,18,2012,1995,17,1900,1492,408,0.926383938993088,0.602209944751381,1.76799642508937,712,347,365,9,1.1,48.57,3.7,0,0,0,0,0,0,0.0248291607978943,16.7770350232858,3.14505936751242
8.7,"greedy_SVM","SVM",99,19,1912,1903,9,2000,1584,416,0.925468835110123,0.596685082872928,1.7728848944675,738,360,378,26,1.1,51.12,3.8,0,0,0,0,0,0,0.0207098605379115,16.3710454665659,3.06813895351639
8.7,"greedy_SVM","SVM",99,20,1812,1806,6,2100,1681,419,0.925260291027949,0.596685082872928,1.76292486697049,744,361,383,6,1.1,53.68,4,0,0,0,0,0,0,0.0159871291184842,13.6291817904515,1.83497137447314
8.7,"greedy_SVM","SVM",99,21,1712,1707,5,2200,1780,420,0.925571550852089,0.596685082872928,1.7728848944675,749,364,385,5,1.1,56.24,4.2,0,0,0,0,0,0,0.0128454765897972,11.2249783801915,1.40856405417782
8.7,"greedy_SVM","SVM",99,22,1612,1607,5,2300,1880,420,0.925714730371191,0.596685082872928,1.7728848944675,748,364,384,-1,1.1,58.79,4.5,0,0,0,0,0,0,0.0104075196551981,9.10483391251195,1.11856611195511
8.7,"greedy_SVM","SVM",99,23,1512,1507,5,2400,1980,420,0.925739631157122,0.596685082872928,1.7728848944675,749,365,384,1,1.1,61.35,4.7,0,0,0,0,0,0,0.00932627385618721,7.94133488397843,0.977633571783054
8.7,"greedy_SVM","SVM",99,24,1412,1407,5,2500,2080,420,0.925602676834499,0.596685082872928,1.76962291674079,758,370,388,9,1,63.91,5,0,0,0,0,0,0,0.007803066609306,6.11126610567121,0.82712566095767
8.7,"greedy_SVM","SVM",99,25,1312,1307,5,2600,2180,420,0.925490623297809,0.585635359116022,1.7728848944675,757,369,388,-1,1.1,66.46,5.2,0,0,0,0,0,0,0.00665905075967201,4.69900958859564,0.691220259798013
8.7,"greedy_SVM","SVM",99,26,1212,1208,4,2700,2279,421,0.926561357092841,0.591160220994475,1.7728848944675,774,378,396,17,1,69.02,5.4,0,0,0,0,0,0,0.00639953810728662,4.03745024957403,0.661892268919546
8.7,"greedy_SVM","SVM",99,27,1112,1108,4,2800,2379,421,0.926850828729288,0.580110497237569,1.76962291674079,783,382,401,9,1,71.57,5.7,0,0,0,0,0,0,0.0045633262892681,2.52338675117144,0.489604750040111
8.7,"greedy_SVM","SVM",99,28,1012,1008,4,2900,2479,421,0.926813477550391,0.580110497237569,1.7728848944675,783,383,400,0,1,74.13,5.9,0,0,0,0,0,0,0.00420190988753223,1.95517368701782,0.429055263552438
8.7,"greedy_SVM","SVM",99,29,912,908,4,3000,2579,421,0.926990895650149,0.574585635359116,1.76962291674079,784,383,401,1,1,76.69,6.1,0,0,0,0,0,0,0.00324566887475203,1.31045476372475,0.352561706376762
8.7,"greedy_SVM","SVM",99,30,812,809,3,3100,2678,422,0.927362851139995,0.574585635359116,1.77125240377278,791,386,405,7,1,79.24,6.3,0,0,0,0,0,0,0.0030260889167664,1.03739823642474,0.326735944822199
8.7,"greedy_SVM","SVM",99,31,712,709,3,3200,2778,422,0.927118512178045,0.580110497237569,1.7728848944675,793,388,405,2,1,81.8,6.6,0,0,0,0,0,0,0.00210303927195824,0.631865711914497,0.245931685279642
8.7,"greedy_SVM","SVM",99,32,612,609,3,3300,2878,422,0.927401758618011,0.574585635359116,1.77125240377278,792,388,404,-1,1,84.36,6.8,0,0,0,0,0,0,0.00129379453193927,0.418407413973105,0.174343140531935
8.7,"greedy_SVM","SVM",99,33,512,509,3,3400,2978,422,0.927722356236872,0.580110497237569,1.77125240377278,792,388,404,0,1,86.91,7.1,0,0,0,0,0,0,0.000745604956219782,0.225706128513919,0.0984776158022519
8.7,"greedy_SVM","SVM",99,34,412,411,1,3500,3076,424,0.92947474904677,0.574585635359116,1.77956461852023,805,395,410,13,1,89.47,7.3,0,0,0,0,0,0,0.000801742736014132,0.243761887306184,0.101074921738643
8.7,"greedy_SVM","SVM",99,35,312,312,0,3600,3175,425,0.930240448214149,0.574585635359116,1.77956461852023,809,397,412,4,1,92.02,7.5,0,0,0,0,0,0,0.000742672991010154,0.191851661852642,0.0893363129097931
8.7,"greedy_SVM","SVM",99,36,212,212,0,3700,3275,425,0.930450548595442,0.574585635359116,1.77792898927527,811,397,414,2,1,94.58,7.7,0,0,0,0,0,0,0.000402064402794216,0.081493461385,0.0495808577321
8.7,"greedy_SVM","SVM",99,37,112,112,0,3800,3375,425,0.930645085985527,0.574585635359116,1.78284492196451,820,401,419,9,1,97.14,7.9,0,0,0,0,0,0,0.000205681752479162,0.0318064725894803,0.029642538747358
8.7,"greedy_SVM","SVM",99,38,12,12,0,3900,3475,425,0.930783596607268,0.574585635359116,1.77792898927527,820,403,417,0,1,99.69,8.2,0,0,0,0,0,0,0.000130490281681044,0.00180818338368247,0.00180818338368247
8.7,"greedy_SVM","SVM",99,39,0,0,0,3912,3487,425,0.930903431639561,0.574585635359116,1.77956461852023,820,403,417,0,1,100,8.2,0,0,0,0,0,0,0,0,0
8.7,"greedy_SVM","SVM",100,0,3812,3428,384,100,91,9,0.827678251571006,0.300469483568075,1.65888232621536,33,9,24,0,2.7,2.56,10.1,0,0,0,0,0,0,0.178122064453556,321.136991135032,27.9968177392736
8.7,"greedy_SVM","SVM",100,1,3712,3350,362,200,169,31,0.910049318669719,0.563380281690141,1.75398026358334,69,31,38,36,1.2,5.11,5.5,0,0,0,0,0,0,0.615598385270227,330.724784287844,72.4127719828711
8.7,"greedy_SVM","SVM",100,2,3612,3307,305,300,212,88,0.916489566582898,0.63849765258216,1.70338467905689,160,79,81,91,1,7.67,2.4,0,0,0,0,0,0,0.641501351845399,320.205238706857,70.7942658526978
8.7,"greedy_SVM","SVM",100,3,3512,3280,232,400,239,161,0.91258528412778,0.643192488262911,1.6849722186329,216,110,106,56,1,10.22,1.5,0,0,0,0,0,0,0.517310988336226,236.680846561867,63.1345395253249
8.7,"greedy_SVM","SVM",100,4,3412,3237,175,500,282,218,0.919377038671135,0.694835680751174,1.7318631198414,302,152,150,86,1,12.78,1.3,0,0,0,0,0,0,0.370643922986361,197.112538380587,48.8428881477016
8.7,"greedy_SVM","SVM",100,5,3312,3183,129,600,336,264,0.915284208598324,0.676056338028169,1.69117837781755,398,198,200,96,1,15.34,1.3,0,0,0,0,0,0,0.281335744772546,148.328281373316,37.1247939519977
8.7,"greedy_SVM","SVM",100,6,3212,3114,98,700,405,295,0.891445055877434,0.694835680751174,1.63893387926455,485,240,245,87,1,17.89,1.4,0,0,0,0,0,0,0.131183330366107,101.107657829594,19.0980837119935
8.7,"greedy_SVM","SVM",100,7,3112,3031,81,800,488,312,0.891919118459091,0.708920187793427,1.64195495553969,535,258,277,50,1.1,20.45,1.6,0,0,0,0,0,0,0.0753259410821739,67.8375308127505,9.57930162356726
8.7,"greedy_SVM","SVM",100,8,3012,2943,69,900,576,324,0.895566168092897,0.704225352112676,1.66122169195153,558,270,288,23,1.1,23.01,1.8,0,0,0,0,0,0,0.0595428091910083,66.745761506384,6.87460513328529
8.7,"greedy_SVM","SVM",100,9,2912,2856,56,1000,663,337,0.904177407147027,0.704225352112676,1.66659351157357,593,287,306,35,1.1,25.56,2,0,0,0,0,0,0,0.0528043260044513,74.542889211042,6.03732255713013
8.7,"greedy_SVM","SVM",100,10,2812,2760,52,1100,759,341,0.909303208811094,0.708920187793427,1.6727263303834,605,292,313,12,1.1,28.12,2.2,0,0,0,0,0,0,0.0437598448724029,63.375293845129,4.65673747387082
8.7,"greedy_SVM","SVM",100,11,2712,2664,48,1200,855,345,0.919257176257014,0.694835680751174,1.66506732703916,632,309,323,27,1,30.67,2.5,0,0,0,0,0,0,0.0372186675205948,43.0189009554246,4.57469429614453
8.7,"greedy_SVM","SVM",100,12,2612,2573,39,1300,946,354,0.926362727906929,0.694835680751174,1.70495028997514,654,318,336,22,1.1,33.23,2.7,0,0,0,0,0,0,0.0515369033307848,55.9592440187922,6.17333187355413
8.7,"greedy_SVM","SVM",100,13,2512,2483,29,1400,1036,364,0.931862931269005,0.694835680751174,1.75559237779619,689,332,357,35,1.1,35.79,2.8,0,0,0,0,0,0,0.0696687335517553,58.4290721351301,8.24150406394061
8.7,"greedy_SVM","SVM",100,14,2412,2385,27,1500,1134,366,0.932284469871434,0.685446009389671,1.75398026358334,698,338,360,9,1.1,38.34,3.1,0,0,0,0,0,0,0.0580605168083178,45.2538864940209,6.21098777441933
8.7,"greedy_SVM","SVM",100,15,2312,2289,23,1600,1230,370,0.933025192655263,0.685446009389671,1.75398026358334,710,345,365,12,1.1,40.9,3.3,0,0,0,0,0,0,0.0424663320881747,31.2500439566037,4.83756386153361
8.7,"greedy_SVM","SVM",100,16,2212,2194,18,1700,1325,375,0.933833253873979,0.685446009389671,1.75398026358334,724,350,374,14,1.1,43.46,3.5,0,0,0,0,0,0,0.0404033415179291,28.1566693822678,4.72847054862018
8.7,"greedy_SVM","SVM",100,17,2112,2102,10,1800,1417,383,0.933450771563784,0.694835680751174,1.75398026358334,746,361,385,22,1.1,46.01,3.7,0,0,0,0,0,0,0.0336663880573869,26.1531664772173,4.63044901619103
8.7,"greedy_SVM","SVM",100,18,2012,2004,8,1900,1515,385,0.933621811188412,0.694835680751174,1.75559237779619,748,364,384,2,1.1,48.57,3.9,0,0,0,0,0,0,0.0241980384867645,22.0399681933895,2.95580515519921
8.7,"greedy_SVM","SVM",100,19,1912,1904,8,2000,1615,385,0.933620464419714,0.694835680751174,1.75882551293025,748,363,385,0,1.1,51.12,4.2,0,0,0,0,0,0,0.0201531610853512,18.1015040275636,2.0953724259449
8.7,"greedy_SVM","SVM",100,20,1812,1804,8,2100,1715,385,0.933396900815867,0.694835680751174,1.75882551293025,766,368,398,18,1.1,53.68,4.5,0,0,0,0,0,0,0.0131708560690235,10.725982973219,1.64137579942665
8.7,"greedy_SVM","SVM",100,21,1712,1706,6,2200,1813,387,0.933477706937741,0.694835680751174,1.76044655026936,771,371,400,5,1.1,56.24,4.7,0,0,0,0,0,0,0.0121885904964756,9.62761203256241,1.26161218621577
8.7,"greedy_SVM","SVM",100,22,1612,1607,5,2300,1912,388,0.934213042646778,0.694835680751174,1.75720745818055,776,377,399,5,1.1,58.79,4.9,0,0,0,0,0,0,0.00779749432779343,5.84234598189476,0.942824003672377
8.7,"greedy_SVM","SVM",100,23,1512,1508,4,2400,2011,389,0.934167252511053,0.694835680751174,1.76044655026936,779,378,401,3,1.1,61.35,5.2,0,0,0,0,0,0,0.0081037082626086,5.87609650431777,0.854728236226132
8.7,"greedy_SVM","SVM",100,24,1412,1408,4,2500,2111,389,0.934495864073333,0.694835680751174,1.75882551293025,782,381,401,3,1.1,63.91,5.4,0,0,0,0,0,0,0.00623043102129104,4.30683206876129,0.690031329216776
8.7,"greedy_SVM","SVM",100,25,1312,1309,3,2600,2210,390,0.934505291454217,0.694835680751174,1.75882551293025,785,382,403,3,1.1,66.46,5.7,0,0,0,0,0,0,0.00529597555562932,3.3040346074509,0.556513882017882
8.7,"greedy_SVM","SVM",100,26,1212,1209,3,2700,2310,390,0.934829862710405,0.694835680751174,1.75882551293025,786,384,402,1,1,69.02,5.9,0,0,0,0,0,0,0.00498780900903726,2.89788494202256,0.533650592047101
8.7,"greedy_SVM","SVM",100,27,1112,1110,2,2800,2409,391,0.935061506926435,0.699530516431925,1.75720745818055,789,385,404,3,1,71.57,6.2,0,0,0,0,0,0,0.004284684868846,2.23703851050529,0.451708804830673
8.7,"greedy_SVM","SVM",100,28,1012,1010,2,2900,2509,391,0.935166554884869,0.694835680751174,1.75720745818055,791,387,404,2,1,74.13,6.4,0,0,0,0,0,0,0.00330698454296549,1.51473412532435,0.35557378228371
8.7,"greedy_SVM","SVM",100,29,912,910,2,3000,2609,391,0.935220425632783,0.694835680751174,1.75720745818055,792,387,405,1,1,76.69,6.7,0,0,0,0,0,0,0.00279353574943772,1.13903747310029,0.305218000749526
8.7,"greedy_SVM","SVM",100,30,812,810,2,3100,2709,391,0.935271602843302,0.694835680751174,1.75882551293025,791,387,404,-1,1,79.24,6.9,0,0,0,0,0,0,0.00220738655782319,0.799422801445521,0.247181122983871
8.7,"greedy_SVM","SVM",100,31,712,711,1,3200,2808,392,0.935589440255994,0.694835680751174,1.75076490104698,793,388,405,2,1,81.8,7.2,0,0,0,0,0,0,0.00168217206391275,0.559421903864212,0.192829580287189
8.7,"greedy_SVM","SVM",100,32,612,611,1,3300,2908,392,0.935764520186715,0.694835680751174,1.75398026358334,797,389,408,4,1,84.36,7.4,0,0,0,0,0,0,0.00126192912416213,0.399467639795758,0.155210869027108
8.7,"greedy_SVM","SVM",100,33,512,511,1,3400,3008,392,0.935901890593897,0.694835680751174,1.75559237779619,800,390,410,3,1.1,86.91,7.7,0,0,0,0,0,0,0.000691647368968681,0.210221990755671,0.0892191564797022
8.7,"greedy_SVM","SVM",100,34,412,412,0,3500,3107,393,0.936283026135389,0.694835680751174,1.75559237779619,800,391,409,0,1,89.47,7.9,0,0,0,0,0,0,0.000447699981887911,0.124998480327772,0.0568143106469961
8.7,"greedy_SVM","SVM",100,35,312,312,0,3600,3207,393,0.93644733191653,0.685446009389671,1.75559237779619,804,392,412,4,1.1,92.02,8.2,0,0,0,0,0,0,0.00041168472779332,0.100447165994086,0.051869553063417
8.7,"greedy_SVM","SVM",100,36,212,212,0,3700,3307,393,0.936703217969126,0.68075117370892,1.75559237779619,806,393,413,2,1.1,94.58,8.4,0,0,0,0,0,0,9.37126533815085e-05,0.0197213239115512,0.0130378641480862
8.7,"greedy_SVM","SVM",100,37,112,112,0,3800,3407,393,0.937019708613124,0.671361502347418,1.76044655026936,807,393,414,1,1.1,97.14,8.7,0,0,0,0,0,0,3.97253112993012e-05,0.00810480332145825,0.00766918143002258
8.7,"greedy_SVM","SVM",100,38,12,12,0,3900,3507,393,0.937138224258535,0.666666666666667,1.75882551293025,806,393,413,-1,1.1,99.69,8.9,0,0,0,0,0,0,1.7760914189801e-05,0.000272282073658208,0.000272282073658208
8.7,"greedy_SVM","SVM",100,39,0,0,0,3912,3519,393,0.937111288884578,0.666666666666667,1.75237110737821,805,393,412,-1,1,100,9,0,0,0,0,0,0,0,0,0
8.7,"eps_greedy_SVM","SVM",1,0,3812,3438,374,100,92,8,0.891300313427912,0.540178571428571,1.76398863933142,23,8,15,0,1.9,2.56,11.5,0,0,0,0,0,0,0.649057055194634,442.015649889589,76.7469440673465
8.7,"eps_greedy_SVM","SVM",1,1,3712,3377,335,200,153,47,0.889720286209174,0.553571428571429,1.70967847340217,105,47,58,82,1.2,5.11,3.3,0,0,0,0,0,0,0.703392717052738,658.791022485348,79.0450436310082
8.7,"eps_greedy_SVM","SVM",1,2,3612,3320,292,300,210,90,0.922583821346091,0.616071428571429,1.76245085190039,184,90,94,79,1,7.67,2.3,0,0,0,0,0,0,0.591658816101588,403.651842100701,66.0661871037356
8.7,"eps_greedy_SVM","SVM",1,3,3512,3277,235,400,253,147,0.915472410095685,0.651785714285714,1.75443971166448,259,127,132,75,1,10.22,1.7,0,0,0,0,0,0,0.514590058546174,271.174923566429,65.9791907615807
8.7,"eps_greedy_SVM","SVM",1,4,3412,3247,165,500,283,217,0.89422323490598,0.638392857142857,1.69657655880032,317,156,161,58,1,12.78,1.3,0,0,0,0,0,0,0.408640560422546,289.054651322795,54.1785196040806
8.7,"eps_greedy_SVM","SVM",1,5,3312,3194,118,600,336,264,0.889814366133291,0.642857142857143,1.66938025210084,402,199,203,85,1,15.34,1.3,0,0,0,0,0,0,0.216074585955937,214.044478161045,28.7954126961232
8.7,"eps_greedy_SVM","SVM",1,6,3212,3120,92,700,410,290,0.903321923457604,0.65625,1.6758658008658,477,229,248,75,1.1,17.89,1.4,0,0,0,0,0,0,0.122266369609824,132.770298018703,16.4394744373908
8.7,"eps_greedy_SVM","SVM",1,7,3112,3045,67,800,485,315,0.906840254866383,0.674107142857143,1.67091602050204,532,255,277,55,1.1,20.45,1.5,0,0,0,0,0,0,0.107351657817325,151.690404239757,14.2902053470791
8.7,"eps_greedy_SVM","SVM",1,8,3012,2969,43,900,561,339,0.883192685994723,0.669642857142857,1.60517331932773,591,280,311,59,1.1,23.01,1.7,0,0,0,0,0,0,0.104903839474184,182.560875170033,14.6589199452087
8.7,"eps_greedy_SVM","SVM",1,9,2912,2872,40,1000,658,342,0.901203192015846,0.678571428571429,1.67399605003292,601,289,312,10,1.1,25.56,1.9,0,0,0,0,0,0,0.0736819201982687,112.783240245397,8.32530778533857
8.7,"eps_greedy_SVM","SVM",1,10,2812,2777,35,1100,753,347,0.909928138403178,0.678571428571429,1.69657655880032,619,296,323,18,1.1,28.12,2.2,0,0,0,0,0,0,0.0699233755876605,101.347361994178,7.4991975503735
8.7,"eps_greedy_SVM","SVM",1,11,2712,2680,32,1200,850,350,0.916707048003968,0.669642857142857,1.73033245556287,630,303,327,11,1.1,30.67,2.4,0,0,0,0,0,0,0.0661748674443005,75.351361427867,7.28287722085643
8.7,"eps_greedy_SVM","SVM",1,12,2612,2583,29,1300,947,353,0.919279425107232,0.669642857142857,1.72228439763002,642,308,334,12,1.1,33.23,2.7,0,0,0,0,0,0,0.0634175211675358,67.3186266190876,7.00585095812305
8.7,"eps_greedy_SVM","SVM",1,13,2512,2489,23,1400,1041,359,0.918819335615314,0.665178571428571,1.72069850039463,660,316,344,18,1.1,35.79,2.9,0,0,0,0,0,0,0.0620062236644505,59.3147169176603,6.93832233864886
8.7,"eps_greedy_SVM","SVM",1,14,2412,2394,18,1500,1136,364,0.919142815902344,0.665178571428571,1.73033245556287,680,321,359,20,1.1,38.34,3.1,0,0,0,0,0,0,0.0559027666742073,51.6126574521002,6.32126185147653
8.7,"eps_greedy_SVM","SVM",1,15,2312,2298,14,1600,1232,368,0.920019176839327,0.665178571428571,1.72873914759274,686,325,361,6,1.1,40.9,3.3,0,0,0,0,0,0,0.0428515270596182,44.2378335234027,4.95871079238871
8.7,"eps_greedy_SVM","SVM",1,16,2212,2201,11,1700,1329,371,0.920106812933028,0.665178571428571,1.73033245556287,692,328,364,6,1.1,43.46,3.6,0,0,0,0,0,0,0.03648590541824,40.1622979291598,3.93543013925449
8.7,"eps_greedy_SVM","SVM",1,17,2112,2102,10,1800,1428,372,0.920818211811285,0.665178571428571,1.73033245556287,694,332,362,2,1.1,46.01,3.8,0,0,0,0,0,0,0.0262889747890813,26.9553427633069,2.78289267756919
8.7,"eps_greedy_SVM","SVM",1,18,2012,2003,9,1900,1527,373,0.921194531507768,0.660714285714286,1.74001377410468,714,341,373,20,1.1,48.57,4.1,0,0,0,0,0,0,0.0196981462535035,18.4403073898729,2.38538582318832
8.7,"eps_greedy_SVM","SVM",1,19,1912,1904,8,2000,1626,374,0.920735730781932,0.660714285714286,1.73838051349572,723,345,378,9,1.1,51.12,4.3,0,0,0,0,0,0,0.0165914975078463,15.446669393119,1.78958344396005
8.7,"eps_greedy_SVM","SVM",1,20,1812,1804,8,2100,1726,374,0.921349183437828,0.660714285714286,1.74482044198895,719,345,374,-4,1.1,53.68,4.6,0,0,0,0,0,0,0.0122827643360844,10.7799171960071,1.35204740159301
8.7,"eps_greedy_SVM","SVM",1,21,1712,1705,7,2200,1825,375,0.921975523754563,0.660714285714286,1.74642857142857,724,348,376,5,1.1,56.24,4.9,0,0,0,0,0,0,0.0112335010828717,9.00077383880023,1.15301293393137
8.7,"eps_greedy_SVM","SVM",1,22,1612,1605,7,2300,1925,375,0.922435613246473,0.647321428571429,1.7656906512605,739,359,380,15,1.1,58.79,5.1,0,0,0,0,0,0,0.00819080883590283,6.09882010550258,1.01895571554796
8.7,"eps_greedy_SVM","SVM",1,23,1512,1507,5,2400,2023,377,0.922491030188078,0.65625,1.76731502168485,744,360,384,5,1.1,61.35,5.4,0,0,0,0,0,0,0.007870867966671,5.41730048217747,0.807780270557729
8.7,"eps_greedy_SVM","SVM",1,24,1412,1407,5,2500,2123,377,0.922694655229315,0.65625,1.76406926406926,748,366,382,4,1,63.91,5.6,0,0,0,0,0,0,0.00612087658471798,3.89906759724857,0.711928899403063
8.7,"eps_greedy_SVM","SVM",1,25,1312,1308,4,2600,2222,378,0.922939520785237,0.65625,1.76245085190039,753,367,386,5,1.1,66.46,5.9,0,0,0,0,0,0,0.00528405808601809,3.13015318941048,0.54637139237786
8.7,"eps_greedy_SVM","SVM",1,26,1212,1209,3,2700,2321,379,0.923224338089758,0.660714285714286,1.76894238358327,758,369,389,5,1.1,69.02,6.1,0,0,0,0,0,0,0.00506963556745899,2.76893209263503,0.540357517782864
8.7,"eps_greedy_SVM","SVM",1,27,1112,1109,3,2800,2421,379,0.923434406961417,0.660714285714286,1.7656906512605,763,370,393,5,1.1,71.57,6.4,0,0,0,0,0,0,0.00484327009367276,2.2904819751309,0.500652120057747
8.7,"eps_greedy_SVM","SVM",1,28,1012,1009,3,2900,2521,379,0.923661229792167,0.660714285714286,1.76731502168485,765,371,394,2,1.1,74.13,6.7,0,0,0,0,0,0,0.00345753957742555,1.4028279957335,0.366459484019681
8.7,"eps_greedy_SVM","SVM",1,29,912,910,2,3000,2620,380,0.923723090564188,0.65625,1.76406926406926,768,373,395,3,1.1,76.69,6.9,0,0,0,0,0,0,0.00284637437739192,1.04641965476552,0.314757635713184
8.7,"eps_greedy_SVM","SVM",1,30,812,810,2,3100,2720,380,0.923746288353697,0.65625,1.76406926406926,770,373,397,2,1.1,79.24,7.2,0,0,0,0,0,0,0.00229990705707827,0.720209959978484,0.251363586688343
8.7,"eps_greedy_SVM","SVM",1,31,712,710,2,3200,2820,380,0.924073634938982,0.651785714285714,1.7656906512605,770,373,397,0,1.1,81.8,7.4,0,0,0,0,0,0,0.00155199445476979,0.454910413975874,0.189731409922006
8.7,"eps_greedy_SVM","SVM",1,32,612,610,2,3300,2920,380,0.924254062190713,0.651785714285714,1.76731502168485,771,374,397,1,1.1,84.36,7.7,0,0,0,0,0,0,0.000833410508677519,0.258837640496616,0.116981679967127
8.7,"eps_greedy_SVM","SVM",1,33,512,511,1,3400,3019,381,0.924848183355344,0.647321428571429,1.76894238358327,779,377,402,8,1.1,86.91,7.9,0,0,0,0,0,0,0.000552255864297173,0.168037075206801,0.0752792306501106
8.7,"eps_greedy_SVM","SVM",1,34,412,412,0,3500,3118,382,0.925934613163986,0.638392857142857,1.76894238358327,783,379,404,4,1.1,89.47,8.2,0,0,0,0,0,0,0.000459347136645777,0.131166511598821,0.0598143182536168
8.7,"eps_greedy_SVM","SVM",1,35,312,312,0,3600,3218,382,0.926609926591897,0.638392857142857,1.76894238358327,784,380,404,1,1.1,92.02,8.4,0,0,0,0,0,0,0.000212249916153795,0.0512959931775118,0.0270474427336198
8.7,"eps_greedy_SVM","SVM",1,36,212,212,0,3700,3318,382,0.927287817551975,0.638392857142857,1.77057274522712,785,381,404,1,1.1,94.58,8.7,0,0,0,0,0,0,0.000100415086523829,0.0215151843043877,0.0141339703324345
8.7,"eps_greedy_SVM","SVM",1,37,112,112,0,3800,3418,382,0.928160312190707,0.638392857142857,1.76894238358327,783,381,402,-2,1.1,97.14,8.9,0,0,0,0,0,0,2.37543985928153e-05,0.00489797967992374,0.00464197703045
8.7,"eps_greedy_SVM","SVM",1,38,12,12,0,3900,3518,382,0.928617824150455,0.638392857142857,1.76731502168485,785,382,403,2,1.1,99.69,9.2,0,0,0,0,0,0,1.55924858550313e-05,0.00021007704002571,0.00021007704002571
8.7,"eps_greedy_SVM","SVM",1,39,0,0,0,3912,3530,382,0.92862942304521,0.638392857142857,1.7656906512605,785,382,403,0,1.1,100,9.2,0,0,0,0,0,0,0,0,0
8.7,"eps_greedy_SVM","SVM",2,0,3812,3426,386,100,87,13,0.918857704747778,0.579710144927536,1.77878920961925,30,13,17,0,1.3,2.56,6.7,0,0,0,0,0,0,0.70659886270428,488.667041672181,75.5993051321643
8.7,"eps_greedy_SVM","SVM",2,1,3712,3400,312,200,113,87,0.922034123018554,0.603864734299517,1.75598309400957,79,42,37,49,0.9,5.11,1.3,0,0,0,0,0,0,0.685379124126415,275.142852423123,77.9632484243534
8.7,"eps_greedy_SVM","SVM",2,2,3612,3357,255,300,156,144,0.903508699242911,0.560386473429952,1.72279606053327,153,78,75,74,1,7.67,1.1,0,0,0,0,0,0,0.401347094572267,187.775194171163,55.8393660472606
8.7,"eps_greedy_SVM","SVM",2,3,3512,3306,206,400,207,193,0.897150338495703,0.623188405797101,1.68179763329345,251,128,123,98,1,10.22,1.1,0,0,0,0,0,0,0.317715036950369,175.986714259809,46.4816660336026
8.7,"eps_greedy_SVM","SVM",2,4,3412,3250,162,500,263,237,0.902135934129366,0.623188405797101,1.71251816594003,335,168,167,84,1,12.78,1.1,0,0,0,0,0,0,0.154302790727333,86.5404543286974,22.2465962426831
8.7,"eps_greedy_SVM","SVM",2,5,3312,3184,128,600,329,271,0.904866272790809,0.652173913043478,1.70539408012384,407,200,207,72,1,15.34,1.2,0,0,0,0,0,0,0.121734276510061,110.543814524056,17.6375833649301
8.7,"eps_greedy_SVM","SVM",2,6,3212,3112,100,700,401,299,0.909082622782388,0.666666666666667,1.68083884325119,462,224,238,55,1.1,17.89,1.3,0,0,0,0,0,0,0.10183949168488,103.192379374064,15.2565717020636
8.7,"eps_greedy_SVM","SVM",2,7,3112,3031,81,800,482,318,0.899230201937344,0.671497584541063,1.63729379549856,513,244,269,51,1.1,20.45,1.5,0,0,0,0,0,0,0.0799176516053459,108.182809807102,10.6913734530708
8.7,"eps_greedy_SVM","SVM",2,8,3012,2950,62,900,563,337,0.896180840397418,0.695652173913043,1.60968318787199,566,266,300,53,1.1,23.01,1.7,0,0,0,0,0,0,0.094114143228607,138.767266365988,12.7707142119348
8.7,"eps_greedy_SVM","SVM",2,9,2912,2859,53,1000,654,346,0.914550205362363,0.695652173913043,1.68488917306053,599,289,310,33,1.1,25.56,1.9,0,0,0,0,0,0,0.0623507681817796,82.1957796375883,7.61587106585922
8.7,"eps_greedy_SVM","SVM",2,10,2812,2765,47,1100,748,352,0.924571114480887,0.681159420289855,1.73149705073798,616,299,317,17,1.1,28.12,2.1,0,0,0,0,0,0,0.0598456427158983,75.4773218815817,6.88147770466658
8.7,"eps_greedy_SVM","SVM",2,11,2712,2669,43,1200,844,356,0.931563377830824,0.676328502415459,1.74729010839566,627,305,322,11,1.1,30.67,2.4,0,0,0,0,0,0,0.0512204394552253,61.7501410667212,5.73862644433865
8.7,"eps_greedy_SVM","SVM",2,12,2612,2579,33,1300,934,366,0.940152136624677,0.676328502415459,1.77500200176155,651,315,336,24,1.1,33.23,2.6,0,0,0,0,0,0,0.0614902233332294,63.6955833696425,6.84426562176151
8.7,"eps_greedy_SVM","SVM",2,13,2512,2484,28,1400,1029,371,0.943335460152549,0.666666666666667,1.78910912190963,666,321,345,15,1.1,35.79,2.8,0,0,0,0,0,0,0.0632717283730397,58.0221168159404,7.19675626090607
8.7,"eps_greedy_SVM","SVM",2,14,2412,2389,23,1500,1124,376,0.945800636940936,0.661835748792271,1.78370299196626,684,328,356,18,1.1,38.34,3,0,0,0,0,0,0,0.0598660299407336,51.0421108470217,6.65231190322206
8.7,"eps_greedy_SVM","SVM",2,15,2312,2295,17,1600,1218,382,0.945807542198051,0.661835748792271,1.78042412617221,706,335,371,22,1.1,40.9,3.2,0,0,0,0,0,0,0.0501449834781912,47.6559994393746,5.8999871741404
8.7,"eps_greedy_SVM","SVM",2,16,2212,2197,15,1700,1316,384,0.946053369351181,0.661835748792271,1.77336906523739,709,336,373,3,1.1,43.46,3.4,0,0,0,0,0,0,0.0342837669222459,36.1318364059085,3.89773237752255
8.7,"eps_greedy_SVM","SVM",2,17,2112,2098,14,1800,1415,385,0.945625243410339,0.661835748792271,1.77663794830695,712,339,373,3,1.1,46.01,3.7,0,0,0,0,0,0,0.0285068437934455,30.8993426631392,3.07505899401812
8.7,"eps_greedy_SVM","SVM",2,18,2012,1999,13,1900,1514,386,0.944223476216933,0.661835748792271,1.77173913043478,715,341,374,3,1.1,48.57,3.9,0,0,0,0,0,0,0.0292985783159843,29.3749514280732,3.01738825031766
8.7,"eps_greedy_SVM","SVM",2,19,1912,1899,13,2000,1614,386,0.944313244559373,0.642512077294686,1.78746623015398,743,358,385,28,1.1,51.12,4.2,0,0,0,0,0,0,0.0220768924320607,13.6850458863898,2.9983624769761
8.7,"eps_greedy_SVM","SVM",2,20,1812,1802,10,2100,1711,389,0.944260764605334,0.642512077294686,1.78910912190963,747,361,386,4,1.1,53.68,4.4,0,0,0,0,0,0,0.0144408047911189,9.97417835080538,1.73630249192117
8.7,"eps_greedy_SVM","SVM",2,21,1712,1702,10,2200,1811,389,0.944260764605334,0.642512077294686,1.78910912190963,749,361,388,2,1.1,56.24,4.7,0,0,0,0,0,0,0.00973783127246503,7.69941388283975,1.13286913288802
8.7,"eps_greedy_SVM","SVM",2,22,1612,1606,6,2300,1907,393,0.944258002502488,0.642512077294686,1.78746623015398,762,368,394,13,1.1,58.79,4.9,0,0,0,0,0,0,0.00960668343617902,8.2121865698101,1.07098374299254
8.7,"eps_greedy_SVM","SVM",2,23,1512,1506,6,2400,2007,393,0.944233143576891,0.642512077294686,1.78582635287861,765,369,396,3,1.1,61.35,5.1,0,0,0,0,0,0,0.00883803540093504,6.88304243824932,0.90128989698689
8.7,"eps_greedy_SVM","SVM",2,24,1412,1406,6,2500,2107,393,0.944423728673138,0.63768115942029,1.78910912190963,776,374,402,11,1.1,63.91,5.4,0,0,0,0,0,0,0.0056253176652661,3.91728311943878,0.675649831464793
8.7,"eps_greedy_SVM","SVM",2,25,1312,1306,6,2600,2207,393,0.944506591758462,0.63768115942029,1.79240398217098,777,374,403,1,1.1,66.46,5.6,0,0,0,0,0,0,0.00493136684929049,3.28986737906175,0.51525080104768
8.7,"eps_greedy_SVM","SVM",2,26,1212,1206,6,2700,2307,393,0.944269050913866,0.642512077294686,1.78746623015398,779,376,403,2,1.1,69.02,5.9,0,0,0,0,0,0,0.00406597493017156,2.44834246742197,0.427060829743314
8.7,"eps_greedy_SVM","SVM",2,27,1112,1107,5,2800,2406,394,0.943843687075869,0.642512077294686,1.79240398217098,785,381,404,6,1.1,71.57,6.1,0,0,0,0,0,0,0.00359514775119909,1.98156415189697,0.381364057864246
8.7,"eps_greedy_SVM","SVM",2,28,1012,1007,5,2900,2506,394,0.943631005156871,0.642512077294686,1.79240398217098,784,381,403,-1,1.1,74.13,6.4,0,0,0,0,0,0,0.00329059699406078,1.57034843367488,0.342171853132983
8.7,"eps_greedy_SVM","SVM",2,29,912,907,5,3000,2606,394,0.94321668973025,0.642512077294686,1.78910912190963,785,383,402,1,1,76.69,6.6,0,0,0,0,0,0,0.00250197316236461,1.02486684357376,0.26783525884188
8.7,"eps_greedy_SVM","SVM",2,30,812,809,3,3100,2704,396,0.943095157205107,0.63768115942029,1.79075503646521,794,386,408,9,1.1,79.24,6.8,0,0,0,0,0,0,0.00225190328862153,0.846997526787532,0.246173889320347
8.7,"eps_greedy_SVM","SVM",2,31,712,709,3,3200,2804,396,0.943012294119782,0.63768115942029,1.79240398217098,793,386,407,-1,1.1,81.8,7.1,0,0,0,0,0,0,0.00218604704408015,0.727849066153213,0.244381382847449
8.7,"eps_greedy_SVM","SVM",2,32,612,610,2,3300,2903,397,0.943190449753229,0.63768115942029,1.79240398217098,796,387,409,3,1.1,84.36,7.3,0,0,0,0,0,0,0.00146946910331497,0.459626525389924,0.176530194423185
8.7,"eps_greedy_SVM","SVM",2,33,512,510,2,3400,3003,397,0.943213927627404,0.63768115942029,1.79075503646521,796,388,408,0,1.1,86.91,7.6,0,0,0,0,0,0,0.000831807203117521,0.246885866345754,0.106537274192495
8.7,"eps_greedy_SVM","SVM",2,34,412,412,0,3500,3101,399,0.943197355010338,0.63768115942029,1.78746623015398,805,393,412,9,1,89.47,7.8,0,0,0,0,0,0,0.000842000944490967,0.249558082377558,0.107326294744743
8.7,"eps_greedy_SVM","SVM",2,35,312,312,0,3600,3201,399,0.943287123352772,0.63768115942029,1.78910912190963,807,394,413,2,1,92.02,8,0,0,0,0,0,0,0.000519241708080584,0.128916011540334,0.0645760609082627
8.7,"eps_greedy_SVM","SVM",2,36,212,212,0,3700,3301,399,0.943423847443556,0.632850241545894,1.794055967408,809,395,414,2,1,94.58,8.3,0,0,0,0,0,0,0.000302396342444011,0.0616495599359158,0.0399260291284937
8.7,"eps_greedy_SVM","SVM",2,37,112,112,0,3800,3401,399,0.943825733407377,0.632850241545894,1.79240398217098,810,396,414,1,1,97.14,8.5,0,0,0,0,0,0,9.17703210755405e-05,0.0174180658129048,0.0164357459098126
8.7,"eps_greedy_SVM","SVM",2,38,12,12,0,3900,3501,399,0.944081227920458,0.628019323671498,1.78746623015398,812,396,416,2,1.1,99.69,8.8,0,0,0,0,0,0,7.05084082998788e-05,0.000982199142183991,0.000982199142183991
8.7,"eps_greedy_SVM","SVM",2,39,0,0,0,3912,3513,399,0.944140613131607,0.628019323671498,1.78582635287861,814,398,416,2,1,100,8.8,0,0,0,0,0,0,0,0,0
8.7,"eps_greedy_SVM","SVM",3,0,3812,3422,390,100,84,16,0.880196469248293,0.475,1.68527956003666,42,16,26,0,1.6,2.56,5.2,0,0,0,0,0,0,0.545189454700446,556.848945402155,68.4373209448846
8.7,"eps_greedy_SVM","SVM",3,1,3712,3360,352,200,146,54,0.903228929384971,0.6,1.71172288058341,108,50,58,66,1.2,5.11,2.7,0,0,0,0,0,0,0.781769369246598,538.551288054253,85.3804559029415
8.7,"eps_greedy_SVM","SVM",3,2,3612,3326,286,300,180,120,0.920101082004556,0.625,1.72588235294118,163,82,81,55,1,7.67,1.5,0,0,0,0,0,0,0.557033028085606,367.18125378875,67.6749279236427
8.7,"eps_greedy_SVM","SVM",3,3,3512,3293,219,400,213,187,0.915649202733488,0.64,1.70903934126258,229,114,115,66,1,10.22,1.1,0,0,0,0,0,0,0.437604943112394,251.108030269344,58.5938064535804
8.7,"eps_greedy_SVM","SVM",3,4,3412,3247,165,500,259,241,0.912112756264233,0.635,1.70047838086477,321,157,164,92,1,12.78,1.1,0,0,0,0,0,0,0.287223798759946,221.875517026823,39.0553378237276
8.7,"eps_greedy_SVM","SVM",3,5,3312,3186,126,600,320,280,0.86261389521641,0.665,1.56264462809917,408,202,206,87,1,15.34,1.1,0,0,0,0,0,0,0.200437385286422,243.224325551129,27.5881425211187
8.7,"eps_greedy_SVM","SVM",3,6,3212,3108,104,700,398,302,0.881617312072897,0.665,1.59544700460829,470,226,244,62,1.1,17.89,1.3,0,0,0,0,0,0,0.122579855172127,193.199422063071,16.7359939756173
8.7,"eps_greedy_SVM","SVM",3,7,3112,3023,89,800,483,317,0.89440205011389,0.675,1.62248847926267,507,244,263,37,1.1,20.45,1.5,0,0,0,0,0,0,0.0957405853661796,147.814688819999,12.0961122339153
8.7,"eps_greedy_SVM","SVM",3,8,3012,2940,72,900,566,334,0.900623576309793,0.675,1.64952995391705,564,266,298,57,1.1,23.01,1.7,0,0,0,0,0,0,0.0820064147454796,120.424578237988,10.6407603563218
8.7,"eps_greedy_SVM","SVM",3,9,2912,2848,64,1000,658,342,0.906698462414593,0.675,1.65397058823529,584,279,305,20,1.1,25.56,1.9,0,0,0,0,0,0,0.060608958425504,81.1875341141456,6.86615702456611
8.7,"eps_greedy_SVM","SVM",3,10,2812,2753,59,1100,753,347,0.909618451025073,0.675,1.68248390064397,603,287,316,19,1.1,28.12,2.2,0,0,0,0,0,0,0.0533724983785075,74.5039529690291,5.88184123168067
8.7,"eps_greedy_SVM","SVM",3,11,2712,2659,53,1200,847,353,0.912710706150351,0.675,1.70047838086477,618,297,321,15,1.1,30.67,2.4,0,0,0,0,0,0,0.0469977260488037,66.7801053726333,5.21938357163237
8.7,"eps_greedy_SVM","SVM",3,12,2612,2565,47,1300,941,359,0.924289578587703,0.675,1.71104972375691,650,309,341,32,1.1,33.23,2.6,0,0,0,0,0,0,0.0530144059692892,64.2435200199725,6.16775538660196
8.7,"eps_greedy_SVM","SVM",3,13,2512,2469,43,1400,1037,363,0.929367881548977,0.67,1.73646734130635,664,316,348,14,1.1,35.79,2.9,0,0,0,0,0,0,0.0477674814889765,51.1566653252926,5.23246641646629
8.7,"eps_greedy_SVM","SVM",3,14,2412,2377,35,1500,1129,371,0.934984339407765,0.665,1.7560773480663,676,324,352,12,1.1,38.34,3,0,0,0,0,0,0,0.0606130466532761,50.8373856593993,6.65352631794462
8.7,"eps_greedy_SVM","SVM",3,15,2312,2281,31,1600,1225,375,0.935948177676563,0.665,1.75284926470588,685,328,357,9,1.1,40.9,3.3,0,0,0,0,0,0,0.0456494605368423,37.5517368575105,5.362889616382
8.7,"eps_greedy_SVM","SVM",3,16,2212,2187,25,1700,1319,381,0.937260820045581,0.665,1.76022038567493,699,334,365,14,1.1,43.46,3.5,0,0,0,0,0,0,0.0358355663214456,33.1092709040836,4.45890609101894
8.7,"eps_greedy_SVM","SVM",3,17,2112,2093,19,1800,1413,387,0.937185364464718,0.665,1.7560773480663,713,342,371,14,1.1,46.01,3.7,0,0,0,0,0,0,0.0302169733655406,30.6113271144737,3.53452971751728
8.7,"eps_greedy_SVM","SVM",3,18,2012,1996,16,1900,1510,390,0.937770501138975,0.66,1.76670967741935,726,347,379,13,1.1,48.57,3.9,0,0,0,0,0,0,0.0277418437785781,27.4334028689064,2.86235526750826
8.7,"eps_greedy_SVM","SVM",3,19,1912,1898,14,2000,1608,392,0.936487756264258,0.66,1.76183823529412,746,360,386,20,1.1,51.12,4.1,0,0,0,0,0,0,0.0205024479515706,16.3530438332748,2.72847913243689
8.7,"eps_greedy_SVM","SVM",3,20,1812,1801,11,2100,1705,395,0.937275056947629,0.66,1.76022038567493,750,362,388,4,1.1,53.68,4.3,0,0,0,0,0,0,0.0162741321470006,13.753363405827,1.76108886466725
8.7,"eps_greedy_SVM","SVM",3,21,1712,1702,10,2200,1804,396,0.937497152619608,0.655,1.76920110192837,767,369,398,17,1.1,56.24,4.6,0,0,0,0,0,0,0.0125080272345901,9.7731530230658,1.44384673456397
8.7,"eps_greedy_SVM","SVM",3,22,1612,1605,7,2300,1901,399,0.938354214123027,0.655,1.76595783684693,774,373,401,7,1.1,58.79,4.8,0,0,0,0,0,0,0.0113574946370889,8.72807391154462,1.19829599425549
8.7,"eps_greedy_SVM","SVM",3,23,1512,1506,6,2400,2000,400,0.938234624145802,0.665,1.76920110192837,778,379,399,4,1.1,61.35,5,0,0,0,0,0,0,0.00841098210774706,6.13497032312453,0.975403366917198
8.7,"eps_greedy_SVM","SVM",3,24,1412,1408,4,2500,2098,402,0.938399772209585,0.67,1.76920110192837,786,383,403,8,1.1,63.91,5.2,0,0,0,0,0,0,0.00849775071324721,6.06925675323891,0.913163278595637
8.7,"eps_greedy_SVM","SVM",3,25,1312,1308,4,2600,2198,402,0.938553530751724,0.665,1.76920110192837,796,389,407,10,1,66.46,5.5,0,0,0,0,0,0,0.0064097008664433,4.24516826509427,0.711726658263523
8.7,"eps_greedy_SVM","SVM",3,26,1212,1208,4,2700,2298,402,0.938527904328034,0.66,1.77245630174793,795,389,406,-1,1,69.02,5.7,0,0,0,0,0,0,0.00557185127522952,3.31131472703672,0.576894910569344
8.7,"eps_greedy_SVM","SVM",3,27,1112,1108,4,2800,2398,402,0.938678815489764,0.66,1.76920110192837,794,388,406,-1,1,71.57,6,0,0,0,0,0,0,0.00466460025253929,2.52613718198817,0.504940528638491
8.7,"eps_greedy_SVM","SVM",3,28,1012,1009,3,2900,2497,403,0.938893792710722,0.665,1.77082720588235,799,390,409,5,1,74.13,6.2,0,0,0,0,0,0,0.00466627975162322,2.35766760422151,0.503976162719231
8.7,"eps_greedy_SVM","SVM",3,29,912,909,3,3000,2597,403,0.938855353075186,0.665,1.76920110192837,797,390,407,-2,1,76.69,6.4,0,0,0,0,0,0,0.00340839341426137,1.52854369710377,0.366889619264567
8.7,"eps_greedy_SVM","SVM",3,30,812,809,3,3100,2697,403,0.938977790432818,0.665,1.77245630174793,800,391,409,3,1,79.24,6.7,0,0,0,0,0,0,0.00294194488428531,1.18865549492653,0.320246365669915
8.7,"eps_greedy_SVM","SVM",3,31,712,709,3,3200,2797,403,0.938970671981793,0.66,1.77408839779006,801,391,410,1,1,81.8,6.9,0,0,0,0,0,0,0.00221496501081299,0.780565223093267,0.243235680430821
8.7,"eps_greedy_SVM","SVM",3,32,612,609,3,3300,2897,403,0.939037585421429,0.66,1.77082720588235,802,391,411,1,1.1,84.36,7.2,0,0,0,0,0,0,0.00181081242611586,0.567870254419823,0.205516500091039
8.7,"eps_greedy_SVM","SVM",3,33,512,510,2,3400,2996,404,0.939436218678831,0.66,1.76757798165138,807,393,414,5,1.1,86.91,7.4,0,0,0,0,0,0,0.00141525894328276,0.441132095934321,0.175422876864362
8.7,"eps_greedy_SVM","SVM",3,34,412,411,1,3500,3095,405,0.93935933940776,0.66,1.76920110192837,811,396,415,4,1,89.47,7.6,0,0,0,0,0,0,0.001085518648873,0.303042631558714,0.133895420987037
8.7,"eps_greedy_SVM","SVM",3,35,312,312,0,3600,3194,406,0.93950740318908,0.66,1.77408839779006,816,398,418,5,1.1,92.02,7.9,0,0,0,0,0,0,0.00080343240456709,0.208781027084884,0.105875578330498
8.7,"eps_greedy_SVM","SVM",3,36,212,212,0,3700,3294,406,0.939832004555822,0.655,1.76920110192837,821,400,421,5,1.1,94.58,8.1,0,0,0,0,0,0,0.000555459246069916,0.116321642566435,0.072225303741868
8.7,"eps_greedy_SVM","SVM",3,37,112,112,0,3800,3394,406,0.939904612756277,0.65,1.77408839779006,823,400,423,2,1.1,97.14,8.4,0,0,0,0,0,0,0.000233862376018684,0.0371811646084126,0.0346624565644863
8.7,"eps_greedy_SVM","SVM",3,38,12,12,0,3900,3494,406,0.940327448747164,0.65,1.77245630174793,825,401,424,2,1.1,99.69,8.6,0,0,0,0,0,0,0.000179052124642012,0.00246747476803348,0.00246747476803348
8.7,"eps_greedy_SVM","SVM",3,39,0,0,0,3912,3506,406,0.940219248291583,0.645,1.77245630174793,825,401,424,0,1.1,100,8.6,0,0,0,0,0,0,0,0,0
8.7,"eps_greedy_SVM","SVM",4,0,3812,3425,387,100,91,9,0.925849560901107,0.604761904761905,1.76679821099711,23,9,14,0,1.6,2.56,10.1,0,0,0,0,0,0,0.407202147833007,312.242198637218,45.6804154176481
8.7,"eps_greedy_SVM","SVM",4,1,3712,3398,314,200,118,82,0.91848579065073,0.60952380952381,1.74803522144829,89,48,41,66,0.9,5.11,1.4,0,0,0,0,0,0,0.662240466519577,210.863544969517,79.5649492551052
8.7,"eps_greedy_SVM","SVM",4,2,3612,3363,249,300,153,147,0.916233022418594,0.628571428571429,1.76517282165856,158,83,75,69,0.9,7.67,1,0,0,0,0,0,0,0.357794550749023,136.972132278015,53.0075956182464
8.7,"eps_greedy_SVM","SVM",4,3,3512,3309,203,400,207,193,0.906679212349314,0.657142857142857,1.72550362080316,250,127,123,92,1,10.22,1.1,0,0,0,0,0,0,0.301496564709117,134.716452238252,46.5773869175847
8.7,"eps_greedy_SVM","SVM",4,4,3412,3251,161,500,265,235,0.877952326405941,0.666666666666667,1.62248847926267,331,166,165,81,1,12.78,1.1,0,0,0,0,0,0,0.151112005986032,87.5821440534,23.3651109465887
8.7,"eps_greedy_SVM","SVM",4,5,3312,3174,138,600,342,258,0.886342933507871,0.69047619047619,1.61241778479348,389,189,200,58,1.1,15.34,1.3,0,0,0,0,0,0,0.0813531833878272,56.4087050107684,11.8108543299869
8.7,"eps_greedy_SVM","SVM",4,6,3212,3101,111,700,415,285,0.89140075274096,0.695238095238095,1.62807201997634,452,217,235,63,1.1,17.89,1.5,0,0,0,0,0,0,0.0684697015597669,70.9359795416768,11.1192777488942
8.7,"eps_greedy_SVM","SVM",4,7,3112,3016,96,800,500,300,0.900670921289481,0.69047619047619,1.65377842029176,486,232,254,34,1.1,20.45,1.7,0,0,0,0,0,0,0.0594381408603392,70.4245675838279,7.47042472406214
8.7,"eps_greedy_SVM","SVM",4,8,3012,2927,85,900,589,311,0.908921071292204,0.695238095238095,1.67948482060718,510,245,265,24,1.1,23.01,1.9,0,0,0,0,0,0,0.0532581621531768,68.9883447680189,5.98746273917814
8.7,"eps_greedy_SVM","SVM",4,9,2912,2840,72,1000,676,324,0.912947962690234,0.704761904761905,1.68650210084034,548,259,289,38,1.1,25.56,2.1,0,0,0,0,0,0,0.0637046564074066,98.3326745536234,7.82373833424159
8.7,"eps_greedy_SVM","SVM",4,10,2812,2745,67,1100,771,329,0.918431244204447,0.704761904761905,1.68960799789529,569,271,298,21,1.1,28.12,2.3,0,0,0,0,0,0,0.0486198547465892,65.6509163656814,5.52256006610488
8.7,"eps_greedy_SVM","SVM",4,11,2712,2655,57,1200,861,339,0.92489227076856,0.704761904761905,1.69974983541804,597,289,308,28,1.1,30.67,2.5,0,0,0,0,0,0,0.0400024575198079,55.0243052157374,5.31702837904695
8.7,"eps_greedy_SVM","SVM",4,12,2612,2567,45,1300,949,351,0.926156384661523,0.7,1.70362394957983,629,301,328,32,1.1,33.23,2.7,0,0,0,0,0,0,0.0492096687728109,69.0357484396049,6.00564138582185
8.7,"eps_greedy_SVM","SVM",4,13,2512,2472,40,1400,1044,356,0.933434244258971,0.69047619047619,1.72930672268908,655,312,343,26,1.1,35.79,2.9,0,0,0,0,0,0,0.0511948269087002,51.0656419373053,6.12831674776996
8.7,"eps_greedy_SVM","SVM",4,14,2412,2376,36,1500,1140,360,0.936570664921161,0.695238095238095,1.74803522144829,664,321,343,9,1.1,38.34,3.2,0,0,0,0,0,0,0.0443817847023838,44.6136086610186,4.9694403105105
8.7,"eps_greedy_SVM","SVM",4,15,2312,2279,33,1600,1237,363,0.938943435335167,0.695238095238095,1.75660402155342,672,324,348,8,1.1,40.9,3.4,0,0,0,0,0,0,0.0413088892698749,40.404753883495,4.5673220625638
8.7,"eps_greedy_SVM","SVM",4,16,2212,2185,27,1700,1331,369,0.939546173566772,0.695238095238095,1.75984200131666,691,334,357,19,1.1,43.46,3.6,0,0,0,0,0,0,0.0428648484265758,36.2414351333879,4.98421366691663
8.7,"eps_greedy_SVM","SVM",4,17,2112,2092,20,1800,1424,376,0.938155239186152,0.695238095238095,1.73308890925756,711,340,371,20,1.1,46.01,3.8,0,0,0,0,0,0,0.0456632813143642,37.5799299386563,5.43183204111387
8.7,"eps_greedy_SVM","SVM",4,18,2012,1997,15,1900,1519,381,0.938114329351428,0.695238095238095,1.73627180899908,722,346,376,11,1.1,48.57,4,0,0,0,0,0,0,0.0358850687625156,32.0633331687867,4.22867358792841
8.7,"eps_greedy_SVM","SVM",4,19,1912,1899,13,2000,1617,383,0.938313423880419,0.695238095238095,1.73150183150183,726,349,377,4,1.1,51.12,4.2,0,0,0,0,0,0,0.0289368905754388,27.0214790225684,3.23194027648148
8.7,"eps_greedy_SVM","SVM",4,20,1812,1801,11,2100,1715,385,0.939111165657545,0.695238095238095,1.73786764705882,736,352,384,10,1.1,53.68,4.5,0,0,0,0,0,0,0.0279728707577814,24.8370036721223,2.84297829430921
8.7,"eps_greedy_SVM","SVM",4,21,1712,1701,11,2200,1815,385,0.939797087219756,0.680952380952381,1.76193099829463,748,362,386,12,1.1,56.24,4.7,0,0,0,0,0,0,0.0182653163402898,12.6133234533616,2.26593401620459
8.7,"eps_greedy_SVM","SVM",4,22,1612,1604,8,2300,1912,388,0.939987999781802,0.676190476190476,1.75660402155342,752,366,386,4,1.1,58.79,4.9,0,0,0,0,0,0,0.0145496858736581,11.6864609487533,1.70101555484497
8.7,"eps_greedy_SVM","SVM",4,23,1512,1505,7,2400,2011,389,0.940042546228104,0.676190476190476,1.75498949579832,759,369,390,7,1.1,61.35,5.2,0,0,0,0,0,0,0.0142023647063382,10.1698325402501,1.44957717235362
8.7,"eps_greedy_SVM","SVM",4,24,1412,1405,7,2500,2111,389,0.941485299732717,0.676190476190476,1.76723844441535,771,374,397,12,1.1,63.91,5.4,0,0,0,0,0,0,0.00866482345370731,5.52055671720091,1.06874474470157
8.7,"eps_greedy_SVM","SVM",4,25,1312,1305,7,2600,2211,389,0.941419843997158,0.671428571428571,1.76193099829463,770,374,396,-1,1.1,66.46,5.7,0,0,0,0,0,0,0.00749763857371476,4.54047439436404,0.792068849050104
8.7,"eps_greedy_SVM","SVM",4,26,1212,1206,6,2700,2310,390,0.941719849451802,0.676190476190476,1.76355042016807,775,377,398,5,1.1,69.02,5.9,0,0,0,0,0,0,0.00666527470503492,3.54479411461951,0.694976557701938
8.7,"eps_greedy_SVM","SVM",4,27,1112,1106,6,2800,2410,390,0.942011672939494,0.676190476190476,1.77048406139315,781,379,402,6,1.1,71.57,6.2,0,0,0,0,0,0,0.00570619869155268,2.73732511617879,0.631057654546426
8.7,"eps_greedy_SVM","SVM",4,28,1012,1006,6,2900,2510,390,0.942052582774219,0.676190476190476,1.77048406139315,782,379,403,1,1.1,74.13,6.4,0,0,0,0,0,0,0.00442426869475147,1.7917657853172,0.465034916585244
8.7,"eps_greedy_SVM","SVM",4,29,912,906,6,3000,2610,390,0.942449408171038,0.671428571428571,1.76885976408912,787,380,407,5,1.1,76.69,6.7,0,0,0,0,0,0,0.00361974286453225,1.25893690692598,0.397416759800084
8.7,"eps_greedy_SVM","SVM",4,30,812,807,5,3100,2709,391,0.942490318005761,0.671428571428571,1.77211134453782,788,381,407,1,1.1,79.24,6.9,0,0,0,0,0,0,0.00293218599190872,0.879320212296451,0.330460628790342
8.7,"eps_greedy_SVM","SVM",4,31,712,708,4,3200,2808,392,0.942808051055452,0.671428571428571,1.77048406139315,793,383,410,5,1.1,81.8,7.2,0,0,0,0,0,0,0.00200006823684132,0.600443695182116,0.249650974552024
8.7,"eps_greedy_SVM","SVM",4,32,612,609,3,3300,2907,393,0.942842142584388,0.671428571428571,1.77211134453782,793,385,408,0,1.1,84.36,7.4,0,0,0,0,0,0,0.00113474688068087,0.350429398242144,0.149550276238454
8.7,"eps_greedy_SVM","SVM",4,33,512,510,2,3400,3006,394,0.943312605683716,0.671428571428571,1.7770111915734,799,388,411,6,1.1,86.91,7.6,0,0,0,0,0,0,0.000945516395325911,0.290544163557269,0.122835044470747
8.7,"eps_greedy_SVM","SVM",4,34,412,411,1,3500,3105,395,0.94347897234493,0.676190476190476,1.77537490134175,804,390,414,5,1.1,89.47,7.9,0,0,0,0,0,0,0.00057909208442035,0.167074574714235,0.0735701742716848
8.7,"eps_greedy_SVM","SVM",4,35,312,312,0,3600,3204,396,0.943915343915321,0.671428571428571,1.77252646712848,807,393,414,3,1.1,92.02,8.1,0,0,0,0,0,0,0.000623633480565386,0.148251384044256,0.0743680351930493
8.7,"eps_greedy_SVM","SVM",4,36,212,212,0,3700,3304,396,0.943802160039251,0.671428571428571,1.76885976408912,809,394,415,2,1.1,94.58,8.3,0,0,0,0,0,0,0.000207193057821853,0.0432852116964936,0.0284766645816774
8.7,"eps_greedy_SVM","SVM",4,37,112,112,0,3800,3404,396,0.943868979435968,0.666666666666667,1.76723844441535,814,396,418,5,1.1,97.14,8.6,0,0,0,0,0,0,9.11235230811216e-05,0.0167703076789016,0.0158072960590394
8.7,"eps_greedy_SVM","SVM",4,38,12,12,0,3900,3504,396,0.943803523700409,0.666666666666667,1.76723844441535,814,396,418,0,1.1,99.69,8.8,0,0,0,0,0,0,4.49797850594325e-05,0.000734938476605912,0.000734938476605912
8.7,"eps_greedy_SVM","SVM",4,39,0,0,0,3912,3516,396,0.943849888179764,0.666666666666667,1.7737416217637,813,396,417,-1,1.1,100,8.9,0,0,0,0,0,0,0,0,0
8.7,"eps_greedy_SVM","SVM",5,0,3812,3412,400,100,88,12,0.914375065822582,0.556701030927835,1.77488716803649,34,12,22,0,1.8,2.56,7.3,0,0,0,0,0,0,0.296610892390413,447.695517156522,33.7145039555752
8.7,"eps_greedy_SVM","SVM",5,1,3712,3388,324,200,112,88,0.914857764723801,0.608247422680412,1.74219223771983,97,47,50,63,1.1,5.11,1.3,0,0,0,0,0,0,0.823726556707059,381.59145738647,87.178112058856
8.7,"eps_greedy_SVM","SVM",5,2,3612,3352,260,300,148,152,0.896822378506162,0.634020618556701,1.67578313595183,160,82,78,63,1,7.67,1,0,0,0,0,0,0,0.584216029749971,255.191160296276,68.2928315174832
8.7,"eps_greedy_SVM","SVM",5,3,3512,3305,207,400,195,205,0.866751699685221,0.608247422680412,1.62023231376558,237,120,117,77,1,10.22,1,0,0,0,0,0,0,0.347568201686421,198.950916805974,49.4378733996465
8.7,"eps_greedy_SVM","SVM",5,4,3412,3255,157,500,245,255,0.867329475642722,0.644329896907217,1.59392055791389,330,166,164,93,1,12.78,1,0,0,0,0,0,0,0.24591799977265,154.276019975387,34.9790561472744
8.7,"eps_greedy_SVM","SVM",5,5,3312,3192,120,600,308,292,0.890515112863783,0.634020618556701,1.63874925449433,414,207,207,84,1,15.34,1.1,0,0,0,0,0,0,0.146469044538666,142.804096563862,21.32848617807
8.7,"eps_greedy_SVM","SVM",5,6,3212,3118,94,700,382,318,0.891091426097342,0.654639175257732,1.63549812342629,477,231,246,63,1.1,17.89,1.2,0,0,0,0,0,0,0.100909005101344,117.066585203394,13.2152016196146
8.7,"eps_greedy_SVM","SVM",5,7,3112,3036,76,800,464,336,0.894063681149596,0.65979381443299,1.64327618613658,521,249,272,44,1.1,20.45,1.4,0,0,0,0,0,0,0.0940013860485307,143.896913715885,11.0962457843068
8.7,"eps_greedy_SVM","SVM",5,8,3012,2951,61,900,549,351,0.905607498508026,0.670103092783505,1.65408332937432,560,268,292,39,1.1,23.01,1.6,0,0,0,0,0,0,0.074732810212094,122.839522375847,8.71389738363609
8.7,"eps_greedy_SVM","SVM",5,9,2912,2860,52,1000,640,360,0.913874814234053,0.664948453608247,1.69741746412618,582,281,301,22,1.1,25.56,1.8,0,0,0,0,0,0,0.0651337361601778,108.725224903401,7.24926726964557
8.7,"eps_greedy_SVM","SVM",5,10,2812,2764,48,1100,736,364,0.914854839275897,0.664948453608247,1.69585733778047,592,284,308,10,1.1,28.12,2,0,0,0,0,0,0,0.0597778315423537,94.8229341981493,6.31141943988191
8.7,"eps_greedy_SVM","SVM",5,11,2712,2665,47,1200,835,365,0.917808078916873,0.664948453608247,1.70512431776834,602,292,310,10,1.1,30.67,2.3,0,0,0,0,0,0,0.0462400979266493,68.6085865956144,5.05520576220758
8.7,"eps_greedy_SVM","SVM",5,12,2612,2569,43,1300,931,369,0.927703406391528,0.664948453608247,1.69887844114648,610,299,311,8,1,33.23,2.5,0,0,0,0,0,0,0.0643054247735959,79.3618806006299,7.58867530244757
8.7,"eps_greedy_SVM","SVM",5,13,2512,2471,41,1400,1029,371,0.929604947517462,0.664948453608247,1.70654870261552,634,307,327,24,1.1,35.79,2.8,0,0,0,0,0,0,0.0487484365422774,52.8554726523243,5.57618306070361
8.7,"eps_greedy_SVM","SVM",5,14,2412,2376,36,1500,1124,376,0.932480662789468,0.65979381443299,1.73899555471484,651,317,334,17,1.1,38.34,3,0,0,0,0,0,0,0.0478471062709925,47.1503022395114,5.30287226243302
8.7,"eps_greedy_SVM","SVM",5,15,2312,2279,33,1600,1221,379,0.934077957335256,0.65979381443299,1.74985089886683,661,321,340,10,1.1,40.9,3.2,0,0,0,0,0,0,0.0445713329984556,39.0293570930524,4.85468846601093
8.7,"eps_greedy_SVM","SVM",5,16,2212,2190,22,1700,1310,390,0.931758077161594,0.654639175257732,1.76234600100532,699,334,365,38,1.1,43.46,3.4,0,0,0,0,0,0,0.0557019000213661,39.7555492147175,6.46037853092499
8.7,"eps_greedy_SVM","SVM",5,17,2112,2098,14,1800,1402,398,0.93217056531353,0.654639175257732,1.76559456506247,714,343,371,15,1.1,46.01,3.5,0,0,0,0,0,0,0.044367969412633,34.1657940187177,5.4408938793612
8.7,"eps_greedy_SVM","SVM",5,18,2012,2001,11,1900,1499,401,0.932923868144194,0.654639175257732,1.76072619769557,720,346,374,6,1.1,48.57,3.7,0,0,0,0,0,0,0.0310561082067438,29.025315127416,3.79225715227624
8.7,"eps_greedy_SVM","SVM",5,19,1912,1902,10,2000,1598,402,0.933140351287761,0.649484536082474,1.76072619769557,722,347,375,2,1.1,51.12,4,0,0,0,0,0,0,0.0248854910563253,24.0177900968557,2.70711714247591
8.7,"eps_greedy_SVM","SVM",5,20,1812,1802,10,2100,1698,402,0.932811238400578,0.644329896907217,1.76396878737825,727,349,378,5,1.1,53.68,4.2,0,0,0,0,0,0,0.0210238961535569,20.4651644420047,2.26787741237933
8.7,"eps_greedy_SVM","SVM",5,21,1712,1703,9,2200,1797,403,0.932903390008987,0.644329896907217,1.76072619769557,733,353,380,6,1.1,56.24,4.5,0,0,0,0,0,0,0.0174776693064595,15.7700341638117,1.79974480860247
8.7,"eps_greedy_SVM","SVM",5,22,1612,1604,8,2300,1896,404,0.931515264987058,0.639175257731959,1.77488716803649,753,365,388,20,1.1,58.79,4.7,0,0,0,0,0,0,0.0125512456614418,9.82685103910245,1.58933412121504
8.7,"eps_greedy_SVM","SVM",5,23,1512,1506,6,2400,1994,406,0.931643984694042,0.639175257731959,1.77325283362761,758,368,390,5,1.1,61.35,4.9,0,0,0,0,0,0,0.00949681579070026,7.84693285681242,1.04143289531469
8.7,"eps_greedy_SVM","SVM",5,24,1412,1406,6,2500,2094,406,0.931439203342017,0.639175257731959,1.77162150627377,759,369,390,1,1.1,63.91,5.2,0,0,0,0,0,0,0.00807927461384109,6.00509463434159,0.831322807823973
8.7,"eps_greedy_SVM","SVM",5,25,1312,1307,5,2600,2193,407,0.931395321623724,0.639175257731959,1.77162150627377,765,374,391,6,1,66.46,5.4,0,0,0,0,0,0,0.00561716024896454,3.8791979630566,0.679125820906554
8.7,"eps_greedy_SVM","SVM",5,26,1212,1209,3,2700,2291,409,0.930997460711221,0.639175257731959,1.77162150627377,772,377,395,7,1,69.02,5.6,0,0,0,0,0,0,0.00539691846246605,3.58765914521865,0.57251926871234
8.7,"eps_greedy_SVM","SVM",5,27,1112,1109,3,2800,2391,409,0.93070199047473,0.639175257731959,1.77325283362761,776,381,395,4,1,71.57,5.8,0,0,0,0,0,0,0.00482052301238435,2.83466005870236,0.505551854295186
8.7,"eps_greedy_SVM","SVM",5,28,1012,1010,2,2900,2490,410,0.931421650654711,0.628865979381443,1.77162150627377,782,384,398,6,1,74.13,6.1,0,0,0,0,0,0,0.00426054905104863,2.33117773238807,0.45553450928672
8.7,"eps_greedy_SVM","SVM",5,29,912,910,2,3000,2590,410,0.93212960904315,0.628865979381443,1.76999317768344,787,386,401,5,1,76.69,6.3,0,0,0,0,0,0,0.00393961290345895,1.89295820777717,0.416082058280905
8.7,"eps_greedy_SVM","SVM",5,30,812,810,2,3100,2690,410,0.93268544414151,0.628865979381443,1.76512610203445,789,386,403,2,1,79.24,6.6,0,0,0,0,0,0,0.00258492796952363,1.04065789217658,0.273991554540849
8.7,"eps_greedy_SVM","SVM",5,31,712,710,2,3200,2790,410,0.932858045566791,0.628865979381443,1.76836783959558,791,387,404,2,1,81.8,6.8,0,0,0,0,0,0,0.0022410888210225,0.785510627067562,0.247966747297521
8.7,"eps_greedy_SVM","SVM",5,32,612,610,2,3300,2890,410,0.93286682191045,0.628865979381443,1.77162150627377,791,388,403,0,1,84.36,7,0,0,0,0,0,0,0.00162373107094378,0.507826243605724,0.193662901858885
8.7,"eps_greedy_SVM","SVM",5,33,512,510,2,3400,2990,410,0.933086230501907,0.628865979381443,1.77325283362761,790,388,402,-1,1,86.91,7.3,0,0,0,0,0,0,0.000984356243630302,0.31691654370316,0.133451421737412
8.7,"eps_greedy_SVM","SVM",5,34,412,412,0,3500,3088,412,0.933042348783622,0.628865979381443,1.77325283362761,801,391,410,11,1,89.47,7.5,0,0,0,0,0,0,0.00113521953777913,0.335356114463244,0.139143762645557
8.7,"eps_greedy_SVM","SVM",5,35,312,312,0,3600,3188,412,0.933329042676456,0.623711340206186,1.77162150627377,805,393,412,4,1,92.02,7.7,0,0,0,0,0,0,0.000727011532419606,0.183341511502695,0.0898199771298585
8.7,"eps_greedy_SVM","SVM",5,36,212,212,0,3700,3288,412,0.933633289256606,0.618556701030928,1.77162150627377,810,395,415,5,1.1,94.58,8,0,0,0,0,0,0,0.0004089050662152,0.085264732035811,0.0530863655072114
8.7,"eps_greedy_SVM","SVM",5,37,112,112,0,3800,3388,412,0.933955088524073,0.618556701030928,1.77162150627377,815,397,418,5,1.1,97.14,8.2,0,0,0,0,0,0,0.000171006504011571,0.0284230068043159,0.0266137069950632
8.7,"eps_greedy_SVM","SVM",5,38,12,12,0,3900,3488,412,0.934183273459185,0.623711340206186,1.76999317768344,815,398,417,0,1,99.69,8.5,0,0,0,0,0,0,9.66432913253039e-05,0.00142531502646609,0.00142531502646609
8.7,"eps_greedy_SVM","SVM",5,39,0,0,0,3912,3500,412,0.934221304281703,0.623711340206186,1.77162150627377,815,398,417,0,1,100,8.5,0,0,0,0,0,0,0,0,0
8.7,"eps_greedy_SVM","SVM",6,0,3812,3396,416,100,91,9,0.894834643218441,0.524861878453039,1.74300481197647,23,9,14,0,1.6,2.56,10.1,0,0,0,0,0,0,0.282126655902208,341.67125683949,32.0732791941071
8.7,"eps_greedy_SVM","SVM",6,1,3712,3360,352,200,127,73,0.893486888179924,0.519337016574586,1.71312472948545,96,49,47,73,1,5.11,1.7,0,0,0,0,0,0,0.826678489006061,355.472294869345,89.2117778498427
8.7,"eps_greedy_SVM","SVM",6,2,3612,3318,294,300,169,131,0.885773869737763,0.580110497237569,1.67328461949742,165,85,80,69,0.9,7.67,1.3,0,0,0,0,0,0,0.457408510944326,143.963938326837,57.5654204659818
8.7,"eps_greedy_SVM","SVM",6,3,3512,3285,227,400,202,198,0.883034783285345,0.585635359116022,1.66332459200041,236,120,116,71,1,10.22,1,0,0,0,0,0,0,0.284816119579456,102.548931538051,44.3112922246211
8.7,"eps_greedy_SVM","SVM",6,4,3412,3239,173,500,248,252,0.880385962181925,0.624309392265193,1.63344450950938,321,160,161,85,1,12.78,1,0,0,0,0,0,0,0.164138425983933,99.7515722838644,29.2019971525521
8.7,"eps_greedy_SVM","SVM",6,5,3312,3180,132,600,307,293,0.871182009182173,0.629834254143646,1.61352445451537,406,200,206,85,1,15.34,1,0,0,0,0,0,0,0.112869068841187,66.2327836671874,18.5247930608216
8.7,"eps_greedy_SVM","SVM",6,6,3212,3100,112,700,387,313,0.876429849817142,0.646408839779006,1.61055568826971,445,215,230,39,1.1,17.89,1.2,0,0,0,0,0,0,0.0659181348984475,46.1860734770235,10.1184017391249
8.7,"eps_greedy_SVM","SVM",6,7,3112,3013,99,800,474,326,0.876999455295323,0.651933701657459,1.62049739004915,485,233,252,40,1.1,20.45,1.5,0,0,0,0,0,0,0.0531614717775529,52.14359236918,7.6059274988765
8.7,"eps_greedy_SVM","SVM",6,8,3012,2935,77,900,552,348,0.886450859855276,0.668508287292818,1.64189127316016,548,262,286,63,1.1,23.01,1.6,0,0,0,0,0,0,0.0489487972122062,62.8525520521576,6.08286127330151
8.7,"eps_greedy_SVM","SVM",6,9,2912,2848,64,1000,639,361,0.901504941249709,0.662983425414365,1.66026419716692,576,276,300,28,1.1,25.56,1.8,0,0,0,0,0,0,0.0467144036163246,65.6182011839929,5.55362505576518
8.7,"eps_greedy_SVM","SVM",6,10,2812,2759,53,1100,728,372,0.912146914636984,0.679558011049724,1.69008930250525,612,291,321,36,1.1,28.12,2,0,0,0,0,0,0,0.0533524614968902,79.8065424101056,6.54964090946442
8.7,"eps_greedy_SVM","SVM",6,11,2712,2664,48,1200,823,377,0.917113065131115,0.662983425414365,1.72149812276793,640,306,334,28,1.1,30.67,2.2,0,0,0,0,0,0,0.0451244921124847,63.9576803264486,5.1260434523218
8.7,"eps_greedy_SVM","SVM",6,12,2612,2571,41,1300,916,384,0.921979612481526,0.657458563535912,1.70159641036598,652,315,337,12,1.1,33.23,2.4,0,0,0,0,0,0,0.0471659183171135,64.7572642871417,5.58497991355921
8.7,"eps_greedy_SVM","SVM",6,13,2512,2478,34,1400,1009,391,0.930377402536788,0.651933701657459,1.72667914707091,671,327,344,19,1.1,35.79,2.6,0,0,0,0,0,0,0.0569760157609244,58.5839103394054,6.36498750032742
8.7,"eps_greedy_SVM","SVM",6,14,2412,2382,30,1500,1105,395,0.932646486654755,0.651933701657459,1.72985610962302,689,333,356,18,1.1,38.34,2.8,0,0,0,0,0,0,0.0563875844100333,50.073022230651,6.1130235418059
8.7,"eps_greedy_SVM","SVM",6,15,2312,2284,28,1600,1203,397,0.932300988249962,0.646408839779006,1.73979781140246,693,336,357,4,1.1,40.9,3,0,0,0,0,0,0,0.0460013472738759,40.9273406550173,5.13887698465475
8.7,"eps_greedy_SVM","SVM",6,16,2212,2189,23,1700,1298,402,0.932053536689776,0.646408839779006,1.74139983516987,710,342,368,17,1.1,43.46,3.2,0,0,0,0,0,0,0.0432399397853295,35.6212246231343,5.32357873126141
8.7,"eps_greedy_SVM","SVM",6,17,2112,2100,12,1800,1387,413,0.931852774103208,0.640883977900553,1.73304478447947,742,352,390,32,1.1,46.01,3.4,0,0,0,0,0,0,0.0370578257365059,36.8560194670512,4.90714506086758
8.7,"eps_greedy_SVM","SVM",6,18,2012,2000,12,1900,1487,413,0.931731382771792,0.640883977900553,1.72985610962302,743,352,391,1,1.1,48.57,3.6,0,0,0,0,0,0,0.0275346212479109,29.0676476042699,2.9786784763369
8.7,"eps_greedy_SVM","SVM",6,19,1912,1901,11,2000,1586,414,0.932901719710549,0.640883977900553,1.74139983516987,753,361,392,10,1.1,51.12,3.8,0,0,0,0,0,0,0.0204616325980584,20.7492323156389,2.34507873288703
8.7,"eps_greedy_SVM","SVM",6,20,1812,1801,11,2100,1686,414,0.932870593728135,0.640883977900553,1.73979781140246,759,365,394,6,1.1,53.68,4.1,0,0,0,0,0,0,0.0177555917321844,16.6170703983305,1.84900851013515
8.7,"eps_greedy_SVM","SVM",6,21,1712,1703,9,2200,1784,416,0.933564703135958,0.640883977900553,1.75644947719282,776,374,402,17,1.1,56.24,4.3,0,0,0,0,0,0,0.0122988496462086,10.3397299683938,1.48801674140653
8.7,"eps_greedy_SVM","SVM",6,22,1612,1604,8,2300,1883,417,0.93374990273132,0.640883977900553,1.75806386090348,777,375,402,1,1.1,58.79,4.5,0,0,0,0,0,0,0.0105147219851471,8.7676688075564,1.09427480086465
8.7,"eps_greedy_SVM","SVM",6,23,1512,1506,6,2400,1981,419,0.934367753482231,0.635359116022099,1.76130154757181,790,386,404,13,1,61.35,4.7,0,0,0,0,0,0,0.00841133334623023,6.55649440530722,0.987702575028027
8.7,"eps_greedy_SVM","SVM",6,24,1412,1406,6,2500,2081,419,0.934235468056972,0.640883977900553,1.76130154757181,791,386,405,1,1,63.91,5,0,0,0,0,0,0,0.00717153084946496,5.28634168040905,0.748382391170214
8.7,"eps_greedy_SVM","SVM",6,25,1312,1307,5,2600,2180,420,0.934110964127316,0.635359116022099,1.76130154757181,796,388,408,5,1.1,66.46,5.2,0,0,0,0,0,0,0.00707615889640993,4.57926405819424,0.724771230323136
8.7,"eps_greedy_SVM","SVM",6,26,1212,1207,5,2700,2280,420,0.935584779394606,0.635359116022099,1.76130154757181,803,393,410,7,1,69.02,5.4,0,0,0,0,0,0,0.00517626660076319,3.03838889198461,0.576826378380574
8.7,"eps_greedy_SVM","SVM",6,27,1112,1108,4,2800,2379,421,0.935917827406434,0.635359116022099,1.75968121496135,807,395,412,4,1,71.57,5.7,0,0,0,0,0,0,0.00518734726218489,2.74114512472594,0.539376114010337
8.7,"eps_greedy_SVM","SVM",6,28,1012,1008,4,2900,2479,421,0.936039218737847,0.635359116022099,1.75806386090348,813,399,414,6,1,74.13,5.9,0,0,0,0,0,0,0.0050732736257257,2.38166431829652,0.536001137678785
8.7,"eps_greedy_SVM","SVM",6,29,912,908,4,3000,2579,421,0.936113921095641,0.635359116022099,1.76292486697049,816,399,417,3,1,76.69,6.1,0,0,0,0,0,0,0.00360641183518803,1.43011680577558,0.384778941260401
8.7,"eps_greedy_SVM","SVM",6,30,812,808,4,3100,2679,421,0.936484320286364,0.635359116022099,1.75968121496135,818,399,419,2,1.1,79.24,6.4,0,0,0,0,0,0,0.00292936245616526,1.0055693395284,0.322674436613358
8.7,"eps_greedy_SVM","SVM",6,31,712,708,4,3200,2779,421,0.936431406116261,0.635359116022099,1.75968121496135,817,399,418,-1,1,81.8,6.6,0,0,0,0,0,0,0.00206583037564942,0.636736144812564,0.238802911282552
8.7,"eps_greedy_SVM","SVM",6,32,612,610,2,3300,2877,423,0.937141078515295,0.635359116022099,1.75968121496135,827,404,423,10,1,84.36,6.8,0,0,0,0,0,0,0.0017787654697349,0.553709050892936,0.216869376844706
8.7,"eps_greedy_SVM","SVM",6,33,512,510,2,3400,2977,423,0.937390086374605,0.635359116022099,1.76292486697049,827,404,423,0,1,86.91,7,0,0,0,0,0,0,0.00103768895866436,0.327782763660129,0.135901425983769
8.7,"eps_greedy_SVM","SVM",6,34,412,411,1,3500,3076,424,0.937962804451019,0.629834254143646,1.76799642508937,832,407,425,5,1,89.47,7.3,0,0,0,0,0,0,0.000870456875545544,0.265543317747608,0.11133635522883
8.7,"eps_greedy_SVM","SVM",6,35,312,312,0,3600,3175,425,0.93814644774726,0.629834254143646,1.77629636394076,838,409,429,6,1,92.02,7.5,0,0,0,0,0,0,0.000697313252717863,0.17691031248805,0.0833041033445013
8.7,"eps_greedy_SVM","SVM",6,36,212,212,0,3700,3275,425,0.938267839078675,0.635359116022099,1.77792898927527,837,409,428,-1,1,94.58,7.7,0,0,0,0,0,0,0.000378442796604181,0.0774360500924497,0.0476886203456836
8.7,"eps_greedy_SVM","SVM",6,37,112,112,0,3800,3375,425,0.938339428838227,0.629834254143646,1.77956461852023,843,412,431,6,1,97.14,7.9,0,0,0,0,0,0,0.000192392418274136,0.0306970243003371,0.0286978378169768
8.7,"eps_greedy_SVM","SVM",6,38,12,12,0,3900,3475,425,0.93830519025757,0.629834254143646,1.77956461852023,844,412,432,1,1,99.69,8.2,0,0,0,0,0,0,0.000146848478321177,0.00203542557770758,0.00203542557770758
8.7,"eps_greedy_SVM","SVM",6,39,0,0,0,3912,3487,425,0.938373667418881,0.629834254143646,1.77956461852023,845,412,433,1,1.1,100,8.2,0,0,0,0,0,0,0,0,0
8.7,"eps_greedy_SVM","SVM",7,0,3812,3423,389,100,95,5,0.835378981305163,0.424528301886792,1.66670724284845,28,5,23,0,4.6,2.56,19,0,0,0,0,0,0,0.0821781270840772,211.908162702491,9.8099240710381
8.7,"eps_greedy_SVM","SVM",7,1,3712,3369,343,200,149,51,0.899385494201131,0.55188679245283,1.75217240782413,104,49,55,76,1.1,5.11,2.9,0,0,0,0,0,0,0.717992651395468,355.837283288539,77.9857433062743
8.7,"eps_greedy_SVM","SVM",7,2,3612,3341,271,300,177,123,0.912518121429792,0.575471698113208,1.74576592735677,159,78,81,55,1,7.67,1.4,0,0,0,0,0,0,0.594397246001795,240.728627732572,72.3211703956222
8.7,"eps_greedy_SVM","SVM",7,3,3512,3309,203,400,209,191,0.912116474813886,0.589622641509434,1.74852024786933,220,112,108,61,1,10.22,1.1,0,0,0,0,0,0,0.500154349660539,208.368958558748,65.5015622914781
8.7,"eps_greedy_SVM","SVM",7,4,3412,3262,150,500,256,244,0.915372922797275,0.60377358490566,1.74852024786933,308,155,153,88,1,12.78,1,0,0,0,0,0,0,0.314599850680735,187.620609389918,46.0546177952437
8.7,"eps_greedy_SVM","SVM",7,5,3312,3201,111,600,317,283,0.895654372944421,0.608490566037736,1.6705917036626,392,197,195,84,1,15.34,1.1,0,0,0,0,0,0,0.146106305222017,114.549889984496,22.24389253768
8.7,"eps_greedy_SVM","SVM",7,6,3212,3124,88,700,394,306,0.894695559979221,0.617924528301887,1.68216407797352,463,221,242,71,1.1,17.89,1.3,0,0,0,0,0,0,0.0925407017808982,101.417169598577,13.4494935194007
8.7,"eps_greedy_SVM","SVM",7,7,3112,3042,70,800,476,324,0.88719139475505,0.608490566037736,1.63968518711561,506,240,266,43,1.1,20.45,1.5,0,0,0,0,0,0,0.0617901758454993,96.5060174215787,10.5492494568656
8.7,"eps_greedy_SVM","SVM",7,8,3012,2950,62,900,568,332,0.897970940799714,0.627358490566038,1.66364062418635,520,250,270,14,1.1,23.01,1.7,0,0,0,0,0,0,0.0466855010058346,67.5273151553553,5.63086882486516
8.7,"eps_greedy_SVM","SVM",7,9,2912,2860,52,1000,658,342,0.902352540245804,0.622641509433962,1.6621115427303,549,262,287,29,1.1,25.56,1.9,0,0,0,0,0,0,0.0558255001303721,89.0859987540288,6.13351759608141
8.7,"eps_greedy_SVM","SVM",7,10,2812,2762,50,1100,756,344,0.913509390687193,0.617924528301887,1.71614719065986,567,274,293,18,1.1,28.12,2.2,0,0,0,0,0,0,0.0422230494907464,53.3034133030201,5.09764702711759
8.7,"eps_greedy_SVM","SVM",7,11,2712,2670,42,1200,848,352,0.922019700969356,0.613207547169811,1.72147266925638,583,280,303,16,1.1,30.67,2.4,0,0,0,0,0,0,0.0380360289758334,53.6873312093614,4.36131475247328
8.7,"eps_greedy_SVM","SVM",7,12,2612,2573,39,1300,945,355,0.924426875973685,0.60377358490566,1.71516690856313,600,291,309,17,1.1,33.23,2.7,0,0,0,0,0,0,0.0392126179680744,53.9105900813729,4.16278560754121
8.7,"eps_greedy_SVM","SVM",7,13,2512,2477,35,1400,1041,359,0.927065302059882,0.599056603773585,1.75862608151777,617,297,320,17,1.1,35.79,2.9,0,0,0,0,0,0,0.0499468356849398,46.9045571692604,5.78431900410248
8.7,"eps_greedy_SVM","SVM",7,14,2412,2378,34,1500,1140,360,0.927368227453679,0.599056603773585,1.76549617260593,622,300,322,5,1.1,38.34,3.2,0,0,0,0,0,0,0.0403204592389672,37.0388034016747,4.56339032863672
8.7,"eps_greedy_SVM","SVM",7,15,2312,2285,27,1600,1233,367,0.92919389388955,0.599056603773585,1.76875054343101,646,309,337,24,1.1,40.9,3.4,0,0,0,0,0,0,0.0438336808475457,34.8003053347884,5.15940083538055
8.7,"eps_greedy_SVM","SVM",7,16,2212,2196,16,1700,1322,378,0.93040830015578,0.60377358490566,1.76549617260593,676,321,355,30,1.1,43.46,3.5,0,0,0,0,0,0,0.0445106679308634,37.0244089075189,5.35936188395026
8.7,"eps_greedy_SVM","SVM",7,17,2112,2100,12,1800,1418,382,0.931142623766652,0.60377358490566,1.76712185968936,684,324,360,8,1.1,46.01,3.7,0,0,0,0,0,0,0.027080555854632,27.8297718630248,3.32992848965633
8.7,"eps_greedy_SVM","SVM",7,18,2012,2000,12,1900,1518,382,0.931175080058842,0.60377358490566,1.76712185968936,685,324,361,1,1.1,48.57,4,0,0,0,0,0,0,0.0202785111474403,22.1770611016243,2.21813377648833
8.7,"eps_greedy_SVM","SVM",7,19,1912,1902,10,2000,1616,384,0.93265048900813,0.608490566037736,1.76712185968936,690,329,361,5,1.1,51.12,4.2,0,0,0,0,0,0,0.0213499484243857,20.6094753589634,2.16468848448868
8.7,"eps_greedy_SVM","SVM",7,20,1812,1803,9,2100,1715,385,0.931252163752787,0.599056603773585,1.77725415181289,725,351,374,35,1.1,53.68,4.5,0,0,0,0,0,0,0.0178932174969994,10.4408907520521,2.35113288376282
8.7,"eps_greedy_SVM","SVM",7,21,1712,1704,8,2200,1814,386,0.931319781028188,0.599056603773585,1.77398413497422,728,353,375,3,1.1,56.24,4.7,0,0,0,0,0,0,0.0103296267804294,7.40328088062559,1.28943038590041
8.7,"eps_greedy_SVM","SVM",7,22,1612,1605,7,2300,1913,387,0.931368465466479,0.599056603773585,1.77398413497422,729,351,378,1,1.1,58.79,4.9,0,0,0,0,0,0,0.00841220872157043,6.29083302901922,0.933376617292473
8.7,"eps_greedy_SVM","SVM",7,23,1512,1507,5,2400,2011,389,0.931555089146589,0.60377358490566,1.77561763786094,737,354,383,8,1.1,61.35,5.2,0,0,0,0,0,0,0.00764215293140406,5.86664345654271,0.822533740478316
8.7,"eps_greedy_SVM","SVM",7,24,1412,1407,5,2500,2111,389,0.931546975073541,0.60377358490566,1.77398413497422,734,354,380,-3,1.1,63.91,5.4,0,0,0,0,0,0,0.00751430318945581,5.38680873116819,0.769241207526266
8.7,"eps_greedy_SVM","SVM",7,25,1312,1307,5,2600,2211,389,0.931206184005514,0.599056603773585,1.77725415181289,741,359,382,7,1.1,66.46,5.7,0,0,0,0,0,0,0.00557855197730925,3.68169979966397,0.627024122668042
8.7,"eps_greedy_SVM","SVM",7,26,1212,1207,5,2700,2311,389,0.931246754370756,0.599056603773585,1.77398413497422,742,359,383,1,1.1,69.02,5.9,0,0,0,0,0,0,0.00471863574298323,2.7169670750885,0.483550489827452
8.7,"eps_greedy_SVM","SVM",7,27,1112,1107,5,2800,2411,389,0.931866128613443,0.589622641509434,1.77398413497422,745,362,383,3,1.1,71.57,6.2,0,0,0,0,0,0,0.00390901418467906,2.04441209491143,0.433000175358469
8.7,"eps_greedy_SVM","SVM",7,28,1012,1007,5,2900,2511,389,0.931752531590767,0.589622641509434,1.7707261292167,747,362,385,2,1.1,74.13,6.5,0,0,0,0,0,0,0.00356825880547881,1.55967811346709,0.369047321224481
8.7,"eps_greedy_SVM","SVM",7,29,912,907,5,3000,2611,389,0.932244785355697,0.589622641509434,1.77398413497422,751,364,387,4,1.1,76.69,6.7,0,0,0,0,0,0,0.00263530230172321,0.995115936465355,0.286444877926758
8.7,"eps_greedy_SVM","SVM",7,30,812,808,4,3100,2710,390,0.93243140903581,0.589622641509434,1.77561763786094,757,367,390,6,1.1,79.24,6.9,0,0,0,0,0,0,0.00225065296539757,0.734302093944032,0.250081200971553
8.7,"eps_greedy_SVM","SVM",7,31,712,708,4,3200,2810,390,0.932478741128592,0.589622641509434,1.76910160983209,755,367,388,-2,1.1,81.8,7.2,0,0,0,0,0,0,0.00162030358304573,0.473254136913631,0.192719146238263
8.7,"eps_greedy_SVM","SVM",7,32,612,610,2,3300,2908,392,0.932500378656722,0.589622641509434,1.77561763786094,761,370,391,6,1.1,84.36,7.4,0,0,0,0,0,0,0.00122676958770868,0.387738362300037,0.163338389800452
8.7,"eps_greedy_SVM","SVM",7,33,512,511,1,3400,3007,393,0.932477388783086,0.589622641509434,1.77398413497422,767,373,394,6,1.1,86.91,7.7,0,0,0,0,0,0,0.000946751957584543,0.301706151114345,0.124844409550746
8.7,"eps_greedy_SVM","SVM",7,34,412,412,0,3500,3106,394,0.932766790721807,0.584905660377358,1.77398413497422,772,377,395,5,1,89.47,7.9,0,0,0,0,0,0,0.000689966131227459,0.208880626954293,0.0847820127359057
8.7,"eps_greedy_SVM","SVM",7,35,312,312,0,3600,3206,394,0.93313868573652,0.584905660377358,1.77235363485017,773,379,394,1,1,92.02,8.1,0,0,0,0,0,0,0.000482517187364916,0.123291260831902,0.058174973133046
8.7,"eps_greedy_SVM","SVM",7,36,212,212,0,3700,3306,394,0.933012917604271,0.589622641509434,1.77398413497422,778,381,397,5,1,94.58,8.4,0,0,0,0,0,0,0.000322146449285342,0.0650873503128297,0.0397615348005287
8.7,"eps_greedy_SVM","SVM",7,37,112,112,0,3800,3406,394,0.933112991171867,0.589622641509434,1.77725415181289,776,381,395,-2,1,97.14,8.6,0,0,0,0,0,0,8.87360768278524e-05,0.0159458319195242,0.0150194078556123
8.7,"eps_greedy_SVM","SVM",7,38,12,12,0,3900,3506,394,0.933253635104705,0.589622641509434,1.78575776019477,780,381,399,4,1,99.69,8.9,0,0,0,0,0,0,6.67806201487654e-05,0.000983064644266569,0.000983064644266569
8.7,"eps_greedy_SVM","SVM",7,39,0,0,0,3912,3518,394,0.933130571663472,0.589622641509434,1.78411341603252,780,381,399,0,1,100,8.9,0,0,0,0,0,0,0,0,0
8.7,"eps_greedy_SVM","SVM",8,0,3812,3428,384,100,89,11,0.908722280313421,0.578199052132701,1.7600454277415,32,11,21,0,1.9,2.56,8.1,0,0,0,0,0,0,0.290900071072158,386.018460423964,33.7053799950705
8.7,"eps_greedy_SVM","SVM",8,1,3712,3401,311,200,116,84,0.908515867950399,0.568720379146919,1.71101797814422,102,53,49,70,0.9,5.11,1.4,0,0,0,0,0,0,0.670390434081587,392.755408894926,75.6976493915822
8.7,"eps_greedy_SVM","SVM",8,2,3612,3367,245,300,150,150,0.910430614212567,0.587677725118483,1.74827888401052,163,84,79,61,0.9,7.67,1,0,0,0,0,0,0,0.527004549348721,293.417301233054,66.0760181974531
8.7,"eps_greedy_SVM","SVM",8,3,3512,3323,189,400,194,206,0.906783090481942,0.611374407582938,1.74295760805469,243,123,120,80,1,10.22,0.9,0,0,0,0,0,0,0.364878556308059,255.168466246155,51.8278966505614
8.7,"eps_greedy_SVM","SVM",8,4,3412,3277,135,500,240,260,0.904824888985436,0.601895734597156,1.73441369821128,336,170,166,93,1,12.78,0.9,0,0,0,0,0,0,0.257700278989963,193.588995332756,33.2377623022115
8.7,"eps_greedy_SVM","SVM",8,5,3312,3203,109,600,314,286,0.889675307921073,0.616113744075829,1.64594060787332,404,201,203,68,1,15.34,1.1,0,0,0,0,0,0,0.16153617132047,183.374621111228,24.0184708967852
8.7,"eps_greedy_SVM","SVM",8,6,3212,3120,92,700,397,303,0.892747049796982,0.649289099526066,1.63590744354614,459,220,239,55,1.1,17.89,1.3,0,0,0,0,0,0,0.0916659503082777,113.804450842097,12.8435025279151
8.7,"eps_greedy_SVM","SVM",8,7,3112,3041,71,800,476,324,0.891382283844155,0.639810426540284,1.62184807939043,518,243,275,59,1.1,20.45,1.5,0,0,0,0,0,0,0.0760858625793961,132.918451124861,10.8305554260557
8.7,"eps_greedy_SVM","SVM",8,8,3012,2952,60,900,565,335,0.890663914501826,0.635071090047393,1.62738709227767,549,257,292,31,1.1,23.01,1.7,0,0,0,0,0,0,0.0694076204428044,115.340199696615,7.95387569693476
8.7,"eps_greedy_SVM","SVM",8,9,2912,2858,54,1000,659,341,0.902354730509654,0.639810426540284,1.65294814608308,568,269,299,19,1.1,25.56,1.9,0,0,0,0,0,0,0.0606323502786893,93.0902276946901,6.57152075037129
8.7,"eps_greedy_SVM","SVM",8,10,2812,2760,52,1100,757,343,0.905440052146278,0.635071090047393,1.67850919988849,577,276,301,9,1.1,28.12,2.2,0,0,0,0,0,0,0.0489287380308746,66.0956331273363,5.35176564111437
8.7,"eps_greedy_SVM","SVM",8,11,2712,2666,46,1200,851,349,0.907790708727708,0.635071090047393,1.66146849735155,592,285,307,15,1.1,30.67,2.4,0,0,0,0,0,0,0.0505274237633561,69.9879700609228,5.6268651561254
8.7,"eps_greedy_SVM","SVM",8,12,2612,2573,39,1300,944,356,0.924037534458643,0.639810426540284,1.73975069433242,615,298,317,23,1.1,33.23,2.7,0,0,0,0,0,0,0.0549173110122706,59.5198040224994,6.35459275218133
8.7,"eps_greedy_SVM","SVM",8,13,2512,2480,32,1400,1037,363,0.929439563274889,0.639810426540284,1.7600454277415,634,308,326,19,1.1,35.79,2.9,0,0,0,0,0,0,0.0584496108985496,55.3821465693356,6.25554391571722
8.7,"eps_greedy_SVM","SVM",8,14,2412,2383,29,1500,1134,366,0.930045220603204,0.630331753554502,1.75680707368862,646,313,333,12,1.1,38.34,3.1,0,0,0,0,0,0,0.0500914465225007,46.027951793902,5.51920081469557
8.7,"eps_greedy_SVM","SVM",8,15,2312,2285,27,1600,1232,368,0.930601990792917,0.639810426540284,1.75680707368862,649,313,336,3,1.1,40.9,3.3,0,0,0,0,0,0,0.0435055982740799,40.6246709861963,4.86535307332207
8.7,"eps_greedy_SVM","SVM",8,16,2212,2191,21,1700,1326,374,0.928980567362404,0.635071090047393,1.74988871723705,674,322,352,25,1.1,43.46,3.5,0,0,0,0,0,0,0.0387060899684827,34.9991502768525,4.87378052611247
8.7,"eps_greedy_SVM","SVM",8,17,2112,2099,13,1800,1418,382,0.928510707641331,0.630331753554502,1.75150151789809,696,332,364,22,1.1,46.01,3.7,0,0,0,0,0,0,0.0347220619264818,34.7359563753997,4.19435438073619
8.7,"eps_greedy_SVM","SVM",8,18,2012,2002,10,1900,1515,385,0.929311913524081,0.630331753554502,1.75150151789809,708,338,370,12,1.1,48.57,3.9,0,0,0,0,0,0,0.0290307797049908,30.978882036516,3.21088673452435
8.7,"eps_greedy_SVM","SVM",8,19,1912,1902,10,2000,1615,385,0.929352652806254,0.625592417061611,1.7600454277415,707,339,368,-1,1.1,51.12,4.2,0,0,0,0,0,0,0.0213132235678885,22.6211032996191,2.30294937570692
8.7,"eps_greedy_SVM","SVM",8,20,1812,1802,10,2100,1715,385,0.929059329974603,0.62085308056872,1.7600454277415,708,341,367,1,1.1,53.68,4.5,0,0,0,0,0,0,0.0178594918459859,17.6000705253117,1.87312263151205
8.7,"eps_greedy_SVM","SVM",8,21,1712,1705,7,2200,1812,388,0.930210893684053,0.62085308056872,1.76696080228326,731,356,375,23,1.1,56.24,4.7,0,0,0,0,0,0,0.0133422316197589,9.59317644182738,1.66967917417167
8.7,"eps_greedy_SVM","SVM",8,22,1612,1606,6,2300,1911,389,0.930037072746779,0.62085308056872,1.75886290676409,731,357,374,0,1,58.79,4.9,0,0,0,0,0,0,0.00897968043657959,7.58320274322228,1.05829634479097
8.7,"eps_greedy_SVM","SVM",8,23,1512,1507,5,2400,2010,390,0.930186450114751,0.616113744075829,1.76533526336672,732,358,374,1,1,61.35,5.2,0,0,0,0,0,0,0.00892540937642467,7.57611737956948,0.923664860047759
8.7,"eps_greedy_SVM","SVM",8,24,1412,1408,4,2500,2109,391,0.931405912627828,0.616113744075829,1.76533526336672,748,364,384,16,1.1,63.91,5.4,0,0,0,0,0,0,0.00700321531706917,5.57317197086589,0.843038136344591
8.7,"eps_greedy_SVM","SVM",8,25,1312,1308,4,2600,2209,391,0.931297274542031,0.616113744075829,1.76533526336672,745,364,381,-3,1,66.46,5.6,0,0,0,0,0,0,0.00673225919324033,4.84936190513872,0.683249964575316
8.7,"eps_greedy_SVM","SVM",8,26,1212,1208,4,2700,2309,391,0.931704667363768,0.62085308056872,1.76533526336672,761,372,389,16,1,69.02,5.9,0,0,0,0,0,0,0.00445995171752283,3.08622658108144,0.520725877867618
8.7,"eps_greedy_SVM","SVM",8,27,1112,1108,4,2800,2409,391,0.931839106994941,0.62085308056872,1.76696080228326,764,373,391,3,1,71.57,6.2,0,0,0,0,0,0,0.00429223839005694,2.58501238106026,0.439112742386212
8.7,"eps_greedy_SVM","SVM",8,28,1012,1009,3,2900,2508,392,0.932155515419809,0.625592417061611,1.7685893375849,771,378,393,7,1,74.13,6.4,0,0,0,0,0,0,0.0035669076291347,2.01728487001687,0.395588120471774
8.7,"eps_greedy_SVM","SVM",8,29,912,909,3,3000,2608,392,0.932025149716852,0.625592417061611,1.7685893375849,771,377,394,0,1,76.69,6.7,0,0,0,0,0,0,0.00299019522134291,1.45557636254252,0.316110692301976
8.7,"eps_greedy_SVM","SVM",8,30,812,809,3,3100,2708,392,0.9320916905444,0.62085308056872,1.76371271257318,771,378,393,0,1,79.24,6.9,0,0,0,0,0,0,0.00237760546711532,1.02810034306364,0.257636708539937
8.7,"eps_greedy_SVM","SVM",8,31,712,710,2,3200,2807,393,0.932037371501505,0.62085308056872,1.76696080228326,776,379,397,5,1,81.8,7.1,0,0,0,0,0,0,0.00202139364721081,0.826427415289514,0.225141959867743
8.7,"eps_greedy_SVM","SVM",8,32,612,610,2,3300,2907,393,0.932186748869475,0.62085308056872,1.76696080228326,775,380,395,-1,1,84.36,7.4,0,0,0,0,0,0,0.00169122641931604,0.61561718519883,0.186980008970028
8.7,"eps_greedy_SVM","SVM",8,33,512,511,1,3400,3006,394,0.932087616616192,0.62085308056872,1.76533526336672,780,382,398,5,1,86.91,7.6,0,0,0,0,0,0,0.00156586380667659,0.538489299121525,0.177640451781373
8.7,"eps_greedy_SVM","SVM",8,34,412,412,0,3500,3105,395,0.931980336506476,0.62085308056872,1.76371271257318,781,384,397,1,1,89.47,7.9,0,0,0,0,0,0,0.00142488827039075,0.436658579089108,0.166896049279463
8.7,"eps_greedy_SVM","SVM",8,35,312,312,0,3600,3205,395,0.93250994717473,0.62085308056872,1.77549684480637,788,386,402,7,1,92.02,8.1,0,0,0,0,0,0,0.000943837186625918,0.239260603024737,0.112999807834737
8.7,"eps_greedy_SVM","SVM",8,36,212,212,0,3700,3305,395,0.932668830375207,0.62085308056872,1.77386345304482,790,386,404,2,1,94.58,8.4,0,0,0,0,0,0,0.000554197694494792,0.118760952263524,0.0716529888474899
8.7,"eps_greedy_SVM","SVM",8,37,112,112,0,3800,3405,395,0.93298388082402,0.62085308056872,1.77713324742831,793,386,407,3,1.1,97.14,8.6,0,0,0,0,0,0,0.000302204550985255,0.0448705105572833,0.0415799843371851
8.7,"eps_greedy_SVM","SVM",8,38,12,12,0,3900,3505,395,0.933135974144135,0.616113744075829,1.77223306384165,796,388,408,3,1.1,99.69,8.9,0,0,0,0,0,0,0.000161586387228936,0.00289729490807813,0.00289729490807813
8.7,"eps_greedy_SVM","SVM",8,39,0,0,0,3912,3517,395,0.933106098670541,0.616113744075829,1.76898126005478,799,389,410,3,1.1,100,8.9,0,0,0,0,0,0,0,0,0
8.7,"eps_greedy_SVM","SVM",9,0,3812,3417,395,100,91,9,0.907555008636557,0.569306930693069,1.74029292330155,26,9,17,0,1.9,2.56,10.1,0,0,0,0,0,0,0.2185421421063,294.060743148403,23.4529229963418
8.7,"eps_greedy_SVM","SVM",9,1,3712,3391,321,200,117,83,0.919825406143815,0.569306930693069,1.77672813152875,92,46,46,66,1,5.11,1.4,0,0,0,0,0,0,0.628424995371959,264.938163771793,76.9381830721159
8.7,"eps_greedy_SVM","SVM",9,2,3612,3357,255,300,151,149,0.915835939352212,0.589108910891089,1.76543952737815,155,80,75,63,0.9,7.67,1,0,0,0,0,0,0,0.436468852155285,253.197554823131,56.3686809211532
8.7,"eps_greedy_SVM","SVM",9,3,3512,3301,211,400,207,193,0.907473158946466,0.613861386138614,1.74029292330155,249,127,122,94,1,10.22,1.1,0,0,0,0,0,0,0.205569598737839,110.302333653559,33.4540978929792
8.7,"eps_greedy_SVM","SVM",9,4,3412,3252,160,500,256,244,0.896821409621021,0.638613861386139,1.69989443797321,338,169,169,89,1,12.78,1,0,0,0,0,0,0,0.178489755674153,132.070351829353,24.4884059849332
8.7,"eps_greedy_SVM","SVM",9,5,3312,3181,131,600,327,273,0.903550018627855,0.658415841584158,1.67319452533489,398,194,204,60,1.1,15.34,1.2,0,0,0,0,0,0,0.132680010748941,113.52308719964,16.9482482723097
8.7,"eps_greedy_SVM","SVM",9,6,3212,3110,102,700,398,302,0.909527868408275,0.658415841584158,1.6716580748984,466,226,240,68,1.1,17.89,1.3,0,0,0,0,0,0,0.0998195946630475,106.41987038961,13.3269456597348
8.7,"eps_greedy_SVM","SVM",9,7,3112,3037,75,800,471,329,0.901745091840996,0.673267326732673,1.63759464181712,532,253,279,66,1.1,20.45,1.4,0,0,0,0,0,0,0.096493085925597,155.385151829412,14.844417465037
8.7,"eps_greedy_SVM","SVM",9,8,3012,2952,60,900,556,344,0.906335730494369,0.678217821782178,1.65691748567681,557,270,287,25,1.1,23.01,1.6,0,0,0,0,0,0,0.0801337163572659,131.289607540471,9.26162768177778
8.7,"eps_greedy_SVM","SVM",9,9,2912,2859,53,1000,649,351,0.914040890976207,0.678217821782178,1.67319452533489,592,284,308,35,1.1,25.56,1.8,0,0,0,0,0,0,0.0681996346075852,109.165842151534,7.54832737309796
8.7,"eps_greedy_SVM","SVM",9,10,2812,2763,49,1100,745,355,0.925607098908295,0.683168316831683,1.71036643682768,609,293,316,17,1.1,28.12,2.1,0,0,0,0,0,0,0.059716966325306,83.5852943958379,6.50948865504366
8.7,"eps_greedy_SVM","SVM",9,11,2712,2672,40,1200,836,364,0.929860460390406,0.678217821782178,1.70409561579439,632,306,326,23,1.1,30.67,2.3,0,0,0,0,0,0,0.0596940415241159,82.6080849631735,6.65216724647604
8.7,"eps_greedy_SVM","SVM",9,12,2612,2574,38,1300,934,366,0.932558677760606,0.673267326732673,1.71769437973209,643,311,332,11,1.1,33.23,2.6,0,0,0,0,0,0,0.0502636314868677,63.3353524126838,5.42455633710587
8.7,"eps_greedy_SVM","SVM",9,13,2512,2478,34,1400,1030,370,0.934921029161078,0.673267326732673,1.74599907092825,651,315,336,8,1.1,35.79,2.8,0,0,0,0,0,0,0.0502542725280784,60.5799688108983,5.46460062965913
8.7,"eps_greedy_SVM","SVM",9,14,2412,2381,31,1500,1127,373,0.937909954051292,0.673267326732673,1.7621942341293,670,321,349,19,1.1,38.34,3,0,0,0,0,0,0,0.0471398038316109,51.6712764210007,5.30870564210927
8.7,"eps_greedy_SVM","SVM",9,15,2312,2286,26,1600,1222,378,0.937304548584854,0.678217821782178,1.76543952737815,678,325,353,8,1.1,40.9,3.2,0,0,0,0,0,0,0.0476422484525394,48.7841760402909,5.69486273378862
8.7,"eps_greedy_SVM","SVM",9,16,2212,2194,18,1700,1314,386,0.938087765447018,0.683168316831683,1.7549072294534,709,333,376,31,1.1,43.46,3.4,0,0,0,0,0,0,0.0406432540343641,45.5161234126594,4.81166703303895
8.7,"eps_greedy_SVM","SVM",9,17,2112,2097,15,1800,1411,389,0.938989523239681,0.678217821782178,1.76543952737815,713,342,371,4,1.1,46.01,3.6,0,0,0,0,0,0,0.0312022644212741,32.5109901926895,3.39730372315959
8.7,"eps_greedy_SVM","SVM",9,18,2012,1999,13,1900,1509,391,0.939699357621065,0.663366336633663,1.77599123967696,724,352,372,11,1.1,48.57,3.9,0,0,0,0,0,0,0.0210638970746097,19.3767173711197,2.61141993376229
8.7,"eps_greedy_SVM","SVM",9,19,1912,1900,12,2000,1608,392,0.939764272892524,0.663366336633663,1.77272354650368,727,353,374,3,1.1,51.12,4.1,0,0,0,0,0,0,0.0172922978522581,16.9198030949436,1.91123628444801
8.7,"eps_greedy_SVM","SVM",9,20,1812,1801,11,2100,1707,393,0.93995055149758,0.653465346534653,1.77599123967696,727,354,373,0,1.1,53.68,4.3,0,0,0,0,0,0,0.0159644430569239,14.088578892282,1.61602995434813
8.7,"eps_greedy_SVM","SVM",9,21,1712,1701,11,2200,1807,393,0.938683292502575,0.648514851485149,1.78327224987692,747,364,383,20,1.1,56.24,4.6,0,0,0,0,0,0,0.0114562979620432,8.63777753408622,1.46612889727754
8.7,"eps_greedy_SVM","SVM",9,22,1612,1604,8,2300,1904,396,0.938787721417531,0.648514851485149,1.77999417588818,756,368,388,9,1.1,58.79,4.8,0,0,0,0,0,0,0.00898105297770005,7.26285380626329,0.991704838606386
8.7,"eps_greedy_SVM","SVM",9,23,1512,1504,8,2400,2004,396,0.938858281495204,0.648514851485149,1.78327224987692,757,368,389,1,1.1,61.35,5.1,0,0,0,0,0,0,0.00783930974302223,5.77402817937481,0.803194140931243
8.7,"eps_greedy_SVM","SVM",9,24,1412,1404,8,2500,2104,396,0.938680470099467,0.653465346534653,1.78163170502883,764,375,389,7,1,63.91,5.3,0,0,0,0,0,0,0.00663816414709702,4.70355993883391,0.736133190105801
8.7,"eps_greedy_SVM","SVM",9,25,1312,1306,6,2600,2202,398,0.938794777425297,0.653465346534653,1.78327224987692,772,377,395,8,1,66.46,5.5,0,0,0,0,0,0,0.0061937902109749,3.86700091898182,0.657958571948045
8.7,"eps_greedy_SVM","SVM",9,26,1212,1206,6,2700,2302,398,0.938499836300627,0.648514851485149,1.77835965414723,779,379,400,7,1.1,69.02,5.8,0,0,0,0,0,0,0.00506593015328464,2.98461643493344,0.548143524382209
8.7,"eps_greedy_SVM","SVM",9,27,1112,1106,6,2800,2402,398,0.938357304943728,0.648514851485149,1.77999417588818,778,379,399,-1,1.1,71.57,6,0,0,0,0,0,0,0.00435442253250894,2.20815469030312,0.450893814335698
8.7,"eps_greedy_SVM","SVM",9,28,1012,1006,6,2900,2502,398,0.938169615137119,0.648514851485149,1.77835965414723,777,381,396,-1,1,74.13,6.3,0,0,0,0,0,0,0.00382937662333126,1.72758524745026,0.411007311898422
8.7,"eps_greedy_SVM","SVM",9,29,912,907,5,3000,2601,399,0.93834178172664,0.648514851485149,1.78163170502883,781,382,399,4,1,76.69,6.5,0,0,0,0,0,0,0.00360536315626915,1.48602634511928,0.393092147384426
8.7,"eps_greedy_SVM","SVM",9,30,812,808,4,3100,2700,400,0.938370005757709,0.653465346534653,1.78163170502883,785,385,400,4,1,79.24,6.8,0,0,0,0,0,0,0.00338372064320368,1.27070676526917,0.372923637231194
8.7,"eps_greedy_SVM","SVM",9,31,712,708,4,3200,2800,400,0.938290978470716,0.648514851485149,1.77672813152875,786,385,401,1,1,81.8,7,0,0,0,0,0,0,0.00218087396276813,0.714555617921181,0.242683703311088
8.7,"eps_greedy_SVM","SVM",9,32,612,609,3,3300,2899,401,0.938429276222954,0.648514851485149,1.78163170502883,792,386,406,6,1.1,84.36,7.2,0,0,0,0,0,0,0.00185907704649894,0.565906796793378,0.220929750880129
8.7,"eps_greedy_SVM","SVM",9,33,512,509,3,3400,2999,401,0.938652246068399,0.648514851485149,1.77835965414723,792,386,406,0,1.1,86.91,7.5,0,0,0,0,0,0,0.000997723063310186,0.319494499452317,0.134179984316647
8.7,"eps_greedy_SVM","SVM",9,34,412,409,3,3500,3099,401,0.938736918161606,0.648514851485149,1.78163170502883,796,387,409,4,1.1,89.47,7.7,0,0,0,0,0,0,0.000714010352658143,0.208928592864253,0.0902137780735161
8.7,"eps_greedy_SVM","SVM",9,35,312,312,0,3600,3196,404,0.939772740101838,0.653465346534653,1.79053986355397,807,396,411,11,1,92.02,7.9,0,0,0,0,0,0,0.000980260196287573,0.249847880094007,0.124483292452152
8.7,"eps_greedy_SVM","SVM",9,36,212,212,0,3700,3296,404,0.940039457195439,0.653465346534653,1.78889414676762,814,396,418,7,1.1,94.58,8.2,0,0,0,0,0,0,0.000535412944991895,0.114504671882561,0.0722021368241588
8.7,"eps_greedy_SVM","SVM",9,37,112,112,0,3800,3396,404,0.940213034986513,0.653465346534653,1.79053986355397,814,397,417,0,1.1,97.14,8.4,0,0,0,0,0,0,0.000258147672882982,0.0418435870130976,0.039033390884388
8.7,"eps_greedy_SVM","SVM",9,38,12,12,0,3900,3496,404,0.940317463901469,0.653465346534653,1.78725145241797,812,397,415,-2,1,99.69,8.7,0,0,0,0,0,0,0.000172190537890758,0.00258611302254672,0.00258611302254672
8.7,"eps_greedy_SVM","SVM",9,39,0,0,0,3912,3508,404,0.940369678358946,0.653465346534653,1.78889414676762,813,397,416,1,1,100,8.7,0,0,0,0,0,0,0,0,0
8.7,"eps_greedy_SVM","SVM",10,0,3812,3411,401,100,89,11,0.897027159858188,0.541237113402062,1.67580850162406,28,11,17,0,1.5,2.56,8.1,0,0,0,0,0,0,0.535637693659268,405.021371525579,58.2543814328756
8.7,"eps_greedy_SVM","SVM",10,1,3712,3391,321,200,109,91,0.906533402763973,0.551546391752577,1.74219223771983,73,38,35,45,0.9,5.11,1.2,0,0,0,0,0,0,0.736038089743572,271.272341760028,84.5958757068409
8.7,"eps_greedy_SVM","SVM",10,2,3612,3345,267,300,155,145,0.910779690370608,0.572164948453608,1.72524397993152,154,80,74,81,0.9,7.67,1.1,0,0,0,0,0,0,0.349113796385899,126.231510893307,50.8747287672706
8.7,"eps_greedy_SVM","SVM",10,3,3512,3302,210,400,198,202,0.900492352879235,0.608247422680412,1.70512431776834,235,120,115,81,1,10.22,1,0,0,0,0,0,0,0.332980971334884,139.407731745633,48.5469782850088
8.7,"eps_greedy_SVM","SVM",10,4,3412,3242,170,500,258,242,0.88325122576265,0.623711340206186,1.66805639781686,315,158,157,80,1,12.78,1.1,0,0,0,0,0,0,0.175127574606124,89.9859617030427,27.6515528346298
8.7,"eps_greedy_SVM","SVM",10,5,3312,3181,131,600,319,281,0.887896837005749,0.639175257731959,1.66959094832083,409,202,207,94,1,15.34,1.1,0,0,0,0,0,0,0.105877583972849,60.6498487131775,15.1825934320024
8.7,"eps_greedy_SVM","SVM",10,6,3212,3099,113,700,401,299,0.891506839697148,0.639175257731959,1.6618442786353,444,217,227,35,1,17.89,1.3,0,0,0,0,0,0,0.0754604703124748,51.0525537929466,9.99361513198499
8.7,"eps_greedy_SVM","SVM",10,7,3112,3020,92,800,480,320,0.890180149080827,0.65979381443299,1.63724581481131,504,239,265,60,1.1,20.45,1.5,0,0,0,0,0,0,0.0679828836852534,75.84841614453,12.6890309822007
8.7,"eps_greedy_SVM","SVM",10,8,3012,2943,69,900,557,343,0.891732099184387,0.654639175257732,1.6357451312047,548,263,285,44,1.1,23.01,1.6,0,0,0,0,0,0,0.0578093598177516,71.7433108938113,7.11397931727446
8.7,"eps_greedy_SVM","SVM",10,9,2912,2851,61,1000,649,351,0.894953017306943,0.65979381443299,1.65103993778393,572,274,298,24,1.1,25.56,1.8,0,0,0,0,0,0,0.0539370768275556,74.530827922745,6.0437720931556
8.7,"eps_greedy_SVM","SVM",10,10,2812,2755,57,1100,745,355,0.898659559778601,0.654639175257732,1.66337593234833,576,282,294,4,1,28.12,2.1,0,0,0,0,0,0,0.0424130712678036,54.3724396052692,4.6974413645136
8.7,"eps_greedy_SVM","SVM",10,11,2712,2656,56,1200,844,356,0.89733140643832,0.65979381443299,1.67266853532234,585,284,301,9,1.1,30.67,2.4,0,0,0,0,0,0,0.0361150084439211,44.7269627890412,4.0011193848247
8.7,"eps_greedy_SVM","SVM",10,12,2612,2561,51,1300,939,361,0.905235966626485,0.654639175257732,1.67266853532234,606,294,312,21,1.1,33.23,2.6,0,0,0,0,0,0,0.030643200096865,35.451605875584,3.47983946076771
8.7,"eps_greedy_SVM","SVM",10,13,2512,2467,45,1400,1033,367,0.917139614074913,0.65979381443299,1.70669296939463,627,302,325,21,1.1,35.79,2.8,0,0,0,0,0,0,0.0337735955875634,42.8953701657827,3.8260019803555
8.7,"eps_greedy_SVM","SVM",10,14,2412,2375,37,1500,1125,375,0.938191137063087,0.644329896907217,1.74059242850246,673,331,342,46,1,38.34,3,0,0,0,0,0,0,0.0429564134363005,37.7139679102575,5.224821105436
8.7,"eps_greedy_SVM","SVM",10,15,2312,2284,28,1600,1216,384,0.945188808406568,0.639175257731959,1.79614325068871,705,346,359,32,1,40.9,3.2,0,0,0,0,0,0,0.0659172822638804,45.3868439886224,7.85029112821796
8.7,"eps_greedy_SVM","SVM",10,16,2212,2185,27,1700,1315,385,0.944403325649157,0.634020618556701,1.80110497237569,714,348,366,9,1.1,43.46,3.4,0,0,0,0,0,0,0.0482332621256127,32.1156695082756,5.40730317998139
8.7,"eps_greedy_SVM","SVM",10,17,2112,2087,25,1800,1413,387,0.944179528885873,0.634020618556701,1.80276497695853,719,351,368,5,1,46.01,3.7,0,0,0,0,0,0,0.0383589446742728,23.8032943880543,4.38639386230916
8.7,"eps_greedy_SVM","SVM",10,18,2012,1992,20,1900,1508,392,0.943594439308659,0.623711340206186,1.80110497237569,731,357,374,12,1,48.57,3.8,0,0,0,0,0,0,0.0385523182722906,21.5516241977471,4.67848156646219
8.7,"eps_greedy_SVM","SVM",10,19,1912,1896,16,2000,1604,396,0.943461331429841,0.628865979381443,1.80110497237569,743,362,381,12,1.1,51.12,4.1,0,0,0,0,0,0,0.0299591413731545,18.9039988204725,3.84765627169857
8.7,"eps_greedy_SVM","SVM",10,20,1812,1801,11,2100,1699,401,0.94300642428356,0.623711340206186,1.79944802207912,755,367,388,12,1.1,53.68,4.2,0,0,0,0,0,0,0.0216881533045595,15.7352663715779,2.61168020135893
8.7,"eps_greedy_SVM","SVM",10,21,1712,1701,11,2200,1799,401,0.942959617117383,0.623711340206186,1.80110497237569,754,367,387,-1,1.1,56.24,4.5,0,0,0,0,0,0,0.0156592633542733,12.2025102566976,1.76440829327597
8.7,"eps_greedy_SVM","SVM",10,22,1612,1603,9,2300,1897,403,0.942985946148358,0.628865979381443,1.80276497695853,765,370,395,11,1.1,58.79,4.7,0,0,0,0,0,0,0.0134546278232401,11.043988438861,1.47190354794927
8.7,"eps_greedy_SVM","SVM",10,23,1512,1504,8,2400,1996,404,0.94302105152299,0.628865979381443,1.79944802207912,770,372,398,5,1.1,61.35,4.9,0,0,0,0,0,0,0.011322792240789,8.94319161039015,1.17290570589539
8.7,"eps_greedy_SVM","SVM",10,24,1412,1404,8,2500,2096,404,0.943044455106078,0.634020618556701,1.80110497237569,777,377,400,7,1.1,63.91,5.2,0,0,0,0,0,0,0.007658029249163,5.6800133965043,0.895451232873107
8.7,"eps_greedy_SVM","SVM",10,25,1312,1304,8,2600,2196,404,0.94296839346104,0.634020618556701,1.80276497695853,776,376,400,-1,1.1,66.46,5.4,0,0,0,0,0,0,0.00753715737392967,5.03054599760513,0.76580694405892
8.7,"eps_greedy_SVM","SVM",10,26,1212,1204,8,2700,2296,404,0.942661221433003,0.634020618556701,1.80110497237569,785,382,403,9,1.1,69.02,5.7,0,0,0,0,0,0,0.00546802446722825,3.43790081702916,0.629601059489655
8.7,"eps_greedy_SVM","SVM",10,27,1112,1105,7,2800,2395,405,0.942532501726015,0.634020618556701,1.79944802207912,787,383,404,2,1.1,71.57,5.9,0,0,0,0,0,0,0.00532450162345648,2.91040907473261,0.542565565049412
8.7,"eps_greedy_SVM","SVM",10,28,1012,1005,7,2900,2495,405,0.942517874486585,0.634020618556701,1.79944802207912,794,387,407,7,1.1,74.13,6.2,0,0,0,0,0,0,0.00447260359914679,2.24528998639614,0.49365695465195
8.7,"eps_greedy_SVM","SVM",10,29,912,906,6,3000,2594,406,0.942554442585161,0.634020618556701,1.80110497237569,795,388,407,1,1,76.69,6.4,0,0,0,0,0,0,0.00422074999730819,1.77562767884271,0.444629025944946
8.7,"eps_greedy_SVM","SVM",10,30,812,806,6,3100,2694,406,0.942431573773946,0.623711340206186,1.80110497237569,800,391,409,5,1,79.24,6.6,0,0,0,0,0,0,0.00354863366750735,1.32006422681638,0.39319868640298
8.7,"eps_greedy_SVM","SVM",10,31,712,707,5,3200,2793,407,0.942471067320409,0.623711340206186,1.80276497695853,803,392,411,3,1,81.8,6.9,0,0,0,0,0,0,0.00357263336377373,1.1586287129561,0.395091502107251
8.7,"eps_greedy_SVM","SVM",10,32,612,608,4,3300,2892,408,0.942523725382359,0.618556701030928,1.80276497695853,811,394,417,8,1.1,84.36,7.1,0,0,0,0,0,0,0.00276439305983383,0.807599410846341,0.321999201737345
8.7,"eps_greedy_SVM","SVM",10,33,512,508,4,3400,2992,408,0.942719730390725,0.623711340206186,1.80110497237569,813,394,419,2,1.1,86.91,7.3,0,0,0,0,0,0,0.00159689533730163,0.455803213298894,0.207888724746438
8.7,"eps_greedy_SVM","SVM",10,34,412,411,1,3500,3089,411,0.942785552968162,0.623711340206186,1.80110497237569,822,399,423,9,1.1,89.47,7.5,0,0,0,0,0,0,0.00142534904544058,0.422492507059483,0.181125116301486
8.7,"eps_greedy_SVM","SVM",10,35,312,312,0,3600,3188,412,0.942684625016093,0.623711340206186,1.80276497695853,825,402,423,3,1.1,92.02,7.7,0,0,0,0,0,0,0.00095498523979735,0.237245335870892,0.117252636879547
8.7,"eps_greedy_SVM","SVM",10,36,212,212,0,3700,3288,412,0.942671460500606,0.623711340206186,1.80110497237569,830,404,426,5,1.1,94.58,8,0,0,0,0,0,0,0.000529782848629423,0.10991140859764,0.0693120344682683
8.7,"eps_greedy_SVM","SVM",10,37,112,112,0,3800,3388,412,0.942731432182271,0.623711340206186,1.79944802207912,834,404,430,4,1.1,97.14,8.2,0,0,0,0,0,0,0.000245099098955931,0.0406956135792187,0.0381037942477867
8.7,"eps_greedy_SVM","SVM",10,38,12,12,0,3900,3488,412,0.942690475911866,0.623711340206186,1.80276497695853,835,405,430,1,1.1,99.69,8.5,0,0,0,0,0,0,0.000148051954155697,0.00207551734073836,0.00207551734073836
8.7,"eps_greedy_SVM","SVM",10,39,0,0,0,3912,3500,412,0.94270217770341,0.623711340206186,1.80276497695853,834,405,429,-1,1.1,100,8.5,0,0,0,0,0,0,0,0,0
8.7,"eps_greedy_SVM","SVM",11,0,3812,3410,402,100,94,6,0.898734213580625,0.55050505050505,1.7026113671275,17,6,11,0,1.8,2.56,15.7,0,0,0,0,0,0,0.198603767043443,202.592988885481,22.2717265784433
8.7,"eps_greedy_SVM","SVM",11,1,3712,3372,340,200,132,68,0.904952540191445,0.560606060606061,1.71923656454043,100,52,48,83,0.9,5.11,1.9,0,0,0,0,0,0,0.589302436702916,212.873233717891,72.6373464877761
8.7,"eps_greedy_SVM","SVM",11,2,3612,3344,268,300,160,140,0.897652578113332,0.606060606060606,1.70699643493761,152,79,73,52,0.9,7.67,1.1,0,0,0,0,0,0,0.452908153192598,152.148736103631,62.0881398047928
8.7,"eps_greedy_SVM","SVM",11,3,3512,3305,207,400,199,201,0.901543880212825,0.580808080808081,1.73903086161151,230,117,113,78,1,10.22,1,0,0,0,0,0,0,0.309209069035001,123.636358570039,44.1518451700916
8.7,"eps_greedy_SVM","SVM",11,4,3412,3255,157,500,249,251,0.86535721262683,0.580808080808081,1.63887725178048,323,166,157,93,0.9,12.78,1,0,0,0,0,0,0,0.238127634683266,127.08712406658,32.7145859158281
8.7,"eps_greedy_SVM","SVM",11,5,3312,3182,130,600,322,278,0.887076108065873,0.616161616161616,1.66312620222464,395,197,198,72,1,15.34,1.2,0,0,0,0,0,0,0.12967384615293,83.1069651051618,18.9720201293253
8.7,"eps_greedy_SVM","SVM",11,6,3212,3109,103,700,395,305,0.891582204295508,0.636363636363636,1.65251782531194,448,219,229,53,1,17.89,1.3,0,0,0,0,0,0,0.0872616567097008,69.2608120927994,12.8965667719361
8.7,"eps_greedy_SVM","SVM",11,7,3112,3041,71,800,463,337,0.891847944748965,0.656565656565657,1.64192893118513,530,254,276,82,1.1,20.45,1.4,0,0,0,0,0,0,0.0846294785283775,99.9432956165561,12.1268644280562
8.7,"eps_greedy_SVM","SVM",11,8,3012,2952,60,900,552,348,0.89298847404649,0.651515151515151,1.64798212540148,549,264,285,19,1.1,23.01,1.6,0,0,0,0,0,0,0.0640401129262888,83.3967953883089,7.36285633327508
8.7,"eps_greedy_SVM","SVM",11,9,2912,2861,51,1000,643,357,0.892627928890732,0.661616161616162,1.63736815670517,582,275,307,33,1.1,25.56,1.8,0,0,0,0,0,0,0.0610630586795587,93.3432609141287,6.89693021211153
8.7,"eps_greedy_SVM","SVM",11,10,2812,2761,51,1100,743,357,0.897964284483054,0.656565656565657,1.64798212540148,585,277,308,3,1.1,28.12,2.1,0,0,0,0,0,0,0.0455281659741191,64.7297220289618,4.95853498327599
8.7,"eps_greedy_SVM","SVM",11,11,2712,2664,48,1200,840,360,0.900508210661796,0.641414141414141,1.65556113622412,592,282,310,7,1.1,30.67,2.3,0,0,0,0,0,0,0.0359020934851634,51.9246257740039,3.88498020564074
8.7,"eps_greedy_SVM","SVM",11,12,2612,2567,45,1300,937,363,0.900409096654831,0.641414141414141,1.65708699902248,604,290,314,12,1.1,33.23,2.6,0,0,0,0,0,0,0.043601270044924,57.5381599703761,5.00358345741105
8.7,"eps_greedy_SVM","SVM",11,13,2512,2468,44,1400,1036,364,0.904569012077542,0.636363636363636,1.67529674626449,605,291,314,1,1.1,35.79,2.8,0,0,0,0,0,0,0.0313773598323092,41.6376694686558,3.40594401608565
8.7,"eps_greedy_SVM","SVM",11,14,2412,2371,41,1500,1133,367,0.924118890842436,0.631313131313131,1.73583117281369,633,308,325,28,1.1,38.34,3.1,0,0,0,0,0,0,0.0295345776421843,28.4444712993604,3.55067294125495
8.7,"eps_greedy_SVM","SVM",11,15,2312,2276,36,1600,1228,372,0.926792096160694,0.636363636363636,1.73742954405938,651,314,337,18,1.1,40.9,3.3,0,0,0,0,0,0,0.02571268156181,28.6098798704372,3.0571014088088
8.7,"eps_greedy_SVM","SVM",11,16,2212,2183,29,1700,1321,379,0.931091345767102,0.641414141414141,1.75239527629233,673,327,346,22,1.1,43.46,3.5,0,0,0,0,0,0,0.0529253956165676,36.6374690741589,6.44721331783339
8.7,"eps_greedy_SVM","SVM",11,17,2112,2085,27,1800,1419,381,0.931947460957689,0.641414141414141,1.76406926406926,687,334,353,14,1.1,46.01,3.7,0,0,0,0,0,0,0.0409363083774824,27.6837355682201,4.76837640191653
8.7,"eps_greedy_SVM","SVM",11,18,2012,1988,24,1900,1516,384,0.931599843715877,0.641414141414141,1.77218365810822,697,339,358,10,1.1,48.57,3.9,0,0,0,0,0,0,0.0371464134415094,22.5726180424255,4.16678158613762
8.7,"eps_greedy_SVM","SVM",11,19,1912,1894,18,2000,1610,390,0.930235230576522,0.636363636363636,1.7689289590116,715,347,368,18,1.1,51.12,4.1,0,0,0,0,0,0,0.0349945525742166,18.7601328398997,4.29926742242273
8.7,"eps_greedy_SVM","SVM",11,20,1812,1803,9,2100,1701,399,0.928758575516247,0.621212121212121,1.77218365810822,735,356,379,20,1.1,53.68,4.3,0,0,0,0,0,0,0.0332935176382496,18.6528000661831,4.61414438014533
8.7,"eps_greedy_SVM","SVM",11,21,1712,1705,7,2200,1799,401,0.929285747118506,0.621212121212121,1.76730608840701,744,359,385,9,1.1,56.24,4.5,0,0,0,0,0,0,0.0192608967983783,13.9334704093141,2.46739598176301
8.7,"eps_greedy_SVM","SVM",11,22,1612,1605,7,2300,1899,401,0.929328840165011,0.621212121212121,1.76730608840701,743,359,384,-1,1.1,58.79,4.7,0,0,0,0,0,0,0.01403029630828,10.9099669008512,1.59981258897986
8.7,"eps_greedy_SVM","SVM",11,23,1512,1506,6,2400,1998,402,0.929860321071919,0.626262626262626,1.76730608840701,747,360,387,4,1.1,61.35,5,0,0,0,0,0,0,0.011115569136624,8.79311839893655,1.21489932286305
8.7,"eps_greedy_SVM","SVM",11,24,1412,1407,5,2500,2097,403,0.93043489502533,0.631313131313131,1.76730608840701,752,364,388,5,1.1,63.91,5.2,0,0,0,0,0,0,0.00972459374508608,7.64945053303233,1.04685229455298
8.7,"eps_greedy_SVM","SVM",11,25,1312,1307,5,2600,2197,403,0.930582847818335,0.626262626262626,1.77381550309727,752,365,387,0,1.1,66.46,5.5,0,0,0,0,0,0,0.00803734458628564,6.2454369466721,0.87216989792037
8.7,"eps_greedy_SVM","SVM",11,26,1212,1207,5,2700,2297,403,0.930771020788078,0.626262626262626,1.76730608840701,754,365,389,2,1.1,69.02,5.7,0,0,0,0,0,0,0.00709002107295613,4.85999124440257,0.715670892035872
8.7,"eps_greedy_SVM","SVM",11,27,1112,1107,5,2800,2397,403,0.931730559290283,0.616161616161616,1.77055481283422,771,376,395,17,1.1,71.57,5.9,0,0,0,0,0,0,0.00542939260895534,3.29517535482438,0.677703197248847
8.7,"eps_greedy_SVM","SVM",11,28,1012,1008,4,2900,2496,404,0.931767906597256,0.616161616161616,1.77381550309727,773,376,397,2,1.1,74.13,6.2,0,0,0,0,0,0,0.00490544558810102,2.73671033586654,0.510716744907395
8.7,"eps_greedy_SVM","SVM",11,29,912,908,4,3000,2596,404,0.932125578883256,0.611111111111111,1.77218365810822,776,379,397,3,1,76.69,6.4,0,0,0,0,0,0,0.00346947201190658,1.68548377402099,0.369162575654242
8.7,"eps_greedy_SVM","SVM",11,30,812,809,3,3100,2695,405,0.931780834511209,0.606060606060606,1.77055481283422,784,384,400,8,1,79.24,6.7,0,0,0,0,0,0,0.00349688212937373,1.50663815383592,0.367064150618954
8.7,"eps_greedy_SVM","SVM",11,31,712,709,3,3200,2795,405,0.931828236862366,0.601010101010101,1.77055481283422,790,385,405,6,1.1,81.8,6.9,0,0,0,0,0,0,0.00272139931930346,0.97071630193706,0.288356569884476
8.7,"eps_greedy_SVM","SVM",11,32,612,610,2,3300,2894,406,0.9318512198205,0.601010101010101,1.77055481283422,794,389,405,4,1,84.36,7.1,0,0,0,0,0,0,0.00263955173877413,0.77180493682713,0.281819837259594
8.7,"eps_greedy_SVM","SVM",11,33,512,510,2,3400,2994,406,0.931999172613503,0.601010101010101,1.7689289590116,800,391,409,6,1,86.91,7.4,0,0,0,0,0,0,0.00178577000334642,0.490758225171319,0.228164199854284
8.7,"eps_greedy_SVM","SVM",11,34,412,410,2,3500,3094,406,0.932141379666973,0.601010101010101,1.77381550309727,801,391,410,1,1,89.47,7.6,0,0,0,0,0,0,0.000755277000996589,0.234082890539577,0.115727972278422
8.7,"eps_greedy_SVM","SVM",11,35,312,312,0,3600,3192,408,0.932879707197108,0.601010101010101,1.78291199285674,810,394,416,9,1.1,92.02,7.8,0,0,0,0,0,0,0.000858789053344701,0.219131086000296,0.110418783799652
8.7,"eps_greedy_SVM","SVM",11,36,212,212,0,3700,3292,408,0.933225888004039,0.590909090909091,1.78455522971652,811,395,416,1,1.1,94.58,8.1,0,0,0,0,0,0,0.000466260961003596,0.0982002672227278,0.0614412234362909
8.7,"eps_greedy_SVM","SVM",11,37,112,112,0,3800,3392,408,0.933724330908625,0.590909090909091,1.78291199285674,810,397,413,-1,1,97.14,8.3,0,0,0,0,0,0,0.000177065821201344,0.0286918681284965,0.0268214912222048
8.7,"eps_greedy_SVM","SVM",11,38,12,12,0,3900,3492,408,0.934234265292279,0.590909090909091,1.78127177943185,812,398,414,2,1,99.69,8.6,0,0,0,0,0,0,0.000134198120238703,0.00197798075618417,0.00197798075618417
8.7,"eps_greedy_SVM","SVM",11,39,0,0,0,3912,3504,408,0.934258684685299,0.595959595959596,1.78291199285674,812,398,414,0,1,100,8.6,0,0,0,0,0,0,0,0,0
8.7,"eps_greedy_SVM","SVM",12,0,3812,3429,383,100,83,17,0.886604715672676,0.519417475728155,1.67817134321989,40,17,23,0,1.4,2.56,4.9,0,0,0,0,0,0,0.755082958750557,602.92772327674,80.8889930204038
8.7,"eps_greedy_SVM","SVM",12,1,3712,3374,338,200,138,62,0.907808599167806,0.645631067961165,1.68744300809955,111,56,55,71,1,5.11,2.2,0,0,0,0,0,0,0.662866792833602,484.244831818182,76.0873856216513
8.7,"eps_greedy_SVM","SVM",12,2,3612,3345,267,300,167,133,0.919237170596394,0.669902912621359,1.7327546865912,167,84,83,56,1,7.67,1.3,0,0,0,0,0,0,0.559875600151179,321.635836664975,70.0297286906154
8.7,"eps_greedy_SVM","SVM",12,3,3512,3309,203,400,203,197,0.924123439667132,0.674757281553398,1.74864560424824,242,123,119,75,1,10.22,1,0,0,0,0,0,0,0.379272034306701,268.014881482543,52.0499498262051
8.7,"eps_greedy_SVM","SVM",12,4,3412,3256,156,500,256,244,0.890898751733693,0.669902912621359,1.66688677898344,337,169,168,95,1,12.78,1,0,0,0,0,0,0,0.2384478594018,201.845255251982,31.3125899472038
8.7,"eps_greedy_SVM","SVM",12,5,3312,3187,125,600,325,275,0.88520388349514,0.669902912621359,1.60579668760708,410,200,210,73,1.1,15.34,1.2,0,0,0,0,0,0,0.152802845456101,162.182505863531,23.3714075859943
8.7,"eps_greedy_SVM","SVM",12,6,3212,3104,108,700,408,292,0.89928710124825,0.679611650485437,1.66688677898344,454,216,238,44,1.1,17.89,1.4,0,0,0,0,0,0,0.0923056391812003,94.085485372778,12.6747178262276
8.7,"eps_greedy_SVM","SVM",12,7,3112,3025,87,800,487,313,0.897728155339779,0.689320388349515,1.65094988433472,497,237,260,43,1.1,20.45,1.6,0,0,0,0,0,0,0.0727618130047353,102.767673132667,11.1554105028694
8.7,"eps_greedy_SVM","SVM",12,8,3012,2940,72,900,572,328,0.904998613037433,0.694174757281553,1.6714956825198,540,256,284,43,1.1,23.01,1.7,0,0,0,0,0,0,0.0635146761103188,92.744435586292,7.42843295860921
8.7,"eps_greedy_SVM","SVM",12,9,2912,2846,66,1000,666,334,0.908790568654652,0.694174757281553,1.67561393489435,563,271,292,23,1.1,25.56,2,0,0,0,0,0,0,0.059690378738907,80.8698818596345,6.43851231941682
8.7,"eps_greedy_SVM","SVM",12,10,2812,2753,59,1100,759,341,0.917360610263519,0.684466019417476,1.6961862361208,579,281,298,16,1.1,28.12,2.2,0,0,0,0,0,0,0.0527627753626869,75.5446285925668,5.81436157239894
8.7,"eps_greedy_SVM","SVM",12,11,2712,2660,52,1200,852,348,0.926374479889033,0.689320388349515,1.69306824671616,604,292,312,25,1.1,30.67,2.4,0,0,0,0,0,0,0.0567574085645621,74.4790165772585,6.64620342919201
8.7,"eps_greedy_SVM","SVM",12,12,2612,2568,44,1300,944,356,0.936629680998617,0.669902912621359,1.72241592018452,641,308,333,37,1.1,33.23,2.7,0,0,0,0,0,0,0.0567528406968804,62.2202014722919,6.43999417318049
8.7,"eps_greedy_SVM","SVM",12,13,2512,2476,36,1400,1036,364,0.943385575589478,0.674757281553398,1.76613206029073,664,318,346,23,1.1,35.79,2.8,0,0,0,0,0,0,0.0555129854895509,56.0633188420328,6.1787952293118
8.7,"eps_greedy_SVM","SVM",12,14,2412,2381,31,1500,1131,369,0.945165048543702,0.674757281553398,1.77324246835952,674,324,350,10,1.1,38.34,3.1,0,0,0,0,0,0,0.0573797141705202,55.935469305689,6.26819398536957
8.7,"eps_greedy_SVM","SVM",12,15,2312,2285,27,1600,1227,373,0.9459916782247,0.674757281553398,1.77487528831197,688,331,357,14,1.1,40.9,3.3,0,0,0,0,0,0,0.0513022365682213,45.3171261734586,5.68940257079837
8.7,"eps_greedy_SVM","SVM",12,16,2212,2189,23,1700,1323,377,0.946230235783645,0.679611650485437,1.77651111807078,701,336,365,13,1.1,43.46,3.5,0,0,0,0,0,0,0.0480737541468522,42.3557512186409,5.62007739844024
8.7,"eps_greedy_SVM","SVM",12,17,2112,2092,20,1800,1420,380,0.94619417475729,0.684466019417476,1.77651111807078,708,339,369,7,1.1,46.01,3.7,0,0,0,0,0,0,0.036438882510629,33.0303559072633,4.15418621460901
8.7,"eps_greedy_SVM","SVM",12,18,2012,1997,15,1900,1515,385,0.947461858529829,0.674757281553398,1.77651111807078,719,344,375,11,1.1,48.57,3.9,0,0,0,0,0,0,0.031402658541668,30.5492429833717,3.49775852120049
8.7,"eps_greedy_SVM","SVM",12,19,1912,1898,14,2000,1614,386,0.947877947295433,0.679611650485437,1.77324246835952,728,348,380,9,1.1,51.12,4.2,0,0,0,0,0,0,0.0251582713415937,25.3769050215978,2.71991047723034
8.7,"eps_greedy_SVM","SVM",12,20,1812,1799,13,2100,1713,387,0.947911234396681,0.679611650485437,1.77324246835952,730,350,380,2,1.1,53.68,4.4,0,0,0,0,0,0,0.023222454760132,20.6614449652438,2.34046668113907
8.7,"eps_greedy_SVM","SVM",12,21,1712,1700,12,2200,1812,388,0.948647711511788,0.674757281553398,1.78361851633321,751,367,384,21,1,56.24,4.7,0,0,0,0,0,0,0.016437499690021,9.82714049945448,2.26559984559566
8.7,"eps_greedy_SVM","SVM",12,22,1612,1603,9,2300,1909,391,0.949067961165047,0.674757281553398,1.78526240436669,764,371,393,13,1.1,58.79,4.9,0,0,0,0,0,0,0.0112269056744409,7.95644289224312,1.36923061192027
8.7,"eps_greedy_SVM","SVM",12,23,1512,1504,8,2400,2008,392,0.949153952843272,0.674757281553398,1.78361851633321,765,371,394,1,1.1,61.35,5.1,0,0,0,0,0,0,0.00888656856400713,7.06243037976108,1.02520003543453
8.7,"eps_greedy_SVM","SVM",12,24,1412,1407,5,2500,2105,395,0.949678224687931,0.684466019417476,1.78197765293272,775,376,399,10,1.1,63.91,5.3,0,0,0,0,0,0,0.00939800472096395,6.90251155678025,1.00075082259982
8.7,"eps_greedy_SVM","SVM",12,25,1312,1308,4,2600,2204,396,0.949011095700391,0.679611650485437,1.78033980582524,795,384,411,20,1.1,66.46,5.6,0,0,0,0,0,0,0.00704236928655479,4.96837626361746,0.819408358998703
8.7,"eps_greedy_SVM","SVM",12,26,1212,1208,4,2700,2304,396,0.949044382801639,0.679611650485437,1.78033980582524,795,383,412,0,1.1,69.02,5.8,0,0,0,0,0,0,0.00626886508915669,3.93627406326074,0.64135468664118
8.7,"eps_greedy_SVM","SVM",12,27,1112,1108,4,2800,2404,396,0.948826629680971,0.679611650485437,1.77870496670144,795,387,408,0,1.1,71.57,6.1,0,0,0,0,0,0,0.0049385010470386,2.82433414799153,0.554303028592787
8.7,"eps_greedy_SVM","SVM",12,28,1012,1008,4,2900,2504,396,0.94892926490982,0.679611650485437,1.77707312728244,795,387,408,0,1.1,74.13,6.3,0,0,0,0,0,0,0.00428754899545422,2.13214660888894,0.441873666755861
8.7,"eps_greedy_SVM","SVM",12,29,912,908,4,3000,2604,396,0.948725381414675,0.674757281553398,1.78033980582524,796,388,408,1,1.1,76.69,6.6,0,0,0,0,0,0,0.00345262238028967,1.52044401775434,0.369146330018293
8.7,"eps_greedy_SVM","SVM",12,30,812,808,4,3100,2704,396,0.948607489597754,0.674757281553398,1.77870496670144,796,389,407,0,1,79.24,6.8,0,0,0,0,0,0,0.00264030160379063,0.97141232136482,0.280415636670628
8.7,"eps_greedy_SVM","SVM",12,31,712,708,4,3200,2804,396,0.94860471567265,0.674757281553398,1.78526240436669,796,389,407,0,1,81.8,7.1,0,0,0,0,0,0,0.00256501051292094,0.826243506660529,0.282566081036365
8.7,"eps_greedy_SVM","SVM",12,32,612,611,1,3300,2901,399,0.948687933425771,0.684466019417476,1.78361851633321,806,393,413,10,1.1,84.36,7.3,0,0,0,0,0,0,0.00201083058415323,0.606184521863334,0.241389192233431
8.7,"eps_greedy_SVM","SVM",12,33,512,511,1,3400,3001,399,0.948808599167796,0.684466019417476,1.78033980582524,805,393,412,-1,1,86.91,7.5,0,0,0,0,0,0,0.00106135623224829,0.325541732715376,0.146201555717991
8.7,"eps_greedy_SVM","SVM",12,34,412,411,1,3500,3101,399,0.948801664355037,0.689320388349515,1.78197765293272,806,393,413,1,1.1,89.47,7.8,0,0,0,0,0,0,0.000820988474263921,0.243373957209104,0.106742104759529
8.7,"eps_greedy_SVM","SVM",12,35,312,312,0,3600,3200,400,0.948723994452125,0.689320388349515,1.77870496670144,809,396,413,3,1,92.02,8,0,0,0,0,0,0,0.000679372925922571,0.16476721349153,0.0826695438178485
8.7,"eps_greedy_SVM","SVM",12,36,212,212,0,3700,3300,400,0.948762829403582,0.684466019417476,1.77057560213699,812,397,415,3,1,94.58,8.2,0,0,0,0,0,0,0.000279672195323358,0.0597130113890897,0.0384007541620125
8.7,"eps_greedy_SVM","SVM",12,37,112,112,0,3800,3400,400,0.948538141470156,0.684466019417476,1.77707312728244,818,399,419,6,1.1,97.14,8.5,0,0,0,0,0,0,0.000102190779886951,0.018503548773694,0.0173913834498842
8.7,"eps_greedy_SVM","SVM",12,38,12,12,0,3900,3500,400,0.948413314840475,0.669902912621359,1.77870496670144,820,400,420,2,1.1,99.69,8.8,0,0,0,0,0,0,7.35054607185004e-05,0.00103991632769253,0.00103991632769253
8.7,"eps_greedy_SVM","SVM",12,39,0,0,0,3912,3512,400,0.948327323162251,0.669902912621359,1.77870496670144,820,400,420,0,1.1,100,8.8,0,0,0,0,0,0,0,0,0
8.7,"eps_greedy_SVM","SVM",13,0,3812,3427,385,100,90,10,0.875036325859933,0.507109004739337,1.74295760805469,24,10,14,0,1.4,2.56,9,0,0,0,0,0,0,0.369456367874115,345.579456557964,41.32063982017
8.7,"eps_greedy_SVM","SVM",13,1,3712,3390,322,200,127,73,0.907718735995876,0.549763033175355,1.74667201003624,93,44,49,69,1.1,5.11,1.7,0,0,0,0,0,0,0.712256723538806,358.286468534893,79.0923780919129
8.7,"eps_greedy_SVM","SVM",13,2,3612,3347,265,300,170,130,0.896125694265284,0.578199052132701,1.71101797814422,162,83,79,69,1,7.67,1.3,0,0,0,0,0,0,0.507518588031227,206.888911468524,64.4585608853125
8.7,"eps_greedy_SVM","SVM",13,3,3512,3304,208,400,213,187,0.896421733049074,0.587677725118483,1.71732587852447,240,121,119,78,1,10.22,1.1,0,0,0,0,0,0,0.285612138712281,147.315735640865,45.0474209075224
8.7,"eps_greedy_SVM","SVM",13,4,3412,3255,157,500,262,238,0.876014068632106,0.601895734597156,1.66606241946404,327,165,162,87,1,12.78,1.1,0,0,0,0,0,0,0.179826075735504,100.458005120269,25.5454794640336
8.7,"eps_greedy_SVM","SVM",13,5,3312,3184,128,600,333,267,0.875345944404453,0.644549763033175,1.65994281461752,393,193,200,66,1,15.34,1.2,0,0,0,0,0,0,0.117927008382522,83.8202996587419,17.3734187827723
8.7,"eps_greedy_SVM","SVM",13,6,3212,3114,98,700,403,297,0.873928217384805,0.66824644549763,1.5977111407168,461,223,238,68,1.1,17.89,1.4,0,0,0,0,0,0,0.114652586999237,119.387953499086,14.7866736415763
8.7,"eps_greedy_SVM","SVM",13,7,3112,3041,71,800,476,324,0.879153709311635,0.682464454976303,1.59330568720379,516,250,266,55,1.1,20.45,1.5,0,0,0,0,0,0,0.0992051984477822,144.671319611794,14.4071492434861
8.7,"eps_greedy_SVM","SVM",13,8,3012,2952,60,900,565,335,0.884356115645238,0.682464454976303,1.61331203686732,554,263,291,38,1.1,23.01,1.7,0,0,0,0,0,0,0.067573461839205,103.760998428622,8.076268808496
8.7,"eps_greedy_SVM","SVM",13,9,2912,2857,55,1000,660,340,0.887677725118479,0.672985781990521,1.62184807939043,569,271,298,15,1.1,25.56,1.9,0,0,0,0,0,0,0.0536296240872171,79.3608416217109,5.78544079247418
8.7,"eps_greedy_SVM","SVM",13,10,2812,2760,52,1100,757,343,0.898351417048028,0.672985781990521,1.66452829200597,575,278,297,6,1.1,28.12,2.2,0,0,0,0,0,0,0.0423188341015129,61.4346791989757,4.73377011118592
8.7,"eps_greedy_SVM","SVM",13,11,2712,2665,47,1200,852,348,0.911272559377502,0.672985781990521,1.70023805883766,590,282,308,15,1.1,30.67,2.4,0,0,0,0,0,0,0.042884377953763,63.1176469271632,4.79421461754516
8.7,"eps_greedy_SVM","SVM",13,12,2612,2572,40,1300,945,355,0.931279620853073,0.649289099526066,1.74876308525598,627,306,321,37,1,33.23,2.7,0,0,0,0,0,0,0.0404119439968699,38.5722497143528,5.00054426297036
8.7,"eps_greedy_SVM","SVM",13,13,2512,2477,35,1400,1040,360,0.932547970504751,0.654028436018957,1.74988871723705,643,311,332,16,1.1,35.79,2.9,0,0,0,0,0,0,0.0525034630212135,48.4473526261234,6.37882458275408
8.7,"eps_greedy_SVM","SVM",13,14,2412,2379,33,1500,1138,362,0.933681880525247,0.649289099526066,1.76209314167091,654,318,336,11,1.1,38.34,3.1,0,0,0,0,0,0,0.039306719935062,32.3635794668056,4.36785401808099
8.7,"eps_greedy_SVM","SVM",13,15,2312,2283,29,1600,1234,366,0.934166677983121,0.649289099526066,1.76371271257318,665,326,339,11,1,40.9,3.4,0,0,0,0,0,0,0.0381219754698867,29.877950775122,4.28634030623239
8.7,"eps_greedy_SVM","SVM",13,16,2212,2188,24,1700,1329,371,0.933676448620968,0.644549763033175,1.77713324742831,680,333,347,15,1,43.46,3.6,0,0,0,0,0,0,0.0352596424937179,25.6540174811109,4.24548332760574
8.7,"eps_greedy_SVM","SVM",13,17,2112,2095,17,1800,1422,378,0.931419492388537,0.639810426540284,1.77713324742831,694,339,355,14,1,46.01,3.8,0,0,0,0,0,0,0.0347937351542568,25.2157117248127,4.49404836247268
8.7,"eps_greedy_SVM","SVM",13,18,2012,1998,14,1900,1519,381,0.930707912926566,0.639810426540284,1.76696080228326,704,343,361,10,1.1,48.57,4,0,0,0,0,0,0,0.0238286487178499,19.2916577881872,2.94703917326388
8.7,"eps_greedy_SVM","SVM",13,19,1912,1901,11,2000,1616,384,0.931427640244973,0.635071090047393,1.76533526336672,711,344,367,7,1.1,51.12,4.2,0,0,0,0,0,0,0.0207581381137601,17.8356637894187,2.29701292079623
8.7,"eps_greedy_SVM","SVM",13,20,1812,1802,10,2100,1715,385,0.930821982916656,0.630331753554502,1.76696080228326,719,349,370,8,1.1,53.68,4.5,0,0,0,0,0,0,0.0170078225799568,15.0382306298065,1.84591140048114
8.7,"eps_greedy_SVM","SVM",13,21,1712,1702,10,2200,1815,385,0.930846426485962,0.630331753554502,1.76371271257318,719,349,370,0,1.1,56.24,4.7,0,0,0,0,0,0,0.013152275044364,11.7642636923834,1.42542986094802
8.7,"eps_greedy_SVM","SVM",13,22,1612,1603,9,2300,1914,386,0.931340729776337,0.630331753554502,1.76209314167091,723,351,372,4,1.1,58.79,5,0,0,0,0,0,0,0.0114900814673703,9.59984328660383,1.18059742781767
8.7,"eps_greedy_SVM","SVM",13,23,1512,1503,9,2400,2014,386,0.931797009736667,0.630331753554502,1.77386345304482,736,360,376,13,1,61.35,5.2,0,0,0,0,0,0,0.00841225805524566,6.14749388013791,1.03640299192492
8.7,"eps_greedy_SVM","SVM",13,24,1412,1406,6,2500,2111,389,0.932061815070795,0.625592417061611,1.78075341511012,745,362,383,9,1.1,63.91,5.4,0,0,0,0,0,0,0.00821546453786882,5.75114698646766,0.847127123532614
8.7,"eps_greedy_SVM","SVM",13,25,1312,1306,6,2600,2211,389,0.9325547603851,0.625592417061611,1.78239164272292,755,368,387,10,1.1,66.46,5.7,0,0,0,0,0,0,0.00602765298110299,4.0515702241588,0.700771056940766
8.7,"eps_greedy_SVM","SVM",13,26,1212,1207,5,2700,2310,390,0.932649818710173,0.625592417061611,1.77911819617981,759,370,389,4,1.1,69.02,5.9,0,0,0,0,0,0,0.00582554717237567,3.4553596144926,0.597972027524443
8.7,"eps_greedy_SVM","SVM",13,27,1112,1107,5,2800,2410,390,0.932799196078144,0.62085308056872,1.78239164272292,766,373,393,7,1.1,71.57,6.2,0,0,0,0,0,0,0.00400386857541015,2.2055675167655,0.449901154274362
8.7,"eps_greedy_SVM","SVM",13,28,1012,1007,5,2900,2510,390,0.93279104822171,0.62085308056872,1.78239164272292,764,372,392,-2,1.1,74.13,6.4,0,0,0,0,0,0,0.00352001272769068,1.68145360740467,0.370722119703582
8.7,"eps_greedy_SVM","SVM",13,29,912,907,5,3000,2610,390,0.933201156995594,0.62085308056872,1.78239164272292,770,376,394,6,1,76.69,6.7,0,0,0,0,0,0,0.00305107408805543,1.29497179966436,0.32808767491349
8.7,"eps_greedy_SVM","SVM",13,30,812,809,3,3100,2708,392,0.933206588899885,0.625592417061611,1.79422106711512,776,380,396,6,1,79.24,6.9,0,0,0,0,0,0,0.00278342684264283,1.11808306732189,0.313387725145163
8.7,"eps_greedy_SVM","SVM",13,31,712,710,2,3200,2807,393,0.933008324393306,0.625592417061611,1.78763072343426,781,382,399,5,1,81.8,7.1,0,0,0,0,0,0,0.00247417447437948,0.897178049695262,0.274113110780689
8.7,"eps_greedy_SVM","SVM",13,32,612,610,2,3300,2907,393,0.932903760235726,0.625592417061611,1.78927376637859,779,382,397,-2,1,84.36,7.4,0,0,0,0,0,0,0.00184457434686112,0.606185536976153,0.214816023829857
8.7,"eps_greedy_SVM","SVM",13,33,512,510,2,3400,3007,393,0.932921413924669,0.630331753554502,1.78763072343426,780,382,398,1,1,86.91,7.7,0,0,0,0,0,0,0.00125964435749103,0.395494013824951,0.158987657103933
8.7,"eps_greedy_SVM","SVM",13,34,412,410,2,3500,3107,393,0.932994744632581,0.630331753554502,1.78763072343426,780,382,398,0,1,89.47,7.9,0,0,0,0,0,0,0.000786002957806434,0.229364456609897,0.101488684834508
8.7,"eps_greedy_SVM","SVM",13,35,312,312,0,3600,3205,395,0.933631635410566,0.630331753554502,1.78599069524762,786,386,400,6,1,92.02,8.1,0,0,0,0,0,0,0.000925465876119374,0.2390622235434,0.11696279755561
8.7,"eps_greedy_SVM","SVM",13,36,212,212,0,3700,3305,395,0.933869281223248,0.635071090047393,1.79422106711512,789,388,401,3,1,94.58,8.4,0,0,0,0,0,0,0.000475731210439842,0.0964359441460527,0.0596975447503896
8.7,"eps_greedy_SVM","SVM",13,37,112,112,0,3800,3405,395,0.934064829777685,0.635071090047393,1.78763072343426,794,389,405,5,1,97.14,8.6,0,0,0,0,0,0,0.00018765524449944,0.0311663592562636,0.0292312099992816
8.7,"eps_greedy_SVM","SVM",13,38,12,12,0,3900,3505,395,0.934123222748802,0.635071090047393,1.78599069524762,795,390,405,1,1,99.69,8.9,0,0,0,0,0,0,0.000139206429588637,0.00208026330890346,0.00208026330890346
8.7,"eps_greedy_SVM","SVM",13,39,0,0,0,3912,3517,395,0.934216923097802,0.635071090047393,1.78435367352879,795,390,405,0,1,100,8.9,0,0,0,0,0,0,0,0,0
8.7,"eps_greedy_SVM","SVM",14,0,3812,3414,398,100,87,13,0.89815955386652,0.533333333333333,1.7636517328825,32,13,19,0,1.5,2.56,6.7,0,0,0,0,0,0,0.696650548181584,532.295199723732,75.8883714316644
8.7,"eps_greedy_SVM","SVM",14,1,3712,3372,340,200,129,71,0.915250658862241,0.57948717948718,1.77013574660633,104,50,54,72,1.1,5.11,1.8,0,0,0,0,0,0,0.693633781624833,367.352508990693,77.8083868501051
8.7,"eps_greedy_SVM","SVM",14,2,3612,3346,266,300,155,145,0.910400559122863,0.58974358974359,1.75929928657201,153,80,73,49,0.9,7.67,1.1,0,0,0,0,0,0,0.61258614755381,261.219429198413,71.9954008262399
8.7,"eps_greedy_SVM","SVM",14,3,3512,3310,202,400,191,209,0.910662647970994,0.625641025641026,1.75654023395959,228,117,111,75,0.9,10.22,0.9,0,0,0,0,0,0,0.39285728252319,183.937888234383,55.8029208376731
8.7,"eps_greedy_SVM","SVM",14,4,3412,3252,160,500,249,251,0.886498056174368,0.615384615384615,1.68871275918194,317,161,156,89,1,12.78,1,0,0,0,0,0,0,0.287779349325957,159.498368741424,39.2717533417192
8.7,"eps_greedy_SVM","SVM",14,5,3312,3186,126,600,315,285,0.869960249858043,0.620512820512821,1.59977437777621,397,199,198,80,1,15.34,1.1,0,0,0,0,0,0,0.157198345269621,114.193901600048,21.9756571716008
8.7,"eps_greedy_SVM","SVM",14,6,3212,3107,105,700,394,306,0.873606196945219,0.646153846153846,1.61786600496278,458,220,238,61,1.1,17.89,1.3,0,0,0,0,0,0,0.09495510721265,82.3271831542855,13.1639222758556
8.7,"eps_greedy_SVM","SVM",14,7,3112,3024,88,800,477,323,0.874133286739767,0.651282051282051,1.62411718915859,496,236,260,38,1.1,20.45,1.5,0,0,0,0,0,0,0.0627179624065051,75.1265653657576,8.26472803364884
8.7,"eps_greedy_SVM","SVM",14,8,3012,2943,69,900,558,342,0.880720453122493,0.656410256410256,1.61488925058382,542,261,281,46,1.1,23.01,1.6,0,0,0,0,0,0,0.0788816928095699,126.510508446862,11.3070565898632
8.7,"eps_greedy_SVM","SVM",14,9,2912,2856,56,1000,645,355,0.889788727267441,0.656410256410256,1.64106334841629,579,281,298,37,1.1,25.56,1.8,0,0,0,0,0,0,0.061636504557488,86.6302136389452,7.19373768896538
8.7,"eps_greedy_SVM","SVM",14,10,2812,2761,51,1100,740,360,0.901632231104125,0.641025641025641,1.65028280542986,605,293,312,26,1.1,28.12,2.1,0,0,0,0,0,0,0.0500662823879703,61.6501441185682,5.85072491615897
8.7,"eps_greedy_SVM","SVM",14,11,2712,2664,48,1200,837,363,0.90361100190742,0.646153846153846,1.65028280542986,608,296,312,3,1.1,30.67,2.3,0,0,0,0,0,0,0.0408380004075331,52.6210364705589,4.32122722649936
8.7,"eps_greedy_SVM","SVM",14,12,2612,2573,39,1300,928,372,0.914841509049335,0.641025641025641,1.69182559376108,647,315,332,39,1.1,33.23,2.5,0,0,0,0,0,0,0.0426492862903074,47.5316109297037,4.93142127746091
8.7,"eps_greedy_SVM","SVM",14,13,2512,2476,36,1400,1025,375,0.916779510476256,0.641025641025641,1.68103130755064,658,321,337,11,1,35.79,2.7,0,0,0,0,0,0,0.0343181363053703,41.0439397125914,3.91162575127378
8.7,"eps_greedy_SVM","SVM",14,14,2412,2383,29,1500,1118,382,0.921060294995543,0.635897435897436,1.70559954751131,680,332,348,22,1,38.34,2.9,0,0,0,0,0,0,0.0499249933756663,46.3719325891255,6.15339206540125
8.7,"eps_greedy_SVM","SVM",14,15,2312,2286,26,1600,1215,385,0.924247586598505,0.635897435897436,1.71639657490623,693,336,357,13,1.1,40.9,3.2,0,0,0,0,0,0,0.0414110523754544,35.5247507031035,4.61567881562553
8.7,"eps_greedy_SVM","SVM",14,16,2212,2190,22,1700,1311,389,0.92666462819784,0.641025641025641,1.73928016937191,705,343,362,12,1.1,43.46,3.4,0,0,0,0,0,0,0.0401875914469832,32.3463857819374,4.44636046885337
8.7,"eps_greedy_SVM","SVM",14,17,2112,2095,17,1800,1406,394,0.927158228861801,0.641025641025641,1.73928016937191,721,348,373,16,1.1,46.01,3.6,0,0,0,0,0,0,0.0378304862885321,27.1851218988229,4.43920647845108
8.7,"eps_greedy_SVM","SVM",14,18,2012,1998,14,1900,1503,397,0.92741012536583,0.635897435897436,1.74408039063053,729,351,378,8,1.1,48.57,3.8,0,0,0,0,0,0,0.0315868881917851,25.4838519684089,3.89916983704466
8.7,"eps_greedy_SVM","SVM",14,19,1912,1903,9,2000,1598,402,0.927348971301273,0.635897435897436,1.74408039063053,740,357,383,11,1.1,51.12,4,0,0,0,0,0,0,0.0247918100113412,21.5898219409729,3.15249372196232
8.7,"eps_greedy_SVM","SVM",14,20,1812,1804,8,2100,1697,403,0.92726888859768,0.641025641025641,1.74568635784105,745,360,385,5,1.1,53.68,4.2,0,0,0,0,0,0,0.0200314248464366,17.9243819722458,2.18278097556883
8.7,"eps_greedy_SVM","SVM",14,21,1712,1704,8,2200,1797,403,0.927951775651941,0.635897435897436,1.74408039063053,752,364,388,7,1.1,56.24,4.5,0,0,0,0,0,0,0.0158945298672949,12.7905024593452,1.66257774352019
8.7,"eps_greedy_SVM","SVM",14,22,1612,1605,7,2300,1896,404,0.929789309687095,0.630769230769231,1.75492279359683,765,372,393,13,1.1,58.79,4.7,0,0,0,0,0,0,0.0111744619559988,7.87886125318762,1.39322321931373
8.7,"eps_greedy_SVM","SVM",14,23,1512,1509,3,2400,1992,408,0.930054310633526,0.630769230769231,1.75492279359683,777,379,398,12,1.1,61.35,4.9,0,0,0,0,0,0,0.0121414714635212,8.57359630615368,1.26205501715373
8.7,"eps_greedy_SVM","SVM",14,24,1412,1409,3,2500,2092,408,0.93086969816101,0.635897435897436,1.75607417330607,780,382,398,3,1,63.91,5.1,0,0,0,0,0,0,0.00897568279822132,6.13678974291561,1.04524993671913
8.7,"eps_greedy_SVM","SVM",14,25,1312,1309,3,2600,2192,408,0.930795439654043,0.635897435897436,1.75446604677374,780,381,399,0,1,66.46,5.4,0,0,0,0,0,0,0.00826037871924078,4.9096784053891,0.847507422194033
8.7,"eps_greedy_SVM","SVM",14,26,1212,1209,3,2700,2292,408,0.931150715648159,0.625641025641026,1.7641592293526,788,385,403,8,1,69.02,5.6,0,0,0,0,0,0,0.00619548009104509,3.45496045247032,0.680059502892403
8.7,"eps_greedy_SVM","SVM",14,27,1112,1109,3,2800,2392,408,0.931230798351751,0.625641025641026,1.75607417330607,787,386,401,-1,1,71.57,5.9,0,0,0,0,0,0,0.00550361696628119,2.70479043102477,0.576981446266038
8.7,"eps_greedy_SVM","SVM",14,28,1012,1009,3,2900,2492,408,0.931294864514623,0.625641025641026,1.75929928657201,790,387,403,3,1,74.13,6.1,0,0,0,0,0,0,0.00477575743880866,2.08978513407722,0.511459273264979
8.7,"eps_greedy_SVM","SVM",14,29,912,909,3,3000,2592,408,0.931516183986367,0.625641025641026,1.75607417330607,790,387,403,0,1,76.69,6.4,0,0,0,0,0,0,0.00425609366671091,1.68162444438004,0.467220691532598
8.7,"eps_greedy_SVM","SVM",14,30,812,809,3,3100,2692,408,0.931638492115489,0.625641025641026,1.76091628959276,791,387,404,1,1,79.24,6.6,0,0,0,0,0,0,0.00307960896268254,1.11462451854591,0.349130771152658
8.7,"eps_greedy_SVM","SVM",14,31,712,709,3,3200,2792,408,0.931670525196925,0.625641025641026,1.75929928657201,791,387,404,0,1,81.8,6.8,0,0,0,0,0,0,0.00230604948196059,0.739989933264212,0.265847997861238
8.7,"eps_greedy_SVM","SVM",14,32,612,610,2,3300,2891,409,0.9320636584691,0.625641025641026,1.75768525052929,796,388,408,5,1.1,84.36,7.1,0,0,0,0,0,0,0.00182056560630824,0.603715841436413,0.225131815248539
8.7,"eps_greedy_SVM","SVM",14,33,512,510,2,3400,2991,409,0.932133548828597,0.625641025641026,1.75929928657201,799,389,410,3,1.1,86.91,7.3,0,0,0,0,0,0,0.00119156045139836,0.370537257640141,0.149713308744445
8.7,"eps_greedy_SVM","SVM",14,34,412,411,1,3500,3090,410,0.932485912724399,0.615384615384615,1.76091628959276,803,391,412,4,1.1,89.47,7.5,0,0,0,0,0,0,0.000987662240888221,0.293714583814538,0.121594512660783
8.7,"eps_greedy_SVM","SVM",14,35,312,312,0,3600,3189,411,0.933187728417694,0.615384615384615,1.75929928657201,812,394,418,9,1.1,92.02,7.8,0,0,0,0,0,0,0.000694762186972185,0.177444127388162,0.0876965362297065
8.7,"eps_greedy_SVM","SVM",14,36,212,212,0,3700,3289,411,0.93326635507213,0.615384615384615,1.7641592293526,814,395,419,2,1.1,94.58,8,0,0,0,0,0,0,0.000453988344380589,0.0922709826523366,0.057764109601002
8.7,"eps_greedy_SVM","SVM",14,37,112,112,0,3800,3389,411,0.933219761499131,0.615384615384615,1.7641592293526,818,397,421,4,1.1,97.14,8.2,0,0,0,0,0,0,0.000163901776651106,0.0266087321185797,0.0248510154312039
8.7,"eps_greedy_SVM","SVM",14,38,12,12,0,3900,3489,411,0.933407591840285,0.615384615384615,1.75768525052929,821,398,423,3,1.1,99.69,8.5,0,0,0,0,0,0,0.000141803977364187,0.00194444697968734,0.00194444697968734
8.7,"eps_greedy_SVM","SVM",14,39,0,0,0,3912,3501,411,0.933457097511597,0.615384615384615,1.75768525052929,821,399,422,0,1.1,100,8.5,0,0,0,0,0,0,0,0,0
8.7,"eps_greedy_SVM","SVM",15,0,3812,3411,401,100,88,12,0.912040533828636,0.575129533678757,1.76540197225472,29,12,17,0,1.4,2.56,7.3,0,0,0,0,0,0,0.368483395418629,434.906486859486,41.6095247714058
8.7,"eps_greedy_SVM","SVM",15,1,3712,3369,343,200,130,70,0.913849449977804,0.580310880829015,1.76984913136239,92,46,46,63,1,5.11,1.9,0,0,0,0,0,0,0.683301481453758,402.193685003285,75.1643635967962
8.7,"eps_greedy_SVM","SVM",15,2,3612,3325,287,300,174,126,0.92155387513629,0.621761658031088,1.76215376255416,157,79,78,65,1,7.67,1.4,0,0,0,0,0,0,0.530501478074405,221.499194367681,62.9758155779979
8.7,"eps_greedy_SVM","SVM",15,3,3512,3286,226,400,213,187,0.912913398323064,0.616580310880829,1.74190414507772,222,111,111,65,1,10.22,1.1,0,0,0,0,0,0,0.304473605829539,153.65287604894,46.7071016545856
8.7,"eps_greedy_SVM","SVM",15,4,3412,3233,179,500,266,234,0.879377180324409,0.621761658031088,1.66265370931926,321,159,162,99,1,12.78,1.1,0,0,0,0,0,0,0.193624369853597,154.501948962542,27.4542464453646
8.7,"eps_greedy_SVM","SVM",15,5,3312,3171,141,600,328,272,0.897719090457582,0.663212435233161,1.68756524350425,392,195,197,71,1,15.34,1.2,0,0,0,0,0,0,0.141597822263919,141.496676742215,21.8791659317231
8.7,"eps_greedy_SVM","SVM",15,6,3212,3097,115,700,402,298,0.899209131867198,0.66839378238342,1.62529070461546,457,223,234,65,1,17.89,1.3,0,0,0,0,0,0,0.109541080517318,155.884537541177,15.3367077203549
8.7,"eps_greedy_SVM","SVM",15,7,3112,3026,86,800,473,327,0.899564743327888,0.683937823834197,1.63793374156068,521,251,270,64,1.1,20.45,1.4,0,0,0,0,0,0,0.0995021984633432,160.475844649712,13.8562389704035
8.7,"eps_greedy_SVM","SVM",15,8,3012,2939,73,900,560,340,0.9161947222557,0.66839378238342,1.66738418165194,562,270,292,41,1.1,23.01,1.6,0,0,0,0,0,0,0.0823178302868912,110.498714648601,10.0417144687384
8.7,"eps_greedy_SVM","SVM",15,9,2912,2851,61,1000,648,352,0.92030776555507,0.673575129533679,1.68601417250838,588,282,306,26,1.1,25.56,1.8,0,0,0,0,0,0,0.0712452255729314,116.593097986407,7.81961968889807
8.7,"eps_greedy_SVM","SVM",15,10,2812,2761,51,1100,738,362,0.929665343165068,0.66839378238342,1.69688880838549,615,295,320,27,1.1,28.12,2,0,0,0,0,0,0,0.0757035183247742,113.230077862594,8.26988372009801
8.7,"eps_greedy_SVM","SVM",15,11,2712,2665,47,1200,834,366,0.935672531806661,0.66839378238342,1.74350663279168,630,304,326,15,1.1,30.67,2.3,0,0,0,0,0,0,0.0721099457504727,88.5788821461792,7.91741366852926
8.7,"eps_greedy_SVM","SVM",15,12,2612,2571,41,1300,928,372,0.938887729641254,0.66839378238342,1.76215376255416,647,313,334,17,1.1,33.23,2.5,0,0,0,0,0,0,0.0604094713943631,67.6252297775249,6.60681833260919
8.7,"eps_greedy_SVM","SVM",15,13,2512,2478,34,1400,1021,379,0.940053018435958,0.663212435233161,1.76377637191195,666,320,346,19,1.1,35.79,2.7,0,0,0,0,0,0,0.0639493108617872,63.4139959999373,7.18296787494394
8.7,"eps_greedy_SVM","SVM",15,14,2412,2384,28,1500,1115,385,0.940824489579996,0.66839378238342,1.76215376255416,684,327,357,18,1.1,38.34,2.9,0,0,0,0,0,0,0.0567423326893528,57.2514146443179,6.47511953306915
8.7,"eps_greedy_SVM","SVM",15,15,2312,2290,22,1600,1209,391,0.942402699120376,0.663212435233161,1.77474272343067,700,333,367,16,1.1,40.9,3.1,0,0,0,0,0,0,0.0451653458558163,50.4877494339248,5.2176326734873
8.7,"eps_greedy_SVM","SVM",15,16,2212,2193,19,1700,1306,394,0.941958919528948,0.66839378238342,1.77474272343067,710,337,373,10,1.1,43.46,3.3,0,0,0,0,0,0,0.0367603354147399,42.0114828661701,4.00551740697432
8.7,"eps_greedy_SVM","SVM",15,17,2112,2094,18,1800,1405,395,0.942371840274613,0.66839378238342,1.77310852202788,716,341,375,6,1.1,46.01,3.6,0,0,0,0,0,0,0.030903498363729,35.240596424571,3.29513676184928
8.7,"eps_greedy_SVM","SVM",15,18,2012,1997,15,1900,1502,398,0.943113922041745,0.66839378238342,1.78408347460662,718,345,373,2,1.1,48.57,3.8,0,0,0,0,0,0,0.0276271429079661,31.0898370249525,2.9615138902029
8.7,"eps_greedy_SVM","SVM",15,19,1912,1899,13,2000,1600,400,0.942778883144904,0.673575129533679,1.7714773274354,727,350,377,9,1.1,51.12,4,0,0,0,0,0,0,0.0268375106947145,26.9110582054534,2.75213170160834
8.7,"eps_greedy_SVM","SVM",15,20,1812,1801,11,2100,1698,402,0.939687120693357,0.652849740932642,1.79779411764706,766,371,395,39,1.1,53.68,4.2,0,0,0,0,0,0,0.0203956111036749,13.7108263339395,2.71031828641914
8.7,"eps_greedy_SVM","SVM",15,21,1712,1703,9,2200,1796,404,0.939813495014096,0.658031088082902,1.79614325068871,771,373,398,5,1.1,56.24,4.4,0,0,0,0,0,0,0.0129682499268329,10.2020807379626,1.52617602804544
8.7,"eps_greedy_SVM","SVM",15,22,1612,1606,6,2300,1893,407,0.940151472848625,0.658031088082902,1.79614325068871,778,376,402,7,1.1,58.79,4.7,0,0,0,0,0,0,0.0123456911047476,10.7135468464578,1.39193592990095
8.7,"eps_greedy_SVM","SVM",15,23,1512,1506,6,2400,1993,407,0.940110327720943,0.658031088082902,1.79779411764706,778,376,402,0,1.1,61.35,4.9,0,0,0,0,0,0,0.0105390042436632,8.81613877912357,1.08785087369881
8.7,"eps_greedy_SVM","SVM",15,24,1412,1406,6,2500,2093,407,0.939463761428794,0.647668393782383,1.79614325068871,787,384,403,9,1,63.91,5.1,0,0,0,0,0,0,0.00760936316057046,5.86913310737413,0.867941408321872
8.7,"eps_greedy_SVM","SVM",15,25,1312,1307,5,2600,2192,408,0.939587196811841,0.647668393782383,1.79614325068871,790,386,404,3,1,66.46,5.4,0,0,0,0,0,0,0.00718587464867664,5.1584210773977,0.738481068769822
8.7,"eps_greedy_SVM","SVM",15,26,1212,1207,5,2700,2292,408,0.939237463226541,0.647668393782383,1.80110497237569,794,387,407,4,1.1,69.02,5.6,0,0,0,0,0,0,0.00534231220408062,3.4877750819054,0.583272036929304
8.7,"eps_greedy_SVM","SVM",15,27,1112,1109,3,2800,2390,410,0.939413799488034,0.647668393782383,1.79342422578257,799,390,409,5,1,71.57,5.8,0,0,0,0,0,0,0.00627355021010892,3.75469685622165,0.647486407119338
8.7,"eps_greedy_SVM","SVM",15,28,1012,1009,3,2900,2490,410,0.938504198272492,0.637305699481865,1.78847912221884,804,392,412,5,1.1,74.13,6.1,0,0,0,0,0,0,0.00451389656125301,2.41886526753389,0.496158713732
8.7,"eps_greedy_SVM","SVM",15,29,912,909,3,3000,2590,410,0.938554160213248,0.637305699481865,1.79177282225975,804,392,412,0,1.1,76.69,6.3,0,0,0,0,0,0,0.00389868517280307,1.83370707006218,0.413760664640684
8.7,"eps_greedy_SVM","SVM",15,30,812,809,3,3100,2690,410,0.93808246071375,0.637305699481865,1.79012445719788,805,393,412,1,1,79.24,6.6,0,0,0,0,0,0,0.00317351675215843,1.28255450875232,0.341760449816
8.7,"eps_greedy_SVM","SVM",15,31,712,709,3,3200,2790,410,0.938152995218348,0.637305699481865,1.78847912221884,804,393,411,-1,1,81.8,6.8,0,0,0,0,0,0,0.00287427942189838,1.07670103808971,0.31966629144988
8.7,"eps_greedy_SVM","SVM",15,32,612,609,3,3300,2890,410,0.938144178405273,0.637305699481865,1.79342422578257,805,394,411,1,1,84.36,7,0,0,0,0,0,0,0.0020559700419857,0.693057826000596,0.238447697594572
8.7,"eps_greedy_SVM","SVM",15,33,512,510,2,3400,2989,411,0.93821471290987,0.637305699481865,1.79342422578257,811,396,415,6,1,86.91,7.3,0,0,0,0,0,0,0.00152699214018179,0.509689560920361,0.182691482673204
8.7,"eps_greedy_SVM","SVM",15,34,412,412,0,3500,3087,413,0.938711393379749,0.642487046632124,1.78847912221884,819,400,419,8,1,89.47,7.5,0,0,0,0,0,0,0.00192019495309265,0.585560906367786,0.224093706559742
8.7,"eps_greedy_SVM","SVM",15,35,312,312,0,3600,3187,413,0.938361659794449,0.642487046632124,1.79012445719788,824,402,422,5,1,92.02,7.7,0,0,0,0,0,0,0.00110322020904076,0.290408454866021,0.135119480928579
8.7,"eps_greedy_SVM","SVM",15,36,212,212,0,3700,3287,413,0.938470400489038,0.642487046632124,1.79177282225975,826,405,421,2,1,94.58,8,0,0,0,0,0,0,0.000713637574339302,0.146442627679144,0.0869439431155588
8.7,"eps_greedy_SVM","SVM",15,37,112,112,0,3800,3387,413,0.938502728803645,0.642487046632124,1.79012445719788,828,406,422,2,1,97.14,8.2,0,0,0,0,0,0,0.00035773801523602,0.054850467328274,0.0508592463677831
8.7,"eps_greedy_SVM","SVM",15,38,12,12,0,3900,3487,413,0.938580610652472,0.642487046632124,1.79177282225975,831,407,424,3,1,99.69,8.4,0,0,0,0,0,0,0.000203698023589649,0.00266881153216066,0.00266881153216066
8.7,"eps_greedy_SVM","SVM",15,39,0,0,0,3912,3499,413,0.938617347373616,0.642487046632124,1.78847912221884,831,407,424,0,1,100,8.5,0,0,0,0,0,0,0,0,0
8.7,"eps_greedy_SVM","SVM",16,0,3812,3417,395,100,93,7,0.897584833019978,0.568627450980392,1.73206831119545,23,7,16,0,2.3,2.56,13.3,0,0,0,0,0,0,0.342362663425692,267.415636606286,40.3163616014308
8.7,"eps_greedy_SVM","SVM",16,1,3712,3387,325,200,123,77,0.915720968752806,0.57843137254902,1.75051268213708,101,51,50,78,1,5.11,1.6,0,0,0,0,0,0,0.622640106827651,260.119014026527,74.6237544565759
8.7,"eps_greedy_SVM","SVM",16,2,3612,3356,256,300,154,146,0.913993251410162,0.583333333333333,1.73930235077456,156,80,76,55,1,7.67,1.1,0,0,0,0,0,0,0.466189880098623,167.504744352765,64.078203818114
8.7,"eps_greedy_SVM","SVM",16,3,3512,3312,200,400,198,202,0.902109074223311,0.598039215686274,1.71281551294551,243,124,119,87,1,10.22,1,0,0,0,0,0,0,0.295756721990818,143.084566040879,43.9012751858868
8.7,"eps_greedy_SVM","SVM",16,4,3412,3254,158,500,256,244,0.870334463694161,0.617647058823529,1.63335499945835,326,164,162,83,1,12.78,1,0,0,0,0,0,0,0.231563235774508,165.064136275882,32.8194684455091
8.7,"eps_greedy_SVM","SVM",16,5,3312,3186,126,600,324,276,0.867149028561203,0.637254901960784,1.61718622933044,394,195,199,68,1,15.34,1.2,0,0,0,0,0,0,0.13564082228637,114.319938002854,23.5099837685073
8.7,"eps_greedy_SVM","SVM",16,6,3212,3104,108,700,406,294,0.878402274151675,0.656862745098039,1.60538990205098,436,213,223,42,1,17.89,1.4,0,0,0,0,0,0,0.071003488642608,69.8197704933279,9.9259202880842
8.7,"eps_greedy_SVM","SVM",16,7,3112,3027,85,800,483,317,0.88916308532546,0.67156862745098,1.63486039577121,493,239,254,57,1.1,20.45,1.5,0,0,0,0,0,0,0.077781398522897,102.734518781291,9.51101326666635
8.7,"eps_greedy_SVM","SVM",16,8,3012,2945,67,900,565,335,0.892028158295288,0.681372549019608,1.63766002268676,543,263,280,50,1.1,23.01,1.7,0,0,0,0,0,0,0.0619092535761665,97.4982335098497,8.97534153879037
8.7,"eps_greedy_SVM","SVM",16,9,2912,2856,56,1000,654,346,0.902584721103065,0.67156862745098,1.66137164543237,575,276,299,32,1.1,25.56,1.9,0,0,0,0,0,0,0.0581698955715494,92.2785214530052,6.70706187456145
8.7,"eps_greedy_SVM","SVM",16,10,2812,2770,42,1100,740,360,0.906110103858906,0.661764705882353,1.64949402023919,606,290,316,31,1.1,28.12,2.1,0,0,0,0,0,0,0.0651622870641017,105.486782281358,7.1449405752495
8.7,"eps_greedy_SVM","SVM",16,11,2712,2672,40,1200,838,362,0.912287917450103,0.661764705882353,1.67749972917344,629,303,326,23,1.1,30.67,2.3,0,0,0,0,0,0,0.0486038162424271,71.3562893646691,5.5946171668506
8.7,"eps_greedy_SVM","SVM",16,12,2612,2581,31,1300,929,371,0.923024946279894,0.656862745098039,1.69515762105947,658,317,341,29,1.1,33.23,2.5,0,0,0,0,0,0,0.0620250195555306,78.4336977804696,7.20813425621739
8.7,"eps_greedy_SVM","SVM",16,13,2512,2482,30,1400,1028,372,0.925538879935546,0.651960784313726,1.72006060934033,658,319,339,0,1.1,35.79,2.8,0,0,0,0,0,0,0.0480907577397214,55.9052541590503,5.35446650076586
8.7,"eps_greedy_SVM","SVM",16,14,2412,2385,27,1500,1125,375,0.930179234935991,0.651960784313726,1.72974574445163,668,323,345,10,1.1,38.34,3,0,0,0,0,0,0,0.0413444084541153,44.8228704985452,4.5254449901597
8.7,"eps_greedy_SVM","SVM",16,15,2312,2286,26,1600,1224,376,0.93080457068673,0.651960784313726,1.74011969590769,670,324,346,2,1.1,40.9,3.3,0,0,0,0,0,0,0.0330940078593894,37.5963381265899,3.69663959417446
8.7,"eps_greedy_SVM","SVM",16,16,2212,2189,23,1700,1321,379,0.933451405676432,0.647058823529412,1.7553439038909,679,328,351,9,1.1,43.46,3.5,0,0,0,0,0,0,0.0311738427281317,33.412802150119,3.64434644580231
8.7,"eps_greedy_SVM","SVM",16,17,2112,2098,14,1800,1412,388,0.933490576595942,0.647058823529412,1.7585795608566,703,338,365,24,1.1,46.01,3.6,0,0,0,0,0,0,0.0312019589174261,33.3142747240822,4.32867666216756
8.7,"eps_greedy_SVM","SVM",16,18,2012,2004,8,1900,1506,394,0.933233167696309,0.637254901960784,1.7569602426606,718,345,373,15,1.1,48.57,3.8,0,0,0,0,0,0,0.0284787187709208,31.0773427988379,3.18120611768706
8.7,"eps_greedy_SVM","SVM",16,19,1912,1904,8,2000,1606,394,0.933014929716185,0.642156862745098,1.7553439038909,721,345,376,3,1.1,51.12,4.1,0,0,0,0,0,0,0.0238030609613348,25.2345437950695,2.48093102916566
8.7,"eps_greedy_SVM","SVM",16,20,1812,1805,7,2100,1705,395,0.93060591816636,0.637254901960784,1.76416472752855,746,357,389,25,1.1,53.68,4.3,0,0,0,0,0,0,0.0166915693638271,14.8359560697558,2.07055635952719
8.7,"eps_greedy_SVM","SVM",16,21,1712,1705,7,2200,1805,395,0.930454830333966,0.637254901960784,1.76741664407699,744,357,387,-2,1.1,56.24,4.6,0,0,0,0,0,0,0.0119905991557022,11.0536259458184,1.31055022927731
8.7,"eps_greedy_SVM","SVM",16,22,1612,1608,4,2300,1902,398,0.930163846360468,0.632352941176471,1.76578918860362,755,362,393,11,1.1,58.79,4.8,0,0,0,0,0,0,0.0112577030612435,10.0127136340383,1.21575568617462
8.7,"eps_greedy_SVM","SVM",16,23,1512,1508,4,2400,2002,398,0.930009960605253,0.637254901960784,1.76741664407699,763,369,394,8,1.1,61.35,5,0,0,0,0,0,0,0.00778524522239922,6.55140670646735,0.917937498664309
8.7,"eps_greedy_SVM","SVM",16,24,1412,1409,3,2500,2101,399,0.929693795326356,0.637254901960784,1.76741664407699,766,371,395,3,1.1,63.91,5.3,0,0,0,0,0,0,0.00817753048661989,5.95644935862988,0.838777504805176
8.7,"eps_greedy_SVM","SVM",16,25,1312,1309,3,2600,2201,399,0.930063121138871,0.647058823529412,1.76741664407699,781,378,403,15,1.1,66.46,5.5,0,0,0,0,0,0,0.0053931282812485,3.37020483042694,0.631161094538094
8.7,"eps_greedy_SVM","SVM",16,26,1212,1210,2,2700,2300,400,0.930589130629425,0.642156862745098,1.76092475557716,783,379,404,2,1.1,69.02,5.8,0,0,0,0,0,0,0.00418328205144649,2.66658350425085,0.456099614683003
8.7,"eps_greedy_SVM","SVM",16,27,1112,1111,1,2800,2399,401,0.93084933745188,0.642156862745098,1.76254325259516,789,381,408,6,1.1,71.57,6,0,0,0,0,0,0,0.00494387104625466,2.89736813444003,0.508508329140987
8.7,"eps_greedy_SVM","SVM",16,28,1012,1011,1,2900,2499,401,0.930603120243535,0.642156862745098,1.75769666253302,786,383,403,-3,1.1,74.13,6.2,0,0,0,0,0,0,0.00380445701181106,2.03783351183331,0.420026017288838
8.7,"eps_greedy_SVM","SVM",16,29,912,911,1,3000,2599,401,0.930810166532371,0.642156862745098,1.75930922827847,785,383,402,-1,1,76.69,6.5,0,0,0,0,0,0,0.00318348762589699,1.43912330859339,0.33298345297518
8.7,"eps_greedy_SVM","SVM",16,30,812,811,1,3100,2699,401,0.931035399319549,0.651960784313726,1.76254325259516,790,386,404,5,1,79.24,6.7,0,0,0,0,0,0,0.00262713266856983,1.03628785623333,0.284170726835486
8.7,"eps_greedy_SVM","SVM",16,31,712,711,1,3200,2799,401,0.931011616975561,0.647058823529412,1.76092475557716,791,387,404,1,1,81.8,7,0,0,0,0,0,0,0.00233398419809695,0.782821929154495,0.253913377938541
8.7,"eps_greedy_SVM","SVM",16,32,612,611,1,3300,2899,401,0.931119337004212,0.647058823529412,1.75930922827847,792,387,405,1,1,84.36,7.2,0,0,0,0,0,0,0.00165010625981439,0.489199826994928,0.191898673646817
8.7,"eps_greedy_SVM","SVM",16,33,512,511,1,3400,2999,401,0.931187886113354,0.651960784313726,1.75448038318713,792,387,405,0,1,86.91,7.5,0,0,0,0,0,0,0.000955219469861348,0.282117653364115,0.124972761187587
8.7,"eps_greedy_SVM","SVM",16,34,412,412,0,3500,3098,402,0.93166353299311,0.651960784313726,1.75930922827847,794,390,404,2,1,89.47,7.7,0,0,0,0,0,0,0.000674010824887906,0.20052822154995,0.0901706622329028
8.7,"eps_greedy_SVM","SVM",16,35,312,312,0,3600,3198,402,0.931506849315072,0.642156862745098,1.76648514584569,796,392,404,2,1,92.02,8,0,0,0,0,0,0,0.000472134451478158,0.119815075419701,0.0608298153521485
8.7,"eps_greedy_SVM","SVM",16,36,212,212,0,3700,3298,402,0.931285813412127,0.642156862745098,1.76972937935505,800,391,409,4,1,94.58,8.2,0,0,0,0,0,0,0.000238425601226826,0.0506009669301725,0.0322558031803584
8.7,"eps_greedy_SVM","SVM",16,37,112,112,0,3800,3398,402,0.931319388485992,0.642156862745098,1.76972937935505,801,392,409,1,1,97.14,8.5,0,0,0,0,0,0,9.80499950771606e-05,0.0167488826689462,0.0157296183308061
8.7,"eps_greedy_SVM","SVM",16,38,12,12,0,3900,3498,402,0.931467678395563,0.647058823529412,1.77625372729737,803,394,409,2,1,99.69,8.7,0,0,0,0,0,0,5.68871558493212e-05,0.000815384684236722,0.000815384684236722
8.7,"eps_greedy_SVM","SVM",16,39,0,0,0,3912,3510,402,0.931491460739551,0.647058823529412,1.76810577441986,804,394,410,1,1,100,8.7,0,0,0,0,0,0,0,0,0
8.7,"eps_greedy_SVM","SVM",17,0,3812,3410,402,100,92,8,0.865674281076056,0.418367346938776,1.72600116403507,33,8,25,0,3.1,2.56,11.5,0,0,0,0,0,0,0.340341623501196,310.881095736015,46.3713393623594
8.7,"eps_greedy_SVM","SVM",17,1,3712,3347,365,200,155,45,0.910963589981447,0.494897959183673,1.78436941596915,99,45,54,66,1.2,5.11,3.4,0,0,0,0,0,0,0.354781577116482,472.133237816209,43.0988229175496
8.7,"eps_greedy_SVM","SVM",17,2,3612,3302,310,300,200,100,0.933818413729114,0.627551020408163,1.77618423516195,195,94,101,96,1.1,7.67,2,0,0,0,0,0,0,0.541065907849501,425.577464266707,64.8148415653766
8.7,"eps_greedy_SVM","SVM",17,3,3512,3274,238,400,228,172,0.93719851576994,0.61734693877551,1.78108630756811,255,124,131,60,1.1,10.22,1.3,0,0,0,0,0,0,0.440290484960881,362.195836104156,59.5568259431702
8.7,"eps_greedy_SVM","SVM",17,4,3412,3234,178,500,268,232,0.934028583024125,0.637755102040816,1.75787305747987,325,160,165,70,1,12.78,1.2,0,0,0,0,0,0,0.347317376658179,265.783686841098,47.1921562124805
8.7,"eps_greedy_SVM","SVM",17,5,3312,3176,136,600,326,274,0.902619144248614,0.647959183673469,1.672454617206,411,205,206,86,1,15.34,1.2,0,0,0,0,0,0,0.199628783424166,201.261356331407,28.1490110870522
8.7,"eps_greedy_SVM","SVM",17,6,3212,3107,105,700,395,305,0.917645524118735,0.668367346938776,1.68009687775754,475,231,244,64,1.1,17.89,1.3,0,0,0,0,0,0,0.15409747092042,185.218053476917,21.2359217481629
8.7,"eps_greedy_SVM","SVM",17,7,3112,3035,77,800,467,333,0.899633290816317,0.673469387755102,1.6356973728718,547,262,285,72,1.1,20.45,1.4,0,0,0,0,0,0,0.127748363693979,198.324431693579,17.1486486954713
8.7,"eps_greedy_SVM","SVM",17,8,3012,2952,60,900,550,350,0.904030902133576,0.683673469387755,1.672454617206,585,283,302,38,1.1,23.01,1.6,0,0,0,0,0,0,0.101577273867989,151.825340774241,11.8405255282395
8.7,"eps_greedy_SVM","SVM",17,9,2912,2858,54,1000,644,356,0.910363520408159,0.673469387755102,1.67399605003292,603,293,310,18,1.1,25.56,1.8,0,0,0,0,0,0,0.0851402270253653,126.150932940874,9.46806621349481
8.7,"eps_greedy_SVM","SVM",17,10,2812,2766,46,1100,736,364,0.918477504638207,0.668367346938776,1.70606992797119,627,303,324,24,1.1,28.12,2,0,0,0,0,0,0,0.0787821262859656,112.48444959598,8.57268655381227
8.7,"eps_greedy_SVM","SVM",17,11,2712,2671,41,1200,831,369,0.922293889146551,0.668367346938776,1.71209511327467,649,311,338,22,1.1,30.67,2.3,0,0,0,0,0,0,0.0658435231894597,83.9347942047299,7.17032058150079
8.7,"eps_greedy_SVM","SVM",17,12,2612,2572,40,1300,930,370,0.923514320500913,0.663265306122449,1.72125070211571,656,313,343,7,1.1,33.23,2.5,0,0,0,0,0,0,0.0604764331050002,71.5010112571145,6.36868758514692
8.7,"eps_greedy_SVM","SVM",17,13,2512,2478,34,1400,1024,376,0.928182977736538,0.663265306122449,1.74757829399041,672,322,350,16,1.1,35.79,2.7,0,0,0,0,0,0,0.0611314137172334,61.9018446278443,7.01187519711359
8.7,"eps_greedy_SVM","SVM",17,14,2412,2382,30,1500,1120,380,0.928956980519467,0.663265306122449,1.75677607448509,688,327,361,16,1.1,38.34,2.9,0,0,0,0,0,0,0.0548802896374537,54.5787959604184,6.12519386177137
8.7,"eps_greedy_SVM","SVM",17,15,2312,2295,17,1600,1207,393,0.928456922541732,0.668367346938776,1.75515841695794,721,339,382,33,1.1,40.9,3.1,0,0,0,0,0,0,0.0489528747652117,48.5792729882109,5.85137729049767
8.7,"eps_greedy_SVM","SVM",17,16,2212,2200,12,1700,1302,398,0.927916280148415,0.663265306122449,1.75677607448509,733,344,389,12,1.1,43.46,3.3,0,0,0,0,0,0,0.0416282125733916,46.177348119657,4.66418607407352
8.7,"eps_greedy_SVM","SVM",17,17,2112,2100,12,1800,1402,398,0.927629290352495,0.663265306122449,1.75354373580159,730,344,386,-3,1.1,46.01,3.5,0,0,0,0,0,0,0.0355256330325971,38.0256955020389,3.79629205976001
8.7,"eps_greedy_SVM","SVM",17,18,2012,2000,12,1900,1502,398,0.927595953153979,0.668367346938776,1.75515841695794,730,345,385,0,1.1,48.57,3.8,0,0,0,0,0,0,0.0277144325275362,28.5440892044681,2.9608420750957
8.7,"eps_greedy_SVM","SVM",17,19,1912,1902,10,2000,1600,400,0.926945153061214,0.658163265306122,1.75032326980379,728,349,379,-2,1.1,51.12,4,0,0,0,0,0,0,0.0237593593701092,23.8959649602166,2.53668422036254
8.7,"eps_greedy_SVM","SVM",17,20,1812,1803,9,2100,1699,401,0.926566848330233,0.658163265306122,1.75515841695794,736,352,384,8,1.1,53.68,4.2,0,0,0,0,0,0,0.0229732137658006,21.9719817390193,2.36563408859964
8.7,"eps_greedy_SVM","SVM",17,21,1712,1704,8,2200,1798,402,0.929612128942467,0.653061224489796,1.76597385497978,758,366,392,22,1.1,56.24,4.5,0,0,0,0,0,0,0.0139616164894303,10.6619556730923,1.83130716037189
8.7,"eps_greedy_SVM","SVM",17,22,1612,1605,7,2300,1897,403,0.928909148886808,0.653061224489796,1.75515841695794,759,367,392,1,1.1,58.79,4.7,0,0,0,0,0,0,0.0110313764853119,9.16818572094851,1.22756697275832
8.7,"eps_greedy_SVM","SVM",17,23,1512,1505,7,2400,1997,403,0.928843923933191,0.653061224489796,1.75515841695794,760,370,390,1,1.1,61.35,5,0,0,0,0,0,0,0.0101906458329802,7.59680057459442,1.03054575293976
8.7,"eps_greedy_SVM","SVM",17,24,1412,1405,7,2500,2097,403,0.930854301948043,0.642857142857143,1.76702864632091,775,376,399,15,1.1,63.91,5.2,0,0,0,0,0,0,0.00649555933555558,4.35603673413155,0.815885764247488
8.7,"eps_greedy_SVM","SVM",17,25,1312,1306,6,2600,2196,404,0.931083314007412,0.647959183673469,1.7702768607443,781,378,403,6,1.1,66.46,5.4,0,0,0,0,0,0,0.00615406628298164,3.91433413583603,0.640468410749718
8.7,"eps_greedy_SVM","SVM",17,26,1212,1207,5,2700,2295,405,0.931794990723557,0.642857142857143,1.77781525833474,794,384,410,13,1.1,69.02,5.7,0,0,0,0,0,0,0.00458863239532098,2.72742753189992,0.515475060755783
8.7,"eps_greedy_SVM","SVM",17,27,1112,1107,5,2800,2395,405,0.931945732838585,0.642857142857143,1.77618423516195,791,383,408,-3,1.1,71.57,5.9,0,0,0,0,0,0,0.0043117742486376,2.19589369641317,0.439905308361985
8.7,"eps_greedy_SVM","SVM",17,28,1012,1007,5,2900,2495,405,0.931800788497214,0.642857142857143,1.77781525833474,796,388,408,5,1.1,74.13,6.2,0,0,0,0,0,0,0.00320489255483351,1.44380600689832,0.357745459120496
8.7,"eps_greedy_SVM","SVM",17,29,912,908,4,3000,2594,406,0.932574791280146,0.637755102040816,1.77455620194916,797,389,408,1,1,76.69,6.4,0,0,0,0,0,0,0.00389184792153442,1.44376557719245,0.423360733273697
8.7,"eps_greedy_SVM","SVM",17,30,812,808,4,3100,2694,406,0.932761769480518,0.637755102040816,1.77944927971188,803,393,410,6,1,79.24,6.6,0,0,0,0,0,0,0.00218920285261313,0.696557475461758,0.253939584508636
8.7,"eps_greedy_SVM","SVM",17,31,712,708,4,3200,2794,406,0.932980635435991,0.637755102040816,1.77781525833474,803,393,410,0,1,81.8,6.9,0,0,0,0,0,0,0.00162123872854448,0.462787806261547,0.192304430767284
8.7,"eps_greedy_SVM","SVM",17,32,612,609,3,3300,2893,407,0.933171961966603,0.637755102040816,1.77781525833474,805,394,411,2,1,84.36,7.1,0,0,0,0,0,0,0.0011540132093843,0.346342842632147,0.152953485254356
8.7,"eps_greedy_SVM","SVM",17,33,512,509,3,3400,2993,407,0.933544468923931,0.637755102040816,1.77944927971188,805,395,410,0,1,86.91,7.4,0,0,0,0,0,0,0.000618260240926668,0.188514873342002,0.0872410372892439
8.7,"eps_greedy_SVM","SVM",17,34,412,411,1,3500,3091,409,0.935162047773654,0.642857142857143,1.78272635020859,812,399,413,7,1,89.47,7.6,0,0,0,0,0,0,0.000582090081016696,0.167156184253128,0.0745648128934908
8.7,"eps_greedy_SVM","SVM",17,35,312,312,0,3600,3190,410,0.935830241187383,0.642857142857143,1.785339824003,817,402,415,5,1,92.02,7.8,0,0,0,0,0,0,0.000330052724489402,0.0826121521358688,0.0424093905326303
8.7,"eps_greedy_SVM","SVM",17,36,212,212,0,3700,3290,410,0.936410018552875,0.642857142857143,1.78370339886642,820,402,418,3,1,94.58,8,0,0,0,0,0,0,0.000210302362086426,0.0437414857581605,0.027962769564543
8.7,"eps_greedy_SVM","SVM",17,37,112,112,0,3800,3390,410,0.937039076994433,0.647959183673469,1.78697925451172,824,404,420,4,1,97.14,8.3,0,0,0,0,0,0,8.815438704432e-05,0.0154838292169577,0.0145368730009592
8.7,"eps_greedy_SVM","SVM",17,38,12,12,0,3900,3490,410,0.937317370129869,0.647959183673469,1.78697925451172,826,405,421,2,1,99.69,8.5,0,0,0,0,0,0,3.53604847374554e-05,0.000578929126752889,0.000578929126752889
8.7,"eps_greedy_SVM","SVM",17,39,0,0,0,3912,3502,410,0.937357954545454,0.647959183673469,1.78697925451172,828,406,422,2,1,100,8.5,0,0,0,0,0,0,0,0,0
8.7,"eps_greedy_SVM","SVM",18,0,3812,3418,394,100,89,11,0.905183484287965,0.577114427860697,1.74985622346981,28,11,17,0,1.5,2.56,8.1,0,0,0,0,0,0,0.6138522508259,407.531231802674,65.8651464313482
8.7,"eps_greedy_SVM","SVM",18,1,3712,3379,333,200,128,72,0.893024903970171,0.587064676616915,1.70992324486125,97,49,48,69,1,5.11,1.8,0,0,0,0,0,0,0.651813580586411,276.476180154175,74.7630328110656
8.7,"eps_greedy_SVM","SVM",18,2,3612,3354,258,300,153,147,0.894233958413054,0.562189054726368,1.72045848107529,150,77,73,53,0.9,7.67,1,0,0,0,0,0,0,0.531839727283786,232.702602948562,68.485849032781
8.7,"eps_greedy_SVM","SVM",18,3,3512,3316,196,400,191,209,0.887805984323402,0.592039800995025,1.71887572258304,228,117,111,78,0.9,10.22,0.9,0,0,0,0,0,0,0.286423991711362,118.621220248302,47.9348774922555
8.7,"eps_greedy_SVM","SVM",18,4,3412,3265,147,500,242,258,0.864397386287938,0.567164179104478,1.63981198977488,319,161,158,91,1,12.78,0.9,0,0,0,0,0,0,0.263370633702782,147.011860730797,35.2369348689591
8.7,"eps_greedy_SVM","SVM",18,5,3312,3187,125,600,320,280,0.872132216410833,0.621890547263682,1.60249351219981,384,189,195,65,1,15.34,1.1,0,0,0,0,0,0,0.0834819791227615,53.8146835826275,13.724215636762
8.7,"eps_greedy_SVM","SVM",18,6,3212,3106,106,700,401,299,0.861881475811827,0.631840796019901,1.57854047733682,434,211,223,50,1.1,17.89,1.3,0,0,0,0,0,0,0.0638224999276885,68.4279845593418,9.87290343119698
8.7,"eps_greedy_SVM","SVM",18,7,3112,3022,90,800,485,315,0.865444855494611,0.646766169154229,1.58313213345039,478,226,252,44,1.1,20.45,1.5,0,0,0,0,0,0,0.0568511749667462,73.6235263436578,6.97565241810003
8.7,"eps_greedy_SVM","SVM",18,8,3012,2937,75,900,570,330,0.872222930929404,0.646766169154229,1.61292982600808,511,243,268,33,1.1,23.01,1.7,0,0,0,0,0,0,0.0588959647551932,84.8150584348996,6.92180202870705
8.7,"eps_greedy_SVM","SVM",18,9,2912,2846,66,1000,661,339,0.883094499014893,0.63681592039801,1.63830342308696,534,256,278,23,1.1,25.56,1.9,0,0,0,0,0,0,0.0474588673775594,64.1774998063584,5.76456726510493
8.7,"eps_greedy_SVM","SVM",18,10,2812,2755,57,1100,752,348,0.902660486740087,0.621890547263682,1.66210270959253,562,273,289,28,1.1,28.12,2.2,0,0,0,0,0,0,0.0383224611214724,43.5318496297167,4.89197612428776
8.7,"eps_greedy_SVM","SVM",18,11,2712,2663,49,1200,844,356,0.909997023429867,0.626865671641791,1.68461559605288,588,284,304,26,1.1,30.67,2.4,0,0,0,0,0,0,0.0372289355931848,54.1244253061937,4.18051785817947
8.7,"eps_greedy_SVM","SVM",18,12,2612,2567,45,1300,940,360,0.914932460206086,0.621890547263682,1.70835162423178,601,291,310,13,1.1,33.23,2.6,0,0,0,0,0,0,0.0515246764664966,55.5381650034685,6.01781324491037
8.7,"eps_greedy_SVM","SVM",18,13,2512,2470,42,1400,1037,363,0.91556746183612,0.616915422885572,1.71307517710984,626,303,323,25,1.1,35.79,2.9,0,0,0,0,0,0,0.0500947811281977,46.2628623408452,5.64711257935792
8.7,"eps_greedy_SVM","SVM",18,14,2412,2380,32,1500,1127,373,0.918731130671436,0.616915422885572,1.73101313707958,655,315,340,29,1.1,38.34,3,0,0,0,0,0,0,0.0603939733007563,47.0634133353939,6.73806654235468
8.7,"eps_greedy_SVM","SVM",18,15,2312,2287,25,1600,1220,380,0.917937378633903,0.616915422885572,1.72941920233089,668,323,345,13,1.1,40.9,3.2,0,0,0,0,0,0,0.0583860942017995,37.5776885213412,6.41818405116262
8.7,"eps_greedy_SVM","SVM",18,16,2212,2191,21,1700,1316,384,0.91744411843915,0.621890547263682,1.73101313707958,682,327,355,14,1.1,43.46,3.4,0,0,0,0,0,0,0.0486188397218859,32.8109989526977,5.67785744058837
8.7,"eps_greedy_SVM","SVM",18,17,2112,2098,14,1800,1409,391,0.916741080920194,0.621890547263682,1.73101313707958,699,335,364,17,1.1,46.01,3.6,0,0,0,0,0,0,0.0389881256482397,29.3704343737948,4.75261346920657
8.7,"eps_greedy_SVM","SVM",18,18,2012,2001,11,1900,1506,394,0.916005442871122,0.621890547263682,1.72941920233089,708,339,369,9,1.1,48.57,3.8,0,0,0,0,0,0,0.0305111534741541,25.782340081652,3.57940434755776
8.7,"eps_greedy_SVM","SVM",18,19,1912,1902,10,2000,1605,395,0.916800612323007,0.621890547263682,1.73101313707958,717,341,376,9,1.1,51.12,4.1,0,0,0,0,0,0,0.0229957511407443,20.6376652628633,2.56827719147194
8.7,"eps_greedy_SVM","SVM",18,20,1812,1803,9,2100,1704,396,0.91709826933708,0.621890547263682,1.72941920233089,720,345,375,3,1.1,53.68,4.3,0,0,0,0,0,0,0.01747587248199,15.8097510309995,1.89603786109663
8.7,"eps_greedy_SVM","SVM",18,21,1712,1703,9,2200,1804,396,0.917322220804815,0.621890547263682,1.72782820030482,724,347,377,4,1.1,56.24,4.6,0,0,0,0,0,0,0.0143350328403751,11.918649751885,1.48746319438504
8.7,"eps_greedy_SVM","SVM",18,22,1612,1606,6,2300,1901,399,0.920661649019871,0.611940298507463,1.74252703425024,745,361,384,21,1.1,58.79,4.8,0,0,0,0,0,0,0.0117310489884304,8.69714529404935,1.50064295027828
8.7,"eps_greedy_SVM","SVM",18,23,1512,1508,4,2400,1999,401,0.921106717126634,0.616915422885572,1.7457331557484,754,364,390,9,1.1,61.35,5,0,0,0,0,0,0,0.0109620369643889,7.77064293082385,1.13165835956388
8.7,"eps_greedy_SVM","SVM",18,24,1412,1408,4,2500,2099,401,0.921316494450836,0.601990049751244,1.75307287093942,759,373,386,5,1,63.91,5.2,0,0,0,0,0,0,0.00799031257414123,5.40184129543004,0.975030917038681
8.7,"eps_greedy_SVM","SVM",18,25,1312,1308,4,2600,2199,401,0.92137035619624,0.601990049751244,1.75792007703418,758,373,385,-1,1,66.46,5.5,0,0,0,0,0,0,0.00722373746240951,4.10868472851483,0.73263338549626
8.7,"eps_greedy_SVM","SVM",18,26,1212,1208,4,2700,2299,401,0.921475244858339,0.601990049751244,1.75630136609769,769,376,393,11,1,69.02,5.7,0,0,0,0,0,0,0.00560514037921985,2.99883896087372,0.635907934289131
8.7,"eps_greedy_SVM","SVM",18,27,1112,1108,4,2800,2399,401,0.921427052770346,0.601990049751244,1.75792007703418,767,375,392,-2,1,71.57,6,0,0,0,0,0,0,0.00515896913199636,2.25956092719958,0.531654269760673
8.7,"eps_greedy_SVM","SVM",18,28,1012,1008,4,2900,2499,401,0.92275942226191,0.597014925373134,1.75792007703418,779,381,398,12,1,74.13,6.2,0,0,0,0,0,0,0.00353760288057724,1.4425884339616,0.403475107851019
8.7,"eps_greedy_SVM","SVM",18,29,912,908,4,3000,2599,401,0.922767926748026,0.597014925373134,1.75792007703418,781,382,399,2,1,76.69,6.5,0,0,0,0,0,0,0.00311479335634992,1.13439789048998,0.34662219249642
8.7,"eps_greedy_SVM","SVM",18,30,812,808,4,3100,2699,401,0.922949355785177,0.601990049751244,1.75792007703418,780,382,398,-1,1,79.24,6.7,0,0,0,0,0,0,0.00216244911095316,0.69408190187009,0.246540244254107
8.7,"eps_greedy_SVM","SVM",18,31,712,708,4,3200,2799,401,0.92292951198424,0.597014925373134,1.75146307032331,778,382,396,-2,1,81.8,7,0,0,0,0,0,0,0.00172650457709506,0.524461027521696,0.212016325818674
8.7,"eps_greedy_SVM","SVM",18,32,612,609,3,3300,2898,402,0.923247012799253,0.592039800995025,1.75630136609769,783,383,400,5,1,84.36,7.2,0,0,0,0,0,0,0.00108631071328607,0.330204665649994,0.143367089168692
8.7,"eps_greedy_SVM","SVM",18,33,512,510,2,3400,2997,403,0.923924536859859,0.597014925373134,1.75792007703418,785,385,400,2,1,86.91,7.4,0,0,0,0,0,0,0.000663899173001789,0.215467041139576,0.09278371890112
8.7,"eps_greedy_SVM","SVM",18,34,412,411,1,3500,3096,404,0.924307238735103,0.597014925373134,1.75792007703418,790,387,403,5,1,89.47,7.7,0,0,0,0,0,0,0.000455117531701254,0.129813368891215,0.0568161386429232
8.7,"eps_greedy_SVM","SVM",18,35,312,312,0,3600,3195,405,0.924946492608187,0.592039800995025,1.75630136609769,796,389,407,6,1,92.02,7.9,0,0,0,0,0,0,0.000453023414116491,0.112759204242521,0.0563712875460494
8.7,"eps_greedy_SVM","SVM",18,36,212,212,0,3700,3295,405,0.925322107411661,0.592039800995025,1.75630136609769,798,391,407,2,1,94.58,8.1,0,0,0,0,0,0,0.000232894950500558,0.047370700912852,0.0301899480363567
8.7,"eps_greedy_SVM","SVM",18,37,112,112,0,3800,3395,405,0.925582911652565,0.582089552238806,1.75630136609769,805,394,411,7,1,97.14,8.4,0,0,0,0,0,0,7.52504766358319e-05,0.0136295091332884,0.0128769092522138
8.7,"eps_greedy_SVM","SVM",18,38,12,12,0,3900,3495,405,0.926076171847321,0.592039800995025,1.75792007703418,810,397,413,5,1,99.69,8.6,0,0,0,0,0,0,5.6666261103899e-05,0.000775563953348068,0.000775563953348068
8.7,"eps_greedy_SVM","SVM",18,39,0,0,0,3912,3507,405,0.926081841504732,0.592039800995025,1.75792007703418,810,397,413,0,1,100,8.7,0,0,0,0,0,0,0,0,0
8.7,"eps_greedy_SVM","SVM",19,0,3812,3396,416,100,94,6,0.817523800176664,0.451086956521739,1.61660989781607,21,6,15,0,2.5,2.56,15.7,0,0,0,0,0,0,0.163894700627114,253.31235034679,18.7508529398677
8.7,"eps_greedy_SVM","SVM",19,1,3712,3369,343,200,121,79,0.896432427127295,0.521739130434783,1.75216190247418,74,36,38,53,1.1,5.11,1.5,0,0,0,0,0,0,0.752436359139501,338.405403459391,84.9451038785631
8.7,"eps_greedy_SVM","SVM",19,2,3612,3337,275,300,153,147,0.905110597212698,0.565217391304348,1.72939977621483,129,68,61,55,0.9,7.67,1,0,0,0,0,0,0,0.470336865436014,152.930198544432,62.1018816460843
8.7,"eps_greedy_SVM","SVM",19,3,3512,3291,221,400,199,201,0.903342452645007,0.570652173913043,1.71143154273829,214,110,104,85,0.9,10.22,1,0,0,0,0,0,0,0.343012831491845,113.021507374024,53.7346245725998
8.7,"eps_greedy_SVM","SVM",19,4,3412,3237,175,500,253,247,0.89995338109728,0.581521739130435,1.73099076036959,299,152,147,85,1,12.78,1,0,0,0,0,0,0,0.157125738929096,72.7274849625831,23.01995078811
8.7,"eps_greedy_SVM","SVM",19,5,3312,3167,145,600,323,277,0.892147781921682,0.608695652173913,1.71143154273829,378,185,193,79,1,15.34,1.2,0,0,0,0,0,0,0.100285967069672,57.0717055745485,13.7163812983109
8.7,"eps_greedy_SVM","SVM",19,6,3212,3091,121,700,399,301,0.883489547551282,0.630434782608696,1.66559807653777,425,209,216,47,1,17.89,1.3,0,0,0,0,0,0,0.104206291009649,89.5825061763891,17.2011594231803
8.7,"eps_greedy_SVM","SVM",19,7,3112,3008,104,800,482,318,0.886844881735209,0.646739130434783,1.64297428102876,466,226,240,41,1.1,20.45,1.5,0,0,0,0,0,0,0.0668442768273405,88.0882947123749,10.4399977268111
8.7,"eps_greedy_SVM","SVM",19,8,3012,2934,78,900,556,344,0.899665079988235,0.646739130434783,1.66100543478261,530,255,275,64,1.1,23.01,1.6,0,0,0,0,0,0,0.0668235127423396,103.713332841334,9.30217005966062
8.7,"eps_greedy_SVM","SVM",19,9,2912,2854,58,1000,636,364,0.898600819511249,0.641304347826087,1.65795771838851,581,278,303,51,1.1,25.56,1.7,0,0,0,0,0,0,0.0837042580137056,125.170567736646,10.1792038542178
8.7,"eps_greedy_SVM","SVM",19,10,2812,2757,55,1100,733,367,0.901135722347626,0.619565217391304,1.67439082656474,601,290,311,20,1.1,28.12,2,0,0,0,0,0,0,0.0544169771989061,71.1852465654319,6.55855617240845
8.7,"eps_greedy_SVM","SVM",19,11,2712,2664,48,1200,826,374,0.899655878888996,0.630434782608696,1.68209271629135,618,296,322,17,1.1,30.67,2.2,0,0,0,0,0,0,0.0534993215795061,71.1260631605274,5.5591339530762
8.7,"eps_greedy_SVM","SVM",19,12,2612,2566,46,1300,924,376,0.915785405829827,0.608695652173913,1.72121115155394,654,315,339,36,1.1,33.23,2.5,0,0,0,0,0,0,0.0437201319392636,34.7182260873781,5.49496404929117
8.7,"eps_greedy_SVM","SVM",19,13,2512,2472,40,1400,1018,382,0.920560776327424,0.603260869565217,1.73917039641944,664,321,343,10,1.1,35.79,2.7,0,0,0,0,0,0,0.0311117374878927,28.8020691793898,3.56626520680374
8.7,"eps_greedy_SVM","SVM",19,14,2412,2380,32,1500,1110,390,0.926949406222391,0.614130434782609,1.76032958681653,680,330,350,16,1.1,38.34,2.8,0,0,0,0,0,0,0.0378809580346554,36.0501950631613,4.60471134708795
8.7,"eps_greedy_SVM","SVM",19,15,2312,2286,26,1600,1204,396,0.92766709196191,0.608695652173913,1.77010919563217,703,342,361,23,1.1,40.9,3,0,0,0,0,0,0,0.0553477410696089,39.3303718723544,6.410571197677
8.7,"eps_greedy_SVM","SVM",19,16,2212,2187,25,1700,1303,397,0.927191701835305,0.614130434782609,1.77010919563217,713,343,370,10,1.1,43.46,3.3,0,0,0,0,0,0,0.0404170313363251,28.2655363334712,4.55890577304888
8.7,"eps_greedy_SVM","SVM",19,17,2112,2092,20,1800,1398,402,0.926883465011279,0.614130434782609,1.76848225703325,727,349,378,14,1.1,46.01,3.5,0,0,0,0,0,0,0.0345366334657363,22.702560608975,4.10902433255441
8.7,"eps_greedy_SVM","SVM",19,18,2012,1996,16,1900,1494,406,0.92630839630974,0.608695652173913,1.76848225703325,731,354,377,4,1.1,48.57,3.7,0,0,0,0,0,0,0.0247329773255815,19.5297560953848,3.38964806439171
8.7,"eps_greedy_SVM","SVM",19,19,1912,1901,11,2000,1589,411,0.925791601236623,0.603260869565217,1.76523733546071,746,359,387,15,1.1,51.12,3.9,0,0,0,0,0,0,0.0183308604130036,16.6409212328781,2.44157205845199
8.7,"eps_greedy_SVM","SVM",19,20,1812,1802,10,2100,1688,412,0.92549256551182,0.608695652173913,1.77173913043478,750,361,389,4,1.1,53.68,4.1,0,0,0,0,0,0,0.0151328093845052,13.5343610665856,1.57295112984315
8.7,"eps_greedy_SVM","SVM",19,21,1712,1702,10,2200,1788,412,0.924449774266366,0.603260869565217,1.77010919563217,767,367,400,17,1.1,56.24,4.3,0,0,0,0,0,0,0.0115631445819388,9.74084663746349,1.37300997302944
8.7,"eps_greedy_SVM","SVM",19,22,1612,1604,8,2300,1886,414,0.924695136912358,0.608695652173913,1.77173913043478,772,371,401,5,1.1,58.79,4.6,0,0,0,0,0,0,0.0123659537784809,9.99868028869275,1.26356888825383
8.7,"eps_greedy_SVM","SVM",19,23,1512,1504,8,2400,1986,414,0.924403768770247,0.603260869565217,1.76848225703325,784,380,404,12,1.1,61.35,4.8,0,0,0,0,0,0,0.00845250327973826,6.22739059798094,0.975889790725138
8.7,"eps_greedy_SVM","SVM",19,24,1412,1406,6,2500,2084,416,0.92511532044362,0.608695652173913,1.77010919563217,790,383,407,6,1.1,63.91,5,0,0,0,0,0,0,0.00810350099610149,5.56638517646075,0.839228933001252
8.7,"eps_greedy_SVM","SVM",19,25,1312,1306,6,2600,2184,416,0.925412822651884,0.608695652173913,1.76848225703325,786,384,402,-4,1,66.46,5.2,0,0,0,0,0,0,0.00673959795325844,4.32686124329804,0.732156698095618
8.7,"eps_greedy_SVM","SVM",19,26,1212,1206,6,2700,2284,416,0.925468029247231,0.603260869565217,1.76361933606982,787,384,403,1,1,69.02,5.5,0,0,0,0,0,0,0.0057906163666518,3.1888902704298,0.592747843255665
8.7,"eps_greedy_SVM","SVM",19,27,1112,1107,5,2800,2383,417,0.926170379821378,0.603260869565217,1.77173913043478,797,391,406,10,1,71.57,5.7,0,0,0,0,0,0,0.00521194625845006,2.65491948859929,0.558850733624581
8.7,"eps_greedy_SVM","SVM",19,28,1012,1008,4,2900,2482,418,0.926477083128867,0.603260869565217,1.77173913043478,804,394,410,7,1,74.13,5.9,0,0,0,0,0,0,0.00494183761654088,2.30483313357278,0.531309151960408
8.7,"eps_greedy_SVM","SVM",19,29,912,908,4,3000,2582,418,0.92700154578467,0.603260869565217,1.77010919563217,805,394,411,1,1,76.69,6.2,0,0,0,0,0,0,0.00393776889860312,1.63095059384394,0.430310394704689
8.7,"eps_greedy_SVM","SVM",19,30,812,809,3,3100,2681,419,0.927032216115419,0.592391304347826,1.77010919563217,808,396,412,3,1,79.24,6.4,0,0,0,0,0,0,0.0035148338299435,1.3354386809665,0.38686570003366
8.7,"eps_greedy_SVM","SVM",19,31,712,709,3,3200,2781,419,0.927262243596036,0.592391304347826,1.76848225703325,804,396,408,-4,1,81.8,6.6,0,0,0,0,0,0,0.00240109571592091,0.834250586019096,0.277821098865555
8.7,"eps_greedy_SVM","SVM",19,32,612,609,3,3300,2881,419,0.927305182059085,0.592391304347826,1.77010919563217,805,396,409,1,1,84.36,6.9,0,0,0,0,0,0,0.0017712202715469,0.600863928403548,0.214737240552139
8.7,"eps_greedy_SVM","SVM",19,33,512,510,2,3400,2980,420,0.927608818333506,0.592391304347826,1.76848225703325,811,398,413,6,1,86.91,7.1,0,0,0,0,0,0,0.00129305805135055,0.427434609062906,0.155687391255777
8.7,"eps_greedy_SVM","SVM",19,34,412,411,1,3500,3079,421,0.928366375503007,0.592391304347826,1.77010919563217,815,399,416,4,1,89.47,7.3,0,0,0,0,0,0,0.00114806646164561,0.352603057730162,0.13593385431563
8.7,"eps_greedy_SVM","SVM",19,35,312,312,0,3600,3178,422,0.930540901953098,0.597826086956522,1.77661995448557,820,404,416,5,1,92.02,7.5,0,0,0,0,0,0,0.00099059847936427,0.250856987212982,0.11735339195094
8.7,"eps_greedy_SVM","SVM",19,36,212,212,0,3700,3278,422,0.930612977230361,0.597826086956522,1.78152774441509,823,404,419,3,1,94.58,7.8,0,0,0,0,0,0,0.000546007502536563,0.115285921924126,0.0705304572700494
8.7,"eps_greedy_SVM","SVM",19,37,112,112,0,3800,3378,422,0.930686586024159,0.597826086956522,1.77825287723785,831,405,426,8,1.1,97.14,8,0,0,0,0,0,0,0.00037504229756761,0.0569387034653617,0.0528418455812329
8.7,"eps_greedy_SVM","SVM",19,38,12,12,0,3900,3478,422,0.931178844832685,0.58695652173913,1.78316970546985,829,405,424,-2,1,99.69,8.2,0,0,0,0,0,0,0.000242159117979958,0.00365594983973575,0.00365594983973575
8.7,"eps_greedy_SVM","SVM",19,39,0,0,0,3912,3490,422,0.931209515163435,0.58695652173913,1.78152774441509,829,405,424,0,1,100,8.3,0,0,0,0,0,0,0,0,0
8.7,"eps_greedy_SVM","SVM",20,0,3812,3410,402,100,86,14,0.89801215950409,0.589473684210526,1.72526897353882,32,14,18,0,1.3,2.56,6.1,0,0,0,0,0,0,0.787886458988797,473.946215214795,86.4329500119651
8.7,"eps_greedy_SVM","SVM",20,1,3712,3376,336,200,120,80,0.905005364487107,0.594736842105263,1.73155959752322,108,54,54,76,1,5.11,1.5,0,0,0,0,0,0,0.76997470206008,412.975909833522,82.8582465692485
8.7,"eps_greedy_SVM","SVM",20,2,3612,3339,273,300,157,143,0.891889193538764,0.631578947368421,1.6937113003096,182,92,90,74,1,7.67,1.1,0,0,0,0,0,0,0.572607632401162,251.360776902873,69.0907599662524
8.7,"eps_greedy_SVM","SVM",20,3,3512,3302,210,400,194,206,0.875204148536689,0.631578947368421,1.62248847926267,251,128,123,69,1,10.22,0.9,0,0,0,0,0,0,0.325369298656842,174.891714549617,54.5998257119449
8.7,"eps_greedy_SVM","SVM",20,4,3412,3257,155,500,239,261,0.881447815461659,0.647368421052632,1.63693885448916,336,168,168,85,1,12.78,0.9,0,0,0,0,0,0,0.27597108438843,149.089199965239,39.6928941818737
8.7,"eps_greedy_SVM","SVM",20,5,3312,3183,129,600,313,287,0.875290576384329,0.657894736842105,1.60056166174406,401,200,201,65,1,15.34,1.1,0,0,0,0,0,0,0.193401067852703,143.191035878226,28.0771570640284
8.7,"eps_greedy_SVM","SVM",20,6,3212,3102,110,700,394,306,0.882285271502654,0.673684210526316,1.61300024254184,448,221,227,47,1,17.89,1.3,0,0,0,0,0,0,0.102628403509646,96.8707344465225,13.6946844073441
8.7,"eps_greedy_SVM","SVM",20,7,3112,3021,91,800,475,325,0.887041783393932,0.678947368421053,1.62449058425881,508,240,268,60,1.1,20.45,1.5,0,0,0,0,0,0,0.0728276684176263,90.4535025639745,9.77046549013625
8.7,"eps_greedy_SVM","SVM",20,8,3012,2939,73,900,557,343,0.887822614293382,0.673684210526316,1.63693885448916,545,260,285,37,1.1,23.01,1.6,0,0,0,0,0,0,0.0626683744933999,96.5330407339572,7.86743348995894
8.7,"eps_greedy_SVM","SVM",20,9,2912,2850,62,1000,646,354,0.902428920545994,0.668421052631579,1.64943297470195,573,276,297,28,1.1,25.56,1.8,0,0,0,0,0,0,0.0530085508525121,78.7071347411415,6.0631528096176
8.7,"eps_greedy_SVM","SVM",20,10,2812,2762,50,1100,734,366,0.908277701615309,0.673684210526316,1.66839197441117,606,290,316,33,1.1,28.12,2,0,0,0,0,0,0,0.0613104489025387,98.2831918957695,6.70172620216192
8.7,"eps_greedy_SVM","SVM",20,11,2712,2670,42,1200,826,374,0.920537044763668,0.668421052631579,1.6952694523798,631,306,325,25,1.1,30.67,2.2,0,0,0,0,0,0,0.0665032666401738,95.1434563874727,7.86038184272716
8.7,"eps_greedy_SVM","SVM",20,12,2612,2576,36,1300,920,380,0.926841807236118,0.663157894736842,1.71263544891641,656,316,340,25,1.1,33.23,2.4,0,0,0,0,0,0,0.0619986186719675,68.458354940884,6.9567166527473
8.7,"eps_greedy_SVM","SVM",20,13,2512,2479,33,1400,1017,383,0.929588126601924,0.652631578947368,1.74102167182663,672,321,351,16,1.1,35.79,2.7,0,0,0,0,0,0,0.0546325899042625,55.2979256359813,5.9282156667953
8.7,"eps_greedy_SVM","SVM",20,14,2412,2382,30,1500,1114,386,0.930762353221694,0.642105263157895,1.75370747310265,679,324,355,7,1.1,38.34,2.9,0,0,0,0,0,0,0.0512543984814139,50.2229527214526,5.55681615030667
8.7,"eps_greedy_SVM","SVM",20,15,2312,2286,26,1600,1210,390,0.930945639864119,0.647368421052632,1.75370747310265,687,330,357,8,1.1,40.9,3.1,0,0,0,0,0,0,0.047142703219565,42.8588695173659,5.32615339539989
8.7,"eps_greedy_SVM","SVM",20,16,2212,2194,18,1700,1302,398,0.929640281337564,0.642105263157895,1.75370747310265,711,340,371,24,1.1,43.46,3.3,0,0,0,0,0,0,0.0444664812602037,40.7329260827192,5.47214372633133
8.7,"eps_greedy_SVM","SVM",20,17,2112,2101,11,1800,1395,405,0.928989092209593,0.647368421052632,1.75532379335435,728,348,380,17,1.1,46.01,3.4,0,0,0,0,0,0,0.0412946088276378,41.5343737462136,4.90579291735226
8.7,"eps_greedy_SVM","SVM",20,18,2012,2002,10,1900,1494,406,0.928962269774115,0.647368421052632,1.75370747310265,732,349,383,4,1.1,48.57,3.7,0,0,0,0,0,0,0.0294406916752526,29.4337429400068,3.2052073117003
8.7,"eps_greedy_SVM","SVM",20,19,1912,1902,10,2000,1594,406,0.928819216784904,0.647368421052632,1.75048374613003,735,351,384,3,1.1,51.12,3.9,0,0,0,0,0,0,0.0252685872679841,25.4625204432412,2.71434930794828
8.7,"eps_greedy_SVM","SVM",20,20,1812,1802,10,2100,1694,406,0.928548012159524,0.647368421052632,1.75209412676125,737,354,383,2,1.1,53.68,4.2,0,0,0,0,0,0,0.0208206393741135,20.328562265128,2.20637408206711
8.7,"eps_greedy_SVM","SVM",20,21,1712,1703,9,2200,1793,407,0.928455623770655,0.652631578947368,1.75532379335435,744,356,388,7,1.1,56.24,4.4,0,0,0,0,0,0,0.0190376854391343,17.0024513044043,1.93592677005734
8.7,"eps_greedy_SVM","SVM",20,22,1612,1603,9,2300,1893,407,0.928859450438118,0.631578947368421,1.77266647281186,766,372,394,22,1.1,58.79,4.7,0,0,0,0,0,0,0.0134097383887811,9.02116423970737,1.72571278030812
8.7,"eps_greedy_SVM","SVM",20,23,1512,1505,7,2400,1991,409,0.929231984264191,0.642105263157895,1.76940789473684,767,371,396,1,1.1,61.35,4.9,0,0,0,0,0,0,0.0101358623201373,7.93761595630358,1.19644487036939
8.7,"eps_greedy_SVM","SVM",20,24,1412,1408,4,2500,2088,412,0.92974757107947,0.636842105263158,1.77266647281186,779,376,403,12,1.1,63.91,5.1,0,0,0,0,0,0,0.00995191668743341,7.07752216793739,1.02268720065562
8.7,"eps_greedy_SVM","SVM",20,25,1312,1308,4,2600,2188,412,0.930215473565013,0.626315789473684,1.77266647281186,788,383,405,9,1.1,66.46,5.3,0,0,0,0,0,0,0.00818257493518025,5.23198234015504,0.947241497460343
8.7,"eps_greedy_SVM","SVM",20,26,1212,1208,4,2700,2288,412,0.930158848423451,0.626315789473684,1.77266647281186,785,381,404,-3,1.1,69.02,5.6,0,0,0,0,0,0,0.00641928846425741,3.83929138290746,0.678091641192966
8.7,"eps_greedy_SVM","SVM",20,27,1112,1108,4,2800,2388,412,0.930243786135794,0.626315789473684,1.77430026679602,785,383,402,0,1,71.57,5.8,0,0,0,0,0,0,0.00628736728790913,3.27117640187991,0.648350126043678
8.7,"eps_greedy_SVM","SVM",20,28,1012,1009,3,2900,2487,413,0.930669964832819,0.626315789473684,1.77266647281186,792,387,405,7,1,74.13,6,0,0,0,0,0,0,0.00536058179762473,2.47416083971811,0.559623790618563
8.7,"eps_greedy_SVM","SVM",20,29,912,909,3,3000,2587,413,0.930714668891948,0.621052631578947,1.77266647281186,794,387,407,2,1.1,76.69,6.3,0,0,0,0,0,0,0.00465856403582034,1.83892129021056,0.490653865649566
8.7,"eps_greedy_SVM","SVM",20,30,812,809,3,3100,2687,413,0.930991834058544,0.621052631578947,1.77430026679602,797,387,410,3,1.1,79.24,6.5,0,0,0,0,0,0,0.00404575765650098,1.41990823357347,0.449392982811809
8.7,"eps_greedy_SVM","SVM",20,31,712,710,2,3200,2786,414,0.931337545449139,0.621052631578947,1.77430026679602,800,390,410,3,1.1,81.8,6.7,0,0,0,0,0,0,0.00308280399198322,0.961410630007344,0.348123399786173
8.7,"eps_greedy_SVM","SVM",20,32,612,612,0,3300,2884,416,0.932030458365632,0.626315789473684,1.77266647281186,807,393,414,7,1.1,84.36,6.9,0,0,0,0,0,0,0.00238144967225872,0.728330056159072,0.284748778144026
8.7,"eps_greedy_SVM","SVM",20,33,512,512,0,3400,2984,416,0.932073672289455,0.626315789473684,1.77430026679602,812,395,417,5,1.1,86.91,7.2,0,0,0,0,0,0,0.00134114606746627,0.421931504371559,0.17610614150965
8.7,"eps_greedy_SVM","SVM",20,34,412,412,0,3500,3084,416,0.932207784466839,0.621052631578947,1.77430026679602,814,396,418,2,1.1,89.47,7.4,0,0,0,0,0,0,0.000763942459506155,0.22577816186819,0.0970276883984802
8.7,"eps_greedy_SVM","SVM",20,35,312,312,0,3600,3184,416,0.932048339989279,0.626315789473684,1.77266647281186,816,398,418,2,1.1,92.02,7.7,0,0,0,0,0,0,0.000476838756248303,0.120666496754731,0.0599628117994539
8.7,"eps_greedy_SVM","SVM",20,36,212,212,0,3700,3284,416,0.932021517553801,0.621052631578947,1.77266647281186,817,401,416,1,1,94.58,7.9,0,0,0,0,0,0,0.000263137435371335,0.0552885735623292,0.0348100217194222
8.7,"eps_greedy_SVM","SVM",20,37,112,112,0,3800,3384,416,0.932550515586815,0.621052631578947,1.77103568488839,822,405,417,5,1,97.14,8.1,0,0,0,0,0,0,0.000125158225923013,0.0212638045033554,0.0198877636806258
8.7,"eps_greedy_SVM","SVM",20,38,12,12,0,3900,3484,416,0.932946891577754,0.621052631578947,1.77103568488839,823,404,419,1,1,99.69,8.4,0,0,0,0,0,0,0.000102259424502872,0.00145721900496923,0.00145721900496923
8.7,"eps_greedy_SVM","SVM",20,39,0,0,0,3912,3496,416,0.932890266436191,0.621052631578947,1.77103568488839,824,404,420,1,1,100,8.4,0,0,0,0,0,0,0,0,0
8.7,"eps_greedy_SVM","SVM",21,0,3812,3418,394,100,87,13,0.88999636772365,0.517587939698492,1.7302920130607,30,13,17,0,1.3,2.56,6.7,0,0,0,0,0,0,0.392420183688337,426.693800661515,42.8765365072936
8.7,"eps_greedy_SVM","SVM",21,1,3712,3377,335,200,128,72,0.916712189290213,0.582914572864322,1.79040556970686,120,60,60,90,1,5.11,1.8,0,0,0,0,0,0,0.653291677592674,403.814976848616,71.7699979584982
8.7,"eps_greedy_SVM","SVM",21,2,3612,3337,275,300,168,132,0.909876645607087,0.592964824120603,1.71806595072881,187,93,94,67,1,7.67,1.3,0,0,0,0,0,0,0.612445368808633,362.228661511506,70.3602201600551
8.7,"eps_greedy_SVM","SVM",21,3,3512,3300,212,400,205,195,0.908160609536008,0.628140703517588,1.71491064136108,257,130,127,70,1,10.22,1.1,0,0,0,0,0,0,0.46693438589459,319.943986332432,60.8433212180947
8.7,"eps_greedy_SVM","SVM",21,4,3412,3253,159,500,252,248,0.90095182800742,0.623115577889447,1.69249562730781,332,166,166,75,1,12.78,1,0,0,0,0,0,0,0.242891287408224,170.220633740886,37.9902388320318
8.7,"eps_greedy_SVM","SVM",21,5,3312,3184,128,600,321,279,0.885224357415986,0.633165829145729,1.65629251228518,411,205,206,79,1,15.34,1.2,0,0,0,0,0,0,0.152573784550664,137.079748498326,21.4942563699626
8.7,"eps_greedy_SVM","SVM",21,6,3212,3110,102,700,395,305,0.889661740689773,0.648241206030151,1.64572633175075,469,230,239,58,1,17.89,1.3,0,0,0,0,0,0,0.11653883597335,143.334063242838,15.1357426153063
8.7,"eps_greedy_SVM","SVM",21,7,3112,3033,79,800,472,328,0.881745094281873,0.678391959798995,1.60955652226172,528,254,274,59,1.1,20.45,1.4,0,0,0,0,0,0,0.100600231342233,158.722575684425,12.5736152743858
8.7,"eps_greedy_SVM","SVM",21,8,3012,2943,69,900,562,338,0.88424335679535,0.673366834170854,1.62008939726256,562,269,293,34,1.1,23.01,1.7,0,0,0,0,0,0,0.0817769480902122,136.028662616379,9.55411351307096
8.7,"eps_greedy_SVM","SVM",21,9,2912,2849,63,1000,656,344,0.885885031303338,0.678391959798995,1.61414411507077,578,278,300,16,1.1,25.56,1.9,0,0,0,0,0,0,0.0674950775675487,108.362055833452,7.54829612774846
8.7,"eps_greedy_SVM","SVM",21,10,2812,2754,58,1100,751,349,0.893070932350979,0.678391959798995,1.63819095477387,590,285,305,12,1.1,28.12,2.2,0,0,0,0,0,0,0.0528531938933914,79.4197184606213,5.84558623409913
8.7,"eps_greedy_SVM","SVM",21,11,2712,2660,52,1200,845,355,0.904250907354069,0.668341708542714,1.65476878412301,609,296,313,19,1.1,30.67,2.4,0,0,0,0,0,0,0.0472668346456658,71.363285149078,5.28975212373294
8.7,"eps_greedy_SVM","SVM",21,12,2612,2569,43,1300,936,364,0.916883792897315,0.668341708542714,1.69685895039938,639,310,329,30,1.1,33.23,2.6,0,0,0,0,0,0,0.0681176254946063,85.1342256688008,7.54534926145365
8.7,"eps_greedy_SVM","SVM",21,13,2512,2470,42,1400,1035,365,0.921491349748153,0.663316582914573,1.72710840310106,652,316,336,13,1.1,35.79,2.8,0,0,0,0,0,0,0.0488191943523156,55.2367019876171,5.30503679400767
8.7,"eps_greedy_SVM","SVM",21,14,2412,2377,35,1500,1128,372,0.924617395457631,0.663316582914573,1.73774952108609,669,322,347,17,1.1,38.34,3,0,0,0,0,0,0,0.0634266314542328,53.2065786255179,7.19150547981542
8.7,"eps_greedy_SVM","SVM",21,15,2312,2284,28,1600,1221,379,0.925069284956346,0.663316582914573,1.7345551285841,690,332,358,21,1.1,40.9,3.2,0,0,0,0,0,0,0.0616702785347842,47.2275926710975,6.72098228427
8.7,"eps_greedy_SVM","SVM",21,16,2212,2189,23,1700,1316,384,0.924591654916562,0.658291457286432,1.73615085547332,705,337,368,15,1.1,43.46,3.4,0,0,0,0,0,0,0.0524086042739044,37.7069747040458,6.06591990306216
8.7,"eps_greedy_SVM","SVM",21,17,2112,2096,16,1800,1409,391,0.92425988794282,0.663316582914573,1.73296233232277,726,347,379,21,1.1,46.01,3.6,0,0,0,0,0,0,0.0381620458778308,31.4041582880075,5.17151905805272
8.7,"eps_greedy_SVM","SVM",21,18,2012,1999,13,1900,1506,394,0.924359990046968,0.653266331658292,1.73935113354792,729,348,381,3,1.1,48.57,3.8,0,0,0,0,0,0,0.0308320280260569,28.7282213336286,3.53912913249975
8.7,"eps_greedy_SVM","SVM",21,19,1912,1901,11,2000,1604,396,0.924954882551612,0.653266331658292,1.73615085547332,742,353,389,13,1.1,51.12,4.1,0,0,0,0,0,0,0.024870849368738,23.7528964193215,2.7208672520183
8.7,"eps_greedy_SVM","SVM",21,20,1812,1804,8,2100,1701,399,0.926178988282311,0.658291457286432,1.73615085547332,744,358,386,2,1.1,53.68,4.3,0,0,0,0,0,0,0.0215703116469034,20.4221152529323,2.30305612914094
8.7,"eps_greedy_SVM","SVM",21,21,1712,1705,7,2200,1800,400,0.926813921628613,0.658291457286432,1.73774952108609,752,359,393,8,1.1,56.24,4.5,0,0,0,0,0,0,0.0193065413197383,16.7531763380232,1.9769665750311
8.7,"eps_greedy_SVM","SVM",21,22,1612,1605,7,2300,1900,400,0.9285056471887,0.653266331658292,1.75585107859741,768,372,396,16,1.1,58.79,4.8,0,0,0,0,0,0,0.0135442989345942,9.15076230967354,1.69042698076184
8.7,"eps_greedy_SVM","SVM",21,23,1512,1506,6,2400,1999,401,0.928940376326707,0.658291457286432,1.75585107859741,771,372,399,3,1.1,61.35,5,0,0,0,0,0,0,0.00976690921651106,7.18009932664103,1.12263393057053
8.7,"eps_greedy_SVM","SVM",21,24,1412,1406,6,2500,2099,401,0.928881745094278,0.658291457286432,1.75585107859741,773,372,401,2,1.1,63.91,5.2,0,0,0,0,0,0,0.00954702390477705,6.76036913225992,0.989839159448808
8.7,"eps_greedy_SVM","SVM",21,25,1312,1307,5,2600,2198,402,0.92929645381146,0.648241206030151,1.75746937452238,783,376,407,10,1.1,66.46,5.5,0,0,0,0,0,0,0.00724636730548218,4.70814948981128,0.776448249476235
8.7,"eps_greedy_SVM","SVM",21,26,1212,1207,5,2700,2298,402,0.92922066221832,0.648241206030151,1.75585107859741,780,376,404,-3,1.1,69.02,5.7,0,0,0,0,0,0,0.00660045937578572,3.76840276890704,0.674543328275201
8.7,"eps_greedy_SVM","SVM",21,27,1112,1109,3,2800,2396,404,0.929273573330512,0.648241206030151,1.74940758840072,793,384,409,13,1.1,71.57,5.9,0,0,0,0,0,0,0.00551556104888782,2.87400123443437,0.611288994772689
8.7,"eps_greedy_SVM","SVM",21,28,1012,1009,3,2900,2496,404,0.92920207182755,0.648241206030151,1.75262341117351,793,384,409,0,1.1,74.13,6.2,0,0,0,0,0,0,0.00508229519809802,2.18958261655056,0.5210791915444
8.7,"eps_greedy_SVM","SVM",21,29,912,909,3,3000,2596,404,0.930055799772907,0.638190954773869,1.75262341117351,798,386,412,5,1.1,76.69,6.4,0,0,0,0,0,0,0.00385585685889388,1.43460569275354,0.424038558720894
8.7,"eps_greedy_SVM","SVM",21,30,812,809,3,3100,2696,404,0.930051509682728,0.64321608040201,1.74780409840218,798,386,412,0,1.1,79.24,6.7,0,0,0,0,0,0,0.00350920035760592,1.09136469478218,0.387747455072558
8.7,"eps_greedy_SVM","SVM",21,31,712,709,3,3200,2796,404,0.930363256235645,0.633165829145729,1.76327821259009,800,388,412,2,1.1,81.8,6.9,0,0,0,0,0,0,0.00220874829847196,0.648387445610055,0.277983790197335
8.7,"eps_greedy_SVM","SVM",21,32,612,609,3,3300,2896,404,0.930570610594233,0.633165829145729,1.76490185735306,803,388,415,3,1.1,84.36,7.2,0,0,0,0,0,0,0.00115804537959173,0.345103711456243,0.157180891460887
8.7,"eps_greedy_SVM","SVM",21,33,512,509,3,3400,2996,404,0.931112591986681,0.633165829145729,1.76165755246822,802,389,413,-1,1.1,86.91,7.4,0,0,0,0,0,0,0.000620513026879305,0.18140440956894,0.087455605635845
8.7,"eps_greedy_SVM","SVM",21,34,412,411,1,3500,3094,406,0.932343847867665,0.633165829145729,1.75842515328938,807,394,413,5,1,89.47,7.6,0,0,0,0,0,0,0.000638745791244949,0.19202995727687,0.0880200806195899
8.7,"eps_greedy_SVM","SVM",21,35,312,312,0,3600,3193,407,0.932925870101772,0.633165829145729,1.75681339787849,812,397,415,5,1,92.02,7.8,0,0,0,0,0,0,0.000576704275606572,0.14159030512354,0.0712744208782044
8.7,"eps_greedy_SVM","SVM",21,36,212,212,0,3700,3293,407,0.933532202846892,0.628140703517588,1.76327821259009,814,398,416,2,1,94.58,8.1,0,0,0,0,0,0,0.000243926265257711,0.0501719893248876,0.0316366010062681
8.7,"eps_greedy_SVM","SVM",21,37,112,112,0,3800,3393,407,0.933996962616148,0.633165829145729,1.75842515328938,815,400,415,1,1,97.14,8.3,0,0,0,0,0,0,0.000113348539443457,0.0202642956006062,0.0190697013723674
8.7,"eps_greedy_SVM","SVM",21,38,12,12,0,3900,3493,407,0.93433301968007,0.628140703517588,1.76906571424616,820,401,419,5,1,99.69,8.6,0,0,0,0,0,0,8.29623495964777e-05,0.00115275852462265,0.00115275852462265
8.7,"eps_greedy_SVM","SVM",21,39,0,0,0,3912,3505,407,0.934350180040781,0.628140703517588,1.76744271817805,822,401,421,2,1,100,8.6,0,0,0,0,0,0,0,0,0
8.7,"eps_greedy_SVM","SVM",22,0,3812,3413,399,100,92,8,0.845322228673242,0.412060301507538,1.65781904916286,31,8,23,0,2.9,2.56,11.5,0,0,0,0,0,0,0.171624429982717,328.657608016088,20.2736806113329
8.7,"eps_greedy_SVM","SVM",22,1,3712,3346,366,200,159,41,0.873682584807925,0.522613065326633,1.70311465159901,92,41,51,61,1.2,5.11,3.9,0,0,0,0,0,0,0.32777205305317,320.759926436193,43.2157618529029
8.7,"eps_greedy_SVM","SVM",22,2,3612,3300,312,300,205,95,0.879778802950427,0.547738693467337,1.64119680973676,180,88,92,88,1,7.67,2.2,0,0,0,0,0,0,0.472332726804201,268.742738595381,60.1992865702861
8.7,"eps_greedy_SVM","SVM",22,3,3512,3272,240,400,233,167,0.903953461101751,0.623115577889447,1.7302920130607,233,116,117,53,1,10.22,1.4,0,0,0,0,0,0,0.382589668330858,223.117428922144,55.6116525322181
8.7,"eps_greedy_SVM","SVM",22,4,3412,3233,179,500,272,228,0.918548347886274,0.653266331658292,1.75746937452238,320,160,160,87,1,12.78,1.2,0,0,0,0,0,0,0.353968470131101,214.236520068834,48.0365569248868
8.7,"eps_greedy_SVM","SVM",22,5,3312,3182,130,600,323,277,0.876917312801907,0.64321608040201,1.65172972299514,404,201,203,84,1,15.34,1.2,0,0,0,0,0,0,0.214681761164247,180.079998338073,29.2684458997382
8.7,"eps_greedy_SVM","SVM",22,6,3212,3109,103,700,396,304,0.890275223585197,0.663316582914573,1.64724173352953,467,228,239,63,1,17.89,1.3,0,0,0,0,0,0,0.124821874183877,126.451074575498,17.3666274706657
8.7,"eps_greedy_SVM","SVM",22,7,3112,3032,80,800,473,327,0.883275226445257,0.673366834170854,1.63064168770118,524,252,272,57,1.1,20.45,1.4,0,0,0,0,0,0,0.0831816902144366,104.440567711902,10.5636244261817
8.7,"eps_greedy_SVM","SVM",22,8,3012,2948,64,900,557,343,0.88318656458157,0.693467336683417,1.62008939726256,572,271,301,48,1.1,23.01,1.6,0,0,0,0,0,0,0.0774566128182776,128.547556216447,11.4120110473517
8.7,"eps_greedy_SVM","SVM",22,9,2912,2854,58,1000,651,349,0.897172258560873,0.678391959798995,1.65172972299514,588,284,304,16,1.1,25.56,1.9,0,0,0,0,0,0,0.0628308889020194,91.8156893947106,7.23385298490566
8.7,"eps_greedy_SVM","SVM",22,10,2812,2764,48,1100,741,359,0.907053766270168,0.688442211055276,1.66978141395684,613,299,314,25,1.1,28.12,2.1,0,0,0,0,0,0,0.0563615843511975,86.4198975805801,6.15694849235431
8.7,"eps_greedy_SVM","SVM",22,11,2712,2673,39,1200,832,368,0.922182054266761,0.688442211055276,1.70745270469997,634,308,326,21,1.1,30.67,2.3,0,0,0,0,0,0,0.0665491747225316,91.2336731925571,7.68537887759346
8.7,"eps_greedy_SVM","SVM",22,12,2612,2582,30,1300,923,377,0.929633940905413,0.678391959798995,1.74198817780362,671,321,350,37,1.1,33.23,2.4,0,0,0,0,0,0,0.0816924453680561,86.5994741093976,8.91221266443478
8.7,"eps_greedy_SVM","SVM",22,13,2512,2484,28,1400,1021,379,0.929694002167908,0.678391959798995,1.74519330784558,678,326,352,7,1.1,35.79,2.7,0,0,0,0,0,0,0.0650833752991378,66.4224923576199,7.00288258040778
8.7,"eps_greedy_SVM","SVM",22,14,2412,2387,25,1500,1118,382,0.930340375754691,0.673366834170854,1.75746937452238,688,330,358,10,1.1,38.34,2.9,0,0,0,0,0,0,0.0601501093063992,53.0884963086604,6.4989987523718
8.7,"eps_greedy_SVM","SVM",22,15,2312,2294,18,1600,1211,389,0.930697883269501,0.678391959798995,1.75746937452238,704,338,366,16,1.1,40.9,3.1,0,0,0,0,0,0,0.0576869003695141,47.8404497598784,6.51380645766418
8.7,"eps_greedy_SVM","SVM",22,16,2212,2199,13,1700,1306,394,0.930120151125569,0.678391959798995,1.75746937452238,716,345,371,12,1.1,43.46,3.3,0,0,0,0,0,0,0.0452311341832051,41.7566864500501,5.53464523025835
8.7,"eps_greedy_SVM","SVM",22,17,2112,2102,10,1800,1403,397,0.92935222498376,0.673366834170854,1.74680029984175,729,348,381,13,1.1,46.01,3.5,0,0,0,0,0,0,0.0360499311182139,36.1085492903022,4.06131125339595
8.7,"eps_greedy_SVM","SVM",22,18,2012,2003,9,1900,1502,398,0.928936086236522,0.678391959798995,1.74519330784558,733,349,384,4,1.1,48.57,3.8,0,0,0,0,0,0,0.0302650229999998,32.0079685998144,3.27030466306043
8.7,"eps_greedy_SVM","SVM",22,19,1912,1903,9,2000,1602,398,0.928974697048124,0.678391959798995,1.75585107859741,733,350,383,0,1.1,51.12,4,0,0,0,0,0,0,0.0253420948622016,24.7289166880923,2.5990742935942
8.7,"eps_greedy_SVM","SVM",22,20,1812,1803,9,2100,1702,398,0.927980826156953,0.653266331658292,1.77558761549684,755,362,393,22,1.1,53.68,4.3,0,0,0,0,0,0,0.0167266552025395,12.7871230452203,2.15215587248329
8.7,"eps_greedy_SVM","SVM",22,21,1712,1705,7,2200,1800,400,0.927889304233163,0.653266331658292,1.77232066496235,757,363,394,2,1.1,56.24,4.5,0,0,0,0,0,0,0.012651068903832,10.8116259384827,1.42994672128455
8.7,"eps_greedy_SVM","SVM",22,22,1612,1607,5,2300,1898,402,0.928195330665837,0.658291457286432,1.77232066496235,760,367,393,3,1.1,58.79,4.7,0,0,0,0,0,0,0.0127034268334187,10.7541110244883,1.32614482902887
8.7,"eps_greedy_SVM","SVM",22,23,1512,1507,5,2400,1998,402,0.927956515645945,0.648241206030151,1.77069169376293,776,374,402,16,1.1,61.35,5,0,0,0,0,0,0,0.00922350560659682,7.02929863238279,1.06976054747283
8.7,"eps_greedy_SVM","SVM",22,24,1412,1407,5,2500,2098,402,0.927962235766182,0.648241206030151,1.77069169376293,773,373,400,-3,1.1,63.91,5.2,0,0,0,0,0,0,0.00786557783205354,5.81565226376247,0.829026417690791
8.7,"eps_greedy_SVM","SVM",22,25,1312,1307,5,2600,2198,402,0.927957945676004,0.648241206030151,1.76906571424616,779,374,405,6,1.1,66.46,5.5,0,0,0,0,0,0,0.00750658605328037,4.94658627419954,0.766386442048201
8.7,"eps_greedy_SVM","SVM",22,26,1212,1207,5,2700,2298,402,0.928183890425361,0.653266331658292,1.77232066496235,780,377,403,1,1.1,69.02,5.7,0,0,0,0,0,0,0.00552665268353177,3.30033936405692,0.605596880247366
8.7,"eps_greedy_SVM","SVM",22,27,1112,1108,4,2800,2397,403,0.928269692228915,0.648241206030151,1.77232066496235,780,378,402,0,1.1,71.57,5.9,0,0,0,0,0,0,0.00546750158113491,2.87651344040558,0.5595271348157
8.7,"eps_greedy_SVM","SVM",22,28,1012,1008,4,2900,2497,403,0.9285928790223,0.648241206030151,1.77558761549684,786,383,403,6,1.1,74.13,6.2,0,0,0,0,0,0,0.00454733653019465,2.14879808370113,0.49665068092606
8.7,"eps_greedy_SVM","SVM",22,29,912,909,3,3000,2596,404,0.928910345695451,0.638190954773869,1.77395263610872,791,384,407,5,1.1,76.69,6.4,0,0,0,0,0,0,0.00418159184972803,1.64987897258778,0.436780105231002
8.7,"eps_greedy_SVM","SVM",22,30,812,810,2,3100,2695,405,0.929396555915589,0.638190954773869,1.77395263610872,798,387,411,7,1.1,79.24,6.7,0,0,0,0,0,0,0.00362922703771911,1.26996900470658,0.402007562309473
8.7,"eps_greedy_SVM","SVM",22,31,712,710,2,3200,2795,405,0.929446606967662,0.638190954773869,1.77069169376293,799,387,412,1,1.1,81.8,6.9,0,0,0,0,0,0,0.00256884827557487,0.828789862737894,0.307987439193999
8.7,"eps_greedy_SVM","SVM",22,32,612,611,1,3300,2894,406,0.929556719282224,0.638190954773869,1.76906571424616,803,390,413,4,1.1,84.36,7.1,0,0,0,0,0,0,0.00151209311254476,0.5049577008733,0.202601078796687
8.7,"eps_greedy_SVM","SVM",22,33,512,512,0,3400,2993,407,0.929456617178077,0.638190954773869,1.76906571424616,804,392,412,1,1.1,86.91,7.4,0,0,0,0,0,0,0.00119707491257978,0.39545632297256,0.1526132592501
8.7,"eps_greedy_SVM","SVM",22,34,412,412,0,3500,3093,407,0.929679701867318,0.638190954773869,1.76906571424616,808,392,416,4,1.1,89.47,7.6,0,0,0,0,0,0,0.000805320250864752,0.238827841940663,0.100402951510853
8.7,"eps_greedy_SVM","SVM",22,35,312,312,0,3600,3193,407,0.929902786556559,0.633165829145729,1.76906571424616,810,394,416,2,1.1,92.02,7.8,0,0,0,0,0,0,0.000499904943184325,0.129485362263863,0.0615147437492535
8.7,"eps_greedy_SVM","SVM",22,36,212,212,0,3700,3293,407,0.930177352327932,0.628140703517588,1.76906571424616,813,394,419,3,1.1,94.58,8.1,0,0,0,0,0,0,0.000301652141205526,0.0620449200149852,0.0377016430319195
8.7,"eps_greedy_SVM","SVM",22,37,112,112,0,3800,3393,407,0.930457638219543,0.628140703517588,1.77069169376293,814,396,418,1,1.1,97.14,8.3,0,0,0,0,0,0,0.000139678123487541,0.023152091067892,0.0216556698659814
8.7,"eps_greedy_SVM","SVM",22,38,12,12,0,3900,3493,407,0.930936698289392,0.628140703517588,1.77069169376293,817,397,420,3,1.1,99.69,8.6,0,0,0,0,0,0,8.81277374377557e-05,0.00121887885895937,0.00121887885895937
8.7,"eps_greedy_SVM","SVM",22,39,0,0,0,3912,3505,407,0.9309610088004,0.628140703517588,1.77232066496235,817,397,420,0,1.1,100,8.6,0,0,0,0,0,0,0,0,0
8.7,"eps_greedy_SVM","SVM",23,0,3812,3427,385,100,84,16,0.897494114861201,0.585365853658537,1.75394548063128,32,15,17,0,1.1,2.56,5.2,0,0,0,0,0,0,0.957209950854811,501.075429093022,96.9466611522504
8.7,"eps_greedy_SVM","SVM",23,1,3712,3401,311,200,110,90,0.896273906199948,0.590243902439024,1.73481152993348,75,37,38,43,1,5.11,1.2,0,0,0,0,0,0,0.736018544472427,293.318359564637,81.6500894042771
8.7,"eps_greedy_SVM","SVM",23,2,3612,3355,257,300,156,144,0.878894290370675,0.614634146341463,1.6781026815793,155,81,74,80,0.9,7.67,1.1,0,0,0,0,0,0,0.5,189.615630921962,64.1872008108669
8.7,"eps_greedy_SVM","SVM",23,3,3512,3310,202,400,201,199,0.880113106099675,0.619512195121951,1.71009684361549,238,121,117,83,1,10.22,1,0,0,0,0,0,0,0.234942631075513,103.537345377906,39.2458510536618
8.7,"eps_greedy_SVM","SVM",23,4,3412,3255,157,500,256,244,0.860146815060381,0.629268292682927,1.62688546701135,329,165,164,91,1,12.78,1,0,0,0,0,0,0,0.171913632509056,104.638320536608,25.5978379290126
8.7,"eps_greedy_SVM","SVM",23,5,3312,3190,122,600,321,279,0.856929141535853,0.639024390243902,1.57122534610811,393,195,198,64,1,15.34,1.2,0,0,0,0,0,0,0.114999432814993,95.1598170746117,19.3888241069342
8.7,"eps_greedy_SVM","SVM",23,6,3212,3109,103,700,402,298,0.86740120627934,0.653658536585366,1.581458024525,450,215,235,57,1.1,17.89,1.3,0,0,0,0,0,0,0.0767117308510797,70.8143064048389,11.0513864620999
8.7,"eps_greedy_SVM","SVM",23,7,3112,3036,76,800,475,325,0.865214302628464,0.668292682926829,1.54205469327421,507,242,265,57,1.1,20.45,1.5,0,0,0,0,0,0,0.063507403261333,100.556073598568,10.2118067394249
8.7,"eps_greedy_SVM","SVM",23,8,3012,2950,62,900,561,339,0.881057514173089,0.668292682926829,1.60633652702672,549,261,288,42,1.1,23.01,1.7,0,0,0,0,0,0,0.0617116618890054,91.7892355997297,7.37252701229359
8.7,"eps_greedy_SVM","SVM",23,9,2912,2864,48,1000,647,353,0.906830939811401,0.673170731707317,1.65174504783722,586,279,307,37,1.1,25.56,1.8,0,0,0,0,0,0,0.0563235570056028,90.2658559100889,6.3048484673612
8.7,"eps_greedy_SVM","SVM",23,10,2812,2774,38,1100,737,363,0.926063155548753,0.663414634146341,1.73004556419191,613,291,322,27,1.1,28.12,2,0,0,0,0,0,0,0.0901996063174106,112.383139033157,10.0087101513557
8.7,"eps_greedy_SVM","SVM",23,11,2712,2681,31,1200,830,370,0.927993759663473,0.648780487804878,1.75555904593085,641,303,338,28,1.1,30.67,2.2,0,0,0,0,0,0,0.0931176500263721,83.2145246927315,10.0115352077464
8.7,"eps_greedy_SVM","SVM",23,12,2612,2585,27,1300,926,374,0.92810519424441,0.648780487804878,1.75555904593085,650,312,338,9,1.1,33.23,2.5,0,0,0,0,0,0,0.0799145390658265,66.4667574484431,8.71486336239708
8.7,"eps_greedy_SVM","SVM",23,13,2512,2490,22,1400,1021,379,0.928180412586542,0.648780487804878,1.75879509947173,676,321,355,26,1.1,35.79,2.7,0,0,0,0,0,0,0.068520320717004,52.3131620435268,7.65910426115342
8.7,"eps_greedy_SVM","SVM",23,14,2412,2392,20,1500,1119,381,0.929096962014743,0.648780487804878,1.75717558280555,680,325,355,4,1.1,38.34,2.9,0,0,0,0,0,0,0.0537916507972352,41.9202963410119,6.10630870793262
8.7,"eps_greedy_SVM","SVM",23,15,2312,2296,16,1600,1215,385,0.928901951498105,0.648780487804878,1.75879509947173,685,328,357,5,1.1,40.9,3.2,0,0,0,0,0,0,0.039257834904079,34.328475004091,4.72973531941211
8.7,"eps_greedy_SVM","SVM",23,16,2212,2200,12,1700,1311,389,0.928408853477461,0.648780487804878,1.75879509947173,696,332,364,11,1.1,43.46,3.4,0,0,0,0,0,0,0.0286576642122381,28.7112670887815,3.34186109895762
8.7,"eps_greedy_SVM","SVM",23,17,2112,2102,10,1800,1409,391,0.929096962014743,0.648780487804878,1.75879509947173,704,336,368,8,1.1,46.01,3.6,0,0,0,0,0,0,0.0240370629028118,25.7156782804512,2.66796016042969
8.7,"eps_greedy_SVM","SVM",23,18,2012,2003,9,1900,1508,392,0.929882575810344,0.648780487804878,1.75879509947173,707,339,368,3,1.1,48.57,3.8,0,0,0,0,0,0,0.0181229745938317,18.8341443933908,1.98561237769865
8.7,"eps_greedy_SVM","SVM",23,19,1912,1903,9,2000,1608,392,0.929648563190377,0.64390243902439,1.75717558280555,708,340,368,1,1.1,51.12,4.1,0,0,0,0,0,0,0.0152219155414295,15.6495063741802,1.61611115728921
8.7,"eps_greedy_SVM","SVM",23,20,1812,1803,9,2100,1708,392,0.929815715061784,0.64390243902439,1.75879509947173,710,341,369,2,1.1,53.68,4.4,0,0,0,0,0,0,0.0129799446116458,12.6496118365129,1.37390153846849
8.7,"eps_greedy_SVM","SVM",23,21,1712,1705,7,2200,1806,394,0.929570558983724,0.639024390243902,1.75879509947173,713,344,369,3,1.1,56.24,4.6,0,0,0,0,0,0,0.0113131391971086,11.1110917958544,1.21820291341635
8.7,"eps_greedy_SVM","SVM",23,22,1612,1607,5,2300,1904,396,0.928729227897656,0.634146341463415,1.76596146071958,726,351,375,13,1.1,58.79,4.8,0,0,0,0,0,0,0.00981588558270767,9.19339860139877,1.12039763212422
8.7,"eps_greedy_SVM","SVM",23,23,1512,1507,5,2400,2004,396,0.928414425206511,0.634146341463415,1.76596146071958,727,351,376,1,1.1,61.35,5.1,0,0,0,0,0,0,0.00881820079776202,7.4420862883125,0.901204859930516
8.7,"eps_greedy_SVM","SVM",23,24,1412,1407,5,2500,2104,396,0.92797983034086,0.639024390243902,1.76271520803443,753,364,389,26,1.1,63.91,5.3,0,0,0,0,0,0,0.00615060922402994,4.0468823387352,0.786592630188343
8.7,"eps_greedy_SVM","SVM",23,25,1312,1307,5,2600,2204,396,0.927929684779439,0.639024390243902,1.76758907496909,753,364,389,0,1.1,66.46,5.6,0,0,0,0,0,0,0.0043780511630484,3.27481184706568,0.500816809286006
8.7,"eps_greedy_SVM","SVM",23,26,1212,1208,4,2700,2303,397,0.928152553941311,0.634146341463415,1.76758907496909,752,364,388,-1,1.1,69.02,5.8,0,0,0,0,0,0,0.00467581525176259,3.18264669932134,0.475752663278938
8.7,"eps_greedy_SVM","SVM",23,27,1112,1108,4,2800,2403,397,0.928035547631328,0.629268292682927,1.76271520803443,757,369,388,5,1.1,71.57,6.1,0,0,0,0,0,0,0.00327603065616251,1.93765847763564,0.389158046451203
8.7,"eps_greedy_SVM","SVM",23,28,1012,1009,3,2900,2502,398,0.92781685726624,0.629268292682927,1.75948086820318,763,371,392,6,1.1,74.13,6.3,0,0,0,0,0,0,0.00265549113610868,1.52865763096501,0.282459722841176
8.7,"eps_greedy_SVM","SVM",23,29,912,910,2,3000,2601,399,0.927773676366128,0.634146341463415,1.76109655311429,768,374,394,5,1.1,76.69,6.5,0,0,0,0,0,0,0.00233728487019067,1.18312741823941,0.245104550038036
8.7,"eps_greedy_SVM","SVM",23,30,812,810,2,3100,2701,399,0.927914362524559,0.634146341463415,1.75948086820318,774,377,397,6,1.1,79.24,6.8,0,0,0,0,0,0,0.00217934181257201,0.949016561204657,0.229229944506759
8.7,"eps_greedy_SVM","SVM",23,31,712,710,2,3200,2801,399,0.927918541321344,0.634146341463415,1.76109655311429,774,379,395,0,1,81.8,7,0,0,0,0,0,0,0.00209188951948032,0.76087319206271,0.220277045959952
8.7,"eps_greedy_SVM","SVM",23,32,612,610,2,3300,2901,399,0.928323884609498,0.624390243902439,1.75625837577057,779,380,399,5,1.1,84.36,7.3,0,0,0,0,0,0,0.00150227635489373,0.466491944951354,0.169841115090706
8.7,"eps_greedy_SVM","SVM",23,33,512,511,1,3400,3000,400,0.928752907746102,0.629268292682927,1.76271520803443,784,383,401,5,1,86.91,7.5,0,0,0,0,0,0,0.00108476168207566,0.328044712680646,0.132705888243353
8.7,"eps_greedy_SVM","SVM",23,34,412,412,0,3500,3099,401,0.92868604699754,0.629268292682927,1.75948086820318,789,386,403,5,1,89.47,7.7,0,0,0,0,0,0,0.000789139802300231,0.235355518850823,0.101210276792633
8.7,"eps_greedy_SVM","SVM",23,35,312,312,0,3600,3199,401,0.928656795420045,0.629268292682927,1.76109655311429,791,387,404,2,1,92.02,8,0,0,0,0,0,0,0.000431364102314726,0.115002780597765,0.0560735770689108
8.7,"eps_greedy_SVM","SVM",23,36,212,212,0,3700,3299,401,0.928550932568154,0.629268292682927,1.76338116171647,795,390,405,4,1,94.58,8.2,0,0,0,0,0,0,0.000311100935107852,0.0649145222547646,0.039266311937685
8.7,"eps_greedy_SVM","SVM",23,37,112,112,0,3800,3399,401,0.928715298575034,0.629268292682927,1.76338116171647,796,391,405,1,1,97.14,8.5,0,0,0,0,0,0,0.000143155219662787,0.022570001100244,0.0210527186656854
8.7,"eps_greedy_SVM","SVM",23,38,12,12,0,3900,3499,401,0.92872922789765,0.624390243902439,1.77311463639015,798,391,407,2,1,99.69,8.7,0,0,0,0,0,0,9.91044111523016e-05,0.00135656603241731,0.00135656603241731
8.7,"eps_greedy_SVM","SVM",23,39,0,0,0,3912,3511,401,0.928738978423482,0.624390243902439,1.77474733863361,798,391,407,0,1,100,8.8,0,0,0,0,0,0,0,0,0
8.7,"eps_greedy_SVM","SVM",24,0,3812,3436,376,100,86,14,0.886230842911903,0.560185185185185,1.71544221817446,31,14,17,0,1.2,2.56,6.1,0,0,0,0,0,0,0.525731502636804,485.66316279636,56.9019325893044
8.7,"eps_greedy_SVM","SVM",24,1,3712,3406,306,200,116,84,0.887319071945535,0.564814814814815,1.72644872186577,99,50,49,68,1,5.11,1.4,0,0,0,0,0,0,0.668172254345673,326.392937171945,78.2775120798641
8.7,"eps_greedy_SVM","SVM",24,2,3612,3376,236,300,146,154,0.884836632609636,0.574074074074074,1.73280179903915,148,75,73,49,1,7.67,0.9,0,0,0,0,0,0,0.475427373141247,184.405146607659,61.1368574323806
8.7,"eps_greedy_SVM","SVM",24,3,3512,3334,178,400,188,212,0.87683056619839,0.578703703703704,1.72764976958525,227,115,112,79,1,10.22,0.9,0,0,0,0,0,0,0.308605148006419,122.98790860098,45.8998811413519
8.7,"eps_greedy_SVM","SVM",24,4,3412,3276,136,500,246,254,0.847643944231588,0.597222222222222,1.6426744423982,324,163,161,97,1,12.78,1,0,0,0,0,0,0,0.261511607442595,166.57339060186,33.9739660171404
8.7,"eps_greedy_SVM","SVM",24,5,3312,3195,117,600,327,273,0.861369199659436,0.601851851851852,1.6245016865992,385,190,195,61,1,15.34,1.2,0,0,0,0,0,0,0.0876841947063917,54.7129934835558,12.7079698743165
8.7,"eps_greedy_SVM","SVM",24,6,3212,3121,91,700,401,299,0.866240953597274,0.611111111111111,1.59411162314388,438,215,223,53,1,17.89,1.3,0,0,0,0,0,0,0.0887237153517771,69.4493846088413,11.2168935686753
8.7,"eps_greedy_SVM","SVM",24,7,3112,3038,74,800,484,316,0.861060557684117,0.62962962962963,1.5857654889913,489,235,254,51,1.1,20.45,1.5,0,0,0,0,0,0,0.0662278007178784,75.5956384995515,8.80295352576379
8.7,"eps_greedy_SVM","SVM",24,8,3012,2953,59,900,569,331,0.854640272456364,0.638888888888889,1.56907322068612,521,253,268,32,1.1,23.01,1.7,0,0,0,0,0,0,0.0653943559976409,103.340449830021,8.84376899719609
8.7,"eps_greedy_SVM","SVM",24,9,2912,2860,52,1000,662,338,0.865788633461056,0.638888888888889,1.61320273441486,549,262,287,28,1.1,25.56,2,0,0,0,0,0,0,0.0620393509758244,98.1782056078149,7.25569319380422
8.7,"eps_greedy_SVM","SVM",24,10,2812,2766,46,1100,756,344,0.884641070668382,0.638888888888889,1.62599754450583,574,276,298,25,1.1,28.12,2.2,0,0,0,0,0,0,0.0567744564905024,81.5446977078729,6.22826388010698
8.7,"eps_greedy_SVM","SVM",24,11,2712,2674,38,1200,848,352,0.895556619838223,0.634259259259259,1.64116324235919,592,286,306,18,1.1,30.67,2.4,0,0,0,0,0,0,0.0584525552944563,76.7518715890436,6.41062324257351
8.7,"eps_greedy_SVM","SVM",24,12,2612,2580,32,1300,942,358,0.908755055342705,0.634259259259259,1.70938203396767,616,296,320,24,1.1,33.23,2.6,0,0,0,0,0,0,0.059797199702512,66.5001677975241,6.31098835504843
8.7,"eps_greedy_SVM","SVM",24,13,2512,2482,30,1400,1040,360,0.911661877394645,0.634259259259259,1.72605893186004,622,300,322,6,1.1,35.79,2.9,0,0,0,0,0,0,0.0478027817379937,51.2167859661931,5.18253950679215
8.7,"eps_greedy_SVM","SVM",24,14,2412,2386,26,1500,1136,364,0.912702213707967,0.634259259259259,1.72764976958525,631,304,327,9,1.1,38.34,3.1,0,0,0,0,0,0,0.0426359212533421,45.6887359961922,4.70217583954223
8.7,"eps_greedy_SVM","SVM",24,15,2312,2292,20,1600,1230,370,0.916320774797792,0.638888888888889,1.72644872186577,653,312,341,22,1.1,40.9,3.3,0,0,0,0,0,0,0.0499603590188472,42.1587614680008,5.80541923011289
8.7,"eps_greedy_SVM","SVM",24,16,2212,2195,17,1700,1327,373,0.915919008088552,0.638888888888889,1.7312091503268,661,315,346,8,1.1,43.46,3.6,0,0,0,0,0,0,0.0371815823253544,35.890086240208,4.60764586083263
8.7,"eps_greedy_SVM","SVM",24,17,2112,2101,11,1800,1421,379,0.917315879097496,0.638888888888889,1.73599590373784,671,321,350,10,1.1,46.01,3.7,0,0,0,0,0,0,0.0302255498187281,31.2976997426906,3.46298172620921
8.7,"eps_greedy_SVM","SVM",24,18,2012,2003,9,1900,1519,381,0.917879948914447,0.643518518518518,1.74434203789042,677,323,354,6,1.1,48.57,4,0,0,0,0,0,0,0.023719540263866,24.8049976029467,2.56154891028535
8.7,"eps_greedy_SVM","SVM",24,19,1912,1903,9,2000,1619,381,0.917744252873578,0.634259259259259,1.74434203789042,688,327,361,11,1.1,51.12,4.2,0,0,0,0,0,0,0.0206972308243955,21.4380968152636,2.22379677842017
8.7,"eps_greedy_SVM","SVM",24,20,1812,1805,7,2100,1717,383,0.917781502767146,0.638888888888889,1.73953227124183,695,330,365,7,1.1,53.68,4.5,0,0,0,0,0,0,0.0207364268848106,20.1168099725923,2.10180422290869
8.7,"eps_greedy_SVM","SVM",24,21,1712,1705,7,2200,1817,383,0.916678639846741,0.634259259259259,1.76450163398693,714,348,366,19,1.1,56.24,4.7,0,0,0,0,0,0,0.0126622693495161,8.7535502793688,1.74236878694269
8.7,"eps_greedy_SVM","SVM",24,22,1612,1606,6,2300,1916,384,0.916264899957426,0.634259259259259,1.76612491055913,714,349,365,0,1,58.79,5,0,0,0,0,0,0,0.00898291849897531,7.10365380232179,1.05197531888848
8.7,"eps_greedy_SVM","SVM",24,23,1512,1507,5,2400,2015,385,0.916686621966793,0.634259259259259,1.76775117659096,717,350,367,3,1,61.35,5.2,0,0,0,0,0,0,0.00861332718228852,6.878539129278,0.914297363262123
8.7,"eps_greedy_SVM","SVM",24,24,1412,1407,5,2500,2115,385,0.916320774797785,0.62962962962963,1.76938044034818,722,354,368,5,1,63.91,5.5,0,0,0,0,0,0,0.00638411625312483,4.82451278633096,0.699643230289869
8.7,"eps_greedy_SVM","SVM",24,25,1312,1307,5,2600,2215,385,0.915857811834823,0.62962962962963,1.76450163398693,726,359,367,4,1,66.46,5.8,0,0,0,0,0,0,0.00510576551887547,3.5097777256458,0.537584969258134
8.7,"eps_greedy_SVM","SVM",24,26,1212,1210,2,2700,2312,388,0.917378405704558,0.625,1.76450163398693,740,363,377,14,1,69.02,6,0,0,0,0,0,0,0.00491006478482788,3.14914004675273,0.530940090845462
8.7,"eps_greedy_SVM","SVM",24,27,1112,1110,2,2800,2412,388,0.917794806300566,0.625,1.76450163398693,748,367,381,8,1,71.57,6.2,0,0,0,0,0,0,0.00395003188150667,2.31826399174297,0.43244623583078
8.7,"eps_greedy_SVM","SVM",24,28,1012,1011,1,2900,2511,389,0.917849350787573,0.625,1.76450163398693,751,369,382,3,1,74.13,6.5,0,0,0,0,0,0,0.00410552961319784,1.94944249263682,0.434217262059352
8.7,"eps_greedy_SVM","SVM",24,29,912,911,1,3000,2611,389,0.917635163899543,0.625,1.76126401630989,753,370,383,2,1,76.69,6.7,0,0,0,0,0,0,0.00325734311549131,1.44223586500574,0.359087866217824
8.7,"eps_greedy_SVM","SVM",24,30,812,811,1,3100,2711,389,0.917736270753523,0.625,1.76612491055913,754,370,384,1,1,79.24,7,0,0,0,0,0,0,0.0032322468694984,1.29219915028489,0.351667572392713
8.7,"eps_greedy_SVM","SVM",24,31,712,711,1,3200,2811,389,0.917877288207759,0.625,1.76288133863891,753,371,382,-1,1,81.8,7.2,0,0,0,0,0,0,0.00219447436024842,0.770253318659185,0.243196507771586
8.7,"eps_greedy_SVM","SVM",24,32,612,611,1,3300,2911,389,0.917889261387835,0.625,1.76126401630989,755,371,384,2,1,84.36,7.5,0,0,0,0,0,0,0.00157670790587497,0.506545370090007,0.184990833439655
8.7,"eps_greedy_SVM","SVM",24,33,512,511,1,3400,3011,389,0.917950457641558,0.62037037037037,1.76775117659096,759,371,388,4,1,86.91,7.7,0,0,0,0,0,0,0.00098705160557851,0.330122239542747,0.130847850670533
8.7,"eps_greedy_SVM","SVM",24,34,412,412,0,3500,3110,390,0.917871966794387,0.615740740740741,1.76450163398693,769,375,394,10,1.1,89.47,8,0,0,0,0,0,0,0.00106050630894531,0.313545852567615,0.127909204882778
8.7,"eps_greedy_SVM","SVM",24,35,312,312,0,3600,3210,390,0.917911877394641,0.615740740740741,1.76288133863891,764,375,389,-5,1,92.02,8.2,0,0,0,0,0,0,0.000597032678267506,0.146726053249295,0.0728676327046403
8.7,"eps_greedy_SVM","SVM",24,36,212,212,0,3700,3310,390,0.918953544061304,0.615740740740741,1.76450163398693,769,377,392,5,1,94.58,8.5,0,0,0,0,0,0,0.000400733551001368,0.0826481903691237,0.0524005072827115
8.7,"eps_greedy_SVM","SVM",24,37,112,112,0,3800,3410,390,0.919651979565772,0.615740740740741,1.76288133863891,773,378,395,4,1,97.14,8.7,0,0,0,0,0,0,0.000157853638173175,0.0259368624630642,0.0242470935364675
8.7,"eps_greedy_SVM","SVM",24,38,12,12,0,3900,3510,390,0.92015485312899,0.611111111111111,1.76288133863891,775,378,397,2,1.1,99.69,9,0,0,0,0,0,0,0.0001152007131469,0.0018690270526886,0.0018690270526886
8.7,"eps_greedy_SVM","SVM",24,39,0,0,0,3912,3522,390,0.920204076202638,0.611111111111111,1.76450163398693,776,379,397,1,1,100,9,0,0,0,0,0,0,0,0,0
8.7,"eps_greedy_SVM","SVM",25,0,3812,3411,401,100,88,12,0.873513999629693,0.481865284974093,1.69067596284711,34,12,22,0,1.8,2.56,7.3,0,0,0,0,0,0,0.229091724399752,438.617826080053,26.4656192305619
8.7,"eps_greedy_SVM","SVM",25,1,3712,3348,364,200,151,49,0.909601215544621,0.559585492227979,1.74030460040823,107,49,58,73,1.2,5.11,3.1,0,0,0,0,0,0,0.644338635887895,450.548886097765,75.231706230879
8.7,"eps_greedy_SVM","SVM",25,2,3612,3322,290,300,177,123,0.921205611019834,0.601036269430052,1.72941008698959,170,86,84,63,1,7.67,1.4,0,0,0,0,0,0,0.607849664718114,377.618197273902,70.3304884388209
8.7,"eps_greedy_SVM","SVM",25,3,3512,3289,223,400,210,190,0.927925492051637,0.637305699481865,1.73737971872687,231,116,115,61,1,10.22,1.1,0,0,0,0,0,0,0.495132537877663,332.252105559609,60.8213436625862
8.7,"eps_greedy_SVM","SVM",25,4,3412,3242,170,500,257,243,0.916760467761327,0.647668393782383,1.7325891496495,325,164,161,94,1,12.78,1.1,0,0,0,0,0,0,0.346204391670147,255.428933803074,46.3794802336432
8.7,"eps_greedy_SVM","SVM",25,5,3312,3185,127,600,314,286,0.875721141836076,0.637305699481865,1.61594995343951,415,208,207,90,1,15.34,1.1,0,0,0,0,0,0,0.275389574901799,299.566616439877,34.520684590808
8.7,"eps_greedy_SVM","SVM",25,6,3212,3106,106,700,393,307,0.90390849323603,0.663212435233161,1.67045487075258,477,230,247,62,1.1,17.89,1.3,0,0,0,0,0,0,0.128460384486975,154.371035031221,18.7752161154638
8.7,"eps_greedy_SVM","SVM",25,7,3112,3028,84,800,471,329,0.903204617658901,0.678756476683938,1.64875419079549,532,253,279,55,1.1,20.45,1.4,0,0,0,0,0,0,0.0824406309291472,117.946728002648,9.97169125880383
8.7,"eps_greedy_SVM","SVM",25,8,3012,2943,69,900,556,344,0.910935493256617,0.694300518134715,1.67978702086852,570,273,297,38,1.1,23.01,1.6,0,0,0,0,0,0,0.0856657741531132,127.926847118515,11.8859346857682
8.7,"eps_greedy_SVM","SVM",25,9,2912,2852,60,1000,647,353,0.912384389538555,0.694300518134715,1.67978702086852,596,289,307,26,1.1,25.56,1.8,0,0,0,0,0,0,0.08024673770884,116.261954904016,9.61636329466002
8.7,"eps_greedy_SVM","SVM",25,10,2812,2755,57,1100,744,356,0.916031611213809,0.689119170984456,1.69067596284711,608,295,313,12,1.1,28.12,2.1,0,0,0,0,0,0,0.0589230623989547,76.93930996717,6.30399788120851
8.7,"eps_greedy_SVM","SVM",25,11,2712,2661,51,1200,838,362,0.919805207209806,0.689119170984456,1.69377239184116,617,300,317,9,1.1,30.67,2.3,0,0,0,0,0,0,0.0525780966701925,71.8558071084039,5.69499039742924
8.7,"eps_greedy_SVM","SVM",25,12,2612,2564,48,1300,935,365,0.922409106004537,0.683937823834197,1.69845132110039,638,307,331,21,1.1,33.23,2.6,0,0,0,0,0,0,0.0457664702218302,60.7041515315635,4.92179982775585
8.7,"eps_greedy_SVM","SVM",25,13,2512,2467,45,1400,1032,368,0.927043810744178,0.689119170984456,1.72803896755092,650,311,339,12,1.1,35.79,2.8,0,0,0,0,0,0,0.042583927092491,52.9331723842948,5.01565295250201
8.7,"eps_greedy_SVM","SVM",25,14,2412,2377,35,1500,1122,378,0.934391154973128,0.683937823834197,1.74672046990282,679,325,354,29,1.1,38.34,3,0,0,0,0,0,0,0.0549940546842553,56.0792541575452,6.14244958590688
8.7,"eps_greedy_SVM","SVM",25,15,2312,2282,30,1600,1217,383,0.934729132807663,0.673575129533679,1.75606122107877,689,331,358,10,1.1,40.9,3.2,0,0,0,0,0,0,0.052762199810117,45.6608431376663,5.89575221263877
8.7,"eps_greedy_SVM","SVM",25,16,2212,2188,24,1700,1311,389,0.934204532429715,0.66839378238342,1.75444422179601,709,338,371,20,1.1,43.46,3.4,0,0,0,0,0,0,0.0518243468020708,43.4763533327245,5.97881128034747
8.7,"eps_greedy_SVM","SVM",25,17,2112,2094,18,1800,1405,395,0.933186190519578,0.66839378238342,1.74511207168007,728,345,383,19,1.1,46.01,3.6,0,0,0,0,0,0,0.0465742902105681,41.5032955617286,5.47422272433628
8.7,"eps_greedy_SVM","SVM",25,18,2012,1999,13,1900,1500,400,0.932811475963902,0.673575129533679,1.74511207168007,736,351,385,8,1.1,48.57,3.8,0,0,0,0,0,0,0.0388033370786157,35.7674520128226,4.33621502974147
8.7,"eps_greedy_SVM","SVM",25,19,1912,1899,13,2000,1600,400,0.932748288803534,0.673575129533679,1.74350663279168,738,353,385,2,1.1,51.12,4,0,0,0,0,0,0,0.0298601170222069,28.1019458954424,3.20921799685653
8.7,"eps_greedy_SVM","SVM",25,20,1812,1801,11,2100,1698,402,0.93280853702621,0.673575129533679,1.74511207168007,739,355,384,1,1.1,53.68,4.2,0,0,0,0,0,0,0.0260244561760748,24.4189104571558,2.77005465924751
8.7,"eps_greedy_SVM","SVM",25,21,1712,1703,9,2200,1796,404,0.93294225869118,0.673575129533679,1.75283019767292,763,365,398,24,1.1,56.24,4.4,0,0,0,0,0,0,0.0173947366154728,15.4293027694674,2.05204419980358
8.7,"eps_greedy_SVM","SVM",25,22,1612,1604,8,2300,1895,405,0.932857029498121,0.66839378238342,1.75606122107877,760,366,394,-3,1.1,58.79,4.7,0,0,0,0,0,0,0.0163590211294142,13.0529379917943,1.64375917121308
8.7,"eps_greedy_SVM","SVM",25,23,1512,1504,8,2400,1995,405,0.932336837526706,0.66839378238342,1.77474272343067,785,380,405,25,1.1,61.35,4.9,0,0,0,0,0,0,0.0102917480840666,6.26538284601039,1.41685049204223
8.7,"eps_greedy_SVM","SVM",25,24,1412,1406,6,2500,2093,407,0.932198707455202,0.66839378238342,1.77474272343067,791,383,408,6,1.1,63.91,5.1,0,0,0,0,0,0,0.00835545587494391,5.71355914387518,0.983761582117806
8.7,"eps_greedy_SVM","SVM",25,25,1312,1307,5,2600,2192,408,0.932382391060926,0.66839378238342,1.77310852202788,789,384,405,-2,1.1,66.46,5.4,0,0,0,0,0,0,0.00662156556722039,4.5275774069578,0.720718392126441
8.7,"eps_greedy_SVM","SVM",25,26,1212,1207,5,2700,2292,408,0.932322142838249,0.66839378238342,1.77474272343067,789,384,405,0,1.1,69.02,5.6,0,0,0,0,0,0,0.00624840702620033,3.86306698643565,0.640356445564248
8.7,"eps_greedy_SVM","SVM",25,27,1112,1107,5,2800,2392,408,0.931904813686041,0.66839378238342,1.7714773274354,796,387,409,7,1.1,71.57,5.9,0,0,0,0,0,0,0.004637032026483,2.62097552818747,0.515756248279817
8.7,"eps_greedy_SVM","SVM",25,28,1012,1007,5,2900,2492,408,0.931920977843344,0.66839378238342,1.76984913136239,797,387,410,1,1.1,74.13,6.1,0,0,0,0,0,0,0.00448899978128366,2.12366048863299,0.457969758708154
8.7,"eps_greedy_SVM","SVM",25,29,912,907,5,3000,2592,408,0.932206054799421,0.663212435233161,1.77310852202788,805,392,413,8,1.1,76.69,6.4,0,0,0,0,0,0,0.00373935818791396,1.51046758180289,0.415190152017767
8.7,"eps_greedy_SVM","SVM",25,30,812,807,5,3100,2692,408,0.932239852582874,0.663212435233161,1.76660170176356,807,392,415,2,1.1,79.24,6.6,0,0,0,0,0,0,0.00331815580476829,1.09130291719746,0.354081358829853
8.7,"eps_greedy_SVM","SVM",25,31,712,707,5,3200,2792,408,0.932245730458255,0.663212435233161,1.77474272343067,809,395,414,2,1,81.8,6.8,0,0,0,0,0,0,0.00216779703342376,0.640211855247798,0.263103004739313
8.7,"eps_greedy_SVM","SVM",25,32,612,610,2,3300,2889,411,0.93316855689341,0.66839378238342,1.7714773274354,821,399,422,12,1.1,84.36,7,0,0,0,0,0,0,0.00182683820883467,0.576840328557691,0.237059442280207
8.7,"eps_greedy_SVM","SVM",25,33,512,511,1,3400,2988,412,0.933812184247869,0.66839378238342,1.76984913136239,829,402,427,8,1.1,86.91,7.3,0,0,0,0,0,0,0.00114916493810679,0.365795590843775,0.15618992185598
8.7,"eps_greedy_SVM","SVM",25,34,412,411,1,3500,3088,412,0.934103139079334,0.66839378238342,1.76984913136239,830,404,426,1,1.1,89.47,7.5,0,0,0,0,0,0,0.000582597482714212,0.164355561628213,0.0754803904782131
8.7,"eps_greedy_SVM","SVM",25,35,312,312,0,3600,3187,413,0.934626269988435,0.658031088082902,1.7714773274354,834,407,427,4,1,92.02,7.7,0,0,0,0,0,0,0.000484815448325949,0.124540926937811,0.0635690172027473
8.7,"eps_greedy_SVM","SVM",25,36,212,212,0,3700,3287,413,0.934640964676893,0.658031088082902,1.7714773274354,838,407,431,4,1.1,94.58,8,0,0,0,0,0,0,0.000238113354390324,0.0493744729956111,0.0311824002981359
8.7,"eps_greedy_SVM","SVM",25,37,112,112,0,3800,3387,413,0.934854037659533,0.658031088082902,1.76660170176356,840,409,431,2,1.1,97.14,8.2,0,0,0,0,0,0,8.24208346222267e-05,0.0146376309885969,0.0137487506598586
8.7,"eps_greedy_SVM","SVM",25,38,12,12,0,3900,3487,413,0.935093561081398,0.658031088082902,1.7714773274354,841,409,432,1,1.1,99.69,8.4,0,0,0,0,0,0,6.14439468083403e-05,0.00084236198071531,0.00084236198071531
8.7,"eps_greedy_SVM","SVM",25,39,0,0,0,3912,3499,413,0.935250794247898,0.658031088082902,1.77310852202788,841,409,432,0,1.1,100,8.5,0,0,0,0,0,0,0,0,0
8.7,"eps_greedy_SVM","SVM",26,0,3812,3410,402,100,88,12,0.902382133408902,0.536458333333333,1.76807851239669,29,12,17,0,1.4,2.56,7.3,0,0,0,0,0,0,0.72513446404959,479.946993405817,77.3368638548639
8.7,"eps_greedy_SVM","SVM",26,1,3712,3371,341,200,127,73,0.905875023620548,0.552083333333333,1.74137340036563,112,55,57,83,1,5.11,1.7,0,0,0,0,0,0,0.686780379357999,439.678828378063,74.3599261064501
8.7,"eps_greedy_SVM","SVM",26,2,3612,3342,270,300,156,144,0.895784615929704,0.578125,1.70415900735294,166,85,81,54,1,7.67,1.1,0,0,0,0,0,0,0.642090286104227,312.872722363067,71.4181505601746
8.7,"eps_greedy_SVM","SVM",26,3,3512,3307,205,400,191,209,0.877573164682531,0.588541666666667,1.61691513761468,239,122,117,73,1,10.22,0.9,0,0,0,0,0,0,0.508047531433448,294.697642059374,62.7971459576505
8.7,"eps_greedy_SVM","SVM",26,4,3412,3263,149,500,235,265,0.865826365268331,0.619791666666667,1.59969008264463,328,168,160,89,1,12.78,0.9,0,0,0,0,0,0,0.332935205675258,278.461915768677,44.2439249558021
8.7,"eps_greedy_SVM","SVM",26,5,3312,3198,114,600,300,300,0.85988727088058,0.625,1.55434283088235,410,205,205,82,1,15.34,1,0,0,0,0,0,0,0.157391710648107,140.621074703268,23.9333371437545
8.7,"eps_greedy_SVM","SVM",26,6,3212,3125,87,700,373,327,0.863104095804986,0.635416666666667,1.55940650779102,486,235,251,76,1.1,17.89,1.1,0,0,0,0,0,0,0.12071835443384,139.016985821151,15.6044349466769
8.7,"eps_greedy_SVM","SVM",26,7,3112,3042,70,800,456,344,0.868936897675739,0.625,1.58243336397059,515,250,265,29,1.1,20.45,1.3,0,0,0,0,0,0,0.0749371539062791,96.0168587744753,9.47391784187941
8.7,"eps_greedy_SVM","SVM",26,8,3012,2958,54,900,540,360,0.8768217356387,0.651041666666667,1.58388914443422,568,272,296,53,1.1,23.01,1.5,0,0,0,0,0,0,0.0736280925324439,116.210358148371,9.23653193909506
8.7,"eps_greedy_SVM","SVM",26,9,2912,2863,49,1000,635,365,0.88639691987905,0.635416666666667,1.6213776448942,583,279,304,15,1.1,25.56,1.7,0,0,0,0,0,0,0.0596100747207184,86.3826499708773,6.66807080918359
8.7,"eps_greedy_SVM","SVM",26,10,2812,2772,40,1100,726,374,0.893570188492054,0.630208333333333,1.63225138121547,609,290,319,26,1.1,28.12,1.9,0,0,0,0,0,0,0.0659833634317719,110.426782870484,7.37087459587487
8.7,"eps_greedy_SVM","SVM",26,11,2712,2680,32,1200,818,382,0.907336545729407,0.614583333333333,1.66823827046918,634,302,332,25,1.1,30.67,2.1,0,0,0,0,0,0,0.069995170254137,95.0766346673408,8.06183069127443
8.7,"eps_greedy_SVM","SVM",26,12,2612,2582,30,1300,916,384,0.91456148431595,0.604166666666667,1.70887096774194,647,312,335,13,1.1,33.23,2.4,0,0,0,0,0,0,0.0532334497572288,64.4517828844045,5.86016378047119
8.7,"eps_greedy_SVM","SVM",26,13,2512,2487,25,1400,1011,389,0.921818901171593,0.604166666666667,1.75549954170486,665,318,347,18,1.1,35.79,2.6,0,0,0,0,0,0,0.0508607621518967,58.6494657589842,5.58153315239101
8.7,"eps_greedy_SVM","SVM",26,14,2412,2389,23,1500,1109,391,0.924130763416492,0.604166666666667,1.77133164673413,667,320,347,2,1.1,38.34,2.8,0,0,0,0,0,0,0.0442579589622056,47.4364042496044,4.86733491580223
8.7,"eps_greedy_SVM","SVM",26,15,2312,2292,20,1600,1206,394,0.926215277777793,0.604166666666667,1.7774334251607,677,324,353,10,1.1,40.9,3.1,0,0,0,0,0,0,0.0400562708139678,40.0526147707934,4.66503524862765
8.7,"eps_greedy_SVM","SVM",26,16,2212,2198,14,1700,1300,400,0.926184275793667,0.604166666666667,1.76970358455882,696,334,362,19,1.1,43.46,3.2,0,0,0,0,0,0,0.0337937509136904,33.7943919075566,4.22443790972596
8.7,"eps_greedy_SVM","SVM",26,17,2112,2101,11,1800,1397,403,0.926349619709007,0.604166666666667,1.77296270718232,708,336,372,12,1.1,46.01,3.5,0,0,0,0,0,0,0.0287139585009101,30.5999009232104,3.25482889294316
8.7,"eps_greedy_SVM","SVM",26,18,2012,2001,11,1900,1497,403,0.926371763983384,0.604166666666667,1.77133164673413,708,336,372,0,1.1,48.57,3.7,0,0,0,0,0,0,0.0242310664142882,25.6254001387124,2.58556725875725
8.7,"eps_greedy_SVM","SVM",26,19,1912,1901,11,2000,1597,403,0.926640447845818,0.604166666666667,1.78234346224678,708,340,368,0,1.1,51.12,4,0,0,0,0,0,0,0.0184051172739517,19.4440327143311,1.97949724065276
8.7,"eps_greedy_SVM","SVM",26,20,1812,1803,9,2100,1695,405,0.92701247165534,0.609375,1.78070377184913,711,342,369,3,1.1,53.68,4.2,0,0,0,0,0,0,0.0162713396107008,17.1925031582609,1.7414027235637
8.7,"eps_greedy_SVM","SVM",26,21,1712,1704,8,2200,1794,406,0.927006566515503,0.609375,1.7774334251607,722,351,371,11,1.1,56.24,4.4,0,0,0,0,0,0,0.0136038490195373,13.4885700329583,1.41681145407482
8.7,"eps_greedy_SVM","SVM",26,22,1612,1605,7,2300,1893,407,0.926909131708234,0.59375,1.7774334251607,739,361,378,17,1,58.79,4.7,0,0,0,0,0,0,0.0116360005614051,10.030159319565,1.41812038169051
8.7,"eps_greedy_SVM","SVM",26,23,1512,1506,6,2400,1992,408,0.926563681027963,0.59375,1.7774334251607,740,361,379,1,1,61.35,4.9,0,0,0,0,0,0,0.00921445898003087,7.87225047506199,0.947446005659014
8.7,"eps_greedy_SVM","SVM",26,24,1412,1406,6,2500,2092,408,0.927445023148128,0.59375,1.77580275229358,753,366,387,13,1.1,63.91,5.1,0,0,0,0,0,0,0.00680807111958969,5.2996745306495,0.811652165167519
8.7,"eps_greedy_SVM","SVM",26,25,1312,1307,5,2600,2191,409,0.927446499433087,0.59375,1.78070377184913,756,367,389,3,1.1,66.46,5.4,0,0,0,0,0,0,0.00705714162052784,5.52724387277429,0.742593986748089
8.7,"eps_greedy_SVM","SVM",26,26,1212,1207,5,2700,2291,409,0.927207341269824,0.598958333333333,1.78070377184913,761,372,389,5,1,69.02,5.6,0,0,0,0,0,0,0.00559979090472332,3.97902125633498,0.60374213431538
8.7,"eps_greedy_SVM","SVM",26,27,1112,1108,4,2800,2390,410,0.926872224584262,0.59375,1.77580275229358,765,374,391,4,1,71.57,5.8,0,0,0,0,0,0,0.00496235969257542,3.17882512025956,0.514695642520045
8.7,"eps_greedy_SVM","SVM",26,28,1012,1008,4,2900,2490,410,0.926365858843522,0.588541666666667,1.77417506874427,772,378,394,7,1,74.13,6.1,0,0,0,0,0,0,0.00456056350189229,2.6458798427026,0.482284339276356
8.7,"eps_greedy_SVM","SVM",26,29,912,909,3,3000,2589,411,0.926107508975797,0.583333333333333,1.78234346224678,776,381,395,4,1,76.69,6.3,0,0,0,0,0,0,0.00412564742939992,2.11968675694327,0.441262320059088
8.7,"eps_greedy_SVM","SVM",26,30,812,809,3,3100,2689,411,0.92579453656461,0.583333333333333,1.78234346224678,777,382,395,1,1,79.24,6.5,0,0,0,0,0,0,0.00327930558746968,1.45703184348395,0.349841046685432
8.7,"eps_greedy_SVM","SVM",26,31,712,710,2,3200,2788,412,0.925849159108072,0.583333333333333,1.78514908256881,778,382,396,1,1,81.8,6.8,0,0,0,0,0,0,0.00314726953104676,1.28361968877206,0.340577599932848
8.7,"eps_greedy_SVM","SVM",26,32,612,610,2,3300,2888,412,0.925971690759621,0.583333333333333,1.78843060661765,779,383,396,1,1,84.36,7,0,0,0,0,0,0,0.00277818837271045,1.00238071579989,0.302864332679377
8.7,"eps_greedy_SVM","SVM",26,33,512,510,2,3400,2988,412,0.92591706821616,0.583333333333333,1.7867883379247,780,383,397,1,1,86.91,7.3,0,0,0,0,0,0,0.00190394120981466,0.61820139750849,0.219040636419073
8.7,"eps_greedy_SVM","SVM",26,34,412,412,0,3500,3086,414,0.926339285714273,0.588541666666667,1.79007589696412,788,387,401,8,1,89.47,7.5,0,0,0,0,0,0,0.00215392812500874,0.672145729682101,0.260409587745854
8.7,"eps_greedy_SVM","SVM",26,35,312,312,0,3600,3186,414,0.926153273809512,0.583333333333333,1.79337557603687,787,388,399,-1,1,92.02,7.7,0,0,0,0,0,0,0.00138250242973063,0.361264259013846,0.166988313621548
8.7,"eps_greedy_SVM","SVM",26,36,212,212,0,3700,3286,414,0.926321570294772,0.583333333333333,1.79007589696412,793,389,404,6,1,94.58,7.9,0,0,0,0,0,0,0.00077176827546598,0.164531121829754,0.0978640524378767
8.7,"eps_greedy_SVM","SVM",26,37,112,112,0,3800,3386,414,0.92616508408918,0.578125,1.79337557603687,797,391,406,4,1,97.14,8.2,0,0,0,0,0,0,0.000459134488994428,0.0702588098110402,0.0654018495171237
8.7,"eps_greedy_SVM","SVM",26,38,12,12,0,3900,3486,414,0.926101603835968,0.578125,1.79172421731123,798,391,407,1,1,99.69,8.4,0,0,0,0,0,0,0.000270992260603133,0.00406233160968141,0.00406233160968141
8.7,"eps_greedy_SVM","SVM",26,39,0,0,0,3912,3498,414,0.926135558390012,0.578125,1.7867883379247,798,391,407,0,1,100,8.4,0,0,0,0,0,0,0,0,0
8.7,"eps_greedy_SVM","SVM",27,0,3812,3405,407,100,86,14,0.855345124910353,0.432432432432432,1.71506289699838,37,14,23,0,1.6,2.56,6.1,0,0,0,0,0,0,0.364922117690811,482.172054330704,43.7506726299466
8.7,"eps_greedy_SVM","SVM",27,1,3712,3360,352,200,131,69,0.907940238375025,0.518918918918919,1.7426907570554,131,64,67,94,1,5.11,1.9,0,0,0,0,0,0,0.574623740232214,589.821977288737,63.5220701189794
8.7,"eps_greedy_SVM","SVM",27,2,3612,3327,285,300,164,136,0.909362552840828,0.583783783783784,1.70876330876331,192,97,95,61,1,7.67,1.2,0,0,0,0,0,0,0.676699803780517,462.58649551836,75.223098930388
8.7,"eps_greedy_SVM","SVM",27,3,3512,3290,222,400,201,199,0.91400491400492,0.610810810810811,1.7426907570554,262,134,128,70,1,10.22,1,0,0,0,0,0,0,0.561720982421159,342.608697348639,67.3899779749115
8.7,"eps_greedy_SVM","SVM",27,4,3412,3245,167,500,246,254,0.892584736063007,0.621621621621622,1.65506943407496,344,174,170,82,1,12.78,1,0,0,0,0,0,0,0.319990258824696,265.703302041241,47.9350175185416
8.7,"eps_greedy_SVM","SVM",27,5,3312,3197,115,600,294,306,0.842896821157699,0.632432432432432,1.535413354531,428,215,213,84,1,15.34,1,0,0,0,0,0,0,0.2529466443893,241.461285363463,33.5875721403007
8.7,"eps_greedy_SVM","SVM",27,6,3212,3117,95,700,374,326,0.862813801944243,0.637837837837838,1.57573286257739,478,236,242,50,1,17.89,1.1,0,0,0,0,0,0,0.140419510861173,175.612333080907,18.9381062769779
8.7,"eps_greedy_SVM","SVM",27,7,3112,3042,70,800,449,351,0.861513574557057,0.654054054054054,1.57573286257739,552,266,286,74,1.1,20.45,1.3,0,0,0,0,0,0,0.113566130042157,170.775023845459,14.6974180014216
8.7,"eps_greedy_SVM","SVM",27,8,3012,2952,60,900,539,361,0.873481160437677,0.654054054054054,1.59812679038485,583,278,305,31,1.1,23.01,1.5,0,0,0,0,0,0,0.0754871437058194,113.307168138938,8.67975076810702
8.7,"eps_greedy_SVM","SVM",27,9,2912,2858,54,1000,633,367,0.87517817083034,0.648648648648649,1.60491310077327,604,289,315,21,1.1,25.56,1.7,0,0,0,0,0,0,0.0646002777077844,97.6269656762953,6.98358844485157
8.7,"eps_greedy_SVM","SVM",27,10,2812,2762,50,1100,729,371,0.885286980939152,0.643243243243243,1.61315580286169,621,296,325,17,1.1,28.12,2,0,0,0,0,0,0,0.0495389137535834,66.4193188623606,5.55720871433554
8.7,"eps_greedy_SVM","SVM",27,11,2712,2665,47,1200,826,374,0.888052253269652,0.648648648648649,1.61167448440176,631,300,331,10,1.1,30.67,2.2,0,0,0,0,0,0,0.0495218732238809,65.6897941053537,5.03465111438782
8.7,"eps_greedy_SVM","SVM",27,12,2612,2567,45,1300,924,376,0.912790147572771,0.621621621621622,1.67655758416528,664,326,338,33,1,33.23,2.5,0,0,0,0,0,0,0.0452420320642397,30.965712125775,5.86207071344916
8.7,"eps_greedy_SVM","SVM",27,13,2512,2472,40,1400,1019,381,0.917224960703232,0.621621621621622,1.70876330876331,677,332,345,13,1,35.79,2.7,0,0,0,0,0,0,0.0327573443254357,25.0301184074553,3.77137292904665
8.7,"eps_greedy_SVM","SVM",27,14,2412,2378,34,1500,1113,387,0.923205701466575,0.621621621621622,1.73629556161666,691,339,352,14,1,38.34,2.9,0,0,0,0,0,0,0.0276628424744087,24.9083409347442,3.28516503779018
8.7,"eps_greedy_SVM","SVM",27,15,2312,2284,28,1600,1207,393,0.928217376043467,0.621621621621622,1.75242645960878,702,344,358,11,1,40.9,3.1,0,0,0,0,0,0,0.0500234736125828,33.2283363469618,6.17958293473337
8.7,"eps_greedy_SVM","SVM",27,16,2212,2185,27,1700,1306,394,0.929323790193362,0.621621621621622,1.76378627475402,712,350,362,10,1,43.46,3.3,0,0,0,0,0,0,0.0339202610449138,23.2014987245404,3.7963342186049
8.7,"eps_greedy_SVM","SVM",27,17,2112,2093,19,1800,1398,402,0.930859035206871,0.621621621621622,1.76701660338024,737,361,376,25,1,46.01,3.5,0,0,0,0,0,0,0.0410082278764647,24.1264592120343,4.86907719120687
8.7,"eps_greedy_SVM","SVM",27,18,2012,1994,18,1900,1497,403,0.930831565614185,0.621621621621622,1.76701660338024,742,362,380,5,1,48.57,3.7,0,0,0,0,0,0,0.0308713459816521,18.7692297512948,3.66305347482526
8.7,"eps_greedy_SVM","SVM",27,19,1912,1898,14,2000,1593,407,0.931124574602849,0.621621621621622,1.76701660338024,749,367,382,7,1,51.12,3.9,0,0,0,0,0,0,0.0211827967607882,14.6372984509678,2.95393632067806
8.7,"eps_greedy_SVM","SVM",27,20,1812,1800,12,2100,1691,409,0.931338226990414,0.621621621621622,1.76377734287908,754,369,385,5,1,53.68,4.1,0,0,0,0,0,0,0.0149491444258826,12.32209426503,1.87698123548124
8.7,"eps_greedy_SVM","SVM",27,21,1712,1702,10,2200,1789,411,0.931535092404672,0.621621621621622,1.76539548723035,762,373,389,8,1,56.24,4.4,0,0,0,0,0,0,0.0116995980800471,9.97312863677186,1.28796614067861
8.7,"eps_greedy_SVM","SVM",27,22,1612,1604,8,2300,1887,413,0.931438948830269,0.621621621621622,1.76377734287908,767,373,394,5,1.1,58.79,4.6,0,0,0,0,0,0,0.0111959550300358,8.54509519247315,1.16523490302935
8.7,"eps_greedy_SVM","SVM",27,23,1512,1504,8,2400,1987,413,0.932177575655842,0.610810810810811,1.76539548723035,785,385,400,18,1,61.35,4.8,0,0,0,0,0,0,0.00835915058954222,5.49239019132637,1.01600702856618
8.7,"eps_greedy_SVM","SVM",27,24,1412,1405,7,2500,2086,414,0.931838784012704,0.610810810810811,1.77189786471554,790,386,404,5,1,63.91,5,0,0,0,0,0,0,0.00665474805206888,4.57970820450179,0.711596357624268
8.7,"eps_greedy_SVM","SVM",27,25,1312,1305,7,2600,2186,414,0.932363758450718,0.610810810810811,1.76539548723035,790,388,402,0,1,66.46,5.3,0,0,0,0,0,0,0.00570107100787366,3.6868261131671,0.612919021611131
8.7,"eps_greedy_SVM","SVM",27,26,1212,1206,6,2700,2285,415,0.932766645810123,0.616216216216216,1.76701660338024,792,388,404,2,1,69.02,5.5,0,0,0,0,0,0,0.0046172652548143,2.65576873309661,0.485626578180952
8.7,"eps_greedy_SVM","SVM",27,27,1112,1106,6,2800,2385,415,0.933190898408286,0.616216216216216,1.77026778388324,796,393,403,4,1,71.57,5.7,0,0,0,0,0,0,0.00427327551398294,2.30249731981214,0.459927573575274
8.7,"eps_greedy_SVM","SVM",27,28,1012,1008,4,2900,2483,417,0.933859325163669,0.616216216216216,1.76377734287908,804,396,408,8,1,74.13,6,0,0,0,0,0,0,0.00419959296637758,2.06445471386145,0.45786183752966
8.7,"eps_greedy_SVM","SVM",27,29,912,909,3,3000,2582,418,0.934048560135512,0.610810810810811,1.76377734287908,808,397,411,4,1,76.69,6.2,0,0,0,0,0,0,0.00400642878024647,1.81511633094545,0.433301766074942
8.7,"eps_greedy_SVM","SVM",27,30,812,809,3,3100,2682,418,0.93413554717902,0.610810810810811,1.76539548723035,809,397,412,1,1,79.24,6.4,0,0,0,0,0,0,0.00302381079018013,1.22263171487448,0.328334905395369
8.7,"eps_greedy_SVM","SVM",27,31,712,709,3,3200,2782,418,0.934077555816681,0.610810810810811,1.76864069952305,808,397,411,-1,1,81.8,6.7,0,0,0,0,0,0,0.00258726893344218,0.951623348219123,0.286706680440178
8.7,"eps_greedy_SVM","SVM",27,32,612,609,3,3300,2882,418,0.934384299601686,0.610810810810811,1.76377734287908,810,397,413,2,1,84.36,6.9,0,0,0,0,0,0,0.00189594965743635,0.644181827922825,0.222561721337028
8.7,"eps_greedy_SVM","SVM",27,33,512,509,3,3400,2982,418,0.934460604025817,0.610810810810811,1.76701660338024,811,399,412,1,1,86.91,7.1,0,0,0,0,0,0,0.0013138074958367,0.400927044761043,0.155478607954108
8.7,"eps_greedy_SVM","SVM",27,34,412,411,1,3500,3080,420,0.933779968562573,0.610810810810811,1.77026778388324,819,402,417,8,1,89.47,7.3,0,0,0,0,0,0,0.0016281649084256,0.491212195547156,0.206448887752795
8.7,"eps_greedy_SVM","SVM",27,35,312,312,0,3600,3179,421,0.933911212172077,0.605405405405405,1.76539548723035,828,406,422,9,1,92.02,7.6,0,0,0,0,0,0,0.0014319023094997,0.359809002422915,0.174152773860018
8.7,"eps_greedy_SVM","SVM",27,36,212,212,0,3700,3279,421,0.933781494651055,0.605405405405405,1.76864069952305,830,408,422,2,1,94.58,7.8,0,0,0,0,0,0,0.000702437118574487,0.14945880538927,0.0924479930240373
8.7,"eps_greedy_SVM","SVM",27,37,112,112,0,3800,3379,421,0.933746394615955,0.605405405405405,1.77353095030514,834,409,425,4,1,97.14,8,0,0,0,0,0,0,0.000320844443170506,0.0527339297529452,0.0491107542857445
8.7,"eps_greedy_SVM","SVM",27,38,12,12,0,3900,3479,421,0.933758603323816,0.605405405405405,1.77353095030514,835,409,426,1,1,99.69,8.3,0,0,0,0,0,0,0.00024286129629932,0.00329953853744027,0.00329953853744027
8.7,"eps_greedy_SVM","SVM",27,39,0,0,0,3912,3491,421,0.933709768492373,0.605405405405405,1.77353095030514,835,409,426,0,1,100,8.3,0,0,0,0,0,0,0,0,0
8.7,"eps_greedy_SVM","SVM",28,0,3812,3424,388,100,89,11,0.906384048303665,0.584541062801932,1.72438389100381,26,11,15,0,1.4,2.56,8.1,0,0,0,0,0,0,0.376779011708992,433.854934481663,42.1197810542578
8.7,"eps_greedy_SVM","SVM",28,1,3712,3385,327,200,128,72,0.924363956767575,0.594202898550725,1.77500200176155,101,50,51,75,1,5.11,1.8,0,0,0,0,0,0,0.798697094823185,468.673982940456,85.0282231445491
8.7,"eps_greedy_SVM","SVM",28,2,3612,3341,271,300,172,128,0.912365382012648,0.599033816425121,1.74889903114741,169,85,84,68,1,7.67,1.3,0,0,0,0,0,0,0.462145264294225,200.383605952399,64.8673744864194
8.7,"eps_greedy_SVM","SVM",28,3,3512,3303,209,400,210,190,0.908943136588749,0.623188405797101,1.7401980409427,242,122,120,73,1,10.22,1.1,0,0,0,0,0,0,0.344758746839458,160.128176385025,47.428111099468
8.7,"eps_greedy_SVM","SVM",28,4,3412,3265,147,500,248,252,0.899053427355328,0.594202898550725,1.73859712278176,332,167,165,90,1,12.78,1,0,0,0,0,0,0,0.336565211167187,199.97453707455,45.165832038196
8.7,"eps_greedy_SVM","SVM",28,5,3312,3187,125,600,326,274,0.876931745676623,0.642512077294686,1.61689532418703,395,196,199,63,1,15.34,1.2,0,0,0,0,0,0,0.152173563633546,100.556141502991,25.1240243844269
8.7,"eps_greedy_SVM","SVM",28,6,3212,3111,101,700,402,298,0.878184359316435,0.661835748792271,1.62708516828142,459,222,237,64,1.1,17.89,1.3,0,0,0,0,0,0,0.0876618930064364,69.8258421232452,11.6436280663295
8.7,"eps_greedy_SVM","SVM",28,7,3112,3026,86,800,487,313,0.882234983137359,0.661835748792271,1.63127986052887,496,238,258,37,1.1,20.45,1.6,0,0,0,0,0,0,0.067306469750326,64.4058009697897,8.29327672656881
8.7,"eps_greedy_SVM","SVM",28,8,3012,2944,68,900,569,331,0.885215292106187,0.676328502415459,1.63277919863598,543,259,284,47,1.1,23.01,1.7,0,0,0,0,0,0,0.0544842406174523,69.8426732573441,7.41806340394184
8.7,"eps_greedy_SVM","SVM",28,9,2912,2860,52,1000,653,347,0.892109500805152,0.661835748792271,1.63428129541485,583,279,304,40,1.1,25.56,1.9,0,0,0,0,0,0,0.059661310295957,86.6588722039215,6.51935182898007
8.7,"eps_greedy_SVM","SVM",28,10,2812,2767,45,1100,746,354,0.900649922799233,0.671497584541063,1.67774622348439,596,288,308,13,1.1,28.12,2.1,0,0,0,0,0,0,0.059444925838473,88.1125814111461,6.35414544441784
8.7,"eps_greedy_SVM","SVM",28,11,2712,2669,43,1200,844,356,0.911556085879303,0.676328502415459,1.69357416879795,609,293,316,13,1.1,30.67,2.4,0,0,0,0,0,0,0.0427282156094367,57.9367832582091,4.89992447824792
8.7,"eps_greedy_SVM","SVM",28,12,2612,2573,39,1300,940,360,0.918001452866103,0.661835748792271,1.68954785280171,614,297,317,5,1.1,33.23,2.6,0,0,0,0,0,0,0.0428702439405187,60.3353820328665,4.96820762784866
8.7,"eps_greedy_SVM","SVM",28,13,2512,2477,35,1400,1036,364,0.929994503415349,0.652173913043478,1.76467607962348,639,310,329,25,1.1,35.79,2.8,0,0,0,0,0,0,0.0555240765934594,53.2573334203816,6.37420137456177
8.7,"eps_greedy_SVM","SVM",28,14,2412,2383,29,1500,1130,370,0.933514803490199,0.647342995169082,1.76848823294775,661,323,338,22,1,38.34,3.1,0,0,0,0,0,0,0.0594265615864285,51.6227765041763,6.3988327259319
8.7,"eps_greedy_SVM","SVM",28,15,2312,2286,26,1600,1227,373,0.933998171487922,0.652173913043478,1.76305413469736,674,326,348,13,1.1,40.9,3.3,0,0,0,0,0,0,0.0534599538517386,42.6617519861845,5.9035389527224
8.7,"eps_greedy_SVM","SVM",28,16,2212,2188,24,1700,1325,375,0.933814491648787,0.657004830917874,1.76467607962348,682,329,353,8,1.1,43.46,3.5,0,0,0,0,0,0,0.0447176264763906,33.7040683026704,5.01371356371569
8.7,"eps_greedy_SVM","SVM",28,17,2112,2097,15,1800,1416,384,0.933568664495659,0.652173913043478,1.76792893875643,708,338,370,26,1.1,46.01,3.7,0,0,0,0,0,0,0.0430482514892778,32.9638645820867,5.54355183701572
8.7,"eps_greedy_SVM","SVM",28,18,2012,2000,12,1900,1513,387,0.93248592018076,0.661835748792271,1.75760002135212,717,343,374,9,1.1,48.57,3.9,0,0,0,0,0,0,0.0327221150284044,27.7376258541091,3.83381401666043
8.7,"eps_greedy_SVM","SVM",28,19,1912,1900,12,2000,1613,387,0.932987241846969,0.661835748792271,1.76630101155684,715,343,372,-2,1.1,51.12,4.2,0,0,0,0,0,0,0.0241183140291978,20.6812439654399,2.61974933860991
8.7,"eps_greedy_SVM","SVM",28,20,1812,1800,12,2100,1713,387,0.933082534395091,0.661835748792271,1.76305413469736,718,345,373,3,1.1,53.68,4.4,0,0,0,0,0,0,0.0201128322580425,17.8919716423725,2.20109824542905
8.7,"eps_greedy_SVM","SVM",28,21,1712,1700,12,2200,1813,387,0.933292454211247,0.661835748792271,1.76630101155684,721,345,376,3,1.1,56.24,4.7,0,0,0,0,0,0,0.0164394830936332,13.9368318351166,1.70300124247827
8.7,"eps_greedy_SVM","SVM",28,22,1612,1601,11,2300,1912,388,0.932115798399662,0.652173913043478,1.77878920961925,736,354,382,15,1.1,58.79,4.9,0,0,0,0,0,0,0.0112560050553062,8.58364857588573,1.41927306228831
8.7,"eps_greedy_SVM","SVM",28,23,1512,1501,11,2400,2012,388,0.932048126879981,0.652173913043478,1.78370299196626,735,354,381,-1,1.1,61.35,5.2,0,0,0,0,0,0,0.00924106015413157,6.66464499551505,0.947507615390055
8.7,"eps_greedy_SVM","SVM",28,24,1412,1402,10,2500,2111,389,0.932789751493624,0.657004830917874,1.78534695785748,749,365,384,14,1.1,63.91,5.4,0,0,0,0,0,0,0.00602259739142964,3.83694251578448,0.744508343449169
8.7,"eps_greedy_SVM","SVM",28,25,1312,1304,8,2600,2209,391,0.933333885753919,0.657004830917874,1.7820620508513,759,368,391,10,1.1,66.46,5.6,0,0,0,0,0,0,0.00531785408380625,3.34612587186825,0.563278204235304
8.7,"eps_greedy_SVM","SVM",28,26,1212,1204,8,2700,2309,391,0.933587999215579,0.657004830917874,1.7820620508513,759,370,389,0,1.1,69.02,5.9,0,0,0,0,0,0,0.00433519313496134,2.49244038538603,0.462691741755467
8.7,"eps_greedy_SVM","SVM",28,27,1112,1105,7,2800,2408,392,0.933828302163018,0.657004830917874,1.78042412617221,767,373,394,8,1.1,71.57,6.1,0,0,0,0,0,0,0.00424099425635251,2.11145196268673,0.442794139492039
8.7,"eps_greedy_SVM","SVM",28,28,1012,1006,6,2900,2507,393,0.933941548379628,0.657004830917874,1.79240398217098,770,377,393,3,1,74.13,6.4,0,0,0,0,0,0,0.00380410490777874,1.63978423777571,0.410299799834143
8.7,"eps_greedy_SVM","SVM",28,29,912,906,6,3000,2607,393,0.934306145955054,0.647342995169082,1.78910912190963,776,379,397,6,1,76.69,6.6,0,0,0,0,0,0,0.00316602846229184,1.22248793881131,0.348216794337439
8.7,"eps_greedy_SVM","SVM",28,30,812,807,5,3100,2706,394,0.934170802915693,0.647342995169082,1.794055967408,776,379,397,0,1,79.24,6.9,0,0,0,0,0,0,0.00241998343377421,0.82642440560427,0.272083175675658
8.7,"eps_greedy_SVM","SVM",28,31,712,708,4,3200,2805,395,0.934437345840152,0.652173913043478,1.78910912190963,782,382,400,6,1,81.8,7.1,0,0,0,0,0,0,0.00211214883807684,0.647546755256454,0.23715550768529
8.7,"eps_greedy_SVM","SVM",28,32,612,609,3,3300,2904,396,0.934800562364159,0.652173913043478,1.79075503646521,783,383,400,1,1,84.36,7.3,0,0,0,0,0,0,0.00156216396264573,0.468918747058929,0.198677171359792
8.7,"eps_greedy_SVM","SVM",28,33,512,510,2,3400,3003,397,0.934659695119109,0.647342995169082,1.79075503646521,787,385,402,4,1,86.91,7.6,0,0,0,0,0,0,0.00105370643816216,0.33509491475664,0.143431028665892
8.7,"eps_greedy_SVM","SVM",28,34,412,410,2,3500,3103,397,0.934803324467003,0.642512077294686,1.79075503646521,791,386,405,4,1,89.47,7.8,0,0,0,0,0,0,0.00062992780702066,0.176825196161249,0.0799287788473014
8.7,"eps_greedy_SVM","SVM",28,35,312,312,0,3600,3201,399,0.935272881950508,0.642512077294686,1.79240398217098,804,392,412,13,1.1,92.02,8,0,0,0,0,0,0,0.000626402947138306,0.154365244733432,0.0825486591288349
8.7,"eps_greedy_SVM","SVM",28,36,212,212,0,3700,3301,399,0.935355745035832,0.642512077294686,1.78582635287861,809,393,416,5,1.1,94.58,8.3,0,0,0,0,0,0,0.000254955259342545,0.0543447155019662,0.0353647985035353
8.7,"eps_greedy_SVM","SVM",28,37,112,112,0,3800,3401,399,0.935817016210803,0.647342995169082,1.794055967408,812,394,418,3,1.1,97.14,8.5,0,0,0,0,0,0,0.000129227138038334,0.0224349371841451,0.0211066472264975
8.7,"eps_greedy_SVM","SVM",28,38,12,12,0,3900,3501,399,0.936122228575081,0.642512077294686,1.78582635287861,812,395,417,0,1.1,99.69,8.8,0,0,0,0,0,0,6.06257172246843e-05,0.00101457538858486,0.00101457538858486
8.7,"eps_greedy_SVM","SVM",28,39,0,0,0,3912,3513,399,0.936210615866093,0.642512077294686,1.78582635287861,812,395,417,0,1.1,100,8.8,0,0,0,0,0,0,0,0,0
8.7,"eps_greedy_SVM","SVM",29,0,3812,3411,401,100,87,13,0.906131897203331,0.520833333333333,1.76520737327189,35,13,22,0,1.7,2.56,6.7,0,0,0,0,0,0,0.414230258737418,509.352499160239,45.7212500793063
8.7,"eps_greedy_SVM","SVM",29,1,3712,3365,347,200,133,67,0.901874291383225,0.572916666666667,1.70568389752973,120,58,62,85,1.1,5.11,2,0,0,0,0,0,0,0.684053056981475,580.385133283157,75.1026272972581
8.7,"eps_greedy_SVM","SVM",29,2,3612,3332,280,300,166,134,0.890108300264545,0.557291666666667,1.69323921028466,183,91,92,63,1,7.67,1.2,0,0,0,0,0,0,0.618646151597988,427.926138523766,72.8502823577034
8.7,"eps_greedy_SVM","SVM",29,3,3512,3299,213,400,199,201,0.915054563492065,0.598958333333333,1.73065886134068,248,124,124,65,1,10.22,1,0,0,0,0,0,0,0.478528128313397,319.526607688386,60.4647445547152
8.7,"eps_greedy_SVM","SVM",29,4,3412,3261,151,500,237,263,0.913291879251714,0.625,1.70572677092916,328,167,161,80,1,12.78,0.9,0,0,0,0,0,0,0.391994261277369,318.473890404838,50.0887094828952
8.7,"eps_greedy_SVM","SVM",29,5,3312,3194,118,600,304,296,0.872711758314444,0.651041666666667,1.60904499540863,412,205,207,84,1,15.34,1,0,0,0,0,0,0,0.218796125325088,243.37884193574,30.307767765249
8.7,"eps_greedy_SVM","SVM",29,6,3212,3117,95,700,381,319,0.872955345332589,0.640625,1.61691513761468,480,235,245,68,1,17.89,1.2,0,0,0,0,0,0,0.140746362561686,207.196800506399,20.5634160068877
8.7,"eps_greedy_SVM","SVM",29,7,3112,3035,77,800,463,337,0.882957175925918,0.635416666666667,1.62287062615101,534,256,278,54,1.1,20.45,1.4,0,0,0,0,0,0,0.10150840185179,155.960590771388,14.3153233609023
8.7,"eps_greedy_SVM","SVM",29,8,3012,2940,72,900,558,342,0.898909911186705,0.630208333333333,1.67761039558418,558,268,290,24,1.1,23.01,1.6,0,0,0,0,0,0,0.0733700645903398,89.4201865644799,9.02033384527837
8.7,"eps_greedy_SVM","SVM",29,9,2912,2848,64,1000,650,350,0.89905753968254,0.625,1.6713133640553,574,278,296,16,1.1,25.56,1.9,0,0,0,0,0,0,0.0549668958951324,74.8420239041152,6.22935944053754
8.7,"eps_greedy_SVM","SVM",29,10,2812,2758,54,1100,740,360,0.896713199168556,0.630208333333333,1.6713133640553,600,287,313,26,1.1,28.12,2.1,0,0,0,0,0,0,0.0516740847667296,71.6084732427499,6.03289911461616
8.7,"eps_greedy_SVM","SVM",29,11,2712,2659,53,1200,839,361,0.898960104875291,0.635416666666667,1.67761039558418,605,290,315,5,1.1,30.67,2.3,0,0,0,0,0,0,0.0395657992644409,53.4683476859776,4.29092668282839
8.7,"eps_greedy_SVM","SVM",29,12,2612,2563,49,1300,935,365,0.908172123015876,0.635416666666667,1.69948156682028,616,296,320,11,1.1,33.23,2.6,0,0,0,0,0,0,0.0367064141743294,50.6773899202377,3.88734014184188
8.7,"eps_greedy_SVM","SVM",29,13,2512,2467,45,1400,1031,369,0.925875732237338,0.625,1.73703917050691,653,319,334,37,1,35.79,2.8,0,0,0,0,0,0,0.0341098571017699,28.3700423967067,4.45676667985671
8.7,"eps_greedy_SVM","SVM",29,14,2412,2371,41,1500,1127,373,0.928565523431598,0.625,1.74642857142857,664,324,340,11,1,38.34,3,0,0,0,0,0,0,0.0279091699735423,26.063874622974,3.23083919759492
8.7,"eps_greedy_SVM","SVM",29,15,2312,2281,31,1600,1217,383,0.929799697656845,0.635416666666667,1.76034007352941,693,336,357,29,1.1,40.9,3.2,0,0,0,0,0,0,0.0356256949455119,30.1589380832826,4.24591000524516
8.7,"eps_greedy_SVM","SVM",29,16,2212,2185,27,1700,1313,387,0.928290934429329,0.635416666666667,1.76195952161914,702,342,360,9,1.1,43.46,3.4,0,0,0,0,0,0,0.0463672699521897,30.2953213856661,5.2829209246712
8.7,"eps_greedy_SVM","SVM",29,17,2112,2088,24,1800,1410,390,0.928887353552531,0.630208333333333,1.76358195211786,711,347,364,9,1,46.01,3.6,0,0,0,0,0,0,0.0380699018248215,22.6517207230199,4.3270073136159
8.7,"eps_greedy_SVM","SVM",29,18,2012,1997,15,1900,1501,399,0.927998630007559,0.630208333333333,1.76195952161914,740,359,381,29,1.1,48.57,3.8,0,0,0,0,0,0,0.0412014619376866,21.8422389819028,5.26512346123968
8.7,"eps_greedy_SVM","SVM",29,19,1912,1902,10,2000,1596,404,0.927213246409672,0.635416666666667,1.76195952161914,752,363,389,12,1.1,51.12,4,0,0,0,0,0,0,0.0247451768463174,17.3127287758719,3.57455418934712
8.7,"eps_greedy_SVM","SVM",29,20,1812,1804,8,2100,1694,406,0.927360874905518,0.635416666666667,1.75872359963269,760,366,394,8,1.1,53.68,4.2,0,0,0,0,0,0,0.01606127966815,13.1889747433481,1.92489759522602
8.7,"eps_greedy_SVM","SVM",29,21,1712,1704,8,2200,1794,406,0.927449452003023,0.635416666666667,1.75872359963269,761,366,395,1,1.1,56.24,4.4,0,0,0,0,0,0,0.0123811244586764,10.5580454294932,1.37432789653098
8.7,"eps_greedy_SVM","SVM",29,22,1612,1605,7,2300,1893,407,0.928237788170826,0.635416666666667,1.76520737327189,764,368,396,3,1.1,58.79,4.7,0,0,0,0,0,0,0.0119960429403441,10.3852290927334,1.26694608914681
8.7,"eps_greedy_SVM","SVM",29,23,1512,1506,6,2400,1992,408,0.92863933767952,0.630208333333333,1.75872359963269,776,375,401,12,1.1,61.35,4.9,0,0,0,0,0,0,0.0101147920051539,7.91054485704622,1.07822500800935
8.7,"eps_greedy_SVM","SVM",29,24,1412,1408,4,2500,2090,410,0.928598001700683,0.625,1.75872359963269,786,381,405,10,1.1,63.91,5.1,0,0,0,0,0,0,0.00847065996107717,6.29201931472692,0.918305625143174
8.7,"eps_greedy_SVM","SVM",29,25,1312,1308,4,2600,2190,410,0.928946404950872,0.625,1.76520737327189,790,383,407,4,1.1,66.46,5.3,0,0,0,0,0,0,0.00736186783243653,5.05356077573152,0.778902812322005
8.7,"eps_greedy_SVM","SVM",29,26,1212,1208,4,2700,2290,410,0.928996598639457,0.619791666666667,1.76520737327189,793,385,408,3,1.1,69.02,5.6,0,0,0,0,0,0,0.00592546079346598,3.6783031715931,0.628941241074195
8.7,"eps_greedy_SVM","SVM",29,27,1112,1109,3,2800,2389,411,0.929235756802722,0.619791666666667,1.75872359963269,797,386,411,4,1.1,71.57,5.8,0,0,0,0,0,0,0.00537649157313499,3.02245102097398,0.562037883556247
8.7,"eps_greedy_SVM","SVM",29,28,1012,1009,3,2900,2489,411,0.929333191609979,0.619791666666667,1.75420119705341,800,387,413,3,1.1,74.13,6.1,0,0,0,0,0,0,0.00441097026692657,2.21399415660385,0.473423098204907
8.7,"eps_greedy_SVM","SVM",29,29,912,910,2,3000,2588,412,0.929563492063493,0.614583333333333,1.7509765625,808,391,417,8,1.1,76.69,6.3,0,0,0,0,0,0,0.00399059287361132,1.80374532918842,0.423476620304729
8.7,"eps_greedy_SVM","SVM",29,30,812,810,2,3100,2688,412,0.929495582955407,0.614583333333333,1.75258739650414,804,391,413,-4,1.1,79.24,6.5,0,0,0,0,0,0,0.00329594374709315,1.26474631255766,0.353139162339847
8.7,"eps_greedy_SVM","SVM",29,31,712,710,2,3200,2788,412,0.929579731198039,0.614583333333333,1.75420119705341,806,391,415,2,1.1,81.8,6.8,0,0,0,0,0,0,0.00260201475245641,0.875797619412162,0.288929741658484
8.7,"eps_greedy_SVM","SVM",29,32,612,611,1,3300,2887,413,0.929745075113384,0.614583333333333,1.7509765625,809,394,415,3,1.1,84.36,7,0,0,0,0,0,0,0.00198506063224668,0.663449331529398,0.245191509706414
8.7,"eps_greedy_SVM","SVM",29,33,512,511,1,3400,2987,413,0.930173197751331,0.614583333333333,1.75420119705341,808,394,414,-1,1.1,86.91,7.2,0,0,0,0,0,0,0.0012131010643471,0.39872369532653,0.155900784800115
8.7,"eps_greedy_SVM","SVM",29,34,412,412,0,3500,3086,414,0.930570318405148,0.614583333333333,1.75258739650414,817,398,419,9,1.1,89.47,7.5,0,0,0,0,0,0,0.000981990580289218,0.297357764482758,0.119610601851449
8.7,"eps_greedy_SVM","SVM",29,35,312,312,0,3600,3186,414,0.93119921579744,0.609375,1.7509765625,824,399,425,7,1.1,92.02,7.7,0,0,0,0,0,0,0.000697416568282106,0.171805082434283,0.0830243316023022
8.7,"eps_greedy_SVM","SVM",29,36,212,212,0,3700,3286,414,0.931746917517021,0.604166666666667,1.75420119705341,827,402,425,3,1.1,94.58,7.9,0,0,0,0,0,0,0.000381538308374944,0.078447424326579,0.0496290276750354
8.7,"eps_greedy_SVM","SVM",29,37,112,112,0,3800,3386,414,0.931801540060481,0.598958333333333,1.75581797235023,826,403,423,-1,1,97.14,8.2,0,0,0,0,0,0,0.000174412155245605,0.0285626793200401,0.0266692857697335
8.7,"eps_greedy_SVM","SVM",29,38,12,12,0,3900,3486,414,0.932067271352998,0.598958333333333,1.75581797235023,827,404,423,1,1,99.69,8.4,0,0,0,0,0,0,0.0001171299128853,0.00157531267182496,0.00157531267182496
8.7,"eps_greedy_SVM","SVM",29,39,0,0,0,3912,3498,414,0.932020030234328,0.59375,1.74616177818515,827,404,423,0,1,100,8.4,0,0,0,0,0,0,0,0,0
8.7,"eps_greedy_SVM","SVM",30,0,3812,3413,399,100,89,11,0.895785018552878,0.510204081632653,1.76646059883808,30,11,19,0,1.7,2.56,8.1,0,0,0,0,0,0,0.556675881395441,413.890762576428,60.690153567206
8.7,"eps_greedy_SVM","SVM",30,1,3712,3383,329,200,119,81,0.906352910482375,0.510204081632653,1.79449541284404,100,51,49,70,1,5.11,1.5,0,0,0,0,0,0,0.629387791162532,349.753529117619,68.4598324782009
8.7,"eps_greedy_SVM","SVM",30,2,3612,3352,260,300,150,150,0.899457908163251,0.525510204081633,1.75193202280912,152,77,75,52,1,7.67,1,0,0,0,0,0,0,0.531888773060252,213.188175655719,66.3921632696431
8.7,"eps_greedy_SVM","SVM",30,3,3512,3315,197,400,187,213,0.888656655844152,0.540816326530612,1.71998495250635,227,116,111,75,1,10.22,0.9,0,0,0,0,0,0,0.33510600750277,145.93991074718,48.2753102414341
8.7,"eps_greedy_SVM","SVM",30,4,3412,3263,149,500,239,261,0.862257942949898,0.581632653061224,1.66326530612245,326,165,161,99,1,12.78,0.9,0,0,0,0,0,0,0.263752368186256,145.973171204156,36.6622326987399
8.7,"eps_greedy_SVM","SVM",30,5,3312,3196,116,600,306,294,0.873270814007424,0.591836734693878,1.64488668395535,401,202,199,75,1,15.34,1,0,0,0,0,0,0,0.114262917514543,59.9786006543426,17.7880108336266
8.7,"eps_greedy_SVM","SVM",30,6,3212,3119,93,700,383,317,0.876466836734702,0.596938775510204,1.63269057623049,458,223,235,57,1.1,17.89,1.2,0,0,0,0,0,0,0.0718689231602685,47.663109381713,10.2286140969767
8.7,"eps_greedy_SVM","SVM",30,7,3112,3040,72,800,462,338,0.870083487940633,0.612244897959184,1.6188093670648,505,248,257,47,1,20.45,1.4,0,0,0,0,0,0,0.054564000444347,49.2455361565534,8.50887877579686
8.7,"eps_greedy_SVM","SVM",30,8,3012,2958,54,900,544,356,0.871205357142852,0.612244897959184,1.62501173422451,549,268,281,44,1,23.01,1.5,0,0,0,0,0,0,0.0590750827727252,71.4093775897938,6.68243569608538
8.7,"eps_greedy_SVM","SVM",30,9,2912,2869,43,1000,633,367,0.886405670222641,0.61734693877551,1.63269057623049,580,281,299,31,1.1,25.56,1.7,0,0,0,0,0,0,0.0461235364552622,63.2091521033906,5.54766606317092
8.7,"eps_greedy_SVM","SVM",30,10,2812,2775,37,1100,727,373,0.896561920222632,0.607142857142857,1.64337344873552,597,291,306,17,1.1,28.12,1.9,0,0,0,0,0,0,0.0437167623505208,62.1462333640887,5.41796695526924
8.7,"eps_greedy_SVM","SVM",30,11,2712,2685,27,1200,817,383,0.906539888682732,0.602040816326531,1.70002255045665,629,303,326,32,1.1,30.67,2.1,0,0,0,0,0,0,0.0661267726046273,72.2099936005347,7.75946849920292
8.7,"eps_greedy_SVM","SVM",30,12,2612,2586,26,1300,916,384,0.907464633580697,0.602040816326531,1.6968975090036,646,312,334,17,1.1,33.23,2.4,0,0,0,0,0,0,0.0527518257400504,51.1067864905069,5.86159328319631
8.7,"eps_greedy_SVM","SVM",30,13,2512,2488,24,1400,1014,386,0.909664888682739,0.602040816326531,1.71682030677957,656,318,338,10,1.1,35.79,2.6,0,0,0,0,0,0,0.0443352496340948,39.9735532722569,4.93834823297198
8.7,"eps_greedy_SVM","SVM",30,14,2412,2391,21,1500,1111,389,0.909461966604816,0.607142857142857,1.72600116403507,666,321,345,10,1.1,38.34,2.9,0,0,0,0,0,0,0.0382855217939676,32.3390549045584,4.73210447164969
8.7,"eps_greedy_SVM","SVM",30,15,2312,2298,14,1600,1204,396,0.910536004174392,0.602040816326531,1.73677979479084,680,331,349,14,1.1,40.9,3,0,0,0,0,0,0,0.0355254998779585,31.0479429726679,4.40050972952139
8.7,"eps_greedy_SVM","SVM",30,16,2212,2205,7,1700,1297,403,0.910538903061217,0.596938775510204,1.72759048370729,701,337,364,21,1.1,43.46,3.2,0,0,0,0,0,0,0.0274203569482923,27.0212388796491,3.32974161949854
8.7,"eps_greedy_SVM","SVM",30,17,2112,2106,6,1800,1396,404,0.910131609461959,0.596938775510204,1.72283128127284,704,341,363,3,1.1,46.01,3.5,0,0,0,0,0,0,0.0216748205224398,21.6455091079273,2.38294899327887
8.7,"eps_greedy_SVM","SVM",30,18,2012,2006,6,1900,1496,404,0.909818529684594,0.596938775510204,1.72283128127284,705,341,364,1,1.1,48.57,3.7,0,0,0,0,0,0,0.0169835927900919,16.9889585154677,1.84983947653912
8.7,"eps_greedy_SVM","SVM",30,19,1912,1907,5,2000,1595,405,0.909888102968456,0.612244897959184,1.72723704866562,713,344,369,8,1.1,51.12,3.9,0,0,0,0,0,0,0.0145772064833885,14.5366715028316,1.5724397053852
8.7,"eps_greedy_SVM","SVM",30,20,1812,1807,5,2100,1695,405,0.910027249536176,0.607142857142857,1.74275960384154,715,346,369,2,1.1,53.68,4.2,0,0,0,0,0,0,0.0111862918544438,10.1186804435746,1.17662117684672
8.7,"eps_greedy_SVM","SVM",30,21,1712,1707,5,2200,1795,405,0.911304209183666,0.596938775510204,1.76434772804149,726,357,369,11,1,56.24,4.4,0,0,0,0,0,0,0.00675236620993792,5.47620092982119,0.892923483683557
8.7,"eps_greedy_SVM","SVM",30,22,1612,1607,5,2300,1895,405,0.911353490259732,0.596938775510204,1.76434772804149,726,357,369,0,1,58.79,4.7,0,0,0,0,0,0,0.00624390677240405,4.94234083094608,0.644111995784674
8.7,"eps_greedy_SVM","SVM",30,23,1512,1507,5,2400,1995,405,0.913408801020397,0.596938775510204,1.76434772804149,740,363,377,14,1,61.35,4.9,0,0,0,0,0,0,0.00477375862131293,3.51043424949802,0.590816166096048
8.7,"eps_greedy_SVM","SVM",30,24,1412,1407,5,2500,2095,405,0.913413149350638,0.596938775510204,1.76434772804149,735,361,374,-5,1,63.91,5.2,0,0,0,0,0,0,0.00396152765337791,2.72618390527547,0.406345205481279
8.7,"eps_greedy_SVM","SVM",30,25,1312,1307,5,2600,2195,405,0.913730577458246,0.596938775510204,1.76434772804149,748,369,379,13,1,66.46,5.4,0,0,0,0,0,0,0.00320660318430189,2.14966629910986,0.376589233886811
8.7,"eps_greedy_SVM","SVM",30,26,1212,1207,5,2700,2295,405,0.913908858998135,0.596938775510204,1.76272459305709,749,369,380,1,1,69.02,5.7,0,0,0,0,0,0,0.00265305429048401,1.54304791475705,0.272240467117148
8.7,"eps_greedy_SVM","SVM",30,27,1112,1107,5,2800,2395,405,0.914369782003705,0.591836734693878,1.76597385497978,755,372,383,6,1,71.57,5.9,0,0,0,0,0,0,0.00231639358400799,1.27402266928224,0.257969679282002
8.7,"eps_greedy_SVM","SVM",30,28,1012,1007,5,2900,2495,405,0.914384276437842,0.591836734693878,1.75787305747987,755,372,383,0,1,74.13,6.2,0,0,0,0,0,0,0.00165354795138616,0.781712665905064,0.172924048117076
8.7,"eps_greedy_SVM","SVM",30,29,912,908,4,3000,2594,406,0.915420628478659,0.591836734693878,1.75787305747987,758,374,384,3,1,76.69,6.4,0,0,0,0,0,0,0.00165191585321409,0.687584388772893,0.1782276693557
8.7,"eps_greedy_SVM","SVM",30,30,812,809,3,3100,2693,407,0.915380044063075,0.591836734693878,1.76110444177671,764,375,389,6,1,79.24,6.6,0,0,0,0,0,0,0.00162798804940656,0.641684143205832,0.180056895780275
8.7,"eps_greedy_SVM","SVM",30,31,712,709,3,3200,2793,407,0.915584415584411,0.586734693877551,1.75787305747987,765,375,390,1,1,81.8,6.9,0,0,0,0,0,0,0.00122870283265069,0.438100854221005,0.138440407688929
8.7,"eps_greedy_SVM","SVM",30,32,612,609,3,3300,2893,407,0.915572820037101,0.586734693877551,1.75948726598077,765,375,390,0,1,84.36,7.1,0,0,0,0,0,0,0.000951666089470651,0.30660594404235,0.110292836889548
8.7,"eps_greedy_SVM","SVM",30,33,512,509,3,3400,2993,407,0.915810528756952,0.586734693877551,1.76272459305709,767,376,391,2,1,86.91,7.4,0,0,0,0,0,0,0.000588780696089817,0.175702200060838,0.0726335755156304
8.7,"eps_greedy_SVM","SVM",30,34,412,411,1,3500,3091,409,0.916071428571423,0.586734693877551,1.78108630756811,777,380,397,10,1,89.47,7.6,0,0,0,0,0,0,0.000595256121323729,0.181445508515446,0.0757106516480191
8.7,"eps_greedy_SVM","SVM",30,35,312,312,0,3600,3190,410,0.916333777829307,0.586734693877551,1.77944927971188,784,382,402,7,1.1,92.02,7.8,0,0,0,0,0,0,0.000537123223236626,0.136344062207897,0.0647598448806356
8.7,"eps_greedy_SVM","SVM",30,36,212,212,0,3700,3290,410,0.916555542671608,0.586734693877551,1.78272635020859,787,385,402,3,1,94.58,8,0,0,0,0,0,0,0.000325646844092394,0.0700585508276036,0.0426996919662775
8.7,"eps_greedy_SVM","SVM",30,37,112,112,0,3800,3390,410,0.916570037105747,0.581632653061224,1.78436941596915,788,388,400,1,1,97.14,8.3,0,0,0,0,0,0,0.000166978047255248,0.0251715495002315,0.023371717929762
8.7,"eps_greedy_SVM","SVM",30,38,12,12,0,3900,3490,410,0.916684543135433,0.581632653061224,1.78272635020859,791,389,402,3,1,99.69,8.5,0,0,0,0,0,0,0.000120634790221941,0.00161752653488874,0.00161752653488874
8.7,"eps_greedy_SVM","SVM",30,39,0,0,0,3912,3502,410,0.916790352504635,0.581632653061224,1.78108630756811,792,389,403,1,1,100,8.5,0,0,0,0,0,0,0,0,0
8.7,"eps_greedy_SVM","SVM",31,0,3812,3393,419,100,93,7,0.90400400400401,0.572222222222222,1.74267281105991,20,7,13,0,1.9,2.56,13.3,0,0,0,0,0,0,0.237837734096459,282.155498849517,26.4060794932687
8.7,"eps_greedy_SVM","SVM",31,1,3712,3358,354,200,128,72,0.923124687187188,0.533333333333333,1.79109883364027,91,45,46,71,1,5.11,1.8,0,0,0,0,0,0,0.791340224251517,413.968973143107,84.2860510736464
8.7,"eps_greedy_SVM","SVM",31,2,3612,3321,291,300,165,135,0.910932807807811,0.55,1.74946335479914,153,76,77,62,1,7.67,1.2,0,0,0,0,0,0,0.633742407666932,257.22041151688,73.061801784711
8.7,"eps_greedy_SVM","SVM",31,3,3512,3291,221,400,195,205,0.89249562062064,0.594444444444444,1.71104972375691,214,109,105,61,1,10.22,1,0,0,0,0,0,0,0.439051884605702,161.361191315548,58.8685863065982
8.7,"eps_greedy_SVM","SVM",31,4,3412,3236,176,500,250,250,0.868355855855856,0.594444444444444,1.66254992319508,306,154,152,92,1,12.78,1,0,0,0,0,0,0,0.178620932755208,78.1557157476302,28.3270710645351
8.7,"eps_greedy_SVM","SVM",31,5,3312,3170,142,600,316,284,0.864236111111107,0.611111111111111,1.55952161913523,383,191,192,77,1,15.34,1.1,0,0,0,0,0,0,0.0959937905950547,56.5355182595245,17.6655006508531
8.7,"eps_greedy_SVM","SVM",31,6,3212,3096,116,700,390,310,0.859384384384386,0.616666666666667,1.58242703533026,441,215,226,58,1.1,17.89,1.3,0,0,0,0,0,0,0.0760609332210737,64.0149085492438,10.9772872960774
8.7,"eps_greedy_SVM","SVM",31,7,3112,3027,85,800,459,341,0.856662912912917,0.627777777777778,1.55095150399018,514,251,263,73,1,20.45,1.3,0,0,0,0,0,0,0.095479101702498,136.091065177854,15.4659271330815
8.7,"eps_greedy_SVM","SVM",31,8,3012,2937,75,900,549,351,0.873137199699697,0.633333333333333,1.60098219766728,545,265,280,31,1.1,23.01,1.6,0,0,0,0,0,0,0.0613639252764131,79.7256618866157,7.23473518922719
8.7,"eps_greedy_SVM","SVM",31,9,2912,2849,63,1000,637,363,0.886963526026027,0.633333333333333,1.63100061387354,572,279,293,27,1.1,25.56,1.8,0,0,0,0,0,0,0.0590282529515918,80.4630856236873,6.77259246413749
8.7,"eps_greedy_SVM","SVM",31,10,2812,2758,54,1100,728,372,0.9015108858859,0.627777777777778,1.67640036730946,602,289,313,30,1.1,28.12,2,0,0,0,0,0,0,0.0597372709807434,80.9436479231319,6.40425352798328
8.7,"eps_greedy_SVM","SVM",31,11,2712,2663,49,1200,823,377,0.927014514514514,0.622222222222222,1.73467889908257,638,312,326,36,1,30.67,2.2,0,0,0,0,0,0,0.0491757746682557,41.002721283693,6.34534426385206
8.7,"eps_greedy_SVM","SVM",31,12,2612,2569,43,1300,917,383,0.928309559559562,0.633333333333333,1.74946335479914,648,317,331,10,1,33.23,2.4,0,0,0,0,0,0,0.0362112748367939,35.0314431774127,4.20648612593571
8.7,"eps_greedy_SVM","SVM",31,13,2512,2474,38,1400,1012,388,0.935804554554577,0.633333333333333,1.75622895622896,664,324,340,16,1,35.79,2.6,0,0,0,0,0,0,0.034140645690461,39.4576534595435,4.09824225251339
8.7,"eps_greedy_SVM","SVM",31,14,2412,2379,33,1500,1107,393,0.938213213213235,0.638888888888889,1.77293003360831,683,331,352,19,1.1,38.34,2.8,0,0,0,0,0,0,0.0461871288235873,42.1896888063495,5.47956759600459
8.7,"eps_greedy_SVM","SVM",31,15,2312,2281,31,1600,1205,395,0.938619869869894,0.627777777777778,1.77945415516713,692,339,353,9,1,40.9,3.1,0,0,0,0,0,0,0.0363874870083492,30.5192869742087,4.11953630237623
8.7,"eps_greedy_SVM","SVM",31,16,2212,2184,28,1700,1302,398,0.938585460460485,0.633333333333333,1.77945415516713,704,344,360,12,1,43.46,3.3,0,0,0,0,0,0,0.0366147547647102,27.2057575492414,4.11449726557636
8.7,"eps_greedy_SVM","SVM",31,17,2112,2089,23,1800,1397,403,0.936899399399419,0.627777777777778,1.78109269490485,720,349,371,16,1.1,46.01,3.5,0,0,0,0,0,0,0.0376534460106677,23.3272892365508,4.51430548982722
8.7,"eps_greedy_SVM","SVM",31,18,2012,1994,18,1900,1492,408,0.93542292292294,0.627777777777778,1.7645871559633,731,356,375,11,1.1,48.57,3.7,0,0,0,0,0,0,0.0242062863900521,17.9082424913275,3.56443196612077
8.7,"eps_greedy_SVM","SVM",31,19,1912,1901,11,2000,1585,415,0.934586148648667,0.622222222222222,1.77108655616943,757,364,393,26,1.1,51.12,3.8,0,0,0,0,0,0,0.020534357189396,17.2860320037012,2.60140155261002
8.7,"eps_greedy_SVM","SVM",31,20,1812,1801,11,2100,1685,415,0.934575200200218,0.622222222222222,1.7645871559633,758,364,394,1,1.1,53.68,4.1,0,0,0,0,0,0,0.0155473896434988,13.8081882535756,1.74013935924559
8.7,"eps_greedy_SVM","SVM",31,21,1712,1703,9,2200,1783,417,0.935347847847858,0.616666666666667,1.77945415516713,760,367,393,2,1.1,56.24,4.3,0,0,0,0,0,0,0.012573982105827,11.5844366952913,1.34936476326316
8.7,"eps_greedy_SVM","SVM",31,22,1612,1603,9,2300,1883,417,0.935446383883892,0.616666666666667,1.77455657492355,763,371,392,3,1.1,58.79,4.5,0,0,0,0,0,0,0.0103997671406723,8.76524350306235,1.0862489396851
8.7,"eps_greedy_SVM","SVM",31,23,1512,1504,8,2400,1982,418,0.93540415415416,0.627777777777778,1.77945415516713,775,381,394,12,1,61.35,4.7,0,0,0,0,0,0,0.0082725885007575,6.70094233068256,0.975276789194277
8.7,"eps_greedy_SVM","SVM",31,24,1412,1404,8,2500,2082,418,0.935394769769776,0.627777777777778,1.77945415516713,775,381,394,0,1,63.91,5,0,0,0,0,0,0,0.00848325232998955,6.22016209326644,0.861002601484046
8.7,"eps_greedy_SVM","SVM",31,25,1312,1304,8,2600,2182,418,0.935521458958964,0.616666666666667,1.77781862745098,793,385,408,18,1.1,66.46,5.2,0,0,0,0,0,0,0.00564499971513993,3.72339620803768,0.650854820863388
8.7,"eps_greedy_SVM","SVM",31,26,1212,1204,8,2700,2282,418,0.935585585585591,0.616666666666667,1.77945415516713,791,384,407,-2,1.1,69.02,5.5,0,0,0,0,0,0,0.00588298803894658,3.4863934172505,0.602726951090604
8.7,"eps_greedy_SVM","SVM",31,27,1112,1105,7,2800,2381,419,0.935992242242245,0.616666666666667,1.77781862745098,795,388,407,4,1,71.57,5.7,0,0,0,0,0,0,0.00475768814926151,2.56704544341552,0.510609098039106
8.7,"eps_greedy_SVM","SVM",31,28,1012,1007,5,2900,2479,421,0.936042292292296,0.611111111111111,1.78109269490485,802,392,410,7,1,74.13,5.9,0,0,0,0,0,0,0.0051518097734184,2.56923013106134,0.553933951708403
8.7,"eps_greedy_SVM","SVM",31,29,912,907,5,3000,2579,421,0.936208083083087,0.611111111111111,1.77945415516713,808,395,413,6,1,76.69,6.1,0,0,0,0,0,0,0.00372267633443183,1.6730923737231,0.413460341468912
8.7,"eps_greedy_SVM","SVM",31,30,812,807,5,3100,2679,421,0.936381694194199,0.616666666666667,1.77130647130647,809,396,413,1,1,79.24,6.4,0,0,0,0,0,0,0.00291893728976695,1.14541055706403,0.316177169854453
8.7,"eps_greedy_SVM","SVM",31,31,712,708,4,3200,2778,422,0.936477102102108,0.616666666666667,1.77945415516713,812,397,415,3,1,81.8,6.6,0,0,0,0,0,0,0.00267723071702874,0.933393408107206,0.292215246113391
8.7,"eps_greedy_SVM","SVM",31,32,612,609,3,3300,2877,423,0.93665853353354,0.616666666666667,1.77781862745098,820,400,420,8,1.1,84.36,6.8,0,0,0,0,0,0,0.00208992646559755,0.688614668739473,0.241573428286554
8.7,"eps_greedy_SVM","SVM",31,33,512,510,2,3400,2976,424,0.936774274274281,0.622222222222222,1.77945415516713,821,401,420,1,1,86.91,7,0,0,0,0,0,0,0.00164782604035419,0.575254938394213,0.207227731818336
8.7,"eps_greedy_SVM","SVM",31,34,412,412,0,3500,3074,426,0.937027652652662,0.622222222222222,1.77781862745098,827,404,423,6,1,89.47,7.2,0,0,0,0,0,0,0.00192010106755682,0.599862599265002,0.230980165929702
8.7,"eps_greedy_SVM","SVM",31,35,312,312,0,3600,3174,426,0.937421796796808,0.616666666666667,1.78273425499232,831,409,422,4,1,92.02,7.5,0,0,0,0,0,0,0.00125245527340036,0.31267987340867,0.144970917887844
8.7,"eps_greedy_SVM","SVM",31,36,212,212,0,3700,3274,426,0.937887887887901,0.616666666666667,1.77618610345883,837,411,426,6,1,94.58,7.7,0,0,0,0,0,0,0.000762582745668363,0.15312270599233,0.0953363974370336
8.7,"eps_greedy_SVM","SVM",31,37,112,112,0,3800,3374,426,0.938228853853874,0.616666666666667,1.78273425499232,839,412,427,2,1,97.14,7.9,0,0,0,0,0,0,0.000390889520259718,0.0621499422772565,0.0579584154476925
8.7,"eps_greedy_SVM","SVM",31,38,12,12,0,3900,3474,426,0.938582332332352,0.616666666666667,1.77945415516713,841,413,428,2,1,99.69,8.2,0,0,0,0,0,0,0.000227779916477379,0.00309281794789307,0.00309281794789307
8.7,"eps_greedy_SVM","SVM",31,39,0,0,0,3912,3486,426,0.938652715215235,0.616666666666667,1.77781862745098,842,414,428,1,1,100,8.2,0,0,0,0,0,0,0,0,0
8.7,"eps_greedy_SVM","SVM",32,0,3812,3432,380,100,94,6,0.189717741935484,0,0.221248428990364,23,6,17,0,2.8,2.56,15.7,0,0,0,0,0,0,0.0665416712521658,237.620195604712,6.69775328286609
8.7,"eps_greedy_SVM","SVM",32,1,3712,3367,345,200,159,41,0.881823418516987,0.540909090909091,1.70633608815427,87,41,46,64,1.1,5.11,3.9,0,0,0,0,0,0,0.709548505276931,414.002562839823,79.0317702184418
8.7,"eps_greedy_SVM","SVM",32,2,3612,3338,274,300,188,112,0.885803309593645,0.577272727272727,1.7032080659945,155,78,77,68,1,7.67,1.7,0,0,0,0,0,0,0.56223327519768,313.988700480527,67.5384704579354
8.7,"eps_greedy_SVM","SVM",32,3,3512,3301,211,400,225,175,0.893480310012573,0.590909090909091,1.71765493016643,226,115,111,71,1,10.22,1.3,0,0,0,0,0,0,0.432581877788036,241.592072814057,57.1842070144169
8.7,"eps_greedy_SVM","SVM",32,4,3412,3259,153,500,267,233,0.872367249685811,0.568181818181818,1.6783023606228,307,155,152,81,1,12.78,1.1,0,0,0,0,0,0,0.366309132872943,220.25396844393,45.7706629964648
8.7,"eps_greedy_SVM","SVM",32,5,3312,3183,129,600,343,257,0.871111751152083,0.613636363636364,1.67675838421009,361,180,181,54,1,15.34,1.3,0,0,0,0,0,0,0.154036905018003,110.607305020388,22.0283264497076
8.7,"eps_greedy_SVM","SVM",32,6,3212,3108,104,700,418,282,0.883156158357771,0.618181818181818,1.7044323418517,419,204,215,58,1.1,17.89,1.5,0,0,0,0,0,0,0.0859777370675226,68.7301397771588,11.6400809056358
8.7,"eps_greedy_SVM","SVM",32,7,3112,3029,83,800,497,303,0.878199622957683,0.645454545454546,1.61429409300377,476,230,246,57,1.1,20.45,1.6,0,0,0,0,0,0,0.0819342148981491,95.581930934194,10.5326510271222
8.7,"eps_greedy_SVM","SVM",32,8,3012,2947,65,900,579,321,0.873840071219103,0.65,1.60314460148867,513,244,269,37,1.1,23.01,1.8,0,0,0,0,0,0,0.0789061496059107,110.437333468682,9.27853782173616
8.7,"eps_greedy_SVM","SVM",32,9,2912,2862,50,1000,664,336,0.86929199832425,0.659090909090909,1.58971093422706,565,269,296,52,1.1,25.56,2,0,0,0,0,0,0,0.0889323735691764,124.848470980859,12.3712977464072
8.7,"eps_greedy_SVM","SVM",32,10,2812,2764,48,1100,762,338,0.88765971931295,0.659090909090909,1.64404114744501,580,279,301,15,1.1,28.12,2.3,0,0,0,0,0,0,0.0645607936611726,86.8649353772343,7.63822319947729
8.7,"eps_greedy_SVM","SVM",32,11,2712,2674,38,1200,852,348,0.898302000418938,0.654545454545455,1.6588736631016,603,290,313,23,1.1,30.67,2.4,0,0,0,0,0,0,0.0557674879293975,70.4794083733924,6.17788581734594
8.7,"eps_greedy_SVM","SVM",32,12,2612,2584,28,1300,942,358,0.906515762463342,0.654545454545455,1.68338903743316,634,302,332,31,1.1,33.23,2.6,0,0,0,0,0,0,0.0552108331031087,71.6684566844323,6.12486962969275
8.7,"eps_greedy_SVM","SVM",32,13,2512,2490,22,1400,1036,364,0.911286395056544,0.654545454545455,1.68338903743316,648,309,339,14,1.1,35.79,2.8,0,0,0,0,0,0,0.0477599461970775,59.4928672631011,5.25658720892365
8.7,"eps_greedy_SVM","SVM",32,14,2412,2395,17,1500,1131,369,0.915105257645576,0.654545454545455,1.7126267281106,671,318,353,23,1.1,38.34,3.1,0,0,0,0,0,0,0.0558939750643918,60.3223097619564,6.54284983706382
8.7,"eps_greedy_SVM","SVM",32,15,2312,2299,13,1600,1227,373,0.916435379136993,0.654545454545455,1.7208211143695,685,322,363,14,1.1,40.9,3.3,0,0,0,0,0,0,0.0499075957436475,55.2374266810304,5.59715213245747
8.7,"eps_greedy_SVM","SVM",32,16,2212,2202,10,1700,1324,376,0.917959258483458,0.654545454545455,1.7208211143695,690,327,363,5,1.1,43.46,3.5,0,0,0,0,0,0,0.042520752550904,46.5429460164743,4.66726016290989
8.7,"eps_greedy_SVM","SVM",32,17,2112,2103,9,1800,1423,377,0.918156943862594,0.65,1.71923656454043,690,329,361,0,1.1,46.01,3.8,0,0,0,0,0,0,0.0321157647474674,34.3466806176893,3.42956719390689
8.7,"eps_greedy_SVM","SVM",32,18,2012,2004,8,1900,1522,378,0.918194909928786,0.65,1.7208211143695,692,330,362,2,1.1,48.57,4,0,0,0,0,0,0,0.0304490802823893,29.9478917181015,3.10815300417467
8.7,"eps_greedy_SVM","SVM",32,19,1912,1905,7,2000,1621,379,0.920593317972345,0.645454545454546,1.74219285774024,721,346,375,29,1.1,51.12,4.3,0,0,0,0,0,0,0.023096676766114,16.308384290567,2.91301169543567
8.7,"eps_greedy_SVM","SVM",32,20,1812,1805,7,2100,1721,379,0.92051476749057,0.645454545454546,1.74379708689101,717,346,371,-4,1.1,53.68,4.5,0,0,0,0,0,0,0.0142637498777046,11.478192871869,1.701958126423
8.7,"eps_greedy_SVM","SVM",32,21,1712,1706,6,2200,1820,380,0.921048910766647,0.645454545454546,1.74219285774024,721,347,374,4,1.1,56.24,4.8,0,0,0,0,0,0,0.0131805096836039,10.5318294272152,1.36347552168224
8.7,"eps_greedy_SVM","SVM",32,22,1612,1607,5,2300,1919,381,0.920023826979463,0.636363636363636,1.75693516042781,736,358,378,15,1.1,58.79,5,0,0,0,0,0,0,0.00835849934453599,6.23846095282831,1.01776566083299
8.7,"eps_greedy_SVM","SVM",32,23,1512,1508,4,2400,2018,382,0.920135106828646,0.636363636363636,1.75855147612277,740,357,383,4,1.1,61.35,5.3,0,0,0,0,0,0,0.00876550551673902,6.04656986037156,0.901149009793775
8.7,"eps_greedy_SVM","SVM",32,24,1412,1408,4,2500,2118,382,0.920780529953913,0.636363636363636,1.7504995004995,745,362,383,5,1.1,63.91,5.5,0,0,0,0,0,0,0.00712456317745297,4.64900732031797,0.852055944483731
8.7,"eps_greedy_SVM","SVM",32,25,1312,1308,4,2600,2218,382,0.92071114369501,0.640909090909091,1.75855147612277,744,362,382,-1,1.1,66.46,5.8,0,0,0,0,0,0,0.00549846408588207,3.18180299843897,0.567790204257231
8.7,"eps_greedy_SVM","SVM",32,26,1212,1208,4,2700,2318,382,0.920679723502305,0.636363636363636,1.75693516042781,752,365,387,8,1.1,69.02,6.1,0,0,0,0,0,0,0.00486657181596226,2.61431078878207,0.519902117084044
8.7,"eps_greedy_SVM","SVM",32,27,1112,1109,3,2800,2417,383,0.921293726434858,0.631818181818182,1.7618682235196,757,368,389,5,1.1,71.57,6.3,0,0,0,0,0,0,0.00431214466749626,2.06137130117101,0.454164902668647
8.7,"eps_greedy_SVM","SVM",32,28,1012,1009,3,2900,2517,383,0.921199465856733,0.627272727272727,1.76510695187166,758,368,390,1,1.1,74.13,6.6,0,0,0,0,0,0,0.00344154738889681,1.448998456318,0.368439968975652
8.7,"eps_greedy_SVM","SVM",32,29,912,909,3,3000,2617,383,0.921389296187694,0.631818181818182,1.76510695187166,758,368,390,0,1.1,76.69,6.8,0,0,0,0,0,0,0.00310200466666758,1.18920623206543,0.342590288121375
8.7,"eps_greedy_SVM","SVM",32,30,812,809,3,3100,2717,383,0.921480938416434,0.636363636363636,1.76348610067618,759,368,391,1,1.1,79.24,7.1,0,0,0,0,0,0,0.00202882269649296,0.679831304365131,0.229738026083883
8.7,"eps_greedy_SVM","SVM",32,31,712,709,3,3200,2817,383,0.921606619187275,0.636363636363636,1.76998743192292,759,369,390,0,1.1,81.8,7.4,0,0,0,0,0,0,0.00148060393274905,0.448504290045483,0.17421153157401
8.7,"eps_greedy_SVM","SVM",32,32,612,609,3,3300,2917,383,0.921981043150408,0.636363636363636,1.76998743192292,761,370,391,2,1.1,84.36,7.6,0,0,0,0,0,0,0.000991100356842832,0.31102178400261,0.133727021609513
8.7,"eps_greedy_SVM","SVM",32,33,512,509,3,3400,3017,383,0.922308336824479,0.631818181818182,1.76835760924159,763,372,391,2,1.1,86.91,7.9,0,0,0,0,0,0,0.000577355821537808,0.174935469241646,0.0783765480444479
8.7,"eps_greedy_SVM","SVM",32,34,412,412,0,3500,3114,386,0.924141181399254,0.627272727272727,1.76348610067618,771,378,393,8,1,89.47,8.1,0,0,0,0,0,0,0.000704963281038534,0.204604697859729,0.0914083818257238
8.7,"eps_greedy_SVM","SVM",32,35,312,312,0,3600,3214,386,0.924787913699209,0.627272727272727,1.7618682235196,773,380,393,2,1,92.02,8.3,0,0,0,0,0,0,0.000395268611731442,0.0970407072830125,0.0495014842830393
8.7,"eps_greedy_SVM","SVM",32,36,212,212,0,3700,3314,386,0.924908357771264,0.631818181818182,1.76673078531404,775,380,395,2,1,94.58,8.6,0,0,0,0,0,0,0.000209341506351062,0.0443391838259064,0.0278313287642743
8.7,"eps_greedy_SVM","SVM",32,37,112,112,0,3800,3414,386,0.925248743192293,0.627272727272727,1.76673078531404,777,381,396,2,1,97.14,8.8,0,0,0,0,0,0,9.79453966767563e-05,0.0158280474081383,0.0148202423789063
8.7,"eps_greedy_SVM","SVM",32,38,12,12,0,3900,3514,386,0.925536761625473,0.627272727272727,1.76348610067618,775,382,393,-2,1,99.69,9.1,0,0,0,0,0,0,5.25085847992362e-05,0.000820853795744787,0.000820853795744787
8.7,"eps_greedy_SVM","SVM",32,39,0,0,0,3912,3526,386,0.92561531210725,0.627272727272727,1.76348610067618,776,382,394,1,1,100,9.1,0,0,0,0,0,0,0,0,0
8.7,"eps_greedy_SVM","SVM",33,0,3812,3422,390,100,89,11,0.914733044532049,0.55609756097561,1.78517702596381,27,11,16,0,1.5,2.56,8.1,0,0,0,0,0,0,0.404179822711031,400.493228006006,46.7048926603172
8.7,"eps_greedy_SVM","SVM",33,1,3712,3369,343,200,142,58,0.912206265409313,0.619512195121951,1.72288569448481,117,57,60,90,1.1,5.11,2.4,0,0,0,0,0,0,0.691262657889266,500.32510346121,74.0699977144644
8.7,"eps_greedy_SVM","SVM",33,2,3612,3328,284,300,183,117,0.915649593960249,0.634146341463415,1.73241317297966,185,94,91,68,1,7.67,1.6,0,0,0,0,0,0,0.526160455970176,307.797159446852,64.3954370273413
8.7,"eps_greedy_SVM","SVM",33,3,3512,3296,216,400,215,185,0.916135727319584,0.648780487804878,1.7396038269775,244,122,122,59,1,10.22,1.2,0,0,0,0,0,0,0.386793754957207,196.78190982323,53.2318723307294
8.7,"eps_greedy_SVM","SVM",33,4,3412,3247,165,500,264,236,0.906492457271811,0.653658536585366,1.73800345547154,334,168,166,90,1,12.78,1.1,0,0,0,0,0,0,0.235939866315638,125.767432933659,30.8725371328097
8.7,"eps_greedy_SVM","SVM",33,5,3312,3176,136,600,335,265,0.897652909139051,0.678048780487805,1.71324619323541,406,203,203,72,1,15.34,1.3,0,0,0,0,0,0,0.143889015356782,103.762786485479,20.5546795739669
8.7,"eps_greedy_SVM","SVM",33,6,3212,3102,110,700,409,291,0.901814990737005,0.692682926829268,1.6781026815793,470,229,241,64,1.1,17.89,1.4,0,0,0,0,0,0,0.102263422489539,86.3919292786143,13.1100978588055
8.7,"eps_greedy_SVM","SVM",33,7,3112,3023,89,800,488,312,0.892969870875179,0.692682926829268,1.63567944250871,519,252,267,49,1.1,20.45,1.6,0,0,0,0,0,0,0.0795777266679292,91.0985129432037,11.4225012597912
8.7,"eps_greedy_SVM","SVM",33,8,3012,2942,70,900,569,331,0.895885278098928,0.702439024390244,1.63417329200916,563,270,293,44,1.1,23.01,1.7,0,0,0,0,0,0,0.0668599762835568,99.8050340862799,9.69938771403448
8.7,"eps_greedy_SVM","SVM",33,9,2912,2857,55,1000,654,346,0.902572745887376,0.702439024390244,1.64447341800607,598,287,311,35,1.1,25.56,1.9,0,0,0,0,0,0,0.0618730651456244,103.850056442358,7.23886244030651
8.7,"eps_greedy_SVM","SVM",33,10,2812,2766,46,1100,745,355,0.914462815673286,0.697560975609756,1.69723727099022,632,302,330,34,1.1,28.12,2.1,0,0,0,0,0,0,0.0683384470611955,103.337700637793,7.8763805865678
8.7,"eps_greedy_SVM","SVM",33,11,2712,2672,40,1200,839,361,0.923728601078144,0.697560975609756,1.72203207114944,649,317,332,17,1,30.67,2.3,0,0,0,0,0,0,0.068103227091856,83.058471702507,7.59009615015553
8.7,"eps_greedy_SVM","SVM",33,12,2612,2578,34,1300,933,367,0.9286150074522,0.68780487804878,1.74120714847701,670,326,344,21,1.1,33.23,2.5,0,0,0,0,0,0,0.0708114462439374,76.8180694900774,7.69417863562436
8.7,"eps_greedy_SVM","SVM",33,13,2512,2482,30,1400,1029,371,0.930793553509503,0.68780487804878,1.75000112397437,683,331,352,13,1.1,35.79,2.8,0,0,0,0,0,0,0.0595758512801221,56.897780971778,6.37019067424526
8.7,"eps_greedy_SVM","SVM",33,14,2412,2390,22,1500,1121,379,0.930317170676001,0.682926829268293,1.75000112397437,703,340,363,20,1.1,38.34,3,0,0,0,0,0,0,0.0658864407837478,55.7845534139046,7.32920751101479
8.7,"eps_greedy_SVM","SVM",33,15,2312,2295,17,1600,1216,384,0.929815715061789,0.682926829268293,1.74120714847701,722,346,376,19,1.1,40.9,3.2,0,0,0,0,0,0,0.0540468710134223,45.3278649194297,6.46787017161117
8.7,"eps_greedy_SVM","SVM",33,16,2212,2201,11,1700,1310,390,0.929513448761001,0.678048780487805,1.73081794906347,743,353,390,21,1.1,43.46,3.4,0,0,0,0,0,0,0.0451690025075049,43.4136302920756,5.43677035446186
8.7,"eps_greedy_SVM","SVM",33,17,2112,2102,10,1800,1409,391,0.930161162262693,0.678048780487805,1.73081794906347,750,354,396,7,1.1,46.01,3.6,0,0,0,0,0,0,0.0331781770758311,32.8103632092801,3.64534390524095
8.7,"eps_greedy_SVM","SVM",33,18,2012,2002,10,1900,1509,391,0.930432784053724,0.673170731707317,1.7396038269775,751,355,396,1,1.1,48.57,3.9,0,0,0,0,0,0,0.0259338914195186,25.1465175419539,2.78136529977042
8.7,"eps_greedy_SVM","SVM",33,19,1912,1903,9,2000,1608,392,0.930748979677129,0.673170731707317,1.74120714847701,747,358,389,-4,1.1,51.12,4.1,0,0,0,0,0,0,0.0216462896018866,20.6043579105611,2.3150510041275
8.7,"eps_greedy_SVM","SVM",33,20,1812,1803,9,2100,1708,392,0.930985778161618,0.673170731707317,1.74838970489152,749,358,391,2,1.1,53.68,4.4,0,0,0,0,0,0,0.0179539324484082,17.3206413479787,1.94779957905486
8.7,"eps_greedy_SVM","SVM",33,21,1712,1703,9,2200,1808,392,0.931180788678256,0.673170731707317,1.74678125070119,747,359,388,-2,1.1,56.24,4.6,0,0,0,0,0,0,0.0146451343961113,13.680536198652,1.53779834557074
8.7,"eps_greedy_SVM","SVM",33,22,1612,1604,8,2300,1907,393,0.934242453789479,0.673170731707317,1.75879509947173,759,364,395,12,1.1,58.79,4.9,0,0,0,0,0,0,0.0118671530532204,9.91274641725807,1.29845266687253
8.7,"eps_greedy_SVM","SVM",33,23,1512,1505,7,2400,2006,394,0.935819253109728,0.668292682926829,1.7643368411605,774,376,398,15,1.1,61.35,5.1,0,0,0,0,0,0,0.00873355301921609,6.99013190861128,1.06753885882893
8.7,"eps_greedy_SVM","SVM",33,24,1412,1407,5,2500,2104,396,0.936529648563196,0.673170731707317,1.76596146071958,779,376,403,5,1.1,63.91,5.3,0,0,0,0,0,0,0.0085229889686091,5.92962164296672,0.869295346871011
8.7,"eps_greedy_SVM","SVM",33,25,1312,1307,5,2600,2204,396,0.938613475226702,0.668292682926829,1.7643368411605,788,386,402,9,1,66.46,5.6,0,0,0,0,0,0,0.00530034820381972,3.11361378161529,0.651544599308938
8.7,"eps_greedy_SVM","SVM",33,26,1212,1207,5,2700,2304,396,0.93837389087769,0.673170731707317,1.76271520803443,787,386,401,-1,1,69.02,5.8,0,0,0,0,0,0,0.00397189963775968,2.46151804412613,0.439743669503342
8.7,"eps_greedy_SVM","SVM",33,27,1112,1108,4,2800,2403,397,0.938982602276054,0.663414634146341,1.76596146071958,792,387,405,5,1,71.57,6.1,0,0,0,0,0,0,0.00388114968429753,2.19024948047754,0.403769778922346
8.7,"eps_greedy_SVM","SVM",33,28,1012,1008,4,2900,2503,397,0.939146968282934,0.663414634146341,1.76271520803443,795,389,406,3,1,74.13,6.3,0,0,0,0,0,0,0.00267842917374818,1.37471025738433,0.297269408216383
8.7,"eps_greedy_SVM","SVM",33,29,912,908,4,3000,2603,397,0.939286261509104,0.668292682926829,1.76271520803443,795,389,406,0,1,76.69,6.6,0,0,0,0,0,0,0.00282474738746842,1.23268706166474,0.293578312111353
8.7,"eps_greedy_SVM","SVM",33,30,812,808,4,3100,2703,397,0.93935730105445,0.668292682926829,1.76758907496909,798,391,407,3,1,79.24,6.8,0,0,0,0,0,0,0.00191573349934245,0.719123036391964,0.208966088219549
8.7,"eps_greedy_SVM","SVM",33,31,712,709,3,3200,2802,398,0.939620565251913,0.663414634146341,1.76596146071958,801,393,408,3,1,81.8,7,0,0,0,0,0,0,0.00186628122869408,0.626263837372006,0.208395765164462
8.7,"eps_greedy_SVM","SVM",33,32,612,610,2,3300,2901,399,0.939797467649149,0.658536585365854,1.76758907496909,805,395,410,4,1,84.36,7.3,0,0,0,0,0,0,0.00144520805274279,0.459493512018975,0.171983830128004
8.7,"eps_greedy_SVM","SVM",33,33,512,510,2,3400,3001,399,0.939922831552702,0.663414634146341,1.76758907496909,806,395,411,1,1,86.91,7.5,0,0,0,0,0,0,0.000952978288410939,0.295206481204903,0.118550188737609
8.7,"eps_greedy_SVM","SVM",33,34,412,412,0,3500,3099,401,0.940349068824784,0.668292682926829,1.76596146071958,817,398,419,11,1.1,89.47,7.7,0,0,0,0,0,0,0.00104850812575286,0.317595746846977,0.129525420380068
8.7,"eps_greedy_SVM","SVM",33,35,312,312,0,3600,3199,401,0.94032121017955,0.668292682926829,1.76758907496909,815,399,416,-2,1,92.02,8,0,0,0,0,0,0,0.000535090407987086,0.131843175156337,0.0646997015431709
8.7,"eps_greedy_SVM","SVM",33,36,212,212,0,3700,3299,401,0.940138736053266,0.668292682926829,1.76596146071958,820,400,420,5,1.1,94.58,8.2,0,0,0,0,0,0,0.000260572201103016,0.0531115043160319,0.0340598217398716
8.7,"eps_greedy_SVM","SVM",33,37,112,112,0,3800,3399,401,0.940067696507919,0.668292682926829,1.77148493543759,821,401,420,1,1,97.14,8.5,0,0,0,0,0,0,8.40583476324906e-05,0.0148729340693077,0.014009562087597
8.7,"eps_greedy_SVM","SVM",33,38,12,12,0,3900,3499,401,0.940034266133637,0.668292682926829,1.77311463639015,822,401,421,1,1,99.69,8.7,0,0,0,0,0,0,3.31681455748872e-05,0.000517714728182474,0.000517714728182474
8.7,"eps_greedy_SVM","SVM",33,39,0,0,0,3912,3511,401,0.940042623727207,0.668292682926829,1.77148493543759,822,401,421,0,1,100,8.8,0,0,0,0,0,0,0,0,0
8.7,"eps_greedy_SVM","SVM",34,0,3812,3408,404,100,92,8,0.892712124226213,0.5,1.70054634424438,28,8,20,0,2.5,2.56,11.5,0,0,0,0,0,0,0.156338876969005,312.260875318506,16.9257936909768
8.7,"eps_greedy_SVM","SVM",34,1,3712,3376,336,200,124,76,0.907795733526807,0.572164948453608,1.75910936923121,104,52,52,76,1,5.11,1.6,0,0,0,0,0,0,0.691628596253888,384.555194846204,75.7501913156015
8.7,"eps_greedy_SVM","SVM",34,2,3612,3345,267,300,155,145,0.908111681898486,0.572164948453608,1.75307049573687,157,79,78,53,1,7.67,1.1,0,0,0,0,0,0,0.625111606586213,306.536051749272,72.4974439975926
8.7,"eps_greedy_SVM","SVM",34,3,3512,3302,210,400,198,202,0.916294159635836,0.603092783505155,1.74219223771983,243,123,120,86,1,10.22,1,0,0,0,0,0,0,0.439319151151631,186.916730073672,60.3424842791429
8.7,"eps_greedy_SVM","SVM",34,4,3412,3258,154,500,242,258,0.9111161168775,0.61340206185567,1.74059242850246,327,166,161,84,1,12.78,0.9,0,0,0,0,0,0,0.278116729308675,186.831662041898,37.1840450232034
8.7,"eps_greedy_SVM","SVM",34,5,3312,3190,122,600,310,290,0.893490293363918,0.634020618556701,1.65878941782899,409,200,209,82,1,15.34,1.1,0,0,0,0,0,0,0.166843687721967,122.115917215282,24.4312893584544
8.7,"eps_greedy_SVM","SVM",34,6,3212,3109,103,700,391,309,0.898925775536233,0.628865979381443,1.66959094832083,454,222,232,45,1,17.89,1.3,0,0,0,0,0,0,0.0923083436674625,88.7911926195371,13.0528982989928
8.7,"eps_greedy_SVM","SVM",34,7,3112,3041,71,800,459,341,0.880998630890399,0.628865979381443,1.60762031450425,523,254,269,69,1.1,20.45,1.3,0,0,0,0,0,0,0.0881410205617245,130.856325359714,13.1434304686426
8.7,"eps_greedy_SVM","SVM",34,8,3012,2956,56,900,544,356,0.883915302432805,0.628865979381443,1.62620552045228,569,279,290,46,1,23.01,1.5,0,0,0,0,0,0,0.0737683731152635,104.172659612119,8.66357024787452
8.7,"eps_greedy_SVM","SVM",34,9,2912,2860,52,1000,640,360,0.889827632610545,0.628865979381443,1.64025545785324,582,283,299,13,1.1,25.56,1.8,0,0,0,0,0,0,0.056681146610767,83.9908450729619,6.23107699317439
8.7,"eps_greedy_SVM","SVM",34,10,2812,2765,47,1100,735,365,0.894822834876028,0.634020618556701,1.64025545785324,592,288,304,10,1.1,28.12,2,0,0,0,0,0,0,0.0507612845465854,76.7673873782212,5.52121815339333
8.7,"eps_greedy_SVM","SVM",34,11,2712,2669,43,1200,831,369,0.899197842189659,0.628865979381443,1.65408332937432,617,296,321,25,1.1,30.67,2.3,0,0,0,0,0,0,0.0421441855991165,59.406432554418,4.43230621550936
8.7,"eps_greedy_SVM","SVM",34,12,2612,2570,42,1300,930,370,0.916352668593571,0.608247422680412,1.73771675614043,641,314,327,24,1,33.23,2.5,0,0,0,0,0,0,0.0366370307716686,28.4384537125237,4.68225150906155
8.7,"eps_greedy_SVM","SVM",34,13,2512,2475,37,1400,1025,375,0.916231262506298,0.623711340206186,1.71754855613146,651,319,332,10,1,35.79,2.7,0,0,0,0,0,0,0.0298524348561969,28.2975543498394,3.4624603228703
8.7,"eps_greedy_SVM","SVM",34,14,2412,2380,32,1500,1120,380,0.91792363410837,0.618556701030928,1.71439129775622,663,323,340,12,1.1,38.34,2.9,0,0,0,0,0,0,0.0253655907306698,28.3251571015093,2.87187801633894
8.7,"eps_greedy_SVM","SVM",34,15,2312,2291,21,1600,1209,391,0.920167452636994,0.608247422680412,1.74700935911445,697,339,358,34,1.1,40.9,3.1,0,0,0,0,0,0,0.0699608686279252,45.5398929333429,8.39199845271602
8.7,"eps_greedy_SVM","SVM",34,16,2212,2191,21,1700,1309,391,0.920299097791865,0.603092783505155,1.74700935911445,701,343,358,4,1,43.46,3.3,0,0,0,0,0,0,0.0509497231933802,31.1779501263831,5.52810214649834
8.7,"eps_greedy_SVM","SVM",34,17,2112,2095,17,1800,1405,395,0.920515580935437,0.603092783505155,1.74700935911445,712,348,364,11,1,46.01,3.6,0,0,0,0,0,0,0.0463913203571658,25.4964986083482,5.21802249997922
8.7,"eps_greedy_SVM","SVM",34,18,2012,2000,12,1900,1500,400,0.919778368068148,0.597938144329897,1.74700935911445,728,354,374,16,1.1,48.57,3.8,0,0,0,0,0,0,0.0443711143123491,22.6042598174939,5.0843795042423
8.7,"eps_greedy_SVM","SVM",34,19,1912,1904,8,2000,1596,404,0.919297131890892,0.597938144329897,1.74540069487954,736,357,379,8,1.1,51.12,4,0,0,0,0,0,0,0.0217427862976941,17.0687587471348,3.55524918474211
8.7,"eps_greedy_SVM","SVM",34,20,1812,1809,3,2100,1691,409,0.918669623319332,0.592783505154639,1.74379499046842,753,364,389,17,1.1,53.68,4.1,0,0,0,0,0,0,0.0163507985794015,14.2445368551775,1.93221857761973
8.7,"eps_greedy_SVM","SVM",34,21,1712,1709,3,2200,1791,409,0.918736908620711,0.597938144329897,1.74379499046842,755,366,389,2,1.1,56.24,4.4,0,0,0,0,0,0,0.0122399958308577,10.2652215631054,1.27073490850386
8.7,"eps_greedy_SVM","SVM",34,22,1612,1609,3,2300,1891,409,0.919266414688084,0.597938144329897,1.74379499046842,765,370,395,10,1.1,58.79,4.6,0,0,0,0,0,0,0.00948921566068872,7.11287622251096,1.12945180602413
8.7,"eps_greedy_SVM","SVM",34,23,1512,1509,3,2400,1991,409,0.919114291398009,0.597938144329897,1.74219223771983,763,370,393,-2,1.1,61.35,4.9,0,0,0,0,0,0,0.0078653133019033,5.84475808640653,0.822392670353137
8.7,"eps_greedy_SVM","SVM",34,24,1412,1409,3,2500,2091,409,0.919519465930227,0.592783505154639,1.74540069487954,771,373,398,8,1.1,63.91,5.1,0,0,0,0,0,0,0.00605747913451552,4.17507529325208,0.645544311157309
8.7,"eps_greedy_SVM","SVM",34,25,1312,1309,3,2600,2191,409,0.920445370186163,0.587628865979381,1.74540069487954,774,375,399,3,1.1,66.46,5.4,0,0,0,0,0,0,0.00541678360247456,3.4738817165629,0.574358409058547
8.7,"eps_greedy_SVM","SVM",34,26,1212,1209,3,2700,2291,409,0.921083117825322,0.587628865979381,1.74540069487954,779,377,402,5,1.1,69.02,5.6,0,0,0,0,0,0,0.00516467523610312,2.98489722050884,0.535834619067236
8.7,"eps_greedy_SVM","SVM",34,27,1112,1109,3,2800,2391,409,0.921141626783044,0.587628865979381,1.7514592177077,779,377,402,0,1.1,71.57,5.8,0,0,0,0,0,0,0.00397097034974355,2.04762338283936,0.421088097119947
8.7,"eps_greedy_SVM","SVM",34,28,1012,1010,2,2900,2490,410,0.92130837731255,0.587628865979381,1.7514592177077,784,381,403,5,1.1,74.13,6.1,0,0,0,0,0,0,0.00330239701650547,1.51635254266508,0.349946187676385
8.7,"eps_greedy_SVM","SVM",34,29,912,911,1,3000,2589,411,0.921343482687184,0.587628865979381,1.75468474112889,788,383,405,4,1.1,76.69,6.3,0,0,0,0,0,0,0.00305282588130488,1.26809207844186,0.328007505405609
8.7,"eps_greedy_SVM","SVM",34,30,812,811,1,3100,2689,411,0.921290824625235,0.587628865979381,1.75468474112889,789,385,404,1,1,79.24,6.5,0,0,0,0,0,0,0.00262728921270611,0.979090057945735,0.291561255913758
8.7,"eps_greedy_SVM","SVM",34,31,712,712,0,3200,2788,412,0.921422469780108,0.587628865979381,1.75307049573687,795,387,408,6,1.1,81.8,6.8,0,0,0,0,0,0,0.00204590045705059,0.700912654093786,0.236322655348144
8.7,"eps_greedy_SVM","SVM",34,32,612,612,0,3300,2888,412,0.92134640813507,0.587628865979381,1.75307049573687,796,387,409,1,1.1,84.36,7,0,0,0,0,0,0,0.00151213581171825,0.475912437458586,0.179667670339989
8.7,"eps_greedy_SVM","SVM",34,33,512,512,0,3400,2988,412,0.921156254022475,0.587628865979381,1.75307049573687,799,388,411,3,1.1,86.91,7.3,0,0,0,0,0,0,0.000837778069975619,0.265535425095686,0.110141089415003
8.7,"eps_greedy_SVM","SVM",34,34,412,412,0,3500,3088,412,0.921065565138007,0.587628865979381,1.75468474112889,801,389,412,2,1.1,89.47,7.5,0,0,0,0,0,0,0.000534138973246488,0.157397890850964,0.0686130947999073
8.7,"eps_greedy_SVM","SVM",34,35,312,312,0,3600,3188,412,0.920983652597198,0.587628865979381,1.74985089886683,805,391,414,4,1.1,92.02,7.7,0,0,0,0,0,0,0.00038818557386873,0.100003165718136,0.048584959799283
8.7,"eps_greedy_SVM","SVM",34,36,212,212,0,3700,3288,412,0.921030459763376,0.587628865979381,1.76234600100532,805,391,414,0,1.1,94.58,8,0,0,0,0,0,0,0.000211664299526261,0.0437463115059798,0.0279880322690379
8.7,"eps_greedy_SVM","SVM",34,37,112,112,0,3800,3388,412,0.921124074095731,0.587628865979381,1.76396878737825,808,391,417,3,1.1,97.14,8.2,0,0,0,0,0,0,9.399464666682e-05,0.015984125660108,0.0150299583731289
8.7,"eps_greedy_SVM","SVM",34,38,12,12,0,3900,3488,412,0.921334706343532,0.587628865979381,1.76559456506247,811,394,417,3,1.1,99.69,8.5,0,0,0,0,0,0,6.52121800029597e-05,0.000915298930981927,0.000915298930981927
8.7,"eps_greedy_SVM","SVM",34,39,0,0,0,3912,3500,412,0.921333243619589,0.587628865979381,1.76396878737825,811,394,417,0,1.1,100,8.5,0,0,0,0,0,0,0,0,0
8.7,"eps_greedy_SVM","SVM",35,0,3812,3433,379,100,91,9,0.877318651618951,0.440366972477064,1.77795628461506,36,9,27,0,3,2.56,10.1,0,0,0,0,0,0,0.0972761610448968,347.746257061292,9.86904056021919
8.7,"eps_greedy_SVM","SVM",35,1,3712,3363,349,200,161,39,0.877664403880882,0.568807339449541,1.68543768057175,87,39,48,51,1.2,5.11,4.1,0,0,0,0,0,0,0.43143493438031,343.400847707703,55.6374944761305
8.7,"eps_greedy_SVM","SVM",35,2,3612,3341,271,300,183,117,0.891254315304959,0.619266055045872,1.70865018610265,156,77,79,69,1,7.67,1.6,0,0,0,0,0,0,0.530751160033366,296.150844718468,66.8395859388311
8.7,"eps_greedy_SVM","SVM",35,3,3512,3295,217,400,229,171,0.900843002079786,0.637614678899083,1.72357325957906,237,121,116,81,1,10.22,1.3,0,0,0,0,0,0,0.312803709376681,206.589303097066,46.246583297083
8.7,"eps_greedy_SVM","SVM",35,4,3412,3246,166,500,278,222,0.884194106903439,0.619266055045872,1.68543768057175,326,164,162,89,1,12.78,1.3,0,0,0,0,0,0,0.22792916992205,160.439709538935,31.4096885761817
8.7,"eps_greedy_SVM","SVM",35,5,3312,3187,125,600,337,263,0.906707593880986,0.651376146788991,1.74166758100318,402,198,204,76,1,15.34,1.3,0,0,0,0,0,0,0.238345507131496,182.687564273939,33.0859814269138
8.7,"eps_greedy_SVM","SVM",35,6,3212,3111,101,700,413,287,0.916805671392818,0.669724770642202,1.70353020758466,459,224,235,57,1,17.89,1.4,0,0,0,0,0,0,0.0994952453415617,105.968316893239,13.913003141912
8.7,"eps_greedy_SVM","SVM",35,7,3112,3033,79,800,491,309,0.92000190031778,0.68348623853211,1.70353020758466,513,244,269,54,1.1,20.45,1.6,0,0,0,0,0,0,0.0815064123255129,102.820492844993,10.0760733441648
8.7,"eps_greedy_SVM","SVM",35,8,3012,2949,63,900,575,325,0.921445613961008,0.711009174311927,1.69214148865238,563,269,294,50,1.1,23.01,1.8,0,0,0,0,0,0,0.0882265243169705,124.288173697372,11.3630832592859
8.7,"eps_greedy_SVM","SVM",35,9,2912,2857,55,1000,667,333,0.926016933942852,0.706422018348624,1.72006933581364,594,285,309,31,1.1,25.56,2,0,0,0,0,0,0,0.0716682575316674,92.0623071037033,8.11974238801698
8.7,"eps_greedy_SVM","SVM",35,10,2812,2768,44,1100,756,344,0.931485626207498,0.701834862385321,1.74992192972832,622,297,325,28,1.1,28.12,2.2,0,0,0,0,0,0,0.0753521742559621,89.9216728809722,8.42766108391258
8.7,"eps_greedy_SVM","SVM",35,11,2712,2674,38,1200,850,350,0.932726111421975,0.706422018348624,1.74670811534865,641,308,333,19,1.1,30.67,2.4,0,0,0,0,0,0,0.0699524462266626,76.6121346362944,7.77444477994921
8.7,"eps_greedy_SVM","SVM",35,12,2612,2580,32,1300,944,356,0.93331072307092,0.701834862385321,1.74831354560173,653,314,339,12,1.1,33.23,2.7,0,0,0,0,0,0,0.0618337528349386,64.5338096048848,6.81769309079965
8.7,"eps_greedy_SVM","SVM",35,13,2512,2482,30,1400,1042,358,0.933689466960867,0.697247706422018,1.74992192972832,655,315,340,2,1.1,35.79,2.9,0,0,0,0,0,0,0.0572995455713086,62.1580684858959,6.17394596595108
8.7,"eps_greedy_SVM","SVM",35,14,2412,2383,29,1500,1141,359,0.933620844374533,0.697247706422018,1.74992192972832,658,316,342,3,1.1,38.34,3.2,0,0,0,0,0,0,0.0460247019625136,49.3752177837132,4.96059618121844
8.7,"eps_greedy_SVM","SVM",35,15,2312,2291,21,1600,1233,367,0.934270119614444,0.697247706422018,1.74831354560173,690,325,365,32,1.1,40.9,3.4,0,0,0,0,0,0,0.0443688574839581,48.6099614447701,5.01066886833506
8.7,"eps_greedy_SVM","SVM",35,16,2212,2192,20,1700,1332,368,0.934163226739578,0.692660550458716,1.74510563083916,694,328,366,4,1.1,43.46,3.6,0,0,0,0,0,0,0.0360168074899842,37.413420545011,3.83784135848056
8.7,"eps_greedy_SVM","SVM",35,17,2112,2092,20,1800,1432,368,0.934124956451046,0.692660550458716,1.74510563083916,698,328,370,4,1.1,46.01,3.9,0,0,0,0,0,0,0.0332666795035413,34.1298395090099,3.52938991333939
8.7,"eps_greedy_SVM","SVM",35,18,2012,1992,20,1900,1532,368,0.933763368207679,0.697247706422018,1.74992192972832,701,330,371,3,1.1,48.57,4.2,0,0,0,0,0,0,0.0237754052457979,22.3517498098558,2.53115871231344
8.7,"eps_greedy_SVM","SVM",35,19,1912,1893,19,2000,1631,369,0.933861023426689,0.697247706422018,1.75817627845345,706,333,373,5,1.1,51.12,4.4,0,0,0,0,0,0,0.02039358967241,19.094616293613,2.18552809075408
8.7,"eps_greedy_SVM","SVM",35,20,1812,1799,13,2100,1725,375,0.934920714519477,0.697247706422018,1.7533372611733,715,341,374,9,1.1,53.68,4.6,0,0,0,0,0,0,0.0182140786657681,17.8798365993928,1.99221122500107
8.7,"eps_greedy_SVM","SVM",35,21,1712,1702,10,2200,1822,378,0.93587219307228,0.692660550458716,1.75173016927488,725,347,378,10,1.1,56.24,4.8,0,0,0,0,0,0,0.0190706217584012,16.8220836679855,1.94666530419315
8.7,"eps_greedy_SVM","SVM",35,22,1612,1603,9,2300,1921,379,0.935482891861355,0.701834862385321,1.75656030760928,745,362,383,20,1.1,58.79,5.1,0,0,0,0,0,0,0.0126629066057478,7.9788246809505,1.63366544906057
8.7,"eps_greedy_SVM","SVM",35,23,1512,1506,6,2400,2018,382,0.936330116869537,0.701834862385321,1.75979522530285,751,365,386,6,1.1,61.35,5.3,0,0,0,0,0,0,0.0100712132617237,7.40021061784541,1.20839280434197
8.7,"eps_greedy_SVM","SVM",35,24,1412,1407,5,2500,2117,383,0.935663685983039,0.701834862385321,1.75494730457199,756,367,389,5,1.1,63.91,5.5,0,0,0,0,0,0,0.00785186732673579,5.943401402647,0.850348969577494
8.7,"eps_greedy_SVM","SVM",35,25,1312,1308,4,2600,2216,384,0.936645516833642,0.701834862385321,1.75494730457199,766,370,396,10,1.1,66.46,5.8,0,0,0,0,0,0,0.00775518926902711,5.31194506373813,0.799554468059325
8.7,"eps_greedy_SVM","SVM",35,26,1212,1208,4,2700,2316,384,0.937504618827903,0.697247706422018,1.76480706961684,769,373,396,3,1.1,69.02,6,0,0,0,0,0,0,0.00509903746887373,3.19893711984911,0.580363571960588
8.7,"eps_greedy_SVM","SVM",35,27,1112,1108,4,2800,2416,384,0.93756928241887,0.697247706422018,1.76805717471742,769,374,395,0,1.1,71.57,6.3,0,0,0,0,0,0,0.00473717396641638,2.55413378702594,0.484045825285943
8.7,"eps_greedy_SVM","SVM",35,28,1012,1008,4,2900,2516,384,0.937330423031824,0.701834862385321,1.76480706961684,775,377,398,6,1.1,74.13,6.6,0,0,0,0,0,0,0.00349684101880578,1.69138121137927,0.38058700875902
8.7,"eps_greedy_SVM","SVM",35,29,912,909,3,3000,2615,385,0.937393766957669,0.701834862385321,1.76480706961684,779,379,400,4,1.1,76.69,6.8,0,0,0,0,0,0,0.00336838672529852,1.39514305882926,0.35205980291024
8.7,"eps_greedy_SVM","SVM",35,30,812,809,3,3100,2715,385,0.937479545190585,0.701834862385321,1.76318649379533,780,380,400,1,1.1,79.24,7.1,0,0,0,0,0,0,0.00223191231756306,0.776202617290063,0.243029503675844
8.7,"eps_greedy_SVM","SVM",35,31,712,709,3,3200,2815,385,0.937511217153508,0.706422018348624,1.75995425457664,782,380,402,2,1.1,81.8,7.3,0,0,0,0,0,0,0.00183077159153875,0.584779451957025,0.211521590823876
8.7,"eps_greedy_SVM","SVM",35,32,612,610,2,3300,2914,386,0.937801543480301,0.701834862385321,1.76332958757526,785,382,403,3,1.1,84.36,7.5,0,0,0,0,0,0,0.00114056140033883,0.372866913927483,0.147658634079763
8.7,"eps_greedy_SVM","SVM",35,33,512,512,0,3400,3012,388,0.937600954381792,0.701834862385321,1.77795628461506,797,386,411,12,1.1,86.91,7.8,0,0,0,0,0,0,0.000983714759994131,0.326981036530747,0.123829044040622
8.7,"eps_greedy_SVM","SVM",35,34,412,412,0,3500,3112,388,0.937734240559092,0.697247706422018,1.77803215217574,794,387,407,-3,1.1,89.47,8,0,0,0,0,0,0,0.000694526523381588,0.207579874322111,0.0849358274579608
8.7,"eps_greedy_SVM","SVM",35,35,312,312,0,3600,3212,388,0.937566643088627,0.697247706422018,1.77142568301868,795,387,408,1,1.1,92.02,8.3,0,0,0,0,0,0,0.000571527862871419,0.145298670562942,0.068089601016863
8.7,"eps_greedy_SVM","SVM",35,36,212,212,0,3700,3312,388,0.937426758585719,0.697247706422018,1.77468497590372,799,388,411,4,1.1,94.58,8.5,0,0,0,0,0,0,0.000218470348449464,0.0433335926696512,0.0275287539524396
8.7,"eps_greedy_SVM","SVM",35,37,112,112,0,3800,3412,388,0.937368693320361,0.688073394495413,1.77305383162439,802,388,414,3,1.1,97.14,8.8,0,0,0,0,0,0,7.37647354847917e-05,0.0134913191580386,0.0127099629570841
8.7,"eps_greedy_SVM","SVM",35,38,12,12,0,3900,3512,388,0.93809978779783,0.688073394495413,1.77468497590372,798,388,410,-4,1.1,99.69,9.1,0,0,0,0,0,0,4.98995534151931e-05,0.000676924971572496,0.000676924971572496
8.7,"eps_greedy_SVM","SVM",35,39,0,0,0,3912,3524,388,0.93821063966806,0.688073394495413,1.77142568301868,798,388,410,0,1.1,100,9.1,0,0,0,0,0,0,0,0,0
8.7,"eps_greedy_SVM","SVM",36,0,3812,3413,399,100,91,9,0.892885050734876,0.505050505050505,1.75663139182846,24,9,15,0,1.7,2.56,10.1,0,0,0,0,0,0,0.651123089206591,353.962972401427,75.7077147022456
8.7,"eps_greedy_SVM","SVM",36,1,3712,3360,352,200,144,56,0.919087059445418,0.611111111111111,1.76406926406926,109,52,57,85,1.1,5.11,2.6,0,0,0,0,0,0,0.678644544370243,340.909760939092,76.0812987748795
8.7,"eps_greedy_SVM","SVM",36,2,3612,3333,279,300,171,129,0.913260879557801,0.616161616161616,1.75824298026133,157,82,75,48,0.9,7.67,1.3,0,0,0,0,0,0,0.568125541900853,223.074312780291,70.3219269268447
8.7,"eps_greedy_SVM","SVM",36,3,3512,3297,215,400,207,193,0.923532825409948,0.636363636363636,1.79366010333752,223,113,110,66,1,10.22,1.1,0,0,0,0,0,0,0.425097822868264,125.236859209338,60.6853243390336
8.7,"eps_greedy_SVM","SVM",36,4,3412,3244,168,500,260,240,0.889786660691106,0.626262626262626,1.69194709526201,314,160,154,91,1,12.78,1.1,0,0,0,0,0,0,0.154300828962565,68.9282820295247,26.2908523767622
8.7,"eps_greedy_SVM","SVM",36,5,3312,3174,138,600,330,270,0.887666482803,0.611111111111111,1.66465762598359,380,188,192,66,1,15.34,1.2,0,0,0,0,0,0,0.0779855425188873,43.9131064508333,13.5936005816586
8.7,"eps_greedy_SVM","SVM",36,6,3212,3097,115,700,407,293,0.884841015387101,0.621212121212121,1.61917517718623,439,213,226,59,1.1,17.89,1.4,0,0,0,0,0,0,0.0610649667677172,44.2693138735469,8.5748869539142
8.7,"eps_greedy_SVM","SVM",36,7,3112,3027,85,800,477,323,0.883235081187309,0.666666666666667,1.63887725178048,501,239,262,62,1.1,20.45,1.5,0,0,0,0,0,0,0.061977534822308,66.6219435691219,10.7547711823968
8.7,"eps_greedy_SVM","SVM",36,8,3012,2944,68,900,560,340,0.892069155721035,0.676767676767677,1.64494995957737,544,263,281,43,1.1,23.01,1.6,0,0,0,0,0,0,0.0610228836871157,81.7413256261497,7.666098626205
8.7,"eps_greedy_SVM","SVM",36,9,2912,2860,52,1000,644,356,0.900577159536198,0.666666666666667,1.64646464646465,590,284,306,46,1.1,25.56,1.8,0,0,0,0,0,0,0.0603843668224994,88.603473290283,6.98726783972686
8.7,"eps_greedy_SVM","SVM",36,10,2812,2765,47,1100,739,361,0.911802898151024,0.661616161616162,1.68285060550254,608,293,315,18,1.1,28.12,2,0,0,0,0,0,0,0.0497838945175595,70.3509188976845,5.71756962582768
8.7,"eps_greedy_SVM","SVM",36,11,2712,2673,39,1200,831,369,0.923874696912241,0.661616161616162,1.7299259879905,636,306,330,28,1.1,30.67,2.3,0,0,0,0,0,0,0.0579023415841451,68.3150489415498,6.44998501771668
8.7,"eps_greedy_SVM","SVM",36,12,2612,2582,30,1300,922,378,0.929818664460291,0.656565656565657,1.74491929413733,659,319,340,23,1.1,33.23,2.4,0,0,0,0,0,0,0.0599494433930023,66.1708188129474,6.66148561132281
8.7,"eps_greedy_SVM","SVM",36,13,2512,2485,27,1400,1019,381,0.930016892474222,0.651515151515151,1.74652603381885,673,322,351,14,1.1,35.79,2.7,0,0,0,0,0,0,0.0556526667611794,56.7048587231856,5.96299274014395
8.7,"eps_greedy_SVM","SVM",36,14,2412,2387,25,1500,1117,383,0.92865515220463,0.656565656565657,1.74813573523251,683,327,356,10,1.1,38.34,2.9,0,0,0,0,0,0,0.0468754054298218,46.7085827459375,5.20463190488841
8.7,"eps_greedy_SVM","SVM",36,15,2312,2295,17,1600,1209,391,0.92682513416301,0.661616161616162,1.74331550802139,712,335,377,29,1.1,40.9,3.1,0,0,0,0,0,0,0.0482798499992173,44.1238480126144,5.98564233696145
8.7,"eps_greedy_SVM","SVM",36,16,2212,2200,12,1700,1304,396,0.926756185288601,0.661616161616162,1.74652603381885,720,342,378,8,1.1,43.46,3.3,0,0,0,0,0,0,0.0363106269190499,37.9105833871303,4.4461708665129
8.7,"eps_greedy_SVM","SVM",36,17,2112,2103,9,1800,1401,399,0.927052090874612,0.661616161616162,1.74331550802139,728,345,383,8,1.1,46.01,3.5,0,0,0,0,0,0,0.0311172607662233,34.1525020637861,3.40788418051495
8.7,"eps_greedy_SVM","SVM",36,18,2012,2003,9,1900,1501,399,0.926911320256021,0.651515151515151,1.74491929413733,729,350,379,1,1.1,48.57,3.8,0,0,0,0,0,0,0.0212587694391731,22.0596409331324,2.46731950072585
8.7,"eps_greedy_SVM","SVM",36,19,1912,1903,9,2000,1601,399,0.926661380586287,0.646464646464647,1.74652603381885,734,351,383,5,1.1,51.12,4,0,0,0,0,0,0,0.0180567368481342,17.1236927924649,1.85155092752079
8.7,"eps_greedy_SVM","SVM",36,20,1812,1804,8,2100,1700,400,0.929738224106818,0.646464646464647,1.78127177943185,751,368,383,17,1,53.68,4.2,0,0,0,0,0,0,0.0127219795984697,9.36250651386823,1.60393148774311
8.7,"eps_greedy_SVM","SVM",36,21,1712,1705,7,2200,1799,401,0.929850266027734,0.646464646464647,1.78127177943185,753,369,384,2,1,56.24,4.5,0,0,0,0,0,0,0.00849168792558259,7.27837445248063,1.01034049185595
8.7,"eps_greedy_SVM","SVM",36,22,1612,1605,7,2300,1899,401,0.929831592374249,0.646464646464647,1.77381550309727,755,369,386,2,1,58.79,4.7,0,0,0,0,0,0,0.00790231013909629,6.27299273547638,0.805695854720453
8.7,"eps_greedy_SVM","SVM",36,23,1512,1505,7,2400,1999,401,0.930700635478793,0.641414141414141,1.7689289590116,769,376,393,14,1,61.35,5,0,0,0,0,0,0,0.00534409976625715,3.81162635723139,0.646627067681747
8.7,"eps_greedy_SVM","SVM",36,24,1412,1405,7,2500,2099,401,0.930726491306697,0.641414141414141,1.77218365810822,767,376,391,-2,1,63.91,5.2,0,0,0,0,0,0,0.00462862383772812,3.20744484001632,0.483248586182359
8.7,"eps_greedy_SVM","SVM",36,25,1312,1305,7,2600,2199,401,0.931026706197354,0.641414141414141,1.77055481283422,773,377,396,6,1.1,66.46,5.5,0,0,0,0,0,0,0.00361547355721349,2.32306540545758,0.394058170936138
8.7,"eps_greedy_SVM","SVM",36,26,1212,1206,6,2700,2298,402,0.931818181818182,0.636363636363636,1.77381550309727,777,380,397,4,1,69.02,5.7,0,0,0,0,0,0,0.00383301436231825,2.16695804104035,0.392784364038821
8.7,"eps_greedy_SVM","SVM",36,27,1112,1106,6,2800,2398,402,0.93250479769251,0.631313131313131,1.78127177943185,782,383,399,5,1,71.57,6,0,0,0,0,0,0,0.00277313864620181,1.41854134052984,0.304675640222926
8.7,"eps_greedy_SVM","SVM",36,28,1012,1006,6,2900,2498,402,0.932703025706438,0.631313131313131,1.77636919655268,783,383,400,1,1,74.13,6.2,0,0,0,0,0,0,0.0023373279143083,1.01929781204633,0.24500591361227
8.7,"eps_greedy_SVM","SVM",36,29,912,907,5,3000,2597,403,0.933245998092415,0.626262626262626,1.78291199285674,792,387,405,9,1,76.69,6.4,0,0,0,0,0,0,0.00226463073418189,0.867535515407645,0.246213676148703
8.7,"eps_greedy_SVM","SVM",36,30,812,809,3,3100,2695,405,0.933493064892383,0.626262626262626,1.78127177943185,799,390,409,7,1,79.24,6.7,0,0,0,0,0,0,0.00190473941723105,0.664515319708186,0.213206070254086
8.7,"eps_greedy_SVM","SVM",36,31,712,709,3,3200,2795,405,0.933734385952817,0.626262626262626,1.77636919655268,801,390,411,2,1.1,81.8,6.9,0,0,0,0,0,0,0.00150891039113743,0.483735973907069,0.17472611481255
8.7,"eps_greedy_SVM","SVM",36,32,612,609,3,3300,2895,405,0.933768860390021,0.626262626262626,1.78127177943185,801,390,411,0,1.1,84.36,7.1,0,0,0,0,0,0,0.00106605087567859,0.326783797332336,0.132282121050819
8.7,"eps_greedy_SVM","SVM",36,33,512,510,2,3400,2994,406,0.934150952069041,0.636363636363636,1.78127177943185,805,394,411,4,1,86.91,7.4,0,0,0,0,0,0,0.00082430250924846,0.262184397602149,0.108005239923872
8.7,"eps_greedy_SVM","SVM",36,34,412,411,1,3500,3093,407,0.934584755403868,0.636363636363636,1.77963458110517,809,395,414,4,1,89.47,7.6,0,0,0,0,0,0,0.000621816083645982,0.185914910686483,0.0774528866812765
8.7,"eps_greedy_SVM","SVM",36,35,312,312,0,3600,3192,408,0.934834695073604,0.631313131313131,1.78127177943185,814,400,414,5,1,92.02,7.8,0,0,0,0,0,0,0.000538676943595184,0.134928228440078,0.0639249950546917
8.7,"eps_greedy_SVM","SVM",36,36,212,212,0,3700,3292,408,0.934870605945692,0.636363636363636,1.79200848261622,816,402,414,2,1,94.58,8.1,0,0,0,0,0,0,0.000228256475360271,0.049360675724266,0.0308171587701588
8.7,"eps_greedy_SVM","SVM",36,37,112,112,0,3800,3392,408,0.935098999092174,0.636363636363636,1.78871434937611,819,402,417,3,1,97.14,8.3,0,0,0,0,0,0,0.000120478417964079,0.0182349545107494,0.0169509792570209
8.7,"eps_greedy_SVM","SVM",36,38,12,12,0,3900,3492,408,0.935432251985154,0.636363636363636,1.78543230469836,822,404,418,3,1,99.69,8.6,0,0,0,0,0,0,8.14450582523984e-05,0.00113509651861276,0.00113509651861276
8.7,"eps_greedy_SVM","SVM",36,39,0,0,0,3912,3504,408,0.935380540329347,0.636363636363636,1.79200848261622,822,404,418,0,1,100,8.6,0,0,0,0,0,0,0,0,0
8.7,"eps_greedy_SVM","SVM",37,0,3812,3417,395,100,89,11,0.900808656036458,0.505,1.75769585253456,33,11,22,0,2,2.56,8.1,0,0,0,0,0,0,0.26322907211477,405.478133580062,30.8796965028928
8.7,"eps_greedy_SVM","SVM",37,1,3712,3382,330,200,124,76,0.922423120728938,0.595,1.76508287292818,106,52,54,73,1,5.11,1.6,0,0,0,0,0,0,0.687149140269114,355.233126055567,76.5888581244366
8.7,"eps_greedy_SVM","SVM",37,2,3612,3360,252,300,146,154,0.931668564920277,0.635,1.78473732718894,156,81,75,50,0.9,7.67,0.9,0,0,0,0,0,0,0.622891027789371,268.091668223833,74.2677581152334
8.7,"eps_greedy_SVM","SVM",37,3,3512,3314,198,400,192,208,0.926981776765387,0.67,1.74707182320442,237,122,115,81,0.9,10.22,0.9,0,0,0,0,0,0,0.375498122673617,187.473329838312,52.8060379200382
8.7,"eps_greedy_SVM","SVM",37,4,3412,3259,153,500,247,253,0.917705011389516,0.67,1.69579816513761,336,168,168,99,1,12.78,1,0,0,0,0,0,0,0.265367997487757,212.96308265244,35.047885857783
8.7,"eps_greedy_SVM","SVM",37,5,3312,3187,125,600,319,281,0.897625284738037,0.67,1.62248847926267,416,206,210,80,1,15.34,1.1,0,0,0,0,0,0,0.141814663358156,161.341266805188,21.5422515501161
8.7,"eps_greedy_SVM","SVM",37,6,3212,3114,98,700,392,308,0.902798974943056,0.68,1.63150230414747,477,231,246,61,1.1,17.89,1.3,0,0,0,0,0,0,0.106026264145215,145.199987100816,13.4661423587558
8.7,"eps_greedy_SVM","SVM",37,7,3112,3028,84,800,478,322,0.904031890660589,0.685,1.64952995391705,519,246,273,42,1.1,20.45,1.5,0,0,0,0,0,0,0.0813464956274442,120.129994430157,9.43403020676803
8.7,"eps_greedy_SVM","SVM",37,8,3012,2938,74,900,568,332,0.911916287015953,0.685,1.67348666053358,544,259,285,25,1.1,23.01,1.7,0,0,0,0,0,0,0.0707410814393056,112.923511100822,7.94490512297759
8.7,"eps_greedy_SVM","SVM",37,9,2912,2847,65,1000,659,341,0.931611617312081,0.665,1.73487132352941,576,278,298,32,1.1,25.56,1.9,0,0,0,0,0,0,0.066784356101198,95.3518605061873,7.87335272285161
8.7,"eps_greedy_SVM","SVM",37,10,2812,2759,53,1100,747,353,0.941551822323475,0.665,1.75446182152714,606,293,313,30,1.1,28.12,2.1,0,0,0,0,0,0,0.0758743261517025,96.0307450605762,8.86323007728975
8.7,"eps_greedy_SVM","SVM",37,11,2712,2666,46,1200,840,360,0.94393507972667,0.66,1.76508287292818,631,307,324,25,1.1,30.67,2.3,0,0,0,0,0,0,0.0713858781569479,82.6161430466118,7.98455832021668
8.7,"eps_greedy_SVM","SVM",37,12,2612,2574,38,1300,932,368,0.946321184510262,0.665,1.76670967741935,655,315,340,24,1.1,33.23,2.5,0,0,0,0,0,0,0.0693049180262442,75.7266184670519,7.44842269343763
8.7,"eps_greedy_SVM","SVM",37,13,2512,2476,36,1400,1030,370,0.946756833712996,0.665,1.76345906163753,661,318,343,6,1.1,35.79,2.8,0,0,0,0,0,0,0.0593990658906185,57.9632930261083,6.25052766152289
8.7,"eps_greedy_SVM","SVM",37,14,2412,2378,34,1500,1128,372,0.946728359908894,0.665,1.77082720588235,665,321,344,4,1.1,38.34,3,0,0,0,0,0,0,0.050097822264002,47.3420530521919,5.55835446383022
8.7,"eps_greedy_SVM","SVM",37,15,2312,2289,23,1600,1217,383,0.946193052391811,0.655,1.77572350230415,698,333,365,33,1.1,40.9,3.2,0,0,0,0,0,0,0.0499292546834217,48.397729319879,6.53532194914644
8.7,"eps_greedy_SVM","SVM",37,16,2212,2196,16,1700,1310,390,0.945148063781335,0.65,1.76345906163753,722,341,381,24,1.1,43.46,3.4,0,0,0,0,0,0,0.0427120127888736,47.2602548166983,5.10263132336358
8.7,"eps_greedy_SVM","SVM",37,17,2112,2099,13,1800,1407,393,0.945529612756284,0.66,1.76508287292818,723,344,379,1,1.1,46.01,3.6,0,0,0,0,0,0,0.0379694592775737,39.6855007901716,3.90830024683038
8.7,"eps_greedy_SVM","SVM",37,18,2012,2000,12,1900,1506,394,0.944236902050126,0.645,1.77981617647059,754,363,391,31,1.1,48.57,3.8,0,0,0,0,0,0,0.0248944223462944,18.1437920618202,3.29451350490487
8.7,"eps_greedy_SVM","SVM",37,19,1912,1901,11,2000,1605,395,0.944188496583154,0.645,1.78145354185833,754,363,391,0,1.1,51.12,4.1,0,0,0,0,0,0,0.0181315198515482,15.3012705108489,2.14841596849655
8.7,"eps_greedy_SVM","SVM",37,20,1812,1802,10,2100,1704,396,0.943775626423695,0.645,1.77245630174793,756,364,392,2,1.1,53.68,4.3,0,0,0,0,0,0,0.0148736277962265,13.2472292768146,1.64396338252055
8.7,"eps_greedy_SVM","SVM",37,21,1712,1704,8,2200,1802,398,0.944219817767655,0.645,1.77245630174793,762,369,393,6,1.1,56.24,4.5,0,0,0,0,0,0,0.0134864271274163,11.2486146783373,1.41013037795741
8.7,"eps_greedy_SVM","SVM",37,22,1612,1606,6,2300,1900,400,0.94452733485194,0.65,1.78880514705882,789,378,411,27,1.1,58.79,4.8,0,0,0,0,0,0,0.00967893042974953,7.63024022172306,1.18271539379087
8.7,"eps_greedy_SVM","SVM",37,23,1512,1507,5,2400,1999,401,0.944316628701598,0.645,1.79045078196872,793,381,412,4,1.1,61.35,5,0,0,0,0,0,0,0.0107411609484023,7.65640446201692,1.0992411918451
8.7,"eps_greedy_SVM","SVM",37,24,1412,1407,5,2500,2099,401,0.943906605922558,0.64,1.79045078196872,800,387,413,7,1.1,63.91,5.2,0,0,0,0,0,0,0.00745117829613511,4.92135084366606,0.843130497384933
8.7,"eps_greedy_SVM","SVM",37,25,1312,1307,5,2600,2199,401,0.944006264236908,0.64,1.78880514705882,799,386,413,-1,1.1,66.46,5.5,0,0,0,0,0,0,0.0063498607139002,3.86993526022807,0.660577458985289
8.7,"eps_greedy_SVM","SVM",37,26,1212,1207,5,2700,2299,401,0.944182801822329,0.635,1.78388634280477,799,389,410,0,1.1,69.02,5.7,0,0,0,0,0,0,0.00494490024786371,2.80645099701999,0.533926928350571
8.7,"eps_greedy_SVM","SVM",37,27,1112,1108,4,2800,2398,402,0.944578587699321,0.635,1.78716253443526,800,390,410,1,1.1,71.57,6,0,0,0,0,0,0,0.00446328796183284,2.24337930289634,0.468945505839054
8.7,"eps_greedy_SVM","SVM",37,28,1012,1008,4,2900,2498,402,0.94445615034169,0.635,1.79045078196872,803,392,411,3,1,74.13,6.2,0,0,0,0,0,0,0.00393765747910476,1.80176276367448,0.426411908205372
8.7,"eps_greedy_SVM","SVM",37,29,912,909,3,3000,2597,403,0.944685364464696,0.635,1.78880514705882,809,394,415,6,1.1,76.69,6.4,0,0,0,0,0,0,0.00329495685543563,1.36787311290708,0.359826482304224
8.7,"eps_greedy_SVM","SVM",37,30,812,809,3,3100,2697,403,0.944733769931666,0.635,1.79209944751381,808,394,414,-1,1.1,79.24,6.7,0,0,0,0,0,0,0.00253299230779708,0.955356860420768,0.283781127296128
8.7,"eps_greedy_SVM","SVM",37,31,712,710,2,3200,2796,404,0.94479498861048,0.635,1.79375115207373,814,395,419,6,1.1,81.8,6.9,0,0,0,0,0,0,0.00204169361629027,0.692862325421656,0.228528115451342
8.7,"eps_greedy_SVM","SVM",37,32,612,610,2,3300,2896,404,0.94473804100228,0.64,1.79045078196872,814,395,419,0,1.1,84.36,7.2,0,0,0,0,0,0,0.00155476801983243,0.485574235947048,0.182650649379847
8.7,"eps_greedy_SVM","SVM",37,33,512,510,2,3400,2996,404,0.944730922551254,0.64,1.79209944751381,814,396,418,0,1.1,86.91,7.4,0,0,0,0,0,0,0.000981441358322127,0.288278295886163,0.124742493146897
8.7,"eps_greedy_SVM","SVM",37,34,412,411,1,3500,3095,405,0.94484339407745,0.64,1.79045078196872,816,397,419,2,1.1,89.47,7.6,0,0,0,0,0,0,0.000843594823369194,0.243314361315033,0.10929100536774
8.7,"eps_greedy_SVM","SVM",37,35,312,312,0,3600,3194,406,0.945472665148065,0.635,1.79045078196872,822,402,420,6,1,92.02,7.9,0,0,0,0,0,0,0.000596566279659684,0.145166200728434,0.0741887360314959
8.7,"eps_greedy_SVM","SVM",37,36,212,212,0,3700,3294,406,0.945498291571755,0.635,1.79045078196872,826,402,424,4,1.1,94.58,8.1,0,0,0,0,0,0,0.000226026066245717,0.051607675320245,0.0336324495184842
8.7,"eps_greedy_SVM","SVM",37,37,112,112,0,3800,3394,406,0.945666287015946,0.635,1.80276497695853,829,402,427,3,1.1,97.14,8.4,0,0,0,0,0,0,0.000106115835884754,0.0188720718903835,0.0177209231666599
8.7,"eps_greedy_SVM","SVM",37,38,12,12,0,3900,3494,406,0.945881264236903,0.63,1.79779411764706,833,404,429,4,1.1,99.69,8.6,0,0,0,0,0,0,6.05760693431588e-05,0.000880641453370743,0.000880641453370743
8.7,"eps_greedy_SVM","SVM",37,39,0,0,0,3912,3506,406,0.945802961275627,0.63,1.80110497237569,835,404,431,2,1.1,100,8.6,0,0,0,0,0,0,0,0,0
8.7,"eps_greedy_SVM","SVM",38,0,3812,3418,394,100,91,9,0.90675520360593,0.551724137931034,1.75836189870832,23,9,14,0,1.6,2.56,10.1,0,0,0,0,0,0,0.345760198404571,319.15800283929,38.7181480056156
8.7,"eps_greedy_SVM","SVM",38,1,3712,3391,321,200,118,82,0.919563647399677,0.596059113300493,1.76075126545346,87,46,41,64,0.9,5.11,1.4,0,0,0,0,0,0,0.712664024832911,261.18167834874,80.0343431164944
8.7,"eps_greedy_SVM","SVM",38,2,3612,3352,260,300,157,143,0.916218221261808,0.610837438423645,1.75674278093787,156,79,77,69,1,7.67,1.1,0,0,0,0,0,0,0.437011950701351,144.743213854377,60.4492775478296
8.7,"eps_greedy_SVM","SVM",38,3,3512,3304,208,400,205,195,0.91793659848424,0.620689655172414,1.7761231300084,241,122,119,85,1,10.22,1.1,0,0,0,0,0,0,0.236497578084142,81.9893837321749,37.7168590045958
8.7,"eps_greedy_SVM","SVM",38,4,3412,3251,161,500,258,242,0.881358909006101,0.635467980295567,1.66801839806222,331,165,166,90,1,12.78,1.1,0,0,0,0,0,0,0.1873427273068,98.4823230761542,29.370528922608
8.7,"eps_greedy_SVM","SVM",38,5,3312,3178,134,600,331,269,0.893254069729857,0.650246305418719,1.6560960591133,394,195,199,63,1,15.34,1.2,0,0,0,0,0,0,0.0915231224576772,57.2200552552436,15.1197823558708
8.7,"eps_greedy_SVM","SVM",38,6,3212,3112,100,700,397,303,0.891611565254777,0.665024630541872,1.63989105460412,469,223,246,75,1.1,17.89,1.3,0,0,0,0,0,0,0.0932733288358269,85.4534562878937,13.9621397037193
8.7,"eps_greedy_SVM","SVM",38,7,3112,3030,82,800,479,321,0.896808848448404,0.684729064039409,1.63838380179658,507,244,263,38,1.1,20.45,1.5,0,0,0,0,0,0,0.0635657764944386,76.165905529223,8.01999521807436
8.7,"eps_greedy_SVM","SVM",38,8,3012,2944,68,900,565,335,0.902337723648981,0.689655172413793,1.64572731343891,549,262,287,42,1.1,23.01,1.7,0,0,0,0,0,0,0.0580302056368513,84.2043545730369,6.78347242862023
8.7,"eps_greedy_SVM","SVM",38,9,2912,2858,54,1000,651,349,0.911595603876839,0.689655172413793,1.68576327463735,582,278,304,33,1.1,25.56,1.9,0,0,0,0,0,0,0.0719667177300599,117.013561255706,9.00571153878214
8.7,"eps_greedy_SVM","SVM",38,10,2812,2764,48,1100,745,355,0.923655155553199,0.694581280788177,1.69570105611068,610,297,313,28,1.1,28.12,2.1,0,0,0,0,0,0,0.0659524422572353,88.0438125711999,7.8002872748842
8.7,"eps_greedy_SVM","SVM",38,11,2712,2667,45,1200,842,358,0.931891563793552,0.684729064039409,1.71808895972182,632,304,328,22,1.1,30.67,2.4,0,0,0,0,0,0,0.0547576288937321,66.4751351751102,6.04132939234637
8.7,"eps_greedy_SVM","SVM",38,12,2612,2575,37,1300,934,366,0.937587640048476,0.679802955665025,1.73899790436274,652,312,340,20,1.1,33.23,2.6,0,0,0,0,0,0,0.0606509720591241,69.0832079160015,6.65090087037196
8.7,"eps_greedy_SVM","SVM",38,13,2512,2482,30,1400,1027,373,0.941816843187931,0.689655172413793,1.76724251435836,672,320,352,20,1.1,35.79,2.8,0,0,0,0,0,0,0.0619357227279947,63.0645001243281,6.83196916669305
8.7,"eps_greedy_SVM","SVM",38,14,2412,2385,27,1500,1124,376,0.942246788756255,0.684729064039409,1.76399091819578,670,324,346,-2,1.1,38.34,3,0,0,0,0,0,0,0.0585556310177318,54.3858104218724,6.2166725581649
8.7,"eps_greedy_SVM","SVM",38,15,2312,2291,21,1600,1218,382,0.942457546387785,0.684729064039409,1.76399091819578,692,331,361,22,1.1,40.9,3.2,0,0,0,0,0,0,0.0570950016489223,47.1407372024401,6.49770660988985
8.7,"eps_greedy_SVM","SVM",38,16,2212,2195,17,1700,1314,386,0.942179346314158,0.684729064039409,1.76399091819578,709,334,375,17,1.1,43.46,3.4,0,0,0,0,0,0,0.0434296332145471,47.3999244432808,5.43722441008835
8.7,"eps_greedy_SVM","SVM",38,17,2112,2098,14,1800,1411,389,0.942170916008894,0.684729064039409,1.75752349044805,716,336,380,7,1.1,46.01,3.6,0,0,0,0,0,0,0.033019635493376,34.377032792579,3.47393715992281
8.7,"eps_greedy_SVM","SVM",38,18,2012,1999,13,1900,1510,390,0.942522178728117,0.679802955665025,1.78171947013745,731,351,380,15,1.1,48.57,3.9,0,0,0,0,0,0,0.0253134070609719,20.7323152090519,3.20386450978201
8.7,"eps_greedy_SVM","SVM",38,19,1912,1900,12,2000,1609,391,0.94212735943171,0.67487684729064,1.774487657513,732,352,380,1,1.1,51.12,4.1,0,0,0,0,0,0,0.0171595886489374,15.5048966669518,1.98413436881421
8.7,"eps_greedy_SVM","SVM",38,20,1812,1801,11,2100,1708,392,0.941724109830042,0.67487684729064,1.77285519416662,734,354,380,2,1.1,53.68,4.4,0,0,0,0,0,0,0.0149500207323532,13.7222531589637,1.60715094615581
8.7,"eps_greedy_SVM","SVM",38,21,1712,1702,10,2200,1807,393,0.942151245296621,0.67487684729064,1.78171947013745,745,360,385,11,1.1,56.24,4.6,0,0,0,0,0,0,0.0123554256077356,10.4563332854788,1.27195734699574
8.7,"eps_greedy_SVM","SVM",38,22,1612,1602,10,2300,1907,393,0.941431859247647,0.655172413793103,1.7889379889887,747,363,384,2,1.1,58.79,4.9,0,0,0,0,0,0,0.00928057598910149,7.44938228790116,1.11450395774888
8.7,"eps_greedy_SVM","SVM",38,23,1512,1505,7,2400,2004,396,0.94136301175468,0.660098522167488,1.78565553396303,762,370,392,15,1.1,61.35,5.1,0,0,0,0,0,0,0.0107033271356703,7.48138471941847,1.10298999225451
8.7,"eps_greedy_SVM","SVM",38,24,1412,1405,7,2500,2104,396,0.940813636861812,0.650246305418719,1.79058374610828,773,376,397,11,1.1,63.91,5.3,0,0,0,0,0,0,0.00699569116919392,4.46979185743915,0.833276350704517
8.7,"eps_greedy_SVM","SVM",38,25,1312,1306,6,2600,2203,397,0.941105887444206,0.650246305418719,1.79223253408813,776,377,399,3,1.1,66.46,5.5,0,0,0,0,0,0,0.00666468166401536,4.21217340969512,0.71065141129303
8.7,"eps_greedy_SVM","SVM",38,26,1212,1206,6,2700,2303,397,0.940844547981104,0.650246305418719,1.79388436130848,778,380,398,2,1,69.02,5.8,0,0,0,0,0,0,0.00546263351719051,3.10923543545749,0.571987892645539
8.7,"eps_greedy_SVM","SVM",38,27,1112,1106,6,2800,2403,397,0.940889509609164,0.650246305418719,1.79058374610828,778,380,398,0,1,71.57,6.1,0,0,0,0,0,0,0.00430591036224609,2.11436654645,0.445225154035805
8.7,"eps_greedy_SVM","SVM",38,28,1012,1006,6,2900,2503,397,0.940881079303903,0.650246305418719,1.79058374610828,782,382,400,4,1,74.13,6.3,0,0,0,0,0,0,0.00378195313526456,1.65527894838389,0.404699756167101
8.7,"eps_greedy_SVM","SVM",38,29,912,907,5,3000,2602,398,0.94106233086702,0.650246305418719,1.79223253408813,786,385,401,4,1,76.69,6.5,0,0,0,0,0,0,0.00322839554047131,1.19684294554445,0.339410347336875
8.7,"eps_greedy_SVM","SVM",38,30,812,808,4,3100,2701,399,0.940933066186344,0.650246305418719,1.79223253408813,789,387,402,3,1,79.24,6.8,0,0,0,0,0,0,0.00269185166706098,0.901059419439253,0.298658518653831
8.7,"eps_greedy_SVM","SVM",38,31,712,709,3,3200,2800,400,0.941103077342445,0.640394088669951,1.7889379889887,793,388,405,4,1,81.8,7,0,0,0,0,0,0,0.00224188293121817,0.704618436058165,0.265368818186181
8.7,"eps_greedy_SVM","SVM",38,32,612,609,3,3300,2900,400,0.941239367277502,0.645320197044335,1.79223253408813,794,388,406,1,1,84.36,7.2,0,0,0,0,0,0,0.00149032609810902,0.448409882638114,0.189561636155163
8.7,"eps_greedy_SVM","SVM",38,33,512,509,3,3400,3000,400,0.941502111791479,0.645320197044335,1.79058374610828,795,388,407,1,1,86.91,7.5,0,0,0,0,0,0,0.000847292326088415,0.258288567621873,0.114725876915749
8.7,"eps_greedy_SVM","SVM",38,34,412,412,0,3500,3097,403,0.942380268589531,0.640394088669951,1.7889379889887,806,393,413,11,1.1,89.47,7.7,0,0,0,0,0,0,0.00100695948486124,0.298609928868984,0.125782842695772
8.7,"eps_greedy_SVM","SVM",38,35,312,312,0,3600,3197,403,0.942547469643878,0.640394088669951,1.79388436130848,813,394,419,7,1.1,92.02,7.9,0,0,0,0,0,0,0.000607269804134625,0.149242266577939,0.0745136199781797
8.7,"eps_greedy_SVM","SVM",38,36,212,212,0,3700,3297,403,0.942926833380637,0.640394088669951,1.79223253408813,818,397,421,5,1.1,94.58,8.2,0,0,0,0,0,0,0.000321995348749218,0.0684098343983119,0.0432405308736004
8.7,"eps_greedy_SVM","SVM",38,37,112,112,0,3800,3397,403,0.943221894064781,0.640394088669951,1.79388436130848,817,398,419,-1,1.1,97.14,8.4,0,0,0,0,0,0,0.00012717110065307,0.0205423658924222,0.0191621508644092
8.7,"eps_greedy_SVM","SVM",38,38,12,12,0,3900,3497,403,0.943365209254224,0.640394088669951,1.79388436130848,816,398,418,-1,1.1,99.69,8.7,0,0,0,0,0,0,9.40181217128504e-05,0.00133347262214677,0.00133347262214677
8.7,"eps_greedy_SVM","SVM",38,39,0,0,0,3912,3509,403,0.943396120373515,0.640394088669951,1.79388436130848,816,398,418,0,1.1,100,8.7,0,0,0,0,0,0,0,0,0
8.7,"eps_greedy_SVM","SVM",39,0,3812,3413,399,100,90,10,0.870981146994559,0.49746192893401,1.69295188191537,30,10,20,0,2,2.56,9,0,0,0,0,0,0,0.176498268652868,377.576770250191,19.3456102049907
8.7,"eps_greedy_SVM","SVM",39,1,3712,3366,346,200,137,63,0.903256060925246,0.573604060913706,1.70496846638979,113,55,58,83,1.1,5.11,2.2,0,0,0,0,0,0,0.671963785634744,382.565358655871,73.7402386918189
8.7,"eps_greedy_SVM","SVM",39,2,3612,3338,274,300,165,135,0.90568158534931,0.598984771573604,1.72478724992535,172,89,83,59,0.9,7.67,1.2,0,0,0,0,0,0,0.611984027036067,290.055429236921,70.1818985842437
8.7,"eps_greedy_SVM","SVM",39,3,3512,3312,200,400,191,209,0.91380370134161,0.614213197969543,1.74143838010935,233,117,116,61,1,10.22,0.9,0,0,0,0,0,0,0.481186526306652,215.129190008067,63.8887652457163
8.7,"eps_greedy_SVM","SVM",39,4,3412,3260,152,500,243,257,0.935259708590751,0.624365482233503,1.78702577225881,322,163,159,89,1,12.78,0.9,0,0,0,0,0,0,0.335093769402536,202.955579871746,46.8058766758477
8.7,"eps_greedy_SVM","SVM",39,5,3312,3198,114,600,305,295,0.887900658830722,0.649746192893401,1.65634751690098,411,207,204,89,1,15.34,1,0,0,0,0,0,0,0.176979841159085,151.432384010334,24.8624329034257
8.7,"eps_greedy_SVM","SVM",39,6,3212,3114,98,700,389,311,0.911027550840779,0.65989847715736,1.69295188191537,466,227,239,55,1.1,17.89,1.3,0,0,0,0,0,0,0.0936490614899768,92.7449851385531,11.8418437348179
8.7,"eps_greedy_SVM","SVM",39,7,3112,3024,88,800,479,321,0.910095433780722,0.66497461928934,1.69585098795989,489,237,252,23,1.1,20.45,1.5,0,0,0,0,0,0,0.0621070140495665,77.2144367973452,7.56172471792815
8.7,"eps_greedy_SVM","SVM",39,8,3012,2940,72,900,563,337,0.912505086242469,0.6751269035533,1.69295188191537,529,254,275,40,1.1,23.01,1.7,0,0,0,0,0,0,0.0721689930412547,116.963554772175,9.36500424526696
8.7,"eps_greedy_SVM","SVM",39,9,2912,2852,60,1000,651,349,0.911708602314989,0.67005076142132,1.70053565919735,562,271,291,33,1.1,25.56,1.9,0,0,0,0,0,0,0.0640389181766391,105.516623591136,8.10005328478925
8.7,"eps_greedy_SVM","SVM",39,10,2812,2757,55,1100,746,354,0.923476940924552,0.680203045685279,1.70810548288728,587,285,302,25,1.1,28.12,2.1,0,0,0,0,0,0,0.0477237684099771,68.3855501617469,5.44294449125163
8.7,"eps_greedy_SVM","SVM",39,11,2712,2664,48,1200,839,361,0.930547178686544,0.680203045685279,1.72955624692975,603,293,310,16,1.1,30.67,2.3,0,0,0,0,0,0,0.0515455909035425,74.264020123345,5.61200193071419
8.7,"eps_greedy_SVM","SVM",39,12,2612,2574,38,1300,929,371,0.941058746461271,0.67005076142132,1.76453431303811,635,308,327,32,1.1,33.23,2.5,0,0,0,0,0,0,0.0636758167133869,71.4767106955435,7.55534399519341
8.7,"eps_greedy_SVM","SVM",39,13,2512,2475,37,1400,1028,372,0.943617018206579,0.67005076142132,1.77204526032157,643,311,332,8,1.1,35.79,2.8,0,0,0,0,0,0,0.053647354580213,60.3752876669185,5.87077487902964
8.7,"eps_greedy_SVM","SVM",39,14,2412,2378,34,1500,1125,375,0.945914124026394,0.67005076142132,1.77041654225142,653,317,336,10,1.1,38.34,3,0,0,0,0,0,0,0.0462085034946408,50.3584060647058,4.97581776719826
8.7,"eps_greedy_SVM","SVM",39,15,2312,2281,31,1600,1222,378,0.947149251276244,0.67005076142132,1.78702577225881,662,321,341,9,1.1,40.9,3.2,0,0,0,0,0,0,0.0412564109595251,43.0416116715081,4.5961737526797
8.7,"eps_greedy_SVM","SVM",39,16,2212,2185,27,1700,1318,382,0.948469509960368,0.66497461928934,1.78866825918185,677,326,351,15,1.1,43.46,3.5,0,0,0,0,0,0,0.037561978887386,37.9093281210809,4.49774487844193
8.7,"eps_greedy_SVM","SVM",39,17,2112,2090,22,1800,1413,387,0.950140394721264,0.65989847715736,1.78866825918185,692,330,362,15,1.1,46.01,3.7,0,0,0,0,0,0,0.033783515556505,33.8724010600474,3.96807985064573
8.7,"eps_greedy_SVM","SVM",39,18,2012,1995,17,1900,1508,392,0.95036693091078,0.654822335025381,1.7919623075413,711,338,373,19,1.1,48.57,3.8,0,0,0,0,0,0,0.0301532634370174,29.6235211970705,3.33103200051695
8.7,"eps_greedy_SVM","SVM",39,19,1912,1896,16,2000,1607,393,0.950170695740244,0.654822335025381,1.7919623075413,711,341,370,0,1.1,51.12,4.1,0,0,0,0,0,0,0.0267890517757423,24.7712613054612,2.75028271285038
8.7,"eps_greedy_SVM","SVM",39,20,1812,1796,16,2100,1707,393,0.947498434447344,0.649746192893401,1.79031376815993,722,351,371,11,1.1,53.68,4.3,0,0,0,0,0,0,0.0183719755065252,13.1698928330707,2.27769364152355
8.7,"eps_greedy_SVM","SVM",39,21,1712,1698,14,2200,1805,395,0.947426289164058,0.644670050761421,1.79031376815993,730,355,375,8,1.1,56.24,4.6,0,0,0,0,0,0,0.0127109146541096,10.7772572167734,1.48947173584648
8.7,"eps_greedy_SVM","SVM",39,22,1612,1602,10,2300,1901,399,0.947131936408253,0.649746192893401,1.79361388570493,743,362,381,13,1.1,58.79,4.8,0,0,0,0,0,0,0.0123226219596408,9.81675607846516,1.28831093725867
8.7,"eps_greedy_SVM","SVM",39,23,1512,1502,10,2400,2001,399,0.946651448821575,0.639593908629442,1.7919623075413,760,370,390,17,1.1,61.35,5,0,0,0,0,0,0,0.00949141634542563,6.49519490528582,1.14573010801351
8.7,"eps_greedy_SVM","SVM",39,24,1412,1403,9,2500,2100,400,0.946748123501178,0.644670050761421,1.79031376815993,758,371,387,-2,1,63.91,5.2,0,0,0,0,0,0,0.00787063281824556,5.83358319114883,0.864402687208752
8.7,"eps_greedy_SVM","SVM",39,25,1312,1303,9,2600,2200,400,0.946804396822141,0.644670050761421,1.7919623075413,759,371,388,1,1,66.46,5.5,0,0,0,0,0,0,0.0065912327632186,4.34869894521501,0.669104557230759
8.7,"eps_greedy_SVM","SVM",39,26,1212,1203,9,2700,2300,400,0.946717822482199,0.639593908629442,1.7919623075413,772,376,396,13,1.1,69.02,5.8,0,0,0,0,0,0,0.00535834138286421,3.21381341798078,0.600971223601334
8.7,"eps_greedy_SVM","SVM",39,27,1112,1106,6,2800,2397,403,0.948339648450461,0.644670050761421,1.80110497237569,778,380,398,6,1,71.57,5.9,0,0,0,0,0,0,0.00597380148755812,3.32817112246078,0.643562043634844
8.7,"eps_greedy_SVM","SVM",39,28,1012,1006,6,2900,2497,403,0.948465181243378,0.644670050761421,1.79614325068871,781,380,401,3,1.1,74.13,6.2,0,0,0,0,0,0,0.00455066075795198,2.23476290058082,0.481869212989254
8.7,"eps_greedy_SVM","SVM",39,29,912,908,4,3000,2595,405,0.949013485396349,0.644670050761421,1.79944802207912,792,387,405,11,1,76.69,6.4,0,0,0,0,0,0,0.00421461957312086,1.82783123029674,0.460353763635411
8.7,"eps_greedy_SVM","SVM",39,30,812,809,3,3100,2694,406,0.949104388453289,0.639593908629442,1.79779411764706,797,390,407,5,1,79.24,6.6,0,0,0,0,0,0,0.00365093052330942,1.42093583015601,0.405377825443595
8.7,"eps_greedy_SVM","SVM",39,31,712,709,3,3200,2794,406,0.949088516490967,0.639593908629442,1.79944802207912,797,389,408,0,1,81.8,6.9,0,0,0,0,0,0,0.00268422831621922,0.944747467435046,0.307867091192713
8.7,"eps_greedy_SVM","SVM",39,32,612,609,3,3300,2894,406,0.949170762113912,0.639593908629442,1.79779411764706,799,389,410,2,1.1,84.36,7.1,0,0,0,0,0,0,0.0019536628500047,0.664341280856586,0.236518233763676
8.7,"eps_greedy_SVM","SVM",39,33,512,509,3,3400,2994,406,0.949219820906546,0.639593908629442,1.80110497237569,801,390,411,2,1.1,86.91,7.4,0,0,0,0,0,0,0.00144743130237773,0.474130895582563,0.1774622181371
8.7,"eps_greedy_SVM","SVM",39,34,412,411,1,3500,3092,408,0.950263041702857,0.639593908629442,1.79944802207912,810,395,415,9,1.1,89.47,7.6,0,0,0,0,0,0,0.0014596645220024,0.440466898854939,0.17993336285685
8.7,"eps_greedy_SVM","SVM",39,35,312,312,0,3600,3191,409,0.950459276873395,0.639593908629442,1.80276497695853,820,398,422,10,1.1,92.02,7.8,0,0,0,0,0,0,0.00134946518269187,0.35288490474053,0.166043958338881
8.7,"eps_greedy_SVM","SVM",39,36,212,212,0,3700,3291,409,0.950361159288126,0.639593908629442,1.79944802207912,823,398,425,3,1.1,94.58,8,0,0,0,0,0,0,0.000881360555332685,0.187582456379745,0.112231014105179
8.7,"eps_greedy_SVM","SVM",39,37,112,112,0,3800,3391,409,0.950252941363197,0.639593908629442,1.80110497237569,827,401,426,4,1.1,97.14,8.3,0,0,0,0,0,0,0.000477115301380796,0.07095390106155,0.0657471442853759
8.7,"eps_greedy_SVM","SVM",39,38,12,12,0,3900,3491,409,0.950065363626655,0.639593908629442,1.79779411764706,830,402,428,3,1.1,99.69,8.5,0,0,0,0,0,0,0.000352936811659253,0.00473161967602039,0.00473161967602039
8.7,"eps_greedy_SVM","SVM",39,39,0,0,0,3912,3503,409,0.950032176796343,0.639593908629442,1.80276497695853,829,402,427,-1,1.1,100,8.6,0,0,0,0,0,0,0,0,0
8.7,"eps_greedy_SVM","SVM",40,0,3812,3413,399,100,92,8,0.902326086894346,0.557788944723618,1.72123289257347,20,8,12,0,1.5,2.56,11.5,0,0,0,0,0,0,0.256292674406765,287.34660918553,28.3491076034404
8.7,"eps_greedy_SVM","SVM",40,1,3712,3383,329,200,122,78,0.905437832303222,0.587939698492462,1.75423576021783,90,46,44,70,1,5.11,1.6,0,0,0,0,0,0,0.74303223072316,324.621999820456,82.5645061279351
8.7,"eps_greedy_SVM","SVM",40,2,3612,3356,256,300,149,151,0.904030682724951,0.582914572864322,1.74841025403515,144,73,71,54,1,7.67,1,0,0,0,0,0,0,0.531629618693971,218.23839886524,65.9876332126601
8.7,"eps_greedy_SVM","SVM",40,3,3512,3316,196,400,189,211,0.891054589967477,0.5678391959799,1.71176690049699,220,113,107,76,0.9,10.22,0.9,0,0,0,0,0,0,0.379482454085072,183.075895269298,53.4583642617916
8.7,"eps_greedy_SVM","SVM",40,4,3412,3270,142,500,235,265,0.86886338350832,0.608040201005025,1.62158256721395,314,160,154,94,1,12.78,0.9,0,0,0,0,0,0,0.257542576117903,134.561325789043,37.0358317124119
8.7,"eps_greedy_SVM","SVM",40,5,3312,3196,116,600,309,291,0.85127687383989,0.597989949748744,1.58388628223993,399,200,199,85,1,15.34,1.1,0,0,0,0,0,0,0.149582246184479,113.607996161155,23.1276887834079
8.7,"eps_greedy_SVM","SVM",40,6,3212,3115,97,700,390,310,0.855358179628937,0.623115577889447,1.6066004955909,451,221,230,52,1,17.89,1.3,0,0,0,0,0,0,0.0762963176395977,66.7961551562151,10.7803458246112
8.7,"eps_greedy_SVM","SVM",40,7,3112,3038,74,800,467,333,0.84772753923287,0.638190954773869,1.56434426040044,502,245,257,51,1,20.45,1.4,0,0,0,0,0,0,0.0688669059054724,91.5551736195232,11.0795356842634
8.7,"eps_greedy_SVM","SVM",40,8,3012,2948,64,900,557,343,0.867633557657374,0.64321608040201,1.59293706099559,526,256,270,24,1.1,23.01,1.6,0,0,0,0,0,0,0.0562822025238265,66.9476359180721,6.90180528676188
8.7,"eps_greedy_SVM","SVM",40,9,2912,2858,54,1000,647,353,0.880772673841591,0.64321608040201,1.60955652226172,555,268,287,29,1.1,25.56,1.8,0,0,0,0,0,0,0.0447291923606617,62.1206170177882,5.34394519045528
8.7,"eps_greedy_SVM","SVM",40,10,2812,2767,45,1100,738,362,0.886624356843963,0.64321608040201,1.63064168770118,576,279,297,21,1.1,28.12,2,0,0,0,0,0,0,0.0479969053576119,73.0459875042473,5.57361110615024
8.7,"eps_greedy_SVM","SVM",40,11,2712,2673,39,1200,832,368,0.893239675897983,0.623115577889447,1.65476878412301,597,289,308,21,1.1,30.67,2.3,0,0,0,0,0,0,0.0396272139923534,57.5701679709727,4.72761916856363
8.7,"eps_greedy_SVM","SVM",40,12,2612,2582,30,1300,923,377,0.905831090569527,0.618090452261307,1.6743940697965,634,305,329,37,1.1,33.23,2.4,0,0,0,0,0,0,0.0600034257471839,67.4248914408621,6.82867105293945
8.7,"eps_greedy_SVM","SVM",40,13,2512,2482,30,1400,1023,377,0.911119341728554,0.613065326633166,1.70154640606347,639,308,331,5,1.1,35.79,2.7,0,0,0,0,0,0,0.03624080328771,39.138000322349,4.07813971895741
8.7,"eps_greedy_SVM","SVM",40,14,2412,2383,29,1500,1122,378,0.911476849243361,0.608040201005025,1.69841856340526,640,309,331,1,1.1,38.34,3,0,0,0,0,0,0,0.0314171781204716,34.7252341989888,3.37606557462137
8.7,"eps_greedy_SVM","SVM",40,15,2312,2287,25,1600,1218,382,0.91490177123521,0.608040201005025,1.72552098728939,657,314,343,17,1.1,40.9,3.2,0,0,0,0,0,0,0.030653616675248,31.6529577988859,3.61352925954637
8.7,"eps_greedy_SVM","SVM",40,16,2212,2192,20,1700,1313,387,0.917265610923127,0.613065326633166,1.74680029984175,676,322,354,19,1.1,43.46,3.4,0,0,0,0,0,0,0.0286493710390983,27.4517442818067,3.57422089850429
8.7,"eps_greedy_SVM","SVM",40,17,2112,2097,15,1800,1408,392,0.917661729249541,0.613065326633166,1.74519330784558,692,328,364,16,1.1,46.01,3.6,0,0,0,0,0,0,0.0225088776653667,24.2348828047353,2.80012757976523
8.7,"eps_greedy_SVM","SVM",40,18,2012,2000,12,1900,1505,395,0.91782761273641,0.613065326633166,1.74841025403515,700,334,366,8,1.1,48.57,3.8,0,0,0,0,0,0,0.0208843708172308,23.1487264982437,2.33204623914945
8.7,"eps_greedy_SVM","SVM",40,19,1912,1900,12,2000,1605,395,0.918073577906594,0.613065326633166,1.74519330784558,701,335,366,1,1.1,51.12,4.1,0,0,0,0,0,0,0.0161968910052954,17.13563678635,1.69947069656844
8.7,"eps_greedy_SVM","SVM",40,20,1812,1800,12,2100,1705,395,0.917251310622537,0.608040201005025,1.75585107859741,709,346,363,8,1,53.68,4.3,0,0,0,0,0,0,0.0112756466811105,8.95066591920941,1.40584440500001
8.7,"eps_greedy_SVM","SVM",40,21,1712,1702,10,2200,1803,397,0.917241300412122,0.608040201005025,1.75423576021783,713,349,364,4,1,56.24,4.5,0,0,0,0,0,0,0.00769037918816382,7.30154491143564,0.899068933396062
8.7,"eps_greedy_SVM","SVM",40,22,1612,1605,7,2300,1900,400,0.918087878207191,0.608040201005025,1.75423576021783,718,353,365,5,1,58.79,4.8,0,0,0,0,0,0,0.00826358037807656,7.92466412203757,0.878629621025837
8.7,"eps_greedy_SVM","SVM",40,23,1512,1507,5,2400,1998,402,0.917172658969284,0.597989949748744,1.75423576021783,739,360,379,21,1.1,61.35,5,0,0,0,0,0,0,0.00773797205060316,6.98377065722397,0.881638593079504
8.7,"eps_greedy_SVM","SVM",40,24,1412,1408,4,2500,2097,403,0.917839052976887,0.597989949748744,1.74940758840072,748,364,384,9,1.1,63.91,5.2,0,0,0,0,0,0,0.00616815310811462,5.07791636515786,0.658653455329248
8.7,"eps_greedy_SVM","SVM",40,25,1312,1308,4,2600,2197,403,0.918057847575953,0.592964824120603,1.75262341117351,758,369,389,10,1.1,66.46,5.5,0,0,0,0,0,0,0.0046819386764152,3.67861646943285,0.549259794079257
8.7,"eps_greedy_SVM","SVM",40,26,1212,1210,2,2700,2295,405,0.918499726864255,0.592964824120603,1.75423576021783,763,371,392,5,1.1,69.02,5.7,0,0,0,0,0,0,0.00506879514233959,3.6586142321232,0.520619462909254
8.7,"eps_greedy_SVM","SVM",40,27,1112,1110,2,2800,2395,405,0.919935477043737,0.592964824120603,1.75262341117351,777,381,396,14,1,71.57,5.9,0,0,0,0,0,0,0.00362521168827626,2.4183914635156,0.416815621981766
8.7,"eps_greedy_SVM","SVM",40,28,1012,1011,1,2900,2494,406,0.920947938325667,0.597989949748744,1.75746937452238,778,381,397,1,1,74.13,6.1,0,0,0,0,0,0,0.00404354373274799,2.34083072267823,0.415951743051816
8.7,"eps_greedy_SVM","SVM",40,29,912,911,1,3000,2594,406,0.921015149738452,0.603015075376884,1.75262341117351,778,383,395,0,1,76.69,6.4,0,0,0,0,0,0,0.00326434824998243,1.74283274165623,0.357904637917317
8.7,"eps_greedy_SVM","SVM",40,30,812,812,0,3100,2693,407,0.921542830830308,0.603015075376884,1.75423576021783,783,385,398,5,1,79.24,6.6,0,0,0,0,0,0,0.00321342968653389,1.59285446196822,0.347680499050151
8.7,"eps_greedy_SVM","SVM",40,31,712,712,0,3200,2793,407,0.921551411010662,0.603015075376884,1.75262341117351,785,386,399,2,1,81.8,6.9,0,0,0,0,0,0,0.00279058403143859,1.25383800019947,0.301083713567983
8.7,"eps_greedy_SVM","SVM",40,32,612,612,0,3300,2893,407,0.921790226030554,0.603015075376884,1.74940758840072,784,386,398,-1,1,84.36,7.1,0,0,0,0,0,0,0.00210016728571502,0.828314477339407,0.227340866560618
8.7,"eps_greedy_SVM","SVM",40,33,512,512,0,3400,2993,407,0.921868877683812,0.603015075376884,1.75101402328447,784,386,398,0,1,86.91,7.4,0,0,0,0,0,0,0.00164055467773319,0.570285178211659,0.180120002560813
8.7,"eps_greedy_SVM","SVM",40,34,412,412,0,3500,3093,407,0.922086242252815,0.603015075376884,1.75101402328447,789,387,402,5,1,89.47,7.6,0,0,0,0,0,0,0.00121335226517908,0.359467981091945,0.13772372405502
8.7,"eps_greedy_SVM","SVM",40,35,312,312,0,3600,3193,407,0.922357947964069,0.603015075376884,1.75101402328447,790,389,401,1,1,92.02,7.8,0,0,0,0,0,0,0.000911903789682217,0.22784327672367,0.109800759195417
8.7,"eps_greedy_SVM","SVM",40,36,212,212,0,3700,3293,407,0.922704015238402,0.597989949748744,1.75746937452238,791,390,401,1,1,94.58,8.1,0,0,0,0,0,0,0.000503405783768534,0.103608059293132,0.0638154524597024
8.7,"eps_greedy_SVM","SVM",40,37,112,112,0,3800,3393,407,0.923218826059724,0.597989949748744,1.75423576021783,792,391,401,1,1,97.14,8.3,0,0,0,0,0,0,0.000250655505864511,0.0398576691310821,0.0372697800479061
8.7,"eps_greedy_SVM","SVM",40,38,12,12,0,3900,3493,407,0.923913820668508,0.603015075376884,1.75423576021783,797,391,406,5,1,99.69,8.6,0,0,0,0,0,0,0.000155748438126524,0.00260067435985271,0.00260067435985271
8.7,"eps_greedy_SVM","SVM",40,39,0,0,0,3912,3505,407,0.923968161810759,0.603015075376884,1.75423576021783,797,391,406,0,1,100,8.6,0,0,0,0,0,0,0,0,0
8.7,"eps_greedy_SVM","SVM",41,0,3812,3423,389,100,90,10,0.880097115536009,0.516908212560386,1.69825686235223,28,10,18,0,1.8,2.56,9,0,0,0,0,0,0,0.367270340324376,346.0675698736,43.4052475384897
8.7,"eps_greedy_SVM","SVM",41,1,3712,3376,336,200,137,63,0.913098720317759,0.550724637681159,1.75436913895993,115,57,58,87,1,5.11,2.2,0,0,0,0,0,0,0.597772074696151,294.645806110025,69.0342742608483
8.7,"eps_greedy_SVM","SVM",41,2,3612,3349,263,300,164,136,0.909886394710025,0.565217391304348,1.74729010839566,171,85,86,56,1,7.67,1.2,0,0,0,0,0,0,0.552721065622406,215.387341554684,66.599607422885
8.7,"eps_greedy_SVM","SVM",41,3,3512,3313,199,400,200,200,0.910565872009707,0.570048309178744,1.75598309400957,231,119,112,60,0.9,10.22,1,0,0,0,0,0,0,0.347948918312159,138.291139367771,49.9365920640751
8.7,"eps_greedy_SVM","SVM",41,4,3412,3260,152,500,253,247,0.905417312308214,0.584541062801932,1.74408112748034,324,164,160,93,1,12.78,1,0,0,0,0,0,0,0.166385241207847,72.4210436978114,23.3280858858159
8.7,"eps_greedy_SVM","SVM",41,5,3312,3189,123,600,324,276,0.894750071124164,0.603864734299517,1.70382518032612,395,196,199,71,1,15.34,1.2,0,0,0,0,0,0,0.120450891538479,68.7743128511378,18.6285191214302
8.7,"eps_greedy_SVM","SVM",41,6,3212,3110,102,700,403,297,0.897669613830392,0.618357487922705,1.67059011930499,437,213,224,42,1.1,17.89,1.4,0,0,0,0,0,0,0.0768976371353658,56.9160907751376,10.7227919945943
8.7,"eps_greedy_SVM","SVM",41,7,3112,3026,86,800,487,313,0.896633825263854,0.628019323671498,1.67212983370066,476,230,246,39,1.1,20.45,1.6,0,0,0,0,0,0,0.0615695490745848,60.5762530604307,8.83061568420557
8.7,"eps_greedy_SVM","SVM",41,8,3012,2944,68,900,569,331,0.897832577898211,0.647342995169082,1.6399568810636,515,249,266,39,1.1,23.01,1.7,0,0,0,0,0,0,0.0545846305069676,71.1497897216776,6.80689254337824
8.7,"eps_greedy_SVM","SVM",41,9,2912,2859,53,1000,654,346,0.892286275387174,0.652173913043478,1.63578615848613,559,268,291,44,1.1,25.56,1.9,0,0,0,0,0,0,0.0622686963118853,97.6907189860608,9.01639830598736
8.7,"eps_greedy_SVM","SVM",41,10,2812,2761,51,1100,752,348,0.905414550205377,0.63768115942029,1.66751918158568,578,281,297,19,1.1,28.12,2.2,0,0,0,0,0,0,0.041302185608809,47.5400769925089,5.00096434221298
8.7,"eps_greedy_SVM","SVM",41,11,2712,2667,45,1200,846,354,0.907585563040868,0.623188405797101,1.67774622348439,593,288,305,15,1.1,30.67,2.4,0,0,0,0,0,0,0.0360812546544998,48.3899956769616,4.0261757853621
8.7,"eps_greedy_SVM","SVM",41,12,2612,2570,42,1300,943,357,0.909264921570104,0.623188405797101,1.68799209971442,604,292,312,11,1.1,33.23,2.6,0,0,0,0,0,0,0.028528845120526,42.5780735620001,3.14475129749463
8.7,"eps_greedy_SVM","SVM",41,13,2512,2473,39,1400,1040,360,0.913845869137104,0.623188405797101,1.68488917306053,609,296,313,5,1.1,35.79,2.9,0,0,0,0,0,0,0.0277326814080452,39.4292556519957,3.10822282185743
8.7,"eps_greedy_SVM","SVM",41,14,2412,2375,37,1500,1138,362,0.922536825736171,0.623188405797101,1.72672708641088,622,304,318,13,1,38.34,3.1,0,0,0,0,0,0,0.0276717341946487,33.0927586365521,3.05966209328073
8.7,"eps_greedy_SVM","SVM",41,15,2312,2282,30,1600,1231,369,0.926264283524335,0.628019323671498,1.75115011301689,644,313,331,22,1.1,40.9,3.3,0,0,0,0,0,0,0.0535197623542948,36.753210366729,6.1806411409506
8.7,"eps_greedy_SVM","SVM",41,16,2212,2183,29,1700,1330,370,0.92631538242695,0.628019323671498,1.74954502583722,650,315,335,6,1.1,43.46,3.6,0,0,0,0,0,0,0.0395953741005036,26.2020791960344,4.68656063871752
8.7,"eps_greedy_SVM","SVM",41,17,2112,2092,20,1800,1421,379,0.927000383932295,0.628019323671498,1.74729010839566,677,325,352,27,1.1,46.01,3.7,0,0,0,0,0,0,0.0412243686676707,27.1654688433078,4.99060886000526
8.7,"eps_greedy_SVM","SVM",41,18,2012,2000,12,1900,1513,387,0.926929950309768,0.623188405797101,1.74889903114741,695,333,362,18,1.1,48.57,3.9,0,0,0,0,0,0,0.030037172172108,22.781383438085,3.96943588888335
8.7,"eps_greedy_SVM","SVM",41,19,1912,1901,11,2000,1612,388,0.926561209580074,0.623188405797101,1.75051091965538,697,335,362,2,1.1,51.12,4.2,0,0,0,0,0,0,0.0217819969042428,17.8819934026495,2.49111569200967
8.7,"eps_greedy_SVM","SVM",41,20,1812,1802,10,2100,1711,389,0.927990597801911,0.623188405797101,1.74568414322251,701,338,363,4,1.1,53.68,4.4,0,0,0,0,0,0,0.0157701071045423,14.3293590589996,1.77298767987223
8.7,"eps_greedy_SVM","SVM",41,21,1712,1703,9,2200,1810,390,0.928525064702247,0.623188405797101,1.75051091965538,711,342,369,10,1.1,56.24,4.6,0,0,0,0,0,0,0.0135050509256197,12.1566356347467,1.39730452117032
8.7,"eps_greedy_SVM","SVM",41,22,1612,1603,9,2300,1910,390,0.927340122582121,0.613526570048309,1.76630101155684,728,355,373,17,1.1,58.79,4.9,0,0,0,0,0,0,0.00829307881365023,6.53156256955433,1.13710014607753
8.7,"eps_greedy_SVM","SVM",41,23,1512,1505,7,2400,2008,392,0.927445082490198,0.613526570048309,1.76143516854979,732,355,377,4,1.1,61.35,5.1,0,0,0,0,0,0,0.00792802403783754,6.65256634342846,0.873248080079723
8.7,"eps_greedy_SVM","SVM",41,24,1412,1406,6,2500,2107,393,0.927121916457435,0.608695652173913,1.76143516854979,741,363,378,9,1,63.91,5.4,0,0,0,0,0,0,0.0069390070106279,5.17728509199746,0.713549736074656
8.7,"eps_greedy_SVM","SVM",41,25,1312,1307,5,2600,2206,394,0.927971263082003,0.613526570048309,1.76630101155684,757,369,388,16,1.1,66.46,5.6,0,0,0,0,0,0,0.00531029537401159,3.4213899764827,0.621851103219626
8.7,"eps_greedy_SVM","SVM",41,26,1212,1208,4,2700,2305,395,0.927646715997818,0.613526570048309,1.76630101155684,760,371,389,3,1,69.02,5.8,0,0,0,0,0,0,0.00453813059962997,2.96861655148514,0.486491357936274
8.7,"eps_greedy_SVM","SVM",41,27,1112,1109,3,2800,2404,396,0.928047220910219,0.613526570048309,1.76467607962348,767,373,394,7,1.1,71.57,6.1,0,0,0,0,0,0,0.00435074184336284,2.55085496757673,0.449409147892904
8.7,"eps_greedy_SVM","SVM",41,28,1012,1009,3,2900,2504,396,0.928892424380526,0.613526570048309,1.76467607962348,773,375,398,6,1.1,74.13,6.3,0,0,0,0,0,0,0.00320840995574247,1.66205471325275,0.350475503982441
8.7,"eps_greedy_SVM","SVM",41,29,912,909,3,3000,2604,396,0.928765367649695,0.613526570048309,1.76143516854979,773,375,398,0,1.1,76.69,6.6,0,0,0,0,0,0,0.00317814974245673,1.38151934400597,0.328120302591351
8.7,"eps_greedy_SVM","SVM",41,30,812,809,3,3100,2704,396,0.92921282831045,0.608695652173913,1.76305413469736,779,379,400,6,1.1,79.24,6.8,0,0,0,0,0,0,0.00255180299590226,0.934692476120034,0.277069180215441
8.7,"eps_greedy_SVM","SVM",41,31,712,710,2,3200,2803,397,0.929323312424216,0.599033816425121,1.76467607962348,784,381,403,5,1.1,81.8,7.1,0,0,0,0,0,0,0.00233454517391305,0.747617152864079,0.260158274859766
8.7,"eps_greedy_SVM","SVM",41,32,612,611,1,3300,2902,398,0.929704482616715,0.603864734299517,1.76143516854979,788,384,404,4,1.1,84.36,7.3,0,0,0,0,0,0,0.00172086245761552,0.519747713215685,0.206637248193309
8.7,"eps_greedy_SVM","SVM",41,33,512,511,1,3400,3002,398,0.929935118204204,0.603864734299517,1.76305413469736,789,385,404,1,1,86.91,7.5,0,0,0,0,0,0,0.000992459777574279,0.290910274744429,0.130621271415874
8.7,"eps_greedy_SVM","SVM",41,34,412,411,1,3500,3102,398,0.92991025927861,0.599033816425121,1.76305413469736,793,386,407,4,1.1,89.47,7.8,0,0,0,0,0,0,0.00059212666672484,0.170147760873782,0.0782890344956399
8.7,"eps_greedy_SVM","SVM",41,35,312,312,0,3600,3201,399,0.93006079388362,0.603864734299517,1.76630101155684,794,389,405,1,1,92.02,8,0,0,0,0,0,0,0.000393443156843936,0.0999211377015091,0.051053232330309
8.7,"eps_greedy_SVM","SVM",41,36,212,212,0,3700,3301,399,0.930243092671338,0.599033816425121,1.76467607962348,798,391,407,4,1,94.58,8.3,0,0,0,0,0,0,0.000208537006355239,0.0439565073048095,0.0280672222344686
8.7,"eps_greedy_SVM","SVM",41,37,112,112,0,3800,3401,399,0.930361863093637,0.599033816425121,1.76467607962348,802,393,409,4,1,97.14,8.5,0,0,0,0,0,0,7.13414570448417e-05,0.0131693174821529,0.0124230055737569
8.7,"eps_greedy_SVM","SVM",41,38,12,12,0,3900,3501,399,0.930400532533453,0.594202898550725,1.76630101155684,806,394,412,4,1,99.69,8.8,0,0,0,0,0,0,4.09683075870151e-05,0.000607452891327474,0.000607452891327474
8.7,"eps_greedy_SVM","SVM",41,39,0,0,0,3912,3513,399,0.930392246224921,0.594202898550725,1.76630101155684,807,394,413,1,1,100,8.8,0,0,0,0,0,0,0,0,0
8.7,"eps_greedy_SVM","SVM",42,0,3812,3415,397,100,91,9,0.83546412300684,0.32,1.74868202764977,33,9,24,0,2.7,2.56,10.1,0,0,0,0,0,0,0.160213703157086,336.610007476141,21.571556131723
8.7,"eps_greedy_SVM","SVM",42,1,3712,3347,365,200,159,41,0.913556378132126,0.505,1.76920110192837,94,41,53,61,1.3,5.11,3.9,0,0,0,0,0,0,0.420989311514771,355.537049774873,54.4390092150025
8.7,"eps_greedy_SVM","SVM",42,2,3612,3305,307,300,201,99,0.935945330296133,0.6,1.78716253443526,184,90,94,90,1,7.67,2,0,0,0,0,0,0,0.671757713708331,424.400659157006,72.3691614300636
8.7,"eps_greedy_SVM","SVM",42,3,3512,3270,242,400,236,164,0.93742596810934,0.625,1.79614325068871,244,120,124,60,1,10.22,1.4,0,0,0,0,0,0,0.588512261604121,295.245230047297,69.7266215231005
8.7,"eps_greedy_SVM","SVM",42,4,3412,3237,175,500,269,231,0.93819048974944,0.635,1.7765504587156,306,151,155,62,1,12.78,1.2,0,0,0,0,0,0,0.411312601047862,225.340651615634,58.2050004744793
8.7,"eps_greedy_SVM","SVM",42,5,3312,3191,121,600,315,285,0.932488610478371,0.645,1.76345906163753,402,201,201,96,1,15.34,1.1,0,0,0,0,0,0,0.279730039645325,220.389466508913,39.7765372035035
8.7,"eps_greedy_SVM","SVM",42,6,3212,3118,94,700,388,312,0.904236902050116,0.65,1.64942254812099,472,233,239,70,1,17.89,1.2,0,0,0,0,0,0,0.152599274485404,160.924307281974,20.5968208841858
8.7,"eps_greedy_SVM","SVM",42,7,3112,3036,76,800,470,330,0.906738325740324,0.655,1.65093577981651,528,258,270,56,1,20.45,1.4,0,0,0,0,0,0,0.0961305587233959,112.610058716452,11.8010908459527
8.7,"eps_greedy_SVM","SVM",42,8,3012,2953,59,900,553,347,0.917895785876986,0.66,1.67939393939394,568,274,294,40,1.1,23.01,1.6,0,0,0,0,0,0,0.0756530443080238,109.115735033871,9.02794477052676
8.7,"eps_greedy_SVM","SVM",42,9,2912,2859,53,1000,647,353,0.925441343963542,0.655,1.69735537190083,585,285,300,17,1.1,25.56,1.8,0,0,0,0,0,0,0.0688476222328185,95.4631686546639,7.89028732989472
8.7,"eps_greedy_SVM","SVM",42,10,2812,2765,47,1100,741,359,0.935475512528482,0.65,1.76022038567493,617,298,319,32,1.1,28.12,2.1,0,0,0,0,0,0,0.0627047898649127,69.5045628430094,7.12113517174622
8.7,"eps_greedy_SVM","SVM",42,11,2712,2670,42,1200,836,364,0.938858200455586,0.645,1.77408839779006,631,304,327,14,1.1,30.67,2.3,0,0,0,0,0,0,0.0547854379846626,58.3871122099741,6.09281594478987
8.7,"eps_greedy_SVM","SVM",42,12,2612,2583,29,1300,923,377,0.942807517084293,0.645,1.78716253443526,661,319,342,30,1.1,33.23,2.4,0,0,0,0,0,0,0.0607336380644396,58.1171665010237,6.67750126004059
8.7,"eps_greedy_SVM","SVM",42,13,2512,2488,24,1400,1018,382,0.943302961275641,0.645,1.78880514705882,676,325,351,15,1.1,35.79,2.7,0,0,0,0,0,0,0.0611185742999939,56.0638698795177,6.85764293187991
8.7,"eps_greedy_SVM","SVM",42,14,2412,2388,24,1500,1118,382,0.943163439635549,0.64,1.79045078196872,677,325,352,1,1.1,38.34,2.9,0,0,0,0,0,0,0.0470335541724255,43.3183883102222,5.2254069080657
8.7,"eps_greedy_SVM","SVM",42,15,2312,2291,21,1600,1215,385,0.943470956719832,0.64,1.78880514705882,687,328,359,10,1.1,40.9,3.2,0,0,0,0,0,0,0.0359310165670041,35.9701431721722,4.10273677767957
8.7,"eps_greedy_SVM","SVM",42,16,2212,2195,17,1700,1311,389,0.942471526195916,0.645,1.78473732718894,697,334,363,10,1.1,43.46,3.4,0,0,0,0,0,0,0.0329435580100915,37.7277698288256,3.82329007277985
8.7,"eps_greedy_SVM","SVM",42,17,2112,2098,14,1800,1408,392,0.942512813211863,0.635,1.7765504587156,710,341,369,13,1.1,46.01,3.6,0,0,0,0,0,0,0.0259693647949641,29.6064825025231,2.94606664134518
8.7,"eps_greedy_SVM","SVM",42,18,2012,2000,12,1900,1506,394,0.942283599088856,0.64,1.78145354185833,719,343,376,9,1.1,48.57,3.8,0,0,0,0,0,0,0.0221500362850768,25.360946926097,2.36176597215073
8.7,"eps_greedy_SVM","SVM",42,19,1912,1900,12,2000,1606,394,0.941785307517102,0.635,1.7765504587156,715,344,371,-4,1.1,51.12,4.1,0,0,0,0,0,0,0.0200750723573801,21.6356715052114,2.08596621991234
8.7,"eps_greedy_SVM","SVM",42,20,1812,1800,12,2100,1706,394,0.941605922551266,0.625,1.78880514705882,724,353,371,9,1.1,53.68,4.3,0,0,0,0,0,0,0.0130881119288456,11.0062623518187,1.67590159667694
8.7,"eps_greedy_SVM","SVM",42,21,1712,1702,10,2200,1804,396,0.942013097949901,0.63,1.78716253443526,729,355,374,5,1.1,56.24,4.6,0,0,0,0,0,0,0.0102949633985474,9.77940543403284,1.14950539904765
8.7,"eps_greedy_SVM","SVM",42,22,1612,1603,9,2300,1903,397,0.941997437357644,0.63,1.77981617647059,731,356,375,2,1.1,58.79,4.8,0,0,0,0,0,0,0.010575211374224,9.40579866901519,1.07032032785084
8.7,"eps_greedy_SVM","SVM",42,23,1512,1503,9,2400,2003,397,0.942033029612764,0.625,1.78145354185833,750,366,384,19,1,61.35,5,0,0,0,0,0,0,0.0065055444421283,4.82890952779221,0.80775882201841
8.7,"eps_greedy_SVM","SVM",42,24,1412,1406,6,2500,2100,400,0.942114179954449,0.625,1.79209944751381,761,372,389,11,1,63.91,5.2,0,0,0,0,0,0,0.00661159389948713,5.43110271674192,0.711577172574114
8.7,"eps_greedy_SVM","SVM",42,25,1312,1306,6,2600,2200,400,0.942075740318914,0.625,1.79375115207373,763,376,387,2,1,66.46,5.5,0,0,0,0,0,0,0.00544349725642734,4.06116557587544,0.570956363524705
8.7,"eps_greedy_SVM","SVM",42,26,1212,1206,6,2700,2300,400,0.941776765375861,0.625,1.79045078196872,765,377,388,2,1,69.02,5.8,0,0,0,0,0,0,0.0047317026783708,3.25711400053122,0.511124052860245
8.7,"eps_greedy_SVM","SVM",42,27,1112,1107,5,2800,2399,401,0.941931947608208,0.625,1.79779411764706,769,378,391,4,1,71.57,6,0,0,0,0,0,0,0.00404401080493024,2.46143633343008,0.41950062489735
8.7,"eps_greedy_SVM","SVM",42,28,1012,1008,4,2900,2498,402,0.941859339407753,0.63,1.79614325068871,779,382,397,10,1,74.13,6.2,0,0,0,0,0,0,0.0034139455848808,1.8389796419282,0.358381539332813
8.7,"eps_greedy_SVM","SVM",42,29,912,908,4,3000,2598,402,0.941884965831443,0.63,1.79285059578368,780,383,397,1,1,76.69,6.5,0,0,0,0,0,0,0.00308187923142381,1.46358792455082,0.323197421397179
8.7,"eps_greedy_SVM","SVM",42,30,812,809,3,3100,2697,403,0.942010250569483,0.63,1.79779411764706,785,385,400,5,1,79.24,6.7,0,0,0,0,0,0,0.00264806835110442,1.14640115912839,0.285264131272489
8.7,"eps_greedy_SVM","SVM",42,31,712,709,3,3200,2797,403,0.941983200455588,0.63,1.79779411764706,787,385,402,2,1,81.8,6.9,0,0,0,0,0,0,0.00237345170909744,0.911113643182386,0.257331182854086
8.7,"eps_greedy_SVM","SVM",42,32,612,609,3,3300,2897,403,0.942088553530758,0.63,1.79779411764706,786,385,401,-1,1,84.36,7.2,0,0,0,0,0,0,0.00166658134326254,0.583413577670367,0.187598408264995
8.7,"eps_greedy_SVM","SVM",42,33,512,511,1,3400,2995,405,0.942297835990894,0.625,1.79779411764706,795,388,407,9,1,86.91,7.4,0,0,0,0,0,0,0.0019433377000231,0.729253318114835,0.241102911442101
8.7,"eps_greedy_SVM","SVM",42,34,412,412,0,3500,3094,406,0.942468678815494,0.63,1.80110497237569,802,392,410,7,1,89.47,7.6,0,0,0,0,0,0,0.00177535136029088,0.559212062505315,0.200043383553489
8.7,"eps_greedy_SVM","SVM",42,35,312,312,0,3600,3194,406,0.942359054669708,0.63,1.79779411764706,803,392,411,1,1,92.02,7.9,0,0,0,0,0,0,0.00122711968457255,0.308520428973589,0.140009627949826
8.7,"eps_greedy_SVM","SVM",42,36,212,212,0,3700,3294,406,0.942257972665152,0.63,1.80276497695853,807,394,413,4,1,94.58,8.1,0,0,0,0,0,0,0.000780284193722239,0.163254969416267,0.0997037625295332
8.7,"eps_greedy_SVM","SVM",42,37,112,112,0,3800,3394,406,0.942400341685654,0.63,1.79779411764706,813,395,418,6,1.1,97.14,8.4,0,0,0,0,0,0,0.000336440782927371,0.0535185888552367,0.0497700584602193
8.7,"eps_greedy_SVM","SVM",42,38,12,12,0,3900,3494,406,0.942421697038729,0.63,1.79449541284404,814,396,418,1,1.1,99.69,8.6,0,0,0,0,0,0,0.000341377603324191,0.00465282229370645,0.00465282229370645
8.7,"eps_greedy_SVM","SVM",42,39,0,0,0,3912,3506,406,0.942290717539868,0.63,1.79449541284404,814,396,418,0,1.1,100,8.6,0,0,0,0,0,0,0,0,0
8.7,"eps_greedy_SVM","SVM",43,0,3812,3422,390,100,93,7,0.917403176463824,0.583732057416268,1.7789552769979,19,7,12,0,1.7,2.56,13.3,0,0,0,0,0,0,0.820616908890698,611.355629772365,85.1710831185143
8.7,"eps_greedy_SVM","SVM",43,1,3712,3398,314,200,117,83,0.918554843162442,0.593301435406699,1.78386951809458,76,39,37,57,0.9,5.11,1.4,0,0,0,0,0,0,0.694990892835559,382.394086390834,75.3451060849863
8.7,"eps_greedy_SVM","SVM",43,2,3612,3358,254,300,157,143,0.893727593167215,0.598086124401914,1.68045679240794,144,75,69,68,0.9,7.67,1.1,0,0,0,0,0,0,0.540831282341005,204.060417677899,65.0636903231334
8.7,"eps_greedy_SVM","SVM",43,3,3512,3309,203,400,206,194,0.861834231204278,0.593301435406699,1.62013270242407,228,116,112,84,1,10.22,1.1,0,0,0,0,0,0,0.341775361770968,186.005735215362,48.7795951372147
8.7,"eps_greedy_SVM","SVM",43,4,3412,3254,158,500,261,239,0.857083777247682,0.593301435406699,1.64750292152669,323,159,164,95,1,12.78,1.1,0,0,0,0,0,0,0.282983660953849,186.921601608036,38.866329474093
8.7,"eps_greedy_SVM","SVM",43,5,3312,3184,128,600,331,269,0.867981474735909,0.61244019138756,1.63736815670517,381,190,191,58,1,15.34,1.2,0,0,0,0,0,0,0.198868898171344,143.982834846216,27.5606758559036
8.7,"eps_greedy_SVM","SVM",43,6,3212,3106,106,700,409,291,0.876233488440884,0.645933014354067,1.62162591228805,435,213,222,54,1,17.89,1.4,0,0,0,0,0,0,0.101414391226969,84.9312763356285,14.5913225524341
8.7,"eps_greedy_SVM","SVM",43,7,3112,3022,90,800,493,307,0.87866554558327,0.645933014354067,1.62725203910504,477,229,248,42,1.1,20.45,1.6,0,0,0,0,0,0,0.0596169048679216,58.4912121800531,7.4409846353715
8.7,"eps_greedy_SVM","SVM",43,8,3012,2943,69,900,572,328,0.881754915466846,0.674641148325359,1.60707554008989,528,251,277,51,1.1,23.01,1.7,0,0,0,0,0,0,0.07341161096993,121.628450042562,11.5787019716483
8.7,"eps_greedy_SVM","SVM",43,9,2912,2859,53,1000,656,344,0.889446843940264,0.650717703349282,1.62875042956462,572,273,299,44,1.1,25.56,1.9,0,0,0,0,0,0,0.066787715650635,107.801028165836,7.36405976479335
8.7,"eps_greedy_SVM","SVM",43,10,2812,2761,51,1100,754,346,0.903339422605527,0.650717703349282,1.66169123569985,588,284,304,16,1.1,28.12,2.2,0,0,0,0,0,0,0.0543908613070802,66.7817589170579,6.5112799721045
8.7,"eps_greedy_SVM","SVM",43,11,2712,2666,46,1200,849,351,0.906823180133824,0.655502392344498,1.67030103484856,600,290,310,12,1.1,30.67,2.4,0,0,0,0,0,0,0.040906391671492,56.8127588345009,4.56767315825891
8.7,"eps_greedy_SVM","SVM",43,12,2612,2575,37,1300,940,360,0.920933493644607,0.650717703349282,1.72195982974078,628,301,327,28,1.1,33.23,2.6,0,0,0,0,0,0,0.0549536599029139,69.7829570310733,6.71032758396048
8.7,"eps_greedy_SVM","SVM",43,13,2512,2480,32,1400,1035,365,0.930648028198721,0.645933014354067,1.74778922718689,656,315,341,28,1.1,35.79,2.8,0,0,0,0,0,0,0.058072448316108,58.0043486068707,6.45162748721302
8.7,"eps_greedy_SVM","SVM",43,14,2412,2384,28,1500,1131,369,0.932535063526536,0.641148325358852,1.7563990263356,665,320,345,9,1.1,38.34,3.1,0,0,0,0,0,0,0.052620013576559,50.0106581936912,5.69743729354198
8.7,"eps_greedy_SVM","SVM",43,15,2312,2286,26,1600,1229,371,0.933886662850595,0.631578947368421,1.76338657472558,670,324,346,5,1.1,40.9,3.3,0,0,0,0,0,0,0.0455147674873194,41.0004646521384,4.96966298280428
8.7,"eps_greedy_SVM","SVM",43,16,2212,2190,22,1700,1325,375,0.93553679171127,0.626794258373206,1.77361862463301,681,327,354,11,1.1,43.46,3.5,0,0,0,0,0,0,0.0414562251678847,33.7605817354533,4.85036472375929
8.7,"eps_greedy_SVM","SVM",43,17,2112,2097,15,1800,1418,382,0.937223894413654,0.636363636363636,1.76663406381348,705,338,367,24,1.1,46.01,3.7,0,0,0,0,0,0,0.0455496050549325,34.3906488375393,5.79792871689182
8.7,"eps_greedy_SVM","SVM",43,18,2012,2003,9,1900,1512,388,0.93826737839029,0.636363636363636,1.76338657472558,724,346,378,19,1.1,48.57,3.9,0,0,0,0,0,0,0.0329350505738557,33.3829967057825,4.44249737809807
8.7,"eps_greedy_SVM","SVM",43,19,1912,1904,8,2000,1611,389,0.938628900397942,0.636363636363636,1.7617673033071,727,347,380,3,1.1,51.12,4.1,0,0,0,0,0,0,0.0235344838758732,23.7994275810076,2.57595111936875
8.7,"eps_greedy_SVM","SVM",43,20,1812,1804,8,2100,1711,389,0.93843992298485,0.636363636363636,1.7617673033071,724,348,376,-3,1.1,53.68,4.4,0,0,0,0,0,0,0.0225506853389852,21.4887459884783,2.28307185515608
8.7,"eps_greedy_SVM","SVM",43,21,1712,1704,8,2200,1811,389,0.93586955628649,0.62200956937799,1.77198846045595,741,358,383,17,1.1,56.24,4.7,0,0,0,0,0,0,0.0147323142133714,11.1488493166517,1.90199346790298
8.7,"eps_greedy_SVM","SVM",43,22,1612,1606,6,2300,1909,391,0.936268052135836,0.62200956937799,1.77361862463301,740,358,382,-1,1.1,58.79,4.9,0,0,0,0,0,0,0.0136383530032037,11.0842617809619,1.48826363571027
8.7,"eps_greedy_SVM","SVM",43,23,1512,1507,5,2400,2008,392,0.936465245958193,0.62200956937799,1.7703612901525,745,359,386,5,1.1,61.35,5.1,0,0,0,0,0,0,0.0109082193349488,8.66376919321104,1.1697237240794
8.7,"eps_greedy_SVM","SVM",43,24,1412,1407,5,2500,2108,392,0.936589861498712,0.62200956937799,1.76873710548264,748,360,388,3,1.1,63.91,5.4,0,0,0,0,0,0,0.0101522972319205,7.17174532852732,1.02843915828615
8.7,"eps_greedy_SVM","SVM",43,25,1312,1307,5,2600,2208,392,0.9358818809004,0.62200956937799,1.7703612901525,756,370,386,8,1,66.46,5.6,0,0,0,0,0,0,0.00638032611524519,3.88609972367661,0.763197129923968
8.7,"eps_greedy_SVM","SVM",43,26,1212,1207,5,2700,2308,392,0.935918854742091,0.62200956937799,1.77198846045595,756,370,386,0,1,69.02,5.9,0,0,0,0,0,0,0.00556097700528241,3.31054313762635,0.602555401620979
8.7,"eps_greedy_SVM","SVM",43,27,1112,1107,5,2800,2408,392,0.93584216825562,0.617224880382775,1.76873710548264,755,370,385,-1,1,71.57,6.1,0,0,0,0,0,0,0.0052353364386905,2.67421198346736,0.535717497098615
8.7,"eps_greedy_SVM","SVM",43,28,1012,1007,5,2900,2508,392,0.935947612174509,0.61244019138756,1.76873710548264,759,370,389,4,1.1,74.13,6.4,0,0,0,0,0,0,0.00347487703656275,1.54550380659495,0.38500517008718
8.7,"eps_greedy_SVM","SVM",43,29,912,908,4,3000,2607,393,0.935794239201563,0.61244019138756,1.77198846045595,761,372,389,2,1,76.69,6.6,0,0,0,0,0,0,0.00356149006123162,1.31221296388546,0.371788957398098
8.7,"eps_greedy_SVM","SVM",43,30,812,808,4,3100,2707,393,0.935575134954501,0.617224880382775,1.7703612901525,764,373,391,3,1,79.24,6.9,0,0,0,0,0,0,0.00274874753791848,0.867508655971858,0.30868628924853
8.7,"eps_greedy_SVM","SVM",43,31,712,709,3,3200,2806,394,0.935829843641711,0.617224880382775,1.7789552769979,768,376,392,4,1,81.8,7.1,0,0,0,0,0,0,0.00216892441124481,0.660213146118785,0.268474006995588
8.7,"eps_greedy_SVM","SVM",43,32,612,610,2,3300,2905,395,0.935616217000824,0.61244019138756,1.7789552769979,773,380,393,5,1,84.36,7.4,0,0,0,0,0,0,0.00130279635322341,0.407386680012356,0.175640625845644
8.7,"eps_greedy_SVM","SVM",43,33,512,511,1,3400,3004,396,0.935609369993102,0.61244019138756,1.77732320793644,777,382,395,4,1,86.91,7.6,0,0,0,0,0,0,0.00112809264253394,0.353410201512389,0.142632297839118
8.7,"eps_greedy_SVM","SVM",43,34,412,412,0,3500,3103,397,0.93587366449112,0.617224880382775,1.7789552769979,784,384,400,7,1,89.47,7.8,0,0,0,0,0,0,0.000706561308159796,0.212431110498644,0.0905570041688343
8.7,"eps_greedy_SVM","SVM",43,35,312,312,0,3600,3203,397,0.93564908263788,0.617224880382775,1.78222842378171,790,384,406,6,1.1,92.02,8.1,0,0,0,0,0,0,0.000463861358313403,0.121387697772785,0.059665183790824
8.7,"eps_greedy_SVM","SVM",43,36,212,212,0,3700,3303,397,0.935801086209279,0.61244019138756,1.78059034618632,796,388,408,6,1.1,94.58,8.3,0,0,0,0,0,0,0.000256354062718325,0.0541782884472325,0.0333032243939632
8.7,"eps_greedy_SVM","SVM",43,37,112,112,0,3800,3403,397,0.935773698178397,0.61244019138756,1.78059034618632,797,388,409,1,1.1,97.14,8.6,0,0,0,0,0,0,0.000120943415438771,0.0182589170695633,0.0170632998315237
8.7,"eps_greedy_SVM","SVM",43,38,12,12,0,3900,3503,397,0.935892836112736,0.61244019138756,1.7855136374661,799,389,410,2,1.1,99.69,8.8,0,0,0,0,0,0,6.35222381240246e-05,0.000969587829368209,0.000969587829368209
8.7,"eps_greedy_SVM","SVM",43,39,0,0,0,3912,3515,397,0.935805194413912,0.61244019138756,1.78059034618632,799,389,410,0,1.1,100,8.9,0,0,0,0,0,0,0,0,0
8.7,"eps_greedy_SVM","SVM",44,0,3812,3403,409,100,85,15,0.910045281663098,0.5,1.7748656453036,37,15,22,0,1.5,2.56,5.7,0,0,0,0,0,0,0.714286760749304,670.433591407082,74.8602076343814
8.7,"eps_greedy_SVM","SVM",44,1,3712,3364,348,200,124,76,0.923741281266653,0.532967032967033,1.77803813833226,106,53,53,69,1,5.11,1.6,0,0,0,0,0,0,0.739149219207315,521.408752446813,79.2595945171473
8.7,"eps_greedy_SVM","SVM",44,2,3612,3336,276,300,152,148,0.884014519865693,0.549450549450549,1.65114186641326,155,79,76,49,1,7.67,1,0,0,0,0,0,0,0.646162319773336,427.951436734328,73.4269431557644
8.7,"eps_greedy_SVM","SVM",44,3,3512,3299,213,400,189,211,0.900671481843978,0.576923076923077,1.69745406109042,223,113,110,68,1,10.22,0.9,0,0,0,0,0,0,0.481328906994284,330.717241923949,62.7461629311772
8.7,"eps_greedy_SVM","SVM",44,4,3412,3253,159,500,235,265,0.89375843998167,0.60989010989011,1.64508818404327,314,161,153,91,1,12.78,0.9,0,0,0,0,0,0,0.338564128909252,245.251890898284,47.516622371512
8.7,"eps_greedy_SVM","SVM",44,5,3312,3195,117,600,293,307,0.852749420815933,0.593406593406593,1.57757838491783,404,204,200,90,1,15.34,1,0,0,0,0,0,0,0.210141360587995,211.679293099351,28.0912199999281
8.7,"eps_greedy_SVM","SVM",44,6,3212,3119,93,700,369,331,0.853042110088329,0.60989010989011,1.5833889867039,478,229,249,74,1.1,17.89,1.1,0,0,0,0,0,0,0.115679877871084,140.952736145744,17.6077558894869
8.7,"eps_greedy_SVM","SVM",44,7,3112,3032,80,800,456,344,0.865090377491736,0.60989010989011,1.60465893553451,512,246,266,34,1.1,20.45,1.3,0,0,0,0,0,0,0.0770723430390222,102.700082594522,9.19545637371114
8.7,"eps_greedy_SVM","SVM",44,8,3012,2942,70,900,546,354,0.868438494988659,0.615384615384615,1.58484833139211,543,261,282,31,1.1,23.01,1.5,0,0,0,0,0,0,0.0633856715746542,92.8579983666478,7.86652413009311
8.7,"eps_greedy_SVM","SVM",44,9,2912,2847,65,1000,641,359,0.896087565196917,0.604395604395604,1.66409074796172,583,286,297,40,1,25.56,1.8,0,0,0,0,0,0,0.0624202693368772,56.410695213098,7.96211508216701
8.7,"eps_greedy_SVM","SVM",44,10,2812,2756,56,1100,732,368,0.8989153462096,0.60989010989011,1.66409074796172,606,295,311,23,1.1,28.12,2,0,0,0,0,0,0,0.0509671285477596,50.046652286129,5.75683892526395
8.7,"eps_greedy_SVM","SVM",44,11,2712,2662,50,1200,826,374,0.9005429463434,0.60989010989011,1.65950226244344,618,299,319,12,1.1,30.67,2.2,0,0,0,0,0,0,0.0483246767367923,50.6839769817417,5.30087464337731
8.7,"eps_greedy_SVM","SVM",44,12,2612,2567,45,1300,921,379,0.905419552262846,0.604395604395604,1.6922469795398,636,310,326,18,1.1,33.23,2.4,0,0,0,0,0,0,0.0400992180152231,42.8146908467355,4.43281712643757
8.7,"eps_greedy_SVM","SVM",44,13,2512,2471,41,1400,1017,383,0.910774681913356,0.615384615384615,1.69069017459082,646,314,332,10,1.1,35.79,2.7,0,0,0,0,0,0,0.0366532504082158,42.2273962562959,4.06345710738406
8.7,"eps_greedy_SVM","SVM",44,14,2412,2375,37,1500,1113,387,0.915640447489373,0.60989010989011,1.7021431607067,660,319,341,14,1.1,38.34,2.9,0,0,0,0,0,0,0.0358590237397204,40.628967296299,4.37206286612071
8.7,"eps_greedy_SVM","SVM",44,15,2312,2283,29,1600,1205,395,0.922929804130485,0.60989010989011,1.72864819004525,694,333,361,34,1.1,40.9,3.1,0,0,0,0,0,0,0.0459125532462479,40.5459320319651,5.4649076370317
8.7,"eps_greedy_SVM","SVM",44,16,2212,2185,27,1700,1303,397,0.927382088035978,0.604395604395604,1.75001263685716,700,340,360,6,1.1,43.46,3.3,0,0,0,0,0,0,0.0359048971090613,31.5091332437293,3.97994530009791
8.7,"eps_greedy_SVM","SVM",44,17,2112,2086,26,1800,1402,398,0.928698415451516,0.604395604395604,1.74679865588956,704,342,362,4,1.1,46.01,3.5,0,0,0,0,0,0,0.0331406205581228,30.5109909255006,3.6574158093274
8.7,"eps_greedy_SVM","SVM",44,18,2012,1991,21,1900,1497,403,0.928240023786808,0.615384615384615,1.73692973692974,722,348,374,18,1.1,48.57,3.7,0,0,0,0,0,0,0.0312061027195847,27.4578971908906,3.59845383802313
8.7,"eps_greedy_SVM","SVM",44,19,1912,1896,16,2000,1592,408,0.928687575108093,0.615384615384615,1.73852617970265,734,358,376,12,1.1,51.12,3.9,0,0,0,0,0,0,0.0296996401139441,25.136593559276,3.747882082275
8.7,"eps_greedy_SVM","SVM",44,20,1812,1801,11,2100,1687,413,0.929316315026575,0.620879120879121,1.74172788537429,748,363,385,14,1.1,53.68,4.1,0,0,0,0,0,0,0.0247559736438865,21.9511277768924,3.25703532042361
8.7,"eps_greedy_SVM","SVM",44,21,1712,1704,8,2200,1784,416,0.929392197430528,0.626373626373626,1.74172788537429,763,366,397,15,1.1,56.24,4.3,0,0,0,0,0,0,0.0230683927501745,19.2149600499436,2.43808785167702
8.7,"eps_greedy_SVM","SVM",44,22,1612,1605,7,2300,1883,417,0.932353159805246,0.615384615384615,1.77141642887499,769,374,395,6,1.1,58.79,4.5,0,0,0,0,0,0,0.0150705981268023,11.7804835519386,1.95955951496066
8.7,"eps_greedy_SVM","SVM",44,23,1512,1506,6,2400,1982,418,0.932201394997335,0.615384615384615,1.76978679094594,768,374,394,-1,1.1,61.35,4.7,0,0,0,0,0,0,0.0137682572273454,10.3635563348036,1.4175873794845
8.7,"eps_greedy_SVM","SVM",44,24,1412,1407,5,2500,2081,419,0.93274650940942,0.615384615384615,1.77803813833226,782,385,397,14,1,63.91,5,0,0,0,0,0,0,0.00973130078413003,6.59218338936827,1.20049997752148
8.7,"eps_greedy_SVM","SVM",44,25,1312,1307,5,2600,2181,419,0.932864204566575,0.615384615384615,1.77640541276905,780,383,397,-2,1,66.46,5.2,0,0,0,0,0,0,0.00900251986389022,6.13994183139091,0.967166738650524
8.7,"eps_greedy_SVM","SVM",44,26,1212,1207,5,2700,2281,419,0.932805356987997,0.615384615384615,1.77967386799034,781,385,396,1,1,69.02,5.4,0,0,0,0,0,0,0.00745723550981431,4.50213884085801,0.767054009383449
8.7,"eps_greedy_SVM","SVM",44,27,1112,1107,5,2800,2381,419,0.932635008734223,0.615384615384615,1.77967386799034,786,385,401,5,1,71.57,5.7,0,0,0,0,0,0,0.00571799139730783,3.21737481061014,0.621059576173895
8.7,"eps_greedy_SVM","SVM",44,28,1012,1007,5,2900,2481,419,0.932619522529334,0.615384615384615,1.77967386799034,786,385,401,0,1,74.13,5.9,0,0,0,0,0,0,0.00550826893639223,2.69323861184646,0.572432359767429
8.7,"eps_greedy_SVM","SVM",44,29,912,907,5,3000,2581,419,0.932512667715602,0.615384615384615,1.78131261004189,792,389,403,6,1,76.69,6.2,0,0,0,0,0,0,0.00463843907866749,1.99133859137999,0.492844081584456
8.7,"eps_greedy_SVM","SVM",44,30,812,809,3,3100,2679,421,0.932715536999645,0.615384615384615,1.77803813833226,800,393,407,8,1,79.24,6.4,0,0,0,0,0,0,0.00420281142373599,1.66607481302171,0.463916122382363
8.7,"eps_greedy_SVM","SVM",44,31,712,709,3,3200,2779,421,0.932780579060179,0.60989010989011,1.77967386799034,800,394,406,0,1,81.8,6.6,0,0,0,0,0,0,0.00332015174005771,1.13008137455355,0.365065505984087
8.7,"eps_greedy_SVM","SVM",44,32,612,609,3,3300,2879,421,0.932789870783113,0.604395604395604,1.77640541276905,801,394,407,1,1,84.36,6.8,0,0,0,0,0,0,0.00253585150437586,0.781181454595256,0.295844909115675
8.7,"eps_greedy_SVM","SVM",44,33,512,510,2,3400,2978,422,0.933254456929778,0.604395604395604,1.77967386799034,804,395,409,3,1,86.91,7.1,0,0,0,0,0,0,0.00157783073109482,0.49752384656105,0.202521445106083
8.7,"eps_greedy_SVM","SVM",44,34,412,411,1,3500,3077,423,0.933375249327913,0.598901098901099,1.77803813833226,810,397,413,6,1,89.47,7.3,0,0,0,0,0,0,0.00135225675779032,0.38880509947763,0.165054513564784
8.7,"eps_greedy_SVM","SVM",44,35,312,312,0,3600,3176,424,0.93377169617307,0.598901098901099,1.77967386799034,815,400,415,5,1,92.02,7.5,0,0,0,0,0,0,0.00106372440180319,0.265271413872188,0.134676774010425
8.7,"eps_greedy_SVM","SVM",44,36,212,212,0,3700,3276,424,0.934313713344174,0.598901098901099,1.77640541276905,816,401,415,1,1,94.58,7.7,0,0,0,0,0,0,0.000466871185066903,0.103782704114477,0.066743206739365
8.7,"eps_greedy_SVM","SVM",44,37,112,112,0,3800,3376,424,0.934741132599102,0.598901098901099,1.77967386799034,822,403,419,6,1,97.14,8,0,0,0,0,0,0,0.000307926308065838,0.0483388716488654,0.0449601388306986
8.7,"eps_greedy_SVM","SVM",44,38,12,12,0,3900,3476,424,0.935075634624696,0.598901098901099,1.77803813833226,826,404,422,4,1,99.69,8.2,0,0,0,0,0,0,0.000217781364876666,0.00310725521339324,0.00310725521339324
8.7,"eps_greedy_SVM","SVM",44,39,0,0,0,3912,3488,424,0.935106607034474,0.598901098901099,1.77314894088496,826,404,422,0,1,100,8.2,0,0,0,0,0,0,0,0,0
8.7,"eps_greedy_SVM","SVM",45,0,3812,3420,392,100,90,10,0.914674545617339,0.622549019607843,1.7585795608566,22,10,12,0,1.2,2.56,9,0,0,0,0,0,0,0.417457345513292,305.371835393403,45.7179714656499
8.7,"eps_greedy_SVM","SVM",45,1,3712,3402,310,200,108,92,0.907832225355905,0.607843137254902,1.71281551294551,81,42,39,59,0.9,5.11,1.2,0,0,0,0,0,0,0.660883223269667,218.849188965961,75.2265848286104
8.7,"eps_greedy_SVM","SVM",45,2,3612,3365,247,300,145,155,0.914785063568816,0.622549019607843,1.73930235077456,148,78,70,67,0.9,7.67,0.9,0,0,0,0,0,0,0.400646635047384,118.441464798856,57.1914904521281
8.7,"eps_greedy_SVM","SVM",45,3,3512,3319,193,400,191,209,0.904599225534976,0.622549019607843,1.73206831119545,239,124,115,91,0.9,10.22,0.9,0,0,0,0,0,0,0.229975942756064,90.9100666878779,34.3032936319384
8.7,"eps_greedy_SVM","SVM",45,4,3412,3256,156,500,254,246,0.858643343182029,0.642156862745098,1.58921026974326,338,169,169,99,1,12.78,1,0,0,0,0,0,0,0.134108038640997,79.8258435267345,19.7011358099133
8.7,"eps_greedy_SVM","SVM",45,5,3312,3185,127,600,325,275,0.857370288297978,0.666666666666667,1.58921026974326,409,199,210,71,1.1,15.34,1.2,0,0,0,0,0,0,0.0963519139733937,77.0849342194459,13.6305313507286
8.7,"eps_greedy_SVM","SVM",45,6,3212,3109,103,700,401,299,0.870807312651094,0.681372549019608,1.59217485159201,464,223,241,55,1.1,17.89,1.3,0,0,0,0,0,0,0.0859526709395449,86.0967870375033,10.901976855059
8.7,"eps_greedy_SVM","SVM",45,7,3112,3028,84,800,482,318,0.874066892738837,0.700980392156863,1.58921026974326,510,244,266,46,1.1,20.45,1.5,0,0,0,0,0,0,0.0745373353535106,94.8475579540794,10.1359864499037
8.7,"eps_greedy_SVM","SVM",45,8,3012,2950,62,900,560,340,0.868668300653602,0.691176470588235,1.57155237785722,550,265,285,40,1.1,23.01,1.6,0,0,0,0,0,0,0.0774713930280012,117.083880027325,10.5050338853853
8.7,"eps_greedy_SVM","SVM",45,9,2912,2856,56,1000,654,346,0.874857305936079,0.686274509803922,1.5818378964489,585,278,307,35,1.1,25.56,1.9,0,0,0,0,0,0,0.0589058336397338,81.3432905471638,6.58030950838068
8.7,"eps_greedy_SVM","SVM",45,10,2812,2757,55,1100,753,347,0.875769428776083,0.686274509803922,1.59067497966929,587,281,306,2,1.1,28.12,2.2,0,0,0,0,0,0,0.0466331121180759,64.5412115006413,5.06884477452885
8.7,"eps_greedy_SVM","SVM",45,11,2712,2661,51,1200,849,351,0.876189117199396,0.676470588235294,1.59951206288967,597,288,309,10,1.1,30.67,2.4,0,0,0,0,0,0,0.038784983610124,51.7591955783603,4.34008313892207
8.7,"eps_greedy_SVM","SVM",45,12,2612,2564,48,1300,946,354,0.880858850389474,0.676470588235294,1.60834914611006,604,292,312,7,1.1,33.23,2.7,0,0,0,0,0,0,0.0370934472268353,47.7915500063383,3.86206458434445
8.7,"eps_greedy_SVM","SVM",45,13,2512,2466,46,1400,1044,356,0.900570216671146,0.67156862745098,1.64646464646465,624,307,317,20,1,35.79,2.9,0,0,0,0,0,0,0.0336034488770687,28.358234063349,4.03865778480939
8.7,"eps_greedy_SVM","SVM",45,14,2412,2374,38,1500,1136,364,0.904274666487607,0.661764705882353,1.64949402023919,645,316,329,21,1,38.34,3.1,0,0,0,0,0,0,0.0267057697797552,26.5888881334103,3.04042630747926
8.7,"eps_greedy_SVM","SVM",45,15,2312,2277,35,1600,1233,367,0.908845073417503,0.661764705882353,1.6598418372874,657,320,337,12,1.1,40.9,3.4,0,0,0,0,0,0,0.0228996052820776,25.9280779402517,2.5461915850306
8.7,"eps_greedy_SVM","SVM",45,16,2212,2181,31,1700,1329,371,0.914106567284463,0.666666666666667,1.66560337370242,668,327,341,11,1,43.46,3.6,0,0,0,0,0,0,0.0212806621373048,25.9806756510737,2.37746330347814
8.7,"eps_greedy_SVM","SVM",45,17,2112,2085,27,1800,1425,375,0.925180745814317,0.661764705882353,1.73133121259503,685,337,348,17,1,46.01,3.8,0,0,0,0,0,0,0.0246203633813377,26.0493365714857,2.79457930361458
8.7,"eps_greedy_SVM","SVM",45,18,2012,1991,21,1900,1519,381,0.931383740710903,0.666666666666667,1.76648514584569,713,347,366,28,1.1,48.57,4,0,0,0,0,0,0,0.0441531689130254,32.0462108317434,5.28325423259004
8.7,"eps_greedy_SVM","SVM",45,19,1912,1893,19,2000,1617,383,0.932214723789065,0.661764705882353,1.76972937935505,720,349,371,7,1.1,51.12,4.2,0,0,0,0,0,0,0.0422681631492485,27.3696166513032,4.61191058249713
8.7,"eps_greedy_SVM","SVM",45,20,1812,1796,16,2100,1714,386,0.932266485361274,0.661764705882353,1.77461813454664,731,354,377,11,1.1,53.68,4.4,0,0,0,0,0,0,0.0366723531215319,21.2816446826853,4.22112361783481
8.7,"eps_greedy_SVM","SVM",45,21,1712,1701,11,2200,1809,391,0.931951719043788,0.656862745098039,1.77135596885813,746,361,385,15,1.1,56.24,4.6,0,0,0,0,0,0,0.0250060668018046,16.4697740316508,3.56738564751645
8.7,"eps_greedy_SVM","SVM",45,22,1612,1605,7,2300,1905,395,0.931372549019614,0.661764705882353,1.77135596885813,757,365,392,11,1.1,58.79,4.8,0,0,0,0,0,0,0.0164510223970072,13.4373421027074,2.08483905583946
8.7,"eps_greedy_SVM","SVM",45,23,1512,1506,6,2400,2004,396,0.931344569791393,0.661764705882353,1.77625372729737,758,366,392,1,1.1,61.35,5.1,0,0,0,0,0,0,0.013003379612474,10.7477510657504,1.3933196040867
8.7,"eps_greedy_SVM","SVM",45,24,1412,1406,6,2500,2104,396,0.93104659101084,0.661764705882353,1.76164103667061,764,372,392,6,1.1,63.91,5.3,0,0,0,0,0,0,0.010685400086545,8.12679039198553,1.12662537600052
8.7,"eps_greedy_SVM","SVM",45,25,1312,1306,6,2600,2204,396,0.930647887008691,0.661764705882353,1.76648514584569,764,374,390,0,1,66.46,5.6,0,0,0,0,0,0,0.00651111996945881,4.62170286639483,0.763642966337088
8.7,"eps_greedy_SVM","SVM",45,26,1212,1208,4,2700,2302,398,0.930477213716543,0.661764705882353,1.76648514584569,768,376,392,4,1,69.02,5.8,0,0,0,0,0,0,0.00739177161170415,4.76246824176931,0.758654591563595
8.7,"eps_greedy_SVM","SVM",45,27,1112,1108,4,2800,2402,398,0.931084362968937,0.656862745098039,1.77298555116619,779,384,395,11,1,71.57,6,0,0,0,0,0,0,0.00554994625221493,3.34903265176929,0.63032310369976
8.7,"eps_greedy_SVM","SVM",45,28,1012,1009,3,2900,2501,399,0.930731824693353,0.642156862745098,1.77461813454664,781,384,397,2,1,74.13,6.3,0,0,0,0,0,0,0.00556255827068802,2.99179907292396,0.582718690830596
8.7,"eps_greedy_SVM","SVM",45,29,912,909,3,3000,2601,399,0.93130120198765,0.642156862745098,1.77135596885813,789,386,403,8,1,76.69,6.5,0,0,0,0,0,0,0.00479835311712067,2.32962988241156,0.512992400092713
8.7,"eps_greedy_SVM","SVM",45,30,812,810,2,3100,2700,400,0.931476072164031,0.647058823529412,1.77461813454664,794,387,407,5,1.1,79.24,6.8,0,0,0,0,0,0,0.00403797668415557,1.74319886063784,0.430719073872183
8.7,"eps_greedy_SVM","SVM",45,31,712,710,2,3200,2800,400,0.931490061778141,0.647058823529412,1.77298555116619,794,387,407,0,1.1,81.8,7,0,0,0,0,0,0,0.00319590322351418,1.21825646452935,0.347253535891421
8.7,"eps_greedy_SVM","SVM",45,32,612,610,2,3300,2900,400,0.931411719939123,0.647058823529412,1.77298555116619,794,387,407,0,1.1,84.36,7.2,0,0,0,0,0,0,0.00264001603130356,0.893040431456096,0.296441807135709
8.7,"eps_greedy_SVM","SVM",45,33,512,510,2,3400,3000,400,0.931006021129919,0.647058823529412,1.77298555116619,794,387,407,0,1.1,86.91,7.5,0,0,0,0,0,0,0.00198565648462023,0.595338504923269,0.232764116809436
8.7,"eps_greedy_SVM","SVM",45,34,412,410,2,3500,3100,400,0.931131927656913,0.647058823529412,1.77298555116619,794,387,407,0,1.1,89.47,7.8,0,0,0,0,0,0,0.00116720549610951,0.337393633932927,0.146224425183977
8.7,"eps_greedy_SVM","SVM",45,35,312,312,0,3600,3198,402,0.931271823798018,0.647058823529412,1.76972937935505,797,391,406,3,1,92.02,8,0,0,0,0,0,0,0.00145237855432607,0.371951159692503,0.186631948460819
8.7,"eps_greedy_SVM","SVM",45,36,212,212,0,3700,3298,402,0.931744672754952,0.642156862745098,1.76486748545572,798,392,406,1,1,94.58,8.2,0,0,0,0,0,0,0.000832422834093727,0.174973526367792,0.10704755697268
8.7,"eps_greedy_SVM","SVM",45,37,112,112,0,3800,3398,402,0.931948921120964,0.642156862745098,1.76325278510306,803,393,410,5,1,97.14,8.5,0,0,0,0,0,0,0.000425231867823643,0.0677147171769105,0.0630761814049395
8.7,"eps_greedy_SVM","SVM",45,38,12,12,0,3900,3498,402,0.932105604799002,0.642156862745098,1.76810577441986,808,396,412,5,1,99.69,8.7,0,0,0,0,0,0,0.00023904123497361,0.00373447690775974,0.00373447690775974
8.7,"eps_greedy_SVM","SVM",45,39,0,0,0,3912,3510,402,0.932111200644646,0.642156862745098,1.76486748545572,808,396,412,0,1,100,8.7,0,0,0,0,0,0,0,0,0
8.7,"eps_greedy_SVM","SVM",46,0,3812,3417,395,100,89,11,0.898758542141231,0.535,1.74707182320442,25,11,14,0,1.3,2.56,8.1,0,0,0,0,0,0,0.744770888691527,390.068000991904,81.0780867842172
8.7,"eps_greedy_SVM","SVM",46,1,3712,3384,328,200,122,78,0.906204441913444,0.565,1.76670967741935,92,46,46,67,1,5.11,1.6,0,0,0,0,0,0,0.725319470632847,266.06335050822,80.1579962057673
8.7,"eps_greedy_SVM","SVM",46,2,3612,3347,265,300,159,141,0.896255694760834,0.58,1.72747010119595,158,79,79,66,1,7.67,1.1,0,0,0,0,0,0,0.479081875298988,153.214945862931,64.8908237160796
8.7,"eps_greedy_SVM","SVM",46,3,3512,3307,205,400,199,201,0.899612756264254,0.59,1.7560773480663,231,117,114,73,1,10.22,1,0,0,0,0,0,0,0.262228735202751,96.7139549980202,43.1057743329942
8.7,"eps_greedy_SVM","SVM",46,4,3412,3263,149,500,243,257,0.888411161731202,0.605,1.70361290322581,325,164,161,94,1,12.78,0.9,0,0,0,0,0,0,0.178432195302136,82.8983153790011,28.5294752779725
8.7,"eps_greedy_SVM","SVM",46,5,3312,3188,124,600,318,282,0.892682232346248,0.605,1.68558525345622,393,192,201,68,1,15.34,1.1,0,0,0,0,0,0,0.0871330854493976,45.9489525603784,13.1981357447624
8.7,"eps_greedy_SVM","SVM",46,6,3212,3115,97,700,391,309,0.871284168564922,0.615,1.60446082949309,458,224,234,65,1,17.89,1.3,0,0,0,0,0,0,0.0794436428261821,59.2095027289898,10.9372015956716
8.7,"eps_greedy_SVM","SVM",46,7,3112,3030,82,800,476,324,0.862529897494307,0.635,1.57596685082873,493,236,257,35,1.1,20.45,1.5,0,0,0,0,0,0,0.0600309510257253,60.9324331752722,8.72873979309353
8.7,"eps_greedy_SVM","SVM",46,8,3012,2949,63,900,557,343,0.872958428246011,0.64,1.59397790055249,542,260,282,49,1.1,23.01,1.6,0,0,0,0,0,0,0.0523402471515548,66.6605891057752,6.79806911149317
8.7,"eps_greedy_SVM","SVM",46,9,2912,2862,50,1000,644,356,0.888875284738042,0.655,1.64051612903226,574,272,302,32,1.1,25.56,1.8,0,0,0,0,0,0,0.0525292245488956,79.7223993050738,6.48681737838108
8.7,"eps_greedy_SVM","SVM",46,10,2812,2772,40,1100,734,366,0.908265945330301,0.645,1.69148114075437,601,289,312,27,1.1,28.12,2,0,0,0,0,0,0,0.0467620210402705,67.2904468548385,5.69261448079179
8.7,"eps_greedy_SVM","SVM",46,11,2712,2676,36,1200,830,370,0.917444476082011,0.64,1.69891544117647,617,297,320,16,1.1,30.67,2.2,0,0,0,0,0,0,0.048955143479005,62.3421948965426,5.43867731642927
8.7,"eps_greedy_SVM","SVM",46,12,2612,2579,33,1300,927,373,0.922414578587712,0.635,1.71847286108556,635,303,332,18,1.1,33.23,2.5,0,0,0,0,0,0,0.0524625029451454,53.5728169379054,5.81398133158481
8.7,"eps_greedy_SVM","SVM",46,13,2512,2480,32,1400,1026,374,0.923795558086576,0.63,1.72005524861878,636,307,329,1,1.1,35.79,2.7,0,0,0,0,0,0,0.0396918465601686,37.5664520882149,4.30913568893097
8.7,"eps_greedy_SVM","SVM",46,14,2412,2384,28,1500,1122,378,0.926671412300702,0.625,1.74868202764977,646,311,335,10,1.1,38.34,3,0,0,0,0,0,0,0.0377169379035806,34.8923793974273,4.21909910661387
8.7,"eps_greedy_SVM","SVM",46,15,2312,2290,22,1600,1216,384,0.92561503416858,0.63,1.74546458141674,669,320,349,23,1.1,40.9,3.2,0,0,0,0,0,0,0.0386386453938074,32.0461669583937,4.87496480217131
8.7,"eps_greedy_SVM","SVM",46,16,2212,2194,18,1700,1312,388,0.92696184510252,0.635,1.74707182320442,674,324,350,5,1.1,43.46,3.4,0,0,0,0,0,0,0.0257903953993398,24.2741704407454,3.23425376221092
8.7,"eps_greedy_SVM","SVM",46,17,2112,2100,12,1800,1406,394,0.927938496583156,0.63,1.74868202764977,691,332,359,17,1.1,46.01,3.6,0,0,0,0,0,0,0.0235639574906614,23.8194135563306,2.72462243041384
8.7,"eps_greedy_SVM","SVM",46,18,2012,2001,11,1900,1505,395,0.92845102505696,0.63,1.74707182320442,695,335,360,4,1.1,48.57,3.8,0,0,0,0,0,0,0.020244992709959,20.5098588661797,2.17442089246638
8.7,"eps_greedy_SVM","SVM",46,19,1912,1902,10,2000,1604,396,0.928021070615049,0.63,1.74868202764977,698,339,359,3,1.1,51.12,4.1,0,0,0,0,0,0,0.0166022856156899,16.5228118844165,1.79066960380701
8.7,"eps_greedy_SVM","SVM",46,20,1812,1803,9,2100,1703,397,0.928923690205031,0.625,1.7560773480663,711,343,368,13,1.1,53.68,4.3,0,0,0,0,0,0,0.0138231828953251,12.8714773003082,1.45445442419163
8.7,"eps_greedy_SVM","SVM",46,21,1712,1703,9,2200,1803,397,0.927152619589993,0.615,1.76508287292818,728,350,378,17,1.1,56.24,4.5,0,0,0,0,0,0,0.00961944607777408,8.47158634957753,1.21173323339664
8.7,"eps_greedy_SVM","SVM",46,22,1612,1605,7,2300,1901,399,0.927699316628717,0.62,1.76670967741935,731,351,380,3,1.1,58.79,4.8,0,0,0,0,0,0,0.0101781979952644,8.08714882598106,1.0275918765564
8.7,"eps_greedy_SVM","SVM",46,23,1512,1505,7,2400,2001,399,0.926719817767664,0.61,1.76345906163753,749,365,384,18,1.1,61.35,5,0,0,0,0,0,0,0.00635072416572896,4.2773272430572,0.865280098178577
8.7,"eps_greedy_SVM","SVM",46,24,1412,1406,6,2500,2100,400,0.925758826879284,0.61,1.76508287292818,751,364,387,2,1.1,63.91,5.2,0,0,0,0,0,0,0.00578122246453499,3.7536556169588,0.601577326696525
8.7,"eps_greedy_SVM","SVM",46,25,1312,1306,6,2600,2200,400,0.925412870159464,0.605,1.77082720588235,758,370,388,7,1,66.46,5.5,0,0,0,0,0,0,0.00461039243650966,2.75575727116722,0.505588194201594
8.7,"eps_greedy_SVM","SVM",46,26,1212,1207,5,2700,2299,401,0.925578018223244,0.6,1.77245630174793,760,372,388,2,1,69.02,5.7,0,0,0,0,0,0,0.00492157564838002,2.64228859134266,0.509881743399096
8.7,"eps_greedy_SVM","SVM",46,27,1112,1108,4,2800,2398,402,0.926047835990897,0.6,1.77245630174793,768,377,391,8,1,71.57,6,0,0,0,0,0,0,0.00420574020325756,2.04207594828372,0.446143553199643
8.7,"eps_greedy_SVM","SVM",46,28,1012,1008,4,2900,2498,402,0.926025056947616,0.605,1.77572350230415,769,378,391,1,1,74.13,6.2,0,0,0,0,0,0,0.00382399391566534,1.62781241165429,0.406933234716696
8.7,"eps_greedy_SVM","SVM",46,29,912,908,4,3000,2598,402,0.92603787015946,0.605,1.77408839779006,774,379,395,5,1,76.69,6.5,0,0,0,0,0,0,0.00317817897323993,1.20377051572132,0.346256475040286
8.7,"eps_greedy_SVM","SVM",46,30,812,808,4,3100,2698,402,0.926060649202741,0.605,1.77408839779006,774,380,394,0,1,79.24,6.7,0,0,0,0,0,0,0.00227448508426921,0.763658989864193,0.253241456572636
8.7,"eps_greedy_SVM","SVM",46,31,712,709,3,3200,2797,403,0.926452164009119,0.605,1.77245630174793,781,381,400,7,1,81.8,6.9,0,0,0,0,0,0,0.00164224826041784,0.49407350404634,0.19181626803768
8.7,"eps_greedy_SVM","SVM",46,32,612,609,3,3300,2897,403,0.92660307517085,0.605,1.77245630174793,780,383,397,-1,1,84.36,7.2,0,0,0,0,0,0,0.00109263994083425,0.335962803121349,0.147397490986782
8.7,"eps_greedy_SVM","SVM",46,33,512,509,3,3400,2997,403,0.926803815489756,0.605,1.77408839779006,780,383,397,0,1,86.91,7.4,0,0,0,0,0,0,0.000662585570949749,0.201098397056504,0.0884995448255822
8.7,"eps_greedy_SVM","SVM",46,34,412,411,1,3500,3095,405,0.928334282460144,0.6,1.77572350230415,792,385,407,12,1.1,89.47,7.6,0,0,0,0,0,0,0.000538560784914701,0.159982899028929,0.0693138313320141
8.7,"eps_greedy_SVM","SVM",46,35,312,312,0,3600,3194,406,0.929054669703879,0.605,1.77082720588235,797,390,407,5,1,92.02,7.9,0,0,0,0,0,0,0.000463091730789068,0.117510216254334,0.0567897749499669
8.7,"eps_greedy_SVM","SVM",46,36,212,212,0,3700,3294,406,0.929036161731212,0.605,1.77082720588235,799,390,409,2,1,94.58,8.1,0,0,0,0,0,0,0.000295064861442976,0.0618512687103656,0.0389212875841439
8.7,"eps_greedy_SVM","SVM",46,37,112,112,0,3800,3394,406,0.929246867881553,0.605,1.77082720588235,799,390,409,0,1,97.14,8.4,0,0,0,0,0,0,0.000119151184728491,0.0216531195836042,0.0202987626986223
8.7,"eps_greedy_SVM","SVM",46,38,12,12,0,3900,3494,406,0.929319476082007,0.605,1.76920110192837,806,394,412,7,1,99.69,8.6,0,0,0,0,0,0,9.6031499715612e-05,0.00127412822480234,0.00127412822480234
8.7,"eps_greedy_SVM","SVM",46,39,0,0,0,3912,3506,406,0.929258257403192,0.605,1.77082720588235,807,394,413,1,1,100,8.6,0,0,0,0,0,0,0,0,0
8.7,"eps_greedy_SVM","SVM",47,0,3812,3410,402,100,88,12,0.903229520975051,0.557291666666667,1.74001377410468,28,12,16,0,1.3,2.56,7.3,0,0,0,0,0,0,0.5,361.483256160904,56.2647559067461
8.7,"eps_greedy_SVM","SVM",47,1,3712,3383,329,200,115,85,0.918125236205587,0.557291666666667,1.75549954170486,91,45,46,63,1,5.11,1.4,0,0,0,0,0,0,0.646091861677812,276.617329216096,77.4005583598378
8.7,"eps_greedy_SVM","SVM",47,2,3612,3350,262,300,148,152,0.917744354686307,0.578125,1.76520737327189,154,81,73,63,0.9,7.67,1,0,0,0,0,0,0,0.457067024334159,178.352882572383,60.1609999766969
8.7,"eps_greedy_SVM","SVM",47,3,3512,3310,202,400,188,212,0.914552626606186,0.59375,1.77459677419355,233,120,113,79,0.9,10.22,0.9,0,0,0,0,0,0,0.299608978489607,108.473321137607,46.6543193052702
8.7,"eps_greedy_SVM","SVM",47,4,3412,3245,167,500,253,247,0.87513286564626,0.604166666666667,1.66823827046918,315,158,157,82,1,12.78,1,0,0,0,0,0,0,0.184017053264964,100.677882950049,27.1644499778367
8.7,"eps_greedy_SVM","SVM",47,5,3312,3174,138,600,324,276,0.874843513794421,0.635416666666667,1.6401218951242,393,191,202,78,1.1,15.34,1.2,0,0,0,0,0,0,0.117514958022158,90.8219361365517,16.9206160895342
8.7,"eps_greedy_SVM","SVM",47,6,3212,3099,113,700,399,301,0.874843513794409,0.651041666666667,1.6213776448942,448,213,235,55,1.1,17.89,1.3,0,0,0,0,0,0,0.0821570960255004,82.7915631354043,11.5036317176852
8.7,"eps_greedy_SVM","SVM",47,7,3112,3025,87,800,473,327,0.883090041572189,0.671875,1.61200551977921,508,244,264,60,1.1,20.45,1.4,0,0,0,0,0,0,0.0799874610666127,115.534256614247,12.4874805829262
8.7,"eps_greedy_SVM","SVM",47,8,3012,2949,63,900,549,351,0.876307988473172,0.671875,1.6213776448942,562,268,294,54,1.1,23.01,1.6,0,0,0,0,0,0,0.100750489867254,155.483203668346,12.5790574969844
8.7,"eps_greedy_SVM","SVM",47,9,2912,2853,59,1000,645,355,0.902684771825411,0.666666666666667,1.66059981684982,588,287,301,26,1,25.56,1.8,0,0,0,0,0,0,0.0692236123350054,78.2191429498147,9.79756697543686
8.7,"eps_greedy_SVM","SVM",47,10,2812,2757,55,1100,741,359,0.902475139361324,0.666666666666667,1.67299311926605,608,294,314,20,1.1,28.12,2.1,0,0,0,0,0,0,0.0547572920656121,66.3141793019294,5.9316145786938
8.7,"eps_greedy_SVM","SVM",47,11,2712,2665,47,1200,833,367,0.910179870559341,0.666666666666667,1.69635464581417,623,299,324,15,1.1,30.67,2.3,0,0,0,0,0,0,0.0481710790864955,67.2676277023616,5.52479558393795
8.7,"eps_greedy_SVM","SVM",47,12,2612,2572,40,1300,926,374,0.921861713435371,0.65625,1.70729742173112,647,313,334,24,1.1,33.23,2.5,0,0,0,0,0,0,0.0480577806998777,66.7866650361514,5.51405217232607
8.7,"eps_greedy_SVM","SVM",47,13,2512,2475,37,1400,1023,377,0.928952310090693,0.651041666666667,1.72907110091743,665,324,341,18,1.1,35.79,2.7,0,0,0,0,0,0,0.0451532633743552,54.3389110101016,5.29561829738569
8.7,"eps_greedy_SVM","SVM",47,14,2412,2378,34,1500,1120,380,0.931763156651541,0.645833333333333,1.73384314627415,677,330,347,12,1.1,38.34,2.9,0,0,0,0,0,0,0.0405895629778832,44.9228425011219,4.45251182374173
8.7,"eps_greedy_SVM","SVM",47,15,2312,2281,31,1600,1217,383,0.935244236583527,0.651041666666667,1.73065886134068,684,332,352,7,1.1,40.9,3.2,0,0,0,0,0,0,0.0360959384126086,36.1274068455741,4.01970758236807
8.7,"eps_greedy_SVM","SVM",47,16,2212,2186,26,1700,1312,388,0.938300146447469,0.651041666666667,1.74936868686869,696,339,357,12,1.1,43.46,3.4,0,0,0,0,0,0,0.0355271010943525,32.2830119867182,4.14935035978551
8.7,"eps_greedy_SVM","SVM",47,17,2112,2091,21,1800,1407,393,0.939581561791391,0.651041666666667,1.76034007352941,717,347,370,21,1.1,46.01,3.6,0,0,0,0,0,0,0.0321021399798441,29.2988183605792,4.05577035260423
8.7,"eps_greedy_SVM","SVM",47,18,2012,1998,14,1900,1500,400,0.939924059901742,0.651041666666667,1.76195952161914,730,354,376,13,1.1,48.57,3.8,0,0,0,0,0,0,0.0298244147696508,27.4556319072847,3.81075935749033
8.7,"eps_greedy_SVM","SVM",47,19,1912,1900,12,2000,1598,402,0.940183886054426,0.651041666666667,1.76358195211786,739,358,381,9,1.1,51.12,4,0,0,0,0,0,0,0.027823582694485,26.623895586679,3.05473122903807
8.7,"eps_greedy_SVM","SVM",47,20,1812,1801,11,2100,1697,403,0.9403019888511,0.65625,1.76195952161914,738,358,380,-1,1.1,53.68,4.2,0,0,0,0,0,0,0.0234509418449182,20.9242872494601,2.38356423539362
8.7,"eps_greedy_SVM","SVM",47,21,1712,1702,10,2200,1796,404,0.939645042044594,0.645833333333333,1.76970358455882,770,373,397,32,1.1,56.24,4.4,0,0,0,0,0,0,0.0183571155815546,12.6652659443579,2.33610572961024
8.7,"eps_greedy_SVM","SVM",47,22,1612,1603,9,2300,1895,405,0.940052496693117,0.645833333333333,1.77296270718232,766,372,394,-4,1.1,58.79,4.7,0,0,0,0,0,0,0.0118263076013612,9.1506418075844,1.3840457458487
8.7,"eps_greedy_SVM","SVM",47,23,1512,1506,6,2400,1992,408,0.940827546296287,0.645833333333333,1.77133164673413,774,378,396,8,1,61.35,4.9,0,0,0,0,0,0,0.010690818868595,8.25855166381215,1.12098954500411
8.7,"eps_greedy_SVM","SVM",47,24,1412,1406,6,2500,2092,408,0.941382629440649,0.635416666666667,1.77133164673413,782,383,399,8,1,63.91,5.1,0,0,0,0,0,0,0.00892605012647081,6.51474799872314,1.02713246274489
8.7,"eps_greedy_SVM","SVM",47,25,1312,1306,6,2600,2192,408,0.941471206538154,0.635416666666667,1.77459677419355,782,383,399,0,1,66.46,5.4,0,0,0,0,0,0,0.00839256992536446,5.58985441151833,0.862530948682187
8.7,"eps_greedy_SVM","SVM",47,26,1212,1206,6,2700,2292,408,0.941211380385473,0.635416666666667,1.7774334251607,782,384,398,0,1,69.02,5.6,0,0,0,0,0,0,0.00614327092987642,3.70523621167062,0.657024598783621
8.7,"eps_greedy_SVM","SVM",47,27,1112,1107,5,2800,2391,409,0.940886597694618,0.635416666666667,1.77417506874427,787,387,400,5,1,71.57,5.8,0,0,0,0,0,0,0.00653098400270601,3.36155276444028,0.688307581168451
8.7,"eps_greedy_SVM","SVM",47,28,1012,1007,5,2900,2491,409,0.940390565948585,0.640625,1.77417506874427,795,389,406,8,1,74.13,6.1,0,0,0,0,0,0,0.00574422642342724,2.66262125354923,0.625187090450946
8.7,"eps_greedy_SVM","SVM",47,29,912,908,4,3000,2590,410,0.940384660808752,0.640625,1.77417506874427,797,390,407,2,1,76.69,6.3,0,0,0,0,0,0,0.00471194747356853,1.92637545382329,0.506402202901124
8.7,"eps_greedy_SVM","SVM",47,30,812,808,4,3100,2690,410,0.940313799130748,0.640625,1.7774334251607,799,391,408,2,1,79.24,6.6,0,0,0,0,0,0,0.00372819253520918,1.33175850246519,0.409672951638277
8.7,"eps_greedy_SVM","SVM",47,31,712,708,4,3200,2790,410,0.940369897959168,0.640625,1.77580275229358,799,391,408,0,1,81.8,6.8,0,0,0,0,0,0,0.00327235308252168,1.08954300488828,0.377175697474736
8.7,"eps_greedy_SVM","SVM",47,32,612,609,3,3300,2889,411,0.94039647108842,0.635416666666667,1.7774334251607,804,393,411,5,1,84.36,7,0,0,0,0,0,0,0.0020960413629527,0.701108577589839,0.264531854159276
8.7,"eps_greedy_SVM","SVM",47,33,512,510,2,3400,2988,412,0.940656297241103,0.630208333333333,1.77906709558824,808,395,413,4,1,86.91,7.3,0,0,0,0,0,0,0.00155533198778528,0.535114627854103,0.195941130637293
8.7,"eps_greedy_SVM","SVM",47,34,412,411,1,3500,3087,413,0.940588388133015,0.635416666666667,1.7867883379247,814,400,414,6,1,89.47,7.5,0,0,0,0,0,0,0.00118863357253928,0.360001793647303,0.14051562227917
8.7,"eps_greedy_SVM","SVM",47,35,312,312,0,3600,3186,414,0.94049981103551,0.635416666666667,1.79007589696412,821,403,418,7,1,92.02,7.7,0,0,0,0,0,0,0.00113165903761005,0.29062291570586,0.136025624898072
8.7,"eps_greedy_SVM","SVM",47,36,212,212,0,3700,3286,414,0.940573625283432,0.635416666666667,1.78843060661765,825,405,420,4,1,94.58,7.9,0,0,0,0,0,0,0.000579052554821394,0.122795566400662,0.0748757036542343
8.7,"eps_greedy_SVM","SVM",47,37,112,112,0,3800,3386,414,0.940623818972018,0.635416666666667,1.79007589696412,830,406,424,5,1,97.14,8.2,0,0,0,0,0,0,0.000310007115160257,0.0455021925203392,0.042247740281886
8.7,"eps_greedy_SVM","SVM",47,38,12,12,0,3900,3486,414,0.940552957294014,0.635416666666667,1.79007589696412,829,406,423,-1,1,99.69,8.4,0,0,0,0,0,0,0.000218398052020594,0.00300025669126374,0.00300025669126374
8.7,"eps_greedy_SVM","SVM",47,39,0,0,0,3912,3498,414,0.940579530423266,0.635416666666667,1.7867883379247,829,406,423,0,1,100,8.4,0,0,0,0,0,0,0,0,0
8.7,"eps_greedy_SVM","SVM",48,0,3812,3422,390,100,90,10,0.914812760055477,0.611650485436893,1.71525211399937,27,10,17,0,1.7,2.56,9,0,0,0,0,0,0,0.170828659946224,372.542819513071,17.956769387119
8.7,"eps_greedy_SVM","SVM",48,1,3712,3393,319,200,119,81,0.9151761442441,0.621359223300971,1.74703691463992,88,44,44,61,1,5.11,1.5,0,0,0,0,0,0,0.715718120607553,318.116992634178,82.1246588285787
8.7,"eps_greedy_SVM","SVM",48,2,3612,3357,255,300,155,145,0.913273231622755,0.621359223300971,1.69774954140754,156,80,76,68,1,7.67,1.1,0,0,0,0,0,0,0.467025285960288,232.393670882376,59.9482200371258
8.7,"eps_greedy_SVM","SVM",48,3,3512,3313,199,400,199,201,0.914191400832167,0.631067961165049,1.70895183075236,242,123,119,86,1,10.22,1,0,0,0,0,0,0,0.354820653381117,167.301987650289,50.8728774549579
8.7,"eps_greedy_SVM","SVM",48,4,3412,3257,155,500,255,245,0.896846047156712,0.635922330097087,1.68589062262752,329,166,163,87,1,12.78,1,0,0,0,0,0,0,0.26521317649696,194.326725414868,36.9293947258452
8.7,"eps_greedy_SVM","SVM",48,5,3312,3186,126,600,326,274,0.915305131761436,0.650485436893204,1.72241592018452,404,197,207,75,1.1,15.34,1.2,0,0,0,0,0,0,0.111982658632263,79.1039163226567,17.0679339740322
8.7,"eps_greedy_SVM","SVM",48,6,3212,3109,103,700,403,297,0.918069348127592,0.660194174757282,1.71209617634712,466,222,244,62,1.1,17.89,1.4,0,0,0,0,0,0,0.0867549839268235,80.3412853906783,11.7119688046536
8.7,"eps_greedy_SVM","SVM",48,7,3112,3020,92,800,492,308,0.912280166435503,0.674757281553398,1.68024696881571,492,231,261,26,1.1,20.45,1.6,0,0,0,0,0,0,0.0693309384752966,81.8819469702781,9.55829793341939
8.7,"eps_greedy_SVM","SVM",48,8,3012,2944,68,900,568,332,0.914837725381408,0.679611650485437,1.68024696881571,557,264,293,65,1.1,23.01,1.7,0,0,0,0,0,0,0.0955294761534054,128.012017788319,13.1280866817157
8.7,"eps_greedy_SVM","SVM",48,9,2912,2854,58,1000,658,342,0.923467406380009,0.674757281553398,1.72241592018452,589,281,308,32,1.1,25.56,1.9,0,0,0,0,0,0,0.0798116674462547,86.4416675567971,8.9207621629454
8.7,"eps_greedy_SVM","SVM",48,10,2812,2764,48,1100,748,352,0.925152565880705,0.669902912621359,1.71609512781687,617,292,325,28,1.1,28.12,2.1,0,0,0,0,0,0,0.085279717072991,83.6783567295002,9.33514847569104
8.7,"eps_greedy_SVM","SVM",48,11,2712,2667,45,1200,845,355,0.926072122052688,0.66504854368932,1.72241592018452,625,300,325,8,1.1,30.67,2.4,0,0,0,0,0,0,0.0694368568556742,61.7282472568309,7.53310135903516
8.7,"eps_greedy_SVM","SVM",48,12,2612,2572,40,1300,940,360,0.925694868238542,0.66504854368932,1.72241592018452,640,305,335,15,1.1,33.23,2.6,0,0,0,0,0,0,0.0618381204230296,52.4740719156726,6.86328349220078
8.7,"eps_greedy_SVM","SVM",48,13,2512,2479,33,1400,1033,367,0.925875173370306,0.66504854368932,1.72083136092032,653,312,341,13,1.1,35.79,2.8,0,0,0,0,0,0,0.0577733959272424,49.3846560262302,6.27609130746704
8.7,"eps_greedy_SVM","SVM",48,14,2412,2387,25,1500,1125,375,0.926529819694853,0.66504854368932,1.71767097274599,680,321,359,27,1.1,38.34,3,0,0,0,0,0,0,0.0492243935763272,46.3171193649623,5.64260869793745
8.7,"eps_greedy_SVM","SVM",48,15,2312,2294,18,1600,1218,382,0.925769764216348,0.669902912621359,1.72083136092032,696,329,367,16,1.1,40.9,3.2,0,0,0,0,0,0,0.0439043001596707,48.934581039907,4.93549640804259
8.7,"eps_greedy_SVM","SVM",48,16,2212,2197,15,1700,1315,385,0.928185852981961,0.669902912621359,1.72241592018452,709,338,371,13,1.1,43.46,3.4,0,0,0,0,0,0,0.0344566287926164,39.573384563091,3.82386266221382
8.7,"eps_greedy_SVM","SVM",48,17,2112,2101,11,1800,1411,389,0.930316227461861,0.674757281553398,1.71609512781687,728,342,386,19,1.1,46.01,3.6,0,0,0,0,0,0,0.0336018341025415,37.241764719247,3.63819548590889
8.7,"eps_greedy_SVM","SVM",48,18,2012,2005,7,1900,1507,393,0.93094313453538,0.66504854368932,1.73115914820576,735,347,388,7,1.1,48.57,3.8,0,0,0,0,0,0,0.0304711106335581,33.1186848141257,3.28687043480389
8.7,"eps_greedy_SVM","SVM",48,19,1912,1905,7,2000,1607,393,0.930454923717069,0.669902912621359,1.72797687035979,738,350,388,3,1.1,51.12,4.1,0,0,0,0,0,0,0.024964157133372,25.8768079187248,2.68594965817205
8.7,"eps_greedy_SVM","SVM",48,20,1812,1805,7,2100,1707,393,0.930273231622754,0.669902912621359,1.73115914820576,736,351,385,-2,1.1,53.68,4.3,0,0,0,0,0,0,0.0212390557410151,21.5327749475982,2.24235038802902
8.7,"eps_greedy_SVM","SVM",48,21,1712,1705,7,2200,1807,393,0.930160887656038,0.669902912621359,1.72956654549352,740,352,388,4,1.1,56.24,4.6,0,0,0,0,0,0,0.0185161372706301,17.3794294765057,1.89948242462216
8.7,"eps_greedy_SVM","SVM",48,22,1612,1605,7,2300,1907,393,0.931392510402211,0.660194174757282,1.74864560424824,757,366,391,17,1.1,58.79,4.9,0,0,0,0,0,0,0.0118674852730566,8.14006184544752,1.58901708090878
8.7,"eps_greedy_SVM","SVM",48,23,1512,1507,5,2400,2005,395,0.931165048543683,0.655339805825243,1.75025725918303,761,368,393,4,1.1,61.35,5.1,0,0,0,0,0,0,0.0096121589071958,7.68042588648941,1.13362287980214
8.7,"eps_greedy_SVM","SVM",48,24,1412,1408,4,2500,2104,396,0.931503467406374,0.655339805825243,1.75025725918303,761,368,393,0,1.1,63.91,5.3,0,0,0,0,0,0,0.00822056138737963,6.2309147260465,0.843745109902254
8.7,"eps_greedy_SVM","SVM",48,25,1312,1308,4,2600,2204,396,0.932671289875181,0.655339805825243,1.75025725918303,770,375,395,9,1.1,66.46,5.6,0,0,0,0,0,0,0.00555742150137095,3.68166801075166,0.666243002533345
8.7,"eps_greedy_SVM","SVM",48,26,1212,1208,4,2700,2304,396,0.932682385575596,0.655339805825243,1.74703691463992,770,375,395,0,1.1,69.02,5.8,0,0,0,0,0,0,0.0050611354854233,3.13993110266884,0.524108876687413
8.7,"eps_greedy_SVM","SVM",48,27,1112,1109,3,2800,2403,397,0.933803051317618,0.655339805825243,1.75900854547895,784,381,403,14,1.1,71.57,6.1,0,0,0,0,0,0,0.00423111071998069,2.47928554706011,0.469257999555479
8.7,"eps_greedy_SVM","SVM",48,28,1012,1010,2,2900,2502,398,0.934353675450763,0.650485436893204,1.75415833809252,792,386,406,8,1.1,74.13,6.3,0,0,0,0,0,0,0.00380486496115846,1.96407216134531,0.40252643264231
8.7,"eps_greedy_SVM","SVM",48,29,912,911,1,3000,2601,399,0.934510402219137,0.650485436893204,1.75577209921312,800,389,411,8,1.1,76.69,6.5,0,0,0,0,0,0,0.0031532964363649,1.38222840692644,0.327360263449461
8.7,"eps_greedy_SVM","SVM",48,30,812,811,1,3100,2701,399,0.934765603328702,0.650485436893204,1.75577209921312,800,391,409,0,1,79.24,6.8,0,0,0,0,0,0,0.00268471787019099,0.97268149026104,0.284494329676836
8.7,"eps_greedy_SVM","SVM",48,31,712,712,0,3200,2800,400,0.934834951456302,0.650485436893204,1.75577209921312,806,393,413,6,1.1,81.8,7,0,0,0,0,0,0,0.00197527488706026,0.606541109322086,0.217421386739632
8.7,"eps_greedy_SVM","SVM",48,32,612,612,0,3300,2900,400,0.935023578363375,0.655339805825243,1.75577209921312,804,393,411,-2,1,84.36,7.2,0,0,0,0,0,0,0.00153228594912791,0.435718725604499,0.187256105358309
8.7,"eps_greedy_SVM","SVM",48,33,512,512,0,3400,3000,400,0.935206657420241,0.655339805825243,1.75415833809252,808,393,415,4,1.1,86.91,7.5,0,0,0,0,0,0,0.000739928152441855,0.228549751832008,0.10392246563464
8.7,"eps_greedy_SVM","SVM",48,34,412,412,0,3500,3100,400,0.935818307905682,0.655339805825243,1.7477328496746,813,396,417,5,1.1,89.47,7.8,0,0,0,0,0,0,0.000354899481064141,0.101584769497379,0.0487498370556109
8.7,"eps_greedy_SVM","SVM",48,35,312,312,0,3600,3200,400,0.936391123439663,0.655339805825243,1.75093969894006,812,396,416,-1,1.1,92.02,8,0,0,0,0,0,0,0.00020899862083712,0.0525920777847696,0.0283318659622178
8.7,"eps_greedy_SVM","SVM",48,36,212,212,0,3700,3300,400,0.93663800277392,0.650485436893204,1.75415833809252,814,397,417,2,1.1,94.58,8.2,0,0,0,0,0,0,8.51929472116434e-05,0.0189280370465063,0.0125196414390283
8.7,"eps_greedy_SVM","SVM",48,37,112,112,0,3800,3400,400,0.936907073509011,0.650485436893204,1.75254754072053,816,398,418,2,1.1,97.14,8.5,0,0,0,0,0,0,2.67099219412709e-05,0.0051890201370678,0.00491260864348463
8.7,"eps_greedy_SVM","SVM",48,38,12,12,0,3900,3500,400,0.937031900138693,0.650485436893204,1.75254754072053,819,399,420,3,1.1,99.69,8.8,0,0,0,0,0,0,2.29419815914028e-05,0.000346229584602747,0.000346229584602747
8.7,"eps_greedy_SVM","SVM",48,39,0,0,0,3912,3512,400,0.937051317614421,0.650485436893204,1.75254754072053,819,399,420,0,1.1,100,8.8,0,0,0,0,0,0,0,0,0
8.7,"eps_greedy_SVM","SVM",49,0,3812,3421,391,100,90,10,0.869816550821141,0.521951219512195,1.69255738880918,31,10,21,0,2.1,2.56,9,0,0,0,0,0,0,0.543555033684984,392.245797248581,64.4605945477831
8.7,"eps_greedy_SVM","SVM",49,1,3712,3360,352,200,151,49,0.890206293267976,0.595121951219512,1.71167006978257,107,49,58,76,1.2,5.11,3.1,0,0,0,0,0,0,0.670716573253867,370.038904870753,78.2780220480064
8.7,"eps_greedy_SVM","SVM",49,2,3612,3332,280,300,179,121,0.90756501511332,0.614634146341463,1.71482522198494,159,79,80,52,1,7.67,1.5,0,0,0,0,0,0,0.517403394085623,236.058020825604,66.6223934371232
8.7,"eps_greedy_SVM","SVM",49,3,3512,3293,219,400,218,182,0.905489546043381,0.624390243902439,1.7236191974823,231,114,117,72,1,10.22,1.2,0,0,0,0,0,0,0.35337359921227,163.476381305745,49.3162311859738
8.7,"eps_greedy_SVM","SVM",49,4,3412,3251,161,500,260,240,0.91210318842195,0.653658536585366,1.75072723204296,324,166,158,93,1,12.78,1.1,0,0,0,0,0,0,0.295613691530498,148.814704477184,43.5017939923192
8.7,"eps_greedy_SVM","SVM",49,5,3312,3181,131,600,330,270,0.919767101725847,0.653658536585366,1.75233487872069,394,196,198,70,1,15.34,1.2,0,0,0,0,0,0,0.135204314341742,85.7438049415777,20.7666751952461
8.7,"eps_greedy_SVM","SVM",49,6,3212,3108,104,700,403,297,0.919438369712086,0.648780487804878,1.75555904593085,456,222,234,62,1.1,17.89,1.4,0,0,0,0,0,0,0.0933748242691441,75.5352492421798,12.3508072314362
8.7,"eps_greedy_SVM","SVM",49,7,3112,3023,89,800,488,312,0.914900196403475,0.658536585365854,1.69411447932327,488,238,250,32,1.1,20.45,1.6,0,0,0,0,0,0,0.0623066863073701,66.1861522770034,9.26486296835457
8.7,"eps_greedy_SVM","SVM",49,8,3012,2939,73,900,572,328,0.908045576743621,0.678048780487805,1.68945177892146,527,256,271,39,1.1,23.01,1.7,0,0,0,0,0,0,0.0604162994395189,92.4812704951242,7.96645330544804
8.7,"eps_greedy_SVM","SVM",49,9,2912,2854,58,1000,657,343,0.91947458595091,0.68780487804878,1.70603124648758,570,278,292,43,1.1,25.56,1.9,0,0,0,0,0,0,0.0797390175504554,111.607475476648,9.60457018090297
8.7,"eps_greedy_SVM","SVM",49,10,2812,2766,46,1100,745,355,0.924979454249161,0.68780487804878,1.71009684361549,616,296,320,46,1.1,28.12,2.1,0,0,0,0,0,0,0.0729816366824447,96.5161741299275,8.26365955715833
8.7,"eps_greedy_SVM","SVM",49,11,2712,2674,38,1200,837,363,0.931367441601326,0.682926829268293,1.72604985553988,644,309,335,28,1.1,30.67,2.3,0,0,0,0,0,0,0.0632991793700484,78.3609722319331,7.13066893628398
8.7,"eps_greedy_SVM","SVM",49,12,2612,2580,32,1300,931,369,0.935267651934092,0.702439024390244,1.74678125070119,664,315,349,20,1.1,33.23,2.5,0,0,0,0,0,0,0.0608161402035172,67.7763119519392,6.52589425699176
8.7,"eps_greedy_SVM","SVM",49,13,2512,2485,27,1400,1026,374,0.936213452939787,0.692682926829268,1.75394548063128,678,323,355,14,1.1,35.79,2.7,0,0,0,0,0,0,0.0600989992111785,64.2799131519196,6.73034041438587
8.7,"eps_greedy_SVM","SVM",49,14,2412,2391,21,1500,1120,380,0.937914223231331,0.692682926829268,1.76596146071958,691,331,360,13,1.1,38.34,2.9,0,0,0,0,0,0,0.0550807355109124,56.4285637686768,6.1192864384885
8.7,"eps_greedy_SVM","SVM",49,15,2312,2294,18,1600,1217,383,0.938671978381697,0.692682926829268,1.75394548063128,697,333,364,6,1.1,40.9,3.2,0,0,0,0,0,0,0.0443289403351424,48.1242327925224,5.09843162911948
8.7,"eps_greedy_SVM","SVM",49,16,2212,2198,14,1700,1313,387,0.939070357008542,0.68780487804878,1.75233487872069,713,339,374,16,1.1,43.46,3.4,0,0,0,0,0,0,0.0398854772901698,44.7932490141834,4.44329043437458
8.7,"eps_greedy_SVM","SVM",49,17,2112,2100,12,1800,1411,389,0.939991085233539,0.682926829268293,1.76271520803443,724,343,381,11,1.1,46.01,3.6,0,0,0,0,0,0,0.031913755908153,34.5623474027773,3.41537885525847
8.7,"eps_greedy_SVM","SVM",49,18,2012,2000,12,1900,1511,389,0.939119109637714,0.682926829268293,1.75948086820318,728,345,383,4,1.1,48.57,3.9,0,0,0,0,0,0,0.0245692657538609,24.0030029598045,2.57902309356053
8.7,"eps_greedy_SVM","SVM",49,19,1912,1900,12,2000,1611,389,0.939073142873075,0.658536585365854,1.76985822750789,748,360,388,20,1.1,51.12,4.1,0,0,0,0,0,0,0.0191571031568516,14.8392648938929,2.35974153713934
8.7,"eps_greedy_SVM","SVM",49,20,1812,1801,11,2100,1710,390,0.939180398657226,0.663414634146341,1.77148493543759,750,360,390,2,1.1,53.68,4.4,0,0,0,0,0,0,0.0151999586184798,13.2046731218308,1.71078531762709
8.7,"eps_greedy_SVM","SVM",49,21,1712,1704,8,2200,1807,393,0.939418590073976,0.663414634146341,1.76823450436339,751,361,390,1,1.1,56.24,4.6,0,0,0,0,0,0,0.0138114051380694,11.5317380371563,1.42029870369228
8.7,"eps_greedy_SVM","SVM",49,22,1612,1604,8,2300,1907,393,0.940321210179558,0.658536585365854,1.78025466284075,767,372,395,16,1.1,58.79,4.9,0,0,0,0,0,0,0.00865916427036664,6.70030844851643,1.09126964714162
8.7,"eps_greedy_SVM","SVM",49,23,1512,1505,7,2400,2006,394,0.940580295580235,0.658536585365854,1.78189243161981,770,372,398,3,1.1,61.35,5.1,0,0,0,0,0,0,0.0079419579403693,6.11456719192275,0.852891970025365
8.7,"eps_greedy_SVM","SVM",49,24,1412,1406,6,2500,2105,395,0.941310192085368,0.658536585365854,1.78189243161981,779,377,402,9,1.1,63.91,5.3,0,0,0,0,0,0,0.00659889806175132,4.87214696989037,0.719573609712182
8.7,"eps_greedy_SVM","SVM",49,25,1312,1306,6,2600,2205,395,0.941349194188696,0.653658536585366,1.78353321654763,777,377,400,-2,1.1,66.46,5.6,0,0,0,0,0,0,0.0059139705982765,3.90702605760007,0.607499429864446
8.7,"eps_greedy_SVM","SVM",49,26,1212,1207,5,2700,2304,396,0.941549776434379,0.653658536585366,1.78353321654763,784,384,400,7,1,69.02,5.8,0,0,0,0,0,0,0.00568210388199203,3.35133077448241,0.594496512141095
8.7,"eps_greedy_SVM","SVM",49,27,1112,1108,4,2800,2403,397,0.941751751612326,0.653658536585366,1.77698814052361,792,386,406,8,1.1,71.57,6.1,0,0,0,0,0,0,0.00423770835201023,2.24505749555582,0.451128037864543
8.7,"eps_greedy_SVM","SVM",49,28,1012,1008,4,2900,2503,397,0.941801897173748,0.658536585365854,1.78025466284075,792,386,406,0,1.1,74.13,6.3,0,0,0,0,0,0,0.0044691136895828,2.16882444333002,0.474312937274768
8.7,"eps_greedy_SVM","SVM",49,29,912,908,4,3000,2603,397,0.941864579125525,0.658536585365854,1.7786199019015,793,387,406,1,1,76.69,6.6,0,0,0,0,0,0,0.00340363223573285,1.45671347505806,0.367467224542885
8.7,"eps_greedy_SVM","SVM",49,30,812,808,4,3100,2703,397,0.941914724686946,0.658536585365854,1.7786199019015,794,388,406,1,1,79.24,6.8,0,0,0,0,0,0,0.00243637731193557,0.943445373398616,0.269801954404397
8.7,"eps_greedy_SVM","SVM",49,31,712,708,4,3200,2803,397,0.942176595952146,0.658536585365854,1.78025466284075,793,389,404,-1,1,81.8,7.1,0,0,0,0,0,0,0.00212152769573108,0.749971813210213,0.239435054651418
8.7,"eps_greedy_SVM","SVM",49,32,612,609,3,3300,2902,398,0.942449610675439,0.653658536585366,1.77698814052361,798,389,409,5,1.1,84.36,7.3,0,0,0,0,0,0,0.00183143028040943,0.594054335291481,0.208660387073417
8.7,"eps_greedy_SVM","SVM",49,33,512,509,3,3400,3002,398,0.942718446601948,0.658536585365854,1.78353321654763,803,390,413,5,1.1,86.91,7.5,0,0,0,0,0,0,0.0010623530311306,0.328367381152358,0.131674007089423
8.7,"eps_greedy_SVM","SVM",49,34,412,410,2,3500,3101,399,0.943190650638665,0.658536585365854,1.7786199019015,808,392,416,5,1.1,89.47,7.8,0,0,0,0,0,0,0.000832277616592695,0.238809764407686,0.105767534717144
8.7,"eps_greedy_SVM","SVM",49,35,312,311,1,3600,3200,400,0.943764538730486,0.658536585365854,1.78189243161981,811,394,417,3,1.1,92.02,8,0,0,0,0,0,0,0.00053050167540456,0.130261343235904,0.0676490785139161
8.7,"eps_greedy_SVM","SVM",49,36,212,212,0,3700,3299,401,0.944260422615652,0.658536585365854,1.7786199019015,813,397,416,2,1,94.58,8.2,0,0,0,0,0,0,0.000380966942893229,0.0826887254174319,0.0521569421730872
8.7,"eps_greedy_SVM","SVM",49,37,112,112,0,3800,3399,401,0.944376035993373,0.658536585365854,1.78025466284075,813,397,416,0,1,97.14,8.5,0,0,0,0,0,0,0.000153119514016245,0.0252506090913386,0.0235706927212505
8.7,"eps_greedy_SVM","SVM",49,38,12,12,0,3900,3499,401,0.944547366661563,0.653658536585366,1.78189243161981,814,398,416,1,1,99.69,8.7,0,0,0,0,0,0,0.000180037112983379,0.00238588266441056,0.00238588266441056
8.7,"eps_greedy_SVM","SVM",49,39,0,0,0,3912,3511,401,0.944530651474422,0.653658536585366,1.78025466284075,815,398,417,1,1,100,8.8,0,0,0,0,0,0,0,0,0
8.7,"eps_greedy_SVM","SVM",50,0,3812,3431,381,100,95,5,0.856103372434023,0.490909090909091,1.67165479681609,24,5,19,0,3.8,2.56,19,0,0,0,0,0,0,0.0714586583893139,207.385456297345,7.70051916671777
8.7,"eps_greedy_SVM","SVM",50,1,3712,3357,355,200,169,31,0.879252199413508,0.463636363636364,1.75359865940511,72,31,41,48,1.3,5.11,5.5,0,0,0,0,0,0,0.209429115487484,196.296683901954,31.4226703291865
8.7,"eps_greedy_SVM","SVM",50,2,3612,3301,311,300,225,75,0.897917103058243,0.640909090909091,1.74059157754011,158,73,85,86,1.2,7.67,3,0,0,0,0,0,0,0.312999352865563,148.447932976042,42.356050070279
8.7,"eps_greedy_SVM","SVM",50,3,3512,3270,242,400,256,144,0.900603529535003,0.663636363636364,1.71292743953294,237,116,121,79,1,10.22,1.8,0,0,0,0,0,0,0.527475959631402,202.123775311997,65.3718042544498
8.7,"eps_greedy_SVM","SVM",50,4,3412,3244,168,500,282,218,0.904574256388771,0.65,1.70633608815427,298,148,150,61,1,12.78,1.3,0,0,0,0,0,0,0.397709568799724,186.503068142155,52.7175381949968
8.7,"eps_greedy_SVM","SVM",50,5,3312,3184,128,600,342,258,0.864098502304152,0.668181818181818,1.58824711200402,378,188,190,80,1,15.34,1.3,0,0,0,0,0,0,0.1685736651119,126.412911928124,25.9045608166018
8.7,"eps_greedy_SVM","SVM",50,6,3212,3106,106,700,420,280,0.864241202346042,0.672727272727273,1.58151654796816,443,214,229,65,1.1,17.89,1.5,0,0,0,0,0,0,0.0915700048947582,71.9099232361263,12.0213907008052
8.7,"eps_greedy_SVM","SVM",50,7,3112,3027,85,800,499,301,0.870032991202342,0.686363636363636,1.60020035061357,491,233,258,48,1.1,20.45,1.7,0,0,0,0,0,0,0.0770681882711801,84.0518939528452,10.4989814487957
8.7,"eps_greedy_SVM","SVM",50,8,3012,2949,63,900,577,323,0.871566034771677,0.695454545454545,1.58824711200402,536,256,280,45,1.1,23.01,1.8,0,0,0,0,0,0,0.0718829766777073,112.837558624029,11.4941456140858
8.7,"eps_greedy_SVM","SVM",50,9,2912,2859,53,1000,667,333,0.875845726853793,0.7,1.6083646381167,574,273,301,38,1.1,25.56,2,0,0,0,0,0,0,0.0639199691391482,88.7637773674169,7.24503883487084
8.7,"eps_greedy_SVM","SVM",50,10,2812,2763,49,1100,763,337,0.884069962295763,0.690909090909091,1.61132391067994,586,283,303,12,1.1,28.12,2.3,0,0,0,0,0,0,0.0540084603399728,73.0262653485171,5.91293952901752
8.7,"eps_greedy_SVM","SVM",50,11,2712,2674,38,1200,852,348,0.897055666108088,0.686363636363636,1.63736815670517,623,297,326,37,1.1,30.67,2.4,0,0,0,0,0,0,0.0612505765974755,90.278733935784,7.22562790273748
8.7,"eps_greedy_SVM","SVM",50,12,2612,2576,36,1300,950,350,0.908334206116473,0.686363636363636,1.66039976582755,637,306,331,14,1.1,33.23,2.7,0,0,0,0,0,0,0.048266130744986,67.7539604309183,5.5133850603144
8.7,"eps_greedy_SVM","SVM",50,13,2512,2482,30,1400,1044,356,0.918651811897793,0.686363636363636,1.6721434528774,655,313,342,18,1.1,35.79,2.9,0,0,0,0,0,0,0.0539784747686447,73.2170243896543,6.15842601119918
8.7,"eps_greedy_SVM","SVM",50,14,2412,2390,22,1500,1136,364,0.932614160033523,0.677272727272727,1.74540427314621,684,329,355,29,1.1,38.34,3.1,0,0,0,0,0,0,0.055743496979211,63.0158723892398,6.08583212910105
8.7,"eps_greedy_SVM","SVM",50,15,2312,2291,21,1600,1235,365,0.935910661918738,0.677272727272727,1.76348610067618,683,331,352,-1,1.1,40.9,3.4,0,0,0,0,0,0,0.0492235596423424,53.764546991732,5.33755399830935
8.7,"eps_greedy_SVM","SVM",50,16,2212,2192,20,1700,1334,366,0.936929199832445,0.677272727272727,1.76835760924159,691,334,357,8,1.1,43.46,3.6,0,0,0,0,0,0,0.0432321758737531,45.5180058009462,4.7358742855325
8.7,"eps_greedy_SVM","SVM",50,17,2112,2097,15,1800,1429,371,0.939042207792226,0.677272727272727,1.77327874331551,703,339,364,12,1.1,46.01,3.9,0,0,0,0,0,0,0.0427588715584147,40.5077084088095,5.09734761721704
8.7,"eps_greedy_SVM","SVM",50,18,2012,2001,11,1900,1525,375,0.939686321742791,0.672727272727273,1.77818181818182,714,343,371,11,1.1,48.57,4.1,0,0,0,0,0,0,0.033315346492296,32.8808948460843,3.98167265782933
8.7,"eps_greedy_SVM","SVM",50,19,1912,1902,10,2000,1624,376,0.939251675743628,0.672727272727273,1.77654445002511,720,344,376,6,1.1,51.12,4.3,0,0,0,0,0,0,0.0285764242904458,29.4505897851398,3.13905011646122
8.7,"eps_greedy_SVM","SVM",50,20,1812,1802,10,2100,1724,376,0.938513301214931,0.672727272727273,1.77818181818182,721,347,374,1,1.1,53.68,4.6,0,0,0,0,0,0,0.0233121110908697,21.8892562819557,2.37496650812978
8.7,"eps_greedy_SVM","SVM",50,21,1712,1702,10,2200,1824,376,0.936981566820291,0.668181818181818,1.79291813159216,740,360,380,19,1.1,56.24,4.9,0,0,0,0,0,0,0.014323394378192,9.24487723065671,1.9939366706033
8.7,"eps_greedy_SVM","SVM",50,22,1612,1605,7,2300,1921,379,0.937146522832021,0.668181818181818,1.79126871288785,745,363,382,5,1.1,58.79,5.1,0,0,0,0,0,0,0.00937251383323624,7.85265546334748,1.16016235475479
8.7,"eps_greedy_SVM","SVM",50,23,1512,1505,7,2400,2021,379,0.937180561374125,0.668181818181818,1.79126871288785,745,363,382,0,1.1,61.35,5.3,0,0,0,0,0,0,0.0080240190266759,6.54915132842874,0.840985137522188
8.7,"eps_greedy_SVM","SVM",50,24,1412,1405,7,2500,2121,379,0.937075827398422,0.672727272727273,1.78962232620321,750,365,385,5,1.1,63.91,5.6,0,0,0,0,0,0,0.00513178352370082,3.93573286514906,0.60376636563776
8.7,"eps_greedy_SVM","SVM",50,25,1312,1306,6,2600,2220,380,0.937078445747814,0.672727272727273,1.78470127489376,754,366,388,4,1.1,66.46,5.8,0,0,0,0,0,0,0.00590543326424537,4.20446271544052,0.61056290679226
8.7,"eps_greedy_SVM","SVM",50,26,1212,1207,5,2700,2319,381,0.936872905320496,0.668181818181818,1.78962232620321,767,374,393,13,1.1,69.02,6.1,0,0,0,0,0,0,0.00408390130884253,2.7130973633563,0.482585459556315
8.7,"eps_greedy_SVM","SVM",50,27,1112,1108,4,2800,2418,382,0.936579650188532,0.668181818181818,1.78633861551293,769,375,394,2,1.1,71.57,6.3,0,0,0,0,0,0,0.00361193727641174,2.27492815895407,0.382914529076951
8.7,"eps_greedy_SVM","SVM",50,28,1012,1008,4,2900,2518,382,0.936444805194815,0.663636363636364,1.78962232620321,770,375,395,1,1.1,74.13,6.6,0,0,0,0,0,0,0.00357636004464032,2.10602036019977,0.374851304327065
8.7,"eps_greedy_SVM","SVM",50,29,912,909,3,3000,2617,383,0.936033724340186,0.663636363636364,1.78633861551293,776,378,398,6,1.1,76.69,6.8,0,0,0,0,0,0,0.00291371991023666,1.55357906584275,0.310712163849576
8.7,"eps_greedy_SVM","SVM",50,30,812,809,3,3100,2717,383,0.936012777545045,0.663636363636364,1.78633861551293,775,378,397,-1,1.1,79.24,7.1,0,0,0,0,0,0,0.00234703503548862,1.1053741687238,0.248929378552118
8.7,"eps_greedy_SVM","SVM",50,31,712,709,3,3200,2817,383,0.93603896103897,0.659090909090909,1.79291813159216,778,379,399,3,1.1,81.8,7.4,0,0,0,0,0,0,0.0019076393169065,0.79202029527876,0.205125943175926
8.7,"eps_greedy_SVM","SVM",50,32,612,610,2,3300,2916,384,0.935913280268126,0.659090909090909,1.78797896318557,785,380,405,7,1.1,84.36,7.6,0,0,0,0,0,0,0.00193279252652267,0.758862455665686,0.212988218235393
8.7,"eps_greedy_SVM","SVM",50,33,512,511,1,3400,3015,385,0.935973502304154,0.659090909090909,1.78470127489376,790,382,408,5,1.1,86.91,7.8,0,0,0,0,0,0,0.00131431185665089,0.46916328028977,0.152993342113702
8.7,"eps_greedy_SVM","SVM",50,34,412,412,0,3500,3114,386,0.936579650188529,0.659090909090909,1.78306693306693,795,384,411,5,1.1,89.47,8.1,0,0,0,0,0,0,0.00114785133539487,0.343264345572939,0.129730144154537
8.7,"eps_greedy_SVM","SVM",50,35,312,312,0,3600,3214,386,0.936641181399253,0.659090909090909,1.79457059069962,799,384,415,4,1.1,92.02,8.3,0,0,0,0,0,0,0.00071765541122526,0.179461467961606,0.0849660363123415
8.7,"eps_greedy_SVM","SVM",50,36,212,212,0,3700,3314,386,0.936620234604113,0.659090909090909,1.79126871288785,801,385,416,2,1.1,94.58,8.6,0,0,0,0,0,0,0.000465381930391449,0.0987014306918434,0.0599542567823179
8.7,"eps_greedy_SVM","SVM",50,37,112,112,0,3800,3414,386,0.936507645580233,0.659090909090909,1.79126871288785,799,385,414,-2,1.1,97.14,8.8,0,0,0,0,0,0,0.000263440395992463,0.0410591969457568,0.0381401716426846
8.7,"eps_greedy_SVM","SVM",50,38,12,12,0,3900,3514,386,0.936654273146215,0.659090909090909,1.78633861551293,803,385,418,4,1.1,99.69,9.1,0,0,0,0,0,0,0.000192360531125912,0.00260513303575053,0.00260513303575053
8.7,"eps_greedy_SVM","SVM",50,39,0,0,0,3912,3526,386,0.936647727272734,0.659090909090909,1.79291813159216,804,385,419,1,1.1,100,9.1,0,0,0,0,0,0,0,0,0
8.7,"eps_greedy_SVM","SVM",51,0,3812,3421,391,100,90,10,0.882079926453187,0.492682926829268,1.70603124648758,35,10,25,0,2.5,2.56,9,0,0,0,0,0,0,0.281765652677818,372.651202437565,32.2397542202664
8.7,"eps_greedy_SVM","SVM",51,1,3712,3378,334,200,133,67,0.917801674304587,0.6,1.76596146071958,108,53,55,73,1,5.11,2,0,0,0,0,0,0,0.757955251315456,403.188822555119,82.044917432229
8.7,"eps_greedy_SVM","SVM",51,2,3612,3343,269,300,168,132,0.92584585811592,0.619512195121951,1.79449541284404,169,85,84,61,1,7.67,1.3,0,0,0,0,0,0,0.593779171878366,274.751705695571,70.3460356235031
8.7,"eps_greedy_SVM","SVM",51,3,3512,3306,206,400,205,195,0.918945271691444,0.619512195121951,1.75717558280555,235,119,116,66,1,10.22,1.1,0,0,0,0,0,0,0.370728515512669,172.297288099953,52.8272037412389
8.7,"eps_greedy_SVM","SVM",51,4,3412,3252,160,500,259,241,0.894396233511181,0.619512195121951,1.70446031532139,329,166,163,94,1,12.78,1.1,0,0,0,0,0,0,0.226621475941368,168.131404857412,30.6498230144956
8.7,"eps_greedy_SVM","SVM",51,5,3312,3192,120,600,319,281,0.899254781240004,0.629268292682927,1.69100315796546,415,208,207,86,1,15.34,1.1,0,0,0,0,0,0,0.185137769678977,142.18564212083,26.4585551105385
8.7,"eps_greedy_SVM","SVM",51,6,3212,3103,109,700,408,292,0.91035923723032,0.64390243902439,1.71167006978257,456,222,234,41,1.1,17.89,1.4,0,0,0,0,0,0,0.0814866656250174,64.887459607295,10.6963491341446
8.7,"eps_greedy_SVM","SVM",51,7,3112,3022,90,800,489,311,0.918856124026712,0.658536585365854,1.71728818114627,498,244,254,42,1,20.45,1.6,0,0,0,0,0,0,0.0804759433882585,83.3683975070839,9.8863260487221
8.7,"eps_greedy_SVM","SVM",51,8,3012,2942,70,900,569,331,0.911987575044235,0.673170731707317,1.68688855949333,546,260,286,48,1.1,23.01,1.7,0,0,0,0,0,0,0.0710155091886747,105.062323213505,10.7994529777224
8.7,"eps_greedy_SVM","SVM",51,9,2912,2858,54,1000,653,347,0.910033291081059,0.697560975609756,1.65900329840465,591,283,308,45,1.1,25.56,1.9,0,0,0,0,0,0,0.0699452558092362,112.220736602751,8.90110333468199
8.7,"eps_greedy_SVM","SVM",51,10,2812,2760,52,1100,751,349,0.917084314189821,0.697560975609756,1.69411447932327,605,293,312,14,1.1,28.12,2.2,0,0,0,0,0,0,0.051710728484717,74.2011010287866,5.77068418904264
8.7,"eps_greedy_SVM","SVM",51,11,2712,2662,50,1200,849,351,0.922747976765908,0.697560975609756,1.72044786501223,611,298,313,6,1.1,30.67,2.4,0,0,0,0,0,0,0.0441193688658772,61.6650323428257,4.7784134513686
8.7,"eps_greedy_SVM","SVM",51,12,2612,2568,44,1300,943,357,0.930934239667941,0.707317073170732,1.73081794906347,630,305,325,19,1.1,33.23,2.6,0,0,0,0,0,0,0.0433376236977855,63.7536612615925,5.06225058421075
8.7,"eps_greedy_SVM","SVM",51,13,2512,2475,37,1400,1036,364,0.938699837026927,0.692682926829268,1.75000112397437,656,317,339,26,1.1,35.79,2.8,0,0,0,0,0,0,0.0605715325400496,62.8220085449839,6.79088990167577
8.7,"eps_greedy_SVM","SVM",51,14,2412,2378,34,1500,1133,367,0.941126325026814,0.68780487804878,1.75879509947173,670,320,350,14,1.1,38.34,3.1,0,0,0,0,0,0,0.0507474364525797,50.8716380575198,5.66403105476009
8.7,"eps_greedy_SVM","SVM",51,15,2312,2283,29,1600,1228,372,0.941574849215094,0.682926829268293,1.76109655311429,686,328,358,16,1.1,40.9,3.3,0,0,0,0,0,0,0.0540195134009711,47.1495137099918,6.01628483042314
8.7,"eps_greedy_SVM","SVM",51,16,2212,2189,23,1700,1322,378,0.940527364154291,0.682926829268293,1.76985822750789,704,336,368,18,1.1,43.46,3.5,0,0,0,0,0,0,0.055064743824696,42.637458536438,6.27439276330121
8.7,"eps_greedy_SVM","SVM",51,17,2112,2093,19,1800,1418,382,0.940247384769687,0.68780487804878,1.77474733863361,715,341,374,11,1.1,46.01,3.7,0,0,0,0,0,0,0.0421097707933442,36.0147296321178,5.20653920554842
8.7,"eps_greedy_SVM","SVM",51,18,2012,1998,14,1900,1513,387,0.938988174005105,0.68780487804878,1.76596146071958,732,346,386,17,1.1,48.57,3.9,0,0,0,0,0,0,0.0361780514115371,32.4189898457782,4.19123572363307
8.7,"eps_greedy_SVM","SVM",51,19,1912,1900,12,2000,1611,389,0.938786198827159,0.682926829268293,1.76758907496909,734,349,385,2,1.1,51.12,4.1,0,0,0,0,0,0,0.0311693194370375,30.1017132127932,3.4492824145752
8.7,"eps_greedy_SVM","SVM",51,20,1812,1802,10,2100,1709,391,0.9392792968478,0.68780487804878,1.76758907496909,738,352,386,4,1.1,53.68,4.4,0,0,0,0,0,0,0.0254930785014484,23.3355492003808,2.65750112782948
8.7,"eps_greedy_SVM","SVM",51,21,1712,1702,10,2200,1809,391,0.939803039378202,0.682926829268293,1.77474733863361,748,358,390,10,1.1,56.24,4.6,0,0,0,0,0,0,0.0178133187072047,15.1018356918468,2.15126416524954
8.7,"eps_greedy_SVM","SVM",51,22,1612,1604,8,2300,1907,393,0.940120627933871,0.682926829268293,1.77638305046645,755,361,394,7,1.1,58.79,4.9,0,0,0,0,0,0,0.0175323369627754,13.4803188329207,1.76266118754953
8.7,"eps_greedy_SVM","SVM",51,23,1512,1504,8,2400,2007,393,0.939744536223209,0.673170731707317,1.78353321654763,772,374,398,17,1.1,61.35,5.1,0,0,0,0,0,0,0.0124964465545375,7.7239006990382,1.61601554936097
8.7,"eps_greedy_SVM","SVM",51,24,1412,1407,5,2500,2104,396,0.939702748255358,0.673170731707317,1.78353321654763,780,378,402,8,1.1,63.91,5.3,0,0,0,0,0,0,0.00913962162579507,6.45781614886995,1.0783126884439
8.7,"eps_greedy_SVM","SVM",51,25,1312,1307,5,2600,2204,396,0.939679068406909,0.673170731707317,1.78353321654763,780,378,402,0,1.1,66.46,5.6,0,0,0,0,0,0,0.00883292346220882,5.55459574530626,0.899365958834674
8.7,"eps_greedy_SVM","SVM",51,26,1212,1207,5,2700,2304,396,0.939868507194499,0.663414634146341,1.77698814052361,786,383,403,6,1.1,69.02,5.8,0,0,0,0,0,0,0.00730107643411438,4.25128870758484,0.842323638260918
8.7,"eps_greedy_SVM","SVM",51,27,1112,1107,5,2800,2404,396,0.940014765081978,0.663414634146341,1.78189243161981,786,382,404,0,1.1,71.57,6.1,0,0,0,0,0,0,0.00540615603820017,2.91250428421906,0.564790245367677
8.7,"eps_greedy_SVM","SVM",51,28,1012,1007,5,2900,2504,396,0.939761251410348,0.658536585365854,1.78025466284075,786,385,401,0,1,74.13,6.3,0,0,0,0,0,0,0.00449567539924383,2.10635238383428,0.471881137403627
8.7,"eps_greedy_SVM","SVM",51,29,912,907,5,3000,2604,396,0.939645638032626,0.658536585365854,1.78353321654763,788,385,403,2,1,76.69,6.6,0,0,0,0,0,0,0.00379470162761907,1.54549478735997,0.405522611989896
8.7,"eps_greedy_SVM","SVM",51,30,812,808,4,3100,2703,397,0.940070482372446,0.658536585365854,1.79397100146117,792,388,404,4,1,79.24,6.8,0,0,0,0,0,0,0.00307041313898731,1.12759699420823,0.340389118312443
8.7,"eps_greedy_SVM","SVM",51,31,712,709,3,3200,2802,398,0.94036856987645,0.658536585365854,1.79397100146117,797,389,408,5,1,81.8,7,0,0,0,0,0,0,0.00252551013504598,0.846737730599927,0.287561480995541
8.7,"eps_greedy_SVM","SVM",51,32,612,610,2,3300,2901,399,0.940365784011926,0.653658536585366,1.79397100146117,800,391,409,3,1,84.36,7.3,0,0,0,0,0,0,0.00211618856374484,0.696776356207863,0.255609043021552
8.7,"eps_greedy_SVM","SVM",51,33,512,510,2,3400,3001,399,0.940608154225462,0.653658536585366,1.78517702596381,802,391,411,2,1.1,86.91,7.5,0,0,0,0,0,0,0.0012759664001603,0.401462964446067,0.16158858362135
8.7,"eps_greedy_SVM","SVM",51,34,412,411,1,3500,3100,400,0.940828237522811,0.653658536585366,1.78517702596381,806,393,413,4,1.1,89.47,7.8,0,0,0,0,0,0,0.000987101299193713,0.300345517867639,0.123746916514708
8.7,"eps_greedy_SVM","SVM",51,35,312,312,0,3600,3199,401,0.94091738518756,0.658536585365854,1.78025466284075,812,396,416,6,1.1,92.02,8,0,0,0,0,0,0,0.000956476135584376,0.241569938522482,0.113379333892099
8.7,"eps_greedy_SVM","SVM",51,36,212,212,0,3700,3299,401,0.940956387290888,0.653658536585366,1.78353321654763,815,398,417,3,1,94.58,8.2,0,0,0,0,0,0,0.000499832011031491,0.105167589038912,0.0649203985054125
8.7,"eps_greedy_SVM","SVM",51,37,112,112,0,3800,3399,401,0.940998175258739,0.648780487804878,1.78189243161981,814,399,415,-1,1,97.14,8.5,0,0,0,0,0,0,0.000210603265356729,0.0332254286492601,0.0310550661742485
8.7,"eps_greedy_SVM","SVM",51,38,12,12,0,3900,3499,401,0.940812915267932,0.648780487804878,1.78353321654763,820,400,420,6,1.1,99.69,8.7,0,0,0,0,0,0,0.000140854482357944,0.00191328194335638,0.00191328194335638
8.7,"eps_greedy_SVM","SVM",51,39,0,0,0,3912,3511,401,0.940870025490662,0.648780487804878,1.78353321654763,820,400,420,0,1.1,100,8.8,0,0,0,0,0,0,0,0,0
8.7,"eps_greedy_SVM","SVM",52,0,3812,3410,402,100,89,11,0.906750445983799,0.559585492227979,1.74961104212164,24,11,13,0,1.2,2.56,8.1,0,0,0,0,0,0,0.757039661687439,449.164763787727,80.5137498137845
8.7,"eps_greedy_SVM","SVM",52,1,3712,3369,343,200,130,70,0.911282287904205,0.564766839378238,1.78080089231664,103,51,52,79,1,5.11,1.9,0,0,0,0,0,0,0.732284394657173,303.236616774714,80.5039460302194
8.7,"eps_greedy_SVM","SVM",52,2,3612,3333,279,300,166,134,0.921145362797168,0.559585492227979,1.7714773274354,173,88,85,70,1,7.67,1.2,0,0,0,0,0,0,0.555960563115731,213.876318449313,64.4914363561925
8.7,"eps_greedy_SVM","SVM",52,3,3512,3292,220,400,207,193,0.921333454809439,0.580310880829015,1.79177282225975,243,124,119,70,1,10.22,1.1,0,0,0,0,0,0,0.302660401455497,128.116948839029,51.3584199737124
8.7,"eps_greedy_SVM","SVM",52,4,3412,3241,171,500,258,242,0.901095929865193,0.590673575129534,1.72485950302921,318,160,158,75,1,12.78,1.1,0,0,0,0,0,0,0.175200810083807,85.2058741555887,28.2667498489641
8.7,"eps_greedy_SVM","SVM",52,5,3312,3176,136,600,323,277,0.884676084982322,0.61139896373057,1.67824167862301,399,196,203,81,1,15.34,1.2,0,0,0,0,0,0,0.112269960411953,71.9604228410394,16.7409299109183
8.7,"eps_greedy_SVM","SVM",52,6,3212,3104,108,700,395,305,0.893857326330828,0.637305699481865,1.66265370931926,457,224,233,58,1,17.89,1.3,0,0,0,0,0,0,0.0875168339032721,76.0272779319521,11.721284369058
8.7,"eps_greedy_SVM","SVM",52,7,3112,3021,91,800,478,322,0.896087980038751,0.632124352331606,1.65027098397929,500,241,259,43,1.1,20.45,1.5,0,0,0,0,0,0,0.0640090802107188,73.6844145050641,10.409013278048
8.7,"eps_greedy_SVM","SVM",52,8,3012,2946,66,900,553,347,0.901971733297285,0.642487046632124,1.67978702086852,561,269,292,61,1.1,23.01,1.6,0,0,0,0,0,0,0.0736038237025282,120.550241665005,10.3645012560058
8.7,"eps_greedy_SVM","SVM",52,9,2912,2857,55,1000,642,358,0.914203591969651,0.647668393782383,1.70001671402307,589,284,305,28,1.1,25.56,1.8,0,0,0,0,0,0,0.0677183555777346,107.833953883,7.8296282356381
8.7,"eps_greedy_SVM","SVM",52,10,2812,2766,46,1100,733,367,0.926201805095545,0.652849740932642,1.7325891496495,619,298,321,30,1.1,28.12,2,0,0,0,0,0,0,0.075998747507828,92.1532724767897,8.65558491428564
8.7,"eps_greedy_SVM","SVM",52,11,2712,2670,42,1200,829,371,0.928522096403051,0.647668393782383,1.73737971872687,637,307,330,18,1.1,30.67,2.2,0,0,0,0,0,0,0.0665141585884202,80.156792151177,7.30646970606808
8.7,"eps_greedy_SVM","SVM",52,12,2612,2573,39,1300,926,374,0.929829923675811,0.647668393782383,1.74672046990282,646,314,332,9,1.1,33.23,2.5,0,0,0,0,0,0,0.0487176864489563,51.7623476745264,5.24676140088336
8.7,"eps_greedy_SVM","SVM",52,13,2512,2476,36,1400,1023,377,0.930417711214133,0.647668393782383,1.75444422179601,659,320,339,13,1.1,35.79,2.7,0,0,0,0,0,0,0.0482894935676678,48.1342172940253,5.33730596646991
8.7,"eps_greedy_SVM","SVM",52,14,2412,2380,32,1500,1119,381,0.930138512133436,0.647668393782383,1.75606122107877,671,325,346,12,1.1,38.34,2.9,0,0,0,0,0,0,0.0403238447763364,38.5407714403824,4.6296326998548
8.7,"eps_greedy_SVM","SVM",52,15,2312,2291,21,1600,1208,392,0.929433167087455,0.647668393782383,1.75283019767292,693,333,360,22,1.1,40.9,3.1,0,0,0,0,0,0,0.0418639685769212,41.3573560067038,5.28300125018402
8.7,"eps_greedy_SVM","SVM",52,16,2212,2194,18,1700,1305,395,0.930060630284607,0.652849740932642,1.75444422179601,701,336,365,8,1.1,43.46,3.3,0,0,0,0,0,0,0.0300909742291094,33.7547817083542,3.52334293072752
8.7,"eps_greedy_SVM","SVM",52,17,2112,2096,16,1800,1403,397,0.92953602990666,0.652849740932642,1.74961104212164,711,340,371,10,1.1,46.01,3.5,0,0,0,0,0,0,0.0288964639092197,33.5450856617043,3.09813776273601
8.7,"eps_greedy_SVM","SVM",52,18,2012,1996,16,1900,1503,397,0.927158429314169,0.637305699481865,1.76215376255416,726,347,379,15,1.1,48.57,3.8,0,0,0,0,0,0,0.0193414567608572,18.9874963004242,2.3136055958693
8.7,"eps_greedy_SVM","SVM",52,19,1912,1899,13,2000,1600,400,0.92736121601489,0.637305699481865,1.76215376255416,733,352,381,7,1.1,51.12,4,0,0,0,0,0,0,0.0198868023666147,20.3966350742228,2.14455899558212
8.7,"eps_greedy_SVM","SVM",52,20,1812,1801,11,2100,1698,402,0.927546369089458,0.637305699481865,1.75891748383505,737,354,383,4,1.1,53.68,4.2,0,0,0,0,0,0,0.0177077115991724,17.7628150591356,1.85725338423384
8.7,"eps_greedy_SVM","SVM",52,21,1712,1703,9,2200,1796,404,0.925389188823834,0.637305699481865,1.76215376255416,748,362,386,11,1.1,56.24,4.4,0,0,0,0,0,0,0.0126912584050143,11.0756789493157,1.50950976734489
8.7,"eps_greedy_SVM","SVM",52,22,1612,1604,8,2300,1895,405,0.925450906515359,0.637305699481865,1.76540197225472,753,364,389,5,1.1,58.79,4.7,0,0,0,0,0,0,0.0109194934183209,9.86565401057675,1.17500704535178
8.7,"eps_greedy_SVM","SVM",52,23,1512,1506,6,2400,1993,407,0.925239303001564,0.637305699481865,1.75121914050594,761,367,394,8,1.1,61.35,4.9,0,0,0,0,0,0,0.0107734821458288,9.17005507572195,1.11284755712565
8.7,"eps_greedy_SVM","SVM",52,24,1412,1407,5,2500,2092,408,0.926689668752352,0.626943005181347,1.76053413593417,774,376,398,13,1.1,63.91,5.1,0,0,0,0,0,0,0.00818199550168758,6.04835991937809,0.960374311664439
8.7,"eps_greedy_SVM","SVM",52,25,1312,1308,4,2600,2191,409,0.926287034288607,0.632124352331606,1.75121914050594,776,376,400,2,1.1,66.46,5.4,0,0,0,0,0,0,0.00711420812410136,5.24337110893064,0.763687431200177
8.7,"eps_greedy_SVM","SVM",52,26,1212,1208,4,2700,2291,409,0.926608847965833,0.626943005181347,1.75121914050594,785,378,407,9,1.1,69.02,5.6,0,0,0,0,0,0,0.00621891982294875,4.08278493926518,0.643898516419149
8.7,"eps_greedy_SVM","SVM",52,27,1112,1109,3,2800,2390,410,0.927505223961762,0.626943005181347,1.76377637191195,793,384,409,8,1.1,71.57,5.8,0,0,0,0,0,0,0.00560697258982703,3.27618192691974,0.581664278028323
8.7,"eps_greedy_SVM","SVM",52,28,1012,1009,3,2900,2490,410,0.927966637179338,0.621761658031088,1.76215376255416,790,387,403,-3,1,74.13,6.1,0,0,0,0,0,0,0.00447051054551921,2.27575061483071,0.471971355861601
8.7,"eps_greedy_SVM","SVM",52,29,912,909,3,3000,2590,410,0.928460378711518,0.621761658031088,1.76215376255416,791,387,404,1,1,76.69,6.3,0,0,0,0,0,0,0.00410154728689331,1.78026588642088,0.426470902052693
8.7,"eps_greedy_SVM","SVM",52,30,812,809,3,3100,2690,410,0.928863013175263,0.621761658031088,1.76540197225472,793,388,405,2,1,79.24,6.6,0,0,0,0,0,0,0.00305282003223351,1.13766878509004,0.331108987856311
8.7,"eps_greedy_SVM","SVM",52,31,712,709,3,3200,2790,410,0.92901289899753,0.626943005181347,1.75891748383505,794,389,405,1,1,81.8,6.8,0,0,0,0,0,0,0.00234535356556546,0.760423323028984,0.265273835079069
8.7,"eps_greedy_SVM","SVM",52,32,612,611,1,3300,2888,412,0.929988626311133,0.621761658031088,1.76215376255416,804,394,410,10,1,84.36,7,0,0,0,0,0,0,0.00204504073217454,0.655116427980286,0.252594173556303
8.7,"eps_greedy_SVM","SVM",52,33,512,511,1,3400,2988,412,0.930520574033304,0.616580310880829,1.76377637191195,807,395,412,3,1,86.91,7.3,0,0,0,0,0,0,0.001188027049836,0.393485019772048,0.159456571957602
8.7,"eps_greedy_SVM","SVM",52,34,412,411,1,3500,3088,412,0.930870307618599,0.616580310880829,1.76377637191195,811,395,416,4,1.1,89.47,7.5,0,0,0,0,0,0,0.000684824529506638,0.19724246284915,0.0852064536090219
8.7,"eps_greedy_SVM","SVM",52,35,312,312,0,3600,3187,413,0.931317026147718,0.626943005181347,1.76215376255416,813,397,416,2,1,92.02,7.7,0,0,0,0,0,0,0.000625084074392291,0.159146571593493,0.0775876429174001
8.7,"eps_greedy_SVM","SVM",52,36,212,212,0,3700,3287,413,0.931437522593072,0.626943005181347,1.76215376255416,818,400,418,5,1,94.58,8,0,0,0,0,0,0,0.000334929735809498,0.0693060393331884,0.0426358267073901
8.7,"eps_greedy_SVM","SVM",52,37,112,112,0,3800,3387,413,0.931503648691134,0.626943005181347,1.76377637191195,822,402,420,4,1,97.14,8.2,0,0,0,0,0,0,0.00016129372705426,0.0265325835521499,0.024785121915716
8.7,"eps_greedy_SVM","SVM",52,38,12,12,0,3900,3487,413,0.931531568599207,0.626943005181347,1.76377637191195,822,403,419,0,1,99.69,8.4,0,0,0,0,0,0,0.000114915610338313,0.00161081123342045,0.00161081123342045
8.7,"eps_greedy_SVM","SVM",52,39,0,0,0,3912,3499,413,0.931516873910749,0.626943005181347,1.76215376255416,821,403,418,-1,1,100,8.5,0,0,0,0,0,0,0,0,0
8.7,"eps_greedy_SVM","SVM",53,0,3812,3416,396,100,83,17,0.909802532776505,0.533678756476684,1.75121914050594,38,17,21,0,1.2,2.56,4.9,0,0,0,0,0,0,0.918703796895496,718.127182779799,94.1830576139833
8.7,"eps_greedy_SVM","SVM",53,1,3712,3366,346,200,133,67,0.92965064847662,0.626943005181347,1.78683680897529,111,54,57,73,1.1,5.11,2,0,0,0,0,0,0,0.697223622812571,525.551459627339,75.9074647192342
8.7,"eps_greedy_SVM","SVM",53,2,3612,3336,276,300,163,137,0.927458200958666,0.642487046632124,1.75891748383505,164,84,80,53,1,7.67,1.2,0,0,0,0,0,0,0.618546784977284,441.432349281164,69.4473195533607
8.7,"eps_greedy_SVM","SVM",53,3,3512,3298,214,400,201,199,0.929377327271294,0.647668393782383,1.76822392554847,239,118,121,75,1,10.22,1,0,0,0,0,0,0,0.546237167728824,327.91595954759,63.7039364072301
8.7,"eps_greedy_SVM","SVM",53,4,3412,3240,172,500,259,241,0.90322519022273,0.658031088082902,1.7264477714482,321,159,162,82,1,12.78,1.1,0,0,0,0,0,0,0.314002750436427,246.589257835768,44.1934113185869
8.7,"eps_greedy_SVM","SVM",53,5,3312,3186,126,600,313,287,0.88556952204056,0.658031088082902,1.62230028933558,423,213,210,102,1,15.34,1.1,0,0,0,0,0,0,0.184650136083828,197.249577736043,26.4441663242352
8.7,"eps_greedy_SVM","SVM",53,6,3212,3118,94,700,381,319,0.892346712357352,0.678756476683938,1.63793374156068,501,245,256,78,1,17.89,1.2,0,0,0,0,0,0,0.128026179132111,189.801879124979,17.3209108423373
8.7,"eps_greedy_SVM","SVM",53,7,3112,3037,75,800,462,338,0.891150564716868,0.678756476683938,1.64245842040477,553,265,288,52,1.1,20.45,1.4,0,0,0,0,0,0,0.110977946968122,185.186499136423,13.1411621586742
8.7,"eps_greedy_SVM","SVM",53,8,3012,2950,62,900,549,351,0.901128258179795,0.683937823834197,1.66738418165194,595,283,312,42,1.1,23.01,1.6,0,0,0,0,0,0,0.0778475322429898,121.351461935928,10.6183623777922
8.7,"eps_greedy_SVM","SVM",53,9,2912,2861,51,1000,638,362,0.911379272848047,0.673575129533679,1.67830139038346,618,298,320,23,1.1,25.56,1.8,0,0,0,0,0,0,0.0819942048717485,129.622668400792,9.4243790451785
8.7,"eps_greedy_SVM","SVM",53,10,2812,2767,45,1100,732,368,0.917803790641853,0.678756476683938,1.68601417250838,642,307,335,24,1.1,28.12,2,0,0,0,0,0,0,0.0623074551276679,92.5094214825072,6.88425875037724
8.7,"eps_greedy_SVM","SVM",53,11,2712,2673,39,1200,826,374,0.923624356740029,0.678756476683938,1.68601417250838,665,319,346,23,1.1,30.67,2.2,0,0,0,0,0,0,0.0614923962486785,84.5606328239321,6.78336273326475
8.7,"eps_greedy_SVM","SVM",53,12,2612,2576,36,1300,923,377,0.926561824962757,0.66839378238342,1.7216917169814,669,321,348,4,1.1,33.23,2.4,0,0,0,0,0,0,0.0525008003432253,66.479957917802,5.62900845479137
8.7,"eps_greedy_SVM","SVM",53,13,2512,2480,32,1400,1019,381,0.930934964247837,0.673575129533679,1.74350663279168,680,327,353,11,1.1,35.79,2.7,0,0,0,0,0,0,0.0566180216212974,69.0810108112126,6.07268298948249
8.7,"eps_greedy_SVM","SVM",53,14,2412,2384,28,1500,1115,385,0.933236152460342,0.673575129533679,1.75606122107877,696,334,362,16,1.1,38.34,2.9,0,0,0,0,0,0,0.0456479831695707,52.6822238161328,5.18067021690188
8.7,"eps_greedy_SVM","SVM",53,15,2312,2288,24,1600,1211,389,0.934173673583948,0.66839378238342,1.7325891496495,706,338,368,10,1.1,40.9,3.1,0,0,0,0,0,0,0.0409898619092286,48.3691189355107,4.63411926653199
8.7,"eps_greedy_SVM","SVM",53,16,2212,2194,18,1700,1305,395,0.936801083880226,0.66839378238342,1.74672046990282,723,346,377,17,1.1,43.46,3.3,0,0,0,0,0,0,0.0396162587345794,46.4801839506137,4.39555453654718
8.7,"eps_greedy_SVM","SVM",53,17,2112,2100,12,1800,1399,401,0.938097155402214,0.678756476683938,1.74672046990282,735,354,381,12,1.1,46.01,3.5,0,0,0,0,0,0,0.0371530144821567,42.6292319860482,4.0554889279626
8.7,"eps_greedy_SVM","SVM",53,18,2012,2000,12,1900,1499,401,0.938599713747479,0.678756476683938,1.75606122107877,739,354,385,4,1.1,48.57,3.7,0,0,0,0,0,0,0.0318284750026095,33.1000741112485,3.23114918194427
8.7,"eps_greedy_SVM","SVM",53,19,1912,1901,11,2000,1598,402,0.939396165861894,0.663212435233161,1.77474272343067,763,370,393,24,1.1,51.12,4,0,0,0,0,0,0,0.0251849790484009,18.3616999284724,3.28787603202715
8.7,"eps_greedy_SVM","SVM",53,20,1812,1801,11,2100,1698,402,0.939325631357296,0.663212435233161,1.7714773274354,763,370,393,0,1.1,53.68,4.2,0,0,0,0,0,0,0.015656592792973,12.5662700024266,1.83617090299995
8.7,"eps_greedy_SVM","SVM",53,21,1712,1701,11,2200,1798,402,0.939155172971185,0.663212435233161,1.7714773274354,763,370,393,0,1.1,56.24,4.5,0,0,0,0,0,0,0.0125254341211021,10.9436645977897,1.36796157016931
8.7,"eps_greedy_SVM","SVM",53,22,1612,1603,9,2300,1896,404,0.939484333992642,0.66839378238342,1.7714773274354,771,373,398,8,1.1,58.79,4.7,0,0,0,0,0,0,0.0122438214641105,10.108817640751,1.26039025018403
8.7,"eps_greedy_SVM","SVM",53,23,1512,1504,8,2400,1995,405,0.93919484863002,0.663212435233161,1.77310852202788,784,380,404,13,1.1,61.35,4.9,0,0,0,0,0,0,0.00890741653115546,6.51019564646822,1.05020369283356
8.7,"eps_greedy_SVM","SVM",53,24,1412,1406,6,2500,2093,407,0.93946816983534,0.66839378238342,1.77310852202788,791,381,410,7,1.1,63.91,5.1,0,0,0,0,0,0,0.00822406160194854,5.9033434192565,0.856384620439377
8.7,"eps_greedy_SVM","SVM",53,25,1312,1308,4,2600,2191,409,0.939816433951791,0.652849740932642,1.7714773274354,798,390,408,7,1,66.46,5.4,0,0,0,0,0,0,0.00697769457143442,4.54625678316923,0.730699653941644
8.7,"eps_greedy_SVM","SVM",53,26,1212,1208,4,2700,2291,409,0.940007464901744,0.647668393782383,1.77474272343067,800,392,408,2,1,69.02,5.6,0,0,0,0,0,0,0.00635885987773648,3.74482397019917,0.667075513748927
8.7,"eps_greedy_SVM","SVM",53,27,1112,1108,4,2800,2391,409,0.940089755157108,0.647668393782383,1.77474272343067,804,392,412,4,1.1,71.57,5.8,0,0,0,0,0,0,0.00575456633033555,2.97803461086262,0.597159405845696
8.7,"eps_greedy_SVM","SVM",53,28,1012,1009,3,2900,2490,410,0.940033915340967,0.647668393782383,1.77474272343067,812,395,417,8,1.1,74.13,6.1,0,0,0,0,0,0,0.00522620330563834,2.37089130031604,0.552349808681975
8.7,"eps_greedy_SVM","SVM",53,29,912,910,2,3000,2589,411,0.940451244493172,0.647668393782383,1.77474272343067,818,396,422,6,1.1,76.69,6.3,0,0,0,0,0,0,0.00480799238838252,2.06128752092297,0.522271706955849
8.7,"eps_greedy_SVM","SVM",53,30,812,810,2,3100,2689,411,0.940583496689293,0.647668393782383,1.77474272343067,818,397,421,0,1.1,79.24,6.5,0,0,0,0,0,0,0.00382465179025189,1.44060291694846,0.418082088950494
8.7,"eps_greedy_SVM","SVM",53,31,712,710,2,3200,2789,411,0.940468878119322,0.647668393782383,1.77474272343067,817,397,420,-1,1.1,81.8,6.8,0,0,0,0,0,0,0.00291616478348259,0.99123080046203,0.329442583884797
8.7,"eps_greedy_SVM","SVM",53,32,612,610,2,3300,2889,411,0.940580557751603,0.647668393782383,1.77474272343067,817,397,420,0,1.1,84.36,7,0,0,0,0,0,0,0.00194345857527133,0.658102850598349,0.246325182872505
8.7,"eps_greedy_SVM","SVM",53,33,512,510,2,3400,2989,411,0.940649622787356,0.647668393782383,1.77310852202788,818,399,419,1,1.1,86.91,7.3,0,0,0,0,0,0,0.00124289224345587,0.390868177649258,0.153057931271933
8.7,"eps_greedy_SVM","SVM",53,34,412,412,0,3500,3087,413,0.940821550642317,0.652849740932642,1.76822392554847,833,403,430,15,1.1,89.47,7.5,0,0,0,0,0,0,0.00124942307713058,0.374921515665764,0.150602564049155
8.7,"eps_greedy_SVM","SVM",53,35,312,312,0,3600,3187,413,0.941268269171438,0.652849740932642,1.76984913136239,836,405,431,3,1.1,92.02,7.7,0,0,0,0,0,0,0.000811236892108032,0.202313170034439,0.0971478080444784
8.7,"eps_greedy_SVM","SVM",53,36,212,212,0,3700,3287,413,0.941672373104033,0.652849740932642,1.76984913136239,839,405,434,3,1.1,94.58,8,0,0,0,0,0,0,0.000412302677372198,0.0857773579892369,0.0541146966719746
8.7,"eps_greedy_SVM","SVM",53,37,112,112,0,3800,3387,413,0.942155828354301,0.652849740932642,1.77474272343067,841,407,434,2,1.1,97.14,8.2,0,0,0,0,0,0,0.000157685254006816,0.0252867128650706,0.023589777583587
8.7,"eps_greedy_SVM","SVM",53,38,12,12,0,3900,3487,413,0.942135255790459,0.658031088082902,1.76822392554847,840,408,432,-1,1.1,99.69,8.4,0,0,0,0,0,0,0.000106557073729531,0.00149236060152037,0.00149236060152037
8.7,"eps_greedy_SVM","SVM",53,39,0,0,0,3912,3499,413,0.942113213757772,0.658031088082902,1.77310852202788,840,408,432,0,1.1,100,8.5,0,0,0,0,0,0,0,0,0
8.7,"eps_greedy_SVM","SVM",54,0,3812,3414,398,100,92,8,0.864161446469255,0.515,1.67785321100917,22,8,14,0,1.8,2.56,11.5,0,0,0,0,0,0,0.5,297.763357953031,58.0653463763868
8.7,"eps_greedy_SVM","SVM",54,1,3712,3387,325,200,119,81,0.897313496583147,0.545,1.73487132352941,91,47,44,69,0.9,5.11,1.5,0,0,0,0,0,0,0.735239973649291,312.065361274956,81.0391762736081
8.7,"eps_greedy_SVM","SVM",54,2,3612,3357,255,300,149,151,0.892568337129859,0.545,1.74066055045872,140,71,69,49,1,7.67,1,0,0,0,0,0,0,0.561886044410604,249.211234877521,67.0904438774233
8.7,"eps_greedy_SVM","SVM",54,3,3512,3303,209,400,203,197,0.87871298405469,0.56,1.67939393939394,224,114,110,84,1,10.22,1,0,0,0,0,0,0,0.30066032594241,119.329369754047,45.0070221402976
8.7,"eps_greedy_SVM","SVM",54,4,3412,3265,147,500,241,259,0.889723804100247,0.58,1.70947562097516,316,161,155,92,1,12.78,0.9,0,0,0,0,0,0,0.203210980402478,95.1600883491052,32.8361901303896
8.7,"eps_greedy_SVM","SVM",54,5,3312,3190,122,600,316,284,0.867779043280178,0.58,1.61950321987121,379,188,191,63,1,15.34,1.1,0,0,0,0,0,0,0.108512241419573,73.0486935134958,16.7864265021281
8.7,"eps_greedy_SVM","SVM",54,6,3212,3110,102,700,396,304,0.87219248291571,0.61,1.62099447513812,437,209,228,58,1.1,17.89,1.3,0,0,0,0,0,0,0.0737313415369915,62.1081766651949,9.62599864164607
8.7,"eps_greedy_SVM","SVM",54,7,3112,3032,80,800,474,326,0.870427107061504,0.615,1.61347465437788,489,234,255,52,1.1,20.45,1.5,0,0,0,0,0,0,0.0717721601563032,101.74130195537,10.0726361908115
8.7,"eps_greedy_SVM","SVM",54,8,3012,2944,68,900,562,338,0.875313211845099,0.62,1.61050597976081,519,248,271,30,1.1,23.01,1.7,0,0,0,0,0,0,0.0605200991464529,95.1263014547107,7.03658259629979
8.7,"eps_greedy_SVM","SVM",54,9,2912,2857,55,1000,649,351,0.883291571753991,0.62,1.637497700092,553,263,290,34,1.1,25.56,1.8,0,0,0,0,0,0,0.0702155524553904,112.076372557304,8.38573016966457
8.7,"eps_greedy_SVM","SVM",54,10,2812,2763,49,1100,743,357,0.912135535307525,0.605,1.70477064220183,590,288,302,37,1,28.12,2.1,0,0,0,0,0,0,0.046304261933844,42.372530850062,6.14709791367521
8.7,"eps_greedy_SVM","SVM",54,11,2712,2669,43,1200,837,363,0.91504982915719,0.61,1.71374311926606,606,293,313,16,1.1,30.67,2.3,0,0,0,0,0,0,0.0376949073424589,46.845500537034,4.35626557685149
8.7,"eps_greedy_SVM","SVM",54,12,2612,2572,40,1300,934,366,0.917961275626435,0.615,1.72429752066116,614,297,317,8,1.1,33.23,2.6,0,0,0,0,0,0,0.0347720021709316,44.1095039568836,3.97021642379639
8.7,"eps_greedy_SVM","SVM",54,13,2512,2483,29,1400,1023,377,0.921828018223264,0.615,1.71847286108556,644,312,332,30,1.1,35.79,2.7,0,0,0,0,0,0,0.0666333941466303,53.6733495458872,7.74966059033337
8.7,"eps_greedy_SVM","SVM",54,14,2412,2386,26,1500,1120,380,0.922488610478387,0.61,1.73065437788018,659,317,342,15,1.1,38.34,2.9,0,0,0,0,0,0,0.052069831110652,37.6578180319471,5.78428754913667
8.7,"eps_greedy_SVM","SVM",54,15,2312,2288,24,1600,1218,382,0.922081435079754,0.61,1.73646734130635,665,322,343,6,1.1,40.9,3.2,0,0,0,0,0,0,0.0422210018226796,29.3723078803441,4.71609390218573
8.7,"eps_greedy_SVM","SVM",54,16,2212,2196,16,1700,1310,390,0.92052534168567,0.605,1.72906077348066,684,330,354,19,1.1,43.46,3.4,0,0,0,0,0,0,0.0436076747814812,30.8410659723692,5.69668340221101
8.7,"eps_greedy_SVM","SVM",54,17,2112,2102,10,1800,1404,396,0.920027050113915,0.605,1.72588235294118,704,337,367,20,1.1,46.01,3.5,0,0,0,0,0,0,0.0251966423907529,22.6705469830687,3.66193088244012
8.7,"eps_greedy_SVM","SVM",54,18,2012,2003,9,1900,1503,397,0.919923120728951,0.605,1.73065437788018,704,338,366,0,1.1,48.57,3.8,0,0,0,0,0,0,0.0192189827541255,19.1384322650035,2.12147747038563
8.7,"eps_greedy_SVM","SVM",54,19,1912,1903,9,2000,1603,397,0.919869020501158,0.6,1.73065437788018,707,339,368,3,1.1,51.12,4,0,0,0,0,0,0,0.0151576689905773,14.0769393605833,1.60300841074584
8.7,"eps_greedy_SVM","SVM",54,20,1812,1803,9,2100,1703,397,0.920367312072914,0.6,1.76022038567493,716,349,367,9,1.1,53.68,4.3,0,0,0,0,0,0,0.0103947809416538,9.0523246877171,1.34362324677491
8.7,"eps_greedy_SVM","SVM",54,21,1712,1704,8,2200,1802,398,0.920193621867904,0.6,1.76022038567493,717,351,366,1,1,56.24,4.5,0,0,0,0,0,0,0.0100024498851599,8.13587162155315,1.01492371404897
8.7,"eps_greedy_SVM","SVM",54,22,1612,1604,8,2300,1902,398,0.918082289293866,0.585,1.76508287292818,744,361,383,27,1.1,58.79,4.8,0,0,0,0,0,0,0.00723793645234312,4.86602228385296,0.882644406676238
8.7,"eps_greedy_SVM","SVM",54,23,1512,1506,6,2400,2000,400,0.918741457858789,0.585,1.76345906163753,745,362,383,1,1.1,61.35,5,0,0,0,0,0,0,0.00544093337832046,4.09848470887581,0.617244760806143
8.7,"eps_greedy_SVM","SVM",54,24,1412,1407,5,2500,2099,401,0.918260250569494,0.585,1.76345906163753,749,364,385,4,1.1,63.91,5.2,0,0,0,0,0,0,0.00581837625464376,3.60448695914799,0.597724951362104
8.7,"eps_greedy_SVM","SVM",54,25,1312,1307,5,2600,2199,401,0.918758542141248,0.58,1.75860550458716,760,370,390,11,1.1,66.46,5.5,0,0,0,0,0,0,0.00395746144045993,2.3946104629864,0.466886829949741
8.7,"eps_greedy_SVM","SVM",54,26,1212,1208,4,2700,2298,402,0.919094533029629,0.585,1.76345906163753,760,372,388,0,1,69.02,5.7,0,0,0,0,0,0,0.00403954580743492,2.16998069204839,0.42235871366879
8.7,"eps_greedy_SVM","SVM",54,27,1112,1108,4,2800,2398,402,0.919191343963569,0.585,1.76022038567493,766,374,392,6,1,71.57,6,0,0,0,0,0,0,0.00342100647742697,1.63824855904518,0.365836847044788
8.7,"eps_greedy_SVM","SVM",54,28,1012,1009,3,2900,2497,403,0.919420558086576,0.585,1.76508287292818,768,375,393,2,1,74.13,6.2,0,0,0,0,0,0,0.00292020344106968,1.28732081629734,0.31733981501514
8.7,"eps_greedy_SVM","SVM",54,29,912,909,3,3000,2597,403,0.919655466970402,0.585,1.76670967741935,769,376,393,1,1,76.69,6.4,0,0,0,0,0,0,0.00265335542555511,1.0258618569845,0.285753084301033
8.7,"eps_greedy_SVM","SVM",54,30,812,810,2,3100,2696,404,0.919696753986348,0.585,1.77408839779006,774,377,397,5,1.1,79.24,6.7,0,0,0,0,0,0,0.00237715345820329,0.865753674865766,0.266408647287604
8.7,"eps_greedy_SVM","SVM",54,31,712,710,2,3200,2796,404,0.919804954441928,0.585,1.77408839779006,775,378,397,1,1.1,81.8,6.9,0,0,0,0,0,0,0.001929911029131,0.621189656811456,0.218438686240203
8.7,"eps_greedy_SVM","SVM",54,32,612,610,2,3300,2896,404,0.919928815489764,0.585,1.77572350230415,773,378,395,-2,1,84.36,7.2,0,0,0,0,0,0,0.00109616191531296,0.353036239724579,0.143209516325001
8.7,"eps_greedy_SVM","SVM",54,33,512,510,2,3400,2996,404,0.919984339407759,0.585,1.77408839779006,775,379,396,2,1,86.91,7.4,0,0,0,0,0,0,0.000675286948855091,0.2131949086981,0.0880069171872533
8.7,"eps_greedy_SVM","SVM",54,34,412,412,0,3500,3094,406,0.920503986332586,0.585,1.77572350230415,784,384,400,9,1,89.47,7.6,0,0,0,0,0,0,0.000641409721686778,0.200960358118815,0.0815351543007738
8.7,"eps_greedy_SVM","SVM",54,35,312,312,0,3600,3194,406,0.920535307517095,0.585,1.77245630174793,787,385,402,3,1,92.02,7.9,0,0,0,0,0,0,0.000429719187790749,0.111618880901456,0.0526789885885954
8.7,"eps_greedy_SVM","SVM",54,36,212,212,0,3700,3294,406,0.920797266514816,0.585,1.77572350230415,790,387,403,3,1,94.58,8.1,0,0,0,0,0,0,0.000257118962212658,0.0532370143327524,0.0329464291275832
8.7,"eps_greedy_SVM","SVM",54,37,112,112,0,3800,3394,406,0.921205865603653,0.585,1.77408839779006,797,390,407,7,1,97.14,8.4,0,0,0,0,0,0,0.000122723681526016,0.021793986681822,0.0204940981680796
8.7,"eps_greedy_SVM","SVM",54,38,12,12,0,3900,3494,406,0.921267084282469,0.585,1.76920110192837,804,391,413,7,1.1,99.69,8.6,0,0,0,0,0,0,8.42989548164727e-05,0.00119532362284165,0.00119532362284165
8.7,"eps_greedy_SVM","SVM",54,39,0,0,0,3912,3506,406,0.921210136674269,0.585,1.77245630174793,804,391,413,0,1.1,100,8.6,0,0,0,0,0,0,0,0,0
8.7,"eps_greedy_SVM","SVM",55,0,3812,3396,416,100,91,9,0.876347365963746,0.513812154696133,1.7183336041599,25,9,16,0,1.8,2.56,10.1,0,0,0,0,0,0,0.422029551268737,372.041256197126,50.5409237027617
8.7,"eps_greedy_SVM","SVM",55,1,3712,3329,383,200,158,42,0.886976888958055,0.580110497237569,1.70159641036598,98,42,56,73,1.3,5.11,3.8,0,0,0,0,0,0,0.500137432493811,342.754921954054,61.3838915185655
8.7,"eps_greedy_SVM","SVM",55,2,3612,3292,320,300,195,105,0.872059761886239,0.607734806629834,1.64189127316016,176,85,91,78,1.1,7.67,1.9,0,0,0,0,0,0,0.609708419649117,231.652972496132,71.9702611440426
8.7,"eps_greedy_SVM","SVM",55,3,3512,3264,248,400,223,177,0.88251186678079,0.613259668508287,1.67020589894636,233,116,117,57,1,10.22,1.3,0,0,0,0,0,0,0.41863473492878,176.691508955037,61.5550066132511
8.7,"eps_greedy_SVM","SVM",55,4,3412,3232,180,500,255,245,0.864433896194859,0.624309392265193,1.59213699215531,306,156,150,73,1,12.78,1,0,0,0,0,0,0,0.2471039942068,109.136645908878,40.4173886107782
8.7,"eps_greedy_SVM","SVM",55,5,3312,3180,132,600,307,293,0.88342852696288,0.61878453038674,1.64189127316016,385,193,192,79,1,15.34,1,0,0,0,0,0,0,0.190310819074691,109.145337275105,27.0326552088754
8.7,"eps_greedy_SVM","SVM",55,6,3212,3104,108,700,383,317,0.864907011127543,0.657458563535912,1.58073058293138,457,224,233,72,1,17.89,1.2,0,0,0,0,0,0,0.102417128846201,76.1520156791899,15.1395819392979
8.7,"eps_greedy_SVM","SVM",55,7,3112,3016,96,800,471,329,0.869809353357723,0.657458563535912,1.60356442701836,494,238,256,37,1.1,20.45,1.4,0,0,0,0,0,0,0.0652537767777494,57.9585775508853,8.20499418407542
8.7,"eps_greedy_SVM","SVM",55,8,3012,2943,69,900,544,356,0.86942961637227,0.651933701657459,1.58218613595434,553,268,285,59,1.1,23.01,1.5,0,0,0,0,0,0,0.0668831064299837,101.667388328959,11.7137315632321
8.7,"eps_greedy_SVM","SVM",55,9,2912,2857,55,1000,630,370,0.875685938837447,0.646408839779006,1.62049739004915,598,286,312,45,1.1,25.56,1.7,0,0,0,0,0,0,0.0552834322107945,77.9767790041582,6.29304425104138
8.7,"eps_greedy_SVM","SVM",55,10,2812,2769,43,1100,718,382,0.882978756517005,0.646408839779006,1.61752126995723,625,302,323,27,1.1,28.12,1.9,0,0,0,0,0,0,0.0593303963966222,87.2317945353082,6.35042088655722
8.7,"eps_greedy_SVM","SVM",55,11,2712,2672,40,1200,815,385,0.892767877986148,0.640883977900553,1.64038079360803,636,309,327,11,1.1,30.67,2.1,0,0,0,0,0,0,0.0487738472756175,68.8891555631797,5.40260797953578
8.7,"eps_greedy_SVM","SVM",55,12,2612,2577,35,1300,910,390,0.894826861722829,0.635359116022099,1.65873821904452,649,316,333,13,1.1,33.23,2.3,0,0,0,0,0,0,0.0503195929397145,73.5269644678866,5.3947015163541
8.7,"eps_greedy_SVM","SVM",55,13,2512,2479,33,1400,1008,392,0.924043265115567,0.629834254143646,1.74332433623165,684,334,350,35,1,35.79,2.6,0,0,0,0,0,0,0.041616034437628,36.8516653431585,5.04301293966436
8.7,"eps_greedy_SVM","SVM",55,14,2412,2383,29,1500,1104,396,0.924908567426669,0.629834254143646,1.74332433623165,696,338,358,12,1.1,38.34,2.8,0,0,0,0,0,0,0.0297448034084086,29.8750998024489,3.31726814996229
8.7,"eps_greedy_SVM","SVM",55,15,2312,2286,26,1600,1201,399,0.930713563146838,0.629834254143646,1.75322958814206,703,341,362,7,1.1,40.9,3,0,0,0,0,0,0,0.0301931563838257,32.2495451658367,3.53036124520221
8.7,"eps_greedy_SVM","SVM",55,16,2212,2192,20,1700,1295,405,0.935236168391569,0.624309392265193,1.78950632029967,725,352,373,22,1.1,43.46,3.2,0,0,0,0,0,0,0.0583741798963401,39.0430192502916,6.56771492266946
8.7,"eps_greedy_SVM","SVM",55,17,2112,2094,18,1800,1393,407,0.934931133763912,0.629834254143646,1.78458107354656,737,355,382,12,1.1,46.01,3.4,0,0,0,0,0,0,0.0465336023302471,29.8476796070266,5.22037836269225
8.7,"eps_greedy_SVM","SVM",55,18,2012,1997,15,1900,1490,410,0.934349077892773,0.61878453038674,1.78786155346116,748,360,388,11,1.1,48.57,3.6,0,0,0,0,0,0,0.0373834405725237,22.2666708053433,4.48709142503201
8.7,"eps_greedy_SVM","SVM",55,19,1912,1900,12,2000,1587,413,0.934717920784379,0.624309392265193,1.78786155346116,759,366,393,11,1.1,51.12,3.8,0,0,0,0,0,0,0.024404939500953,18.1233562828679,3.43401375431697
8.7,"eps_greedy_SVM","SVM",55,20,1812,1805,7,2100,1682,418,0.93485643140612,0.61878453038674,1.79280494946152,767,371,396,8,1.1,53.68,4,0,0,0,0,0,0,0.0186262070450058,15.7869129048505,2.28579303167012
8.7,"eps_greedy_SVM","SVM",55,21,1712,1706,6,2200,1781,419,0.934517158197809,0.61878453038674,1.79280494946152,763,371,392,-4,1.1,56.24,4.3,0,0,0,0,0,0,0.0149303752861338,13.2624422051809,1.6696772938769
8.7,"eps_greedy_SVM","SVM",55,22,1612,1606,6,2300,1881,419,0.934467356625947,0.61878453038674,1.79280494946152,765,372,393,2,1.1,58.79,4.5,0,0,0,0,0,0,0.0117362730244983,10.4096697330044,1.25977093570411
8.7,"eps_greedy_SVM","SVM",55,23,1512,1506,6,2400,1981,419,0.93447358182243,0.624309392265193,1.79280494946152,766,372,394,1,1.1,61.35,4.7,0,0,0,0,0,0,0.0105629792055985,8.95198039321005,1.08388758354323
8.7,"eps_greedy_SVM","SVM",55,24,1412,1406,6,2500,2081,419,0.934401992062877,0.624309392265193,1.78458107354656,777,378,399,11,1.1,63.91,5,0,0,0,0,0,0,0.00674016925460339,5.28016115030929,0.833429398850809
8.7,"eps_greedy_SVM","SVM",55,25,1312,1307,5,2600,2180,420,0.93463388063186,0.624309392265193,1.78131261004189,782,380,402,5,1.1,66.46,5.2,0,0,0,0,0,0,0.00657562706396339,4.94741984036618,0.680609850923314
8.7,"eps_greedy_SVM","SVM",55,26,1212,1207,5,2700,2280,420,0.935058750291808,0.624309392265193,1.78950632029967,794,386,408,12,1.1,69.02,5.4,0,0,0,0,0,0,0.00484646794246168,3.30064354662166,0.571440124503367
8.7,"eps_greedy_SVM","SVM",55,27,1112,1107,5,2800,2380,420,0.935183254221464,0.624309392265193,1.79779411764706,795,386,409,1,1.1,71.57,5.7,0,0,0,0,0,0,0.00459974284180936,2.847951188154,0.470997325752764
8.7,"eps_greedy_SVM","SVM",55,28,1012,1007,5,2900,2480,420,0.935217492802118,0.61878453038674,1.78950632029967,802,393,409,7,1,74.13,5.9,0,0,0,0,0,0,0.00310639783922719,1.74324625877396,0.351271000249918
8.7,"eps_greedy_SVM","SVM",55,29,912,908,4,3000,2579,421,0.935727958913705,0.61878453038674,1.79614325068871,805,394,411,3,1,76.69,6.1,0,0,0,0,0,0,0.00366380672816956,1.79880668872749,0.378165042455009
8.7,"eps_greedy_SVM","SVM",55,30,812,809,3,3100,2678,422,0.935861800638084,0.61878453038674,1.80110497237569,815,397,418,10,1.1,79.24,6.3,0,0,0,0,0,0,0.00304094809305255,1.29019619811406,0.327405721915704
8.7,"eps_greedy_SVM","SVM",55,31,712,709,3,3200,2778,422,0.935952065987084,0.61878453038674,1.80110497237569,815,397,418,0,1.1,81.8,6.6,0,0,0,0,0,0,0.00251086315882337,0.880855077876019,0.26518706816951
8.7,"eps_greedy_SVM","SVM",55,32,612,609,3,3300,2878,422,0.93605478172905,0.624309392265193,1.80110497237569,818,399,419,3,1.1,84.36,6.8,0,0,0,0,0,0,0.00222426091725294,0.683088929297216,0.252934510299755
8.7,"eps_greedy_SVM","SVM",55,33,512,509,3,3400,2978,422,0.935967628978291,0.624309392265193,1.80110497237569,818,398,420,0,1.1,86.91,7.1,0,0,0,0,0,0,0.00115009337999977,0.341547842320992,0.146772468676255
8.7,"eps_greedy_SVM","SVM",55,34,412,411,1,3500,3076,424,0.936448525406584,0.624309392265193,1.80110497237569,827,403,424,9,1.1,89.47,7.3,0,0,0,0,0,0,0.00114867134442704,0.349797620675586,0.144574242822126
8.7,"eps_greedy_SVM","SVM",55,35,312,312,0,3600,3175,425,0.936549684849429,0.61878453038674,1.80276497695853,834,407,427,7,1,92.02,7.5,0,0,0,0,0,0,0.000948592891684397,0.244872826706025,0.113776578241422
8.7,"eps_greedy_SVM","SVM",55,36,212,212,0,3700,3275,425,0.936692864368533,0.61878453038674,1.80110497237569,841,408,433,7,1.1,94.58,7.7,0,0,0,0,0,0,0.000565381669611932,0.118275228707963,0.0720015871975661
8.7,"eps_greedy_SVM","SVM",55,37,112,112,0,3800,3375,425,0.936688195471171,0.61878453038674,1.79779411764706,843,409,434,2,1.1,97.14,7.9,0,0,0,0,0,0,0.000217354295734734,0.0338227628244534,0.0316140167976583
8.7,"eps_greedy_SVM","SVM",55,38,12,12,0,3900,3475,425,0.936689751770292,0.61878453038674,1.79449541284404,843,409,434,0,1.1,99.69,8.2,0,0,0,0,0,0,0.00014794232507235,0.00243188615645653,0.00243188615645653
8.7,"eps_greedy_SVM","SVM",55,39,0,0,0,3912,3487,425,0.936688195471171,0.61878453038674,1.79779411764706,843,409,434,0,1.1,100,8.2,0,0,0,0,0,0,0,0,0
8.7,"eps_greedy_SVM","SVM",56,0,3812,3412,400,100,87,13,0.877078931049587,0.393782383419689,1.72803896755092,38,13,25,0,1.9,2.56,6.7,0,0,0,0,0,0,0.18493387509154,508.241866409453,21.3736075438508
8.7,"eps_greedy_SVM","SVM",56,1,3712,3357,355,200,142,58,0.894644961632159,0.559585492227979,1.73393569061716,110,51,59,72,1.2,5.11,2.4,0,0,0,0,0,0,0.708600522964726,593.937706826005,77.2286088157387
8.7,"eps_greedy_SVM","SVM",56,2,3612,3311,301,300,188,112,0.912663588619233,0.61139896373057,1.73099815869481,187,92,95,77,1,7.67,1.7,0,0,0,0,0,0,0.65029746079849,425.247741896544,71.9509134778416
8.7,"eps_greedy_SVM","SVM",56,3,3512,3283,229,400,216,184,0.910106712827567,0.632124352331606,1.7201121832961,242,122,120,55,1,10.22,1.2,0,0,0,0,0,0,0.541034353688321,371.368735337169,66.1696283724576
8.7,"eps_greedy_SVM","SVM",56,4,3412,3241,171,500,258,242,0.921545058323218,0.658031088082902,1.75283019767292,326,163,163,84,1,12.78,1.1,0,0,0,0,0,0,0.448602235374285,369.044582951609,55.0634107390185
8.7,"eps_greedy_SVM","SVM",56,5,3312,3188,124,600,311,289,0.870783726514219,0.652849740932642,1.58646551970916,407,204,203,81,1,15.34,1.1,0,0,0,0,0,0,0.280589934326437,254.542823693932,37.8158850217365
8.7,"eps_greedy_SVM","SVM",56,6,3212,3110,102,700,389,311,0.901951160733445,0.673575129533679,1.63162385421682,483,237,246,76,1,17.89,1.3,0,0,0,0,0,0,0.162998928581331,181.061945008597,23.1105412100253
8.7,"eps_greedy_SVM","SVM",56,7,3112,3043,69,800,456,344,0.897195959548468,0.663212435233161,1.62529070461546,558,267,291,75,1.1,20.45,1.3,0,0,0,0,0,0,0.124089196637991,173.684260678708,17.1481450178006
8.7,"eps_greedy_SVM","SVM",56,8,3012,2959,53,900,540,360,0.904578571029717,0.66839378238342,1.65959454886053,602,285,317,44,1.1,23.01,1.5,0,0,0,0,0,0,0.0882020808316505,138.536767705557,10.0967956520607
8.7,"eps_greedy_SVM","SVM",56,9,2912,2864,48,1000,635,365,0.913668705309781,0.658031088082902,1.69067596284711,612,291,321,10,1.1,25.56,1.7,0,0,0,0,0,0,0.0666140030126268,108.753314046443,7.28235986774335
8.7,"eps_greedy_SVM","SVM",56,10,2812,2772,40,1100,727,373,0.927705071724781,0.652849740932642,1.69845132110039,633,307,326,21,1.1,28.12,1.9,0,0,0,0,0,0,0.066563206954839,101.472234872368,7.50723543569369
8.7,"eps_greedy_SVM","SVM",56,11,2712,2677,35,1200,822,378,0.935002454012977,0.663212435233161,1.7325891496495,659,320,339,26,1.1,30.67,2.2,0,0,0,0,0,0,0.0707483094220226,91.5711691509951,8.00242601899505
8.7,"eps_greedy_SVM","SVM",56,12,2612,2583,29,1300,916,384,0.941080177159179,0.663212435233161,1.7714773274354,676,328,348,17,1.1,33.23,2.4,0,0,0,0,0,0,0.0608110756223081,65.6193579375061,6.68877365230085
8.7,"eps_greedy_SVM","SVM",56,13,2512,2486,26,1400,1013,387,0.941738499202092,0.652849740932642,1.77474272343067,684,335,349,8,1,35.79,2.6,0,0,0,0,0,0,0.0605363204559222,61.127484885666,6.53859639553856
8.7,"eps_greedy_SVM","SVM",56,14,2412,2390,22,1500,1109,391,0.940649622787365,0.658031088082902,1.76984913136239,700,339,361,16,1.1,38.34,2.8,0,0,0,0,0,0,0.0592352018605296,51.7438469916678,6.58557300364808
8.7,"eps_greedy_SVM","SVM",56,15,2312,2295,17,1600,1204,396,0.940476225463561,0.652849740932642,1.77310852202788,715,345,370,15,1.1,40.9,3,0,0,0,0,0,0,0.0507757532467733,43.6843212084973,5.75166844664924
8.7,"eps_greedy_SVM","SVM",56,16,2212,2200,12,1700,1299,401,0.93924040216425,0.642487046632124,1.76215376255416,728,351,377,13,1.1,43.46,3.2,0,0,0,0,0,0,0.0394527513346904,36.959777624231,4.83490172705982
8.7,"eps_greedy_SVM","SVM",56,17,2112,2103,9,1800,1396,404,0.939125783594277,0.647668393782383,1.76540197225472,738,354,384,10,1.1,46.01,3.5,0,0,0,0,0,0,0.0291490814168912,32.0294879893363,3.3570788351054
8.7,"eps_greedy_SVM","SVM",56,18,2012,2004,8,1900,1495,405,0.939258035790399,0.642487046632124,1.77474272343067,742,355,387,4,1.1,48.57,3.7,0,0,0,0,0,0,0.0250964566679653,28.0168263531194,2.71032329221661
8.7,"eps_greedy_SVM","SVM",56,19,1912,1904,8,2000,1595,405,0.938493911990588,0.647668393782383,1.77310852202788,748,358,390,6,1.1,51.12,3.9,0,0,0,0,0,0,0.0221559683890702,24.1909259227771,2.41173062287511
8.7,"eps_greedy_SVM","SVM",56,20,1812,1804,8,2100,1695,405,0.938155934156057,0.647668393782383,1.77310852202788,749,359,390,1,1.1,53.68,4.2,0,0,0,0,0,0,0.0184328266173952,18.9361752550799,1.91257597442941
8.7,"eps_greedy_SVM","SVM",56,21,1712,1704,8,2200,1795,405,0.937819425790377,0.647668393782383,1.77916412679061,752,363,389,3,1.1,56.24,4.4,0,0,0,0,0,0,0.0135096585171083,12.052574994321,1.67077076092323
8.7,"eps_greedy_SVM","SVM",56,22,1612,1605,7,2300,1894,406,0.937815017383842,0.642487046632124,1.78080089231664,754,365,389,2,1.1,58.79,4.7,0,0,0,0,0,0,0.0106951517567112,9.25436623979513,1.09773030725984
8.7,"eps_greedy_SVM","SVM",56,23,1512,1505,7,2400,1994,406,0.937631333778116,0.647668393782383,1.79177282225975,769,374,395,15,1.1,61.35,4.9,0,0,0,0,0,0,0.00748668175138549,5.54811531726961,0.932920253611763
8.7,"eps_greedy_SVM","SVM",56,24,1412,1406,6,2500,2093,407,0.937628394840424,0.642487046632124,1.78847912221884,770,375,395,1,1.1,63.91,5.1,0,0,0,0,0,0,0.0062897035440954,4.85163249500895,0.673656867512494
8.7,"eps_greedy_SVM","SVM",56,25,1312,1307,5,2600,2192,408,0.937806200570765,0.637305699481865,1.79012445719788,782,380,402,12,1.1,66.46,5.4,0,0,0,0,0,0,0.0054826550359111,3.99268280591681,0.604237778436972
8.7,"eps_greedy_SVM","SVM",56,26,1212,1208,4,2700,2291,409,0.937866448793443,0.637305699481865,1.78519750915054,783,381,402,1,1.1,69.02,5.6,0,0,0,0,0,0,0.0054693021562681,3.65679016460258,0.561648882255532
8.7,"eps_greedy_SVM","SVM",56,27,1112,1108,4,2800,2391,409,0.938185323532979,0.642487046632124,1.79342422578257,793,387,406,10,1,71.57,5.8,0,0,0,0,0,0,0.0036654459966828,2.21876444779093,0.4101127730298
8.7,"eps_greedy_SVM","SVM",56,28,1012,1008,4,2900,2491,409,0.938276430601418,0.642487046632124,1.79177282225975,793,387,406,0,1,74.13,6.1,0,0,0,0,0,0,0.00342685129553389,1.80855031292045,0.353328073320596
8.7,"eps_greedy_SVM","SVM",56,29,912,909,3,3000,2590,410,0.938123605841455,0.637305699481865,1.79012445719788,798,390,408,5,1,76.69,6.3,0,0,0,0,0,0,0.00279553275991056,1.34982943843276,0.303210554776162
8.7,"eps_greedy_SVM","SVM",56,30,812,810,2,3100,2689,411,0.938643797812865,0.637305699481865,1.79012445719788,802,393,409,4,1,79.24,6.5,0,0,0,0,0,0,0.00263472319505701,1.13847482479924,0.284360215909712
8.7,"eps_greedy_SVM","SVM",56,31,712,711,1,3200,2788,412,0.938499789865978,0.637305699481865,1.78847912221884,808,395,413,6,1,81.8,6.8,0,0,0,0,0,0,0.00231297041256889,0.886456682717513,0.251279263524066
8.7,"eps_greedy_SVM","SVM",56,32,612,611,1,3300,2888,412,0.938505667741361,0.637305699481865,1.79012445719788,808,395,413,0,1,84.36,7,0,0,0,0,0,0,0.00166514669936334,0.57522269167257,0.189998381886612
8.7,"eps_greedy_SVM","SVM",56,33,512,511,1,3400,2988,412,0.938532118180585,0.632124352331606,1.79177282225975,809,396,413,1,1,86.91,7.3,0,0,0,0,0,0,0.00115682196168657,0.346176925734366,0.13361211791756
8.7,"eps_greedy_SVM","SVM",56,34,412,411,1,3500,3088,412,0.938643797812865,0.632124352331606,1.78847912221884,811,397,414,2,1,89.47,7.5,0,0,0,0,0,0,0.000700987300627254,0.201921544260505,0.0894850888023779
8.7,"eps_greedy_SVM","SVM",56,35,312,312,0,3600,3187,413,0.939089046873138,0.637305699481865,1.79177282225975,816,401,415,5,1,92.02,7.7,0,0,0,0,0,0,0.000626363729760978,0.160554164741639,0.0787854563414671
8.7,"eps_greedy_SVM","SVM",56,36,212,212,0,3700,3287,413,0.939357959671917,0.642487046632124,1.79342422578257,823,402,421,7,1,94.58,8,0,0,0,0,0,0,0.000320346192703501,0.0663775464473906,0.0412956836929922
8.7,"eps_greedy_SVM","SVM",56,37,112,112,0,3800,3387,413,0.939397635330752,0.647668393782383,1.79177282225975,826,403,423,3,1,97.14,8.2,0,0,0,0,0,0,0.000131549933851121,0.0226272326337486,0.0211670661074375
8.7,"eps_greedy_SVM","SVM",56,38,12,12,0,3900,3487,413,0.939440249927279,0.642487046632124,1.78683680897529,828,405,423,2,1,99.69,8.4,0,0,0,0,0,0,9.02667075511776e-05,0.00129603745193794,0.00129603745193794
8.7,"eps_greedy_SVM","SVM",56,39,0,0,0,3912,3499,413,0.939454944615737,0.642487046632124,1.78683680897529,828,405,423,0,1,100,8.5,0,0,0,0,0,0,0,0,0
8.7,"eps_greedy_SVM","SVM",57,0,3812,3402,410,100,82,18,0.924305810088348,0.601123595505618,1.77270620706701,39,18,21,0,1.2,2.56,4.6,0,0,0,0,0,0,0.755876255800252,607.331870956833,79.9353635333235
8.7,"eps_greedy_SVM","SVM",57,1,3712,3379,333,200,105,95,0.925891988220575,0.612359550561798,1.7691202464261,80,40,40,41,1,5.11,1.1,0,0,0,0,0,0,0.813330608110645,394.746270214156,86.20792720113
8.7,"eps_greedy_SVM","SVM",57,2,3612,3335,277,300,149,151,0.90970159628922,0.629213483146067,1.72550840375151,158,81,77,78,1,7.67,1,0,0,0,0,0,0,0.568924323795817,302.398834498952,65.5607987702343
8.7,"eps_greedy_SVM","SVM",57,3,3512,3292,220,400,192,208,0.902066139204497,0.640449438202247,1.7068944150694,235,122,113,77,0.9,10.22,0.9,0,0,0,0,0,0,0.340070126488207,163.39389331056,50.6158927588842
8.7,"eps_greedy_SVM","SVM",57,4,3412,3235,177,500,249,251,0.863917291237483,0.623595505617977,1.64071868689484,338,173,165,103,1,12.78,1,0,0,0,0,0,0,0.236513977153671,138.646659532459,34.7078293214631
8.7,"eps_greedy_SVM","SVM",57,5,3312,3160,152,600,324,276,0.890041834658305,0.668539325842697,1.6609744731528,392,195,197,54,1,15.34,1.2,0,0,0,0,0,0,0.104788766219022,60.4736219078892,16.7082151906102
8.7,"eps_greedy_SVM","SVM",57,6,3212,3087,125,700,397,303,0.898919060679202,0.679775280898876,1.64932646346763,460,225,235,68,1,17.89,1.3,0,0,0,0,0,0,0.070972279181882,54.341095449943,10.6104931038746
8.7,"eps_greedy_SVM","SVM",57,7,3112,3014,98,800,470,330,0.900064458234848,0.707865168539326,1.64780914381402,525,254,271,65,1.1,20.45,1.4,0,0,0,0,0,0,0.0714560758104249,84.2462387235483,10.065936955505
8.7,"eps_greedy_SVM","SVM",57,8,3012,2936,76,900,548,352,0.902623829324708,0.724719101123595,1.64932646346763,576,277,299,51,1.1,23.01,1.6,0,0,0,0,0,0,0.0625258242527656,88.4105096606504,8.4839666941567
8.7,"eps_greedy_SVM","SVM",57,9,2912,2850,62,1000,634,366,0.912333640879152,0.719101123595506,1.65791840236503,612,295,317,36,1.1,25.56,1.7,0,0,0,0,0,0,0.0663120791824197,100.919262862229,7.77506116441212
8.7,"eps_greedy_SVM","SVM",57,10,2812,2760,52,1100,724,376,0.920924912475824,0.707865168539326,1.67968216524924,645,312,333,33,1.1,28.12,1.9,0,0,0,0,0,0,0.076699104476593,97.2796497589459,8.87553831151318
8.7,"eps_greedy_SVM","SVM",57,11,2712,2668,44,1200,816,384,0.931023369269854,0.696629213483146,1.73027500155193,671,324,347,26,1.1,30.67,2.1,0,0,0,0,0,0,0.0717863639377579,80.6802618197832,8.14244881248956
8.7,"eps_greedy_SVM","SVM",57,12,2612,2576,36,1300,908,392,0.935059908241808,0.679775280898876,1.74039356881246,699,335,364,28,1.1,33.23,2.3,0,0,0,0,0,0,0.0771301273632332,76.4144789416025,8.71278911140139
8.7,"eps_greedy_SVM","SVM",57,13,2512,2482,30,1400,1002,398,0.935987285297204,0.679775280898876,1.74039356881246,717,341,376,18,1.1,35.79,2.5,0,0,0,0,0,0,0.0666196778257146,58.4223079306746,7.42350111925639
8.7,"eps_greedy_SVM","SVM",57,14,2412,2386,26,1500,1098,402,0.936353812515015,0.679775280898876,1.73559909617111,724,345,379,7,1.1,38.34,2.7,0,0,0,0,0,0,0.0619342500439431,54.9067972082397,7.19706779595585
8.7,"eps_greedy_SVM","SVM",57,15,2312,2292,20,1600,1192,408,0.936488100504295,0.679775280898876,1.73719431592862,746,353,393,22,1.1,40.9,2.9,0,0,0,0,0,0,0.0495044808575269,42.9814619500901,5.65558957497718
8.7,"eps_greedy_SVM","SVM",57,16,2212,2197,15,1700,1287,413,0.93689096447214,0.679775280898876,1.73879247077308,759,358,401,13,1.1,43.46,3.1,0,0,0,0,0,0,0.0379562563075189,38.2930410311283,4.53322387598152
8.7,"eps_greedy_SVM","SVM",57,17,2112,2100,12,1800,1384,416,0.93871096169159,0.679775280898876,1.75212551131362,765,364,401,6,1.1,46.01,3.3,0,0,0,0,0,0,0.0303769960538655,33.0754356426668,3.40609149770746
8.7,"eps_greedy_SVM","SVM",57,18,2012,2001,11,1900,1483,417,0.939589363127356,0.679775280898876,1.76063070333354,774,368,406,9,1.1,48.57,3.6,0,0,0,0,0,0,0.0250330891390997,27.2295460680033,2.74330664147898
8.7,"eps_greedy_SVM","SVM",57,19,1912,1902,10,2000,1582,418,0.939624120018703,0.674157303370786,1.77238129757158,777,368,409,3,1.1,51.12,3.8,0,0,0,0,0,0,0.0198243985055812,20.6118868793806,2.14936170883477
8.7,"eps_greedy_SVM","SVM",57,20,1812,1803,9,2100,1681,419,0.939153322126866,0.674157303370786,1.76749421678784,781,373,408,4,1.1,53.68,4,0,0,0,0,0,0,0.0178402324651995,18.2334631995051,1.91365680260822
8.7,"eps_greedy_SVM","SVM",57,21,1712,1704,8,2200,1780,420,0.93871886098507,0.679775280898876,1.76749421678784,785,374,411,4,1.1,56.24,4.2,0,0,0,0,0,0,0.015286937791804,14.8347525233022,1.57873588836735
8.7,"eps_greedy_SVM","SVM",57,22,1612,1604,8,2300,1880,420,0.936688742558858,0.679775280898876,1.75416967322956,796,384,412,11,1.1,58.79,4.5,0,0,0,0,0,0,0.0114831547297576,8.43294913688149,1.42612776246813
8.7,"eps_greedy_SVM","SVM",57,23,1512,1505,7,2400,1979,421,0.936766155635033,0.679775280898876,1.75739424983477,798,384,414,2,1.1,61.35,4.7,0,0,0,0,0,0,0.00856199081931389,6.92659618203332,0.965475586946239
8.7,"eps_greedy_SVM","SVM",57,24,1412,1407,5,2500,2077,423,0.936034681058126,0.674157303370786,1.76063070333354,803,386,417,5,1.1,63.91,4.9,0,0,0,0,0,0,0.00837003741651206,6.96032962255148,0.906457733133282
8.7,"eps_greedy_SVM","SVM",57,25,1312,1308,4,2600,2176,424,0.936165809330014,0.674157303370786,1.75416967322956,815,398,417,12,1,66.46,5.1,0,0,0,0,0,0,0.00614508957340708,4.72248983051075,0.695770879707252
8.7,"eps_greedy_SVM","SVM",57,26,1212,1209,3,2700,2275,425,0.936439124884667,0.674157303370786,1.75256181835034,815,399,416,0,1,69.02,5.4,0,0,0,0,0,0,0.00556155298823214,3.79486698214698,0.569945142098119
8.7,"eps_greedy_SVM","SVM",57,27,1112,1110,2,2800,2374,426,0.937257491689935,0.674157303370786,1.75901098787509,829,406,423,14,1,71.57,5.6,0,0,0,0,0,0,0.00463648069897857,2.96721796359087,0.511798366410295
8.7,"eps_greedy_SVM","SVM",57,28,1012,1010,2,2900,2474,426,0.937505529505433,0.668539325842697,1.76063070333354,831,406,425,2,1,74.13,5.8,0,0,0,0,0,0,0.00410893419959579,2.24089276889833,0.420209143967741
8.7,"eps_greedy_SVM","SVM",57,29,912,910,2,3000,2574,426,0.938652506919775,0.662921348314607,1.75095690826028,843,409,434,12,1.1,76.69,6,0,0,0,0,0,0,0.00302877996101895,1.43510896778704,0.325648566416211
8.7,"eps_greedy_SVM","SVM",57,30,812,811,1,3100,2673,427,0.939598842279539,0.662921348314607,1.75416967322956,847,410,437,4,1.1,79.24,6.3,0,0,0,0,0,0,0.00278351983694512,1.16112576859927,0.297517561666061
8.7,"eps_greedy_SVM","SVM",57,31,712,711,1,3200,2773,427,0.940154952541047,0.657303370786517,1.75256181835034,850,412,438,3,1.1,81.8,6.5,0,0,0,0,0,0,0.0022135862492027,0.827399400680455,0.245435793225747
8.7,"eps_greedy_SVM","SVM",57,32,612,611,1,3300,2873,427,0.940363493889109,0.657303370786517,1.75578048101031,849,413,436,-1,1.1,84.36,6.7,0,0,0,0,0,0,0.00162184998105808,0.526484424874817,0.182181404598047
8.7,"eps_greedy_SVM","SVM",57,33,512,511,1,3400,2973,427,0.940409309791335,0.657303370786517,1.75739424983477,845,413,432,-4,1,86.91,7,0,0,0,0,0,0,0.00110605815426241,0.346748725269307,0.138163573368542
8.7,"eps_greedy_SVM","SVM",57,34,412,412,0,3500,3072,428,0.940606792128516,0.662921348314607,1.75578048101031,848,415,433,3,1,89.47,7.2,0,0,0,0,0,0,0.00096157199786983,0.293679941055486,0.119399886882017
8.7,"eps_greedy_SVM","SVM",57,35,312,312,0,3600,3172,428,0.940905385422332,0.662921348314607,1.75739424983477,852,417,435,4,1,92.02,7.4,0,0,0,0,0,0,0.000526105203684643,0.135418856267161,0.0648856555672402
8.7,"eps_greedy_SVM","SVM",57,36,212,212,0,3700,3272,428,0.941219777303122,0.662921348314607,1.75901098787509,854,418,436,2,1,94.58,7.6,0,0,0,0,0,0,0.000344526957422533,0.0738005668601767,0.0451921640018215
8.7,"eps_greedy_SVM","SVM",57,37,112,112,0,3800,3372,428,0.941804325021176,0.662921348314607,1.75578048101031,853,419,434,-1,1,97.14,7.9,0,0,0,0,0,0,0.000163646254365113,0.0266236304961544,0.0249130108362324
8.7,"eps_greedy_SVM","SVM",57,38,12,12,0,3900,3472,428,0.942268803478222,0.662921348314607,1.75901098787509,855,419,436,2,1,99.69,8.1,0,0,0,0,0,0,0.000139416912944109,0.00191813779828508,0.00191813779828508
8.7,"eps_greedy_SVM","SVM",57,39,0,0,0,3912,3484,428,0.942290921499986,0.662921348314607,1.75416967322956,855,419,436,0,1,100,8.1,0,0,0,0,0,0,0,0,0
8.7,"eps_greedy_SVM","SVM",58,0,3812,3412,400,100,90,10,0.874426020408169,0.51530612244898,1.73838051349572,29,10,19,0,1.9,2.56,9,0,0,0,0,0,0,0.255380503038351,376.151040832649,28.927346195351
8.7,"eps_greedy_SVM","SVM",58,1,3712,3361,351,200,141,59,0.898718692022255,0.561224489795918,1.75193202280912,109,53,56,80,1.1,5.11,2.4,0,0,0,0,0,0,0.70646516251124,538.825858719199,77.5333918136071
8.7,"eps_greedy_SVM","SVM",58,2,3612,3320,292,300,182,118,0.91419584879406,0.571428571428571,1.75193202280912,176,88,88,67,1,7.67,1.5,0,0,0,0,0,0,0.572403940647164,299.464220897803,66.6937537648691
8.7,"eps_greedy_SVM","SVM",58,3,3512,3285,227,400,217,183,0.903881609461961,0.586734693877551,1.73956187979779,240,122,118,64,1,10.22,1.2,0,0,0,0,0,0,0.417693345234503,254.107013265074,54.847559534183
8.7,"eps_greedy_SVM","SVM",58,4,3412,3248,164,500,254,246,0.910062036178098,0.607142857142857,1.7347872360289,322,160,162,82,1,12.78,1,0,0,0,0,0,0,0.333692340280015,245.211810085874,44.1277934251402
8.7,"eps_greedy_SVM","SVM",58,5,3312,3193,119,600,309,291,0.905331052875685,0.607142857142857,1.68308423277652,402,204,198,80,1,15.34,1.1,0,0,0,0,0,0,0.204866872979366,142.997847680629,25.9214373227156
8.7,"eps_greedy_SVM","SVM",58,6,3212,3117,95,700,385,315,0.888143552875705,0.612244897959184,1.64488668395535,467,222,245,65,1.1,17.89,1.2,0,0,0,0,0,0,0.127807127740292,110.496051859333,15.7816708387606
8.7,"eps_greedy_SVM","SVM",58,7,3112,3033,79,800,469,331,0.886704255565857,0.637755102040816,1.6235181572629,512,244,268,45,1.1,20.45,1.4,0,0,0,0,0,0,0.084999112169114,101.15934251664,12.2121817887555
8.7,"eps_greedy_SVM","SVM",58,8,3012,2951,61,900,551,349,0.890262639146569,0.647959183673469,1.62800714755948,551,261,290,39,1.1,23.01,1.6,0,0,0,0,0,0,0.0742986637988405,109.980455097424,8.94238940297488
8.7,"eps_greedy_SVM","SVM",58,9,2912,2856,56,1000,646,354,0.902440862708722,0.647959183673469,1.6356973728718,563,268,295,12,1.1,25.56,1.8,0,0,0,0,0,0,0.0648250099174882,102.794795038132,7.32426624449598
8.7,"eps_greedy_SVM","SVM",58,10,2812,2761,51,1100,741,359,0.912634798237471,0.647959183673469,1.68164392828955,584,278,306,21,1.1,28.12,2.1,0,0,0,0,0,0,0.0613218781072459,93.9507329348568,6.64277548298184
8.7,"eps_greedy_SVM","SVM",58,11,2712,2666,46,1200,836,364,0.929065688775499,0.647959183673469,1.73358718487395,601,291,310,17,1.1,30.67,2.3,0,0,0,0,0,0,0.0570384670860941,73.3183921651838,6.2304345124554
8.7,"eps_greedy_SVM","SVM",58,12,2612,2575,37,1300,927,373,0.93858708256028,0.653061224489796,1.76865126215776,629,304,325,28,1.1,33.23,2.5,0,0,0,0,0,0,0.0768550621717859,71.0737186255034,8.63915612027115
8.7,"eps_greedy_SVM","SVM",58,13,2512,2476,36,1400,1026,374,0.938882769016685,0.647959183673469,1.77781525833474,643,308,335,14,1.1,35.79,2.7,0,0,0,0,0,0,0.0611809778194704,54.4725935177279,6.58316175582593
8.7,"eps_greedy_SVM","SVM",58,14,2412,2381,31,1500,1121,379,0.938875521799615,0.653061224489796,1.77944927971188,656,314,342,13,1.1,38.34,3,0,0,0,0,0,0,0.0598158779829814,45.6640551991894,6.43057558962517
8.7,"eps_greedy_SVM","SVM",58,15,2312,2283,29,1600,1219,381,0.939132073283846,0.653061224489796,1.77944927971188,661,316,345,5,1.1,40.9,3.2,0,0,0,0,0,0,0.045673721508345,35.8392176901351,5.33671671017086
8.7,"eps_greedy_SVM","SVM",58,16,2212,2188,24,1700,1314,386,0.939579951298683,0.653061224489796,1.76702864632091,682,323,359,21,1.1,43.46,3.4,0,0,0,0,0,0,0.0379054631793326,32.3081962763255,4.57952217272453
8.7,"eps_greedy_SVM","SVM",58,17,2112,2095,17,1800,1407,393,0.939259624304246,0.653061224489796,1.77517163547447,698,331,367,16,1.1,46.01,3.6,0,0,0,0,0,0,0.0313964557931016,30.3337091243065,3.90566874656229
8.7,"eps_greedy_SVM","SVM",58,18,2012,1997,15,1900,1505,395,0.938784206864543,0.642857142857143,1.7719054503126,698,333,365,0,1.1,48.57,3.8,0,0,0,0,0,0,0.0255693073273013,24.7278797155551,2.76684158899659
8.7,"eps_greedy_SVM","SVM",58,19,1912,1899,13,2000,1603,397,0.938242115027812,0.63265306122449,1.76865126215776,709,338,371,11,1.1,51.12,4,0,0,0,0,0,0,0.0234036904342887,23.5858612783375,2.54323747825918
8.7,"eps_greedy_SVM","SVM",58,20,1812,1799,13,2100,1703,397,0.938427643784772,0.63265306122449,1.78108630756811,712,341,371,3,1.1,53.68,4.3,0,0,0,0,0,0,0.0184557942901517,17.821393611871,1.97074773803579
8.7,"eps_greedy_SVM","SVM",58,21,1712,1701,11,2200,1801,399,0.938233418367334,0.627551020408163,1.77944927971188,720,345,375,8,1.1,56.24,4.5,0,0,0,0,0,0,0.0153928283097317,13.477532241377,1.60852276381421
8.7,"eps_greedy_SVM","SVM",58,22,1612,1602,10,2300,1900,400,0.937397089517615,0.627551020408163,1.78272635020859,732,355,377,12,1.1,58.79,4.8,0,0,0,0,0,0,0.0103577148159552,7.79963601335626,1.30736930665365
8.7,"eps_greedy_SVM","SVM",58,23,1512,1504,8,2400,1998,402,0.937908743042661,0.627551020408163,1.78108630756811,739,358,381,7,1.1,61.35,5,0,0,0,0,0,0,0.0101066874000451,7.81532409605482,1.05839451557649
8.7,"eps_greedy_SVM","SVM",58,24,1412,1405,7,2500,2097,403,0.937152133580697,0.622448979591837,1.78108630756811,750,367,383,11,1,63.91,5.2,0,0,0,0,0,0,0.00781233229990243,5.39470687948542,0.955229090399974
8.7,"eps_greedy_SVM","SVM",58,25,1312,1305,7,2600,2197,403,0.937302875695725,0.627551020408163,1.78108630756811,750,367,383,0,1,66.46,5.5,0,0,0,0,0,0,0.00681756209755104,4.58456264694089,0.708092762969252
8.7,"eps_greedy_SVM","SVM",58,26,1212,1206,6,2700,2296,404,0.937401437847863,0.622448979591837,1.78108630756811,761,372,389,11,1,69.02,5.7,0,0,0,0,0,0,0.0052540381022196,3.4066052082336,0.601798918597665
8.7,"eps_greedy_SVM","SVM",58,27,1112,1106,6,2800,2396,404,0.937410134508345,0.61734693877551,1.78108630756811,761,372,389,0,1,71.57,5.9,0,0,0,0,0,0,0.00522330925277299,2.91366283754224,0.532230856300396
8.7,"eps_greedy_SVM","SVM",58,28,1012,1006,6,2900,2496,404,0.937408685064931,0.607142857142857,1.77944927971188,762,373,389,1,1,74.13,6.2,0,0,0,0,0,0,0.0038799216421174,1.97291872008643,0.431685024970108
8.7,"eps_greedy_SVM","SVM",58,29,912,908,4,3000,2594,406,0.937172425788493,0.612244897959184,1.77944927971188,772,376,396,10,1.1,76.69,6.4,0,0,0,0,0,0,0.00404697544324712,1.85889436106669,0.466384131623332
8.7,"eps_greedy_SVM","SVM",58,30,812,810,2,3100,2692,408,0.937792787569571,0.61734693877551,1.77781525833474,786,382,404,14,1.1,79.24,6.6,0,0,0,0,0,0,0.00346470304347454,1.41386639312945,0.387967858264493
8.7,"eps_greedy_SVM","SVM",58,31,712,710,2,3200,2792,408,0.937678281539886,0.612244897959184,1.77618423516195,784,382,402,-2,1.1,81.8,6.8,0,0,0,0,0,0,0.00308776839376156,1.0963142498202,0.338593790699646
8.7,"eps_greedy_SVM","SVM",58,32,612,610,2,3300,2892,408,0.937802933673467,0.612244897959184,1.77944927971188,785,382,403,1,1.1,84.36,7.1,0,0,0,0,0,0,0.00206149843549715,0.679732930944816,0.244983013098572
8.7,"eps_greedy_SVM","SVM",58,33,512,510,2,3400,2992,408,0.938008754638218,0.612244897959184,1.77944927971188,784,383,401,-1,1,86.91,7.3,0,0,0,0,0,0,0.00141214975085507,0.456114521634635,0.181166365453649
8.7,"eps_greedy_SVM","SVM",58,34,412,412,0,3500,3090,410,0.938363868274581,0.61734693877551,1.78108630756811,792,386,406,8,1.1,89.47,7.5,0,0,0,0,0,0,0.00133343830244089,0.388089063018788,0.161140602279986
8.7,"eps_greedy_SVM","SVM",58,35,312,312,0,3600,3190,410,0.938314587198514,0.61734693877551,1.77781525833474,798,389,409,6,1.1,92.02,7.8,0,0,0,0,0,0,0.000970770768164588,0.247186610510299,0.119843984239087
8.7,"eps_greedy_SVM","SVM",58,36,212,212,0,3700,3290,410,0.938389958256028,0.612244897959184,1.78436941596915,801,392,409,3,1,94.58,8,0,0,0,0,0,0,0.000495389622030056,0.101118677146048,0.0618916196964911
8.7,"eps_greedy_SVM","SVM",58,37,112,112,0,3800,3390,410,0.938501565398885,0.612244897959184,1.78272635020859,804,393,411,3,1,97.14,8.3,0,0,0,0,0,0,0.000216008861643275,0.0360303826089892,0.0336972377699363
8.7,"eps_greedy_SVM","SVM",58,38,12,12,0,3900,3490,410,0.938607374768087,0.61734693877551,1.78108630756811,804,393,411,0,1,99.69,8.5,0,0,0,0,0,0,0.000180067606435636,0.00250607484658592,0.00250607484658592
8.7,"eps_greedy_SVM","SVM",58,39,0,0,0,3912,3502,410,0.938618970315397,0.61734693877551,1.78108630756811,805,394,411,1,1,100,8.5,0,0,0,0,0,0,0,0,0
8.7,"eps_greedy_SVM","SVM",59,0,3812,3427,385,100,92,8,0.896196455843497,0.596244131455399,1.72659180891802,26,8,18,0,2.2,2.56,11.5,0,0,0,0,0,0,0.24232533131299,310.053811828802,31.3101250628722
8.7,"eps_greedy_SVM","SVM",59,1,3712,3388,324,200,131,69,0.905326200846317,0.596244131455399,1.72709652409872,101,50,51,75,1,5.11,1.9,0,0,0,0,0,0,0.780216368564798,502.408867119274,84.354874652651
8.7,"eps_greedy_SVM","SVM",59,2,3612,3340,272,300,179,121,0.921302917909072,0.633802816901408,1.76565557096026,179,90,89,78,1,7.67,1.5,0,0,0,0,0,0,0.545552530130725,321.097797221144,65.8299285030072
8.7,"eps_greedy_SVM","SVM",59,3,3512,3313,199,400,206,194,0.925257030806002,0.666666666666667,1.75559237779619,237,119,118,58,1,10.22,1.1,0,0,0,0,0,0,0.5,260.601591796849,63.2000168716118
8.7,"eps_greedy_SVM","SVM",59,4,3412,3265,147,500,254,246,0.914183898572158,0.647887323943662,1.7318631198414,332,166,166,95,1,12.78,1,0,0,0,0,0,0,0.36892245210028,293.39370502185,49.0107034464731
8.7,"eps_greedy_SVM","SVM",59,5,3312,3207,105,600,312,288,0.914393994489022,0.661971830985915,1.68874914629589,422,209,213,90,1,15.34,1.1,0,0,0,0,0,0,0.267271090923981,282.527325492283,33.4871500617767
8.7,"eps_greedy_SVM","SVM",59,6,3212,3132,80,700,387,313,0.899660344934406,0.657276995305164,1.63893387926455,493,239,254,71,1.1,17.89,1.2,0,0,0,0,0,0,0.131106133409944,140.819301173434,17.6221310627903
8.7,"eps_greedy_SVM","SVM",59,7,3112,3045,67,800,474,326,0.900899372136428,0.676056338028169,1.64044302648302,531,254,277,38,1.1,20.45,1.5,0,0,0,0,0,0,0.0853730322198787,114.865187990429,10.4348314592342
8.7,"eps_greedy_SVM","SVM",59,8,3012,2958,54,900,561,339,0.905327547615013,0.676056338028169,1.65041864087752,566,269,297,35,1.1,23.01,1.7,0,0,0,0,0,0,0.0706196557705689,116.094611885047,8.09697980874234
8.7,"eps_greedy_SVM","SVM",59,9,2912,2864,48,1000,655,345,0.906561187742262,0.685446009389671,1.65041864087752,581,277,304,15,1.1,25.56,1.9,0,0,0,0,0,0,0.0600136067539329,97.2849788394393,6.27995252691472
8.7,"eps_greedy_SVM","SVM",59,10,2812,2771,41,1100,748,352,0.916508421344671,0.671361502347418,1.67962924606462,606,290,316,25,1.1,28.12,2.1,0,0,0,0,0,0,0.0538015688192436,79.5288931388003,5.91196839918091
8.7,"eps_greedy_SVM","SVM",59,11,2712,2677,35,1200,842,358,0.918577058064592,0.671361502347418,1.69807066872255,618,296,322,12,1.1,30.67,2.4,0,0,0,0,0,0,0.065340352688348,87.0137639652547,7.47027830385878
8.7,"eps_greedy_SVM","SVM",59,12,2612,2583,29,1300,936,364,0.924389711764568,0.671361502347418,1.72183098591549,644,306,338,26,1.1,33.23,2.6,0,0,0,0,0,0,0.0606580434804807,68.6568174977504,6.73041196814526
8.7,"eps_greedy_SVM","SVM",59,13,2512,2485,27,1400,1034,366,0.925916947467945,0.666666666666667,1.73871168185584,648,312,336,4,1.1,35.79,2.8,0,0,0,0,0,0,0.0486739980204921,54.3155004255305,5.30465233944898
8.7,"eps_greedy_SVM","SVM",59,14,2412,2387,25,1500,1132,368,0.926625347803022,0.666666666666667,1.74031123262112,658,318,340,10,1.1,38.34,3.1,0,0,0,0,0,0,0.0409058007893475,41.5758536666605,4.48318700177319
8.7,"eps_greedy_SVM","SVM",59,15,2312,2294,18,1600,1225,375,0.926124349847414,0.657276995305164,1.72024987389904,675,325,350,17,1.1,40.9,3.3,0,0,0,0,0,0,0.046579493322022,41.9824326242778,5.79695435714252
8.7,"eps_greedy_SVM","SVM",59,16,2212,2201,11,1700,1318,382,0.926333098995582,0.647887323943662,1.72183098591549,695,333,362,20,1.1,43.46,3.5,0,0,0,0,0,0,0.0365463343598625,37.0836431134884,4.80100234314637
8.7,"eps_greedy_SVM","SVM",59,17,2112,2106,6,1800,1413,387,0.926153978758766,0.652582159624413,1.72024987389904,715,338,377,20,1.1,46.01,3.7,0,0,0,0,0,0,0.0308429341154266,33.5670741378425,3.49972017368897
8.7,"eps_greedy_SVM","SVM",59,18,2012,2006,6,1900,1513,387,0.92642063896094,0.647887323943662,1.72659180891802,712,341,371,-3,1.1,48.57,3.9,0,0,0,0,0,0,0.0247292564457338,26.4127846707986,2.63000457393956
8.7,"eps_greedy_SVM","SVM",59,19,1912,1906,6,2000,1613,387,0.926706153924885,0.647887323943662,1.72868247132012,716,343,373,4,1.1,51.12,4.2,0,0,0,0,0,0,0.020320177439491,20.7201611136999,2.12834208934983
8.7,"eps_greedy_SVM","SVM",59,20,1812,1806,6,2100,1713,387,0.927146547289077,0.647887323943662,1.75036962104116,725,348,377,9,1.1,53.68,4.4,0,0,0,0,0,0,0.0146883308008207,13.5491022520677,1.74559432651115
8.7,"eps_greedy_SVM","SVM",59,21,1712,1707,5,2200,1812,388,0.927185603581314,0.647887323943662,1.74554766616226,726,350,376,1,1.1,56.24,4.7,0,0,0,0,0,0,0.013542941716747,11.7553070573944,1.3706235587723
8.7,"eps_greedy_SVM","SVM",59,22,1612,1608,4,2300,1911,389,0.927103450690747,0.652582159624413,1.76403272576636,752,364,388,26,1.1,58.79,4.9,0,0,0,0,0,0,0.00952944326027189,6.96744564043437,1.23493654037
8.7,"eps_greedy_SVM","SVM",59,23,1512,1509,3,2400,2010,390,0.926828709876382,0.647887323943662,1.76728140481934,758,364,394,6,1.1,61.35,5.2,0,0,0,0,0,0,0.00838668480756777,6.47177591804881,0.897980178787972
8.7,"eps_greedy_SVM","SVM",59,24,1412,1409,3,2500,2110,390,0.926770798822375,0.647887323943662,1.76241286100441,753,366,387,-5,1.1,63.91,5.4,0,0,0,0,0,0,0.00629144540026358,4.53309399617986,0.677275507447465
8.7,"eps_greedy_SVM","SVM",59,25,1312,1309,3,2600,2210,390,0.92676137144149,0.647887323943662,1.76728140481934,754,366,388,1,1.1,66.46,5.7,0,0,0,0,0,0,0.00559196506657111,3.58225413017558,0.570715477627896
8.7,"eps_greedy_SVM","SVM",59,26,1212,1210,2,2700,2309,391,0.927048233174138,0.647887323943662,1.76241286100441,761,371,390,7,1.1,69.02,5.9,0,0,0,0,0,0,0.00442253966374275,2.54377012596869,0.495987157165938
8.7,"eps_greedy_SVM","SVM",59,27,1112,1110,2,2800,2409,391,0.927056313786326,0.647887323943662,1.76565557096026,761,371,390,0,1.1,71.57,6.2,0,0,0,0,0,0,0.00374080925080959,2.01644134996231,0.392565837214232
8.7,"eps_greedy_SVM","SVM",59,28,1012,1010,2,2900,2509,391,0.927250248478821,0.647887323943662,1.76403272576636,759,371,388,-2,1,74.13,6.4,0,0,0,0,0,0,0.00300590974978363,1.43000795134044,0.316825108164078
8.7,"eps_greedy_SVM","SVM",59,29,912,911,1,3000,2608,392,0.928268405614409,0.643192488262911,1.76565557096026,768,374,394,9,1.1,76.69,6.7,0,0,0,0,0,0,0.00291942906806529,1.22525521319082,0.308160439908291
8.7,"eps_greedy_SVM","SVM",59,30,812,811,1,3100,2708,392,0.928664355611587,0.63849765258216,1.76565557096026,768,374,394,0,1.1,79.24,6.9,0,0,0,0,0,0,0.00238231223137221,0.838197311106906,0.253974732634423
8.7,"eps_greedy_SVM","SVM",59,31,712,712,0,3200,2807,393,0.928998354248659,0.63849765258216,1.76891023560719,776,379,397,8,1,81.8,7.1,0,0,0,0,0,0,0.00202050261212734,0.664018677306257,0.232246252827726
8.7,"eps_greedy_SVM","SVM",59,32,612,612,0,3300,2907,393,0.929124950506259,0.643192488262911,1.76403272576636,775,379,396,-1,1,84.36,7.4,0,0,0,0,0,0,0.00134780036256261,0.426482762495509,0.169608432901249
8.7,"eps_greedy_SVM","SVM",59,33,512,512,0,3400,3007,393,0.929378143021458,0.643192488262911,1.76079596847138,776,379,397,1,1,86.91,7.7,0,0,0,0,0,0,0.000737445120622343,0.22771932014639,0.097097303861449
8.7,"eps_greedy_SVM","SVM",59,34,412,412,0,3500,3107,393,0.929642109686241,0.647887323943662,1.76241286100441,779,380,399,3,1.1,89.47,7.9,0,0,0,0,0,0,0.000430902450169474,0.126216651825177,0.0560336962806575
8.7,"eps_greedy_SVM","SVM",59,35,312,312,0,3600,3207,393,0.929747157644676,0.643192488262911,1.75596304266588,779,381,398,0,1,92.02,8.2,0,0,0,0,0,0,0.000279283291660183,0.0721536518881381,0.0351506511427664
8.7,"eps_greedy_SVM","SVM",59,36,212,212,0,3700,3307,393,0.930013817846853,0.63849765258216,1.75275580423178,781,382,399,2,1,94.58,8.4,0,0,0,0,0,0,0.000169407067796138,0.0362694655860901,0.0228838389224926
8.7,"eps_greedy_SVM","SVM",59,37,112,112,0,3800,3407,393,0.93007846274435,0.633802816901408,1.76891023560719,785,383,402,4,1,97.14,8.7,0,0,0,0,0,0,6.67537659591142e-05,0.0110902717017591,0.0104182526208953
8.7,"eps_greedy_SVM","SVM",59,38,12,12,0,3900,3507,393,0.930385526007462,0.633802816901408,1.76241286100441,788,385,403,3,1,99.69,8.9,0,0,0,0,0,0,6.30449555932066e-05,0.000837517675366974,0.000837517675366974
8.7,"eps_greedy_SVM","SVM",59,39,0,0,0,3912,3519,393,0.930478453047615,0.633802816901408,1.76079596847138,788,386,402,0,1,100,9,0,0,0,0,0,0,0,0,0
8.7,"eps_greedy_SVM","SVM",60,0,3812,3426,386,100,90,10,0.931879670539454,0.60952380952381,1.7770111915734,28,10,18,0,1.8,2.56,9,0,0,0,0,0,0,0.212360420462179,380.401072589846,22.8462713152514
8.7,"eps_greedy_SVM","SVM",60,1,3712,3395,317,200,121,79,0.940716194839907,0.628571428571429,1.78759018759019,97,49,48,69,1,5.11,1.5,0,0,0,0,0,0,0.624133234983766,312.923418234705,69.6487717205954
8.7,"eps_greedy_SVM","SVM",60,2,3612,3355,257,300,161,139,0.938886161566567,0.628571428571429,1.78231042186884,167,84,83,70,1,7.67,1.2,0,0,0,0,0,0,0.431005418504423,148.53969293991,57.1942272843008
8.7,"eps_greedy_SVM","SVM",60,3,3512,3308,204,400,208,192,0.919666721213106,0.623809523809524,1.7737416217637,251,127,124,84,1,10.22,1.1,0,0,0,0,0,0,0.282818471687595,151.4323929322,40.0208055071262
8.7,"eps_greedy_SVM","SVM",60,4,3412,3251,161,500,265,235,0.920011727485971,0.657142857142857,1.76031454783748,342,170,172,91,1,12.78,1.1,0,0,0,0,0,0,0.16003510921769,99.2520180989702,22.0748817786077
8.7,"eps_greedy_SVM","SVM",60,5,3312,3178,134,600,338,262,0.903778705067375,0.666666666666667,1.71218487394958,400,195,205,58,1.1,15.34,1.3,0,0,0,0,0,0,0.136607398351108,89.857629625045,20.4439420060707
8.7,"eps_greedy_SVM","SVM",60,6,3212,3094,118,700,422,278,0.903204603720076,0.671428571428571,1.66541145490454,441,214,227,41,1.1,17.89,1.5,0,0,0,0,0,0,0.0779403277797589,56.1228567724196,11.3829383403726
8.7,"eps_greedy_SVM","SVM",60,7,3112,3015,97,800,501,299,0.901243658975615,0.676190476190476,1.65682685977617,493,239,254,52,1.1,20.45,1.7,0,0,0,0,0,0,0.0656990694267616,67.4895098046701,9.52797730005665
8.7,"eps_greedy_SVM","SVM",60,8,3012,2934,78,900,582,318,0.908370152184592,0.695238095238095,1.65377842029176,537,259,278,44,1.1,23.01,1.8,0,0,0,0,0,0,0.0590133394483023,80.3134095670709,7.83093142929717
8.7,"eps_greedy_SVM","SVM",60,9,2912,2852,60,1000,664,336,0.906785577919598,0.7,1.64824226464779,583,277,306,46,1.1,25.56,2,0,0,0,0,0,0,0.0794659002428268,119.061677702326,9.30268996568917
8.7,"eps_greedy_SVM","SVM",60,10,2812,2753,59,1100,763,337,0.91452299132712,0.69047619047619,1.67948482060718,598,285,313,15,1.1,28.12,2.3,0,0,0,0,0,0,0.0522526045929562,67.6886931503439,6.25430496960712
8.7,"eps_greedy_SVM","SVM",60,11,2712,2657,55,1200,859,341,0.924472263132061,0.69047619047619,1.70519122092259,605,289,316,7,1.1,30.67,2.5,0,0,0,0,0,0,0.041091516680071,58.3070298306166,4.50582328070408
8.7,"eps_greedy_SVM","SVM",60,12,2612,2563,49,1300,953,347,0.934765177548672,0.685714285714286,1.73946642134315,628,299,329,23,1.1,33.23,2.7,0,0,0,0,0,0,0.0433663623378783,58.4664564030054,4.91920530004627
8.7,"eps_greedy_SVM","SVM",60,13,2512,2468,44,1400,1048,352,0.941456662848415,0.69047619047619,1.76679821099711,651,310,341,23,1.1,35.79,3,0,0,0,0,0,0,0.0618184188015557,58.8195024997245,7.03016927191027
8.7,"eps_greedy_SVM","SVM",60,14,2412,2372,40,1500,1144,356,0.943004418262145,0.69047619047619,1.7737416217637,664,316,348,13,1.1,38.34,3.2,0,0,0,0,0,0,0.0603563565222003,53.3498712018039,6.48873556701226
8.7,"eps_greedy_SVM","SVM",60,15,2312,2279,33,1600,1237,363,0.943382152402766,0.676190476190476,1.77211134453782,683,326,357,19,1.1,40.9,3.4,0,0,0,0,0,0,0.057256092441165,41.9549110425906,6.15158507278572
8.7,"eps_greedy_SVM","SVM",60,16,2212,2188,24,1700,1328,372,0.942389407080123,0.676190476190476,1.76355042016807,700,335,365,17,1.1,43.46,3.6,0,0,0,0,0,0,0.055852965274674,39.4408551678362,6.16684139494347
8.7,"eps_greedy_SVM","SVM",60,17,2112,2092,20,1800,1424,376,0.9426498663612,0.676190476190476,1.76517282165856,716,340,376,16,1.1,46.01,3.8,0,0,0,0,0,0,0.0430190101451365,35.264978674922,5.18904502629211
8.7,"eps_greedy_SVM","SVM",60,18,2012,1994,18,1900,1522,378,0.942524409534712,0.676190476190476,1.76842659644503,721,342,379,5,1.1,48.57,4,0,0,0,0,0,0,0.0309343249046371,28.9782454190288,3.53974369899684
8.7,"eps_greedy_SVM","SVM",60,19,1912,1896,16,2000,1620,380,0.943138057055579,0.671428571428571,1.76193099829463,730,344,386,9,1.1,51.12,4.3,0,0,0,0,0,0,0.0261005602797567,25.8020966683459,2.85554335729558
8.7,"eps_greedy_SVM","SVM",60,20,1812,1797,15,2100,1719,381,0.944670812196579,0.671428571428571,1.76885976408912,738,346,392,8,1.1,53.68,4.5,0,0,0,0,0,0,0.0216861145562909,19.615502999355,2.20845358825333
8.7,"eps_greedy_SVM","SVM",60,21,1712,1698,14,2200,1818,382,0.944966726667746,0.657142857142857,1.78923319327731,755,359,396,17,1.1,56.24,4.8,0,0,0,0,0,0,0.0135520808779311,9.2247310796186,1.78044231452471
8.7,"eps_greedy_SVM","SVM",60,22,1612,1602,10,2300,1914,386,0.944706267386667,0.652380952380952,1.79087922197398,761,362,399,6,1.1,58.79,5,0,0,0,0,0,0,0.0106444497197335,8.6289464410887,1.25447026339683
8.7,"eps_greedy_SVM","SVM",60,23,1512,1503,9,2400,2013,387,0.944518082146935,0.652380952380952,1.79087922197398,769,364,405,8,1.1,61.35,5.2,0,0,0,0,0,0,0.0108978483143343,8.3649382182353,1.11561624408804
8.7,"eps_greedy_SVM","SVM",60,24,1412,1403,9,2500,2113,387,0.944880816014837,0.647619047619048,1.79252828203104,771,371,400,2,1.1,63.91,5.5,0,0,0,0,0,0,0.00730145853921879,5.2871351658681,0.863673741829849
8.7,"eps_greedy_SVM","SVM",60,25,1312,1304,8,2600,2212,388,0.944676266841213,0.647619047619048,1.78923319327731,775,372,403,4,1.1,66.46,5.7,0,0,0,0,0,0,0.00731772663157691,4.74528673270337,0.755639053626789
8.7,"eps_greedy_SVM","SVM",60,26,1212,1204,8,2700,2312,388,0.945229913271152,0.647619047619048,1.79087922197398,779,376,403,4,1.1,69.02,6,0,0,0,0,0,0,0.00465316086701441,2.67611820455139,0.52538182078525
8.7,"eps_greedy_SVM","SVM",60,27,1112,1105,7,2800,2411,389,0.945752195494464,0.647619047619048,1.7859501965924,783,379,404,4,1.1,71.57,6.2,0,0,0,0,0,0,0.00458451948588366,2.3184638965084,0.476970232319433
8.7,"eps_greedy_SVM","SVM",60,28,1012,1006,6,2900,2510,390,0.945911743849889,0.642857142857143,1.78923319327731,790,384,406,7,1.1,74.13,6.4,0,0,0,0,0,0,0.00372188379760632,1.66311206609405,0.398794954397383
8.7,"eps_greedy_SVM","SVM",60,29,912,906,6,3000,2610,390,0.946050837287951,0.642857142857143,1.79087922197398,790,384,406,0,1.1,76.69,6.7,0,0,0,0,0,0,0.00297095750786238,1.13224583524686,0.319138202759748
8.7,"eps_greedy_SVM","SVM",60,30,812,806,6,3100,2710,390,0.945947199039983,0.642857142857143,1.79252828203104,792,385,407,2,1.1,79.24,6.9,0,0,0,0,0,0,0.00258027187042719,0.83305905822565,0.284106794037649
8.7,"eps_greedy_SVM","SVM",60,31,712,708,4,3200,2808,392,0.946537664321168,0.647619047619048,1.79252828203104,800,387,413,8,1.1,81.8,7.2,0,0,0,0,0,0,0.00226374503214092,0.674698486927498,0.268619273956354
8.7,"eps_greedy_SVM","SVM",60,32,612,609,3,3300,2907,393,0.946656302841869,0.647619047619048,1.80110497237569,804,389,415,4,1.1,84.36,7.4,0,0,0,0,0,0,0.0011218224106717,0.347335151421064,0.154352364112207
8.7,"eps_greedy_SVM","SVM",60,33,512,509,3,3400,3007,393,0.946787214312986,0.647619047619048,1.79614325068871,803,389,414,-1,1.1,86.91,7.7,0,0,0,0,0,0,0.000623707311277681,0.180232789944546,0.0840487502112078
8.7,"eps_greedy_SVM","SVM",60,34,412,411,1,3500,3105,395,0.946800850924559,0.652380952380952,1.79944802207912,810,392,418,7,1.1,89.47,7.9,0,0,0,0,0,0,0.000550507702610673,0.162332213506001,0.0747035599870634
8.7,"eps_greedy_SVM","SVM",60,35,312,312,0,3600,3204,396,0.947175857742867,0.652380952380952,1.80110497237569,816,396,420,6,1.1,92.02,8.1,0,0,0,0,0,0,0.000369291104020437,0.0903827753520157,0.0473775982397054
8.7,"eps_greedy_SVM","SVM",60,36,212,212,0,3700,3304,396,0.947220858561063,0.652380952380952,1.79614325068871,818,396,422,2,1.1,94.58,8.3,0,0,0,0,0,0,0.000148907712941132,0.0326099262135776,0.0214295928061616
8.7,"eps_greedy_SVM","SVM",60,37,112,112,0,3800,3404,396,0.947358588337968,0.652380952380952,1.80110497237569,817,396,421,-1,1.1,97.14,8.6,0,0,0,0,0,0,4.88732919180382e-05,0.00881956023411325,0.00829495757590446
8.7,"eps_greedy_SVM","SVM",60,38,12,12,0,3900,3504,396,0.947572683139692,0.652380952380952,1.80110497237569,816,396,420,-1,1.1,99.69,8.8,0,0,0,0,0,0,4.92782901006272e-05,0.000662215046370003,0.000662215046370003
8.7,"eps_greedy_SVM","SVM",60,39,0,0,0,3912,3516,396,0.947621774941361,0.652380952380952,1.79944802207912,816,396,420,0,1.1,100,8.9,0,0,0,0,0,0,0,0,0
8.7,"eps_greedy_SVM","SVM",61,0,3812,3410,402,100,91,9,0.905974169687957,0.58974358974359,1.73450629882469,25,9,16,0,1.8,2.56,10.1,0,0,0,0,0,0,0.482083110021826,330.356507242472,53.337716595223
8.7,"eps_greedy_SVM","SVM",61,1,3712,3377,335,200,124,76,0.904509384236795,0.58974358974359,1.725624513481,89,46,43,64,0.9,5.11,1.6,0,0,0,0,0,0,0.785160718877025,334.577787325045,85.0314328156868
8.7,"eps_greedy_SVM","SVM",61,2,3612,3344,268,300,157,143,0.911349903172701,0.594871794871795,1.74568635784105,146,74,72,57,1,7.67,1.1,0,0,0,0,0,0,0.477955340419434,168.560415290827,62.0191410496187
8.7,"eps_greedy_SVM","SVM",61,3,3512,3298,214,400,203,197,0.89847697258257,0.594871794871795,1.73644992208528,231,116,115,85,1,10.22,1,0,0,0,0,0,0,0.252431656308735,86.7380211320245,40.7691008919359
8.7,"eps_greedy_SVM","SVM",61,4,3412,3245,167,500,256,244,0.863169236593432,0.584615384615385,1.6733356965615,316,158,158,85,1,12.78,1,0,0,0,0,0,0,0.201267214388466,90.64693053622,27.8788280988857
8.7,"eps_greedy_SVM","SVM",61,5,3312,3170,142,600,331,269,0.872339434179304,0.61025641025641,1.6733356965615,378,188,190,62,1,15.34,1.2,0,0,0,0,0,0,0.0860984524430135,47.0568317412488,14.5636431043996
8.7,"eps_greedy_SVM","SVM",61,6,3212,3102,110,700,399,301,0.888593310910184,0.620512820512821,1.6625584360391,446,219,227,68,1,17.89,1.3,0,0,0,0,0,0,0.0600036015235377,38.8195884423176,9.49867822811213
8.7,"eps_greedy_SVM","SVM",61,7,3112,3025,87,800,476,324,0.892330989094213,0.641025641025641,1.65028280542986,498,240,258,52,1.1,20.45,1.5,0,0,0,0,0,0,0.0596755993899048,54.5995033957774,8.17667094697456
8.7,"eps_greedy_SVM","SVM",61,8,3012,2942,70,900,559,341,0.90379009595364,0.666666666666667,1.66102894345765,543,261,282,45,1.1,23.01,1.6,0,0,0,0,0,0,0.0475373034545261,58.0471277440598,6.38146535932231
8.7,"eps_greedy_SVM","SVM",61,9,2912,2856,56,1000,645,355,0.917765255755024,0.666666666666667,1.70247000705716,574,279,295,31,1.1,25.56,1.8,0,0,0,0,0,0,0.0607521034714466,96.1161789615526,7.05388940487237
8.7,"eps_greedy_SVM","SVM",61,10,2812,2763,49,1100,738,362,0.92452132383988,0.676923076923077,1.71929775082846,599,290,309,25,1.1,28.12,2,0,0,0,0,0,0,0.0514779158939969,77.2520438064514,5.76254287194512
8.7,"eps_greedy_SVM","SVM",61,11,2712,2669,43,1200,832,368,0.933528443920254,0.671794871794872,1.71797705057374,631,303,328,32,1.1,30.67,2.3,0,0,0,0,0,0,0.0612286552249057,70.8042806314811,6.92269750709703
8.7,"eps_greedy_SVM","SVM",61,12,2612,2571,41,1300,930,370,0.935994991190893,0.666666666666667,1.73325791855204,640,310,330,9,1.1,33.23,2.5,0,0,0,0,0,0,0.0504851713810221,53.5887342142117,5.51333796390201
8.7,"eps_greedy_SVM","SVM",61,13,2512,2477,35,1400,1024,376,0.941350339987476,0.656410256410256,1.7641592293526,658,319,339,18,1.1,35.79,2.7,0,0,0,0,0,0,0.0504648348515319,46.6925840775226,5.57082229272136
8.7,"eps_greedy_SVM","SVM",61,14,2412,2379,33,1500,1122,378,0.943382984609556,0.661538461538462,1.78427507975895,664,323,341,6,1.1,38.34,3,0,0,0,0,0,0,0.0455936164496025,40.4399360450706,5.08866288525073
8.7,"eps_greedy_SVM","SVM",61,15,2312,2284,28,1600,1217,383,0.943592655688055,0.656410256410256,1.78099214492959,681,328,353,17,1.1,40.9,3.2,0,0,0,0,0,0,0.0472560640107059,37.2553820027432,5.53607934126243
8.7,"eps_greedy_SVM","SVM",61,16,2212,2191,21,1700,1310,390,0.944579857015971,0.656410256410256,1.78263210086415,708,334,374,27,1.1,43.46,3.4,0,0,0,0,0,0,0.039104942336961,32.7888632760385,4.84806792805802
8.7,"eps_greedy_SVM","SVM",61,17,2112,2094,18,1800,1407,393,0.945322442085643,0.656410256410256,1.78099214492959,713,337,376,5,1.1,46.01,3.6,0,0,0,0,0,0,0.0270633885141262,25.3325981965036,3.17276136617458
8.7,"eps_greedy_SVM","SVM",61,18,2012,1997,15,1900,1504,396,0.945801482258031,0.656410256410256,1.79186853661992,722,340,382,9,1.1,48.57,3.8,0,0,0,0,0,0,0.0259243545011246,25.3683214687867,2.84676258605296
8.7,"eps_greedy_SVM","SVM",61,19,1912,1899,13,2000,1602,398,0.945462222804632,0.661538461538462,1.79352002835874,728,347,381,6,1.1,51.12,4,0,0,0,0,0,0,0.0210063433739372,20.0421283701003,2.25618376563279
8.7,"eps_greedy_SVM","SVM",61,20,1812,1799,13,2100,1702,398,0.945149172236046,0.661538461538462,1.78529287226535,729,348,381,1,1.1,53.68,4.3,0,0,0,0,0,0,0.016768886632256,15.7685195991194,1.81708771682355
8.7,"eps_greedy_SVM","SVM",61,21,1712,1699,13,2200,1802,398,0.944630818736433,0.661538461538462,1.79186853661992,730,349,381,1,1.1,56.24,4.5,0,0,0,0,0,0,0.0129891298585563,11.678301745892,1.35667859746141
8.7,"eps_greedy_SVM","SVM",61,22,1612,1599,13,2300,1902,398,0.943789222324149,0.656410256410256,1.79186853661992,736,354,382,6,1.1,58.79,4.8,0,0,0,0,0,0,0.00951307221572221,7.77120063418657,1.18513972654016
8.7,"eps_greedy_SVM","SVM",61,23,1512,1503,9,2400,1998,402,0.945205958153151,0.661538461538462,1.79779411764706,750,362,388,14,1.1,61.35,5,0,0,0,0,0,0,0.0105390762612429,8.45157254754969,1.08533934850722
8.7,"eps_greedy_SVM","SVM",61,24,1412,1403,9,2500,2098,402,0.942244354169398,0.641025641025641,1.80276497695853,760,371,389,10,1,63.91,5.2,0,0,0,0,0,0,0.00681722120277689,4.81355176814155,0.898386781443752
8.7,"eps_greedy_SVM","SVM",61,25,1312,1304,8,2600,2197,403,0.942472953886925,0.641025641025641,1.80110497237569,765,372,393,5,1.1,66.46,5.5,0,0,0,0,0,0,0.00640598217826602,4.13239414501992,0.658157100119956
8.7,"eps_greedy_SVM","SVM",61,26,1212,1204,8,2700,2297,403,0.941880341880343,0.641025641025641,1.79944802207912,774,377,397,9,1.1,69.02,5.7,0,0,0,0,0,0,0.00448446617228643,2.7634098219626,0.516269963020027
8.7,"eps_greedy_SVM","SVM",61,27,1112,1106,6,2800,2395,405,0.942197760596398,0.641025641025641,1.79944802207912,785,380,405,11,1.1,71.57,5.9,0,0,0,0,0,0,0.00577042089536238,2.87302937254585,0.59323669134767
8.7,"eps_greedy_SVM","SVM",61,28,1012,1006,6,2900,2495,405,0.941484296509851,0.641025641025641,1.79944802207912,788,384,404,3,1.1,74.13,6.2,0,0,0,0,0,0,0.00369450666403441,1.75738776771286,0.413099371809659
8.7,"eps_greedy_SVM","SVM",61,29,912,907,5,3000,2594,406,0.941525065886226,0.641025641025641,1.80276497695853,795,387,408,7,1.1,76.69,6.4,0,0,0,0,0,0,0.00351453286466101,1.52322661772574,0.382152268506731
8.7,"eps_greedy_SVM","SVM",61,30,812,808,4,3100,2693,407,0.941126108417423,0.635897435897436,1.79779411764706,800,389,411,5,1.1,79.24,6.6,0,0,0,0,0,0,0.00292995085048984,1.18562871808736,0.32477459968744
8.7,"eps_greedy_SVM","SVM",61,31,712,709,3,3200,2792,408,0.941041657566361,0.635897435897436,1.80110497237569,803,390,413,3,1.1,81.8,6.8,0,0,0,0,0,0,0.00269916351900068,1.02677226191785,0.308016933956086
8.7,"eps_greedy_SVM","SVM",61,32,612,609,3,3300,2892,408,0.94099215189505,0.635897435897436,1.79779411764706,802,391,411,-1,1.1,84.36,7.1,0,0,0,0,0,0,0.00203547945792971,0.693281887219318,0.233911494552448
8.7,"eps_greedy_SVM","SVM",61,33,512,509,3,3400,2992,408,0.941006712386612,0.635897435897436,1.80110497237569,804,392,412,2,1.1,86.91,7.3,0,0,0,0,0,0,0.00143364512344626,0.447933962494275,0.170085714022566
8.7,"eps_greedy_SVM","SVM",61,34,412,410,2,3500,3091,409,0.940954294616989,0.635897435897436,1.79779411764706,812,395,417,8,1.1,89.47,7.6,0,0,0,0,0,0,0.00111072686501289,0.326011926278678,0.133312968076935
8.7,"eps_greedy_SVM","SVM",61,35,312,312,0,3600,3189,411,0.94118435038367,0.635897435897436,1.79285059578368,819,399,420,7,1.1,92.02,7.8,0,0,0,0,0,0,0.00120077074515549,0.309229937894136,0.152124358454333
8.7,"eps_greedy_SVM","SVM",61,36,212,212,0,3700,3289,411,0.941040201517205,0.635897435897436,1.79449541284404,823,402,421,4,1,94.58,8,0,0,0,0,0,0,0.000657430054115664,0.134169661617295,0.0819831000065477
8.7,"eps_greedy_SVM","SVM",61,37,112,112,0,3800,3389,411,0.941021272878174,0.635897435897436,1.79944802207912,828,404,424,5,1,97.14,8.2,0,0,0,0,0,0,0.000308243556027372,0.0502828882265096,0.0469997892564895
8.7,"eps_greedy_SVM","SVM",61,38,12,12,0,3900,3489,411,0.941044569664673,0.630769230769231,1.79944802207912,827,405,422,-1,1,99.69,8.5,0,0,0,0,0,0,0.00015776169786583,0.00227063728808454,0.00227063728808454
8.7,"eps_greedy_SVM","SVM",61,39,0,0,0,3912,3501,411,0.941019816829017,0.630769230769231,1.79449541284404,827,405,422,0,1,100,8.5,0,0,0,0,0,0,0,0,0
8.7,"eps_greedy_SVM","SVM",62,0,3812,3410,402,100,89,11,0.778211597635913,0.373056994818653,1.53134430336503,32,11,21,0,1.9,2.56,8.1,0,0,0,0,0,0,0.756770990022506,596.273641008579,87.7684299285339
8.7,"eps_greedy_SVM","SVM",62,1,3712,3331,381,200,168,32,0.898832947842673,0.595854922279793,1.70935746519902,80,32,48,48,1.5,5.11,5.2,0,0,0,0,0,0,0.436769557193497,467.760682596315,50.0221602804044
8.7,"eps_greedy_SVM","SVM",62,2,3612,3307,305,300,192,108,0.926464840018938,0.637305699481865,1.7714773274354,149,75,74,69,1,7.67,1.8,0,0,0,0,0,0,0.650197876607299,321.295432597191,74.8963567345863
8.7,"eps_greedy_SVM","SVM",62,3,3512,3277,235,400,222,178,0.921042499977956,0.626943005181347,1.74672046990282,208,107,101,59,0.9,10.22,1.2,0,0,0,0,0,0,0.486937714479373,196.642680070254,65.1148695220201
8.7,"eps_greedy_SVM","SVM",62,4,3412,3231,181,500,268,232,0.914717906065667,0.621761658031088,1.71395915879305,291,147,144,83,1,12.78,1.2,0,0,0,0,0,0,0.338096115220866,147.894489016982,50.5824854493782
8.7,"eps_greedy_SVM","SVM",62,5,3312,3178,134,600,321,279,0.907438157403647,0.626943005181347,1.70935746519902,385,192,193,94,1,15.34,1.2,0,0,0,0,0,0,0.21471035730332,127.989454305893,28.1670909535327
8.7,"eps_greedy_SVM","SVM",62,6,3212,3105,107,700,394,306,0.896411263184799,0.637305699481865,1.66738418165194,459,225,234,74,1,17.89,1.3,0,0,0,0,0,0,0.115674131042701,89.9617975776568,16.3695568988124
8.7,"eps_greedy_SVM","SVM",62,7,3112,3020,92,800,479,321,0.88859074998751,0.642487046632124,1.63312627028884,501,244,257,42,1.1,20.45,1.5,0,0,0,0,0,0,0.0762999430880058,73.5244711913022,9.4627997279358
8.7,"eps_greedy_SVM","SVM",62,8,3012,2934,78,900,565,335,0.898403862939719,0.652849740932642,1.63162385421682,539,262,277,38,1.1,23.01,1.7,0,0,0,0,0,0,0.0587465365742258,71.5578362812008,7.4196174249824
8.7,"eps_greedy_SVM","SVM",62,9,2912,2849,63,1000,650,350,0.906491819466943,0.652849740932642,1.64094741909805,581,279,302,42,1.1,25.56,1.9,0,0,0,0,0,0,0.0718573299005419,104.291127127536,8.90957566585428
8.7,"eps_greedy_SVM","SVM",62,10,2812,2759,53,1100,740,360,0.91496183789409,0.658031088082902,1.71711562133226,610,292,318,29,1.1,28.12,2.1,0,0,0,0,0,0,0.0725566892143356,88.1688544141958,8.17915067255014
8.7,"eps_greedy_SVM","SVM",62,11,2712,2667,45,1200,832,368,0.917749420294549,0.66839378238342,1.71395915879305,638,307,331,28,1.1,30.67,2.3,0,0,0,0,0,0,0.0693304328046154,79.1321349527976,7.59561363868107
8.7,"eps_greedy_SVM","SVM",62,12,2612,2575,37,1300,924,376,0.922976320979014,0.663212435233161,1.72485950302921,655,315,340,17,1.1,33.23,2.5,0,0,0,0,0,0,0.0683264588896596,70.9654535779374,7.39214286668481
8.7,"eps_greedy_SVM","SVM",62,13,2512,2479,33,1400,1020,380,0.924722049967816,0.663212435233161,1.75606122107877,672,319,353,17,1.1,35.79,2.7,0,0,0,0,0,0,0.0611828154594765,59.8137619685659,6.59536592201913
8.7,"eps_greedy_SVM","SVM",62,14,2412,2387,25,1500,1112,388,0.922467884758366,0.663212435233161,1.73577992156414,688,328,360,16,1.1,38.34,2.9,0,0,0,0,0,0,0.0603943008433661,55.5248435052278,6.89335176888023
8.7,"eps_greedy_SVM","SVM",62,15,2312,2294,18,1600,1205,395,0.921969734819641,0.66839378238342,1.72327415422127,708,336,372,20,1.1,40.9,3.1,0,0,0,0,0,0,0.0534991103212761,51.2130938567298,6.0315117353324
8.7,"eps_greedy_SVM","SVM",62,16,2212,2197,15,1700,1302,398,0.921020457945267,0.663212435233161,1.71395915879305,715,340,375,7,1.1,43.46,3.3,0,0,0,0,0,0,0.0404448991595606,41.2334493938397,4.60457681024288
8.7,"eps_greedy_SVM","SVM",62,17,2112,2098,14,1800,1401,399,0.924807279160868,0.66839378238342,1.74030460040823,721,344,377,6,1.1,46.01,3.5,0,0,0,0,0,0,0.0337487324485409,35.4720313658999,3.76100690271142
8.7,"eps_greedy_SVM","SVM",62,18,2012,2000,12,1900,1499,401,0.924387011070967,0.66839378238342,1.73577992156414,731,348,383,10,1.1,48.57,3.7,0,0,0,0,0,0,0.0301872222132441,31.4027282991571,3.27999851385257
8.7,"eps_greedy_SVM","SVM",62,19,1912,1900,12,2000,1599,401,0.924494282296714,0.663212435233161,1.75444422179601,735,353,382,4,1.1,51.12,4,0,0,0,0,0,0,0.0251022160821185,24.4199376710237,2.72632981237184
8.7,"eps_greedy_SVM","SVM",62,20,1812,1802,10,2100,1697,403,0.926738161224247,0.663212435233161,1.74672046990282,744,356,388,9,1.1,53.68,4.2,0,0,0,0,0,0,0.0205337450285683,19.6021024406903,2.22431570544331
8.7,"eps_greedy_SVM","SVM",62,21,1712,1704,8,2200,1795,405,0.928836562736048,0.658031088082902,1.74350663279168,752,361,391,8,1.1,56.24,4.4,0,0,0,0,0,0,0.0175860199730392,17.0030515468471,1.92089264005199
8.7,"eps_greedy_SVM","SVM",62,22,1612,1604,8,2300,1895,405,0.929374388333608,0.658031088082902,1.75730379807007,756,361,395,4,1.1,58.79,4.7,0,0,0,0,0,0,0.0151294369737557,13.4983295086963,1.54587480211262
8.7,"eps_greedy_SVM","SVM",62,23,1512,1504,8,2400,1995,405,0.929012898997539,0.658031088082902,1.76540197225472,774,375,399,18,1.1,61.35,4.9,0,0,0,0,0,0,0.00953468155049118,6.9988331517537,1.23968303160654
8.7,"eps_greedy_SVM","SVM",62,24,1412,1405,7,2500,2094,406,0.92882774592297,0.652849740932642,1.76377637191195,780,376,404,6,1.1,63.91,5.2,0,0,0,0,0,0,0.00805030672910226,6.28564237425816,0.897323033189438
8.7,"eps_greedy_SVM","SVM",62,25,1312,1306,6,2600,2193,407,0.928692554789158,0.652849740932642,1.76540197225472,781,379,402,1,1.1,66.46,5.4,0,0,0,0,0,0,0.00750285995079806,5.36656899657433,0.769868545091564
8.7,"eps_greedy_SVM","SVM",62,26,1212,1207,5,2700,2292,408,0.928962937056776,0.663212435233161,1.76377637191195,792,385,407,11,1.1,69.02,5.6,0,0,0,0,0,0,0.00558250520391544,3.67700497156359,0.670110138113528
8.7,"eps_greedy_SVM","SVM",62,27,1112,1107,5,2800,2392,408,0.928957059181392,0.658031088082902,1.76215376255416,791,385,406,-1,1.1,71.57,5.9,0,0,0,0,0,0,0.00458285594885649,2.77382686461991,0.474633788005654
8.7,"eps_greedy_SVM","SVM",62,28,1012,1007,5,2900,2492,408,0.930292806362206,0.658031088082902,1.76377637191195,800,390,410,9,1.1,74.13,6.1,0,0,0,0,0,0,0.0037998853737353,2.06203996195598,0.410880104704955
8.7,"eps_greedy_SVM","SVM",62,29,912,907,5,3000,2592,408,0.930373627148723,0.658031088082902,1.76215376255416,803,390,413,3,1.1,76.69,6.4,0,0,0,0,0,0,0.00348188816056502,1.58980397753107,0.356455923924788
8.7,"eps_greedy_SVM","SVM",62,30,812,808,4,3100,2691,409,0.930426528027169,0.658031088082902,1.76540197225472,810,395,415,7,1.1,79.24,6.6,0,0,0,0,0,0,0.0027917683627535,1.1132066020849,0.300272735628978
8.7,"eps_greedy_SVM","SVM",62,31,712,709,3,3200,2790,410,0.931043704942404,0.652849740932642,1.76540197225472,809,396,413,-1,1,81.8,6.8,0,0,0,0,0,0,0.00246557004609352,0.778383973375147,0.266679611827753
8.7,"eps_greedy_SVM","SVM",62,32,612,610,2,3300,2889,411,0.931369927026169,0.658031088082902,1.76540197225472,816,398,418,7,1.1,84.36,7,0,0,0,0,0,0,0.00167077783211117,0.481609075873705,0.203228805532479
8.7,"eps_greedy_SVM","SVM",62,33,512,510,2,3400,2989,411,0.93166969867071,0.658031088082902,1.76053413593417,816,398,418,0,1.1,86.91,7.3,0,0,0,0,0,0,0.00101734596466042,0.299603198994623,0.138762314446637
8.7,"eps_greedy_SVM","SVM",62,34,412,411,1,3500,3088,412,0.932804128619664,0.658031088082902,1.75891748383505,827,403,424,11,1.1,89.47,7.5,0,0,0,0,0,0,0.000776877949153224,0.20247795102719,0.0976937915255396
8.7,"eps_greedy_SVM","SVM",62,35,312,312,0,3600,3187,413,0.933513882072194,0.658031088082902,1.76377637191195,833,405,428,6,1.1,92.02,7.7,0,0,0,0,0,0,0.000466771945614549,0.122240868196625,0.0660679032861429
8.7,"eps_greedy_SVM","SVM",62,36,212,212,0,3700,3287,413,0.93380336743482,0.658031088082902,1.76540197225472,836,408,428,3,1,94.58,8,0,0,0,0,0,0,0.000203032646176088,0.0438472659065761,0.0281738311453228
8.7,"eps_greedy_SVM","SVM",62,37,112,112,0,3800,3387,413,0.934361765596223,0.658031088082902,1.76053413593417,838,409,429,2,1,97.14,8.2,0,0,0,0,0,0,7.20262934998719e-05,0.0131033574901594,0.0123373083575948
8.7,"eps_greedy_SVM","SVM",62,38,12,12,0,3900,3487,413,0.934826117751493,0.652849740932642,1.76053413593417,839,409,430,1,1.1,99.69,8.4,0,0,0,0,0,0,4.04959936800876e-05,0.000664767674855005,0.000664767674855005
8.7,"eps_greedy_SVM","SVM",62,39,0,0,0,3912,3499,413,0.934854037659563,0.652849740932642,1.76377637191195,840,409,431,1,1.1,100,8.5,0,0,0,0,0,0,0,0,0
8.7,"eps_greedy_SVM","SVM",63,0,3812,3428,384,100,88,12,0.884309714722079,0.538095238095238,1.71061261970353,33,12,21,0,1.8,2.56,7.3,0,0,0,0,0,0,0.567290857009803,532.090868794213,63.3302770419819
8.7,"eps_greedy_SVM","SVM",63,1,3712,3378,334,200,138,62,0.914794359897451,0.60952380952381,1.75498949579832,124,58,66,91,1.1,5.11,2.2,0,0,0,0,0,0,0.738103961003598,570.428791257978,80.0178202877633
8.7,"eps_greedy_SVM","SVM",63,2,3612,3336,276,300,180,120,0.908700158184699,0.628571428571429,1.74642857142857,188,92,96,64,1,7.67,1.5,0,0,0,0,0,0,0.583183329594066,459.834792740467,66.9249281714709
8.7,"eps_greedy_SVM","SVM",63,3,3512,3304,208,400,212,188,0.914512082037853,0.661904761904762,1.72771874590056,250,121,129,62,1.1,10.22,1.1,0,0,0,0,0,0,0.487548212357836,349.521605214018,61.3457500482905
8.7,"eps_greedy_SVM","SVM",63,4,3412,3250,162,500,266,234,0.900864561173837,0.638095238095238,1.69738356881214,333,167,166,83,1,12.78,1.1,0,0,0,0,0,0,0.358252428646754,353.568851879029,48.6362604985052
8.7,"eps_greedy_SVM","SVM",63,5,3312,3192,120,600,324,276,0.888845251731848,0.685714285714286,1.63363505181687,415,206,209,82,1,15.34,1.2,0,0,0,0,0,0,0.202311624350824,242.75162448345,26.9133974012168
8.7,"eps_greedy_SVM","SVM",63,6,3212,3125,87,700,391,309,0.873720885834297,0.69047619047619,1.59526440410418,496,242,254,81,1,17.89,1.3,0,0,0,0,0,0,0.158911312161839,227.802969148374,19.9214580462724
8.7,"eps_greedy_SVM","SVM",63,7,3112,3048,64,800,468,332,0.876782305132822,0.69047619047619,1.59673469387755,559,268,291,63,1.1,20.45,1.4,0,0,0,0,0,0,0.11929171950893,203.456008829049,15.5754300208024
8.7,"eps_greedy_SVM","SVM",63,8,3012,2962,50,900,554,346,0.901974581356026,0.695238095238095,1.672454617206,597,286,311,38,1.1,23.01,1.6,0,0,0,0,0,0,0.0900657266027247,142.92062650151,10.299784615161
8.7,"eps_greedy_SVM","SVM",63,9,2912,2871,41,1000,645,355,0.909260622920407,0.69047619047619,1.69506302521008,625,298,327,28,1.1,25.56,1.8,0,0,0,0,0,0,0.0846583028985281,125.227914760773,9.64835500060296
8.7,"eps_greedy_SVM","SVM",63,10,2812,2776,36,1100,740,360,0.918770795832648,0.680952380952381,1.71533806892923,643,310,333,18,1.1,28.12,2.1,0,0,0,0,0,0,0.0705126705285828,95.0105839453274,7.86588517805589
8.7,"eps_greedy_SVM","SVM",63,11,2712,2681,31,1200,835,365,0.923902252768227,0.680952380952381,1.74267281105991,656,316,340,13,1.1,30.67,2.3,0,0,0,0,0,0,0.0682187142993602,82.3913136088853,7.51113760713117
8.7,"eps_greedy_SVM","SVM",63,12,2612,2582,30,1300,934,366,0.925265913925707,0.680952380952381,1.74267281105991,663,318,345,7,1.1,33.23,2.6,0,0,0,0,0,0,0.0587662913817246,65.4445324088977,6.16173059234293
8.7,"eps_greedy_SVM","SVM",63,13,2512,2487,25,1400,1029,371,0.926550482736044,0.676190476190476,1.75660402155342,675,325,350,12,1.1,35.79,2.8,0,0,0,0,0,0,0.0538215001296889,57.8670821356798,6.04234415372267
8.7,"eps_greedy_SVM","SVM",63,14,2412,2391,21,1500,1125,375,0.928435062455672,0.676190476190476,1.76842659644503,689,329,360,14,1.1,38.34,3,0,0,0,0,0,0,0.0447815934386411,45.7922879118797,5.11084854963058
8.7,"eps_greedy_SVM","SVM",63,15,2312,2297,15,1600,1219,381,0.930021000381822,0.676190476190476,1.76679821099711,702,334,368,13,1.1,40.9,3.2,0,0,0,0,0,0,0.0379559718271487,40.7566727761912,4.50922558168283
8.7,"eps_greedy_SVM","SVM",63,16,2212,2201,11,1700,1315,385,0.930678285059728,0.676190476190476,1.76679821099711,715,339,376,13,1.1,43.46,3.4,0,0,0,0,0,0,0.0334259709292442,37.1344290401021,3.65379714595296
8.7,"eps_greedy_SVM","SVM",63,17,2112,2101,11,1800,1415,385,0.930646920853106,0.676190476190476,1.76842659644503,719,340,379,4,1.1,46.01,3.7,0,0,0,0,0,0,0.0240607826273724,27.1340836820858,2.66487048474668
8.7,"eps_greedy_SVM","SVM",63,18,2012,2002,10,1900,1514,386,0.930314187530685,0.676190476190476,1.76842659644503,725,343,382,6,1.1,48.57,3.9,0,0,0,0,0,0,0.0216456998224801,23.1354381551206,2.22584965171297
8.7,"eps_greedy_SVM","SVM",63,19,1912,1903,9,2000,1613,387,0.92845960835652,0.666666666666667,1.77537490134175,740,358,382,15,1.1,51.12,4.2,0,0,0,0,0,0,0.0148683303239603,12.0578153440716,1.96744325455087
8.7,"eps_greedy_SVM","SVM",63,20,1812,1804,8,2100,1712,388,0.928518245786291,0.666666666666667,1.77211134453782,742,358,384,2,1.1,53.68,4.4,0,0,0,0,0,0,0.0127886723519232,11.7635758564044,1.4439792394283
8.7,"eps_greedy_SVM","SVM",63,21,1712,1705,7,2200,1811,389,0.928523700430922,0.666666666666667,1.77211134453782,746,360,386,4,1.1,56.24,4.7,0,0,0,0,0,0,0.00976033905657671,9.07543942949802,1.04562749275169
8.7,"eps_greedy_SVM","SVM",63,22,1612,1605,7,2300,1911,389,0.928593247149953,0.666666666666667,1.7737416217637,748,360,388,2,1.1,58.79,4.9,0,0,0,0,0,0,0.00881658963718527,7.69209287389039,0.910956282083523
8.7,"eps_greedy_SVM","SVM",63,23,1512,1505,7,2400,2011,389,0.928582337860694,0.666666666666667,1.76842659644503,754,365,389,6,1.1,61.35,5.2,0,0,0,0,0,0,0.00736953947889905,5.96104212295952,0.790450682103314
8.7,"eps_greedy_SVM","SVM",63,24,1412,1407,5,2500,2109,391,0.928814160257467,0.666666666666667,1.77211134453782,759,369,390,5,1.1,63.91,5.4,0,0,0,0,0,0,0.00760587963123916,5.73086647240144,0.796677960288502
8.7,"eps_greedy_SVM","SVM",63,25,1312,1307,5,2600,2209,391,0.928844160802929,0.671428571428571,1.77048406139315,769,374,395,10,1.1,66.46,5.6,0,0,0,0,0,0,0.0056611547840493,3.89256438162712,0.640621844999578
8.7,"eps_greedy_SVM","SVM",63,26,1212,1207,5,2700,2309,391,0.92903234604266,0.671428571428571,1.77048406139315,770,374,396,1,1.1,69.02,5.9,0,0,0,0,0,0,0.00505540959303643,2.98716394665215,0.513028202769011
8.7,"eps_greedy_SVM","SVM",63,27,1112,1107,5,2800,2409,391,0.929003709158353,0.666666666666667,1.77211134453782,774,377,397,4,1.1,71.57,6.2,0,0,0,0,0,0,0.00370989259690224,1.95669648309602,0.401485088185702
8.7,"eps_greedy_SVM","SVM",63,28,1012,1008,4,2900,2508,392,0.929040528009604,0.666666666666667,1.7737416217637,776,378,398,2,1.1,74.13,6.4,0,0,0,0,0,0,0.00379921370644885,1.72778306809359,0.392491410752836
8.7,"eps_greedy_SVM","SVM",63,29,912,909,3,3000,2607,393,0.928736431571488,0.666666666666667,1.77537490134175,784,382,402,8,1.1,76.69,6.6,0,0,0,0,0,0,0.00315701713898562,1.27799331884279,0.340585115111381
8.7,"eps_greedy_SVM","SVM",63,30,812,810,2,3100,2706,394,0.92862188403426,0.666666666666667,1.77211134453782,792,385,407,8,1.1,79.24,6.9,0,0,0,0,0,0,0.0031034832426646,1.16599975543474,0.345344250938355
8.7,"eps_greedy_SVM","SVM",63,31,712,710,2,3200,2806,394,0.928680521464032,0.666666666666667,1.7770111915734,793,385,408,1,1.1,81.8,7.1,0,0,0,0,0,0,0.00232419764051721,0.787865572811964,0.266113596473455
8.7,"eps_greedy_SVM","SVM",63,32,612,611,1,3300,2905,395,0.929317351224572,0.661904761904762,1.77537490134175,794,386,408,1,1.1,84.36,7.4,0,0,0,0,0,0,0.00154050710053776,0.524678037476122,0.19687969354803
8.7,"eps_greedy_SVM","SVM",63,33,512,511,1,3400,3005,395,0.929423716794856,0.657142857142857,1.77537490134175,796,386,410,2,1.1,86.91,7.6,0,0,0,0,0,0,0.00100535949322884,0.322107669146197,0.126264253324079
8.7,"eps_greedy_SVM","SVM",63,34,412,412,0,3500,3104,396,0.929888725249556,0.657142857142857,1.7737416217637,802,389,413,6,1.1,89.47,7.8,0,0,0,0,0,0,0.00078214759903994,0.234915961969807,0.095489214932731
8.7,"eps_greedy_SVM","SVM",63,35,312,312,0,3600,3204,396,0.930008727431415,0.661904761904762,1.76885976408912,808,391,417,6,1.1,92.02,8.1,0,0,0,0,0,0,0.000477649684403787,0.117887521103859,0.056986668189116
8.7,"eps_greedy_SVM","SVM",63,36,212,212,0,3700,3304,396,0.930286914307541,0.657142857142857,1.77537490134175,807,391,416,-1,1.1,94.58,8.3,0,0,0,0,0,0,0.000216518881228844,0.0458296402079708,0.029513377949807
8.7,"eps_greedy_SVM","SVM",63,37,112,112,0,3800,3404,396,0.930657830142375,0.657142857142857,1.7770111915734,808,393,415,1,1.1,97.14,8.6,0,0,0,0,0,0,0.000103383649020904,0.0165058350714107,0.0154465290708718
8.7,"eps_greedy_SVM","SVM",63,38,12,12,0,3900,3504,396,0.931012382043324,0.657142857142857,1.7737416217637,812,394,418,4,1.1,99.69,8.8,0,0,0,0,0,0,6.65374397583508e-05,0.000955576636082232,0.000955576636082232
8.7,"eps_greedy_SVM","SVM",63,39,0,0,0,3912,3516,396,0.931116020291293,0.657142857142857,1.77048406139315,815,394,421,3,1.1,100,8.9,0,0,0,0,0,0,0,0,0
8.7,"eps_greedy_SVM","SVM",64,0,3812,3415,397,100,85,15,0.901570380425259,0.541237113402062,1.74700935911445,37,15,22,0,1.5,2.56,5.7,0,0,0,0,0,0,0.299161710392923,469.447952311288,32.84948517805
8.7,"eps_greedy_SVM","SVM",64,1,3712,3384,328,200,116,84,0.934968756216586,0.577319587628866,1.7759954601343,106,54,52,69,1,5.11,1.4,0,0,0,0,0,0,0.662284621961085,358.551682246345,73.9065708638191
8.7,"eps_greedy_SVM","SVM",64,2,3612,3344,268,300,156,144,0.9305264636016,0.597938144329897,1.77162150627377,168,84,84,62,1,7.67,1.1,0,0,0,0,0,0,0.533057530101972,277.529262830057,65.4781813800643
8.7,"eps_greedy_SVM","SVM",64,3,3512,3303,209,400,197,203,0.902445089343167,0.603092783505155,1.70054634424438,242,122,120,74,1,10.22,1,0,0,0,0,0,0,0.311054336778113,183.486274124555,50.410531720473
8.7,"eps_greedy_SVM","SVM",64,4,3412,3246,166,500,254,246,0.908911791895348,0.61340206185567,1.73292525773196,335,167,168,93,1,12.78,1,0,0,0,0,0,0,0.191562416019184,126.851870232671,28.2502877112907
8.7,"eps_greedy_SVM","SVM",64,5,3312,3174,138,600,326,274,0.895122693284344,0.654639175257732,1.67424572023078,409,199,210,74,1.1,15.34,1.2,0,0,0,0,0,0,0.123218489489414,129.296082952496,16.5611693585571
8.7,"eps_greedy_SVM","SVM",64,6,3212,3094,118,700,406,294,0.901903881484261,0.675257731958763,1.69741746412618,450,215,235,41,1.1,17.89,1.4,0,0,0,0,0,0,0.0852828031267168,98.7406359727184,10.9809272319129
8.7,"eps_greedy_SVM","SVM",64,7,3112,3013,99,800,487,313,0.900060849316041,0.664948453608247,1.68195262078676,498,239,259,48,1.1,20.45,1.6,0,0,0,0,0,0,0.144106451655577,145.27067700079,16.4443907657215
8.7,"eps_greedy_SVM","SVM",64,8,3012,2924,88,900,576,324,0.898460629322347,0.65979381443299,1.66959094832083,541,258,283,43,1.1,23.01,1.8,0,0,0,0,0,0,0.100739579845617,100.845921277715,13.3443345711352
8.7,"eps_greedy_SVM","SVM",64,9,2912,2842,70,1000,658,342,0.901974092233535,0.654639175257732,1.67886645358928,582,276,306,41,1.1,25.56,1.9,0,0,0,0,0,0,0.0891766216780588,86.7590346364209,10.0605895749087
8.7,"eps_greedy_SVM","SVM",64,10,2812,2754,58,1100,746,354,0.898697590601133,0.654639175257732,1.66959094832083,605,289,316,23,1.1,28.12,2.1,0,0,0,0,0,0,0.0851204542109384,87.5077719312447,10.0681706695648
8.7,"eps_greedy_SVM","SVM",64,11,2712,2662,50,1200,838,362,0.901965315889884,0.65979381443299,1.68041237113402,625,299,326,20,1.1,30.67,2.3,0,0,0,0,0,0,0.0807773175278363,78.3720760405278,8.72338464860622
8.7,"eps_greedy_SVM","SVM",64,12,2612,2568,44,1300,932,368,0.901754683642081,0.65979381443299,1.67886645358928,652,307,345,27,1.1,33.23,2.5,0,0,0,0,0,0,0.0688529866378209,64.5302013456237,7.59476693664805
8.7,"eps_greedy_SVM","SVM",64,13,2512,2476,36,1400,1024,376,0.901859999765975,0.654639175257732,1.66959094832083,672,316,356,20,1.1,35.79,2.7,0,0,0,0,0,0,0.0610638446767117,62.6167232799189,6.82848728770838
8.7,"eps_greedy_SVM","SVM",64,14,2412,2380,32,1500,1120,380,0.903825900745413,0.65979381443299,1.66959094832083,683,320,363,11,1.1,38.34,2.9,0,0,0,0,0,0,0.0555539343900499,60.0424444607341,6.06235883919213
8.7,"eps_greedy_SVM","SVM",64,15,2312,2285,27,1600,1215,385,0.913158079501971,0.649484536082474,1.68969641738338,688,327,361,5,1.1,40.9,3.2,0,0,0,0,0,0,0.0484684186319938,54.4433200959943,5.54315858020827
8.7,"eps_greedy_SVM","SVM",64,16,2212,2190,22,1700,1310,390,0.922060217419287,0.654639175257732,1.70669296939463,704,335,369,16,1.1,43.46,3.4,0,0,0,0,0,0,0.0422287044594897,45.5404583097757,4.78029694232443
8.7,"eps_greedy_SVM","SVM",64,17,2112,2096,16,1800,1404,396,0.923157260376565,0.675257731958763,1.70199564929537,727,344,383,23,1.1,46.01,3.5,0,0,0,0,0,0,0.0367619538996494,39.989113128965,4.12007337096784
8.7,"eps_greedy_SVM","SVM",64,18,2012,1999,13,1900,1501,399,0.923239172917376,0.680412371134021,1.70199564929537,733,349,384,6,1.1,48.57,3.8,0,0,0,0,0,0,0.0361559417052918,35.4069314619921,3.63960398248551
8.7,"eps_greedy_SVM","SVM",64,19,1912,1901,11,2000,1599,401,0.929808266145551,0.654639175257732,1.73611664863018,773,374,399,40,1.1,51.12,4,0,0,0,0,0,0,0.0278822291660618,17.835367998707,3.87446930445715
8.7,"eps_greedy_SVM","SVM",64,20,1812,1805,7,2100,1695,405,0.930435774717122,0.654639175257732,1.74059242850246,779,379,400,6,1.1,53.68,4.2,0,0,0,0,0,0,0.0183445258662041,13.6744432933891,2.26779800509181
8.7,"eps_greedy_SVM","SVM",64,21,1712,1706,6,2200,1794,406,0.930108124553882,0.649484536082474,1.74379499046842,777,379,398,-2,1.1,56.24,4.4,0,0,0,0,0,0,0.0150769187118641,12.1383500934196,1.6777298258967
8.7,"eps_greedy_SVM","SVM",64,22,1612,1607,5,2300,1893,407,0.930166633511606,0.649484536082474,1.74379499046842,785,381,404,8,1.1,58.79,4.7,0,0,0,0,0,0,0.012638564985596,10.0548802408434,1.35832092777177
8.7,"eps_greedy_SVM","SVM",64,23,1512,1507,5,2400,1993,407,0.930225142469327,0.649484536082474,1.74540069487954,790,381,409,5,1.1,61.35,4.9,0,0,0,0,0,0,0.0126727942387159,9.25294395921473,1.29553744280292
8.7,"eps_greedy_SVM","SVM",64,24,1412,1407,5,2500,2093,407,0.931215406578753,0.654639175257732,1.74540069487954,796,388,408,6,1.1,63.91,5.1,0,0,0,0,0,0,0.0079300135769077,5.4259573666452,0.946117988086972
8.7,"eps_greedy_SVM","SVM",64,25,1312,1308,4,2600,2192,408,0.931737599026416,0.649484536082474,1.74219223771983,799,387,412,3,1.1,66.46,5.4,0,0,0,0,0,0,0.00805101130152502,5.08912150095052,0.839112931999895
8.7,"eps_greedy_SVM","SVM",64,26,1212,1208,4,2700,2292,408,0.932950197175185,0.654639175257732,1.75468474112889,803,391,412,4,1.1,69.02,5.6,0,0,0,0,0,0,0.0054712952019511,3.15252208480876,0.595192367590465
8.7,"eps_greedy_SVM","SVM",64,27,1112,1108,4,2800,2392,408,0.933133037668063,0.649484536082474,1.75307049573687,805,392,413,2,1.1,71.57,5.9,0,0,0,0,0,0,0.00483213293623633,2.40217379087463,0.501344052621696
8.7,"eps_greedy_SVM","SVM",64,28,1012,1008,4,2900,2492,408,0.933501644101706,0.649484536082474,1.74985089886683,808,394,414,3,1.1,74.13,6.1,0,0,0,0,0,0,0.00430889403363202,1.86214961493734,0.457159780664167
8.7,"eps_greedy_SVM","SVM",64,29,912,908,4,3000,2592,408,0.933706425453731,0.644329896907217,1.74985089886683,809,394,415,1,1.1,76.69,6.4,0,0,0,0,0,0,0.0038291370568305,1.45521693373593,0.414704666189662
8.7,"eps_greedy_SVM","SVM",64,30,812,809,3,3100,2691,409,0.933902430462096,0.644329896907217,1.74985089886683,813,397,416,4,1,79.24,6.6,0,0,0,0,0,0,0.00322745023967633,1.09588424932504,0.362482620024795
8.7,"eps_greedy_SVM","SVM",64,31,712,709,3,3200,2791,409,0.933719589969217,0.644329896907217,1.74824553106971,814,397,417,1,1.1,81.8,6.8,0,0,0,0,0,0,0.00212973821390774,0.679020068401282,0.25482852951174
8.7,"eps_greedy_SVM","SVM",64,32,612,610,2,3300,2890,410,0.934135003569039,0.644329896907217,1.75468474112889,818,399,419,4,1.1,84.36,7,0,0,0,0,0,0,0.0018134246775481,0.546078577253353,0.221741720243814
8.7,"eps_greedy_SVM","SVM",64,33,512,510,2,3400,2990,410,0.934335396749235,0.644329896907217,1.74985089886683,816,399,417,-2,1,86.91,7.3,0,0,0,0,0,0,0.000952276814119134,0.296804600620782,0.130481439144154
8.7,"eps_greedy_SVM","SVM",64,34,412,411,1,3500,3089,411,0.934651345120933,0.649484536082474,1.7514592177077,823,401,422,7,1.1,89.47,7.5,0,0,0,0,0,0,0.000704940834285501,0.205703245063664,0.091330583525378
8.7,"eps_greedy_SVM","SVM",64,35,312,312,0,3600,3188,412,0.934905859087024,0.649484536082474,1.75910936923121,830,405,425,7,1,92.02,7.7,0,0,0,0,0,0,0.00052979424092436,0.130586439570291,0.0663989947512649
8.7,"eps_greedy_SVM","SVM",64,36,212,212,0,3700,3288,412,0.935170612120718,0.644329896907217,1.76999317768344,836,406,430,6,1.1,94.58,8,0,0,0,0,0,0,0.000268504985244181,0.0556078509122253,0.0360378813094289
8.7,"eps_greedy_SVM","SVM",64,37,112,112,0,3800,3388,412,0.935552383069856,0.644329896907217,1.76559456506247,834,407,427,-2,1,97.14,8.2,0,0,0,0,0,0,9.98918251708381e-05,0.0184684825638948,0.0174063817775869
8.7,"eps_greedy_SVM","SVM",64,38,12,12,0,3900,3488,412,0.935637221058556,0.644329896907217,1.75910936923121,836,407,429,2,1.1,99.69,8.5,0,0,0,0,0,0,5.20623812340688e-05,0.000733448974177216,0.000733448974177216
8.7,"eps_greedy_SVM","SVM",64,39,0,0,0,3912,3500,412,0.935610892027582,0.644329896907217,1.75427665118387,836,407,429,0,1.1,100,8.5,0,0,0,0,0,0,0,0,0
8.7,"eps_greedy_SVM","SVM",65,0,3812,3425,387,100,88,12,0.892628776139863,0.51207729468599,1.72438389100381,32,12,20,0,1.7,2.56,7.3,0,0,0,0,0,0,0.330568169579672,399.805860686291,35.6145341340338
8.7,"eps_greedy_SVM","SVM",65,1,3712,3394,318,200,119,81,0.924453725110004,0.570048309178744,1.79120879120879,98,48,50,66,1,5.11,1.5,0,0,0,0,0,0,0.614062404043215,345.049356733693,68.0830184160885
8.7,"eps_greedy_SVM","SVM",65,2,3612,3352,260,300,161,139,0.927304215245162,0.594202898550725,1.794055967408,173,89,84,75,0.9,7.67,1.2,0,0,0,0,0,0,0.5,261.423525071734,60.3507202058268
8.7,"eps_greedy_SVM","SVM",65,3,3512,3309,203,400,204,196,0.921478940346867,0.584541062801932,1.76792893875643,254,129,125,81,1,10.22,1,0,0,0,0,0,0,0.292760970821005,139.737385628904,43.0598827090899
8.7,"eps_greedy_SVM","SVM",65,4,3412,3249,163,500,264,236,0.922953903265651,0.608695652173913,1.76792893875643,339,169,170,85,1,12.78,1.1,0,0,0,0,0,0,0.1514541587527,89.4398094368951,22.2865255910794
8.7,"eps_greedy_SVM","SVM",65,5,3312,3182,130,600,331,269,0.927962976773477,0.652173913043478,1.76305413469736,401,198,203,62,1,15.34,1.2,0,0,0,0,0,0,0.110754453852266,72.7576463273376,17.5014715375673
8.7,"eps_greedy_SVM","SVM",65,6,3212,3107,105,700,406,294,0.925586187276106,0.652173913043478,1.75598309400957,454,218,236,53,1.1,17.89,1.4,0,0,0,0,0,0,0.0942448796537428,72.5337944310331,12.7482829068154
8.7,"eps_greedy_SVM","SVM",65,7,3112,3029,83,800,484,316,0.922157036595097,0.642512077294686,1.73149705073798,506,244,262,52,1.1,20.45,1.5,0,0,0,0,0,0,0.0793121234442087,86.0243039586567,10.2182013540676
8.7,"eps_greedy_SVM","SVM",65,8,3012,2944,68,900,569,331,0.920128272056073,0.666666666666667,1.70382518032612,551,265,286,45,1.1,23.01,1.7,0,0,0,0,0,0,0.0694918665836574,108.541909302502,8.73554275271301
8.7,"eps_greedy_SVM","SVM",65,9,2912,2854,58,1000,659,341,0.9304060567391,0.661835748792271,1.70937304534142,581,279,302,30,1.1,25.56,1.9,0,0,0,0,0,0,0.065749837440812,100.713857499177,8.14163888085284
8.7,"eps_greedy_SVM","SVM",65,10,2812,2767,45,1100,746,354,0.94105258215185,0.676328502415459,1.75436913895993,622,298,324,41,1.1,28.12,2.1,0,0,0,0,0,0,0.0877781840144807,123.490095029701,10.1013898777844
8.7,"eps_greedy_SVM","SVM",65,11,2712,2674,38,1200,839,361,0.94739575133341,0.666666666666667,1.79075503646521,646,311,335,24,1.1,30.67,2.3,0,0,0,0,0,0,0.0744341971203585,91.4886912921757,8.33001106491078
8.7,"eps_greedy_SVM","SVM",65,12,2612,2575,37,1300,938,362,0.948785089064009,0.661835748792271,1.79075503646521,648,312,336,2,1.1,33.23,2.6,0,0,0,0,0,0,0.0617663878806002,72.2368457236237,6.57630836402113
8.7,"eps_greedy_SVM","SVM",65,13,2512,2479,33,1400,1034,366,0.95039539502214,0.652173913043478,1.794055967408,658,318,340,10,1.1,35.79,2.8,0,0,0,0,0,0,0.0610972430698442,60.336183991259,6.51954066739151
8.7,"eps_greedy_SVM","SVM",65,14,2412,2383,29,1500,1130,370,0.950649508483807,0.652173913043478,1.794055967408,677,323,354,19,1.1,38.34,3.1,0,0,0,0,0,0,0.0539122748009905,51.2664948980324,6.10721220772486
8.7,"eps_greedy_SVM","SVM",65,15,2312,2286,26,1600,1227,373,0.951243360595298,0.652173913043478,1.794055967408,681,327,354,4,1.1,40.9,3.3,0,0,0,0,0,0,0.0427585793113461,42.2904687122768,4.92295552032352
8.7,"eps_greedy_SVM","SVM",65,16,2212,2192,20,1700,1321,379,0.951003057647857,0.647342995169082,1.79075503646521,698,334,364,17,1.1,43.46,3.5,0,0,0,0,0,0,0.0365929368731645,39.0514956572042,4.26976744299511
8.7,"eps_greedy_SVM","SVM",65,17,2112,2097,15,1800,1416,384,0.952008463083124,0.647342995169082,1.79075503646521,720,341,379,22,1.1,46.01,3.7,0,0,0,0,0,0,0.0321974687809253,36.1704207143519,3.59241972928914
8.7,"eps_greedy_SVM","SVM",65,18,2012,1998,14,1900,1515,385,0.952103755631244,0.647342995169082,1.78910912190963,722,342,380,2,1.1,48.57,3.9,0,0,0,0,0,0,0.0282755930232888,30.1712384068175,2.94755353803791
8.7,"eps_greedy_SVM","SVM",65,19,1912,1899,13,2000,1614,386,0.951914551586416,0.657004830917874,1.79944802207912,733,356,377,11,1.1,51.12,4.2,0,0,0,0,0,0,0.0196325135689068,15.2934357040096,2.41910145907203
8.7,"eps_greedy_SVM","SVM",65,20,1812,1800,12,2100,1713,387,0.951873120043755,0.661835748792271,1.79779411764706,734,357,377,1,1.1,53.68,4.4,0,0,0,0,0,0,0.0150138137269912,13.8811342075099,1.7307689308524
8.7,"eps_greedy_SVM","SVM",65,21,1712,1705,7,2200,1808,392,0.951834450603937,0.657004830917874,1.79779411764706,748,363,385,14,1.1,56.24,4.6,0,0,0,0,0,0,0.0147117802971593,13.7177993857021,1.61601176282438
8.7,"eps_greedy_SVM","SVM",65,22,1612,1605,7,2300,1908,392,0.950671605306555,0.657004830917874,1.80276497695853,758,370,388,10,1,58.79,4.9,0,0,0,0,0,0,0.0127302877000514,11.1584712641239,1.41922318378131
8.7,"eps_greedy_SVM","SVM",65,23,1512,1505,7,2400,2008,392,0.950891192482664,0.657004830917874,1.80110497237569,759,370,389,1,1.1,61.35,5.1,0,0,0,0,0,0,0.0120096832894804,9.65749697934153,1.21829712671777
8.7,"eps_greedy_SVM","SVM",65,24,1412,1406,6,2500,2107,393,0.950326342451038,0.647342995169082,1.79779411764706,772,377,395,13,1,63.91,5.4,0,0,0,0,0,0,0.00799521513501855,5.91848517349889,0.937359160891229
8.7,"eps_greedy_SVM","SVM",65,25,1312,1307,5,2600,2206,394,0.950189618360254,0.642512077294686,1.79779411764706,775,378,397,3,1.1,66.46,5.6,0,0,0,0,0,0,0.00764008798304082,5.53402228862616,0.810358339205969
8.7,"eps_greedy_SVM","SVM",65,26,1212,1207,5,2700,2306,394,0.950121946840573,0.642512077294686,1.79944802207912,778,380,398,3,1,69.02,5.9,0,0,0,0,0,0,0.00637749038214059,4.04957221509496,0.652741992674009
8.7,"eps_greedy_SVM","SVM",65,27,1112,1108,4,2800,2405,395,0.950146805766169,0.642512077294686,1.79779411764706,789,384,405,11,1.1,71.57,6.1,0,0,0,0,0,0,0.00603388223305859,3.52679682643065,0.640908262616049
8.7,"eps_greedy_SVM","SVM",65,28,1012,1009,3,2900,2504,396,0.950182713103143,0.642512077294686,1.80110497237569,795,386,409,6,1.1,74.13,6.3,0,0,0,0,0,0,0.00509142580457726,2.58800212345331,0.528854017866186
8.7,"eps_greedy_SVM","SVM",65,29,912,909,3,3000,2604,396,0.950005938521119,0.642512077294686,1.79944802207912,797,388,409,2,1.1,76.69,6.6,0,0,0,0,0,0,0.00435458755726057,1.90632831761541,0.46123576671489
8.7,"eps_greedy_SVM","SVM",65,30,812,809,3,3100,2704,396,0.949950696464236,0.642512077294686,1.79944802207912,797,389,408,0,1,79.24,6.8,0,0,0,0,0,0,0.00321526972734933,1.24270856330182,0.349349140120179
8.7,"eps_greedy_SVM","SVM",65,31,712,709,3,3200,2804,396,0.950028035343872,0.642512077294686,1.79944802207912,798,389,409,1,1.1,81.8,7.1,0,0,0,0,0,0,0.00250649434505051,0.865671901182678,0.284833371227259
8.7,"eps_greedy_SVM","SVM",65,32,612,609,3,3300,2904,396,0.95011366053204,0.642512077294686,1.79285059578368,799,389,410,1,1.1,84.36,7.3,0,0,0,0,0,0,0.00193501378323385,0.609416530939811,0.226008877772851
8.7,"eps_greedy_SVM","SVM",65,33,512,509,3,3400,3004,396,0.95020757202874,0.63768115942029,1.79285059578368,801,389,412,2,1.1,86.91,7.6,0,0,0,0,0,0,0.00115940010572832,0.360846813538954,0.15125566115877
8.7,"eps_greedy_SVM","SVM",65,34,412,412,0,3500,3101,399,0.950505879135906,0.647342995169082,1.79944802207912,812,394,418,11,1.1,89.47,7.8,0,0,0,0,0,0,0.00127979172341297,0.381463000170982,0.173074725435918
8.7,"eps_greedy_SVM","SVM",65,35,312,312,0,3600,3201,399,0.950641222175269,0.642512077294686,1.79449541284404,818,396,422,6,1.1,92.02,8,0,0,0,0,0,0,0.00104542035036111,0.273042267709859,0.133700407049639
8.7,"eps_greedy_SVM","SVM",65,36,212,212,0,3700,3301,399,0.950867714608489,0.63768115942029,1.80276497695853,817,397,420,-1,1.1,94.58,8.3,0,0,0,0,0,0,0.000326603838723894,0.0678585118478516,0.0423186358214958
8.7,"eps_greedy_SVM","SVM",65,37,112,112,0,3800,3401,399,0.95115497330428,0.632850241545894,1.79944802207912,815,398,417,-2,1,97.14,8.5,0,0,0,0,0,0,0.000127422940691947,0.0206659984393572,0.0193206061456741
8.7,"eps_greedy_SVM","SVM",65,38,12,12,0,3900,3501,399,0.951138400687215,0.63768115942029,1.79614325068871,816,399,417,1,1,99.69,8.8,0,0,0,0,0,0,0.00013717822451643,0.00184288555015858,0.00184288555015858
8.7,"eps_greedy_SVM","SVM",65,39,0,0,0,3912,3513,399,0.951157735407124,0.63768115942029,1.80276497695853,817,399,418,1,1,100,8.8,0,0,0,0,0,0,0,0,0
8.7,"eps_greedy_SVM","SVM",66,0,3812,3404,408,100,94,6,0.901080050075587,0.541666666666667,1.73703917050691,20,6,14,0,2.3,2.56,15.7,0,0,0,0,0,0,0.164782213421215,256.544012523125,18.5143926293423
8.7,"eps_greedy_SVM","SVM",66,1,3712,3362,350,200,136,64,0.91466187169312,0.583333333333333,1.76195952161914,95,47,48,75,1,5.11,2.1,0,0,0,0,0,0,0.76629223372472,311.844518251845,85.2327619761381
8.7,"eps_greedy_SVM","SVM",66,2,3612,3337,275,300,161,139,0.920189082577479,0.588541666666667,1.76195952161914,136,70,66,41,0.9,7.67,1.2,0,0,0,0,0,0,0.566738695911321,166.281360962414,72.1293347479655
8.7,"eps_greedy_SVM","SVM",66,3,3512,3290,222,400,208,192,0.905048304043864,0.572916666666667,1.74936868686869,222,115,107,86,0.9,10.22,1.1,0,0,0,0,0,0,0.267332880968846,95.0029053897879,45.3454996437954
8.7,"eps_greedy_SVM","SVM",66,4,3412,3235,177,500,263,237,0.898717994142101,0.614583333333333,1.74161305147059,309,154,155,87,1,12.78,1.1,0,0,0,0,0,0,0.128223983750796,52.5269750188147,21.8577873549033
8.7,"eps_greedy_SVM","SVM",66,5,3312,3177,135,600,321,279,0.881665426587297,0.651041666666667,1.65101289134438,399,200,199,90,1,15.34,1.2,0,0,0,0,0,0,0.115333692041877,64.0890587524292,18.1157397296718
8.7,"eps_greedy_SVM","SVM",66,6,3212,3093,119,700,405,295,0.895202959656097,0.645833333333333,1.6697744014733,441,215,226,42,1.1,17.89,1.4,0,0,0,0,0,0,0.0742109927953269,48.2091091748751,10.2562859735333
8.7,"eps_greedy_SVM","SVM",66,7,3112,3016,96,800,482,318,0.904590655706716,0.666666666666667,1.6713133640553,483,238,245,42,1,20.45,1.5,0,0,0,0,0,0,0.0645202212556482,54.0287248063753,9.07840776388295
8.7,"eps_greedy_SVM","SVM",66,8,3012,2938,74,900,560,340,0.896271789965983,0.666666666666667,1.64163213627993,535,259,276,52,1.1,23.01,1.6,0,0,0,0,0,0,0.061340065817963,82.242238544838,10.7566696754038
8.7,"eps_greedy_SVM","SVM",66,9,2912,2852,60,1000,646,354,0.898723899281945,0.6875,1.66192396313364,577,276,301,42,1.1,25.56,1.8,0,0,0,0,0,0,0.0615686139265161,82.9250436671824,6.85207772682593
8.7,"eps_greedy_SVM","SVM",66,10,2812,2759,53,1100,739,361,0.915113614890415,0.671875,1.68698252069917,607,293,314,30,1.1,28.12,2,0,0,0,0,0,0,0.0461165621063116,57.6913828697524,5.83869920359542
8.7,"eps_greedy_SVM","SVM",66,11,2712,2668,44,1200,830,370,0.923974277210894,0.671875,1.71826036866359,634,305,329,27,1.1,30.67,2.2,0,0,0,0,0,0,0.0480942070200244,67.4711880004282,5.71457517536385
8.7,"eps_greedy_SVM","SVM",66,12,2612,2576,36,1300,922,378,0.930028521825421,0.666666666666667,1.73543968692449,655,315,340,21,1.1,33.23,2.4,0,0,0,0,0,0,0.0587214620653296,64.7340744722754,6.74339207195416
8.7,"eps_greedy_SVM","SVM",66,13,2512,2480,32,1400,1018,382,0.935619212962993,0.65625,1.76195952161914,673,324,349,18,1.1,35.79,2.7,0,0,0,0,0,0,0.056405571369722,55.4952004844349,6.18663657975251
8.7,"eps_greedy_SVM","SVM",66,14,2412,2382,30,1500,1116,384,0.935893801965262,0.65625,1.76358195211786,683,328,355,10,1.1,38.34,2.9,0,0,0,0,0,0,0.0466899477916171,42.265286247207,5.08131125649564
8.7,"eps_greedy_SVM","SVM",66,15,2312,2286,26,1600,1212,388,0.936144770408192,0.65625,1.76358195211786,690,333,357,7,1.1,40.9,3.1,0,0,0,0,0,0,0.0441078918814066,35.9185409476306,5.02517295369583
8.7,"eps_greedy_SVM","SVM",66,16,2212,2193,19,1700,1305,395,0.936970013699949,0.65625,1.76358195211786,720,344,376,30,1.1,43.46,3.3,0,0,0,0,0,0,0.0430592724483471,34.7224388657069,5.2965173584199
8.7,"eps_greedy_SVM","SVM",66,17,2112,2096,16,1800,1402,398,0.937808543556333,0.65625,1.76358195211786,729,347,382,9,1.1,46.01,3.5,0,0,0,0,0,0,0.0325183405198586,31.2064318200415,3.89797680288697
8.7,"eps_greedy_SVM","SVM",66,18,2012,1998,14,1900,1500,400,0.938249952758902,0.65625,1.76520737327189,733,350,383,4,1.1,48.57,3.8,0,0,0,0,0,0,0.0266165008872911,25.6607409243022,2.92027176692279
8.7,"eps_greedy_SVM","SVM",66,19,1912,1899,13,2000,1599,401,0.938151041666691,0.65625,1.76358195211786,739,353,386,6,1.1,51.12,4,0,0,0,0,0,0,0.0203151381967098,19.2897712792424,2.15260736757987
8.7,"eps_greedy_SVM","SVM",66,20,1812,1799,13,2100,1699,401,0.93769782218445,0.640625,1.77459677419355,743,360,383,4,1.1,53.68,4.2,0,0,0,0,0,0,0.0143262050614764,12.7457804042901,1.76336932803955
8.7,"eps_greedy_SVM","SVM",66,21,1712,1702,10,2200,1796,404,0.938359197845826,0.635416666666667,1.77459677419355,755,364,391,12,1.1,56.24,4.4,0,0,0,0,0,0,0.0138535644634632,11.8123812816875,1.42266078863216
8.7,"eps_greedy_SVM","SVM",66,22,1612,1602,10,2300,1896,404,0.937390754913097,0.645833333333333,1.78398617511521,768,373,395,13,1.1,58.79,4.7,0,0,0,0,0,0,0.00915150935250605,6.55464409454361,1.14976962558982
8.7,"eps_greedy_SVM","SVM",66,23,1512,1504,8,2400,1994,406,0.937665343915364,0.640625,1.78234346224678,773,375,398,5,1.1,61.35,4.9,0,0,0,0,0,0,0.00783281820759612,5.87114210899036,0.848820071931421
8.7,"eps_greedy_SVM","SVM",66,24,1412,1405,7,2500,2093,407,0.937133881330332,0.645833333333333,1.78398617511521,778,380,398,5,1,63.91,5.1,0,0,0,0,0,0,0.00740160323260986,5.06387967195197,0.775050635611417
8.7,"eps_greedy_SVM","SVM",66,25,1312,1306,6,2600,2192,408,0.937272652116423,0.640625,1.78070377184913,786,385,401,8,1,66.46,5.4,0,0,0,0,0,0,0.00623900750919431,4.13740091809334,0.671464353555284
8.7,"eps_greedy_SVM","SVM",66,26,1212,1207,5,2700,2291,409,0.937054161942575,0.640625,1.78234346224678,796,387,409,10,1.1,69.02,5.6,0,0,0,0,0,0,0.00645194208132446,3.72104882837854,0.667729255479344
8.7,"eps_greedy_SVM","SVM",66,27,1112,1107,5,2800,2391,409,0.937225410997752,0.645833333333333,1.77906709558824,803,393,410,7,1,71.57,5.8,0,0,0,0,0,0,0.00496987740682129,2.6544466632681,0.547797737698214
8.7,"eps_greedy_SVM","SVM",66,28,1012,1008,4,2900,2490,410,0.937303654100549,0.640625,1.77906709558824,809,393,416,6,1.1,74.13,6.1,0,0,0,0,0,0,0.00447585885192276,2.10813180234917,0.474258654230467
8.7,"eps_greedy_SVM","SVM",66,29,912,909,3,3000,2589,411,0.93735975292897,0.645833333333333,1.77580275229358,815,396,419,6,1.1,76.69,6.3,0,0,0,0,0,0,0.00372986705816654,1.56921688008244,0.40589862232429
8.7,"eps_greedy_SVM","SVM",66,30,812,809,3,3100,2689,411,0.93743504346185,0.645833333333333,1.78070377184913,815,396,419,0,1.1,79.24,6.5,0,0,0,0,0,0,0.00337639516571458,1.28132667276529,0.37352311420924
8.7,"eps_greedy_SVM","SVM",66,31,712,710,2,3200,2788,412,0.937378944633429,0.645833333333333,1.78070377184913,821,398,423,6,1.1,81.8,6.8,0,0,0,0,0,0,0.00264744129147534,0.942125655918768,0.299546067335026
8.7,"eps_greedy_SVM","SVM",66,32,612,611,1,3300,2887,413,0.93748228458052,0.645833333333333,1.78398617511521,825,402,423,4,1.1,84.36,7,0,0,0,0,0,0,0.00198921839786564,0.64832497734932,0.230028135041653
8.7,"eps_greedy_SVM","SVM",66,33,512,511,1,3400,2987,413,0.937423233182182,0.645833333333333,1.7774334251607,824,402,422,-1,1,86.91,7.2,0,0,0,0,0,0,0.00131394863794403,0.410595141614317,0.15869125044916
8.7,"eps_greedy_SVM","SVM",66,34,412,411,1,3500,3087,413,0.937401088907806,0.645833333333333,1.78234346224678,822,401,421,-2,1,89.47,7.5,0,0,0,0,0,0,0.000784481162616921,0.229074772181556,0.0987632648071112
8.7,"eps_greedy_SVM","SVM",66,35,312,312,0,3600,3186,414,0.937758349867745,0.645833333333333,1.77906709558824,828,405,423,6,1,92.02,7.7,0,0,0,0,0,0,0.000783082233861802,0.197677539443584,0.0986253799117452
8.7,"eps_greedy_SVM","SVM",66,36,212,212,0,3700,3286,414,0.937895644368878,0.645833333333333,1.7774334251607,834,407,427,6,1,94.58,7.9,0,0,0,0,0,0,0.000347221228168392,0.0747531034545006,0.0475436504988184
8.7,"eps_greedy_SVM","SVM",66,37,112,112,0,3800,3386,414,0.93808165627364,0.645833333333333,1.78398617511521,837,409,428,3,1,97.14,8.2,0,0,0,0,0,0,0.000123539494384713,0.0195923709699558,0.0182747789307405
8.7,"eps_greedy_SVM","SVM",66,38,12,12,0,3900,3486,414,0.938424154383994,0.645833333333333,1.78398617511521,837,410,427,0,1,99.69,8.4,0,0,0,0,0,0,9.45406623867318e-05,0.00131400384262906,0.00131400384262906
8.7,"eps_greedy_SVM","SVM",66,39,0,0,0,3912,3498,414,0.938409391534409,0.645833333333333,1.78398617511521,837,410,427,0,1,100,8.4,0,0,0,0,0,0,0,0,0
8.7,"eps_greedy_SVM","SVM",67,0,3812,3414,398,100,87,13,0.856905313123366,0.420512820512821,1.68258064516129,42,13,29,0,2.2,2.56,6.7,0,0,0,0,0,0,0.167666471854909,507.1664596909,18.1653596490019
8.7,"eps_greedy_SVM","SVM",67,1,3712,3352,360,200,149,51,0.909212423011404,0.528205128205128,1.75768525052929,108,49,59,66,1.2,5.11,2.9,0,0,0,0,0,0,0.804766582791965,510.066508386589,85.0540807423026
8.7,"eps_greedy_SVM","SVM",67,2,3612,3316,296,300,185,115,0.917819129573794,0.548717948717949,1.77013574660633,175,82,93,67,1.1,7.67,1.6,0,0,0,0,0,0,0.5610513241503,372.191856807803,67.9441324633352
8.7,"eps_greedy_SVM","SVM",67,3,3512,3286,226,400,215,185,0.9144702165145,0.620512820512821,1.74247737556561,227,111,116,52,1,10.22,1.2,0,0,0,0,0,0,0.445987956047183,309.559602715108,60.2243945306241
8.7,"eps_greedy_SVM","SVM",67,4,3412,3236,176,500,265,235,0.911923586540253,0.641025641025641,1.72403846153846,315,157,158,88,1,12.78,1.1,0,0,0,0,0,0,0.361289253214078,236.239059194409,50.8291852040167
8.7,"eps_greedy_SVM","SVM",67,5,3312,3180,132,600,321,279,0.880493309454132,0.651282051282051,1.63635590216235,402,200,202,87,1,15.34,1.2,0,0,0,0,0,0,0.194194006516839,156.518430573339,27.84133018537
8.7,"eps_greedy_SVM","SVM",67,6,3212,3105,107,700,396,304,0.902444706533285,0.671794871794872,1.66872171945701,461,223,238,59,1.1,17.89,1.3,0,0,0,0,0,0,0.105544426055887,139.217110348243,15.2535871962851
8.7,"eps_greedy_SVM","SVM",67,7,3112,3032,80,800,469,331,0.904491911646937,0.682051282051282,1.65797838525111,536,255,281,75,1.1,20.45,1.4,0,0,0,0,0,0,0.110620180933958,160.846748859761,13.8519220221852
8.7,"eps_greedy_SVM","SVM",67,8,3012,2941,71,900,560,340,0.91468425574046,0.661538461538462,1.69026774330642,569,275,294,33,1.1,23.01,1.6,0,0,0,0,0,0,0.0796752437738664,106.490354673239,9.50373470396911
8.7,"eps_greedy_SVM","SVM",67,9,2912,2856,56,1000,645,355,0.923812227900779,0.656410256410256,1.71797705057374,602,287,315,33,1.1,25.56,1.8,0,0,0,0,0,0,0.0905201142512636,125.907224261526,10.34526298681
8.7,"eps_greedy_SVM","SVM",67,10,2812,2760,52,1100,741,359,0.929345214694422,0.656410256410256,1.73007762879323,620,298,322,18,1.1,28.12,2.1,0,0,0,0,0,0,0.0763429117038385,97.7444322677167,8.29505135519861
8.7,"eps_greedy_SVM","SVM",67,11,2712,2666,46,1200,835,365,0.935001965666347,0.656410256410256,1.74408039063053,641,307,334,21,1.1,30.67,2.3,0,0,0,0,0,0,0.0754520817673856,89.5335244826253,8.33206104924566
8.7,"eps_greedy_SVM","SVM",67,12,2612,2576,36,1300,925,375,0.938528516722717,0.661538461538462,1.76253626778006,664,317,347,23,1.1,33.23,2.5,0,0,0,0,0,0,0.0670856877260872,70.5080623533368,7.45060592916546
8.7,"eps_greedy_SVM","SVM",67,13,2512,2485,27,1400,1016,384,0.939096375893646,0.661538461538462,1.76253626778006,691,328,363,27,1.1,35.79,2.6,0,0,0,0,0,0,0.0644677999415225,65.7121556480001,7.35554767817073
8.7,"eps_greedy_SVM","SVM",67,14,2412,2388,24,1500,1113,387,0.939495333362452,0.661538461538462,1.75929928657201,695,331,364,4,1.1,38.34,2.9,0,0,0,0,0,0,0.0583509870168688,59.7544254432345,6.2872772515704
8.7,"eps_greedy_SVM","SVM",67,15,2312,2294,18,1600,1207,393,0.939597256803386,0.646153846153846,1.75654023395959,706,340,366,11,1.1,40.9,3.1,0,0,0,0,0,0,0.0496495003317547,54.8902406298809,5.53240209405445
8.7,"eps_greedy_SVM","SVM",67,16,2212,2198,14,1700,1303,397,0.94009668166397,0.646153846153846,1.75492279359683,718,344,374,12,1.1,43.46,3.3,0,0,0,0,0,0,0.0424244946595265,48.945650002656,4.63858574474257
8.7,"eps_greedy_SVM","SVM",67,17,2112,2100,12,1800,1401,399,0.939605993098328,0.651282051282051,1.75654023395959,728,347,381,10,1.1,46.01,3.5,0,0,0,0,0,0,0.0356247138987597,39.1830938082689,3.78846543079304
8.7,"eps_greedy_SVM","SVM",67,18,2012,2002,10,1900,1499,401,0.9390614307139,0.641025641025641,1.75654023395959,735,351,384,7,1.1,48.57,3.7,0,0,0,0,0,0,0.0307745498351256,33.7314153074353,3.32742805171063
8.7,"eps_greedy_SVM","SVM",67,19,1912,1902,10,2000,1599,401,0.938709066818095,0.646153846153846,1.75169683257919,735,351,384,0,1.1,51.12,4,0,0,0,0,0,0,0.0240769122597666,25.3455353851693,2.55706874470532
8.7,"eps_greedy_SVM","SVM",67,20,1812,1802,10,2100,1699,401,0.939169178351457,0.646153846153846,1.77339566510837,738,354,384,3,1.1,53.68,4.2,0,0,0,0,0,0,0.0198232924913738,18.9461496774857,2.02992673862343
8.7,"eps_greedy_SVM","SVM",67,21,1712,1703,9,2200,1798,402,0.938050932599478,0.666666666666667,1.77176420635482,756,367,389,18,1.1,56.24,4.5,0,0,0,0,0,0,0.016050981280449,11.5880954273341,2.09328134134761
8.7,"eps_greedy_SVM","SVM",67,22,1612,1605,7,2300,1896,404,0.938082965680911,0.666666666666667,1.77176420635482,762,371,391,6,1.1,58.79,4.7,0,0,0,0,0,0,0.0118523411484187,9.79960541472017,1.38583792042609
8.7,"eps_greedy_SVM","SVM",67,23,1512,1505,7,2400,1996,404,0.938068405189349,0.666666666666667,1.77176420635482,764,372,392,2,1.1,61.35,4.9,0,0,0,0,0,0,0.00921054892968066,7.82085671626225,0.996131282577491
8.7,"eps_greedy_SVM","SVM",67,24,1412,1406,6,2500,2095,405,0.938307197250972,0.666666666666667,1.77339566510837,769,374,395,5,1.1,63.91,5.2,0,0,0,0,0,0,0.00805029469718118,6.33152294542721,0.85556867630564
8.7,"eps_greedy_SVM","SVM",67,25,1312,1307,5,2600,2194,406,0.938974067764529,0.666666666666667,1.76851027760119,780,379,401,11,1.1,66.46,5.4,0,0,0,0,0,0,0.00703286824156298,5.15170897531152,0.745625617079733
8.7,"eps_greedy_SVM","SVM",67,26,1212,1208,4,2700,2293,407,0.939151705761588,0.671794871794872,1.76851027760119,789,383,406,9,1.1,69.02,5.6,0,0,0,0,0,0,0.00657711984481597,4.48731212678457,0.70821400081333
8.7,"eps_greedy_SVM","SVM",67,27,1112,1108,4,2800,2393,407,0.939119672680151,0.671794871794872,1.76851027760119,792,383,409,3,1.1,71.57,5.9,0,0,0,0,0,0,0.00574745986862596,3.37508388418676,0.584024542657234
8.7,"eps_greedy_SVM","SVM",67,28,1012,1008,4,2900,2493,407,0.939329343758635,0.671794871794872,1.76688779110797,799,388,411,7,1.1,74.13,6.1,0,0,0,0,0,0,0.00442751205202706,2.32852922752461,0.498708263546499
8.7,"eps_greedy_SVM","SVM",67,29,912,909,3,3000,2592,408,0.939320607463696,0.671794871794872,1.76851027760119,801,389,412,2,1.1,76.69,6.4,0,0,0,0,0,0,0.00373567081259657,1.72958967073616,0.388998590575695
8.7,"eps_greedy_SVM","SVM",67,30,812,809,3,3100,2692,408,0.939110936385198,0.671794871794872,1.76851027760119,801,390,411,0,1.1,79.24,6.6,0,0,0,0,0,0,0.00340927660348934,1.3359790765456,0.36437564724749
8.7,"eps_greedy_SVM","SVM",67,31,712,709,3,3200,2792,408,0.939099287991948,0.671794871794872,1.77176420635482,804,391,413,3,1.1,81.8,6.8,0,0,0,0,0,0,0.00271912986462827,0.898779546893155,0.297728617059664
8.7,"eps_greedy_SVM","SVM",67,32,612,609,3,3300,2892,408,0.939303134873817,0.671794871794872,1.76851027760119,804,391,413,0,1.1,84.36,7.1,0,0,0,0,0,0,0.00192781423172065,0.582572341898839,0.233942626900149
8.7,"eps_greedy_SVM","SVM",67,33,512,509,3,3400,2992,408,0.939233244514318,0.666666666666667,1.77013574660633,806,392,414,2,1.1,86.91,7.3,0,0,0,0,0,0,0.00105743014033777,0.314953790706321,0.138551043028157
8.7,"eps_greedy_SVM","SVM",67,34,412,412,0,3500,3089,411,0.938767308784328,0.661538461538462,1.77503013115916,818,398,420,12,1.1,89.47,7.5,0,0,0,0,0,0,0.00125449688854507,0.384207074262255,0.16249143751599
8.7,"eps_greedy_SVM","SVM",67,35,312,312,0,3600,3189,411,0.938614423622925,0.656410256410256,1.77339566510837,823,399,424,5,1.1,92.02,7.8,0,0,0,0,0,0,0.000872027857049493,0.225810512870626,0.107336438410235
8.7,"eps_greedy_SVM","SVM",67,36,212,212,0,3700,3289,411,0.938615879672084,0.656410256410256,1.76851027760119,822,401,421,-1,1,94.58,8,0,0,0,0,0,0,0.000427718348198958,0.089568764950182,0.0553856529409732
8.7,"eps_greedy_SVM","SVM",67,37,112,112,0,3800,3389,411,0.939081815402083,0.656410256410256,1.757215047726,824,403,421,2,1,97.14,8.2,0,0,0,0,0,0,0.000162632742671296,0.026468582431546,0.0248330834468876
8.7,"eps_greedy_SVM","SVM",67,38,12,12,0,3900,3489,411,0.939145881564958,0.651282051282051,1.7636517328825,827,404,423,3,1,99.69,8.5,0,0,0,0,0,0,9.27862375862544e-05,0.00155887785093822,0.00155887785093822
8.7,"eps_greedy_SVM","SVM",67,39,0,0,0,3912,3501,411,0.939073079107147,0.651282051282051,1.77176420635482,828,404,424,1,1,100,8.5,0,0,0,0,0,0,0,0,0
8.7,"eps_greedy_SVM","SVM",68,0,3812,3398,414,100,89,11,0.897159754104749,0.50828729281768,1.76475239495159,27,11,16,0,1.5,2.56,8.1,0,0,0,0,0,0,0.810355503878333,571.005451453336,84.5173941895423
8.7,"eps_greedy_SVM","SVM",68,1,3712,3373,339,200,114,86,0.907891992841027,0.541436464088398,1.75968121496135,84,42,42,57,1,5.11,1.3,0,0,0,0,0,0,0.770329166325522,410.741704855588,81.9688102349903
8.7,"eps_greedy_SVM","SVM",68,2,3612,3340,272,300,147,153,0.905171581978068,0.569060773480663,1.70997270606413,147,73,74,63,1,7.67,1,0,0,0,0,0,0,0.603287647423956,289.37771636972,70.1620130989981
8.7,"eps_greedy_SVM","SVM",68,3,3512,3298,214,400,189,211,0.897640650533049,0.574585635359116,1.74139983516987,221,113,108,74,1,10.22,0.9,0,0,0,0,0,0,0.5,248.768988087001,62.5964181013427
8.7,"eps_greedy_SVM","SVM",68,4,3412,3248,164,500,239,261,0.896263325811231,0.602209944751381,1.70003100428469,316,160,156,95,1,12.78,0.9,0,0,0,0,0,0,0.30523552101967,220.867143272496,41.3662557384746
8.7,"eps_greedy_SVM","SVM",68,5,3312,3184,128,600,303,297,0.852204497704469,0.613259668508287,1.60208784835628,407,201,206,91,1,15.34,1,0,0,0,0,0,0,0.226839247413892,170.837316199213,33.1689532847589
8.7,"eps_greedy_SVM","SVM",68,6,3212,3097,115,700,390,310,0.86655668819548,0.607734806629834,1.60061398649026,450,220,230,43,1,17.89,1.3,0,0,0,0,0,0,0.0981930243712681,84.7623136504302,14.14271608406
8.7,"eps_greedy_SVM","SVM",68,7,3112,3024,88,800,463,337,0.866122480740811,0.61878453038674,1.59213699215531,513,246,267,63,1.1,20.45,1.4,0,0,0,0,0,0,0.0758887277222749,98.5528180896884,11.1035813231048
8.7,"eps_greedy_SVM","SVM",68,8,3012,2943,69,900,544,356,0.862796669519894,0.61878453038674,1.57078888115194,547,264,283,34,1.1,23.01,1.5,0,0,0,0,0,0,0.0746775319537641,117.631177318972,9.17657956890919
8.7,"eps_greedy_SVM","SVM",68,9,2912,2854,58,1000,633,367,0.869554120301931,0.607734806629834,1.60759782658326,579,280,299,32,1.1,25.56,1.7,0,0,0,0,0,0,0.0714181660538232,105.735234877916,7.6993655117331
8.7,"eps_greedy_SVM","SVM",68,10,2812,2756,56,1100,731,369,0.879961092521983,0.602209944751381,1.62894052648684,591,286,305,12,1.1,28.12,2,0,0,0,0,0,0,0.0494404443091645,65.0126862351176,5.6425028027993
8.7,"eps_greedy_SVM","SVM",68,11,2712,2663,49,1200,824,376,0.892618473270568,0.61878453038674,1.63436656521717,609,292,317,18,1.1,30.67,2.2,0,0,0,0,0,0,0.0461692281233046,68.7792810401921,5.03073343673034
8.7,"eps_greedy_SVM","SVM",68,12,2612,2572,40,1300,915,385,0.906724768500517,0.607734806629834,1.6739875728588,636,311,325,27,1,33.23,2.4,0,0,0,0,0,0,0.0383046607922212,52.9490479608236,4.42302470775534
8.7,"eps_greedy_SVM","SVM",68,13,2512,2476,36,1400,1011,389,0.907062485409712,0.613259668508287,1.67552334127427,643,315,328,7,1,35.79,2.6,0,0,0,0,0,0,0.0376182421451908,55.4433010934346,4.00560186393311
8.7,"eps_greedy_SVM","SVM",68,14,2412,2379,33,1500,1108,392,0.915150571939939,0.602209944751381,1.69379807667961,661,323,338,18,1,38.34,2.8,0,0,0,0,0,0,0.0335203351019192,45.6423460789777,3.70486752112324
8.7,"eps_greedy_SVM","SVM",68,15,2312,2285,27,1600,1202,398,0.923171737607985,0.613259668508287,1.7497395131819,684,332,352,23,1.1,40.9,3,0,0,0,0,0,0,0.0522170312377016,46.0386617674457,6.08376931840821
8.7,"eps_greedy_SVM","SVM",68,16,2212,2187,25,1700,1300,400,0.923875184810536,0.602209944751381,1.75135069137084,699,338,361,15,1.1,43.46,3.2,0,0,0,0,0,0,0.0408428030611225,34.901267077534,4.65969521065071
8.7,"eps_greedy_SVM","SVM",68,17,2112,2092,20,1800,1395,405,0.925148237491257,0.596685082872928,1.74652603381885,714,348,366,15,1.1,46.01,3.4,0,0,0,0,0,0,0.0405039630352884,32.3867625508673,4.57557837753578
8.7,"eps_greedy_SVM","SVM",68,18,2012,1997,15,1900,1490,410,0.925678935491417,0.596685082872928,1.76152024770809,728,355,373,14,1.1,48.57,3.6,0,0,0,0,0,0,0.0343154252111168,27.887136846142,4.29434072719085
8.7,"eps_greedy_SVM","SVM",68,19,1912,1903,9,2000,1584,416,0.925876585479746,0.596685082872928,1.76637292056679,743,360,383,15,1.1,51.12,3.8,0,0,0,0,0,0,0.0269464645130426,25.528151886557,3.43821824321728
8.7,"eps_greedy_SVM","SVM",68,20,1812,1803,9,2100,1684,416,0.925503073690781,0.596685082872928,1.76637292056679,746,361,385,3,1.1,53.68,4,0,0,0,0,0,0,0.0222507041817996,21.5290937649468,2.36059279029603
8.7,"eps_greedy_SVM","SVM",68,21,1712,1703,9,2200,1784,416,0.925286748113004,0.596685082872928,1.78120325997375,760,369,391,14,1.1,56.24,4.3,0,0,0,0,0,0,0.0135529370293345,12.1719947287869,1.68953538786662
8.7,"eps_greedy_SVM","SVM",68,22,1612,1606,6,2300,1881,419,0.926138043732022,0.602209944751381,1.77792898927527,768,373,395,8,1.1,58.79,4.5,0,0,0,0,0,0,0.0153044623900792,12.2431299673149,1.5664174197041
8.7,"eps_greedy_SVM","SVM",68,23,1512,1506,6,2400,1981,419,0.927535600342401,0.602209944751381,1.77956461852023,786,383,403,18,1.1,61.35,4.7,0,0,0,0,0,0,0.0113916785577119,7.51887329081522,1.35549945199423
8.7,"eps_greedy_SVM","SVM",68,24,1412,1407,5,2500,2080,420,0.927518481052074,0.602209944751381,1.78120325997375,786,384,402,0,1,63.91,5,0,0,0,0,0,0,0.00870529904032378,6.44518726929578,1.0033260781349
8.7,"eps_greedy_SVM","SVM",68,25,1312,1307,5,2600,2180,420,0.92741887790835,0.602209944751381,1.77792898927527,786,384,402,0,1,66.46,5.2,0,0,0,0,0,0,0.00770676788941053,5.15554911953916,0.793805970406518
8.7,"eps_greedy_SVM","SVM",68,26,1212,1207,5,2700,2280,420,0.927688117656229,0.607734806629834,1.77466673424908,792,390,402,6,1,69.02,5.4,0,0,0,0,0,0,0.00613660302229901,3.89420339139407,0.678427107125474
8.7,"eps_greedy_SVM","SVM",68,27,1112,1109,3,2800,2378,422,0.927845303867419,0.607734806629834,1.77792898927527,801,392,409,9,1,71.57,5.6,0,0,0,0,0,0,0.00612786946781089,3.33253530008497,0.647478856720036
8.7,"eps_greedy_SVM","SVM",68,28,1012,1009,3,2900,2478,422,0.927762820014022,0.607734806629834,1.77629636394076,809,395,414,8,1,74.13,5.9,0,0,0,0,0,0,0.00481829141910812,2.43845171159982,0.51986924821014
8.7,"eps_greedy_SVM","SVM",68,29,912,910,2,3000,2577,423,0.927305268072539,0.613259668508287,1.78120325997375,810,396,414,1,1,76.69,6.1,0,0,0,0,0,0,0.00446955102113055,2.08437476309633,0.480029002259959
8.7,"eps_greedy_SVM","SVM",68,30,812,811,1,3100,2676,424,0.927168313749918,0.613259668508287,1.77956461852023,811,399,412,1,1,79.24,6.3,0,0,0,0,0,0,0.00378475923768159,1.62589412056441,0.411170546507469
8.7,"eps_greedy_SVM","SVM",68,31,712,711,1,3200,2776,424,0.927180764142883,0.613259668508287,1.77956461852023,814,399,415,3,1,81.8,6.5,0,0,0,0,0,0,0.00303701518804406,1.14680886435636,0.329736536326875
8.7,"eps_greedy_SVM","SVM",68,32,612,611,1,3300,2876,424,0.927213446424418,0.613259668508287,1.77792898927527,814,399,415,0,1,84.36,6.8,0,0,0,0,0,0,0.00263047917233584,0.898040400665675,0.293262183247902
8.7,"eps_greedy_SVM","SVM",68,33,512,511,1,3400,2976,424,0.92728503618397,0.613259668508287,1.77792898927527,813,399,414,-1,1,86.91,7,0,0,0,0,0,0,0.00170029487346051,0.512018787962819,0.197025949015407
8.7,"eps_greedy_SVM","SVM",68,34,412,412,0,3500,3075,425,0.927611858999314,0.607734806629834,1.77792898927527,818,399,419,5,1.1,89.47,7.2,0,0,0,0,0,0,0.00134500195704159,0.407801447927561,0.168372391564866
8.7,"eps_greedy_SVM","SVM",68,35,312,312,0,3600,3175,425,0.927804840090279,0.607734806629834,1.78120325997375,822,401,421,4,1,92.02,7.5,0,0,0,0,0,0,0.000884465391912148,0.221058141700097,0.105099704404729
8.7,"eps_greedy_SVM","SVM",68,36,212,212,0,3700,3275,425,0.927957357404106,0.607734806629834,1.78120325997375,821,401,420,-1,1,94.58,7.7,0,0,0,0,0,0,0.000526450897973294,0.113624396679321,0.0698730736246947
8.7,"eps_greedy_SVM","SVM",68,37,112,112,0,3800,3375,425,0.927865535755985,0.607734806629834,1.77956461852023,824,402,422,3,1,97.14,7.9,0,0,0,0,0,0,0.000275313401760824,0.0415987756423114,0.0386711205754986
8.7,"eps_greedy_SVM","SVM",68,38,12,12,0,3900,3475,425,0.928004046377727,0.607734806629834,1.77792898927527,825,403,422,1,1,99.69,8.2,0,0,0,0,0,0,0.000207878474398337,0.00307294058519602,0.00307294058519602
8.7,"eps_greedy_SVM","SVM",68,39,0,0,0,3912,3487,425,0.928112987316175,0.607734806629834,1.77466673424908,825,403,422,0,1,100,8.2,0,0,0,0,0,0,0,0,0
8.7,"eps_greedy_SVM","SVM",69,0,3812,3412,400,100,89,11,0.863192533379924,0.502564102564103,1.64560085076214,31,11,20,0,1.8,2.56,8.1,0,0,0,0,0,0,0.220414870647783,355.376130539197,25.1059949756755
8.7,"eps_greedy_SVM","SVM",69,1,3712,3371,341,200,130,70,0.919314492057235,0.605128205128205,1.72403846153846,107,51,56,76,1.1,5.11,1.9,0,0,0,0,0,0,0.783734408436219,347.531146308543,86.0748651447572
8.7,"eps_greedy_SVM","SVM",69,2,3612,3344,268,300,157,143,0.912283230681851,0.630769230769231,1.68716063348416,161,79,82,54,1,7.67,1.1,0,0,0,0,0,0,0.570996515175823,225.387992519167,70.3664250468403
8.7,"eps_greedy_SVM","SVM",69,3,3512,3302,210,400,199,201,0.919751306804108,0.605128205128205,1.74568635784105,237,119,118,76,1,10.22,1,0,0,0,0,0,0,0.404815404942291,178.272882439063,56.9127785479784
8.7,"eps_greedy_SVM","SVM",69,4,3412,3253,159,500,248,252,0.89156801933634,0.615384615384615,1.64257306630812,328,163,165,91,1,12.78,1,0,0,0,0,0,0,0.239643868466615,131.508734969372,33.515826906437
8.7,"eps_greedy_SVM","SVM",69,5,3312,3192,120,600,309,291,0.862741158141492,0.641025641025641,1.58720543485953,417,204,213,89,1,15.34,1.1,0,0,0,0,0,0,0.150677889336563,120.921409863637,25.3838608638439
8.7,"eps_greedy_SVM","SVM",69,6,3212,3117,95,700,384,316,0.876524119454265,0.676923076923077,1.59013115916342,494,237,257,77,1.1,17.89,1.2,0,0,0,0,0,0,0.0881611035851255,74.9122468319545,12.7016522891795
8.7,"eps_greedy_SVM","SVM",69,7,3112,3035,77,800,466,334,0.877113819362559,0.676923076923077,1.60418552036199,539,255,284,45,1.1,20.45,1.4,0,0,0,0,0,0,0.0652171798889159,72.824010960335,8.10801317137043
8.7,"eps_greedy_SVM","SVM",69,8,3012,2946,66,900,555,345,0.882447327421768,0.676923076923077,1.61637625726024,560,265,295,21,1.1,23.01,1.6,0,0,0,0,0,0,0.0510822666787599,69.3500113061204,6.03608088529954
8.7,"eps_greedy_SVM","SVM",69,9,2912,2855,57,1000,646,354,0.889927051937286,0.676923076923077,1.62561269301601,589,281,308,29,1.1,25.56,1.8,0,0,0,0,0,0,0.0487526225010371,69.2340607122352,5.2798183428779
8.7,"eps_greedy_SVM","SVM",69,10,2812,2762,50,1100,739,361,0.919698889034476,0.651282051282051,1.69794069775671,619,299,320,30,1.1,28.12,2,0,0,0,0,0,0,0.0448391778405605,46.3179860747271,5.55083887695354
8.7,"eps_greedy_SVM","SVM",69,11,2712,2673,39,1200,828,372,0.932599484558578,0.646153846153846,1.72403846153846,647,310,337,28,1.1,30.67,2.2,0,0,0,0,0,0,0.0431586885525972,53.6586068070973,5.46346867949415
8.7,"eps_greedy_SVM","SVM",69,12,2612,2583,29,1300,918,382,0.945546673655705,0.646153846153846,1.79352002835874,674,326,348,27,1.1,33.23,2.4,0,0,0,0,0,0,0.0792412444861181,73.7848504338761,9.00710121256487
8.7,"eps_greedy_SVM","SVM",69,13,2512,2484,28,1400,1017,383,0.945567058343892,0.641025641025641,1.79352002835874,689,333,356,15,1.1,35.79,2.7,0,0,0,0,0,0,0.0592604981865769,52.2404731652587,6.34107598044476
8.7,"eps_greedy_SVM","SVM",69,14,2412,2385,27,1500,1116,384,0.945620932162674,0.641025641025641,1.79186853661992,695,336,359,6,1.1,38.34,2.9,0,0,0,0,0,0,0.0488735981295363,41.472166341032,5.27618243241814
8.7,"eps_greedy_SVM","SVM",69,15,2312,2289,23,1600,1212,388,0.945808762503823,0.641025641025641,1.79352002835874,706,340,366,11,1.1,40.9,3.1,0,0,0,0,0,0,0.0488322047709698,34.4207616080167,5.62727802771168
8.7,"eps_greedy_SVM","SVM",69,16,2212,2192,20,1700,1309,391,0.945910685944756,0.641025641025641,1.79022008350435,715,344,371,9,1.1,43.46,3.3,0,0,0,0,0,0,0.033661943134475,27.5124471143268,4.28852446910409
8.7,"eps_greedy_SVM","SVM",69,17,2112,2097,15,1800,1404,396,0.946325659954273,0.641025641025641,1.79186853661992,727,350,377,12,1.1,46.01,3.5,0,0,0,0,0,0,0.0270132130326401,26.2470553237081,3.49858372349975
8.7,"eps_greedy_SVM","SVM",69,18,2012,1999,13,1900,1502,398,0.946446512034239,0.641025641025641,1.79352002835874,737,353,384,10,1.1,48.57,3.8,0,0,0,0,0,0,0.021846555338214,22.2776572680883,2.4288128630645
8.7,"eps_greedy_SVM","SVM",69,19,1912,1900,12,2000,1601,399,0.946302363167773,0.641025641025641,1.78857466063348,738,355,383,1,1.1,51.12,4,0,0,0,0,0,0,0.0188931661267566,18.0516225994579,1.9337617535908
8.7,"eps_greedy_SVM","SVM",69,20,1812,1800,12,2100,1701,399,0.944148866465734,0.641025641025641,1.79944802207912,743,365,378,5,1,53.68,4.3,0,0,0,0,0,0,0.0156861949992744,12.7426104075545,1.89355965157579
8.7,"eps_greedy_SVM","SVM",69,21,1712,1701,11,2200,1800,400,0.944195460038733,0.646153846153846,1.80110497237569,746,366,380,3,1,56.24,4.5,0,0,0,0,0,0,0.0113068368022681,9.64488481680928,1.25747203061139
8.7,"eps_greedy_SVM","SVM",69,22,1612,1602,10,2300,1899,401,0.944495406164914,0.641025641025641,1.79944802207912,754,370,384,8,1,58.79,4.7,0,0,0,0,0,0,0.0109651409309439,8.83628811518575,1.13652135516275
8.7,"eps_greedy_SVM","SVM",69,23,1512,1504,8,2400,1997,403,0.943496556443748,0.641025641025641,1.80276497695853,762,373,389,8,1,61.35,5,0,0,0,0,0,0,0.00948933363851711,7.04185401518597,1.01409111045583
8.7,"eps_greedy_SVM","SVM",69,24,1412,1404,8,2500,2097,403,0.943176225629379,0.641025641025641,1.79944802207912,769,376,393,7,1,63.91,5.2,0,0,0,0,0,0,0.00798465760957207,5.71271220801025,0.874253582759048
8.7,"eps_greedy_SVM","SVM",69,25,1312,1304,8,2600,2197,403,0.943112159466505,0.641025641025641,1.79944802207912,770,377,393,1,1,66.46,5.5,0,0,0,0,0,0,0.00639684463246091,4.06601005242737,0.661464850873421
8.7,"eps_greedy_SVM","SVM",69,26,1212,1204,8,2700,2297,403,0.942959274305102,0.635897435897436,1.79779411764706,776,380,396,6,1,69.02,5.7,0,0,0,0,0,0,0.00579297692051329,3.42606998573583,0.626087003305179
8.7,"eps_greedy_SVM","SVM",69,27,1112,1104,8,2800,2397,403,0.942895208142229,0.635897435897436,1.80110497237569,775,379,396,-1,1,71.57,5.9,0,0,0,0,0,0,0.00496879840586672,2.54431622441389,0.51410155469205
8.7,"eps_greedy_SVM","SVM",69,28,1012,1004,8,2900,2497,403,0.942860262962479,0.630769230769231,1.80110497237569,782,384,398,7,1,74.13,6.2,0,0,0,0,0,0,0.00418500973358671,1.89336333455148,0.447936687919685
8.7,"eps_greedy_SVM","SVM",69,29,912,907,5,3000,2594,406,0.942803477045386,0.630769230769231,1.79944802207912,795,387,408,13,1.1,76.69,6.4,0,0,0,0,0,0,0.00432830359545512,1.81162097560282,0.467485557800177
8.7,"eps_greedy_SVM","SVM",69,30,812,807,5,3100,2694,406,0.942561772885453,0.630769230769231,1.79944802207912,796,388,408,1,1.1,79.24,6.6,0,0,0,0,0,0,0.00304005553465214,1.11264063266019,0.339016153478275
8.7,"eps_greedy_SVM","SVM",69,31,712,708,4,3200,2793,407,0.94282094963526,0.635897435897436,1.79449541284404,798,389,409,2,1.1,81.8,6.9,0,0,0,0,0,0,0.00266791460087403,0.873521408018212,0.305487284261583
8.7,"eps_greedy_SVM","SVM",69,32,612,608,4,3300,2893,407,0.942949081961008,0.635897435897436,1.79944802207912,796,389,407,-2,1,84.36,7.1,0,0,0,0,0,0,0.0018060195990245,0.57264877626551,0.224216958384232
8.7,"eps_greedy_SVM","SVM",69,33,512,510,2,3400,2991,409,0.943199522415878,0.641025641025641,1.79449541284404,805,393,412,9,1,86.91,7.3,0,0,0,0,0,0,0.00131649433096236,0.443085151923036,0.169229718398782
8.7,"eps_greedy_SVM","SVM",69,34,412,411,1,3500,3090,410,0.943432490280873,0.641025641025641,1.79285059578368,810,395,415,5,1.1,89.47,7.5,0,0,0,0,0,0,0.00106815838532306,0.32739845228505,0.127839836405722
8.7,"eps_greedy_SVM","SVM",69,35,312,312,0,3600,3189,411,0.943755733193554,0.635897435897436,1.79449541284404,814,398,416,4,1,92.02,7.8,0,0,0,0,0,0,0.00120538336103513,0.3132564664577,0.144992627476135
8.7,"eps_greedy_SVM","SVM",69,36,212,212,0,3700,3289,411,0.943816887258115,0.630769230769231,1.79614325068871,820,401,419,6,1,94.58,8,0,0,0,0,0,0,0.000628602193233896,0.129264430198329,0.078469750239915
8.7,"eps_greedy_SVM","SVM",69,37,112,112,0,3800,3389,411,0.943712051718868,0.625641025641026,1.79614325068871,824,403,421,4,1,97.14,8.2,0,0,0,0,0,0,0.000248620020947581,0.0404009354495381,0.0377473418196963
8.7,"eps_greedy_SVM","SVM",69,38,12,12,0,3900,3489,411,0.943732436407055,0.625641025641026,1.79614325068871,826,403,423,2,1,99.69,8.5,0,0,0,0,0,0,0.000156586509799456,0.00244427546035374,0.00244427546035374
8.7,"eps_greedy_SVM","SVM",69,39,0,0,0,3912,3501,411,0.943675650489962,0.625641025641026,1.79449541284404,826,403,423,0,1,100,8.5,0,0,0,0,0,0,0,0,0
8.7,"eps_greedy_SVM","SVM",70,0,3812,3435,377,100,88,12,0.91082061569364,0.580645161290323,1.77958893501415,29,12,17,0,1.4,2.56,7.3,0,0,0,0,0,0,0.572969111815125,393.948807687284,63.1975184480038
8.7,"eps_greedy_SVM","SVM",70,1,3712,3405,307,200,118,82,0.920372426549501,0.589861751152074,1.767904880719,91,44,47,62,1.1,5.11,1.4,0,0,0,0,0,0,0.714744985199112,302.09617390282,80.3276889371684
8.7,"eps_greedy_SVM","SVM",70,2,3612,3368,244,300,155,145,0.916172226741885,0.617511520737327,1.75130483489065,155,81,74,64,0.9,7.67,1.1,0,0,0,0,0,0,0.46316162758691,156.102318804421,62.1250774264714
8.7,"eps_greedy_SVM","SVM",70,3,3512,3326,186,400,197,203,0.890972352880368,0.622119815668203,1.69993937569686,237,119,118,82,1,10.22,1,0,0,0,0,0,0,0.288914523384487,138.326895239766,41.6494251954853
8.7,"eps_greedy_SVM","SVM",70,4,3412,3265,147,500,258,242,0.87645052641619,0.631336405529954,1.64340453700639,331,165,166,94,1,12.78,1.1,0,0,0,0,0,0,0.167109448504271,97.2178772895074,24.6642425190395
8.7,"eps_greedy_SVM","SVM",70,5,3312,3192,120,600,331,269,0.878855372678283,0.649769585253456,1.62680449117804,395,193,202,64,1,15.34,1.2,0,0,0,0,0,0,0.0791616900508256,53.3063654258145,11.1988881660885
8.7,"eps_greedy_SVM","SVM",70,6,3212,3109,103,700,414,286,0.881737213240287,0.649769585253456,1.62680449117804,438,211,227,43,1.1,17.89,1.4,0,0,0,0,0,0,0.0648514359872758,55.6969852444966,8.12428231475625
8.7,"eps_greedy_SVM","SVM",70,7,3112,3027,85,800,496,304,0.887869239962568,0.67741935483871,1.63661152286097,484,231,253,46,1.1,20.45,1.6,0,0,0,0,0,0,0.0638197404220977,83.1394168481577,9.13979690302755
8.7,"eps_greedy_SVM","SVM",70,8,3012,2948,64,900,575,325,0.892285412189312,0.686635944700461,1.62680449117804,530,258,272,46,1.1,23.01,1.8,0,0,0,0,0,0,0.0742283464284901,116.564487099894,9.99434161481776
8.7,"eps_greedy_SVM","SVM",70,9,2912,2859,53,1000,664,336,0.896488261965259,0.686635944700461,1.62083456643978,570,276,294,40,1.1,25.56,2,0,0,0,0,0,0,0.0852517159425299,133.982936705218,9.22177022743456
8.7,"eps_greedy_SVM","SVM",70,10,2812,2762,50,1100,761,339,0.917617784467465,0.67741935483871,1.68906224989259,605,296,309,35,1,28.12,2.2,0,0,0,0,0,0,0.0620070518260052,60.1312120828627,8.05681943364196
8.7,"eps_greedy_SVM","SVM",70,11,2712,2668,44,1200,855,345,0.923609362868105,0.67741935483871,1.70823176289538,619,302,317,14,1,30.67,2.5,0,0,0,0,0,0,0.0504045409918814,59.1374485609812,5.83290848879795
8.7,"eps_greedy_SVM","SVM",70,12,2612,2577,35,1300,946,354,0.935107575464469,0.682027649769585,1.73501670559711,646,313,333,27,1.1,33.23,2.7,0,0,0,0,0,0,0.0724472984947884,67.3564314083146,8.51131997821878
8.7,"eps_greedy_SVM","SVM",70,13,2512,2480,32,1400,1043,357,0.9374554474074,0.67741935483871,1.76627847328503,662,320,342,16,1.1,35.79,2.9,0,0,0,0,0,0,0.05942340244104,51.2589075379478,6.45208980984141
8.7,"eps_greedy_SVM","SVM",70,14,2412,2383,29,1500,1140,360,0.938870530497159,0.672811059907834,1.77457086048355,671,327,344,9,1.1,38.34,3.2,0,0,0,0,0,0,0.0480337801208907,40.0227951270063,5.31795630533585
8.7,"eps_greedy_SVM","SVM",70,15,2312,2285,27,1600,1238,362,0.939265375778758,0.672811059907834,1.77620490363317,678,329,349,7,1.1,40.9,3.4,0,0,0,0,0,0,0.0415679517313305,33.8107252304034,4.51576426487762
8.7,"eps_greedy_SVM","SVM",70,16,2212,2194,18,1700,1329,371,0.940110715676945,0.663594470046083,1.76627847328503,703,341,362,25,1.1,43.46,3.6,0,0,0,0,0,0,0.0524873431577323,34.9935745645964,6.37860622461825
8.7,"eps_greedy_SVM","SVM",70,17,2112,2098,14,1800,1425,375,0.940461836481051,0.658986175115207,1.76465505557062,717,346,371,14,1.1,46.01,3.8,0,0,0,0,0,0,0.0349500541396976,28.6440025134724,4.68347357340597
8.7,"eps_greedy_SVM","SVM",70,18,2012,1998,14,1900,1525,375,0.940370412573567,0.663594470046083,1.76627847328503,719,346,373,2,1.1,48.57,4.1,0,0,0,0,0,0,0.0248038623188944,23.2260922806119,2.86019844659989
8.7,"eps_greedy_SVM","SVM",70,19,1912,1900,12,2000,1623,377,0.940309463301911,0.649769585253456,1.767904880719,720,347,373,1,1.1,51.12,4.3,0,0,0,0,0,0,0.0202966206330178,18.9094493465433,2.14372636866515
8.7,"eps_greedy_SVM","SVM",70,20,1812,1800,12,2100,1723,377,0.940956055575134,0.654377880184332,1.77795628461506,728,352,376,8,1.1,53.68,4.6,0,0,0,0,0,0,0.0154221158380309,13.8054457488766,1.82163709298767
8.7,"eps_greedy_SVM","SVM",70,21,1712,1700,12,2200,1823,377,0.940945455701802,0.654377880184332,1.78286324768207,728,352,376,0,1.1,56.24,4.8,0,0,0,0,0,0,0.0126449151597548,9.98165324658057,1.27798386445656
8.7,"eps_greedy_SVM","SVM",70,22,1612,1600,12,2300,1923,377,0.940934855828471,0.640552995391705,1.78786609285143,739,361,378,11,1,58.79,5.1,0,0,0,0,0,0,0.0107556257637193,7.58302611820259,1.31971975961707
8.7,"eps_greedy_SVM","SVM",70,23,1512,1502,10,2400,2021,379,0.940970630400965,0.640552995391705,1.79280494946152,745,363,382,6,1.1,61.35,5.3,0,0,0,0,0,0,0.00815198675422952,5.97876755229834,0.90455136076613
8.7,"eps_greedy_SVM","SVM",70,24,1412,1406,6,2500,2117,383,0.941160103136766,0.640552995391705,1.78950935212795,760,369,391,15,1.1,63.91,5.5,0,0,0,0,0,0,0.00912289866251401,6.21096128114513,0.9702433833069
8.7,"eps_greedy_SVM","SVM",70,25,1312,1306,6,2600,2217,383,0.940783807633498,0.640552995391705,1.78950935212795,762,371,391,2,1.1,66.46,5.8,0,0,0,0,0,0,0.00722942387273324,4.50706617230544,0.782682642920706
8.7,"eps_greedy_SVM","SVM",70,26,1212,1206,6,2700,2317,383,0.940623484549358,0.640552995391705,1.79280494946152,763,371,392,1,1.1,69.02,6,0,0,0,0,0,0,0.00726753766404342,3.96561911154592,0.743644144997301
8.7,"eps_greedy_SVM","SVM",70,27,1112,1106,6,2800,2417,383,0.941137578405937,0.63594470046083,1.78950935212795,766,374,392,3,1,71.57,6.3,0,0,0,0,0,0,0.00568159777338889,2.6770330680377,0.614388870614892
8.7,"eps_greedy_SVM","SVM",70,28,1012,1006,6,2900,2517,383,0.941096503896777,0.63594470046083,1.7911556348806,768,374,394,2,1.1,74.13,6.6,0,0,0,0,0,0,0.00498667375917578,2.05932581300497,0.524287579318661
8.7,"eps_greedy_SVM","SVM",70,29,912,906,6,3000,2617,383,0.941285976632578,0.63594470046083,1.78950935212795,766,375,391,-2,1,76.69,6.8,0,0,0,0,0,0,0.00401948366313239,1.43707433237668,0.440278301677359
8.7,"eps_greedy_SVM","SVM",70,30,812,806,6,3100,2717,383,0.941256826980917,0.63594470046083,1.78950935212795,767,375,392,1,1,79.24,7.1,0,0,0,0,0,0,0.00318899743110468,1.02222982318564,0.357776371422919
8.7,"eps_greedy_SVM","SVM",70,31,712,707,5,3200,2816,384,0.94158674803836,0.63594470046083,1.78950935212795,773,376,397,6,1.1,81.8,7.3,0,0,0,0,0,0,0.00250438491642397,0.784166571726937,0.30135516399845
8.7,"eps_greedy_SVM","SVM",70,32,612,609,3,3300,2914,386,0.94151254892504,0.640552995391705,1.78622584872955,776,380,396,3,1,84.36,7.5,0,0,0,0,0,0,0.00193370600560229,0.628448019824993,0.244008468970633
8.7,"eps_greedy_SVM","SVM",70,33,512,509,3,3400,3014,386,0.941656972199182,0.640552995391705,1.78622584872955,778,381,397,2,1,86.91,7.8,0,0,0,0,0,0,0.00109448353877111,0.352514643070202,0.144993513426492
8.7,"eps_greedy_SVM","SVM",70,34,412,411,1,3500,3112,388,0.941900769285807,0.640552995391705,1.79280494946152,789,386,403,11,1,89.47,8,0,0,0,0,0,0,0.000813996520546295,0.234733073774626,0.103106640938634
8.7,"eps_greedy_SVM","SVM",70,35,312,312,0,3600,3211,389,0.942270439868243,0.640552995391705,1.78950935212795,793,388,405,4,1,92.02,8.3,0,0,0,0,0,0,0.000684385239929723,0.167881419897413,0.0852708411957859
8.7,"eps_greedy_SVM","SVM",70,36,212,212,0,3700,3311,389,0.942437387873215,0.640552995391705,1.7911556348806,796,388,408,3,1.1,94.58,8.5,0,0,0,0,0,0,0.000357712223525969,0.0771946445239559,0.0492170676623224
8.7,"eps_greedy_SVM","SVM",70,37,112,112,0,3800,3411,389,0.942564586353193,0.63594470046083,1.78622584872955,800,389,411,4,1.1,97.14,8.8,0,0,0,0,0,0,0.000132202916719191,0.0223114445118842,0.0208950220121837
8.7,"eps_greedy_SVM","SVM",70,38,12,12,0,3900,3511,389,0.942516886923201,0.63594470046083,1.78622584872955,801,389,412,1,1.1,99.69,9,0,0,0,0,0,0,0.00010199204520186,0.00140693826342472,0.00140693826342472
8.7,"eps_greedy_SVM","SVM",70,39,0,0,0,3912,3523,389,0.942612285783184,0.63594470046083,1.78786609285143,800,389,411,-1,1.1,100,9.1,0,0,0,0,0,0,0,0,0
8.7,"eps_greedy_SVM","SVM",71,0,3812,3403,409,100,92,8,0.774732530250351,0.259259259259259,1.56430400117036,29,8,21,0,2.6,2.56,11.5,0,0,0,0,0,0,0.136431150535283,328.311055703934,15.1107188473388
8.7,"eps_greedy_SVM","SVM",71,1,3712,3322,390,200,173,27,0.851396711611757,0.439153439153439,1.70738058664326,80,27,53,51,2,5.11,6.4,0,0,0,0,0,0,0.253595609508759,326.523697322719,42.7729669031582
8.7,"eps_greedy_SVM","SVM",71,2,3612,3285,327,300,210,90,0.927144623805628,0.560846560846561,1.76763304036031,157,76,81,77,1.1,7.67,2.3,0,0,0,0,0,0,0.724523598017733,394.645044614486,79.040137209945
8.7,"eps_greedy_SVM","SVM",71,3,3512,3257,255,400,238,162,0.927890215383135,0.587301587301587,1.75023342670401,210,104,106,53,1,10.22,1.5,0,0,0,0,0,0,0.594994887687785,323.228659544913,70.0880804027984
8.7,"eps_greedy_SVM","SVM",71,4,3412,3221,191,500,274,226,0.938288073828536,0.608465608465608,1.79779411764706,282,141,141,72,1,12.78,1.2,0,0,0,0,0,0,0.513680823204253,284.845936759466,63.4925371246972
8.7,"eps_greedy_SVM","SVM",71,5,3312,3167,145,600,328,272,0.921597602129569,0.608465608465608,1.75651667394787,368,184,184,86,1,15.34,1.2,0,0,0,0,0,0,0.256750876786896,181.110889760756,36.1219987917964
8.7,"eps_greedy_SVM","SVM",71,6,3212,3098,114,700,397,303,0.909214493821162,0.650793650793651,1.68830370858021,456,225,231,88,1,17.89,1.3,0,0,0,0,0,0,0.144045161622124,146.26992457519,19.9388861262104
8.7,"eps_greedy_SVM","SVM",71,7,3112,3022,90,800,473,327,0.913339202246941,0.650793650793651,1.69954856560361,509,247,262,53,1.1,20.45,1.4,0,0,0,0,0,0,0.101831892587663,146.580324425527,13.6069109096067
8.7,"eps_greedy_SVM","SVM",71,8,3012,2945,67,900,550,350,0.905282920563052,0.677248677248677,1.67567646500489,562,270,292,53,1.1,23.01,1.6,0,0,0,0,0,0,0.102850037555395,159.772552520164,12.8921450234715
8.7,"eps_greedy_SVM","SVM",71,9,2912,2855,57,1000,640,360,0.915152277348086,0.661375661375661,1.69160581281793,593,288,305,31,1.1,25.56,1.8,0,0,0,0,0,0,0.0766539676589387,112.442804545292,9.34651234564331
8.7,"eps_greedy_SVM","SVM",71,10,2812,2766,46,1100,729,371,0.918679614208751,0.650793650793651,1.74392703674472,623,302,321,30,1.1,28.12,2,0,0,0,0,0,0,0.0724686774562566,113.100887039353,7.98902304127608
8.7,"eps_greedy_SVM","SVM",71,11,2712,2671,41,1200,824,376,0.927834820024963,0.661375661375661,1.76298634862171,647,312,335,24,1.1,30.67,2.2,0,0,0,0,0,0,0.0759342591727267,95.4999575468842,8.61491927922958
8.7,"eps_greedy_SVM","SVM",71,12,2612,2573,39,1300,922,378,0.929818572716132,0.656084656084656,1.76461122083242,653,317,336,6,1.1,33.23,2.4,0,0,0,0,0,0,0.061566487849794,71.4532940951248,6.69241475290658
8.7,"eps_greedy_SVM","SVM",71,13,2512,2478,34,1400,1017,383,0.931068711204527,0.650793650793651,1.75023342670401,666,322,344,13,1.1,35.79,2.7,0,0,0,0,0,0,0.0560016876520359,56.2164934746991,6.07728558866594
8.7,"eps_greedy_SVM","SVM",71,14,2412,2384,28,1500,1111,389,0.931180999092706,0.645502645502645,1.75184357705057,685,330,355,19,1.1,38.34,2.9,0,0,0,0,0,0,0.0565376908694258,54.047600557254,6.22634780834695
8.7,"eps_greedy_SVM","SVM",71,15,2312,2289,23,1600,1206,394,0.933552519291052,0.645502645502645,1.75507278180089,694,335,359,9,1.1,40.9,3.1,0,0,0,0,0,0,0.0435865791306043,44.0325941946145,5.21869829762397
8.7,"eps_greedy_SVM","SVM",71,16,2212,2198,14,1700,1297,403,0.93626389749762,0.645502645502645,1.75345669268321,722,343,379,28,1.1,43.46,3.2,0,0,0,0,0,0,0.0390674727225397,44.0607270237597,4.51150429288897
8.7,"eps_greedy_SVM","SVM",71,17,2112,2102,10,1800,1393,407,0.93574437886831,0.645502645502645,1.75184357705057,736,348,388,14,1.1,46.01,3.4,0,0,0,0,0,0,0.0412696861347344,44.8122151350821,4.16400536323122
8.7,"eps_greedy_SVM","SVM",71,18,2012,2002,10,1900,1493,407,0.934212772073548,0.64021164021164,1.76925770308123,762,365,397,26,1.1,48.57,3.7,0,0,0,0,0,0,0.028782575343547,20.9055493377472,3.88409783036274
8.7,"eps_greedy_SVM","SVM",71,19,1912,1902,10,2000,1593,407,0.934175342777488,0.64021164021164,1.77414965986395,761,365,396,-1,1.1,51.12,3.9,0,0,0,0,0,0,0.0186512995630786,15.4434388378457,2.22662483612824
8.7,"eps_greedy_SVM","SVM",71,20,1812,1803,9,2100,1692,408,0.934286133493825,0.634920634920635,1.77414965986395,762,367,395,1,1.1,53.68,4.1,0,0,0,0,0,0,0.0145116622307647,12.2781861799841,1.61182043208597
8.7,"eps_greedy_SVM","SVM",71,21,1712,1704,8,2200,1791,409,0.934121444591162,0.64021164021164,1.76763304036031,768,370,398,6,1.1,56.24,4.4,0,0,0,0,0,0,0.0148638235301683,11.7997405938333,1.52121890878218
8.7,"eps_greedy_SVM","SVM",71,22,1612,1604,8,2300,1891,409,0.934040597311673,0.64021164021164,1.77414965986395,771,377,394,3,1,58.79,4.6,0,0,0,0,0,0,0.00968139743082285,6.70181261716165,1.15418679329371
8.7,"eps_greedy_SVM","SVM",71,23,1512,1506,6,2400,1989,411,0.934849070106564,0.634920634920635,1.77414965986395,780,380,400,9,1.1,61.35,4.8,0,0,0,0,0,0,0.00862515716143316,6.20645831611596,0.935507667923667
8.7,"eps_greedy_SVM","SVM",71,24,1412,1406,6,2500,2089,411,0.934762234139705,0.634920634920635,1.77414965986395,779,381,398,-1,1,63.91,5.1,0,0,0,0,0,0,0.00759439836172784,4.86948883157764,0.780637999274202
8.7,"eps_greedy_SVM","SVM",71,25,1312,1307,5,2600,2188,412,0.935709943915939,0.645502645502645,1.7725160045602,790,386,404,11,1,66.46,5.3,0,0,0,0,0,0,0.00533034227027782,3.18669347983581,0.588094230145836
8.7,"eps_greedy_SVM","SVM",71,26,1212,1208,4,2700,2287,413,0.935606639058814,0.645502645502645,1.77088535506199,790,388,402,0,1,69.02,5.5,0,0,0,0,0,0,0.00543412494169849,2.89419804782872,0.566330816478987
8.7,"eps_greedy_SVM","SVM",71,27,1112,1108,4,2800,2387,413,0.935846186553596,0.645502645502645,1.7725160045602,797,390,407,7,1,71.57,5.8,0,0,0,0,0,0,0.00441900923888359,2.09900605837957,0.476283931629331
8.7,"eps_greedy_SVM","SVM",71,28,1012,1008,4,2900,2487,413,0.936016864143629,0.645502645502645,1.77088535506199,797,390,407,0,1,74.13,6,0,0,0,0,0,0,0.00375241286586571,1.52197921947687,0.398740585519699
8.7,"eps_greedy_SVM","SVM",71,29,912,908,4,3000,2587,413,0.936010875456259,0.650793650793651,1.77088535506199,798,390,408,1,1,76.69,6.3,0,0,0,0,0,0,0.00311496828044549,1.14599537347435,0.346052617433642
8.7,"eps_greedy_SVM","SVM",71,30,812,809,3,3100,2686,414,0.936214490826825,0.650793650793651,1.76925770308123,802,392,410,4,1,79.24,6.5,0,0,0,0,0,0,0.00264009809264709,0.876385985186065,0.29860862634827
8.7,"eps_greedy_SVM","SVM",71,31,712,709,3,3200,2786,414,0.936268389013151,0.650793650793651,1.76925770308123,802,392,410,0,1,81.8,6.7,0,0,0,0,0,0,0.00183341330650119,0.569694490195642,0.223017779653332
8.7,"eps_greedy_SVM","SVM",71,32,612,609,3,3300,2886,414,0.936439066603183,0.645502645502645,1.77088535506199,804,392,412,2,1.1,84.36,7,0,0,0,0,0,0,0.00112588220428587,0.354640924489491,0.149767240847231
8.7,"eps_greedy_SVM","SVM",71,33,512,509,3,3400,2986,414,0.93665615652033,0.64021164021164,1.76925770308123,807,393,414,3,1.1,86.91,7.2,0,0,0,0,0,0,0.000595111593731223,0.187023895792845,0.0796822502692747
8.7,"eps_greedy_SVM","SVM",71,34,412,411,1,3500,3084,416,0.937406239613367,0.634920634920635,1.77088535506199,816,398,418,9,1.1,89.47,7.4,0,0,0,0,0,0,0.00072141082359863,0.215194283367274,0.0917796538427495
8.7,"eps_greedy_SVM","SVM",71,35,312,312,0,3600,3183,417,0.938620445977546,0.634920634920635,1.76601135867191,823,404,419,7,1,92.02,7.6,0,0,0,0,0,0,0.000536996355720696,0.134945188293548,0.0661438436441992
8.7,"eps_greedy_SVM","SVM",71,36,212,212,0,3700,3283,417,0.938852507613117,0.624338624338624,1.76277690563405,824,404,420,1,1,94.58,7.9,0,0,0,0,0,0,0.000280210749888593,0.0583782225451165,0.0366110880160083
8.7,"eps_greedy_SVM","SVM",71,37,112,112,0,3800,3383,417,0.939310642196889,0.62962962962963,1.77387863180714,827,404,423,3,1,97.14,8.1,0,0,0,0,0,0,0.00013060921290629,0.0222041128178548,0.0208078235639645
8.7,"eps_greedy_SVM","SVM",71,38,12,12,0,3900,3483,417,0.939640020002214,0.62962962962963,1.77387863180714,826,405,421,-1,1,99.69,8.4,0,0,0,0,0,0,0.000105277426921758,0.00151142050133355,0.00151142050133355
8.7,"eps_greedy_SVM","SVM",71,39,0,0,0,3912,3495,417,0.939695415360382,0.62962962962963,1.77550604339595,826,405,421,0,1,100,8.4,0,0,0,0,0,0,0,0,0
8.7,"eps_greedy_SVM","SVM",72,0,3812,3416,396,100,92,8,0.823692945121199,0.48019801980198,1.60642423689374,24,8,16,0,2,2.56,11.5,0,0,0,0,0,0,0.243149698717409,304.142423575217,37.2782022844935
8.7,"eps_greedy_SVM","SVM",72,1,3712,3359,353,200,149,51,0.881505639161421,0.54950495049505,1.69099446709377,88,43,45,64,1,5.11,2.9,0,0,0,0,0,0,0.675986252054906,362.019965611492,74.7198236338229
8.7,"eps_greedy_SVM","SVM",72,2,3612,3322,290,300,186,114,0.873766609842309,0.569306930693069,1.68519227613369,156,78,78,68,1,7.67,1.6,0,0,0,0,0,0,0.594932942638801,218.009885891424,69.4597699529683
8.7,"eps_greedy_SVM","SVM",72,3,3512,3286,226,400,222,178,0.879689422762123,0.584158415841584,1.66889629055071,228,115,113,72,1,10.22,1.2,0,0,0,0,0,0,0.442433163599397,192.16108813154,59.7971111632025
8.7,"eps_greedy_SVM","SVM",72,4,3412,3246,166,500,262,238,0.884830430021341,0.589108910891089,1.70302499863246,303,157,146,75,0.9,12.78,1.1,0,0,0,0,0,0,0.272794808926193,116.831399413032,42.4106010116749
8.7,"eps_greedy_SVM","SVM",72,5,3312,3190,122,600,318,282,0.824642683766677,0.589108910891089,1.5635207557453,397,199,198,94,1,15.34,1.1,0,0,0,0,0,0,0.258937717516183,144.761362243029,35.3217663681852
8.7,"eps_greedy_SVM","SVM",72,6,3212,3106,106,700,402,298,0.855120403716544,0.599009900990099,1.58857507870603,442,219,223,45,1,17.89,1.3,0,0,0,0,0,0,0.0831206659654906,45.0666383008674,13.2158291370567
8.7,"eps_greedy_SVM","SVM",72,7,3112,3035,77,800,473,327,0.853590661232605,0.608910891089109,1.57965049961217,498,243,255,56,1,20.45,1.4,0,0,0,0,0,0,0.0742713355317817,52.7455661597959,9.98803408123351
8.7,"eps_greedy_SVM","SVM",72,8,3012,2950,62,900,558,342,0.861857479932721,0.618811881188119,1.61534881598759,533,259,274,35,1.1,23.01,1.6,0,0,0,0,0,0,0.0526133172918753,42.3106089003221,6.4481421958624
8.7,"eps_greedy_SVM","SVM",72,9,2912,2864,48,1000,644,356,0.860742630705491,0.628712871287129,1.61237669305109,573,279,294,40,1.1,25.56,1.8,0,0,0,0,0,0,0.0561591537485188,66.8396328354875,7.81092339002562
8.7,"eps_greedy_SVM","SVM",72,10,2812,2773,39,1100,735,365,0.873649480113355,0.643564356435644,1.61534881598759,597,289,308,24,1.1,28.12,2,0,0,0,0,0,0,0.0431979292450607,57.9595954909599,5.10447056715355
8.7,"eps_greedy_SVM","SVM",72,11,2712,2674,38,1200,834,366,0.880454294004089,0.643564356435644,1.62427339508144,597,291,306,0,1.1,30.67,2.3,0,0,0,0,0,0,0.0322881066817085,41.9784007677007,3.57138615790297
8.7,"eps_greedy_SVM","SVM",72,12,2612,2578,34,1300,930,370,0.878687469659171,0.638613861386139,1.61534881598759,610,296,314,13,1.1,33.23,2.5,0,0,0,0,0,0,0.0326675082277678,44.0612855577867,3.56532982914211
8.7,"eps_greedy_SVM","SVM",72,13,2512,2478,34,1400,1030,370,0.881070989082949,0.638613861386139,1.622777747388,615,299,316,5,1.1,35.79,2.8,0,0,0,0,0,0,0.0237922392413032,30.0536583091807,2.66399464204782
8.7,"eps_greedy_SVM","SVM",72,14,2412,2384,28,1500,1124,376,0.896276685821382,0.643564356435644,1.6747338027271,636,306,330,21,1.1,38.34,3,0,0,0,0,0,0,0.0235214153607559,31.4853718582346,2.63775379084606
8.7,"eps_greedy_SVM","SVM",72,15,2312,2288,24,1600,1220,380,0.906965126387222,0.643564356435644,1.68209449621433,656,320,336,20,1.1,40.9,3.2,0,0,0,0,0,0,0.0291112968133688,32.5933090651685,3.61778877918732
8.7,"eps_greedy_SVM","SVM",72,16,2212,2192,20,1700,1316,384,0.915504306987151,0.638613861386139,1.71769437973209,675,328,347,19,1.1,43.46,3.4,0,0,0,0,0,0,0.0384113538471207,33.2567667746684,4.57502528307316
8.7,"eps_greedy_SVM","SVM",72,17,2112,2092,20,1800,1416,384,0.916748986757291,0.638613861386139,1.73549432149097,681,330,351,6,1.1,46.01,3.7,0,0,0,0,0,0,0.0294351768229944,25.9046808563487,3.30730396440852
8.7,"eps_greedy_SVM","SVM",72,18,2012,1994,18,1900,1514,386,0.918057170597341,0.643564356435644,1.7549072294534,685,333,352,4,1.1,48.57,3.9,0,0,0,0,0,0,0.0247529232799457,20.2858770814368,2.77466647186492
8.7,"eps_greedy_SVM","SVM",72,19,1912,1899,13,2000,1609,391,0.918573670365902,0.643564356435644,1.74279246106429,704,341,363,19,1.1,51.12,4.1,0,0,0,0,0,0,0.0253578467318882,18.6190726818359,3.30216989444502
8.7,"eps_greedy_SVM","SVM",72,20,1812,1804,8,2100,1704,396,0.917035460672642,0.633663366336634,1.74599907092825,717,347,370,13,1.1,53.68,4.3,0,0,0,0,0,0,0.0179568104001202,15.9643784183801,2.59055805201952
8.7,"eps_greedy_SVM","SVM",72,21,1712,1706,6,2200,1802,398,0.916321392686597,0.638613861386139,1.7492175023954,722,350,372,5,1.1,56.24,4.5,0,0,0,0,0,0,0.0134931458138877,12.1047622979458,1.4987566713787
8.7,"eps_greedy_SVM","SVM",72,22,1612,1606,6,2300,1902,398,0.917615464511115,0.633663366336634,1.76543952737815,733,354,379,11,1.1,58.79,4.8,0,0,0,0,0,0,0.0116309428053256,9.4825941252606,1.23475605885778
8.7,"eps_greedy_SVM","SVM",72,23,1512,1506,6,2400,2002,398,0.918980096413301,0.623762376237624,1.76381538797854,741,363,378,8,1,61.35,5,0,0,0,0,0,0,0.00720486876886775,5.22548545987269,0.971168802958226
8.7,"eps_greedy_SVM","SVM",72,24,1412,1407,5,2500,2101,399,0.918805107420673,0.633663366336634,1.7621942341293,751,366,385,10,1.1,63.91,5.3,0,0,0,0,0,0,0.00741121794154194,4.91275415333188,0.766021603254973
8.7,"eps_greedy_SVM","SVM",72,25,1312,1307,5,2600,2201,399,0.919394989670014,0.618811881188119,1.76706666058311,765,371,394,14,1.1,66.46,5.5,0,0,0,0,0,0,0.00502168154363877,3.12206552752429,0.635506767545174
8.7,"eps_greedy_SVM","SVM",72,26,1212,1208,4,2700,2300,400,0.91975343486459,0.618811881188119,1.77109420500874,766,372,394,1,1.1,69.02,5.8,0,0,0,0,0,0,0.00500846938050235,3.07604707232283,0.533320332076115
8.7,"eps_greedy_SVM","SVM",72,27,1112,1108,4,2800,2400,400,0.919332896801662,0.618811881188119,1.77272354650368,770,373,397,4,1.1,71.57,6,0,0,0,0,0,0,0.00416267778866027,2.33169384203517,0.438588975185768
8.7,"eps_greedy_SVM","SVM",72,28,1012,1009,3,2900,2499,401,0.919169197421462,0.618811881188119,1.77599123967696,779,380,399,9,1.1,74.13,6.2,0,0,0,0,0,0,0.00366523753546739,1.85616097433387,0.384050552189207
8.7,"eps_greedy_SVM","SVM",72,29,912,909,3,3000,2599,401,0.91915226300282,0.613861386138614,1.77599123967696,778,380,398,-1,1,76.69,6.5,0,0,0,0,0,0,0.00323927562284258,1.508141401813,0.353293755686339
8.7,"eps_greedy_SVM","SVM",72,30,812,810,2,3100,2698,402,0.91943450331351,0.618811881188119,1.77599123967696,779,381,398,1,1,79.24,6.7,0,0,0,0,0,0,0.00266119179879776,1.16578805730489,0.293485738899498
8.7,"eps_greedy_SVM","SVM",72,31,712,710,2,3200,2798,402,0.919620781918566,0.618811881188119,1.77435588862754,779,382,397,0,1,81.8,7,0,0,0,0,0,0,0.00179644635949764,0.687289920302085,0.196443113758252
8.7,"eps_greedy_SVM","SVM",72,32,612,610,2,3300,2898,402,0.920013095950425,0.618811881188119,1.77435588862754,781,383,398,2,1,84.36,7.2,0,0,0,0,0,0,0.00181842932936883,0.625892287366927,0.202037797763501
8.7,"eps_greedy_SVM","SVM",72,33,512,510,2,3400,2998,402,0.920134459284022,0.618811881188119,1.77435588862754,779,383,396,-2,1,86.91,7.5,0,0,0,0,0,0,0.00107967531457898,0.331401255938695,0.126841159864473
8.7,"eps_greedy_SVM","SVM",72,34,412,410,2,3500,3098,402,0.920320737889077,0.618811881188119,1.77599123967696,778,383,395,-1,1,89.47,7.7,0,0,0,0,0,0,0.000843807533306509,0.242944195780438,0.103290781183674
8.7,"eps_greedy_SVM","SVM",72,35,312,312,0,3600,3196,404,0.921864592388552,0.618811881188119,1.77272354650368,790,387,403,12,1,92.02,7.9,0,0,0,0,0,0,0.000958610474523034,0.244088776266628,0.119981353557443
8.7,"eps_greedy_SVM","SVM",72,36,212,212,0,3700,3296,404,0.922447418630127,0.618811881188119,1.77435588862754,794,391,403,4,1,94.58,8.2,0,0,0,0,0,0,0.000506362997692525,0.105660094029249,0.0650665885961756
8.7,"eps_greedy_SVM","SVM",72,37,112,112,0,3800,3396,404,0.922573015568384,0.618811881188119,1.77599123967696,794,392,402,0,1,97.14,8.4,0,0,0,0,0,0,0.000257188223262505,0.0419307480278611,0.0390958483188299
8.7,"eps_greedy_SVM","SVM",72,38,12,12,0,3900,3496,404,0.923100804949376,0.618811881188119,1.77109420500874,797,394,403,3,1,99.69,8.7,0,0,0,0,0,0,0.000179718989272441,0.00233779309811436,0.00233779309811436
8.7,"eps_greedy_SVM","SVM",72,39,0,0,0,3912,3508,404,0.923320952391714,0.618811881188119,1.77272354650368,797,394,403,0,1,100,8.7,0,0,0,0,0,0,0,0,0
8.7,"eps_greedy_SVM","SVM",73,0,3812,3414,398,100,94,6,0.908913995732527,0.504950495049505,1.76543952737815,18,6,12,0,2,2.56,15.7,0,0,0,0,0,0,0.467379312529605,279.480722786005,54.1118281910473
8.7,"eps_greedy_SVM","SVM",73,1,3712,3377,335,200,131,69,0.920484437269273,0.579207920792079,1.7492175023954,90,45,45,72,1,5.11,1.9,0,0,0,0,0,0,0.654725907151712,252.756731358011,78.3352828857681
8.7,"eps_greedy_SVM","SVM",73,2,3612,3347,265,300,161,139,0.919677229980702,0.608910891089109,1.75814208148925,145,72,73,55,1,7.67,1.2,0,0,0,0,0,0,0.5,171.714452012114,64.8062321920686
8.7,"eps_greedy_SVM","SVM",73,3,3512,3300,212,400,208,192,0.91807692741909,0.638613861386139,1.76057605760576,229,116,113,84,1,10.22,1.1,0,0,0,0,0,0,0.288731880965526,139.212926748311,44.2073164758005
8.7,"eps_greedy_SVM","SVM",73,4,3412,3249,163,500,259,241,0.888060670377194,0.628712871287129,1.69099446709377,318,159,159,89,1,12.78,1.1,0,0,0,0,0,0,0.213228271951647,110.613531625723,30.4524646005733
8.7,"eps_greedy_SVM","SVM",73,5,3312,3171,141,600,337,263,0.900016369938024,0.613861386138614,1.66889629055071,370,181,189,52,1,15.34,1.3,0,0,0,0,0,0,0.0794600166364322,39.5109450260258,13.6044328711473
8.7,"eps_greedy_SVM","SVM",73,6,3212,3098,114,700,410,290,0.906922790340603,0.618811881188119,1.68364196125224,426,206,220,56,1.1,17.89,1.4,0,0,0,0,0,0,0.0644130112144025,41.3661506702581,8.52119474715796
8.7,"eps_greedy_SVM","SVM",73,7,3112,3014,98,800,494,306,0.909965340889841,0.638613861386139,1.68519227613369,467,223,244,41,1.1,20.45,1.6,0,0,0,0,0,0,0.0574258942030769,57.0185310858342,8.53760468276471
8.7,"eps_greedy_SVM","SVM",73,8,3012,2931,81,900,577,323,0.915522652607335,0.648514851485149,1.68364196125224,510,246,264,43,1.1,23.01,1.8,0,0,0,0,0,0,0.0462758395557791,59.5337887242574,6.30644680333346
8.7,"eps_greedy_SVM","SVM",73,9,2912,2847,65,1000,661,339,0.924551520146325,0.658415841584158,1.69989443797321,551,263,288,41,1.1,25.56,1.9,0,0,0,0,0,0,0.0517508795967689,76.497282292353,6.21321607629776
8.7,"eps_greedy_SVM","SVM",73,10,2812,2756,56,1100,752,348,0.935093195750597,0.643564356435644,1.73869044363,587,279,308,36,1.1,28.12,2.2,0,0,0,0,0,0,0.0470340167881821,65.1047615191178,5.47881051024406
8.7,"eps_greedy_SVM","SVM",73,11,2712,2666,46,1200,842,358,0.938614143626456,0.658415841584158,1.73869044363,622,296,326,35,1.1,30.67,2.4,0,0,0,0,0,0,0.0550681954628189,67.6185100621542,6.35179057407892
8.7,"eps_greedy_SVM","SVM",73,12,2612,2570,42,1300,938,362,0.9427447305734,0.658415841584158,1.75814208148925,638,306,332,16,1.1,33.23,2.6,0,0,0,0,0,0,0.0485886561272379,58.4453081251267,5.52968694473815
8.7,"eps_greedy_SVM","SVM",73,13,2512,2475,37,1400,1033,367,0.944573647786674,0.648514851485149,1.77672813152875,651,315,336,13,1.1,35.79,2.8,0,0,0,0,0,0,0.0494486518478069,53.6524022461876,5.46346553059326
8.7,"eps_greedy_SVM","SVM",73,14,2412,2377,35,1500,1131,369,0.945188931663983,0.653465346534653,1.78491581877082,657,317,340,6,1.1,38.34,3.1,0,0,0,0,0,0,0.044699434257379,46.2968775616913,4.96765212287919
8.7,"eps_greedy_SVM","SVM",73,15,2312,2282,30,1600,1226,374,0.944548246158716,0.653465346534653,1.78163170502883,675,324,351,18,1.1,40.9,3.3,0,0,0,0,0,0,0.0483708821290625,39.8685124237429,5.49292305649592
8.7,"eps_greedy_SVM","SVM",73,16,2212,2193,19,1700,1315,385,0.944726057554452,0.653465346534653,1.78163170502883,698,335,363,23,1.1,43.46,3.4,0,0,0,0,0,0,0.0481497538711672,37.0533319555053,5.85915225365683
8.7,"eps_greedy_SVM","SVM",73,17,2112,2098,14,1800,1410,390,0.944826252864748,0.648514851485149,1.78327224987692,713,339,374,15,1.1,46.01,3.6,0,0,0,0,0,0,0.0327103706539952,33.137718879959,4.20186914065257
8.7,"eps_greedy_SVM","SVM",73,18,2012,1998,14,1900,1510,390,0.944980073834074,0.648514851485149,1.78163170502883,712,339,373,-1,1.1,48.57,3.9,0,0,0,0,0,0,0.0282678438614652,28.7776027948789,2.99034713319769
8.7,"eps_greedy_SVM","SVM",73,19,1912,1898,14,2000,1610,390,0.943591451505476,0.643564356435644,1.78491581877082,722,349,373,10,1.1,51.12,4.1,0,0,0,0,0,0,0.0179043161294095,16.9038972097093,2.18784204389093
8.7,"eps_greedy_SVM","SVM",73,20,1812,1799,13,2100,1709,391,0.943450331350132,0.643564356435644,1.78163170502883,732,351,381,10,1.1,53.68,4.4,0,0,0,0,0,0,0.0166025737589697,14.0735567468747,1.67546514105164
8.7,"eps_greedy_SVM","SVM",73,21,1712,1699,13,2200,1809,391,0.942487891890675,0.643564356435644,1.79384039786467,749,363,386,17,1.1,56.24,4.6,0,0,0,0,0,0,0.00991599047506902,6.72697438431022,1.31832716217224
8.7,"eps_greedy_SVM","SVM",73,22,1612,1602,10,2300,1906,394,0.943241473520218,0.648514851485149,1.78889414676762,754,366,388,5,1.1,58.79,4.8,0,0,0,0,0,0,0.00937626017611647,7.33377369194012,1.07010520030159
8.7,"eps_greedy_SVM","SVM",73,23,1512,1504,8,2400,2004,396,0.942804001038649,0.643564356435644,1.79218861112631,760,369,391,6,1.1,61.35,5.1,0,0,0,0,0,0,0.00941372338367973,6.50162151830978,0.958820788465175
8.7,"eps_greedy_SVM","SVM",73,24,1412,1404,8,2500,2104,396,0.943173735845652,0.648514851485149,1.79384039786467,775,377,398,15,1.1,63.91,5.3,0,0,0,0,0,0,0.00675384958983926,4.26090649236413,0.779541393567992
8.7,"eps_greedy_SVM","SVM",73,25,1312,1305,7,2600,2203,397,0.943393883287991,0.648514851485149,1.79384039786467,775,377,398,0,1.1,66.46,5.5,0,0,0,0,0,0,0.0057593109595722,3.4693480292681,0.609258774346694
8.7,"eps_greedy_SVM","SVM",73,26,1212,1205,7,2700,2303,397,0.943518069024695,0.648514851485149,1.79384039786467,780,378,402,5,1.1,69.02,5.8,0,0,0,0,0,0,0.00572350416903177,3.04561988100501,0.588363597215533
8.7,"eps_greedy_SVM","SVM",73,27,1112,1105,7,2800,2403,397,0.943726926854605,0.648514851485149,1.80276497695853,782,379,403,2,1.1,71.57,6.1,0,0,0,0,0,0,0.0049976035261373,2.35462537628612,0.525479334123964
8.7,"eps_greedy_SVM","SVM",73,28,1012,1005,7,2900,2503,397,0.943776318908976,0.648514851485149,1.79779411764706,781,380,401,-1,1.1,74.13,6.3,0,0,0,0,0,0,0.00368803138595818,1.49135196670418,0.389534939138744
8.7,"eps_greedy_SVM","SVM",73,29,912,905,7,3000,2603,397,0.94394142949073,0.648514851485149,1.79944802207912,782,381,401,1,1.1,76.69,6.6,0,0,0,0,0,0,0.00334754231622182,1.17229620160238,0.363418316333626
8.7,"eps_greedy_SVM","SVM",73,30,812,805,7,3100,2703,397,0.944007755963742,0.648514851485149,1.80110497237569,786,381,405,4,1.1,79.24,6.8,0,0,0,0,0,0,0.00268512530839717,0.876252111891467,0.314981358224852
8.7,"eps_greedy_SVM","SVM",73,31,712,706,6,3200,2802,398,0.944124885692678,0.653465346534653,1.79779411764706,788,383,405,2,1.1,81.8,7,0,0,0,0,0,0,0.00175908789591963,0.534440084553695,0.216668283523318
8.7,"eps_greedy_SVM","SVM",73,32,612,608,4,3300,2900,400,0.944709123135806,0.648514851485149,1.79449541284404,793,385,408,5,1.1,84.36,7.2,0,0,0,0,0,0,0.00122644687823148,0.391786149520269,0.163355396020193
8.7,"eps_greedy_SVM","SVM",73,33,512,509,3,3400,2999,401,0.945203043679515,0.648514851485149,1.79614325068871,803,391,412,10,1.1,86.91,7.5,0,0,0,0,0,0,0.000968861084166243,0.287873751549755,0.122016396863856
8.7,"eps_greedy_SVM","SVM",73,34,412,411,1,3500,3097,403,0.945651805773512,0.648514851485149,1.78793418647166,812,394,418,9,1.1,89.47,7.7,0,0,0,0,0,0,0.000876883633094453,0.256428852183491,0.107163599098549
8.7,"eps_greedy_SVM","SVM",73,35,312,312,0,3600,3196,404,0.945726599455845,0.648514851485149,1.79779411764706,818,397,421,6,1.1,92.02,7.9,0,0,0,0,0,0,0.0007128396615467,0.172199947622228,0.0857496173352595
8.7,"eps_greedy_SVM","SVM",73,36,212,212,0,3700,3296,404,0.945558666470985,0.648514851485149,1.79120879120879,822,398,424,4,1.1,94.58,8.2,0,0,0,0,0,0,0.000355614292685715,0.0752970132732911,0.0475365136325381
8.7,"eps_greedy_SVM","SVM",73,37,112,112,0,3800,3396,404,0.94578163631643,0.648514851485149,1.79944802207912,818,400,418,-4,1,97.14,8.4,0,0,0,0,0,0,0.000140266351038394,0.0221355037579193,0.0206365854782779
8.7,"eps_greedy_SVM","SVM",73,38,12,12,0,3900,3496,404,0.945812682750606,0.648514851485149,1.79285059578368,817,400,417,-1,1,99.69,8.7,0,0,0,0,0,0,7.82828308318937e-05,0.00114241765383246,0.00114241765383246
8.7,"eps_greedy_SVM","SVM",73,39,0,0,0,3912,3508,404,0.945753412285362,0.648514851485149,1.79285059578368,817,400,417,0,1,100,8.7,0,0,0,0,0,0,0,0,0
8.7,"eps_greedy_SVM","SVM",74,0,3812,3424,388,100,89,11,0.892170267067732,0.541062801932367,1.74408112748034,30,11,19,0,1.7,2.56,8.1,0,0,0,0,0,0,0.472664452814757,405.940817233799,54.0514672349883
8.7,"eps_greedy_SVM","SVM",74,1,3712,3372,340,200,141,59,0.918495869275198,0.579710144927536,1.79614325068871,122,59,63,92,1.1,5.11,2.4,0,0,0,0,0,0,0.700130098923884,499.594379326292,76.3026501097666
8.7,"eps_greedy_SVM","SVM",74,2,3612,3353,259,300,160,140,0.909220727924591,0.608695652173913,1.77336906523739,166,83,83,44,1,7.67,1.1,0,0,0,0,0,0,0.626164001164499,370.453662863857,72.3054326548699
8.7,"eps_greedy_SVM","SVM",74,3,3512,3310,202,400,203,197,0.891829147366473,0.613526570048309,1.70780481318974,245,124,121,79,1,10.22,1,0,0,0,0,0,0,0.410329436608185,229.352230681472,56.4724587889077
8.7,"eps_greedy_SVM","SVM",74,4,3412,3260,152,500,253,247,0.875616984722807,0.608695652173913,1.69357416879795,341,172,169,96,1,12.78,1,0,0,0,0,0,0,0.289321188632964,205.467814151493,41.5391488717615
8.7,"eps_greedy_SVM","SVM",74,5,3312,3190,122,600,323,277,0.894344042006067,0.618357487922705,1.71567488145328,406,199,207,65,1,15.34,1.2,0,0,0,0,0,0,0.154233809202346,119.602470517187,21.608638010856
8.7,"eps_greedy_SVM","SVM",74,6,3212,3119,93,700,394,306,0.909723430642221,0.652173913043478,1.74180191010486,484,232,252,78,1.1,17.89,1.3,0,0,0,0,0,0,0.114989693188403,103.883536977742,14.7012542467926
8.7,"eps_greedy_SVM","SVM",74,7,3112,3039,73,800,474,326,0.9093905972495,0.657004830917874,1.71409507032856,533,255,278,49,1.1,20.45,1.5,0,0,0,0,0,0,0.0956841963681744,111.725618172897,12.9830412615141
8.7,"eps_greedy_SVM","SVM",74,8,3012,2956,56,900,557,343,0.911107244167129,0.657004830917874,1.69669308991913,576,277,299,43,1.1,23.01,1.6,0,0,0,0,0,0,0.0819210397023799,105.293688787148,9.57489173973641
8.7,"eps_greedy_SVM","SVM",74,9,2912,2864,48,1000,649,351,0.912482771383517,0.657004830917874,1.7006960248067,601,286,315,25,1.1,25.56,1.8,0,0,0,0,0,0,0.07229429554809,99.0677359170884,8.05082612487512
8.7,"eps_greedy_SVM","SVM",74,10,2812,2770,42,1100,743,357,0.920530158019899,0.657004830917874,1.7109441602728,625,299,326,24,1.1,28.12,2.1,0,0,0,0,0,0,0.0665398902772566,82.5703982187258,7.33935951783283
8.7,"eps_greedy_SVM","SVM",74,11,2712,2676,36,1200,837,363,0.924514491372587,0.661835748792271,1.72121115155394,638,305,333,13,1.1,30.67,2.3,0,0,0,0,0,0,0.0598622125335249,67.594455138174,6.5710591431672
8.7,"eps_greedy_SVM","SVM",74,12,2612,2582,30,1300,931,369,0.92596597641718,0.661835748792271,1.7401980409427,661,315,346,23,1.1,33.23,2.5,0,0,0,0,0,0,0.059258139811111,61.7818522099308,6.60867728654624
8.7,"eps_greedy_SVM","SVM",74,13,2512,2486,26,1400,1027,373,0.927128821714559,0.661835748792271,1.74889903114741,677,320,357,16,1.1,35.79,2.8,0,0,0,0,0,0,0.0527068354140671,50.2543170564266,5.80361879178154
8.7,"eps_greedy_SVM","SVM",74,14,2412,2390,22,1500,1123,377,0.927765486420133,0.666666666666667,1.74729010839566,685,324,361,8,1.1,38.34,3,0,0,0,0,0,0,0.0397436273617126,38.3994647497867,4.61504846549694
8.7,"eps_greedy_SVM","SVM",74,15,2312,2296,16,1600,1217,383,0.927864922122517,0.676328502415459,1.74889903114741,705,331,374,20,1.1,40.9,3.2,0,0,0,0,0,0,0.039394152616673,40.0961757262554,4.65295246827904
8.7,"eps_greedy_SVM","SVM",74,16,2212,2200,12,1700,1313,387,0.927302834193735,0.671497584541063,1.74889903114741,715,338,377,10,1.1,43.46,3.4,0,0,0,0,0,0,0.0329765827561353,34.6076672343953,3.60522571661806
8.7,"eps_greedy_SVM","SVM",74,17,2112,2100,12,1800,1413,387,0.926946522926845,0.666666666666667,1.74248105305146,714,339,375,-1,1.1,46.01,3.7,0,0,0,0,0,0,0.0246237520548331,25.8375230957895,2.68291827199767
8.7,"eps_greedy_SVM","SVM",74,18,2012,2001,11,1900,1512,388,0.926703457876562,0.671497584541063,1.74889903114741,721,341,380,7,1.1,48.57,3.9,0,0,0,0,0,0,0.0216583613785715,22.8906339146933,2.31592610356582
8.7,"eps_greedy_SVM","SVM",74,19,1912,1902,10,2000,1611,389,0.925925925925943,0.666666666666667,1.7592199292059,731,344,387,10,1.1,51.12,4.1,0,0,0,0,0,0,0.0195217741247397,19.5990948192558,2.05314122971597
8.7,"eps_greedy_SVM","SVM",74,20,1812,1802,10,2100,1711,389,0.92550332419079,0.652173913043478,1.7592199292059,738,355,383,7,1.1,53.68,4.4,0,0,0,0,0,0,0.0133805749937486,12.5758730405491,1.60569847023951
8.7,"eps_greedy_SVM","SVM",74,21,1712,1703,9,2200,1810,390,0.925075198249951,0.652173913043478,1.7592199292059,740,356,384,2,1.1,56.24,4.6,0,0,0,0,0,0,0.0132207594715112,11.18415972852,1.32712798501996
8.7,"eps_greedy_SVM","SVM",74,22,1612,1603,9,2300,1910,390,0.927975406236286,0.652173913043478,1.7820620508513,754,368,386,14,1,58.79,4.9,0,0,0,0,0,0,0.00997151481404123,6.41508579151234,1.28444514192168
8.7,"eps_greedy_SVM","SVM",74,23,1512,1504,8,2400,2009,391,0.927911877870871,0.647342995169082,1.78534695785748,757,369,388,3,1.1,61.35,5.1,0,0,0,0,0,0,0.00749856695934225,5.45746570948796,0.867510405530016
8.7,"eps_greedy_SVM","SVM",74,24,1412,1405,7,2500,2108,392,0.928417342691348,0.647342995169082,1.78534695785748,759,370,389,2,1.1,63.91,5.4,0,0,0,0,0,0,0.00654867248666618,4.55797209715294,0.689823362044743
8.7,"eps_greedy_SVM","SVM",74,25,1312,1305,7,2600,2208,392,0.928784702369613,0.647342995169082,1.78370299196626,762,375,387,3,1,66.46,5.6,0,0,0,0,0,0,0.00571716500184744,3.64025255049094,0.599797050353852
8.7,"eps_greedy_SVM","SVM",74,26,1212,1205,7,2700,2308,392,0.929008432699988,0.642512077294686,1.77878920961925,769,376,393,7,1,69.02,5.9,0,0,0,0,0,0,0.00424101972137977,2.40878763190553,0.445111164450633
8.7,"eps_greedy_SVM","SVM",74,27,1112,1105,7,2800,2408,392,0.929433796537982,0.642512077294686,1.77878920961925,772,377,395,3,1,71.57,6.1,0,0,0,0,0,0,0.00375057529428129,1.84415360465405,0.38830768830931
8.7,"eps_greedy_SVM","SVM",74,28,1012,1005,7,2900,2508,392,0.92985363617029,0.642512077294686,1.7820620508513,776,378,398,4,1.1,74.13,6.4,0,0,0,0,0,0,0.00333421535794229,1.4474930804439,0.356140123157316
8.7,"eps_greedy_SVM","SVM",74,29,912,907,5,3000,2606,394,0.929831539347536,0.642512077294686,1.77878920961925,781,382,399,5,1,76.69,6.6,0,0,0,0,0,0,0.00289169941100606,1.15589609243341,0.325368980289758
8.7,"eps_greedy_SVM","SVM",74,30,812,808,4,3100,2705,395,0.929867446684509,0.642512077294686,1.77878920961925,783,384,399,2,1,79.24,6.8,0,0,0,0,0,0,0.00259298792895052,0.933404547074579,0.28735617702224
8.7,"eps_greedy_SVM","SVM",74,31,712,708,4,3200,2805,395,0.929995884466762,0.642512077294686,1.78042412617221,784,384,400,1,1,81.8,7.1,0,0,0,0,0,0,0.00198194627687952,0.657743618127882,0.231311805684582
8.7,"eps_greedy_SVM","SVM",74,32,612,609,3,3300,2904,396,0.929861922478821,0.63768115942029,1.77878920961925,786,386,400,2,1,84.36,7.3,0,0,0,0,0,0,0.0016820637952845,0.534088336527589,0.204063785971373
8.7,"eps_greedy_SVM","SVM",74,33,512,509,3,3400,3004,396,0.930226520054247,0.63768115942029,1.7820620508513,796,388,408,10,1.1,86.91,7.6,0,0,0,0,0,0,0.000898683103817653,0.275065377561748,0.116982562160532
8.7,"eps_greedy_SVM","SVM",74,34,412,411,1,3500,3102,398,0.930831420577114,0.63768115942029,1.7820620508513,803,390,413,7,1.1,89.47,7.8,0,0,0,0,0,0,0.000925516225730627,0.269316217395158,0.116196638518819
8.7,"eps_greedy_SVM","SVM",74,35,312,312,0,3600,3201,399,0.93155509152228,0.63768115942029,1.77878920961925,809,393,416,6,1.1,92.02,8,0,0,0,0,0,0,0.000795343335710767,0.202836604010706,0.099882177740972
8.7,"eps_greedy_SVM","SVM",74,36,212,212,0,3700,3301,399,0.931762249235591,0.63768115942029,1.7820620508513,808,394,414,-1,1.1,94.58,8.3,0,0,0,0,0,0,0.000281007809358631,0.0588401045378975,0.0380297409153192
8.7,"eps_greedy_SVM","SVM",74,37,112,112,0,3800,3401,399,0.932103368936841,0.63768115942029,1.77390242607634,810,396,414,2,1,97.14,8.5,0,0,0,0,0,0,0.000153461060080962,0.0261498561324947,0.0245617506368143
8.7,"eps_greedy_SVM","SVM",74,38,12,12,0,3900,3501,399,0.932215234102027,0.63768115942029,1.77878920961925,812,396,416,2,1.1,99.69,8.8,0,0,0,0,0,0,9.76167242930991e-05,0.00136097884175312,0.00136097884175312
8.7,"eps_greedy_SVM","SVM",74,39,0,0,0,3912,3513,399,0.932249760387578,0.63768115942029,1.78370299196626,813,396,417,1,1.1,100,8.8,0,0,0,0,0,0,0,0,0
8.7,"eps_greedy_SVM","SVM",75,0,3812,3432,380,100,84,16,0.909376534118801,0.533333333333333,1.75337793519612,36,16,20,0,1.2,2.56,5.2,0,0,0,0,0,0,0.7498680792689,510.145312070324,79.0786785779939
8.7,"eps_greedy_SVM","SVM",75,1,3712,3406,306,200,110,90,0.916546664484812,0.557142857142857,1.76517282165856,93,47,46,57,1,5.11,1.2,0,0,0,0,0,0,0.749053318246853,315.757528386758,81.6356037427146
8.7,"eps_greedy_SVM","SVM",75,2,3612,3367,245,300,149,151,0.915474826815022,0.552380952380952,1.77211134453782,163,84,79,70,0.9,7.67,1,0,0,0,0,0,0,0.5,196.22111185746,62.1048034718999
8.7,"eps_greedy_SVM","SVM",75,3,3512,3323,189,400,193,207,0.895071728576872,0.580952380952381,1.72550362080316,241,125,116,78,0.9,10.22,0.9,0,0,0,0,0,0,0.219693494050572,98.594890053126,37.7594976653064
8.7,"eps_greedy_SVM","SVM",75,4,3412,3267,145,500,249,251,0.890033000599995,0.614285714285714,1.68103130755064,334,169,165,93,1,12.78,1,0,0,0,0,0,0,0.162769506399678,108.22662834789,25.9502092162901
8.7,"eps_greedy_SVM","SVM",75,5,3312,3203,109,600,313,287,0.885051546391748,0.619047619047619,1.64824226464779,410,199,211,76,1.1,15.34,1.1,0,0,0,0,0,0,0.139414786009556,95.3730956153362,20.1631565326398
8.7,"eps_greedy_SVM","SVM",75,6,3212,3127,85,700,389,311,0.879075983199689,0.647619047619048,1.61801470588235,468,228,240,58,1.1,17.89,1.3,0,0,0,0,0,0,0.0878035022471917,90.2109106645195,13.7109105425295
8.7,"eps_greedy_SVM","SVM",75,7,3112,3046,66,800,470,330,0.875546828124148,0.642857142857143,1.60089285714286,512,247,265,44,1.1,20.45,1.4,0,0,0,0,0,0,0.06244800013995,83.7953138380827,8.67475531312976
8.7,"eps_greedy_SVM","SVM",75,8,3012,2951,61,900,565,335,0.884402443680792,0.638095238095238,1.62248847926267,522,253,269,10,1.1,23.01,1.7,0,0,0,0,0,0,0.050696561319287,60.7098454689636,5.86651769043857
8.7,"eps_greedy_SVM","SVM",75,9,2912,2852,60,1000,664,336,0.883798341788032,0.638095238095238,1.61241778479348,527,254,273,5,1.1,25.56,2,0,0,0,0,0,0,0.0369898282017021,45.7171160146805,4.10729697856561
8.7,"eps_greedy_SVM","SVM",75,10,2812,2758,54,1100,758,342,0.885327005945563,0.642857142857143,1.64824226464779,551,264,287,24,1.1,28.12,2.2,0,0,0,0,0,0,0.0339892628130294,44.4539057871047,3.81085021135687
8.7,"eps_greedy_SVM","SVM",75,11,2712,2663,49,1200,853,347,0.88646839033437,0.647619047619048,1.65530123651671,571,274,297,20,1.1,30.67,2.5,0,0,0,0,0,0,0.0341861962598507,37.6168994052595,3.46778472686681
8.7,"eps_greedy_SVM","SVM",75,12,2612,2563,49,1300,953,347,0.914881634211533,0.628571428571429,1.71444270015699,611,301,310,40,1,33.23,2.7,0,0,0,0,0,0,0.0325398307294092,17.0529890677171,4.44697914211754
8.7,"eps_greedy_SVM","SVM",75,13,2512,2469,43,1400,1047,353,0.917876234113346,0.638095238095238,1.71758846657929,624,306,318,13,1,35.79,3,0,0,0,0,0,0,0.0255163151084778,16.6666633402393,3.14347676102194
8.7,"eps_greedy_SVM","SVM",75,14,2412,2376,36,1500,1140,360,0.922358588337974,0.633333333333333,1.74803522144829,645,317,328,21,1,38.34,3.2,0,0,0,0,0,0,0.0205116543028777,15.832556890718,2.51400122799739
8.7,"eps_greedy_SVM","SVM",75,15,2312,2279,33,1600,1237,363,0.924682266950304,0.633333333333333,1.74803522144829,650,319,331,5,1,40.9,3.4,0,0,0,0,0,0,0.0163660957734044,14.0929602211717,1.88659578840789
8.7,"eps_greedy_SVM","SVM",75,16,2212,2186,26,1700,1330,370,0.927524136802496,0.642857142857143,1.76031454783748,668,326,342,18,1,43.46,3.6,0,0,0,0,0,0,0.0326150943617307,23.0210177813627,4.16764896353768
8.7,"eps_greedy_SVM","SVM",75,17,2112,2087,25,1800,1429,371,0.928175966835773,0.633333333333333,1.77211134453782,681,331,350,13,1.1,46.01,3.9,0,0,0,0,0,0,0.0247814686282069,15.9404342066754,2.77842625790275
8.7,"eps_greedy_SVM","SVM",75,18,2012,1992,20,1900,1524,376,0.928413243877173,0.638095238095238,1.7737416217637,698,341,357,17,1,48.57,4.1,0,0,0,0,0,0,0.0312815481950096,16.3457515701305,3.66481027770316
8.7,"eps_greedy_SVM","SVM",75,19,1912,1896,16,2000,1620,380,0.928672339497095,0.638095238095238,1.76885976408912,709,346,363,11,1,51.12,4.3,0,0,0,0,0,0,0.0279488837677815,13.1417922435617,3.37161149510352
8.7,"eps_greedy_SVM","SVM",75,20,1812,1801,11,2100,1715,385,0.926986854306454,0.642857142857143,1.77537490134175,720,352,368,11,1,53.68,4.5,0,0,0,0,0,0,0.0217525915285262,11.091552396262,3.21241504314855
8.7,"eps_greedy_SVM","SVM",75,21,1712,1705,7,2200,1811,389,0.925874106801952,0.642857142857143,1.76517282165856,732,357,375,12,1.1,56.24,4.7,0,0,0,0,0,0,0.0112772145355053,7.75142824310905,1.69704824012867
8.7,"eps_greedy_SVM","SVM",75,22,1612,1606,6,2300,1910,390,0.9256641029837,0.642857142857143,1.76193099829463,736,358,378,4,1.1,58.79,4.9,0,0,0,0,0,0,0.00963032172934644,6.63746703941974,1.0826366755821
8.7,"eps_greedy_SVM","SVM",75,23,1512,1506,6,2400,2010,390,0.925666830306015,0.638095238095238,1.7587010606259,737,358,379,1,1.1,61.35,5.2,0,0,0,0,0,0,0.00714742850690889,5.06819125010866,0.783396409544232
8.7,"eps_greedy_SVM","SVM",75,24,1412,1407,5,2500,2109,391,0.925868652157321,0.642857142857143,1.7587010606259,743,361,382,6,1.1,63.91,5.4,0,0,0,0,0,0,0.00618730947182133,4.45855388534217,0.659107241967096
8.7,"eps_greedy_SVM","SVM",75,25,1312,1307,5,2600,2209,391,0.926179566901225,0.642857142857143,1.76193099829463,740,361,379,-3,1,66.46,5.6,0,0,0,0,0,0,0.0050387871077473,3.31459089722633,0.532542073746274
8.7,"eps_greedy_SVM","SVM",75,26,1212,1207,5,2700,2309,391,0.92668003054602,0.638095238095238,1.76679821099711,748,364,384,8,1.1,69.02,5.9,0,0,0,0,0,0,0.00403350191926564,2.37453859851723,0.428939178466065
8.7,"eps_greedy_SVM","SVM",75,27,1112,1108,4,2800,2408,392,0.926910489281633,0.638095238095238,1.76355042016807,753,366,387,5,1.1,71.57,6.1,0,0,0,0,0,0,0.00419509975386345,2.20787103840919,0.434121884481349
8.7,"eps_greedy_SVM","SVM",75,28,1012,1008,4,2900,2508,392,0.927199585447016,0.633333333333333,1.76517282165856,757,370,387,4,1,74.13,6.4,0,0,0,0,0,0,0.0035819493022331,1.64406410127795,0.382154069222424
8.7,"eps_greedy_SVM","SVM",75,29,912,909,3,3000,2607,393,0.927611411116575,0.633333333333333,1.76517282165856,765,374,391,8,1,76.69,6.6,0,0,0,0,0,0,0.00349167077224787,1.35511410786045,0.381927112937222
8.7,"eps_greedy_SVM","SVM",75,30,812,809,3,3100,2707,393,0.92781868761251,0.628571428571429,1.76193099829463,769,374,395,4,1.1,79.24,6.9,0,0,0,0,0,0,0.00260710286585937,0.882418836579974,0.296377446605518
8.7,"eps_greedy_SVM","SVM",75,31,712,710,2,3200,2806,394,0.928036873397705,0.628571428571429,1.7587010606259,772,375,397,3,1.1,81.8,7.1,0,0,0,0,0,0,0.00187570251791744,0.590818033771063,0.227508673201606
8.7,"eps_greedy_SVM","SVM",75,32,612,610,2,3300,2906,394,0.928238695249012,0.633333333333333,1.76193099829463,773,375,398,1,1.1,84.36,7.4,0,0,0,0,0,0,0.00112269975043474,0.351960292118488,0.142594531366833
8.7,"eps_greedy_SVM","SVM",75,33,512,511,1,3400,3005,395,0.928604156439218,0.638095238095238,1.7570905285191,775,376,399,2,1.1,86.91,7.6,0,0,0,0,0,0,0.000918895100141916,0.28970519658239,0.115150286561435
8.7,"eps_greedy_SVM","SVM",75,34,412,412,0,3500,3104,396,0.929273714067545,0.638095238095238,1.76031454783748,781,380,401,6,1.1,89.47,7.8,0,0,0,0,0,0,0.000761091521948057,0.215736742427152,0.0902740465519815
8.7,"eps_greedy_SVM","SVM",75,35,312,312,0,3600,3204,396,0.929774177712341,0.633333333333333,1.76355042016807,785,382,403,4,1.1,92.02,8.1,0,0,0,0,0,0,0.000413396656936874,0.100236488721335,0.0513343367081638
8.7,"eps_greedy_SVM","SVM",75,36,212,212,0,3700,3304,396,0.929812360224751,0.628571428571429,1.76193099829463,787,383,404,2,1.1,94.58,8.3,0,0,0,0,0,0,0.00025507266188923,0.0547969848808533,0.0346077418429027
8.7,"eps_greedy_SVM","SVM",75,37,112,112,0,3800,3404,396,0.929782359679287,0.628571428571429,1.76031454783748,789,384,405,2,1.1,97.14,8.6,0,0,0,0,0,0,0.000126459831861356,0.0208660116901696,0.0194898884624705
8.7,"eps_greedy_SVM","SVM",75,38,12,12,0,3900,3504,396,0.929954180985128,0.628571428571429,1.76031454783748,789,385,404,0,1,99.69,8.8,0,0,0,0,0,0,0.000103183182675419,0.00138273340305508,0.00138273340305508
8.7,"eps_greedy_SVM","SVM",75,39,0,0,0,3912,3516,396,0.930090547100876,0.628571428571429,1.76517282165856,790,385,405,1,1.1,100,8.9,0,0,0,0,0,0,0,0,0
8.7,"eps_greedy_SVM","SVM",76,0,3812,3420,392,100,87,13,0.900001417414346,0.537313432835821,1.73200054772012,30,13,17,0,1.3,2.56,6.7,0,0,0,0,0,0,0.610335393897266,482.475797991788,66.8645845410798
8.7,"eps_greedy_SVM","SVM",76,1,3712,3374,338,200,133,67,0.906463409448482,0.587064676616915,1.75630136609769,120,58,62,90,1.1,5.11,2,0,0,0,0,0,0,0.725208282089802,472.758515216634,78.3161491502874
8.7,"eps_greedy_SVM","SVM",76,2,3612,3346,266,300,161,139,0.910975039333259,0.601990049751244,1.75792007703418,170,87,83,50,1,7.67,1.2,0,0,0,0,0,0,0.594244201238587,343.515843982178,68.5113492181649
8.7,"eps_greedy_SVM","SVM",76,3,3512,3311,201,400,196,204,0.909907726325646,0.611940298507463,1.75630136609769,241,126,115,71,0.9,10.22,1,0,0,0,0,0,0,0.471010245047449,261.213551810278,60.6319638001691
8.7,"eps_greedy_SVM","SVM",76,4,3412,3266,146,500,241,259,0.882645178665083,0.606965174129353,1.67565487479728,332,167,165,91,1,12.78,0.9,0,0,0,0,0,0,0.330336108691482,283.07780725874,44.9507091099681
8.7,"eps_greedy_SVM","SVM",76,5,3312,3204,108,600,303,297,0.876449660529263,0.631840796019901,1.61890913081651,426,211,215,94,1,15.34,1,0,0,0,0,0,0,0.191750945374642,163.427636922078,28.5462163021793
8.7,"eps_greedy_SVM","SVM",76,6,3212,3130,82,700,377,323,0.864761661776585,0.656716417910448,1.56957149735195,500,244,256,74,1,17.89,1.2,0,0,0,0,0,0,0.167990639152481,221.735050917289,23.4018746218323
8.7,"eps_greedy_SVM","SVM",76,7,3112,3044,68,800,463,337,0.884767047951136,0.661691542288557,1.64574187884109,545,261,284,45,1.1,20.45,1.4,0,0,0,0,0,0,0.0936981391234903,116.63415703221,11.919642513625
8.7,"eps_greedy_SVM","SVM",76,8,3012,2957,55,900,550,350,0.88838995903674,0.661691542288557,1.64423063744638,578,274,304,33,1.1,23.01,1.6,0,0,0,0,0,0,0.0729569149013828,101.848582311542,8.69838306739641
8.7,"eps_greedy_SVM","SVM",76,9,2912,2864,48,1000,643,357,0.893930631741588,0.656716417910448,1.64272216897166,597,286,311,19,1.1,25.56,1.8,0,0,0,0,0,0,0.0584219676926747,82.398656741777,6.35739648498793
8.7,"eps_greedy_SVM","SVM",76,10,2812,2769,43,1100,738,362,0.901739167410822,0.646766169154229,1.68306581169589,613,292,321,16,1.1,28.12,2,0,0,0,0,0,0,0.0481434716533537,70.9681189775226,5.33788880698857
8.7,"eps_greedy_SVM","SVM",76,11,2712,2674,38,1200,833,367,0.914192569913977,0.631840796019901,1.71887572258304,630,303,327,17,1.1,30.67,2.3,0,0,0,0,0,0,0.0469248953391791,63.7654089762784,5.5593989998684
8.7,"eps_greedy_SVM","SVM",76,12,2612,2577,35,1300,930,370,0.922983373729648,0.626865671641791,1.73101313707958,638,310,328,8,1.1,33.23,2.5,0,0,0,0,0,0,0.0428883023784735,49.2216093882248,4.87006948330727
8.7,"eps_greedy_SVM","SVM",76,13,2512,2482,30,1400,1025,375,0.92404359966548,0.626865671641791,1.72204415709471,659,317,342,21,1.1,35.79,2.7,0,0,0,0,0,0,0.0500647489398886,49.1120632052675,5.5993767677173
8.7,"eps_greedy_SVM","SVM",76,14,2412,2383,29,1500,1124,376,0.92447307621436,0.626865671641791,1.71729587357331,662,318,344,3,1.1,38.34,3,0,0,0,0,0,0,0.0393991213106922,39.3186329384707,4.43497164516158
8.7,"eps_greedy_SVM","SVM",76,15,2312,2285,27,1600,1222,378,0.924508511573185,0.626865671641791,1.73101313707958,665,320,345,3,1.1,40.9,3.2,0,0,0,0,0,0,0.0316896843032701,30.6655138020767,3.68560491197526
8.7,"eps_greedy_SVM","SVM",76,16,2212,2192,20,1700,1315,385,0.92567362617113,0.631840796019901,1.73998211706445,686,328,358,21,1.1,43.46,3.4,0,0,0,0,0,0,0.0310290026749012,30.0990089251429,3.97011024317011
8.7,"eps_greedy_SVM","SVM",76,17,2112,2100,12,1800,1407,393,0.927130728125752,0.63681592039801,1.72941920233089,708,339,369,22,1.1,46.01,3.6,0,0,0,0,0,0,0.0272922566318782,28.0853031214424,3.33158003495597
8.7,"eps_greedy_SVM","SVM",76,18,2012,2000,12,1900,1507,393,0.927371688565715,0.63681592039801,1.73678067802661,708,339,369,0,1.1,48.57,3.8,0,0,0,0,0,0,0.0232733028975228,24.5596599831402,2.50815930505218
8.7,"eps_greedy_SVM","SVM",76,19,1912,1903,9,2000,1604,396,0.927462403084283,0.63681592039801,1.73837992358649,719,344,375,11,1.1,51.12,4.1,0,0,0,0,0,0,0.0213553958169235,22.0262133463789,2.24692601107571
8.7,"eps_greedy_SVM","SVM",76,20,1812,1803,9,2100,1704,396,0.926276027271039,0.63681592039801,1.73837992358649,730,350,380,11,1.1,53.68,4.3,0,0,0,0,0,0,0.0157917817681721,15.3161639479366,1.85506318506618
8.7,"eps_greedy_SVM","SVM",76,21,1712,1704,8,2200,1803,397,0.925753001374877,0.63681592039801,1.73998211706445,730,352,378,0,1.1,56.24,4.5,0,0,0,0,0,0,0.0138698614937613,12.3795222173135,1.41739201543464
8.7,"eps_greedy_SVM","SVM",76,22,1612,1604,8,2300,1903,397,0.926246261569629,0.621890547263682,1.76688905701905,743,361,382,13,1.1,58.79,4.8,0,0,0,0,0,0,0.009540888811824,7.33065273315173,1.18338876287574
8.7,"eps_greedy_SVM","SVM",76,23,1512,1507,5,2400,2000,400,0.926885515442713,0.626865671641791,1.77422280860889,756,366,390,13,1.1,61.35,5,0,0,0,0,0,0,0.00843352036024082,6.71582301709499,0.907462495619039
8.7,"eps_greedy_SVM","SVM",76,24,1412,1407,5,2500,2100,400,0.927337670621239,0.616915422885572,1.77259058891376,764,372,392,8,1.1,63.91,5.2,0,0,0,0,0,0,0.00640508829940431,4.79888483036718,0.755532780427465
8.7,"eps_greedy_SVM","SVM",76,25,1312,1308,4,2600,2199,401,0.92756162208897,0.616915422885572,1.77585803700392,767,374,393,3,1.1,66.46,5.5,0,0,0,0,0,0,0.00566830878374403,3.69694062035407,0.573730591426693
8.7,"eps_greedy_SVM","SVM",76,26,1212,1208,4,2700,2299,401,0.928329860668147,0.616915422885572,1.77585803700392,778,379,399,11,1.1,69.02,5.7,0,0,0,0,0,0,0.00446705780058266,2.56099474640269,0.535135551017733
8.7,"eps_greedy_SVM","SVM",76,27,1112,1109,3,2800,2398,402,0.928287338237565,0.616915422885572,1.77585803700392,778,380,398,0,1,71.57,6,0,0,0,0,0,0,0.00337712342111204,1.90158835174549,0.363192627018742
8.7,"eps_greedy_SVM","SVM",76,28,1012,1010,2,2900,2497,403,0.928412070700606,0.616915422885572,1.77585803700392,782,383,399,4,1,74.13,6.2,0,0,0,0,0,0,0.00336159272554967,1.67164001449495,0.346935336187465
8.7,"eps_greedy_SVM","SVM",76,29,912,910,2,3000,2597,403,0.928602004223874,0.616915422885572,1.77422280860889,785,384,401,3,1,76.69,6.4,0,0,0,0,0,0,0.00265823770633303,1.13708283994871,0.281993101041957
8.7,"eps_greedy_SVM","SVM",76,30,812,810,2,3100,2697,403,0.928740910830443,0.616915422885572,1.76933514246947,791,387,404,6,1,79.24,6.7,0,0,0,0,0,0,0.00222380119852982,0.835502007715155,0.241943741397171
8.7,"eps_greedy_SVM","SVM",76,31,712,710,2,3200,2797,403,0.92866153562669,0.616915422885572,1.77585803700392,791,388,403,0,1,81.8,6.9,0,0,0,0,0,0,0.00205149369550751,0.682524966319306,0.227780513322249
8.7,"eps_greedy_SVM","SVM",76,32,612,610,2,3300,2897,403,0.928644526654459,0.616915422885572,1.77585803700392,791,388,403,0,1,84.36,7.2,0,0,0,0,0,0,0.00120760586379743,0.382569223984304,0.149476323967345
8.7,"eps_greedy_SVM","SVM",76,33,512,510,2,3400,2997,403,0.92876358946009,0.616915422885572,1.77259058891376,790,388,402,-1,1,86.91,7.4,0,0,0,0,0,0,0.000761829107405372,0.230027556813762,0.0940265435999107
8.7,"eps_greedy_SVM","SVM",76,34,412,412,0,3500,3095,405,0.929344729344721,0.606965174129353,1.77096136962248,799,392,407,9,1,89.47,7.6,0,0,0,0,0,0,0.00082855887465069,0.253219668563371,0.103381653769032
8.7,"eps_greedy_SVM","SVM",76,35,312,312,0,3600,3195,405,0.929693413275506,0.606965174129353,1.76363811119197,806,393,413,7,1.1,92.02,7.9,0,0,0,0,0,0,0.000574504530408806,0.151066152129672,0.0694328442769784
8.7,"eps_greedy_SVM","SVM",76,36,212,212,0,3700,3295,405,0.929877677141365,0.606965174129353,1.76363811119197,808,396,412,2,1,94.58,8.1,0,0,0,0,0,0,0.000257069289878917,0.0523457836046492,0.0321470435424009
8.7,"eps_greedy_SVM","SVM",76,37,112,112,0,3800,3395,405,0.930064775835928,0.601990049751244,1.76201712028095,810,396,414,2,1,97.14,8.4,0,0,0,0,0,0,0.000109510725955446,0.0185002047435196,0.0173805983166785
8.7,"eps_greedy_SVM","SVM",76,38,12,12,0,3900,3495,405,0.930005244433114,0.601990049751244,1.76688905701905,813,398,415,3,1,99.69,8.6,0,0,0,0,0,0,7.78504219807731e-05,0.00107355323917413,0.00107355323917413
8.7,"eps_greedy_SVM","SVM",76,39,0,0,0,3912,3507,405,0.929983983217822,0.601990049751244,1.76201712028095,812,398,414,-1,1,100,8.7,0,0,0,0,0,0,0,0,0
8.7,"eps_greedy_SVM","SVM",77,0,3812,3414,398,100,90,10,0.881574562461925,0.53030303030303,1.74813573523251,29,10,19,0,1.9,2.56,9,0,0,0,0,0,0,0.388231885193586,403.134624519562,47.0793730155116
8.7,"eps_greedy_SVM","SVM",77,1,3712,3362,350,200,142,58,0.912661886211365,0.616161616161616,1.76147504456328,116,56,60,87,1.1,5.11,2.4,0,0,0,0,0,0,0.637618792278906,499.235838022694,69.4258960293758
8.7,"eps_greedy_SVM","SVM",77,2,3612,3335,277,300,169,131,0.908863952379301,0.626262626262626,1.7208211143695,165,84,81,49,1,7.67,1.3,0,0,0,0,0,0,0.620637979438846,297.619903418541,72.4419374408367
8.7,"eps_greedy_SVM","SVM",77,3,3512,3299,213,400,205,195,0.8976999804645,0.616161616161616,1.71014007478096,234,116,118,69,1,10.22,1.1,0,0,0,0,0,0,0.490967528415308,275.882504299361,60.1362502842018
8.7,"eps_greedy_SVM","SVM",77,4,3412,3243,169,500,261,239,0.903701405407898,0.641414141414141,1.73583117281369,314,156,158,80,1,12.78,1.1,0,0,0,0,0,0,0.270588257196599,154.405473542639,40.5951609213891
8.7,"eps_greedy_SVM","SVM",77,5,3312,3181,131,600,323,277,0.883095747003606,0.661616161616162,1.63736815670517,408,201,207,94,1,15.34,1.2,0,0,0,0,0,0,0.148669393864641,122.045756091525,21.7090886943715
8.7,"eps_greedy_SVM","SVM",77,6,3212,3109,103,700,395,305,0.870590144907555,0.656565656565657,1.60098219766728,469,231,238,61,1,17.89,1.3,0,0,0,0,0,0,0.10489608574656,129.134097352939,15.41609207589
8.7,"eps_greedy_SVM","SVM",77,7,3112,3031,81,800,473,327,0.878908539318098,0.671717171717172,1.61917517718623,519,251,268,50,1.1,20.45,1.4,0,0,0,0,0,0,0.0885837871153201,127.058481633202,12.6428702981875
8.7,"eps_greedy_SVM","SVM",77,8,3012,2951,61,900,553,347,0.890948736511868,0.686868686868687,1.62527852049911,568,270,298,49,1.1,23.01,1.6,0,0,0,0,0,0,0.0782711203056766,125.628680943771,9.50209669736277
8.7,"eps_greedy_SVM","SVM",77,9,2912,2864,48,1000,640,360,0.900834281380351,0.676767676767677,1.66619187264349,610,289,321,42,1.1,25.56,1.8,0,0,0,0,0,0,0.0772460720944149,128.426564101362,8.80601445234146
8.7,"eps_greedy_SVM","SVM",77,10,2812,2771,41,1100,733,367,0.908448822697967,0.671717171717172,1.67067736185383,625,300,325,15,1.1,28.12,2,0,0,0,0,0,0,0.0637219366293042,102.089689288483,6.98919726388868
8.7,"eps_greedy_SVM","SVM",77,11,2712,2679,33,1200,825,375,0.918363096264121,0.656565656565657,1.71014007478096,653,312,341,28,1.1,30.67,2.2,0,0,0,0,0,0,0.065821678962841,92.5892222312917,7.29266003468174
8.7,"eps_greedy_SVM","SVM",77,12,2612,2581,31,1300,923,377,0.923804311602947,0.651515151515151,1.7283330542999,657,317,340,4,1.1,33.23,2.4,0,0,0,0,0,0,0.0561262941032936,71.2895597100744,5.97574996529284
8.7,"eps_greedy_SVM","SVM",77,13,2512,2483,29,1400,1021,379,0.926431551004921,0.651515151515151,1.7299259879905,663,321,342,6,1.1,35.79,2.7,0,0,0,0,0,0,0.0463622049877694,57.9222193926678,5.01403698408861
8.7,"eps_greedy_SVM","SVM",77,14,2412,2385,27,1500,1119,381,0.928329081486056,0.661616161616162,1.73742954405938,665,323,342,2,1.1,38.34,2.9,0,0,0,0,0,0,0.0396957307264971,47.1631080696411,4.36552621671176
8.7,"eps_greedy_SVM","SVM",77,15,2312,2288,24,1600,1216,384,0.930669033911325,0.661616161616162,1.75724060885351,681,326,355,16,1.1,40.9,3.2,0,0,0,0,0,0,0.0381170862034726,44.9555750036641,4.29099683268634
8.7,"eps_greedy_SVM","SVM",77,16,2212,2196,16,1700,1308,392,0.933211523655181,0.651515151515151,1.75724060885351,706,339,367,25,1.1,43.46,3.3,0,0,0,0,0,0,0.0375336983364642,44.0755538279775,4.58690712088709
8.7,"eps_greedy_SVM","SVM",77,17,2112,2100,12,1800,1404,396,0.934013054320192,0.646464646464647,1.75724060885351,720,343,377,14,1.1,46.01,3.5,0,0,0,0,0,0,0.034185585118754,37.1896841996968,3.64816573384685
8.7,"eps_greedy_SVM","SVM",77,18,2012,2000,12,1900,1504,396,0.933748750301629,0.636363636363636,1.76309553678459,724,351,373,4,1.1,48.57,3.8,0,0,0,0,0,0,0.0256903098016448,25.1795012326375,2.99591469191741
8.7,"eps_greedy_SVM","SVM",77,19,1912,1901,11,2000,1603,397,0.933892393789982,0.641414141414141,1.7647190133378,733,352,381,9,1.1,51.12,4,0,0,0,0,0,0,0.0253541541037821,23.3984825293882,2.55526727646918
8.7,"eps_greedy_SVM","SVM",77,20,1812,1801,11,2100,1703,397,0.931427471529839,0.626262626262626,1.75985752845257,756,367,389,23,1.1,53.68,4.3,0,0,0,0,0,0,0.0171324745425657,11.0028614414521,2.22991263830295
8.7,"eps_greedy_SVM","SVM",77,21,1712,1703,9,2200,1801,399,0.931395869962401,0.626262626262626,1.76309553678459,760,370,390,4,1.1,56.24,4.5,0,0,0,0,0,0,0.0128647878689059,9.60787382220932,1.49699489287544
8.7,"eps_greedy_SVM","SVM",77,22,1612,1607,5,2300,1897,403,0.931005159674078,0.621212121212121,1.76634548247451,772,373,399,12,1.1,58.79,4.7,0,0,0,0,0,0,0.0112803504765445,9.39044082031148,1.28719010709589
8.7,"eps_greedy_SVM","SVM",77,23,1512,1509,3,2400,1995,405,0.930847151836889,0.621212121212121,1.75985752845257,780,377,403,8,1.1,61.35,4.9,0,0,0,0,0,0,0.0120887467392217,9.03583865636188,1.24456580785801
8.7,"eps_greedy_SVM","SVM",77,24,1412,1409,3,2500,2095,405,0.930908918536883,0.621212121212121,1.76147504456328,786,382,404,6,1.1,63.91,5.2,0,0,0,0,0,0,0.00815951250698812,5.55315394873772,0.967968437886972
8.7,"eps_greedy_SVM","SVM",77,25,1312,1309,3,2600,2195,405,0.930950575148506,0.621212121212121,1.75824298026133,787,382,405,1,1.1,66.46,5.4,0,0,0,0,0,0,0.00731693578930854,4.91382739781175,0.782046381272983
8.7,"eps_greedy_SVM","SVM",77,26,1212,1209,3,2700,2295,405,0.930927592190369,0.621212121212121,1.76309553678459,787,382,405,0,1.1,69.02,5.7,0,0,0,0,0,0,0.00616903885849093,3.65591069862421,0.635009268376849
8.7,"eps_greedy_SVM","SVM",77,27,1112,1109,3,2800,2395,405,0.930908918536884,0.626262626262626,1.76147504456328,788,384,404,1,1.1,71.57,5.9,0,0,0,0,0,0,0.00534006351749836,2.87399524468091,0.569198704694187
8.7,"eps_greedy_SVM","SVM",77,28,1012,1010,2,2900,2494,406,0.930850024706659,0.631313131313131,1.75985752845257,793,386,407,5,1.1,74.13,6.1,0,0,0,0,0,0,0.0048342035980307,2.27980943821057,0.511687631660076
8.7,"eps_greedy_SVM","SVM",77,29,912,911,1,3000,2593,407,0.930749474264813,0.631313131313131,1.76309553678459,798,388,410,5,1.1,76.69,6.4,0,0,0,0,0,0,0.00439298625600661,1.87690013237693,0.468746173595025
8.7,"eps_greedy_SVM","SVM",77,30,812,811,1,3100,2693,407,0.93079687661597,0.626262626262626,1.7647190133378,797,389,408,-1,1,79.24,6.6,0,0,0,0,0,0,0.0033510805603211,1.28449370674492,0.370082381347869
8.7,"eps_greedy_SVM","SVM",77,31,712,712,0,3200,2792,408,0.930766711483415,0.631313131313131,1.76309553678459,803,391,412,6,1.1,81.8,6.8,0,0,0,0,0,0,0.00276315134710409,0.999587075979961,0.314757352745974
8.7,"eps_greedy_SVM","SVM",77,32,612,612,0,3300,2892,408,0.93093908366944,0.636363636363636,1.76309553678459,805,391,414,2,1.1,84.36,7.1,0,0,0,0,0,0,0.00219791616253382,0.7410331048064,0.256540651830354
8.7,"eps_greedy_SVM","SVM",77,33,512,512,0,3400,2992,408,0.930893117753167,0.631313131313131,1.76147504456328,806,391,415,1,1.1,86.91,7.3,0,0,0,0,0,0,0.00123737221187495,0.416295031608235,0.157631461700865
8.7,"eps_greedy_SVM","SVM",77,34,412,412,0,3500,3092,408,0.930913227841537,0.626262626262626,1.76309553678459,807,392,415,1,1.1,89.47,7.6,0,0,0,0,0,0,0.000807537718176265,0.237023248740189,0.0968087433689141
8.7,"eps_greedy_SVM","SVM",77,35,312,312,0,3600,3192,408,0.930913227841537,0.621212121212121,1.7647190133378,810,394,416,3,1.1,92.02,7.8,0,0,0,0,0,0,0.000570429845886859,0.145025057595553,0.0696565795255404
8.7,"eps_greedy_SVM","SVM",77,36,212,212,0,3700,3292,408,0.931059744199659,0.631313131313131,1.75985752845257,812,396,416,2,1.1,94.58,8.1,0,0,0,0,0,0,0.000354212639242587,0.0741606592407599,0.0461753321768875
8.7,"eps_greedy_SVM","SVM",77,37,112,112,0,3800,3392,408,0.931209133427547,0.631313131313131,1.76147504456328,814,396,418,2,1.1,97.14,8.3,0,0,0,0,0,0,0.000140676818122039,0.0235190673135555,0.0220292736687438
8.7,"eps_greedy_SVM","SVM",77,38,12,12,0,3900,3492,408,0.931482056055418,0.626262626262626,1.7647190133378,816,398,418,2,1.1,99.69,8.6,0,0,0,0,0,0,9.60888113209711e-05,0.00133133167634954,0.00133133167634954
8.7,"eps_greedy_SVM","SVM",77,39,0,0,0,3912,3504,408,0.931573987887964,0.626262626262626,1.76309553678459,816,398,418,0,1.1,100,8.6,0,0,0,0,0,0,0,0,0
8.7,"eps_greedy_SVM","SVM",78,0,3812,3421,391,100,90,10,0.912970985220989,0.565853658536585,1.76499597963013,24,10,14,0,1.4,2.56,9,0,0,0,0,0,0,0.845574334713019,544.426383824792,87.6373931145661
8.7,"eps_greedy_SVM","SVM",78,1,3712,3387,325,200,124,76,0.916766725634135,0.570731707317073,1.75948086820318,83,41,42,59,1,5.11,1.6,0,0,0,0,0,0,0.606807687824428,269.727424792158,71.6055562366059
8.7,"eps_greedy_SVM","SVM",78,2,3612,3362,250,300,149,151,0.907748882171868,0.570731707317073,1.75879509947173,139,75,64,56,0.9,7.67,1,0,0,0,0,0,0,0.444081809183629,163.084219304932,61.0573249517356
8.7,"eps_greedy_SVM","SVM",78,3,3512,3311,201,400,200,200,0.910201835884728,0.609756097560976,1.74838970489152,225,114,111,86,1,10.22,1,0,0,0,0,0,0,0.218028455882514,72.6567089319792,39.9751541536997
8.7,"eps_greedy_SVM","SVM",78,4,3412,3247,165,500,264,236,0.884681923918058,0.604878048780488,1.65900329840465,313,157,156,88,1,12.78,1.1,0,0,0,0,0,0,0.182578453320018,74.2629415898812,27.3539156927848
8.7,"eps_greedy_SVM","SVM",78,5,3312,3166,146,600,345,255,0.889270242788104,0.624390243902439,1.69411447932327,357,174,183,44,1.1,15.34,1.4,0,0,0,0,0,0,0.0756503142238567,40.6979715831532,11.7050135751451
8.7,"eps_greedy_SVM","SVM",78,6,3212,3096,116,700,415,285,0.905751417308591,0.624390243902439,1.72044786501223,417,200,217,60,1.1,17.89,1.5,0,0,0,0,0,0,0.0603928373587395,39.3185021466098,10.2593312457161
8.7,"eps_greedy_SVM","SVM",78,7,3112,3016,96,800,495,305,0.903196779540625,0.634146341463415,1.6781026815793,460,219,241,43,1.1,20.45,1.6,0,0,0,0,0,0,0.0489743734051371,39.3641160854073,6.34678869114175
8.7,"eps_greedy_SVM","SVM",78,8,3012,2935,77,900,576,324,0.898235154824431,0.648780487804878,1.65326739350343,515,245,270,55,1.1,23.01,1.8,0,0,0,0,0,0,0.0601444377322542,89.9292610440169,9.82460928811589
8.7,"eps_greedy_SVM","SVM",78,9,2912,2852,60,1000,659,341,0.91045395662411,0.634146341463415,1.69976483235907,546,262,284,31,1.1,25.56,1.9,0,0,0,0,0,0,0.0572376561681697,88.5162100406594,6.77992319066218
8.7,"eps_greedy_SVM","SVM",78,10,2812,2764,48,1100,747,353,0.925930826983904,0.639024390243902,1.71886657101865,584,280,304,38,1.1,28.12,2.1,0,0,0,0,0,0,0.057189525058283,82.1949586978748,6.5234897549002
8.7,"eps_greedy_SVM","SVM",78,11,2712,2673,39,1200,838,362,0.933537630065058,0.64390243902439,1.72763629842181,619,299,320,35,1.1,30.67,2.3,0,0,0,0,0,0,0.0569432035108998,73.0035262848154,6.38291987891729
8.7,"eps_greedy_SVM","SVM",78,12,2612,2576,36,1300,935,365,0.936824950202673,0.639024390243902,1.75394548063128,633,304,329,14,1.1,33.23,2.6,0,0,0,0,0,0,0.0527179937153838,60.9610064575765,5.83616330995144
8.7,"eps_greedy_SVM","SVM",78,13,2512,2480,32,1400,1031,369,0.941651460489486,0.634146341463415,1.76823450436339,645,310,335,12,1.1,35.79,2.8,0,0,0,0,0,0,0.0484503683407436,47.369837528185,5.35719693177305
8.7,"eps_greedy_SVM","SVM",78,14,2412,2385,27,1500,1126,374,0.94392890473737,0.634146341463415,1.78574177668382,662,316,346,17,1.1,38.34,3,0,0,0,0,0,0,0.0542001290336188,49.8993770989595,6.23067744584752
8.7,"eps_greedy_SVM","SVM",78,15,2312,2292,20,1600,1219,381,0.944767449958915,0.639024390243902,1.79397100146117,680,326,354,18,1.1,40.9,3.2,0,0,0,0,0,0,0.0469712457196817,43.637925343426,5.81033921089173
8.7,"eps_greedy_SVM","SVM",78,16,2212,2196,16,1700,1315,385,0.945424913986439,0.64390243902439,1.7786199019015,690,331,359,10,1.1,43.46,3.4,0,0,0,0,0,0,0.0330615091967303,36.4286043080832,4.11922632291189
8.7,"eps_greedy_SVM","SVM",78,17,2112,2096,16,1800,1415,385,0.945316265270026,0.64390243902439,1.78517702596381,689,331,358,-1,1.1,46.01,3.7,0,0,0,0,0,0,0.0278176453060367,28.4301991833093,2.81825722537333
8.7,"eps_greedy_SVM","SVM",78,18,2012,1996,16,1900,1515,385,0.942700338482544,0.639024390243902,1.7873815762951,719,349,370,30,1.1,48.57,3.9,0,0,0,0,0,0,0.0205732447971447,13.7830311233267,2.8025580854215
8.7,"eps_greedy_SVM","SVM",78,19,1912,1897,15,2000,1614,386,0.94283684584419,0.639024390243902,1.7890243902439,722,350,372,3,1.1,51.12,4.2,0,0,0,0,0,0,0.0129693443683707,9.90271847763323,1.52265194418845
8.7,"eps_greedy_SVM","SVM",78,20,1812,1800,12,2100,1711,389,0.942733768856824,0.634146341463415,1.79067022684946,729,354,375,7,1.1,53.68,4.4,0,0,0,0,0,0,0.0121924023784897,10.7105612328726,1.38912649418558
8.7,"eps_greedy_SVM","SVM",78,21,1712,1702,10,2200,1809,391,0.942717053669684,0.634146341463415,1.79231909446166,735,359,376,6,1,56.24,4.6,0,0,0,0,0,0,0.0101024449764906,8.97837953635988,1.08016462041583
8.7,"eps_greedy_SVM","SVM",78,22,1612,1603,9,2300,1908,392,0.941878508448137,0.634146341463415,1.79397100146117,748,363,385,13,1.1,58.79,4.9,0,0,0,0,0,0,0.00864752587088847,7.23722245741785,0.901082934346478
8.7,"eps_greedy_SVM","SVM",78,23,1512,1504,8,2400,2007,393,0.941530275382713,0.629268292682927,1.79231909446166,753,367,386,5,1.1,61.35,5.1,0,0,0,0,0,0,0.00749358124753049,5.84189757968068,0.855245844565077
8.7,"eps_greedy_SVM","SVM",78,24,1412,1405,7,2500,2106,394,0.941967656112887,0.629268292682927,1.79397100146117,759,370,389,6,1.1,63.91,5.3,0,0,0,0,0,0,0.00656222064875387,4.85778481584016,0.687333805347467
8.7,"eps_greedy_SVM","SVM",78,25,1312,1306,6,2600,2205,395,0.941911938822419,0.634146341463415,1.78410498312133,765,372,393,6,1.1,66.46,5.6,0,0,0,0,0,0,0.00587646526767657,3.87623001642444,0.614575456242491
8.7,"eps_greedy_SVM","SVM",78,26,1212,1206,6,2700,2305,395,0.941605493724844,0.639024390243902,1.7873815762951,767,373,394,2,1.1,69.02,5.8,0,0,0,0,0,0,0.00549187992749746,3.34104775959335,0.582529441642924
8.7,"eps_greedy_SVM","SVM",78,27,1112,1107,5,2800,2404,396,0.941733643492921,0.629268292682927,1.79067022684946,769,374,395,2,1.1,71.57,6.1,0,0,0,0,0,0,0.00507101671251707,2.75340351671218,0.527488916037716
8.7,"eps_greedy_SVM","SVM",78,28,1012,1007,5,2900,2504,396,0.94152888245045,0.624390243902439,1.7890243902439,769,376,393,0,1,74.13,6.3,0,0,0,0,0,0,0.00412779084374933,2.02056832560168,0.443839410596087
8.7,"eps_greedy_SVM","SVM",78,29,912,907,5,3000,2604,396,0.941555348163423,0.624390243902439,1.7873815762951,768,376,392,-1,1,76.69,6.6,0,0,0,0,0,0,0.00342601520848867,1.4610290219906,0.365587173437073
8.7,"eps_greedy_SVM","SVM",78,30,812,807,5,3100,2704,396,0.941427198395345,0.629268292682927,1.7873815762951,772,378,394,4,1,79.24,6.8,0,0,0,0,0,0,0.00278939845754373,1.02004061762642,0.301596283010646
8.7,"eps_greedy_SVM","SVM",78,31,712,708,4,3200,2803,397,0.941615244250676,0.629268292682927,1.79231909446166,780,380,400,8,1.1,81.8,7.1,0,0,0,0,0,0,0.0023482389139956,0.810276963850038,0.268093862290142
8.7,"eps_greedy_SVM","SVM",78,32,612,609,3,3300,2902,398,0.941838113412549,0.624390243902439,1.79231909446166,783,382,401,3,1,84.36,7.3,0,0,0,0,0,0,0.00176771206620105,0.564117844733702,0.207036740414437
8.7,"eps_greedy_SVM","SVM",78,33,512,509,3,3400,3002,398,0.941996907690383,0.629268292682927,1.7890243902439,784,382,402,1,1.1,86.91,7.5,0,0,0,0,0,0,0.00128348291655944,0.385759988326859,0.157138573438701
8.7,"eps_greedy_SVM","SVM",78,34,412,409,3,3500,3102,398,0.94228106587177,0.624390243902439,1.7890243902439,783,382,401,-1,1,89.47,7.8,0,0,0,0,0,0,0.000721363747004173,0.20795217827659,0.0943018579624466
8.7,"eps_greedy_SVM","SVM",78,35,312,312,0,3600,3199,401,0.94264183532755,0.629268292682927,1.78410498312133,801,391,410,18,1,92.02,8,0,0,0,0,0,0,0.00107166206456497,0.278071512311259,0.14357562473329
8.7,"eps_greedy_SVM","SVM",78,36,212,212,0,3700,3299,401,0.942559652324109,0.624390243902439,1.7890243902439,802,391,411,1,1.1,94.58,8.2,0,0,0,0,0,0,0.000491105089359699,0.104024096106879,0.0645937146007995
8.7,"eps_greedy_SVM","SVM",78,37,112,112,0,3800,3399,401,0.942448217743172,0.624390243902439,1.7890243902439,806,393,413,4,1.1,97.14,8.5,0,0,0,0,0,0,0.000229879125168091,0.0370988900878082,0.0346671351811836
8.7,"eps_greedy_SVM","SVM",78,38,12,12,0,3900,3499,401,0.942400858046274,0.624390243902439,1.78574177668382,806,393,413,0,1.1,99.69,8.7,0,0,0,0,0,0,0.000152905640318267,0.0020946882500618,0.0020946882500618
8.7,"eps_greedy_SVM","SVM",78,39,0,0,0,3912,3511,401,0.942320067975095,0.624390243902439,1.7890243902439,807,393,414,1,1.1,100,8.8,0,0,0,0,0,0,0,0,0
8.7,"eps_greedy_SVM","SVM",79,0,3812,3413,399,100,93,7,0.851551822323469,0.51,1.67657142857143,35,7,28,0,4,2.56,13.3,0,0,0,0,0,0,0.0773896274652111,271.728453024796,7.99710967937972
8.7,"eps_greedy_SVM","SVM",79,1,3712,3352,360,200,154,46,0.902945615034186,0.57,1.73487132352941,94,44,50,59,1.1,5.11,3.3,0,0,0,0,0,0,0.534545002718753,434.919466365072,59.9486063409925
8.7,"eps_greedy_SVM","SVM",79,2,3612,3330,282,300,176,124,0.911156036446485,0.6,1.73646734130635,153,75,78,59,1,7.67,1.4,0,0,0,0,0,0,0.601490798765411,349.691345646513,71.7810078332472
8.7,"eps_greedy_SVM","SVM",79,3,3512,3291,221,400,215,185,0.904877562642379,0.615,1.70633608815427,218,111,107,65,1,10.22,1.2,0,0,0,0,0,0,0.396930312498852,211.920407005665,53.1566700805951
8.7,"eps_greedy_SVM","SVM",79,4,3412,3243,169,500,263,237,0.891576025056941,0.64,1.65990825688073,316,160,156,98,1,12.78,1.1,0,0,0,0,0,0,0.346455775728432,182.573731511421,46.9107495959684
8.7,"eps_greedy_SVM","SVM",79,5,3312,3174,138,600,332,268,0.872206719817772,0.63,1.61198895027624,392,194,198,76,1,15.34,1.2,0,0,0,0,0,0,0.244399258337463,187.574156746529,33.0356091137459
8.7,"eps_greedy_SVM","SVM",79,6,3212,3094,118,700,412,288,0.897569760820046,0.675,1.70204419889503,441,218,223,49,1,17.89,1.4,0,0,0,0,0,0,0.1006678881054,81.8019564238214,14.0127463818068
8.7,"eps_greedy_SVM","SVM",79,7,3112,3012,100,800,494,306,0.903866742596814,0.675,1.70790441176471,479,233,246,38,1.1,20.45,1.6,0,0,0,0,0,0,0.0661995178203542,70.6976079282004,8.46184085831922
8.7,"eps_greedy_SVM","SVM",79,8,3012,2929,83,900,577,323,0.908166287015941,0.68,1.65854377880184,515,249,266,36,1.1,23.01,1.8,0,0,0,0,0,0,0.0681117680393203,101.422037123349,9.49064729888392
8.7,"eps_greedy_SVM","SVM",79,9,2912,2848,64,1000,658,342,0.917975512528483,0.68,1.71104972375691,573,276,297,58,1.1,25.56,1.9,0,0,0,0,0,0,0.0784034681151747,99.0413723357111,9.49749823831879
8.7,"eps_greedy_SVM","SVM",79,10,2812,2754,58,1100,752,348,0.923274487471526,0.67,1.72747010119595,596,286,310,23,1.1,28.12,2.2,0,0,0,0,0,0,0.058185549774621,66.9261507899691,6.36804653848032
8.7,"eps_greedy_SVM","SVM",79,11,2712,2667,45,1200,839,361,0.928157744874715,0.68,1.75446182152714,637,302,335,41,1.1,30.67,2.3,0,0,0,0,0,0,0.0764359518808932,76.0151487009908,8.65681777153278
8.7,"eps_greedy_SVM","SVM",79,12,2612,2575,37,1300,931,369,0.930956719817786,0.68,1.75284926470588,655,316,339,18,1.1,33.23,2.5,0,0,0,0,0,0,0.0644312495819819,63.428430058766,7.28685270596214
8.7,"eps_greedy_SVM","SVM",79,13,2512,2482,30,1400,1024,376,0.931956150341707,0.68,1.75446182152714,672,321,351,17,1.1,35.79,2.7,0,0,0,0,0,0,0.0599645388087421,54.7881093429721,6.63523575612665
8.7,"eps_greedy_SVM","SVM",79,14,2412,2388,24,1500,1118,382,0.93149772209569,0.67,1.75446182152714,690,328,362,18,1.1,38.34,2.9,0,0,0,0,0,0,0.0569929078336469,53.0490120484255,6.54848510728611
8.7,"eps_greedy_SVM","SVM",79,15,2312,2294,18,1600,1212,388,0.931625854214138,0.675,1.74546458141674,706,334,372,16,1.1,40.9,3.1,0,0,0,0,0,0,0.048387480451412,50.3241406853702,5.73456652798252
8.7,"eps_greedy_SVM","SVM",79,16,2212,2196,16,1700,1310,390,0.931657175398649,0.675,1.74868202764977,710,337,373,4,1.1,43.46,3.4,0,0,0,0,0,0,0.0372204525351479,41.8042696663544,4.23436604381544
8.7,"eps_greedy_SVM","SVM",79,17,2112,2098,14,1800,1408,392,0.932158314350815,0.67,1.75769585253456,717,343,374,7,1.1,46.01,3.6,0,0,0,0,0,0,0.0267890817849001,30.760730227412,2.95304892731775
8.7,"eps_greedy_SVM","SVM",79,18,2012,2001,11,1900,1505,395,0.9324103075171,0.67,1.75284926470588,723,346,377,6,1.1,48.57,3.8,0,0,0,0,0,0,0.0271405643711679,32.1206714220466,2.91879680544935
8.7,"eps_greedy_SVM","SVM",79,19,1912,1902,10,2000,1604,396,0.93238610478362,0.675,1.76345906163753,728,351,377,5,1.1,51.12,4.1,0,0,0,0,0,0,0.020444023690258,22.2977497527441,2.22472232603181
8.7,"eps_greedy_SVM","SVM",79,20,1812,1803,9,2100,1703,397,0.931986047836011,0.675,1.76508287292818,731,354,377,3,1.1,53.68,4.3,0,0,0,0,0,0,0.0196792278951226,20.652315647685,2.06790820300718
8.7,"eps_greedy_SVM","SVM",79,21,1712,1704,8,2200,1802,398,0.931398063781341,0.675,1.76670967741935,742,358,384,11,1.1,56.24,4.5,0,0,0,0,0,0,0.0157436914386482,14.9068956722648,1.61011645811466
8.7,"eps_greedy_SVM","SVM",79,22,1612,1605,7,2300,1901,399,0.929095956719836,0.665,1.7560773480663,763,368,395,21,1.1,58.79,4.8,0,0,0,0,0,0,0.0119866203378365,8.5747000581467,1.49007251675527
8.7,"eps_greedy_SVM","SVM",79,23,1512,1506,6,2400,2000,400,0.929424829157194,0.665,1.75446182152714,766,370,396,3,1.1,61.35,5,0,0,0,0,0,0,0.008783761939819,7.19693912194263,1.0245790252654
8.7,"eps_greedy_SVM","SVM",79,24,1412,1407,5,2500,2099,401,0.929538724373589,0.67,1.75123966942149,770,369,401,4,1.1,63.91,5.2,0,0,0,0,0,0,0.00817524750508256,6.38435143204107,0.839796929327964
8.7,"eps_greedy_SVM","SVM",79,25,1312,1308,4,2600,2198,402,0.929441913439652,0.665,1.75446182152714,777,380,397,7,1,66.46,5.5,0,0,0,0,0,0,0.0059283393036628,4.1942928897,0.686514440622932
8.7,"eps_greedy_SVM","SVM",79,26,1212,1209,3,2700,2297,403,0.929766514806398,0.665,1.75769585253456,781,382,399,4,1,69.02,5.7,0,0,0,0,0,0,0.00538074187345654,3.62338042686097,0.552265085075615
8.7,"eps_greedy_SVM","SVM",79,27,1112,1109,3,2800,2397,403,0.929891799544438,0.665,1.75769585253456,790,385,405,9,1.1,71.57,5.9,0,0,0,0,0,0,0.00405114736314803,2.51536593343868,0.451641020784772
8.7,"eps_greedy_SVM","SVM",79,28,1012,1010,2,2900,2496,404,0.93040717539865,0.655,1.75446182152714,793,386,407,3,1.1,74.13,6.2,0,0,0,0,0,0,0.00359670214194148,1.93286977558849,0.367953438725901
8.7,"eps_greedy_SVM","SVM",79,29,912,910,2,3000,2596,404,0.929823462414594,0.65,1.75769585253456,801,389,412,8,1.1,76.69,6.4,0,0,0,0,0,0,0.00306300495089071,1.41113134147761,0.32898976752712
8.7,"eps_greedy_SVM","SVM",79,30,812,810,2,3100,2696,404,0.929743735763113,0.65,1.7560773480663,802,389,413,1,1.1,79.24,6.7,0,0,0,0,0,0,0.00284740326675312,1.05988059691399,0.293971312281404
8.7,"eps_greedy_SVM","SVM",79,31,712,710,2,3200,2796,404,0.929746583143524,0.65,1.75769585253456,805,392,413,3,1.1,81.8,6.9,0,0,0,0,0,0,0.00206696048593102,0.640630254140136,0.229613542521547
8.7,"eps_greedy_SVM","SVM",79,32,612,610,2,3300,2896,404,0.929757972665163,0.655,1.75769585253456,805,392,413,0,1.1,84.36,7.2,0,0,0,0,0,0,0.00140333972321832,0.433856740619295,0.181492842588425
8.7,"eps_greedy_SVM","SVM",79,33,512,510,2,3400,2996,404,0.930066913439651,0.65,1.7560773480663,806,392,414,1,1.1,86.91,7.4,0,0,0,0,0,0,0.000745360633437971,0.229463614109751,0.10248354597107
8.7,"eps_greedy_SVM","SVM",79,34,412,412,0,3500,3094,406,0.930933940774503,0.655,1.76345906163753,813,395,418,7,1.1,89.47,7.6,0,0,0,0,0,0,0.000986950613078672,0.297012019314772,0.124993762813389
8.7,"eps_greedy_SVM","SVM",79,35,312,312,0,3600,3194,406,0.931469248291587,0.655,1.76508287292818,817,397,420,4,1.1,92.02,7.9,0,0,0,0,0,0,0.000472327901822045,0.117233570650171,0.0588807548344752
8.7,"eps_greedy_SVM","SVM",79,36,212,212,0,3700,3294,406,0.93177961275628,0.655,1.76345906163753,821,398,423,4,1.1,94.58,8.1,0,0,0,0,0,0,0.000255271652317495,0.0552832008621284,0.0351265783436719
8.7,"eps_greedy_SVM","SVM",79,37,112,112,0,3800,3394,406,0.931903473804116,0.65,1.76508287292818,825,400,425,4,1.1,97.14,8.4,0,0,0,0,0,0,9.80260027967943e-05,0.0160514406253641,0.0150650129496897
8.7,"eps_greedy_SVM","SVM",79,38,12,12,0,3900,3494,406,0.932246583143523,0.65,1.76670967741935,824,400,424,-1,1.1,99.69,8.6,0,0,0,0,0,0,6.39608390264488e-05,0.000997408315485952,0.000997408315485952
8.7,"eps_greedy_SVM","SVM",79,39,0,0,0,3912,3506,406,0.932248006833728,0.65,1.76508287292818,826,400,426,2,1.1,100,8.6,0,0,0,0,0,0,0,0,0
8.7,"eps_greedy_SVM","SVM",80,0,3812,3440,372,100,88,12,0.903480470089481,0.572072072072072,1.71052371052371,28,12,16,0,1.3,2.56,7.3,0,0,0,0,0,0,0.540043118208197,446.149974141468,61.9748589170459
8.7,"eps_greedy_SVM","SVM",80,1,3712,3392,320,200,136,64,0.894962436484931,0.63963963963964,1.67283596961016,120,59,61,92,1,5.11,2.1,0,0,0,0,0,0,0.63997097394762,419.512787143488,73.1078293770454
8.7,"eps_greedy_SVM","SVM",80,2,3612,3362,250,300,166,134,0.921619283643507,0.68018018018018,1.76053954506993,182,94,88,62,0.9,7.67,1.2,0,0,0,0,0,0,0.492891740214773,282.879653388194,64.080823686997
8.7,"eps_greedy_SVM","SVM",80,3,3512,3329,183,400,199,201,0.90178673483172,0.666666666666667,1.68441971383148,252,130,122,70,0.9,10.22,1,0,0,0,0,0,0,0.410951419482283,270.539992710407,55.5666838636007
8.7,"eps_greedy_SVM","SVM",80,4,3412,3280,132,500,248,252,0.857398921412763,0.657657657657658,1.59016475038574,339,171,168,87,1,12.78,1,0,0,0,0,0,0,0.371880422471545,404.125787561761,44.8334365464379
8.7,"eps_greedy_SVM","SVM",80,5,3312,3202,110,600,326,274,0.905747009985765,0.68018018018018,1.66822337042925,416,206,210,77,1,15.34,1.2,0,0,0,0,0,0,0.133005571153775,154.372669942792,20.9397076075108
8.7,"eps_greedy_SVM","SVM",80,6,3212,3124,88,700,404,296,0.882203570352357,0.68018018018018,1.59016475038574,479,233,246,63,1.1,17.89,1.4,0,0,0,0,0,0,0.107809675593227,171.921646373396,14.0531165336953
8.7,"eps_greedy_SVM","SVM",80,7,3112,3046,66,800,482,318,0.882591934495057,0.684684684684685,1.59163034001744,544,258,286,65,1.1,20.45,1.5,0,0,0,0,0,0,0.126528929302972,203.072714994526,15.7421350544277
8.7,"eps_greedy_SVM","SVM",80,8,3012,2949,63,900,579,321,0.898773340814861,0.693693693693694,1.65354683109973,560,269,291,16,1.1,23.01,1.8,0,0,0,0,0,0,0.0776837523011641,108.985321318037,9.29568646671489
8.7,"eps_greedy_SVM","SVM",80,9,2912,2863,49,1000,665,335,0.915141785383989,0.689189189189189,1.69096369096369,592,285,307,32,1.1,25.56,2,0,0,0,0,0,0,0.065946140167393,101.159150289124,7.50502664403566
8.7,"eps_greedy_SVM","SVM",80,10,2812,2769,43,1100,759,341,0.923794902168603,0.684684684684685,1.70871422893482,614,293,321,22,1.1,28.12,2.2,0,0,0,0,0,0,0.0616660784802648,88.257984279637,6.82736064061255
8.7,"eps_greedy_SVM","SVM",80,11,2712,2675,37,1200,853,347,0.925969221816982,0.689189189189189,1.69905442632715,638,302,336,24,1.1,30.67,2.5,0,0,0,0,0,0,0.058666846223352,80.5108610035506,6.25508083581436
8.7,"eps_greedy_SVM","SVM",80,12,2612,2577,35,1300,951,349,0.928324085331012,0.693693693693694,1.70871422893482,650,309,341,12,1.1,33.23,2.7,0,0,0,0,0,0,0.049139439142548,63.2474372466724,5.22765842580227
8.7,"eps_greedy_SVM","SVM",80,13,2512,2481,31,1400,1047,353,0.930021717218954,0.689189189189189,1.71839180486835,654,314,340,4,1.1,35.79,3,0,0,0,0,0,0,0.0465589280510229,59.9676687235069,5.05561182303747
8.7,"eps_greedy_SVM","SVM",80,14,2412,2383,29,1500,1145,355,0.932448018953215,0.689189189189189,1.72967991032507,658,316,342,4,1.1,38.34,3.2,0,0,0,0,0,0,0.0375686291759237,47.6072049612838,4.04289276451708
8.7,"eps_greedy_SVM","SVM",80,15,2312,2286,26,1600,1242,358,0.932975362906175,0.684684684684685,1.74592103624362,674,319,355,16,1.1,40.9,3.5,0,0,0,0,0,0,0.0383129059570102,46.9183621101914,4.48624329460798
8.7,"eps_greedy_SVM","SVM",80,16,2212,2193,19,1700,1335,365,0.937329197709834,0.689189189189189,1.75242645960878,691,327,364,17,1.1,43.46,3.7,0,0,0,0,0,0,0.0417180266145326,44.1047430151776,4.75280508705934
8.7,"eps_greedy_SVM","SVM",80,17,2112,2095,17,1800,1433,367,0.938459220466156,0.689189189189189,1.75404159920289,696,330,366,5,1.1,46.01,3.9,0,0,0,0,0,0,0.0347952841214288,38.9263852246202,3.85036069989672
8.7,"eps_greedy_SVM","SVM",80,18,2012,1999,13,1900,1529,371,0.939080083543765,0.689189189189189,1.75404159920289,711,335,376,15,1.1,48.57,4.1,0,0,0,0,0,0,0.0334376577465476,34.24613508812,3.48334149250443
8.7,"eps_greedy_SVM","SVM",80,19,1912,1899,13,2000,1629,371,0.937877323690476,0.675675675675676,1.77513115691589,729,353,376,18,1.1,51.12,4.4,0,0,0,0,0,0,0.0223540684143964,14.9104569274303,2.86914426868203
8.7,"eps_greedy_SVM","SVM",80,20,1812,1800,12,2100,1728,372,0.937840955141996,0.68018018018018,1.77349960254372,729,352,377,0,1.1,53.68,4.6,0,0,0,0,0,0,0.0146777936221419,11.7123720408008,1.82686389701699
8.7,"eps_greedy_SVM","SVM",80,21,1712,1703,9,2200,1825,375,0.937464280889887,0.68018018018018,1.77840328808071,741,357,384,12,1.1,56.24,4.9,0,0,0,0,0,0,0.0123490853706487,10.8743456983818,1.38793378496578
8.7,"eps_greedy_SVM","SVM",80,22,1612,1603,9,2300,1925,375,0.937046042582374,0.675675675675676,1.77840328808071,740,357,383,-1,1.1,58.79,5.1,0,0,0,0,0,0,0.0114575802995371,9.56629518900251,1.17461371441526
8.7,"eps_greedy_SVM","SVM",80,23,1512,1505,7,2400,2023,377,0.937340887600402,0.671171171171171,1.77676571599224,756,367,389,16,1.1,61.35,5.4,0,0,0,0,0,0,0.00826417157805655,6.40374865697581,0.948960868125418
8.7,"eps_greedy_SVM","SVM",80,24,1412,1407,5,2500,2121,379,0.937557800014545,0.671171171171171,1.77676571599224,766,370,396,10,1.1,63.91,5.6,0,0,0,0,0,0,0.00818038334728479,6.03723944744238,0.852701826141876
8.7,"eps_greedy_SVM","SVM",80,25,1312,1307,5,2600,2221,379,0.938434541808247,0.671171171171171,1.77349960254372,763,372,391,-3,1.1,66.46,5.9,0,0,0,0,0,0,0.00567184209404819,3.83806615340876,0.638547017693378
8.7,"eps_greedy_SVM","SVM",80,26,1212,1207,5,2700,2321,379,0.938412460903812,0.671171171171171,1.77840328808071,764,372,392,1,1.1,69.02,6.1,0,0,0,0,0,0,0.00525091701700149,3.19841317005914,0.540492313986528
8.7,"eps_greedy_SVM","SVM",80,27,1112,1107,5,2800,2421,379,0.939090474557614,0.666666666666667,1.77187104459832,770,374,396,6,1.1,71.57,6.4,0,0,0,0,0,0,0.00473378599302717,2.51346919100471,0.522435408587269
8.7,"eps_greedy_SVM","SVM",80,28,1012,1008,4,2900,2520,380,0.938893045294439,0.671171171171171,1.77349960254372,770,375,395,0,1.1,74.13,6.6,0,0,0,0,0,0,0.00383291625610901,1.85201411263232,0.40076163761808
8.7,"eps_greedy_SVM","SVM",80,29,912,910,2,3000,2618,382,0.938142294543684,0.671171171171171,1.77840328808071,780,380,400,10,1.1,76.69,6.9,0,0,0,0,0,0,0.0034428248886116,1.61582734914261,0.383534802337435
8.7,"eps_greedy_SVM","SVM",80,30,812,810,2,3100,2718,382,0.938183858599089,0.671171171171171,1.77840328808071,782,380,402,2,1.1,79.24,7.1,0,0,0,0,0,0,0.00304412204572312,1.22716940162715,0.324046664257915
8.7,"eps_greedy_SVM","SVM",80,31,712,710,2,3200,2818,382,0.938251400189124,0.666666666666667,1.77187104459832,783,380,403,1,1.1,81.8,7.4,0,0,0,0,0,0,0.0019768507912703,0.678534240118707,0.219975913886147
8.7,"eps_greedy_SVM","SVM",80,32,612,610,2,3300,2918,382,0.938381287862264,0.671171171171171,1.77840328808071,782,380,402,-1,1.1,84.36,7.6,0,0,0,0,0,0,0.00156972606575124,0.508353017926377,0.185879893879533
8.7,"eps_greedy_SVM","SVM",80,33,512,510,2,3400,3018,382,0.938389081122653,0.666666666666667,1.77349960254372,786,381,405,4,1.1,86.91,7.9,0,0,0,0,0,0,0.00108525020445702,0.335171464863612,0.135007791935415
8.7,"eps_greedy_SVM","SVM",80,34,412,412,0,3500,3116,384,0.93847740474038,0.666666666666667,1.77513115691589,792,383,409,6,1.1,89.47,8.1,0,0,0,0,0,0,0.00160252459616095,0.46540628220172,0.215314598405897
8.7,"eps_greedy_SVM","SVM",80,35,312,312,0,3600,3216,384,0.939054106009126,0.666666666666667,1.77349960254372,793,383,410,1,1.1,92.02,8.4,0,0,0,0,0,0,0.00067212420309336,0.163425507519609,0.0862102671546809
8.7,"eps_greedy_SVM","SVM",80,36,212,212,0,3700,3316,384,0.939534690399746,0.666666666666667,1.77349960254372,795,384,411,2,1.1,94.58,8.6,0,0,0,0,0,0,0.000343681061072197,0.073808973493154,0.0478008642684227
8.7,"eps_greedy_SVM","SVM",80,37,112,112,0,3800,3416,384,0.940080218626933,0.666666666666667,1.77840328808071,793,384,409,-2,1.1,97.14,8.9,0,0,0,0,0,0,0.000143205077699616,0.02457834741772,0.0230706436804616
8.7,"eps_greedy_SVM","SVM",80,38,12,12,0,3900,3516,384,0.940472479399816,0.666666666666667,1.77349960254372,793,384,409,0,1.1,99.69,9.2,0,0,0,0,0,0,7.53788251395424e-05,0.00117100069288038,0.00117100069288038
8.7,"eps_greedy_SVM","SVM",80,39,0,0,0,3912,3528,384,0.940543917620043,0.666666666666667,1.77349960254372,793,384,409,0,1.1,100,9.2,0,0,0,0,0,0,0,0,0
8.7,"eps_greedy_SVM","SVM",81,0,3812,3404,408,100,91,9,0.827714447408839,0.455026455026455,1.62153463535952,23,9,14,0,1.6,2.56,10.1,0,0,0,0,0,0,0.246585973372929,384.422073999427,27.1936072801352
8.7,"eps_greedy_SVM","SVM",81,1,3712,3365,347,200,130,70,0.855404640633837,0.53968253968254,1.63308577253531,94,46,48,71,1,5.11,1.9,0,0,0,0,0,0,0.794078948041593,317.852764214364,88.1402054823829
8.7,"eps_greedy_SVM","SVM",81,2,3612,3341,271,300,154,146,0.847453160978902,0.560846560846561,1.63910082142126,139,70,69,45,1,7.67,1.1,0,0,0,0,0,0,0.554233045576315,246.212552222924,68.7353014820028
8.7,"eps_greedy_SVM","SVM",81,3,3512,3297,215,400,198,202,0.831373535391639,0.597883597883598,1.58192288579029,232,118,114,93,1,10.22,1,0,0,0,0,0,0,0.406475780376466,197.073848948104,54.6169871470464
8.7,"eps_greedy_SVM","SVM",81,4,3412,3252,160,500,243,257,0.860520476819283,0.608465608465608,1.63759290898205,314,161,153,82,1,12.78,0.9,0,0,0,0,0,0,0.271791279169951,124.302343556656,41.6680709443554
8.7,"eps_greedy_SVM","SVM",81,5,3312,3182,130,600,313,287,0.840964418213983,0.608465608465608,1.55476556213883,392,198,194,78,1,15.34,1.1,0,0,0,0,0,0,0.142885893730688,89.1436173152191,21.5265588410335
8.7,"eps_greedy_SVM","SVM",81,6,3212,3113,99,700,382,318,0.834418782919051,0.613756613756614,1.53568868407578,471,230,241,79,1,17.89,1.2,0,0,0,0,0,0,0.107024228768954,89.078616105677,14.2070857390561
8.7,"eps_greedy_SVM","SVM",81,7,3112,3031,81,800,464,336,0.834574488790659,0.619047619047619,1.52334224091354,513,247,266,42,1.1,20.45,1.4,0,0,0,0,0,0,0.0729765152927945,79.6775189755182,9.30260696122268
8.7,"eps_greedy_SVM","SVM",81,8,3012,2942,70,900,553,347,0.844824127223662,0.619047619047619,1.55190490793067,541,259,282,28,1.1,23.01,1.6,0,0,0,0,0,0,0.060072985817285,65.9824212494795,6.76677275644384
8.7,"eps_greedy_SVM","SVM",81,9,2912,2850,62,1000,645,355,0.847930758796619,0.613756613756614,1.55047852474323,563,270,293,22,1.1,25.56,1.8,0,0,0,0,0,0,0.0531686229319236,67.966188294737,6.13594158341222
8.7,"eps_greedy_SVM","SVM",81,10,2812,2760,52,1100,735,365,0.860942679278833,0.64021164021164,1.57384244020189,587,282,305,24,1.1,28.12,2,0,0,0,0,0,0,0.0508752063264849,69.395022289567,5.69370383650915
8.7,"eps_greedy_SVM","SVM",81,11,2712,2663,49,1200,832,368,0.883027461125936,0.634920634920635,1.58852707749767,618,300,318,31,1.1,30.67,2.3,0,0,0,0,0,0,0.0439430448824926,40.916318513279,5.27932102131295
8.7,"eps_greedy_SVM","SVM",81,12,2612,2572,40,1300,923,377,0.895707009459132,0.634920634920635,1.64711379798776,637,311,326,19,1,33.23,2.4,0,0,0,0,0,0,0.0336844686276806,38.7093798406873,3.87279575277525
8.7,"eps_greedy_SVM","SVM",81,13,2512,2478,34,1400,1017,383,0.910142740363439,0.634920634920635,1.68830370858021,651,319,332,14,1,35.79,2.7,0,0,0,0,0,0,0.0387745496462265,48.2284493796503,4.48920788911017
8.7,"eps_greedy_SVM","SVM",81,14,2412,2385,27,1500,1110,390,0.921143959061324,0.624338624338624,1.75184357705057,685,330,355,34,1.1,38.34,2.8,0,0,0,0,0,0,0.0609846123208901,50.9325544558034,7.21884438326399
8.7,"eps_greedy_SVM","SVM",81,15,2312,2290,22,1600,1205,395,0.922757910307421,0.624338624338624,1.76461122083242,701,338,363,16,1.1,40.9,3.1,0,0,0,0,0,0,0.0496385372165738,40.6442401435251,5.59117805471601
8.7,"eps_greedy_SVM","SVM",81,16,2212,2192,20,1700,1303,397,0.923284914795942,0.624338624338624,1.77088535506199,709,342,367,8,1.1,43.46,3.3,0,0,0,0,0,0,0.040066701818004,31.0877019878874,4.43194965650211
8.7,"eps_greedy_SVM","SVM",81,17,2112,2094,18,1800,1401,399,0.923982596874496,0.624338624338624,1.76925770308123,716,345,371,7,1.1,46.01,3.5,0,0,0,0,0,0,0.0332296607224566,25.862736647797,3.81942625625646
8.7,"eps_greedy_SVM","SVM",81,18,2012,1997,15,1900,1498,402,0.924069432841355,0.624338624338624,1.76136446605628,721,350,371,5,1.1,48.57,3.7,0,0,0,0,0,0,0.029703747027176,23.0692270562652,3.46042821823933
8.7,"eps_greedy_SVM","SVM",81,19,1912,1902,10,2000,1593,407,0.923668190787594,0.608465608465608,1.75507278180089,734,356,378,13,1.1,51.12,3.9,0,0,0,0,0,0,0.0227951473851545,20.4205935506392,2.90846754332451
8.7,"eps_greedy_SVM","SVM",81,20,1812,1804,8,2100,1691,409,0.923404688543335,0.608465608465608,1.75507278180089,742,359,383,8,1.1,53.68,4.1,0,0,0,0,0,0,0.0190234122898093,17.2037586348434,2.11936526284697
8.7,"eps_greedy_SVM","SVM",81,21,1712,1705,7,2200,1790,410,0.92442276539616,0.608465608465608,1.75974556489262,746,362,384,4,1.1,56.24,4.4,0,0,0,0,0,0,0.0154922708526379,13.936009863301,1.63781453368182
8.7,"eps_greedy_SVM","SVM",81,22,1612,1606,6,2300,1889,411,0.924605420360932,0.608465608465608,1.77088535506199,759,371,388,13,1,58.79,4.6,0,0,0,0,0,0,0.0108239412315385,9.02747341501069,1.29247536829426
8.7,"eps_greedy_SVM","SVM",81,23,1512,1507,5,2400,1988,412,0.924738668654905,0.603174603174603,1.76925770308123,761,373,388,2,1,61.35,4.8,0,0,0,0,0,0,0.0100327585941313,7.8781727320017,1.02454696659646
8.7,"eps_greedy_SVM","SVM",81,24,1412,1407,5,2500,2088,412,0.92442276539616,0.608465608465608,1.77088535506199,775,380,395,14,1,63.91,5.1,0,0,0,0,0,0,0.00727931705742007,5.34308432230206,0.919766287189737
8.7,"eps_greedy_SVM","SVM",81,25,1312,1307,5,2600,2188,412,0.924478160754329,0.608465608465608,1.76925770308123,775,379,396,0,1,66.46,5.3,0,0,0,0,0,0,0.00565271389911016,3.99425825411454,0.588126337058887
8.7,"eps_greedy_SVM","SVM",81,26,1212,1207,5,2700,2288,412,0.924731182795693,0.608465608465608,1.76925770308123,780,382,398,5,1,69.02,5.6,0,0,0,0,0,0,0.00474730375321263,3.11114326807953,0.507597869153523
8.7,"eps_greedy_SVM","SVM",81,27,1112,1107,5,2800,2388,412,0.924608414704617,0.608465608465608,1.77088535506199,783,384,399,3,1,71.57,5.8,0,0,0,0,0,0,0.00434466084262816,2.5155934080939,0.448381820344671
8.7,"eps_greedy_SVM","SVM",81,28,1012,1007,5,2900,2488,412,0.924267059524552,0.613756613756614,1.77088535506199,787,384,403,4,1,74.13,6,0,0,0,0,0,0,0.00405087984354181,2.11479966113074,0.423689167865589
8.7,"eps_greedy_SVM","SVM",81,29,912,907,5,3000,2588,412,0.924232624572177,0.613756613756614,1.76925770308123,787,385,402,0,1,76.69,6.3,0,0,0,0,0,0,0.00329293187806723,1.48896227782577,0.346490405247702
8.7,"eps_greedy_SVM","SVM",81,30,812,809,3,3100,2686,414,0.924418273880633,0.608465608465608,1.7725160045602,796,390,406,9,1,79.24,6.5,0,0,0,0,0,0,0.00298213653910162,1.23932629496743,0.322183393612139
8.7,"eps_greedy_SVM","SVM",81,31,712,709,3,3200,2786,414,0.924258076493497,0.608465608465608,1.77088535506199,794,390,404,-2,1,81.8,6.7,0,0,0,0,0,0,0.00260329386435136,0.952719254505883,0.283216269046522
8.7,"eps_greedy_SVM","SVM",81,32,612,609,3,3300,2886,414,0.924264065180867,0.608465608465608,1.77088535506199,792,390,402,-2,1,84.36,7,0,0,0,0,0,0,0.0021608187439108,0.692179767970676,0.241422584305405
8.7,"eps_greedy_SVM","SVM",81,33,512,510,2,3400,2985,415,0.92442276539616,0.608465608465608,1.7725160045602,796,391,405,4,1,86.91,7.2,0,0,0,0,0,0,0.00151180678736981,0.45447898617442,0.185531989610247
8.7,"eps_greedy_SVM","SVM",81,34,412,410,2,3500,3085,415,0.924434742770899,0.608465608465608,1.77088535506199,797,392,405,1,1,89.47,7.4,0,0,0,0,0,0,0.000854575627093223,0.245369663482815,0.111073919682854
8.7,"eps_greedy_SVM","SVM",81,35,312,312,0,3600,3183,417,0.924371861553519,0.603174603174603,1.77088535506199,806,396,410,9,1,92.02,7.6,0,0,0,0,0,0,0.00108635781506434,0.269791565332487,0.136601889058626
8.7,"eps_greedy_SVM","SVM",81,36,212,212,0,3700,3283,417,0.924683273296736,0.603174603174603,1.77387863180714,811,398,413,5,1,94.58,7.9,0,0,0,0,0,0,0.000666163710927423,0.135460577393923,0.0840024996161183
8.7,"eps_greedy_SVM","SVM",81,37,112,112,0,3800,3383,417,0.924886888667302,0.608465608465608,1.78368809889547,819,400,419,8,1,97.14,8.1,0,0,0,0,0,0,0.000301119039802341,0.0486695874919496,0.0454268444347573
8.7,"eps_greedy_SVM","SVM",81,38,12,12,0,3900,3483,417,0.925114458787345,0.608465608465608,1.78368809889547,821,401,420,2,1,99.69,8.4,0,0,0,0,0,0,0.000211977342677939,0.00316896246099145,0.00316896246099145
8.7,"eps_greedy_SVM","SVM",81,39,0,0,0,3912,3495,417,0.925210277785258,0.608465608465608,1.78368809889547,821,401,420,0,1,100,8.4,0,0,0,0,0,0,0,0,0
8.7,"eps_greedy_SVM","SVM",82,0,3812,3424,388,100,93,7,0.88525916973343,0.502369668246445,1.73655555990756,25,7,18,0,2.6,2.56,13.3,0,0,0,0,0,0,0.449898647076956,316.467650285841,56.9392007629919
8.7,"eps_greedy_SVM","SVM",82,1,3712,3369,343,200,148,52,0.91637175952961,0.601895734597156,1.74667201003624,94,46,48,69,1,5.11,2.8,0,0,0,0,0,0,0.715991315668712,366.114465364494,80.0407008708355
8.7,"eps_greedy_SVM","SVM",82,2,3612,3343,269,300,174,126,0.916606689390149,0.606635071090047,1.76209314167091,143,72,71,49,1,7.67,1.4,0,0,0,0,0,0,0.519445544015266,233.22149883406,67.0666810986051
8.7,"eps_greedy_SVM","SVM",82,3,3512,3294,218,400,223,177,0.90699765070138,0.644549763033175,1.73815165876777,216,109,107,73,1,10.22,1.3,0,0,0,0,0,0,0.279896781274816,128.797548256189,42.9004830614924
8.7,"eps_greedy_SVM","SVM",82,4,3412,3246,166,500,271,229,0.889887152188362,0.630331753554502,1.72586978836788,311,155,156,95,1,12.78,1.2,0,0,0,0,0,0,0.218005798244469,114.330887535276,31.9345393400248
8.7,"eps_greedy_SVM","SVM",82,5,3312,3167,145,600,350,250,0.880436996700115,0.654028436018957,1.6188667410092,357,177,180,46,1,15.34,1.4,0,0,0,0,0,0,0.0970157229749203,62.111600723965,17.4702593122898
8.7,"eps_greedy_SVM","SVM",82,6,3212,3095,117,700,422,278,0.893741088282009,0.672985781990521,1.63188678009042,421,205,216,64,1.1,17.89,1.5,0,0,0,0,0,0,0.0716723576120238,58.3795606595634,10.9733854772717
8.7,"eps_greedy_SVM","SVM",82,7,3112,3025,87,800,492,308,0.885796928258115,0.691943127962085,1.5977111407168,487,235,252,66,1.1,20.45,1.6,0,0,0,0,0,0,0.071057837574908,100.179166761932,12.1099137686736
8.7,"eps_greedy_SVM","SVM",82,8,3012,2947,65,900,570,330,0.892403481850643,0.701421800947867,1.61331203686732,547,259,288,60,1.1,23.01,1.7,0,0,0,0,0,0,0.0783881045366666,120.499720821693,9.32536767767428
8.7,"eps_greedy_SVM","SVM",82,9,2912,2859,53,1000,658,342,0.907519113513218,0.701421800947867,1.64594060787332,583,277,306,36,1.1,25.56,1.9,0,0,0,0,0,0,0.0743251237842228,108.206888634031,8.50685985362674
8.7,"eps_greedy_SVM","SVM",82,10,2812,2765,47,1100,752,348,0.920847648664433,0.691943127962085,1.6754293664942,605,289,316,22,1.1,28.12,2.2,0,0,0,0,0,0,0.0675238880637869,86.2643459357973,7.82194778252879
8.7,"eps_greedy_SVM","SVM",82,11,2712,2672,40,1200,845,355,0.926514482814808,0.687203791469194,1.69554990242543,629,300,329,24,1.1,30.67,2.4,0,0,0,0,0,0,0.0677255838101392,85.2860679950291,7.6363959655065
8.7,"eps_greedy_SVM","SVM",82,12,2612,2578,34,1300,939,361,0.932844009288556,0.696682464454976,1.74135267471394,649,313,336,20,1.1,33.23,2.6,0,0,0,0,0,0,0.0620667984126069,75.5569779380783,6.8015335309887
8.7,"eps_greedy_SVM","SVM",82,13,2512,2482,30,1400,1035,365,0.934904058990487,0.682464454976303,1.75519236130471,658,315,343,9,1.1,35.79,2.8,0,0,0,0,0,0,0.0590496062188398,64.8374317840231,6.2638055372589
8.7,"eps_greedy_SVM","SVM",82,14,2412,2385,27,1500,1132,368,0.936419560287345,0.691943127962085,1.75842475976015,667,321,346,9,1.1,38.34,3.1,0,0,0,0,0,0,0.0521630896865665,54.7611056910182,5.74224594875128
8.7,"eps_greedy_SVM","SVM",82,15,2312,2289,23,1600,1228,372,0.936772634066182,0.691943127962085,1.7600454277415,678,324,354,11,1.1,40.9,3.3,0,0,0,0,0,0,0.0412613419407899,45.5395213788585,4.81329697954097
8.7,"eps_greedy_SVM","SVM",82,16,2212,2190,22,1700,1327,373,0.936786213826907,0.691943127962085,1.7600454277415,683,326,357,5,1.1,43.46,3.6,0,0,0,0,0,0,0.0327034205065521,36.6436388079155,3.58232945452668
8.7,"eps_greedy_SVM","SVM",82,17,2112,2094,18,1800,1423,377,0.937277801165141,0.691943127962085,1.7600454277415,701,332,369,18,1.1,46.01,3.8,0,0,0,0,0,0,0.0304178758168639,34.2603566964064,3.2939136864409
8.7,"eps_greedy_SVM","SVM",82,18,2012,1994,18,1900,1523,377,0.936954602859896,0.687203791469194,1.7600454277415,699,333,366,-2,1.1,48.57,4,0,0,0,0,0,0,0.027794876223078,29.0058818797119,2.83852339251319
8.7,"eps_greedy_SVM","SVM",82,19,1912,1895,17,2000,1622,378,0.939986963429694,0.687203791469194,1.78403288732948,719,343,376,20,1.1,51.12,4.3,0,0,0,0,0,0,0.0188512577849538,14.5551352754305,2.33412285183287
8.7,"eps_greedy_SVM","SVM",82,20,1812,1799,13,2100,1718,382,0.939870177487459,0.691943127962085,1.77223306384165,726,349,377,7,1.1,53.68,4.5,0,0,0,0,0,0,0.0155928487563065,13.7481386199315,1.8135796477271
8.7,"eps_greedy_SVM","SVM",82,21,1712,1701,11,2200,1816,384,0.939113784815098,0.687203791469194,1.77713324742831,726,350,376,0,1.1,56.24,4.7,0,0,0,0,0,0,0.0143596032726996,12.8074057221315,1.47425636551492
8.7,"eps_greedy_SVM","SVM",82,22,1612,1601,11,2300,1916,384,0.941183340349523,0.677725118483412,1.79422106711512,745,361,384,19,1.1,58.79,5,0,0,0,0,0,0,0.0107055959519144,8.2731012438753,1.28349155862131
8.7,"eps_greedy_SVM","SVM",82,23,1512,1503,9,2400,2014,386,0.941215931775261,0.677725118483412,1.79091983240102,749,363,386,4,1.1,61.35,5.2,0,0,0,0,0,0,0.00900884131622154,7.09145737211559,0.962482350150293
8.7,"eps_greedy_SVM","SVM",82,24,1412,1404,8,2500,2113,387,0.941524192343711,0.672985781990521,1.78927376637859,754,366,388,5,1.1,63.91,5.5,0,0,0,0,0,0,0.00942366731899999,6.62661180036147,0.956712780778236
8.7,"eps_greedy_SVM","SVM",82,25,1312,1304,8,2600,2213,387,0.942405518814741,0.672985781990521,1.79091983240102,765,370,395,11,1.1,66.46,5.7,0,0,0,0,0,0,0.00655426722646209,4.35047420592006,0.768702247602031
8.7,"eps_greedy_SVM","SVM",82,26,1212,1204,8,2700,2313,387,0.942465269761929,0.672985781990521,1.79091983240102,764,370,394,-1,1.1,69.02,6,0,0,0,0,0,0,0.0072233720893783,4.22083198168331,0.741119948540824
8.7,"eps_greedy_SVM","SVM",82,27,1112,1104,8,2800,2413,387,0.942787110091104,0.66824644549763,1.79256892985258,764,374,390,0,1,71.57,6.2,0,0,0,0,0,0,0.00476873028575155,2.49283402971526,0.530441065952323
8.7,"eps_greedy_SVM","SVM",82,28,1012,1006,6,2900,2511,389,0.942755876641437,0.66824644549763,1.79422106711512,772,377,395,8,1,74.13,6.5,0,0,0,0,0,0,0.0050934662252472,2.43257332346184,0.548732393680765
8.7,"eps_greedy_SVM","SVM",82,29,912,907,5,3000,2610,390,0.942674398077089,0.663507109004739,1.78763072343426,775,380,395,3,1,76.69,6.7,0,0,0,0,0,0,0.00490816851989453,2.13474136403312,0.520961680314913
8.7,"eps_greedy_SVM","SVM",82,30,812,808,4,3100,2709,391,0.94254810630235,0.663507109004739,1.78927376637859,779,381,398,4,1,79.24,6.9,0,0,0,0,0,0,0.00361577305060793,1.4512843391943,0.399869512614224
8.7,"eps_greedy_SVM","SVM",82,31,712,708,4,3200,2809,391,0.942769456402161,0.663507109004739,1.79091983240102,780,381,399,1,1,81.8,7.2,0,0,0,0,0,0,0.00276368986296169,0.983885437376345,0.308573835443767
8.7,"eps_greedy_SVM","SVM",82,32,612,608,4,3300,2909,391,0.942796615923611,0.663507109004739,1.79091983240102,784,382,402,4,1.1,84.36,7.4,0,0,0,0,0,0,0.00217385420177682,0.693346843865147,0.246146096223987
8.7,"eps_greedy_SVM","SVM",82,33,512,509,3,3400,3008,392,0.943149689702453,0.663507109004739,1.79091983240102,786,384,402,2,1,86.91,7.7,0,0,0,0,0,0,0.00147640500502516,0.474783557240325,0.185176869333707
8.7,"eps_greedy_SVM","SVM",82,34,412,410,2,3500,3107,393,0.943110308396354,0.663507109004739,1.78271965001823,788,385,403,2,1,89.47,7.9,0,0,0,0,0,0,0.00115610595899126,0.339569973273957,0.142997174906262
8.7,"eps_greedy_SVM","SVM",82,35,312,311,1,3600,3206,394,0.943519059194169,0.654028436018957,1.79091983240102,793,387,406,5,1,92.02,8.1,0,0,0,0,0,0,0.0011125284117552,0.2780999587223,0.138319120657497
8.7,"eps_greedy_SVM","SVM",82,36,212,212,0,3700,3305,395,0.943418568964807,0.654028436018957,1.79256892985258,801,390,411,8,1.1,94.58,8.4,0,0,0,0,0,0,0.000725507401452431,0.154072087565132,0.0972376788446766
8.7,"eps_greedy_SVM","SVM",82,37,112,112,0,3800,3405,395,0.94336424992191,0.654028436018957,1.79091983240102,802,393,409,1,1,97.14,8.6,0,0,0,0,0,0,0.000303236424429217,0.0481690424340171,0.0448244874907446
8.7,"eps_greedy_SVM","SVM",82,38,12,12,0,3900,3505,395,0.943445728486258,0.658767772511848,1.79091983240102,805,393,412,3,1,99.69,8.9,0,0,0,0,0,0,0.000190110838364666,0.00262191207335369,0.00262191207335369
8.7,"eps_greedy_SVM","SVM",82,39,0,0,0,3912,3517,395,0.943331658496171,0.658767772511848,1.78763072343426,803,393,410,-2,1,100,8.9,0,0,0,0,0,0,0,0,0
8.7,"eps_greedy_SVM","SVM",83,0,3812,3431,381,100,86,14,0.899902225722781,0.597156398104265,1.72861883431384,40,14,26,0,1.9,2.56,6.1,0,0,0,0,0,0,0.647296111343801,485.02211371881,70.9880583083066
8.7,"eps_greedy_SVM","SVM",83,1,3712,3411,301,200,106,94,0.90559486141854,0.616113744075829,1.76047654245837,97,47,50,57,1.1,5.11,1.1,0,0,0,0,0,0,0.649716967672082,345.096561643289,76.5050011695194
8.7,"eps_greedy_SVM","SVM",83,2,3612,3380,232,300,137,163,0.908815980662437,0.62085308056872,1.74988871723705,148,76,72,51,0.9,7.67,0.8,0,0,0,0,0,0,0.491322825732225,233.393267711444,61.241887600041
8.7,"eps_greedy_SVM","SVM",83,3,3512,3316,196,400,201,199,0.886633441518757,0.601895734597156,1.68315023915085,247,122,125,99,1,10.22,1,0,0,0,0,0,0,0.337910058368087,159.912576015212,49.2758760238581
8.7,"eps_greedy_SVM","SVM",83,4,3412,3258,154,500,259,241,0.860997569222835,0.616113744075829,1.66299698722952,337,170,167,90,1,12.78,1.1,0,0,0,0,0,0,0.186118703405378,172.44537433718,25.5900436978916
8.7,"eps_greedy_SVM","SVM",83,5,3312,3185,127,600,332,268,0.855709610396659,0.654028436018957,1.56353550134318,401,195,206,64,1.1,15.34,1.2,0,0,0,0,0,0,0.151062419795177,157.850616977517,20.7260411145846
8.7,"eps_greedy_SVM","SVM",83,6,3212,3099,113,700,418,282,0.86876383438123,0.663507109004739,1.58478533593532,440,209,231,39,1.1,17.89,1.5,0,0,0,0,0,0,0.100169351224362,144.645375288519,14.6740713164607
8.7,"eps_greedy_SVM","SVM",83,7,3112,3033,79,800,484,316,0.84171974089816,0.677725118483412,1.4811797422741,509,241,268,69,1.1,20.45,1.5,0,0,0,0,0,0,0.124188094439132,192.501041861906,18.0935200690722
8.7,"eps_greedy_SVM","SVM",83,8,3012,2940,72,900,577,323,0.875221010605792,0.658767772511848,1.59477146980472,536,259,277,27,1.1,23.01,1.8,0,0,0,0,0,0,0.0678482093244855,93.4696839601744,9.00546974793798
8.7,"eps_greedy_SVM","SVM",83,9,2912,2853,59,1000,664,336,0.88507176903543,0.663507109004739,1.61182784916092,562,271,291,26,1.1,25.56,2,0,0,0,0,0,0,0.0724691902454958,103.672831676344,8.19498586950781
8.7,"eps_greedy_SVM","SVM",83,10,2812,2758,54,1100,759,341,0.896118904384902,0.663507109004739,1.63892016443665,581,283,298,19,1.1,28.12,2.2,0,0,0,0,0,0,0.0491033107845186,65.4538092305012,5.8242098741067
8.7,"eps_greedy_SVM","SVM",83,11,2712,2669,43,1200,848,352,0.904507122584516,0.663507109004739,1.64442779481461,610,296,314,29,1.1,30.67,2.4,0,0,0,0,0,0,0.0612992991786444,79.1488231657954,7.08359855157588
8.7,"eps_greedy_SVM","SVM",83,12,2612,2573,39,1300,944,356,0.909576447263004,0.663507109004739,1.68160037705219,630,303,327,20,1.1,33.23,2.7,0,0,0,0,0,0,0.0516862388313451,63.9324395569143,5.77351426734638
8.7,"eps_greedy_SVM","SVM",83,13,2512,2479,33,1400,1038,362,0.919789785303984,0.658767772511848,1.72269431497622,647,311,336,17,1.1,35.79,2.9,0,0,0,0,0,0,0.0514027501967909,57.7030618541608,5.86713799660059
8.7,"eps_greedy_SVM","SVM",83,14,2412,2385,27,1500,1132,368,0.926305354499661,0.663507109004739,1.74988871723705,665,317,348,18,1.1,38.34,3.1,0,0,0,0,0,0,0.0501997857669791,53.7891591671788,5.83999091991978
8.7,"eps_greedy_SVM","SVM",83,15,2312,2290,22,1600,1227,373,0.929364874590918,0.663507109004739,1.74988871723705,673,321,352,8,1.1,40.9,3.3,0,0,0,0,0,0,0.0448746588936035,50.9042547324631,5.20424002993662
8.7,"eps_greedy_SVM","SVM",83,16,2212,2193,19,1700,1324,376,0.930338543434872,0.658767772511848,1.75150151789809,681,324,357,8,1.1,43.46,3.5,0,0,0,0,0,0,0.0353505366320589,41.5313759039639,3.92895539379248
8.7,"eps_greedy_SVM","SVM",83,17,2112,2094,18,1800,1423,377,0.930572115319337,0.658767772511848,1.74988871723705,689,328,361,8,1.1,46.01,3.8,0,0,0,0,0,0,0.0296942743503113,32.9415648925035,3.08587907123041
8.7,"eps_greedy_SVM","SVM",83,18,2012,1996,16,1900,1521,379,0.931926017463571,0.654028436018957,1.76696080228326,715,346,369,26,1.1,48.57,4,0,0,0,0,0,0,0.0216019077138709,16.0895707452176,2.84702425725554
8.7,"eps_greedy_SVM","SVM",83,19,1912,1900,12,2000,1617,383,0.932391803256426,0.654028436018957,1.7685893375849,720,350,370,5,1.1,51.12,4.2,0,0,0,0,0,0,0.0167768084077471,14.3794539167083,1.95319714879411
8.7,"eps_greedy_SVM","SVM",83,20,1812,1803,9,2100,1714,386,0.932704137753089,0.658767772511848,1.76533526336672,735,356,379,15,1.1,53.68,4.4,0,0,0,0,0,0,0.0151229315185837,13.5151521646756,1.57729918382745
8.7,"eps_greedy_SVM","SVM",83,21,1712,1703,9,2200,1814,386,0.932698705848807,0.654028436018957,1.7685893375849,745,363,382,10,1.1,56.24,4.7,0,0,0,0,0,0,0.0104254032617257,8.15210803497037,1.26588404300755
8.7,"eps_greedy_SVM","SVM",83,22,1612,1606,6,2300,1911,389,0.9326742622795,0.649289099526066,1.7685893375849,751,366,385,6,1.1,58.79,4.9,0,0,0,0,0,0,0.0104297675958968,8.08258210357418,1.08387012389699
8.7,"eps_greedy_SVM","SVM",83,23,1512,1506,6,2400,2011,389,0.933432012927937,0.644549763033175,1.77713324742831,763,373,390,12,1,61.35,5.2,0,0,0,0,0,0,0.00859100219870735,6.28949715280069,0.962696067718033
8.7,"eps_greedy_SVM","SVM",83,24,1412,1407,5,2500,2110,390,0.934195195480666,0.649289099526066,1.77713324742831,765,373,392,2,1.1,63.91,5.4,0,0,0,0,0,0,0.00798108043738971,4.96429207365891,0.834228983627097
8.7,"eps_greedy_SVM","SVM",83,25,1312,1307,5,2600,2210,390,0.934515677833767,0.644549763033175,1.77713324742831,765,375,390,0,1,66.46,5.7,0,0,0,0,0,0,0.00579106758089749,3.55439555062837,0.658333468287275
8.7,"eps_greedy_SVM","SVM",83,26,1212,1208,4,2700,2309,391,0.934534689498781,0.644549763033175,1.77713324742831,772,378,394,7,1,69.02,5.9,0,0,0,0,0,0,0.00566466365193698,3.29821228583239,0.608519192470695
8.7,"eps_greedy_SVM","SVM",83,27,1112,1108,4,2800,2409,391,0.934546911283434,0.644549763033175,1.77549684480637,773,379,394,1,1,71.57,6.2,0,0,0,0,0,0,0.00477387591029045,2.56592505051681,0.513981883892719
8.7,"eps_greedy_SVM","SVM",83,28,1012,1010,2,2900,2507,393,0.934089273347015,0.639810426540284,1.77713324742831,781,382,399,8,1,74.13,6.4,0,0,0,0,0,0,0.00405477693252899,2.11126797469583,0.448883089162153
8.7,"eps_greedy_SVM","SVM",83,29,912,911,1,3000,2606,394,0.933991499069799,0.644549763033175,1.77223306384165,783,383,400,2,1,76.69,6.6,0,0,0,0,0,0,0.00349217182717693,1.71638343584511,0.379669997203861
8.7,"eps_greedy_SVM","SVM",83,30,812,811,1,3100,2706,394,0.933929032170465,0.639810426540284,1.77386345304482,783,383,400,0,1,79.24,6.9,0,0,0,0,0,0,0.00277349638248639,1.25508070860529,0.303125889189143
8.7,"eps_greedy_SVM","SVM",83,31,712,711,1,3200,2806,394,0.93392631621832,0.639810426540284,1.77386345304482,783,383,400,0,1,81.8,7.1,0,0,0,0,0,0,0.00231413826096093,0.952903522135697,0.254509173290178
8.7,"eps_greedy_SVM","SVM",83,32,612,611,1,3300,2906,394,0.933876071103638,0.639810426540284,1.77223306384165,783,384,399,0,1,84.36,7.4,0,0,0,0,0,0,0.00195226495959034,0.722090607066829,0.217150736069084
8.7,"eps_greedy_SVM","SVM",83,33,512,511,1,3400,3006,394,0.933870639199348,0.639810426540284,1.77223306384165,786,385,401,3,1,86.91,7.6,0,0,0,0,0,0,0.00141494861341494,0.471921819145796,0.163733620184169
8.7,"eps_greedy_SVM","SVM",83,34,412,412,0,3500,3105,395,0.933486331970839,0.635071090047393,1.77060566892536,796,387,409,10,1.1,89.47,7.9,0,0,0,0,0,0,0.00116733767607967,0.34319833611561,0.136547062134353
8.7,"eps_greedy_SVM","SVM",83,35,312,312,0,3600,3205,395,0.933499911731563,0.639810426540284,1.77386345304482,796,388,408,0,1.1,92.02,8.1,0,0,0,0,0,0,0.000983957860796981,0.246095760059581,0.119757382183072
8.7,"eps_greedy_SVM","SVM",83,36,212,212,0,3700,3305,395,0.933452382569027,0.639810426540284,1.77549684480637,797,388,409,1,1.1,94.58,8.4,0,0,0,0,0,0,0.000447963222343527,0.0945819053353292,0.0600258678309333
8.7,"eps_greedy_SVM","SVM",83,37,112,112,0,3800,3405,395,0.933554230774461,0.644549763033175,1.77386345304482,800,389,411,3,1.1,97.14,8.6,0,0,0,0,0,0,0.000174198122509859,0.0313205364945034,0.029474075474238
8.7,"eps_greedy_SVM","SVM",83,38,12,12,0,3900,3505,395,0.933787802658924,0.644549763033175,1.77713324742831,799,390,409,-1,1,99.69,8.9,0,0,0,0,0,0,0.000161838637442428,0.00216942484344237,0.00216942484344237
8.7,"eps_greedy_SVM","SVM",83,39,0,0,0,3912,3517,395,0.933766075041764,0.644549763033175,1.77060566892536,799,390,409,0,1,100,8.9,0,0,0,0,0,0,0,0,0
8.7,"eps_greedy_SVM","SVM",84,0,3812,3426,386,100,91,9,0.865696166433548,0.535545023696682,1.66606241946404,22,9,13,0,1.4,2.56,10.1,0,0,0,0,0,0,0.268625030039687,320.279392732882,29.343849054084
8.7,"eps_greedy_SVM","SVM",84,1,3712,3385,327,200,132,68,0.901196376919844,0.630331753554502,1.70720850462151,107,54,53,85,1,5.11,1.9,0,0,0,0,0,0,0.669654835169556,264.443926198377,78.2465958760098
8.7,"eps_greedy_SVM","SVM",84,2,3612,3366,246,300,151,149,0.892024606526438,0.625592417061611,1.65994281461752,146,74,72,39,1,7.67,1,0,0,0,0,0,0,0.590284005893348,203.295231230275,71.7696643406979
8.7,"eps_greedy_SVM","SVM",84,3,3512,3323,189,400,194,206,0.907581580412547,0.639810426540284,1.72111095623083,234,120,114,88,1,10.22,0.9,0,0,0,0,0,0,0.379022835483935,168.72985010889,52.6415800221779
8.7,"eps_greedy_SVM","SVM",84,4,3412,3270,142,500,247,253,0.895968169040865,0.625592417061611,1.69169414899426,335,170,165,101,1,12.78,1,0,0,0,0,0,0,0.260345187711741,168.745036043299,35.362280919963
8.7,"eps_greedy_SVM","SVM",84,5,3312,3197,115,600,320,280,0.902691508575605,0.635071090047393,1.67850919988849,410,203,207,75,1,15.34,1.1,0,0,0,0,0,0,0.133518328761488,97.6540281818641,20.1297067606546
8.7,"eps_greedy_SVM","SVM",84,6,3212,3123,89,700,394,306,0.897920938633066,0.66824644549763,1.64745620695975,481,231,250,71,1.1,17.89,1.3,0,0,0,0,0,0,0.0788508896325776,65.5361263908066,11.8936186714314
8.7,"eps_greedy_SVM","SVM",84,7,3112,3045,67,800,472,328,0.885978897051838,0.672985781990521,1.61331203686732,525,251,274,44,1.1,20.45,1.4,0,0,0,0,0,0,0.0657893811898995,91.3580186235235,9.04978701599285
8.7,"eps_greedy_SVM","SVM",84,8,3012,2958,54,900,559,341,0.895615095262023,0.682464454976303,1.64141049610853,568,272,296,43,1.1,23.01,1.6,0,0,0,0,0,0,0.0632908065530387,94.9346805794055,9.0934342297701
8.7,"eps_greedy_SVM","SVM",84,9,2912,2861,51,1000,656,344,0.904405274379066,0.677725118483412,1.67306433452908,587,283,304,19,1.1,25.56,1.9,0,0,0,0,0,0,0.0566690453410852,78.9004991805366,6.40334655119161
8.7,"eps_greedy_SVM","SVM",84,10,2812,2765,47,1100,752,348,0.909056342427261,0.682464454976303,1.6986724620984,603,288,315,16,1.1,28.12,2.2,0,0,0,0,0,0,0.0447880058399,63.9664771272055,5.14825613331248
8.7,"eps_greedy_SVM","SVM",84,11,2712,2667,45,1200,850,350,0.918692540637437,0.672985781990521,1.70407025369389,608,293,315,5,1.1,30.67,2.4,0,0,0,0,0,0,0.0383177080030313,49.6887946479874,4.30785178912188
8.7,"eps_greedy_SVM","SVM",84,12,2612,2572,40,1300,945,355,0.922943005744225,0.672985781990521,1.71259060496236,626,300,326,18,1.1,33.23,2.7,0,0,0,0,0,0,0.041725386933957,52.9728909045052,4.84746339799299
8.7,"eps_greedy_SVM","SVM",84,13,2512,2475,37,1400,1042,358,0.927809991987933,0.66824644549763,1.72428058966772,642,310,332,16,1.1,35.79,2.9,0,0,0,0,0,0,0.04036918201015,45.0002700289811,4.59423235281506
8.7,"eps_greedy_SVM","SVM",84,14,2412,2378,34,1500,1139,361,0.930020777033908,0.672985781990521,1.73655555990756,657,317,340,15,1.1,38.34,3.2,0,0,0,0,0,0,0.0402215419086762,41.8184780478926,4.53482992480234
8.7,"eps_greedy_SVM","SVM",84,15,2312,2280,32,1600,1237,363,0.931744048669867,0.672985781990521,1.74988871723705,663,320,343,6,1.1,40.9,3.4,0,0,0,0,0,0,0.0327390922891488,32.9002640462989,3.54220585897818
8.7,"eps_greedy_SVM","SVM",84,16,2212,2184,28,1700,1333,367,0.931712815220203,0.672985781990521,1.73975069433242,673,324,349,10,1.1,43.46,3.6,0,0,0,0,0,0,0.0307902096787323,28.7444619488194,3.69511858222301
8.7,"eps_greedy_SVM","SVM",84,17,2112,2095,17,1800,1422,378,0.929962384062793,0.677725118483412,1.73815165876777,705,338,367,32,1.1,46.01,3.8,0,0,0,0,0,0,0.0388458201823961,31.9194714374505,5.12262320137189
8.7,"eps_greedy_SVM","SVM",84,18,2012,2002,10,1900,1515,385,0.929428699466315,0.672985781990521,1.73975069433242,729,344,385,24,1.1,48.57,3.9,0,0,0,0,0,0,0.031369553507081,29.005855685391,3.74142797079423
8.7,"eps_greedy_SVM","SVM",84,19,1912,1902,10,2000,1615,385,0.929785847173374,0.672985781990521,1.73815165876777,732,346,386,3,1.1,51.12,4.2,0,0,0,0,0,0,0.0215255256662748,20.5284702993803,2.35650768580226
8.7,"eps_greedy_SVM","SVM",84,20,1812,1803,9,2100,1714,386,0.929636469805404,0.66824644549763,1.74135267471394,733,349,384,1,1.1,53.68,4.4,0,0,0,0,0,0,0.0208844114399738,18.9949968077044,2.14117353126981
8.7,"eps_greedy_SVM","SVM",84,21,1712,1704,8,2200,1813,387,0.931275546924873,0.658767772511848,1.75680707368862,756,365,391,23,1.1,56.24,4.7,0,0,0,0,0,0,0.0138934169329557,9.44951516541074,1.89008137603906
8.7,"eps_greedy_SVM","SVM",84,22,1612,1606,6,2300,1911,389,0.931005309686452,0.649289099526066,1.75519236130471,759,365,394,3,1.1,58.79,4.9,0,0,0,0,0,0,0.00943553954730479,7.60350012818643,1.15488247518224
8.7,"eps_greedy_SVM","SVM",84,23,1512,1508,4,2400,2009,391,0.930813835060235,0.649289099526066,1.75680707368862,764,369,395,5,1.1,61.35,5.1,0,0,0,0,0,0,0.0101865052613838,7.54409240746299,1.03225687896658
8.7,"eps_greedy_SVM","SVM",84,24,1412,1408,4,2500,2109,391,0.930836920653468,0.649289099526066,1.75519236130471,782,376,406,18,1.1,63.91,5.4,0,0,0,0,0,0,0.00725082497885905,4.42781681672269,0.866757830957145
8.7,"eps_greedy_SVM","SVM",84,25,1312,1309,3,2600,2208,392,0.930938768858901,0.649289099526066,1.75680707368862,784,376,408,2,1.1,66.46,5.6,0,0,0,0,0,0,0.00599114500086532,4.09027005972669,0.683724808620797
8.7,"eps_greedy_SVM","SVM",84,26,1212,1209,3,2700,2308,392,0.930851858390263,0.644549763033175,1.75680707368862,786,377,409,2,1.1,69.02,5.9,0,0,0,0,0,0,0.0050701223109336,3.06887641686681,0.520719340390557
8.7,"eps_greedy_SVM","SVM",84,27,1112,1109,3,2800,2408,392,0.931718247124478,0.649289099526066,1.7600454277415,791,384,407,5,1.1,71.57,6.1,0,0,0,0,0,0,0.0034940556806004,1.9228837604652,0.389226763730486
8.7,"eps_greedy_SVM","SVM",84,28,1012,1009,3,2900,2508,392,0.931871698420666,0.649289099526066,1.75519236130471,794,384,410,3,1.1,74.13,6.4,0,0,0,0,0,0,0.00325911101755341,1.50891787458226,0.336210267736819
8.7,"eps_greedy_SVM","SVM",84,29,912,909,3,3000,2608,392,0.932167737204469,0.639810426540284,1.75842475976015,795,384,411,1,1.1,76.69,6.7,0,0,0,0,0,0,0.00233405575839424,0.975054615928883,0.262693693730754
8.7,"eps_greedy_SVM","SVM",84,30,812,810,2,3100,2707,393,0.932528958839744,0.644549763033175,1.75842475976015,796,385,411,1,1.1,79.24,6.9,0,0,0,0,0,0,0.00216502314917312,0.768581142815937,0.234578909594454
8.7,"eps_greedy_SVM","SVM",84,31,712,711,1,3200,2806,394,0.933141406048431,0.644549763033175,1.75842475976015,797,389,408,1,1,81.8,7.1,0,0,0,0,0,0,0.00168195907283322,0.536088117646764,0.190008502110276
8.7,"eps_greedy_SVM","SVM",84,32,612,611,1,3300,2906,394,0.933407569358636,0.644549763033175,1.75680707368862,798,389,409,1,1.1,84.36,7.4,0,0,0,0,0,0,0.0012914915393618,0.377982027527878,0.152924986608918
8.7,"eps_greedy_SVM","SVM",84,33,512,511,1,3400,3006,394,0.933547440894102,0.644549763033175,1.75842475976015,800,389,411,2,1.1,86.91,7.6,0,0,0,0,0,0,0.00069614529331493,0.199803158579723,0.0936023729182761
8.7,"eps_greedy_SVM","SVM",84,34,412,412,0,3500,3105,395,0.933994215021946,0.644549763033175,1.75842475976015,804,391,413,4,1.1,89.47,7.9,0,0,0,0,0,0,0.000477300308150982,0.137399823694257,0.0637959986465679
8.7,"eps_greedy_SVM","SVM",84,35,312,312,0,3600,3205,395,0.934545553307367,0.644549763033175,1.7600454277415,805,391,414,1,1.1,92.02,8.1,0,0,0,0,0,0,0.000368713326887827,0.0947317489912788,0.0493050768412667
8.7,"eps_greedy_SVM","SVM",84,36,212,212,0,3700,3305,395,0.934398891891541,0.639810426540284,1.75842475976015,809,393,416,4,1.1,94.58,8.4,0,0,0,0,0,0,0.000126794524533589,0.0270156261673303,0.0174783701448143
8.7,"eps_greedy_SVM","SVM",84,37,112,112,0,3800,3405,395,0.934700362579626,0.635071090047393,1.75519236130471,810,394,416,1,1.1,97.14,8.6,0,0,0,0,0,0,4.11382780250104e-05,0.00739557882582239,0.00700114200952739
8.7,"eps_greedy_SVM","SVM",84,38,12,12,0,3900,3505,395,0.935053436358467,0.635071090047393,1.7685893375849,810,395,415,0,1.1,99.69,8.9,0,0,0,0,0,0,2.00062946819329e-05,0.000305748224959315,0.000305748224959315
8.7,"eps_greedy_SVM","SVM",84,39,0,0,0,3912,3517,395,0.93514306277925,0.635071090047393,1.7685893375849,810,395,415,0,1.1,100,8.9,0,0,0,0,0,0,0,0,0
8.7,"eps_greedy_SVM","SVM",85,0,3812,3423,389,100,94,6,0.837156941294698,0.5260663507109,1.6062550505602,24,6,18,0,3,2.56,15.7,0,0,0,0,0,0,0.142352373328418,265.230780220632,15.2939880778356
8.7,"eps_greedy_SVM","SVM",85,1,3712,3385,327,200,132,68,0.896495063756969,0.582938388625592,1.67696786912642,81,42,39,57,0.9,5.11,1.9,0,0,0,0,0,0,0.686044835975415,262.225182763181,79.5678817543043
8.7,"eps_greedy_SVM","SVM",85,2,3612,3351,261,300,166,134,0.889400996754441,0.597156398104265,1.64745620695975,143,72,71,62,1,7.67,1.2,0,0,0,0,0,0,0.46064039044794,163.764846096862,60.6417290854957
8.7,"eps_greedy_SVM","SVM",85,3,3512,3305,207,400,212,188,0.893996387783652,0.601895734597156,1.72586978836788,228,114,114,85,1,10.22,1.1,0,0,0,0,0,0,0.328648554171647,157.889153771798,47.4477001761879
8.7,"eps_greedy_SVM","SVM",85,4,3412,3258,154,500,259,241,0.908953136245733,0.597156398104265,1.73441369821128,321,162,159,93,1,12.78,1.1,0,0,0,0,0,0,0.268135992013684,174.447857433589,35.5422382306954
8.7,"eps_greedy_SVM","SVM",85,5,3312,3196,116,600,321,279,0.882793085185833,0.62085308056872,1.64043068993382,403,198,205,82,1,15.34,1.2,0,0,0,0,0,0,0.197082886036649,147.547832191486,29.7375319398979
8.7,"eps_greedy_SVM","SVM",85,6,3212,3121,91,700,396,304,0.88193484430805,0.644549763033175,1.61331203686732,468,227,241,65,1.1,17.89,1.3,0,0,0,0,0,0,0.116806158891482,102.346945892248,16.8735510031722
8.7,"eps_greedy_SVM","SVM",85,7,3112,3041,71,800,476,324,0.877776721574169,0.663507109004739,1.59623995182111,520,246,274,52,1.1,20.45,1.5,0,0,0,0,0,0,0.0808652917429955,106.092766980345,11.9498885076145
8.7,"eps_greedy_SVM","SVM",85,8,3012,2955,57,900,562,338,0.889534078409531,0.658767772511848,1.63892016443665,552,266,286,32,1.1,23.01,1.7,0,0,0,0,0,0,0.070621012979943,109.132654833059,8.07505128353688
8.7,"eps_greedy_SVM","SVM",85,9,2912,2861,51,1000,656,344,0.895866320835433,0.658767772511848,1.63590744354614,569,274,295,17,1.1,25.56,1.9,0,0,0,0,0,0,0.0604641433684318,92.4688202870303,6.80984233870193
8.7,"eps_greedy_SVM","SVM",85,10,2812,2765,47,1100,752,348,0.901098602642622,0.654028436018957,1.66606241946404,586,283,303,17,1.1,28.12,2.2,0,0,0,0,0,0,0.0441475044977377,65.5902830915433,4.95172229176246
8.7,"eps_greedy_SVM","SVM",85,11,2712,2671,41,1200,846,354,0.90848056057252,0.654028436018957,1.68315023915085,606,294,312,20,1.1,30.67,2.4,0,0,0,0,0,0,0.0430661482773584,63.48437037548,4.74319766772579
8.7,"eps_greedy_SVM","SVM",85,12,2612,2578,34,1300,939,361,0.915552899957904,0.654028436018957,1.71416612529812,629,307,322,23,1,33.23,2.6,0,0,0,0,0,0,0.0608281503035741,66.6528971150747,7.03470701462358
8.7,"eps_greedy_SVM","SVM",85,13,2512,2485,27,1400,1032,368,0.919852252203304,0.654028436018957,1.70563793562002,663,321,342,34,1.1,35.79,2.8,0,0,0,0,0,0,0.0540376238519065,51.7100005304129,6.09413009060869
8.7,"eps_greedy_SVM","SVM",85,14,2412,2388,24,1500,1129,371,0.920603212971382,0.654028436018957,1.70407025369389,674,325,349,11,1.1,38.34,3,0,0,0,0,0,0,0.0485638905128365,43.8013951339793,5.45940482919977
8.7,"eps_greedy_SVM","SVM",85,15,2312,2292,20,1600,1225,375,0.919939162671947,0.654028436018957,1.72586978836788,683,330,353,9,1.1,40.9,3.3,0,0,0,0,0,0,0.0466215383639289,38.307059118363,5.60122498941152
8.7,"eps_greedy_SVM","SVM",85,16,2212,2198,14,1700,1319,381,0.918776735153915,0.654028436018957,1.71732587852447,707,336,371,24,1.1,43.46,3.5,0,0,0,0,0,0,0.0380139077138448,31.9322455454662,4.80200997078544
8.7,"eps_greedy_SVM","SVM",85,17,2112,2103,9,1800,1414,386,0.917956517606146,0.654028436018957,1.70944823687986,718,340,378,11,1.1,46.01,3.7,0,0,0,0,0,0,0.0356790470329423,30.9389951473096,3.99453200525097
8.7,"eps_greedy_SVM","SVM",85,18,2012,2004,8,1900,1513,387,0.91821181710777,0.654028436018957,1.71416612529812,718,341,377,0,1.1,48.57,3.9,0,0,0,0,0,0,0.028898756082815,26.5025218185395,3.16995769521358
8.7,"eps_greedy_SVM","SVM",85,19,1912,1906,6,2000,1611,389,0.918832412172884,0.649289099526066,1.71259060496236,730,346,384,12,1.1,51.12,4.1,0,0,0,0,0,0,0.0220997710183636,20.9066731873744,2.43153663671886
8.7,"eps_greedy_SVM","SVM",85,20,1812,1806,6,2100,1711,389,0.918776735153917,0.649289099526066,1.71732587852447,733,348,385,3,1.1,53.68,4.4,0,0,0,0,0,0,0.0187674257371463,17.7991043509338,2.02510128180215
8.7,"eps_greedy_SVM","SVM",85,21,1712,1707,5,2200,1810,390,0.919819660777565,0.649289099526066,1.71574454714462,737,353,384,4,1.1,56.24,4.6,0,0,0,0,0,0,0.0161685217583995,14.1485225835811,1.67550714091331
8.7,"eps_greedy_SVM","SVM",85,22,1612,1607,5,2300,1910,390,0.92060457094746,0.639810426540284,1.73975069433242,752,364,388,15,1.1,58.79,4.9,0,0,0,0,0,0,0.0116540086149028,8.18558841614557,1.52540299925123
8.7,"eps_greedy_SVM","SVM",85,23,1512,1509,3,2400,2008,392,0.921117885902851,0.639810426540284,1.74988871723705,753,365,388,1,1.1,61.35,5.1,0,0,0,0,0,0,0.00828669361363414,6.56880023475034,0.953648939889805
8.7,"eps_greedy_SVM","SVM",85,24,1412,1409,3,2500,2108,392,0.921066282812097,0.639810426540284,1.74827888401052,755,366,389,2,1.1,63.91,5.4,0,0,0,0,0,0,0.00776289742316911,5.71955629873613,0.800356458396091
8.7,"eps_greedy_SVM","SVM",85,25,1312,1309,3,2600,2208,392,0.921716753350815,0.639810426540284,1.74988871723705,761,371,390,6,1.1,66.46,5.6,0,0,0,0,0,0,0.00555341620029046,3.8820672785172,0.644890103897373
8.7,"eps_greedy_SVM","SVM",85,26,1212,1209,3,2700,2308,392,0.92170860549438,0.639810426540284,1.74988871723705,761,370,391,0,1.1,69.02,5.9,0,0,0,0,0,0,0.00494986936774294,2.94747663043194,0.499918713321638
8.7,"eps_greedy_SVM","SVM",85,27,1112,1109,3,2800,2408,392,0.922676842434045,0.644549763033175,1.74827888401052,768,376,392,7,1,71.57,6.1,0,0,0,0,0,0,0.00319978577047882,1.73952693248554,0.379033749978054
8.7,"eps_greedy_SVM","SVM",85,28,1012,1010,2,2900,2507,393,0.922978313122131,0.639810426540284,1.75150151789809,776,378,398,8,1.1,74.13,6.4,0,0,0,0,0,0,0.00295227472149405,1.40525036074133,0.305473813260221
8.7,"eps_greedy_SVM","SVM",85,29,912,910,2,3000,2607,393,0.924218145276278,0.639810426540284,1.74988871723705,774,380,394,-2,1,76.69,6.6,0,0,0,0,0,0,0.00264867554424121,1.09227798037899,0.28282274786997
8.7,"eps_greedy_SVM","SVM",85,30,812,810,2,3100,2707,393,0.925026141039397,0.639810426540284,1.74827888401052,778,380,398,4,1,79.24,6.9,0,0,0,0,0,0,0.0019494971238605,0.657609743566805,0.206488289921424
8.7,"eps_greedy_SVM","SVM",85,31,712,710,2,3200,2807,393,0.925532666114427,0.639810426540284,1.74667201003624,779,382,397,1,1,81.8,7.1,0,0,0,0,0,0,0.00149528807899679,0.455424344370549,0.17302882698224
8.7,"eps_greedy_SVM","SVM",85,32,612,610,2,3300,2907,393,0.925696981219194,0.639810426540284,1.75150151789809,781,383,398,2,1,84.36,7.4,0,0,0,0,0,0,0.00110240924367573,0.330437567547882,0.144437955508614
8.7,"eps_greedy_SVM","SVM",85,33,512,510,2,3400,3007,393,0.925965860481541,0.639810426540284,1.74827888401052,783,383,400,2,1,86.91,7.7,0,0,0,0,0,0,0.000485618749971316,0.143847840905846,0.06749594305019
8.7,"eps_greedy_SVM","SVM",85,34,412,411,1,3500,3106,394,0.9268159535029,0.639810426540284,1.74988871723705,787,386,401,4,1,89.47,7.9,0,0,0,0,0,0,0.000392054135766544,0.11339250816942,0.050651901175876
8.7,"eps_greedy_SVM","SVM",85,35,312,312,0,3600,3205,395,0.928216026833601,0.644549763033175,1.74346710726553,794,389,405,7,1,92.02,8.1,0,0,0,0,0,0,0.000300444724659902,0.0768602222164613,0.0382764279204008
8.7,"eps_greedy_SVM","SVM",85,36,212,212,0,3700,3305,395,0.928977851410247,0.644549763033175,1.74506808716201,797,390,407,3,1,94.58,8.4,0,0,0,0,0,0,0.000183239695267764,0.0367882837849164,0.023246517402274
8.7,"eps_greedy_SVM","SVM",85,37,112,112,0,3800,3405,395,0.929199201510055,0.644549763033175,1.74667201003624,802,391,411,5,1.1,97.14,8.6,0,0,0,0,0,0,5.93632249368402e-05,0.0103019690626944,0.00969899009424439
8.7,"eps_greedy_SVM","SVM",85,38,12,12,0,3900,3505,395,0.929325493284793,0.644549763033175,1.74667201003624,801,391,410,-1,1,99.69,8.9,0,0,0,0,0,0,4.95534444345765e-05,0.000716716698391467,0.000716716698391467
8.7,"eps_greedy_SVM","SVM",85,39,0,0,0,3912,3517,395,0.929442279227024,0.644549763033175,1.75150151789809,801,391,410,0,1,100,8.9,0,0,0,0,0,0,0,0,0
8.7,"eps_greedy_SVM","SVM",86,0,3812,3427,385,100,91,9,0.883511662627633,0.5,1.75174332666725,26,9,17,0,1.9,2.56,10.1,0,0,0,0,0,0,0.266667281617535,321.762884933825,31.4692749305106
8.7,"eps_greedy_SVM","SVM",86,1,3712,3380,332,200,138,62,0.909315767266749,0.537735849056604,1.75539331298557,93,46,47,67,1,5.11,2.2,0,0,0,0,0,0,0.768104054758585,360.711802943141,84.4123994971346
8.7,"eps_greedy_SVM","SVM",86,2,3612,3346,266,300,172,128,0.917152609485889,0.547169811320755,1.74530900774469,155,80,75,62,0.9,7.67,1.3,0,0,0,0,0,0,0.534526787393592,186.634553941019,66.8946670800428
8.7,"eps_greedy_SVM","SVM",86,3,3512,3304,208,400,214,186,0.918418404881399,0.594339622641509,1.74163452517461,223,113,110,68,1,10.22,1.2,0,0,0,0,0,0,0.243247289973032,115.403373884757,39.7590896665528
8.7,"eps_greedy_SVM","SVM",86,4,3412,3250,162,500,268,232,0.905366918383239,0.608490566037736,1.72464296883144,318,160,158,95,1,12.78,1.2,0,0,0,0,0,0,0.144431645588214,79.2239217456689,21.14083225073
8.7,"eps_greedy_SVM","SVM",86,5,3312,3180,132,600,338,262,0.900115760775476,0.636792452830189,1.72305636076444,380,188,192,62,1,15.34,1.3,0,0,0,0,0,0,0.131063645756633,94.277406972543,20.8949969529063
8.7,"eps_greedy_SVM","SVM",86,6,3212,3101,111,700,417,283,0.904532521204762,0.655660377358491,1.69136848658838,428,207,221,48,1.1,17.89,1.5,0,0,0,0,0,0,0.0939649961633367,86.6582440597856,13.4837903013899
8.7,"eps_greedy_SVM","SVM",86,7,3112,3026,86,800,492,308,0.893605569499731,0.655660377358491,1.64818096528719,482,229,253,54,1.1,20.45,1.6,0,0,0,0,0,0,0.0808446389334106,103.366019392969,13.723147999423
8.7,"eps_greedy_SVM","SVM",86,8,3012,2951,61,900,567,333,0.897329929028901,0.660377358490566,1.65820363446657,529,253,276,47,1.1,23.01,1.7,0,0,0,0,0,0,0.0802583138113968,133.625048930855,10.70949802037
8.7,"eps_greedy_SVM","SVM",86,9,2912,2866,46,1000,652,348,0.90239446295654,0.674528301886792,1.67907186459489,581,272,309,52,1.1,25.56,1.9,0,0,0,0,0,0,0.0743715396879256,119.646750181688,8.15867653011722
8.7,"eps_greedy_SVM","SVM",86,10,2812,2769,43,1100,749,351,0.913229455167035,0.669811320754717,1.69065985614511,600,289,311,19,1.1,28.12,2.1,0,0,0,0,0,0,0.0563834905887514,69.501486866791,6.4312515280351
8.7,"eps_greedy_SVM","SVM",86,11,2712,2673,39,1200,845,355,0.916215434048809,0.669811320754717,1.69292020079626,615,293,322,15,1.1,30.67,2.4,0,0,0,0,0,0,0.0480408255759624,68.4631553078374,5.23356249148157
8.7,"eps_greedy_SVM","SVM",86,12,2612,2577,35,1300,941,359,0.917748993854942,0.669811320754717,1.70765141248827,622,299,323,7,1.1,33.23,2.6,0,0,0,0,0,0,0.0444807070535009,60.9691102895851,4.84446547374199
8.7,"eps_greedy_SVM","SVM",86,13,2512,2479,33,1400,1039,361,0.922810823091566,0.665094339622642,1.71456839839614,637,310,327,15,1.1,35.79,2.9,0,0,0,0,0,0,0.036908220577313,43.6357486692266,4.18676749803531
8.7,"eps_greedy_SVM","SVM",86,14,2412,2380,32,1500,1138,362,0.924031991085342,0.665094339622642,1.71299250832408,638,311,327,1,1.1,38.34,3.1,0,0,0,0,0,0,0.0313767391833622,38.313673685578,3.4982555669842
8.7,"eps_greedy_SVM","SVM",86,15,2312,2285,27,1600,1233,367,0.931925631815823,0.665094339622642,1.76549617260593,659,317,342,21,1.1,40.9,3.4,0,0,0,0,0,0,0.0470549913065959,41.9249414945134,5.43768889425855
8.7,"eps_greedy_SVM","SVM",86,16,2212,2188,24,1700,1330,370,0.934039347844905,0.660377358490566,1.78411341603252,672,325,347,13,1.1,43.46,3.6,0,0,0,0,0,0,0.040293000627473,33.2288105261577,4.53090548365492
8.7,"eps_greedy_SVM","SVM",86,17,2112,2092,20,1800,1426,374,0.935206422018349,0.655660377358491,1.79426136857665,679,330,349,7,1.1,46.01,3.8,0,0,0,0,0,0,0.0357464680876346,28.5325875168231,4.16173671960704
8.7,"eps_greedy_SVM","SVM",86,18,2012,1997,15,1900,1521,379,0.935059016357968,0.660377358490566,1.79260919420411,695,335,360,16,1.1,48.57,4,0,0,0,0,0,0,0.0317334977610852,25.9274000275176,4.03924117923122
8.7,"eps_greedy_SVM","SVM",86,19,1912,1900,12,2000,1618,382,0.934900791933524,0.660377358490566,1.79260919420411,703,338,365,8,1.1,51.12,4.2,0,0,0,0,0,0,0.0239302309183927,21.9451242272894,2.84612234274381
8.7,"eps_greedy_SVM","SVM",86,20,1812,1801,11,2100,1717,383,0.935025207720264,0.660377358490566,1.79426136857665,706,341,365,3,1.1,53.68,4.5,0,0,0,0,0,0,0.0205475954092012,18.9785425021483,2.22182736756776
8.7,"eps_greedy_SVM","SVM",86,21,1712,1701,11,2200,1817,383,0.934914315388605,0.655660377358491,1.79426136857665,709,342,367,3,1.1,56.24,4.7,0,0,0,0,0,0,0.0173107448620376,14.1774250568612,1.75468543711762
8.7,"eps_greedy_SVM","SVM",86,22,1612,1602,10,2300,1916,384,0.935349770642205,0.641509433962264,1.79426136857665,737,356,381,28,1.1,58.79,5,0,0,0,0,0,0,0.0122332445525104,7.85371074617301,1.63066826888937
8.7,"eps_greedy_SVM","SVM",86,23,1512,1503,9,2400,2015,385,0.935470129392421,0.636792452830189,1.79260919420411,736,356,380,-1,1.1,61.35,5.2,0,0,0,0,0,0,0.00906050934603935,6.62781182029148,1.05432488778627
8.7,"eps_greedy_SVM","SVM",86,24,1412,1404,8,2500,2114,386,0.935439025445736,0.641509433962264,1.79426136857665,738,357,381,2,1.1,63.91,5.5,0,0,0,0,0,0,0.00750104286661993,5.21284058798788,0.786101898663664
8.7,"eps_greedy_SVM","SVM",86,25,1312,1305,7,2600,2213,387,0.935797397005368,0.64622641509434,1.79449541284404,746,362,384,8,1.1,66.46,5.7,0,0,0,0,0,0,0.00622637378828286,3.82433359015801,0.659816290844917
8.7,"eps_greedy_SVM","SVM",86,26,1212,1205,7,2700,2313,387,0.935506642721138,0.64622641509434,1.79779411764706,749,364,385,3,1.1,69.02,6,0,0,0,0,0,0,0.00563656139804469,3.23586132326043,0.602156074394782
8.7,"eps_greedy_SVM","SVM",86,27,1112,1106,6,2800,2412,388,0.935426854336163,0.641509433962264,1.79779411764706,753,366,387,4,1.1,71.57,6.2,0,0,0,0,0,0,0.00496001564130399,2.53885995919836,0.517535902006183
8.7,"eps_greedy_SVM","SVM",86,28,1012,1006,6,2900,2512,388,0.935320019041027,0.636792452830189,1.79779411764706,756,369,387,3,1,74.13,6.5,0,0,0,0,0,0,0.00454934300047249,2.10126122416555,0.47942655168154
8.7,"eps_greedy_SVM","SVM",86,29,912,906,6,3000,2612,388,0.935249697074609,0.636792452830189,1.79285059578368,756,369,387,0,1,76.69,6.7,0,0,0,0,0,0,0.00339857010138824,1.36819141216698,0.362576912079657
8.7,"eps_greedy_SVM","SVM",86,30,812,807,5,3100,2711,389,0.935297029167391,0.636792452830189,1.79449541284404,760,372,388,4,1,79.24,7,0,0,0,0,0,0,0.00330830919301423,1.24694698071996,0.369840698528814
8.7,"eps_greedy_SVM","SVM",86,31,712,708,4,3200,2810,390,0.935063073394498,0.632075471698113,1.79944802207912,763,373,390,3,1,81.8,7.2,0,0,0,0,0,0,0.00229573644574493,0.762642116996662,0.257893341482808
8.7,"eps_greedy_SVM","SVM",86,32,612,609,3,3300,2909,391,0.934976523281983,0.636792452830189,1.79944802207912,765,374,391,2,1,84.36,7.4,0,0,0,0,0,0,0.00214860764229883,0.686872357868631,0.249154491639946
8.7,"eps_greedy_SVM","SVM",86,33,512,509,3,3400,3009,391,0.934872392677863,0.636792452830189,1.80110497237569,768,375,393,3,1,86.91,7.7,0,0,0,0,0,0,0.00137900500184736,0.40915132544361,0.169336748888152
8.7,"eps_greedy_SVM","SVM",86,34,412,410,2,3500,3108,392,0.934581638393633,0.627358490566038,1.79944802207912,774,377,397,6,1.1,89.47,7.9,0,0,0,0,0,0,0.00105946042233087,0.306306664167454,0.13782586791465
8.7,"eps_greedy_SVM","SVM",86,35,312,312,0,3600,3206,394,0.93448697420807,0.627358490566038,1.79614325068871,786,382,404,12,1.1,92.02,8.1,0,0,0,0,0,0,0.00124772370383308,0.319274202411976,0.158463750521152
8.7,"eps_greedy_SVM","SVM",86,36,212,212,0,3700,3306,394,0.934424766314699,0.632075471698113,1.79614325068871,789,384,405,3,1.1,94.58,8.4,0,0,0,0,0,0,0.00053043777936844,0.110847795177796,0.0683385305221103
8.7,"eps_greedy_SVM","SVM",86,37,112,112,0,3800,3406,394,0.934231380907048,0.636792452830189,1.79449541284404,790,385,405,1,1.1,97.14,8.6,0,0,0,0,0,0,0.000314574084838993,0.0487263403846517,0.0452747942984968
8.7,"eps_greedy_SVM","SVM",86,38,12,12,0,3900,3506,394,0.934261132508225,0.636792452830189,1.79779411764706,793,386,407,3,1.1,99.69,8.9,0,0,0,0,0,0,0.000184569845840231,0.00273412251655441,0.00273412251655441
8.7,"eps_greedy_SVM","SVM",86,39,0,0,0,3912,3518,394,0.934171877704694,0.636792452830189,1.79779411764706,794,386,408,1,1.1,100,8.9,0,0,0,0,0,0,0,0,0
8.7,"eps_greedy_SVM","SVM",87,0,3812,3420,392,100,95,5,0.896678653494822,0.588516746411483,1.74238528873503,16,5,11,0,2.2,2.56,19,0,0,0,0,0,0,0.128770065758169,195.602620113957,14.091553165633
8.7,"eps_greedy_SVM","SVM",87,1,3712,3383,329,200,132,68,0.909556505615902,0.588516746411483,1.73917942803819,91,44,47,75,1.1,5.11,1.9,0,0,0,0,0,0,0.767414760810525,288.670898158523,84.2074842057343
8.7,"eps_greedy_SVM","SVM",87,2,3612,3346,266,300,169,131,0.90384336237376,0.607655502392344,1.73056962888949,146,74,72,55,1,7.67,1.3,0,0,0,0,0,0,0.479736644903105,131.970908310772,63.2037968624501
8.7,"eps_greedy_SVM","SVM",87,3,3512,3311,201,400,204,196,0.891685815464917,0.598086124401914,1.68596960315227,218,110,108,72,1,10.22,1,0,0,0,0,0,0,0.231630779012163,79.9817950445815,42.3188940911037
8.7,"eps_greedy_SVM","SVM",87,4,3412,3246,166,500,269,231,0.869259126376589,0.593301435406699,1.65156206023079,302,149,153,84,1,12.78,1.2,0,0,0,0,0,0,0.142359279413022,72.3511874466346,21.476191461856
8.7,"eps_greedy_SVM","SVM",87,5,3312,3177,135,600,338,262,0.870769576279782,0.631578947368421,1.63025158203426,370,178,192,68,1.1,15.34,1.3,0,0,0,0,0,0,0.0732104382293122,45.1797947762051,12.2271147654618
8.7,"eps_greedy_SVM","SVM",87,6,3212,3108,104,700,407,293,0.871528224735229,0.631578947368421,1.59427952100241,434,211,223,64,1.1,17.89,1.4,0,0,0,0,0,0,0.0658809385794177,58.5208684374058,11.0316623907927
8.7,"eps_greedy_SVM","SVM",87,7,3112,3032,80,800,483,317,0.87500376585425,0.641148325358852,1.60289724814296,480,235,245,46,1,20.45,1.5,0,0,0,0,0,0,0.0617928724406597,82.2696160893988,8.61236343714239
8.7,"eps_greedy_SVM","SVM",87,8,3012,2947,65,900,568,332,0.893260627240702,0.641148325358852,1.63586183825374,521,251,270,41,1.1,23.01,1.7,0,0,0,0,0,0,0.0616331722592099,91.3177788988288,8.14903911443287
8.7,"eps_greedy_SVM","SVM",87,9,2912,2854,58,1000,661,339,0.905703009670711,0.636363636363636,1.6844214216985,557,270,287,36,1.1,25.56,1.9,0,0,0,0,0,0,0.0653694725996754,85.2093911106543,7.72347777153186
8.7,"eps_greedy_SVM","SVM",87,10,2812,2758,54,1100,757,343,0.915680469321288,0.631578947368421,1.71650827949639,579,283,296,22,1,28.12,2.2,0,0,0,0,0,0,0.0534900197655095,62.1798933126845,5.9544900404066
8.7,"eps_greedy_SVM","SVM",87,11,2712,2665,47,1200,850,350,0.921208743354962,0.631578947368421,1.73216315525126,599,292,307,20,1.1,30.67,2.4,0,0,0,0,0,0,0.0445850577779714,52.3065062350541,5.01526459498756
8.7,"eps_greedy_SVM","SVM",87,12,2612,2574,38,1300,941,359,0.927903747504268,0.631578947368421,1.73758091753448,624,302,322,25,1.1,33.23,2.6,0,0,0,0,0,0,0.0441338532731542,49.2969259473461,5.25748207433045
8.7,"eps_greedy_SVM","SVM",87,13,2512,2481,31,1400,1034,366,0.932091377426234,0.631578947368421,1.75801633667292,652,312,340,28,1.1,35.79,2.8,0,0,0,0,0,0,0.0502871881982027,44.8665841179822,5.73676345531548
8.7,"eps_greedy_SVM","SVM",87,14,2412,2383,29,1500,1132,368,0.932529585920361,0.636363636363636,1.7563990263356,656,314,342,4,1.1,38.34,3.1,0,0,0,0,0,0,0.041650829833811,41.4400198803626,4.90818091638841
8.7,"eps_greedy_SVM","SVM",87,15,2312,2289,23,1600,1226,374,0.933841472599642,0.631578947368421,1.76826229797367,666,320,346,10,1.1,40.9,3.3,0,0,0,0,0,0,0.0359764138442265,36.592996967658,4.27225249838283
8.7,"eps_greedy_SVM","SVM",87,16,2212,2195,17,1700,1320,380,0.934427576460538,0.62200956937799,1.7531733164617,692,328,364,26,1.1,43.46,3.5,0,0,0,0,0,0,0.0302153876948306,33.8403049338877,3.5976039019126
8.7,"eps_greedy_SVM","SVM",87,17,2112,2096,16,1800,1419,381,0.934186561788769,0.62200956937799,1.75801633667292,693,329,364,1,1.1,46.01,3.7,0,0,0,0,0,0,0.0270312707252321,30.5801668769076,2.89795631160417
8.7,"eps_greedy_SVM","SVM",87,18,2012,1998,14,1900,1517,383,0.934263248275242,0.626794258373206,1.75801633667292,697,332,365,4,1.1,48.57,4,0,0,0,0,0,0,0.0209007918683495,22.8998238604726,2.23419128472045
8.7,"eps_greedy_SVM","SVM",87,19,1912,1899,13,2000,1616,384,0.934898650591713,0.62200956937799,1.7703612901525,712,339,373,15,1.1,51.12,4.2,0,0,0,0,0,0,0.0155925621046532,15.8789750741225,1.85631910951071
8.7,"eps_greedy_SVM","SVM",87,20,1812,1801,11,2100,1714,386,0.93422216622891,0.62200956937799,1.76015100302884,712,343,369,0,1.1,53.68,4.4,0,0,0,0,0,0,0.0158779839531998,15.0722194623893,1.6022784154473
8.7,"eps_greedy_SVM","SVM",87,21,1712,1701,11,2200,1814,386,0.933403264105523,0.617224880382775,1.78222842378171,733,355,378,21,1.1,56.24,4.7,0,0,0,0,0,0,0.0117448271184822,8.88549971065449,1.53146969770566
8.7,"eps_greedy_SVM","SVM",87,22,1612,1604,8,2300,1911,389,0.934413882445094,0.617224880382775,1.7855136374661,741,358,383,8,1.1,58.79,4.9,0,0,0,0,0,0,0.00884796881741201,7.44624291619772,1.0159624134114
8.7,"eps_greedy_SVM","SVM",87,23,1512,1504,8,2400,2011,389,0.934324871344725,0.617224880382775,1.78386951809458,741,358,383,0,1.1,61.35,5.2,0,0,0,0,0,0,0.00800964318964465,6.30987043170932,0.824843965190366
8.7,"eps_greedy_SVM","SVM",87,24,1412,1404,8,2500,2111,389,0.93325536873875,0.61244019138756,1.78222842378171,747,364,383,6,1.1,63.91,5.4,0,0,0,0,0,0,0.00584416629902641,4.39066160380802,0.66451267456498
8.7,"eps_greedy_SVM","SVM",87,25,1312,1306,6,2600,2209,391,0.933390939491621,0.607655502392344,1.78059034618632,754,368,386,7,1,66.46,5.6,0,0,0,0,0,0,0.0064779538318687,4.32802333031962,0.668675835491547
8.7,"eps_greedy_SVM","SVM",87,26,1212,1207,5,2700,2308,392,0.933920897889192,0.602870813397129,1.7855136374661,764,373,391,10,1,69.02,5.9,0,0,0,0,0,0,0.00467296291402457,2.92498807277369,0.522613400226333
8.7,"eps_greedy_SVM","SVM",87,27,1112,1108,4,2800,2407,393,0.934197517001108,0.602870813397129,1.78386951809458,766,374,392,2,1,71.57,6.1,0,0,0,0,0,0,0.0044162487192922,2.53419881877511,0.462687268997867
8.7,"eps_greedy_SVM","SVM",87,28,1012,1008,4,2900,2507,393,0.933918159086105,0.602870813397129,1.7855136374661,777,379,398,11,1.1,74.13,6.4,0,0,0,0,0,0,0.00393022640216717,2.06480459610887,0.423169174087205
8.7,"eps_greedy_SVM","SVM",87,29,912,909,3,3000,2606,394,0.933912681479929,0.602870813397129,1.7855136374661,779,381,398,2,1,76.69,6.6,0,0,0,0,0,0,0.00346735762412206,1.65459876738003,0.371575008748085
8.7,"eps_greedy_SVM","SVM",87,30,812,809,3,3100,2706,394,0.933923636692284,0.602870813397129,1.78059034618632,778,381,397,-1,1,79.24,6.9,0,0,0,0,0,0,0.00302406215820015,1.28924322916245,0.327914394763233
8.7,"eps_greedy_SVM","SVM",87,31,712,709,3,3200,2806,394,0.933994845572579,0.602870813397129,1.78222842378171,780,381,399,2,1,81.8,7.1,0,0,0,0,0,0,0.00217447826420411,0.805835745643189,0.235306944612437
8.7,"eps_greedy_SVM","SVM",87,32,612,609,3,3300,2906,394,0.934105767097656,0.602870813397129,1.78386951809458,778,381,397,-2,1,84.36,7.4,0,0,0,0,0,0,0.00195612264777031,0.646098536289815,0.220367173599774
8.7,"eps_greedy_SVM","SVM",87,33,512,509,3,3400,3006,394,0.934096181286847,0.607655502392344,1.7789552769979,779,381,398,1,1,86.91,7.6,0,0,0,0,0,0,0.00127010856126466,0.39754991169994,0.157345469653507
8.7,"eps_greedy_SVM","SVM",87,34,412,409,3,3500,3106,394,0.934435792869793,0.607655502392344,1.7789552769979,779,381,398,0,1,89.47,7.9,0,0,0,0,0,0,0.000761557885109127,0.205600208030319,0.0936756933002617
8.7,"eps_greedy_SVM","SVM",87,35,312,312,0,3600,3203,397,0.934900019993262,0.607655502392344,1.78590931039024,792,388,404,13,1,92.02,8.1,0,0,0,0,0,0,0.000821203544804401,0.216200889332173,0.116884776138399
8.7,"eps_greedy_SVM","SVM",87,36,212,212,0,3700,3303,397,0.935206765939147,0.607655502392344,1.78590931039024,792,390,402,0,1,94.58,8.3,0,0,0,0,0,0,0.00045087956908878,0.0946761335227299,0.0596086583043239
8.7,"eps_greedy_SVM","SVM",87,37,112,112,0,3800,3403,397,0.935703858699668,0.607655502392344,1.79248724523514,792,389,403,0,1,97.14,8.6,0,0,0,0,0,0,0.000184862726008243,0.0291453326931687,0.0271610040390297
8.7,"eps_greedy_SVM","SVM",87,38,12,12,0,3900,3503,397,0.936285854355926,0.607655502392344,1.79248724523514,796,390,406,4,1,99.69,8.8,0,0,0,0,0,0,0.00011620445458869,0.00178698804976951,0.00178698804976951
8.7,"eps_greedy_SVM","SVM",87,39,0,0,0,3912,3515,397,0.936276268545117,0.607655502392344,1.7875492638433,797,391,406,1,1,100,8.9,0,0,0,0,0,0,0,0,0
8.7,"eps_greedy_SVM","SVM",88,0,3812,3429,383,100,91,9,0.900755925619939,0.55607476635514,1.76257047964779,23,9,14,0,1.6,2.56,10.1,0,0,0,0,0,0,0.774152685767712,428.440260940733,83.6226134156794
8.7,"eps_greedy_SVM","SVM",88,1,3712,3382,330,200,138,62,0.908351395431177,0.58411214953271,1.75578958218802,99,49,50,76,1,5.11,2.2,0,0,0,0,0,0,0.728047714415004,283.851176049976,81.4179664890414
8.7,"eps_greedy_SVM","SVM",88,2,3612,3360,252,300,160,140,0.906123587669118,0.574766355140187,1.73537189370774,151,79,72,52,0.9,7.67,1.1,0,0,0,0,0,0,0.538288178734809,175.293322346432,71.3815122186089
8.7,"eps_greedy_SVM","SVM",88,3,3512,3316,196,400,204,196,0.88350483384658,0.602803738317757,1.6764029458633,220,111,109,69,1,10.22,1,0,0,0,0,0,0,0.225054033928867,75.3439915970765,41.3222796227901
8.7,"eps_greedy_SVM","SVM",88,4,3412,3260,152,500,260,240,0.85974870435743,0.598130841121495,1.60900986261252,321,162,159,101,1,12.78,1.1,0,0,0,0,0,0,0.117437805562429,57.8545359945527,17.6384056628419
8.7,"eps_greedy_SVM","SVM",88,5,3312,3186,126,600,334,266,0.845802439992693,0.616822429906542,1.57647260567607,376,181,195,55,1.1,15.34,1.3,0,0,0,0,0,0,0.141046311017656,89.99700554295,21.4231446279018
8.7,"eps_greedy_SVM","SVM",88,6,3212,3100,112,700,420,280,0.855026181100243,0.626168224299065,1.58227913461042,406,195,211,30,1.1,17.89,1.5,0,0,0,0,0,0,0.0602608347879399,41.2645900564904,8.70491926330614
8.7,"eps_greedy_SVM","SVM",88,7,3112,3024,88,800,496,304,0.85583495176883,0.630841121495327,1.58373745639347,460,219,241,54,1.1,20.45,1.6,0,0,0,0,0,0,0.0647858122354271,75.3207081619857,10.7377730302587
8.7,"eps_greedy_SVM","SVM",88,8,3012,2939,73,900,581,319,0.870720087556457,0.649532710280374,1.61743399801886,499,236,263,39,1.1,23.01,1.8,0,0,0,0,0,0,0.0554328460565049,74.4981175948263,6.80127748548081
8.7,"eps_greedy_SVM","SVM",88,9,2912,2852,60,1000,668,332,0.877879652778526,0.663551401869159,1.63428226883156,533,258,275,34,1.1,25.56,2,0,0,0,0,0,0,0.0605922241356266,84.8930331299637,9.03505546757831
8.7,"eps_greedy_SVM","SVM",88,10,2812,2755,57,1100,765,335,0.899707072116046,0.649532710280374,1.66337960417812,569,275,294,36,1.1,28.12,2.3,0,0,0,0,0,0,0.0447226407502877,37.3262624599912,6.27464467671635
8.7,"eps_greedy_SVM","SVM",88,11,2712,2661,51,1200,859,341,0.902306404712592,0.649532710280374,1.67178051126993,576,280,296,7,1.1,30.67,2.5,0,0,0,0,0,0,0.0293477058830335,28.4379713988423,3.50566467395868
8.7,"eps_greedy_SVM","SVM",88,12,2612,2569,43,1300,951,349,0.913304612809417,0.649532710280374,1.69169205349306,596,289,307,20,1.1,33.23,2.7,0,0,0,0,0,0,0.030970112453021,38.1792475677297,3.76647138903904
8.7,"eps_greedy_SVM","SVM",88,13,2512,2480,32,1400,1040,360,0.924616672210481,0.654205607476635,1.74379602911409,635,304,331,39,1.1,35.79,2.9,0,0,0,0,0,0,0.0597599740560759,48.4828411547019,7.3076458185627
8.7,"eps_greedy_SVM","SVM",88,14,2412,2382,30,1500,1138,362,0.926183246241838,0.644859813084112,1.75060670212217,646,310,336,11,1.1,38.34,3.1,0,0,0,0,0,0,0.0480855928282077,38.4764058161668,5.41848578002014
8.7,"eps_greedy_SVM","SVM",88,15,2312,2286,26,1600,1234,366,0.928771848879259,0.644859813084112,1.76581347961035,660,317,343,14,1.1,40.9,3.4,0,0,0,0,0,0,0.0425449820956231,30.0513750271443,4.83172379643431
8.7,"eps_greedy_SVM","SVM",88,16,2212,2188,24,1700,1332,368,0.929329806753436,0.644859813084112,1.76581347961035,667,321,346,7,1.1,43.46,3.6,0,0,0,0,0,0,0.0360154336309081,25.1522527745399,4.14004828721967
8.7,"eps_greedy_SVM","SVM",88,17,2112,2092,20,1800,1428,372,0.930389390216424,0.644859813084112,1.76743945887334,676,326,350,9,1.1,46.01,3.8,0,0,0,0,0,0,0.0306706120999456,21.2879902916108,3.75274399152089
8.7,"eps_greedy_SVM","SVM",88,18,2012,1999,13,1900,1521,379,0.930209663401178,0.644859813084112,1.75740484399316,689,333,356,13,1.1,48.57,4,0,0,0,0,0,0,0.0230410198051135,20.1267616550507,3.42046351637161
8.7,"eps_greedy_SVM","SVM",88,19,1912,1899,13,2000,1621,379,0.930201615931839,0.644859813084112,1.75902308049775,689,333,356,0,1.1,51.12,4.3,0,0,0,0,0,0,0.0165706741977241,15.2864446778597,1.82381670224542
8.7,"eps_greedy_SVM","SVM",88,20,1812,1801,11,2100,1719,381,0.930333057931049,0.64018691588785,1.76064429992678,696,335,361,7,1.1,53.68,4.5,0,0,0,0,0,0,0.0179408455583648,15.8673005002709,1.81630362060649
8.7,"eps_greedy_SVM","SVM",88,21,1712,1702,10,2200,1818,382,0.929064240265242,0.64018691588785,1.77749257073948,724,351,373,28,1.1,56.24,4.8,0,0,0,0,0,0,0.0115350806097097,8.39293025384449,1.48073778166925
8.7,"eps_greedy_SVM","SVM",88,22,1612,1605,7,2300,1915,385,0.929112525081278,0.64018691588785,1.76419048927982,730,355,375,6,1.1,58.79,5,0,0,0,0,0,0,0.00912458811125188,7.11834774380204,1.01510066375448
8.7,"eps_greedy_SVM","SVM",88,23,1512,1505,7,2400,2015,385,0.929015955449208,0.64018691588785,1.76581347961035,732,356,376,2,1.1,61.35,5.2,0,0,0,0,0,0,0.00794165563280163,5.65694858041888,0.820486296640978
8.7,"eps_greedy_SVM","SVM",88,24,1412,1405,7,2500,2115,385,0.92871551659388,0.64018691588785,1.77259139637163,743,361,382,11,1.1,63.91,5.5,0,0,0,0,0,0,0.00628659845367419,4.2704978343504,0.693998938077249
8.7,"eps_greedy_SVM","SVM",88,25,1312,1306,6,2600,2214,386,0.928696739165421,0.630841121495327,1.77585583724893,745,363,382,2,1.1,66.46,5.7,0,0,0,0,0,0,0.00583270722407245,3.51414696112458,0.598806695515911
8.7,"eps_greedy_SVM","SVM",88,26,1212,1206,6,2700,2314,386,0.927984538128903,0.626168224299065,1.77585583724893,752,366,386,7,1.1,69.02,6,0,0,0,0,0,0,0.00560904157220848,3.14627366550346,0.602000847969113
8.7,"eps_greedy_SVM","SVM",88,27,1112,1106,6,2800,2414,386,0.927999291822691,0.626168224299065,1.77585583724893,752,367,385,0,1,71.57,6.3,0,0,0,0,0,0,0.00420729542782632,1.9758829240359,0.434561720311682
8.7,"eps_greedy_SVM","SVM",88,28,1012,1006,6,2900,2514,386,0.928070377801845,0.626168224299065,1.77585583724893,758,370,388,6,1,74.13,6.5,0,0,0,0,0,0,0.003792787220679,1.57987375534514,0.405724697479126
8.7,"eps_greedy_SVM","SVM",88,29,912,906,6,3000,2614,386,0.928093178964971,0.626168224299065,1.78263075084473,756,370,386,-2,1,76.69,6.8,0,0,0,0,0,0,0.00300869064026198,1.0918708271542,0.326516657939891
8.7,"eps_greedy_SVM","SVM",88,30,812,808,4,3100,2712,388,0.928838911123732,0.626168224299065,1.78099230346344,759,373,386,3,1,79.24,7,0,0,0,0,0,0,0.00270641510389962,0.945590897529699,0.307141419120326
8.7,"eps_greedy_SVM","SVM",88,31,712,708,4,3200,2812,388,0.928867077266419,0.626168224299065,1.78099230346344,759,373,386,0,1,81.8,7.2,0,0,0,0,0,0,0.00197911620365787,0.63794655693055,0.230475400384349
8.7,"eps_greedy_SVM","SVM",88,32,612,609,3,3300,2911,389,0.928712834104085,0.626168224299065,1.77935686516825,765,374,391,6,1,84.36,7.5,0,0,0,0,0,0,0.00156217597747112,0.493507923299708,0.190586678989841
8.7,"eps_greedy_SVM","SVM",88,33,512,510,2,3400,3010,390,0.929150079938174,0.621495327102804,1.77935686516825,769,376,393,4,1,86.91,7.7,0,0,0,0,0,0,0.000940088887244406,0.295335632552408,0.120180551899148
8.7,"eps_greedy_SVM","SVM",88,34,412,411,1,3500,3109,391,0.929120572550596,0.621495327102804,1.78263075084473,773,379,394,4,1,89.47,8,0,0,0,0,0,0,0.000799391189066947,0.23485599399933,0.0997190368906066
8.7,"eps_greedy_SVM","SVM",88,35,312,312,0,3600,3208,392,0.929366020365442,0.621495327102804,1.78099230346344,777,381,396,4,1,92.02,8.2,0,0,0,0,0,0,0.000735696095747123,0.178034035697148,0.0883120535231438
8.7,"eps_greedy_SVM","SVM",88,36,212,212,0,3700,3308,392,0.929659752996322,0.621495327102804,1.78427221562452,784,383,401,7,1,94.58,8.4,0,0,0,0,0,0,0.000443720429212343,0.0938585394572687,0.0583531991731818
8.7,"eps_greedy_SVM","SVM",88,37,112,112,0,3800,3408,392,0.92959805573139,0.616822429906542,1.78263075084473,785,384,401,1,1,97.14,8.7,0,0,0,0,0,0,0.00014755801069327,0.0252946926482554,0.0236720902959485
8.7,"eps_greedy_SVM","SVM",88,38,12,12,0,3900,3508,392,0.929632928098526,0.616822429906542,1.77935686516825,785,385,400,0,1,99.69,8.9,0,0,0,0,0,0,9.91853963351318e-05,0.00164277003119974,0.00164277003119974
8.7,"eps_greedy_SVM","SVM",88,39,0,0,0,3912,3520,392,0.92969462536346,0.616822429906542,1.78591670614583,786,385,401,1,1,100,9,0,0,0,0,0,0,0,0,0
8.7,"eps_greedy_SVM","SVM",89,0,3812,3420,392,100,89,11,0.899862024003912,0.561576354679803,1.75190326914465,25,11,14,0,1.3,2.56,8.1,0,0,0,0,0,0,0.618790290149721,368.789342326373,67.1140582184195
8.7,"eps_greedy_SVM","SVM",89,1,3712,3377,335,200,132,68,0.910259400492889,0.61576354679803,1.73420727652703,105,52,53,80,1,5.11,1.9,0,0,0,0,0,0,0.655017526719448,262.891016720019,74.9065360257181
8.7,"eps_greedy_SVM","SVM",89,2,3612,3350,262,300,159,141,0.900733155547556,0.610837438423645,1.73899790436274,157,79,78,52,1,7.67,1.1,0,0,0,0,0,0,0.52597243730158,178.026916350497,68.4311147966921
8.7,"eps_greedy_SVM","SVM",89,3,3512,3313,199,400,196,204,0.901095658673791,0.605911330049261,1.74060066740823,236,121,115,79,1,10.22,1,0,0,0,0,0,0,0.326533525542707,121.11282935249,49.0655773903219
8.7,"eps_greedy_SVM","SVM",89,4,3412,3259,153,500,250,250,0.890081464849856,0.620689655172414,1.69463571292491,334,169,165,98,1,12.78,1,0,0,0,0,0,0,0.254848603370494,145.021693358728,37.5922988357452
8.7,"eps_greedy_SVM","SVM",89,5,3312,3187,125,600,322,278,0.896959188892245,0.640394088669951,1.6695557422079,391,196,195,57,1,15.34,1.2,0,0,0,0,0,0,0.112356414184877,56.5034202191657,17.2735486550471
8.7,"eps_greedy_SVM","SVM",89,6,3212,3108,104,700,401,299,0.894491919552409,0.645320197044335,1.64421747186695,457,220,237,66,1.1,17.89,1.3,0,0,0,0,0,0,0.0731363639482799,47.4620873220292,11.254184149007
8.7,"eps_greedy_SVM","SVM",89,7,3112,3038,74,800,471,329,0.886717773050555,0.665024630541872,1.63252864491196,517,248,269,60,1.1,20.45,1.4,0,0,0,0,0,0,0.0794436746054637,100.060640882441,12.2241710305707
8.7,"eps_greedy_SVM","SVM",89,8,3012,2954,58,900,555,345,0.892884541349237,0.655172413793103,1.64723993045494,560,272,288,43,1.1,23.01,1.6,0,0,0,0,0,0,0.0614690339127354,83.1518197295084,7.22012715318161
8.7,"eps_greedy_SVM","SVM",89,9,2912,2862,50,1000,647,353,0.900238577638893,0.665024630541872,1.67843635785794,585,281,304,25,1.1,25.56,1.8,0,0,0,0,0,0,0.0586452465624698,81.833106219636,6.34551005429675
8.7,"eps_greedy_SVM","SVM",89,10,2812,2764,48,1100,745,355,0.906446092413014,0.665024630541872,1.6695557422079,596,286,310,11,1.1,28.12,2.1,0,0,0,0,0,0,0.0388750253243209,52.6368683612587,4.31870933061736
8.7,"eps_greedy_SVM","SVM",89,11,2712,2671,41,1200,838,362,0.910953495626076,0.669950738916256,1.67534815848745,613,295,318,17,1.1,30.67,2.3,0,0,0,0,0,0,0.0439843947299004,63.567407735726,5.05192083285909
8.7,"eps_greedy_SVM","SVM",89,12,2612,2574,38,1300,935,365,0.917534753933444,0.660098522167488,1.69152057374674,635,305,330,22,1.1,33.23,2.6,0,0,0,0,0,0,0.0489154242078815,53.5646016072116,5.8646918209573
8.7,"eps_greedy_SVM","SVM",89,13,2512,2480,32,1400,1029,371,0.924921106393262,0.660098522167488,1.73580121703854,656,315,341,21,1.1,35.79,2.8,0,0,0,0,0,0,0.059997420787774,51.0107133338322,6.56060296047465
8.7,"eps_greedy_SVM","SVM",89,14,2412,2387,25,1500,1122,378,0.92663245836132,0.660098522167488,1.7446573456969,679,325,354,23,1.1,38.34,3,0,0,0,0,0,0,0.0600872940631964,43.0734792197754,6.57017393481377
8.7,"eps_greedy_SVM","SVM",89,15,2312,2292,20,1600,1217,383,0.926854456399869,0.665024630541872,1.7446573456969,691,332,359,12,1.1,40.9,3.2,0,0,0,0,0,0,0.0547831747454301,35.9633745684758,6.03862186705398
8.7,"eps_greedy_SVM","SVM",89,16,2212,2196,16,1700,1313,387,0.926706926057793,0.660098522167488,1.74948128305827,700,335,365,9,1.1,43.46,3.4,0,0,0,0,0,0,0.0441138774698383,29.8891834054178,5.25668702935838
8.7,"eps_greedy_SVM","SVM",89,17,2112,2099,13,1800,1410,390,0.926642293717455,0.665024630541872,1.74626236625412,707,338,369,7,1.1,46.01,3.6,0,0,0,0,0,0,0.0290954477345228,24.9613222043127,3.7674912694603
8.7,"eps_greedy_SVM","SVM",89,18,2012,2003,9,1900,1506,394,0.927238035289262,0.665024630541872,1.74948128305827,722,342,380,15,1.1,48.57,3.8,0,0,0,0,0,0,0.0238320584959477,22.1267907336441,2.73073196891746
8.7,"eps_greedy_SVM","SVM",89,19,1912,1903,9,2000,1606,394,0.927044138268252,0.665024630541872,1.74626236625412,723,345,378,1,1.1,51.12,4.1,0,0,0,0,0,0,0.0179990673970725,17.8426111097252,1.98330336084314
8.7,"eps_greedy_SVM","SVM",89,20,1812,1805,7,2100,1704,396,0.927822536454055,0.665024630541872,1.75512664222495,730,350,380,7,1.1,53.68,4.3,0,0,0,0,0,0,0.0153839195041676,14.6783330038743,1.5855972747547
8.7,"eps_greedy_SVM","SVM",89,21,1712,1705,7,2200,1804,396,0.92676031799111,0.655172413793103,1.73985993778023,749,361,388,19,1.1,56.24,4.6,0,0,0,0,0,0,0.0108414845703828,8.1936073079599,1.40726976117744
8.7,"eps_greedy_SVM","SVM",89,22,1612,1608,4,2300,1901,399,0.926898012977043,0.660098522167488,1.75512664222495,760,365,395,11,1.1,58.79,4.8,0,0,0,0,0,0,0.00809067899836281,6.94262727180147,0.935198514428362
8.7,"eps_greedy_SVM","SVM",89,23,1512,1508,4,2400,2001,399,0.926867101857751,0.660098522167488,1.75190326914465,760,365,395,0,1.1,61.35,5,0,0,0,0,0,0,0.00776281332832813,5.98924114199429,0.784926665763915
8.7,"eps_greedy_SVM","SVM",89,24,1412,1408,4,2500,2101,399,0.926043742043892,0.650246305418719,1.75836189870832,766,373,393,6,1.1,63.91,5.3,0,0,0,0,0,0,0.00568669117908825,3.7764554651649,0.723889699067945
8.7,"eps_greedy_SVM","SVM",89,25,1312,1309,3,2600,2200,400,0.926115399638613,0.645320197044335,1.75351347435526,771,374,397,5,1.1,66.46,5.5,0,0,0,0,0,0,0.00448466953173375,3.00615689377882,0.483930220253149
8.7,"eps_greedy_SVM","SVM",89,26,1212,1209,3,2700,2300,400,0.926147715808782,0.640394088669951,1.75674278093787,770,376,394,-1,1,69.02,5.8,0,0,0,0,0,0,0.00402499403365573,2.39063560291262,0.412420389130954
8.7,"eps_greedy_SVM","SVM",89,27,1112,1110,2,2800,2399,401,0.926302271405238,0.640394088669951,1.75351347435526,775,380,395,5,1,71.57,6,0,0,0,0,0,0,0.00333473831736371,1.88580833963803,0.368387649817119
8.7,"eps_greedy_SVM","SVM",89,28,1012,1011,1,2900,2498,402,0.926594521987633,0.645320197044335,1.75029601843901,779,384,395,4,1,74.13,6.2,0,0,0,0,0,0,0.00340985416712616,1.71185230560049,0.360292206143498
8.7,"eps_greedy_SVM","SVM",89,29,912,912,0,3000,2597,403,0.926892392773536,0.640394088669951,1.75512664222495,788,387,401,9,1,76.69,6.4,0,0,0,0,0,0,0.0025038448710051,1.15129051503457,0.27929678992081
8.7,"eps_greedy_SVM","SVM",89,30,812,812,0,3100,2697,403,0.927055378675256,0.640394088669951,1.75190326914465,787,387,400,-1,1,79.24,6.7,0,0,0,0,0,0,0.00227313146721101,0.923627691264191,0.24634275192829
8.7,"eps_greedy_SVM","SVM",89,31,712,712,0,3200,2797,403,0.927138276676993,0.640394088669951,1.75029601843901,788,389,399,1,1,81.8,6.9,0,0,0,0,0,0,0.00199641231943932,0.721884104894017,0.219816645776772
8.7,"eps_greedy_SVM","SVM",89,32,612,612,0,3300,2897,403,0.927266136306791,0.645320197044335,1.75836189870832,788,389,399,0,1,84.36,7.2,0,0,0,0,0,0,0.00123653884208687,0.396549181824712,0.143069659602053
8.7,"eps_greedy_SVM","SVM",89,33,512,512,0,3400,2997,403,0.927458628276925,0.645320197044335,1.75029601843901,788,389,399,0,1,86.91,7.4,0,0,0,0,0,0,0.00088910036363636,0.280994702309441,0.112275860586331
8.7,"eps_greedy_SVM","SVM",89,34,412,412,0,3500,3097,403,0.927725587943535,0.645320197044335,1.75674278093787,791,389,402,3,1,89.47,7.7,0,0,0,0,0,0,0.000538209470023781,0.163181626658908,0.0693992158542632
8.7,"eps_greedy_SVM","SVM",89,35,312,312,0,3600,3197,403,0.928269342632896,0.645320197044335,1.74709034807557,794,391,403,3,1,92.02,7.9,0,0,0,0,0,0,0.000333148439729181,0.0854083069258234,0.0415346983001319
8.7,"eps_greedy_SVM","SVM",89,36,212,212,0,3700,3297,403,0.92889318522224,0.645320197044335,1.74549191225848,798,391,407,4,1,94.58,8.2,0,0,0,0,0,0,0.000176126705881586,0.0373760865685345,0.0231102177678921
8.7,"eps_greedy_SVM","SVM",89,37,112,112,0,3800,3397,403,0.929376522723898,0.645320197044335,1.74869171411414,801,393,408,3,1,97.14,8.4,0,0,0,0,0,0,9.66825997645665e-05,0.0154552766861971,0.0144527143813877
8.7,"eps_greedy_SVM","SVM",89,38,12,12,0,3900,3497,403,0.929605546016833,0.645320197044335,1.75674278093787,806,393,413,5,1.1,99.69,8.7,0,0,0,0,0,0,5.79428842564255e-05,0.000812597199441244,0.000812597199441244
8.7,"eps_greedy_SVM","SVM",89,39,0,0,0,3912,3509,403,0.929761506664169,0.645320197044335,1.74709034807557,808,393,415,2,1.1,100,8.7,0,0,0,0,0,0,0,0,0
8.7,"eps_greedy_SVM","SVM",90,0,3812,3389,423,100,92,8,0.851996470682594,0.434285714285714,1.67914680710994,30,8,22,0,2.8,2.56,11.5,0,0,0,0,0,0,0.123317696028822,317.096119108566,13.8259288988648
8.7,"eps_greedy_SVM","SVM",90,1,3712,3343,369,200,138,62,0.924689179433705,0.565714285714286,1.7739868938401,113,54,59,83,1.1,5.11,2.2,0,0,0,0,0,0,0.669509189247948,439.413966763134,72.8483828584206
8.7,"eps_greedy_SVM","SVM",90,2,3612,3308,304,300,173,127,0.925675784069937,0.565714285714286,1.78916546195295,180,90,90,67,1,7.67,1.4,0,0,0,0,0,0,0.637574268340158,355.380382380567,70.1505048924465
8.7,"eps_greedy_SVM","SVM",90,3,3512,3282,230,400,199,201,0.927358626774684,0.571428571428571,1.79449541284404,235,120,115,55,1,10.22,1,0,0,0,0,0,0,0.563266555735843,278.99963110565,67.3186478657088
8.7,"eps_greedy_SVM","SVM",90,4,3412,3241,171,500,240,260,0.917600064169407,0.56,1.74964483030781,304,152,152,69,1,12.78,0.9,0,0,0,0,0,0,0.423633065622819,283.221622462118,54.5078132407687
8.7,"eps_greedy_SVM","SVM",90,5,3312,3182,130,600,299,301,0.909206705703051,0.594285714285714,1.71560924369748,404,204,200,100,1,15.34,1,0,0,0,0,0,0,0.237797726174206,156.089167781354,32.8601607885028
8.7,"eps_greedy_SVM","SVM",90,6,3212,3112,100,700,369,331,0.900741156653546,0.605714285714286,1.68789265982636,480,236,244,76,1,17.89,1.1,0,0,0,0,0,0,0.130500516987244,102.02131615498,19.9836755372149
8.7,"eps_greedy_SVM","SVM",90,7,3112,3036,76,800,445,355,0.897928932381479,0.611428571428571,1.67914680710994,538,262,276,58,1.1,20.45,1.3,0,0,0,0,0,0,0.0864014368483625,91.8481085750659,13.5401322167502
8.7,"eps_greedy_SVM","SVM",90,8,3012,2953,59,900,528,372,0.901198363680112,0.622857142857143,1.66424369747899,583,279,304,45,1.1,23.01,1.4,0,0,0,0,0,0,0.0689550785615704,87.6177940109251,8.32574749206183
8.7,"eps_greedy_SVM","SVM",90,9,2912,2859,53,1000,622,378,0.903500441164663,0.617142857142857,1.66730860299921,592,286,306,9,1.1,25.56,1.6,0,0,0,0,0,0,0.0538953768449587,75.1080151431191,6.15170651616579
8.7,"eps_greedy_SVM","SVM",90,10,2812,2763,49,1100,718,382,0.910158017165314,0.617142857142857,1.68169855832241,608,295,313,16,1.1,28.12,1.9,0,0,0,0,0,0,0.0487870428992747,68.2087757987626,5.41176351781534
8.7,"eps_greedy_SVM","SVM",90,11,2712,2667,45,1200,814,386,0.916772278816073,0.622857142857143,1.70690498094362,622,302,320,14,1.1,30.67,2.1,0,0,0,0,0,0,0.0421507440967036,58.5610892537021,4.7027942938648
8.7,"eps_greedy_SVM","SVM",90,12,2612,2574,38,1300,907,393,0.926019090398659,0.617142857142857,1.71718754106979,640,313,327,18,1,33.23,2.3,0,0,0,0,0,0,0.0452585566076532,55.9240818891842,5.49982086767352
8.7,"eps_greedy_SVM","SVM",90,13,2512,2481,31,1400,1000,400,0.933456324697205,0.605714285714286,1.76155892034233,678,328,350,38,1.1,35.79,2.5,0,0,0,0,0,0,0.0517168559459038,51.4216589255629,5.83038035895967
8.7,"eps_greedy_SVM","SVM",90,14,2412,2382,30,1500,1099,401,0.933895885136765,0.605714285714286,1.75993685872139,682,329,353,4,1.1,38.34,2.7,0,0,0,0,0,0,0.0372892239167837,36.6826610149431,4.15674421453311
8.7,"eps_greedy_SVM","SVM",90,15,2312,2284,28,1600,1197,403,0.933331194353095,0.605714285714286,1.75670168067227,685,330,355,3,1.1,40.9,3,0,0,0,0,0,0,0.0334325255513439,31.3169575720418,3.70849971978165
8.7,"eps_greedy_SVM","SVM",90,16,2212,2188,24,1700,1293,407,0.9318039624609,0.605714285714286,1.75831778157445,697,336,361,12,1.1,43.46,3.2,0,0,0,0,0,0,0.0362369724232345,30.1267102496475,4.28924869530367
8.7,"eps_greedy_SVM","SVM",90,17,2112,2098,14,1800,1383,417,0.927745247453277,0.594285714285714,1.75993685872139,725,347,378,28,1.1,46.01,3.3,0,0,0,0,0,0,0.0364348627411154,30.6360268001898,5.28306143909715
8.7,"eps_greedy_SVM","SVM",90,18,2012,2002,10,1900,1479,421,0.927121199967916,0.588571428571429,1.75347837483617,730,352,378,5,1.1,48.57,3.5,0,0,0,0,0,0,0.0291803409100134,25.7375289419571,3.37977726227077
8.7,"eps_greedy_SVM","SVM",90,19,1912,1902,10,2000,1579,421,0.927334563246972,0.588571428571429,1.75670168067227,738,353,385,8,1.1,51.12,3.8,0,0,0,0,0,0,0.0208885997559007,19.2181204365787,2.30565951344867
8.7,"eps_greedy_SVM","SVM",90,20,1812,1802,10,2100,1679,421,0.927170931258522,0.588571428571429,1.75508854781582,740,355,385,2,1.1,53.68,4,0,0,0,0,0,0,0.0172491073299129,15.8394419055229,1.86300123916644
8.7,"eps_greedy_SVM","SVM",90,21,1712,1703,9,2200,1778,422,0.927607283227718,0.588571428571429,1.75026687598116,748,359,389,8,1.1,56.24,4.2,0,0,0,0,0,0,0.0157342018812784,13.0495983747467,1.60256426697548
8.7,"eps_greedy_SVM","SVM",90,22,1612,1604,8,2300,1877,423,0.928757519852411,0.6,1.79081294396212,766,373,393,18,1.1,58.79,4.4,0,0,0,0,0,0,0.011136222080644,7.3052810638062,1.42257800910946
8.7,"eps_greedy_SVM","SVM",90,23,1512,1504,8,2400,1977,423,0.928868212079891,0.6,1.78916546195295,765,373,392,-1,1.1,61.35,4.7,0,0,0,0,0,0,0.00758379924786614,5.56608030289373,0.844492378127971
8.7,"eps_greedy_SVM","SVM",90,24,1412,1404,8,2500,2077,423,0.928964466190743,0.6,1.79246346280448,775,377,398,10,1.1,63.91,4.9,0,0,0,0,0,0,0.00588724131741387,3.93461765102412,0.618720525969003
8.7,"eps_greedy_SVM","SVM",90,25,1312,1304,8,2600,2177,423,0.931271356380842,0.594285714285714,1.78052091554854,777,379,398,2,1.1,66.46,5.1,0,0,0,0,0,0,0.00462312033335863,2.94972109203442,0.525768859786857
8.7,"eps_greedy_SVM","SVM",90,26,1212,1205,7,2700,2276,424,0.93167081094088,0.594285714285714,1.78752100840336,780,382,398,3,1,69.02,5.4,0,0,0,0,0,0,0.00463412862347561,2.47470708787827,0.474672900885418
8.7,"eps_greedy_SVM","SVM",90,27,1112,1106,6,2800,2375,425,0.933190021657172,0.594285714285714,1.78052091554854,795,389,406,15,1,71.57,5.6,0,0,0,0,0,0,0.003684093104427,1.8847779939944,0.416320302165859
8.7,"eps_greedy_SVM","SVM",90,28,1012,1006,6,2900,2475,425,0.933315152001281,0.594285714285714,1.78587957497048,796,389,407,1,1,74.13,5.8,0,0,0,0,0,0,0.00342105525293074,1.49304928605321,0.360906099498015
8.7,"eps_greedy_SVM","SVM",90,29,912,906,6,3000,2575,425,0.933207668244162,0.594285714285714,1.78052091554854,796,390,406,0,1,76.69,6.1,0,0,0,0,0,0,0.00257417440514085,0.974668828718207,0.282213244245931
8.7,"eps_greedy_SVM","SVM",90,30,812,807,5,3100,2674,426,0.933417823052857,0.594285714285714,1.77724789915966,797,391,406,1,1,79.24,6.3,0,0,0,0,0,0,0.00253912597379397,0.857807225717277,0.277368549186246
8.7,"eps_greedy_SVM","SVM",90,31,712,708,4,3200,2773,427,0.933623165156009,0.594285714285714,1.77888290182678,800,392,408,3,1,81.8,6.5,0,0,0,0,0,0,0.00183262632939479,0.581522783967137,0.21492406926574
8.7,"eps_greedy_SVM","SVM",90,32,612,608,4,3300,2873,427,0.933748295500118,0.6,1.77888290182678,800,392,408,0,1,84.36,6.7,0,0,0,0,0,0,0.00112591765981463,0.33957809953906,0.143571915754097
8.7,"eps_greedy_SVM","SVM",90,33,512,509,3,3400,2972,428,0.934239191465467,0.6,1.77724789915966,806,397,409,6,1,86.91,6.9,0,0,0,0,0,0,0.000856385484649036,0.265228897622338,0.112496100220668
8.7,"eps_greedy_SVM","SVM",90,34,412,411,1,3500,3070,430,0.93486805165637,0.6,1.79246346280448,816,402,414,10,1,89.47,7.1,0,0,0,0,0,0,0.00081580475888284,0.245807301463073,0.102296587825684
8.7,"eps_greedy_SVM","SVM",90,35,312,312,0,3600,3169,431,0.935272318921952,0.594285714285714,1.79081294396212,828,406,422,12,1,92.02,7.4,0,0,0,0,0,0,0.000708428433931369,0.177176633966626,0.0847367289742405
8.7,"eps_greedy_SVM","SVM",90,36,212,212,0,3700,3269,431,0.935528996550892,0.594285714285714,1.79246346280448,830,406,424,2,1,94.58,7.6,0,0,0,0,0,0,0.000379368018042171,0.0781812622394744,0.0487184130009405
8.7,"eps_greedy_SVM","SVM",90,37,112,112,0,3800,3369,431,0.935723109007778,0.594285714285714,1.78752100840336,831,408,423,1,1,97.14,7.8,0,0,0,0,0,0,0.000204523797391424,0.0315294276624919,0.0293225257213333
8.7,"eps_greedy_SVM","SVM",90,38,12,12,0,3900,3469,431,0.935753589476214,0.588571428571429,1.78916546195295,833,410,423,2,1,99.69,8,0,0,0,0,0,0,0.000149728229237735,0.00208614325617875,0.00208614325617875
8.7,"eps_greedy_SVM","SVM",90,39,0,0,0,3912,3481,431,0.935729525948501,0.588571428571429,1.78752100840336,834,411,423,1,1,100,8.1,0,0,0,0,0,0,0,0,0
8.7,"eps_greedy_SVM","SVM",91,0,3812,3423,389,100,92,8,0.887984323091124,0.478468899521531,1.76015100302884,27,8,19,0,2.4,2.56,11.5,0,0,0,0,0,0,0.452058282978407,329.54582200873,59.232383971786
8.7,"eps_greedy_SVM","SVM",91,1,3712,3364,348,200,151,49,0.91031515407136,0.564593301435407,1.76873710548264,104,49,55,77,1.1,5.11,3.1,0,0,0,0,0,0,0.764010233033876,443.95019928789,81.8488729736903
8.7,"eps_greedy_SVM","SVM",91,2,3612,3340,272,300,175,125,0.910457571831936,0.583732057416268,1.74238528873503,152,78,74,48,0.9,7.67,1.4,0,0,0,0,0,0,0.636885104530107,283.808960887119,72.3755285365975
8.7,"eps_greedy_SVM","SVM",91,3,3512,3302,210,400,213,187,0.905996061601158,0.559808612440191,1.74939860953237,222,111,111,70,1,10.22,1.1,0,0,0,0,0,0,0.469195307671113,218.816349825916,62.4921852570615
8.7,"eps_greedy_SVM","SVM",91,4,3412,3254,158,500,261,239,0.884601901277096,0.569377990430622,1.72354542811071,307,153,154,85,1,12.78,1.1,0,0,0,0,0,0,0.29051459265269,153.014293942849,41.0450769884221
8.7,"eps_greedy_SVM","SVM",91,5,3312,3187,125,600,328,272,0.878643635158562,0.598086124401914,1.64447163740245,379,187,192,72,1,15.34,1.2,0,0,0,0,0,0,0.140629388132835,81.476809541931,21.3200521325206
8.7,"eps_greedy_SVM","SVM",91,6,3212,3115,97,700,400,300,0.877186591915606,0.607655502392344,1.64447163740245,444,218,226,65,1,17.89,1.3,0,0,0,0,0,0,0.0893378039023743,72.0123871680342,12.686754732581
8.7,"eps_greedy_SVM","SVM",91,7,3112,3044,68,800,471,329,0.872308783615375,0.631578947368421,1.61003244080763,511,248,263,67,1.1,20.45,1.4,0,0,0,0,0,0,0.0901939321235368,107.595918704421,13.787809300435
8.7,"eps_greedy_SVM","SVM",91,8,3012,2951,61,900,564,336,0.878498478594884,0.631578947368421,1.63736815670517,532,259,273,21,1.1,23.01,1.7,0,0,0,0,0,0,0.0610672254300364,75.1499733782009,7.73385536598764
8.7,"eps_greedy_SVM","SVM",91,9,2912,2858,54,1000,657,343,0.887689901759132,0.641148325358852,1.63736815670517,555,266,289,23,1.1,25.56,1.9,0,0,0,0,0,0,0.0459399098129651,62.0627079272514,5.46448130357494
8.7,"eps_greedy_SVM","SVM",91,10,2812,2767,45,1100,748,352,0.900959402721822,0.645933014354067,1.66322133812683,574,276,298,19,1.1,28.12,2.1,0,0,0,0,0,0,0.0453511398025798,66.6073108385185,5.16358758172739
8.7,"eps_greedy_SVM","SVM",91,11,2712,2673,39,1200,842,358,0.909961848472968,0.641148325358852,1.67891083399726,594,288,306,20,1.1,30.67,2.4,0,0,0,0,0,0,0.0582146575257657,68.0217353070594,6.70426825251099
8.7,"eps_greedy_SVM","SVM",91,12,2612,2579,33,1300,936,364,0.918747928780155,0.641148325358852,1.72195982974078,621,301,320,27,1.1,33.23,2.6,0,0,0,0,0,0,0.0540843498314697,55.0125781702767,6.0381039203812
8.7,"eps_greedy_SVM","SVM",91,13,2512,2485,27,1400,1030,370,0.923171095767725,0.645933014354067,1.74238528873503,640,309,331,19,1.1,35.79,2.8,0,0,0,0,0,0,0.0564426575260556,49.8401670268797,6.08969935935429
8.7,"eps_greedy_SVM","SVM",91,14,2412,2387,25,1500,1128,372,0.923732550400821,0.645933014354067,1.75101095848125,644,312,332,4,1.1,38.34,3,0,0,0,0,0,0,0.046613029526383,40.9423510684268,5.1565088502649
8.7,"eps_greedy_SVM","SVM",91,15,2312,2288,24,1600,1227,373,0.924378907929653,0.645933014354067,1.74939860953237,649,313,336,5,1.1,40.9,3.3,0,0,0,0,0,0,0.0375776277120609,34.2713273738735,4.26111971810456
8.7,"eps_greedy_SVM","SVM",91,16,2212,2197,15,1700,1318,382,0.925266280130247,0.645933014354067,1.75101095848125,673,324,349,24,1.1,43.46,3.5,0,0,0,0,0,0,0.039066806452736,36.8558078231033,5.03735081208436
8.7,"eps_greedy_SVM","SVM",91,17,2112,2100,12,1800,1415,385,0.925096474338772,0.645933014354067,1.7445793296163,686,328,358,13,1.1,46.01,3.7,0,0,0,0,0,0,0.0296570266148512,28.5619931741726,3.36631333119489
8.7,"eps_greedy_SVM","SVM",91,18,2012,2001,11,1900,1514,386,0.924819855226854,0.645933014354067,1.7445793296163,688,331,357,2,1.1,48.57,3.9,0,0,0,0,0,0,0.0233017694034151,22.4824694968267,2.5463323628156
8.7,"eps_greedy_SVM","SVM",91,19,1912,1902,10,2000,1613,387,0.925074563914065,0.645933014354067,1.75101095848125,688,334,354,0,1.1,51.12,4.2,0,0,0,0,0,0,0.0206145141255626,19.5965498016463,2.2039214717418
8.7,"eps_greedy_SVM","SVM",91,20,1812,1803,9,2100,1712,388,0.924740429937296,0.645933014354067,1.75101095848125,695,336,359,7,1.1,53.68,4.4,0,0,0,0,0,0,0.0163309935498008,15.5803263332007,1.7721833126389
8.7,"eps_greedy_SVM","SVM",91,21,1712,1703,9,2200,1812,388,0.924302221443173,0.645933014354067,1.75101095848125,695,337,358,0,1.1,56.24,4.7,0,0,0,0,0,0,0.015289398919934,14.700055169352,1.62306040451185
8.7,"eps_greedy_SVM","SVM",91,22,1612,1605,7,2300,1910,390,0.925400481481574,0.645933014354067,1.7563990263356,701,340,361,6,1.1,58.79,4.9,0,0,0,0,0,0,0.0128892889270333,11.4668322532141,1.32091542933757
8.7,"eps_greedy_SVM","SVM",91,23,1512,1505,7,2400,2010,390,0.924117352234723,0.636363636363636,1.74939860953237,717,350,367,16,1,61.35,5.2,0,0,0,0,0,0,0.00968914383402182,7.59256916937392,1.14881172162119
8.7,"eps_greedy_SVM","SVM",91,24,1412,1406,6,2500,2109,391,0.92390235619229,0.631578947368421,1.74778922718689,723,351,372,6,1.1,63.91,5.4,0,0,0,0,0,0,0.00730450169418362,5.52152175326201,0.765151153850079
8.7,"eps_greedy_SVM","SVM",91,25,1312,1306,6,2600,2209,391,0.923317621732943,0.62200956937799,1.74939860953237,725,353,372,2,1.1,66.46,5.6,0,0,0,0,0,0,0.00570513394793732,3.90220911757391,0.612319247827712
8.7,"eps_greedy_SVM","SVM",91,26,1212,1206,6,2700,2309,391,0.923361442582357,0.62200956937799,1.74939860953237,730,354,376,5,1.1,69.02,5.9,0,0,0,0,0,0,0.00531554785774548,3.13541469611931,0.538806924718663
8.7,"eps_greedy_SVM","SVM",91,27,1112,1107,5,2800,2408,392,0.923864012949059,0.617224880382775,1.75101095848125,740,362,378,10,1,71.57,6.1,0,0,0,0,0,0,0.00394643321096776,2.16722543902153,0.461684376145699
8.7,"eps_greedy_SVM","SVM",91,28,1012,1008,4,2900,2507,393,0.924032449338989,0.617224880382775,1.74618280326485,745,364,381,5,1,74.13,6.4,0,0,0,0,0,0,0.00402951240657718,1.81343425544844,0.408244819085558
8.7,"eps_greedy_SVM","SVM",91,29,912,908,4,3000,2607,393,0.924458333219212,0.61244019138756,1.74778922718689,759,370,389,14,1.1,76.69,6.6,0,0,0,0,0,0,0.00299156220474373,1.26276576971796,0.350440126836797
8.7,"eps_greedy_SVM","SVM",91,30,812,809,3,3100,2706,394,0.924617183798331,0.61244019138756,1.74939860953237,760,371,389,1,1,79.24,6.9,0,0,0,0,0,0,0.00245964815136347,0.888973226596292,0.267652116947775
8.7,"eps_greedy_SVM","SVM",91,31,712,710,2,3200,2805,395,0.92454734431958,0.61244019138756,1.74939860953237,764,376,388,4,1,81.8,7.1,0,0,0,0,0,0,0.00231160305766348,0.768582093800952,0.26064940019363
8.7,"eps_greedy_SVM","SVM",91,32,612,610,2,3300,2905,395,0.924611706192154,0.61244019138756,1.75101095848125,765,376,389,1,1,84.36,7.4,0,0,0,0,0,0,0.00167913964139697,0.494024883646555,0.197095309409915
8.7,"eps_greedy_SVM","SVM",91,33,512,510,2,3400,3005,395,0.924849982060832,0.61244019138756,1.74939860953237,764,376,388,-1,1,86.91,7.6,0,0,0,0,0,0,0.000788113367326149,0.250066469853779,0.111415532010401
8.7,"eps_greedy_SVM","SVM",91,34,412,412,0,3500,3103,397,0.924978705805983,0.61244019138756,1.7563990263356,770,377,393,6,1,89.47,7.8,0,0,0,0,0,0,0.000741162665464469,0.239195947934596,0.0995453103420454
8.7,"eps_greedy_SVM","SVM",91,35,312,312,0,3600,3203,397,0.925295037562672,0.61244019138756,1.75801633667292,774,379,395,4,1,92.02,8.1,0,0,0,0,0,0,0.000688841022047222,0.179573596464359,0.0811410954030496
8.7,"eps_greedy_SVM","SVM",91,36,212,212,0,3700,3303,397,0.925522358218996,0.61244019138756,1.75801633667292,779,383,396,5,1,94.58,8.3,0,0,0,0,0,0,0.000368044536653109,0.0742898200471746,0.0449612166048662
8.7,"eps_greedy_SVM","SVM",91,37,112,112,0,3800,3403,397,0.925379940458405,0.61244019138756,1.75801633667292,781,383,398,2,1,97.14,8.6,0,0,0,0,0,0,0.000140176843964445,0.0248947166007225,0.0233754903636148
8.7,"eps_greedy_SVM","SVM",91,38,12,12,0,3900,3503,397,0.925545638045245,0.607655502392344,1.75801633667292,782,383,399,1,1,99.69,8.8,0,0,0,0,0,0,8.91585967164023e-05,0.00124645496988529,0.00124645496988529
8.7,"eps_greedy_SVM","SVM",91,39,0,0,0,3912,3515,397,0.925545638045244,0.607655502392344,1.7563990263356,782,383,399,0,1,100,8.9,0,0,0,0,0,0,0,0,0
8.7,"eps_greedy_SVM","SVM",92,0,3812,3415,397,100,87,13,0.908395176252323,0.556122448979592,1.74275960384154,31,13,18,0,1.4,2.56,6.7,0,0,0,0,0,0,0.798974249196387,597.290102958624,82.8880234708005
8.7,"eps_greedy_SVM","SVM",92,1,3712,3382,330,200,120,80,0.908954661410008,0.581632653061224,1.76272459305709,91,45,46,60,1,5.11,1.5,0,0,0,0,0,0,0.718453278269508,374.288497175322,78.207988219213
8.7,"eps_greedy_SVM","SVM",92,2,3612,3339,273,300,163,137,0.877936572356222,0.591836734693878,1.61434573829532,158,80,78,67,1,7.67,1.2,0,0,0,0,0,0,0.520636519877205,293.761553541489,62.3554121982784
8.7,"eps_greedy_SVM","SVM",92,3,3512,3302,210,400,200,200,0.883354591836732,0.596938775510204,1.6968975090036,231,117,114,73,1,10.22,1,0,0,0,0,0,0,0.402432265727933,254.103632752529,53.0704895366988
8.7,"eps_greedy_SVM","SVM",92,4,3412,3249,163,500,253,247,0.902110389610392,0.612244897959184,1.72759048370729,322,162,160,91,1,12.78,1,0,0,0,0,0,0,0.311569718535334,217.164752771167,42.3284828341249
8.7,"eps_greedy_SVM","SVM",92,5,3312,3180,132,600,322,278,0.895908221243038,0.607142857142857,1.66020783313325,400,197,203,78,1,15.34,1.2,0,0,0,0,0,0,0.15720781304339,107.510559548405,21.6900432776837
8.7,"eps_greedy_SVM","SVM",92,6,3212,3117,95,700,385,315,0.891474373840443,0.658163265306122,1.63269057623049,481,237,244,81,1,17.89,1.2,0,0,0,0,0,0,0.118542426017395,128.08188711459,17.513078148444
8.7,"eps_greedy_SVM","SVM",92,7,3112,3040,72,800,462,338,0.891146799628933,0.653061224489796,1.63419259148001,545,263,282,64,1.1,20.45,1.4,0,0,0,0,0,0,0.0795563969070986,98.1124641741822,11.667715983592
8.7,"eps_greedy_SVM","SVM",92,8,3012,2949,63,900,553,347,0.896619897959174,0.653061224489796,1.63720492805417,565,271,294,20,1.1,23.01,1.6,0,0,0,0,0,0,0.058919092413592,72.0173900988027,6.99848876732787
8.7,"eps_greedy_SVM","SVM",92,9,2912,2855,57,1000,647,353,0.902353896103886,0.642857142857143,1.6540759950389,577,277,300,12,1.1,25.56,1.8,0,0,0,0,0,0,0.0442551624793811,60.89143700325,5.01502083202133
8.7,"eps_greedy_SVM","SVM",92,10,2812,2763,49,1100,739,361,0.912908743042678,0.647959183673469,1.6831938305276,600,287,313,23,1.1,28.12,2,0,0,0,0,0,0,0.0556855051535743,77.231082912486,6.26658052428537
8.7,"eps_greedy_SVM","SVM",92,11,2712,2672,40,1200,830,370,0.925366709183681,0.647959183673469,1.73677979479084,636,305,331,36,1.1,30.67,2.2,0,0,0,0,0,0,0.0707212303920396,79.5627838961911,8.08394286533563
8.7,"eps_greedy_SVM","SVM",92,12,2612,2579,33,1300,923,377,0.925542091836745,0.63265306122449,1.74757829399041,652,312,340,16,1.1,33.23,2.4,0,0,0,0,0,0,0.0687233301403652,63.4238838117202,7.56114769210293
8.7,"eps_greedy_SVM","SVM",92,13,2512,2481,31,1400,1021,379,0.924994202226352,0.63265306122449,1.74436287854608,663,319,344,11,1.1,35.79,2.7,0,0,0,0,0,0,0.0601174236318685,49.7356498786221,6.41742903832274
8.7,"eps_greedy_SVM","SVM",92,14,2412,2384,28,1500,1118,382,0.923962198515776,0.63265306122449,1.74757829399041,672,322,350,9,1.1,38.34,2.9,0,0,0,0,0,0,0.0491160706983242,38.6614945108839,5.60086368523425
8.7,"eps_greedy_SVM","SVM",92,15,2312,2287,25,1600,1215,385,0.923295454545462,0.63265306122449,1.74757829399041,682,328,354,10,1.1,40.9,3.2,0,0,0,0,0,0,0.0386935747962008,32.2096471086014,4.53947005677945
8.7,"eps_greedy_SVM","SVM",92,16,2212,2193,19,1700,1309,391,0.922779452690175,0.627551020408163,1.74596910587439,696,334,362,14,1.1,43.46,3.3,0,0,0,0,0,0,0.0333580888449566,31.1035429555258,3.99148592133961
8.7,"eps_greedy_SVM","SVM",92,17,2112,2095,17,1800,1407,393,0.921573515769949,0.622448979591837,1.73358718487395,699,336,363,3,1.1,46.01,3.6,0,0,0,0,0,0,0.0270247779468773,27.1732679249424,2.98446515643106
8.7,"eps_greedy_SVM","SVM",92,18,2012,1996,16,1900,1506,394,0.921648886827462,0.622448979591837,1.73838051349572,701,339,362,2,1.1,48.57,3.8,0,0,0,0,0,0,0.0206741251137698,20.7185327913211,2.26029484467338
8.7,"eps_greedy_SVM","SVM",92,19,1912,1898,14,2000,1604,396,0.923249072356222,0.627551020408163,1.74757829399041,704,342,362,3,1.1,51.12,4.1,0,0,0,0,0,0,0.0177934461295318,18.6285767591876,1.98584225652266
8.7,"eps_greedy_SVM","SVM",92,20,1812,1802,10,2100,1700,400,0.925327574211508,0.61734693877551,1.74757829399041,718,348,370,14,1.1,53.68,4.2,0,0,0,0,0,0,0.0185820084232905,18.5877589232324,1.89244401591025
8.7,"eps_greedy_SVM","SVM",92,21,1712,1704,8,2200,1798,402,0.92483766233766,0.612244897959184,1.76272459305709,751,364,387,33,1.1,56.24,4.5,0,0,0,0,0,0,0.0129638472145454,8.90731218681713,1.68787003624317
8.7,"eps_greedy_SVM","SVM",92,22,1612,1607,5,2300,1895,405,0.924721706864565,0.607142857142857,1.76272459305709,756,367,389,5,1.1,58.79,4.7,0,0,0,0,0,0,0.00954826875882049,7.74531966637051,1.14817807073472
8.7,"eps_greedy_SVM","SVM",92,23,1512,1507,5,2400,1995,405,0.924598504174398,0.607142857142857,1.76110444177671,758,367,391,2,1.1,61.35,4.9,0,0,0,0,0,0,0.00688383733418393,5.85907525720885,0.763337895482039
8.7,"eps_greedy_SVM","SVM",92,24,1412,1407,5,2500,2095,405,0.924388334879407,0.607142857142857,1.75948726598077,764,369,395,6,1.1,63.91,5.2,0,0,0,0,0,0,0.00607489726320974,4.86579116179106,0.634209236968217
8.7,"eps_greedy_SVM","SVM",92,25,1312,1307,5,2600,2195,405,0.923962198515775,0.607142857142857,1.75787305747987,769,372,397,5,1.1,66.46,5.4,0,0,0,0,0,0,0.00461912970189218,3.42395187707007,0.501799654119794
8.7,"eps_greedy_SVM","SVM",92,26,1212,1207,5,2700,2295,405,0.923975243506499,0.607142857142857,1.76110444177671,771,373,398,2,1.1,69.02,5.7,0,0,0,0,0,0,0.003744886449437,2.44205316180459,0.380288864237932
8.7,"eps_greedy_SVM","SVM",92,27,1112,1107,5,2800,2395,405,0.923853490259749,0.61734693877551,1.76110444177671,774,378,396,3,1,71.57,5.9,0,0,0,0,0,0,0.00313433339602482,1.87811530194931,0.358727896097826
8.7,"eps_greedy_SVM","SVM",92,28,1012,1009,3,2900,2493,407,0.923820153061234,0.612244897959184,1.76272459305709,783,380,403,9,1.1,74.13,6.1,0,0,0,0,0,0,0.00324524555197759,1.71658281732707,0.333526356770878
8.7,"eps_greedy_SVM","SVM",92,29,912,909,3,3000,2593,407,0.923367926716149,0.607142857142857,1.76434772804149,789,384,405,6,1.1,76.69,6.4,0,0,0,0,0,0,0.00251886304080219,1.18960108411777,0.284817091337214
8.7,"eps_greedy_SVM","SVM",92,30,812,809,3,3100,2693,407,0.923591141001862,0.607142857142857,1.76434772804149,789,384,405,0,1.1,79.24,6.6,0,0,0,0,0,0,0.00208581423564448,0.820579653232844,0.221202745709268
8.7,"eps_greedy_SVM","SVM",92,31,712,709,3,3200,2793,407,0.924431818181805,0.612244897959184,1.76597385497978,794,387,407,5,1.1,81.8,6.9,0,0,0,0,0,0,0.00167352968580144,0.578543226756949,0.187601427789908
8.7,"eps_greedy_SVM","SVM",92,32,612,610,2,3300,2892,408,0.925026089981432,0.607142857142857,1.76597385497978,797,389,408,3,1,84.36,7.1,0,0,0,0,0,0,0.00140963536662589,0.444654583281488,0.164707429504635
8.7,"eps_greedy_SVM","SVM",92,33,512,511,1,3400,2991,409,0.925497159090893,0.612244897959184,1.76434772804149,801,390,411,4,1.1,86.91,7.3,0,0,0,0,0,0,0.000982957455832346,0.307860249421522,0.122120836633636
8.7,"eps_greedy_SVM","SVM",92,34,412,412,0,3500,3090,410,0.925850823283842,0.612244897959184,1.75787305747987,806,393,413,5,1.1,89.47,7.5,0,0,0,0,0,0,0.000768394175511061,0.235247917704943,0.09623878065249
8.7,"eps_greedy_SVM","SVM",92,35,312,312,0,3600,3190,410,0.926152307513895,0.612244897959184,1.75465350975555,807,395,412,1,1,92.02,7.8,0,0,0,0,0,0,0.000440548654167703,0.115342773882984,0.0546629710521489
8.7,"eps_greedy_SVM","SVM",92,36,212,212,0,3700,3290,410,0.926211734693857,0.61734693877551,1.76272459305709,808,395,413,1,1,94.58,8,0,0,0,0,0,0,0.000233886022142445,0.0484894137694422,0.0300326972875941
8.7,"eps_greedy_SVM","SVM",92,37,112,112,0,3800,3390,410,0.9263639262523,0.612244897959184,1.76110444177671,813,397,416,5,1,97.14,8.3,0,0,0,0,0,0,0.000114353531707565,0.0191763546269896,0.0179454396728234
8.7,"eps_greedy_SVM","SVM",92,38,12,12,0,3900,3490,410,0.926623376623359,0.612244897959184,1.76597385497978,817,400,417,4,1,99.69,8.5,0,0,0,0,0,0,7.56774586272422e-05,0.00116391791332905,0.00116391791332905
8.7,"eps_greedy_SVM","SVM",92,39,0,0,0,3912,3502,410,0.926701646567701,0.612244897959184,1.76597385497978,818,400,418,1,1,100,8.5,0,0,0,0,0,0,0,0,0
8.7,"eps_greedy_SVM","SVM",93,0,3812,3425,387,100,88,12,0.917208729349833,0.618357487922705,1.74729010839566,30,12,18,0,1.5,2.56,7.3,0,0,0,0,0,0,0.458904577690195,470.960141296528,50.8877196557188
8.7,"eps_greedy_SVM","SVM",93,1,3712,3406,306,200,107,93,0.914140033090005,0.608695652173913,1.72121115155394,80,41,39,50,1,5.11,1.2,0,0,0,0,0,0,0.677019664779296,358.999024339273,74.8657863986913
8.7,"eps_greedy_SVM","SVM",93,2,3612,3370,242,300,143,157,0.922165322903655,0.599033816425121,1.74248105305146,157,80,77,77,1,7.67,0.9,0,0,0,0,0,0,0.533766908278252,286.200665019023,63.2335401977127
8.7,"eps_greedy_SVM","SVM",93,3,3512,3324,188,400,189,211,0.915225539507729,0.618357487922705,1.73149705073798,247,127,120,90,0.9,10.22,0.9,0,0,0,0,0,0,0.39924011587268,242.569876449279,53.3063416228199
8.7,"eps_greedy_SVM","SVM",93,4,3412,3261,151,500,252,248,0.899221915628819,0.628019323671498,1.67774622348439,335,169,166,88,1,12.78,1,0,0,0,0,0,0,0.215745995592394,171.194283499814,27.2451334999674
8.7,"eps_greedy_SVM","SVM",93,5,3312,3188,124,600,325,275,0.882189408440438,0.642512077294686,1.65318813889556,411,203,208,76,1,15.34,1.2,0,0,0,0,0,0,0.157417574875693,122.13060799562,21.6223019036402
8.7,"eps_greedy_SVM","SVM",93,6,3212,3099,113,700,414,286,0.898517579403552,0.652173913043478,1.66905323787049,433,210,223,22,1.1,17.89,1.4,0,0,0,0,0,0,0.087831594216732,74.2729449282524,11.9643476393121
8.7,"eps_greedy_SVM","SVM",93,7,3112,3019,93,800,494,306,0.900544962891146,0.652173913043478,1.68083884325119,481,232,249,48,1.1,20.45,1.6,0,0,0,0,0,0,0.0764962488771286,80.3559950068815,9.62002531525376
8.7,"eps_greedy_SVM","SVM",93,8,3012,2936,76,900,577,323,0.90024389368114,0.671497584541063,1.66036025225658,522,252,270,41,1.1,23.01,1.8,0,0,0,0,0,0,0.0632181811116314,90.3197462247894,8.38468469067121
8.7,"eps_greedy_SVM","SVM",93,9,2912,2852,60,1000,661,339,0.892971276892529,0.666666666666667,1.65471181459961,557,267,290,35,1.1,25.56,1.9,0,0,0,0,0,0,0.0694918689522802,107.489467973038,12.299087580004
8.7,"eps_greedy_SVM","SVM",93,10,2812,2758,54,1100,755,345,0.918647784931629,0.661835748792271,1.69669308991913,598,288,310,41,1.1,28.12,2.2,0,0,0,0,0,0,0.049901627641401,53.7939717032692,6.41106005465596
8.7,"eps_greedy_SVM","SVM",93,11,2712,2668,44,1200,845,355,0.925490894727983,0.666666666666667,1.70539408012384,624,299,325,26,1.1,30.67,2.4,0,0,0,0,0,0,0.04402190962107,59.6447357052402,5.07046933567601
8.7,"eps_greedy_SVM","SVM",93,12,2612,2576,36,1300,937,363,0.931497087362578,0.657004830917874,1.75051091965538,645,308,337,21,1.1,33.23,2.6,0,0,0,0,0,0,0.0600615246074189,68.6491038957868,6.88388943292551
8.7,"eps_greedy_SVM","SVM",93,13,2512,2480,32,1400,1033,367,0.93672160489227,0.652173913043478,1.77500200176155,660,320,340,15,1.1,35.79,2.8,0,0,0,0,0,0,0.0566662208391854,57.8952164799312,6.22069406037677
8.7,"eps_greedy_SVM","SVM",93,14,2412,2381,31,1500,1132,368,0.936968813096817,0.652173913043478,1.76630101155684,675,325,350,15,1.1,38.34,3.1,0,0,0,0,0,0,0.0433604428293001,42.510753193572,4.74120343866984
8.7,"eps_greedy_SVM","SVM",93,15,2312,2283,29,1600,1230,370,0.937633098830833,0.652173913043478,1.76630101155684,678,327,351,3,1.1,40.9,3.3,0,0,0,0,0,0,0.036473172607559,36.0741487476841,4.08093726632441
8.7,"eps_greedy_SVM","SVM",93,16,2212,2185,27,1700,1328,372,0.938358150827415,0.652173913043478,1.76792893875643,688,330,358,10,1.1,43.46,3.6,0,0,0,0,0,0,0.0316515835549465,30.7974316821949,3.54012994943816
8.7,"eps_greedy_SVM","SVM",93,17,2112,2092,20,1800,1421,379,0.937710437710458,0.652173913043478,1.76305413469736,706,339,367,18,1.1,46.01,3.7,0,0,0,0,0,0,0.036903258912723,30.4523087507814,4.74440685350837
8.7,"eps_greedy_SVM","SVM",93,18,2012,1999,13,1900,1514,386,0.93539579552707,0.652173913043478,1.75659606094389,729,349,380,23,1.1,48.57,3.9,0,0,0,0,0,0,0.0286080685159514,26.846774447153,3.52565695233428
8.7,"eps_greedy_SVM","SVM",93,19,1912,1901,11,2000,1612,388,0.936519971384641,0.652173913043478,1.76524924351011,732,350,382,3,1.1,51.12,4.2,0,0,0,0,0,0,0.0233307584295872,22.2802084758969,2.52235314974205
8.7,"eps_greedy_SVM","SVM",93,20,1812,1802,10,2100,1711,389,0.936417773579409,0.657004830917874,1.77173913043478,737,351,386,5,1.1,53.68,4.4,0,0,0,0,0,0,0.0217155745302733,19.9171214664107,2.23317958665087
8.7,"eps_greedy_SVM","SVM",93,21,1712,1704,8,2200,1809,391,0.934565783622419,0.657004830917874,1.77715729291318,755,364,391,18,1.1,56.24,4.6,0,0,0,0,0,0,0.0153301291027816,12.1215952112201,1.90129659767232
8.7,"eps_greedy_SVM","SVM",93,22,1612,1605,7,2300,1908,392,0.93475360661582,0.657004830917874,1.78370299196626,757,364,393,2,1.1,58.79,4.9,0,0,0,0,0,0,0.0123576055311107,10.4650739345851,1.35489066678148
8.7,"eps_greedy_SVM","SVM",93,23,1512,1507,5,2400,2006,394,0.934919332786467,0.657004830917874,1.7820620508513,762,370,392,5,1.1,61.35,5.1,0,0,0,0,0,0,0.0124734673236519,9.70338357763985,1.26961632196533
8.7,"eps_greedy_SVM","SVM",93,24,1412,1407,5,2500,2106,394,0.934614120422186,0.652173913043478,1.78042412617221,774,378,396,12,1,63.91,5.3,0,0,0,0,0,0,0.00879254174289394,6.12089736190819,1.04999946290699
8.7,"eps_greedy_SVM","SVM",93,25,1312,1307,5,2600,2206,394,0.934654170913426,0.652173913043478,1.78534695785748,772,376,396,-2,1.1,66.46,5.6,0,0,0,0,0,0,0.00750250735326075,4.90295076829575,0.78129821748215
8.7,"eps_greedy_SVM","SVM",93,26,1212,1207,5,2700,2306,394,0.934868233883847,0.652173913043478,1.78370299196626,774,378,396,2,1,69.02,5.9,0,0,0,0,0,0,0.00593245352865685,3.37098076305637,0.6161385716135
8.7,"eps_greedy_SVM","SVM",93,27,1112,1107,5,2800,2406,394,0.93547175335529,0.652173913043478,1.78534695785748,783,380,403,9,1.1,71.57,6.1,0,0,0,0,0,0,0.00532725513698294,2.65151553997526,0.553562038619856
8.7,"eps_greedy_SVM","SVM",93,28,1012,1008,4,2900,2505,395,0.935620906908873,0.647342995169082,1.78534695785748,787,382,405,4,1.1,74.13,6.3,0,0,0,0,0,0,0.00544066344209204,2.41264032593437,0.573504385770493
8.7,"eps_greedy_SVM","SVM",93,29,912,908,4,3000,2605,395,0.935656814245847,0.647342995169082,1.7820620508513,793,384,409,6,1.1,76.69,6.6,0,0,0,0,0,0,0.00403484844975645,1.57153939412488,0.444013338044652
8.7,"eps_greedy_SVM","SVM",93,30,812,810,2,3100,2703,397,0.935589142726166,0.652173913043478,1.78370299196626,799,386,413,6,1.1,79.24,6.8,0,0,0,0,0,0,0.00358582170845608,1.30958486269342,0.40701303949089
8.7,"eps_greedy_SVM","SVM",93,31,712,710,2,3200,2803,397,0.935509041743687,0.647342995169082,1.78370299196626,799,386,413,0,1.1,81.8,7.1,0,0,0,0,0,0,0.00255856100616976,0.804598838563733,0.290259927735613
8.7,"eps_greedy_SVM","SVM",93,32,612,610,2,3300,2903,397,0.935622287960296,0.647342995169082,1.78370299196626,799,387,412,0,1.1,84.36,7.3,0,0,0,0,0,0,0.00176216090828059,0.552785487441219,0.221390539955174
8.7,"eps_greedy_SVM","SVM",93,33,512,510,2,3400,3003,397,0.935756249948236,0.642512077294686,1.78534695785748,799,388,411,0,1.1,86.91,7.6,0,0,0,0,0,0,0.000954439828310493,0.294233893431552,0.128411402734125
8.7,"eps_greedy_SVM","SVM",93,34,412,411,1,3500,3102,398,0.935524233309327,0.647342995169082,1.78534695785748,805,390,415,6,1.1,89.47,7.8,0,0,0,0,0,0,0.000661771466331776,0.191860632382961,0.0838165543870483
8.7,"eps_greedy_SVM","SVM",93,35,312,312,0,3600,3201,399,0.936068367569619,0.647342995169082,1.77878920961925,804,392,412,-1,1.1,92.02,8,0,0,0,0,0,0,0.00056453473287238,0.141681469174691,0.0706223227649009
8.7,"eps_greedy_SVM","SVM",93,36,212,212,0,3700,3301,399,0.936165041169163,0.647342995169082,1.78042412617221,808,394,414,4,1.1,94.58,8.3,0,0,0,0,0,0,0.000278066088892608,0.0582637525292112,0.0371914041286149
8.7,"eps_greedy_SVM","SVM",93,37,112,112,0,3800,3401,399,0.936243761100221,0.647342995169082,1.78370299196626,811,395,416,3,1.1,97.14,8.5,0,0,0,0,0,0,0.000108741536829562,0.0178055095769817,0.0167107449466107
8.7,"eps_greedy_SVM","SVM",93,38,12,12,0,3900,3501,399,0.936435727247888,0.647342995169082,1.78042412617221,811,396,415,0,1,99.69,8.8,0,0,0,0,0,0,7.7058262025548e-05,0.00108198348312077,0.00108198348312077
8.7,"eps_greedy_SVM","SVM",93,39,0,0,0,3912,3513,399,0.936449537762108,0.647342995169082,1.78370299196626,813,396,417,2,1.1,100,8.8,0,0,0,0,0,0,0,0,0
8.7,"eps_greedy_SVM","SVM",94,0,3812,3425,387,100,87,13,0.910846047156727,0.597087378640777,1.75254754072053,31,13,18,0,1.4,2.56,6.7,0,0,0,0,0,0,0.904025346192065,614.76774697557,92.6619801801258
8.7,"eps_greedy_SVM","SVM",94,1,3712,3399,313,200,113,87,0.905081830790575,0.606796116504854,1.72241592018452,87,46,41,56,0.9,5.11,1.3,0,0,0,0,0,0,0.663089255988101,369.013432847141,72.233942836405
8.7,"eps_greedy_SVM","SVM",94,2,3612,3362,250,300,150,150,0.911841886269069,0.631067961165049,1.72797687035979,154,79,75,67,0.9,7.67,1,0,0,0,0,0,0,0.555241585455899,272.205111655288,66.4374710065331
8.7,"eps_greedy_SVM","SVM",94,3,3512,3314,198,400,198,202,0.914138696255181,0.635922330097087,1.75900854547895,235,122,113,81,0.9,10.22,1,0,0,0,0,0,0,0.361827238150886,206.888197435058,50.5475888012897
8.7,"eps_greedy_SVM","SVM",94,4,3412,3258,154,500,254,246,0.899897364771146,0.655339805825243,1.69867284225528,331,165,166,96,1,12.78,1,0,0,0,0,0,0,0.237809108004174,164.627338660801,33.7281531678702
8.7,"eps_greedy_SVM","SVM",94,5,3312,3194,118,600,318,282,0.899675450762816,0.650485436893204,1.68899825511163,413,204,209,82,1,15.34,1.1,0,0,0,0,0,0,0.141633907325102,147.412354077764,19.7444821503776
8.7,"eps_greedy_SVM","SVM",94,6,3212,3119,93,700,393,307,0.903531206657418,0.674757281553398,1.65360006407233,475,228,247,62,1.1,17.89,1.3,0,0,0,0,0,0,0.117747986436225,156.364318084706,15.7634949980959
8.7,"eps_greedy_SVM","SVM",94,7,3112,3035,77,800,477,323,0.905042995839107,0.684466019417476,1.66121332403583,509,247,262,34,1.1,20.45,1.5,0,0,0,0,0,0,0.0920558241412338,136.031962588095,10.4426975703869
8.7,"eps_greedy_SVM","SVM",94,8,3012,2949,63,900,563,337,0.916521497919534,0.684466019417476,1.68589062262752,544,262,282,35,1.1,23.01,1.7,0,0,0,0,0,0,0.0895059737719011,148.619622115831,10.4509698739116
8.7,"eps_greedy_SVM","SVM",94,9,2912,2861,51,1000,651,349,0.924825242718442,0.684466019417476,1.70492946414204,596,286,310,52,1.1,25.56,1.9,0,0,0,0,0,0,0.0958393552928384,140.353041536661,10.397105947555
8.7,"eps_greedy_SVM","SVM",94,10,2812,2767,45,1100,745,355,0.931134535367551,0.674757281553398,1.72956654549352,616,293,323,20,1.1,28.12,2.1,0,0,0,0,0,0,0.0865879813211135,121.911670306973,9.39926485835878
8.7,"eps_greedy_SVM","SVM",94,11,2712,2675,37,1200,837,363,0.934062413314828,0.674757281553398,1.739902376227,634,302,332,18,1.1,30.67,2.3,0,0,0,0,0,0,0.0706605548525695,92.4394406479781,7.62138893758502
8.7,"eps_greedy_SVM","SVM",94,12,2612,2582,30,1300,930,370,0.935733703189991,0.674757281553398,1.75025725918303,648,310,338,14,1.1,33.23,2.5,0,0,0,0,0,0,0.0667773481072098,84.2422031161152,7.41403715541275
8.7,"eps_greedy_SVM","SVM",94,13,2512,2484,28,1400,1028,372,0.935561719833545,0.669902912621359,1.75025725918303,658,316,342,10,1.1,35.79,2.8,0,0,0,0,0,0,0.0559041942742696,66.8217662434598,5.99725005808467
8.7,"eps_greedy_SVM","SVM",94,14,2412,2388,24,1500,1124,376,0.936113730929246,0.669902912621359,1.75025725918303,672,321,351,14,1.1,38.34,3,0,0,0,0,0,0,0.0493620203353672,58.1693190555328,5.53738091722299
8.7,"eps_greedy_SVM","SVM",94,15,2312,2295,17,1600,1217,383,0.936124826629667,0.66504854368932,1.74150597288712,688,329,359,16,1.1,40.9,3.2,0,0,0,0,0,0,0.0451218172046864,54.586399048764,4.96297973855501
8.7,"eps_greedy_SVM","SVM",94,16,2212,2196,16,1700,1316,384,0.936238557558934,0.674757281553398,1.739902376227,685,329,356,-3,1.1,43.46,3.4,0,0,0,0,0,0,0.0374848102467265,44.7042359883603,3.99513848696288
8.7,"eps_greedy_SVM","SVM",94,17,2112,2097,15,1800,1415,385,0.936126213592215,0.66504854368932,1.74864560424824,691,332,359,6,1.1,46.01,3.7,0,0,0,0,0,0,0.0303112500723047,35.1462584907153,3.21961423580537
8.7,"eps_greedy_SVM","SVM",94,18,2012,1997,15,1900,1515,385,0.935789181692079,0.660194174757282,1.75025725918303,695,331,364,4,1.1,48.57,3.9,0,0,0,0,0,0,0.0265758046229468,29.4491425773596,2.79179954200603
8.7,"eps_greedy_SVM","SVM",94,19,1912,1899,13,2000,1613,387,0.936733703189997,0.660194174757282,1.74864560424824,704,337,367,9,1.1,51.12,4.2,0,0,0,0,0,0,0.0240931604412534,25.7418534736404,2.50885094157366
8.7,"eps_greedy_SVM","SVM",94,20,1812,1799,13,2100,1713,387,0.936393897364769,0.640776699029126,1.76450728378632,721,349,372,17,1.1,53.68,4.4,0,0,0,0,0,0,0.0165177996531422,13.7269771946105,1.99208662796464
8.7,"eps_greedy_SVM","SVM",94,21,1712,1701,11,2200,1811,389,0.936589459084598,0.645631067961165,1.76613206029073,723,351,372,2,1.1,56.24,4.7,0,0,0,0,0,0,0.0129298845489023,11.5050279929204,1.43322825887201
8.7,"eps_greedy_SVM","SVM",94,22,1612,1604,8,2300,1908,392,0.93740915395284,0.640776699029126,1.76775983177486,728,352,376,5,1.1,58.79,4.9,0,0,0,0,0,0,0.012670431585507,11.7905069754223,1.41556707744328
8.7,"eps_greedy_SVM","SVM",94,23,1512,1505,7,2400,2007,393,0.937936199722609,0.640776699029126,1.76288549400343,733,355,378,5,1.1,61.35,5.1,0,0,0,0,0,0,0.0126025263590235,10.6828754773139,1.29175353340323
8.7,"eps_greedy_SVM","SVM",94,24,1412,1405,7,2500,2107,393,0.936782246879333,0.631067961165049,1.77487528831197,745,362,383,12,1.1,63.91,5.4,0,0,0,0,0,0,0.0089299224723913,6.65118923828846,1.05781735585979
8.7,"eps_greedy_SVM","SVM",94,25,1312,1306,6,2600,2206,394,0.936873786407767,0.635922330097087,1.77161264991433,749,363,386,4,1.1,66.46,5.6,0,0,0,0,0,0,0.00958200319880461,6.86902812425608,0.988611617108175
8.7,"eps_greedy_SVM","SVM",94,26,1212,1207,5,2700,2305,395,0.937019417475726,0.631067961165049,1.77161264991433,760,369,391,11,1.1,69.02,5.8,0,0,0,0,0,0,0.00725904797170585,4.53906072908138,0.781735715090091
8.7,"eps_greedy_SVM","SVM",94,27,1112,1107,5,2800,2405,395,0.936955617198333,0.631067961165049,1.77161264991433,765,372,393,5,1.1,71.57,6.1,0,0,0,0,0,0,0.00615421296915515,3.31942539176955,0.632685077288786
8.7,"eps_greedy_SVM","SVM",94,28,1012,1007,5,2900,2505,395,0.936704576976415,0.631067961165049,1.78361851633321,770,374,396,5,1.1,74.13,6.3,0,0,0,0,0,0,0.00481110465830151,2.25406506931452,0.516123222540982
8.7,"eps_greedy_SVM","SVM",94,29,912,908,4,3000,2604,396,0.937126213592214,0.635922330097087,1.78361851633321,774,376,398,4,1.1,76.69,6.6,0,0,0,0,0,0,0.00433693272464711,1.74143072884484,0.454788237360959
8.7,"eps_greedy_SVM","SVM",94,30,812,808,4,3100,2704,396,0.937294036061006,0.631067961165049,1.78361851633321,777,379,398,3,1.1,79.24,6.8,0,0,0,0,0,0,0.00342079247185687,1.15029113333912,0.371455506563936
8.7,"eps_greedy_SVM","SVM",94,31,712,709,3,3200,2803,397,0.937517337031878,0.62621359223301,1.77870496670144,778,381,397,1,1,81.8,7.1,0,0,0,0,0,0,0.00268738814226014,0.843269863414924,0.321979651405634
8.7,"eps_greedy_SVM","SVM",94,32,612,611,1,3300,2901,399,0.937454923717034,0.631067961165049,1.77707312728244,785,383,402,7,1,84.36,7.3,0,0,0,0,0,0,0.00212002198114469,0.667749507596405,0.26438416471234
8.7,"eps_greedy_SVM","SVM",94,33,512,511,1,3400,3001,399,0.937428571428544,0.631067961165049,1.78033980582524,788,385,403,3,1,86.91,7.5,0,0,0,0,0,0,0.00125419423010751,0.400338522706239,0.17043323014326
8.7,"eps_greedy_SVM","SVM",94,34,412,412,0,3500,3100,400,0.937353675450738,0.631067961165049,1.77870496670144,797,388,409,9,1.1,89.47,7.8,0,0,0,0,0,0,0.000916862859913729,0.26593851320381,0.116346467856971
8.7,"eps_greedy_SVM","SVM",94,35,312,312,0,3600,3200,400,0.93743689320386,0.631067961165049,1.77707312728244,799,389,410,2,1.1,92.02,8,0,0,0,0,0,0,0.000567366117294084,0.138857084665709,0.0707292493041989
8.7,"eps_greedy_SVM","SVM",94,36,212,212,0,3700,3300,400,0.937413314840476,0.62621359223301,1.78361851633321,802,391,411,3,1.1,94.58,8.2,0,0,0,0,0,0,0.00027128286348838,0.0575300214145498,0.036595201655476
8.7,"eps_greedy_SVM","SVM",94,37,112,112,0,3800,3400,400,0.93752565880719,0.631067961165049,1.78197765293272,802,391,411,0,1.1,97.14,8.5,0,0,0,0,0,0,0.000111973402827878,0.0187501687550836,0.0176042871257309
8.7,"eps_greedy_SVM","SVM",94,38,12,12,0,3900,3500,400,0.937583911234375,0.631067961165049,1.78197765293272,804,392,412,2,1.1,99.69,8.8,0,0,0,0,0,0,7.23549619345378e-05,0.00117233890976687,0.00117233890976687
8.7,"eps_greedy_SVM","SVM",94,39,0,0,0,3912,3512,400,0.937520110956982,0.631067961165049,1.79071283750592,804,392,412,0,1.1,100,8.8,0,0,0,0,0,0,0,0,0
8.7,"eps_greedy_SVM","SVM",95,0,3812,3429,383,100,90,10,0.909682997583901,0.539906103286385,1.77737392094502,23,10,13,0,1.3,2.56,9,0,0,0,0,0,0,0.384416132806947,327.666479908062,43.0270325578251
8.7,"eps_greedy_SVM","SVM",95,1,3712,3390,322,200,129,71,0.886295012376807,0.568075117370892,1.70338467905689,101,52,49,78,0.9,5.11,1.8,0,0,0,0,0,0,0.722031666386694,241.439040634687,80.2477787565326
8.7,"eps_greedy_SVM","SVM",95,2,3612,3354,258,300,165,135,0.904415785206564,0.577464788732394,1.72709652409872,167,86,81,66,0.9,7.67,1.2,0,0,0,0,0,0,0.481883782568224,161.832414416634,60.859445365574
8.7,"eps_greedy_SVM","SVM",95,3,3512,3312,200,400,207,193,0.897656353111985,0.563380281690141,1.7318631198414,239,120,119,72,1,10.22,1.1,0,0,0,0,0,0,0.287082469700783,132.048554519988,46.9972297017329
8.7,"eps_greedy_SVM","SVM",95,4,3412,3265,147,500,254,246,0.885750917822882,0.572769953051643,1.71339063794532,332,168,164,93,1,12.78,1,0,0,0,0,0,0,0.238868263451176,129.996814150087,32.8667340524851
8.7,"eps_greedy_SVM","SVM",95,5,3312,3183,129,600,336,264,0.88184528859906,0.60093896713615,1.6727263303834,378,186,192,46,1,15.34,1.3,0,0,0,0,0,0,0.111531580863213,69.225327937601,16.7744869342009
8.7,"eps_greedy_SVM","SVM",95,6,3212,3106,106,700,413,287,0.887701038897377,0.615023474178404,1.67580969689102,425,206,219,47,1.1,17.89,1.4,0,0,0,0,0,0,0.0673356593051488,46.2495233452016,9.4330797960012
8.7,"eps_greedy_SVM","SVM",95,7,3112,3027,85,800,492,308,0.894117044973989,0.63849765258216,1.6727263303834,482,234,248,57,1.1,20.45,1.6,0,0,0,0,0,0,0.0595907341843947,52.3291431495886,7.65045267982512
8.7,"eps_greedy_SVM","SVM",95,8,3012,2944,68,900,575,325,0.878295206311496,0.657276995305164,1.60219351000401,526,250,276,44,1.1,23.01,1.8,0,0,0,0,0,0,0.0685298676358514,92.9333219531395,10.2112955869923
8.7,"eps_greedy_SVM","SVM",95,9,2912,2855,57,1000,664,336,0.882572543695914,0.647887323943662,1.61358954092541,564,268,296,38,1.1,25.56,2,0,0,0,0,0,0,0.0626260063951514,82.2219463777155,7.17495553148353
8.7,"eps_greedy_SVM","SVM",95,10,2812,2759,53,1100,760,340,0.8885737450136,0.657276995305164,1.64195495553969,572,271,301,8,1.1,28.12,2.2,0,0,0,0,0,0,0.0482730787893201,62.4969290495923,5.52889903756758
8.7,"eps_greedy_SVM","SVM",95,11,2712,2661,51,1200,858,342,0.889026259296086,0.652582159624413,1.64195495553969,576,275,301,4,1.1,30.67,2.5,0,0,0,0,0,0,0.0380150191390176,49.026812547484,4.08190991058799
8.7,"eps_greedy_SVM","SVM",95,12,2612,2562,50,1300,957,343,0.894047013001719,0.647887323943662,1.65041864087752,583,278,305,7,1.1,33.23,2.8,0,0,0,0,0,0,0.0291804656284207,36.2968473548678,3.20927732608538
8.7,"eps_greedy_SVM","SVM",95,13,2512,2467,45,1400,1052,348,0.897966109912484,0.63849765258216,1.64586785418393,601,288,313,18,1.1,35.79,3,0,0,0,0,0,0,0.0284497074441801,36.552514875939,3.06572315324135
8.7,"eps_greedy_SVM","SVM",95,14,2412,2370,42,1500,1149,351,0.905184790133044,0.643192488262911,1.67808688679367,612,294,318,11,1.1,38.34,3.3,0,0,0,0,0,0,0.025057240032425,29.2753471046889,2.71741236385657
8.7,"eps_greedy_SVM","SVM",95,15,2312,2277,35,1600,1242,358,0.909994101153097,0.652582159624413,1.67118889809445,633,304,329,21,1.1,40.9,3.5,0,0,0,0,0,0,0.0272085494743146,35.1416312822309,3.08622511512623
8.7,"eps_greedy_SVM","SVM",95,16,2212,2184,28,1700,1335,365,0.919518449384386,0.652582159624413,1.72709652409872,659,318,341,26,1.1,43.46,3.7,0,0,0,0,0,0,0.0510895517548009,43.5450675943074,5.90871289236658
8.7,"eps_greedy_SVM","SVM",95,17,2112,2086,26,1800,1433,367,0.921173628114051,0.652582159624413,1.74191372915208,672,325,347,13,1.1,46.01,3.9,0,0,0,0,0,0,0.0432425075372993,34.9149313035506,4.86694848667638
8.7,"eps_greedy_SVM","SVM",95,18,2012,1989,23,1900,1530,370,0.920885419612712,0.652582159624413,1.74191372915208,683,331,352,11,1.1,48.57,4.1,0,0,0,0,0,0,0.0424162785355469,30.5755257806075,4.74577523215022
8.7,"eps_greedy_SVM","SVM",95,19,1912,1896,16,2000,1623,377,0.92144298185363,0.652582159624413,1.7318631198414,708,340,368,25,1.1,51.12,4.3,0,0,0,0,0,0,0.0455884723022288,26.3953862330751,5.39501649071165
8.7,"eps_greedy_SVM","SVM",95,20,1812,1804,8,2100,1715,385,0.922205252936622,0.657276995305164,1.73345783726299,726,348,378,18,1.1,53.68,4.5,0,0,0,0,0,0,0.0309133119932976,22.728519386628,4.23191967427058
8.7,"eps_greedy_SVM","SVM",95,21,1712,1707,5,2200,1812,388,0.922015358550226,0.657276995305164,1.73027133388567,734,352,382,8,1.1,56.24,4.7,0,0,0,0,0,0,0.0247380668957552,19.6939303332909,2.83918911281462
8.7,"eps_greedy_SVM","SVM",95,22,1612,1607,5,2300,1912,388,0.921987076407571,0.657276995305164,1.72235609448088,737,354,383,3,1.1,58.79,4.9,0,0,0,0,0,0,0.0177144334129852,14.8095936899174,1.93764142526655
8.7,"eps_greedy_SVM","SVM",95,23,1512,1507,5,2400,2012,388,0.922098858209491,0.652582159624413,1.72709652409872,736,355,381,-1,1.1,61.35,5.2,0,0,0,0,0,0,0.014809308267125,11.4976094911574,1.51013613828545
8.7,"eps_greedy_SVM","SVM",95,24,1412,1407,5,2500,2112,388,0.925297433866913,0.647887323943662,1.75559237779619,756,366,390,20,1.1,63.91,5.4,0,0,0,0,0,0,0.0110289611961715,7.26634152515838,1.38079121010628
8.7,"eps_greedy_SVM","SVM",95,25,1312,1307,5,2600,2212,388,0.925057709038692,0.647887323943662,1.74715202982601,757,365,392,1,1.1,66.46,5.7,0,0,0,0,0,0,0.00825375862908791,5.60736468124881,0.887233630895401
8.7,"eps_greedy_SVM","SVM",95,26,1212,1207,5,2700,2312,388,0.925176224684106,0.647887323943662,1.76044655026936,754,367,387,-3,1.1,69.02,6,0,0,0,0,0,0,0.00681030618387281,4.13905779964127,0.706593891040125
8.7,"eps_greedy_SVM","SVM",95,27,1112,1107,5,2800,2412,388,0.925485981484616,0.647887323943662,1.75559237779619,750,369,381,-4,1,71.57,6.2,0,0,0,0,0,0,0.00550320364935806,3.04721039156928,0.593852496285526
8.7,"eps_greedy_SVM","SVM",95,28,1012,1007,5,2900,2512,388,0.925542545769927,0.647887323943662,1.75720745818055,750,370,380,0,1,74.13,6.5,0,0,0,0,0,0,0.00503631789618174,2.31250888595589,0.50928268375595
8.7,"eps_greedy_SVM","SVM",95,29,912,907,5,3000,2612,388,0.926555315830732,0.647887323943662,1.76241286100441,758,373,385,8,1,76.69,6.7,0,0,0,0,0,0,0.00392820493640658,1.55874086664684,0.426563552967828
8.7,"eps_greedy_SVM","SVM",95,30,812,808,4,3100,2711,389,0.926768105284994,0.63849765258216,1.76241286100441,767,375,392,9,1,79.24,7,0,0,0,0,0,0,0.00347799976000601,1.14523563480829,0.391908507093106
8.7,"eps_greedy_SVM","SVM",95,31,712,709,3,3200,2810,390,0.926812548652023,0.643192488262911,1.75559237779619,772,377,395,5,1,81.8,7.2,0,0,0,0,0,0,0.00275774331797983,0.774044870820904,0.323371629156081
8.7,"eps_greedy_SVM","SVM",95,32,612,610,2,3300,2909,391,0.927015910725403,0.643192488262911,1.75720745818055,779,378,401,7,1.1,84.36,7.4,0,0,0,0,0,0,0.00155384807437538,0.46451599425232,0.216522653641936
8.7,"eps_greedy_SVM","SVM",95,33,512,511,1,3400,3008,392,0.927675827387359,0.63849765258216,1.76891023560719,787,383,404,8,1.1,86.91,7.7,0,0,0,0,0,0,0.000976646644567428,0.31801772915004,0.134641029402436
8.7,"eps_greedy_SVM","SVM",95,34,412,412,0,3500,3107,393,0.927972116500889,0.633802816901408,1.76403272576636,790,385,405,3,1.1,89.47,7.9,0,0,0,0,0,0,0.000697933553772116,0.20415694709341,0.0904627699916033
8.7,"eps_greedy_SVM","SVM",95,35,312,312,0,3600,3207,393,0.928574122108832,0.629107981220657,1.76403272576636,794,386,408,4,1.1,92.02,8.2,0,0,0,0,0,0,0.000592037749566437,0.151635412611524,0.0764729043384601
8.7,"eps_greedy_SVM","SVM",95,36,212,212,0,3700,3307,393,0.928658968536796,0.624413145539906,1.76403272576636,797,387,410,3,1.1,94.58,8.4,0,0,0,0,0,0,0.000235601376646698,0.0494913136335738,0.0318280326662955
8.7,"eps_greedy_SVM","SVM",95,37,112,112,0,3800,3407,393,0.928900040133712,0.624413145539906,1.76403272576636,796,388,408,-1,1.1,97.14,8.7,0,0,0,0,0,0,8.27773953459921e-05,0.0149314373399,0.0140339084425986
8.7,"eps_greedy_SVM","SVM",95,38,12,12,0,3900,3507,393,0.929073773295734,0.619718309859155,1.76241286100441,796,389,407,0,1,99.69,8.9,0,0,0,0,0,0,8.41719147112585e-05,0.00116782230451476,0.00116782230451476
8.7,"eps_greedy_SVM","SVM",95,39,0,0,0,3912,3519,393,0.929022596085216,0.619718309859155,1.76241286100441,797,390,407,1,1,100,9,0,0,0,0,0,0,0,0,0
8.7,"eps_greedy_SVM","SVM",96,0,3812,3403,409,100,85,15,0.919583235254031,0.56043956043956,1.76007158440827,33,15,18,0,1.2,2.56,5.7,0,0,0,0,0,0,0.711796019922025,691.247811832627,73.9796822003437
8.7,"eps_greedy_SVM","SVM",96,1,3712,3382,330,200,106,94,0.921181411598541,0.56043956043956,1.76007158440827,84,44,40,51,0.9,5.11,1.1,0,0,0,0,0,0,0.692763316410894,512.642631258858,73.1673001239154
8.7,"eps_greedy_SVM","SVM",96,2,3612,3351,261,300,137,163,0.919821722809314,0.571428571428571,1.75323846660252,145,77,68,61,0.9,7.67,0.8,0,0,0,0,0,0,0.64593927225458,415.311290970324,69.5620498591207
8.7,"eps_greedy_SVM","SVM",96,3,3512,3295,217,400,193,207,0.914726761400943,0.565934065934066,1.74333316453132,231,119,112,86,0.9,10.22,0.9,0,0,0,0,0,0,0.451974504422244,217.339347780456,56.9318833571382
8.7,"eps_greedy_SVM","SVM",96,4,3412,3236,176,500,252,248,0.899963762280578,0.598901098901099,1.71877020038785,325,165,160,94,1,12.78,1,0,0,0,0,0,0,0.280028250223653,147.951612703836,38.7386864962159
8.7,"eps_greedy_SVM","SVM",96,5,3312,3175,137,600,313,287,0.903709875243145,0.626373626373626,1.73342786246012,401,201,200,76,1,15.34,1.1,0,0,0,0,0,0,0.209636583772335,148.283421374767,28.4617341876319
8.7,"eps_greedy_SVM","SVM",96,6,3212,3095,117,700,393,307,0.918533270562603,0.615384615384615,1.72864819004525,456,222,234,55,1.1,17.89,1.3,0,0,0,0,0,0,0.0982077631896918,63.7709762942645,13.3517522574622
8.7,"eps_greedy_SVM","SVM",96,7,3112,3016,96,800,472,328,0.923129576173544,0.642857142857143,1.75989971390155,496,244,252,40,1,20.45,1.4,0,0,0,0,0,0,0.0786482962814581,68.1884864527501,10.3678614075481
8.7,"eps_greedy_SVM","SVM",96,8,3012,2936,76,900,552,348,0.925437020701975,0.653846153846154,1.74840416936005,548,269,279,52,1,23.01,1.6,0,0,0,0,0,0,0.085666661578569,106.182697027433,12.4312687005544
8.7,"eps_greedy_SVM","SVM",96,9,2912,2859,53,1000,629,371,0.921475649491444,0.653846153846154,1.74012555981277,620,297,323,72,1.1,25.56,1.7,0,0,0,0,0,0,0.0982506563152255,111.192874267215,12.5531257881163
8.7,"eps_greedy_SVM","SVM",96,10,2812,2763,49,1100,725,375,0.924244582925535,0.642857142857143,1.74679865588956,635,304,331,15,1.1,28.12,1.9,0,0,0,0,0,0,0.0888349358133996,88.4273031435686,9.55831232798426
8.7,"eps_greedy_SVM","SVM",96,11,2712,2668,44,1200,820,380,0.926285664729868,0.642857142857143,1.75323846660252,656,314,342,21,1.1,30.67,2.2,0,0,0,0,0,0,0.0776061944533052,75.7769366100051,8.45945111778486
8.7,"eps_greedy_SVM","SVM",96,12,2612,2572,40,1300,916,384,0.927956626237359,0.642857142857143,1.75162406654119,665,318,347,9,1.1,33.23,2.4,0,0,0,0,0,0,0.0615308550951702,54.3280037422268,6.75544156867123
8.7,"eps_greedy_SVM","SVM",96,13,2512,2476,36,1400,1012,388,0.931888573658595,0.648351648351648,1.76152024770809,674,323,351,9,1.1,35.79,2.6,0,0,0,0,0,0,0.0553164648858757,47.7563712407551,6.04639488106571
8.7,"eps_greedy_SVM","SVM",96,14,2412,2384,28,1500,1104,396,0.933158442459464,0.659340659340659,1.75989971390155,697,334,363,23,1.1,38.34,2.8,0,0,0,0,0,0,0.0516911915463568,46.8942358979216,5.92821403309514
8.7,"eps_greedy_SVM","SVM",96,15,2312,2289,23,1600,1199,401,0.933864613402387,0.659340659340659,1.76152024770809,712,339,373,15,1.1,40.9,3,0,0,0,0,0,0,0.0405727475940676,37.4494538818712,4.56993973109907
8.7,"eps_greedy_SVM","SVM",96,16,2212,2192,20,1700,1296,404,0.934044253379095,0.659340659340659,1.76314376867372,717,342,375,5,1.1,43.46,3.2,0,0,0,0,0,0,0.0339245233454431,33.6136879031994,3.81139201736618
8.7,"eps_greedy_SVM","SVM",96,17,2112,2095,17,1800,1393,407,0.93428583817536,0.664835164835165,1.75989971390155,724,347,377,7,1.1,46.01,3.4,0,0,0,0,0,0,0.0267247478472487,26.9611173971156,2.9191730902884
8.7,"eps_greedy_SVM","SVM",96,18,2012,1996,16,1900,1492,408,0.934363269199807,0.664835164835165,1.76152024770809,732,352,380,8,1.1,48.57,3.7,0,0,0,0,0,0,0.0204331925226656,20.7189865753673,2.25411748635381
8.7,"eps_greedy_SVM","SVM",96,19,1912,1899,13,2000,1589,411,0.93472874363518,0.659340659340659,1.76314376867372,741,358,383,9,1.1,51.12,3.9,0,0,0,0,0,0,0.0193198190711402,19.4837535417818,2.06310234900567
8.7,"eps_greedy_SVM","SVM",96,20,1812,1799,13,2100,1689,411,0.934834049828427,0.659340659340659,1.76314376867372,744,360,384,3,1.1,53.68,4.1,0,0,0,0,0,0,0.0166926178280614,16.980169360374,1.79987090560496
8.7,"eps_greedy_SVM","SVM",96,21,1712,1702,10,2200,1786,414,0.935225850812115,0.664835164835165,1.76152024770809,760,366,394,16,1.1,56.24,4.3,0,0,0,0,0,0,0.0161260319291775,14.1617996240305,1.63113322948928
8.7,"eps_greedy_SVM","SVM",96,22,1612,1603,9,2300,1885,415,0.935258371842381,0.642857142857143,1.76653649380922,787,383,404,27,1.1,58.79,4.5,0,0,0,0,0,0,0.0116922218796096,7.10861755191393,1.61060538557355
8.7,"eps_greedy_SVM","SVM",96,23,1512,1505,7,2400,1983,417,0.935007495323184,0.642857142857143,1.77141642887499,797,386,411,10,1.1,61.35,4.8,0,0,0,0,0,0,0.00768390766798799,5.47947203674563,0.967212355891833
8.7,"eps_greedy_SVM","SVM",96,24,1412,1406,6,2500,2082,418,0.935196427022826,0.648351648351648,1.76978679094594,798,388,410,1,1.1,63.91,5,0,0,0,0,0,0,0.00644847010699021,4.90073084675562,0.727893479428905
8.7,"eps_greedy_SVM","SVM",96,25,1312,1307,5,2600,2181,419,0.935685791097308,0.648351648351648,1.76978679094594,799,389,410,1,1.1,66.46,5.2,0,0,0,0,0,0,0.00618033290118135,4.47628360302133,0.646364886786781
8.7,"eps_greedy_SVM","SVM",96,26,1212,1207,5,2700,2281,419,0.936710977860938,0.637362637362637,1.77141642887499,803,396,407,4,1,69.02,5.4,0,0,0,0,0,0,0.0044050512553545,2.94602940951906,0.485937009476858
8.7,"eps_greedy_SVM","SVM",96,27,1112,1110,2,2800,2378,422,0.937565816370795,0.631868131868132,1.76653649380922,815,400,415,12,1,71.57,5.6,0,0,0,0,0,0,0.00539344434409368,3.12565283052564,0.555002653805033
8.7,"eps_greedy_SVM","SVM",96,28,1012,1010,2,2900,2478,422,0.938326189030825,0.631868131868132,1.76491581812683,818,401,417,3,1,74.13,5.9,0,0,0,0,0,0,0.00386739546523565,2.07179106077384,0.439414606825222
8.7,"eps_greedy_SVM","SVM",96,29,912,910,2,3000,2578,422,0.938343223856202,0.626373626373626,1.76816014867485,816,401,415,-2,1,76.69,6.1,0,0,0,0,0,0,0.00339614918160925,1.58526077526653,0.354011782114094
8.7,"eps_greedy_SVM","SVM",96,30,812,810,2,3100,2678,422,0.938656045194949,0.626373626373626,1.76168337157348,828,405,423,12,1,79.24,6.3,0,0,0,0,0,0,0.00275738690229765,1.10351657840287,0.298290370835057
8.7,"eps_greedy_SVM","SVM",96,31,712,710,2,3200,2778,422,0.938742767942324,0.626373626373626,1.76491581812683,827,404,423,-1,1,81.8,6.6,0,0,0,0,0,0,0.00236915072198956,0.84827451652878,0.26414194189755
8.7,"eps_greedy_SVM","SVM",96,32,612,611,1,3300,2877,423,0.939538758873597,0.631868131868132,1.76653649380922,831,406,425,4,1,84.36,6.8,0,0,0,0,0,0,0.00207280733146339,0.697319316818072,0.241611658122171
8.7,"eps_greedy_SVM","SVM",96,33,512,511,1,3400,2977,423,0.939678134717593,0.631868131868132,1.76653649380922,833,408,425,2,1,86.91,7,0,0,0,0,0,0,0.00136872685489285,0.425265850778952,0.166616468952915
8.7,"eps_greedy_SVM","SVM",96,34,412,412,0,3500,3076,424,0.940012636743187,0.626373626373626,1.76816014867485,836,409,427,3,1,89.47,7.3,0,0,0,0,0,0,0.00110766930815946,0.319345159697191,0.134500259651726
8.7,"eps_greedy_SVM","SVM",96,35,312,312,0,3600,3176,424,0.940201568442828,0.626373626373626,1.76978679094594,836,410,426,0,1,92.02,7.5,0,0,0,0,0,0,0.000667610662511456,0.171581726165641,0.0856286555639322
8.7,"eps_greedy_SVM","SVM",96,36,212,212,0,3700,3276,424,0.940350236009759,0.626373626373626,1.76978679094594,838,412,426,2,1,94.58,7.7,0,0,0,0,0,0,0.000424627220550247,0.0851381642981562,0.0528265967029083
8.7,"eps_greedy_SVM","SVM",96,37,112,112,0,3800,3376,424,0.940605758390422,0.631868131868132,1.77141642887499,845,413,432,7,1,97.14,8,0,0,0,0,0,0,0.00019415656364835,0.0319283726276312,0.0298923365137707
8.7,"eps_greedy_SVM","SVM",96,38,12,12,0,3900,3476,424,0.940550008052824,0.631868131868132,1.77141642887499,844,413,431,-1,1,99.69,8.2,0,0,0,0,0,0,9.72065067892824e-05,0.00154117325347555,0.00154117325347555
8.7,"eps_greedy_SVM","SVM",96,39,0,0,0,3912,3488,424,0.940553105293801,0.631868131868132,1.77141642887499,845,413,432,1,1,100,8.2,0,0,0,0,0,0,0,0,0
8.7,"eps_greedy_SVM","SVM",97,0,3812,3412,400,100,92,8,0.819646981763023,0.44949494949495,1.58424801005446,26,8,18,0,2.2,2.56,11.5,0,0,0,0,0,0,0.401973299866205,349.744387489009,52.6301469661184
8.7,"eps_greedy_SVM","SVM",97,1,3712,3342,370,200,162,38,0.863983980878178,0.54040404040404,1.6282716669457,83,38,45,57,1.2,5.11,4.3,0,0,0,0,0,0,0.451398649524129,432.454988441789,51.9431415662878
8.7,"eps_greedy_SVM","SVM",97,2,3612,3325,287,300,179,121,0.87014341365876,0.515151515151515,1.64798212540148,133,69,64,50,0.9,7.67,1.5,0,0,0,0,0,0,0.588500103789497,292.270125330447,72.3377268209266
8.7,"eps_greedy_SVM","SVM",97,3,3512,3278,234,400,226,174,0.881540088024739,0.570707070707071,1.72357180621643,213,107,106,80,1,10.22,1.3,0,0,0,0,0,0,0.347886778796506,208.98322174106,46.9042743338529
8.7,"eps_greedy_SVM","SVM",97,4,3412,3229,183,500,275,225,0.884204674733687,0.606060606060606,1.70104358502149,299,150,149,86,1,12.78,1.2,0,0,0,0,0,0,0.337279053130932,192.008911137594,47.0784007248393
8.7,"eps_greedy_SVM","SVM",97,5,3312,3176,136,600,328,272,0.849418531159144,0.626262626262626,1.59042123163558,378,188,190,79,1,15.34,1.2,0,0,0,0,0,0,0.199047433446779,135.63827037525,28.5708569386987
8.7,"eps_greedy_SVM","SVM",97,6,3212,3107,105,700,397,303,0.846266993024673,0.641414141414141,1.55121462559479,461,226,235,83,1,17.89,1.3,0,0,0,0,0,0,0.102172642139682,91.6296769311566,14.4613696569354
8.7,"eps_greedy_SVM","SVM",97,7,3112,3031,81,800,473,327,0.834562921593642,0.646464646464647,1.52051389470744,513,246,267,52,1.1,20.45,1.4,0,0,0,0,0,0,0.0885370298243613,119.074601474582,12.5424250836963
8.7,"eps_greedy_SVM","SVM",97,8,3012,2937,75,900,567,333,0.848532250836005,0.646464646464647,1.55549974886991,529,253,276,16,1.1,23.01,1.7,0,0,0,0,0,0,0.0664652066813497,89.3009228011355,8.39848773531673
8.7,"eps_greedy_SVM","SVM",97,9,2912,2854,58,1000,650,350,0.858221004125443,0.646464646464647,1.56315686766469,578,272,306,49,1.1,25.56,1.9,0,0,0,0,0,0,0.0599177252656196,88.6694391497633,7.15557831527406
8.7,"eps_greedy_SVM","SVM",97,10,2812,2766,46,1100,738,362,0.865779524482594,0.646464646464647,1.57079991087344,606,290,316,28,1.1,28.12,2,0,0,0,0,0,0,0.0578014860621701,79.9450335178234,6.26792316887234
8.7,"eps_greedy_SVM","SVM",97,11,2712,2669,43,1200,835,365,0.90118477149194,0.641414141414141,1.66312620222464,640,315,325,34,1,30.67,2.3,0,0,0,0,0,0,0.0532399796614967,40.6321602844942,6.69023031586711
8.7,"eps_greedy_SVM","SVM",97,12,2612,2574,38,1300,930,370,0.901321232805875,0.646464646464647,1.64948568251321,652,321,331,12,1,33.23,2.5,0,0,0,0,0,0,0.0364853767259938,30.9325672410754,4.15248604802025
8.7,"eps_greedy_SVM","SVM",97,13,2512,2481,31,1400,1023,377,0.909972880109396,0.646464646464647,1.69791666666667,669,330,339,17,1,35.79,2.7,0,0,0,0,0,0,0.0357071715903168,37.5582617739342,4.14308989419376
8.7,"eps_greedy_SVM","SVM",97,14,2412,2384,28,1500,1120,380,0.912538352811387,0.641414141414141,1.7117162407485,678,333,345,9,1,38.34,2.9,0,0,0,0,0,0,0.0295455134130378,32.7055660802369,3.25868166776684
8.7,"eps_greedy_SVM","SVM",97,15,2312,2293,19,1600,1211,389,0.918887394996592,0.646464646464647,1.75400741546096,702,343,359,24,1,40.9,3.1,0,0,0,0,0,0,0.0675960674850195,48.065674060563,8.16049304850331
8.7,"eps_greedy_SVM","SVM",97,16,2212,2194,18,1700,1310,390,0.920486147021969,0.651515151515151,1.7647190133378,716,351,365,14,1,43.46,3.4,0,0,0,0,0,0,0.045819738669274,30.4474362416819,5.11317302041191
8.7,"eps_greedy_SVM","SVM",97,17,2112,2098,14,1800,1406,394,0.920408579538257,0.646464646464647,1.75824298026133,735,357,378,19,1.1,46.01,3.6,0,0,0,0,0,0,0.0452030304308242,26.3855268755207,5.11312748700679
8.7,"eps_greedy_SVM","SVM",97,18,2012,2004,8,1900,1500,400,0.920259190310368,0.641414141414141,1.76147504456328,745,362,383,10,1.1,48.57,3.8,0,0,0,0,0,0,0.0427329910512756,22.988454075764,5.12923093575541
8.7,"eps_greedy_SVM","SVM",97,19,1912,1905,7,2000,1599,401,0.919858424977861,0.636363636363636,1.75078609789354,745,364,381,0,1,51.12,4,0,0,0,0,0,0,0.0249906728111251,17.6030304479039,3.47275193424217
8.7,"eps_greedy_SVM","SVM",97,20,1812,1807,5,2100,1697,403,0.91969179853137,0.636363636363636,1.75078609789354,751,366,385,6,1.1,53.68,4.2,0,0,0,0,0,0,0.01751328194775,14.2268746503449,2.10115762653011
8.7,"eps_greedy_SVM","SVM",97,21,1712,1707,5,2200,1797,403,0.919645832615097,0.636363636363636,1.75239527629233,750,366,384,-1,1,56.24,4.5,0,0,0,0,0,0,0.0133984085597067,11.5700016845869,1.49403939375725
8.7,"eps_greedy_SVM","SVM",97,22,1612,1607,5,2300,1897,403,0.91972052722904,0.636363636363636,1.75239527629233,751,366,385,1,1.1,58.79,4.7,0,0,0,0,0,0,0.0112756030031424,9.30017338849716,1.17542180751865
8.7,"eps_greedy_SVM","SVM",97,23,1512,1507,5,2400,1997,403,0.920191677870843,0.646464646464647,1.76309553678459,756,368,388,5,1.1,61.35,5,0,0,0,0,0,0,0.00917834680292066,7.16153880388961,0.992338866726789
8.7,"eps_greedy_SVM","SVM",97,24,1412,1408,4,2500,2096,404,0.921504579354397,0.641414141414141,1.76309553678459,769,372,397,13,1.1,63.91,5.2,0,0,0,0,0,0,0.00731340311905141,5.37064358112321,0.805710371140808
8.7,"eps_greedy_SVM","SVM",97,25,1312,1308,4,2600,2196,404,0.921539053791602,0.641414141414141,1.76309553678459,773,375,398,4,1.1,66.46,5.4,0,0,0,0,0,0,0.00685509091761549,4.46350438712054,0.699044080698512
8.7,"eps_greedy_SVM","SVM",97,26,1212,1208,4,2700,2296,404,0.922172521575242,0.641414141414141,1.7647190133378,784,380,404,11,1.1,69.02,5.7,0,0,0,0,0,0,0.00560978424525465,3.3178540270235,0.599113194626103
8.7,"eps_greedy_SVM","SVM",97,27,1112,1108,4,2800,2396,404,0.922334838717082,0.646464646464647,1.7647190133378,785,382,403,1,1.1,71.57,5.9,0,0,0,0,0,0,0.00510262170379423,2.62540859595079,0.52638141346241
8.7,"eps_greedy_SVM","SVM",97,28,1012,1008,4,2900,2496,404,0.922201250272914,0.646464646464647,1.75824298026133,781,382,399,-4,1,74.13,6.2,0,0,0,0,0,0,0.00415845056112169,1.86555279204916,0.438972757261815
8.7,"eps_greedy_SVM","SVM",97,29,912,908,4,3000,2596,404,0.922409533331026,0.646464646464647,1.75985752845257,787,383,404,6,1.1,76.69,6.4,0,0,0,0,0,0,0.0033330734979495,1.27204909961297,0.354502975346371
8.7,"eps_greedy_SVM","SVM",97,30,812,808,4,3100,2696,404,0.922579032647283,0.646464646464647,1.76309553678459,788,383,405,1,1.1,79.24,6.7,0,0,0,0,0,0,0.0027133491620212,0.90827555916391,0.299521700899298
8.7,"eps_greedy_SVM","SVM",97,31,712,710,2,3200,2794,406,0.923232610519289,0.646464646464647,1.75502275502276,794,386,408,6,1.1,81.8,6.9,0,0,0,0,0,0,0.00261475736162068,0.89481976267405,0.313641775458654
8.7,"eps_greedy_SVM","SVM",97,32,612,610,2,3300,2894,406,0.923271394261144,0.646464646464647,1.75021447350214,798,386,412,4,1.1,84.36,7.1,0,0,0,0,0,0,0.00165276480085516,0.511117038574058,0.199328569364734
8.7,"eps_greedy_SVM","SVM",97,33,512,510,2,3400,2994,406,0.923381999747176,0.646464646464647,1.75502275502276,799,387,412,1,1.1,86.91,7.4,0,0,0,0,0,0,0.00103692483918268,0.322012255591573,0.134668526625774
8.7,"eps_greedy_SVM","SVM",97,34,412,412,0,3500,3092,408,0.923857459693626,0.646464646464647,1.77381550309727,806,391,415,7,1.1,89.47,7.6,0,0,0,0,0,0,0.000953636274248177,0.276028501722595,0.116897706563901
8.7,"eps_greedy_SVM","SVM",97,35,312,312,0,3600,3192,408,0.924331483205193,0.646464646464647,1.76730608840701,806,392,414,0,1.1,92.02,7.8,0,0,0,0,0,0,0.000650684801406123,0.161061582439081,0.0805962401651073
8.7,"eps_greedy_SVM","SVM",97,36,212,212,0,3700,3292,408,0.924794015237692,0.641414141414141,1.7689289590116,807,394,413,1,1,94.58,8.1,0,0,0,0,0,0,0.000356976467571896,0.0732753710468754,0.0461391244666104
8.7,"eps_greedy_SVM","SVM",97,37,112,112,0,3800,3392,408,0.925611346686425,0.641414141414141,1.77055481283422,807,395,412,0,1,97.14,8.3,0,0,0,0,0,0,0.000173690335081545,0.0284250092513411,0.0265896610810395
8.7,"eps_greedy_SVM","SVM",97,38,12,12,0,3900,3492,408,0.926167246986354,0.636363636363636,1.7689289590116,816,398,418,9,1.1,99.69,8.6,0,0,0,0,0,0,0.00012859705353231,0.00182498681172062,0.00182498681172062
8.7,"eps_greedy_SVM","SVM",97,39,0,0,0,3912,3504,408,0.926241941600298,0.636363636363636,1.7689289590116,816,398,418,0,1.1,100,8.6,0,0,0,0,0,0,0,0,0
8.7,"eps_greedy_SVM","SVM",98,0,3812,3394,418,100,90,10,0.911916558183037,0.539325842696629,1.76063070333354,25,10,15,0,1.5,2.56,9,0,0,0,0,0,0,0.663450197251427,384.11375887368,72.2488268248342
8.7,"eps_greedy_SVM","SVM",98,1,3712,3367,345,200,117,83,0.913114091075703,0.561797752808989,1.75739424983477,89,46,43,64,0.9,5.11,1.4,0,0,0,0,0,0,0.74540616514038,293.258048946501,81.813317791151
8.7,"eps_greedy_SVM","SVM",98,2,3612,3336,276,300,148,152,0.914122040924666,0.556179775280899,1.75212551131362,151,78,73,62,0.9,7.67,1,0,0,0,0,0,0,0.609495712092185,236.20434171578,69.5385008277221
8.7,"eps_greedy_SVM","SVM",98,3,3512,3294,218,400,190,210,0.919199706778252,0.573033707865168,1.7743325430368,226,117,109,75,0.9,10.22,0.9,0,0,0,0,0,0,0.443972960019868,204.256343744929,56.9924738636323
8.7,"eps_greedy_SVM","SVM",98,4,3412,3240,172,500,244,256,0.909666839397884,0.589887640449438,1.75739424983477,314,156,158,88,1,12.78,1,0,0,0,0,0,0,0.218604201998556,99.6993881403432,33.446179762015
8.7,"eps_greedy_SVM","SVM",98,5,3312,3180,132,600,304,296,0.894452800141553,0.606741573033708,1.70148604566872,408,202,206,94,1,15.34,1,0,0,0,0,0,0,0.182750161588874,111.115369312701,25.8511388710314
8.7,"eps_greedy_SVM","SVM",98,6,3212,3094,118,700,390,310,0.902336295041773,0.617977528089888,1.70148604566872,448,214,234,40,1.1,17.89,1.3,0,0,0,0,0,0,0.0802092971100293,52.6044815495257,11.6779076855305
8.7,"eps_greedy_SVM","SVM",98,7,3112,3019,93,800,465,335,0.895944186751936,0.634831460674157,1.65084658002382,501,239,262,53,1.1,20.45,1.4,0,0,0,0,0,0,0.0854976428468793,93.4736946219619,11.8585170177412
8.7,"eps_greedy_SVM","SVM",98,8,3012,2934,78,900,550,350,0.894936236902957,0.640449438202247,1.6609744731528,532,254,278,31,1.1,23.01,1.6,0,0,0,0,0,0,0.0624090113486863,79.8143825702326,8.14138645148682
8.7,"eps_greedy_SVM","SVM",98,9,2912,2846,66,1000,638,362,0.90131886604062,0.640449438202247,1.67968216524924,564,271,293,32,1.1,25.56,1.8,0,0,0,0,0,0,0.0558674162478935,77.9505991588017,8.03932772557133
8.7,"eps_greedy_SVM","SVM",98,10,2812,2753,59,1100,731,369,0.91048836592055,0.634831460674157,1.7116139387977,576,278,298,12,1.1,28.12,2,0,0,0,0,0,0,0.0439551912947588,60.2648257079363,4.93266420798747
8.7,"eps_greedy_SVM","SVM",98,11,2712,2659,53,1200,825,375,0.917916861515906,0.640449438202247,1.71003786703085,599,285,314,23,1.1,30.67,2.2,0,0,0,0,0,0,0.0388921928193995,55.5289254109164,4.2281675006051
8.7,"eps_greedy_SVM","SVM",98,12,2612,2563,49,1300,921,379,0.922452635836239,0.623595505617977,1.72015643429139,627,301,326,28,1.1,33.23,2.4,0,0,0,0,0,0,0.0360537814817459,50.6764779490627,3.95418330038255
8.7,"eps_greedy_SVM","SVM",98,13,2512,2468,44,1400,1016,384,0.926407022155928,0.623595505617977,1.72392536851871,647,316,331,20,1,35.79,2.6,0,0,0,0,0,0,0.0292444507061682,32.6707080197527,3.3982898988634
8.7,"eps_greedy_SVM","SVM",98,14,2412,2372,40,1500,1112,388,0.928798928223849,0.617977528089888,1.73027500155193,651,317,334,4,1.1,38.34,2.9,0,0,0,0,0,0,0.0291034569706795,35.756130230516,3.19295488596156
8.7,"eps_greedy_SVM","SVM",98,15,2312,2279,33,1600,1205,395,0.935804021688294,0.612359550561798,1.75901098787509,675,328,347,24,1.1,40.9,3.1,0,0,0,0,0,0,0.0543257218119316,40.8820277616238,6.36805532276564
8.7,"eps_greedy_SVM","SVM",98,16,2212,2182,30,1700,1302,398,0.936205305797439,0.612359550561798,1.7622534044426,687,333,354,12,1.1,43.46,3.3,0,0,0,0,0,0,0.0498022594117747,33.1829705827739,5.60378363085847
8.7,"eps_greedy_SVM","SVM",98,17,2112,2085,27,1800,1399,401,0.936303257036682,0.617977528089888,1.77074927059408,696,339,357,9,1.1,46.01,3.5,0,0,0,0,0,0,0.0430537171159518,27.7221920950365,5.04092570197956
8.7,"eps_greedy_SVM","SVM",98,18,2012,1993,19,1900,1491,409,0.93453697501294,0.617977528089888,1.75578048101031,721,348,373,25,1.1,48.57,3.6,0,0,0,0,0,0,0.0393067879216116,24.6481095975881,4.87510002444261
8.7,"eps_greedy_SVM","SVM",98,19,1912,1900,12,2000,1584,416,0.933807080294728,0.617977528089888,1.7622534044426,740,355,385,19,1.1,51.12,3.8,0,0,0,0,0,0,0.0282885099294071,22.8418541295024,4.03063731626913
8.7,"eps_greedy_SVM","SVM",98,20,1812,1802,10,2100,1682,418,0.933895552381785,0.612359550561798,1.75901098787509,746,358,388,6,1.1,53.68,4,0,0,0,0,0,0,0.0220626140390536,19.1064506728568,2.53829902322555
8.7,"eps_greedy_SVM","SVM",98,21,1712,1702,10,2200,1782,418,0.934086715284172,0.612359550561798,1.75739424983477,753,362,391,7,1.1,56.24,4.3,0,0,0,0,0,0,0.0161478887362761,14.2957877058322,1.7320288645879
8.7,"eps_greedy_SVM","SVM",98,22,1612,1602,10,2300,1882,418,0.933456351663898,0.612359550561798,1.76587117342991,760,366,394,7,1.1,58.79,4.5,0,0,0,0,0,0,0.0113940610512262,9.40806465743119,1.28153571625113
8.7,"eps_greedy_SVM","SVM",98,23,1512,1505,7,2400,1979,421,0.932650623728203,0.617977528089888,1.7691202464261,769,373,396,9,1.1,61.35,4.7,0,0,0,0,0,0,0.00975615874300901,7.6665990290569,1.08700981108318
8.7,"eps_greedy_SVM","SVM",98,24,1412,1405,7,2500,2079,421,0.93195548590133,0.606741573033708,1.76749421678784,776,376,400,7,1.1,63.91,4.9,0,0,0,0,0,0,0.00722281773543451,5.22130727898212,0.783972457839935
8.7,"eps_greedy_SVM","SVM",98,25,1312,1305,7,2600,2179,421,0.931423073520295,0.606741573033708,1.76749421678784,781,382,399,5,1,66.46,5.2,0,0,0,0,0,0,0.00556389451135676,3.71627161092908,0.603120921913878
8.7,"eps_greedy_SVM","SVM",98,26,1212,1207,5,2700,2277,423,0.932622186271651,0.601123595505618,1.76263401270868,793,388,405,12,1,69.02,5.4,0,0,0,0,0,0,0.00577599180758592,3.47142571115143,0.595112929594548
8.7,"eps_greedy_SVM","SVM",98,27,1112,1107,5,2800,2377,423,0.932577950228124,0.612359550561798,1.7691202464261,800,394,406,7,1,71.57,5.6,0,0,0,0,0,0,0.00446653813638519,2.41905404275741,0.499925672624046
8.7,"eps_greedy_SVM","SVM",98,28,1012,1008,4,2900,2476,424,0.9325305544672,0.606741573033708,1.7691202464261,803,392,411,3,1,74.13,5.8,0,0,0,0,0,0,0.00451762464328331,2.17083712430557,0.46731509876908
8.7,"eps_greedy_SVM","SVM",98,29,912,909,3,3000,2575,425,0.933074025859119,0.606741573033708,1.76587117342991,806,397,409,3,1,76.69,6.1,0,0,0,0,0,0,0.00441833071311947,1.81722608067834,0.470581645811942
8.7,"eps_greedy_SVM","SVM",98,30,812,810,2,3100,2674,426,0.933156178511385,0.601123595505618,1.76587117342991,811,399,412,5,1,79.24,6.3,0,0,0,0,0,0,0.00360362288690808,1.34335921463484,0.393496195143072
8.7,"eps_greedy_SVM","SVM",98,31,712,711,1,3200,2773,427,0.933389997598605,0.601123595505618,1.76263401270868,814,402,412,3,1,81.8,6.5,0,0,0,0,0,0,0.00324252390775694,1.13375107774044,0.363164709573081
8.7,"eps_greedy_SVM","SVM",98,32,612,611,1,3300,2873,427,0.933608018098851,0.601123595505618,1.76749421678784,812,400,412,-2,1,84.36,6.7,0,0,0,0,0,0,0.00209513637528465,0.653511696107399,0.246148040882411
8.7,"eps_greedy_SVM","SVM",98,33,512,511,1,3400,2973,427,0.933754944957712,0.595505617977528,1.76749421678784,811,400,411,-1,1,86.91,7,0,0,0,0,0,0,0.00140883644810434,0.438245174622764,0.179405278004768
8.7,"eps_greedy_SVM","SVM",98,34,412,412,0,3500,3072,428,0.934386888436684,0.595505617977528,1.76749421678784,820,404,416,9,1,89.47,7.2,0,0,0,0,0,0,0.000999886030011232,0.289730401418641,0.126260535812533
8.7,"eps_greedy_SVM","SVM",98,35,312,312,0,3600,3172,428,0.935042529796118,0.595505617977528,1.7691202464261,824,405,419,4,1,92.02,7.4,0,0,0,0,0,0,0.00059143615773655,0.154634328093855,0.077928697630109
8.7,"eps_greedy_SVM","SVM",98,36,212,212,0,3700,3272,428,0.935440654187868,0.589887640449438,1.7691202464261,829,408,421,5,1,94.58,7.6,0,0,0,0,0,0,0.000362303311409689,0.0767618840932999,0.0476861754468767
8.7,"eps_greedy_SVM","SVM",98,37,112,112,0,3800,3372,428,0.935627077514165,0.595505617977528,1.7691202464261,830,410,420,1,1,97.14,7.9,0,0,0,0,0,0,0.000166596675163813,0.0266895961456041,0.0249876626555283
8.7,"eps_greedy_SVM","SVM",98,38,12,12,0,3900,3472,428,0.935712389883827,0.595505617977528,1.76587117342991,831,411,420,1,1,99.69,8.1,0,0,0,0,0,0,0.000133869348301022,0.00183832302928191,0.00183832302928191
8.7,"eps_greedy_SVM","SVM",98,39,0,0,0,3912,3484,428,0.935608119209796,0.595505617977528,1.76587117342991,833,412,421,2,1,100,8.1,0,0,0,0,0,0,0,0,0
8.7,"eps_greedy_SVM","SVM",99,0,3812,3399,413,100,88,12,0.916414286825929,0.513812154696133,1.79449541284404,28,12,16,0,1.3,2.56,7.3,0,0,0,0,0,0,0.859865226713408,592.376844457125,89.1951503714325
8.7,"eps_greedy_SVM","SVM",99,1,3712,3378,334,200,109,91,0.905042409151043,0.50828729281768,1.78120325997375,66,35,31,38,0.9,5.11,1.2,0,0,0,0,0,0,0.773817090714525,337.223112634734,82.8510172021926
8.7,"eps_greedy_SVM","SVM",99,2,3612,3340,272,300,147,153,0.909666173838613,0.530386740331492,1.75968121496135,128,66,62,62,0.9,7.67,1,0,0,0,0,0,0,0.575866225952965,207.952879761118,68.2606023978806
8.7,"eps_greedy_SVM","SVM",99,3,3512,3301,211,400,186,214,0.915592560890208,0.535911602209945,1.76962291674079,210,108,102,82,0.9,10.22,0.9,0,0,0,0,0,0,0.358835327310869,132.454893384686,53.9556913609066
8.7,"eps_greedy_SVM","SVM",99,4,3412,3239,173,500,248,252,0.886562913391953,0.558011049723757,1.68169469796404,297,148,149,87,1,12.78,1,0,0,0,0,0,0,0.209786175659869,112.812870095996,30.6653522481676
8.7,"eps_greedy_SVM","SVM",99,5,3312,3184,128,600,303,297,0.885356781573431,0.591160220994475,1.6617929855621,390,194,196,93,1,15.34,1,0,0,0,0,0,0,0.158390576639171,97.5136176815145,26.0835327476809
8.7,"eps_greedy_SVM","SVM",99,6,3212,3104,108,700,383,317,0.894370866080469,0.602209944751381,1.66332459200041,441,212,229,51,1.1,17.89,1.2,0,0,0,0,0,0,0.0882083921597523,65.6607726375647,12.6164970566388
8.7,"eps_greedy_SVM","SVM",99,7,3112,3024,88,800,463,337,0.891224029258434,0.61878453038674,1.65032249538748,487,237,250,46,1.1,20.45,1.4,0,0,0,0,0,0,0.0656911048086377,73.6104894173547,9.7127544553961
8.7,"eps_greedy_SVM","SVM",99,8,3012,2941,71,900,546,354,0.888271729826486,0.61878453038674,1.65184212936113,524,255,269,37,1.1,23.01,1.5,0,0,0,0,0,0,0.0511398772262096,58.8479168543509,6.58579137375052
8.7,"eps_greedy_SVM","SVM",99,9,2912,2857,55,1000,630,370,0.885591782740658,0.613259668508287,1.64880565485863,570,277,293,46,1.1,25.56,1.7,0,0,0,0,0,0,0.0602602312219788,84.2337217479256,7.29036724226371
8.7,"eps_greedy_SVM","SVM",99,10,2812,2760,52,1100,727,373,0.888239047544946,0.61878453038674,1.65032249538748,588,282,306,18,1.1,28.12,1.9,0,0,0,0,0,0,0.0449224874034555,62.5112931792733,4.97948978367012
8.7,"eps_greedy_SVM","SVM",99,11,2712,2665,47,1200,822,378,0.897519259201619,0.613259668508287,1.6617929855621,601,291,310,13,1.1,30.67,2.2,0,0,0,0,0,0,0.0387980361960037,54.6788211132013,4.46988888422178
8.7,"eps_greedy_SVM","SVM",99,12,2612,2571,41,1300,916,384,0.91503851840325,0.607734806629834,1.67552334127427,628,305,323,27,1.1,33.23,2.4,0,0,0,0,0,0,0.0342299052252296,42.0477456183637,4.25023124432383
8.7,"eps_greedy_SVM","SVM",99,13,2512,2480,32,1400,1007,393,0.922561668352674,0.607734806629834,1.74492371635663,656,314,342,28,1.1,35.79,2.6,0,0,0,0,0,0,0.0553871049015595,54.7950681566851,6.73794120951527
8.7,"eps_greedy_SVM","SVM",99,14,2412,2384,28,1500,1103,397,0.925075091432588,0.607734806629834,1.76475239495159,670,326,344,14,1.1,38.34,2.8,0,0,0,0,0,0,0.0482530294747626,41.4265584031048,5.4685406836729
8.7,"eps_greedy_SVM","SVM",99,15,2312,2285,27,1600,1202,398,0.924921017819636,0.602209944751381,1.75322958814206,678,327,351,8,1.1,40.9,3,0,0,0,0,0,0,0.0366995862045361,30.6513960943004,4.06202741244088
8.7,"eps_greedy_SVM","SVM",99,16,2212,2189,23,1700,1298,402,0.924984826083583,0.607734806629834,1.75806386090348,687,334,353,9,1.1,43.46,3.2,0,0,0,0,0,0,0.0367039532544684,27.378604864218,4.2185255541272
8.7,"eps_greedy_SVM","SVM",99,17,2112,2093,19,1800,1394,406,0.924116411174239,0.602209944751381,1.76130154757181,703,343,360,16,1,46.01,3.4,0,0,0,0,0,0,0.0303438254383511,22.0768204254107,3.92036062667547
8.7,"eps_greedy_SVM","SVM",99,18,2012,2000,12,1900,1487,413,0.923577931678484,0.607734806629834,1.76130154757181,719,350,369,16,1.1,48.57,3.6,0,0,0,0,0,0,0.0250889038899241,20.8586813863072,3.49372771682175
8.7,"eps_greedy_SVM","SVM",99,19,1912,1904,8,2000,1583,417,0.923377169091916,0.602209944751381,1.75968121496135,735,357,378,16,1.1,51.12,3.8,0,0,0,0,0,0,0.0208907455278493,19.6877333492302,2.39908638975638
8.7,"eps_greedy_SVM","SVM",99,20,1812,1804,8,2100,1683,417,0.92343008326202,0.602209944751381,1.75968121496135,736,358,378,1,1.1,53.68,4,0,0,0,0,0,0,0.0162531134555664,15.5393523036177,1.77679933318551
8.7,"eps_greedy_SVM","SVM",99,21,1712,1705,7,2200,1782,418,0.923834721033399,0.602209944751381,1.75644947719282,735,358,377,-1,1.1,56.24,4.3,0,0,0,0,0,0,0.0141184498899647,13.484152416479,1.49922670326128
8.7,"eps_greedy_SVM","SVM",99,22,1612,1606,6,2300,1881,419,0.924324955256413,0.596685082872928,1.76130154757181,745,362,383,10,1.1,58.79,4.5,0,0,0,0,0,0,0.0108090191416567,9.52764675225497,1.12733410458895
8.7,"eps_greedy_SVM","SVM",99,23,1512,1506,6,2400,1981,419,0.924676678857685,0.585635359116022,1.76130154757181,754,367,387,9,1.1,61.35,4.7,0,0,0,0,0,0,0.00783599496909685,6.15868971486777,0.932462495484778
8.7,"eps_greedy_SVM","SVM",99,24,1412,1406,6,2500,2081,419,0.924651778071754,0.585635359116022,1.76130154757181,754,367,387,0,1.1,63.91,5,0,0,0,0,0,0,0.00704549842165151,5.34868440521652,0.738990435740247
8.7,"eps_greedy_SVM","SVM",99,25,1312,1306,6,2600,2181,419,0.925067309936978,0.580110497237569,1.75968121496135,761,371,390,7,1.1,66.46,5.2,0,0,0,0,0,0,0.00607670886194711,4.23290408686822,0.651153479070979
8.7,"eps_greedy_SVM","SVM",99,26,1212,1208,4,2700,2279,421,0.92610380515136,0.591160220994475,1.76962291674079,770,374,396,9,1.1,69.02,5.4,0,0,0,0,0,0,0.00699819367208383,4.31852338544842,0.712966637813461
8.7,"eps_greedy_SVM","SVM",99,27,1112,1108,4,2800,2379,421,0.926791689362702,0.574585635359116,1.77125240377278,784,383,401,14,1,71.57,5.7,0,0,0,0,0,0,0.00434202809194749,2.38472107355536,0.499177023129111
8.7,"eps_greedy_SVM","SVM",99,28,1012,1008,4,2900,2479,421,0.926928643685323,0.580110497237569,1.76962291674079,785,383,402,1,1,74.13,5.9,0,0,0,0,0,0,0.00434259825312903,2.03024755691123,0.44518782301576
8.7,"eps_greedy_SVM","SVM",99,29,912,908,4,3000,2579,421,0.927023577931683,0.574585635359116,1.77125240377278,785,383,402,0,1,76.69,6.1,0,0,0,0,0,0,0.002969828467659,1.1879361090134,0.326974009922657
8.7,"eps_greedy_SVM","SVM",99,30,812,809,3,3100,2678,422,0.927339506653185,0.574585635359116,1.76962291674079,791,386,405,6,1,79.24,6.3,0,0,0,0,0,0,0.00316782113925128,1.09392928522078,0.343712757868038
8.7,"eps_greedy_SVM","SVM",99,31,712,709,3,3200,2778,422,0.927124737374528,0.580110497237569,1.7728848944675,793,388,405,2,1,81.8,6.6,0,0,0,0,0,0,0.00220224218705068,0.687347397078006,0.26345785841313
8.7,"eps_greedy_SVM","SVM",99,32,612,609,3,3300,2878,422,0.92735506964439,0.574585635359116,1.77125240377278,791,387,404,-2,1,84.36,6.8,0,0,0,0,0,0,0.00127004985285243,0.411200367277587,0.167745409176994
8.7,"eps_greedy_SVM","SVM",99,33,512,509,3,3400,2978,422,0.927722356236872,0.580110497237569,1.7728848944675,792,388,404,1,1,86.91,7.1,0,0,0,0,0,0,0.00072986636427918,0.219114135059391,0.0945779758246164
8.7,"eps_greedy_SVM","SVM",99,34,412,411,1,3500,3076,424,0.929409384483701,0.574585635359116,1.77956461852023,804,395,409,12,1,89.47,7.3,0,0,0,0,0,0,0.000760910074532284,0.230857958061368,0.0960165868397053
8.7,"eps_greedy_SVM","SVM",99,35,312,312,0,3600,3175,425,0.930240448214149,0.574585635359116,1.77956461852023,809,397,412,5,1,92.02,7.5,0,0,0,0,0,0,0.000742672991010154,0.191851661852642,0.0893363129097931
8.7,"eps_greedy_SVM","SVM",99,36,212,212,0,3700,3275,425,0.930450548595442,0.574585635359116,1.77792898927527,811,397,414,2,1,94.58,7.7,0,0,0,0,0,0,0.000402064402794216,0.081493461385,0.0495808577321
8.7,"eps_greedy_SVM","SVM",99,37,112,112,0,3800,3375,425,0.930645085985527,0.574585635359116,1.78284492196451,820,401,419,9,1,97.14,7.9,0,0,0,0,0,0,0.000205681752479162,0.0318064725894803,0.029642538747358
8.7,"eps_greedy_SVM","SVM",99,38,12,12,0,3900,3475,425,0.930783596607268,0.574585635359116,1.77792898927527,820,403,417,0,1,99.69,8.2,0,0,0,0,0,0,0.000130490281681044,0.00180818338368247,0.00180818338368247
8.7,"eps_greedy_SVM","SVM",99,39,0,0,0,3912,3487,425,0.930903431639561,0.574585635359116,1.77956461852023,820,403,417,0,1,100,8.2,0,0,0,0,0,0,0,0,0
8.7,"eps_greedy_SVM","SVM",100,0,3812,3428,384,100,91,9,0.827678251571006,0.300469483568075,1.65888232621536,33,9,24,0,2.7,2.56,10.1,0,0,0,0,0,0,0.178122064453556,321.136991135032,27.9968177392736
8.7,"eps_greedy_SVM","SVM",100,1,3712,3350,362,200,169,31,0.910049318669719,0.563380281690141,1.75398026358334,69,31,38,36,1.2,5.11,5.5,0,0,0,0,0,0,0.615598385270227,330.724784287844,72.4127719828711
8.7,"eps_greedy_SVM","SVM",100,2,3612,3307,305,300,212,88,0.914554259964065,0.647887323943662,1.69963426970664,154,76,78,85,1,7.67,2.4,0,0,0,0,0,0,0.672582462760567,318.408325637135,73.8114824966455
8.7,"eps_greedy_SVM","SVM",100,3,3512,3269,243,400,250,150,0.90816384249271,0.661971830985915,1.68962255594283,223,111,112,69,1,10.22,1.7,0,0,0,0,0,0,0.523002879830512,202.961574397301,67.2535431851631
8.7,"eps_greedy_SVM","SVM",100,4,3412,3231,181,500,288,212,0.915707093969439,0.694835680751174,1.70495028997514,304,152,152,81,1,12.78,1.4,0,0,0,0,0,0,0.36527880392185,179.701634005594,51.2468815717879
8.7,"eps_greedy_SVM","SVM",100,5,3312,3180,132,600,339,261,0.931932963241318,0.699530516431925,1.72709652409872,392,196,196,88,1,15.34,1.3,0,0,0,0,0,0,0.264798210602851,138.571022869425,37.087254840333
8.7,"eps_greedy_SVM","SVM",100,6,3212,3111,101,700,408,292,0.897058387810122,0.694835680751174,1.64824846514987,479,238,241,87,1,17.89,1.4,0,0,0,0,0,0,0.156940687566347,116.053096635361,22.56889780602
8.7,"eps_greedy_SVM","SVM",100,7,3112,3030,82,800,489,311,0.901622586927181,0.704225352112676,1.6573548102612,530,256,274,51,1.1,20.45,1.6,0,0,0,0,0,0,0.0758401927116983,71.2004276976798,10.4616546566645
8.7,"eps_greedy_SVM","SVM",100,8,3012,2948,64,900,571,329,0.902976089468538,0.699530516431925,1.66122169195153,569,275,294,39,1.1,23.01,1.7,0,0,0,0,0,0,0.0621853850811809,74.552096401732,7.70067058710219
8.7,"eps_greedy_SVM","SVM",100,9,2912,2855,57,1000,664,336,0.90466763095305,0.704225352112676,1.6696542893726,593,287,306,24,1.1,25.56,2,0,0,0,0,0,0,0.0505493966678106,69.9675423041074,5.75598620451121
8.7,"eps_greedy_SVM","SVM",100,10,2812,2760,52,1100,759,341,0.909419030919107,0.704225352112676,1.6696542893726,609,295,314,16,1.1,28.12,2.2,0,0,0,0,0,0,0.0430806275361347,62.1687118683739,4.63315169863003
8.7,"eps_greedy_SVM","SVM",100,11,2712,2665,47,1200,854,346,0.91975413390652,0.694835680751174,1.6727263303834,632,308,324,23,1.1,30.67,2.5,0,0,0,0,0,0,0.0343720144927577,40.0998330009339,4.28610228538145
8.7,"eps_greedy_SVM","SVM",100,12,2612,2573,39,1300,946,354,0.925984285902828,0.694835680751174,1.69807066872255,654,318,336,22,1.1,33.23,2.7,0,0,0,0,0,0,0.0483176381014503,51.2744120692713,5.87882796857544
8.7,"eps_greedy_SVM","SVM",100,13,2512,2482,30,1400,1037,363,0.931465634503134,0.694835680751174,1.75720745818055,685,331,354,31,1.1,35.79,2.9,0,0,0,0,0,0,0.0649945262122196,56.2929272900254,7.73014992264235
8.7,"eps_greedy_SVM","SVM",100,14,2412,2385,27,1500,1134,366,0.932319485857578,0.685446009389671,1.76044655026936,698,338,360,13,1.1,38.34,3.1,0,0,0,0,0,0,0.055146452371984,43.2902037807085,6.02370246607532
8.7,"eps_greedy_SVM","SVM",100,15,2312,2289,23,1600,1230,370,0.932889169016779,0.685446009389671,1.75559237779619,708,343,365,10,1.1,40.9,3.3,0,0,0,0,0,0,0.041724852863503,31.5078769294649,4.7470490748096
8.7,"eps_greedy_SVM","SVM",100,16,2212,2194,18,1700,1325,375,0.933842681254864,0.685446009389671,1.75559237779619,721,350,371,13,1.1,43.46,3.5,0,0,0,0,0,0,0.0402065486864985,28.7102947469708,4.70763538024137
8.7,"eps_greedy_SVM","SVM",100,17,2112,2102,10,1800,1417,383,0.933593529045757,0.694835680751174,1.75398026358334,743,361,382,22,1.1,46.01,3.7,0,0,0,0,0,0,0.0327411452380922,26.3480756711884,4.49193817387794
8.7,"eps_greedy_SVM","SVM",100,18,2012,2004,8,1900,1515,385,0.933854802173142,0.694835680751174,1.75398026358334,747,363,384,4,1.1,48.57,3.9,0,0,0,0,0,0,0.0237308601325424,22.1977448499878,2.84233551975081
8.7,"eps_greedy_SVM","SVM",100,19,1912,1904,8,2000,1615,385,0.933892511696682,0.694835680751174,1.75237110737821,747,363,384,0,1.1,51.12,4.2,0,0,0,0,0,0,0.0205688450719876,18.2375446949455,2.10409797920571
8.7,"eps_greedy_SVM","SVM",100,20,1812,1804,8,2100,1715,385,0.93340767496545,0.694835680751174,1.75720745818055,766,368,398,19,1.1,53.68,4.5,0,0,0,0,0,0,0.0137457154155976,10.5569476281992,1.72335079478803
8.7,"eps_greedy_SVM","SVM",100,21,1712,1706,6,2200,1813,387,0.933588141970965,0.694835680751174,1.75882551293025,768,371,397,2,1.1,56.24,4.7,0,0,0,0,0,0,0.0112227415832359,8.8868642583241,1.18930243417402
8.7,"eps_greedy_SVM","SVM",100,22,1612,1607,5,2300,1912,388,0.934215736184174,0.694835680751174,1.75720745818055,776,377,399,8,1.1,58.79,4.9,0,0,0,0,0,0,0.00809823829907406,6.22368542236076,0.957665439571806
8.7,"eps_greedy_SVM","SVM",100,23,1512,1508,4,2400,2011,389,0.934042003022151,0.694835680751174,1.75882551293025,780,378,402,4,1.1,61.35,5.2,0,0,0,0,0,0,0.0085798310069264,6.19958117287604,0.900756843849363
8.7,"eps_greedy_SVM","SVM",100,24,1412,1408,4,2500,2111,389,0.934635928017911,0.694835680751174,1.75720745818055,782,381,401,2,1.1,63.91,5.4,0,0,0,0,0,0,0.00583332115479817,3.95045606194748,0.649233329434648
8.7,"eps_greedy_SVM","SVM",100,25,1312,1309,3,2600,2210,390,0.934688451997127,0.694835680751174,1.75882551293025,786,382,404,4,1.1,66.46,5.7,0,0,0,0,0,0,0.00513271129249401,3.20493592462265,0.539048960588375
8.7,"eps_greedy_SVM","SVM",100,26,1212,1209,3,2700,2310,390,0.934829862710405,0.694835680751174,1.76044655026936,785,384,401,-1,1,69.02,5.9,0,0,0,0,0,0,0.0051518559354202,3.00755293037505,0.547963057156582
8.7,"eps_greedy_SVM","SVM",100,27,1112,1110,2,2800,2409,391,0.935143659817005,0.699530516431925,1.75559237779619,789,385,404,4,1,71.57,6.2,0,0,0,0,0,0,0.00430565705903494,2.24260106212741,0.453336561499295
8.7,"eps_greedy_SVM","SVM",100,28,1012,1010,2,2900,2509,391,0.935105950293465,0.694835680751174,1.75882551293025,792,387,405,3,1,74.13,6.4,0,0,0,0,0,0,0.00319241804660631,1.46019467197042,0.342165033320746
8.7,"eps_greedy_SVM","SVM",100,29,912,910,2,3000,2609,391,0.935215038557992,0.694835680751174,1.75882551293025,792,387,405,0,1,76.69,6.7,0,0,0,0,0,0,0.00273251866250554,1.1111455489179,0.298536556287966
8.7,"eps_greedy_SVM","SVM",100,30,812,810,2,3100,2709,391,0.935285070530281,0.694835680751174,1.75720745818055,790,387,403,-2,1,79.24,6.9,0,0,0,0,0,0,0.00228274389335917,0.836184333526044,0.256208576051332
8.7,"eps_greedy_SVM","SVM",100,31,712,711,1,3200,2808,392,0.935659472228283,0.694835680751174,1.75076490104698,793,388,405,3,1,81.8,7.2,0,0,0,0,0,0,0.00172355586950085,0.573666902482014,0.196850652751445
8.7,"eps_greedy_SVM","SVM",100,32,612,611,1,3300,2908,392,0.935775294336298,0.694835680751174,1.75720745818055,797,389,408,4,1,84.36,7.4,0,0,0,0,0,0,0.00114095195082048,0.358847021554327,0.141013103380664
8.7,"eps_greedy_SVM","SVM",100,33,512,511,1,3400,3008,392,0.935901890593897,0.694835680751174,1.75559237779619,800,390,410,3,1.1,86.91,7.7,0,0,0,0,0,0,0.000691647368968681,0.210221990755671,0.0892191564797022
8.7,"eps_greedy_SVM","SVM",100,34,412,412,0,3500,3107,393,0.936283026135389,0.694835680751174,1.75559237779619,800,391,409,0,1,89.47,7.9,0,0,0,0,0,0,0.000447699981887911,0.124998480327772,0.0568143106469961
8.7,"eps_greedy_SVM","SVM",100,35,312,312,0,3600,3207,393,0.93644733191653,0.685446009389671,1.75559237779619,804,392,412,4,1.1,92.02,8.2,0,0,0,0,0,0,0.00041168472779332,0.100447165994086,0.051869553063417
8.7,"eps_greedy_SVM","SVM",100,36,212,212,0,3700,3307,393,0.936703217969126,0.68075117370892,1.75559237779619,806,393,413,2,1.1,94.58,8.4,0,0,0,0,0,0,9.37126533815085e-05,0.0197213239115512,0.0130378641480862
8.7,"eps_greedy_SVM","SVM",100,37,112,112,0,3800,3407,393,0.937019708613124,0.671361502347418,1.76044655026936,807,393,414,1,1.1,97.14,8.7,0,0,0,0,0,0,3.97253112993012e-05,0.00810480332145825,0.00766918143002258
8.7,"eps_greedy_SVM","SVM",100,38,12,12,0,3900,3507,393,0.937138224258535,0.666666666666667,1.75882551293025,806,393,413,-1,1.1,99.69,8.9,0,0,0,0,0,0,1.7760914189801e-05,0.000272282073658208,0.000272282073658208
8.7,"eps_greedy_SVM","SVM",100,39,0,0,0,3912,3519,393,0.937111288884578,0.666666666666667,1.75237110737821,805,393,412,-1,1,100,9,0,0,0,0,0,0,0,0,0
